time,subj_course_id,sec_code,sec_id,prof,available,waitlist,total,enrolled_ct
1713301199855,AESE 279B,A00,494370,Wade; Jon P,33,0,33,0
1713301200883,ANAR 135S,A00,494369,Braswell; Geoffrey E.,0,0,0,0
1713301201913,CAT 124RS,A01,519847,Geibel; William,18,0,20,2
1713301202945,CAT 125RS,A01,515971,Geibel; William,18,0,20,2
1713301203969,CLRE 250,A00,511389,Morris; Sheldon,9996,0,9999,3
1713301205000,CLRE 251,A00,507176,Mehta; Ravindra L.,9996,0,9999,3
1713301205000,CLRE 251,B00,511410,Mehta; Ravindra L.,9998,0,9999,1
1713301206025,CLRE 252,A00,507189,Cuomo; Raphael Eduardo,9998,0,9999,1
1713301207055,CLRE 253,A00,507199,Vaida; Florin,9997,0,9999,2
1713301207055,CLRE 253,B00,507202,Vaida; Florin,9999,0,9999,0
1713301208079,CLRE 259,A00,507211,Patel; Hemal,9996,0,9999,3
1713301209105,CLRE 260,A00,507221,Cuomo; Raphael Eduardo,9999,0,9999,0
1713301210129,CLRE 297,001,507242,Cuomo; Raphael Eduardo,9999,0,9999,0
1713301211154,CSE 191,A00,516875,Minnes Kemp; Mor Mia,9999,0,9999,0
1713301212181,CSS 201S,A01,494383,Staff,35,0,35,0
1713301213207,CSS 202S,A01,494387,Staff,35,0,35,0
1713301214230,EAP 100,A00,516065,Staff,9792,0,9999,207
1713301215254,ECE 45,A01,507414,Staff,56,0,60,4
1713301216288,ECE 100,A01,507416,Baghdadchi; Saharnaz,12,0,20,8
1713301216288,ECE 100,A02,507418,Baghdadchi; Saharnaz,20,0,20,0
1713301217315,ECE 111,A01,507420,Staff,42,0,50,8
1713301218341,ECE 197,001,548057,Sievenpiper; Daniel F.,9999,0,9999,0
1713301219367,EDS 115,A00,507243,Choi; Bailey Miyeon,28,0,28,0
1713301220396,EDS 117,A01,494379,Staff,25,0,25,0
1713301221424,EDS 125,A00,507246,Hopkins; Megan Beth,29,0,30,1
1713301222450,EDS 128A,A01,507264,Fargason; Sharon Gayle,26,0,26,0
1713301223480,EDS 128B,A01,507293,Pappas; Elizabeth,30,0,30,0
1713301224507,EDS 139,A00,507294,Fargason; Sharon Gayle,30,0,30,0
1713301224507,EDS 139,B00,507313,Pappas; Elizabeth,30,0,30,0
1713301225535,EDS 201,A00,507315,Staff,27,0,30,3
1713301226561,EDS 203,A01,507317,Halter; Christopher P.,27,0,30,3
1713301227590,EDS 204R,A01,507319,Halter; Christopher P.,6,0,30,24
1713301227590,EDS 204R,B01,507331,Heinzman; Erica M.,30,0,30,0
1713301228618,EDS 206R,A00,507332,Staff,8,0,30,22
1713301228618,EDS 206R,B00,507343,Staff,29,0,30,1
1713301229643,EDS 250,A00,507344,Hemans; Patricia Ann Benitez,37,0,40,3
1713301230669,EDS 281,A00,507345,Daly; Alan J.,18,0,18,0
1713301231693,EDS 284,A00,507350,Daly; Alan J.,16,0,16,0
1713301232717,EDS 286,A00,507359,Fine; Sarah,18,0,18,0
1713301233742,EDS 289C,A01,507361,Daly; Alan J.,18,0,18,0
1713301234767,EDS 290,A00,507366,Hofstetter; Carolyn,15,0,15,0
1713301235794,LIGM 5A,A00,507421,Fischer-Grunski; Eva K,20,0,20,0
1713301236823,LIGM 5B,A00,507423,Fischer-Grunski; Eva K,20,0,20,0
1713301237849,LIGM 5C,A00,507425,Fischer-Grunski; Eva K,20,0,20,0
1713301238875,LIIT 5AS,A00,507427,Carnelos; Chiara,20,0,20,0
1713301239904,LIIT 5BS,A00,507430,Carnelos; Chiara,20,0,20,0
1713301240931,LIIT 5CS,A00,507432,Carnelos; Chiara,20,0,20,0
1713301241960,LISP 5A,A00,507541,Munoz Sanchez; Alicia,19,0,20,1
1713301242988,LISP 5B,A00,507671,Munoz Sanchez; Alicia,17,0,20,3
1713301244014,LISP 5C,A00,507696,Munoz Sanchez; Alicia,18,0,20,2
1713301245045,MAE 197,001,528363,Boechler; Nicholas Sebastia,9999,0,9999,0
1713301246072,MATH 197,001,523477,Kedlaya; Kiran S.,9999,0,9999,0
1713301246072,MATH 197,002,563811,Zhang; Danna,9999,0,9999,0
1713301247100,MCWP 40R,A00,518780,Staff,20,0,20,0
1713301247100,MCWP 40R,B00,518781,Staff,20,0,20,0
1713301247100,MCWP 40R,C00,518783,Staff,20,0,20,0
1713301248126,MCWP 50R,A00,518791,Staff,20,0,20,0
1713301248126,MCWP 50R,B00,518792,Staff,20,0,20,0
1713301248126,MCWP 50R,C00,518793,Staff,20,0,20,0
1713301248126,MCWP 50R,D00,518794,Staff,19,0,20,1
1713301248126,MCWP 50R,E00,518795,Staff,19,0,20,1
1713301248126,MCWP 50R,F00,518796,Staff,20,0,20,0
1713301248126,MCWP 50R,G00,518797,Staff,19,0,20,1
1713301249151,MMW 12R,A01,514034,Herbst; Matthew,16,0,16,0
1713301249151,MMW 12R,A02,514035,Herbst; Matthew,16,0,16,0
1713301250176,MMW 13R,A01,514037,Staff,16,0,16,0
1713301250176,MMW 13R,A02,514039,Staff,16,0,16,0
1713301251202,RMED 296,001,626776,Averbach; Sarah Helene,1,0,1,0
1713301252229,SIO 295LS,A00,523233,Staff,19,0,30,11
1713301253255,SIO 295S,A00,523232,Staff,19,0,30,11
1713301254281,SOCI 117,A01,494376,Staff,2,0,5,3
1713301255307,WES 237B,A00,494380,Staff,19,0,20,1
1713301257392,AESE 279B,A00,494370,Wade; Jon P,33,0,33,0
1713301258417,ANAR 135S,A00,494369,Braswell; Geoffrey E.,0,0,0,0
1713301259445,CAT 124RS,A01,519847,Geibel; William,18,0,20,2
1713301260470,CAT 125RS,A01,515971,Geibel; William,18,0,20,2
1713301261506,CLRE 250,A00,511389,Morris; Sheldon,9996,0,9999,3
1713301262532,CLRE 251,A00,507176,Mehta; Ravindra L.,9996,0,9999,3
1713301262532,CLRE 251,B00,511410,Mehta; Ravindra L.,9998,0,9999,1
1713301263560,CLRE 252,A00,507189,Cuomo; Raphael Eduardo,9998,0,9999,1
1713301264596,CLRE 253,A00,507199,Vaida; Florin,9997,0,9999,2
1713301264596,CLRE 253,B00,507202,Vaida; Florin,9999,0,9999,0
1713301265622,CLRE 259,A00,507211,Patel; Hemal,9996,0,9999,3
1713301266651,CLRE 260,A00,507221,Cuomo; Raphael Eduardo,9999,0,9999,0
1713301267678,CLRE 297,001,507242,Cuomo; Raphael Eduardo,9999,0,9999,0
1713301268707,CSE 191,A00,516875,Minnes Kemp; Mor Mia,9999,0,9999,0
1713301269732,CSS 201S,A01,494383,Staff,35,0,35,0
1713301270756,CSS 202S,A01,494387,Staff,35,0,35,0
1713301271785,EAP 100,A00,516065,Staff,9792,0,9999,207
1713301272809,ECE 45,A01,507414,Staff,56,0,60,4
1713301273839,ECE 100,A01,507416,Baghdadchi; Saharnaz,12,0,20,8
1713301273839,ECE 100,A02,507418,Baghdadchi; Saharnaz,20,0,20,0
1713301274864,ECE 111,A01,507420,Staff,42,0,50,8
1713301275894,ECE 197,001,548057,Sievenpiper; Daniel F.,9999,0,9999,0
1713301276921,EDS 115,A00,507243,Choi; Bailey Miyeon,28,0,28,0
1713301277947,EDS 117,A01,494379,Staff,25,0,25,0
1713301278988,EDS 125,A00,507246,Hopkins; Megan Beth,29,0,30,1
1713301280019,EDS 128A,A01,507264,Fargason; Sharon Gayle,26,0,26,0
1713301281043,EDS 128B,A01,507293,Pappas; Elizabeth,30,0,30,0
1713301282068,EDS 139,A00,507294,Fargason; Sharon Gayle,30,0,30,0
1713301282068,EDS 139,B00,507313,Pappas; Elizabeth,30,0,30,0
1713301283096,EDS 201,A00,507315,Staff,26,0,30,4
1713301284130,EDS 203,A01,507317,Halter; Christopher P.,26,0,30,4
1713301285156,EDS 204R,A01,507319,Halter; Christopher P.,6,0,30,24
1713301285156,EDS 204R,B01,507331,Heinzman; Erica M.,30,0,30,0
1713301286181,EDS 206R,A00,507332,Staff,8,0,30,22
1713301286181,EDS 206R,B00,507343,Staff,29,0,30,1
1713301287209,EDS 250,A00,507344,Hemans; Patricia Ann Benitez,36,0,40,4
1713301288234,EDS 281,A00,507345,Daly; Alan J.,18,0,18,0
1713301289262,EDS 284,A00,507350,Daly; Alan J.,16,0,16,0
1713301290340,EDS 286,A00,507359,Fine; Sarah,18,0,18,0
1713301291364,EDS 289C,A01,507361,Daly; Alan J.,18,0,18,0
1713301292390,EDS 290,A00,507366,Hofstetter; Carolyn,15,0,15,0
1713301293419,LIGM 5A,A00,507421,Fischer-Grunski; Eva K,20,0,20,0
1713301294443,LIGM 5B,A00,507423,Fischer-Grunski; Eva K,20,0,20,0
1713301295476,LIGM 5C,A00,507425,Fischer-Grunski; Eva K,20,0,20,0
1713301296503,LIIT 5AS,A00,507427,Carnelos; Chiara,20,0,20,0
1713301297526,LIIT 5BS,A00,507430,Carnelos; Chiara,20,0,20,0
1713301298551,LIIT 5CS,A00,507432,Carnelos; Chiara,20,0,20,0
1713301299579,LISP 5A,A00,507541,Munoz Sanchez; Alicia,19,0,20,1
1713301300605,LISP 5B,A00,507671,Munoz Sanchez; Alicia,17,0,20,3
1713301301638,LISP 5C,A00,507696,Munoz Sanchez; Alicia,18,0,20,2
1713301302667,MAE 197,001,528363,Boechler; Nicholas Sebastia,9999,0,9999,0
1713301303695,MATH 197,001,523477,Kedlaya; Kiran S.,9999,0,9999,0
1713301303695,MATH 197,002,563811,Zhang; Danna,9999,0,9999,0
1713301304719,MCWP 40R,A00,518780,Staff,20,0,20,0
1713301304719,MCWP 40R,B00,518781,Staff,20,0,20,0
1713301304719,MCWP 40R,C00,518783,Staff,20,0,20,0
1713301305749,MCWP 50R,A00,518791,Staff,20,0,20,0
1713301305749,MCWP 50R,B00,518792,Staff,20,0,20,0
1713301305749,MCWP 50R,C00,518793,Staff,20,0,20,0
1713301305749,MCWP 50R,D00,518794,Staff,19,0,20,1
1713301305749,MCWP 50R,E00,518795,Staff,19,0,20,1
1713301305749,MCWP 50R,F00,518796,Staff,20,0,20,0
1713301305749,MCWP 50R,G00,518797,Staff,19,0,20,1
1713301306779,MMW 12R,A01,514034,Herbst; Matthew,16,0,16,0
1713301306779,MMW 12R,A02,514035,Herbst; Matthew,16,0,16,0
1713301307804,MMW 13R,A01,514037,Staff,16,0,16,0
1713301307804,MMW 13R,A02,514039,Staff,16,0,16,0
1713301308831,RMED 296,001,626776,Averbach; Sarah Helene,1,0,1,0
1713301309857,SIO 295LS,A00,523233,Staff,19,0,30,11
1713301310882,SIO 295S,A00,523232,Staff,19,0,30,11
1713301311908,SOCI 117,A01,494376,Staff,2,0,5,3
1713301312936,WES 237B,A00,494380,Staff,19,0,20,1
1713301315009,AESE 279B,A00,494370,Wade; Jon P,33,0,33,0
1713301316034,ANAR 135S,A00,494369,Braswell; Geoffrey E.,0,0,0,0
1713301317062,CAT 124RS,A01,519847,Geibel; William,18,0,20,2
1713301318101,CAT 125RS,A01,515971,Geibel; William,18,0,20,2
1713301319130,CLRE 250,A00,511389,Morris; Sheldon,9996,0,9999,3
1713301320155,CLRE 251,A00,507176,Mehta; Ravindra L.,9996,0,9999,3
1713301320155,CLRE 251,B00,511410,Mehta; Ravindra L.,9998,0,9999,1
1713301321182,CLRE 252,A00,507189,Cuomo; Raphael Eduardo,9998,0,9999,1
1713301322207,CLRE 253,A00,507199,Vaida; Florin,9997,0,9999,2
1713301322207,CLRE 253,B00,507202,Vaida; Florin,9999,0,9999,0
1713301323237,CLRE 259,A00,507211,Patel; Hemal,9996,0,9999,3
1713301324266,CLRE 260,A00,507221,Cuomo; Raphael Eduardo,9999,0,9999,0
1713301325291,CLRE 297,001,507242,Cuomo; Raphael Eduardo,9999,0,9999,0
1713301326316,CSE 191,A00,516875,Minnes Kemp; Mor Mia,9999,0,9999,0
1713301327345,CSS 201S,A01,494383,Staff,35,0,35,0
1713301328371,CSS 202S,A01,494387,Staff,35,0,35,0
1713301329395,EAP 100,A00,516065,Staff,9792,0,9999,207
1713301330419,ECE 45,A01,507414,Staff,56,0,60,4
1713301331445,ECE 100,A01,507416,Baghdadchi; Saharnaz,12,0,20,8
1713301331445,ECE 100,A02,507418,Baghdadchi; Saharnaz,20,0,20,0
1713301332471,ECE 111,A01,507420,Staff,42,0,50,8
1713301333498,ECE 197,001,548057,Sievenpiper; Daniel F.,9999,0,9999,0
1713301334526,EDS 115,A00,507243,Choi; Bailey Miyeon,28,0,28,0
1713301335551,EDS 117,A01,494379,Staff,25,0,25,0
1713301336577,EDS 125,A00,507246,Hopkins; Megan Beth,29,0,30,1
1713301337608,EDS 128A,A01,507264,Fargason; Sharon Gayle,26,0,26,0
1713301338632,EDS 128B,A01,507293,Pappas; Elizabeth,30,0,30,0
1713301339657,EDS 139,A00,507294,Fargason; Sharon Gayle,30,0,30,0
1713301339657,EDS 139,B00,507313,Pappas; Elizabeth,30,0,30,0
1713301340686,EDS 201,A00,507315,Staff,26,0,30,4
1713301341714,EDS 203,A01,507317,Halter; Christopher P.,26,0,30,4
1713301342738,EDS 204R,A01,507319,Halter; Christopher P.,6,0,30,24
1713301342738,EDS 204R,B01,507331,Heinzman; Erica M.,30,0,30,0
1713301343763,EDS 206R,A00,507332,Staff,8,0,30,22
1713301343763,EDS 206R,B00,507343,Staff,29,0,30,1
1713301344794,EDS 250,A00,507344,Hemans; Patricia Ann Benitez,36,0,40,4
1713301345820,EDS 281,A00,507345,Daly; Alan J.,18,0,18,0
1713301346847,EDS 284,A00,507350,Daly; Alan J.,16,0,16,0
1713301347875,EDS 286,A00,507359,Fine; Sarah,18,0,18,0
1713301348900,EDS 289C,A01,507361,Daly; Alan J.,18,0,18,0
1713301349926,EDS 290,A00,507366,Hofstetter; Carolyn,15,0,15,0
1713301350959,LIGM 5A,A00,507421,Fischer-Grunski; Eva K,20,0,20,0
1713301351984,LIGM 5B,A00,507423,Fischer-Grunski; Eva K,20,0,20,0
1713301353013,LIGM 5C,A00,507425,Fischer-Grunski; Eva K,20,0,20,0
1713301354039,LIIT 5AS,A00,507427,Carnelos; Chiara,20,0,20,0
1713301355064,LIIT 5BS,A00,507430,Carnelos; Chiara,20,0,20,0
1713301356092,LIIT 5CS,A00,507432,Carnelos; Chiara,20,0,20,0
1713301357117,LISP 5A,A00,507541,Munoz Sanchez; Alicia,19,0,20,1
1713301358142,LISP 5B,A00,507671,Munoz Sanchez; Alicia,17,0,20,3
1713301359173,LISP 5C,A00,507696,Munoz Sanchez; Alicia,18,0,20,2
1713301360200,MAE 197,001,528363,Boechler; Nicholas Sebastia,9999,0,9999,0
1713301361232,MATH 197,001,523477,Kedlaya; Kiran S.,9999,0,9999,0
1713301361232,MATH 197,002,563811,Zhang; Danna,9999,0,9999,0
1713301362257,MCWP 40R,A00,518780,Staff,20,0,20,0
1713301362257,MCWP 40R,B00,518781,Staff,20,0,20,0
1713301362257,MCWP 40R,C00,518783,Staff,20,0,20,0
1713301363287,MCWP 50R,A00,518791,Staff,20,0,20,0
1713301363287,MCWP 50R,B00,518792,Staff,20,0,20,0
1713301363287,MCWP 50R,C00,518793,Staff,20,0,20,0
1713301363287,MCWP 50R,D00,518794,Staff,19,0,20,1
1713301363287,MCWP 50R,E00,518795,Staff,19,0,20,1
1713301363287,MCWP 50R,F00,518796,Staff,20,0,20,0
1713301363287,MCWP 50R,G00,518797,Staff,19,0,20,1
1713301364319,MMW 12R,A01,514034,Herbst; Matthew,16,0,16,0
1713301364319,MMW 12R,A02,514035,Herbst; Matthew,16,0,16,0
1713301365342,MMW 13R,A01,514037,Staff,16,0,16,0
1713301365342,MMW 13R,A02,514039,Staff,16,0,16,0
1713301366371,RMED 296,001,626776,Averbach; Sarah Helene,1,0,1,0
1713301367402,SIO 295LS,A00,523233,Staff,19,0,30,11
1713301368430,SIO 295S,A00,523232,Staff,19,0,30,11
1713301369462,SOCI 117,A01,494376,Staff,2,0,5,3
1713301370490,WES 237B,A00,494380,Staff,19,0,20,1
1713301372570,AESE 279B,A00,494370,Wade; Jon P,33,0,33,0
1713301373593,ANAR 135S,A00,494369,Braswell; Geoffrey E.,0,0,0,0
1713301374623,CAT 124RS,A01,519847,Geibel; William,18,0,20,2
1713301375646,CAT 125RS,A01,515971,Geibel; William,18,0,20,2
1713301376672,CLRE 250,A00,511389,Morris; Sheldon,9996,0,9999,3
1713301377697,CLRE 251,A00,507176,Mehta; Ravindra L.,9996,0,9999,3
1713301377697,CLRE 251,B00,511410,Mehta; Ravindra L.,9998,0,9999,1
1713301378723,CLRE 252,A00,507189,Cuomo; Raphael Eduardo,9998,0,9999,1
1713301379750,CLRE 253,A00,507199,Vaida; Florin,9997,0,9999,2
1713301379750,CLRE 253,B00,507202,Vaida; Florin,9999,0,9999,0
1713301380779,CLRE 259,A00,507211,Patel; Hemal,9996,0,9999,3
1713301381803,CLRE 260,A00,507221,Cuomo; Raphael Eduardo,9999,0,9999,0
1713301382832,CLRE 297,001,507242,Cuomo; Raphael Eduardo,9999,0,9999,0
1713301383857,CSE 191,A00,516875,Minnes Kemp; Mor Mia,9999,0,9999,0
1713301384883,CSS 201S,A01,494383,Staff,35,0,35,0
1713301385909,CSS 202S,A01,494387,Staff,35,0,35,0
1713301386932,EAP 100,A00,516065,Staff,9792,0,9999,207
1713301387957,ECE 45,A01,507414,Staff,56,0,60,4
1713301388981,ECE 100,A01,507416,Baghdadchi; Saharnaz,12,0,20,8
1713301388981,ECE 100,A02,507418,Baghdadchi; Saharnaz,20,0,20,0
1713301390005,ECE 111,A01,507420,Staff,42,0,50,8
1713301391031,ECE 197,001,548057,Sievenpiper; Daniel F.,9999,0,9999,0
1713301392061,EDS 115,A00,507243,Choi; Bailey Miyeon,28,0,28,0
1713301393087,EDS 117,A01,494379,Staff,25,0,25,0
1713301394168,EDS 125,A00,507246,Hopkins; Megan Beth,29,0,30,1
1713301395196,EDS 128A,A01,507264,Fargason; Sharon Gayle,26,0,26,0
1713301396221,EDS 128B,A01,507293,Pappas; Elizabeth,30,0,30,0
1713301397246,EDS 139,A00,507294,Fargason; Sharon Gayle,30,0,30,0
1713301397246,EDS 139,B00,507313,Pappas; Elizabeth,30,0,30,0
1713301398277,EDS 201,A00,507315,Staff,26,0,30,4
1713301399306,EDS 203,A01,507317,Halter; Christopher P.,26,0,30,4
1713301400335,EDS 204R,A01,507319,Halter; Christopher P.,6,0,30,24
1713301400335,EDS 204R,B01,507331,Heinzman; Erica M.,30,0,30,0
1713301401363,EDS 206R,A00,507332,Staff,8,0,30,22
1713301401363,EDS 206R,B00,507343,Staff,29,0,30,1
1713301402391,EDS 250,A00,507344,Hemans; Patricia Ann Benitez,36,0,40,4
1713301403416,EDS 281,A00,507345,Daly; Alan J.,18,0,18,0
1713301404439,EDS 284,A00,507350,Daly; Alan J.,16,0,16,0
1713301405463,EDS 286,A00,507359,Fine; Sarah,18,0,18,0
1713301406491,EDS 289C,A01,507361,Daly; Alan J.,18,0,18,0
1713301407516,EDS 290,A00,507366,Hofstetter; Carolyn,15,0,15,0
1713301408546,LIGM 5A,A00,507421,Fischer-Grunski; Eva K,20,0,20,0
1713301409576,LIGM 5B,A00,507423,Fischer-Grunski; Eva K,20,0,20,0
1713301410604,LIGM 5C,A00,507425,Fischer-Grunski; Eva K,20,0,20,0
1713301411635,LIIT 5AS,A00,507427,Carnelos; Chiara,20,0,20,0
1713301412661,LIIT 5BS,A00,507430,Carnelos; Chiara,20,0,20,0
1713301413691,LIIT 5CS,A00,507432,Carnelos; Chiara,20,0,20,0
1713301414717,LISP 5A,A00,507541,Munoz Sanchez; Alicia,19,0,20,1
1713301415741,LISP 5B,A00,507671,Munoz Sanchez; Alicia,17,0,20,3
1713301416767,LISP 5C,A00,507696,Munoz Sanchez; Alicia,18,0,20,2
1713301417793,MAE 197,001,528363,Boechler; Nicholas Sebastia,9999,0,9999,0
1713301418819,MATH 197,001,523477,Kedlaya; Kiran S.,9999,0,9999,0
1713301418819,MATH 197,002,563811,Zhang; Danna,9999,0,9999,0
1713301419844,MCWP 40R,A00,518780,Staff,20,0,20,0
1713301419844,MCWP 40R,B00,518781,Staff,20,0,20,0
1713301419844,MCWP 40R,C00,518783,Staff,20,0,20,0
1713301420870,MCWP 50R,A00,518791,Staff,20,0,20,0
1713301420870,MCWP 50R,B00,518792,Staff,20,0,20,0
1713301420870,MCWP 50R,C00,518793,Staff,20,0,20,0
1713301420870,MCWP 50R,D00,518794,Staff,19,0,20,1
1713301420870,MCWP 50R,E00,518795,Staff,19,0,20,1
1713301420870,MCWP 50R,F00,518796,Staff,20,0,20,0
1713301420870,MCWP 50R,G00,518797,Staff,19,0,20,1
1713301421897,MMW 12R,A01,514034,Herbst; Matthew,16,0,16,0
1713301421897,MMW 12R,A02,514035,Herbst; Matthew,16,0,16,0
1713301422922,MMW 13R,A01,514037,Staff,16,0,16,0
1713301422922,MMW 13R,A02,514039,Staff,16,0,16,0
1713301423948,RMED 296,001,626776,Averbach; Sarah Helene,1,0,1,0
1713301424973,SIO 295LS,A00,523233,Staff,19,0,30,11
1713301425999,SIO 295S,A00,523232,Staff,19,0,30,11
1713301427026,SOCI 117,A01,494376,Staff,2,0,5,3
1713301428054,WES 237B,A00,494380,Staff,19,0,20,1
1713301430130,AESE 279B,A00,494370,Wade; Jon P,33,0,33,0
1713301431155,ANAR 135S,A00,494369,Braswell; Geoffrey E.,0,0,0,0
1713301432220,CAT 124RS,A01,519847,Geibel; William,18,0,20,2
1713301433245,CAT 125RS,A01,515971,Geibel; William,18,0,20,2
1713301434270,CLRE 250,A00,511389,Morris; Sheldon,9996,0,9999,3
1713301435299,CLRE 251,A00,507176,Mehta; Ravindra L.,9996,0,9999,3
1713301435299,CLRE 251,B00,511410,Mehta; Ravindra L.,9998,0,9999,1
1713301436329,CLRE 252,A00,507189,Cuomo; Raphael Eduardo,9998,0,9999,1
1713301437354,CLRE 253,A00,507199,Vaida; Florin,9997,0,9999,2
1713301437354,CLRE 253,B00,507202,Vaida; Florin,9999,0,9999,0
1713301438380,CLRE 259,A00,507211,Patel; Hemal,9996,0,9999,3
1713301439409,CLRE 260,A00,507221,Cuomo; Raphael Eduardo,9999,0,9999,0
1713301440434,CLRE 297,001,507242,Cuomo; Raphael Eduardo,9999,0,9999,0
1713301441460,CSE 191,A00,516875,Minnes Kemp; Mor Mia,9999,0,9999,0
1713301442487,CSS 201S,A01,494383,Staff,35,0,35,0
1713301443516,CSS 202S,A01,494387,Staff,35,0,35,0
1713301444538,EAP 100,A00,516065,Staff,9792,0,9999,207
1713301445567,ECE 45,A01,507414,Staff,56,0,60,4
1713301446591,ECE 100,A01,507416,Baghdadchi; Saharnaz,12,0,20,8
1713301446591,ECE 100,A02,507418,Baghdadchi; Saharnaz,20,0,20,0
1713301447621,ECE 111,A01,507420,Staff,42,0,50,8
1713301448647,ECE 197,001,548057,Sievenpiper; Daniel F.,9999,0,9999,0
1713301449673,EDS 115,A00,507243,Choi; Bailey Miyeon,28,0,28,0
1713301450697,EDS 117,A01,494379,Staff,25,0,25,0
1713301451723,EDS 125,A00,507246,Hopkins; Megan Beth,29,0,30,1
1713301452752,EDS 128A,A01,507264,Fargason; Sharon Gayle,26,0,26,0
1713301453782,EDS 128B,A01,507293,Pappas; Elizabeth,30,0,30,0
1713301454810,EDS 139,A00,507294,Fargason; Sharon Gayle,30,0,30,0
1713301454810,EDS 139,B00,507313,Pappas; Elizabeth,30,0,30,0
1713301455835,EDS 201,A00,507315,Staff,26,0,30,4
1713301456860,EDS 203,A01,507317,Halter; Christopher P.,26,0,30,4
1713301457885,EDS 204R,A01,507319,Halter; Christopher P.,6,0,30,24
1713301457885,EDS 204R,B01,507331,Heinzman; Erica M.,30,0,30,0
1713301458913,EDS 206R,A00,507332,Staff,8,0,30,22
1713301458913,EDS 206R,B00,507343,Staff,29,0,30,1
1713301459942,EDS 250,A00,507344,Hemans; Patricia Ann Benitez,36,0,40,4
1713301460967,EDS 281,A00,507345,Daly; Alan J.,18,0,18,0
1713301461992,EDS 284,A00,507350,Daly; Alan J.,16,0,16,0
1713301463017,EDS 286,A00,507359,Fine; Sarah,18,0,18,0
1713301464043,EDS 289C,A01,507361,Daly; Alan J.,18,0,18,0
1713301465072,EDS 290,A00,507366,Hofstetter; Carolyn,15,0,15,0
1713301466100,LIGM 5A,A00,507421,Fischer-Grunski; Eva K,20,0,20,0
1713301467130,LIGM 5B,A00,507423,Fischer-Grunski; Eva K,20,0,20,0
1713301468159,LIGM 5C,A00,507425,Fischer-Grunski; Eva K,20,0,20,0
1713301469185,LIIT 5AS,A00,507427,Carnelos; Chiara,20,0,20,0
1713301470216,LIIT 5BS,A00,507430,Carnelos; Chiara,20,0,20,0
1713301471242,LIIT 5CS,A00,507432,Carnelos; Chiara,20,0,20,0
1713301472266,LISP 5A,A00,507541,Munoz Sanchez; Alicia,19,0,20,1
1713301473290,LISP 5B,A00,507671,Munoz Sanchez; Alicia,17,0,20,3
1713301474314,LISP 5C,A00,507696,Munoz Sanchez; Alicia,18,0,20,2
1713301475338,MAE 197,001,528363,Boechler; Nicholas Sebastia,9999,0,9999,0
1713301476362,MATH 197,001,523477,Kedlaya; Kiran S.,9999,0,9999,0
1713301476362,MATH 197,002,563811,Zhang; Danna,9999,0,9999,0
1713301477390,MCWP 40R,A00,518780,Staff,20,0,20,0
1713301477390,MCWP 40R,B00,518781,Staff,20,0,20,0
1713301477390,MCWP 40R,C00,518783,Staff,20,0,20,0
1713301478415,MCWP 50R,A00,518791,Staff,20,0,20,0
1713301478415,MCWP 50R,B00,518792,Staff,20,0,20,0
1713301478415,MCWP 50R,C00,518793,Staff,20,0,20,0
1713301478415,MCWP 50R,D00,518794,Staff,19,0,20,1
1713301478415,MCWP 50R,E00,518795,Staff,19,0,20,1
1713301478415,MCWP 50R,F00,518796,Staff,20,0,20,0
1713301478415,MCWP 50R,G00,518797,Staff,19,0,20,1
1713301479439,MMW 12R,A01,514034,Herbst; Matthew,16,0,16,0
1713301479439,MMW 12R,A02,514035,Herbst; Matthew,16,0,16,0
1713301480464,MMW 13R,A01,514037,Staff,16,0,16,0
1713301480464,MMW 13R,A02,514039,Staff,16,0,16,0
1713301481489,RMED 296,001,626776,Averbach; Sarah Helene,1,0,1,0
1713301482517,SIO 295LS,A00,523233,Staff,19,0,30,11
1713301483540,SIO 295S,A00,523232,Staff,19,0,30,11
1713301484566,SOCI 117,A01,494376,Staff,2,0,5,3
1713301485593,WES 237B,A00,494380,Staff,19,0,20,1
1713301487660,AESE 279B,A00,494370,Wade; Jon P,33,0,33,0
1713301488685,ANAR 135S,A00,494369,Braswell; Geoffrey E.,0,0,0,0
1713301489714,CAT 124RS,A01,519847,Geibel; William,18,0,20,2
1713301490743,CAT 125RS,A01,515971,Geibel; William,18,0,20,2
1713301491772,CLRE 250,A00,511389,Morris; Sheldon,9996,0,9999,3
1713301492803,CLRE 251,A00,507176,Mehta; Ravindra L.,9996,0,9999,3
1713301492803,CLRE 251,B00,511410,Mehta; Ravindra L.,9998,0,9999,1
1713301493829,CLRE 252,A00,507189,Cuomo; Raphael Eduardo,9998,0,9999,1
1713301494859,CLRE 253,A00,507199,Vaida; Florin,9997,0,9999,2
1713301494859,CLRE 253,B00,507202,Vaida; Florin,9999,0,9999,0
1713301495885,CLRE 259,A00,507211,Patel; Hemal,9996,0,9999,3
1713301496911,CLRE 260,A00,507221,Cuomo; Raphael Eduardo,9999,0,9999,0
1713301497996,CLRE 297,001,507242,Cuomo; Raphael Eduardo,9999,0,9999,0
1713301499028,CSE 191,A00,516875,Minnes Kemp; Mor Mia,9999,0,9999,0
1713301500060,CSS 201S,A01,494383,Staff,35,0,35,0
1713301501091,CSS 202S,A01,494387,Staff,35,0,35,0
1713301502115,EAP 100,A00,516065,Staff,9792,0,9999,207
1713301503139,ECE 45,A01,507414,Staff,56,0,60,4
1713301504164,ECE 100,A01,507416,Baghdadchi; Saharnaz,12,0,20,8
1713301504164,ECE 100,A02,507418,Baghdadchi; Saharnaz,20,0,20,0
1713301505188,ECE 111,A01,507420,Staff,42,0,50,8
1713301506212,ECE 197,001,548057,Sievenpiper; Daniel F.,9999,0,9999,0
1713301507244,EDS 115,A00,507243,Choi; Bailey Miyeon,28,0,28,0
1713301508273,EDS 117,A01,494379,Staff,25,0,25,0
1713301509298,EDS 125,A00,507246,Hopkins; Megan Beth,29,0,30,1
1713301510325,EDS 128A,A01,507264,Fargason; Sharon Gayle,26,0,26,0
1713301511351,EDS 128B,A01,507293,Pappas; Elizabeth,30,0,30,0
1713301512375,EDS 139,A00,507294,Fargason; Sharon Gayle,30,0,30,0
1713301512375,EDS 139,B00,507313,Pappas; Elizabeth,30,0,30,0
1713301513403,EDS 201,A00,507315,Staff,26,0,30,4
1713301514431,EDS 203,A01,507317,Halter; Christopher P.,26,0,30,4
1713301515456,EDS 204R,A01,507319,Halter; Christopher P.,6,0,30,24
1713301515456,EDS 204R,B01,507331,Heinzman; Erica M.,30,0,30,0
1713301516481,EDS 206R,A00,507332,Staff,8,0,30,22
1713301516481,EDS 206R,B00,507343,Staff,29,0,30,1
1713301517507,EDS 250,A00,507344,Hemans; Patricia Ann Benitez,36,0,40,4
1713301518531,EDS 281,A00,507345,Daly; Alan J.,18,0,18,0
1713301519566,EDS 284,A00,507350,Daly; Alan J.,16,0,16,0
1713301520589,EDS 286,A00,507359,Fine; Sarah,18,0,18,0
1713301521615,EDS 289C,A01,507361,Daly; Alan J.,18,0,18,0
1713301522644,EDS 290,A00,507366,Hofstetter; Carolyn,15,0,15,0
1713301523674,LIGM 5A,A00,507421,Fischer-Grunski; Eva K,20,0,20,0
1713301524702,LIGM 5B,A00,507423,Fischer-Grunski; Eva K,20,0,20,0
1713301525726,LIGM 5C,A00,507425,Fischer-Grunski; Eva K,20,0,20,0
1713301526757,LIIT 5AS,A00,507427,Carnelos; Chiara,20,0,20,0
1713301527797,LIIT 5BS,A00,507430,Carnelos; Chiara,20,0,20,0
1713301528826,LIIT 5CS,A00,507432,Carnelos; Chiara,20,0,20,0
1713301529857,LISP 5A,A00,507541,Munoz Sanchez; Alicia,19,0,20,1
1713301530887,LISP 5B,A00,507671,Munoz Sanchez; Alicia,17,0,20,3
1713301531919,LISP 5C,A00,507696,Munoz Sanchez; Alicia,18,0,20,2
1713301532948,MAE 197,001,528363,Boechler; Nicholas Sebastia,9999,0,9999,0
1713301533976,MATH 197,001,523477,Kedlaya; Kiran S.,9999,0,9999,0
1713301533976,MATH 197,002,563811,Zhang; Danna,9999,0,9999,0
1713301535006,MCWP 40R,A00,518780,Staff,20,0,20,0
1713301535006,MCWP 40R,B00,518781,Staff,20,0,20,0
1713301535006,MCWP 40R,C00,518783,Staff,20,0,20,0
1713301536031,MCWP 50R,A00,518791,Staff,20,0,20,0
1713301536031,MCWP 50R,B00,518792,Staff,20,0,20,0
1713301536031,MCWP 50R,C00,518793,Staff,20,0,20,0
1713301536031,MCWP 50R,D00,518794,Staff,19,0,20,1
1713301536031,MCWP 50R,E00,518795,Staff,19,0,20,1
1713301536031,MCWP 50R,F00,518796,Staff,20,0,20,0
1713301536031,MCWP 50R,G00,518797,Staff,19,0,20,1
1713301537062,MMW 12R,A01,514034,Herbst; Matthew,16,0,16,0
1713301537062,MMW 12R,A02,514035,Herbst; Matthew,16,0,16,0
1713301538091,MMW 13R,A01,514037,Staff,16,0,16,0
1713301538091,MMW 13R,A02,514039,Staff,16,0,16,0
1713301539125,RMED 296,001,626776,Averbach; Sarah Helene,1,0,1,0
1713301540155,SIO 295LS,A00,523233,Staff,19,0,30,11
1713301541183,SIO 295S,A00,523232,Staff,19,0,30,11
1713301542209,SOCI 117,A01,494376,Staff,2,0,5,3
1713301543234,WES 237B,A00,494380,Staff,19,0,20,1
1713301545307,AESE 279B,A00,494370,Wade; Jon P,33,0,33,0
1713301546334,ANAR 135S,A00,494369,Braswell; Geoffrey E.,0,0,0,0
1713301547365,CAT 124RS,A01,519847,Geibel; William,18,0,20,2
1713301548391,CAT 125RS,A01,515971,Geibel; William,18,0,20,2
1713301549420,CLRE 250,A00,511389,Morris; Sheldon,9996,0,9999,3
1713301550445,CLRE 251,A00,507176,Mehta; Ravindra L.,9996,0,9999,3
1713301550445,CLRE 251,B00,511410,Mehta; Ravindra L.,9998,0,9999,1
1713301551472,CLRE 252,A00,507189,Cuomo; Raphael Eduardo,9998,0,9999,1
1713301552496,CLRE 253,A00,507199,Vaida; Florin,9997,0,9999,2
1713301552496,CLRE 253,B00,507202,Vaida; Florin,9999,0,9999,0
1713301553521,CLRE 259,A00,507211,Patel; Hemal,9996,0,9999,3
1713301554546,CLRE 260,A00,507221,Cuomo; Raphael Eduardo,9999,0,9999,0
1713301555571,CLRE 297,001,507242,Cuomo; Raphael Eduardo,9999,0,9999,0
1713301556598,CSE 191,A00,516875,Minnes Kemp; Mor Mia,9999,0,9999,0
1713301557630,CSS 201S,A01,494383,Staff,35,0,35,0
1713301558659,CSS 202S,A01,494387,Staff,35,0,35,0
1713301559684,EAP 100,A00,516065,Staff,9792,0,9999,207
1713301560710,ECE 45,A01,507414,Staff,56,0,60,4
1713301561739,ECE 100,A01,507416,Baghdadchi; Saharnaz,12,0,20,8
1713301561739,ECE 100,A02,507418,Baghdadchi; Saharnaz,20,0,20,0
1713301562767,ECE 111,A01,507420,Staff,42,0,50,8
1713301563805,ECE 197,001,548057,Sievenpiper; Daniel F.,9999,0,9999,0
1713301564836,EDS 115,A00,507243,Choi; Bailey Miyeon,28,0,28,0
1713301565861,EDS 117,A01,494379,Staff,25,0,25,0
1713301566884,EDS 125,A00,507246,Hopkins; Megan Beth,29,0,30,1
1713301567915,EDS 128A,A01,507264,Fargason; Sharon Gayle,26,0,26,0
1713301568949,EDS 128B,A01,507293,Pappas; Elizabeth,30,0,30,0
1713301569977,EDS 139,A00,507294,Fargason; Sharon Gayle,30,0,30,0
1713301569977,EDS 139,B00,507313,Pappas; Elizabeth,30,0,30,0
1713301571003,EDS 201,A00,507315,Staff,26,0,30,4
1713301572031,EDS 203,A01,507317,Halter; Christopher P.,26,0,30,4
1713301573059,EDS 204R,A01,507319,Halter; Christopher P.,6,0,30,24
1713301573059,EDS 204R,B01,507331,Heinzman; Erica M.,30,0,30,0
1713301574087,EDS 206R,A00,507332,Staff,8,0,30,22
1713301574087,EDS 206R,B00,507343,Staff,29,0,30,1
1713301575111,EDS 250,A00,507344,Hemans; Patricia Ann Benitez,36,0,40,4
1713301576139,EDS 281,A00,507345,Daly; Alan J.,18,0,18,0
1713301577168,EDS 284,A00,507350,Daly; Alan J.,16,0,16,0
1713301578196,EDS 286,A00,507359,Fine; Sarah,18,0,18,0
1713301579223,EDS 289C,A01,507361,Daly; Alan J.,18,0,18,0
1713301580249,EDS 290,A00,507366,Hofstetter; Carolyn,15,0,15,0
1713301581279,LIGM 5A,A00,507421,Fischer-Grunski; Eva K,20,0,20,0
1713301582304,LIGM 5B,A00,507423,Fischer-Grunski; Eva K,20,0,20,0
1713301583329,LIGM 5C,A00,507425,Fischer-Grunski; Eva K,20,0,20,0
1713301584353,LIIT 5AS,A00,507427,Carnelos; Chiara,20,0,20,0
1713301585382,LIIT 5BS,A00,507430,Carnelos; Chiara,20,0,20,0
1713301586405,LIIT 5CS,A00,507432,Carnelos; Chiara,20,0,20,0
1713301587435,LISP 5A,A00,507541,Munoz Sanchez; Alicia,19,0,20,1
1713301588459,LISP 5B,A00,507671,Munoz Sanchez; Alicia,17,0,20,3
1713301589487,LISP 5C,A00,507696,Munoz Sanchez; Alicia,18,0,20,2
1713301590515,MAE 197,001,528363,Boechler; Nicholas Sebastia,9999,0,9999,0
1713301591541,MATH 197,001,523477,Kedlaya; Kiran S.,9999,0,9999,0
1713301591541,MATH 197,002,563811,Zhang; Danna,9999,0,9999,0
1713301592565,MCWP 40R,A00,518780,Staff,20,0,20,0
1713301592565,MCWP 40R,B00,518781,Staff,20,0,20,0
1713301592565,MCWP 40R,C00,518783,Staff,20,0,20,0
1713301593593,MCWP 50R,A00,518791,Staff,20,0,20,0
1713301593593,MCWP 50R,B00,518792,Staff,20,0,20,0
1713301593593,MCWP 50R,C00,518793,Staff,20,0,20,0
1713301593593,MCWP 50R,D00,518794,Staff,19,0,20,1
1713301593593,MCWP 50R,E00,518795,Staff,19,0,20,1
1713301593593,MCWP 50R,F00,518796,Staff,20,0,20,0
1713301593593,MCWP 50R,G00,518797,Staff,19,0,20,1
1713301594621,MMW 12R,A01,514034,Herbst; Matthew,16,0,16,0
1713301594621,MMW 12R,A02,514035,Herbst; Matthew,16,0,16,0
1713301595648,MMW 13R,A01,514037,Staff,16,0,16,0
1713301595648,MMW 13R,A02,514039,Staff,16,0,16,0
1713301596673,RMED 296,001,626776,Averbach; Sarah Helene,1,0,1,0
1713301597699,SIO 295LS,A00,523233,Staff,19,0,30,11
1713301598722,SIO 295S,A00,523232,Staff,19,0,30,11
1713301599745,SOCI 117,A01,494376,Staff,2,0,5,3
1713301600772,WES 237B,A00,494380,Staff,19,0,20,1
1713301602897,AESE 279B,A00,494370,Wade; Jon P,33,0,33,0
1713301603923,ANAR 135S,A00,494369,Braswell; Geoffrey E.,0,0,0,0
1713301604948,CAT 124RS,A01,519847,Geibel; William,18,0,20,2
1713301605972,CAT 125RS,A01,515971,Geibel; William,18,0,20,2
1713301606997,CLRE 250,A00,511389,Morris; Sheldon,9996,0,9999,3
1713301608028,CLRE 251,A00,507176,Mehta; Ravindra L.,9996,0,9999,3
1713301608028,CLRE 251,B00,511410,Mehta; Ravindra L.,9998,0,9999,1
1713301609056,CLRE 252,A00,507189,Cuomo; Raphael Eduardo,9998,0,9999,1
1713301610082,CLRE 253,A00,507199,Vaida; Florin,9997,0,9999,2
1713301610082,CLRE 253,B00,507202,Vaida; Florin,9999,0,9999,0
1713301611108,CLRE 259,A00,507211,Patel; Hemal,9996,0,9999,3
1713301612134,CLRE 260,A00,507221,Cuomo; Raphael Eduardo,9999,0,9999,0
1713301613158,CLRE 297,001,507242,Cuomo; Raphael Eduardo,9999,0,9999,0
1713301614184,CSE 191,A00,516875,Minnes Kemp; Mor Mia,9999,0,9999,0
1713301615209,CSS 201S,A01,494383,Staff,35,0,35,0
1713301616235,CSS 202S,A01,494387,Staff,35,0,35,0
1713301617259,EAP 100,A00,516065,Staff,9792,0,9999,207
1713301618284,ECE 45,A01,507414,Staff,56,0,60,4
1713301619310,ECE 100,A01,507416,Baghdadchi; Saharnaz,12,0,20,8
1713301619310,ECE 100,A02,507418,Baghdadchi; Saharnaz,20,0,20,0
1713301620340,ECE 111,A01,507420,Staff,42,0,50,8
1713301621372,ECE 197,001,548057,Sievenpiper; Daniel F.,9999,0,9999,0
1713301622402,EDS 115,A00,507243,Choi; Bailey Miyeon,28,0,28,0
1713301623432,EDS 117,A01,494379,Staff,25,0,25,0
1713301624461,EDS 125,A00,507246,Hopkins; Megan Beth,29,0,30,1
1713301625490,EDS 128A,A01,507264,Fargason; Sharon Gayle,26,0,26,0
1713301626518,EDS 128B,A01,507293,Pappas; Elizabeth,30,0,30,0
1713301627542,EDS 139,A00,507294,Fargason; Sharon Gayle,30,0,30,0
1713301627542,EDS 139,B00,507313,Pappas; Elizabeth,30,0,30,0
1713301628568,EDS 201,A00,507315,Staff,26,0,30,4
1713301629595,EDS 203,A01,507317,Halter; Christopher P.,26,0,30,4
1713301630624,EDS 204R,A01,507319,Halter; Christopher P.,6,0,30,24
1713301630624,EDS 204R,B01,507331,Heinzman; Erica M.,30,0,30,0
1713301631649,EDS 206R,A00,507332,Staff,8,0,30,22
1713301631649,EDS 206R,B00,507343,Staff,29,0,30,1
1713301632676,EDS 250,A00,507344,Hemans; Patricia Ann Benitez,36,0,40,4
1713301633704,EDS 281,A00,507345,Daly; Alan J.,18,0,18,0
1713301634730,EDS 284,A00,507350,Daly; Alan J.,16,0,16,0
1713301635755,EDS 286,A00,507359,Fine; Sarah,18,0,18,0
1713301636780,EDS 289C,A01,507361,Daly; Alan J.,18,0,18,0
1713301637807,EDS 290,A00,507366,Hofstetter; Carolyn,15,0,15,0
1713301638835,LIGM 5A,A00,507421,Fischer-Grunski; Eva K,20,0,20,0
1713301639863,LIGM 5B,A00,507423,Fischer-Grunski; Eva K,20,0,20,0
1713301640888,LIGM 5C,A00,507425,Fischer-Grunski; Eva K,20,0,20,0
1713301641917,LIIT 5AS,A00,507427,Carnelos; Chiara,20,0,20,0
1713301642947,LIIT 5BS,A00,507430,Carnelos; Chiara,20,0,20,0
1713301643974,LIIT 5CS,A00,507432,Carnelos; Chiara,20,0,20,0
1713301645001,LISP 5A,A00,507541,Munoz Sanchez; Alicia,19,0,20,1
1713301646028,LISP 5B,A00,507671,Munoz Sanchez; Alicia,17,0,20,3
1713301647051,LISP 5C,A00,507696,Munoz Sanchez; Alicia,18,0,20,2
1713301648081,MAE 197,001,528363,Boechler; Nicholas Sebastia,9999,0,9999,0
1713301649107,MATH 197,001,523477,Kedlaya; Kiran S.,9999,0,9999,0
1713301649107,MATH 197,002,563811,Zhang; Danna,9999,0,9999,0
1713301650131,MCWP 40R,A00,518780,Staff,20,0,20,0
1713301650131,MCWP 40R,B00,518781,Staff,20,0,20,0
1713301650131,MCWP 40R,C00,518783,Staff,20,0,20,0
1713301651160,MCWP 50R,A00,518791,Staff,20,0,20,0
1713301651160,MCWP 50R,B00,518792,Staff,20,0,20,0
1713301651160,MCWP 50R,C00,518793,Staff,20,0,20,0
1713301651160,MCWP 50R,D00,518794,Staff,19,0,20,1
1713301651160,MCWP 50R,E00,518795,Staff,19,0,20,1
1713301651160,MCWP 50R,F00,518796,Staff,20,0,20,0
1713301651160,MCWP 50R,G00,518797,Staff,19,0,20,1
1713301652184,MMW 12R,A01,514034,Herbst; Matthew,16,0,16,0
1713301652184,MMW 12R,A02,514035,Herbst; Matthew,16,0,16,0
1713301653209,MMW 13R,A01,514037,Staff,16,0,16,0
1713301653209,MMW 13R,A02,514039,Staff,16,0,16,0
1713301654287,RMED 296,001,626776,Averbach; Sarah Helene,1,0,1,0
1713301655315,SIO 295LS,A00,523233,Staff,19,0,30,11
1713301656341,SIO 295S,A00,523232,Staff,19,0,30,11
1713301657370,SOCI 117,A01,494376,Staff,2,0,5,3
1713301658399,WES 237B,A00,494380,Staff,19,0,20,1
1713301660460,AESE 279B,A00,494370,Wade; Jon P,33,0,33,0
1713301661485,ANAR 135S,A00,494369,Braswell; Geoffrey E.,0,0,0,0
1713301662513,CAT 124RS,A01,519847,Geibel; William,18,0,20,2
1713301663536,CAT 125RS,A01,515971,Geibel; William,18,0,20,2
1713301664565,CLRE 250,A00,511389,Morris; Sheldon,9996,0,9999,3
1713301665591,CLRE 251,A00,507176,Mehta; Ravindra L.,9996,0,9999,3
1713301665591,CLRE 251,B00,511410,Mehta; Ravindra L.,9998,0,9999,1
1713301666615,CLRE 252,A00,507189,Cuomo; Raphael Eduardo,9998,0,9999,1
1713301667639,CLRE 253,A00,507199,Vaida; Florin,9997,0,9999,2
1713301667639,CLRE 253,B00,507202,Vaida; Florin,9999,0,9999,0
1713301668669,CLRE 259,A00,507211,Patel; Hemal,9996,0,9999,3
1713301669693,CLRE 260,A00,507221,Cuomo; Raphael Eduardo,9999,0,9999,0
1713301670720,CLRE 297,001,507242,Cuomo; Raphael Eduardo,9999,0,9999,0
1713301671745,CSE 191,A00,516875,Minnes Kemp; Mor Mia,9999,0,9999,0
1713301672775,CSS 201S,A01,494383,Staff,35,0,35,0
1713301673799,CSS 202S,A01,494387,Staff,35,0,35,0
1713301674824,EAP 100,A00,516065,Staff,9792,0,9999,207
1713301675853,ECE 45,A01,507414,Staff,56,0,60,4
1713301676882,ECE 100,A01,507416,Baghdadchi; Saharnaz,12,0,20,8
1713301676882,ECE 100,A02,507418,Baghdadchi; Saharnaz,20,0,20,0
1713301677911,ECE 111,A01,507420,Staff,42,0,50,8
1713301678934,ECE 197,001,548057,Sievenpiper; Daniel F.,9999,0,9999,0
1713301679960,EDS 115,A00,507243,Choi; Bailey Miyeon,28,0,28,0
1713301680984,EDS 117,A01,494379,Staff,25,0,25,0
1713301682015,EDS 125,A00,507246,Hopkins; Megan Beth,29,0,30,1
1713301683040,EDS 128A,A01,507264,Fargason; Sharon Gayle,26,0,26,0
1713301684064,EDS 128B,A01,507293,Pappas; Elizabeth,30,0,30,0
1713301685097,EDS 139,A00,507294,Fargason; Sharon Gayle,30,0,30,0
1713301685097,EDS 139,B00,507313,Pappas; Elizabeth,30,0,30,0
1713301686123,EDS 201,A00,507315,Staff,26,0,30,4
1713301687176,EDS 203,A01,507317,Halter; Christopher P.,26,0,30,4
1713301688203,EDS 204R,A01,507319,Halter; Christopher P.,6,0,30,24
1713301688203,EDS 204R,B01,507331,Heinzman; Erica M.,30,0,30,0
1713301689233,EDS 206R,A00,507332,Staff,8,0,30,22
1713301689233,EDS 206R,B00,507343,Staff,29,0,30,1
1713301690261,EDS 250,A00,507344,Hemans; Patricia Ann Benitez,36,0,40,4
1713301691287,EDS 281,A00,507345,Daly; Alan J.,18,0,18,0
1713301692315,EDS 284,A00,507350,Daly; Alan J.,16,0,16,0
1713301693341,EDS 286,A00,507359,Fine; Sarah,18,0,18,0
1713301694367,EDS 289C,A01,507361,Daly; Alan J.,18,0,18,0
1713301695393,EDS 290,A00,507366,Hofstetter; Carolyn,15,0,15,0
1713301696419,LIGM 5A,A00,507421,Fischer-Grunski; Eva K,20,0,20,0
1713301697449,LIGM 5B,A00,507423,Fischer-Grunski; Eva K,20,0,20,0
1713301698475,LIGM 5C,A00,507425,Fischer-Grunski; Eva K,20,0,20,0
1713301699564,LIIT 5AS,A00,507427,Carnelos; Chiara,20,0,20,0
1713301700592,LIIT 5BS,A00,507430,Carnelos; Chiara,20,0,20,0
1713301701619,LIIT 5CS,A00,507432,Carnelos; Chiara,20,0,20,0
1713301702646,LISP 5A,A00,507541,Munoz Sanchez; Alicia,19,0,20,1
1713301703671,LISP 5B,A00,507671,Munoz Sanchez; Alicia,17,0,20,3
1713301704697,LISP 5C,A00,507696,Munoz Sanchez; Alicia,18,0,20,2
1713301705778,MAE 197,001,528363,Boechler; Nicholas Sebastia,9999,0,9999,0
1713301706804,MATH 197,001,523477,Kedlaya; Kiran S.,9999,0,9999,0
1713301706804,MATH 197,002,563811,Zhang; Danna,9999,0,9999,0
1713301707831,MCWP 40R,A00,518780,Staff,20,0,20,0
1713301707831,MCWP 40R,B00,518781,Staff,20,0,20,0
1713301707831,MCWP 40R,C00,518783,Staff,20,0,20,0
1713301708862,MCWP 50R,A00,518791,Staff,20,0,20,0
1713301708862,MCWP 50R,B00,518792,Staff,20,0,20,0
1713301708862,MCWP 50R,C00,518793,Staff,20,0,20,0
1713301708862,MCWP 50R,D00,518794,Staff,19,0,20,1
1713301708862,MCWP 50R,E00,518795,Staff,19,0,20,1
1713301708862,MCWP 50R,F00,518796,Staff,20,0,20,0
1713301708862,MCWP 50R,G00,518797,Staff,19,0,20,1
1713301709889,MMW 12R,A01,514034,Herbst; Matthew,16,0,16,0
1713301709889,MMW 12R,A02,514035,Herbst; Matthew,16,0,16,0
1713301710913,MMW 13R,A01,514037,Staff,16,0,16,0
1713301710913,MMW 13R,A02,514039,Staff,16,0,16,0
1713301711941,RMED 296,001,626776,Averbach; Sarah Helene,1,0,1,0
1713301712966,SIO 295LS,A00,523233,Staff,19,0,30,11
1713301713992,SIO 295S,A00,523232,Staff,19,0,30,11
1713301715017,SOCI 117,A01,494376,Staff,2,0,5,3
1713301716043,WES 237B,A00,494380,Staff,19,0,20,1
1713301718109,AESE 279B,A00,494370,Wade; Jon P,33,0,33,0
1713301719135,ANAR 135S,A00,494369,Braswell; Geoffrey E.,0,0,0,0
1713301720161,CAT 124RS,A01,519847,Geibel; William,18,0,20,2
1713301721189,CAT 125RS,A01,515971,Geibel; William,18,0,20,2
1713301722213,CLRE 250,A00,511389,Morris; Sheldon,9996,0,9999,3
1713301723243,CLRE 251,A00,507176,Mehta; Ravindra L.,9996,0,9999,3
1713301723243,CLRE 251,B00,511410,Mehta; Ravindra L.,9998,0,9999,1
1713301724272,CLRE 252,A00,507189,Cuomo; Raphael Eduardo,9998,0,9999,1
1713301725302,CLRE 253,A00,507199,Vaida; Florin,9997,0,9999,2
1713301725302,CLRE 253,B00,507202,Vaida; Florin,9999,0,9999,0
1713301726329,CLRE 259,A00,507211,Patel; Hemal,9996,0,9999,3
1713301727356,CLRE 260,A00,507221,Cuomo; Raphael Eduardo,9999,0,9999,0
1713301728382,CLRE 297,001,507242,Cuomo; Raphael Eduardo,9999,0,9999,0
1713301729407,CSE 191,A00,516875,Minnes Kemp; Mor Mia,9999,0,9999,0
1713301730438,CSS 201S,A01,494383,Staff,35,0,35,0
1713301731462,CSS 202S,A01,494387,Staff,35,0,35,0
1713301732485,EAP 100,A00,516065,Staff,9792,0,9999,207
1713301733510,ECE 45,A01,507414,Staff,56,0,60,4
1713301734539,ECE 100,A01,507416,Baghdadchi; Saharnaz,12,0,20,8
1713301734539,ECE 100,A02,507418,Baghdadchi; Saharnaz,20,0,20,0
1713301735567,ECE 111,A01,507420,Staff,42,0,50,8
1713301736596,ECE 197,001,548057,Sievenpiper; Daniel F.,9999,0,9999,0
1713301737621,EDS 115,A00,507243,Choi; Bailey Miyeon,28,0,28,0
1713301738645,EDS 117,A01,494379,Staff,25,0,25,0
1713301739671,EDS 125,A00,507246,Hopkins; Megan Beth,29,0,30,1
1713301740699,EDS 128A,A01,507264,Fargason; Sharon Gayle,26,0,26,0
1713301741728,EDS 128B,A01,507293,Pappas; Elizabeth,30,0,30,0
1713301742755,EDS 139,A00,507294,Fargason; Sharon Gayle,30,0,30,0
1713301742755,EDS 139,B00,507313,Pappas; Elizabeth,30,0,30,0
1713301743780,EDS 201,A00,507315,Staff,26,0,30,4
1713301744810,EDS 203,A01,507317,Halter; Christopher P.,26,0,30,4
1713301745834,EDS 204R,A01,507319,Halter; Christopher P.,6,0,30,24
1713301745834,EDS 204R,B01,507331,Heinzman; Erica M.,30,0,30,0
1713301746858,EDS 206R,A00,507332,Staff,8,0,30,22
1713301746858,EDS 206R,B00,507343,Staff,29,0,30,1
1713301747887,EDS 250,A00,507344,Hemans; Patricia Ann Benitez,36,0,40,4
1713301748915,EDS 281,A00,507345,Daly; Alan J.,18,0,18,0
1713301749943,EDS 284,A00,507350,Daly; Alan J.,16,0,16,0
1713301750968,EDS 286,A00,507359,Fine; Sarah,18,0,18,0
1713301752000,EDS 289C,A01,507361,Daly; Alan J.,18,0,18,0
1713301753029,EDS 290,A00,507366,Hofstetter; Carolyn,15,0,15,0
1713301754060,LIGM 5A,A00,507421,Fischer-Grunski; Eva K,20,0,20,0
1713301755090,LIGM 5B,A00,507423,Fischer-Grunski; Eva K,20,0,20,0
1713301756115,LIGM 5C,A00,507425,Fischer-Grunski; Eva K,20,0,20,0
1713301757141,LIIT 5AS,A00,507427,Carnelos; Chiara,20,0,20,0
1713301758165,LIIT 5BS,A00,507430,Carnelos; Chiara,20,0,20,0
1713301759194,LIIT 5CS,A00,507432,Carnelos; Chiara,20,0,20,0
1713301760224,LISP 5A,A00,507541,Munoz Sanchez; Alicia,19,0,20,1
1713301761248,LISP 5B,A00,507671,Munoz Sanchez; Alicia,17,0,20,3
1713301762278,LISP 5C,A00,507696,Munoz Sanchez; Alicia,18,0,20,2
1713301763303,MAE 197,001,528363,Boechler; Nicholas Sebastia,9999,0,9999,0
1713301764329,MATH 197,001,523477,Kedlaya; Kiran S.,9999,0,9999,0
1713301764329,MATH 197,002,563811,Zhang; Danna,9999,0,9999,0
1713301765357,MCWP 40R,A00,518780,Staff,20,0,20,0
1713301765357,MCWP 40R,B00,518781,Staff,20,0,20,0
1713301765357,MCWP 40R,C00,518783,Staff,20,0,20,0
1713301766383,MCWP 50R,A00,518791,Staff,20,0,20,0
1713301766383,MCWP 50R,B00,518792,Staff,20,0,20,0
1713301766383,MCWP 50R,C00,518793,Staff,20,0,20,0
1713301766383,MCWP 50R,D00,518794,Staff,19,0,20,1
1713301766383,MCWP 50R,E00,518795,Staff,19,0,20,1
1713301766383,MCWP 50R,F00,518796,Staff,20,0,20,0
1713301766383,MCWP 50R,G00,518797,Staff,19,0,20,1
1713301767409,MMW 12R,A01,514034,Herbst; Matthew,16,0,16,0
1713301767409,MMW 12R,A02,514035,Herbst; Matthew,16,0,16,0
1713301768437,MMW 13R,A01,514037,Staff,16,0,16,0
1713301768437,MMW 13R,A02,514039,Staff,16,0,16,0
1713301769464,RMED 296,001,626776,Averbach; Sarah Helene,1,0,1,0
1713301770489,SIO 295LS,A00,523233,Staff,19,0,30,11
1713301771518,SIO 295S,A00,523232,Staff,19,0,30,11
1713301772547,SOCI 117,A01,494376,Staff,2,0,5,3
1713301773572,WES 237B,A00,494380,Staff,19,0,20,1
1713301775649,AESE 279B,A00,494370,Wade; Jon P,33,0,33,0
1713301776677,ANAR 135S,A00,494369,Braswell; Geoffrey E.,0,0,0,0
1713301777702,CAT 124RS,A01,519847,Geibel; William,18,0,20,2
1713301778730,CAT 125RS,A01,515971,Geibel; William,18,0,20,2
1713301779755,CLRE 250,A00,511389,Morris; Sheldon,9996,0,9999,3
1713301780782,CLRE 251,A00,507176,Mehta; Ravindra L.,9996,0,9999,3
1713301780782,CLRE 251,B00,511410,Mehta; Ravindra L.,9998,0,9999,1
1713301781810,CLRE 252,A00,507189,Cuomo; Raphael Eduardo,9998,0,9999,1
1713301782836,CLRE 253,A00,507199,Vaida; Florin,9997,0,9999,2
1713301782836,CLRE 253,B00,507202,Vaida; Florin,9999,0,9999,0
1713301783866,CLRE 259,A00,507211,Patel; Hemal,9996,0,9999,3
1713301784890,CLRE 260,A00,507221,Cuomo; Raphael Eduardo,9999,0,9999,0
1713301785918,CLRE 297,001,507242,Cuomo; Raphael Eduardo,9999,0,9999,0
1713301786945,CSE 191,A00,516875,Minnes Kemp; Mor Mia,9999,0,9999,0
1713301787971,CSS 201S,A01,494383,Staff,35,0,35,0
1713301789000,CSS 202S,A01,494387,Staff,35,0,35,0
1713301790025,EAP 100,A00,516065,Staff,9792,0,9999,207
1713301791050,ECE 45,A01,507414,Staff,56,0,60,4
1713301792077,ECE 100,A01,507416,Baghdadchi; Saharnaz,12,0,20,8
1713301792077,ECE 100,A02,507418,Baghdadchi; Saharnaz,20,0,20,0
1713301793107,ECE 111,A01,507420,Staff,42,0,50,8
1713301794133,ECE 197,001,548057,Sievenpiper; Daniel F.,9999,0,9999,0
1713301795163,EDS 115,A00,507243,Choi; Bailey Miyeon,28,0,28,0
1713301796190,EDS 117,A01,494379,Staff,25,0,25,0
1713301797217,EDS 125,A00,507246,Hopkins; Megan Beth,29,0,30,1
1713301798247,EDS 128A,A01,507264,Fargason; Sharon Gayle,26,0,26,0
1713301799274,EDS 128B,A01,507293,Pappas; Elizabeth,30,0,30,0
1713301800303,EDS 139,A00,507294,Fargason; Sharon Gayle,30,0,30,0
1713301800303,EDS 139,B00,507313,Pappas; Elizabeth,30,0,30,0
1713301801331,EDS 201,A00,507315,Staff,26,0,30,4
1713301802357,EDS 203,A01,507317,Halter; Christopher P.,26,0,30,4
1713301803389,EDS 204R,A01,507319,Halter; Christopher P.,6,0,30,24
1713301803389,EDS 204R,B01,507331,Heinzman; Erica M.,30,0,30,0
1713301804413,EDS 206R,A00,507332,Staff,8,0,30,22
1713301804413,EDS 206R,B00,507343,Staff,29,0,30,1
1713301805439,EDS 250,A00,507344,Hemans; Patricia Ann Benitez,36,0,40,4
1713301806466,EDS 281,A00,507345,Daly; Alan J.,18,0,18,0
1713301807495,EDS 284,A00,507350,Daly; Alan J.,16,0,16,0
1713301808524,EDS 286,A00,507359,Fine; Sarah,18,0,18,0
1713301809619,EDS 289C,A01,507361,Daly; Alan J.,18,0,18,0
1713301810645,EDS 290,A00,507366,Hofstetter; Carolyn,15,0,15,0
1713301811670,LIGM 5A,A00,507421,Fischer-Grunski; Eva K,20,0,20,0
1713301812695,LIGM 5B,A00,507423,Fischer-Grunski; Eva K,20,0,20,0
1713301813719,LIGM 5C,A00,507425,Fischer-Grunski; Eva K,20,0,20,0
1713301814745,LIIT 5AS,A00,507427,Carnelos; Chiara,20,0,20,0
1713301815774,LIIT 5BS,A00,507430,Carnelos; Chiara,20,0,20,0
1713301816805,LIIT 5CS,A00,507432,Carnelos; Chiara,20,0,20,0
1713301817830,LISP 5A,A00,507541,Munoz Sanchez; Alicia,19,0,20,1
1713301818855,LISP 5B,A00,507671,Munoz Sanchez; Alicia,17,0,20,3
1713301819881,LISP 5C,A00,507696,Munoz Sanchez; Alicia,18,0,20,2
1713301820906,MAE 197,001,528363,Boechler; Nicholas Sebastia,9999,0,9999,0
1713301821932,MATH 197,001,523477,Kedlaya; Kiran S.,9999,0,9999,0
1713301821932,MATH 197,002,563811,Zhang; Danna,9999,0,9999,0
1713301822962,MCWP 40R,A00,518780,Staff,20,0,20,0
1713301822962,MCWP 40R,B00,518781,Staff,20,0,20,0
1713301822962,MCWP 40R,C00,518783,Staff,20,0,20,0
1713301823989,MCWP 50R,A00,518791,Staff,20,0,20,0
1713301823989,MCWP 50R,B00,518792,Staff,20,0,20,0
1713301823989,MCWP 50R,C00,518793,Staff,20,0,20,0
1713301823989,MCWP 50R,D00,518794,Staff,19,0,20,1
1713301823989,MCWP 50R,E00,518795,Staff,19,0,20,1
1713301823989,MCWP 50R,F00,518796,Staff,20,0,20,0
1713301823989,MCWP 50R,G00,518797,Staff,19,0,20,1
1713301825019,MMW 12R,A01,514034,Herbst; Matthew,16,0,16,0
1713301825019,MMW 12R,A02,514035,Herbst; Matthew,16,0,16,0
1713301826044,MMW 13R,A01,514037,Staff,16,0,16,0
1713301826044,MMW 13R,A02,514039,Staff,16,0,16,0
1713301827069,RMED 296,001,626776,Averbach; Sarah Helene,1,0,1,0
1713301828094,SIO 295LS,A00,523233,Staff,19,0,30,11
1713301829121,SIO 295S,A00,523232,Staff,19,0,30,11
1713301830150,SOCI 117,A01,494376,Staff,2,0,5,3
1713301831174,WES 237B,A00,494380,Staff,19,0,20,1
1713301833239,AESE 279B,A00,494370,Wade; Jon P,33,0,33,0
1713301834264,ANAR 135S,A00,494369,Braswell; Geoffrey E.,0,0,0,0
1713301835294,CAT 124RS,A01,519847,Geibel; William,18,0,20,2
1713301836318,CAT 125RS,A01,515971,Geibel; William,18,0,20,2
1713301837348,CLRE 250,A00,511389,Morris; Sheldon,9996,0,9999,3
1713301838375,CLRE 251,A00,507176,Mehta; Ravindra L.,9996,0,9999,3
1713301838375,CLRE 251,B00,511410,Mehta; Ravindra L.,9998,0,9999,1
1713301839400,CLRE 252,A00,507189,Cuomo; Raphael Eduardo,9998,0,9999,1
1713301840429,CLRE 253,A00,507199,Vaida; Florin,9997,0,9999,2
1713301840429,CLRE 253,B00,507202,Vaida; Florin,9999,0,9999,0
1713301841458,CLRE 259,A00,507211,Patel; Hemal,9996,0,9999,3
1713301842483,CLRE 260,A00,507221,Cuomo; Raphael Eduardo,9999,0,9999,0
1713301843508,CLRE 297,001,507242,Cuomo; Raphael Eduardo,9999,0,9999,0
1713301844534,CSE 191,A00,516875,Minnes Kemp; Mor Mia,9999,0,9999,0
1713301845559,CSS 201S,A01,494383,Staff,35,0,35,0
1713301846587,CSS 202S,A01,494387,Staff,35,0,35,0
1713301847613,EAP 100,A00,516065,Staff,9792,0,9999,207
1713301848637,ECE 45,A01,507414,Staff,56,0,60,4
1713301849660,ECE 100,A01,507416,Baghdadchi; Saharnaz,12,0,20,8
1713301849660,ECE 100,A02,507418,Baghdadchi; Saharnaz,20,0,20,0
1713301850685,ECE 111,A01,507420,Staff,42,0,50,8
1713301851711,ECE 197,001,548057,Sievenpiper; Daniel F.,9999,0,9999,0
1713301852741,EDS 115,A00,507243,Choi; Bailey Miyeon,28,0,28,0
1713301853767,EDS 117,A01,494379,Staff,25,0,25,0
1713301854798,EDS 125,A00,507246,Hopkins; Megan Beth,29,0,30,1
1713301855908,EDS 128A,A01,507264,Fargason; Sharon Gayle,26,0,26,0
1713301856939,EDS 128B,A01,507293,Pappas; Elizabeth,30,0,30,0
1713301857965,EDS 139,A00,507294,Fargason; Sharon Gayle,30,0,30,0
1713301857965,EDS 139,B00,507313,Pappas; Elizabeth,30,0,30,0
1713301858994,EDS 201,A00,507315,Staff,26,0,30,4
1713301860024,EDS 203,A01,507317,Halter; Christopher P.,26,0,30,4
1713301861050,EDS 204R,A01,507319,Halter; Christopher P.,6,0,30,24
1713301861050,EDS 204R,B01,507331,Heinzman; Erica M.,30,0,30,0
1713301862078,EDS 206R,A00,507332,Staff,8,0,30,22
1713301862078,EDS 206R,B00,507343,Staff,29,0,30,1
1713301863106,EDS 250,A00,507344,Hemans; Patricia Ann Benitez,36,0,40,4
1713301864132,EDS 281,A00,507345,Daly; Alan J.,18,0,18,0
1713301865160,EDS 284,A00,507350,Daly; Alan J.,16,0,16,0
1713301866183,EDS 286,A00,507359,Fine; Sarah,18,0,18,0
1713301867207,EDS 289C,A01,507361,Daly; Alan J.,18,0,18,0
1713301868235,EDS 290,A00,507366,Hofstetter; Carolyn,15,0,15,0
1713301869261,LIGM 5A,A00,507421,Fischer-Grunski; Eva K,20,0,20,0
1713301870299,LIGM 5B,A00,507423,Fischer-Grunski; Eva K,20,0,20,0
1713301871326,LIGM 5C,A00,507425,Fischer-Grunski; Eva K,20,0,20,0
1713301872350,LIIT 5AS,A00,507427,Carnelos; Chiara,20,0,20,0
1713301873375,LIIT 5BS,A00,507430,Carnelos; Chiara,20,0,20,0
1713301874405,LIIT 5CS,A00,507432,Carnelos; Chiara,20,0,20,0
1713301875433,LISP 5A,A00,507541,Munoz Sanchez; Alicia,19,0,20,1
1713301876464,LISP 5B,A00,507671,Munoz Sanchez; Alicia,17,0,20,3
1713301877495,LISP 5C,A00,507696,Munoz Sanchez; Alicia,18,0,20,2
1713301878519,MAE 197,001,528363,Boechler; Nicholas Sebastia,9999,0,9999,0
1713301879558,MATH 197,001,523477,Kedlaya; Kiran S.,9999,0,9999,0
1713301879558,MATH 197,002,563811,Zhang; Danna,9999,0,9999,0
1713301880587,MCWP 40R,A00,518780,Staff,20,0,20,0
1713301880587,MCWP 40R,B00,518781,Staff,20,0,20,0
1713301880587,MCWP 40R,C00,518783,Staff,20,0,20,0
1713301881613,MCWP 50R,A00,518791,Staff,20,0,20,0
1713301881613,MCWP 50R,B00,518792,Staff,20,0,20,0
1713301881613,MCWP 50R,C00,518793,Staff,20,0,20,0
1713301881613,MCWP 50R,D00,518794,Staff,19,0,20,1
1713301881613,MCWP 50R,E00,518795,Staff,19,0,20,1
1713301881613,MCWP 50R,F00,518796,Staff,20,0,20,0
1713301881613,MCWP 50R,G00,518797,Staff,19,0,20,1
1713301882640,MMW 12R,A01,514034,Herbst; Matthew,16,0,16,0
1713301882640,MMW 12R,A02,514035,Herbst; Matthew,16,0,16,0
1713301883665,MMW 13R,A01,514037,Staff,16,0,16,0
1713301883665,MMW 13R,A02,514039,Staff,16,0,16,0
1713301884690,RMED 296,001,626776,Averbach; Sarah Helene,1,0,1,0
1713301885714,SIO 295LS,A00,523233,Staff,19,0,30,11
1713301886739,SIO 295S,A00,523232,Staff,19,0,30,11
1713301887768,SOCI 117,A01,494376,Staff,2,0,5,3
1713301888793,WES 237B,A00,494380,Staff,19,0,20,1
1713301890876,AESE 279B,A00,494370,Wade; Jon P,33,0,33,0
1713301891902,ANAR 135S,A00,494369,Braswell; Geoffrey E.,0,0,0,0
1713301892927,CAT 124RS,A01,519847,Geibel; William,18,0,20,2
1713301893954,CAT 125RS,A01,515971,Geibel; William,18,0,20,2
1713301894985,CLRE 250,A00,511389,Morris; Sheldon,9996,0,9999,3
1713301896012,CLRE 251,A00,507176,Mehta; Ravindra L.,9996,0,9999,3
1713301896012,CLRE 251,B00,511410,Mehta; Ravindra L.,9998,0,9999,1
1713301897037,CLRE 252,A00,507189,Cuomo; Raphael Eduardo,9998,0,9999,1
1713301898065,CLRE 253,A00,507199,Vaida; Florin,9997,0,9999,2
1713301898065,CLRE 253,B00,507202,Vaida; Florin,9999,0,9999,0
1713301899091,CLRE 259,A00,507211,Patel; Hemal,9996,0,9999,3
1713301900117,CLRE 260,A00,507221,Cuomo; Raphael Eduardo,9999,0,9999,0
1713301901144,CLRE 297,001,507242,Cuomo; Raphael Eduardo,9999,0,9999,0
1713301902173,CSE 191,A00,516875,Minnes Kemp; Mor Mia,9999,0,9999,0
1713301903202,CSS 201S,A01,494383,Staff,35,0,35,0
1713301904230,CSS 202S,A01,494387,Staff,35,0,35,0
1713301905255,EAP 100,A00,516065,Staff,9792,0,9999,207
1713301906279,ECE 45,A01,507414,Staff,56,0,60,4
1713301907304,ECE 100,A01,507416,Baghdadchi; Saharnaz,12,0,20,8
1713301907304,ECE 100,A02,507418,Baghdadchi; Saharnaz,20,0,20,0
1713301908329,ECE 111,A01,507420,Staff,42,0,50,8
1713301909367,ECE 197,001,548057,Sievenpiper; Daniel F.,9999,0,9999,0
1713301910393,EDS 115,A00,507243,Choi; Bailey Miyeon,28,0,28,0
1713301911422,EDS 117,A01,494379,Staff,25,0,25,0
1713301912447,EDS 125,A00,507246,Hopkins; Megan Beth,29,0,30,1
1713301913535,EDS 128A,A01,507264,Fargason; Sharon Gayle,26,0,26,0
1713301914560,EDS 128B,A01,507293,Pappas; Elizabeth,30,0,30,0
1713301915585,EDS 139,A00,507294,Fargason; Sharon Gayle,30,0,30,0
1713301915585,EDS 139,B00,507313,Pappas; Elizabeth,30,0,30,0
1713301916615,EDS 201,A00,507315,Staff,26,0,30,4
1713301928166,EDS 203,A01,507317,Halter; Christopher P.,26,0,30,4
1713301929193,EDS 204R,A01,507319,Halter; Christopher P.,6,0,30,24
1713301929193,EDS 204R,B01,507331,Heinzman; Erica M.,30,0,30,0
1713301930223,EDS 206R,A00,507332,Staff,8,0,30,22
1713301930223,EDS 206R,B00,507343,Staff,29,0,30,1
1713301931254,EDS 250,A00,507344,Hemans; Patricia Ann Benitez,36,0,40,4
1713301932281,EDS 281,A00,507345,Daly; Alan J.,18,0,18,0
1713301933309,EDS 284,A00,507350,Daly; Alan J.,16,0,16,0
1713301934338,EDS 286,A00,507359,Fine; Sarah,18,0,18,0
1713301935361,EDS 289C,A01,507361,Daly; Alan J.,18,0,18,0
1713301936389,EDS 290,A00,507366,Hofstetter; Carolyn,15,0,15,0
1713301937416,LIGM 5A,A00,507421,Fischer-Grunski; Eva K,20,0,20,0
1713301938441,LIGM 5B,A00,507423,Fischer-Grunski; Eva K,20,0,20,0
1713301939467,LIGM 5C,A00,507425,Fischer-Grunski; Eva K,20,0,20,0
1713301940494,LIIT 5AS,A00,507427,Carnelos; Chiara,20,0,20,0
1713301941523,LIIT 5BS,A00,507430,Carnelos; Chiara,20,0,20,0
1713301942549,LIIT 5CS,A00,507432,Carnelos; Chiara,20,0,20,0
1713301943575,LISP 5A,A00,507541,Munoz Sanchez; Alicia,19,0,20,1
1713301944599,LISP 5B,A00,507671,Munoz Sanchez; Alicia,17,0,20,3
1713301945627,LISP 5C,A00,507696,Munoz Sanchez; Alicia,18,0,20,2
1713301946732,MAE 197,001,528363,Boechler; Nicholas Sebastia,9999,0,9999,0
1713301947764,MATH 197,001,523477,Kedlaya; Kiran S.,9999,0,9999,0
1713301947764,MATH 197,002,563811,Zhang; Danna,9999,0,9999,0
1713301948789,MCWP 40R,A00,518780,Staff,20,0,20,0
1713301948789,MCWP 40R,B00,518781,Staff,20,0,20,0
1713301948789,MCWP 40R,C00,518783,Staff,20,0,20,0
1713301949816,MCWP 50R,A00,518791,Staff,20,0,20,0
1713301949816,MCWP 50R,B00,518792,Staff,20,0,20,0
1713301949816,MCWP 50R,C00,518793,Staff,19,0,20,1
1713301949816,MCWP 50R,D00,518794,Staff,19,0,20,1
1713301949816,MCWP 50R,E00,518795,Staff,19,0,20,1
1713301949816,MCWP 50R,F00,518796,Staff,20,0,20,0
1713301949816,MCWP 50R,G00,518797,Staff,19,0,20,1
1713301950849,MMW 12R,A01,514034,Herbst; Matthew,16,0,16,0
1713301950849,MMW 12R,A02,514035,Herbst; Matthew,16,0,16,0
1713301951872,MMW 13R,A01,514037,Staff,16,0,16,0
1713301951872,MMW 13R,A02,514039,Staff,16,0,16,0
1713301952897,RMED 296,001,626776,Averbach; Sarah Helene,1,0,1,0
1713301953925,SIO 295LS,A00,523233,Staff,19,0,30,11
1713301954956,SIO 295S,A00,523232,Staff,19,0,30,11
1713301955980,SOCI 117,A01,494376,Staff,2,0,5,3
1713301957009,WES 237B,A00,494380,Staff,19,0,20,1
1713301959076,AESE 279B,A00,494370,Wade; Jon P,33,0,33,0
1713301960103,ANAR 135S,A00,494369,Braswell; Geoffrey E.,0,0,0,0
1713301961128,CAT 124RS,A01,519847,Geibel; William,18,0,20,2
1713301962151,CAT 125RS,A01,515971,Geibel; William,18,0,20,2
1713301963179,CLRE 250,A00,511389,Morris; Sheldon,9996,0,9999,3
1713301964204,CLRE 251,A00,507176,Mehta; Ravindra L.,9996,0,9999,3
1713301964204,CLRE 251,B00,511410,Mehta; Ravindra L.,9998,0,9999,1
1713301965228,CLRE 252,A00,507189,Cuomo; Raphael Eduardo,9998,0,9999,1
1713301966259,CLRE 253,A00,507199,Vaida; Florin,9997,0,9999,2
1713301966259,CLRE 253,B00,507202,Vaida; Florin,9999,0,9999,0
1713301967284,CLRE 259,A00,507211,Patel; Hemal,9996,0,9999,3
1713301968308,CLRE 260,A00,507221,Cuomo; Raphael Eduardo,9999,0,9999,0
1713301969332,CLRE 297,001,507242,Cuomo; Raphael Eduardo,9999,0,9999,0
1713301970358,CSE 191,A00,516875,Minnes Kemp; Mor Mia,9999,0,9999,0
1713301971385,CSS 201S,A01,494383,Staff,35,0,35,0
1713301972413,CSS 202S,A01,494387,Staff,35,0,35,0
1713301973441,EAP 100,A00,516065,Staff,9792,0,9999,207
1713301974465,ECE 45,A01,507414,Staff,56,0,60,4
1713301975494,ECE 100,A01,507416,Baghdadchi; Saharnaz,12,0,20,8
1713301975494,ECE 100,A02,507418,Baghdadchi; Saharnaz,20,0,20,0
1713301976521,ECE 111,A01,507420,Staff,42,0,50,8
1713301977550,ECE 197,001,548057,Sievenpiper; Daniel F.,9999,0,9999,0
1713301978577,EDS 115,A00,507243,Choi; Bailey Miyeon,28,0,28,0
1713301979606,EDS 117,A01,494379,Staff,25,0,25,0
1713301980636,EDS 125,A00,507246,Hopkins; Megan Beth,29,0,30,1
1713301981670,EDS 128A,A01,507264,Fargason; Sharon Gayle,26,0,26,0
1713301982696,EDS 128B,A01,507293,Pappas; Elizabeth,30,0,30,0
1713301983723,EDS 139,A00,507294,Fargason; Sharon Gayle,30,0,30,0
1713301983723,EDS 139,B00,507313,Pappas; Elizabeth,30,0,30,0
1713301984753,EDS 201,A00,507315,Staff,26,0,30,4
1713301985777,EDS 203,A01,507317,Halter; Christopher P.,26,0,30,4
1713301986803,EDS 204R,A01,507319,Halter; Christopher P.,6,0,30,24
1713301986803,EDS 204R,B01,507331,Heinzman; Erica M.,30,0,30,0
1713301987829,EDS 206R,A00,507332,Staff,8,0,30,22
1713301987829,EDS 206R,B00,507343,Staff,29,0,30,1
1713301988857,EDS 250,A00,507344,Hemans; Patricia Ann Benitez,36,0,40,4
1713301989882,EDS 281,A00,507345,Daly; Alan J.,18,0,18,0
1713301990904,EDS 284,A00,507350,Daly; Alan J.,16,0,16,0
1713301991928,EDS 286,A00,507359,Fine; Sarah,18,0,18,0
1713301992956,EDS 289C,A01,507361,Daly; Alan J.,18,0,18,0
1713301993983,EDS 290,A00,507366,Hofstetter; Carolyn,15,0,15,0
1713301995007,LIGM 5A,A00,507421,Fischer-Grunski; Eva K,20,0,20,0
1713301996033,LIGM 5B,A00,507423,Fischer-Grunski; Eva K,20,0,20,0
1713301997059,LIGM 5C,A00,507425,Fischer-Grunski; Eva K,20,0,20,0
1713301998092,LIIT 5AS,A00,507427,Carnelos; Chiara,20,0,20,0
1713301999118,LIIT 5BS,A00,507430,Carnelos; Chiara,20,0,20,0
1713302000143,LIIT 5CS,A00,507432,Carnelos; Chiara,20,0,20,0
1713302001168,LISP 5A,A00,507541,Munoz Sanchez; Alicia,19,0,20,1
1713302002198,LISP 5B,A00,507671,Munoz Sanchez; Alicia,17,0,20,3
1713302003224,LISP 5C,A00,507696,Munoz Sanchez; Alicia,18,0,20,2
1713302004247,MAE 197,001,528363,Boechler; Nicholas Sebastia,9999,0,9999,0
1713302005272,MATH 197,001,523477,Kedlaya; Kiran S.,9999,0,9999,0
1713302005272,MATH 197,002,563811,Zhang; Danna,9999,0,9999,0
1713302006302,MCWP 40R,A00,518780,Staff,20,0,20,0
1713302006302,MCWP 40R,B00,518781,Staff,20,0,20,0
1713302006302,MCWP 40R,C00,518783,Staff,20,0,20,0
1713302007332,MCWP 50R,A00,518791,Staff,20,0,20,0
1713302007332,MCWP 50R,B00,518792,Staff,20,0,20,0
1713302007332,MCWP 50R,C00,518793,Staff,19,0,20,1
1713302007332,MCWP 50R,D00,518794,Staff,19,0,20,1
1713302007332,MCWP 50R,E00,518795,Staff,19,0,20,1
1713302007332,MCWP 50R,F00,518796,Staff,20,0,20,0
1713302007332,MCWP 50R,G00,518797,Staff,19,0,20,1
1713302008357,MMW 12R,A01,514034,Herbst; Matthew,16,0,16,0
1713302008357,MMW 12R,A02,514035,Herbst; Matthew,16,0,16,0
1713302009387,MMW 13R,A01,514037,Staff,16,0,16,0
1713302009387,MMW 13R,A02,514039,Staff,16,0,16,0
1713302010410,RMED 296,001,626776,Averbach; Sarah Helene,1,0,1,0
1713302011439,SIO 295LS,A00,523233,Staff,19,0,30,11
1713302012469,SIO 295S,A00,523232,Staff,19,0,30,11
1713302013495,SOCI 117,A01,494376,Staff,2,0,5,3
1713302014522,WES 237B,A00,494380,Staff,19,0,20,1
1713302016586,AESE 279B,A00,494370,Wade; Jon P,33,0,33,0
1713302017612,ANAR 135S,A00,494369,Braswell; Geoffrey E.,0,0,0,0
1713302018639,CAT 124RS,A01,519847,Geibel; William,17,0,20,3
1713302019665,CAT 125RS,A01,515971,Geibel; William,17,0,20,3
1713302020696,CLRE 250,A00,511389,Morris; Sheldon,9996,0,9999,3
1713302021721,CLRE 251,A00,507176,Mehta; Ravindra L.,9996,0,9999,3
1713302021721,CLRE 251,B00,511410,Mehta; Ravindra L.,9998,0,9999,1
1713302022747,CLRE 252,A00,507189,Cuomo; Raphael Eduardo,9998,0,9999,1
1713302023775,CLRE 253,A00,507199,Vaida; Florin,9997,0,9999,2
1713302023775,CLRE 253,B00,507202,Vaida; Florin,9999,0,9999,0
1713302024800,CLRE 259,A00,507211,Patel; Hemal,9996,0,9999,3
1713302025829,CLRE 260,A00,507221,Cuomo; Raphael Eduardo,9999,0,9999,0
1713302026858,CLRE 297,001,507242,Cuomo; Raphael Eduardo,9999,0,9999,0
1713302027951,CSE 191,A00,516875,Minnes Kemp; Mor Mia,9999,0,9999,0
1713302028976,CSS 201S,A01,494383,Staff,35,0,35,0
1713302030002,CSS 202S,A01,494387,Staff,35,0,35,0
1713302031026,EAP 100,A00,516065,Staff,9792,0,9999,207
1713302032057,ECE 45,A01,507414,Staff,56,0,60,4
1713302033086,ECE 100,A01,507416,Baghdadchi; Saharnaz,12,0,20,8
1713302033086,ECE 100,A02,507418,Baghdadchi; Saharnaz,20,0,20,0
1713302034116,ECE 111,A01,507420,Staff,42,0,50,8
1713302035140,ECE 197,001,548057,Sievenpiper; Daniel F.,9999,0,9999,0
1713302036169,EDS 115,A00,507243,Choi; Bailey Miyeon,28,0,28,0
1713302037192,EDS 117,A01,494379,Staff,25,0,25,0
1713302038217,EDS 125,A00,507246,Hopkins; Megan Beth,29,0,30,1
1713302039241,EDS 128A,A01,507264,Fargason; Sharon Gayle,26,0,26,0
1713302040265,EDS 128B,A01,507293,Pappas; Elizabeth,30,0,30,0
1713302041292,EDS 139,A00,507294,Fargason; Sharon Gayle,30,0,30,0
1713302041292,EDS 139,B00,507313,Pappas; Elizabeth,30,0,30,0
1713302042320,EDS 201,A00,507315,Staff,26,0,30,4
1713302043350,EDS 203,A01,507317,Halter; Christopher P.,26,0,30,4
1713302044378,EDS 204R,A01,507319,Halter; Christopher P.,6,0,30,24
1713302044378,EDS 204R,B01,507331,Heinzman; Erica M.,30,0,30,0
1713302045403,EDS 206R,A00,507332,Staff,8,0,30,22
1713302045403,EDS 206R,B00,507343,Staff,29,0,30,1
1713302046437,EDS 250,A00,507344,Hemans; Patricia Ann Benitez,36,0,40,4
1713302047467,EDS 281,A00,507345,Daly; Alan J.,18,0,18,0
1713302048497,EDS 284,A00,507350,Daly; Alan J.,16,0,16,0
1713302049523,EDS 286,A00,507359,Fine; Sarah,18,0,18,0
1713302050553,EDS 289C,A01,507361,Daly; Alan J.,18,0,18,0
1713302051593,EDS 290,A00,507366,Hofstetter; Carolyn,15,0,15,0
1713302052622,LIGM 5A,A00,507421,Fischer-Grunski; Eva K,20,0,20,0
1713302053648,LIGM 5B,A00,507423,Fischer-Grunski; Eva K,20,0,20,0
1713302054680,LIGM 5C,A00,507425,Fischer-Grunski; Eva K,20,0,20,0
1713302055710,LIIT 5AS,A00,507427,Carnelos; Chiara,20,0,20,0
1713302056736,LIIT 5BS,A00,507430,Carnelos; Chiara,20,0,20,0
1713302057760,LIIT 5CS,A00,507432,Carnelos; Chiara,20,0,20,0
1713302058786,LISP 5A,A00,507541,Munoz Sanchez; Alicia,19,0,20,1
1713302059815,LISP 5B,A00,507671,Munoz Sanchez; Alicia,17,0,20,3
1713302060840,LISP 5C,A00,507696,Munoz Sanchez; Alicia,18,0,20,2
1713302061867,MAE 197,001,528363,Boechler; Nicholas Sebastia,9999,0,9999,0
1713302062895,MATH 197,001,523477,Kedlaya; Kiran S.,9999,0,9999,0
1713302062895,MATH 197,002,563811,Zhang; Danna,9999,0,9999,0
1713302063926,MCWP 40R,A00,518780,Staff,20,0,20,0
1713302063926,MCWP 40R,B00,518781,Staff,20,0,20,0
1713302063926,MCWP 40R,C00,518783,Staff,20,0,20,0
1713302064952,MCWP 50R,A00,518791,Staff,20,0,20,0
1713302064952,MCWP 50R,B00,518792,Staff,20,0,20,0
1713302064952,MCWP 50R,C00,518793,Staff,19,0,20,1
1713302064952,MCWP 50R,D00,518794,Staff,19,0,20,1
1713302064952,MCWP 50R,E00,518795,Staff,19,0,20,1
1713302064952,MCWP 50R,F00,518796,Staff,20,0,20,0
1713302064952,MCWP 50R,G00,518797,Staff,19,0,20,1
1713302065978,MMW 12R,A01,514034,Herbst; Matthew,16,0,16,0
1713302065978,MMW 12R,A02,514035,Herbst; Matthew,16,0,16,0
1713302067007,MMW 13R,A01,514037,Staff,16,0,16,0
1713302067007,MMW 13R,A02,514039,Staff,16,0,16,0
1713302068031,RMED 296,001,626776,Averbach; Sarah Helene,1,0,1,0
1713302069061,SIO 295LS,A00,523233,Staff,19,0,30,11
1713302070089,SIO 295S,A00,523232,Staff,19,0,30,11
1713302071118,SOCI 117,A01,494376,Staff,2,0,5,3
1713302072150,WES 237B,A00,494380,Staff,19,0,20,1
1713302074229,AESE 279B,A00,494370,Wade; Jon P,33,0,33,0
1713302075254,ANAR 135S,A00,494369,Braswell; Geoffrey E.,0,0,0,0
1713302076286,CAT 124RS,A01,519847,Geibel; William,17,0,20,3
1713302077314,CAT 125RS,A01,515971,Geibel; William,17,0,20,3
1713302078339,CLRE 250,A00,511389,Morris; Sheldon,9996,0,9999,3
1713302079363,CLRE 251,A00,507176,Mehta; Ravindra L.,9996,0,9999,3
1713302079363,CLRE 251,B00,511410,Mehta; Ravindra L.,9998,0,9999,1
1713302080392,CLRE 252,A00,507189,Cuomo; Raphael Eduardo,9998,0,9999,1
1713302081417,CLRE 253,A00,507199,Vaida; Florin,9997,0,9999,2
1713302081417,CLRE 253,B00,507202,Vaida; Florin,9999,0,9999,0
1713302082443,CLRE 259,A00,507211,Patel; Hemal,9996,0,9999,3
1713302083468,CLRE 260,A00,507221,Cuomo; Raphael Eduardo,9999,0,9999,0
1713302084497,CLRE 297,001,507242,Cuomo; Raphael Eduardo,9999,0,9999,0
1713302085520,CSE 191,A00,516875,Minnes Kemp; Mor Mia,9999,0,9999,0
1713302086547,CSS 201S,A01,494383,Staff,35,0,35,0
1713302087571,CSS 202S,A01,494387,Staff,35,0,35,0
1713302088596,EAP 100,A00,516065,Staff,9792,0,9999,207
1713302089625,ECE 45,A01,507414,Staff,56,0,60,4
1713302090655,ECE 100,A01,507416,Baghdadchi; Saharnaz,12,0,20,8
1713302090655,ECE 100,A02,507418,Baghdadchi; Saharnaz,20,0,20,0
1713302091678,ECE 111,A01,507420,Staff,42,0,50,8
1713302092704,ECE 197,001,548057,Sievenpiper; Daniel F.,9999,0,9999,0
1713302093732,EDS 115,A00,507243,Choi; Bailey Miyeon,28,0,28,0
1713302094757,EDS 117,A01,494379,Staff,25,0,25,0
1713302095788,EDS 125,A00,507246,Hopkins; Megan Beth,29,0,30,1
1713302096814,EDS 128A,A01,507264,Fargason; Sharon Gayle,26,0,26,0
1713302097844,EDS 128B,A01,507293,Pappas; Elizabeth,30,0,30,0
1713302098869,EDS 139,A00,507294,Fargason; Sharon Gayle,30,0,30,0
1713302098869,EDS 139,B00,507313,Pappas; Elizabeth,30,0,30,0
1713302099897,EDS 201,A00,507315,Staff,26,0,30,4
1713302100923,EDS 203,A01,507317,Halter; Christopher P.,26,0,30,4
1713302101950,EDS 204R,A01,507319,Halter; Christopher P.,6,0,30,24
1713302101950,EDS 204R,B01,507331,Heinzman; Erica M.,30,0,30,0
1713302102975,EDS 206R,A00,507332,Staff,8,0,30,22
1713302102975,EDS 206R,B00,507343,Staff,29,0,30,1
1713302104000,EDS 250,A00,507344,Hemans; Patricia Ann Benitez,36,0,40,4
1713302105027,EDS 281,A00,507345,Daly; Alan J.,18,0,18,0
1713302106052,EDS 284,A00,507350,Daly; Alan J.,16,0,16,0
1713302107080,EDS 286,A00,507359,Fine; Sarah,18,0,18,0
1713302108108,EDS 289C,A01,507361,Daly; Alan J.,18,0,18,0
1713302109134,EDS 290,A00,507366,Hofstetter; Carolyn,15,0,15,0
1713302110165,LIGM 5A,A00,507421,Fischer-Grunski; Eva K,20,0,20,0
1713302111195,LIGM 5B,A00,507423,Fischer-Grunski; Eva K,20,0,20,0
1713302112219,LIGM 5C,A00,507425,Fischer-Grunski; Eva K,20,0,20,0
1713302113243,LIIT 5AS,A00,507427,Carnelos; Chiara,20,0,20,0
1713302114270,LIIT 5BS,A00,507430,Carnelos; Chiara,20,0,20,0
1713302115307,LIIT 5CS,A00,507432,Carnelos; Chiara,20,0,20,0
1713302116337,LISP 5A,A00,507541,Munoz Sanchez; Alicia,19,0,20,1
1713302117364,LISP 5B,A00,507671,Munoz Sanchez; Alicia,17,0,20,3
1713302118390,LISP 5C,A00,507696,Munoz Sanchez; Alicia,18,0,20,2
1713302119415,MAE 197,001,528363,Boechler; Nicholas Sebastia,9999,0,9999,0
1713302120446,MATH 197,001,523477,Kedlaya; Kiran S.,9999,0,9999,0
1713302120446,MATH 197,002,563811,Zhang; Danna,9999,0,9999,0
1713302121483,MCWP 40R,A00,518780,Staff,20,0,20,0
1713302121483,MCWP 40R,B00,518781,Staff,20,0,20,0
1713302121483,MCWP 40R,C00,518783,Staff,20,0,20,0
1713302122507,MCWP 50R,A00,518791,Staff,20,0,20,0
1713302122507,MCWP 50R,B00,518792,Staff,20,0,20,0
1713302122507,MCWP 50R,C00,518793,Staff,19,0,20,1
1713302122507,MCWP 50R,D00,518794,Staff,19,0,20,1
1713302122507,MCWP 50R,E00,518795,Staff,19,0,20,1
1713302122507,MCWP 50R,F00,518796,Staff,20,0,20,0
1713302122507,MCWP 50R,G00,518797,Staff,19,0,20,1
1713302123532,MMW 12R,A01,514034,Herbst; Matthew,16,0,16,0
1713302123532,MMW 12R,A02,514035,Herbst; Matthew,16,0,16,0
1713302124558,MMW 13R,A01,514037,Staff,16,0,16,0
1713302124558,MMW 13R,A02,514039,Staff,16,0,16,0
1713302125584,RMED 296,001,626776,Averbach; Sarah Helene,1,0,1,0
1713302126608,SIO 295LS,A00,523233,Staff,19,0,30,11
1713302127632,SIO 295S,A00,523232,Staff,19,0,30,11
1713302128656,SOCI 117,A01,494376,Staff,2,0,5,3
1713302129682,WES 237B,A00,494380,Staff,19,0,20,1
1713302131809,AESE 279B,A00,494370,Wade; Jon P,33,0,33,0
1713302132834,ANAR 135S,A00,494369,Braswell; Geoffrey E.,0,0,0,0
1713302133859,CAT 124RS,A01,519847,Geibel; William,17,0,20,3
1713302134884,CAT 125RS,A01,515971,Geibel; William,17,0,20,3
1713302135911,CLRE 250,A00,511389,Morris; Sheldon,9996,0,9999,3
1713302136935,CLRE 251,A00,507176,Mehta; Ravindra L.,9996,0,9999,3
1713302136935,CLRE 251,B00,511410,Mehta; Ravindra L.,9998,0,9999,1
1713302138073,CLRE 252,A00,507189,Cuomo; Raphael Eduardo,9998,0,9999,1
1713302139098,CLRE 253,A00,507199,Vaida; Florin,9997,0,9999,2
1713302139098,CLRE 253,B00,507202,Vaida; Florin,9999,0,9999,0
1713302140124,CLRE 259,A00,507211,Patel; Hemal,9996,0,9999,3
1713302141150,CLRE 260,A00,507221,Cuomo; Raphael Eduardo,9999,0,9999,0
1713302142174,CLRE 297,001,507242,Cuomo; Raphael Eduardo,9999,0,9999,0
1713302143200,CSE 191,A00,516875,Minnes Kemp; Mor Mia,9999,0,9999,0
1713302144231,CSS 201S,A01,494383,Staff,35,0,35,0
1713302145257,CSS 202S,A01,494387,Staff,35,0,35,0
1713302146280,EAP 100,A00,516065,Staff,9792,0,9999,207
1713302147306,ECE 45,A01,507414,Staff,56,0,60,4
1713302148333,ECE 100,A01,507416,Baghdadchi; Saharnaz,12,0,20,8
1713302148333,ECE 100,A02,507418,Baghdadchi; Saharnaz,20,0,20,0
1713302149358,ECE 111,A01,507420,Staff,42,0,50,8
1713302150384,ECE 197,001,548057,Sievenpiper; Daniel F.,9999,0,9999,0
1713302151413,EDS 115,A00,507243,Choi; Bailey Miyeon,28,0,28,0
1713302152441,EDS 117,A01,494379,Staff,25,0,25,0
1713302153468,EDS 125,A00,507246,Hopkins; Megan Beth,29,0,30,1
1713302154496,EDS 128A,A01,507264,Fargason; Sharon Gayle,26,0,26,0
1713302155523,EDS 128B,A01,507293,Pappas; Elizabeth,30,0,30,0
1713302156553,EDS 139,A00,507294,Fargason; Sharon Gayle,30,0,30,0
1713302156553,EDS 139,B00,507313,Pappas; Elizabeth,30,0,30,0
1713302157579,EDS 201,A00,507315,Staff,26,0,30,4
1713302158605,EDS 203,A01,507317,Halter; Christopher P.,26,0,30,4
1713302159630,EDS 204R,A01,507319,Halter; Christopher P.,6,0,30,24
1713302159630,EDS 204R,B01,507331,Heinzman; Erica M.,30,0,30,0
1713302160654,EDS 206R,A00,507332,Staff,8,0,30,22
1713302160654,EDS 206R,B00,507343,Staff,29,0,30,1
1713302161691,EDS 250,A00,507344,Hemans; Patricia Ann Benitez,36,0,40,4
1713302162717,EDS 281,A00,507345,Daly; Alan J.,18,0,18,0
1713302163745,EDS 284,A00,507350,Daly; Alan J.,16,0,16,0
1713302164774,EDS 286,A00,507359,Fine; Sarah,18,0,18,0
1713302165803,EDS 289C,A01,507361,Daly; Alan J.,18,0,18,0
1713302166830,EDS 290,A00,507366,Hofstetter; Carolyn,15,0,15,0
1713302167860,LIGM 5A,A00,507421,Fischer-Grunski; Eva K,20,0,20,0
1713302168890,LIGM 5B,A00,507423,Fischer-Grunski; Eva K,20,0,20,0
1713302169916,LIGM 5C,A00,507425,Fischer-Grunski; Eva K,20,0,20,0
1713302170944,LIIT 5AS,A00,507427,Carnelos; Chiara,20,0,20,0
1713302171967,LIIT 5BS,A00,507430,Carnelos; Chiara,20,0,20,0
1713302172993,LIIT 5CS,A00,507432,Carnelos; Chiara,20,0,20,0
1713302174023,LISP 5A,A00,507541,Munoz Sanchez; Alicia,19,0,20,1
1713302175048,LISP 5B,A00,507671,Munoz Sanchez; Alicia,17,0,20,3
1713302176076,LISP 5C,A00,507696,Munoz Sanchez; Alicia,18,0,20,2
1713302177101,MAE 197,001,528363,Boechler; Nicholas Sebastia,9999,0,9999,0
1713302178132,MATH 197,001,523477,Kedlaya; Kiran S.,9999,0,9999,0
1713302178132,MATH 197,002,563811,Zhang; Danna,9999,0,9999,0
1713302179163,MCWP 40R,A00,518780,Staff,20,0,20,0
1713302179163,MCWP 40R,B00,518781,Staff,20,0,20,0
1713302179163,MCWP 40R,C00,518783,Staff,20,0,20,0
1713302180194,MCWP 50R,A00,518791,Staff,20,0,20,0
1713302180194,MCWP 50R,B00,518792,Staff,20,0,20,0
1713302180194,MCWP 50R,C00,518793,Staff,19,0,20,1
1713302180194,MCWP 50R,D00,518794,Staff,19,0,20,1
1713302180194,MCWP 50R,E00,518795,Staff,19,0,20,1
1713302180194,MCWP 50R,F00,518796,Staff,20,0,20,0
1713302180194,MCWP 50R,G00,518797,Staff,19,0,20,1
1713302181350,MMW 12R,A01,514034,Herbst; Matthew,16,0,16,0
1713302181350,MMW 12R,A02,514035,Herbst; Matthew,16,0,16,0
1713302182374,MMW 13R,A01,514037,Staff,16,0,16,0
1713302182374,MMW 13R,A02,514039,Staff,16,0,16,0
1713302183398,RMED 296,001,626776,Averbach; Sarah Helene,1,0,1,0
1713302184424,SIO 295LS,A00,523233,Staff,19,0,30,11
1713302185449,SIO 295S,A00,523232,Staff,19,0,30,11
1713302186493,SOCI 117,A01,494376,Staff,2,0,5,3
1713302187520,WES 237B,A00,494380,Staff,19,0,20,1
1713302189589,AESE 279B,A00,494370,Wade; Jon P,33,0,33,0
1713302190615,ANAR 135S,A00,494369,Braswell; Geoffrey E.,0,0,0,0
1713302191638,CAT 124RS,A01,519847,Geibel; William,17,0,20,3
1713302192666,CAT 125RS,A01,515971,Geibel; William,17,0,20,3
1713302193693,CLRE 250,A00,511389,Morris; Sheldon,9996,0,9999,3
1713302194724,CLRE 251,A00,507176,Mehta; Ravindra L.,9996,0,9999,3
1713302194724,CLRE 251,B00,511410,Mehta; Ravindra L.,9998,0,9999,1
1713302195755,CLRE 252,A00,507189,Cuomo; Raphael Eduardo,9998,0,9999,1
1713302196779,CLRE 253,A00,507199,Vaida; Florin,9997,0,9999,2
1713302196779,CLRE 253,B00,507202,Vaida; Florin,9999,0,9999,0
1713302197809,CLRE 259,A00,507211,Patel; Hemal,9996,0,9999,3
1713302198837,CLRE 260,A00,507221,Cuomo; Raphael Eduardo,9999,0,9999,0
1713302199867,CLRE 297,001,507242,Cuomo; Raphael Eduardo,9999,0,9999,0
1713302200895,CSE 191,A00,516875,Minnes Kemp; Mor Mia,9999,0,9999,0
1713302201921,CSS 201S,A01,494383,Staff,35,0,35,0
1713302202947,CSS 202S,A01,494387,Staff,35,0,35,0
1713302203971,EAP 100,A00,516065,Staff,9792,0,9999,207
1713302204996,ECE 45,A01,507414,Staff,56,0,60,4
1713302206025,ECE 100,A01,507416,Baghdadchi; Saharnaz,12,0,20,8
1713302206025,ECE 100,A02,507418,Baghdadchi; Saharnaz,20,0,20,0
1713302207054,ECE 111,A01,507420,Staff,42,0,50,8
1713302208080,ECE 197,001,548057,Sievenpiper; Daniel F.,9999,0,9999,0
1713302209107,EDS 115,A00,507243,Choi; Bailey Miyeon,28,0,28,0
1713302210135,EDS 117,A01,494379,Staff,25,0,25,0
1713302211161,EDS 125,A00,507246,Hopkins; Megan Beth,29,0,30,1
1713302212190,EDS 128A,A01,507264,Fargason; Sharon Gayle,26,0,26,0
1713302213216,EDS 128B,A01,507293,Pappas; Elizabeth,30,0,30,0
1713302214241,EDS 139,A00,507294,Fargason; Sharon Gayle,30,0,30,0
1713302214241,EDS 139,B00,507313,Pappas; Elizabeth,30,0,30,0
1713302215268,EDS 201,A00,507315,Staff,26,0,30,4
1713302216295,EDS 203,A01,507317,Halter; Christopher P.,26,0,30,4
1713302217323,EDS 204R,A01,507319,Halter; Christopher P.,6,0,30,24
1713302217323,EDS 204R,B01,507331,Heinzman; Erica M.,30,0,30,0
1713302218349,EDS 206R,A00,507332,Staff,8,0,30,22
1713302218349,EDS 206R,B00,507343,Staff,29,0,30,1
1713302219375,EDS 250,A00,507344,Hemans; Patricia Ann Benitez,36,0,40,4
1713302220404,EDS 281,A00,507345,Daly; Alan J.,18,0,18,0
1713302221430,EDS 284,A00,507350,Daly; Alan J.,16,0,16,0
1713302222463,EDS 286,A00,507359,Fine; Sarah,18,0,18,0
1713302223491,EDS 289C,A01,507361,Daly; Alan J.,18,0,18,0
1713302224517,EDS 290,A00,507366,Hofstetter; Carolyn,15,0,15,0
1713302225543,LIGM 5A,A00,507421,Fischer-Grunski; Eva K,20,0,20,0
1713302226567,LIGM 5B,A00,507423,Fischer-Grunski; Eva K,20,0,20,0
1713302227592,LIGM 5C,A00,507425,Fischer-Grunski; Eva K,20,0,20,0
1713302228622,LIIT 5AS,A00,507427,Carnelos; Chiara,20,0,20,0
1713302229653,LIIT 5BS,A00,507430,Carnelos; Chiara,20,0,20,0
1713302230679,LIIT 5CS,A00,507432,Carnelos; Chiara,20,0,20,0
1713302231709,LISP 5A,A00,507541,Munoz Sanchez; Alicia,19,0,20,1
1713302232733,LISP 5B,A00,507671,Munoz Sanchez; Alicia,17,0,20,3
1713302233760,LISP 5C,A00,507696,Munoz Sanchez; Alicia,18,0,20,2
1713302234786,MAE 197,001,528363,Boechler; Nicholas Sebastia,9999,0,9999,0
1713302235886,MATH 197,001,523477,Kedlaya; Kiran S.,9999,0,9999,0
1713302235886,MATH 197,002,563811,Zhang; Danna,9999,0,9999,0
1713302236912,MCWP 40R,A00,518780,Staff,20,0,20,0
1713302236912,MCWP 40R,B00,518781,Staff,20,0,20,0
1713302236912,MCWP 40R,C00,518783,Staff,20,0,20,0
1713302237942,MCWP 50R,A00,518791,Staff,20,0,20,0
1713302237942,MCWP 50R,B00,518792,Staff,20,0,20,0
1713302237942,MCWP 50R,C00,518793,Staff,19,0,20,1
1713302237942,MCWP 50R,D00,518794,Staff,19,0,20,1
1713302237942,MCWP 50R,E00,518795,Staff,19,0,20,1
1713302237942,MCWP 50R,F00,518796,Staff,20,0,20,0
1713302237942,MCWP 50R,G00,518797,Staff,19,0,20,1
1713302238967,MMW 12R,A01,514034,Herbst; Matthew,16,0,16,0
1713302238967,MMW 12R,A02,514035,Herbst; Matthew,16,0,16,0
1713302239992,MMW 13R,A01,514037,Staff,16,0,16,0
1713302239992,MMW 13R,A02,514039,Staff,16,0,16,0
1713302241021,RMED 296,001,626776,Averbach; Sarah Helene,1,0,1,0
1713302242046,SIO 295LS,A00,523233,Staff,19,0,30,11
1713302243070,SIO 295S,A00,523232,Staff,19,0,30,11
1713302244095,SOCI 117,A01,494376,Staff,2,0,5,3
1713302245121,WES 237B,A00,494380,Staff,19,0,20,1
1713302247187,AESE 279B,A00,494370,Wade; Jon P,33,0,33,0
1713302248216,ANAR 135S,A00,494369,Braswell; Geoffrey E.,0,0,0,0
1713302249242,CAT 124RS,A01,519847,Geibel; William,17,0,20,3
1713302250275,CAT 125RS,A01,515971,Geibel; William,17,0,20,3
1713302251303,CLRE 250,A00,511389,Morris; Sheldon,9996,0,9999,3
1713302252329,CLRE 251,A00,507176,Mehta; Ravindra L.,9996,0,9999,3
1713302252329,CLRE 251,B00,511410,Mehta; Ravindra L.,9998,0,9999,1
1713302253354,CLRE 252,A00,507189,Cuomo; Raphael Eduardo,9998,0,9999,1
1713302254380,CLRE 253,A00,507199,Vaida; Florin,9997,0,9999,2
1713302254380,CLRE 253,B00,507202,Vaida; Florin,9999,0,9999,0
1713302255405,CLRE 259,A00,507211,Patel; Hemal,9996,0,9999,3
1713302256430,CLRE 260,A00,507221,Cuomo; Raphael Eduardo,9999,0,9999,0
1713302257456,CLRE 297,001,507242,Cuomo; Raphael Eduardo,9999,0,9999,0
1713302258483,CSE 191,A00,516875,Minnes Kemp; Mor Mia,9999,0,9999,0
1713302259511,CSS 201S,A01,494383,Staff,35,0,35,0
1713302260535,CSS 202S,A01,494387,Staff,35,0,35,0
1713302261559,EAP 100,A00,516065,Staff,9792,0,9999,207
1713302262584,ECE 45,A01,507414,Staff,56,0,60,4
1713302263609,ECE 100,A01,507416,Baghdadchi; Saharnaz,12,0,20,8
1713302263609,ECE 100,A02,507418,Baghdadchi; Saharnaz,20,0,20,0
1713302264639,ECE 111,A01,507420,Staff,42,0,50,8
1713302265665,ECE 197,001,548057,Sievenpiper; Daniel F.,9999,0,9999,0
1713302266690,EDS 115,A00,507243,Choi; Bailey Miyeon,28,0,28,0
1713302267718,EDS 117,A01,494379,Staff,25,0,25,0
1713302268746,EDS 125,A00,507246,Hopkins; Megan Beth,29,0,30,1
1713302269774,EDS 128A,A01,507264,Fargason; Sharon Gayle,26,0,26,0
1713302270802,EDS 128B,A01,507293,Pappas; Elizabeth,30,0,30,0
1713302271829,EDS 139,A00,507294,Fargason; Sharon Gayle,30,0,30,0
1713302271829,EDS 139,B00,507313,Pappas; Elizabeth,30,0,30,0
1713302272856,EDS 201,A00,507315,Staff,26,0,30,4
1713302273891,EDS 203,A01,507317,Halter; Christopher P.,26,0,30,4
1713302274916,EDS 204R,A01,507319,Halter; Christopher P.,6,0,30,24
1713302274916,EDS 204R,B01,507331,Heinzman; Erica M.,30,0,30,0
1713302275942,EDS 206R,A00,507332,Staff,8,0,30,22
1713302275942,EDS 206R,B00,507343,Staff,29,0,30,1
1713302276971,EDS 250,A00,507344,Hemans; Patricia Ann Benitez,36,0,40,4
1713302278000,EDS 281,A00,507345,Daly; Alan J.,18,0,18,0
1713302279027,EDS 284,A00,507350,Daly; Alan J.,16,0,16,0
1713302280056,EDS 286,A00,507359,Fine; Sarah,18,0,18,0
1713302281081,EDS 289C,A01,507361,Daly; Alan J.,18,0,18,0
1713302282111,EDS 290,A00,507366,Hofstetter; Carolyn,15,0,15,0
1713302283137,LIGM 5A,A00,507421,Fischer-Grunski; Eva K,20,0,20,0
1713302284161,LIGM 5B,A00,507423,Fischer-Grunski; Eva K,20,0,20,0
1713302285188,LIGM 5C,A00,507425,Fischer-Grunski; Eva K,20,0,20,0
1713302286218,LIIT 5AS,A00,507427,Carnelos; Chiara,20,0,20,0
1713302287243,LIIT 5BS,A00,507430,Carnelos; Chiara,20,0,20,0
1713302288266,LIIT 5CS,A00,507432,Carnelos; Chiara,20,0,20,0
1713302289294,LISP 5A,A00,507541,Munoz Sanchez; Alicia,19,0,20,1
1713302290324,LISP 5B,A00,507671,Munoz Sanchez; Alicia,17,0,20,3
1713302291354,LISP 5C,A00,507696,Munoz Sanchez; Alicia,18,0,20,2
1713302292379,MAE 197,001,528363,Boechler; Nicholas Sebastia,9999,0,9999,0
1713302293407,MATH 197,001,523477,Kedlaya; Kiran S.,9999,0,9999,0
1713302293407,MATH 197,002,563811,Zhang; Danna,9999,0,9999,0
1713302294432,MCWP 40R,A00,518780,Staff,20,0,20,0
1713302294432,MCWP 40R,B00,518781,Staff,20,0,20,0
1713302294432,MCWP 40R,C00,518783,Staff,20,0,20,0
1713302295458,MCWP 50R,A00,518791,Staff,20,0,20,0
1713302295458,MCWP 50R,B00,518792,Staff,20,0,20,0
1713302295458,MCWP 50R,C00,518793,Staff,19,0,20,1
1713302295458,MCWP 50R,D00,518794,Staff,19,0,20,1
1713302295458,MCWP 50R,E00,518795,Staff,19,0,20,1
1713302295458,MCWP 50R,F00,518796,Staff,20,0,20,0
1713302295458,MCWP 50R,G00,518797,Staff,19,0,20,1
1713302296484,MMW 12R,A01,514034,Herbst; Matthew,16,0,16,0
1713302296484,MMW 12R,A02,514035,Herbst; Matthew,16,0,16,0
1713302297520,MMW 13R,A01,514037,Staff,16,0,16,0
1713302297520,MMW 13R,A02,514039,Staff,16,0,16,0
1713302298547,RMED 296,001,626776,Averbach; Sarah Helene,1,0,1,0
1713302299585,SIO 295LS,A00,523233,Staff,19,0,30,11
1713302300612,SIO 295S,A00,523232,Staff,19,0,30,11
1713302301638,SOCI 117,A01,494376,Staff,2,0,5,3
1713302302666,WES 237B,A00,494380,Staff,19,0,20,1
1713302304742,AESE 279B,A00,494370,Wade; Jon P,33,0,33,0
1713302305767,ANAR 135S,A00,494369,Braswell; Geoffrey E.,0,0,0,0
1713302306796,CAT 124RS,A01,519847,Geibel; William,17,0,20,3
1713302307825,CAT 125RS,A01,515971,Geibel; William,17,0,20,3
1713302308850,CLRE 250,A00,511389,Morris; Sheldon,9996,0,9999,3
1713302309880,CLRE 251,A00,507176,Mehta; Ravindra L.,9996,0,9999,3
1713302309880,CLRE 251,B00,511410,Mehta; Ravindra L.,9998,0,9999,1
1713302310905,CLRE 252,A00,507189,Cuomo; Raphael Eduardo,9998,0,9999,1
1713302311936,CLRE 253,A00,507199,Vaida; Florin,9997,0,9999,2
1713302311936,CLRE 253,B00,507202,Vaida; Florin,9999,0,9999,0
1713302312962,CLRE 259,A00,507211,Patel; Hemal,9996,0,9999,3
1713302313994,CLRE 260,A00,507221,Cuomo; Raphael Eduardo,9999,0,9999,0
1713302315025,CLRE 297,001,507242,Cuomo; Raphael Eduardo,9999,0,9999,0
1713302316052,CSE 191,A00,516875,Minnes Kemp; Mor Mia,9999,0,9999,0
1713302317079,CSS 201S,A01,494383,Staff,35,0,35,0
1713302318110,CSS 202S,A01,494387,Staff,35,0,35,0
1713302319135,EAP 100,A00,516065,Staff,9792,0,9999,207
1713302320163,ECE 45,A01,507414,Staff,56,0,60,4
1713302321194,ECE 100,A01,507416,Baghdadchi; Saharnaz,12,0,20,8
1713302321194,ECE 100,A02,507418,Baghdadchi; Saharnaz,20,0,20,0
1713302322221,ECE 111,A01,507420,Staff,42,0,50,8
1713302323250,ECE 197,001,548057,Sievenpiper; Daniel F.,9999,0,9999,0
1713302324280,EDS 115,A00,507243,Choi; Bailey Miyeon,28,0,28,0
1713302325309,EDS 117,A01,494379,Staff,25,0,25,0
1713302326334,EDS 125,A00,507246,Hopkins; Megan Beth,29,0,30,1
1713302327359,EDS 128A,A01,507264,Fargason; Sharon Gayle,26,0,26,0
1713302328390,EDS 128B,A01,507293,Pappas; Elizabeth,30,0,30,0
1713302329415,EDS 139,A00,507294,Fargason; Sharon Gayle,30,0,30,0
1713302329415,EDS 139,B00,507313,Pappas; Elizabeth,30,0,30,0
1713302330446,EDS 201,A00,507315,Staff,26,0,30,4
1713302331471,EDS 203,A01,507317,Halter; Christopher P.,26,0,30,4
1713302332495,EDS 204R,A01,507319,Halter; Christopher P.,6,0,30,24
1713302332495,EDS 204R,B01,507331,Heinzman; Erica M.,30,0,30,0
1713302333525,EDS 206R,A00,507332,Staff,8,0,30,22
1713302333525,EDS 206R,B00,507343,Staff,29,0,30,1
1713302334548,EDS 250,A00,507344,Hemans; Patricia Ann Benitez,36,0,40,4
1713302335572,EDS 281,A00,507345,Daly; Alan J.,18,0,18,0
1713302336597,EDS 284,A00,507350,Daly; Alan J.,16,0,16,0
1713302337627,EDS 286,A00,507359,Fine; Sarah,18,0,18,0
1713302338653,EDS 289C,A01,507361,Daly; Alan J.,18,0,18,0
1713302339732,EDS 290,A00,507366,Hofstetter; Carolyn,15,0,15,0
1713302340757,LIGM 5A,A00,507421,Fischer-Grunski; Eva K,20,0,20,0
1713302341786,LIGM 5B,A00,507423,Fischer-Grunski; Eva K,20,0,20,0
1713302342816,LIGM 5C,A00,507425,Fischer-Grunski; Eva K,20,0,20,0
1713302343844,LIIT 5AS,A00,507427,Carnelos; Chiara,20,0,20,0
1713302344875,LIIT 5BS,A00,507430,Carnelos; Chiara,20,0,20,0
1713302345907,LIIT 5CS,A00,507432,Carnelos; Chiara,20,0,20,0
1713302346936,LISP 5A,A00,507541,Munoz Sanchez; Alicia,19,0,20,1
1713302347965,LISP 5B,A00,507671,Munoz Sanchez; Alicia,17,0,20,3
1713302348995,LISP 5C,A00,507696,Munoz Sanchez; Alicia,18,0,20,2
1713302350025,MAE 197,001,528363,Boechler; Nicholas Sebastia,9999,0,9999,0
1713302351050,MATH 197,001,523477,Kedlaya; Kiran S.,9999,0,9999,0
1713302351050,MATH 197,002,563811,Zhang; Danna,9999,0,9999,0
1713302352078,MCWP 40R,A00,518780,Staff,20,0,20,0
1713302352078,MCWP 40R,B00,518781,Staff,20,0,20,0
1713302352078,MCWP 40R,C00,518783,Staff,20,0,20,0
1713302353107,MCWP 50R,A00,518791,Staff,20,0,20,0
1713302353107,MCWP 50R,B00,518792,Staff,20,0,20,0
1713302353107,MCWP 50R,C00,518793,Staff,19,0,20,1
1713302353107,MCWP 50R,D00,518794,Staff,19,0,20,1
1713302353107,MCWP 50R,E00,518795,Staff,19,0,20,1
1713302353107,MCWP 50R,F00,518796,Staff,20,0,20,0
1713302353107,MCWP 50R,G00,518797,Staff,19,0,20,1
1713302354136,MMW 12R,A01,514034,Herbst; Matthew,16,0,16,0
1713302354136,MMW 12R,A02,514035,Herbst; Matthew,16,0,16,0
1713302355161,MMW 13R,A01,514037,Staff,16,0,16,0
1713302355161,MMW 13R,A02,514039,Staff,16,0,16,0
1713302356187,RMED 296,001,626776,Averbach; Sarah Helene,1,0,1,0
1713302357213,SIO 295LS,A00,523233,Staff,19,0,30,11
1713302358237,SIO 295S,A00,523232,Staff,19,0,30,11
1713302359264,SOCI 117,A01,494376,Staff,2,0,5,3
1713302360291,WES 237B,A00,494380,Staff,19,0,20,1
1713302362368,AESE 279B,A00,494370,Wade; Jon P,33,0,33,0
1713302363500,ANAR 135S,A00,494369,Braswell; Geoffrey E.,0,0,0,0
1713302364529,CAT 124RS,A01,519847,Geibel; William,17,0,20,3
1713302365555,CAT 125RS,A01,515971,Geibel; William,17,0,20,3
1713302366585,CLRE 250,A00,511389,Morris; Sheldon,9996,0,9999,3
1713302367610,CLRE 251,A00,507176,Mehta; Ravindra L.,9996,0,9999,3
1713302367610,CLRE 251,B00,511410,Mehta; Ravindra L.,9998,0,9999,1
1713302368638,CLRE 252,A00,507189,Cuomo; Raphael Eduardo,9998,0,9999,1
1713302369675,CLRE 253,A00,507199,Vaida; Florin,9997,0,9999,2
1713302369675,CLRE 253,B00,507202,Vaida; Florin,9999,0,9999,0
1713302370700,CLRE 259,A00,507211,Patel; Hemal,9996,0,9999,3
1713302371727,CLRE 260,A00,507221,Cuomo; Raphael Eduardo,9999,0,9999,0
1713302372754,CLRE 297,001,507242,Cuomo; Raphael Eduardo,9999,0,9999,0
1713302373782,CSE 191,A00,516875,Minnes Kemp; Mor Mia,9999,0,9999,0
1713302374808,CSS 201S,A01,494383,Staff,35,0,35,0
1713302375835,CSS 202S,A01,494387,Staff,35,0,35,0
1713302376860,EAP 100,A00,516065,Staff,9792,0,9999,207
1713302377889,ECE 45,A01,507414,Staff,56,0,60,4
1713302378917,ECE 100,A01,507416,Baghdadchi; Saharnaz,12,0,20,8
1713302378917,ECE 100,A02,507418,Baghdadchi; Saharnaz,20,0,20,0
1713302379947,ECE 111,A01,507420,Staff,42,0,50,8
1713302380976,ECE 197,001,548057,Sievenpiper; Daniel F.,9999,0,9999,0
1713302382002,EDS 115,A00,507243,Choi; Bailey Miyeon,28,0,28,0
1713302383029,EDS 117,A01,494379,Staff,25,0,25,0
1713302384056,EDS 125,A00,507246,Hopkins; Megan Beth,29,0,30,1
1713302385090,EDS 128A,A01,507264,Fargason; Sharon Gayle,26,0,26,0
1713302386150,EDS 128B,A01,507293,Pappas; Elizabeth,30,0,30,0
1713302387179,EDS 139,A00,507294,Fargason; Sharon Gayle,30,0,30,0
1713302387179,EDS 139,B00,507313,Pappas; Elizabeth,30,0,30,0
1713302388204,EDS 201,A00,507315,Staff,26,0,30,4
1713302389234,EDS 203,A01,507317,Halter; Christopher P.,26,0,30,4
1713302390258,EDS 204R,A01,507319,Halter; Christopher P.,6,0,30,24
1713302390258,EDS 204R,B01,507331,Heinzman; Erica M.,30,0,30,0
1713302391286,EDS 206R,A00,507332,Staff,8,0,30,22
1713302391286,EDS 206R,B00,507343,Staff,29,0,30,1
1713302392312,EDS 250,A00,507344,Hemans; Patricia Ann Benitez,36,0,40,4
1713302393348,EDS 281,A00,507345,Daly; Alan J.,18,0,18,0
1713302394372,EDS 284,A00,507350,Daly; Alan J.,16,0,16,0
1713302395398,EDS 286,A00,507359,Fine; Sarah,18,0,18,0
1713302396423,EDS 289C,A01,507361,Daly; Alan J.,18,0,18,0
1713302397453,EDS 290,A00,507366,Hofstetter; Carolyn,15,0,15,0
1713302398480,LIGM 5A,A00,507421,Fischer-Grunski; Eva K,20,0,20,0
1713302399505,LIGM 5B,A00,507423,Fischer-Grunski; Eva K,20,0,20,0
1713302400533,LIGM 5C,A00,507425,Fischer-Grunski; Eva K,20,0,20,0
1713302401562,LIIT 5AS,A00,507427,Carnelos; Chiara,20,0,20,0
1713302402592,LIIT 5BS,A00,507430,Carnelos; Chiara,20,0,20,0
1713302403619,LIIT 5CS,A00,507432,Carnelos; Chiara,20,0,20,0
1713302404653,LISP 5A,A00,507541,Munoz Sanchez; Alicia,19,0,20,1
1713302405685,LISP 5B,A00,507671,Munoz Sanchez; Alicia,17,0,20,3
1713302406715,LISP 5C,A00,507696,Munoz Sanchez; Alicia,18,0,20,2
1713302407739,MAE 197,001,528363,Boechler; Nicholas Sebastia,9999,0,9999,0
1713302408762,MATH 197,001,523477,Kedlaya; Kiran S.,9999,0,9999,0
1713302408762,MATH 197,002,563811,Zhang; Danna,9999,0,9999,0
1713302409786,MCWP 40R,A00,518780,Staff,20,0,20,0
1713302409786,MCWP 40R,B00,518781,Staff,20,0,20,0
1713302409786,MCWP 40R,C00,518783,Staff,20,0,20,0
1713302410818,MCWP 50R,A00,518791,Staff,20,0,20,0
1713302410818,MCWP 50R,B00,518792,Staff,20,0,20,0
1713302410818,MCWP 50R,C00,518793,Staff,19,0,20,1
1713302410818,MCWP 50R,D00,518794,Staff,19,0,20,1
1713302410818,MCWP 50R,E00,518795,Staff,19,0,20,1
1713302410818,MCWP 50R,F00,518796,Staff,20,0,20,0
1713302410818,MCWP 50R,G00,518797,Staff,19,0,20,1
1713302411843,MMW 12R,A01,514034,Herbst; Matthew,16,0,16,0
1713302411843,MMW 12R,A02,514035,Herbst; Matthew,16,0,16,0
1713302412868,MMW 13R,A01,514037,Staff,16,0,16,0
1713302412868,MMW 13R,A02,514039,Staff,16,0,16,0
1713302413895,RMED 296,001,626776,Averbach; Sarah Helene,1,0,1,0
1713302414922,SIO 295LS,A00,523233,Staff,19,0,30,11
1713302415947,SIO 295S,A00,523232,Staff,19,0,30,11
1713302416977,SOCI 117,A01,494376,Staff,2,0,5,3
1713302418007,WES 237B,A00,494380,Staff,19,0,20,1
1713302420099,AESE 279B,A00,494370,Wade; Jon P,33,0,33,0
1713302421129,ANAR 135S,A00,494369,Braswell; Geoffrey E.,0,0,0,0
1713302422157,CAT 124RS,A01,519847,Geibel; William,17,0,20,3
1713302423180,CAT 125RS,A01,515971,Geibel; William,17,0,20,3
1713302424208,CLRE 250,A00,511389,Morris; Sheldon,9996,0,9999,3
1713302425234,CLRE 251,A00,507176,Mehta; Ravindra L.,9996,0,9999,3
1713302425234,CLRE 251,B00,511410,Mehta; Ravindra L.,9998,0,9999,1
1713302426268,CLRE 252,A00,507189,Cuomo; Raphael Eduardo,9998,0,9999,1
1713302427299,CLRE 253,A00,507199,Vaida; Florin,9997,0,9999,2
1713302427299,CLRE 253,B00,507202,Vaida; Florin,9999,0,9999,0
1713302428324,CLRE 259,A00,507211,Patel; Hemal,9996,0,9999,3
1713302429350,CLRE 260,A00,507221,Cuomo; Raphael Eduardo,9999,0,9999,0
1713302430377,CLRE 297,001,507242,Cuomo; Raphael Eduardo,9999,0,9999,0
1713302431405,CSE 191,A00,516875,Minnes Kemp; Mor Mia,9999,0,9999,0
1713302432435,CSS 201S,A01,494383,Staff,35,0,35,0
1713302433459,CSS 202S,A01,494387,Staff,35,0,35,0
1713302434487,EAP 100,A00,516065,Staff,9792,0,9999,207
1713302435511,ECE 45,A01,507414,Staff,56,0,60,4
1713302436537,ECE 100,A01,507416,Baghdadchi; Saharnaz,12,0,20,8
1713302436537,ECE 100,A02,507418,Baghdadchi; Saharnaz,20,0,20,0
1713302437563,ECE 111,A01,507420,Staff,42,0,50,8
1713302438588,ECE 197,001,548057,Sievenpiper; Daniel F.,9999,0,9999,0
1713302439614,EDS 115,A00,507243,Choi; Bailey Miyeon,28,0,28,0
1713302440639,EDS 117,A01,494379,Staff,25,0,25,0
1713302441664,EDS 125,A00,507246,Hopkins; Megan Beth,29,0,30,1
1713302442689,EDS 128A,A01,507264,Fargason; Sharon Gayle,26,0,26,0
1713302443769,EDS 128B,A01,507293,Pappas; Elizabeth,30,0,30,0
1713302444798,EDS 139,A00,507294,Fargason; Sharon Gayle,30,0,30,0
1713302444798,EDS 139,B00,507313,Pappas; Elizabeth,30,0,30,0
1713302445826,EDS 201,A00,507315,Staff,26,0,30,4
1713302446852,EDS 203,A01,507317,Halter; Christopher P.,26,0,30,4
1713302447878,EDS 204R,A01,507319,Halter; Christopher P.,6,0,30,24
1713302447878,EDS 204R,B01,507331,Heinzman; Erica M.,30,0,30,0
1713302448903,EDS 206R,A00,507332,Staff,8,0,30,22
1713302448903,EDS 206R,B00,507343,Staff,29,0,30,1
1713302449928,EDS 250,A00,507344,Hemans; Patricia Ann Benitez,36,0,40,4
1713302450956,EDS 281,A00,507345,Daly; Alan J.,18,0,18,0
1713302451981,EDS 284,A00,507350,Daly; Alan J.,16,0,16,0
1713302453010,EDS 286,A00,507359,Fine; Sarah,18,0,18,0
1713302454038,EDS 289C,A01,507361,Daly; Alan J.,18,0,18,0
1713302455062,EDS 290,A00,507366,Hofstetter; Carolyn,15,0,15,0
1713302456090,LIGM 5A,A00,507421,Fischer-Grunski; Eva K,20,0,20,0
1713302457115,LIGM 5B,A00,507423,Fischer-Grunski; Eva K,20,0,20,0
1713302458144,LIGM 5C,A00,507425,Fischer-Grunski; Eva K,20,0,20,0
1713302459175,LIIT 5AS,A00,507427,Carnelos; Chiara,20,0,20,0
1713302460203,LIIT 5BS,A00,507430,Carnelos; Chiara,20,0,20,0
1713302461229,LIIT 5CS,A00,507432,Carnelos; Chiara,20,0,20,0
1713302462254,LISP 5A,A00,507541,Munoz Sanchez; Alicia,19,0,20,1
1713302463280,LISP 5B,A00,507671,Munoz Sanchez; Alicia,17,0,20,3
1713302464303,LISP 5C,A00,507696,Munoz Sanchez; Alicia,18,0,20,2
1713302465328,MAE 197,001,528363,Boechler; Nicholas Sebastia,9999,0,9999,0
1713302466353,MATH 197,001,523477,Kedlaya; Kiran S.,9999,0,9999,0
1713302466353,MATH 197,002,563811,Zhang; Danna,9999,0,9999,0
1713302467378,MCWP 40R,A00,518780,Staff,20,0,20,0
1713302467378,MCWP 40R,B00,518781,Staff,20,0,20,0
1713302467378,MCWP 40R,C00,518783,Staff,20,0,20,0
1713302468409,MCWP 50R,A00,518791,Staff,20,0,20,0
1713302468409,MCWP 50R,B00,518792,Staff,20,0,20,0
1713302468409,MCWP 50R,C00,518793,Staff,19,0,20,1
1713302468409,MCWP 50R,D00,518794,Staff,19,0,20,1
1713302468409,MCWP 50R,E00,518795,Staff,19,0,20,1
1713302468409,MCWP 50R,F00,518796,Staff,20,0,20,0
1713302468409,MCWP 50R,G00,518797,Staff,19,0,20,1
1713302469436,MMW 12R,A01,514034,Herbst; Matthew,16,0,16,0
1713302469436,MMW 12R,A02,514035,Herbst; Matthew,16,0,16,0
1713302470461,MMW 13R,A01,514037,Staff,16,0,16,0
1713302470461,MMW 13R,A02,514039,Staff,16,0,16,0
1713302471489,RMED 296,001,626776,Averbach; Sarah Helene,1,0,1,0
1713302472513,SIO 295LS,A00,523233,Staff,19,0,30,11
1713302473542,SIO 295S,A00,523232,Staff,19,0,30,11
1713302474566,SOCI 117,A01,494376,Staff,2,0,5,3
1713302475592,WES 237B,A00,494380,Staff,19,0,20,1
1713302477671,AESE 279B,A00,494370,Wade; Jon P,33,0,33,0
1713302478701,ANAR 135S,A00,494369,Braswell; Geoffrey E.,0,0,0,0
1713302479725,CAT 124RS,A01,519847,Geibel; William,17,0,20,3
1713302480753,CAT 125RS,A01,515971,Geibel; William,17,0,20,3
1713302481778,CLRE 250,A00,511389,Morris; Sheldon,9996,0,9999,3
1713302482804,CLRE 251,A00,507176,Mehta; Ravindra L.,9996,0,9999,3
1713302482804,CLRE 251,B00,511410,Mehta; Ravindra L.,9998,0,9999,1
1713302483829,CLRE 252,A00,507189,Cuomo; Raphael Eduardo,9998,0,9999,1
1713302484859,CLRE 253,A00,507199,Vaida; Florin,9997,0,9999,2
1713302484859,CLRE 253,B00,507202,Vaida; Florin,9999,0,9999,0
1713302485884,CLRE 259,A00,507211,Patel; Hemal,9996,0,9999,3
1713302486914,CLRE 260,A00,507221,Cuomo; Raphael Eduardo,9999,0,9999,0
1713302487943,CLRE 297,001,507242,Cuomo; Raphael Eduardo,9999,0,9999,0
1713302488971,CSE 191,A00,516875,Minnes Kemp; Mor Mia,9999,0,9999,0
1713302489995,CSS 201S,A01,494383,Staff,35,0,35,0
1713302491022,CSS 202S,A01,494387,Staff,35,0,35,0
1713302492051,EAP 100,A00,516065,Staff,9792,0,9999,207
1713302493076,ECE 45,A01,507414,Staff,56,0,60,4
1713302494101,ECE 100,A01,507416,Baghdadchi; Saharnaz,12,0,20,8
1713302494101,ECE 100,A02,507418,Baghdadchi; Saharnaz,20,0,20,0
1713302495132,ECE 111,A01,507420,Staff,42,0,50,8
1713302496161,ECE 197,001,548057,Sievenpiper; Daniel F.,9999,0,9999,0
1713302497186,EDS 115,A00,507243,Choi; Bailey Miyeon,28,0,28,0
1713302498211,EDS 117,A01,494379,Staff,25,0,25,0
1713302499235,EDS 125,A00,507246,Hopkins; Megan Beth,29,0,30,1
1713302500260,EDS 128A,A01,507264,Fargason; Sharon Gayle,26,0,26,0
1713302501289,EDS 128B,A01,507293,Pappas; Elizabeth,30,0,30,0
1713302502317,EDS 139,A00,507294,Fargason; Sharon Gayle,30,0,30,0
1713302502317,EDS 139,B00,507313,Pappas; Elizabeth,30,0,30,0
1713302503342,EDS 201,A00,507315,Staff,26,0,30,4
1713302504367,EDS 203,A01,507317,Halter; Christopher P.,26,0,30,4
1713302505392,EDS 204R,A01,507319,Halter; Christopher P.,6,0,30,24
1713302505392,EDS 204R,B01,507331,Heinzman; Erica M.,30,0,30,0
1713302506421,EDS 206R,A00,507332,Staff,8,0,30,22
1713302506421,EDS 206R,B00,507343,Staff,29,0,30,1
1713302507450,EDS 250,A00,507344,Hemans; Patricia Ann Benitez,36,0,40,4
1713302508473,EDS 281,A00,507345,Daly; Alan J.,18,0,18,0
1713302509500,EDS 284,A00,507350,Daly; Alan J.,16,0,16,0
1713302510527,EDS 286,A00,507359,Fine; Sarah,18,0,18,0
1713302511552,EDS 289C,A01,507361,Daly; Alan J.,18,0,18,0
1713302512579,EDS 290,A00,507366,Hofstetter; Carolyn,15,0,15,0
1713302513605,LIGM 5A,A00,507421,Fischer-Grunski; Eva K,20,0,20,0
1713302514628,LIGM 5B,A00,507423,Fischer-Grunski; Eva K,20,0,20,0
1713302515671,LIGM 5C,A00,507425,Fischer-Grunski; Eva K,20,0,20,0
1713302516700,LIIT 5AS,A00,507427,Carnelos; Chiara,20,0,20,0
1713302517724,LIIT 5BS,A00,507430,Carnelos; Chiara,20,0,20,0
1713302518768,LIIT 5CS,A00,507432,Carnelos; Chiara,20,0,20,0
1713302519795,LISP 5A,A00,507541,Munoz Sanchez; Alicia,19,0,20,1
1713302520821,LISP 5B,A00,507671,Munoz Sanchez; Alicia,17,0,20,3
1713302521847,LISP 5C,A00,507696,Munoz Sanchez; Alicia,18,0,20,2
1713302522875,MAE 197,001,528363,Boechler; Nicholas Sebastia,9999,0,9999,0
1713302523907,MATH 197,001,523477,Kedlaya; Kiran S.,9999,0,9999,0
1713302523907,MATH 197,002,563811,Zhang; Danna,9999,0,9999,0
1713302524937,MCWP 40R,A00,518780,Staff,20,0,20,0
1713302524937,MCWP 40R,B00,518781,Staff,20,0,20,0
1713302524937,MCWP 40R,C00,518783,Staff,20,0,20,0
1713302525965,MCWP 50R,A00,518791,Staff,20,0,20,0
1713302525965,MCWP 50R,B00,518792,Staff,20,0,20,0
1713302525965,MCWP 50R,C00,518793,Staff,19,0,20,1
1713302525965,MCWP 50R,D00,518794,Staff,19,0,20,1
1713302525965,MCWP 50R,E00,518795,Staff,19,0,20,1
1713302525965,MCWP 50R,F00,518796,Staff,20,0,20,0
1713302525965,MCWP 50R,G00,518797,Staff,19,0,20,1
1713302526995,MMW 12R,A01,514034,Herbst; Matthew,16,0,16,0
1713302526995,MMW 12R,A02,514035,Herbst; Matthew,16,0,16,0
1713302528021,MMW 13R,A01,514037,Staff,16,0,16,0
1713302528021,MMW 13R,A02,514039,Staff,16,0,16,0
1713302529051,RMED 296,001,626776,Averbach; Sarah Helene,1,0,1,0
1713302530077,SIO 295LS,A00,523233,Staff,19,0,30,11
1713302531102,SIO 295S,A00,523232,Staff,19,0,30,11
1713302532130,SOCI 117,A01,494376,Staff,2,0,5,3
1713302533155,WES 237B,A00,494380,Staff,19,0,20,1
1713302535229,AESE 279B,A00,494370,Wade; Jon P,33,0,33,0
1713302536257,ANAR 135S,A00,494369,Braswell; Geoffrey E.,0,0,0,0
1713302537286,CAT 124RS,A01,519847,Geibel; William,17,0,20,3
1713302538325,CAT 125RS,A01,515971,Geibel; William,17,0,20,3
1713302539354,CLRE 250,A00,511389,Morris; Sheldon,9996,0,9999,3
1713302540384,CLRE 251,A00,507176,Mehta; Ravindra L.,9996,0,9999,3
1713302540384,CLRE 251,B00,511410,Mehta; Ravindra L.,9998,0,9999,1
1713302541411,CLRE 252,A00,507189,Cuomo; Raphael Eduardo,9998,0,9999,1
1713302542437,CLRE 253,A00,507199,Vaida; Florin,9997,0,9999,2
1713302542437,CLRE 253,B00,507202,Vaida; Florin,9999,0,9999,0
1713302543464,CLRE 259,A00,507211,Patel; Hemal,9996,0,9999,3
1713302544491,CLRE 260,A00,507221,Cuomo; Raphael Eduardo,9999,0,9999,0
1713302545522,CLRE 297,001,507242,Cuomo; Raphael Eduardo,9999,0,9999,0
1713302546549,CSE 191,A00,516875,Minnes Kemp; Mor Mia,9999,0,9999,0
1713302547629,CSS 201S,A01,494383,Staff,35,0,35,0
1713302548657,CSS 202S,A01,494387,Staff,35,0,35,0
1713302549683,EAP 100,A00,516065,Staff,9792,0,9999,207
1713302550708,ECE 45,A01,507414,Staff,56,0,60,4
1713302551734,ECE 100,A01,507416,Baghdadchi; Saharnaz,12,0,20,8
1713302551734,ECE 100,A02,507418,Baghdadchi; Saharnaz,20,0,20,0
1713302552759,ECE 111,A01,507420,Staff,42,0,50,8
1713302553785,ECE 197,001,548057,Sievenpiper; Daniel F.,9999,0,9999,0
1713302554813,EDS 115,A00,507243,Choi; Bailey Miyeon,28,0,28,0
1713302555847,EDS 117,A01,494379,Staff,25,0,25,0
1713302556874,EDS 125,A00,507246,Hopkins; Megan Beth,29,0,30,1
1713302557898,EDS 128A,A01,507264,Fargason; Sharon Gayle,26,0,26,0
1713302558923,EDS 128B,A01,507293,Pappas; Elizabeth,30,0,30,0
1713302559947,EDS 139,A00,507294,Fargason; Sharon Gayle,30,0,30,0
1713302559947,EDS 139,B00,507313,Pappas; Elizabeth,30,0,30,0
1713302560971,EDS 201,A00,507315,Staff,26,0,30,4
1713302561996,EDS 203,A01,507317,Halter; Christopher P.,26,0,30,4
1713302563023,EDS 204R,A01,507319,Halter; Christopher P.,6,0,30,24
1713302563023,EDS 204R,B01,507331,Heinzman; Erica M.,30,0,30,0
1713302564049,EDS 206R,A00,507332,Staff,8,0,30,22
1713302564049,EDS 206R,B00,507343,Staff,29,0,30,1
1713302565077,EDS 250,A00,507344,Hemans; Patricia Ann Benitez,36,0,40,4
1713302566103,EDS 281,A00,507345,Daly; Alan J.,18,0,18,0
1713302567131,EDS 284,A00,507350,Daly; Alan J.,16,0,16,0
1713302568157,EDS 286,A00,507359,Fine; Sarah,18,0,18,0
1713302569186,EDS 289C,A01,507361,Daly; Alan J.,18,0,18,0
1713302570214,EDS 290,A00,507366,Hofstetter; Carolyn,15,0,15,0
1713302571240,LIGM 5A,A00,507421,Fischer-Grunski; Eva K,20,0,20,0
1713302572269,LIGM 5B,A00,507423,Fischer-Grunski; Eva K,20,0,20,0
1713302573296,LIGM 5C,A00,507425,Fischer-Grunski; Eva K,20,0,20,0
1713302574322,LIIT 5AS,A00,507427,Carnelos; Chiara,20,0,20,0
1713302575351,LIIT 5BS,A00,507430,Carnelos; Chiara,20,0,20,0
1713302576374,LIIT 5CS,A00,507432,Carnelos; Chiara,20,0,20,0
1713302577404,LISP 5A,A00,507541,Munoz Sanchez; Alicia,19,0,20,1
1713302578435,LISP 5B,A00,507671,Munoz Sanchez; Alicia,17,0,20,3
1713302579462,LISP 5C,A00,507696,Munoz Sanchez; Alicia,18,0,20,2
1713302580492,MAE 197,001,528363,Boechler; Nicholas Sebastia,9999,0,9999,0
1713302581526,MATH 197,001,523477,Kedlaya; Kiran S.,9999,0,9999,0
1713302581526,MATH 197,002,563811,Zhang; Danna,9999,0,9999,0
1713302582554,MCWP 40R,A00,518780,Staff,20,0,20,0
1713302582554,MCWP 40R,B00,518781,Staff,20,0,20,0
1713302582554,MCWP 40R,C00,518783,Staff,20,0,20,0
1713302583579,MCWP 50R,A00,518791,Staff,20,0,20,0
1713302583579,MCWP 50R,B00,518792,Staff,20,0,20,0
1713302583579,MCWP 50R,C00,518793,Staff,19,0,20,1
1713302583579,MCWP 50R,D00,518794,Staff,19,0,20,1
1713302583579,MCWP 50R,E00,518795,Staff,19,0,20,1
1713302583579,MCWP 50R,F00,518796,Staff,20,0,20,0
1713302583579,MCWP 50R,G00,518797,Staff,19,0,20,1
1713302584608,MMW 12R,A01,514034,Herbst; Matthew,16,0,16,0
1713302584608,MMW 12R,A02,514035,Herbst; Matthew,16,0,16,0
1713302585633,MMW 13R,A01,514037,Staff,16,0,16,0
1713302585633,MMW 13R,A02,514039,Staff,16,0,16,0
1713302586658,RMED 296,001,626776,Averbach; Sarah Helene,1,0,1,0
1713302587687,SIO 295LS,A00,523233,Staff,19,0,30,11
1713302588714,SIO 295S,A00,523232,Staff,19,0,30,11
1713302589744,SOCI 117,A01,494376,Staff,2,0,5,3
1713302590769,WES 237B,A00,494380,Staff,19,0,20,1
1713302592842,AESE 279B,A00,494370,Wade; Jon P,33,0,33,0
1713302593868,ANAR 135S,A00,494369,Braswell; Geoffrey E.,0,0,0,0
1713302594897,CAT 124RS,A01,519847,Geibel; William,17,0,20,3
1713302595925,CAT 125RS,A01,515971,Geibel; William,17,0,20,3
1713302596951,CLRE 250,A00,511389,Morris; Sheldon,9996,0,9999,3
1713302597975,CLRE 251,A00,507176,Mehta; Ravindra L.,9996,0,9999,3
1713302597975,CLRE 251,B00,511410,Mehta; Ravindra L.,9998,0,9999,1
1713302599005,CLRE 252,A00,507189,Cuomo; Raphael Eduardo,9998,0,9999,1
1713302600035,CLRE 253,A00,507199,Vaida; Florin,9997,0,9999,2
1713302600035,CLRE 253,B00,507202,Vaida; Florin,9999,0,9999,0
1713302601063,CLRE 259,A00,507211,Patel; Hemal,9996,0,9999,3
1713302602091,CLRE 260,A00,507221,Cuomo; Raphael Eduardo,9999,0,9999,0
1713302603116,CLRE 297,001,507242,Cuomo; Raphael Eduardo,9999,0,9999,0
1713302604145,CSE 191,A00,516875,Minnes Kemp; Mor Mia,9999,0,9999,0
1713302605175,CSS 201S,A01,494383,Staff,35,0,35,0
1713302606201,CSS 202S,A01,494387,Staff,35,0,35,0
1713302607228,EAP 100,A00,516065,Staff,9792,0,9999,207
1713302608254,ECE 45,A01,507414,Staff,56,0,60,4
1713302609287,ECE 100,A01,507416,Baghdadchi; Saharnaz,12,0,20,8
1713302609287,ECE 100,A02,507418,Baghdadchi; Saharnaz,20,0,20,0
1713302610310,ECE 111,A01,507420,Staff,42,0,50,8
1713302611336,ECE 197,001,548057,Sievenpiper; Daniel F.,9999,0,9999,0
1713302612365,EDS 115,A00,507243,Choi; Bailey Miyeon,28,0,28,0
1713302613390,EDS 117,A01,494379,Staff,25,0,25,0
1713302614417,EDS 125,A00,507246,Hopkins; Megan Beth,29,0,30,1
1713302615446,EDS 128A,A01,507264,Fargason; Sharon Gayle,26,0,26,0
1713302616471,EDS 128B,A01,507293,Pappas; Elizabeth,30,0,30,0
1713302617497,EDS 139,A00,507294,Fargason; Sharon Gayle,30,0,30,0
1713302617497,EDS 139,B00,507313,Pappas; Elizabeth,30,0,30,0
1713302618521,EDS 201,A00,507315,Staff,26,0,30,4
1713302619546,EDS 203,A01,507317,Halter; Christopher P.,26,0,30,4
1713302620576,EDS 204R,A01,507319,Halter; Christopher P.,6,0,30,24
1713302620576,EDS 204R,B01,507331,Heinzman; Erica M.,30,0,30,0
1713302621603,EDS 206R,A00,507332,Staff,8,0,30,22
1713302621603,EDS 206R,B00,507343,Staff,29,0,30,1
1713302622631,EDS 250,A00,507344,Hemans; Patricia Ann Benitez,36,0,40,4
1713302623656,EDS 281,A00,507345,Daly; Alan J.,18,0,18,0
1713302624681,EDS 284,A00,507350,Daly; Alan J.,16,0,16,0
1713302625707,EDS 286,A00,507359,Fine; Sarah,18,0,18,0
1713302626738,EDS 289C,A01,507361,Daly; Alan J.,18,0,18,0
1713302627763,EDS 290,A00,507366,Hofstetter; Carolyn,15,0,15,0
1713302628793,LIGM 5A,A00,507421,Fischer-Grunski; Eva K,20,0,20,0
1713302629822,LIGM 5B,A00,507423,Fischer-Grunski; Eva K,20,0,20,0
1713302630848,LIGM 5C,A00,507425,Fischer-Grunski; Eva K,20,0,20,0
1713302631874,LIIT 5AS,A00,507427,Carnelos; Chiara,20,0,20,0
1713302632903,LIIT 5BS,A00,507430,Carnelos; Chiara,20,0,20,0
1713302633930,LIIT 5CS,A00,507432,Carnelos; Chiara,20,0,20,0
1713302634956,LISP 5A,A00,507541,Munoz Sanchez; Alicia,19,0,20,1
1713302635985,LISP 5B,A00,507671,Munoz Sanchez; Alicia,17,0,20,3
1713302637016,LISP 5C,A00,507696,Munoz Sanchez; Alicia,18,0,20,2
1713302638041,MAE 197,001,528363,Boechler; Nicholas Sebastia,9999,0,9999,0
1713302639067,MATH 197,001,523477,Kedlaya; Kiran S.,9999,0,9999,0
1713302639067,MATH 197,002,563811,Zhang; Danna,9999,0,9999,0
1713302640096,MCWP 40R,A00,518780,Staff,20,0,20,0
1713302640096,MCWP 40R,B00,518781,Staff,20,0,20,0
1713302640096,MCWP 40R,C00,518783,Staff,20,0,20,0
1713302641122,MCWP 50R,A00,518791,Staff,20,0,20,0
1713302641122,MCWP 50R,B00,518792,Staff,20,0,20,0
1713302641122,MCWP 50R,C00,518793,Staff,19,0,20,1
1713302641122,MCWP 50R,D00,518794,Staff,19,0,20,1
1713302641122,MCWP 50R,E00,518795,Staff,19,0,20,1
1713302641122,MCWP 50R,F00,518796,Staff,20,0,20,0
1713302641122,MCWP 50R,G00,518797,Staff,19,0,20,1
1713302642149,MMW 12R,A01,514034,Herbst; Matthew,16,0,16,0
1713302642149,MMW 12R,A02,514035,Herbst; Matthew,16,0,16,0
1713302643173,MMW 13R,A01,514037,Staff,16,0,16,0
1713302643173,MMW 13R,A02,514039,Staff,16,0,16,0
1713302644202,RMED 296,001,626776,Averbach; Sarah Helene,1,0,1,0
1713302645234,SIO 295LS,A00,523233,Staff,19,0,30,11
1713302646258,SIO 295S,A00,523232,Staff,19,0,30,11
1713302647282,SOCI 117,A01,494376,Staff,2,0,5,3
1713302648310,WES 237B,A00,494380,Staff,19,0,20,1
1713302650381,AESE 279B,A00,494370,Wade; Jon P,33,0,33,0
1713302651465,ANAR 135S,A00,494369,Braswell; Geoffrey E.,0,0,0,0
1713302652491,CAT 124RS,A01,519847,Geibel; William,17,0,20,3
1713302653517,CAT 125RS,A01,515971,Geibel; William,17,0,20,3
1713302654552,CLRE 250,A00,511389,Morris; Sheldon,9996,0,9999,3
1713302655577,CLRE 251,A00,507176,Mehta; Ravindra L.,9996,0,9999,3
1713302655577,CLRE 251,B00,511410,Mehta; Ravindra L.,9998,0,9999,1
1713302656601,CLRE 252,A00,507189,Cuomo; Raphael Eduardo,9998,0,9999,1
1713302657627,CLRE 253,A00,507199,Vaida; Florin,9997,0,9999,2
1713302657627,CLRE 253,B00,507202,Vaida; Florin,9999,0,9999,0
1713302658653,CLRE 259,A00,507211,Patel; Hemal,9996,0,9999,3
1713302659681,CLRE 260,A00,507221,Cuomo; Raphael Eduardo,9999,0,9999,0
1713302660706,CLRE 297,001,507242,Cuomo; Raphael Eduardo,9999,0,9999,0
1713302661733,CSE 191,A00,516875,Minnes Kemp; Mor Mia,9999,0,9999,0
1713302662758,CSS 201S,A01,494383,Staff,35,0,35,0
1713302663781,CSS 202S,A01,494387,Staff,35,0,35,0
1713302664805,EAP 100,A00,516065,Staff,9792,0,9999,207
1713302665831,ECE 45,A01,507414,Staff,56,0,60,4
1713302666855,ECE 100,A01,507416,Baghdadchi; Saharnaz,12,0,20,8
1713302666855,ECE 100,A02,507418,Baghdadchi; Saharnaz,20,0,20,0
1713302667887,ECE 111,A01,507420,Staff,42,0,50,8
1713302668917,ECE 197,001,548057,Sievenpiper; Daniel F.,9999,0,9999,0
1713302669941,EDS 115,A00,507243,Choi; Bailey Miyeon,28,0,28,0
1713302670966,EDS 117,A01,494379,Staff,25,0,25,0
1713302671996,EDS 125,A00,507246,Hopkins; Megan Beth,29,0,30,1
1713302673025,EDS 128A,A01,507264,Fargason; Sharon Gayle,26,0,26,0
1713302674054,EDS 128B,A01,507293,Pappas; Elizabeth,30,0,30,0
1713302675082,EDS 139,A00,507294,Fargason; Sharon Gayle,30,0,30,0
1713302675082,EDS 139,B00,507313,Pappas; Elizabeth,30,0,30,0
1713302676107,EDS 201,A00,507315,Staff,26,0,30,4
1713302677132,EDS 203,A01,507317,Halter; Christopher P.,26,0,30,4
1713302678157,EDS 204R,A01,507319,Halter; Christopher P.,6,0,30,24
1713302678157,EDS 204R,B01,507331,Heinzman; Erica M.,30,0,30,0
1713302679181,EDS 206R,A00,507332,Staff,8,0,30,22
1713302679181,EDS 206R,B00,507343,Staff,29,0,30,1
1713302680206,EDS 250,A00,507344,Hemans; Patricia Ann Benitez,36,0,40,4
1713302681233,EDS 281,A00,507345,Daly; Alan J.,18,0,18,0
1713302682256,EDS 284,A00,507350,Daly; Alan J.,16,0,16,0
1713302683284,EDS 286,A00,507359,Fine; Sarah,18,0,18,0
1713302684311,EDS 289C,A01,507361,Daly; Alan J.,18,0,18,0
1713302685334,EDS 290,A00,507366,Hofstetter; Carolyn,15,0,15,0
1713302686359,LIGM 5A,A00,507421,Fischer-Grunski; Eva K,20,0,20,0
1713302687384,LIGM 5B,A00,507423,Fischer-Grunski; Eva K,20,0,20,0
1713302688408,LIGM 5C,A00,507425,Fischer-Grunski; Eva K,20,0,20,0
1713302689434,LIIT 5AS,A00,507427,Carnelos; Chiara,20,0,20,0
1713302690459,LIIT 5BS,A00,507430,Carnelos; Chiara,20,0,20,0
1713302691483,LIIT 5CS,A00,507432,Carnelos; Chiara,20,0,20,0
1713302692510,LISP 5A,A00,507541,Munoz Sanchez; Alicia,19,0,20,1
1713302693535,LISP 5B,A00,507671,Munoz Sanchez; Alicia,17,0,20,3
1713302694561,LISP 5C,A00,507696,Munoz Sanchez; Alicia,18,0,20,2
1713302695588,MAE 197,001,528363,Boechler; Nicholas Sebastia,9999,0,9999,0
1713302696615,MATH 197,001,523477,Kedlaya; Kiran S.,9999,0,9999,0
1713302696615,MATH 197,002,563811,Zhang; Danna,9999,0,9999,0
1713302697641,MCWP 40R,A00,518780,Staff,20,0,20,0
1713302697641,MCWP 40R,B00,518781,Staff,20,0,20,0
1713302697641,MCWP 40R,C00,518783,Staff,20,0,20,0
1713302698666,MCWP 50R,A00,518791,Staff,20,0,20,0
1713302698666,MCWP 50R,B00,518792,Staff,20,0,20,0
1713302698666,MCWP 50R,C00,518793,Staff,19,0,20,1
1713302698666,MCWP 50R,D00,518794,Staff,19,0,20,1
1713302698666,MCWP 50R,E00,518795,Staff,19,0,20,1
1713302698666,MCWP 50R,F00,518796,Staff,20,0,20,0
1713302698666,MCWP 50R,G00,518797,Staff,19,0,20,1
1713302699690,MMW 12R,A01,514034,Herbst; Matthew,16,0,16,0
1713302699690,MMW 12R,A02,514035,Herbst; Matthew,16,0,16,0
1713302700720,MMW 13R,A01,514037,Staff,16,0,16,0
1713302700720,MMW 13R,A02,514039,Staff,16,0,16,0
1713302701745,RMED 296,001,626776,Averbach; Sarah Helene,1,0,1,0
1713302702774,SIO 295LS,A00,523233,Staff,19,0,30,11
1713302703799,SIO 295S,A00,523232,Staff,19,0,30,11
1713302704824,SOCI 117,A01,494376,Staff,2,0,5,3
1713302705850,WES 237B,A00,494380,Staff,19,0,20,1
1713302707909,AESE 279B,A00,494370,Wade; Jon P,33,0,33,0
1713302708935,ANAR 135S,A00,494369,Braswell; Geoffrey E.,0,0,0,0
1713302709961,CAT 124RS,A01,519847,Geibel; William,17,0,20,3
1713302710986,CAT 125RS,A01,515971,Geibel; William,17,0,20,3
1713302712012,CLRE 250,A00,511389,Morris; Sheldon,9996,0,9999,3
1713302713042,CLRE 251,A00,507176,Mehta; Ravindra L.,9996,0,9999,3
1713302713042,CLRE 251,B00,511410,Mehta; Ravindra L.,9998,0,9999,1
1713302714075,CLRE 252,A00,507189,Cuomo; Raphael Eduardo,9998,0,9999,1
1713302715105,CLRE 253,A00,507199,Vaida; Florin,9997,0,9999,2
1713302715105,CLRE 253,B00,507202,Vaida; Florin,9999,0,9999,0
1713302716140,CLRE 259,A00,507211,Patel; Hemal,9996,0,9999,3
1713302717169,CLRE 260,A00,507221,Cuomo; Raphael Eduardo,9999,0,9999,0
1713302718198,CLRE 297,001,507242,Cuomo; Raphael Eduardo,9999,0,9999,0
1713302719223,CSE 191,A00,516875,Minnes Kemp; Mor Mia,9999,0,9999,0
1713302720248,CSS 201S,A01,494383,Staff,35,0,35,0
1713302721278,CSS 202S,A01,494387,Staff,35,0,35,0
1713302722306,EAP 100,A00,516065,Staff,9792,0,9999,207
1713302723336,ECE 45,A01,507414,Staff,56,0,60,4
1713302724366,ECE 100,A01,507416,Baghdadchi; Saharnaz,12,0,20,8
1713302724366,ECE 100,A02,507418,Baghdadchi; Saharnaz,20,0,20,0
1713302725391,ECE 111,A01,507420,Staff,42,0,50,8
1713302726416,ECE 197,001,548057,Sievenpiper; Daniel F.,9999,0,9999,0
1713302727444,EDS 115,A00,507243,Choi; Bailey Miyeon,28,0,28,0
1713302728470,EDS 117,A01,494379,Staff,25,0,25,0
1713302729495,EDS 125,A00,507246,Hopkins; Megan Beth,29,0,30,1
1713302730520,EDS 128A,A01,507264,Fargason; Sharon Gayle,26,0,26,0
1713302731546,EDS 128B,A01,507293,Pappas; Elizabeth,30,0,30,0
1713302732571,EDS 139,A00,507294,Fargason; Sharon Gayle,30,0,30,0
1713302732571,EDS 139,B00,507313,Pappas; Elizabeth,30,0,30,0
1713302733598,EDS 201,A00,507315,Staff,26,0,30,4
1713302734623,EDS 203,A01,507317,Halter; Christopher P.,26,0,30,4
1713302735648,EDS 204R,A01,507319,Halter; Christopher P.,6,0,30,24
1713302735648,EDS 204R,B01,507331,Heinzman; Erica M.,30,0,30,0
1713302736676,EDS 206R,A00,507332,Staff,8,0,30,22
1713302736676,EDS 206R,B00,507343,Staff,29,0,30,1
1713302737704,EDS 250,A00,507344,Hemans; Patricia Ann Benitez,36,0,40,4
1713302738731,EDS 281,A00,507345,Daly; Alan J.,18,0,18,0
1713302739756,EDS 284,A00,507350,Daly; Alan J.,16,0,16,0
1713302740781,EDS 286,A00,507359,Fine; Sarah,18,0,18,0
1713302741804,EDS 289C,A01,507361,Daly; Alan J.,18,0,18,0
1713302742829,EDS 290,A00,507366,Hofstetter; Carolyn,15,0,15,0
1713302743868,LIGM 5A,A00,507421,Fischer-Grunski; Eva K,20,0,20,0
1713302744896,LIGM 5B,A00,507423,Fischer-Grunski; Eva K,20,0,20,0
1713302745921,LIGM 5C,A00,507425,Fischer-Grunski; Eva K,20,0,20,0
1713302746948,LIIT 5AS,A00,507427,Carnelos; Chiara,20,0,20,0
1713302747977,LIIT 5BS,A00,507430,Carnelos; Chiara,20,0,20,0
1713302749005,LIIT 5CS,A00,507432,Carnelos; Chiara,20,0,20,0
1713302750029,LISP 5A,A00,507541,Munoz Sanchez; Alicia,19,0,20,1
1713302751055,LISP 5B,A00,507671,Munoz Sanchez; Alicia,17,0,20,3
1713302752080,LISP 5C,A00,507696,Munoz Sanchez; Alicia,18,0,20,2
1713302753107,MAE 197,001,528363,Boechler; Nicholas Sebastia,9999,0,9999,0
1713302754133,MATH 197,001,523477,Kedlaya; Kiran S.,9999,0,9999,0
1713302754133,MATH 197,002,563811,Zhang; Danna,9999,0,9999,0
1713302755215,MCWP 40R,A00,518780,Staff,20,0,20,0
1713302755215,MCWP 40R,B00,518781,Staff,20,0,20,0
1713302755215,MCWP 40R,C00,518783,Staff,20,0,20,0
1713302756242,MCWP 50R,A00,518791,Staff,20,0,20,0
1713302756242,MCWP 50R,B00,518792,Staff,20,0,20,0
1713302756242,MCWP 50R,C00,518793,Staff,19,0,20,1
1713302756242,MCWP 50R,D00,518794,Staff,19,0,20,1
1713302756242,MCWP 50R,E00,518795,Staff,19,0,20,1
1713302756242,MCWP 50R,F00,518796,Staff,20,0,20,0
1713302756242,MCWP 50R,G00,518797,Staff,19,0,20,1
1713302757266,MMW 12R,A01,514034,Herbst; Matthew,16,0,16,0
1713302757266,MMW 12R,A02,514035,Herbst; Matthew,16,0,16,0
1713302758291,MMW 13R,A01,514037,Staff,16,0,16,0
1713302758291,MMW 13R,A02,514039,Staff,16,0,16,0
1713302759319,RMED 296,001,626776,Averbach; Sarah Helene,1,0,1,0
1713302760344,SIO 295LS,A00,523233,Staff,19,0,30,11
1713302761370,SIO 295S,A00,523232,Staff,19,0,30,11
1713302762396,SOCI 117,A01,494376,Staff,2,0,5,3
1713302763421,WES 237B,A00,494380,Staff,19,0,20,1
1713302765485,AESE 279B,A00,494370,Wade; Jon P,33,0,33,0
1713302766509,ANAR 135S,A00,494369,Braswell; Geoffrey E.,0,0,0,0
1713302767536,CAT 124RS,A01,519847,Geibel; William,17,0,20,3
1713302768561,CAT 125RS,A01,515971,Geibel; William,17,0,20,3
1713302769593,CLRE 250,A00,511389,Morris; Sheldon,9996,0,9999,3
1713302770623,CLRE 251,A00,507176,Mehta; Ravindra L.,9996,0,9999,3
1713302770623,CLRE 251,B00,511410,Mehta; Ravindra L.,9998,0,9999,1
1713302771649,CLRE 252,A00,507189,Cuomo; Raphael Eduardo,9998,0,9999,1
1713302772675,CLRE 253,A00,507199,Vaida; Florin,9997,0,9999,2
1713302772675,CLRE 253,B00,507202,Vaida; Florin,9999,0,9999,0
1713302773707,CLRE 259,A00,507211,Patel; Hemal,9996,0,9999,3
1713302774731,CLRE 260,A00,507221,Cuomo; Raphael Eduardo,9999,0,9999,0
1713302775756,CLRE 297,001,507242,Cuomo; Raphael Eduardo,9999,0,9999,0
1713302776783,CSE 191,A00,516875,Minnes Kemp; Mor Mia,9999,0,9999,0
1713302777808,CSS 201S,A01,494383,Staff,35,0,35,0
1713302778838,CSS 202S,A01,494387,Staff,35,0,35,0
1713302779865,EAP 100,A00,516065,Staff,9792,0,9999,207
1713302780889,ECE 45,A01,507414,Staff,56,0,60,4
1713302781915,ECE 100,A01,507416,Baghdadchi; Saharnaz,12,0,20,8
1713302781915,ECE 100,A02,507418,Baghdadchi; Saharnaz,20,0,20,0
1713302782939,ECE 111,A01,507420,Staff,42,0,50,8
1713302783966,ECE 197,001,548057,Sievenpiper; Daniel F.,9999,0,9999,0
1713302784993,EDS 115,A00,507243,Choi; Bailey Miyeon,28,0,28,0
1713302786019,EDS 117,A01,494379,Staff,25,0,25,0
1713302787047,EDS 125,A00,507246,Hopkins; Megan Beth,29,0,30,1
1713302788071,EDS 128A,A01,507264,Fargason; Sharon Gayle,26,0,26,0
1713302789101,EDS 128B,A01,507293,Pappas; Elizabeth,30,0,30,0
1713302790127,EDS 139,A00,507294,Fargason; Sharon Gayle,30,0,30,0
1713302790127,EDS 139,B00,507313,Pappas; Elizabeth,30,0,30,0
1713302791153,EDS 201,A00,507315,Staff,26,0,30,4
1713302792179,EDS 203,A01,507317,Halter; Christopher P.,26,0,30,4
1713302793210,EDS 204R,A01,507319,Halter; Christopher P.,6,0,30,24
1713302793210,EDS 204R,B01,507331,Heinzman; Erica M.,30,0,30,0
1713302794235,EDS 206R,A00,507332,Staff,8,0,30,22
1713302794235,EDS 206R,B00,507343,Staff,29,0,30,1
1713302795264,EDS 250,A00,507344,Hemans; Patricia Ann Benitez,36,0,40,4
1713302796293,EDS 281,A00,507345,Daly; Alan J.,18,0,18,0
1713302797317,EDS 284,A00,507350,Daly; Alan J.,16,0,16,0
1713302798348,EDS 286,A00,507359,Fine; Sarah,18,0,18,0
1713302799376,EDS 289C,A01,507361,Daly; Alan J.,18,0,18,0
1713302800400,EDS 290,A00,507366,Hofstetter; Carolyn,15,0,15,0
1713302801428,LIGM 5A,A00,507421,Fischer-Grunski; Eva K,20,0,20,0
1713302802455,LIGM 5B,A00,507423,Fischer-Grunski; Eva K,20,0,20,0
1713302803484,LIGM 5C,A00,507425,Fischer-Grunski; Eva K,20,0,20,0
1713302804514,LIIT 5AS,A00,507427,Carnelos; Chiara,20,0,20,0
1713302805538,LIIT 5BS,A00,507430,Carnelos; Chiara,20,0,20,0
1713302806563,LIIT 5CS,A00,507432,Carnelos; Chiara,20,0,20,0
1713302807595,LISP 5A,A00,507541,Munoz Sanchez; Alicia,19,0,20,1
1713302808624,LISP 5B,A00,507671,Munoz Sanchez; Alicia,17,0,20,3
1713302809649,LISP 5C,A00,507696,Munoz Sanchez; Alicia,18,0,20,2
1713302810677,MAE 197,001,528363,Boechler; Nicholas Sebastia,9999,0,9999,0
1713302811702,MATH 197,001,523477,Kedlaya; Kiran S.,9999,0,9999,0
1713302811702,MATH 197,002,563811,Zhang; Danna,9999,0,9999,0
1713302812728,MCWP 40R,A00,518780,Staff,20,0,20,0
1713302812728,MCWP 40R,B00,518781,Staff,20,0,20,0
1713302812728,MCWP 40R,C00,518783,Staff,20,0,20,0
1713302813756,MCWP 50R,A00,518791,Staff,20,0,20,0
1713302813756,MCWP 50R,B00,518792,Staff,20,0,20,0
1713302813756,MCWP 50R,C00,518793,Staff,19,0,20,1
1713302813756,MCWP 50R,D00,518794,Staff,19,0,20,1
1713302813756,MCWP 50R,E00,518795,Staff,19,0,20,1
1713302813756,MCWP 50R,F00,518796,Staff,20,0,20,0
1713302813756,MCWP 50R,G00,518797,Staff,19,0,20,1
1713302814780,MMW 12R,A01,514034,Herbst; Matthew,16,0,16,0
1713302814780,MMW 12R,A02,514035,Herbst; Matthew,16,0,16,0
1713302815809,MMW 13R,A01,514037,Staff,16,0,16,0
1713302815809,MMW 13R,A02,514039,Staff,16,0,16,0
1713302816835,RMED 296,001,626776,Averbach; Sarah Helene,1,0,1,0
1713302817863,SIO 295LS,A00,523233,Staff,19,0,30,11
1713302818891,SIO 295S,A00,523232,Staff,19,0,30,11
1713302819916,SOCI 117,A01,494376,Staff,2,0,5,3
1713302820945,WES 237B,A00,494380,Staff,19,0,20,1
1713302823010,AESE 279B,A00,494370,Wade; Jon P,33,0,33,0
1713302824034,ANAR 135S,A00,494369,Braswell; Geoffrey E.,0,0,0,0
1713302825058,CAT 124RS,A01,519847,Geibel; William,17,0,20,3
1713302826084,CAT 125RS,A01,515971,Geibel; William,17,0,20,3
1713302827113,CLRE 250,A00,511389,Morris; Sheldon,9996,0,9999,3
1713302828138,CLRE 251,A00,507176,Mehta; Ravindra L.,9996,0,9999,3
1713302828138,CLRE 251,B00,511410,Mehta; Ravindra L.,9998,0,9999,1
1713302829163,CLRE 252,A00,507189,Cuomo; Raphael Eduardo,9998,0,9999,1
1713302830191,CLRE 253,A00,507199,Vaida; Florin,9997,0,9999,2
1713302830191,CLRE 253,B00,507202,Vaida; Florin,9999,0,9999,0
1713302831216,CLRE 259,A00,507211,Patel; Hemal,9996,0,9999,3
1713302832241,CLRE 260,A00,507221,Cuomo; Raphael Eduardo,9999,0,9999,0
1713302833268,CLRE 297,001,507242,Cuomo; Raphael Eduardo,9999,0,9999,0
1713302834296,CSE 191,A00,516875,Minnes Kemp; Mor Mia,9999,0,9999,0
1713302835323,CSS 201S,A01,494383,Staff,35,0,35,0
1713302836348,CSS 202S,A01,494387,Staff,35,0,35,0
1713302837373,EAP 100,A00,516065,Staff,9792,0,9999,207
1713302838399,ECE 45,A01,507414,Staff,56,0,60,4
1713302839425,ECE 100,A01,507416,Baghdadchi; Saharnaz,12,0,20,8
1713302839425,ECE 100,A02,507418,Baghdadchi; Saharnaz,20,0,20,0
1713302840451,ECE 111,A01,507420,Staff,41,0,50,9
1713302841476,ECE 197,001,548057,Sievenpiper; Daniel F.,9999,0,9999,0
1713302842503,EDS 115,A00,507243,Choi; Bailey Miyeon,28,0,28,0
1713302843530,EDS 117,A01,494379,Staff,25,0,25,0
1713302844558,EDS 125,A00,507246,Hopkins; Megan Beth,29,0,30,1
1713302845586,EDS 128A,A01,507264,Fargason; Sharon Gayle,26,0,26,0
1713302846617,EDS 128B,A01,507293,Pappas; Elizabeth,30,0,30,0
1713302847643,EDS 139,A00,507294,Fargason; Sharon Gayle,30,0,30,0
1713302847643,EDS 139,B00,507313,Pappas; Elizabeth,30,0,30,0
1713302848668,EDS 201,A00,507315,Staff,26,0,30,4
1713302849696,EDS 203,A01,507317,Halter; Christopher P.,26,0,30,4
1713302850727,EDS 204R,A01,507319,Halter; Christopher P.,6,0,30,24
1713302850727,EDS 204R,B01,507331,Heinzman; Erica M.,30,0,30,0
1713302851752,EDS 206R,A00,507332,Staff,8,0,30,22
1713302851752,EDS 206R,B00,507343,Staff,29,0,30,1
1713302852776,EDS 250,A00,507344,Hemans; Patricia Ann Benitez,36,0,40,4
1713302853805,EDS 281,A00,507345,Daly; Alan J.,18,0,18,0
1713302854831,EDS 284,A00,507350,Daly; Alan J.,16,0,16,0
1713302855860,EDS 286,A00,507359,Fine; Sarah,18,0,18,0
1713302856886,EDS 289C,A01,507361,Daly; Alan J.,18,0,18,0
1713302857916,EDS 290,A00,507366,Hofstetter; Carolyn,15,0,15,0
1713302858998,LIGM 5A,A00,507421,Fischer-Grunski; Eva K,20,0,20,0
1713302860061,LIGM 5B,A00,507423,Fischer-Grunski; Eva K,20,0,20,0
1713302861087,LIGM 5C,A00,507425,Fischer-Grunski; Eva K,20,0,20,0
1713302862112,LIIT 5AS,A00,507427,Carnelos; Chiara,20,0,20,0
1713302863143,LIIT 5BS,A00,507430,Carnelos; Chiara,20,0,20,0
1713302864173,LIIT 5CS,A00,507432,Carnelos; Chiara,20,0,20,0
1713302865204,LISP 5A,A00,507541,Munoz Sanchez; Alicia,19,0,20,1
1713302866229,LISP 5B,A00,507671,Munoz Sanchez; Alicia,17,0,20,3
1713302867256,LISP 5C,A00,507696,Munoz Sanchez; Alicia,18,0,20,2
1713302868283,MAE 197,001,528363,Boechler; Nicholas Sebastia,9999,0,9999,0
1713302869313,MATH 197,001,523477,Kedlaya; Kiran S.,9999,0,9999,0
1713302869313,MATH 197,002,563811,Zhang; Danna,9999,0,9999,0
1713302870339,MCWP 40R,A00,518780,Staff,20,0,20,0
1713302870339,MCWP 40R,B00,518781,Staff,20,0,20,0
1713302870339,MCWP 40R,C00,518783,Staff,20,0,20,0
1713302871367,MCWP 50R,A00,518791,Staff,20,0,20,0
1713302871367,MCWP 50R,B00,518792,Staff,20,0,20,0
1713302871367,MCWP 50R,C00,518793,Staff,19,0,20,1
1713302871367,MCWP 50R,D00,518794,Staff,19,0,20,1
1713302871367,MCWP 50R,E00,518795,Staff,19,0,20,1
1713302871367,MCWP 50R,F00,518796,Staff,20,0,20,0
1713302871367,MCWP 50R,G00,518797,Staff,19,0,20,1
1713302872396,MMW 12R,A01,514034,Herbst; Matthew,16,0,16,0
1713302872396,MMW 12R,A02,514035,Herbst; Matthew,16,0,16,0
1713302873422,MMW 13R,A01,514037,Staff,16,0,16,0
1713302873422,MMW 13R,A02,514039,Staff,16,0,16,0
1713302874446,RMED 296,001,626776,Averbach; Sarah Helene,1,0,1,0
1713302875471,SIO 295LS,A00,523233,Staff,19,0,30,11
1713302876497,SIO 295S,A00,523232,Staff,19,0,30,11
1713302877522,SOCI 117,A01,494376,Staff,2,0,5,3
1713302878550,WES 237B,A00,494380,Staff,19,0,20,1
1713302880616,AESE 279B,A00,494370,Wade; Jon P,33,0,33,0
1713302881642,ANAR 135S,A00,494369,Braswell; Geoffrey E.,0,0,0,0
1713302882668,CAT 124RS,A01,519847,Geibel; William,17,0,20,3
1713302883699,CAT 125RS,A01,515971,Geibel; William,17,0,20,3
1713302884728,CLRE 250,A00,511389,Morris; Sheldon,9996,0,9999,3
1713302885756,CLRE 251,A00,507176,Mehta; Ravindra L.,9996,0,9999,3
1713302885756,CLRE 251,B00,511410,Mehta; Ravindra L.,9998,0,9999,1
1713302886786,CLRE 252,A00,507189,Cuomo; Raphael Eduardo,9998,0,9999,1
1713302887813,CLRE 253,A00,507199,Vaida; Florin,9997,0,9999,2
1713302887813,CLRE 253,B00,507202,Vaida; Florin,9999,0,9999,0
1713302888845,CLRE 259,A00,507211,Patel; Hemal,9996,0,9999,3
1713302889874,CLRE 260,A00,507221,Cuomo; Raphael Eduardo,9999,0,9999,0
1713302890900,CLRE 297,001,507242,Cuomo; Raphael Eduardo,9999,0,9999,0
1713302891926,CSE 191,A00,516875,Minnes Kemp; Mor Mia,9999,0,9999,0
1713302892957,CSS 201S,A01,494383,Staff,35,0,35,0
1713302893991,CSS 202S,A01,494387,Staff,35,0,35,0
1713302895017,EAP 100,A00,516065,Staff,9792,0,9999,207
1713302896046,ECE 45,A01,507414,Staff,56,0,60,4
1713302897075,ECE 100,A01,507416,Baghdadchi; Saharnaz,12,0,20,8
1713302897075,ECE 100,A02,507418,Baghdadchi; Saharnaz,20,0,20,0
1713302898099,ECE 111,A01,507420,Staff,41,0,50,9
1713302899125,ECE 197,001,548057,Sievenpiper; Daniel F.,9999,0,9999,0
1713302900156,EDS 115,A00,507243,Choi; Bailey Miyeon,28,0,28,0
1713302901181,EDS 117,A01,494379,Staff,25,0,25,0
1713302902206,EDS 125,A00,507246,Hopkins; Megan Beth,29,0,30,1
1713302903236,EDS 128A,A01,507264,Fargason; Sharon Gayle,26,0,26,0
1713302904259,EDS 128B,A01,507293,Pappas; Elizabeth,30,0,30,0
1713302905284,EDS 139,A00,507294,Fargason; Sharon Gayle,30,0,30,0
1713302905284,EDS 139,B00,507313,Pappas; Elizabeth,30,0,30,0
1713302906308,EDS 201,A00,507315,Staff,26,0,30,4
1713302907343,EDS 203,A01,507317,Halter; Christopher P.,26,0,30,4
1713302908371,EDS 204R,A01,507319,Halter; Christopher P.,6,0,30,24
1713302908371,EDS 204R,B01,507331,Heinzman; Erica M.,30,0,30,0
1713302909396,EDS 206R,A00,507332,Staff,8,0,30,22
1713302909396,EDS 206R,B00,507343,Staff,29,0,30,1
1713302910422,EDS 250,A00,507344,Hemans; Patricia Ann Benitez,36,0,40,4
1713302911450,EDS 281,A00,507345,Daly; Alan J.,18,0,18,0
1713302912474,EDS 284,A00,507350,Daly; Alan J.,16,0,16,0
1713302913498,EDS 286,A00,507359,Fine; Sarah,18,0,18,0
1713302914523,EDS 289C,A01,507361,Daly; Alan J.,18,0,18,0
1713302915548,EDS 290,A00,507366,Hofstetter; Carolyn,15,0,15,0
1713302916574,LIGM 5A,A00,507421,Fischer-Grunski; Eva K,20,0,20,0
1713302917608,LIGM 5B,A00,507423,Fischer-Grunski; Eva K,20,0,20,0
1713302918634,LIGM 5C,A00,507425,Fischer-Grunski; Eva K,20,0,20,0
1713302919661,LIIT 5AS,A00,507427,Carnelos; Chiara,20,0,20,0
1713302920687,LIIT 5BS,A00,507430,Carnelos; Chiara,20,0,20,0
1713302921714,LIIT 5CS,A00,507432,Carnelos; Chiara,20,0,20,0
1713302922741,LISP 5A,A00,507541,Munoz Sanchez; Alicia,19,0,20,1
1713302923767,LISP 5B,A00,507671,Munoz Sanchez; Alicia,17,0,20,3
1713302924792,LISP 5C,A00,507696,Munoz Sanchez; Alicia,18,0,20,2
1713302925820,MAE 197,001,528363,Boechler; Nicholas Sebastia,9999,0,9999,0
1713302926851,MATH 197,001,523477,Kedlaya; Kiran S.,9999,0,9999,0
1713302926851,MATH 197,002,563811,Zhang; Danna,9999,0,9999,0
1713302927876,MCWP 40R,A00,518780,Staff,20,0,20,0
1713302927876,MCWP 40R,B00,518781,Staff,20,0,20,0
1713302927876,MCWP 40R,C00,518783,Staff,20,0,20,0
1713302928901,MCWP 50R,A00,518791,Staff,20,0,20,0
1713302928901,MCWP 50R,B00,518792,Staff,20,0,20,0
1713302928901,MCWP 50R,C00,518793,Staff,19,0,20,1
1713302928901,MCWP 50R,D00,518794,Staff,19,0,20,1
1713302928901,MCWP 50R,E00,518795,Staff,19,0,20,1
1713302928901,MCWP 50R,F00,518796,Staff,20,0,20,0
1713302928901,MCWP 50R,G00,518797,Staff,19,0,20,1
1713302929932,MMW 12R,A01,514034,Herbst; Matthew,16,0,16,0
1713302929932,MMW 12R,A02,514035,Herbst; Matthew,16,0,16,0
1713302930961,MMW 13R,A01,514037,Staff,16,0,16,0
1713302930961,MMW 13R,A02,514039,Staff,16,0,16,0
1713302931987,RMED 296,001,626776,Averbach; Sarah Helene,1,0,1,0
1713302933011,SIO 295LS,A00,523233,Staff,19,0,30,11
1713302934034,SIO 295S,A00,523232,Staff,19,0,30,11
1713302935063,SOCI 117,A01,494376,Staff,2,0,5,3
1713302936092,WES 237B,A00,494380,Staff,19,0,20,1
1713302938154,AESE 279B,A00,494370,Wade; Jon P,33,0,33,0
1713302939180,ANAR 135S,A00,494369,Braswell; Geoffrey E.,0,0,0,0
1713302940210,CAT 124RS,A01,519847,Geibel; William,17,0,20,3
1713302941234,CAT 125RS,A01,515971,Geibel; William,17,0,20,3
1713302942262,CLRE 250,A00,511389,Morris; Sheldon,9996,0,9999,3
1713302943294,CLRE 251,A00,507176,Mehta; Ravindra L.,9996,0,9999,3
1713302943294,CLRE 251,B00,511410,Mehta; Ravindra L.,9998,0,9999,1
1713302944321,CLRE 252,A00,507189,Cuomo; Raphael Eduardo,9998,0,9999,1
1713302945348,CLRE 253,A00,507199,Vaida; Florin,9997,0,9999,2
1713302945348,CLRE 253,B00,507202,Vaida; Florin,9999,0,9999,0
1713302946373,CLRE 259,A00,507211,Patel; Hemal,9996,0,9999,3
1713302947396,CLRE 260,A00,507221,Cuomo; Raphael Eduardo,9999,0,9999,0
1713302948425,CLRE 297,001,507242,Cuomo; Raphael Eduardo,9999,0,9999,0
1713302949452,CSE 191,A00,516875,Minnes Kemp; Mor Mia,9999,0,9999,0
1713302950478,CSS 201S,A01,494383,Staff,35,0,35,0
1713302951506,CSS 202S,A01,494387,Staff,35,0,35,0
1713302952536,EAP 100,A00,516065,Staff,9792,0,9999,207
1713302953562,ECE 45,A01,507414,Staff,56,0,60,4
1713302954589,ECE 100,A01,507416,Baghdadchi; Saharnaz,12,0,20,8
1713302954589,ECE 100,A02,507418,Baghdadchi; Saharnaz,20,0,20,0
1713302955667,ECE 111,A01,507420,Staff,41,0,50,9
1713302956693,ECE 197,001,548057,Sievenpiper; Daniel F.,9999,0,9999,0
1713302957720,EDS 115,A00,507243,Choi; Bailey Miyeon,28,0,28,0
1713302958748,EDS 117,A01,494379,Staff,25,0,25,0
1713302959771,EDS 125,A00,507246,Hopkins; Megan Beth,29,0,30,1
1713302960801,EDS 128A,A01,507264,Fargason; Sharon Gayle,26,0,26,0
1713302961826,EDS 128B,A01,507293,Pappas; Elizabeth,30,0,30,0
1713302962905,EDS 139,A00,507294,Fargason; Sharon Gayle,30,0,30,0
1713302962905,EDS 139,B00,507313,Pappas; Elizabeth,30,0,30,0
1713302963932,EDS 201,A00,507315,Staff,26,0,30,4
1713302964962,EDS 203,A01,507317,Halter; Christopher P.,26,0,30,4
1713302965991,EDS 204R,A01,507319,Halter; Christopher P.,6,0,30,24
1713302965991,EDS 204R,B01,507331,Heinzman; Erica M.,30,0,30,0
1713302967017,EDS 206R,A00,507332,Staff,8,0,30,22
1713302967017,EDS 206R,B00,507343,Staff,29,0,30,1
1713302968041,EDS 250,A00,507344,Hemans; Patricia Ann Benitez,36,0,40,4
1713302969066,EDS 281,A00,507345,Daly; Alan J.,18,0,18,0
1713302970089,EDS 284,A00,507350,Daly; Alan J.,16,0,16,0
1713302971113,EDS 286,A00,507359,Fine; Sarah,18,0,18,0
1713302972137,EDS 289C,A01,507361,Daly; Alan J.,18,0,18,0
1713302973167,EDS 290,A00,507366,Hofstetter; Carolyn,15,0,15,0
1713302974192,LIGM 5A,A00,507421,Fischer-Grunski; Eva K,20,0,20,0
1713302975216,LIGM 5B,A00,507423,Fischer-Grunski; Eva K,20,0,20,0
1713302976240,LIGM 5C,A00,507425,Fischer-Grunski; Eva K,20,0,20,0
1713302977267,LIIT 5AS,A00,507427,Carnelos; Chiara,20,0,20,0
1713302978291,LIIT 5BS,A00,507430,Carnelos; Chiara,20,0,20,0
1713302979316,LIIT 5CS,A00,507432,Carnelos; Chiara,20,0,20,0
1713302980344,LISP 5A,A00,507541,Munoz Sanchez; Alicia,19,0,20,1
1713302981369,LISP 5B,A00,507671,Munoz Sanchez; Alicia,17,0,20,3
1713302982394,LISP 5C,A00,507696,Munoz Sanchez; Alicia,18,0,20,2
1713302983419,MAE 197,001,528363,Boechler; Nicholas Sebastia,9999,0,9999,0
1713302984445,MATH 197,001,523477,Kedlaya; Kiran S.,9999,0,9999,0
1713302984445,MATH 197,002,563811,Zhang; Danna,9999,0,9999,0
1713302985474,MCWP 40R,A00,518780,Staff,20,0,20,0
1713302985474,MCWP 40R,B00,518781,Staff,20,0,20,0
1713302985474,MCWP 40R,C00,518783,Staff,20,0,20,0
1713302986502,MCWP 50R,A00,518791,Staff,20,0,20,0
1713302986502,MCWP 50R,B00,518792,Staff,20,0,20,0
1713302986502,MCWP 50R,C00,518793,Staff,19,0,20,1
1713302986502,MCWP 50R,D00,518794,Staff,19,0,20,1
1713302986502,MCWP 50R,E00,518795,Staff,19,0,20,1
1713302986502,MCWP 50R,F00,518796,Staff,20,0,20,0
1713302986502,MCWP 50R,G00,518797,Staff,19,0,20,1
1713302987527,MMW 12R,A01,514034,Herbst; Matthew,16,0,16,0
1713302987527,MMW 12R,A02,514035,Herbst; Matthew,16,0,16,0
1713302988555,MMW 13R,A01,514037,Staff,16,0,16,0
1713302988555,MMW 13R,A02,514039,Staff,16,0,16,0
1713302989581,RMED 296,001,626776,Averbach; Sarah Helene,1,0,1,0
1713302990611,SIO 295LS,A00,523233,Staff,19,0,30,11
1713302991636,SIO 295S,A00,523232,Staff,19,0,30,11
1713302992661,SOCI 117,A01,494376,Staff,2,0,5,3
1713302993686,WES 237B,A00,494380,Staff,19,0,20,1
1713302995766,AESE 279B,A00,494370,Wade; Jon P,33,0,33,0
1713302996791,ANAR 135S,A00,494369,Braswell; Geoffrey E.,0,0,0,0
1713302997816,CAT 124RS,A01,519847,Geibel; William,17,0,20,3
1713302998847,CAT 125RS,A01,515971,Geibel; William,17,0,20,3
1713302999871,CLRE 250,A00,511389,Morris; Sheldon,9996,0,9999,3
1713303000900,CLRE 251,A00,507176,Mehta; Ravindra L.,9996,0,9999,3
1713303000900,CLRE 251,B00,511410,Mehta; Ravindra L.,9998,0,9999,1
1713303001927,CLRE 252,A00,507189,Cuomo; Raphael Eduardo,9998,0,9999,1
1713303002953,CLRE 253,A00,507199,Vaida; Florin,9997,0,9999,2
1713303002953,CLRE 253,B00,507202,Vaida; Florin,9999,0,9999,0
1713303003978,CLRE 259,A00,507211,Patel; Hemal,9996,0,9999,3
1713303005005,CLRE 260,A00,507221,Cuomo; Raphael Eduardo,9999,0,9999,0
1713303006033,CLRE 297,001,507242,Cuomo; Raphael Eduardo,9999,0,9999,0
1713303007057,CSE 191,A00,516875,Minnes Kemp; Mor Mia,9999,0,9999,0
1713303008083,CSS 201S,A01,494383,Staff,35,0,35,0
1713303009108,CSS 202S,A01,494387,Staff,35,0,35,0
1713303010157,EAP 100,A00,516065,Staff,9792,0,9999,207
1713303011182,ECE 45,A01,507414,Staff,56,0,60,4
1713303012207,ECE 100,A01,507416,Baghdadchi; Saharnaz,12,0,20,8
1713303012207,ECE 100,A02,507418,Baghdadchi; Saharnaz,20,0,20,0
1713303013233,ECE 111,A01,507420,Staff,41,0,50,9
1713303014257,ECE 197,001,548057,Sievenpiper; Daniel F.,9999,0,9999,0
1713303015283,EDS 115,A00,507243,Choi; Bailey Miyeon,28,0,28,0
1713303016308,EDS 117,A01,494379,Staff,25,0,25,0
1713303017334,EDS 125,A00,507246,Hopkins; Megan Beth,29,0,30,1
1713303018363,EDS 128A,A01,507264,Fargason; Sharon Gayle,26,0,26,0
1713303019390,EDS 128B,A01,507293,Pappas; Elizabeth,30,0,30,0
1713303020419,EDS 139,A00,507294,Fargason; Sharon Gayle,30,0,30,0
1713303020419,EDS 139,B00,507313,Pappas; Elizabeth,30,0,30,0
1713303021444,EDS 201,A00,507315,Staff,26,0,30,4
1713303022474,EDS 203,A01,507317,Halter; Christopher P.,26,0,30,4
1713303023499,EDS 204R,A01,507319,Halter; Christopher P.,6,0,30,24
1713303023499,EDS 204R,B01,507331,Heinzman; Erica M.,30,0,30,0
1713303024524,EDS 206R,A00,507332,Staff,8,0,30,22
1713303024524,EDS 206R,B00,507343,Staff,29,0,30,1
1713303025555,EDS 250,A00,507344,Hemans; Patricia Ann Benitez,36,0,40,4
1713303026584,EDS 281,A00,507345,Daly; Alan J.,18,0,18,0
1713303027607,EDS 284,A00,507350,Daly; Alan J.,16,0,16,0
1713303028631,EDS 286,A00,507359,Fine; Sarah,18,0,18,0
1713303029660,EDS 289C,A01,507361,Daly; Alan J.,18,0,18,0
1713303030687,EDS 290,A00,507366,Hofstetter; Carolyn,15,0,15,0
1713303031712,LIGM 5A,A00,507421,Fischer-Grunski; Eva K,20,0,20,0
1713303032736,LIGM 5B,A00,507423,Fischer-Grunski; Eva K,20,0,20,0
1713303033763,LIGM 5C,A00,507425,Fischer-Grunski; Eva K,20,0,20,0
1713303034792,LIIT 5AS,A00,507427,Carnelos; Chiara,20,0,20,0
1713303035821,LIIT 5BS,A00,507430,Carnelos; Chiara,20,0,20,0
1713303036852,LIIT 5CS,A00,507432,Carnelos; Chiara,20,0,20,0
1713303037879,LISP 5A,A00,507541,Munoz Sanchez; Alicia,19,0,20,1
1713303038904,LISP 5B,A00,507671,Munoz Sanchez; Alicia,17,0,20,3
1713303039929,LISP 5C,A00,507696,Munoz Sanchez; Alicia,18,0,20,2
1713303040958,MAE 197,001,528363,Boechler; Nicholas Sebastia,9999,0,9999,0
1713303041985,MATH 197,001,523477,Kedlaya; Kiran S.,9999,0,9999,0
1713303041985,MATH 197,002,563811,Zhang; Danna,9999,0,9999,0
1713303043013,MCWP 40R,A00,518780,Staff,20,0,20,0
1713303043013,MCWP 40R,B00,518781,Staff,20,0,20,0
1713303043013,MCWP 40R,C00,518783,Staff,20,0,20,0
1713303044042,MCWP 50R,A00,518791,Staff,20,0,20,0
1713303044042,MCWP 50R,B00,518792,Staff,20,0,20,0
1713303044042,MCWP 50R,C00,518793,Staff,19,0,20,1
1713303044042,MCWP 50R,D00,518794,Staff,19,0,20,1
1713303044042,MCWP 50R,E00,518795,Staff,19,0,20,1
1713303044042,MCWP 50R,F00,518796,Staff,20,0,20,0
1713303044042,MCWP 50R,G00,518797,Staff,19,0,20,1
1713303045069,MMW 12R,A01,514034,Herbst; Matthew,16,0,16,0
1713303045069,MMW 12R,A02,514035,Herbst; Matthew,16,0,16,0
1713303046095,MMW 13R,A01,514037,Staff,16,0,16,0
1713303046095,MMW 13R,A02,514039,Staff,16,0,16,0
1713303047119,RMED 296,001,626776,Averbach; Sarah Helene,1,0,1,0
1713303048148,SIO 295LS,A00,523233,Staff,19,0,30,11
1713303049181,SIO 295S,A00,523232,Staff,19,0,30,11
1713303050206,SOCI 117,A01,494376,Staff,2,0,5,3
1713303051230,WES 237B,A00,494380,Staff,19,0,20,1
1713303053297,AESE 279B,A00,494370,Wade; Jon P,33,0,33,0
1713303054325,ANAR 135S,A00,494369,Braswell; Geoffrey E.,0,0,0,0
1713303055353,CAT 124RS,A01,519847,Geibel; William,17,0,20,3
1713303056377,CAT 125RS,A01,515971,Geibel; William,17,0,20,3
1713303057408,CLRE 250,A00,511389,Morris; Sheldon,9996,0,9999,3
1713303058437,CLRE 251,A00,507176,Mehta; Ravindra L.,9996,0,9999,3
1713303058437,CLRE 251,B00,511410,Mehta; Ravindra L.,9998,0,9999,1
1713303059462,CLRE 252,A00,507189,Cuomo; Raphael Eduardo,9998,0,9999,1
1713303060486,CLRE 253,A00,507199,Vaida; Florin,9997,0,9999,2
1713303060486,CLRE 253,B00,507202,Vaida; Florin,9999,0,9999,0
1713303061516,CLRE 259,A00,507211,Patel; Hemal,9996,0,9999,3
1713303062546,CLRE 260,A00,507221,Cuomo; Raphael Eduardo,9999,0,9999,0
1713303063577,CLRE 297,001,507242,Cuomo; Raphael Eduardo,9999,0,9999,0
1713303064606,CSE 191,A00,516875,Minnes Kemp; Mor Mia,9999,0,9999,0
1713303065633,CSS 201S,A01,494383,Staff,35,0,35,0
1713303066717,CSS 202S,A01,494387,Staff,35,0,35,0
1713303067747,EAP 100,A00,516065,Staff,9792,0,9999,207
1713303068783,ECE 45,A01,507414,Staff,56,0,60,4
1713303069809,ECE 100,A01,507416,Baghdadchi; Saharnaz,12,0,20,8
1713303069809,ECE 100,A02,507418,Baghdadchi; Saharnaz,20,0,20,0
1713303070834,ECE 111,A01,507420,Staff,41,0,50,9
1713303071859,ECE 197,001,548057,Sievenpiper; Daniel F.,9999,0,9999,0
1713303072884,EDS 115,A00,507243,Choi; Bailey Miyeon,28,0,28,0
1713303073909,EDS 117,A01,494379,Staff,25,0,25,0
1713303074935,EDS 125,A00,507246,Hopkins; Megan Beth,29,0,30,1
1713303075966,EDS 128A,A01,507264,Fargason; Sharon Gayle,26,0,26,0
1713303076995,EDS 128B,A01,507293,Pappas; Elizabeth,30,0,30,0
1713303078023,EDS 139,A00,507294,Fargason; Sharon Gayle,30,0,30,0
1713303078023,EDS 139,B00,507313,Pappas; Elizabeth,30,0,30,0
1713303079051,EDS 201,A00,507315,Staff,26,0,30,4
1713303080078,EDS 203,A01,507317,Halter; Christopher P.,26,0,30,4
1713303081107,EDS 204R,A01,507319,Halter; Christopher P.,6,0,30,24
1713303081107,EDS 204R,B01,507331,Heinzman; Erica M.,30,0,30,0
1713303082132,EDS 206R,A00,507332,Staff,8,0,30,22
1713303082132,EDS 206R,B00,507343,Staff,29,0,30,1
1713303083158,EDS 250,A00,507344,Hemans; Patricia Ann Benitez,36,0,40,4
1713303084183,EDS 281,A00,507345,Daly; Alan J.,18,0,18,0
1713303085207,EDS 284,A00,507350,Daly; Alan J.,16,0,16,0
1713303086234,EDS 286,A00,507359,Fine; Sarah,18,0,18,0
1713303087258,EDS 289C,A01,507361,Daly; Alan J.,18,0,18,0
1713303088281,EDS 290,A00,507366,Hofstetter; Carolyn,15,0,15,0
1713303089308,LIGM 5A,A00,507421,Fischer-Grunski; Eva K,20,0,20,0
1713303090333,LIGM 5B,A00,507423,Fischer-Grunski; Eva K,20,0,20,0
1713303091362,LIGM 5C,A00,507425,Fischer-Grunski; Eva K,20,0,20,0
1713303092390,LIIT 5AS,A00,507427,Carnelos; Chiara,20,0,20,0
1713303093421,LIIT 5BS,A00,507430,Carnelos; Chiara,20,0,20,0
1713303094447,LIIT 5CS,A00,507432,Carnelos; Chiara,20,0,20,0
1713303095471,LISP 5A,A00,507541,Munoz Sanchez; Alicia,19,0,20,1
1713303096502,LISP 5B,A00,507671,Munoz Sanchez; Alicia,17,0,20,3
1713303097531,LISP 5C,A00,507696,Munoz Sanchez; Alicia,18,0,20,2
1713303098559,MAE 197,001,528363,Boechler; Nicholas Sebastia,9999,0,9999,0
1713303099586,MATH 197,001,523477,Kedlaya; Kiran S.,9999,0,9999,0
1713303099586,MATH 197,002,563811,Zhang; Danna,9999,0,9999,0
1713303100616,MCWP 40R,A00,518780,Staff,20,0,20,0
1713303100616,MCWP 40R,B00,518781,Staff,20,0,20,0
1713303100616,MCWP 40R,C00,518783,Staff,20,0,20,0
1713303101646,MCWP 50R,A00,518791,Staff,20,0,20,0
1713303101646,MCWP 50R,B00,518792,Staff,20,0,20,0
1713303101646,MCWP 50R,C00,518793,Staff,19,0,20,1
1713303101646,MCWP 50R,D00,518794,Staff,19,0,20,1
1713303101646,MCWP 50R,E00,518795,Staff,19,0,20,1
1713303101646,MCWP 50R,F00,518796,Staff,20,0,20,0
1713303101646,MCWP 50R,G00,518797,Staff,19,0,20,1
1713303102671,MMW 12R,A01,514034,Herbst; Matthew,16,0,16,0
1713303102671,MMW 12R,A02,514035,Herbst; Matthew,16,0,16,0
1713303103699,MMW 13R,A01,514037,Staff,16,0,16,0
1713303103699,MMW 13R,A02,514039,Staff,16,0,16,0
1713303104726,RMED 296,001,626776,Averbach; Sarah Helene,1,0,1,0
1713303105751,SIO 295LS,A00,523233,Staff,19,0,30,11
1713303106776,SIO 295S,A00,523232,Staff,19,0,30,11
1713303107804,SOCI 117,A01,494376,Staff,2,0,5,3
1713303108831,WES 237B,A00,494380,Staff,19,0,20,1
1713303110895,AESE 279B,A00,494370,Wade; Jon P,33,0,33,0
1713303111921,ANAR 135S,A00,494369,Braswell; Geoffrey E.,0,0,0,0
1713303112953,CAT 124RS,A01,519847,Geibel; William,17,0,20,3
1713303113983,CAT 125RS,A01,515971,Geibel; William,17,0,20,3
1713303115011,CLRE 250,A00,511389,Morris; Sheldon,9996,0,9999,3
1713303116043,CLRE 251,A00,507176,Mehta; Ravindra L.,9996,0,9999,3
1713303116043,CLRE 251,B00,511410,Mehta; Ravindra L.,9998,0,9999,1
1713303117066,CLRE 252,A00,507189,Cuomo; Raphael Eduardo,9998,0,9999,1
1713303118091,CLRE 253,A00,507199,Vaida; Florin,9997,0,9999,2
1713303118091,CLRE 253,B00,507202,Vaida; Florin,9999,0,9999,0
1713303119117,CLRE 259,A00,507211,Patel; Hemal,9996,0,9999,3
1713303120146,CLRE 260,A00,507221,Cuomo; Raphael Eduardo,9999,0,9999,0
1713303121175,CLRE 297,001,507242,Cuomo; Raphael Eduardo,9999,0,9999,0
1713303122203,CSE 191,A00,516875,Minnes Kemp; Mor Mia,9999,0,9999,0
1713303123228,CSS 201S,A01,494383,Staff,35,0,35,0
1713303124258,CSS 202S,A01,494387,Staff,35,0,35,0
1713303125283,EAP 100,A00,516065,Staff,9792,0,9999,207
1713303126314,ECE 45,A01,507414,Staff,56,0,60,4
1713303127339,ECE 100,A01,507416,Baghdadchi; Saharnaz,12,0,20,8
1713303127339,ECE 100,A02,507418,Baghdadchi; Saharnaz,20,0,20,0
1713303128363,ECE 111,A01,507420,Staff,41,0,50,9
1713303129386,ECE 197,001,548057,Sievenpiper; Daniel F.,9999,0,9999,0
1713303130413,EDS 115,A00,507243,Choi; Bailey Miyeon,28,0,28,0
1713303131439,EDS 117,A01,494379,Staff,25,0,25,0
1713303132465,EDS 125,A00,507246,Hopkins; Megan Beth,29,0,30,1
1713303133490,EDS 128A,A01,507264,Fargason; Sharon Gayle,26,0,26,0
1713303134515,EDS 128B,A01,507293,Pappas; Elizabeth,30,0,30,0
1713303135540,EDS 139,A00,507294,Fargason; Sharon Gayle,30,0,30,0
1713303135540,EDS 139,B00,507313,Pappas; Elizabeth,30,0,30,0
1713303136568,EDS 201,A00,507315,Staff,26,0,30,4
1713303137596,EDS 203,A01,507317,Halter; Christopher P.,26,0,30,4
1713303138621,EDS 204R,A01,507319,Halter; Christopher P.,6,0,30,24
1713303138621,EDS 204R,B01,507331,Heinzman; Erica M.,30,0,30,0
1713303139649,EDS 206R,A00,507332,Staff,8,0,30,22
1713303139649,EDS 206R,B00,507343,Staff,29,0,30,1
1713303140675,EDS 250,A00,507344,Hemans; Patricia Ann Benitez,36,0,40,4
1713303141713,EDS 281,A00,507345,Daly; Alan J.,18,0,18,0
1713303142740,EDS 284,A00,507350,Daly; Alan J.,16,0,16,0
1713303143770,EDS 286,A00,507359,Fine; Sarah,18,0,18,0
1713303144795,EDS 289C,A01,507361,Daly; Alan J.,18,0,18,0
1713303145821,EDS 290,A00,507366,Hofstetter; Carolyn,15,0,15,0
1713303146853,LIGM 5A,A00,507421,Fischer-Grunski; Eva K,20,0,20,0
1713303147876,LIGM 5B,A00,507423,Fischer-Grunski; Eva K,20,0,20,0
1713303148901,LIGM 5C,A00,507425,Fischer-Grunski; Eva K,20,0,20,0
1713303149927,LIIT 5AS,A00,507427,Carnelos; Chiara,20,0,20,0
1713303150952,LIIT 5BS,A00,507430,Carnelos; Chiara,20,0,20,0
1713303151983,LIIT 5CS,A00,507432,Carnelos; Chiara,20,0,20,0
1713303153010,LISP 5A,A00,507541,Munoz Sanchez; Alicia,19,0,20,1
1713303154036,LISP 5B,A00,507671,Munoz Sanchez; Alicia,17,0,20,3
1713303155063,LISP 5C,A00,507696,Munoz Sanchez; Alicia,18,0,20,2
1713303156089,MAE 197,001,528363,Boechler; Nicholas Sebastia,9999,0,9999,0
1713303157114,MATH 197,001,523477,Kedlaya; Kiran S.,9999,0,9999,0
1713303157114,MATH 197,002,563811,Zhang; Danna,9999,0,9999,0
1713303158142,MCWP 40R,A00,518780,Staff,20,0,20,0
1713303158142,MCWP 40R,B00,518781,Staff,20,0,20,0
1713303158142,MCWP 40R,C00,518783,Staff,20,0,20,0
1713303159170,MCWP 50R,A00,518791,Staff,20,0,20,0
1713303159170,MCWP 50R,B00,518792,Staff,20,0,20,0
1713303159170,MCWP 50R,C00,518793,Staff,19,0,20,1
1713303159170,MCWP 50R,D00,518794,Staff,19,0,20,1
1713303159170,MCWP 50R,E00,518795,Staff,19,0,20,1
1713303159170,MCWP 50R,F00,518796,Staff,20,0,20,0
1713303159170,MCWP 50R,G00,518797,Staff,19,0,20,1
1713303160194,MMW 12R,A01,514034,Herbst; Matthew,16,0,16,0
1713303160194,MMW 12R,A02,514035,Herbst; Matthew,16,0,16,0
1713303161222,MMW 13R,A01,514037,Staff,16,0,16,0
1713303161222,MMW 13R,A02,514039,Staff,16,0,16,0
1713303162245,RMED 296,001,626776,Averbach; Sarah Helene,1,0,1,0
1713303163271,SIO 295LS,A00,523233,Staff,19,0,30,11
1713303164297,SIO 295S,A00,523232,Staff,19,0,30,11
1713303165324,SOCI 117,A01,494376,Staff,2,0,5,3
1713303166350,WES 237B,A00,494380,Staff,19,0,20,1
1713303168428,AESE 279B,A00,494370,Wade; Jon P,33,0,33,0
1713303169452,ANAR 135S,A00,494369,Braswell; Geoffrey E.,0,0,0,0
1713303170532,CAT 124RS,A01,519847,Geibel; William,17,0,20,3
1713303171560,CAT 125RS,A01,515971,Geibel; William,17,0,20,3
1713303172589,CLRE 250,A00,511389,Morris; Sheldon,9996,0,9999,3
1713303173616,CLRE 251,A00,507176,Mehta; Ravindra L.,9996,0,9999,3
1713303173616,CLRE 251,B00,511410,Mehta; Ravindra L.,9998,0,9999,1
1713303174642,CLRE 252,A00,507189,Cuomo; Raphael Eduardo,9998,0,9999,1
1713303175667,CLRE 253,A00,507199,Vaida; Florin,9997,0,9999,2
1713303175667,CLRE 253,B00,507202,Vaida; Florin,9999,0,9999,0
1713303176692,CLRE 259,A00,507211,Patel; Hemal,9996,0,9999,3
1713303177718,CLRE 260,A00,507221,Cuomo; Raphael Eduardo,9999,0,9999,0
1713303178743,CLRE 297,001,507242,Cuomo; Raphael Eduardo,9999,0,9999,0
1713303179767,CSE 191,A00,516875,Minnes Kemp; Mor Mia,9999,0,9999,0
1713303180793,CSS 201S,A01,494383,Staff,35,0,35,0
1713303181817,CSS 202S,A01,494387,Staff,35,0,35,0
1713303182843,EAP 100,A00,516065,Staff,9792,0,9999,207
1713303183868,ECE 45,A01,507414,Staff,56,0,60,4
1713303184897,ECE 100,A01,507416,Baghdadchi; Saharnaz,12,0,20,8
1713303184897,ECE 100,A02,507418,Baghdadchi; Saharnaz,20,0,20,0
1713303185926,ECE 111,A01,507420,Staff,41,0,50,9
1713303186953,ECE 197,001,548057,Sievenpiper; Daniel F.,9999,0,9999,0
1713303187981,EDS 115,A00,507243,Choi; Bailey Miyeon,28,0,28,0
1713303189009,EDS 117,A01,494379,Staff,25,0,25,0
1713303190034,EDS 125,A00,507246,Hopkins; Megan Beth,29,0,30,1
1713303191063,EDS 128A,A01,507264,Fargason; Sharon Gayle,26,0,26,0
1713303192089,EDS 128B,A01,507293,Pappas; Elizabeth,30,0,30,0
1713303193116,EDS 139,A00,507294,Fargason; Sharon Gayle,30,0,30,0
1713303193116,EDS 139,B00,507313,Pappas; Elizabeth,30,0,30,0
1713303194141,EDS 201,A00,507315,Staff,26,0,30,4
1713303195167,EDS 203,A01,507317,Halter; Christopher P.,26,0,30,4
1713303196196,EDS 204R,A01,507319,Halter; Christopher P.,6,0,30,24
1713303196196,EDS 204R,B01,507331,Heinzman; Erica M.,30,0,30,0
1713303197223,EDS 206R,A00,507332,Staff,8,0,30,22
1713303197223,EDS 206R,B00,507343,Staff,29,0,30,1
1713303198249,EDS 250,A00,507344,Hemans; Patricia Ann Benitez,36,0,40,4
1713303199274,EDS 281,A00,507345,Daly; Alan J.,18,0,18,0
1713303200300,EDS 284,A00,507350,Daly; Alan J.,16,0,16,0
1713303201325,EDS 286,A00,507359,Fine; Sarah,18,0,18,0
1713303202359,EDS 289C,A01,507361,Daly; Alan J.,18,0,18,0
1713303203390,EDS 290,A00,507366,Hofstetter; Carolyn,15,0,15,0
1713303204419,LIGM 5A,A00,507421,Fischer-Grunski; Eva K,20,0,20,0
1713303205447,LIGM 5B,A00,507423,Fischer-Grunski; Eva K,20,0,20,0
1713303206472,LIGM 5C,A00,507425,Fischer-Grunski; Eva K,20,0,20,0
1713303207496,LIIT 5AS,A00,507427,Carnelos; Chiara,20,0,20,0
1713303208521,LIIT 5BS,A00,507430,Carnelos; Chiara,20,0,20,0
1713303209551,LIIT 5CS,A00,507432,Carnelos; Chiara,20,0,20,0
1713303210578,LISP 5A,A00,507541,Munoz Sanchez; Alicia,19,0,20,1
1713303211603,LISP 5B,A00,507671,Munoz Sanchez; Alicia,17,0,20,3
1713303212632,LISP 5C,A00,507696,Munoz Sanchez; Alicia,18,0,20,2
1713303213659,MAE 197,001,528363,Boechler; Nicholas Sebastia,9999,0,9999,0
1713303214684,MATH 197,001,523477,Kedlaya; Kiran S.,9999,0,9999,0
1713303214684,MATH 197,002,563811,Zhang; Danna,9999,0,9999,0
1713303215710,MCWP 40R,A00,518780,Staff,20,0,20,0
1713303215710,MCWP 40R,B00,518781,Staff,20,0,20,0
1713303215710,MCWP 40R,C00,518783,Staff,20,0,20,0
1713303216736,MCWP 50R,A00,518791,Staff,20,0,20,0
1713303216736,MCWP 50R,B00,518792,Staff,20,0,20,0
1713303216736,MCWP 50R,C00,518793,Staff,19,0,20,1
1713303216736,MCWP 50R,D00,518794,Staff,19,0,20,1
1713303216736,MCWP 50R,E00,518795,Staff,19,0,20,1
1713303216736,MCWP 50R,F00,518796,Staff,20,0,20,0
1713303216736,MCWP 50R,G00,518797,Staff,19,0,20,1
1713303217763,MMW 12R,A01,514034,Herbst; Matthew,16,0,16,0
1713303217763,MMW 12R,A02,514035,Herbst; Matthew,16,0,16,0
1713303218787,MMW 13R,A01,514037,Staff,16,0,16,0
1713303218787,MMW 13R,A02,514039,Staff,16,0,16,0
1713303219817,RMED 296,001,626776,Averbach; Sarah Helene,1,0,1,0
1713303220843,SIO 295LS,A00,523233,Staff,19,0,30,11
1713303221869,SIO 295S,A00,523232,Staff,19,0,30,11
1713303222896,SOCI 117,A01,494376,Staff,2,0,5,3
1713303223924,WES 237B,A00,494380,Staff,19,0,20,1
1713303226002,AESE 279B,A00,494370,Wade; Jon P,33,0,33,0
1713303227029,ANAR 135S,A00,494369,Braswell; Geoffrey E.,0,0,0,0
1713303228054,CAT 124RS,A01,519847,Geibel; William,17,0,20,3
1713303229082,CAT 125RS,A01,515971,Geibel; William,17,0,20,3
1713303230107,CLRE 250,A00,511389,Morris; Sheldon,9996,0,9999,3
1713303231138,CLRE 251,A00,507176,Mehta; Ravindra L.,9996,0,9999,3
1713303231138,CLRE 251,B00,511410,Mehta; Ravindra L.,9998,0,9999,1
1713303232166,CLRE 252,A00,507189,Cuomo; Raphael Eduardo,9998,0,9999,1
1713303233194,CLRE 253,A00,507199,Vaida; Florin,9997,0,9999,2
1713303233194,CLRE 253,B00,507202,Vaida; Florin,9999,0,9999,0
1713303234218,CLRE 259,A00,507211,Patel; Hemal,9996,0,9999,3
1713303235243,CLRE 260,A00,507221,Cuomo; Raphael Eduardo,9999,0,9999,0
1713303236271,CLRE 297,001,507242,Cuomo; Raphael Eduardo,9999,0,9999,0
1713303237298,CSE 191,A00,516875,Minnes Kemp; Mor Mia,9999,0,9999,0
1713303238325,CSS 201S,A01,494383,Staff,35,0,35,0
1713303239350,CSS 202S,A01,494387,Staff,35,0,35,0
1713303240375,EAP 100,A00,516065,Staff,9792,0,9999,207
1713303241402,ECE 45,A01,507414,Staff,56,0,60,4
1713303242428,ECE 100,A01,507416,Baghdadchi; Saharnaz,12,0,20,8
1713303242428,ECE 100,A02,507418,Baghdadchi; Saharnaz,20,0,20,0
1713303243465,ECE 111,A01,507420,Staff,41,0,50,9
1713303244494,ECE 197,001,548057,Sievenpiper; Daniel F.,9999,0,9999,0
1713303245525,EDS 115,A00,507243,Choi; Bailey Miyeon,28,0,28,0
1713303246550,EDS 117,A01,494379,Staff,25,0,25,0
1713303247576,EDS 125,A00,507246,Hopkins; Megan Beth,29,0,30,1
1713303248601,EDS 128A,A01,507264,Fargason; Sharon Gayle,26,0,26,0
1713303249627,EDS 128B,A01,507293,Pappas; Elizabeth,30,0,30,0
1713303250656,EDS 139,A00,507294,Fargason; Sharon Gayle,30,0,30,0
1713303250656,EDS 139,B00,507313,Pappas; Elizabeth,30,0,30,0
1713303251681,EDS 201,A00,507315,Staff,26,0,30,4
1713303252712,EDS 203,A01,507317,Halter; Christopher P.,26,0,30,4
1713303253743,EDS 204R,A01,507319,Halter; Christopher P.,6,0,30,24
1713303253743,EDS 204R,B01,507331,Heinzman; Erica M.,30,0,30,0
1713303254768,EDS 206R,A00,507332,Staff,8,0,30,22
1713303254768,EDS 206R,B00,507343,Staff,29,0,30,1
1713303255796,EDS 250,A00,507344,Hemans; Patricia Ann Benitez,36,0,40,4
1713303256821,EDS 281,A00,507345,Daly; Alan J.,18,0,18,0
1713303257845,EDS 284,A00,507350,Daly; Alan J.,16,0,16,0
1713303258874,EDS 286,A00,507359,Fine; Sarah,18,0,18,0
1713303259899,EDS 289C,A01,507361,Daly; Alan J.,18,0,18,0
1713303260925,EDS 290,A00,507366,Hofstetter; Carolyn,15,0,15,0
1713303261951,LIGM 5A,A00,507421,Fischer-Grunski; Eva K,20,0,20,0
1713303262981,LIGM 5B,A00,507423,Fischer-Grunski; Eva K,20,0,20,0
1713303264006,LIGM 5C,A00,507425,Fischer-Grunski; Eva K,20,0,20,0
1713303265036,LIIT 5AS,A00,507427,Carnelos; Chiara,20,0,20,0
1713303266062,LIIT 5BS,A00,507430,Carnelos; Chiara,20,0,20,0
1713303267091,LIIT 5CS,A00,507432,Carnelos; Chiara,20,0,20,0
1713303268121,LISP 5A,A00,507541,Munoz Sanchez; Alicia,19,0,20,1
1713303269147,LISP 5B,A00,507671,Munoz Sanchez; Alicia,17,0,20,3
1713303270179,LISP 5C,A00,507696,Munoz Sanchez; Alicia,18,0,20,2
1713303271205,MAE 197,001,528363,Boechler; Nicholas Sebastia,9999,0,9999,0
1713303272231,MATH 197,001,523477,Kedlaya; Kiran S.,9999,0,9999,0
1713303272231,MATH 197,002,563811,Zhang; Danna,9999,0,9999,0
1713303273257,MCWP 40R,A00,518780,Staff,20,0,20,0
1713303273257,MCWP 40R,B00,518781,Staff,20,0,20,0
1713303273257,MCWP 40R,C00,518783,Staff,20,0,20,0
1713303274340,MCWP 50R,A00,518791,Staff,20,0,20,0
1713303274340,MCWP 50R,B00,518792,Staff,20,0,20,0
1713303274340,MCWP 50R,C00,518793,Staff,19,0,20,1
1713303274340,MCWP 50R,D00,518794,Staff,19,0,20,1
1713303274340,MCWP 50R,E00,518795,Staff,19,0,20,1
1713303274340,MCWP 50R,F00,518796,Staff,20,0,20,0
1713303274340,MCWP 50R,G00,518797,Staff,19,0,20,1
1713303275366,MMW 12R,A01,514034,Herbst; Matthew,16,0,16,0
1713303275366,MMW 12R,A02,514035,Herbst; Matthew,16,0,16,0
1713303276394,MMW 13R,A01,514037,Staff,16,0,16,0
1713303276394,MMW 13R,A02,514039,Staff,16,0,16,0
1713303277422,RMED 296,001,626776,Averbach; Sarah Helene,1,0,1,0
1713303278449,SIO 295LS,A00,523233,Staff,19,0,30,11
1713303279474,SIO 295S,A00,523232,Staff,19,0,30,11
1713303280503,SOCI 117,A01,494376,Staff,2,0,5,3
1713303281532,WES 237B,A00,494380,Staff,19,0,20,1
1713303283594,AESE 279B,A00,494370,Wade; Jon P,33,0,33,0
1713303284619,ANAR 135S,A00,494369,Braswell; Geoffrey E.,0,0,0,0
1713303285648,CAT 124RS,A01,519847,Geibel; William,17,0,20,3
1713303286672,CAT 125RS,A01,515971,Geibel; William,17,0,20,3
1713303287702,CLRE 250,A00,511389,Morris; Sheldon,9996,0,9999,3
1713303288727,CLRE 251,A00,507176,Mehta; Ravindra L.,9996,0,9999,3
1713303288727,CLRE 251,B00,511410,Mehta; Ravindra L.,9998,0,9999,1
1713303289752,CLRE 252,A00,507189,Cuomo; Raphael Eduardo,9998,0,9999,1
1713303290801,CLRE 253,A00,507199,Vaida; Florin,9997,0,9999,2
1713303290801,CLRE 253,B00,507202,Vaida; Florin,9999,0,9999,0
1713303291826,CLRE 259,A00,507211,Patel; Hemal,9996,0,9999,3
1713303292855,CLRE 260,A00,507221,Cuomo; Raphael Eduardo,9999,0,9999,0
1713303293891,CLRE 297,001,507242,Cuomo; Raphael Eduardo,9999,0,9999,0
1713303294917,CSE 191,A00,516875,Minnes Kemp; Mor Mia,9999,0,9999,0
1713303295946,CSS 201S,A01,494383,Staff,35,0,35,0
1713303296972,CSS 202S,A01,494387,Staff,35,0,35,0
1713303298000,EAP 100,A00,516065,Staff,9792,0,9999,207
1713303299026,ECE 45,A01,507414,Staff,56,0,60,4
1713303300060,ECE 100,A01,507416,Baghdadchi; Saharnaz,12,0,20,8
1713303300060,ECE 100,A02,507418,Baghdadchi; Saharnaz,20,0,20,0
1713303301085,ECE 111,A01,507420,Staff,41,0,50,9
1713303302113,ECE 197,001,548057,Sievenpiper; Daniel F.,9999,0,9999,0
1713303303142,EDS 115,A00,507243,Choi; Bailey Miyeon,28,0,28,0
1713303304170,EDS 117,A01,494379,Staff,25,0,25,0
1713303305195,EDS 125,A00,507246,Hopkins; Megan Beth,29,0,30,1
1713303306221,EDS 128A,A01,507264,Fargason; Sharon Gayle,26,0,26,0
1713303307260,EDS 128B,A01,507293,Pappas; Elizabeth,30,0,30,0
1713303308284,EDS 139,A00,507294,Fargason; Sharon Gayle,30,0,30,0
1713303308284,EDS 139,B00,507313,Pappas; Elizabeth,30,0,30,0
1713303309309,EDS 201,A00,507315,Staff,26,0,30,4
1713303310338,EDS 203,A01,507317,Halter; Christopher P.,26,0,30,4
1713303311365,EDS 204R,A01,507319,Halter; Christopher P.,6,0,30,24
1713303311365,EDS 204R,B01,507331,Heinzman; Erica M.,30,0,30,0
1713303312395,EDS 206R,A00,507332,Staff,8,0,30,22
1713303312395,EDS 206R,B00,507343,Staff,29,0,30,1
1713303313421,EDS 250,A00,507344,Hemans; Patricia Ann Benitez,36,0,40,4
1713303314446,EDS 281,A00,507345,Daly; Alan J.,18,0,18,0
1713303315470,EDS 284,A00,507350,Daly; Alan J.,16,0,16,0
1713303316494,EDS 286,A00,507359,Fine; Sarah,18,0,18,0
1713303317522,EDS 289C,A01,507361,Daly; Alan J.,18,0,18,0
1713303318547,EDS 290,A00,507366,Hofstetter; Carolyn,15,0,15,0
1713303319585,LIGM 5A,A00,507421,Fischer-Grunski; Eva K,20,0,20,0
1713303320613,LIGM 5B,A00,507423,Fischer-Grunski; Eva K,20,0,20,0
1713303321639,LIGM 5C,A00,507425,Fischer-Grunski; Eva K,20,0,20,0
1713303322664,LIIT 5AS,A00,507427,Carnelos; Chiara,20,0,20,0
1713303323688,LIIT 5BS,A00,507430,Carnelos; Chiara,20,0,20,0
1713303324716,LIIT 5CS,A00,507432,Carnelos; Chiara,20,0,20,0
1713303325742,LISP 5A,A00,507541,Munoz Sanchez; Alicia,19,0,20,1
1713303326768,LISP 5B,A00,507671,Munoz Sanchez; Alicia,17,0,20,3
1713303327795,LISP 5C,A00,507696,Munoz Sanchez; Alicia,18,0,20,2
1713303328820,MAE 197,001,528363,Boechler; Nicholas Sebastia,9999,0,9999,0
1713303329846,MATH 197,001,523477,Kedlaya; Kiran S.,9999,0,9999,0
1713303329846,MATH 197,002,563811,Zhang; Danna,9999,0,9999,0
1713303330874,MCWP 40R,A00,518780,Staff,20,0,20,0
1713303330874,MCWP 40R,B00,518781,Staff,20,0,20,0
1713303330874,MCWP 40R,C00,518783,Staff,20,0,20,0
1713303331905,MCWP 50R,A00,518791,Staff,20,0,20,0
1713303331905,MCWP 50R,B00,518792,Staff,20,0,20,0
1713303331905,MCWP 50R,C00,518793,Staff,19,0,20,1
1713303331905,MCWP 50R,D00,518794,Staff,19,0,20,1
1713303331905,MCWP 50R,E00,518795,Staff,19,0,20,1
1713303331905,MCWP 50R,F00,518796,Staff,20,0,20,0
1713303331905,MCWP 50R,G00,518797,Staff,19,0,20,1
1713303332933,MMW 12R,A01,514034,Herbst; Matthew,16,0,16,0
1713303332933,MMW 12R,A02,514035,Herbst; Matthew,16,0,16,0
1713303333962,MMW 13R,A01,514037,Staff,16,0,16,0
1713303333962,MMW 13R,A02,514039,Staff,16,0,16,0
1713303334991,RMED 296,001,626776,Averbach; Sarah Helene,1,0,1,0
1713303336016,SIO 295LS,A00,523233,Staff,19,0,30,11
1713303337042,SIO 295S,A00,523232,Staff,19,0,30,11
1713303338069,SOCI 117,A01,494376,Staff,2,0,5,3
1713303339098,WES 237B,A00,494380,Staff,19,0,20,1
1713303341177,AESE 279B,A00,494370,Wade; Jon P,33,0,33,0
1713303342203,ANAR 135S,A00,494369,Braswell; Geoffrey E.,0,0,0,0
1713303343233,CAT 124RS,A01,519847,Geibel; William,17,0,20,3
1713303344258,CAT 125RS,A01,515971,Geibel; William,17,0,20,3
1713303345282,CLRE 250,A00,511389,Morris; Sheldon,9996,0,9999,3
1713303346309,CLRE 251,A00,507176,Mehta; Ravindra L.,9996,0,9999,3
1713303346309,CLRE 251,B00,511410,Mehta; Ravindra L.,9998,0,9999,1
1713303347335,CLRE 252,A00,507189,Cuomo; Raphael Eduardo,9998,0,9999,1
1713303348359,CLRE 253,A00,507199,Vaida; Florin,9997,0,9999,2
1713303348359,CLRE 253,B00,507202,Vaida; Florin,9999,0,9999,0
1713303349385,CLRE 259,A00,507211,Patel; Hemal,9996,0,9999,3
1713303350414,CLRE 260,A00,507221,Cuomo; Raphael Eduardo,9999,0,9999,0
1713303351440,CLRE 297,001,507242,Cuomo; Raphael Eduardo,9999,0,9999,0
1713303352469,CSE 191,A00,516875,Minnes Kemp; Mor Mia,9999,0,9999,0
1713303353496,CSS 201S,A01,494383,Staff,35,0,35,0
1713303354521,CSS 202S,A01,494387,Staff,35,0,35,0
1713303355548,EAP 100,A00,516065,Staff,9792,0,9999,207
1713303356574,ECE 45,A01,507414,Staff,56,0,60,4
1713303357600,ECE 100,A01,507416,Baghdadchi; Saharnaz,12,0,20,8
1713303357600,ECE 100,A02,507418,Baghdadchi; Saharnaz,20,0,20,0
1713303358627,ECE 111,A01,507420,Staff,41,0,50,9
1713303359656,ECE 197,001,548057,Sievenpiper; Daniel F.,9999,0,9999,0
1713303360685,EDS 115,A00,507243,Choi; Bailey Miyeon,28,0,28,0
1713303361709,EDS 117,A01,494379,Staff,25,0,25,0
1713303362736,EDS 125,A00,507246,Hopkins; Megan Beth,29,0,30,1
1713303363769,EDS 128A,A01,507264,Fargason; Sharon Gayle,26,0,26,0
1713303364794,EDS 128B,A01,507293,Pappas; Elizabeth,30,0,30,0
1713303365819,EDS 139,A00,507294,Fargason; Sharon Gayle,30,0,30,0
1713303365819,EDS 139,B00,507313,Pappas; Elizabeth,30,0,30,0
1713303366847,EDS 201,A00,507315,Staff,26,0,30,4
1713303367871,EDS 203,A01,507317,Halter; Christopher P.,26,0,30,4
1713303368901,EDS 204R,A01,507319,Halter; Christopher P.,6,0,30,24
1713303368901,EDS 204R,B01,507331,Heinzman; Erica M.,30,0,30,0
1713303369931,EDS 206R,A00,507332,Staff,8,0,30,22
1713303369931,EDS 206R,B00,507343,Staff,29,0,30,1
1713303370954,EDS 250,A00,507344,Hemans; Patricia Ann Benitez,36,0,40,4
1713303371981,EDS 281,A00,507345,Daly; Alan J.,18,0,18,0
1713303373010,EDS 284,A00,507350,Daly; Alan J.,16,0,16,0
1713303374035,EDS 286,A00,507359,Fine; Sarah,18,0,18,0
1713303375063,EDS 289C,A01,507361,Daly; Alan J.,18,0,18,0
1713303376095,EDS 290,A00,507366,Hofstetter; Carolyn,15,0,15,0
1713303377122,LIGM 5A,A00,507421,Fischer-Grunski; Eva K,20,0,20,0
1713303378208,LIGM 5B,A00,507423,Fischer-Grunski; Eva K,20,0,20,0
1713303379237,LIGM 5C,A00,507425,Fischer-Grunski; Eva K,20,0,20,0
1713303380266,LIIT 5AS,A00,507427,Carnelos; Chiara,20,0,20,0
1713303381294,LIIT 5BS,A00,507430,Carnelos; Chiara,20,0,20,0
1713303382317,LIIT 5CS,A00,507432,Carnelos; Chiara,20,0,20,0
1713303383345,LISP 5A,A00,507541,Munoz Sanchez; Alicia,19,0,20,1
1713303384373,LISP 5B,A00,507671,Munoz Sanchez; Alicia,17,0,20,3
1713303385405,LISP 5C,A00,507696,Munoz Sanchez; Alicia,18,0,20,2
1713303386430,MAE 197,001,528363,Boechler; Nicholas Sebastia,9999,0,9999,0
1713303387455,MATH 197,001,523477,Kedlaya; Kiran S.,9999,0,9999,0
1713303387455,MATH 197,002,563811,Zhang; Danna,9999,0,9999,0
1713303388484,MCWP 40R,A00,518780,Staff,20,0,20,0
1713303388484,MCWP 40R,B00,518781,Staff,20,0,20,0
1713303388484,MCWP 40R,C00,518783,Staff,20,0,20,0
1713303389509,MCWP 50R,A00,518791,Staff,20,0,20,0
1713303389509,MCWP 50R,B00,518792,Staff,20,0,20,0
1713303389509,MCWP 50R,C00,518793,Staff,19,0,20,1
1713303389509,MCWP 50R,D00,518794,Staff,19,0,20,1
1713303389509,MCWP 50R,E00,518795,Staff,19,0,20,1
1713303389509,MCWP 50R,F00,518796,Staff,20,0,20,0
1713303389509,MCWP 50R,G00,518797,Staff,19,0,20,1
1713303390537,MMW 12R,A01,514034,Herbst; Matthew,16,0,16,0
1713303390537,MMW 12R,A02,514035,Herbst; Matthew,16,0,16,0
1713303391563,MMW 13R,A01,514037,Staff,16,0,16,0
1713303391563,MMW 13R,A02,514039,Staff,16,0,16,0
1713303392588,RMED 296,001,626776,Averbach; Sarah Helene,1,0,1,0
1713303393614,SIO 295LS,A00,523233,Staff,19,0,30,11
1713303394651,SIO 295S,A00,523232,Staff,19,0,30,11
1713303395681,SOCI 117,A01,494376,Staff,2,0,5,3
1713303396710,WES 237B,A00,494380,Staff,19,0,20,1
1713303398768,AESE 279B,A00,494370,Wade; Jon P,33,0,33,0
1713303399794,ANAR 135S,A00,494369,Braswell; Geoffrey E.,0,0,0,0
1713303400819,CAT 124RS,A01,519847,Geibel; William,17,0,20,3
1713303401845,CAT 125RS,A01,515971,Geibel; William,17,0,20,3
1713303402875,CLRE 250,A00,511389,Morris; Sheldon,9996,0,9999,3
1713303403902,CLRE 251,A00,507176,Mehta; Ravindra L.,9996,0,9999,3
1713303403902,CLRE 251,B00,511410,Mehta; Ravindra L.,9998,0,9999,1
1713303404927,CLRE 252,A00,507189,Cuomo; Raphael Eduardo,9998,0,9999,1
1713303405955,CLRE 253,A00,507199,Vaida; Florin,9997,0,9999,2
1713303405955,CLRE 253,B00,507202,Vaida; Florin,9999,0,9999,0
1713303406980,CLRE 259,A00,507211,Patel; Hemal,9996,0,9999,3
1713303408005,CLRE 260,A00,507221,Cuomo; Raphael Eduardo,9999,0,9999,0
1713303409034,CLRE 297,001,507242,Cuomo; Raphael Eduardo,9999,0,9999,0
1713303410063,CSE 191,A00,516875,Minnes Kemp; Mor Mia,9999,0,9999,0
1713303411094,CSS 201S,A01,494383,Staff,35,0,35,0
1713303412121,CSS 202S,A01,494387,Staff,35,0,35,0
1713303413145,EAP 100,A00,516065,Staff,9792,0,9999,207
1713303414170,ECE 45,A01,507414,Staff,56,0,60,4
1713303415196,ECE 100,A01,507416,Baghdadchi; Saharnaz,12,0,20,8
1713303415196,ECE 100,A02,507418,Baghdadchi; Saharnaz,20,0,20,0
1713303416226,ECE 111,A01,507420,Staff,41,0,50,9
1713303417251,ECE 197,001,548057,Sievenpiper; Daniel F.,9999,0,9999,0
1713303418281,EDS 115,A00,507243,Choi; Bailey Miyeon,28,0,28,0
1713303419310,EDS 117,A01,494379,Staff,25,0,25,0
1713303420340,EDS 125,A00,507246,Hopkins; Megan Beth,29,0,30,1
1713303421371,EDS 128A,A01,507264,Fargason; Sharon Gayle,26,0,26,0
1713303422397,EDS 128B,A01,507293,Pappas; Elizabeth,30,0,30,0
1713303423436,EDS 139,A00,507294,Fargason; Sharon Gayle,30,0,30,0
1713303423436,EDS 139,B00,507313,Pappas; Elizabeth,30,0,30,0
1713303424462,EDS 201,A00,507315,Staff,26,0,30,4
1713303425487,EDS 203,A01,507317,Halter; Christopher P.,26,0,30,4
1713303426514,EDS 204R,A01,507319,Halter; Christopher P.,6,0,30,24
1713303426514,EDS 204R,B01,507331,Heinzman; Erica M.,30,0,30,0
1713303427540,EDS 206R,A00,507332,Staff,8,0,30,22
1713303427540,EDS 206R,B00,507343,Staff,29,0,30,1
1713303428565,EDS 250,A00,507344,Hemans; Patricia Ann Benitez,36,0,40,4
1713303429591,EDS 281,A00,507345,Daly; Alan J.,18,0,18,0
1713303430619,EDS 284,A00,507350,Daly; Alan J.,16,0,16,0
1713303431643,EDS 286,A00,507359,Fine; Sarah,18,0,18,0
1713303432670,EDS 289C,A01,507361,Daly; Alan J.,18,0,18,0
1713303433696,EDS 290,A00,507366,Hofstetter; Carolyn,15,0,15,0
1713303434723,LIGM 5A,A00,507421,Fischer-Grunski; Eva K,20,0,20,0
1713303435752,LIGM 5B,A00,507423,Fischer-Grunski; Eva K,20,0,20,0
1713303436781,LIGM 5C,A00,507425,Fischer-Grunski; Eva K,20,0,20,0
1713303437812,LIIT 5AS,A00,507427,Carnelos; Chiara,20,0,20,0
1713303438838,LIIT 5BS,A00,507430,Carnelos; Chiara,20,0,20,0
1713303439868,LIIT 5CS,A00,507432,Carnelos; Chiara,20,0,20,0
1713303440894,LISP 5A,A00,507541,Munoz Sanchez; Alicia,19,0,20,1
1713303441919,LISP 5B,A00,507671,Munoz Sanchez; Alicia,17,0,20,3
1713303442950,LISP 5C,A00,507696,Munoz Sanchez; Alicia,18,0,20,2
1713303443980,MAE 197,001,528363,Boechler; Nicholas Sebastia,9999,0,9999,0
1713303445015,MATH 197,001,523477,Kedlaya; Kiran S.,9999,0,9999,0
1713303445015,MATH 197,002,563811,Zhang; Danna,9999,0,9999,0
1713303446040,MCWP 40R,A00,518780,Staff,20,0,20,0
1713303446040,MCWP 40R,B00,518781,Staff,20,0,20,0
1713303446040,MCWP 40R,C00,518783,Staff,20,0,20,0
1713303447067,MCWP 50R,A00,518791,Staff,20,0,20,0
1713303447067,MCWP 50R,B00,518792,Staff,20,0,20,0
1713303447067,MCWP 50R,C00,518793,Staff,19,0,20,1
1713303447067,MCWP 50R,D00,518794,Staff,19,0,20,1
1713303447067,MCWP 50R,E00,518795,Staff,19,0,20,1
1713303447067,MCWP 50R,F00,518796,Staff,20,0,20,0
1713303447067,MCWP 50R,G00,518797,Staff,19,0,20,1
1713303448096,MMW 12R,A01,514034,Herbst; Matthew,16,0,16,0
1713303448096,MMW 12R,A02,514035,Herbst; Matthew,16,0,16,0
1713303449123,MMW 13R,A01,514037,Staff,16,0,16,0
1713303449123,MMW 13R,A02,514039,Staff,16,0,16,0
1713303450149,RMED 296,001,626776,Averbach; Sarah Helene,1,0,1,0
1713303451181,SIO 295LS,A00,523233,Staff,19,0,30,11
1713303452207,SIO 295S,A00,523232,Staff,19,0,30,11
1713303453233,SOCI 117,A01,494376,Staff,3,0,5,2
1713303454257,WES 237B,A00,494380,Staff,19,0,20,1
1713303456323,AESE 279B,A00,494370,Wade; Jon P,33,0,33,0
1713303457348,ANAR 135S,A00,494369,Braswell; Geoffrey E.,0,0,0,0
1713303458375,CAT 124RS,A01,519847,Geibel; William,17,0,20,3
1713303459400,CAT 125RS,A01,515971,Geibel; William,17,0,20,3
1713303460428,CLRE 250,A00,511389,Morris; Sheldon,9996,0,9999,3
1713303461455,CLRE 251,A00,507176,Mehta; Ravindra L.,9996,0,9999,3
1713303461455,CLRE 251,B00,511410,Mehta; Ravindra L.,9998,0,9999,1
1713303462486,CLRE 252,A00,507189,Cuomo; Raphael Eduardo,9998,0,9999,1
1713303463511,CLRE 253,A00,507199,Vaida; Florin,9997,0,9999,2
1713303463511,CLRE 253,B00,507202,Vaida; Florin,9999,0,9999,0
1713303464541,CLRE 259,A00,507211,Patel; Hemal,9996,0,9999,3
1713303465566,CLRE 260,A00,507221,Cuomo; Raphael Eduardo,9999,0,9999,0
1713303466591,CLRE 297,001,507242,Cuomo; Raphael Eduardo,9999,0,9999,0
1713303467623,CSE 191,A00,516875,Minnes Kemp; Mor Mia,9999,0,9999,0
1713303468651,CSS 201S,A01,494383,Staff,35,0,35,0
1713303469680,CSS 202S,A01,494387,Staff,35,0,35,0
1713303470713,EAP 100,A00,516065,Staff,9792,0,9999,207
1713303471742,ECE 45,A01,507414,Staff,56,0,60,4
1713303472768,ECE 100,A01,507416,Baghdadchi; Saharnaz,12,0,20,8
1713303472768,ECE 100,A02,507418,Baghdadchi; Saharnaz,20,0,20,0
1713303473796,ECE 111,A01,507420,Staff,41,0,50,9
1713303474821,ECE 197,001,548057,Sievenpiper; Daniel F.,9999,0,9999,0
1713303475845,EDS 115,A00,507243,Choi; Bailey Miyeon,28,0,28,0
1713303476874,EDS 117,A01,494379,Staff,25,0,25,0
1713303477900,EDS 125,A00,507246,Hopkins; Megan Beth,29,0,30,1
1713303478924,EDS 128A,A01,507264,Fargason; Sharon Gayle,26,0,26,0
1713303479955,EDS 128B,A01,507293,Pappas; Elizabeth,30,0,30,0
1713303480987,EDS 139,A00,507294,Fargason; Sharon Gayle,30,0,30,0
1713303480987,EDS 139,B00,507313,Pappas; Elizabeth,30,0,30,0
1713303482073,EDS 201,A00,507315,Staff,26,0,30,4
1713303483098,EDS 203,A01,507317,Halter; Christopher P.,26,0,30,4
1713303484124,EDS 204R,A01,507319,Halter; Christopher P.,6,0,30,24
1713303484124,EDS 204R,B01,507331,Heinzman; Erica M.,30,0,30,0
1713303485149,EDS 206R,A00,507332,Staff,8,0,30,22
1713303485149,EDS 206R,B00,507343,Staff,29,0,30,1
1713303486174,EDS 250,A00,507344,Hemans; Patricia Ann Benitez,36,0,40,4
1713303487205,EDS 281,A00,507345,Daly; Alan J.,18,0,18,0
1713303488231,EDS 284,A00,507350,Daly; Alan J.,16,0,16,0
1713303489260,EDS 286,A00,507359,Fine; Sarah,18,0,18,0
1713303490288,EDS 289C,A01,507361,Daly; Alan J.,18,0,18,0
1713303491314,EDS 290,A00,507366,Hofstetter; Carolyn,15,0,15,0
1713303492340,LIGM 5A,A00,507421,Fischer-Grunski; Eva K,20,0,20,0
1713303493367,LIGM 5B,A00,507423,Fischer-Grunski; Eva K,20,0,20,0
1713303494392,LIGM 5C,A00,507425,Fischer-Grunski; Eva K,20,0,20,0
1713303495417,LIIT 5AS,A00,507427,Carnelos; Chiara,20,0,20,0
1713303496440,LIIT 5BS,A00,507430,Carnelos; Chiara,20,0,20,0
1713303497466,LIIT 5CS,A00,507432,Carnelos; Chiara,20,0,20,0
1713303498491,LISP 5A,A00,507541,Munoz Sanchez; Alicia,19,0,20,1
1713303499516,LISP 5B,A00,507671,Munoz Sanchez; Alicia,17,0,20,3
1713303500541,LISP 5C,A00,507696,Munoz Sanchez; Alicia,18,0,20,2
1713303501566,MAE 197,001,528363,Boechler; Nicholas Sebastia,9999,0,9999,0
1713303502598,MATH 197,001,523477,Kedlaya; Kiran S.,9999,0,9999,0
1713303502598,MATH 197,002,563811,Zhang; Danna,9999,0,9999,0
1713303503631,MCWP 40R,A00,518780,Staff,20,0,20,0
1713303503631,MCWP 40R,B00,518781,Staff,20,0,20,0
1713303503631,MCWP 40R,C00,518783,Staff,20,0,20,0
1713303504659,MCWP 50R,A00,518791,Staff,20,0,20,0
1713303504659,MCWP 50R,B00,518792,Staff,20,0,20,0
1713303504659,MCWP 50R,C00,518793,Staff,19,0,20,1
1713303504659,MCWP 50R,D00,518794,Staff,19,0,20,1
1713303504659,MCWP 50R,E00,518795,Staff,19,0,20,1
1713303504659,MCWP 50R,F00,518796,Staff,20,0,20,0
1713303504659,MCWP 50R,G00,518797,Staff,19,0,20,1
1713303505691,MMW 12R,A01,514034,Herbst; Matthew,16,0,16,0
1713303505691,MMW 12R,A02,514035,Herbst; Matthew,16,0,16,0
1713303506715,MMW 13R,A01,514037,Staff,16,0,16,0
1713303506715,MMW 13R,A02,514039,Staff,16,0,16,0
1713303507743,RMED 296,001,626776,Averbach; Sarah Helene,1,0,1,0
1713303508767,SIO 295LS,A00,523233,Staff,19,0,30,11
1713303509796,SIO 295S,A00,523232,Staff,19,0,30,11
1713303510819,SOCI 117,A01,494376,Staff,3,0,5,2
1713303511845,WES 237B,A00,494380,Staff,19,0,20,1
1713303513909,AESE 279B,A00,494370,Wade; Jon P,33,0,33,0
1713303514934,ANAR 135S,A00,494369,Braswell; Geoffrey E.,0,0,0,0
1713303515957,CAT 124RS,A01,519847,Geibel; William,17,0,20,3
1713303516982,CAT 125RS,A01,515971,Geibel; William,17,0,20,3
1713303518011,CLRE 250,A00,511389,Morris; Sheldon,9996,0,9999,3
1713303519040,CLRE 251,A00,507176,Mehta; Ravindra L.,9996,0,9999,3
1713303519040,CLRE 251,B00,511410,Mehta; Ravindra L.,9998,0,9999,1
1713303520069,CLRE 252,A00,507189,Cuomo; Raphael Eduardo,9998,0,9999,1
1713303521098,CLRE 253,A00,507199,Vaida; Florin,9997,0,9999,2
1713303521098,CLRE 253,B00,507202,Vaida; Florin,9999,0,9999,0
1713303522126,CLRE 259,A00,507211,Patel; Hemal,9996,0,9999,3
1713303523150,CLRE 260,A00,507221,Cuomo; Raphael Eduardo,9999,0,9999,0
1713303524175,CLRE 297,001,507242,Cuomo; Raphael Eduardo,9999,0,9999,0
1713303525206,CSE 191,A00,516875,Minnes Kemp; Mor Mia,9999,0,9999,0
1713303526231,CSS 201S,A01,494383,Staff,35,0,35,0
1713303527260,CSS 202S,A01,494387,Staff,35,0,35,0
1713303528284,EAP 100,A00,516065,Staff,9792,0,9999,207
1713303529309,ECE 45,A01,507414,Staff,56,0,60,4
1713303530335,ECE 100,A01,507416,Baghdadchi; Saharnaz,12,0,20,8
1713303530335,ECE 100,A02,507418,Baghdadchi; Saharnaz,20,0,20,0
1713303531364,ECE 111,A01,507420,Staff,41,0,50,9
1713303532391,ECE 197,001,548057,Sievenpiper; Daniel F.,9999,0,9999,0
1713303533417,EDS 115,A00,507243,Choi; Bailey Miyeon,28,0,28,0
1713303534444,EDS 117,A01,494379,Staff,25,0,25,0
1713303535475,EDS 125,A00,507246,Hopkins; Megan Beth,29,0,30,1
1713303536501,EDS 128A,A01,507264,Fargason; Sharon Gayle,26,0,26,0
1713303537530,EDS 128B,A01,507293,Pappas; Elizabeth,30,0,30,0
1713303538554,EDS 139,A00,507294,Fargason; Sharon Gayle,30,0,30,0
1713303538554,EDS 139,B00,507313,Pappas; Elizabeth,30,0,30,0
1713303539578,EDS 201,A00,507315,Staff,26,0,30,4
1713303540608,EDS 203,A01,507317,Halter; Christopher P.,26,0,30,4
1713303541633,EDS 204R,A01,507319,Halter; Christopher P.,6,0,30,24
1713303541633,EDS 204R,B01,507331,Heinzman; Erica M.,30,0,30,0
1713303542662,EDS 206R,A00,507332,Staff,8,0,30,22
1713303542662,EDS 206R,B00,507343,Staff,29,0,30,1
1713303543691,EDS 250,A00,507344,Hemans; Patricia Ann Benitez,36,0,40,4
1713303544719,EDS 281,A00,507345,Daly; Alan J.,18,0,18,0
1713303545746,EDS 284,A00,507350,Daly; Alan J.,16,0,16,0
1713303546772,EDS 286,A00,507359,Fine; Sarah,18,0,18,0
1713303547802,EDS 289C,A01,507361,Daly; Alan J.,18,0,18,0
1713303548826,EDS 290,A00,507366,Hofstetter; Carolyn,15,0,15,0
1713303549851,LIGM 5A,A00,507421,Fischer-Grunski; Eva K,20,0,20,0
1713303550878,LIGM 5B,A00,507423,Fischer-Grunski; Eva K,20,0,20,0
1713303551903,LIGM 5C,A00,507425,Fischer-Grunski; Eva K,20,0,20,0
1713303552929,LIIT 5AS,A00,507427,Carnelos; Chiara,20,0,20,0
1713303553955,LIIT 5BS,A00,507430,Carnelos; Chiara,20,0,20,0
1713303554982,LIIT 5CS,A00,507432,Carnelos; Chiara,20,0,20,0
1713303556008,LISP 5A,A00,507541,Munoz Sanchez; Alicia,19,0,20,1
1713303557039,LISP 5B,A00,507671,Munoz Sanchez; Alicia,17,0,20,3
1713303558065,LISP 5C,A00,507696,Munoz Sanchez; Alicia,18,0,20,2
1713303559093,MAE 197,001,528363,Boechler; Nicholas Sebastia,9999,0,9999,0
1713303560118,MATH 197,001,523477,Kedlaya; Kiran S.,9999,0,9999,0
1713303560118,MATH 197,002,563811,Zhang; Danna,9999,0,9999,0
1713303561146,MCWP 40R,A00,518780,Staff,20,0,20,0
1713303561146,MCWP 40R,B00,518781,Staff,20,0,20,0
1713303561146,MCWP 40R,C00,518783,Staff,20,0,20,0
1713303562172,MCWP 50R,A00,518791,Staff,20,0,20,0
1713303562172,MCWP 50R,B00,518792,Staff,20,0,20,0
1713303562172,MCWP 50R,C00,518793,Staff,19,0,20,1
1713303562172,MCWP 50R,D00,518794,Staff,19,0,20,1
1713303562172,MCWP 50R,E00,518795,Staff,19,0,20,1
1713303562172,MCWP 50R,F00,518796,Staff,20,0,20,0
1713303562172,MCWP 50R,G00,518797,Staff,19,0,20,1
1713303563196,MMW 12R,A01,514034,Herbst; Matthew,16,0,16,0
1713303563196,MMW 12R,A02,514035,Herbst; Matthew,16,0,16,0
1713303564220,MMW 13R,A01,514037,Staff,16,0,16,0
1713303564220,MMW 13R,A02,514039,Staff,16,0,16,0
1713303565246,RMED 296,001,626776,Averbach; Sarah Helene,1,0,1,0
1713303566272,SIO 295LS,A00,523233,Staff,19,0,30,11
1713303567296,SIO 295S,A00,523232,Staff,19,0,30,11
1713303568324,SOCI 117,A01,494376,Staff,3,0,5,2
1713303569353,WES 237B,A00,494380,Staff,19,0,20,1
1713303571422,AESE 279B,A00,494370,Wade; Jon P,33,0,33,0
1713303572446,ANAR 135S,A00,494369,Braswell; Geoffrey E.,0,0,0,0
1713303573471,CAT 124RS,A01,519847,Geibel; William,17,0,20,3
1713303574500,CAT 125RS,A01,515971,Geibel; William,17,0,20,3
1713303575525,CLRE 250,A00,511389,Morris; Sheldon,9996,0,9999,3
1713303576552,CLRE 251,A00,507176,Mehta; Ravindra L.,9996,0,9999,3
1713303576552,CLRE 251,B00,511410,Mehta; Ravindra L.,9998,0,9999,1
1713303577578,CLRE 252,A00,507189,Cuomo; Raphael Eduardo,9998,0,9999,1
1713303578608,CLRE 253,A00,507199,Vaida; Florin,9997,0,9999,2
1713303578608,CLRE 253,B00,507202,Vaida; Florin,9999,0,9999,0
1713303579637,CLRE 259,A00,507211,Patel; Hemal,9996,0,9999,3
1713303580667,CLRE 260,A00,507221,Cuomo; Raphael Eduardo,9999,0,9999,0
1713303581694,CLRE 297,001,507242,Cuomo; Raphael Eduardo,9999,0,9999,0
1713303582721,CSE 191,A00,516875,Minnes Kemp; Mor Mia,9999,0,9999,0
1713303583747,CSS 201S,A01,494383,Staff,35,0,35,0
1713303584777,CSS 202S,A01,494387,Staff,35,0,35,0
1713303585856,EAP 100,A00,516065,Staff,9792,0,9999,207
1713303586884,ECE 45,A01,507414,Staff,56,0,60,4
1713303587914,ECE 100,A01,507416,Baghdadchi; Saharnaz,12,0,20,8
1713303587914,ECE 100,A02,507418,Baghdadchi; Saharnaz,20,0,20,0
1713303588938,ECE 111,A01,507420,Staff,41,0,50,9
1713303589967,ECE 197,001,548057,Sievenpiper; Daniel F.,9999,0,9999,0
1713303590994,EDS 115,A00,507243,Choi; Bailey Miyeon,28,0,28,0
1713303592020,EDS 117,A01,494379,Staff,25,0,25,0
1713303593045,EDS 125,A00,507246,Hopkins; Megan Beth,29,0,30,1
1713303594070,EDS 128A,A01,507264,Fargason; Sharon Gayle,26,0,26,0
1713303595094,EDS 128B,A01,507293,Pappas; Elizabeth,30,0,30,0
1713303596124,EDS 139,A00,507294,Fargason; Sharon Gayle,30,0,30,0
1713303596124,EDS 139,B00,507313,Pappas; Elizabeth,30,0,30,0
1713303597153,EDS 201,A00,507315,Staff,26,0,30,4
1713303598178,EDS 203,A01,507317,Halter; Christopher P.,26,0,30,4
1713303599208,EDS 204R,A01,507319,Halter; Christopher P.,6,0,30,24
1713303599208,EDS 204R,B01,507331,Heinzman; Erica M.,30,0,30,0
1713303600233,EDS 206R,A00,507332,Staff,8,0,30,22
1713303600233,EDS 206R,B00,507343,Staff,29,0,30,1
1713303601259,EDS 250,A00,507344,Hemans; Patricia Ann Benitez,36,0,40,4
1713303602285,EDS 281,A00,507345,Daly; Alan J.,18,0,18,0
1713303603315,EDS 284,A00,507350,Daly; Alan J.,16,0,16,0
1713303604340,EDS 286,A00,507359,Fine; Sarah,18,0,18,0
1713303605364,EDS 289C,A01,507361,Daly; Alan J.,18,0,18,0
1713303606392,EDS 290,A00,507366,Hofstetter; Carolyn,15,0,15,0
1713303607418,LIGM 5A,A00,507421,Fischer-Grunski; Eva K,20,0,20,0
1713303608445,LIGM 5B,A00,507423,Fischer-Grunski; Eva K,20,0,20,0
1713303609471,LIGM 5C,A00,507425,Fischer-Grunski; Eva K,20,0,20,0
1713303610502,LIIT 5AS,A00,507427,Carnelos; Chiara,20,0,20,0
1713303611527,LIIT 5BS,A00,507430,Carnelos; Chiara,20,0,20,0
1713303612557,LIIT 5CS,A00,507432,Carnelos; Chiara,20,0,20,0
1713303613582,LISP 5A,A00,507541,Munoz Sanchez; Alicia,19,0,20,1
1713303614607,LISP 5B,A00,507671,Munoz Sanchez; Alicia,17,0,20,3
1713303615637,LISP 5C,A00,507696,Munoz Sanchez; Alicia,18,0,20,2
1713303616663,MAE 197,001,528363,Boechler; Nicholas Sebastia,9999,0,9999,0
1713303617690,MATH 197,001,523477,Kedlaya; Kiran S.,9999,0,9999,0
1713303617690,MATH 197,002,563811,Zhang; Danna,9999,0,9999,0
1713303618717,MCWP 40R,A00,518780,Staff,20,0,20,0
1713303618717,MCWP 40R,B00,518781,Staff,20,0,20,0
1713303618717,MCWP 40R,C00,518783,Staff,20,0,20,0
1713303619753,MCWP 50R,A00,518791,Staff,20,0,20,0
1713303619753,MCWP 50R,B00,518792,Staff,20,0,20,0
1713303619753,MCWP 50R,C00,518793,Staff,19,0,20,1
1713303619753,MCWP 50R,D00,518794,Staff,19,0,20,1
1713303619753,MCWP 50R,E00,518795,Staff,19,0,20,1
1713303619753,MCWP 50R,F00,518796,Staff,20,0,20,0
1713303619753,MCWP 50R,G00,518797,Staff,19,0,20,1
1713303620779,MMW 12R,A01,514034,Herbst; Matthew,16,0,16,0
1713303620779,MMW 12R,A02,514035,Herbst; Matthew,16,0,16,0
1713303621803,MMW 13R,A01,514037,Staff,16,0,16,0
1713303621803,MMW 13R,A02,514039,Staff,16,0,16,0
1713303622834,RMED 296,001,626776,Averbach; Sarah Helene,1,0,1,0
1713303623862,SIO 295LS,A00,523233,Staff,19,0,30,11
1713303624901,SIO 295S,A00,523232,Staff,19,0,30,11
1713303625927,SOCI 117,A01,494376,Staff,3,0,5,2
1713303626953,WES 237B,A00,494380,Staff,19,0,20,1
1713303629018,AESE 279B,A00,494370,Wade; Jon P,33,0,33,0
1713303630047,ANAR 135S,A00,494369,Braswell; Geoffrey E.,0,0,0,0
1713303631072,CAT 124RS,A01,519847,Geibel; William,17,0,20,3
1713303632101,CAT 125RS,A01,515971,Geibel; William,17,0,20,3
1713303633128,CLRE 250,A00,511389,Morris; Sheldon,9996,0,9999,3
1713303634154,CLRE 251,A00,507176,Mehta; Ravindra L.,9996,0,9999,3
1713303634154,CLRE 251,B00,511410,Mehta; Ravindra L.,9998,0,9999,1
1713303635181,CLRE 252,A00,507189,Cuomo; Raphael Eduardo,9998,0,9999,1
1713303636205,CLRE 253,A00,507199,Vaida; Florin,9997,0,9999,2
1713303636205,CLRE 253,B00,507202,Vaida; Florin,9999,0,9999,0
1713303637235,CLRE 259,A00,507211,Patel; Hemal,9996,0,9999,3
1713303638260,CLRE 260,A00,507221,Cuomo; Raphael Eduardo,9999,0,9999,0
1713303639286,CLRE 297,001,507242,Cuomo; Raphael Eduardo,9999,0,9999,0
1713303640316,CSE 191,A00,516875,Minnes Kemp; Mor Mia,9999,0,9999,0
1713303641346,CSS 201S,A01,494383,Staff,35,0,35,0
1713303642374,CSS 202S,A01,494387,Staff,35,0,35,0
1713303643459,EAP 100,A00,516065,Staff,9792,0,9999,207
1713303644484,ECE 45,A01,507414,Staff,56,0,60,4
1713303645514,ECE 100,A01,507416,Baghdadchi; Saharnaz,12,0,20,8
1713303645514,ECE 100,A02,507418,Baghdadchi; Saharnaz,20,0,20,0
1713303646544,ECE 111,A01,507420,Staff,41,0,50,9
1713303647574,ECE 197,001,548057,Sievenpiper; Daniel F.,9999,0,9999,0
1713303648602,EDS 115,A00,507243,Choi; Bailey Miyeon,28,0,28,0
1713303649627,EDS 117,A01,494379,Staff,25,0,25,0
1713303650657,EDS 125,A00,507246,Hopkins; Megan Beth,29,0,30,1
1713303651686,EDS 128A,A01,507264,Fargason; Sharon Gayle,26,0,26,0
1713303652713,EDS 128B,A01,507293,Pappas; Elizabeth,30,0,30,0
1713303653742,EDS 139,A00,507294,Fargason; Sharon Gayle,30,0,30,0
1713303653742,EDS 139,B00,507313,Pappas; Elizabeth,30,0,30,0
1713303654768,EDS 201,A00,507315,Staff,26,0,30,4
1713303655794,EDS 203,A01,507317,Halter; Christopher P.,26,0,30,4
1713303656823,EDS 204R,A01,507319,Halter; Christopher P.,6,0,30,24
1713303656823,EDS 204R,B01,507331,Heinzman; Erica M.,30,0,30,0
1713303657856,EDS 206R,A00,507332,Staff,8,0,30,22
1713303657856,EDS 206R,B00,507343,Staff,29,0,30,1
1713303658882,EDS 250,A00,507344,Hemans; Patricia Ann Benitez,36,0,40,4
1713303659906,EDS 281,A00,507345,Daly; Alan J.,18,0,18,0
1713303660934,EDS 284,A00,507350,Daly; Alan J.,16,0,16,0
1713303661960,EDS 286,A00,507359,Fine; Sarah,18,0,18,0
1713303662986,EDS 289C,A01,507361,Daly; Alan J.,18,0,18,0
1713303664014,EDS 290,A00,507366,Hofstetter; Carolyn,15,0,15,0
1713303665043,LIGM 5A,A00,507421,Fischer-Grunski; Eva K,20,0,20,0
1713303666072,LIGM 5B,A00,507423,Fischer-Grunski; Eva K,20,0,20,0
1713303667096,LIGM 5C,A00,507425,Fischer-Grunski; Eva K,20,0,20,0
1713303668122,LIIT 5AS,A00,507427,Carnelos; Chiara,20,0,20,0
1713303669151,LIIT 5BS,A00,507430,Carnelos; Chiara,20,0,20,0
1713303670182,LIIT 5CS,A00,507432,Carnelos; Chiara,20,0,20,0
1713303671211,LISP 5A,A00,507541,Munoz Sanchez; Alicia,19,0,20,1
1713303672240,LISP 5B,A00,507671,Munoz Sanchez; Alicia,17,0,20,3
1713303673270,LISP 5C,A00,507696,Munoz Sanchez; Alicia,18,0,20,2
1713303674298,MAE 197,001,528363,Boechler; Nicholas Sebastia,9999,0,9999,0
1713303675322,MATH 197,001,523477,Kedlaya; Kiran S.,9999,0,9999,0
1713303675322,MATH 197,002,563811,Zhang; Danna,9999,0,9999,0
1713303676348,MCWP 40R,A00,518780,Staff,20,0,20,0
1713303676348,MCWP 40R,B00,518781,Staff,20,0,20,0
1713303676348,MCWP 40R,C00,518783,Staff,20,0,20,0
1713303677373,MCWP 50R,A00,518791,Staff,20,0,20,0
1713303677373,MCWP 50R,B00,518792,Staff,20,0,20,0
1713303677373,MCWP 50R,C00,518793,Staff,19,0,20,1
1713303677373,MCWP 50R,D00,518794,Staff,19,0,20,1
1713303677373,MCWP 50R,E00,518795,Staff,19,0,20,1
1713303677373,MCWP 50R,F00,518796,Staff,20,0,20,0
1713303677373,MCWP 50R,G00,518797,Staff,19,0,20,1
1713303678398,MMW 12R,A01,514034,Herbst; Matthew,16,0,16,0
1713303678398,MMW 12R,A02,514035,Herbst; Matthew,16,0,16,0
1713303679423,MMW 13R,A01,514037,Staff,16,0,16,0
1713303679423,MMW 13R,A02,514039,Staff,16,0,16,0
1713303680448,RMED 296,001,626776,Averbach; Sarah Helene,1,0,1,0
1713303681472,SIO 295LS,A00,523233,Staff,19,0,30,11
1713303682501,SIO 295S,A00,523232,Staff,19,0,30,11
1713303683527,SOCI 117,A01,494376,Staff,3,0,5,2
1713303684554,WES 237B,A00,494380,Staff,19,0,20,1
1713303686618,AESE 279B,A00,494370,Wade; Jon P,33,0,33,0
1713303687644,ANAR 135S,A00,494369,Braswell; Geoffrey E.,0,0,0,0
1713303688670,CAT 124RS,A01,519847,Geibel; William,17,0,20,3
1713303689753,CAT 125RS,A01,515971,Geibel; William,17,0,20,3
1713303690780,CLRE 250,A00,511389,Morris; Sheldon,9996,0,9999,3
1713303691809,CLRE 251,A00,507176,Mehta; Ravindra L.,9996,0,9999,3
1713303691809,CLRE 251,B00,511410,Mehta; Ravindra L.,9998,0,9999,1
1713303692837,CLRE 252,A00,507189,Cuomo; Raphael Eduardo,9998,0,9999,1
1713303693866,CLRE 253,A00,507199,Vaida; Florin,9997,0,9999,2
1713303693866,CLRE 253,B00,507202,Vaida; Florin,9999,0,9999,0
1713303694890,CLRE 259,A00,507211,Patel; Hemal,9996,0,9999,3
1713303695919,CLRE 260,A00,507221,Cuomo; Raphael Eduardo,9999,0,9999,0
1713303696943,CLRE 297,001,507242,Cuomo; Raphael Eduardo,9999,0,9999,0
1713303697969,CSE 191,A00,516875,Minnes Kemp; Mor Mia,9999,0,9999,0
1713303698999,CSS 201S,A01,494383,Staff,35,0,35,0
1713303700028,CSS 202S,A01,494387,Staff,35,0,35,0
1713303701054,EAP 100,A00,516065,Staff,9792,0,9999,207
1713303702080,ECE 45,A01,507414,Staff,56,0,60,4
1713303703105,ECE 100,A01,507416,Baghdadchi; Saharnaz,12,0,20,8
1713303703105,ECE 100,A02,507418,Baghdadchi; Saharnaz,20,0,20,0
1713303704131,ECE 111,A01,507420,Staff,41,0,50,9
1713303705156,ECE 197,001,548057,Sievenpiper; Daniel F.,9999,0,9999,0
1713303706181,EDS 115,A00,507243,Choi; Bailey Miyeon,28,0,28,0
1713303707208,EDS 117,A01,494379,Staff,25,0,25,0
1713303708240,EDS 125,A00,507246,Hopkins; Megan Beth,29,0,30,1
1713303709267,EDS 128A,A01,507264,Fargason; Sharon Gayle,26,0,26,0
1713303710293,EDS 128B,A01,507293,Pappas; Elizabeth,30,0,30,0
1713303711318,EDS 139,A00,507294,Fargason; Sharon Gayle,30,0,30,0
1713303711318,EDS 139,B00,507313,Pappas; Elizabeth,30,0,30,0
1713303712344,EDS 201,A00,507315,Staff,26,0,30,4
1713303713370,EDS 203,A01,507317,Halter; Christopher P.,26,0,30,4
1713303714394,EDS 204R,A01,507319,Halter; Christopher P.,6,0,30,24
1713303714394,EDS 204R,B01,507331,Heinzman; Erica M.,30,0,30,0
1713303715423,EDS 206R,A00,507332,Staff,8,0,30,22
1713303715423,EDS 206R,B00,507343,Staff,29,0,30,1
1713303716448,EDS 250,A00,507344,Hemans; Patricia Ann Benitez,36,0,40,4
1713303717473,EDS 281,A00,507345,Daly; Alan J.,18,0,18,0
1713303718498,EDS 284,A00,507350,Daly; Alan J.,16,0,16,0
1713303719525,EDS 286,A00,507359,Fine; Sarah,18,0,18,0
1713303720550,EDS 289C,A01,507361,Daly; Alan J.,18,0,18,0
1713303721575,EDS 290,A00,507366,Hofstetter; Carolyn,15,0,15,0
1713303722605,LIGM 5A,A00,507421,Fischer-Grunski; Eva K,20,0,20,0
1713303723630,LIGM 5B,A00,507423,Fischer-Grunski; Eva K,20,0,20,0
1713303724659,LIGM 5C,A00,507425,Fischer-Grunski; Eva K,20,0,20,0
1713303725685,LIIT 5AS,A00,507427,Carnelos; Chiara,20,0,20,0
1713303726714,LIIT 5BS,A00,507430,Carnelos; Chiara,20,0,20,0
1713303727742,LIIT 5CS,A00,507432,Carnelos; Chiara,20,0,20,0
1713303728771,LISP 5A,A00,507541,Munoz Sanchez; Alicia,19,0,20,1
1713303729800,LISP 5B,A00,507671,Munoz Sanchez; Alicia,17,0,20,3
1713303730824,LISP 5C,A00,507696,Munoz Sanchez; Alicia,18,0,20,2
1713303731850,MAE 197,001,528363,Boechler; Nicholas Sebastia,9999,0,9999,0
1713303732876,MATH 197,001,523477,Kedlaya; Kiran S.,9999,0,9999,0
1713303732876,MATH 197,002,563811,Zhang; Danna,9999,0,9999,0
1713303733901,MCWP 40R,A00,518780,Staff,20,0,20,0
1713303733901,MCWP 40R,B00,518781,Staff,20,0,20,0
1713303733901,MCWP 40R,C00,518783,Staff,20,0,20,0
1713303734929,MCWP 50R,A00,518791,Staff,20,0,20,0
1713303734929,MCWP 50R,B00,518792,Staff,20,0,20,0
1713303734929,MCWP 50R,C00,518793,Staff,19,0,20,1
1713303734929,MCWP 50R,D00,518794,Staff,19,0,20,1
1713303734929,MCWP 50R,E00,518795,Staff,19,0,20,1
1713303734929,MCWP 50R,F00,518796,Staff,20,0,20,0
1713303734929,MCWP 50R,G00,518797,Staff,19,0,20,1
1713303735960,MMW 12R,A01,514034,Herbst; Matthew,16,0,16,0
1713303735960,MMW 12R,A02,514035,Herbst; Matthew,16,0,16,0
1713303736988,MMW 13R,A01,514037,Staff,16,0,16,0
1713303736988,MMW 13R,A02,514039,Staff,16,0,16,0
1713303738018,RMED 296,001,626776,Averbach; Sarah Helene,1,0,1,0
1713303739044,SIO 295LS,A00,523233,Staff,19,0,30,11
1713303740070,SIO 295S,A00,523232,Staff,19,0,30,11
1713303741096,SOCI 117,A01,494376,Staff,3,0,5,2
1713303742122,WES 237B,A00,494380,Staff,19,0,20,1
1713303744185,AESE 279B,A00,494370,Wade; Jon P,33,0,33,0
1713303745211,ANAR 135S,A00,494369,Braswell; Geoffrey E.,0,0,0,0
1713303746237,CAT 124RS,A01,519847,Geibel; William,17,0,20,3
1713303747263,CAT 125RS,A01,515971,Geibel; William,17,0,20,3
1713303748294,CLRE 250,A00,511389,Morris; Sheldon,9996,0,9999,3
1713303749326,CLRE 251,A00,507176,Mehta; Ravindra L.,9996,0,9999,3
1713303749326,CLRE 251,B00,511410,Mehta; Ravindra L.,9998,0,9999,1
1713303750353,CLRE 252,A00,507189,Cuomo; Raphael Eduardo,9998,0,9999,1
1713303751386,CLRE 253,A00,507199,Vaida; Florin,9997,0,9999,2
1713303751386,CLRE 253,B00,507202,Vaida; Florin,9999,0,9999,0
1713303752411,CLRE 259,A00,507211,Patel; Hemal,9996,0,9999,3
1713303753442,CLRE 260,A00,507221,Cuomo; Raphael Eduardo,9999,0,9999,0
1713303754471,CLRE 297,001,507242,Cuomo; Raphael Eduardo,9999,0,9999,0
1713303755497,CSE 191,A00,516875,Minnes Kemp; Mor Mia,9999,0,9999,0
1713303756528,CSS 201S,A01,494383,Staff,35,0,35,0
1713303757554,CSS 202S,A01,494387,Staff,35,0,35,0
1713303758593,EAP 100,A00,516065,Staff,9792,0,9999,207
1713303759620,ECE 45,A01,507414,Staff,56,0,60,4
1713303760688,ECE 100,A01,507416,Baghdadchi; Saharnaz,12,0,20,8
1713303760688,ECE 100,A02,507418,Baghdadchi; Saharnaz,20,0,20,0
1713303761714,ECE 111,A01,507420,Staff,41,0,50,9
1713303762739,ECE 197,001,548057,Sievenpiper; Daniel F.,9999,0,9999,0
1713303763766,EDS 115,A00,507243,Choi; Bailey Miyeon,28,0,28,0
1713303764790,EDS 117,A01,494379,Staff,25,0,25,0
1713303765815,EDS 125,A00,507246,Hopkins; Megan Beth,29,0,30,1
1713303766840,EDS 128A,A01,507264,Fargason; Sharon Gayle,26,0,26,0
1713303767869,EDS 128B,A01,507293,Pappas; Elizabeth,30,0,30,0
1713303768895,EDS 139,A00,507294,Fargason; Sharon Gayle,30,0,30,0
1713303768895,EDS 139,B00,507313,Pappas; Elizabeth,30,0,30,0
1713303769924,EDS 201,A00,507315,Staff,26,0,30,4
1713303770954,EDS 203,A01,507317,Halter; Christopher P.,26,0,30,4
1713303771979,EDS 204R,A01,507319,Halter; Christopher P.,6,0,30,24
1713303771979,EDS 204R,B01,507331,Heinzman; Erica M.,30,0,30,0
1713303773008,EDS 206R,A00,507332,Staff,8,0,30,22
1713303773008,EDS 206R,B00,507343,Staff,29,0,30,1
1713303774034,EDS 250,A00,507344,Hemans; Patricia Ann Benitez,36,0,40,4
1713303775060,EDS 281,A00,507345,Daly; Alan J.,18,0,18,0
1713303776088,EDS 284,A00,507350,Daly; Alan J.,16,0,16,0
1713303777116,EDS 286,A00,507359,Fine; Sarah,18,0,18,0
1713303778142,EDS 289C,A01,507361,Daly; Alan J.,18,0,18,0
1713303779169,EDS 290,A00,507366,Hofstetter; Carolyn,15,0,15,0
1713303780196,LIGM 5A,A00,507421,Fischer-Grunski; Eva K,20,0,20,0
1713303781222,LIGM 5B,A00,507423,Fischer-Grunski; Eva K,20,0,20,0
1713303782252,LIGM 5C,A00,507425,Fischer-Grunski; Eva K,20,0,20,0
1713303783282,LIIT 5AS,A00,507427,Carnelos; Chiara,20,0,20,0
1713303784306,LIIT 5BS,A00,507430,Carnelos; Chiara,20,0,20,0
1713303785334,LIIT 5CS,A00,507432,Carnelos; Chiara,20,0,20,0
1713303786361,LISP 5A,A00,507541,Munoz Sanchez; Alicia,19,0,20,1
1713303787386,LISP 5B,A00,507671,Munoz Sanchez; Alicia,17,0,20,3
1713303788412,LISP 5C,A00,507696,Munoz Sanchez; Alicia,18,0,20,2
1713303789436,MAE 197,001,528363,Boechler; Nicholas Sebastia,9999,0,9999,0
1713303790461,MATH 197,001,523477,Kedlaya; Kiran S.,9999,0,9999,0
1713303790461,MATH 197,002,563811,Zhang; Danna,9999,0,9999,0
1713303791490,MCWP 40R,A00,518780,Staff,20,0,20,0
1713303791490,MCWP 40R,B00,518781,Staff,20,0,20,0
1713303791490,MCWP 40R,C00,518783,Staff,20,0,20,0
1713303792516,MCWP 50R,A00,518791,Staff,20,0,20,0
1713303792516,MCWP 50R,B00,518792,Staff,20,0,20,0
1713303792516,MCWP 50R,C00,518793,Staff,19,0,20,1
1713303792516,MCWP 50R,D00,518794,Staff,19,0,20,1
1713303792516,MCWP 50R,E00,518795,Staff,19,0,20,1
1713303792516,MCWP 50R,F00,518796,Staff,20,0,20,0
1713303792516,MCWP 50R,G00,518797,Staff,19,0,20,1
1713303793595,MMW 12R,A01,514034,Herbst; Matthew,16,0,16,0
1713303793595,MMW 12R,A02,514035,Herbst; Matthew,16,0,16,0
1713303794623,MMW 13R,A01,514037,Staff,16,0,16,0
1713303794623,MMW 13R,A02,514039,Staff,16,0,16,0
1713303795649,RMED 296,001,626776,Averbach; Sarah Helene,1,0,1,0
1713303796675,SIO 295LS,A00,523233,Staff,19,0,30,11
1713303797704,SIO 295S,A00,523232,Staff,19,0,30,11
1713303798730,SOCI 117,A01,494376,Staff,3,0,5,2
1713303799758,WES 237B,A00,494380,Staff,19,0,20,1
1713303801827,AESE 279B,A00,494370,Wade; Jon P,33,0,33,0
1713303802854,ANAR 135S,A00,494369,Braswell; Geoffrey E.,0,0,0,0
1713303803891,CAT 124RS,A01,519847,Geibel; William,17,0,20,3
1713303804916,CAT 125RS,A01,515971,Geibel; William,17,0,20,3
1713303805940,CLRE 250,A00,511389,Morris; Sheldon,9996,0,9999,3
1713303806968,CLRE 251,A00,507176,Mehta; Ravindra L.,9996,0,9999,3
1713303806968,CLRE 251,B00,511410,Mehta; Ravindra L.,9998,0,9999,1
1713303807994,CLRE 252,A00,507189,Cuomo; Raphael Eduardo,9998,0,9999,1
1713303809018,CLRE 253,A00,507199,Vaida; Florin,9997,0,9999,2
1713303809018,CLRE 253,B00,507202,Vaida; Florin,9999,0,9999,0
1713303810043,CLRE 259,A00,507211,Patel; Hemal,9996,0,9999,3
1713303811068,CLRE 260,A00,507221,Cuomo; Raphael Eduardo,9999,0,9999,0
1713303812096,CLRE 297,001,507242,Cuomo; Raphael Eduardo,9999,0,9999,0
1713303813124,CSE 191,A00,516875,Minnes Kemp; Mor Mia,9999,0,9999,0
1713303814156,CSS 201S,A01,494383,Staff,35,0,35,0
1713303815185,CSS 202S,A01,494387,Staff,35,0,35,0
1713303816209,EAP 100,A00,516065,Staff,9792,0,9999,207
1713303817280,ECE 45,A01,507414,Staff,56,0,60,4
1713303818310,ECE 100,A01,507416,Baghdadchi; Saharnaz,12,0,20,8
1713303818310,ECE 100,A02,507418,Baghdadchi; Saharnaz,20,0,20,0
1713303819338,ECE 111,A01,507420,Staff,41,0,50,9
1713303820364,ECE 197,001,548057,Sievenpiper; Daniel F.,9999,0,9999,0
1713303821389,EDS 115,A00,507243,Choi; Bailey Miyeon,28,0,28,0
1713303822413,EDS 117,A01,494379,Staff,25,0,25,0
1713303823442,EDS 125,A00,507246,Hopkins; Megan Beth,29,0,30,1
1713303824472,EDS 128A,A01,507264,Fargason; Sharon Gayle,26,0,26,0
1713303825495,EDS 128B,A01,507293,Pappas; Elizabeth,30,0,30,0
1713303826519,EDS 139,A00,507294,Fargason; Sharon Gayle,30,0,30,0
1713303826519,EDS 139,B00,507313,Pappas; Elizabeth,30,0,30,0
1713303827549,EDS 201,A00,507315,Staff,26,0,30,4
1713303828578,EDS 203,A01,507317,Halter; Christopher P.,26,0,30,4
1713303829608,EDS 204R,A01,507319,Halter; Christopher P.,6,0,30,24
1713303829608,EDS 204R,B01,507331,Heinzman; Erica M.,30,0,30,0
1713303830634,EDS 206R,A00,507332,Staff,8,0,30,22
1713303830634,EDS 206R,B00,507343,Staff,29,0,30,1
1713303831658,EDS 250,A00,507344,Hemans; Patricia Ann Benitez,36,0,40,4
1713303832686,EDS 281,A00,507345,Daly; Alan J.,18,0,18,0
1713303833713,EDS 284,A00,507350,Daly; Alan J.,16,0,16,0
1713303834741,EDS 286,A00,507359,Fine; Sarah,18,0,18,0
1713303835766,EDS 289C,A01,507361,Daly; Alan J.,18,0,18,0
1713303836791,EDS 290,A00,507366,Hofstetter; Carolyn,15,0,15,0
1713303837816,LIGM 5A,A00,507421,Fischer-Grunski; Eva K,20,0,20,0
1713303838841,LIGM 5B,A00,507423,Fischer-Grunski; Eva K,20,0,20,0
1713303839868,LIGM 5C,A00,507425,Fischer-Grunski; Eva K,20,0,20,0
1713303840893,LIIT 5AS,A00,507427,Carnelos; Chiara,20,0,20,0
1713303841925,LIIT 5BS,A00,507430,Carnelos; Chiara,20,0,20,0
1713303842950,LIIT 5CS,A00,507432,Carnelos; Chiara,20,0,20,0
1713303843974,LISP 5A,A00,507541,Munoz Sanchez; Alicia,19,0,20,1
1713303844999,LISP 5B,A00,507671,Munoz Sanchez; Alicia,17,0,20,3
1713303846025,LISP 5C,A00,507696,Munoz Sanchez; Alicia,18,0,20,2
1713303847055,MAE 197,001,528363,Boechler; Nicholas Sebastia,9999,0,9999,0
1713303848082,MATH 197,001,523477,Kedlaya; Kiran S.,9999,0,9999,0
1713303848082,MATH 197,002,563811,Zhang; Danna,9999,0,9999,0
1713303849106,MCWP 40R,A00,518780,Staff,20,0,20,0
1713303849106,MCWP 40R,B00,518781,Staff,20,0,20,0
1713303849106,MCWP 40R,C00,518783,Staff,20,0,20,0
1713303850133,MCWP 50R,A00,518791,Staff,20,0,20,0
1713303850133,MCWP 50R,B00,518792,Staff,20,0,20,0
1713303850133,MCWP 50R,C00,518793,Staff,19,0,20,1
1713303850133,MCWP 50R,D00,518794,Staff,19,0,20,1
1713303850133,MCWP 50R,E00,518795,Staff,19,0,20,1
1713303850133,MCWP 50R,F00,518796,Staff,20,0,20,0
1713303850133,MCWP 50R,G00,518797,Staff,19,0,20,1
1713303851156,MMW 12R,A01,514034,Herbst; Matthew,16,0,16,0
1713303851156,MMW 12R,A02,514035,Herbst; Matthew,16,0,16,0
1713303852187,MMW 13R,A01,514037,Staff,16,0,16,0
1713303852187,MMW 13R,A02,514039,Staff,16,0,16,0
1713303853221,RMED 296,001,626776,Averbach; Sarah Helene,1,0,1,0
1713303854245,SIO 295LS,A00,523233,Staff,19,0,30,11
1713303855275,SIO 295S,A00,523232,Staff,19,0,30,11
1713303856300,SOCI 117,A01,494376,Staff,3,0,5,2
1713303857328,WES 237B,A00,494380,Staff,19,0,20,1
1713303859397,AESE 279B,A00,494370,Wade; Jon P,33,0,33,0
1713303860422,ANAR 135S,A00,494369,Braswell; Geoffrey E.,0,0,0,0
1713303861446,CAT 124RS,A01,519847,Geibel; William,17,0,20,3
1713303862470,CAT 125RS,A01,515971,Geibel; William,17,0,20,3
1713303863500,CLRE 250,A00,511389,Morris; Sheldon,9996,0,9999,3
1713303864528,CLRE 251,A00,507176,Mehta; Ravindra L.,9996,0,9999,3
1713303864528,CLRE 251,B00,511410,Mehta; Ravindra L.,9998,0,9999,1
1713303865555,CLRE 252,A00,507189,Cuomo; Raphael Eduardo,9998,0,9999,1
1713303866582,CLRE 253,A00,507199,Vaida; Florin,9997,0,9999,2
1713303866582,CLRE 253,B00,507202,Vaida; Florin,9999,0,9999,0
1713303867606,CLRE 259,A00,507211,Patel; Hemal,9996,0,9999,3
1713303868632,CLRE 260,A00,507221,Cuomo; Raphael Eduardo,9999,0,9999,0
1713303869657,CLRE 297,001,507242,Cuomo; Raphael Eduardo,9999,0,9999,0
1713303870685,CSE 191,A00,516875,Minnes Kemp; Mor Mia,9999,0,9999,0
1713303871719,CSS 201S,A01,494383,Staff,35,0,35,0
1713303872748,CSS 202S,A01,494387,Staff,35,0,35,0
1713303873774,EAP 100,A00,516065,Staff,9792,0,9999,207
1713303874801,ECE 45,A01,507414,Staff,56,0,60,4
1713303875828,ECE 100,A01,507416,Baghdadchi; Saharnaz,12,0,20,8
1713303875828,ECE 100,A02,507418,Baghdadchi; Saharnaz,20,0,20,0
1713303876853,ECE 111,A01,507420,Staff,42,0,50,8
1713303877880,ECE 197,001,548057,Sievenpiper; Daniel F.,9999,0,9999,0
1713303878906,EDS 115,A00,507243,Choi; Bailey Miyeon,28,0,28,0
1713303879932,EDS 117,A01,494379,Staff,25,0,25,0
1713303880961,EDS 125,A00,507246,Hopkins; Megan Beth,29,0,30,1
1713303881987,EDS 128A,A01,507264,Fargason; Sharon Gayle,26,0,26,0
1713303883014,EDS 128B,A01,507293,Pappas; Elizabeth,30,0,30,0
1713303884039,EDS 139,A00,507294,Fargason; Sharon Gayle,30,0,30,0
1713303884039,EDS 139,B00,507313,Pappas; Elizabeth,30,0,30,0
1713303885064,EDS 201,A00,507315,Staff,26,0,30,4
1713303886091,EDS 203,A01,507317,Halter; Christopher P.,26,0,30,4
1713303887117,EDS 204R,A01,507319,Halter; Christopher P.,6,0,30,24
1713303887117,EDS 204R,B01,507331,Heinzman; Erica M.,30,0,30,0
1713303888146,EDS 206R,A00,507332,Staff,8,0,30,22
1713303888146,EDS 206R,B00,507343,Staff,29,0,30,1
1713303889170,EDS 250,A00,507344,Hemans; Patricia Ann Benitez,36,0,40,4
1713303890197,EDS 281,A00,507345,Daly; Alan J.,18,0,18,0
1713303891222,EDS 284,A00,507350,Daly; Alan J.,16,0,16,0
1713303892246,EDS 286,A00,507359,Fine; Sarah,18,0,18,0
1713303893274,EDS 289C,A01,507361,Daly; Alan J.,18,0,18,0
1713303894298,EDS 290,A00,507366,Hofstetter; Carolyn,15,0,15,0
1713303895324,LIGM 5A,A00,507421,Fischer-Grunski; Eva K,20,0,20,0
1713303896349,LIGM 5B,A00,507423,Fischer-Grunski; Eva K,20,0,20,0
1713303897428,LIGM 5C,A00,507425,Fischer-Grunski; Eva K,20,0,20,0
1713303898454,LIIT 5AS,A00,507427,Carnelos; Chiara,20,0,20,0
1713303899485,LIIT 5BS,A00,507430,Carnelos; Chiara,20,0,20,0
1713303900509,LIIT 5CS,A00,507432,Carnelos; Chiara,20,0,20,0
1713303901539,LISP 5A,A00,507541,Munoz Sanchez; Alicia,19,0,20,1
1713303902564,LISP 5B,A00,507671,Munoz Sanchez; Alicia,17,0,20,3
1713303903588,LISP 5C,A00,507696,Munoz Sanchez; Alicia,18,0,20,2
1713303904612,MAE 197,001,528363,Boechler; Nicholas Sebastia,9999,0,9999,0
1713303905638,MATH 197,001,523477,Kedlaya; Kiran S.,9999,0,9999,0
1713303905638,MATH 197,002,563811,Zhang; Danna,9999,0,9999,0
1713303906666,MCWP 40R,A00,518780,Staff,20,0,20,0
1713303906666,MCWP 40R,B00,518781,Staff,20,0,20,0
1713303906666,MCWP 40R,C00,518783,Staff,20,0,20,0
1713303907691,MCWP 50R,A00,518791,Staff,20,0,20,0
1713303907691,MCWP 50R,B00,518792,Staff,20,0,20,0
1713303907691,MCWP 50R,C00,518793,Staff,19,0,20,1
1713303907691,MCWP 50R,D00,518794,Staff,19,0,20,1
1713303907691,MCWP 50R,E00,518795,Staff,19,0,20,1
1713303907691,MCWP 50R,F00,518796,Staff,20,0,20,0
1713303907691,MCWP 50R,G00,518797,Staff,19,0,20,1
1713303908723,MMW 12R,A01,514034,Herbst; Matthew,16,0,16,0
1713303908723,MMW 12R,A02,514035,Herbst; Matthew,16,0,16,0
1713303909748,MMW 13R,A01,514037,Staff,16,0,16,0
1713303909748,MMW 13R,A02,514039,Staff,16,0,16,0
1713303910773,RMED 296,001,626776,Averbach; Sarah Helene,1,0,1,0
1713303911799,SIO 295LS,A00,523233,Staff,19,0,30,11
1713303912828,SIO 295S,A00,523232,Staff,19,0,30,11
1713303913858,SOCI 117,A01,494376,Staff,3,0,5,2
1713303914883,WES 237B,A00,494380,Staff,19,0,20,1
1713303916957,AESE 279B,A00,494370,Wade; Jon P,33,0,33,0
1713303917982,ANAR 135S,A00,494369,Braswell; Geoffrey E.,0,0,0,0
1713303919008,CAT 124RS,A01,519847,Geibel; William,17,0,20,3
1713303920039,CAT 125RS,A01,515971,Geibel; William,17,0,20,3
1713303921065,CLRE 250,A00,511389,Morris; Sheldon,9996,0,9999,3
1713303922096,CLRE 251,A00,507176,Mehta; Ravindra L.,9996,0,9999,3
1713303922096,CLRE 251,B00,511410,Mehta; Ravindra L.,9998,0,9999,1
1713303923129,CLRE 252,A00,507189,Cuomo; Raphael Eduardo,9998,0,9999,1
1713303924159,CLRE 253,A00,507199,Vaida; Florin,9997,0,9999,2
1713303924159,CLRE 253,B00,507202,Vaida; Florin,9999,0,9999,0
1713303925189,CLRE 259,A00,507211,Patel; Hemal,9996,0,9999,3
1713303926218,CLRE 260,A00,507221,Cuomo; Raphael Eduardo,9999,0,9999,0
1713303927243,CLRE 297,001,507242,Cuomo; Raphael Eduardo,9999,0,9999,0
1713303928269,CSE 191,A00,516875,Minnes Kemp; Mor Mia,9999,0,9999,0
1713303929298,CSS 201S,A01,494383,Staff,35,0,35,0
1713303930323,CSS 202S,A01,494387,Staff,35,0,35,0
1713303931348,EAP 100,A00,516065,Staff,9792,0,9999,207
1713303932377,ECE 45,A01,507414,Staff,56,0,60,4
1713303933400,ECE 100,A01,507416,Baghdadchi; Saharnaz,12,0,20,8
1713303933400,ECE 100,A02,507418,Baghdadchi; Saharnaz,20,0,20,0
1713303934426,ECE 111,A01,507420,Staff,42,0,50,8
1713303935452,ECE 197,001,548057,Sievenpiper; Daniel F.,9999,0,9999,0
1713303936477,EDS 115,A00,507243,Choi; Bailey Miyeon,28,0,28,0
1713303937508,EDS 117,A01,494379,Staff,25,0,25,0
1713303938534,EDS 125,A00,507246,Hopkins; Megan Beth,29,0,30,1
1713303939558,EDS 128A,A01,507264,Fargason; Sharon Gayle,26,0,26,0
1713303940584,EDS 128B,A01,507293,Pappas; Elizabeth,30,0,30,0
1713303941609,EDS 139,A00,507294,Fargason; Sharon Gayle,30,0,30,0
1713303941609,EDS 139,B00,507313,Pappas; Elizabeth,30,0,30,0
1713303942633,EDS 201,A00,507315,Staff,26,0,30,4
1713303943659,EDS 203,A01,507317,Halter; Christopher P.,26,0,30,4
1713303944684,EDS 204R,A01,507319,Halter; Christopher P.,6,0,30,24
1713303944684,EDS 204R,B01,507331,Heinzman; Erica M.,30,0,30,0
1713303945709,EDS 206R,A00,507332,Staff,8,0,30,22
1713303945709,EDS 206R,B00,507343,Staff,29,0,30,1
1713303946734,EDS 250,A00,507344,Hemans; Patricia Ann Benitez,36,0,40,4
1713303947767,EDS 281,A00,507345,Daly; Alan J.,18,0,18,0
1713303948793,EDS 284,A00,507350,Daly; Alan J.,16,0,16,0
1713303949818,EDS 286,A00,507359,Fine; Sarah,18,0,18,0
1713303950848,EDS 289C,A01,507361,Daly; Alan J.,18,0,18,0
1713303951872,EDS 290,A00,507366,Hofstetter; Carolyn,15,0,15,0
1713303952902,LIGM 5A,A00,507421,Fischer-Grunski; Eva K,20,0,20,0
1713303953932,LIGM 5B,A00,507423,Fischer-Grunski; Eva K,20,0,20,0
1713303954957,LIGM 5C,A00,507425,Fischer-Grunski; Eva K,20,0,20,0
1713303955985,LIIT 5AS,A00,507427,Carnelos; Chiara,20,0,20,0
1713303957013,LIIT 5BS,A00,507430,Carnelos; Chiara,20,0,20,0
1713303958038,LIIT 5CS,A00,507432,Carnelos; Chiara,20,0,20,0
1713303959069,LISP 5A,A00,507541,Munoz Sanchez; Alicia,19,0,20,1
1713303960112,LISP 5B,A00,507671,Munoz Sanchez; Alicia,17,0,20,3
1713303961138,LISP 5C,A00,507696,Munoz Sanchez; Alicia,18,0,20,2
1713303962164,MAE 197,001,528363,Boechler; Nicholas Sebastia,9999,0,9999,0
1713303963188,MATH 197,001,523477,Kedlaya; Kiran S.,9999,0,9999,0
1713303963188,MATH 197,002,563811,Zhang; Danna,9999,0,9999,0
1713303964214,MCWP 40R,A00,518780,Staff,20,0,20,0
1713303964214,MCWP 40R,B00,518781,Staff,20,0,20,0
1713303964214,MCWP 40R,C00,518783,Staff,19,0,20,1
1713303965242,MCWP 50R,A00,518791,Staff,20,0,20,0
1713303965242,MCWP 50R,B00,518792,Staff,20,0,20,0
1713303965242,MCWP 50R,C00,518793,Staff,19,0,20,1
1713303965242,MCWP 50R,D00,518794,Staff,19,0,20,1
1713303965242,MCWP 50R,E00,518795,Staff,19,0,20,1
1713303965242,MCWP 50R,F00,518796,Staff,20,0,20,0
1713303965242,MCWP 50R,G00,518797,Staff,19,0,20,1
1713303966265,MMW 12R,A01,514034,Herbst; Matthew,16,0,16,0
1713303966265,MMW 12R,A02,514035,Herbst; Matthew,16,0,16,0
1713303967290,MMW 13R,A01,514037,Staff,16,0,16,0
1713303967290,MMW 13R,A02,514039,Staff,16,0,16,0
1713303968314,RMED 296,001,626776,Averbach; Sarah Helene,1,0,1,0
1713303969338,SIO 295LS,A00,523233,Staff,19,0,30,11
1713303970362,SIO 295S,A00,523232,Staff,19,0,30,11
1713303971388,SOCI 117,A01,494376,Staff,3,0,5,2
1713303972413,WES 237B,A00,494380,Staff,19,0,20,1
1713303974491,AESE 279B,A00,494370,Wade; Jon P,33,0,33,0
1713303975518,ANAR 135S,A00,494369,Braswell; Geoffrey E.,0,0,0,0
1713303976544,CAT 124RS,A01,519847,Geibel; William,17,0,20,3
1713303977569,CAT 125RS,A01,515971,Geibel; William,17,0,20,3
1713303978598,CLRE 250,A00,511389,Morris; Sheldon,9996,0,9999,3
1713303979623,CLRE 251,A00,507176,Mehta; Ravindra L.,9996,0,9999,3
1713303979623,CLRE 251,B00,511410,Mehta; Ravindra L.,9998,0,9999,1
1713303980648,CLRE 252,A00,507189,Cuomo; Raphael Eduardo,9998,0,9999,1
1713303981674,CLRE 253,A00,507199,Vaida; Florin,9997,0,9999,2
1713303981674,CLRE 253,B00,507202,Vaida; Florin,9999,0,9999,0
1713303982700,CLRE 259,A00,507211,Patel; Hemal,9996,0,9999,3
1713303983729,CLRE 260,A00,507221,Cuomo; Raphael Eduardo,9999,0,9999,0
1713303984753,CLRE 297,001,507242,Cuomo; Raphael Eduardo,9999,0,9999,0
1713303985777,CSE 191,A00,516875,Minnes Kemp; Mor Mia,9999,0,9999,0
1713303986803,CSS 201S,A01,494383,Staff,35,0,35,0
1713303987833,CSS 202S,A01,494387,Staff,35,0,35,0
1713303988861,EAP 100,A00,516065,Staff,9792,0,9999,207
1713303989890,ECE 45,A01,507414,Staff,56,0,60,4
1713303990914,ECE 100,A01,507416,Baghdadchi; Saharnaz,12,0,20,8
1713303990914,ECE 100,A02,507418,Baghdadchi; Saharnaz,20,0,20,0
1713303991942,ECE 111,A01,507420,Staff,42,0,50,8
1713303992967,ECE 197,001,548057,Sievenpiper; Daniel F.,9999,0,9999,0
1713303993997,EDS 115,A00,507243,Choi; Bailey Miyeon,28,0,28,0
1713303995026,EDS 117,A01,494379,Staff,25,0,25,0
1713303996053,EDS 125,A00,507246,Hopkins; Megan Beth,29,0,30,1
1713303997083,EDS 128A,A01,507264,Fargason; Sharon Gayle,26,0,26,0
1713303998111,EDS 128B,A01,507293,Pappas; Elizabeth,30,0,30,0
1713303999135,EDS 139,A00,507294,Fargason; Sharon Gayle,30,0,30,0
1713303999135,EDS 139,B00,507313,Pappas; Elizabeth,30,0,30,0
1713304000158,EDS 201,A00,507315,Staff,26,0,30,4
1713304001243,EDS 203,A01,507317,Halter; Christopher P.,26,0,30,4
1713304002274,EDS 204R,A01,507319,Halter; Christopher P.,6,0,30,24
1713304002274,EDS 204R,B01,507331,Heinzman; Erica M.,30,0,30,0
1713304003297,EDS 206R,A00,507332,Staff,8,0,30,22
1713304003297,EDS 206R,B00,507343,Staff,29,0,30,1
1713304004325,EDS 250,A00,507344,Hemans; Patricia Ann Benitez,36,0,40,4
1713304005350,EDS 281,A00,507345,Daly; Alan J.,18,0,18,0
1713304006374,EDS 284,A00,507350,Daly; Alan J.,16,0,16,0
1713304007400,EDS 286,A00,507359,Fine; Sarah,18,0,18,0
1713304008425,EDS 289C,A01,507361,Daly; Alan J.,18,0,18,0
1713304009449,EDS 290,A00,507366,Hofstetter; Carolyn,15,0,15,0
1713304010484,LIGM 5A,A00,507421,Fischer-Grunski; Eva K,20,0,20,0
1713304011509,LIGM 5B,A00,507423,Fischer-Grunski; Eva K,20,0,20,0
1713304012534,LIGM 5C,A00,507425,Fischer-Grunski; Eva K,20,0,20,0
1713304013562,LIIT 5AS,A00,507427,Carnelos; Chiara,20,0,20,0
1713304014588,LIIT 5BS,A00,507430,Carnelos; Chiara,20,0,20,0
1713304015617,LIIT 5CS,A00,507432,Carnelos; Chiara,20,0,20,0
1713304016646,LISP 5A,A00,507541,Munoz Sanchez; Alicia,19,0,20,1
1713304017675,LISP 5B,A00,507671,Munoz Sanchez; Alicia,17,0,20,3
1713304018702,LISP 5C,A00,507696,Munoz Sanchez; Alicia,18,0,20,2
1713304019727,MAE 197,001,528363,Boechler; Nicholas Sebastia,9999,0,9999,0
1713304020753,MATH 197,001,523477,Kedlaya; Kiran S.,9999,0,9999,0
1713304020753,MATH 197,002,563811,Zhang; Danna,9999,0,9999,0
1713304021778,MCWP 40R,A00,518780,Staff,20,0,20,0
1713304021778,MCWP 40R,B00,518781,Staff,20,0,20,0
1713304021778,MCWP 40R,C00,518783,Staff,19,0,20,1
1713304022804,MCWP 50R,A00,518791,Staff,20,0,20,0
1713304022804,MCWP 50R,B00,518792,Staff,20,0,20,0
1713304022804,MCWP 50R,C00,518793,Staff,19,0,20,1
1713304022804,MCWP 50R,D00,518794,Staff,19,0,20,1
1713304022804,MCWP 50R,E00,518795,Staff,19,0,20,1
1713304022804,MCWP 50R,F00,518796,Staff,20,0,20,0
1713304022804,MCWP 50R,G00,518797,Staff,19,0,20,1
1713304023830,MMW 12R,A01,514034,Herbst; Matthew,16,0,16,0
1713304023830,MMW 12R,A02,514035,Herbst; Matthew,16,0,16,0
1713304024859,MMW 13R,A01,514037,Staff,16,0,16,0
1713304024859,MMW 13R,A02,514039,Staff,16,0,16,0
1713304025888,RMED 296,001,626776,Averbach; Sarah Helene,1,0,1,0
1713304026919,SIO 295LS,A00,523233,Staff,19,0,30,11
1713304027946,SIO 295S,A00,523232,Staff,19,0,30,11
1713304028975,SOCI 117,A01,494376,Staff,3,0,5,2
1713304030004,WES 237B,A00,494380,Staff,19,0,20,1
1713304032082,AESE 279B,A00,494370,Wade; Jon P,33,0,33,0
1713304033112,ANAR 135S,A00,494369,Braswell; Geoffrey E.,0,0,0,0
1713304034141,CAT 124RS,A01,519847,Geibel; William,17,0,20,3
1713304035167,CAT 125RS,A01,515971,Geibel; William,17,0,20,3
1713304036196,CLRE 250,A00,511389,Morris; Sheldon,9996,0,9999,3
1713304037228,CLRE 251,A00,507176,Mehta; Ravindra L.,9996,0,9999,3
1713304037228,CLRE 251,B00,511410,Mehta; Ravindra L.,9998,0,9999,1
1713304038253,CLRE 252,A00,507189,Cuomo; Raphael Eduardo,9998,0,9999,1
1713304039283,CLRE 253,A00,507199,Vaida; Florin,9997,0,9999,2
1713304039283,CLRE 253,B00,507202,Vaida; Florin,9999,0,9999,0
1713304040310,CLRE 259,A00,507211,Patel; Hemal,9996,0,9999,3
1713304041338,CLRE 260,A00,507221,Cuomo; Raphael Eduardo,9999,0,9999,0
1713304042367,CLRE 297,001,507242,Cuomo; Raphael Eduardo,9999,0,9999,0
1713304043394,CSE 191,A00,516875,Minnes Kemp; Mor Mia,9999,0,9999,0
1713304044419,CSS 201S,A01,494383,Staff,35,0,35,0
1713304045444,CSS 202S,A01,494387,Staff,35,0,35,0
1713304046483,EAP 100,A00,516065,Staff,9792,0,9999,207
1713304047508,ECE 45,A01,507414,Staff,56,0,60,4
1713304048534,ECE 100,A01,507416,Baghdadchi; Saharnaz,12,0,20,8
1713304048534,ECE 100,A02,507418,Baghdadchi; Saharnaz,20,0,20,0
1713304049560,ECE 111,A01,507420,Staff,42,0,50,8
1713304050586,ECE 197,001,548057,Sievenpiper; Daniel F.,9999,0,9999,0
1713304051611,EDS 115,A00,507243,Choi; Bailey Miyeon,28,0,28,0
1713304052640,EDS 117,A01,494379,Staff,25,0,25,0
1713304053670,EDS 125,A00,507246,Hopkins; Megan Beth,29,0,30,1
1713304054699,EDS 128A,A01,507264,Fargason; Sharon Gayle,26,0,26,0
1713304055731,EDS 128B,A01,507293,Pappas; Elizabeth,30,0,30,0
1713304056759,EDS 139,A00,507294,Fargason; Sharon Gayle,30,0,30,0
1713304056759,EDS 139,B00,507313,Pappas; Elizabeth,30,0,30,0
1713304057787,EDS 201,A00,507315,Staff,26,0,30,4
1713304058818,EDS 203,A01,507317,Halter; Christopher P.,26,0,30,4
1713304059844,EDS 204R,A01,507319,Halter; Christopher P.,6,0,30,24
1713304059844,EDS 204R,B01,507331,Heinzman; Erica M.,30,0,30,0
1713304060892,EDS 206R,A00,507332,Staff,8,0,30,22
1713304060892,EDS 206R,B00,507343,Staff,29,0,30,1
1713304061920,EDS 250,A00,507344,Hemans; Patricia Ann Benitez,36,0,40,4
1713304062951,EDS 281,A00,507345,Daly; Alan J.,18,0,18,0
1713304063976,EDS 284,A00,507350,Daly; Alan J.,16,0,16,0
1713304065006,EDS 286,A00,507359,Fine; Sarah,18,0,18,0
1713304066030,EDS 289C,A01,507361,Daly; Alan J.,18,0,18,0
1713304067055,EDS 290,A00,507366,Hofstetter; Carolyn,15,0,15,0
1713304068082,LIGM 5A,A00,507421,Fischer-Grunski; Eva K,20,0,20,0
1713304069113,LIGM 5B,A00,507423,Fischer-Grunski; Eva K,20,0,20,0
1713304070142,LIGM 5C,A00,507425,Fischer-Grunski; Eva K,20,0,20,0
1713304071173,LIIT 5AS,A00,507427,Carnelos; Chiara,20,0,20,0
1713304072203,LIIT 5BS,A00,507430,Carnelos; Chiara,20,0,20,0
1713304073228,LIIT 5CS,A00,507432,Carnelos; Chiara,20,0,20,0
1713304074262,LISP 5A,A00,507541,Munoz Sanchez; Alicia,19,0,20,1
1713304075293,LISP 5B,A00,507671,Munoz Sanchez; Alicia,17,0,20,3
1713304076324,LISP 5C,A00,507696,Munoz Sanchez; Alicia,18,0,20,2
1713304077350,MAE 197,001,528363,Boechler; Nicholas Sebastia,9999,0,9999,0
1713304078377,MATH 197,001,523477,Kedlaya; Kiran S.,9999,0,9999,0
1713304078377,MATH 197,002,563811,Zhang; Danna,9999,0,9999,0
1713304079402,MCWP 40R,A00,518780,Staff,20,0,20,0
1713304079402,MCWP 40R,B00,518781,Staff,20,0,20,0
1713304079402,MCWP 40R,C00,518783,Staff,19,0,20,1
1713304080449,MCWP 50R,A00,518791,Staff,20,0,20,0
1713304080449,MCWP 50R,B00,518792,Staff,20,0,20,0
1713304080449,MCWP 50R,C00,518793,Staff,19,0,20,1
1713304080449,MCWP 50R,D00,518794,Staff,19,0,20,1
1713304080449,MCWP 50R,E00,518795,Staff,19,0,20,1
1713304080449,MCWP 50R,F00,518796,Staff,20,0,20,0
1713304080449,MCWP 50R,G00,518797,Staff,19,0,20,1
1713304081480,MMW 12R,A01,514034,Herbst; Matthew,16,0,16,0
1713304081480,MMW 12R,A02,514035,Herbst; Matthew,16,0,16,0
1713304082508,MMW 13R,A01,514037,Staff,16,0,16,0
1713304082508,MMW 13R,A02,514039,Staff,16,0,16,0
1713304083533,RMED 296,001,626776,Averbach; Sarah Helene,1,0,1,0
1713304084565,SIO 295LS,A00,523233,Staff,19,0,30,11
1713304085590,SIO 295S,A00,523232,Staff,19,0,30,11
1713304086616,SOCI 117,A01,494376,Staff,3,0,5,2
1713304087640,WES 237B,A00,494380,Staff,19,0,20,1
1713304089711,AESE 279B,A00,494370,Wade; Jon P,33,0,33,0
1713304090738,ANAR 135S,A00,494369,Braswell; Geoffrey E.,0,0,0,0
1713304091765,CAT 124RS,A01,519847,Geibel; William,17,0,20,3
1713304092797,CAT 125RS,A01,515971,Geibel; William,17,0,20,3
1713304093824,CLRE 250,A00,511389,Morris; Sheldon,9996,0,9999,3
1713304094854,CLRE 251,A00,507176,Mehta; Ravindra L.,9996,0,9999,3
1713304094854,CLRE 251,B00,511410,Mehta; Ravindra L.,9998,0,9999,1
1713304095886,CLRE 252,A00,507189,Cuomo; Raphael Eduardo,9998,0,9999,1
1713304096912,CLRE 253,A00,507199,Vaida; Florin,9997,0,9999,2
1713304096912,CLRE 253,B00,507202,Vaida; Florin,9999,0,9999,0
1713304097938,CLRE 259,A00,507211,Patel; Hemal,9996,0,9999,3
1713304098964,CLRE 260,A00,507221,Cuomo; Raphael Eduardo,9999,0,9999,0
1713304099991,CLRE 297,001,507242,Cuomo; Raphael Eduardo,9999,0,9999,0
1713304101017,CSE 191,A00,516875,Minnes Kemp; Mor Mia,9999,0,9999,0
1713304102048,CSS 201S,A01,494383,Staff,35,0,35,0
1713304103078,CSS 202S,A01,494387,Staff,35,0,35,0
1713304104102,EAP 100,A00,516065,Staff,9792,0,9999,207
1713304105187,ECE 45,A01,507414,Staff,56,0,60,4
1713304106214,ECE 100,A01,507416,Baghdadchi; Saharnaz,12,0,20,8
1713304106214,ECE 100,A02,507418,Baghdadchi; Saharnaz,20,0,20,0
1713304107242,ECE 111,A01,507420,Staff,42,0,50,8
1713304108272,ECE 197,001,548057,Sievenpiper; Daniel F.,9999,0,9999,0
1713304109302,EDS 115,A00,507243,Choi; Bailey Miyeon,28,0,28,0
1713304110329,EDS 117,A01,494379,Staff,25,0,25,0
1713304111354,EDS 125,A00,507246,Hopkins; Megan Beth,29,0,30,1
1713304112382,EDS 128A,A01,507264,Fargason; Sharon Gayle,26,0,26,0
1713304113407,EDS 128B,A01,507293,Pappas; Elizabeth,30,0,30,0
1713304114432,EDS 139,A00,507294,Fargason; Sharon Gayle,30,0,30,0
1713304114432,EDS 139,B00,507313,Pappas; Elizabeth,30,0,30,0
1713304115456,EDS 201,A00,507315,Staff,26,0,30,4
1713304116482,EDS 203,A01,507317,Halter; Christopher P.,26,0,30,4
1713304117508,EDS 204R,A01,507319,Halter; Christopher P.,6,0,30,24
1713304117508,EDS 204R,B01,507331,Heinzman; Erica M.,30,0,30,0
1713304118536,EDS 206R,A00,507332,Staff,8,0,30,22
1713304118536,EDS 206R,B00,507343,Staff,29,0,30,1
1713304119559,EDS 250,A00,507344,Hemans; Patricia Ann Benitez,36,0,40,4
1713304120588,EDS 281,A00,507345,Daly; Alan J.,18,0,18,0
1713304121615,EDS 284,A00,507350,Daly; Alan J.,16,0,16,0
1713304122644,EDS 286,A00,507359,Fine; Sarah,18,0,18,0
1713304123671,EDS 289C,A01,507361,Daly; Alan J.,18,0,18,0
1713304124696,EDS 290,A00,507366,Hofstetter; Carolyn,15,0,15,0
1713304125723,LIGM 5A,A00,507421,Fischer-Grunski; Eva K,20,0,20,0
1713304126749,LIGM 5B,A00,507423,Fischer-Grunski; Eva K,20,0,20,0
1713304127775,LIGM 5C,A00,507425,Fischer-Grunski; Eva K,20,0,20,0
1713304128801,LIIT 5AS,A00,507427,Carnelos; Chiara,20,0,20,0
1713304129832,LIIT 5BS,A00,507430,Carnelos; Chiara,20,0,20,0
1713304130857,LIIT 5CS,A00,507432,Carnelos; Chiara,20,0,20,0
1713304131888,LISP 5A,A00,507541,Munoz Sanchez; Alicia,19,0,20,1
1713304132920,LISP 5B,A00,507671,Munoz Sanchez; Alicia,17,0,20,3
1713304133946,LISP 5C,A00,507696,Munoz Sanchez; Alicia,18,0,20,2
1713304134976,MAE 197,001,528363,Boechler; Nicholas Sebastia,9999,0,9999,0
1713304136005,MATH 197,001,523477,Kedlaya; Kiran S.,9999,0,9999,0
1713304136005,MATH 197,002,563811,Zhang; Danna,9999,0,9999,0
1713304137039,MCWP 40R,A00,518780,Staff,20,0,20,0
1713304137039,MCWP 40R,B00,518781,Staff,20,0,20,0
1713304137039,MCWP 40R,C00,518783,Staff,19,0,20,1
1713304138068,MCWP 50R,A00,518791,Staff,20,0,20,0
1713304138068,MCWP 50R,B00,518792,Staff,20,0,20,0
1713304138068,MCWP 50R,C00,518793,Staff,19,0,20,1
1713304138068,MCWP 50R,D00,518794,Staff,19,0,20,1
1713304138068,MCWP 50R,E00,518795,Staff,19,0,20,1
1713304138068,MCWP 50R,F00,518796,Staff,20,0,20,0
1713304138068,MCWP 50R,G00,518797,Staff,19,0,20,1
1713304139094,MMW 12R,A01,514034,Herbst; Matthew,16,0,16,0
1713304139094,MMW 12R,A02,514035,Herbst; Matthew,16,0,16,0
1713304140120,MMW 13R,A01,514037,Staff,16,0,16,0
1713304140120,MMW 13R,A02,514039,Staff,16,0,16,0
1713304141154,RMED 296,001,626776,Averbach; Sarah Helene,1,0,1,0
1713304142184,SIO 295LS,A00,523233,Staff,19,0,30,11
1713304143215,SIO 295S,A00,523232,Staff,19,0,30,11
1713304144246,SOCI 117,A01,494376,Staff,3,0,5,2
1713304145272,WES 237B,A00,494380,Staff,19,0,20,1
1713304147338,AESE 279B,A00,494370,Wade; Jon P,33,0,33,0
1713304148362,ANAR 135S,A00,494369,Braswell; Geoffrey E.,0,0,0,0
1713304149399,CAT 124RS,A01,519847,Geibel; William,17,0,20,3
1713304150426,CAT 125RS,A01,515971,Geibel; William,17,0,20,3
1713304151455,CLRE 250,A00,511389,Morris; Sheldon,9996,0,9999,3
1713304152488,CLRE 251,A00,507176,Mehta; Ravindra L.,9996,0,9999,3
1713304152488,CLRE 251,B00,511410,Mehta; Ravindra L.,9998,0,9999,1
1713304153511,CLRE 252,A00,507189,Cuomo; Raphael Eduardo,9998,0,9999,1
1713304154536,CLRE 253,A00,507199,Vaida; Florin,9997,0,9999,2
1713304154536,CLRE 253,B00,507202,Vaida; Florin,9999,0,9999,0
1713304155570,CLRE 259,A00,507211,Patel; Hemal,9996,0,9999,3
1713304156598,CLRE 260,A00,507221,Cuomo; Raphael Eduardo,9999,0,9999,0
1713304157624,CLRE 297,001,507242,Cuomo; Raphael Eduardo,9999,0,9999,0
1713304158648,CSE 191,A00,516875,Minnes Kemp; Mor Mia,9999,0,9999,0
1713304159674,CSS 201S,A01,494383,Staff,35,0,35,0
1713304160704,CSS 202S,A01,494387,Staff,35,0,35,0
1713304161729,EAP 100,A00,516065,Staff,9792,0,9999,207
1713304162759,ECE 45,A01,507414,Staff,56,0,60,4
1713304163792,ECE 100,A01,507416,Baghdadchi; Saharnaz,12,0,20,8
1713304163792,ECE 100,A02,507418,Baghdadchi; Saharnaz,20,0,20,0
1713304164817,ECE 111,A01,507420,Staff,42,0,50,8
1713304165843,ECE 197,001,548057,Sievenpiper; Daniel F.,9999,0,9999,0
1713304166869,EDS 115,A00,507243,Choi; Bailey Miyeon,28,0,28,0
1713304167895,EDS 117,A01,494379,Staff,25,0,25,0
1713304168927,EDS 125,A00,507246,Hopkins; Megan Beth,29,0,30,1
1713304169957,EDS 128A,A01,507264,Fargason; Sharon Gayle,26,0,26,0
1713304170988,EDS 128B,A01,507293,Pappas; Elizabeth,30,0,30,0
1713304172013,EDS 139,A00,507294,Fargason; Sharon Gayle,30,0,30,0
1713304172013,EDS 139,B00,507313,Pappas; Elizabeth,30,0,30,0
1713304173037,EDS 201,A00,507315,Staff,26,0,30,4
1713304174067,EDS 203,A01,507317,Halter; Christopher P.,26,0,30,4
1713304175104,EDS 204R,A01,507319,Halter; Christopher P.,6,0,30,24
1713304175104,EDS 204R,B01,507331,Heinzman; Erica M.,30,0,30,0
1713304176130,EDS 206R,A00,507332,Staff,8,0,30,22
1713304176130,EDS 206R,B00,507343,Staff,29,0,30,1
1713304177156,EDS 250,A00,507344,Hemans; Patricia Ann Benitez,36,0,40,4
1713304178181,EDS 281,A00,507345,Daly; Alan J.,18,0,18,0
1713304179209,EDS 284,A00,507350,Daly; Alan J.,16,0,16,0
1713304180242,EDS 286,A00,507359,Fine; Sarah,18,0,18,0
1713304181267,EDS 289C,A01,507361,Daly; Alan J.,18,0,18,0
1713304182291,EDS 290,A00,507366,Hofstetter; Carolyn,15,0,15,0
1713304183320,LIGM 5A,A00,507421,Fischer-Grunski; Eva K,20,0,20,0
1713304184349,LIGM 5B,A00,507423,Fischer-Grunski; Eva K,20,0,20,0
1713304185376,LIGM 5C,A00,507425,Fischer-Grunski; Eva K,20,0,20,0
1713304186407,LIIT 5AS,A00,507427,Carnelos; Chiara,20,0,20,0
1713304187433,LIIT 5BS,A00,507430,Carnelos; Chiara,20,0,20,0
1713304188462,LIIT 5CS,A00,507432,Carnelos; Chiara,20,0,20,0
1713304189487,LISP 5A,A00,507541,Munoz Sanchez; Alicia,19,0,20,1
1713304190516,LISP 5B,A00,507671,Munoz Sanchez; Alicia,17,0,20,3
1713304191544,LISP 5C,A00,507696,Munoz Sanchez; Alicia,18,0,20,2
1713304192574,MAE 197,001,528363,Boechler; Nicholas Sebastia,9999,0,9999,0
1713304193602,MATH 197,001,523477,Kedlaya; Kiran S.,9999,0,9999,0
1713304193602,MATH 197,002,563811,Zhang; Danna,9999,0,9999,0
1713304194628,MCWP 40R,A00,518780,Staff,20,0,20,0
1713304194628,MCWP 40R,B00,518781,Staff,20,0,20,0
1713304194628,MCWP 40R,C00,518783,Staff,19,0,20,1
1713304195654,MCWP 50R,A00,518791,Staff,20,0,20,0
1713304195654,MCWP 50R,B00,518792,Staff,20,0,20,0
1713304195654,MCWP 50R,C00,518793,Staff,19,0,20,1
1713304195654,MCWP 50R,D00,518794,Staff,19,0,20,1
1713304195654,MCWP 50R,E00,518795,Staff,19,0,20,1
1713304195654,MCWP 50R,F00,518796,Staff,20,0,20,0
1713304195654,MCWP 50R,G00,518797,Staff,19,0,20,1
1713304196685,MMW 12R,A01,514034,Herbst; Matthew,16,0,16,0
1713304196685,MMW 12R,A02,514035,Herbst; Matthew,16,0,16,0
1713304197709,MMW 13R,A01,514037,Staff,16,0,16,0
1713304197709,MMW 13R,A02,514039,Staff,16,0,16,0
1713304198734,RMED 296,001,626776,Averbach; Sarah Helene,1,0,1,0
1713304199760,SIO 295LS,A00,523233,Staff,19,0,30,11
1713304200786,SIO 295S,A00,523232,Staff,19,0,30,11
1713304201817,SOCI 117,A01,494376,Staff,3,0,5,2
1713304202848,WES 237B,A00,494380,Staff,19,0,20,1
1713304204931,AESE 279B,A00,494370,Wade; Jon P,33,0,33,0
1713304205958,ANAR 135S,A00,494369,Braswell; Geoffrey E.,0,0,0,0
1713304206990,CAT 124RS,A01,519847,Geibel; William,17,0,20,3
1713304208015,CAT 125RS,A01,515971,Geibel; William,17,0,20,3
1713304209097,CLRE 250,A00,511389,Morris; Sheldon,9996,0,9999,3
1713304210132,CLRE 251,A00,507176,Mehta; Ravindra L.,9996,0,9999,3
1713304210132,CLRE 251,B00,511410,Mehta; Ravindra L.,9998,0,9999,1
1713304211159,CLRE 252,A00,507189,Cuomo; Raphael Eduardo,9998,0,9999,1
1713304212184,CLRE 253,A00,507199,Vaida; Florin,9997,0,9999,2
1713304212184,CLRE 253,B00,507202,Vaida; Florin,9999,0,9999,0
1713304213212,CLRE 259,A00,507211,Patel; Hemal,9996,0,9999,3
1713304214241,CLRE 260,A00,507221,Cuomo; Raphael Eduardo,9999,0,9999,0
1713304215268,CLRE 297,001,507242,Cuomo; Raphael Eduardo,9999,0,9999,0
1713304216300,CSE 191,A00,516875,Minnes Kemp; Mor Mia,9999,0,9999,0
1713304217332,CSS 201S,A01,494383,Staff,35,0,35,0
1713304218363,CSS 202S,A01,494387,Staff,35,0,35,0
1713304219386,EAP 100,A00,516065,Staff,9792,0,9999,207
1713304220411,ECE 45,A01,507414,Staff,56,0,60,4
1713304221442,ECE 100,A01,507416,Baghdadchi; Saharnaz,12,0,20,8
1713304221442,ECE 100,A02,507418,Baghdadchi; Saharnaz,20,0,20,0
1713304222468,ECE 111,A01,507420,Staff,42,0,50,8
1713304223495,ECE 197,001,548057,Sievenpiper; Daniel F.,9999,0,9999,0
1713304224522,EDS 115,A00,507243,Choi; Bailey Miyeon,28,0,28,0
1713304225555,EDS 117,A01,494379,Staff,25,0,25,0
1713304226589,EDS 125,A00,507246,Hopkins; Megan Beth,29,0,30,1
1713304227624,EDS 128A,A01,507264,Fargason; Sharon Gayle,26,0,26,0
1713304228649,EDS 128B,A01,507293,Pappas; Elizabeth,30,0,30,0
1713304229677,EDS 139,A00,507294,Fargason; Sharon Gayle,30,0,30,0
1713304229677,EDS 139,B00,507313,Pappas; Elizabeth,30,0,30,0
1713304230703,EDS 201,A00,507315,Staff,26,0,30,4
1713304231733,EDS 203,A01,507317,Halter; Christopher P.,26,0,30,4
1713304232760,EDS 204R,A01,507319,Halter; Christopher P.,6,0,30,24
1713304232760,EDS 204R,B01,507331,Heinzman; Erica M.,30,0,30,0
1713304233785,EDS 206R,A00,507332,Staff,8,0,30,22
1713304233785,EDS 206R,B00,507343,Staff,29,0,30,1
1713304234817,EDS 250,A00,507344,Hemans; Patricia Ann Benitez,36,0,40,4
1713304235844,EDS 281,A00,507345,Daly; Alan J.,18,0,18,0
1713304236867,EDS 284,A00,507350,Daly; Alan J.,16,0,16,0
1713304237896,EDS 286,A00,507359,Fine; Sarah,18,0,18,0
1713304238921,EDS 289C,A01,507361,Daly; Alan J.,18,0,18,0
1713304239948,EDS 290,A00,507366,Hofstetter; Carolyn,15,0,15,0
1713304240988,LIGM 5A,A00,507421,Fischer-Grunski; Eva K,20,0,20,0
1713304242018,LIGM 5B,A00,507423,Fischer-Grunski; Eva K,20,0,20,0
1713304243044,LIGM 5C,A00,507425,Fischer-Grunski; Eva K,20,0,20,0
1713304244072,LIIT 5AS,A00,507427,Carnelos; Chiara,20,0,20,0
1713304245098,LIIT 5BS,A00,507430,Carnelos; Chiara,20,0,20,0
1713304246122,LIIT 5CS,A00,507432,Carnelos; Chiara,20,0,20,0
1713304247150,LISP 5A,A00,507541,Munoz Sanchez; Alicia,19,0,20,1
1713304248181,LISP 5B,A00,507671,Munoz Sanchez; Alicia,17,0,20,3
1713304249211,LISP 5C,A00,507696,Munoz Sanchez; Alicia,18,0,20,2
1713304250237,MAE 197,001,528363,Boechler; Nicholas Sebastia,9999,0,9999,0
1713304251264,MATH 197,001,523477,Kedlaya; Kiran S.,9999,0,9999,0
1713304251264,MATH 197,002,563811,Zhang; Danna,9999,0,9999,0
1713304252288,MCWP 40R,A00,518780,Staff,20,0,20,0
1713304252288,MCWP 40R,B00,518781,Staff,20,0,20,0
1713304252288,MCWP 40R,C00,518783,Staff,19,0,20,1
1713304253318,MCWP 50R,A00,518791,Staff,20,0,20,0
1713304253318,MCWP 50R,B00,518792,Staff,20,0,20,0
1713304253318,MCWP 50R,C00,518793,Staff,19,0,20,1
1713304253318,MCWP 50R,D00,518794,Staff,19,0,20,1
1713304253318,MCWP 50R,E00,518795,Staff,19,0,20,1
1713304253318,MCWP 50R,F00,518796,Staff,20,0,20,0
1713304253318,MCWP 50R,G00,518797,Staff,19,0,20,1
1713304254343,MMW 12R,A01,514034,Herbst; Matthew,16,0,16,0
1713304254343,MMW 12R,A02,514035,Herbst; Matthew,16,0,16,0
1713304255368,MMW 13R,A01,514037,Staff,16,0,16,0
1713304255368,MMW 13R,A02,514039,Staff,16,0,16,0
1713304256394,RMED 296,001,626776,Averbach; Sarah Helene,1,0,1,0
1713304257421,SIO 295LS,A00,523233,Staff,19,0,30,11
1713304258446,SIO 295S,A00,523232,Staff,19,0,30,11
1713304259472,SOCI 117,A01,494376,Staff,3,0,5,2
1713304260497,WES 237B,A00,494380,Staff,19,0,20,1
1713304262569,AESE 279B,A00,494370,Wade; Jon P,33,0,33,0
1713304263594,ANAR 135S,A00,494369,Braswell; Geoffrey E.,0,0,0,0
1713304264620,CAT 124RS,A01,519847,Geibel; William,17,0,20,3
1713304265645,CAT 125RS,A01,515971,Geibel; William,17,0,20,3
1713304266673,CLRE 250,A00,511389,Morris; Sheldon,9996,0,9999,3
1713304267701,CLRE 251,A00,507176,Mehta; Ravindra L.,9996,0,9999,3
1713304267701,CLRE 251,B00,511410,Mehta; Ravindra L.,9998,0,9999,1
1713304268730,CLRE 252,A00,507189,Cuomo; Raphael Eduardo,9998,0,9999,1
1713304269766,CLRE 253,A00,507199,Vaida; Florin,9997,0,9999,2
1713304269766,CLRE 253,B00,507202,Vaida; Florin,9999,0,9999,0
1713304270790,CLRE 259,A00,507211,Patel; Hemal,9996,0,9999,3
1713304271821,CLRE 260,A00,507221,Cuomo; Raphael Eduardo,9999,0,9999,0
1713304272848,CLRE 297,001,507242,Cuomo; Raphael Eduardo,9999,0,9999,0
1713304273878,CSE 191,A00,516875,Minnes Kemp; Mor Mia,9999,0,9999,0
1713304274902,CSS 201S,A01,494383,Staff,35,0,35,0
1713304275929,CSS 202S,A01,494387,Staff,35,0,35,0
1713304276953,EAP 100,A00,516065,Staff,9792,0,9999,207
1713304277978,ECE 45,A01,507414,Staff,56,0,60,4
1713304279002,ECE 100,A01,507416,Baghdadchi; Saharnaz,12,0,20,8
1713304279002,ECE 100,A02,507418,Baghdadchi; Saharnaz,20,0,20,0
1713304280034,ECE 111,A01,507420,Staff,42,0,50,8
1713304281059,ECE 197,001,548057,Sievenpiper; Daniel F.,9999,0,9999,0
1713304282088,EDS 115,A00,507243,Choi; Bailey Miyeon,28,0,28,0
1713304283113,EDS 117,A01,494379,Staff,25,0,25,0
1713304284141,EDS 125,A00,507246,Hopkins; Megan Beth,29,0,30,1
1713304285170,EDS 128A,A01,507264,Fargason; Sharon Gayle,26,0,26,0
1713304286199,EDS 128B,A01,507293,Pappas; Elizabeth,30,0,30,0
1713304287223,EDS 139,A00,507294,Fargason; Sharon Gayle,30,0,30,0
1713304287223,EDS 139,B00,507313,Pappas; Elizabeth,30,0,30,0
1713304288249,EDS 201,A00,507315,Staff,26,0,30,4
1713304289276,EDS 203,A01,507317,Halter; Christopher P.,26,0,30,4
1713304290302,EDS 204R,A01,507319,Halter; Christopher P.,6,0,30,24
1713304290302,EDS 204R,B01,507331,Heinzman; Erica M.,30,0,30,0
1713304291331,EDS 206R,A00,507332,Staff,8,0,30,22
1713304291331,EDS 206R,B00,507343,Staff,29,0,30,1
1713304292360,EDS 250,A00,507344,Hemans; Patricia Ann Benitez,36,0,40,4
1713304293387,EDS 281,A00,507345,Daly; Alan J.,18,0,18,0
1713304294414,EDS 284,A00,507350,Daly; Alan J.,16,0,16,0
1713304295443,EDS 286,A00,507359,Fine; Sarah,18,0,18,0
1713304296469,EDS 289C,A01,507361,Daly; Alan J.,18,0,18,0
1713304297498,EDS 290,A00,507366,Hofstetter; Carolyn,15,0,15,0
1713304298523,LIGM 5A,A00,507421,Fischer-Grunski; Eva K,20,0,20,0
1713304299549,LIGM 5B,A00,507423,Fischer-Grunski; Eva K,20,0,20,0
1713304300574,LIGM 5C,A00,507425,Fischer-Grunski; Eva K,20,0,20,0
1713304301605,LIIT 5AS,A00,507427,Carnelos; Chiara,20,0,20,0
1713304302634,LIIT 5BS,A00,507430,Carnelos; Chiara,20,0,20,0
1713304303659,LIIT 5CS,A00,507432,Carnelos; Chiara,20,0,20,0
1713304304685,LISP 5A,A00,507541,Munoz Sanchez; Alicia,19,0,20,1
1713304305713,LISP 5B,A00,507671,Munoz Sanchez; Alicia,17,0,20,3
1713304306742,LISP 5C,A00,507696,Munoz Sanchez; Alicia,18,0,20,2
1713304307769,MAE 197,001,528363,Boechler; Nicholas Sebastia,9999,0,9999,0
1713304308794,MATH 197,001,523477,Kedlaya; Kiran S.,9999,0,9999,0
1713304308794,MATH 197,002,563811,Zhang; Danna,9999,0,9999,0
1713304309819,MCWP 40R,A00,518780,Staff,20,0,20,0
1713304309819,MCWP 40R,B00,518781,Staff,20,0,20,0
1713304309819,MCWP 40R,C00,518783,Staff,19,0,20,1
1713304310848,MCWP 50R,A00,518791,Staff,20,0,20,0
1713304310848,MCWP 50R,B00,518792,Staff,20,0,20,0
1713304310848,MCWP 50R,C00,518793,Staff,19,0,20,1
1713304310848,MCWP 50R,D00,518794,Staff,19,0,20,1
1713304310848,MCWP 50R,E00,518795,Staff,19,0,20,1
1713304310848,MCWP 50R,F00,518796,Staff,20,0,20,0
1713304310848,MCWP 50R,G00,518797,Staff,19,0,20,1
1713304311874,MMW 12R,A01,514034,Herbst; Matthew,16,0,16,0
1713304311874,MMW 12R,A02,514035,Herbst; Matthew,16,0,16,0
1713304312952,MMW 13R,A01,514037,Staff,16,0,16,0
1713304312952,MMW 13R,A02,514039,Staff,16,0,16,0
1713304313976,RMED 296,001,626776,Averbach; Sarah Helene,1,0,1,0
1713304315004,SIO 295LS,A00,523233,Staff,19,0,30,11
1713304316029,SIO 295S,A00,523232,Staff,19,0,30,11
1713304317052,SOCI 117,A01,494376,Staff,3,0,5,2
1713304318076,WES 237B,A00,494380,Staff,19,0,20,1
1713304320151,AESE 279B,A00,494370,Wade; Jon P,33,0,33,0
1713304321181,ANAR 135S,A00,494369,Braswell; Geoffrey E.,0,0,0,0
1713304322207,CAT 124RS,A01,519847,Geibel; William,17,0,20,3
1713304323233,CAT 125RS,A01,515971,Geibel; William,17,0,20,3
1713304324259,CLRE 250,A00,511389,Morris; Sheldon,9996,0,9999,3
1713304325290,CLRE 251,A00,507176,Mehta; Ravindra L.,9996,0,9999,3
1713304325290,CLRE 251,B00,511410,Mehta; Ravindra L.,9998,0,9999,1
1713304326314,CLRE 252,A00,507189,Cuomo; Raphael Eduardo,9998,0,9999,1
1713304327340,CLRE 253,A00,507199,Vaida; Florin,9997,0,9999,2
1713304327340,CLRE 253,B00,507202,Vaida; Florin,9999,0,9999,0
1713304328369,CLRE 259,A00,507211,Patel; Hemal,9996,0,9999,3
1713304329392,CLRE 260,A00,507221,Cuomo; Raphael Eduardo,9999,0,9999,0
1713304330418,CLRE 297,001,507242,Cuomo; Raphael Eduardo,9999,0,9999,0
1713304331445,CSE 191,A00,516875,Minnes Kemp; Mor Mia,9999,0,9999,0
1713304332471,CSS 201S,A01,494383,Staff,35,0,35,0
1713304333502,CSS 202S,A01,494387,Staff,35,0,35,0
1713304334530,EAP 100,A00,516065,Staff,9792,0,9999,207
1713304335556,ECE 45,A01,507414,Staff,56,0,60,4
1713304336582,ECE 100,A01,507416,Baghdadchi; Saharnaz,12,0,20,8
1713304336582,ECE 100,A02,507418,Baghdadchi; Saharnaz,20,0,20,0
1713304337608,ECE 111,A01,507420,Staff,42,0,50,8
1713304338635,ECE 197,001,548057,Sievenpiper; Daniel F.,9999,0,9999,0
1713304339661,EDS 115,A00,507243,Choi; Bailey Miyeon,28,0,28,0
1713304340691,EDS 117,A01,494379,Staff,25,0,25,0
1713304341716,EDS 125,A00,507246,Hopkins; Megan Beth,29,0,30,1
1713304342745,EDS 128A,A01,507264,Fargason; Sharon Gayle,26,0,26,0
1713304343770,EDS 128B,A01,507293,Pappas; Elizabeth,30,0,30,0
1713304344795,EDS 139,A00,507294,Fargason; Sharon Gayle,30,0,30,0
1713304344795,EDS 139,B00,507313,Pappas; Elizabeth,30,0,30,0
1713304345820,EDS 201,A00,507315,Staff,26,0,30,4
1713304346851,EDS 203,A01,507317,Halter; Christopher P.,26,0,30,4
1713304347877,EDS 204R,A01,507319,Halter; Christopher P.,6,0,30,24
1713304347877,EDS 204R,B01,507331,Heinzman; Erica M.,30,0,30,0
1713304348904,EDS 206R,A00,507332,Staff,8,0,30,22
1713304348904,EDS 206R,B00,507343,Staff,29,0,30,1
1713304349929,EDS 250,A00,507344,Hemans; Patricia Ann Benitez,36,0,40,4
1713304350966,EDS 281,A00,507345,Daly; Alan J.,18,0,18,0
1713304351990,EDS 284,A00,507350,Daly; Alan J.,16,0,16,0
1713304353016,EDS 286,A00,507359,Fine; Sarah,18,0,18,0
1713304354044,EDS 289C,A01,507361,Daly; Alan J.,18,0,18,0
1713304355080,EDS 290,A00,507366,Hofstetter; Carolyn,15,0,15,0
1713304356105,LIGM 5A,A00,507421,Fischer-Grunski; Eva K,20,0,20,0
1713304357134,LIGM 5B,A00,507423,Fischer-Grunski; Eva K,20,0,20,0
1713304358158,LIGM 5C,A00,507425,Fischer-Grunski; Eva K,20,0,20,0
1713304359181,LIIT 5AS,A00,507427,Carnelos; Chiara,20,0,20,0
1713304360210,LIIT 5BS,A00,507430,Carnelos; Chiara,20,0,20,0
1713304361234,LIIT 5CS,A00,507432,Carnelos; Chiara,20,0,20,0
1713304362260,LISP 5A,A00,507541,Munoz Sanchez; Alicia,19,0,20,1
1713304363288,LISP 5B,A00,507671,Munoz Sanchez; Alicia,17,0,20,3
1713304364318,LISP 5C,A00,507696,Munoz Sanchez; Alicia,17,0,20,3
1713304365347,MAE 197,001,528363,Boechler; Nicholas Sebastia,9999,0,9999,0
1713304366375,MATH 197,001,523477,Kedlaya; Kiran S.,9999,0,9999,0
1713304366375,MATH 197,002,563811,Zhang; Danna,9999,0,9999,0
1713304367403,MCWP 40R,A00,518780,Staff,20,0,20,0
1713304367403,MCWP 40R,B00,518781,Staff,20,0,20,0
1713304367403,MCWP 40R,C00,518783,Staff,19,0,20,1
1713304368432,MCWP 50R,A00,518791,Staff,20,0,20,0
1713304368432,MCWP 50R,B00,518792,Staff,20,0,20,0
1713304368432,MCWP 50R,C00,518793,Staff,19,0,20,1
1713304368432,MCWP 50R,D00,518794,Staff,19,0,20,1
1713304368432,MCWP 50R,E00,518795,Staff,19,0,20,1
1713304368432,MCWP 50R,F00,518796,Staff,20,0,20,0
1713304368432,MCWP 50R,G00,518797,Staff,19,0,20,1
1713304369457,MMW 12R,A01,514034,Herbst; Matthew,16,0,16,0
1713304369457,MMW 12R,A02,514035,Herbst; Matthew,16,0,16,0
1713304370481,MMW 13R,A01,514037,Staff,16,0,16,0
1713304370481,MMW 13R,A02,514039,Staff,16,0,16,0
1713304371507,RMED 296,001,626776,Averbach; Sarah Helene,1,0,1,0
1713304372530,SIO 295LS,A00,523233,Staff,19,0,30,11
1713304373564,SIO 295S,A00,523232,Staff,19,0,30,11
1713304374588,SOCI 117,A01,494376,Staff,3,0,5,2
1713304375616,WES 237B,A00,494380,Staff,19,0,20,1
1713304377681,AESE 279B,A00,494370,Wade; Jon P,33,0,33,0
1713304378707,ANAR 135S,A00,494369,Braswell; Geoffrey E.,0,0,0,0
1713304379733,CAT 124RS,A01,519847,Geibel; William,17,0,20,3
1713304380758,CAT 125RS,A01,515971,Geibel; William,17,0,20,3
1713304381786,CLRE 250,A00,511389,Morris; Sheldon,9996,0,9999,3
1713304382814,CLRE 251,A00,507176,Mehta; Ravindra L.,9996,0,9999,3
1713304382814,CLRE 251,B00,511410,Mehta; Ravindra L.,9998,0,9999,1
1713304383843,CLRE 252,A00,507189,Cuomo; Raphael Eduardo,9998,0,9999,1
1713304384868,CLRE 253,A00,507199,Vaida; Florin,9997,0,9999,2
1713304384868,CLRE 253,B00,507202,Vaida; Florin,9999,0,9999,0
1713304385894,CLRE 259,A00,507211,Patel; Hemal,9996,0,9999,3
1713304386922,CLRE 260,A00,507221,Cuomo; Raphael Eduardo,9999,0,9999,0
1713304387950,CLRE 297,001,507242,Cuomo; Raphael Eduardo,9999,0,9999,0
1713304388974,CSE 191,A00,516875,Minnes Kemp; Mor Mia,9999,0,9999,0
1713304390001,CSS 201S,A01,494383,Staff,35,0,35,0
1713304391027,CSS 202S,A01,494387,Staff,35,0,35,0
1713304392054,EAP 100,A00,516065,Staff,9792,0,9999,207
1713304393078,ECE 45,A01,507414,Staff,56,0,60,4
1713304394103,ECE 100,A01,507416,Baghdadchi; Saharnaz,12,0,20,8
1713304394103,ECE 100,A02,507418,Baghdadchi; Saharnaz,20,0,20,0
1713304395132,ECE 111,A01,507420,Staff,42,0,50,8
1713304396158,ECE 197,001,548057,Sievenpiper; Daniel F.,9999,0,9999,0
1713304397182,EDS 115,A00,507243,Choi; Bailey Miyeon,28,0,28,0
1713304398205,EDS 117,A01,494379,Staff,25,0,25,0
1713304399232,EDS 125,A00,507246,Hopkins; Megan Beth,29,0,30,1
1713304400259,EDS 128A,A01,507264,Fargason; Sharon Gayle,26,0,26,0
1713304401284,EDS 128B,A01,507293,Pappas; Elizabeth,30,0,30,0
1713304402315,EDS 139,A00,507294,Fargason; Sharon Gayle,30,0,30,0
1713304402315,EDS 139,B00,507313,Pappas; Elizabeth,30,0,30,0
1713304403341,EDS 201,A00,507315,Staff,26,0,30,4
1713304404370,EDS 203,A01,507317,Halter; Christopher P.,26,0,30,4
1713304405394,EDS 204R,A01,507319,Halter; Christopher P.,6,0,30,24
1713304405394,EDS 204R,B01,507331,Heinzman; Erica M.,30,0,30,0
1713304406419,EDS 206R,A00,507332,Staff,8,0,30,22
1713304406419,EDS 206R,B00,507343,Staff,29,0,30,1
1713304407443,EDS 250,A00,507344,Hemans; Patricia Ann Benitez,36,0,40,4
1713304408467,EDS 281,A00,507345,Daly; Alan J.,18,0,18,0
1713304409493,EDS 284,A00,507350,Daly; Alan J.,16,0,16,0
1713304410518,EDS 286,A00,507359,Fine; Sarah,18,0,18,0
1713304411542,EDS 289C,A01,507361,Daly; Alan J.,18,0,18,0
1713304412568,EDS 290,A00,507366,Hofstetter; Carolyn,15,0,15,0
1713304413594,LIGM 5A,A00,507421,Fischer-Grunski; Eva K,20,0,20,0
1713304414623,LIGM 5B,A00,507423,Fischer-Grunski; Eva K,20,0,20,0
1713304415647,LIGM 5C,A00,507425,Fischer-Grunski; Eva K,20,0,20,0
1713304416742,LIIT 5AS,A00,507427,Carnelos; Chiara,20,0,20,0
1713304417767,LIIT 5BS,A00,507430,Carnelos; Chiara,20,0,20,0
1713304418798,LIIT 5CS,A00,507432,Carnelos; Chiara,20,0,20,0
1713304419823,LISP 5A,A00,507541,Munoz Sanchez; Alicia,19,0,20,1
1713304420848,LISP 5B,A00,507671,Munoz Sanchez; Alicia,17,0,20,3
1713304421876,LISP 5C,A00,507696,Munoz Sanchez; Alicia,17,0,20,3
1713304422901,MAE 197,001,528363,Boechler; Nicholas Sebastia,9999,0,9999,0
1713304423926,MATH 197,001,523477,Kedlaya; Kiran S.,9999,0,9999,0
1713304423926,MATH 197,002,563811,Zhang; Danna,9999,0,9999,0
1713304424955,MCWP 40R,A00,518780,Staff,20,0,20,0
1713304424955,MCWP 40R,B00,518781,Staff,20,0,20,0
1713304424955,MCWP 40R,C00,518783,Staff,19,0,20,1
1713304425984,MCWP 50R,A00,518791,Staff,20,0,20,0
1713304425984,MCWP 50R,B00,518792,Staff,20,0,20,0
1713304425984,MCWP 50R,C00,518793,Staff,19,0,20,1
1713304425984,MCWP 50R,D00,518794,Staff,19,0,20,1
1713304425984,MCWP 50R,E00,518795,Staff,19,0,20,1
1713304425984,MCWP 50R,F00,518796,Staff,20,0,20,0
1713304425984,MCWP 50R,G00,518797,Staff,19,0,20,1
1713304427010,MMW 12R,A01,514034,Herbst; Matthew,16,0,16,0
1713304427010,MMW 12R,A02,514035,Herbst; Matthew,16,0,16,0
1713304428041,MMW 13R,A01,514037,Staff,16,0,16,0
1713304428041,MMW 13R,A02,514039,Staff,16,0,16,0
1713304429069,RMED 296,001,626776,Averbach; Sarah Helene,1,0,1,0
1713304430094,SIO 295LS,A00,523233,Staff,19,0,30,11
1713304431125,SIO 295S,A00,523232,Staff,19,0,30,11
1713304432151,SOCI 117,A01,494376,Staff,3,0,5,2
1713304433175,WES 237B,A00,494380,Staff,19,0,20,1
1713304435247,AESE 279B,A00,494370,Wade; Jon P,33,0,33,0
1713304436272,ANAR 135S,A00,494369,Braswell; Geoffrey E.,0,0,0,0
1713304437296,CAT 124RS,A01,519847,Geibel; William,17,0,20,3
1713304438324,CAT 125RS,A01,515971,Geibel; William,17,0,20,3
1713304439350,CLRE 250,A00,511389,Morris; Sheldon,9996,0,9999,3
1713304440376,CLRE 251,A00,507176,Mehta; Ravindra L.,9996,0,9999,3
1713304440376,CLRE 251,B00,511410,Mehta; Ravindra L.,9998,0,9999,1
1713304441401,CLRE 252,A00,507189,Cuomo; Raphael Eduardo,9998,0,9999,1
1713304442433,CLRE 253,A00,507199,Vaida; Florin,9997,0,9999,2
1713304442433,CLRE 253,B00,507202,Vaida; Florin,9999,0,9999,0
1713304443462,CLRE 259,A00,507211,Patel; Hemal,9996,0,9999,3
1713304444490,CLRE 260,A00,507221,Cuomo; Raphael Eduardo,9999,0,9999,0
1713304445514,CLRE 297,001,507242,Cuomo; Raphael Eduardo,9999,0,9999,0
1713304446540,CSE 191,A00,516875,Minnes Kemp; Mor Mia,9999,0,9999,0
1713304447565,CSS 201S,A01,494383,Staff,35,0,35,0
1713304448594,CSS 202S,A01,494387,Staff,35,0,35,0
1713304449622,EAP 100,A00,516065,Staff,9792,0,9999,207
1713304450647,ECE 45,A01,507414,Staff,56,0,60,4
1713304451673,ECE 100,A01,507416,Baghdadchi; Saharnaz,12,0,20,8
1713304451673,ECE 100,A02,507418,Baghdadchi; Saharnaz,20,0,20,0
1713304452699,ECE 111,A01,507420,Staff,42,0,50,8
1713304453724,ECE 197,001,548057,Sievenpiper; Daniel F.,9999,0,9999,0
1713304454756,EDS 115,A00,507243,Choi; Bailey Miyeon,28,0,28,0
1713304455781,EDS 117,A01,494379,Staff,25,0,25,0
1713304456823,EDS 125,A00,507246,Hopkins; Megan Beth,29,0,30,1
1713304457850,EDS 128A,A01,507264,Fargason; Sharon Gayle,26,0,26,0
1713304458876,EDS 128B,A01,507293,Pappas; Elizabeth,30,0,30,0
1713304459906,EDS 139,A00,507294,Fargason; Sharon Gayle,30,0,30,0
1713304459906,EDS 139,B00,507313,Pappas; Elizabeth,30,0,30,0
1713304460931,EDS 201,A00,507315,Staff,26,0,30,4
1713304461963,EDS 203,A01,507317,Halter; Christopher P.,26,0,30,4
1713304462993,EDS 204R,A01,507319,Halter; Christopher P.,6,0,30,24
1713304462993,EDS 204R,B01,507331,Heinzman; Erica M.,30,0,30,0
1713304464019,EDS 206R,A00,507332,Staff,8,0,30,22
1713304464019,EDS 206R,B00,507343,Staff,29,0,30,1
1713304465046,EDS 250,A00,507344,Hemans; Patricia Ann Benitez,36,0,40,4
1713304466071,EDS 281,A00,507345,Daly; Alan J.,18,0,18,0
1713304467100,EDS 284,A00,507350,Daly; Alan J.,16,0,16,0
1713304468125,EDS 286,A00,507359,Fine; Sarah,18,0,18,0
1713304469148,EDS 289C,A01,507361,Daly; Alan J.,18,0,18,0
1713304470174,EDS 290,A00,507366,Hofstetter; Carolyn,15,0,15,0
1713304471204,LIGM 5A,A00,507421,Fischer-Grunski; Eva K,20,0,20,0
1713304472235,LIGM 5B,A00,507423,Fischer-Grunski; Eva K,20,0,20,0
1713304473259,LIGM 5C,A00,507425,Fischer-Grunski; Eva K,20,0,20,0
1713304474285,LIIT 5AS,A00,507427,Carnelos; Chiara,20,0,20,0
1713304475310,LIIT 5BS,A00,507430,Carnelos; Chiara,20,0,20,0
1713304476338,LIIT 5CS,A00,507432,Carnelos; Chiara,20,0,20,0
1713304477362,LISP 5A,A00,507541,Munoz Sanchez; Alicia,19,0,20,1
1713304478391,LISP 5B,A00,507671,Munoz Sanchez; Alicia,17,0,20,3
1713304479416,LISP 5C,A00,507696,Munoz Sanchez; Alicia,17,0,20,3
1713304480441,MAE 197,001,528363,Boechler; Nicholas Sebastia,9999,0,9999,0
1713304481469,MATH 197,001,523477,Kedlaya; Kiran S.,9999,0,9999,0
1713304481469,MATH 197,002,563811,Zhang; Danna,9999,0,9999,0
1713304482501,MCWP 40R,A00,518780,Staff,20,0,20,0
1713304482501,MCWP 40R,B00,518781,Staff,20,0,20,0
1713304482501,MCWP 40R,C00,518783,Staff,19,0,20,1
1713304483528,MCWP 50R,A00,518791,Staff,20,0,20,0
1713304483528,MCWP 50R,B00,518792,Staff,20,0,20,0
1713304483528,MCWP 50R,C00,518793,Staff,19,0,20,1
1713304483528,MCWP 50R,D00,518794,Staff,19,0,20,1
1713304483528,MCWP 50R,E00,518795,Staff,19,0,20,1
1713304483528,MCWP 50R,F00,518796,Staff,20,0,20,0
1713304483528,MCWP 50R,G00,518797,Staff,19,0,20,1
1713304484554,MMW 12R,A01,514034,Herbst; Matthew,16,0,16,0
1713304484554,MMW 12R,A02,514035,Herbst; Matthew,16,0,16,0
1713304485579,MMW 13R,A01,514037,Staff,16,0,16,0
1713304485579,MMW 13R,A02,514039,Staff,16,0,16,0
1713304486605,RMED 296,001,626776,Averbach; Sarah Helene,1,0,1,0
1713304487634,SIO 295LS,A00,523233,Staff,19,0,30,11
1713304488663,SIO 295S,A00,523232,Staff,19,0,30,11
1713304489692,SOCI 117,A01,494376,Staff,3,0,5,2
1713304490717,WES 237B,A00,494380,Staff,19,0,20,1
1713304492774,AESE 279B,A00,494370,Wade; Jon P,33,0,33,0
1713304493805,ANAR 135S,A00,494369,Braswell; Geoffrey E.,0,0,0,0
1713304494832,CAT 124RS,A01,519847,Geibel; William,17,0,20,3
1713304495872,CAT 125RS,A01,515971,Geibel; William,17,0,20,3
1713304496905,CLRE 250,A00,511389,Morris; Sheldon,9996,0,9999,3
1713304497932,CLRE 251,A00,507176,Mehta; Ravindra L.,9996,0,9999,3
1713304497932,CLRE 251,B00,511410,Mehta; Ravindra L.,9998,0,9999,1
1713304498961,CLRE 252,A00,507189,Cuomo; Raphael Eduardo,9998,0,9999,1
1713304499991,CLRE 253,A00,507199,Vaida; Florin,9997,0,9999,2
1713304499991,CLRE 253,B00,507202,Vaida; Florin,9999,0,9999,0
1713304501017,CLRE 259,A00,507211,Patel; Hemal,9996,0,9999,3
1713304502043,CLRE 260,A00,507221,Cuomo; Raphael Eduardo,9999,0,9999,0
1713304503075,CLRE 297,001,507242,Cuomo; Raphael Eduardo,9999,0,9999,0
1713304504101,CSE 191,A00,516875,Minnes Kemp; Mor Mia,9999,0,9999,0
1713304505127,CSS 201S,A01,494383,Staff,35,0,35,0
1713304506153,CSS 202S,A01,494387,Staff,35,0,35,0
1713304507178,EAP 100,A00,516065,Staff,9792,0,9999,207
1713304508203,ECE 45,A01,507414,Staff,56,0,60,4
1713304509228,ECE 100,A01,507416,Baghdadchi; Saharnaz,12,0,20,8
1713304509228,ECE 100,A02,507418,Baghdadchi; Saharnaz,20,0,20,0
1713304510254,ECE 111,A01,507420,Staff,40,0,50,10
1713304511279,ECE 197,001,548057,Sievenpiper; Daniel F.,9999,0,9999,0
1713304512303,EDS 115,A00,507243,Choi; Bailey Miyeon,28,0,28,0
1713304513331,EDS 117,A01,494379,Staff,25,0,25,0
1713304514355,EDS 125,A00,507246,Hopkins; Megan Beth,29,0,30,1
1713304515380,EDS 128A,A01,507264,Fargason; Sharon Gayle,26,0,26,0
1713304516405,EDS 128B,A01,507293,Pappas; Elizabeth,30,0,30,0
1713304517432,EDS 139,A00,507294,Fargason; Sharon Gayle,30,0,30,0
1713304517432,EDS 139,B00,507313,Pappas; Elizabeth,30,0,30,0
1713304518457,EDS 201,A00,507315,Staff,26,0,30,4
1713304519489,EDS 203,A01,507317,Halter; Christopher P.,26,0,30,4
1713304520569,EDS 204R,A01,507319,Halter; Christopher P.,6,0,30,24
1713304520569,EDS 204R,B01,507331,Heinzman; Erica M.,30,0,30,0
1713304521597,EDS 206R,A00,507332,Staff,8,0,30,22
1713304521597,EDS 206R,B00,507343,Staff,29,0,30,1
1713304522620,EDS 250,A00,507344,Hemans; Patricia Ann Benitez,36,0,40,4
1713304523646,EDS 281,A00,507345,Daly; Alan J.,18,0,18,0
1713304524677,EDS 284,A00,507350,Daly; Alan J.,16,0,16,0
1713304525708,EDS 286,A00,507359,Fine; Sarah,18,0,18,0
1713304526734,EDS 289C,A01,507361,Daly; Alan J.,18,0,18,0
1713304527764,EDS 290,A00,507366,Hofstetter; Carolyn,15,0,15,0
1713304528791,LIGM 5A,A00,507421,Fischer-Grunski; Eva K,20,0,20,0
1713304529825,LIGM 5B,A00,507423,Fischer-Grunski; Eva K,20,0,20,0
1713304530854,LIGM 5C,A00,507425,Fischer-Grunski; Eva K,20,0,20,0
1713304531879,LIIT 5AS,A00,507427,Carnelos; Chiara,20,0,20,0
1713304532905,LIIT 5BS,A00,507430,Carnelos; Chiara,20,0,20,0
1713304533932,LIIT 5CS,A00,507432,Carnelos; Chiara,20,0,20,0
1713304534964,LISP 5A,A00,507541,Munoz Sanchez; Alicia,19,0,20,1
1713304535993,LISP 5B,A00,507671,Munoz Sanchez; Alicia,17,0,20,3
1713304537018,LISP 5C,A00,507696,Munoz Sanchez; Alicia,17,0,20,3
1713304538042,MAE 197,001,528363,Boechler; Nicholas Sebastia,9999,0,9999,0
1713304539070,MATH 197,001,523477,Kedlaya; Kiran S.,9999,0,9999,0
1713304539070,MATH 197,002,563811,Zhang; Danna,9999,0,9999,0
1713304540098,MCWP 40R,A00,518780,Staff,20,0,20,0
1713304540098,MCWP 40R,B00,518781,Staff,20,0,20,0
1713304540098,MCWP 40R,C00,518783,Staff,19,0,20,1
1713304541122,MCWP 50R,A00,518791,Staff,20,0,20,0
1713304541122,MCWP 50R,B00,518792,Staff,20,0,20,0
1713304541122,MCWP 50R,C00,518793,Staff,19,0,20,1
1713304541122,MCWP 50R,D00,518794,Staff,19,0,20,1
1713304541122,MCWP 50R,E00,518795,Staff,19,0,20,1
1713304541122,MCWP 50R,F00,518796,Staff,20,0,20,0
1713304541122,MCWP 50R,G00,518797,Staff,19,0,20,1
1713304542147,MMW 12R,A01,514034,Herbst; Matthew,16,0,16,0
1713304542147,MMW 12R,A02,514035,Herbst; Matthew,16,0,16,0
1713304543173,MMW 13R,A01,514037,Staff,16,0,16,0
1713304543173,MMW 13R,A02,514039,Staff,16,0,16,0
1713304544198,RMED 296,001,626776,Averbach; Sarah Helene,1,0,1,0
1713304545225,SIO 295LS,A00,523233,Staff,19,0,30,11
1713304546254,SIO 295S,A00,523232,Staff,19,0,30,11
1713304547279,SOCI 117,A01,494376,Staff,3,0,5,2
1713304548305,WES 237B,A00,494380,Staff,19,0,20,1
1713304550371,AESE 279B,A00,494370,Wade; Jon P,33,0,33,0
1713304551397,ANAR 135S,A00,494369,Braswell; Geoffrey E.,0,0,0,0
1713304552422,CAT 124RS,A01,519847,Geibel; William,17,0,20,3
1713304553453,CAT 125RS,A01,515971,Geibel; William,17,0,20,3
1713304554481,CLRE 250,A00,511389,Morris; Sheldon,9996,0,9999,3
1713304555509,CLRE 251,A00,507176,Mehta; Ravindra L.,9996,0,9999,3
1713304555509,CLRE 251,B00,511410,Mehta; Ravindra L.,9998,0,9999,1
1713304556650,CLRE 252,A00,507189,Cuomo; Raphael Eduardo,9998,0,9999,1
1713304557679,CLRE 253,A00,507199,Vaida; Florin,9997,0,9999,2
1713304557679,CLRE 253,B00,507202,Vaida; Florin,9999,0,9999,0
1713304558706,CLRE 259,A00,507211,Patel; Hemal,9996,0,9999,3
1713304559734,CLRE 260,A00,507221,Cuomo; Raphael Eduardo,9999,0,9999,0
1713304560758,CLRE 297,001,507242,Cuomo; Raphael Eduardo,9999,0,9999,0
1713304561785,CSE 191,A00,516875,Minnes Kemp; Mor Mia,9999,0,9999,0
1713304562809,CSS 201S,A01,494383,Staff,35,0,35,0
1713304563838,CSS 202S,A01,494387,Staff,35,0,35,0
1713304564864,EAP 100,A00,516065,Staff,9792,0,9999,207
1713304565894,ECE 45,A01,507414,Staff,56,0,60,4
1713304566923,ECE 100,A01,507416,Baghdadchi; Saharnaz,12,0,20,8
1713304566923,ECE 100,A02,507418,Baghdadchi; Saharnaz,20,0,20,0
1713304567947,ECE 111,A01,507420,Staff,40,0,50,10
1713304568979,ECE 197,001,548057,Sievenpiper; Daniel F.,9999,0,9999,0
1713304570005,EDS 115,A00,507243,Choi; Bailey Miyeon,28,0,28,0
1713304571036,EDS 117,A01,494379,Staff,25,0,25,0
1713304572060,EDS 125,A00,507246,Hopkins; Megan Beth,29,0,30,1
1713304573086,EDS 128A,A01,507264,Fargason; Sharon Gayle,26,0,26,0
1713304574111,EDS 128B,A01,507293,Pappas; Elizabeth,30,0,30,0
1713304575139,EDS 139,A00,507294,Fargason; Sharon Gayle,30,0,30,0
1713304575139,EDS 139,B00,507313,Pappas; Elizabeth,30,0,30,0
1713304576166,EDS 201,A00,507315,Staff,26,0,30,4
1713304577194,EDS 203,A01,507317,Halter; Christopher P.,26,0,30,4
1713304578220,EDS 204R,A01,507319,Halter; Christopher P.,6,0,30,24
1713304578220,EDS 204R,B01,507331,Heinzman; Erica M.,30,0,30,0
1713304579244,EDS 206R,A00,507332,Staff,8,0,30,22
1713304579244,EDS 206R,B00,507343,Staff,29,0,30,1
1713304580269,EDS 250,A00,507344,Hemans; Patricia Ann Benitez,36,0,40,4
1713304581292,EDS 281,A00,507345,Daly; Alan J.,18,0,18,0
1713304582316,EDS 284,A00,507350,Daly; Alan J.,16,0,16,0
1713304583341,EDS 286,A00,507359,Fine; Sarah,18,0,18,0
1713304584365,EDS 289C,A01,507361,Daly; Alan J.,18,0,18,0
1713304585394,EDS 290,A00,507366,Hofstetter; Carolyn,15,0,15,0
1713304586424,LIGM 5A,A00,507421,Fischer-Grunski; Eva K,20,0,20,0
1713304587448,LIGM 5B,A00,507423,Fischer-Grunski; Eva K,20,0,20,0
1713304588477,LIGM 5C,A00,507425,Fischer-Grunski; Eva K,20,0,20,0
1713304589508,LIIT 5AS,A00,507427,Carnelos; Chiara,20,0,20,0
1713304590537,LIIT 5BS,A00,507430,Carnelos; Chiara,20,0,20,0
1713304591561,LIIT 5CS,A00,507432,Carnelos; Chiara,20,0,20,0
1713304592586,LISP 5A,A00,507541,Munoz Sanchez; Alicia,19,0,20,1
1713304593612,LISP 5B,A00,507671,Munoz Sanchez; Alicia,17,0,20,3
1713304594644,LISP 5C,A00,507696,Munoz Sanchez; Alicia,17,0,20,3
1713304595673,MAE 197,001,528363,Boechler; Nicholas Sebastia,9999,0,9999,0
1713304596698,MATH 197,001,523477,Kedlaya; Kiran S.,9999,0,9999,0
1713304596698,MATH 197,002,563811,Zhang; Danna,9999,0,9999,0
1713304597724,MCWP 40R,A00,518780,Staff,20,0,20,0
1713304597724,MCWP 40R,B00,518781,Staff,20,0,20,0
1713304597724,MCWP 40R,C00,518783,Staff,19,0,20,1
1713304598755,MCWP 50R,A00,518791,Staff,20,0,20,0
1713304598755,MCWP 50R,B00,518792,Staff,20,0,20,0
1713304598755,MCWP 50R,C00,518793,Staff,19,0,20,1
1713304598755,MCWP 50R,D00,518794,Staff,19,0,20,1
1713304598755,MCWP 50R,E00,518795,Staff,19,0,20,1
1713304598755,MCWP 50R,F00,518796,Staff,20,0,20,0
1713304598755,MCWP 50R,G00,518797,Staff,19,0,20,1
1713304599782,MMW 12R,A01,514034,Herbst; Matthew,16,0,16,0
1713304599782,MMW 12R,A02,514035,Herbst; Matthew,16,0,16,0
1713304600806,MMW 13R,A01,514037,Staff,16,0,16,0
1713304600806,MMW 13R,A02,514039,Staff,16,0,16,0
1713304601831,RMED 296,001,626776,Averbach; Sarah Helene,1,0,1,0
1713304602857,SIO 295LS,A00,523233,Staff,19,0,30,11
1713304603882,SIO 295S,A00,523232,Staff,19,0,30,11
1713304604909,SOCI 117,A01,494376,Staff,3,0,5,2
1713304605934,WES 237B,A00,494380,Staff,19,0,20,1
1713304608002,AESE 279B,A00,494370,Wade; Jon P,33,0,33,0
1713304609027,ANAR 135S,A00,494369,Braswell; Geoffrey E.,0,0,0,0
1713304610054,CAT 124RS,A01,519847,Geibel; William,17,0,20,3
1713304611079,CAT 125RS,A01,515971,Geibel; William,17,0,20,3
1713304612104,CLRE 250,A00,511389,Morris; Sheldon,9996,0,9999,3
1713304613132,CLRE 251,A00,507176,Mehta; Ravindra L.,9996,0,9999,3
1713304613132,CLRE 251,B00,511410,Mehta; Ravindra L.,9998,0,9999,1
1713304614161,CLRE 252,A00,507189,Cuomo; Raphael Eduardo,9998,0,9999,1
1713304615190,CLRE 253,A00,507199,Vaida; Florin,9997,0,9999,2
1713304615190,CLRE 253,B00,507202,Vaida; Florin,9999,0,9999,0
1713304616219,CLRE 259,A00,507211,Patel; Hemal,9996,0,9999,3
1713304617244,CLRE 260,A00,507221,Cuomo; Raphael Eduardo,9999,0,9999,0
1713304618274,CLRE 297,001,507242,Cuomo; Raphael Eduardo,9999,0,9999,0
1713304619302,CSE 191,A00,516875,Minnes Kemp; Mor Mia,9999,0,9999,0
1713304620326,CSS 201S,A01,494383,Staff,35,0,35,0
1713304621352,CSS 202S,A01,494387,Staff,35,0,35,0
1713304622378,EAP 100,A00,516065,Staff,9792,0,9999,207
1713304623407,ECE 45,A01,507414,Staff,56,0,60,4
1713304624490,ECE 100,A01,507416,Baghdadchi; Saharnaz,12,0,20,8
1713304624490,ECE 100,A02,507418,Baghdadchi; Saharnaz,20,0,20,0
1713304625516,ECE 111,A01,507420,Staff,40,0,50,10
1713304626542,ECE 197,001,548057,Sievenpiper; Daniel F.,9999,0,9999,0
1713304627570,EDS 115,A00,507243,Choi; Bailey Miyeon,28,0,28,0
1713304628597,EDS 117,A01,494379,Staff,25,0,25,0
1713304629627,EDS 125,A00,507246,Hopkins; Megan Beth,29,0,30,1
1713304630655,EDS 128A,A01,507264,Fargason; Sharon Gayle,26,0,26,0
1713304631682,EDS 128B,A01,507293,Pappas; Elizabeth,30,0,30,0
1713304632710,EDS 139,A00,507294,Fargason; Sharon Gayle,30,0,30,0
1713304632710,EDS 139,B00,507313,Pappas; Elizabeth,30,0,30,0
1713304633739,EDS 201,A00,507315,Staff,26,0,30,4
1713304634765,EDS 203,A01,507317,Halter; Christopher P.,26,0,30,4
1713304635791,EDS 204R,A01,507319,Halter; Christopher P.,6,0,30,24
1713304635791,EDS 204R,B01,507331,Heinzman; Erica M.,30,0,30,0
1713304636817,EDS 206R,A00,507332,Staff,8,0,30,22
1713304636817,EDS 206R,B00,507343,Staff,29,0,30,1
1713304637846,EDS 250,A00,507344,Hemans; Patricia Ann Benitez,36,0,40,4
1713304638875,EDS 281,A00,507345,Daly; Alan J.,18,0,18,0
1713304639900,EDS 284,A00,507350,Daly; Alan J.,16,0,16,0
1713304640927,EDS 286,A00,507359,Fine; Sarah,18,0,18,0
1713304641951,EDS 289C,A01,507361,Daly; Alan J.,18,0,18,0
1713304642977,EDS 290,A00,507366,Hofstetter; Carolyn,15,0,15,0
1713304644005,LIGM 5A,A00,507421,Fischer-Grunski; Eva K,20,0,20,0
1713304645031,LIGM 5B,A00,507423,Fischer-Grunski; Eva K,20,0,20,0
1713304646057,LIGM 5C,A00,507425,Fischer-Grunski; Eva K,20,0,20,0
1713304647087,LIIT 5AS,A00,507427,Carnelos; Chiara,20,0,20,0
1713304648113,LIIT 5BS,A00,507430,Carnelos; Chiara,20,0,20,0
1713304649141,LIIT 5CS,A00,507432,Carnelos; Chiara,20,0,20,0
1713304650170,LISP 5A,A00,507541,Munoz Sanchez; Alicia,19,0,20,1
1713304651199,LISP 5B,A00,507671,Munoz Sanchez; Alicia,17,0,20,3
1713304652223,LISP 5C,A00,507696,Munoz Sanchez; Alicia,17,0,20,3
1713304653256,MAE 197,001,528363,Boechler; Nicholas Sebastia,9999,0,9999,0
1713304654284,MATH 197,001,523477,Kedlaya; Kiran S.,9999,0,9999,0
1713304654284,MATH 197,002,563811,Zhang; Danna,9999,0,9999,0
1713304655310,MCWP 40R,A00,518780,Staff,20,0,20,0
1713304655310,MCWP 40R,B00,518781,Staff,20,0,20,0
1713304655310,MCWP 40R,C00,518783,Staff,19,0,20,1
1713304656332,MCWP 50R,A00,518791,Staff,20,0,20,0
1713304656332,MCWP 50R,B00,518792,Staff,20,0,20,0
1713304656332,MCWP 50R,C00,518793,Staff,19,0,20,1
1713304656332,MCWP 50R,D00,518794,Staff,19,0,20,1
1713304656332,MCWP 50R,E00,518795,Staff,18,0,20,2
1713304656332,MCWP 50R,F00,518796,Staff,20,0,20,0
1713304656332,MCWP 50R,G00,518797,Staff,19,0,20,1
1713304657359,MMW 12R,A01,514034,Herbst; Matthew,16,0,16,0
1713304657359,MMW 12R,A02,514035,Herbst; Matthew,16,0,16,0
1713304658387,MMW 13R,A01,514037,Staff,16,0,16,0
1713304658387,MMW 13R,A02,514039,Staff,16,0,16,0
1713304659414,RMED 296,001,626776,Averbach; Sarah Helene,1,0,1,0
1713304660442,SIO 295LS,A00,523233,Staff,19,0,30,11
1713304661470,SIO 295S,A00,523232,Staff,19,0,30,11
1713304662499,SOCI 117,A01,494376,Staff,3,0,5,2
1713304663528,WES 237B,A00,494380,Staff,19,0,20,1
1713304665599,AESE 279B,A00,494370,Wade; Jon P,33,0,33,0
1713304666625,ANAR 135S,A00,494369,Braswell; Geoffrey E.,0,0,0,0
1713304667650,CAT 124RS,A01,519847,Geibel; William,17,0,20,3
1713304668676,CAT 125RS,A01,515971,Geibel; William,17,0,20,3
1713304669701,CLRE 250,A00,511389,Morris; Sheldon,9996,0,9999,3
1713304670726,CLRE 251,A00,507176,Mehta; Ravindra L.,9996,0,9999,3
1713304670726,CLRE 251,B00,511410,Mehta; Ravindra L.,9998,0,9999,1
1713304671752,CLRE 252,A00,507189,Cuomo; Raphael Eduardo,9998,0,9999,1
1713304672781,CLRE 253,A00,507199,Vaida; Florin,9997,0,9999,2
1713304672781,CLRE 253,B00,507202,Vaida; Florin,9999,0,9999,0
1713304673808,CLRE 259,A00,507211,Patel; Hemal,9996,0,9999,3
1713304674835,CLRE 260,A00,507221,Cuomo; Raphael Eduardo,9999,0,9999,0
1713304675861,CLRE 297,001,507242,Cuomo; Raphael Eduardo,9999,0,9999,0
1713304676889,CSE 191,A00,516875,Minnes Kemp; Mor Mia,9999,0,9999,0
1713304677920,CSS 201S,A01,494383,Staff,35,0,35,0
1713304678946,CSS 202S,A01,494387,Staff,35,0,35,0
1713304679971,EAP 100,A00,516065,Staff,9792,0,9999,207
1713304680997,ECE 45,A01,507414,Staff,56,0,60,4
1713304682022,ECE 100,A01,507416,Baghdadchi; Saharnaz,12,0,20,8
1713304682022,ECE 100,A02,507418,Baghdadchi; Saharnaz,20,0,20,0
1713304683047,ECE 111,A01,507420,Staff,40,0,50,10
1713304684073,ECE 197,001,548057,Sievenpiper; Daniel F.,9999,0,9999,0
1713304685098,EDS 115,A00,507243,Choi; Bailey Miyeon,28,0,28,0
1713304686122,EDS 117,A01,494379,Staff,25,0,25,0
1713304687149,EDS 125,A00,507246,Hopkins; Megan Beth,29,0,30,1
1713304688175,EDS 128A,A01,507264,Fargason; Sharon Gayle,26,0,26,0
1713304689204,EDS 128B,A01,507293,Pappas; Elizabeth,30,0,30,0
1713304690230,EDS 139,A00,507294,Fargason; Sharon Gayle,30,0,30,0
1713304690230,EDS 139,B00,507313,Pappas; Elizabeth,30,0,30,0
1713304691255,EDS 201,A00,507315,Staff,26,0,30,4
1713304692282,EDS 203,A01,507317,Halter; Christopher P.,26,0,30,4
1713304693307,EDS 204R,A01,507319,Halter; Christopher P.,6,0,30,24
1713304693307,EDS 204R,B01,507331,Heinzman; Erica M.,30,0,30,0
1713304694333,EDS 206R,A00,507332,Staff,8,0,30,22
1713304694333,EDS 206R,B00,507343,Staff,29,0,30,1
1713304695361,EDS 250,A00,507344,Hemans; Patricia Ann Benitez,36,0,40,4
1713304696387,EDS 281,A00,507345,Daly; Alan J.,18,0,18,0
1713304697411,EDS 284,A00,507350,Daly; Alan J.,16,0,16,0
1713304698438,EDS 286,A00,507359,Fine; Sarah,18,0,18,0
1713304699465,EDS 289C,A01,507361,Daly; Alan J.,18,0,18,0
1713304700491,EDS 290,A00,507366,Hofstetter; Carolyn,15,0,15,0
1713304701521,LIGM 5A,A00,507421,Fischer-Grunski; Eva K,20,0,20,0
1713304702552,LIGM 5B,A00,507423,Fischer-Grunski; Eva K,20,0,20,0
1713304703578,LIGM 5C,A00,507425,Fischer-Grunski; Eva K,20,0,20,0
1713304704603,LIIT 5AS,A00,507427,Carnelos; Chiara,20,0,20,0
1713304705628,LIIT 5BS,A00,507430,Carnelos; Chiara,20,0,20,0
1713304706654,LIIT 5CS,A00,507432,Carnelos; Chiara,20,0,20,0
1713304707684,LISP 5A,A00,507541,Munoz Sanchez; Alicia,19,0,20,1
1713304708713,LISP 5B,A00,507671,Munoz Sanchez; Alicia,17,0,20,3
1713304709740,LISP 5C,A00,507696,Munoz Sanchez; Alicia,17,0,20,3
1713304710769,MAE 197,001,528363,Boechler; Nicholas Sebastia,9999,0,9999,0
1713304711797,MATH 197,001,523477,Kedlaya; Kiran S.,9999,0,9999,0
1713304711797,MATH 197,002,563811,Zhang; Danna,9999,0,9999,0
1713304712823,MCWP 40R,A00,518780,Staff,20,0,20,0
1713304712823,MCWP 40R,B00,518781,Staff,20,0,20,0
1713304712823,MCWP 40R,C00,518783,Staff,19,0,20,1
1713304713854,MCWP 50R,A00,518791,Staff,20,0,20,0
1713304713854,MCWP 50R,B00,518792,Staff,20,0,20,0
1713304713854,MCWP 50R,C00,518793,Staff,19,0,20,1
1713304713854,MCWP 50R,D00,518794,Staff,19,0,20,1
1713304713854,MCWP 50R,E00,518795,Staff,18,0,20,2
1713304713854,MCWP 50R,F00,518796,Staff,20,0,20,0
1713304713854,MCWP 50R,G00,518797,Staff,19,0,20,1
1713304714879,MMW 12R,A01,514034,Herbst; Matthew,16,0,16,0
1713304714879,MMW 12R,A02,514035,Herbst; Matthew,16,0,16,0
1713304715907,MMW 13R,A01,514037,Staff,16,0,16,0
1713304715907,MMW 13R,A02,514039,Staff,16,0,16,0
1713304716938,RMED 296,001,626776,Averbach; Sarah Helene,1,0,1,0
1713304717962,SIO 295LS,A00,523233,Staff,19,0,30,11
1713304718986,SIO 295S,A00,523232,Staff,19,0,30,11
1713304720016,SOCI 117,A01,494376,Staff,3,0,5,2
1713304721042,WES 237B,A00,494380,Staff,19,0,20,1
1713304723129,AESE 279B,A00,494370,Wade; Jon P,33,0,33,0
1713304724154,ANAR 135S,A00,494369,Braswell; Geoffrey E.,0,0,0,0
1713304725184,CAT 124RS,A01,519847,Geibel; William,17,0,20,3
1713304726209,CAT 125RS,A01,515971,Geibel; William,17,0,20,3
1713304727235,CLRE 250,A00,511389,Morris; Sheldon,9996,0,9999,3
1713304728313,CLRE 251,A00,507176,Mehta; Ravindra L.,9996,0,9999,3
1713304728313,CLRE 251,B00,511410,Mehta; Ravindra L.,9998,0,9999,1
1713304729344,CLRE 252,A00,507189,Cuomo; Raphael Eduardo,9998,0,9999,1
1713304730370,CLRE 253,A00,507199,Vaida; Florin,9997,0,9999,2
1713304730370,CLRE 253,B00,507202,Vaida; Florin,9999,0,9999,0
1713304731401,CLRE 259,A00,507211,Patel; Hemal,9996,0,9999,3
1713304732427,CLRE 260,A00,507221,Cuomo; Raphael Eduardo,9999,0,9999,0
1713304733453,CLRE 297,001,507242,Cuomo; Raphael Eduardo,9999,0,9999,0
1713304734480,CSE 191,A00,516875,Minnes Kemp; Mor Mia,9999,0,9999,0
1713304735506,CSS 201S,A01,494383,Staff,35,0,35,0
1713304736533,CSS 202S,A01,494387,Staff,35,0,35,0
1713304737561,EAP 100,A00,516065,Staff,9792,0,9999,207
1713304738588,ECE 45,A01,507414,Staff,56,0,60,4
1713304739617,ECE 100,A01,507416,Baghdadchi; Saharnaz,12,0,20,8
1713304739617,ECE 100,A02,507418,Baghdadchi; Saharnaz,20,0,20,0
1713304740642,ECE 111,A01,507420,Staff,40,0,50,10
1713304741669,ECE 197,001,548057,Sievenpiper; Daniel F.,9999,0,9999,0
1713304742696,EDS 115,A00,507243,Choi; Bailey Miyeon,28,0,28,0
1713304743722,EDS 117,A01,494379,Staff,25,0,25,0
1713304744748,EDS 125,A00,507246,Hopkins; Megan Beth,29,0,30,1
1713304745776,EDS 128A,A01,507264,Fargason; Sharon Gayle,26,0,26,0
1713304746807,EDS 128B,A01,507293,Pappas; Elizabeth,30,0,30,0
1713304747839,EDS 139,A00,507294,Fargason; Sharon Gayle,30,0,30,0
1713304747839,EDS 139,B00,507313,Pappas; Elizabeth,30,0,30,0
1713304748862,EDS 201,A00,507315,Staff,26,0,30,4
1713304749892,EDS 203,A01,507317,Halter; Christopher P.,26,0,30,4
1713304750918,EDS 204R,A01,507319,Halter; Christopher P.,6,0,30,24
1713304750918,EDS 204R,B01,507331,Heinzman; Erica M.,30,0,30,0
1713304751946,EDS 206R,A00,507332,Staff,8,0,30,22
1713304751946,EDS 206R,B00,507343,Staff,29,0,30,1
1713304752975,EDS 250,A00,507344,Hemans; Patricia Ann Benitez,36,0,40,4
1713304754004,EDS 281,A00,507345,Daly; Alan J.,18,0,18,0
1713304755031,EDS 284,A00,507350,Daly; Alan J.,16,0,16,0
1713304756056,EDS 286,A00,507359,Fine; Sarah,18,0,18,0
1713304757084,EDS 289C,A01,507361,Daly; Alan J.,18,0,18,0
1713304758109,EDS 290,A00,507366,Hofstetter; Carolyn,15,0,15,0
1713304759134,LIGM 5A,A00,507421,Fischer-Grunski; Eva K,20,0,20,0
1713304760162,LIGM 5B,A00,507423,Fischer-Grunski; Eva K,20,0,20,0
1713304761185,LIGM 5C,A00,507425,Fischer-Grunski; Eva K,20,0,20,0
1713304762211,LIIT 5AS,A00,507427,Carnelos; Chiara,20,0,20,0
1713304763235,LIIT 5BS,A00,507430,Carnelos; Chiara,20,0,20,0
1713304764261,LIIT 5CS,A00,507432,Carnelos; Chiara,20,0,20,0
1713304765285,LISP 5A,A00,507541,Munoz Sanchez; Alicia,19,0,20,1
1713304766314,LISP 5B,A00,507671,Munoz Sanchez; Alicia,17,0,20,3
1713304767339,LISP 5C,A00,507696,Munoz Sanchez; Alicia,17,0,20,3
1713304768369,MAE 197,001,528363,Boechler; Nicholas Sebastia,9999,0,9999,0
1713304769395,MATH 197,001,523477,Kedlaya; Kiran S.,9999,0,9999,0
1713304769395,MATH 197,002,563811,Zhang; Danna,9999,0,9999,0
1713304770426,MCWP 40R,A00,518780,Staff,20,0,20,0
1713304770426,MCWP 40R,B00,518781,Staff,20,0,20,0
1713304770426,MCWP 40R,C00,518783,Staff,19,0,20,1
1713304771457,MCWP 50R,A00,518791,Staff,20,0,20,0
1713304771457,MCWP 50R,B00,518792,Staff,20,0,20,0
1713304771457,MCWP 50R,C00,518793,Staff,19,0,20,1
1713304771457,MCWP 50R,D00,518794,Staff,19,0,20,1
1713304771457,MCWP 50R,E00,518795,Staff,18,0,20,2
1713304771457,MCWP 50R,F00,518796,Staff,19,0,20,1
1713304771457,MCWP 50R,G00,518797,Staff,19,0,20,1
1713304772484,MMW 12R,A01,514034,Herbst; Matthew,16,0,16,0
1713304772484,MMW 12R,A02,514035,Herbst; Matthew,16,0,16,0
1713304773510,MMW 13R,A01,514037,Staff,16,0,16,0
1713304773510,MMW 13R,A02,514039,Staff,16,0,16,0
1713304774537,RMED 296,001,626776,Averbach; Sarah Helene,1,0,1,0
1713304775562,SIO 295LS,A00,523233,Staff,19,0,30,11
1713304776590,SIO 295S,A00,523232,Staff,19,0,30,11
1713304777615,SOCI 117,A01,494376,Staff,3,0,5,2
1713304778642,WES 237B,A00,494380,Staff,19,0,20,1
1713304780714,AESE 279B,A00,494370,Wade; Jon P,33,0,33,0
1713304781741,ANAR 135S,A00,494369,Braswell; Geoffrey E.,0,0,0,0
1713304782765,CAT 124RS,A01,519847,Geibel; William,17,0,20,3
1713304783794,CAT 125RS,A01,515971,Geibel; William,17,0,20,3
1713304784821,CLRE 250,A00,511389,Morris; Sheldon,9996,0,9999,3
1713304785854,CLRE 251,A00,507176,Mehta; Ravindra L.,9996,0,9999,3
1713304785854,CLRE 251,B00,511410,Mehta; Ravindra L.,9998,0,9999,1
1713304786880,CLRE 252,A00,507189,Cuomo; Raphael Eduardo,9998,0,9999,1
1713304787911,CLRE 253,A00,507199,Vaida; Florin,9997,0,9999,2
1713304787911,CLRE 253,B00,507202,Vaida; Florin,9999,0,9999,0
1713304788935,CLRE 259,A00,507211,Patel; Hemal,9996,0,9999,3
1713304789988,CLRE 260,A00,507221,Cuomo; Raphael Eduardo,9999,0,9999,0
1713304791013,CLRE 297,001,507242,Cuomo; Raphael Eduardo,9999,0,9999,0
1713304792039,CSE 191,A00,516875,Minnes Kemp; Mor Mia,9999,0,9999,0
1713304793070,CSS 201S,A01,494383,Staff,35,0,35,0
1713304794098,CSS 202S,A01,494387,Staff,35,0,35,0
1713304795123,EAP 100,A00,516065,Staff,9792,0,9999,207
1713304796149,ECE 45,A01,507414,Staff,56,0,60,4
1713304797178,ECE 100,A01,507416,Baghdadchi; Saharnaz,12,0,20,8
1713304797178,ECE 100,A02,507418,Baghdadchi; Saharnaz,20,0,20,0
1713304798205,ECE 111,A01,507420,Staff,40,0,50,10
1713304799234,ECE 197,001,548057,Sievenpiper; Daniel F.,9999,0,9999,0
1713304800261,EDS 115,A00,507243,Choi; Bailey Miyeon,28,0,28,0
1713304801287,EDS 117,A01,494379,Staff,25,0,25,0
1713304802312,EDS 125,A00,507246,Hopkins; Megan Beth,29,0,30,1
1713304803337,EDS 128A,A01,507264,Fargason; Sharon Gayle,26,0,26,0
1713304804370,EDS 128B,A01,507293,Pappas; Elizabeth,30,0,30,0
1713304805402,EDS 139,A00,507294,Fargason; Sharon Gayle,30,0,30,0
1713304805402,EDS 139,B00,507313,Pappas; Elizabeth,30,0,30,0
1713304806450,EDS 201,A00,507315,Staff,26,0,30,4
1713304807475,EDS 203,A01,507317,Halter; Christopher P.,26,0,30,4
1713304808505,EDS 204R,A01,507319,Halter; Christopher P.,6,0,30,24
1713304808505,EDS 204R,B01,507331,Heinzman; Erica M.,30,0,30,0
1713304809537,EDS 206R,A00,507332,Staff,8,0,30,22
1713304809537,EDS 206R,B00,507343,Staff,29,0,30,1
1713304810563,EDS 250,A00,507344,Hemans; Patricia Ann Benitez,36,0,40,4
1713304811589,EDS 281,A00,507345,Daly; Alan J.,18,0,18,0
1713304812613,EDS 284,A00,507350,Daly; Alan J.,16,0,16,0
1713304813641,EDS 286,A00,507359,Fine; Sarah,18,0,18,0
1713304814666,EDS 289C,A01,507361,Daly; Alan J.,18,0,18,0
1713304815693,EDS 290,A00,507366,Hofstetter; Carolyn,15,0,15,0
1713304816725,LIGM 5A,A00,507421,Fischer-Grunski; Eva K,20,0,20,0
1713304817761,LIGM 5B,A00,507423,Fischer-Grunski; Eva K,20,0,20,0
1713304818788,LIGM 5C,A00,507425,Fischer-Grunski; Eva K,20,0,20,0
1713304819811,LIIT 5AS,A00,507427,Carnelos; Chiara,20,0,20,0
1713304820837,LIIT 5BS,A00,507430,Carnelos; Chiara,20,0,20,0
1713304821869,LIIT 5CS,A00,507432,Carnelos; Chiara,20,0,20,0
1713304822903,LISP 5A,A00,507541,Munoz Sanchez; Alicia,19,0,20,1
1713304823929,LISP 5B,A00,507671,Munoz Sanchez; Alicia,17,0,20,3
1713304824955,LISP 5C,A00,507696,Munoz Sanchez; Alicia,17,0,20,3
1713304825988,MAE 197,001,528363,Boechler; Nicholas Sebastia,9999,0,9999,0
1713304827037,MATH 197,001,523477,Kedlaya; Kiran S.,9999,0,9999,0
1713304827037,MATH 197,002,563811,Zhang; Danna,9999,0,9999,0
1713304828065,MCWP 40R,A00,518780,Staff,20,0,20,0
1713304828065,MCWP 40R,B00,518781,Staff,20,0,20,0
1713304828065,MCWP 40R,C00,518783,Staff,19,0,20,1
1713304829090,MCWP 50R,A00,518791,Staff,20,0,20,0
1713304829090,MCWP 50R,B00,518792,Staff,20,0,20,0
1713304829090,MCWP 50R,C00,518793,Staff,19,0,20,1
1713304829090,MCWP 50R,D00,518794,Staff,19,0,20,1
1713304829090,MCWP 50R,E00,518795,Staff,18,0,20,2
1713304829090,MCWP 50R,F00,518796,Staff,19,0,20,1
1713304829090,MCWP 50R,G00,518797,Staff,19,0,20,1
1713304830124,MMW 12R,A01,514034,Herbst; Matthew,16,0,16,0
1713304830124,MMW 12R,A02,514035,Herbst; Matthew,16,0,16,0
1713304831149,MMW 13R,A01,514037,Staff,16,0,16,0
1713304831149,MMW 13R,A02,514039,Staff,16,0,16,0
1713304832228,RMED 296,001,626776,Averbach; Sarah Helene,1,0,1,0
1713304833254,SIO 295LS,A00,523233,Staff,19,0,30,11
1713304834278,SIO 295S,A00,523232,Staff,19,0,30,11
1713304835307,SOCI 117,A01,494376,Staff,3,0,5,2
1713304836332,WES 237B,A00,494380,Staff,19,0,20,1
1713304838401,AESE 279B,A00,494370,Wade; Jon P,33,0,33,0
1713304839456,ANAR 135S,A00,494369,Braswell; Geoffrey E.,0,0,0,0
1713304840541,CAT 124RS,A01,519847,Geibel; William,17,0,20,3
1713304841571,CAT 125RS,A01,515971,Geibel; William,17,0,20,3
1713304842666,CLRE 250,A00,511389,Morris; Sheldon,9996,0,9999,3
1713304843693,CLRE 251,A00,507176,Mehta; Ravindra L.,9996,0,9999,3
1713304843693,CLRE 251,B00,511410,Mehta; Ravindra L.,9998,0,9999,1
1713304844717,CLRE 252,A00,507189,Cuomo; Raphael Eduardo,9998,0,9999,1
1713304845744,CLRE 253,A00,507199,Vaida; Florin,9997,0,9999,2
1713304845744,CLRE 253,B00,507202,Vaida; Florin,9999,0,9999,0
1713304846772,CLRE 259,A00,507211,Patel; Hemal,9996,0,9999,3
1713304847802,CLRE 260,A00,507221,Cuomo; Raphael Eduardo,9999,0,9999,0
1713304848828,CLRE 297,001,507242,Cuomo; Raphael Eduardo,9999,0,9999,0
1713304849856,CSE 191,A00,516875,Minnes Kemp; Mor Mia,9999,0,9999,0
1713304850880,CSS 201S,A01,494383,Staff,35,0,35,0
1713304851913,CSS 202S,A01,494387,Staff,35,0,35,0
1713304852940,EAP 100,A00,516065,Staff,9792,0,9999,207
1713304853971,ECE 45,A01,507414,Staff,56,0,60,4
1713304855000,ECE 100,A01,507416,Baghdadchi; Saharnaz,12,0,20,8
1713304855000,ECE 100,A02,507418,Baghdadchi; Saharnaz,20,0,20,0
1713304856025,ECE 111,A01,507420,Staff,40,0,50,10
1713304857060,ECE 197,001,548057,Sievenpiper; Daniel F.,9999,0,9999,0
1713304858091,EDS 115,A00,507243,Choi; Bailey Miyeon,28,0,28,0
1713304859129,EDS 117,A01,494379,Staff,25,0,25,0
1713304860271,EDS 125,A00,507246,Hopkins; Megan Beth,29,0,30,1
1713304861299,EDS 128A,A01,507264,Fargason; Sharon Gayle,26,0,26,0
1713304862374,EDS 128B,A01,507293,Pappas; Elizabeth,30,0,30,0
1713304863402,EDS 139,A00,507294,Fargason; Sharon Gayle,30,0,30,0
1713304863402,EDS 139,B00,507313,Pappas; Elizabeth,30,0,30,0
1713304864429,EDS 201,A00,507315,Staff,26,0,30,4
1713304865454,EDS 203,A01,507317,Halter; Christopher P.,26,0,30,4
1713304866478,EDS 204R,A01,507319,Halter; Christopher P.,6,0,30,24
1713304866478,EDS 204R,B01,507331,Heinzman; Erica M.,30,0,30,0
1713304867503,EDS 206R,A00,507332,Staff,8,0,30,22
1713304867503,EDS 206R,B00,507343,Staff,29,0,30,1
1713304868528,EDS 250,A00,507344,Hemans; Patricia Ann Benitez,36,0,40,4
1713304869558,EDS 281,A00,507345,Daly; Alan J.,18,0,18,0
1713304870601,EDS 284,A00,507350,Daly; Alan J.,16,0,16,0
1713304871657,EDS 286,A00,507359,Fine; Sarah,18,0,18,0
1713304872681,EDS 289C,A01,507361,Daly; Alan J.,18,0,18,0
1713304873706,EDS 290,A00,507366,Hofstetter; Carolyn,15,0,15,0
1713304874730,LIGM 5A,A00,507421,Fischer-Grunski; Eva K,20,0,20,0
1713304875764,LIGM 5B,A00,507423,Fischer-Grunski; Eva K,20,0,20,0
1713304876792,LIGM 5C,A00,507425,Fischer-Grunski; Eva K,20,0,20,0
1713304877824,LIIT 5AS,A00,507427,Carnelos; Chiara,20,0,20,0
1713304878850,LIIT 5BS,A00,507430,Carnelos; Chiara,20,0,20,0
1713304879880,LIIT 5CS,A00,507432,Carnelos; Chiara,20,0,20,0
1713304880910,LISP 5A,A00,507541,Munoz Sanchez; Alicia,19,0,20,1
1713304881937,LISP 5B,A00,507671,Munoz Sanchez; Alicia,17,0,20,3
1713304882966,LISP 5C,A00,507696,Munoz Sanchez; Alicia,17,0,20,3
1713304883996,MAE 197,001,528363,Boechler; Nicholas Sebastia,9999,0,9999,0
1713304885022,MATH 197,001,523477,Kedlaya; Kiran S.,9999,0,9999,0
1713304885022,MATH 197,002,563811,Zhang; Danna,9999,0,9999,0
1713304886053,MCWP 40R,A00,518780,Staff,20,0,20,0
1713304886053,MCWP 40R,B00,518781,Staff,20,0,20,0
1713304886053,MCWP 40R,C00,518783,Staff,19,0,20,1
1713304887080,MCWP 50R,A00,518791,Staff,20,0,20,0
1713304887080,MCWP 50R,B00,518792,Staff,20,0,20,0
1713304887080,MCWP 50R,C00,518793,Staff,19,0,20,1
1713304887080,MCWP 50R,D00,518794,Staff,19,0,20,1
1713304887080,MCWP 50R,E00,518795,Staff,18,0,20,2
1713304887080,MCWP 50R,F00,518796,Staff,19,0,20,1
1713304887080,MCWP 50R,G00,518797,Staff,19,0,20,1
1713304888109,MMW 12R,A01,514034,Herbst; Matthew,16,0,16,0
1713304888109,MMW 12R,A02,514035,Herbst; Matthew,16,0,16,0
1713304889134,MMW 13R,A01,514037,Staff,15,0,16,1
1713304889134,MMW 13R,A02,514039,Staff,16,0,16,0
1713304890158,RMED 296,001,626776,Averbach; Sarah Helene,1,0,1,0
1713304891182,SIO 295LS,A00,523233,Staff,19,0,30,11
1713304892210,SIO 295S,A00,523232,Staff,19,0,30,11
1713304893240,SOCI 117,A01,494376,Staff,3,0,5,2
1713304894266,WES 237B,A00,494380,Staff,19,0,20,1
1713304896337,AESE 279B,A00,494370,Wade; Jon P,33,0,33,0
1713304897371,ANAR 135S,A00,494369,Braswell; Geoffrey E.,0,0,0,0
1713304898401,CAT 124RS,A01,519847,Geibel; William,17,0,20,3
1713304899425,CAT 125RS,A01,515971,Geibel; William,17,0,20,3
1713304900460,CLRE 250,A00,511389,Morris; Sheldon,9996,0,9999,3
1713304901486,CLRE 251,A00,507176,Mehta; Ravindra L.,9996,0,9999,3
1713304901486,CLRE 251,B00,511410,Mehta; Ravindra L.,9998,0,9999,1
1713304902510,CLRE 252,A00,507189,Cuomo; Raphael Eduardo,9998,0,9999,1
1713304903538,CLRE 253,A00,507199,Vaida; Florin,9997,0,9999,2
1713304903538,CLRE 253,B00,507202,Vaida; Florin,9999,0,9999,0
1713304904563,CLRE 259,A00,507211,Patel; Hemal,9996,0,9999,3
1713304905590,CLRE 260,A00,507221,Cuomo; Raphael Eduardo,9999,0,9999,0
1713304906625,CLRE 297,001,507242,Cuomo; Raphael Eduardo,9999,0,9999,0
1713304907649,CSE 191,A00,516875,Minnes Kemp; Mor Mia,9999,0,9999,0
1713304908680,CSS 201S,A01,494383,Staff,35,0,35,0
1713304909707,CSS 202S,A01,494387,Staff,35,0,35,0
1713304910805,EAP 100,A00,516065,Staff,9792,0,9999,207
1713304911835,ECE 45,A01,507414,Staff,56,0,60,4
1713304912862,ECE 100,A01,507416,Baghdadchi; Saharnaz,12,0,20,8
1713304912862,ECE 100,A02,507418,Baghdadchi; Saharnaz,20,0,20,0
1713304913899,ECE 111,A01,507420,Staff,40,0,50,10
1713304914924,ECE 197,001,548057,Sievenpiper; Daniel F.,9999,0,9999,0
1713304915953,EDS 115,A00,507243,Choi; Bailey Miyeon,28,0,28,0
1713304916978,EDS 117,A01,494379,Staff,25,0,25,0
1713304918008,EDS 125,A00,507246,Hopkins; Megan Beth,29,0,30,1
1713304919037,EDS 128A,A01,507264,Fargason; Sharon Gayle,26,0,26,0
1713304920074,EDS 128B,A01,507293,Pappas; Elizabeth,30,0,30,0
1713304921099,EDS 139,A00,507294,Fargason; Sharon Gayle,30,0,30,0
1713304921099,EDS 139,B00,507313,Pappas; Elizabeth,30,0,30,0
1713304922127,EDS 201,A00,507315,Staff,26,0,30,4
1713304923155,EDS 203,A01,507317,Halter; Christopher P.,26,0,30,4
1713304924184,EDS 204R,A01,507319,Halter; Christopher P.,6,0,30,24
1713304924184,EDS 204R,B01,507331,Heinzman; Erica M.,30,0,30,0
1713304925215,EDS 206R,A00,507332,Staff,8,0,30,22
1713304925215,EDS 206R,B00,507343,Staff,29,0,30,1
1713304926249,EDS 250,A00,507344,Hemans; Patricia Ann Benitez,36,0,40,4
1713304927275,EDS 281,A00,507345,Daly; Alan J.,18,0,18,0
1713304928301,EDS 284,A00,507350,Daly; Alan J.,16,0,16,0
1713304929329,EDS 286,A00,507359,Fine; Sarah,18,0,18,0
1713304930357,EDS 289C,A01,507361,Daly; Alan J.,18,0,18,0
1713304931389,EDS 290,A00,507366,Hofstetter; Carolyn,15,0,15,0
1713304932414,LIGM 5A,A00,507421,Fischer-Grunski; Eva K,20,0,20,0
1713304933446,LIGM 5B,A00,507423,Fischer-Grunski; Eva K,20,0,20,0
1713304934472,LIGM 5C,A00,507425,Fischer-Grunski; Eva K,20,0,20,0
1713304935496,LIIT 5AS,A00,507427,Carnelos; Chiara,20,0,20,0
1713304936574,LIIT 5BS,A00,507430,Carnelos; Chiara,20,0,20,0
1713304937601,LIIT 5CS,A00,507432,Carnelos; Chiara,20,0,20,0
1713304938626,LISP 5A,A00,507541,Munoz Sanchez; Alicia,19,0,20,1
1713304939657,LISP 5B,A00,507671,Munoz Sanchez; Alicia,17,0,20,3
1713304940680,LISP 5C,A00,507696,Munoz Sanchez; Alicia,17,0,20,3
1713304941708,MAE 197,001,528363,Boechler; Nicholas Sebastia,9999,0,9999,0
1713304942737,MATH 197,001,523477,Kedlaya; Kiran S.,9999,0,9999,0
1713304942737,MATH 197,002,563811,Zhang; Danna,9999,0,9999,0
1713304943766,MCWP 40R,A00,518780,Staff,20,0,20,0
1713304943766,MCWP 40R,B00,518781,Staff,20,0,20,0
1713304943766,MCWP 40R,C00,518783,Staff,19,0,20,1
1713304944794,MCWP 50R,A00,518791,Staff,20,0,20,0
1713304944794,MCWP 50R,B00,518792,Staff,20,0,20,0
1713304944794,MCWP 50R,C00,518793,Staff,19,0,20,1
1713304944794,MCWP 50R,D00,518794,Staff,19,0,20,1
1713304944794,MCWP 50R,E00,518795,Staff,18,0,20,2
1713304944794,MCWP 50R,F00,518796,Staff,19,0,20,1
1713304944794,MCWP 50R,G00,518797,Staff,19,0,20,1
1713304945829,MMW 12R,A01,514034,Herbst; Matthew,16,0,16,0
1713304945829,MMW 12R,A02,514035,Herbst; Matthew,16,0,16,0
1713304946855,MMW 13R,A01,514037,Staff,15,0,16,1
1713304946855,MMW 13R,A02,514039,Staff,16,0,16,0
1713304947882,RMED 296,001,626776,Averbach; Sarah Helene,1,0,1,0
1713304948908,SIO 295LS,A00,523233,Staff,19,0,30,11
1713304949935,SIO 295S,A00,523232,Staff,19,0,30,11
1713304950961,SOCI 117,A01,494376,Staff,3,0,5,2
1713304951985,WES 237B,A00,494380,Staff,19,0,20,1
1713304954071,AESE 279B,A00,494370,Wade; Jon P,33,0,33,0
1713304955095,ANAR 135S,A00,494369,Braswell; Geoffrey E.,0,0,0,0
1713304956119,CAT 124RS,A01,519847,Geibel; William,17,0,20,3
1713304957143,CAT 125RS,A01,515971,Geibel; William,17,0,20,3
1713304958172,CLRE 250,A00,511389,Morris; Sheldon,9996,0,9999,3
1713304959202,CLRE 251,A00,507176,Mehta; Ravindra L.,9996,0,9999,3
1713304959202,CLRE 251,B00,511410,Mehta; Ravindra L.,9998,0,9999,1
1713304960226,CLRE 252,A00,507189,Cuomo; Raphael Eduardo,9998,0,9999,1
1713304961250,CLRE 253,A00,507199,Vaida; Florin,9997,0,9999,2
1713304961250,CLRE 253,B00,507202,Vaida; Florin,9999,0,9999,0
1713304962279,CLRE 259,A00,507211,Patel; Hemal,9996,0,9999,3
1713304963309,CLRE 260,A00,507221,Cuomo; Raphael Eduardo,9999,0,9999,0
1713304964340,CLRE 297,001,507242,Cuomo; Raphael Eduardo,9999,0,9999,0
1713304965364,CSE 191,A00,516875,Minnes Kemp; Mor Mia,9999,0,9999,0
1713304966392,CSS 201S,A01,494383,Staff,35,0,35,0
1713304967417,CSS 202S,A01,494387,Staff,35,0,35,0
1713304968442,EAP 100,A00,516065,Staff,9792,0,9999,207
1713304969465,ECE 45,A01,507414,Staff,56,0,60,4
1713304970496,ECE 100,A01,507416,Baghdadchi; Saharnaz,12,0,20,8
1713304970496,ECE 100,A02,507418,Baghdadchi; Saharnaz,20,0,20,0
1713304971520,ECE 111,A01,507420,Staff,40,0,50,10
1713304972546,ECE 197,001,548057,Sievenpiper; Daniel F.,9999,0,9999,0
1713304973571,EDS 115,A00,507243,Choi; Bailey Miyeon,28,0,28,0
1713304974601,EDS 117,A01,494379,Staff,25,0,25,0
1713304975626,EDS 125,A00,507246,Hopkins; Megan Beth,29,0,30,1
1713304976651,EDS 128A,A01,507264,Fargason; Sharon Gayle,26,0,26,0
1713304977682,EDS 128B,A01,507293,Pappas; Elizabeth,30,0,30,0
1713304978706,EDS 139,A00,507294,Fargason; Sharon Gayle,30,0,30,0
1713304978706,EDS 139,B00,507313,Pappas; Elizabeth,30,0,30,0
1713304979741,EDS 201,A00,507315,Staff,26,0,30,4
1713304980767,EDS 203,A01,507317,Halter; Christopher P.,26,0,30,4
1713304981791,EDS 204R,A01,507319,Halter; Christopher P.,6,0,30,24
1713304981791,EDS 204R,B01,507331,Heinzman; Erica M.,30,0,30,0
1713304982818,EDS 206R,A00,507332,Staff,8,0,30,22
1713304982818,EDS 206R,B00,507343,Staff,29,0,30,1
1713304983845,EDS 250,A00,507344,Hemans; Patricia Ann Benitez,36,0,40,4
1713304984874,EDS 281,A00,507345,Daly; Alan J.,18,0,18,0
1713304985906,EDS 284,A00,507350,Daly; Alan J.,16,0,16,0
1713304986934,EDS 286,A00,507359,Fine; Sarah,18,0,18,0
1713304987963,EDS 289C,A01,507361,Daly; Alan J.,18,0,18,0
1713304988991,EDS 290,A00,507366,Hofstetter; Carolyn,15,0,15,0
1713304990016,LIGM 5A,A00,507421,Fischer-Grunski; Eva K,20,0,20,0
1713304991048,LIGM 5B,A00,507423,Fischer-Grunski; Eva K,20,0,20,0
1713304992072,LIGM 5C,A00,507425,Fischer-Grunski; Eva K,20,0,20,0
1713304993098,LIIT 5AS,A00,507427,Carnelos; Chiara,20,0,20,0
1713304994124,LIIT 5BS,A00,507430,Carnelos; Chiara,20,0,20,0
1713304995150,LIIT 5CS,A00,507432,Carnelos; Chiara,20,0,20,0
1713304996179,LISP 5A,A00,507541,Munoz Sanchez; Alicia,19,0,20,1
1713304997345,LISP 5B,A00,507671,Munoz Sanchez; Alicia,17,0,20,3
1713304998368,LISP 5C,A00,507696,Munoz Sanchez; Alicia,17,0,20,3
1713304999400,MAE 197,001,528363,Boechler; Nicholas Sebastia,9999,0,9999,0
1713305000428,MATH 197,001,523477,Kedlaya; Kiran S.,9999,0,9999,0
1713305000428,MATH 197,002,563811,Zhang; Danna,9999,0,9999,0
1713305001454,MCWP 40R,A00,518780,Staff,20,0,20,0
1713305001454,MCWP 40R,B00,518781,Staff,20,0,20,0
1713305001454,MCWP 40R,C00,518783,Staff,19,0,20,1
1713305002484,MCWP 50R,A00,518791,Staff,20,0,20,0
1713305002484,MCWP 50R,B00,518792,Staff,20,0,20,0
1713305002484,MCWP 50R,C00,518793,Staff,19,0,20,1
1713305002484,MCWP 50R,D00,518794,Staff,19,0,20,1
1713305002484,MCWP 50R,E00,518795,Staff,18,0,20,2
1713305002484,MCWP 50R,F00,518796,Staff,19,0,20,1
1713305002484,MCWP 50R,G00,518797,Staff,19,0,20,1
1713305003512,MMW 12R,A01,514034,Herbst; Matthew,16,0,16,0
1713305003512,MMW 12R,A02,514035,Herbst; Matthew,16,0,16,0
1713305004539,MMW 13R,A01,514037,Staff,15,0,16,1
1713305004539,MMW 13R,A02,514039,Staff,16,0,16,0
1713305005570,RMED 296,001,626776,Averbach; Sarah Helene,1,0,1,0
1713305006599,SIO 295LS,A00,523233,Staff,19,0,30,11
1713305007627,SIO 295S,A00,523232,Staff,19,0,30,11
1713305008651,SOCI 117,A01,494376,Staff,3,0,5,2
1713305009676,WES 237B,A00,494380,Staff,19,0,20,1
1713305011748,AESE 279B,A00,494370,Wade; Jon P,33,0,33,0
1713305012772,ANAR 135S,A00,494369,Braswell; Geoffrey E.,0,0,0,0
1713305013796,CAT 124RS,A01,519847,Geibel; William,17,0,20,3
1713305014825,CAT 125RS,A01,515971,Geibel; William,17,0,20,3
1713305015851,CLRE 250,A00,511389,Morris; Sheldon,9996,0,9999,3
1713305016962,CLRE 251,A00,507176,Mehta; Ravindra L.,9996,0,9999,3
1713305016962,CLRE 251,B00,511410,Mehta; Ravindra L.,9998,0,9999,1
1713305017990,CLRE 252,A00,507189,Cuomo; Raphael Eduardo,9998,0,9999,1
1713305019017,CLRE 253,A00,507199,Vaida; Florin,9997,0,9999,2
1713305019017,CLRE 253,B00,507202,Vaida; Florin,9999,0,9999,0
1713305020043,CLRE 259,A00,507211,Patel; Hemal,9996,0,9999,3
1713305021067,CLRE 260,A00,507221,Cuomo; Raphael Eduardo,9999,0,9999,0
1713305022092,CLRE 297,001,507242,Cuomo; Raphael Eduardo,9999,0,9999,0
1713305023116,CSE 191,A00,516875,Minnes Kemp; Mor Mia,9999,0,9999,0
1713305024145,CSS 201S,A01,494383,Staff,35,0,35,0
1713305025169,CSS 202S,A01,494387,Staff,35,0,35,0
1713305026196,EAP 100,A00,516065,Staff,9792,0,9999,207
1713305027224,ECE 45,A01,507414,Staff,56,0,60,4
1713305028256,ECE 100,A01,507416,Baghdadchi; Saharnaz,12,0,20,8
1713305028256,ECE 100,A02,507418,Baghdadchi; Saharnaz,20,0,20,0
1713305029279,ECE 111,A01,507420,Staff,40,0,50,10
1713305030304,ECE 197,001,548057,Sievenpiper; Daniel F.,9999,0,9999,0
1713305031334,EDS 115,A00,507243,Choi; Bailey Miyeon,28,0,28,0
1713305032359,EDS 117,A01,494379,Staff,25,0,25,0
1713305033386,EDS 125,A00,507246,Hopkins; Megan Beth,29,0,30,1
1713305034413,EDS 128A,A01,507264,Fargason; Sharon Gayle,26,0,26,0
1713305035444,EDS 128B,A01,507293,Pappas; Elizabeth,30,0,30,0
1713305036472,EDS 139,A00,507294,Fargason; Sharon Gayle,30,0,30,0
1713305036472,EDS 139,B00,507313,Pappas; Elizabeth,30,0,30,0
1713305037497,EDS 201,A00,507315,Staff,26,0,30,4
1713305038523,EDS 203,A01,507317,Halter; Christopher P.,26,0,30,4
1713305039554,EDS 204R,A01,507319,Halter; Christopher P.,6,0,30,24
1713305039554,EDS 204R,B01,507331,Heinzman; Erica M.,30,0,30,0
1713305040641,EDS 206R,A00,507332,Staff,8,0,30,22
1713305040641,EDS 206R,B00,507343,Staff,29,0,30,1
1713305041671,EDS 250,A00,507344,Hemans; Patricia Ann Benitez,36,0,40,4
1713305042698,EDS 281,A00,507345,Daly; Alan J.,18,0,18,0
1713305043721,EDS 284,A00,507350,Daly; Alan J.,16,0,16,0
1713305044747,EDS 286,A00,507359,Fine; Sarah,18,0,18,0
1713305045773,EDS 289C,A01,507361,Daly; Alan J.,18,0,18,0
1713305046798,EDS 290,A00,507366,Hofstetter; Carolyn,15,0,15,0
1713305047823,LIGM 5A,A00,507421,Fischer-Grunski; Eva K,20,0,20,0
1713305048851,LIGM 5B,A00,507423,Fischer-Grunski; Eva K,20,0,20,0
1713305049876,LIGM 5C,A00,507425,Fischer-Grunski; Eva K,20,0,20,0
1713305050906,LIIT 5AS,A00,507427,Carnelos; Chiara,20,0,20,0
1713305051934,LIIT 5BS,A00,507430,Carnelos; Chiara,20,0,20,0
1713305052968,LIIT 5CS,A00,507432,Carnelos; Chiara,20,0,20,0
1713305053994,LISP 5A,A00,507541,Munoz Sanchez; Alicia,19,0,20,1
1713305055017,LISP 5B,A00,507671,Munoz Sanchez; Alicia,17,0,20,3
1713305056043,LISP 5C,A00,507696,Munoz Sanchez; Alicia,17,0,20,3
1713305057067,MAE 197,001,528363,Boechler; Nicholas Sebastia,9999,0,9999,0
1713305058092,MATH 197,001,523477,Kedlaya; Kiran S.,9999,0,9999,0
1713305058092,MATH 197,002,563811,Zhang; Danna,9999,0,9999,0
1713305059119,MCWP 40R,A00,518780,Staff,20,0,20,0
1713305059119,MCWP 40R,B00,518781,Staff,20,0,20,0
1713305059119,MCWP 40R,C00,518783,Staff,19,0,20,1
1713305060149,MCWP 50R,A00,518791,Staff,20,0,20,0
1713305060149,MCWP 50R,B00,518792,Staff,20,0,20,0
1713305060149,MCWP 50R,C00,518793,Staff,19,0,20,1
1713305060149,MCWP 50R,D00,518794,Staff,19,0,20,1
1713305060149,MCWP 50R,E00,518795,Staff,18,0,20,2
1713305060149,MCWP 50R,F00,518796,Staff,19,0,20,1
1713305060149,MCWP 50R,G00,518797,Staff,19,0,20,1
1713305061178,MMW 12R,A01,514034,Herbst; Matthew,16,0,16,0
1713305061178,MMW 12R,A02,514035,Herbst; Matthew,16,0,16,0
1713305062204,MMW 13R,A01,514037,Staff,15,0,16,1
1713305062204,MMW 13R,A02,514039,Staff,16,0,16,0
1713305063233,RMED 296,001,626776,Averbach; Sarah Helene,1,0,1,0
1713305064260,SIO 295LS,A00,523233,Staff,19,0,30,11
1713305065288,SIO 295S,A00,523232,Staff,19,0,30,11
1713305066315,SOCI 117,A01,494376,Staff,3,0,5,2
1713305067339,WES 237B,A00,494380,Staff,19,0,20,1
1713305069404,AESE 279B,A00,494370,Wade; Jon P,33,0,33,0
1713305070432,ANAR 135S,A00,494369,Braswell; Geoffrey E.,0,0,0,0
1713305071458,CAT 124RS,A01,519847,Geibel; William,17,0,20,3
1713305072488,CAT 125RS,A01,515971,Geibel; William,17,0,20,3
1713305073517,CLRE 250,A00,511389,Morris; Sheldon,9996,0,9999,3
1713305074548,CLRE 251,A00,507176,Mehta; Ravindra L.,9996,0,9999,3
1713305074548,CLRE 251,B00,511410,Mehta; Ravindra L.,9998,0,9999,1
1713305075574,CLRE 252,A00,507189,Cuomo; Raphael Eduardo,9998,0,9999,1
1713305076600,CLRE 253,A00,507199,Vaida; Florin,9997,0,9999,2
1713305076600,CLRE 253,B00,507202,Vaida; Florin,9999,0,9999,0
1713305077628,CLRE 259,A00,507211,Patel; Hemal,9996,0,9999,3
1713305078651,CLRE 260,A00,507221,Cuomo; Raphael Eduardo,9999,0,9999,0
1713305079679,CLRE 297,001,507242,Cuomo; Raphael Eduardo,9999,0,9999,0
1713305080709,CSE 191,A00,516875,Minnes Kemp; Mor Mia,9999,0,9999,0
1713305081736,CSS 201S,A01,494383,Staff,35,0,35,0
1713305082761,CSS 202S,A01,494387,Staff,35,0,35,0
1713305083793,EAP 100,A00,516065,Staff,9792,0,9999,207
1713305084823,ECE 45,A01,507414,Staff,56,0,60,4
1713305085848,ECE 100,A01,507416,Baghdadchi; Saharnaz,12,0,20,8
1713305085848,ECE 100,A02,507418,Baghdadchi; Saharnaz,20,0,20,0
1713305086872,ECE 111,A01,507420,Staff,40,0,50,10
1713305087899,ECE 197,001,548057,Sievenpiper; Daniel F.,9999,0,9999,0
1713305088928,EDS 115,A00,507243,Choi; Bailey Miyeon,28,0,28,0
1713305089952,EDS 117,A01,494379,Staff,25,0,25,0
1713305090977,EDS 125,A00,507246,Hopkins; Megan Beth,29,0,30,1
1713305092002,EDS 128A,A01,507264,Fargason; Sharon Gayle,26,0,26,0
1713305093032,EDS 128B,A01,507293,Pappas; Elizabeth,30,0,30,0
1713305094063,EDS 139,A00,507294,Fargason; Sharon Gayle,30,0,30,0
1713305094063,EDS 139,B00,507313,Pappas; Elizabeth,30,0,30,0
1713305095093,EDS 201,A00,507315,Staff,26,0,30,4
1713305096119,EDS 203,A01,507317,Halter; Christopher P.,26,0,30,4
1713305097147,EDS 204R,A01,507319,Halter; Christopher P.,6,0,30,24
1713305097147,EDS 204R,B01,507331,Heinzman; Erica M.,30,0,30,0
1713305098172,EDS 206R,A00,507332,Staff,8,0,30,22
1713305098172,EDS 206R,B00,507343,Staff,29,0,30,1
1713305099197,EDS 250,A00,507344,Hemans; Patricia Ann Benitez,36,0,40,4
1713305100227,EDS 281,A00,507345,Daly; Alan J.,18,0,18,0
1713305101252,EDS 284,A00,507350,Daly; Alan J.,16,0,16,0
1713305102275,EDS 286,A00,507359,Fine; Sarah,18,0,18,0
1713305103300,EDS 289C,A01,507361,Daly; Alan J.,18,0,18,0
1713305104327,EDS 290,A00,507366,Hofstetter; Carolyn,15,0,15,0
1713305105357,LIGM 5A,A00,507421,Fischer-Grunski; Eva K,20,0,20,0
1713305106383,LIGM 5B,A00,507423,Fischer-Grunski; Eva K,20,0,20,0
1713305107406,LIGM 5C,A00,507425,Fischer-Grunski; Eva K,20,0,20,0
1713305108435,LIIT 5AS,A00,507427,Carnelos; Chiara,20,0,20,0
1713305109465,LIIT 5BS,A00,507430,Carnelos; Chiara,20,0,20,0
1713305110493,LIIT 5CS,A00,507432,Carnelos; Chiara,20,0,20,0
1713305111519,LISP 5A,A00,507541,Munoz Sanchez; Alicia,19,0,20,1
1713305112543,LISP 5B,A00,507671,Munoz Sanchez; Alicia,17,0,20,3
1713305113574,LISP 5C,A00,507696,Munoz Sanchez; Alicia,17,0,20,3
1713305114612,MAE 197,001,528363,Boechler; Nicholas Sebastia,9999,0,9999,0
1713305115637,MATH 197,001,523477,Kedlaya; Kiran S.,9999,0,9999,0
1713305115637,MATH 197,002,563811,Zhang; Danna,9999,0,9999,0
1713305116666,MCWP 40R,A00,518780,Staff,20,0,20,0
1713305116666,MCWP 40R,B00,518781,Staff,20,0,20,0
1713305116666,MCWP 40R,C00,518783,Staff,19,0,20,1
1713305117697,MCWP 50R,A00,518791,Staff,20,0,20,0
1713305117697,MCWP 50R,B00,518792,Staff,20,0,20,0
1713305117697,MCWP 50R,C00,518793,Staff,19,0,20,1
1713305117697,MCWP 50R,D00,518794,Staff,19,0,20,1
1713305117697,MCWP 50R,E00,518795,Staff,18,0,20,2
1713305117697,MCWP 50R,F00,518796,Staff,19,0,20,1
1713305117697,MCWP 50R,G00,518797,Staff,19,0,20,1
1713305118722,MMW 12R,A01,514034,Herbst; Matthew,16,0,16,0
1713305118722,MMW 12R,A02,514035,Herbst; Matthew,16,0,16,0
1713305119747,MMW 13R,A01,514037,Staff,15,0,16,1
1713305119747,MMW 13R,A02,514039,Staff,16,0,16,0
1713305120775,RMED 296,001,626776,Averbach; Sarah Helene,1,0,1,0
1713305121801,SIO 295LS,A00,523233,Staff,19,0,30,11
1713305122826,SIO 295S,A00,523232,Staff,19,0,30,11
1713305123859,SOCI 117,A01,494376,Staff,3,0,5,2
1713305124884,WES 237B,A00,494380,Staff,19,0,20,1
1713305126952,AESE 279B,A00,494370,Wade; Jon P,33,0,33,0
1713305127977,ANAR 135S,A00,494369,Braswell; Geoffrey E.,0,0,0,0
1713305129004,CAT 124RS,A01,519847,Geibel; William,17,0,20,3
1713305130028,CAT 125RS,A01,515971,Geibel; William,17,0,20,3
1713305131056,CLRE 250,A00,511389,Morris; Sheldon,9996,0,9999,3
1713305132084,CLRE 251,A00,507176,Mehta; Ravindra L.,9996,0,9999,3
1713305132084,CLRE 251,B00,511410,Mehta; Ravindra L.,9998,0,9999,1
1713305133111,CLRE 252,A00,507189,Cuomo; Raphael Eduardo,9998,0,9999,1
1713305134136,CLRE 253,A00,507199,Vaida; Florin,9997,0,9999,2
1713305134136,CLRE 253,B00,507202,Vaida; Florin,9999,0,9999,0
1713305135162,CLRE 259,A00,507211,Patel; Hemal,9996,0,9999,3
1713305136186,CLRE 260,A00,507221,Cuomo; Raphael Eduardo,9999,0,9999,0
1713305137213,CLRE 297,001,507242,Cuomo; Raphael Eduardo,9999,0,9999,0
1713305138243,CSE 191,A00,516875,Minnes Kemp; Mor Mia,9999,0,9999,0
1713305139269,CSS 201S,A01,494383,Staff,35,0,35,0
1713305140299,CSS 202S,A01,494387,Staff,35,0,35,0
1713305141324,EAP 100,A00,516065,Staff,9792,0,9999,207
1713305142348,ECE 45,A01,507414,Staff,56,0,60,4
1713305143374,ECE 100,A01,507416,Baghdadchi; Saharnaz,12,0,20,8
1713305143374,ECE 100,A02,507418,Baghdadchi; Saharnaz,20,0,20,0
1713305144471,ECE 111,A01,507420,Staff,40,0,50,10
1713305145500,ECE 197,001,548057,Sievenpiper; Daniel F.,9999,0,9999,0
1713305146525,EDS 115,A00,507243,Choi; Bailey Miyeon,28,0,28,0
1713305147551,EDS 117,A01,494379,Staff,25,0,25,0
1713305148576,EDS 125,A00,507246,Hopkins; Megan Beth,29,0,30,1
1713305149601,EDS 128A,A01,507264,Fargason; Sharon Gayle,26,0,26,0
1713305150626,EDS 128B,A01,507293,Pappas; Elizabeth,30,0,30,0
1713305151657,EDS 139,A00,507294,Fargason; Sharon Gayle,30,0,30,0
1713305151657,EDS 139,B00,507313,Pappas; Elizabeth,30,0,30,0
1713305152685,EDS 201,A00,507315,Staff,26,0,30,4
1713305153710,EDS 203,A01,507317,Halter; Christopher P.,26,0,30,4
1713305154739,EDS 204R,A01,507319,Halter; Christopher P.,6,0,30,24
1713305154739,EDS 204R,B01,507331,Heinzman; Erica M.,30,0,30,0
1713305155767,EDS 206R,A00,507332,Staff,8,0,30,22
1713305155767,EDS 206R,B00,507343,Staff,29,0,30,1
1713305156796,EDS 250,A00,507344,Hemans; Patricia Ann Benitez,36,0,40,4
1713305157824,EDS 281,A00,507345,Daly; Alan J.,18,0,18,0
1713305158849,EDS 284,A00,507350,Daly; Alan J.,16,0,16,0
1713305159874,EDS 286,A00,507359,Fine; Sarah,18,0,18,0
1713305160902,EDS 289C,A01,507361,Daly; Alan J.,18,0,18,0
1713305161928,EDS 290,A00,507366,Hofstetter; Carolyn,15,0,15,0
1713305162955,LIGM 5A,A00,507421,Fischer-Grunski; Eva K,20,0,20,0
1713305163984,LIGM 5B,A00,507423,Fischer-Grunski; Eva K,20,0,20,0
1713305165014,LIGM 5C,A00,507425,Fischer-Grunski; Eva K,20,0,20,0
1713305166039,LIIT 5AS,A00,507427,Carnelos; Chiara,20,0,20,0
1713305167070,LIIT 5BS,A00,507430,Carnelos; Chiara,20,0,20,0
1713305168097,LIIT 5CS,A00,507432,Carnelos; Chiara,20,0,20,0
1713305169122,LISP 5A,A00,507541,Munoz Sanchez; Alicia,19,0,20,1
1713305170154,LISP 5B,A00,507671,Munoz Sanchez; Alicia,17,0,20,3
1713305171179,LISP 5C,A00,507696,Munoz Sanchez; Alicia,17,0,20,3
1713305172204,MAE 197,001,528363,Boechler; Nicholas Sebastia,9999,0,9999,0
1713305173230,MATH 197,001,523477,Kedlaya; Kiran S.,9999,0,9999,0
1713305173230,MATH 197,002,563811,Zhang; Danna,9999,0,9999,0
1713305174255,MCWP 40R,A00,518780,Staff,20,0,20,0
1713305174255,MCWP 40R,B00,518781,Staff,20,0,20,0
1713305174255,MCWP 40R,C00,518783,Staff,19,0,20,1
1713305175280,MCWP 50R,A00,518791,Staff,20,0,20,0
1713305175280,MCWP 50R,B00,518792,Staff,20,0,20,0
1713305175280,MCWP 50R,C00,518793,Staff,19,0,20,1
1713305175280,MCWP 50R,D00,518794,Staff,18,0,20,2
1713305175280,MCWP 50R,E00,518795,Staff,18,0,20,2
1713305175280,MCWP 50R,F00,518796,Staff,19,0,20,1
1713305175280,MCWP 50R,G00,518797,Staff,19,0,20,1
1713305176305,MMW 12R,A01,514034,Herbst; Matthew,16,0,16,0
1713305176305,MMW 12R,A02,514035,Herbst; Matthew,16,0,16,0
1713305177329,MMW 13R,A01,514037,Staff,15,0,16,1
1713305177329,MMW 13R,A02,514039,Staff,16,0,16,0
1713305178354,RMED 296,001,626776,Averbach; Sarah Helene,1,0,1,0
1713305179378,SIO 295LS,A00,523233,Staff,19,0,30,11
1713305180403,SIO 295S,A00,523232,Staff,19,0,30,11
1713305181429,SOCI 117,A01,494376,Staff,3,0,5,2
1713305182461,WES 237B,A00,494380,Staff,19,0,20,1
1713305184526,AESE 279B,A00,494370,Wade; Jon P,33,0,33,0
1713305185553,ANAR 135S,A00,494369,Braswell; Geoffrey E.,0,0,0,0
1713305186580,CAT 124RS,A01,519847,Geibel; William,17,0,20,3
1713305187609,CAT 125RS,A01,515971,Geibel; William,17,0,20,3
1713305188638,CLRE 250,A00,511389,Morris; Sheldon,9996,0,9999,3
1713305189662,CLRE 251,A00,507176,Mehta; Ravindra L.,9996,0,9999,3
1713305189662,CLRE 251,B00,511410,Mehta; Ravindra L.,9998,0,9999,1
1713305190688,CLRE 252,A00,507189,Cuomo; Raphael Eduardo,9998,0,9999,1
1713305191714,CLRE 253,A00,507199,Vaida; Florin,9997,0,9999,2
1713305191714,CLRE 253,B00,507202,Vaida; Florin,9999,0,9999,0
1713305192742,CLRE 259,A00,507211,Patel; Hemal,9996,0,9999,3
1713305193770,CLRE 260,A00,507221,Cuomo; Raphael Eduardo,9999,0,9999,0
1713305194796,CLRE 297,001,507242,Cuomo; Raphael Eduardo,9999,0,9999,0
1713305195827,CSE 191,A00,516875,Minnes Kemp; Mor Mia,9999,0,9999,0
1713305196851,CSS 201S,A01,494383,Staff,35,0,35,0
1713305197878,CSS 202S,A01,494387,Staff,35,0,35,0
1713305198905,EAP 100,A00,516065,Staff,9792,0,9999,207
1713305199934,ECE 45,A01,507414,Staff,56,0,60,4
1713305200964,ECE 100,A01,507416,Baghdadchi; Saharnaz,12,0,20,8
1713305200964,ECE 100,A02,507418,Baghdadchi; Saharnaz,20,0,20,0
1713305201989,ECE 111,A01,507420,Staff,40,0,50,10
1713305203017,ECE 197,001,548057,Sievenpiper; Daniel F.,9999,0,9999,0
1713305204044,EDS 115,A00,507243,Choi; Bailey Miyeon,28,0,28,0
1713305205077,EDS 117,A01,494379,Staff,25,0,25,0
1713305206103,EDS 125,A00,507246,Hopkins; Megan Beth,29,0,30,1
1713305207128,EDS 128A,A01,507264,Fargason; Sharon Gayle,26,0,26,0
1713305208157,EDS 128B,A01,507293,Pappas; Elizabeth,30,0,30,0
1713305209185,EDS 139,A00,507294,Fargason; Sharon Gayle,30,0,30,0
1713305209185,EDS 139,B00,507313,Pappas; Elizabeth,30,0,30,0
1713305210211,EDS 201,A00,507315,Staff,26,0,30,4
1713305211241,EDS 203,A01,507317,Halter; Christopher P.,26,0,30,4
1713305212266,EDS 204R,A01,507319,Halter; Christopher P.,6,0,30,24
1713305212266,EDS 204R,B01,507331,Heinzman; Erica M.,30,0,30,0
1713305213298,EDS 206R,A00,507332,Staff,8,0,30,22
1713305213298,EDS 206R,B00,507343,Staff,29,0,30,1
1713305214321,EDS 250,A00,507344,Hemans; Patricia Ann Benitez,36,0,40,4
1713305215349,EDS 281,A00,507345,Daly; Alan J.,18,0,18,0
1713305216376,EDS 284,A00,507350,Daly; Alan J.,16,0,16,0
1713305217401,EDS 286,A00,507359,Fine; Sarah,18,0,18,0
1713305218429,EDS 289C,A01,507361,Daly; Alan J.,18,0,18,0
1713305219459,EDS 290,A00,507366,Hofstetter; Carolyn,15,0,15,0
1713305220492,LIGM 5A,A00,507421,Fischer-Grunski; Eva K,20,0,20,0
1713305221516,LIGM 5B,A00,507423,Fischer-Grunski; Eva K,20,0,20,0
1713305222543,LIGM 5C,A00,507425,Fischer-Grunski; Eva K,20,0,20,0
1713305223569,LIIT 5AS,A00,507427,Carnelos; Chiara,20,0,20,0
1713305224598,LIIT 5BS,A00,507430,Carnelos; Chiara,20,0,20,0
1713305225622,LIIT 5CS,A00,507432,Carnelos; Chiara,20,0,20,0
1713305226652,LISP 5A,A00,507541,Munoz Sanchez; Alicia,19,0,20,1
1713305227684,LISP 5B,A00,507671,Munoz Sanchez; Alicia,17,0,20,3
1713305228712,LISP 5C,A00,507696,Munoz Sanchez; Alicia,17,0,20,3
1713305229742,MAE 197,001,528363,Boechler; Nicholas Sebastia,9999,0,9999,0
1713305230774,MATH 197,001,523477,Kedlaya; Kiran S.,9999,0,9999,0
1713305230774,MATH 197,002,563811,Zhang; Danna,9999,0,9999,0
1713305231799,MCWP 40R,A00,518780,Staff,20,0,20,0
1713305231799,MCWP 40R,B00,518781,Staff,20,0,20,0
1713305231799,MCWP 40R,C00,518783,Staff,19,0,20,1
1713305232825,MCWP 50R,A00,518791,Staff,20,0,20,0
1713305232825,MCWP 50R,B00,518792,Staff,20,0,20,0
1713305232825,MCWP 50R,C00,518793,Staff,19,0,20,1
1713305232825,MCWP 50R,D00,518794,Staff,18,0,20,2
1713305232825,MCWP 50R,E00,518795,Staff,18,0,20,2
1713305232825,MCWP 50R,F00,518796,Staff,19,0,20,1
1713305232825,MCWP 50R,G00,518797,Staff,19,0,20,1
1713305233856,MMW 12R,A01,514034,Herbst; Matthew,16,0,16,0
1713305233856,MMW 12R,A02,514035,Herbst; Matthew,16,0,16,0
1713305234883,MMW 13R,A01,514037,Staff,15,0,16,1
1713305234883,MMW 13R,A02,514039,Staff,16,0,16,0
1713305235909,RMED 296,001,626776,Averbach; Sarah Helene,1,0,1,0
1713305236939,SIO 295LS,A00,523233,Staff,19,0,30,11
1713305237965,SIO 295S,A00,523232,Staff,19,0,30,11
1713305238994,SOCI 117,A01,494376,Staff,3,0,5,2
1713305240018,WES 237B,A00,494380,Staff,19,0,20,1
1713305242167,AESE 279B,A00,494370,Wade; Jon P,33,0,33,0
1713305243192,ANAR 135S,A00,494369,Braswell; Geoffrey E.,0,0,0,0
1713305244228,CAT 124RS,A01,519847,Geibel; William,17,0,20,3
1713305245253,CAT 125RS,A01,515971,Geibel; William,17,0,20,3
1713305246277,CLRE 250,A00,511389,Morris; Sheldon,9996,0,9999,3
1713305247309,CLRE 251,A00,507176,Mehta; Ravindra L.,9996,0,9999,3
1713305247309,CLRE 251,B00,511410,Mehta; Ravindra L.,9998,0,9999,1
1713305248388,CLRE 252,A00,507189,Cuomo; Raphael Eduardo,9998,0,9999,1
1713305249418,CLRE 253,A00,507199,Vaida; Florin,9997,0,9999,2
1713305249418,CLRE 253,B00,507202,Vaida; Florin,9999,0,9999,0
1713305250443,CLRE 259,A00,507211,Patel; Hemal,9996,0,9999,3
1713305251469,CLRE 260,A00,507221,Cuomo; Raphael Eduardo,9999,0,9999,0
1713305252499,CLRE 297,001,507242,Cuomo; Raphael Eduardo,9999,0,9999,0
1713305253523,CSE 191,A00,516875,Minnes Kemp; Mor Mia,9999,0,9999,0
1713305254555,CSS 201S,A01,494383,Staff,35,0,35,0
1713305255579,CSS 202S,A01,494387,Staff,35,0,35,0
1713305256604,EAP 100,A00,516065,Staff,9792,0,9999,207
1713305257632,ECE 45,A01,507414,Staff,56,0,60,4
1713305258658,ECE 100,A01,507416,Baghdadchi; Saharnaz,12,0,20,8
1713305258658,ECE 100,A02,507418,Baghdadchi; Saharnaz,20,0,20,0
1713305259683,ECE 111,A01,507420,Staff,40,0,50,10
1713305260709,ECE 197,001,548057,Sievenpiper; Daniel F.,9999,0,9999,0
1713305261736,EDS 115,A00,507243,Choi; Bailey Miyeon,28,0,28,0
1713305262764,EDS 117,A01,494379,Staff,25,0,25,0
1713305263788,EDS 125,A00,507246,Hopkins; Megan Beth,29,0,30,1
1713305264817,EDS 128A,A01,507264,Fargason; Sharon Gayle,26,0,26,0
1713305265848,EDS 128B,A01,507293,Pappas; Elizabeth,30,0,30,0
1713305266873,EDS 139,A00,507294,Fargason; Sharon Gayle,30,0,30,0
1713305266873,EDS 139,B00,507313,Pappas; Elizabeth,30,0,30,0
1713305267900,EDS 201,A00,507315,Staff,26,0,30,4
1713305268925,EDS 203,A01,507317,Halter; Christopher P.,26,0,30,4
1713305269954,EDS 204R,A01,507319,Halter; Christopher P.,6,0,30,24
1713305269954,EDS 204R,B01,507331,Heinzman; Erica M.,30,0,30,0
1713305270983,EDS 206R,A00,507332,Staff,8,0,30,22
1713305270983,EDS 206R,B00,507343,Staff,29,0,30,1
1713305272008,EDS 250,A00,507344,Hemans; Patricia Ann Benitez,36,0,40,4
1713305273033,EDS 281,A00,507345,Daly; Alan J.,18,0,18,0
1713305274060,EDS 284,A00,507350,Daly; Alan J.,16,0,16,0
1713305275085,EDS 286,A00,507359,Fine; Sarah,18,0,18,0
1713305276112,EDS 289C,A01,507361,Daly; Alan J.,18,0,18,0
1713305277138,EDS 290,A00,507366,Hofstetter; Carolyn,15,0,15,0
1713305278163,LIGM 5A,A00,507421,Fischer-Grunski; Eva K,20,0,20,0
1713305279188,LIGM 5B,A00,507423,Fischer-Grunski; Eva K,20,0,20,0
1713305280217,LIGM 5C,A00,507425,Fischer-Grunski; Eva K,20,0,20,0
1713305281243,LIIT 5AS,A00,507427,Carnelos; Chiara,20,0,20,0
1713305282268,LIIT 5BS,A00,507430,Carnelos; Chiara,20,0,20,0
1713305283293,LIIT 5CS,A00,507432,Carnelos; Chiara,20,0,20,0
1713305284322,LISP 5A,A00,507541,Munoz Sanchez; Alicia,19,0,20,1
1713305285347,LISP 5B,A00,507671,Munoz Sanchez; Alicia,17,0,20,3
1713305286374,LISP 5C,A00,507696,Munoz Sanchez; Alicia,17,0,20,3
1713305287402,MAE 197,001,528363,Boechler; Nicholas Sebastia,9999,0,9999,0
1713305288426,MATH 197,001,523477,Kedlaya; Kiran S.,9999,0,9999,0
1713305288426,MATH 197,002,563811,Zhang; Danna,9999,0,9999,0
1713305301163,MCWP 40R,A00,518780,Staff,20,0,20,0
1713305301163,MCWP 40R,B00,518781,Staff,20,0,20,0
1713305301163,MCWP 40R,C00,518783,Staff,19,0,20,1
1713305302190,MCWP 50R,A00,518791,Staff,20,0,20,0
1713305302190,MCWP 50R,B00,518792,Staff,20,0,20,0
1713305302190,MCWP 50R,C00,518793,Staff,19,0,20,1
1713305302190,MCWP 50R,D00,518794,Staff,18,0,20,2
1713305302190,MCWP 50R,E00,518795,Staff,18,0,20,2
1713305302190,MCWP 50R,F00,518796,Staff,19,0,20,1
1713305302190,MCWP 50R,G00,518797,Staff,19,0,20,1
1713305303215,MMW 12R,A01,514034,Herbst; Matthew,16,0,16,0
1713305303215,MMW 12R,A02,514035,Herbst; Matthew,16,0,16,0
1713305304242,MMW 13R,A01,514037,Staff,15,0,16,1
1713305304242,MMW 13R,A02,514039,Staff,16,0,16,0
1713305305267,RMED 296,001,626776,Averbach; Sarah Helene,1,0,1,0
1713305306301,SIO 295LS,A00,523233,Staff,19,0,30,11
1713305307324,SIO 295S,A00,523232,Staff,19,0,30,11
1713305308352,SOCI 117,A01,494376,Staff,3,0,5,2
1713305309378,WES 237B,A00,494380,Staff,19,0,20,1
1713305311459,AESE 279B,A00,494370,Wade; Jon P,33,0,33,0
1713305312482,ANAR 135S,A00,494369,Braswell; Geoffrey E.,0,0,0,0
1713305313506,CAT 124RS,A01,519847,Geibel; William,17,0,20,3
1713305314534,CAT 125RS,A01,515971,Geibel; William,17,0,20,3
1713305315564,CLRE 250,A00,511389,Morris; Sheldon,9996,0,9999,3
1713305316589,CLRE 251,A00,507176,Mehta; Ravindra L.,9996,0,9999,3
1713305316589,CLRE 251,B00,511410,Mehta; Ravindra L.,9998,0,9999,1
1713305317618,CLRE 252,A00,507189,Cuomo; Raphael Eduardo,9998,0,9999,1
1713305318644,CLRE 253,A00,507199,Vaida; Florin,9997,0,9999,2
1713305318644,CLRE 253,B00,507202,Vaida; Florin,9999,0,9999,0
1713305319669,CLRE 259,A00,507211,Patel; Hemal,9996,0,9999,3
1713305320695,CLRE 260,A00,507221,Cuomo; Raphael Eduardo,9999,0,9999,0
1713305321719,CLRE 297,001,507242,Cuomo; Raphael Eduardo,9999,0,9999,0
1713305322742,CSE 191,A00,516875,Minnes Kemp; Mor Mia,9999,0,9999,0
1713305323767,CSS 201S,A01,494383,Staff,35,0,35,0
1713305324793,CSS 202S,A01,494387,Staff,35,0,35,0
1713305325819,EAP 100,A00,516065,Staff,9792,0,9999,207
1713305326844,ECE 45,A01,507414,Staff,56,0,60,4
1713305327871,ECE 100,A01,507416,Baghdadchi; Saharnaz,12,0,20,8
1713305327871,ECE 100,A02,507418,Baghdadchi; Saharnaz,20,0,20,0
1713305328899,ECE 111,A01,507420,Staff,40,0,50,10
1713305329924,ECE 197,001,548057,Sievenpiper; Daniel F.,9999,0,9999,0
1713305330949,EDS 115,A00,507243,Choi; Bailey Miyeon,28,0,28,0
1713305331976,EDS 117,A01,494379,Staff,25,0,25,0
1713305333003,EDS 125,A00,507246,Hopkins; Megan Beth,29,0,30,1
1713305334031,EDS 128A,A01,507264,Fargason; Sharon Gayle,26,0,26,0
1713305335058,EDS 128B,A01,507293,Pappas; Elizabeth,30,0,30,0
1713305336083,EDS 139,A00,507294,Fargason; Sharon Gayle,30,0,30,0
1713305336083,EDS 139,B00,507313,Pappas; Elizabeth,30,0,30,0
1713305337110,EDS 201,A00,507315,Staff,26,0,30,4
1713305338142,EDS 203,A01,507317,Halter; Christopher P.,26,0,30,4
1713305339166,EDS 204R,A01,507319,Halter; Christopher P.,6,0,30,24
1713305339166,EDS 204R,B01,507331,Heinzman; Erica M.,30,0,30,0
1713305340191,EDS 206R,A00,507332,Staff,8,0,30,22
1713305340191,EDS 206R,B00,507343,Staff,29,0,30,1
1713305341215,EDS 250,A00,507344,Hemans; Patricia Ann Benitez,36,0,40,4
1713305342247,EDS 281,A00,507345,Daly; Alan J.,18,0,18,0
1713305343276,EDS 284,A00,507350,Daly; Alan J.,16,0,16,0
1713305344301,EDS 286,A00,507359,Fine; Sarah,18,0,18,0
1713305345329,EDS 289C,A01,507361,Daly; Alan J.,18,0,18,0
1713305346357,EDS 290,A00,507366,Hofstetter; Carolyn,15,0,15,0
1713305347388,LIGM 5A,A00,507421,Fischer-Grunski; Eva K,20,0,20,0
1713305348419,LIGM 5B,A00,507423,Fischer-Grunski; Eva K,20,0,20,0
1713305349449,LIGM 5C,A00,507425,Fischer-Grunski; Eva K,20,0,20,0
1713305350479,LIIT 5AS,A00,507427,Carnelos; Chiara,20,0,20,0
1713305351507,LIIT 5BS,A00,507430,Carnelos; Chiara,20,0,20,0
1713305352537,LIIT 5CS,A00,507432,Carnelos; Chiara,20,0,20,0
1713305353569,LISP 5A,A00,507541,Munoz Sanchez; Alicia,19,0,20,1
1713305354599,LISP 5B,A00,507671,Munoz Sanchez; Alicia,17,0,20,3
1713305355625,LISP 5C,A00,507696,Munoz Sanchez; Alicia,17,0,20,3
1713305356653,MAE 197,001,528363,Boechler; Nicholas Sebastia,9999,0,9999,0
1713305357681,MATH 197,001,523477,Kedlaya; Kiran S.,9999,0,9999,0
1713305357681,MATH 197,002,563811,Zhang; Danna,9999,0,9999,0
1713305358710,MCWP 40R,A00,518780,Staff,20,0,20,0
1713305358710,MCWP 40R,B00,518781,Staff,20,0,20,0
1713305358710,MCWP 40R,C00,518783,Staff,19,0,20,1
1713305359737,MCWP 50R,A00,518791,Staff,20,0,20,0
1713305359737,MCWP 50R,B00,518792,Staff,20,0,20,0
1713305359737,MCWP 50R,C00,518793,Staff,19,0,20,1
1713305359737,MCWP 50R,D00,518794,Staff,18,0,20,2
1713305359737,MCWP 50R,E00,518795,Staff,18,0,20,2
1713305359737,MCWP 50R,F00,518796,Staff,19,0,20,1
1713305359737,MCWP 50R,G00,518797,Staff,19,0,20,1
1713305360763,MMW 12R,A01,514034,Herbst; Matthew,16,0,16,0
1713305360763,MMW 12R,A02,514035,Herbst; Matthew,16,0,16,0
1713305361790,MMW 13R,A01,514037,Staff,15,0,16,1
1713305361790,MMW 13R,A02,514039,Staff,16,0,16,0
1713305362815,RMED 296,001,626776,Averbach; Sarah Helene,1,0,1,0
1713305363911,SIO 295LS,A00,523233,Staff,19,0,30,11
1713305364940,SIO 295S,A00,523232,Staff,19,0,30,11
1713305365967,SOCI 117,A01,494376,Staff,3,0,5,2
1713305366991,WES 237B,A00,494380,Staff,19,0,20,1
1713305369060,AESE 279B,A00,494370,Wade; Jon P,33,0,33,0
1713305370087,ANAR 135S,A00,494369,Braswell; Geoffrey E.,0,0,0,0
1713305371114,CAT 124RS,A01,519847,Geibel; William,17,0,20,3
1713305372140,CAT 125RS,A01,515971,Geibel; William,17,0,20,3
1713305373169,CLRE 250,A00,511389,Morris; Sheldon,9996,0,9999,3
1713305374201,CLRE 251,A00,507176,Mehta; Ravindra L.,9996,0,9999,3
1713305374201,CLRE 251,B00,511410,Mehta; Ravindra L.,9998,0,9999,1
1713305375224,CLRE 252,A00,507189,Cuomo; Raphael Eduardo,9998,0,9999,1
1713305376249,CLRE 253,A00,507199,Vaida; Florin,9997,0,9999,2
1713305376249,CLRE 253,B00,507202,Vaida; Florin,9999,0,9999,0
1713305377273,CLRE 259,A00,507211,Patel; Hemal,9996,0,9999,3
1713305378298,CLRE 260,A00,507221,Cuomo; Raphael Eduardo,9999,0,9999,0
1713305379322,CLRE 297,001,507242,Cuomo; Raphael Eduardo,9999,0,9999,0
1713305380347,CSE 191,A00,516875,Minnes Kemp; Mor Mia,9999,0,9999,0
1713305381372,CSS 201S,A01,494383,Staff,35,0,35,0
1713305382400,CSS 202S,A01,494387,Staff,35,0,35,0
1713305383424,EAP 100,A00,516065,Staff,9792,0,9999,207
1713305384449,ECE 45,A01,507414,Staff,56,0,60,4
1713305385476,ECE 100,A01,507416,Baghdadchi; Saharnaz,12,0,20,8
1713305385476,ECE 100,A02,507418,Baghdadchi; Saharnaz,20,0,20,0
1713305386501,ECE 111,A01,507420,Staff,40,0,50,10
1713305387530,ECE 197,001,548057,Sievenpiper; Daniel F.,9999,0,9999,0
1713305388557,EDS 115,A00,507243,Choi; Bailey Miyeon,28,0,28,0
1713305389584,EDS 117,A01,494379,Staff,25,0,25,0
1713305390609,EDS 125,A00,507246,Hopkins; Megan Beth,29,0,30,1
1713305391640,EDS 128A,A01,507264,Fargason; Sharon Gayle,26,0,26,0
1713305392670,EDS 128B,A01,507293,Pappas; Elizabeth,30,0,30,0
1713305393695,EDS 139,A00,507294,Fargason; Sharon Gayle,30,0,30,0
1713305393695,EDS 139,B00,507313,Pappas; Elizabeth,30,0,30,0
1713305394721,EDS 201,A00,507315,Staff,26,0,30,4
1713305395750,EDS 203,A01,507317,Halter; Christopher P.,26,0,30,4
1713305396780,EDS 204R,A01,507319,Halter; Christopher P.,6,0,30,24
1713305396780,EDS 204R,B01,507331,Heinzman; Erica M.,30,0,30,0
1713305397804,EDS 206R,A00,507332,Staff,8,0,30,22
1713305397804,EDS 206R,B00,507343,Staff,29,0,30,1
1713305398834,EDS 250,A00,507344,Hemans; Patricia Ann Benitez,36,0,40,4
1713305399860,EDS 281,A00,507345,Daly; Alan J.,18,0,18,0
1713305400885,EDS 284,A00,507350,Daly; Alan J.,16,0,16,0
1713305401910,EDS 286,A00,507359,Fine; Sarah,18,0,18,0
1713305402936,EDS 289C,A01,507361,Daly; Alan J.,18,0,18,0
1713305403963,EDS 290,A00,507366,Hofstetter; Carolyn,15,0,15,0
1713305404988,LIGM 5A,A00,507421,Fischer-Grunski; Eva K,20,0,20,0
1713305406013,LIGM 5B,A00,507423,Fischer-Grunski; Eva K,20,0,20,0
1713305407041,LIGM 5C,A00,507425,Fischer-Grunski; Eva K,20,0,20,0
1713305408072,LIIT 5AS,A00,507427,Carnelos; Chiara,20,0,20,0
1713305409099,LIIT 5BS,A00,507430,Carnelos; Chiara,20,0,20,0
1713305410129,LIIT 5CS,A00,507432,Carnelos; Chiara,20,0,20,0
1713305411165,LISP 5A,A00,507541,Munoz Sanchez; Alicia,19,0,20,1
1713305412192,LISP 5B,A00,507671,Munoz Sanchez; Alicia,17,0,20,3
1713305413222,LISP 5C,A00,507696,Munoz Sanchez; Alicia,17,0,20,3
1713305414249,MAE 197,001,528363,Boechler; Nicholas Sebastia,9999,0,9999,0
1713305415281,MATH 197,001,523477,Kedlaya; Kiran S.,9999,0,9999,0
1713305415281,MATH 197,002,563811,Zhang; Danna,9999,0,9999,0
1713305416309,MCWP 40R,A00,518780,Staff,20,0,20,0
1713305416309,MCWP 40R,B00,518781,Staff,20,0,20,0
1713305416309,MCWP 40R,C00,518783,Staff,19,0,20,1
1713305417346,MCWP 50R,A00,518791,Staff,20,0,20,0
1713305417346,MCWP 50R,B00,518792,Staff,20,0,20,0
1713305417346,MCWP 50R,C00,518793,Staff,19,0,20,1
1713305417346,MCWP 50R,D00,518794,Staff,18,0,20,2
1713305417346,MCWP 50R,E00,518795,Staff,18,0,20,2
1713305417346,MCWP 50R,F00,518796,Staff,19,0,20,1
1713305417346,MCWP 50R,G00,518797,Staff,19,0,20,1
1713305418373,MMW 12R,A01,514034,Herbst; Matthew,16,0,16,0
1713305418373,MMW 12R,A02,514035,Herbst; Matthew,16,0,16,0
1713305419397,MMW 13R,A01,514037,Staff,15,0,16,1
1713305419397,MMW 13R,A02,514039,Staff,16,0,16,0
1713305420421,RMED 296,001,626776,Averbach; Sarah Helene,1,0,1,0
1713305421445,SIO 295LS,A00,523233,Staff,19,0,30,11
1713305422471,SIO 295S,A00,523232,Staff,19,0,30,11
1713305423495,SOCI 117,A01,494376,Staff,3,0,5,2
1713305424519,WES 237B,A00,494380,Staff,19,0,20,1
1713305426589,AESE 279B,A00,494370,Wade; Jon P,33,0,33,0
1713305427624,ANAR 135S,A00,494369,Braswell; Geoffrey E.,0,0,0,0
1713305428652,CAT 124RS,A01,519847,Geibel; William,17,0,20,3
1713305429680,CAT 125RS,A01,515971,Geibel; William,17,0,20,3
1713305430708,CLRE 250,A00,511389,Morris; Sheldon,9996,0,9999,3
1713305431743,CLRE 251,A00,507176,Mehta; Ravindra L.,9996,0,9999,3
1713305431743,CLRE 251,B00,511410,Mehta; Ravindra L.,9998,0,9999,1
1713305432773,CLRE 252,A00,507189,Cuomo; Raphael Eduardo,9998,0,9999,1
1713305433805,CLRE 253,A00,507199,Vaida; Florin,9997,0,9999,2
1713305433805,CLRE 253,B00,507202,Vaida; Florin,9999,0,9999,0
1713305434830,CLRE 259,A00,507211,Patel; Hemal,9996,0,9999,3
1713305435858,CLRE 260,A00,507221,Cuomo; Raphael Eduardo,9999,0,9999,0
1713305436883,CLRE 297,001,507242,Cuomo; Raphael Eduardo,9999,0,9999,0
1713305437917,CSE 191,A00,516875,Minnes Kemp; Mor Mia,9999,0,9999,0
1713305438947,CSS 201S,A01,494383,Staff,35,0,35,0
1713305439972,CSS 202S,A01,494387,Staff,35,0,35,0
1713305440997,EAP 100,A00,516065,Staff,9792,0,9999,207
1713305442024,ECE 45,A01,507414,Staff,56,0,60,4
1713305443050,ECE 100,A01,507416,Baghdadchi; Saharnaz,12,0,20,8
1713305443050,ECE 100,A02,507418,Baghdadchi; Saharnaz,20,0,20,0
1713305444081,ECE 111,A01,507420,Staff,40,0,50,10
1713305445105,ECE 197,001,548057,Sievenpiper; Daniel F.,9999,0,9999,0
1713305446130,EDS 115,A00,507243,Choi; Bailey Miyeon,28,0,28,0
1713305447155,EDS 117,A01,494379,Staff,25,0,25,0
1713305448184,EDS 125,A00,507246,Hopkins; Megan Beth,29,0,30,1
1713305449209,EDS 128A,A01,507264,Fargason; Sharon Gayle,26,0,26,0
1713305450234,EDS 128B,A01,507293,Pappas; Elizabeth,30,0,30,0
1713305451259,EDS 139,A00,507294,Fargason; Sharon Gayle,30,0,30,0
1713305451259,EDS 139,B00,507313,Pappas; Elizabeth,30,0,30,0
1713305452284,EDS 201,A00,507315,Staff,26,0,30,4
1713305453309,EDS 203,A01,507317,Halter; Christopher P.,26,0,30,4
1713305454333,EDS 204R,A01,507319,Halter; Christopher P.,6,0,30,24
1713305454333,EDS 204R,B01,507331,Heinzman; Erica M.,30,0,30,0
1713305455360,EDS 206R,A00,507332,Staff,8,0,30,22
1713305455360,EDS 206R,B00,507343,Staff,29,0,30,1
1713305456387,EDS 250,A00,507344,Hemans; Patricia Ann Benitez,36,0,40,4
1713305457416,EDS 281,A00,507345,Daly; Alan J.,18,0,18,0
1713305458443,EDS 284,A00,507350,Daly; Alan J.,16,0,16,0
1713305459468,EDS 286,A00,507359,Fine; Sarah,18,0,18,0
1713305460493,EDS 289C,A01,507361,Daly; Alan J.,18,0,18,0
1713305461520,EDS 290,A00,507366,Hofstetter; Carolyn,15,0,15,0
1713305462547,LIGM 5A,A00,507421,Fischer-Grunski; Eva K,20,0,20,0
1713305463573,LIGM 5B,A00,507423,Fischer-Grunski; Eva K,20,0,20,0
1713305464597,LIGM 5C,A00,507425,Fischer-Grunski; Eva K,20,0,20,0
1713305465627,LIIT 5AS,A00,507427,Carnelos; Chiara,20,0,20,0
1713305466653,LIIT 5BS,A00,507430,Carnelos; Chiara,20,0,20,0
1713305467732,LIIT 5CS,A00,507432,Carnelos; Chiara,20,0,20,0
1713305468758,LISP 5A,A00,507541,Munoz Sanchez; Alicia,19,0,20,1
1713305469783,LISP 5B,A00,507671,Munoz Sanchez; Alicia,17,0,20,3
1713305470820,LISP 5C,A00,507696,Munoz Sanchez; Alicia,17,0,20,3
1713305471844,MAE 197,001,528363,Boechler; Nicholas Sebastia,9999,0,9999,0
1713305472870,MATH 197,001,523477,Kedlaya; Kiran S.,9999,0,9999,0
1713305472870,MATH 197,002,563811,Zhang; Danna,9999,0,9999,0
1713305473903,MCWP 40R,A00,518780,Staff,20,0,20,0
1713305473903,MCWP 40R,B00,518781,Staff,20,0,20,0
1713305473903,MCWP 40R,C00,518783,Staff,19,0,20,1
1713305474930,MCWP 50R,A00,518791,Staff,20,0,20,0
1713305474930,MCWP 50R,B00,518792,Staff,20,0,20,0
1713305474930,MCWP 50R,C00,518793,Staff,19,0,20,1
1713305474930,MCWP 50R,D00,518794,Staff,18,0,20,2
1713305474930,MCWP 50R,E00,518795,Staff,18,0,20,2
1713305474930,MCWP 50R,F00,518796,Staff,19,0,20,1
1713305474930,MCWP 50R,G00,518797,Staff,19,0,20,1
1713305475957,MMW 12R,A01,514034,Herbst; Matthew,16,0,16,0
1713305475957,MMW 12R,A02,514035,Herbst; Matthew,16,0,16,0
1713305476982,MMW 13R,A01,514037,Staff,15,0,16,1
1713305476982,MMW 13R,A02,514039,Staff,16,0,16,0
1713305478007,RMED 296,001,626776,Averbach; Sarah Helene,1,0,1,0
1713305479035,SIO 295LS,A00,523233,Staff,19,0,30,11
1713305480059,SIO 295S,A00,523232,Staff,19,0,30,11
1713305481095,SOCI 117,A01,494376,Staff,3,0,5,2
1713305482120,WES 237B,A00,494380,Staff,19,0,20,1
1713305484197,AESE 279B,A00,494370,Wade; Jon P,33,0,33,0
1713305485226,ANAR 135S,A00,494369,Braswell; Geoffrey E.,0,0,0,0
1713305486253,CAT 124RS,A01,519847,Geibel; William,17,0,20,3
1713305487276,CAT 125RS,A01,515971,Geibel; William,17,0,20,3
1713305488305,CLRE 250,A00,511389,Morris; Sheldon,9996,0,9999,3
1713305489331,CLRE 251,A00,507176,Mehta; Ravindra L.,9996,0,9999,3
1713305489331,CLRE 251,B00,511410,Mehta; Ravindra L.,9998,0,9999,1
1713305490360,CLRE 252,A00,507189,Cuomo; Raphael Eduardo,9998,0,9999,1
1713305491391,CLRE 253,A00,507199,Vaida; Florin,9997,0,9999,2
1713305491391,CLRE 253,B00,507202,Vaida; Florin,9999,0,9999,0
1713305492420,CLRE 259,A00,507211,Patel; Hemal,9996,0,9999,3
1713305493445,CLRE 260,A00,507221,Cuomo; Raphael Eduardo,9999,0,9999,0
1713305494469,CLRE 297,001,507242,Cuomo; Raphael Eduardo,9999,0,9999,0
1713305495492,CSE 191,A00,516875,Minnes Kemp; Mor Mia,9999,0,9999,0
1713305496521,CSS 201S,A01,494383,Staff,35,0,35,0
1713305497551,CSS 202S,A01,494387,Staff,35,0,35,0
1713305498634,EAP 100,A00,516065,Staff,9792,0,9999,207
1713305499669,ECE 45,A01,507414,Staff,56,0,60,4
1713305500697,ECE 100,A01,507416,Baghdadchi; Saharnaz,12,0,20,8
1713305500697,ECE 100,A02,507418,Baghdadchi; Saharnaz,20,0,20,0
1713305501722,ECE 111,A01,507420,Staff,40,0,50,10
1713305502749,ECE 197,001,548057,Sievenpiper; Daniel F.,9999,0,9999,0
1713305503776,EDS 115,A00,507243,Choi; Bailey Miyeon,28,0,28,0
1713305504805,EDS 117,A01,494379,Staff,25,0,25,0
1713305505833,EDS 125,A00,507246,Hopkins; Megan Beth,29,0,30,1
1713305506860,EDS 128A,A01,507264,Fargason; Sharon Gayle,26,0,26,0
1713305507886,EDS 128B,A01,507293,Pappas; Elizabeth,30,0,30,0
1713305508912,EDS 139,A00,507294,Fargason; Sharon Gayle,30,0,30,0
1713305508912,EDS 139,B00,507313,Pappas; Elizabeth,30,0,30,0
1713305509940,EDS 201,A00,507315,Staff,26,0,30,4
1713305510969,EDS 203,A01,507317,Halter; Christopher P.,26,0,30,4
1713305511994,EDS 204R,A01,507319,Halter; Christopher P.,6,0,30,24
1713305511994,EDS 204R,B01,507331,Heinzman; Erica M.,30,0,30,0
1713305513023,EDS 206R,A00,507332,Staff,8,0,30,22
1713305513023,EDS 206R,B00,507343,Staff,29,0,30,1
1713305514055,EDS 250,A00,507344,Hemans; Patricia Ann Benitez,36,0,40,4
1713305515079,EDS 281,A00,507345,Daly; Alan J.,18,0,18,0
1713305516102,EDS 284,A00,507350,Daly; Alan J.,16,0,16,0
1713305517131,EDS 286,A00,507359,Fine; Sarah,18,0,18,0
1713305518158,EDS 289C,A01,507361,Daly; Alan J.,18,0,18,0
1713305519184,EDS 290,A00,507366,Hofstetter; Carolyn,15,0,15,0
1713305520212,LIGM 5A,A00,507421,Fischer-Grunski; Eva K,20,0,20,0
1713305521239,LIGM 5B,A00,507423,Fischer-Grunski; Eva K,20,0,20,0
1713305522264,LIGM 5C,A00,507425,Fischer-Grunski; Eva K,20,0,20,0
1713305523287,LIIT 5AS,A00,507427,Carnelos; Chiara,20,0,20,0
1713305524311,LIIT 5BS,A00,507430,Carnelos; Chiara,20,0,20,0
1713305525337,LIIT 5CS,A00,507432,Carnelos; Chiara,20,0,20,0
1713305526363,LISP 5A,A00,507541,Munoz Sanchez; Alicia,19,0,20,1
1713305527389,LISP 5B,A00,507671,Munoz Sanchez; Alicia,17,0,20,3
1713305528418,LISP 5C,A00,507696,Munoz Sanchez; Alicia,17,0,20,3
1713305529442,MAE 197,001,528363,Boechler; Nicholas Sebastia,9999,0,9999,0
1713305530470,MATH 197,001,523477,Kedlaya; Kiran S.,9999,0,9999,0
1713305530470,MATH 197,002,563811,Zhang; Danna,9999,0,9999,0
1713305531494,MCWP 40R,A00,518780,Staff,20,0,20,0
1713305531494,MCWP 40R,B00,518781,Staff,20,0,20,0
1713305531494,MCWP 40R,C00,518783,Staff,19,0,20,1
1713305532518,MCWP 50R,A00,518791,Staff,20,0,20,0
1713305532518,MCWP 50R,B00,518792,Staff,20,0,20,0
1713305532518,MCWP 50R,C00,518793,Staff,19,0,20,1
1713305532518,MCWP 50R,D00,518794,Staff,18,0,20,2
1713305532518,MCWP 50R,E00,518795,Staff,18,0,20,2
1713305532518,MCWP 50R,F00,518796,Staff,19,0,20,1
1713305532518,MCWP 50R,G00,518797,Staff,19,0,20,1
1713305533543,MMW 12R,A01,514034,Herbst; Matthew,16,0,16,0
1713305533543,MMW 12R,A02,514035,Herbst; Matthew,16,0,16,0
1713305534571,MMW 13R,A01,514037,Staff,15,0,16,1
1713305534571,MMW 13R,A02,514039,Staff,16,0,16,0
1713305535597,RMED 296,001,626776,Averbach; Sarah Helene,1,0,1,0
1713305536622,SIO 295LS,A00,523233,Staff,19,0,30,11
1713305537648,SIO 295S,A00,523232,Staff,19,0,30,11
1713305538674,SOCI 117,A01,494376,Staff,3,0,5,2
1713305539697,WES 237B,A00,494380,Staff,19,0,20,1
1713305541767,AESE 279B,A00,494370,Wade; Jon P,33,0,33,0
1713305542805,ANAR 135S,A00,494369,Braswell; Geoffrey E.,0,0,0,0
1713305543830,CAT 124RS,A01,519847,Geibel; William,17,0,20,3
1713305544858,CAT 125RS,A01,515971,Geibel; William,17,0,20,3
1713305545886,CLRE 250,A00,511389,Morris; Sheldon,9996,0,9999,3
1713305546915,CLRE 251,A00,507176,Mehta; Ravindra L.,9996,0,9999,3
1713305546915,CLRE 251,B00,511410,Mehta; Ravindra L.,9998,0,9999,1
1713305547943,CLRE 252,A00,507189,Cuomo; Raphael Eduardo,9998,0,9999,1
1713305548968,CLRE 253,A00,507199,Vaida; Florin,9997,0,9999,2
1713305548968,CLRE 253,B00,507202,Vaida; Florin,9999,0,9999,0
1713305549995,CLRE 259,A00,507211,Patel; Hemal,9996,0,9999,3
1713305551020,CLRE 260,A00,507221,Cuomo; Raphael Eduardo,9999,0,9999,0
1713305552046,CLRE 297,001,507242,Cuomo; Raphael Eduardo,9999,0,9999,0
1713305553073,CSE 191,A00,516875,Minnes Kemp; Mor Mia,9999,0,9999,0
1713305554107,CSS 201S,A01,494383,Staff,35,0,35,0
1713305555139,CSS 202S,A01,494387,Staff,35,0,35,0
1713305556166,EAP 100,A00,516065,Staff,9792,0,9999,207
1713305557192,ECE 45,A01,507414,Staff,56,0,60,4
1713305558217,ECE 100,A01,507416,Baghdadchi; Saharnaz,12,0,20,8
1713305558217,ECE 100,A02,507418,Baghdadchi; Saharnaz,20,0,20,0
1713305559245,ECE 111,A01,507420,Staff,40,0,50,10
1713305560275,ECE 197,001,548057,Sievenpiper; Daniel F.,9999,0,9999,0
1713305561301,EDS 115,A00,507243,Choi; Bailey Miyeon,28,0,28,0
1713305562329,EDS 117,A01,494379,Staff,25,0,25,0
1713305563354,EDS 125,A00,507246,Hopkins; Megan Beth,29,0,30,1
1713305564387,EDS 128A,A01,507264,Fargason; Sharon Gayle,26,0,26,0
1713305565413,EDS 128B,A01,507293,Pappas; Elizabeth,30,0,30,0
1713305566439,EDS 139,A00,507294,Fargason; Sharon Gayle,30,0,30,0
1713305566439,EDS 139,B00,507313,Pappas; Elizabeth,30,0,30,0
1713305567464,EDS 201,A00,507315,Staff,26,0,30,4
1713305568493,EDS 203,A01,507317,Halter; Christopher P.,26,0,30,4
1713305569522,EDS 204R,A01,507319,Halter; Christopher P.,6,0,30,24
1713305569522,EDS 204R,B01,507331,Heinzman; Erica M.,30,0,30,0
1713305570552,EDS 206R,A00,507332,Staff,8,0,30,22
1713305570552,EDS 206R,B00,507343,Staff,29,0,30,1
1713305571636,EDS 250,A00,507344,Hemans; Patricia Ann Benitez,36,0,40,4
1713305572665,EDS 281,A00,507345,Daly; Alan J.,18,0,18,0
1713305573693,EDS 284,A00,507350,Daly; Alan J.,16,0,16,0
1713305574723,EDS 286,A00,507359,Fine; Sarah,18,0,18,0
1713305575751,EDS 289C,A01,507361,Daly; Alan J.,18,0,18,0
1713305576780,EDS 290,A00,507366,Hofstetter; Carolyn,15,0,15,0
1713305577805,LIGM 5A,A00,507421,Fischer-Grunski; Eva K,20,0,20,0
1713305578831,LIGM 5B,A00,507423,Fischer-Grunski; Eva K,20,0,20,0
1713305579855,LIGM 5C,A00,507425,Fischer-Grunski; Eva K,20,0,20,0
1713305580886,LIIT 5AS,A00,507427,Carnelos; Chiara,20,0,20,0
1713305581913,LIIT 5BS,A00,507430,Carnelos; Chiara,20,0,20,0
1713305582938,LIIT 5CS,A00,507432,Carnelos; Chiara,20,0,20,0
1713305583965,LISP 5A,A00,507541,Munoz Sanchez; Alicia,19,0,20,1
1713305584993,LISP 5B,A00,507671,Munoz Sanchez; Alicia,17,0,20,3
1713305586018,LISP 5C,A00,507696,Munoz Sanchez; Alicia,17,0,20,3
1713305587046,MAE 197,001,528363,Boechler; Nicholas Sebastia,9999,0,9999,0
1713305588073,MATH 197,001,523477,Kedlaya; Kiran S.,9999,0,9999,0
1713305588073,MATH 197,002,563811,Zhang; Danna,9999,0,9999,0
1713305589099,MCWP 40R,A00,518780,Staff,20,0,20,0
1713305589099,MCWP 40R,B00,518781,Staff,20,0,20,0
1713305589099,MCWP 40R,C00,518783,Staff,19,0,20,1
1713305590130,MCWP 50R,A00,518791,Staff,20,0,20,0
1713305590130,MCWP 50R,B00,518792,Staff,20,0,20,0
1713305590130,MCWP 50R,C00,518793,Staff,19,0,20,1
1713305590130,MCWP 50R,D00,518794,Staff,18,0,20,2
1713305590130,MCWP 50R,E00,518795,Staff,18,0,20,2
1713305590130,MCWP 50R,F00,518796,Staff,19,0,20,1
1713305590130,MCWP 50R,G00,518797,Staff,19,0,20,1
1713305591156,MMW 12R,A01,514034,Herbst; Matthew,16,0,16,0
1713305591156,MMW 12R,A02,514035,Herbst; Matthew,16,0,16,0
1713305592183,MMW 13R,A01,514037,Staff,15,0,16,1
1713305592183,MMW 13R,A02,514039,Staff,16,0,16,0
1713305593210,RMED 296,001,626776,Averbach; Sarah Helene,1,0,1,0
1713305594240,SIO 295LS,A00,523233,Staff,19,0,30,11
1713305595265,SIO 295S,A00,523232,Staff,19,0,30,11
1713305596296,SOCI 117,A01,494376,Staff,3,0,5,2
1713305597320,WES 237B,A00,494380,Staff,19,0,20,1
1713305599402,AESE 279B,A00,494370,Wade; Jon P,33,0,33,0
1713305600428,ANAR 135S,A00,494369,Braswell; Geoffrey E.,0,0,0,0
1713305601453,CAT 124RS,A01,519847,Geibel; William,17,0,20,3
1713305602482,CAT 125RS,A01,515971,Geibel; William,17,0,20,3
1713305603508,CLRE 250,A00,511389,Morris; Sheldon,9996,0,9999,3
1713305604538,CLRE 251,A00,507176,Mehta; Ravindra L.,9996,0,9999,3
1713305604538,CLRE 251,B00,511410,Mehta; Ravindra L.,9998,0,9999,1
1713305605567,CLRE 252,A00,507189,Cuomo; Raphael Eduardo,9998,0,9999,1
1713305606593,CLRE 253,A00,507199,Vaida; Florin,9997,0,9999,2
1713305606593,CLRE 253,B00,507202,Vaida; Florin,9999,0,9999,0
1713305607619,CLRE 259,A00,507211,Patel; Hemal,9996,0,9999,3
1713305608644,CLRE 260,A00,507221,Cuomo; Raphael Eduardo,9999,0,9999,0
1713305609669,CLRE 297,001,507242,Cuomo; Raphael Eduardo,9999,0,9999,0
1713305610694,CSE 191,A00,516875,Minnes Kemp; Mor Mia,9999,0,9999,0
1713305611730,CSS 201S,A01,494383,Staff,35,0,35,0
1713305612755,CSS 202S,A01,494387,Staff,35,0,35,0
1713305613778,EAP 100,A00,516065,Staff,9792,0,9999,207
1713305614806,ECE 45,A01,507414,Staff,56,0,60,4
1713305615832,ECE 100,A01,507416,Baghdadchi; Saharnaz,12,0,20,8
1713305615832,ECE 100,A02,507418,Baghdadchi; Saharnaz,20,0,20,0
1713305616858,ECE 111,A01,507420,Staff,40,0,50,10
1713305617884,ECE 197,001,548057,Sievenpiper; Daniel F.,9999,0,9999,0
1713305618921,EDS 115,A00,507243,Choi; Bailey Miyeon,28,0,28,0
1713305619952,EDS 117,A01,494379,Staff,25,0,25,0
1713305620982,EDS 125,A00,507246,Hopkins; Megan Beth,29,0,30,1
1713305622015,EDS 128A,A01,507264,Fargason; Sharon Gayle,26,0,26,0
1713305623046,EDS 128B,A01,507293,Pappas; Elizabeth,30,0,30,0
1713305624076,EDS 139,A00,507294,Fargason; Sharon Gayle,30,0,30,0
1713305624076,EDS 139,B00,507313,Pappas; Elizabeth,30,0,30,0
1713305625101,EDS 201,A00,507315,Staff,26,0,30,4
1713305626133,EDS 203,A01,507317,Halter; Christopher P.,26,0,30,4
1713305627162,EDS 204R,A01,507319,Halter; Christopher P.,6,0,30,24
1713305627162,EDS 204R,B01,507331,Heinzman; Erica M.,30,0,30,0
1713305628194,EDS 206R,A00,507332,Staff,8,0,30,22
1713305628194,EDS 206R,B00,507343,Staff,29,0,30,1
1713305629226,EDS 250,A00,507344,Hemans; Patricia Ann Benitez,36,0,40,4
1713305630253,EDS 281,A00,507345,Daly; Alan J.,18,0,18,0
1713305631278,EDS 284,A00,507350,Daly; Alan J.,16,0,16,0
1713305632302,EDS 286,A00,507359,Fine; Sarah,18,0,18,0
1713305633327,EDS 289C,A01,507361,Daly; Alan J.,18,0,18,0
1713305634353,EDS 290,A00,507366,Hofstetter; Carolyn,15,0,15,0
1713305635378,LIGM 5A,A00,507421,Fischer-Grunski; Eva K,20,0,20,0
1713305636403,LIGM 5B,A00,507423,Fischer-Grunski; Eva K,20,0,20,0
1713305637432,LIGM 5C,A00,507425,Fischer-Grunski; Eva K,20,0,20,0
1713305638465,LIIT 5AS,A00,507427,Carnelos; Chiara,20,0,20,0
1713305639493,LIIT 5BS,A00,507430,Carnelos; Chiara,20,0,20,0
1713305640525,LIIT 5CS,A00,507432,Carnelos; Chiara,20,0,20,0
1713305641552,LISP 5A,A00,507541,Munoz Sanchez; Alicia,19,0,20,1
1713305642579,LISP 5B,A00,507671,Munoz Sanchez; Alicia,17,0,20,3
1713305643601,LISP 5C,A00,507696,Munoz Sanchez; Alicia,17,0,20,3
1713305644630,MAE 197,001,528363,Boechler; Nicholas Sebastia,9999,0,9999,0
1713305645661,MATH 197,001,523477,Kedlaya; Kiran S.,9999,0,9999,0
1713305645661,MATH 197,002,563811,Zhang; Danna,9999,0,9999,0
1713305646685,MCWP 40R,A00,518780,Staff,20,0,20,0
1713305646685,MCWP 40R,B00,518781,Staff,20,0,20,0
1713305646685,MCWP 40R,C00,518783,Staff,19,0,20,1
1713305647709,MCWP 50R,A00,518791,Staff,20,0,20,0
1713305647709,MCWP 50R,B00,518792,Staff,20,0,20,0
1713305647709,MCWP 50R,C00,518793,Staff,19,0,20,1
1713305647709,MCWP 50R,D00,518794,Staff,18,0,20,2
1713305647709,MCWP 50R,E00,518795,Staff,18,0,20,2
1713305647709,MCWP 50R,F00,518796,Staff,19,0,20,1
1713305647709,MCWP 50R,G00,518797,Staff,19,0,20,1
1713305648737,MMW 12R,A01,514034,Herbst; Matthew,16,0,16,0
1713305648737,MMW 12R,A02,514035,Herbst; Matthew,16,0,16,0
1713305649766,MMW 13R,A01,514037,Staff,15,0,16,1
1713305649766,MMW 13R,A02,514039,Staff,16,0,16,0
1713305650790,RMED 296,001,626776,Averbach; Sarah Helene,1,0,1,0
1713305651815,SIO 295LS,A00,523233,Staff,19,0,30,11
1713305652844,SIO 295S,A00,523232,Staff,19,0,30,11
1713305653869,SOCI 117,A01,494376,Staff,3,0,5,2
1713305654894,WES 237B,A00,494380,Staff,19,0,20,1
1713305656957,AESE 279B,A00,494370,Wade; Jon P,33,0,33,0
1713305657981,ANAR 135S,A00,494369,Braswell; Geoffrey E.,0,0,0,0
1713305659007,CAT 124RS,A01,519847,Geibel; William,17,0,20,3
1713305660032,CAT 125RS,A01,515971,Geibel; William,17,0,20,3
1713305661060,CLRE 250,A00,511389,Morris; Sheldon,9996,0,9999,3
1713305662085,CLRE 251,A00,507176,Mehta; Ravindra L.,9996,0,9999,3
1713305662085,CLRE 251,B00,511410,Mehta; Ravindra L.,9998,0,9999,1
1713305663113,CLRE 252,A00,507189,Cuomo; Raphael Eduardo,9998,0,9999,1
1713305664143,CLRE 253,A00,507199,Vaida; Florin,9997,0,9999,2
1713305664143,CLRE 253,B00,507202,Vaida; Florin,9999,0,9999,0
1713305665170,CLRE 259,A00,507211,Patel; Hemal,9996,0,9999,3
1713305666197,CLRE 260,A00,507221,Cuomo; Raphael Eduardo,9999,0,9999,0
1713305667222,CLRE 297,001,507242,Cuomo; Raphael Eduardo,9999,0,9999,0
1713305668252,CSE 191,A00,516875,Minnes Kemp; Mor Mia,9999,0,9999,0
1713305669281,CSS 201S,A01,494383,Staff,35,0,35,0
1713305670309,CSS 202S,A01,494387,Staff,35,0,35,0
1713305671334,EAP 100,A00,516065,Staff,9792,0,9999,207
1713305672361,ECE 45,A01,507414,Staff,56,0,60,4
1713305673384,ECE 100,A01,507416,Baghdadchi; Saharnaz,12,0,20,8
1713305673384,ECE 100,A02,507418,Baghdadchi; Saharnaz,20,0,20,0
1713305674412,ECE 111,A01,507420,Staff,40,0,50,10
1713305675493,ECE 197,001,548057,Sievenpiper; Daniel F.,9999,0,9999,0
1713305676523,EDS 115,A00,507243,Choi; Bailey Miyeon,28,0,28,0
1713305677582,EDS 117,A01,494379,Staff,25,0,25,0
1713305678608,EDS 125,A00,507246,Hopkins; Megan Beth,29,0,30,1
1713305679637,EDS 128A,A01,507264,Fargason; Sharon Gayle,26,0,26,0
1713305680666,EDS 128B,A01,507293,Pappas; Elizabeth,30,0,30,0
1713305681692,EDS 139,A00,507294,Fargason; Sharon Gayle,30,0,30,0
1713305681692,EDS 139,B00,507313,Pappas; Elizabeth,30,0,30,0
1713305682719,EDS 201,A00,507315,Staff,26,0,30,4
1713305683749,EDS 203,A01,507317,Halter; Christopher P.,26,0,30,4
1713305684778,EDS 204R,A01,507319,Halter; Christopher P.,6,0,30,24
1713305684778,EDS 204R,B01,507331,Heinzman; Erica M.,30,0,30,0
1713305685804,EDS 206R,A00,507332,Staff,8,0,30,22
1713305685804,EDS 206R,B00,507343,Staff,29,0,30,1
1713305686831,EDS 250,A00,507344,Hemans; Patricia Ann Benitez,36,0,40,4
1713305687864,EDS 281,A00,507345,Daly; Alan J.,18,0,18,0
1713305688893,EDS 284,A00,507350,Daly; Alan J.,16,0,16,0
1713305689918,EDS 286,A00,507359,Fine; Sarah,18,0,18,0
1713305690943,EDS 289C,A01,507361,Daly; Alan J.,18,0,18,0
1713305691974,EDS 290,A00,507366,Hofstetter; Carolyn,15,0,15,0
1713305693003,LIGM 5A,A00,507421,Fischer-Grunski; Eva K,20,0,20,0
1713305694031,LIGM 5B,A00,507423,Fischer-Grunski; Eva K,20,0,20,0
1713305695058,LIGM 5C,A00,507425,Fischer-Grunski; Eva K,20,0,20,0
1713305696091,LIIT 5AS,A00,507427,Carnelos; Chiara,20,0,20,0
1713305697115,LIIT 5BS,A00,507430,Carnelos; Chiara,20,0,20,0
1713305698140,LIIT 5CS,A00,507432,Carnelos; Chiara,20,0,20,0
1713305699166,LISP 5A,A00,507541,Munoz Sanchez; Alicia,19,0,20,1
1713305700200,LISP 5B,A00,507671,Munoz Sanchez; Alicia,17,0,20,3
1713305701224,LISP 5C,A00,507696,Munoz Sanchez; Alicia,17,0,20,3
1713305702250,MAE 197,001,528363,Boechler; Nicholas Sebastia,9999,0,9999,0
1713305703280,MATH 197,001,523477,Kedlaya; Kiran S.,9999,0,9999,0
1713305703280,MATH 197,002,563811,Zhang; Danna,9999,0,9999,0
1713305704308,MCWP 40R,A00,518780,Staff,20,0,20,0
1713305704308,MCWP 40R,B00,518781,Staff,20,0,20,0
1713305704308,MCWP 40R,C00,518783,Staff,19,0,20,1
1713305705337,MCWP 50R,A00,518791,Staff,20,0,20,0
1713305705337,MCWP 50R,B00,518792,Staff,20,0,20,0
1713305705337,MCWP 50R,C00,518793,Staff,19,0,20,1
1713305705337,MCWP 50R,D00,518794,Staff,18,0,20,2
1713305705337,MCWP 50R,E00,518795,Staff,18,0,20,2
1713305705337,MCWP 50R,F00,518796,Staff,19,0,20,1
1713305705337,MCWP 50R,G00,518797,Staff,19,0,20,1
1713305706361,MMW 12R,A01,514034,Herbst; Matthew,16,0,16,0
1713305706361,MMW 12R,A02,514035,Herbst; Matthew,16,0,16,0
1713305707388,MMW 13R,A01,514037,Staff,15,0,16,1
1713305707388,MMW 13R,A02,514039,Staff,16,0,16,0
1713305708420,RMED 296,001,626776,Averbach; Sarah Helene,1,0,1,0
1713305709447,SIO 295LS,A00,523233,Staff,19,0,30,11
1713305710472,SIO 295S,A00,523232,Staff,19,0,30,11
1713305711497,SOCI 117,A01,494376,Staff,3,0,5,2
1713305712521,WES 237B,A00,494380,Staff,19,0,20,1
1713305714600,AESE 279B,A00,494370,Wade; Jon P,33,0,33,0
1713305715628,ANAR 135S,A00,494369,Braswell; Geoffrey E.,0,0,0,0
1713305716653,CAT 124RS,A01,519847,Geibel; William,17,0,20,3
1713305717679,CAT 125RS,A01,515971,Geibel; William,17,0,20,3
1713305718705,CLRE 250,A00,511389,Morris; Sheldon,9996,0,9999,3
1713305719731,CLRE 251,A00,507176,Mehta; Ravindra L.,9996,0,9999,3
1713305719731,CLRE 251,B00,511410,Mehta; Ravindra L.,9998,0,9999,1
1713305720756,CLRE 252,A00,507189,Cuomo; Raphael Eduardo,9998,0,9999,1
1713305721827,CLRE 253,A00,507199,Vaida; Florin,9997,0,9999,2
1713305721827,CLRE 253,B00,507202,Vaida; Florin,9999,0,9999,0
1713305722855,CLRE 259,A00,507211,Patel; Hemal,9996,0,9999,3
1713305723892,CLRE 260,A00,507221,Cuomo; Raphael Eduardo,9999,0,9999,0
1713305724925,CLRE 297,001,507242,Cuomo; Raphael Eduardo,9999,0,9999,0
1713305725954,CSE 191,A00,516875,Minnes Kemp; Mor Mia,9999,0,9999,0
1713305726978,CSS 201S,A01,494383,Staff,35,0,35,0
1713305728003,CSS 202S,A01,494387,Staff,35,0,35,0
1713305729028,EAP 100,A00,516065,Staff,9792,0,9999,207
1713305730052,ECE 45,A01,507414,Staff,56,0,60,4
1713305731080,ECE 100,A01,507416,Baghdadchi; Saharnaz,12,0,20,8
1713305731080,ECE 100,A02,507418,Baghdadchi; Saharnaz,20,0,20,0
1713305732104,ECE 111,A01,507420,Staff,40,0,50,10
1713305733132,ECE 197,001,548057,Sievenpiper; Daniel F.,9999,0,9999,0
1713305734161,EDS 115,A00,507243,Choi; Bailey Miyeon,28,0,28,0
1713305735191,EDS 117,A01,494379,Staff,25,0,25,0
1713305736215,EDS 125,A00,507246,Hopkins; Megan Beth,29,0,30,1
1713305737239,EDS 128A,A01,507264,Fargason; Sharon Gayle,26,0,26,0
1713305738264,EDS 128B,A01,507293,Pappas; Elizabeth,30,0,30,0
1713305739286,EDS 139,A00,507294,Fargason; Sharon Gayle,30,0,30,0
1713305739286,EDS 139,B00,507313,Pappas; Elizabeth,30,0,30,0
1713305740312,EDS 201,A00,507315,Staff,26,0,30,4
1713305741338,EDS 203,A01,507317,Halter; Christopher P.,26,0,30,4
1713305742361,EDS 204R,A01,507319,Halter; Christopher P.,6,0,30,24
1713305742361,EDS 204R,B01,507331,Heinzman; Erica M.,30,0,30,0
1713305743390,EDS 206R,A00,507332,Staff,8,0,30,22
1713305743390,EDS 206R,B00,507343,Staff,29,0,30,1
1713305744420,EDS 250,A00,507344,Hemans; Patricia Ann Benitez,36,0,40,4
1713305745445,EDS 281,A00,507345,Daly; Alan J.,18,0,18,0
1713305746469,EDS 284,A00,507350,Daly; Alan J.,16,0,16,0
1713305747497,EDS 286,A00,507359,Fine; Sarah,18,0,18,0
1713305748521,EDS 289C,A01,507361,Daly; Alan J.,18,0,18,0
1713305749545,EDS 290,A00,507366,Hofstetter; Carolyn,15,0,15,0
1713305750571,LIGM 5A,A00,507421,Fischer-Grunski; Eva K,20,0,20,0
1713305751595,LIGM 5B,A00,507423,Fischer-Grunski; Eva K,20,0,20,0
1713305752621,LIGM 5C,A00,507425,Fischer-Grunski; Eva K,20,0,20,0
1713305753645,LIIT 5AS,A00,507427,Carnelos; Chiara,20,0,20,0
1713305754674,LIIT 5BS,A00,507430,Carnelos; Chiara,20,0,20,0
1713305755704,LIIT 5CS,A00,507432,Carnelos; Chiara,20,0,20,0
1713305756734,LISP 5A,A00,507541,Munoz Sanchez; Alicia,19,0,20,1
1713305757761,LISP 5B,A00,507671,Munoz Sanchez; Alicia,17,0,20,3
1713305758792,LISP 5C,A00,507696,Munoz Sanchez; Alicia,17,0,20,3
1713305759817,MAE 197,001,528363,Boechler; Nicholas Sebastia,9999,0,9999,0
1713305760848,MATH 197,001,523477,Kedlaya; Kiran S.,9999,0,9999,0
1713305760848,MATH 197,002,563811,Zhang; Danna,9999,0,9999,0
1713305761872,MCWP 40R,A00,518780,Staff,20,0,20,0
1713305761872,MCWP 40R,B00,518781,Staff,20,0,20,0
1713305761872,MCWP 40R,C00,518783,Staff,19,0,20,1
1713305762898,MCWP 50R,A00,518791,Staff,20,0,20,0
1713305762898,MCWP 50R,B00,518792,Staff,20,0,20,0
1713305762898,MCWP 50R,C00,518793,Staff,19,0,20,1
1713305762898,MCWP 50R,D00,518794,Staff,18,0,20,2
1713305762898,MCWP 50R,E00,518795,Staff,18,0,20,2
1713305762898,MCWP 50R,F00,518796,Staff,19,0,20,1
1713305762898,MCWP 50R,G00,518797,Staff,19,0,20,1
1713305763928,MMW 12R,A01,514034,Herbst; Matthew,16,0,16,0
1713305763928,MMW 12R,A02,514035,Herbst; Matthew,16,0,16,0
1713305764953,MMW 13R,A01,514037,Staff,15,0,16,1
1713305764953,MMW 13R,A02,514039,Staff,16,0,16,0
1713305765979,RMED 296,001,626776,Averbach; Sarah Helene,1,0,1,0
1713305767004,SIO 295LS,A00,523233,Staff,19,0,30,11
1713305768032,SIO 295S,A00,523232,Staff,19,0,30,11
1713305769062,SOCI 117,A01,494376,Staff,3,0,5,2
1713305770091,WES 237B,A00,494380,Staff,19,0,20,1
1713305772170,AESE 279B,A00,494370,Wade; Jon P,33,0,33,0
1713305773196,ANAR 135S,A00,494369,Braswell; Geoffrey E.,0,0,0,0
1713305774228,CAT 124RS,A01,519847,Geibel; William,17,0,20,3
1713305775258,CAT 125RS,A01,515971,Geibel; William,17,0,20,3
1713305776289,CLRE 250,A00,511389,Morris; Sheldon,9996,0,9999,3
1713305777321,CLRE 251,A00,507176,Mehta; Ravindra L.,9996,0,9999,3
1713305777321,CLRE 251,B00,511410,Mehta; Ravindra L.,9998,0,9999,1
1713305778352,CLRE 252,A00,507189,Cuomo; Raphael Eduardo,9998,0,9999,1
1713305779437,CLRE 253,A00,507199,Vaida; Florin,9997,0,9999,2
1713305779437,CLRE 253,B00,507202,Vaida; Florin,9999,0,9999,0
1713305780466,CLRE 259,A00,507211,Patel; Hemal,9996,0,9999,3
1713305781489,CLRE 260,A00,507221,Cuomo; Raphael Eduardo,9999,0,9999,0
1713305782516,CLRE 297,001,507242,Cuomo; Raphael Eduardo,9999,0,9999,0
1713305783545,CSE 191,A00,516875,Minnes Kemp; Mor Mia,9999,0,9999,0
1713305784569,CSS 201S,A01,494383,Staff,35,0,35,0
1713305785598,CSS 202S,A01,494387,Staff,35,0,35,0
1713305786625,EAP 100,A00,516065,Staff,9792,0,9999,207
1713305787654,ECE 45,A01,507414,Staff,56,0,60,4
1713305788684,ECE 100,A01,507416,Baghdadchi; Saharnaz,12,0,20,8
1713305788684,ECE 100,A02,507418,Baghdadchi; Saharnaz,20,0,20,0
1713305789712,ECE 111,A01,507420,Staff,40,0,50,10
1713305790740,ECE 197,001,548057,Sievenpiper; Daniel F.,9999,0,9999,0
1713305791766,EDS 115,A00,507243,Choi; Bailey Miyeon,28,0,28,0
1713305792795,EDS 117,A01,494379,Staff,25,0,25,0
1713305793826,EDS 125,A00,507246,Hopkins; Megan Beth,29,0,30,1
1713305794855,EDS 128A,A01,507264,Fargason; Sharon Gayle,26,0,26,0
1713305795878,EDS 128B,A01,507293,Pappas; Elizabeth,30,0,30,0
1713305796906,EDS 139,A00,507294,Fargason; Sharon Gayle,30,0,30,0
1713305796906,EDS 139,B00,507313,Pappas; Elizabeth,30,0,30,0
1713305797933,EDS 201,A00,507315,Staff,26,0,30,4
1713305798958,EDS 203,A01,507317,Halter; Christopher P.,26,0,30,4
1713305799984,EDS 204R,A01,507319,Halter; Christopher P.,6,0,30,24
1713305799984,EDS 204R,B01,507331,Heinzman; Erica M.,30,0,30,0
1713305801011,EDS 206R,A00,507332,Staff,8,0,30,22
1713305801011,EDS 206R,B00,507343,Staff,29,0,30,1
1713305802037,EDS 250,A00,507344,Hemans; Patricia Ann Benitez,36,0,40,4
1713305803063,EDS 281,A00,507345,Daly; Alan J.,18,0,18,0
1713305804088,EDS 284,A00,507350,Daly; Alan J.,16,0,16,0
1713305805113,EDS 286,A00,507359,Fine; Sarah,18,0,18,0
1713305806139,EDS 289C,A01,507361,Daly; Alan J.,18,0,18,0
1713305807165,EDS 290,A00,507366,Hofstetter; Carolyn,15,0,15,0
1713305808195,LIGM 5A,A00,507421,Fischer-Grunski; Eva K,20,0,20,0
1713305809220,LIGM 5B,A00,507423,Fischer-Grunski; Eva K,20,0,20,0
1713305810249,LIGM 5C,A00,507425,Fischer-Grunski; Eva K,20,0,20,0
1713305811275,LIIT 5AS,A00,507427,Carnelos; Chiara,20,0,20,0
1713305812301,LIIT 5BS,A00,507430,Carnelos; Chiara,20,0,20,0
1713305813326,LIIT 5CS,A00,507432,Carnelos; Chiara,20,0,20,0
1713305814354,LISP 5A,A00,507541,Munoz Sanchez; Alicia,19,0,20,1
1713305815383,LISP 5B,A00,507671,Munoz Sanchez; Alicia,17,0,20,3
1713305816408,LISP 5C,A00,507696,Munoz Sanchez; Alicia,17,0,20,3
1713305817434,MAE 197,001,528363,Boechler; Nicholas Sebastia,9999,0,9999,0
1713305818459,MATH 197,001,523477,Kedlaya; Kiran S.,9999,0,9999,0
1713305818459,MATH 197,002,563811,Zhang; Danna,9999,0,9999,0
1713305819484,MCWP 40R,A00,518780,Staff,20,0,20,0
1713305819484,MCWP 40R,B00,518781,Staff,20,0,20,0
1713305819484,MCWP 40R,C00,518783,Staff,19,0,20,1
1713305820511,MCWP 50R,A00,518791,Staff,20,0,20,0
1713305820511,MCWP 50R,B00,518792,Staff,20,0,20,0
1713305820511,MCWP 50R,C00,518793,Staff,19,0,20,1
1713305820511,MCWP 50R,D00,518794,Staff,18,0,20,2
1713305820511,MCWP 50R,E00,518795,Staff,18,0,20,2
1713305820511,MCWP 50R,F00,518796,Staff,19,0,20,1
1713305820511,MCWP 50R,G00,518797,Staff,19,0,20,1
1713305821535,MMW 12R,A01,514034,Herbst; Matthew,16,0,16,0
1713305821535,MMW 12R,A02,514035,Herbst; Matthew,16,0,16,0
1713305822563,MMW 13R,A01,514037,Staff,15,0,16,1
1713305822563,MMW 13R,A02,514039,Staff,16,0,16,0
1713305823591,RMED 296,001,626776,Averbach; Sarah Helene,1,0,1,0
1713305824620,SIO 295LS,A00,523233,Staff,19,0,30,11
1713305825646,SIO 295S,A00,523232,Staff,19,0,30,11
1713305826671,SOCI 117,A01,494376,Staff,3,0,5,2
1713305827697,WES 237B,A00,494380,Staff,19,0,20,1
1713305829764,AESE 279B,A00,494370,Wade; Jon P,33,0,33,0
1713305830790,ANAR 135S,A00,494369,Braswell; Geoffrey E.,0,0,0,0
1713305831814,CAT 124RS,A01,519847,Geibel; William,17,0,20,3
1713305832840,CAT 125RS,A01,515971,Geibel; William,17,0,20,3
1713305833870,CLRE 250,A00,511389,Morris; Sheldon,9996,0,9999,3
1713305834897,CLRE 251,A00,507176,Mehta; Ravindra L.,9996,0,9999,3
1713305834897,CLRE 251,B00,511410,Mehta; Ravindra L.,9998,0,9999,1
1713305835921,CLRE 252,A00,507189,Cuomo; Raphael Eduardo,9998,0,9999,1
1713305836949,CLRE 253,A00,507199,Vaida; Florin,9997,0,9999,2
1713305836949,CLRE 253,B00,507202,Vaida; Florin,9999,0,9999,0
1713305837977,CLRE 259,A00,507211,Patel; Hemal,9996,0,9999,3
1713305839002,CLRE 260,A00,507221,Cuomo; Raphael Eduardo,9999,0,9999,0
1713305840029,CLRE 297,001,507242,Cuomo; Raphael Eduardo,9999,0,9999,0
1713305841058,CSE 191,A00,516875,Minnes Kemp; Mor Mia,9999,0,9999,0
1713305842083,CSS 201S,A01,494383,Staff,35,0,35,0
1713305843108,CSS 202S,A01,494387,Staff,35,0,35,0
1713305844135,EAP 100,A00,516065,Staff,9792,0,9999,207
1713305845162,ECE 45,A01,507414,Staff,56,0,60,4
1713305846192,ECE 100,A01,507416,Baghdadchi; Saharnaz,12,0,20,8
1713305846192,ECE 100,A02,507418,Baghdadchi; Saharnaz,20,0,20,0
1713305847221,ECE 111,A01,507420,Staff,40,0,50,10
1713305848251,ECE 197,001,548057,Sievenpiper; Daniel F.,9999,0,9999,0
1713305849277,EDS 115,A00,507243,Choi; Bailey Miyeon,28,0,28,0
1713305850305,EDS 117,A01,494379,Staff,25,0,25,0
1713305851329,EDS 125,A00,507246,Hopkins; Megan Beth,29,0,30,1
1713305852357,EDS 128A,A01,507264,Fargason; Sharon Gayle,26,0,26,0
1713305853383,EDS 128B,A01,507293,Pappas; Elizabeth,30,0,30,0
1713305854406,EDS 139,A00,507294,Fargason; Sharon Gayle,30,0,30,0
1713305854406,EDS 139,B00,507313,Pappas; Elizabeth,30,0,30,0
1713305855433,EDS 201,A00,507315,Staff,26,0,30,4
1713305856460,EDS 203,A01,507317,Halter; Christopher P.,26,0,30,4
1713305857488,EDS 204R,A01,507319,Halter; Christopher P.,6,0,30,24
1713305857488,EDS 204R,B01,507331,Heinzman; Erica M.,30,0,30,0
1713305858516,EDS 206R,A00,507332,Staff,8,0,30,22
1713305858516,EDS 206R,B00,507343,Staff,29,0,30,1
1713305859545,EDS 250,A00,507344,Hemans; Patricia Ann Benitez,36,0,40,4
1713305860574,EDS 281,A00,507345,Daly; Alan J.,18,0,18,0
1713305861603,EDS 284,A00,507350,Daly; Alan J.,16,0,16,0
1713305862633,EDS 286,A00,507359,Fine; Sarah,18,0,18,0
1713305863657,EDS 289C,A01,507361,Daly; Alan J.,18,0,18,0
1713305864685,EDS 290,A00,507366,Hofstetter; Carolyn,15,0,15,0
1713305865711,LIGM 5A,A00,507421,Fischer-Grunski; Eva K,20,0,20,0
1713305866736,LIGM 5B,A00,507423,Fischer-Grunski; Eva K,20,0,20,0
1713305867762,LIGM 5C,A00,507425,Fischer-Grunski; Eva K,20,0,20,0
1713305868788,LIIT 5AS,A00,507427,Carnelos; Chiara,20,0,20,0
1713305869814,LIIT 5BS,A00,507430,Carnelos; Chiara,20,0,20,0
1713305870838,LIIT 5CS,A00,507432,Carnelos; Chiara,20,0,20,0
1713305871883,LISP 5A,A00,507541,Munoz Sanchez; Alicia,19,0,20,1
1713305872907,LISP 5B,A00,507671,Munoz Sanchez; Alicia,17,0,20,3
1713305873938,LISP 5C,A00,507696,Munoz Sanchez; Alicia,17,0,20,3
1713305874962,MAE 197,001,528363,Boechler; Nicholas Sebastia,9999,0,9999,0
1713305875989,MATH 197,001,523477,Kedlaya; Kiran S.,9999,0,9999,0
1713305875989,MATH 197,002,563811,Zhang; Danna,9999,0,9999,0
1713305877018,MCWP 40R,A00,518780,Staff,20,0,20,0
1713305877018,MCWP 40R,B00,518781,Staff,20,0,20,0
1713305877018,MCWP 40R,C00,518783,Staff,19,0,20,1
1713305878044,MCWP 50R,A00,518791,Staff,20,0,20,0
1713305878044,MCWP 50R,B00,518792,Staff,20,0,20,0
1713305878044,MCWP 50R,C00,518793,Staff,19,0,20,1
1713305878044,MCWP 50R,D00,518794,Staff,18,0,20,2
1713305878044,MCWP 50R,E00,518795,Staff,18,0,20,2
1713305878044,MCWP 50R,F00,518796,Staff,19,0,20,1
1713305878044,MCWP 50R,G00,518797,Staff,19,0,20,1
1713305879075,MMW 12R,A01,514034,Herbst; Matthew,16,0,16,0
1713305879075,MMW 12R,A02,514035,Herbst; Matthew,16,0,16,0
1713305880108,MMW 13R,A01,514037,Staff,15,0,16,1
1713305880108,MMW 13R,A02,514039,Staff,16,0,16,0
1713305881143,RMED 296,001,626776,Averbach; Sarah Helene,1,0,1,0
1713305882167,SIO 295LS,A00,523233,Staff,19,0,30,11
1713305883249,SIO 295S,A00,523232,Staff,19,0,30,11
1713305884276,SOCI 117,A01,494376,Staff,3,0,5,2
1713305885302,WES 237B,A00,494380,Staff,19,0,20,1
1713305887380,AESE 279B,A00,494370,Wade; Jon P,33,0,33,0
1713305888405,ANAR 135S,A00,494369,Braswell; Geoffrey E.,0,0,0,0
1713305889433,CAT 124RS,A01,519847,Geibel; William,17,0,20,3
1713305890459,CAT 125RS,A01,515971,Geibel; William,17,0,20,3
1713305891491,CLRE 250,A00,511389,Morris; Sheldon,9996,0,9999,3
1713305892523,CLRE 251,A00,507176,Mehta; Ravindra L.,9996,0,9999,3
1713305892523,CLRE 251,B00,511410,Mehta; Ravindra L.,9998,0,9999,1
1713305893548,CLRE 252,A00,507189,Cuomo; Raphael Eduardo,9998,0,9999,1
1713305894574,CLRE 253,A00,507199,Vaida; Florin,9997,0,9999,2
1713305894574,CLRE 253,B00,507202,Vaida; Florin,9999,0,9999,0
1713305895597,CLRE 259,A00,507211,Patel; Hemal,9996,0,9999,3
1713305896622,CLRE 260,A00,507221,Cuomo; Raphael Eduardo,9999,0,9999,0
1713305897649,CLRE 297,001,507242,Cuomo; Raphael Eduardo,9999,0,9999,0
1713305898674,CSE 191,A00,516875,Minnes Kemp; Mor Mia,9999,0,9999,0
1713305899700,CSS 201S,A01,494383,Staff,35,0,35,0
1713305900725,CSS 202S,A01,494387,Staff,35,0,35,0
1713305901754,EAP 100,A00,516065,Staff,9792,0,9999,207
1713305902873,ECE 45,A01,507414,Staff,56,0,60,4
1713305903898,ECE 100,A01,507416,Baghdadchi; Saharnaz,12,0,20,8
1713305903898,ECE 100,A02,507418,Baghdadchi; Saharnaz,20,0,20,0
1713305904923,ECE 111,A01,507420,Staff,40,0,50,10
1713305905948,ECE 197,001,548057,Sievenpiper; Daniel F.,9999,0,9999,0
1713305906973,EDS 115,A00,507243,Choi; Bailey Miyeon,28,0,28,0
1713305908001,EDS 117,A01,494379,Staff,25,0,25,0
1713305909028,EDS 125,A00,507246,Hopkins; Megan Beth,29,0,30,1
1713305910056,EDS 128A,A01,507264,Fargason; Sharon Gayle,26,0,26,0
1713305911086,EDS 128B,A01,507293,Pappas; Elizabeth,30,0,30,0
1713305912148,EDS 139,A00,507294,Fargason; Sharon Gayle,30,0,30,0
1713305912148,EDS 139,B00,507313,Pappas; Elizabeth,30,0,30,0
1713305913173,EDS 201,A00,507315,Staff,26,0,30,4
1713305914198,EDS 203,A01,507317,Halter; Christopher P.,26,0,30,4
1713305915224,EDS 204R,A01,507319,Halter; Christopher P.,6,0,30,24
1713305915224,EDS 204R,B01,507331,Heinzman; Erica M.,30,0,30,0
1713305916250,EDS 206R,A00,507332,Staff,8,0,30,22
1713305916250,EDS 206R,B00,507343,Staff,29,0,30,1
1713305917274,EDS 250,A00,507344,Hemans; Patricia Ann Benitez,36,0,40,4
1713305918298,EDS 281,A00,507345,Daly; Alan J.,18,0,18,0
1713305919325,EDS 284,A00,507350,Daly; Alan J.,16,0,16,0
1713305920352,EDS 286,A00,507359,Fine; Sarah,18,0,18,0
1713305921376,EDS 289C,A01,507361,Daly; Alan J.,18,0,18,0
1713305922399,EDS 290,A00,507366,Hofstetter; Carolyn,15,0,15,0
1713305923428,LIGM 5A,A00,507421,Fischer-Grunski; Eva K,20,0,20,0
1713305924457,LIGM 5B,A00,507423,Fischer-Grunski; Eva K,20,0,20,0
1713305925480,LIGM 5C,A00,507425,Fischer-Grunski; Eva K,20,0,20,0
1713305926509,LIIT 5AS,A00,507427,Carnelos; Chiara,20,0,20,0
1713305927534,LIIT 5BS,A00,507430,Carnelos; Chiara,20,0,20,0
1713305928563,LIIT 5CS,A00,507432,Carnelos; Chiara,20,0,20,0
1713305929590,LISP 5A,A00,507541,Munoz Sanchez; Alicia,19,0,20,1
1713305930616,LISP 5B,A00,507671,Munoz Sanchez; Alicia,17,0,20,3
1713305931641,LISP 5C,A00,507696,Munoz Sanchez; Alicia,17,0,20,3
1713305932666,MAE 197,001,528363,Boechler; Nicholas Sebastia,9999,0,9999,0
1713305933696,MATH 197,001,523477,Kedlaya; Kiran S.,9999,0,9999,0
1713305933696,MATH 197,002,563811,Zhang; Danna,9999,0,9999,0
1713305934722,MCWP 40R,A00,518780,Staff,20,0,20,0
1713305934722,MCWP 40R,B00,518781,Staff,20,0,20,0
1713305934722,MCWP 40R,C00,518783,Staff,19,0,20,1
1713305935751,MCWP 50R,A00,518791,Staff,20,0,20,0
1713305935751,MCWP 50R,B00,518792,Staff,20,0,20,0
1713305935751,MCWP 50R,C00,518793,Staff,19,0,20,1
1713305935751,MCWP 50R,D00,518794,Staff,18,0,20,2
1713305935751,MCWP 50R,E00,518795,Staff,18,0,20,2
1713305935751,MCWP 50R,F00,518796,Staff,19,0,20,1
1713305935751,MCWP 50R,G00,518797,Staff,19,0,20,1
1713305936780,MMW 12R,A01,514034,Herbst; Matthew,16,0,16,0
1713305936780,MMW 12R,A02,514035,Herbst; Matthew,16,0,16,0
1713305937807,MMW 13R,A01,514037,Staff,15,0,16,1
1713305937807,MMW 13R,A02,514039,Staff,16,0,16,0
1713305938833,RMED 296,001,626776,Averbach; Sarah Helene,1,0,1,0
1713305939858,SIO 295LS,A00,523233,Staff,19,0,30,11
1713305940884,SIO 295S,A00,523232,Staff,19,0,30,11
1713305941916,SOCI 117,A01,494376,Staff,3,0,5,2
1713305942946,WES 237B,A00,494380,Staff,19,0,20,1
1713305945009,AESE 279B,A00,494370,Wade; Jon P,33,0,33,0
1713305946033,ANAR 135S,A00,494369,Braswell; Geoffrey E.,0,0,0,0
1713305947060,CAT 124RS,A01,519847,Geibel; William,17,0,20,3
1713305948090,CAT 125RS,A01,515971,Geibel; William,17,0,20,3
1713305949118,CLRE 250,A00,511389,Morris; Sheldon,9996,0,9999,3
1713305950150,CLRE 251,A00,507176,Mehta; Ravindra L.,9996,0,9999,3
1713305950150,CLRE 251,B00,511410,Mehta; Ravindra L.,9998,0,9999,1
1713305951180,CLRE 252,A00,507189,Cuomo; Raphael Eduardo,9998,0,9999,1
1713305952205,CLRE 253,A00,507199,Vaida; Florin,9997,0,9999,2
1713305952205,CLRE 253,B00,507202,Vaida; Florin,9999,0,9999,0
1713305953229,CLRE 259,A00,507211,Patel; Hemal,9996,0,9999,3
1713305954253,CLRE 260,A00,507221,Cuomo; Raphael Eduardo,9999,0,9999,0
1713305955280,CLRE 297,001,507242,Cuomo; Raphael Eduardo,9999,0,9999,0
1713305956311,CSE 191,A00,516875,Minnes Kemp; Mor Mia,9999,0,9999,0
1713305957342,CSS 201S,A01,494383,Staff,35,0,35,0
1713305958367,CSS 202S,A01,494387,Staff,35,0,35,0
1713305959391,EAP 100,A00,516065,Staff,9792,0,9999,207
1713305960422,ECE 45,A01,507414,Staff,56,0,60,4
1713305961447,ECE 100,A01,507416,Baghdadchi; Saharnaz,12,0,20,8
1713305961447,ECE 100,A02,507418,Baghdadchi; Saharnaz,20,0,20,0
1713305962472,ECE 111,A01,507420,Staff,40,0,50,10
1713305963496,ECE 197,001,548057,Sievenpiper; Daniel F.,9999,0,9999,0
1713305964522,EDS 115,A00,507243,Choi; Bailey Miyeon,28,0,28,0
1713305965548,EDS 117,A01,494379,Staff,25,0,25,0
1713305966573,EDS 125,A00,507246,Hopkins; Megan Beth,29,0,30,1
1713305967610,EDS 128A,A01,507264,Fargason; Sharon Gayle,26,0,26,0
1713305968638,EDS 128B,A01,507293,Pappas; Elizabeth,30,0,30,0
1713305969664,EDS 139,A00,507294,Fargason; Sharon Gayle,30,0,30,0
1713305969664,EDS 139,B00,507313,Pappas; Elizabeth,30,0,30,0
1713305970693,EDS 201,A00,507315,Staff,26,0,30,4
1713305971722,EDS 203,A01,507317,Halter; Christopher P.,26,0,30,4
1713305972751,EDS 204R,A01,507319,Halter; Christopher P.,6,0,30,24
1713305972751,EDS 204R,B01,507331,Heinzman; Erica M.,30,0,30,0
1713305973775,EDS 206R,A00,507332,Staff,8,0,30,22
1713305973775,EDS 206R,B00,507343,Staff,29,0,30,1
1713305974800,EDS 250,A00,507344,Hemans; Patricia Ann Benitez,36,0,40,4
1713305975824,EDS 281,A00,507345,Daly; Alan J.,18,0,18,0
1713305976849,EDS 284,A00,507350,Daly; Alan J.,16,0,16,0
1713305980805,EDS 286,A00,507359,Fine; Sarah,18,0,18,0
1713305981830,EDS 289C,A01,507361,Daly; Alan J.,18,0,18,0
1713305982859,EDS 290,A00,507366,Hofstetter; Carolyn,15,0,15,0
1713305983886,LIGM 5A,A00,507421,Fischer-Grunski; Eva K,20,0,20,0
1713305984913,LIGM 5B,A00,507423,Fischer-Grunski; Eva K,20,0,20,0
1713305985938,LIGM 5C,A00,507425,Fischer-Grunski; Eva K,20,0,20,0
1713305987064,LIIT 5AS,A00,507427,Carnelos; Chiara,20,0,20,0
1713305988090,LIIT 5BS,A00,507430,Carnelos; Chiara,20,0,20,0
1713305989115,LIIT 5CS,A00,507432,Carnelos; Chiara,20,0,20,0
1713305990237,LISP 5A,A00,507541,Munoz Sanchez; Alicia,19,0,20,1
1713305991264,LISP 5B,A00,507671,Munoz Sanchez; Alicia,17,0,20,3
1713305992293,LISP 5C,A00,507696,Munoz Sanchez; Alicia,17,0,20,3
1713305993319,MAE 197,001,528363,Boechler; Nicholas Sebastia,9999,0,9999,0
1713305994345,MATH 197,001,523477,Kedlaya; Kiran S.,9999,0,9999,0
1713305994345,MATH 197,002,563811,Zhang; Danna,9999,0,9999,0
1713305995372,MCWP 40R,A00,518780,Staff,20,0,20,0
1713305995372,MCWP 40R,B00,518781,Staff,20,0,20,0
1713305995372,MCWP 40R,C00,518783,Staff,19,0,20,1
1713305996398,MCWP 50R,A00,518791,Staff,20,0,20,0
1713305996398,MCWP 50R,B00,518792,Staff,20,0,20,0
1713305996398,MCWP 50R,C00,518793,Staff,19,0,20,1
1713305996398,MCWP 50R,D00,518794,Staff,18,0,20,2
1713305996398,MCWP 50R,E00,518795,Staff,18,0,20,2
1713305996398,MCWP 50R,F00,518796,Staff,19,0,20,1
1713305996398,MCWP 50R,G00,518797,Staff,19,0,20,1
1713305997424,MMW 12R,A01,514034,Herbst; Matthew,16,0,16,0
1713305997424,MMW 12R,A02,514035,Herbst; Matthew,16,0,16,0
1713305998451,MMW 13R,A01,514037,Staff,15,0,16,1
1713305998451,MMW 13R,A02,514039,Staff,16,0,16,0
1713305999479,RMED 296,001,626776,Averbach; Sarah Helene,1,0,1,0
1713306000502,SIO 295LS,A00,523233,Staff,19,0,30,11
1713306001529,SIO 295S,A00,523232,Staff,19,0,30,11
1713306002556,SOCI 117,A01,494376,Staff,3,0,5,2
1713306003580,WES 237B,A00,494380,Staff,19,0,20,1
1713306005648,AESE 279B,A00,494370,Wade; Jon P,33,0,33,0
1713306006674,ANAR 135S,A00,494369,Braswell; Geoffrey E.,0,0,0,0
1713306007702,CAT 124RS,A01,519847,Geibel; William,17,0,20,3
1713306008727,CAT 125RS,A01,515971,Geibel; William,17,0,20,3
1713306009753,CLRE 250,A00,511389,Morris; Sheldon,9996,0,9999,3
1713306010780,CLRE 251,A00,507176,Mehta; Ravindra L.,9996,0,9999,3
1713306010780,CLRE 251,B00,511410,Mehta; Ravindra L.,9998,0,9999,1
1713306011806,CLRE 252,A00,507189,Cuomo; Raphael Eduardo,9998,0,9999,1
1713306012836,CLRE 253,A00,507199,Vaida; Florin,9997,0,9999,2
1713306012836,CLRE 253,B00,507202,Vaida; Florin,9999,0,9999,0
1713306013867,CLRE 259,A00,507211,Patel; Hemal,9996,0,9999,3
1713306014895,CLRE 260,A00,507221,Cuomo; Raphael Eduardo,9999,0,9999,0
1713306015921,CLRE 297,001,507242,Cuomo; Raphael Eduardo,9999,0,9999,0
1713306016946,CSE 191,A00,516875,Minnes Kemp; Mor Mia,9999,0,9999,0
1713306017971,CSS 201S,A01,494383,Staff,35,0,35,0
1713306019000,CSS 202S,A01,494387,Staff,35,0,35,0
1713306020026,EAP 100,A00,516065,Staff,9792,0,9999,207
1713306021054,ECE 45,A01,507414,Staff,56,0,60,4
1713306022082,ECE 100,A01,507416,Baghdadchi; Saharnaz,12,0,20,8
1713306022082,ECE 100,A02,507418,Baghdadchi; Saharnaz,20,0,20,0
1713306023107,ECE 111,A01,507420,Staff,40,0,50,10
1713306024136,ECE 197,001,548057,Sievenpiper; Daniel F.,9999,0,9999,0
1713306025161,EDS 115,A00,507243,Choi; Bailey Miyeon,28,0,28,0
1713306026192,EDS 117,A01,494379,Staff,25,0,25,0
1713306027218,EDS 125,A00,507246,Hopkins; Megan Beth,29,0,30,1
1713306028245,EDS 128A,A01,507264,Fargason; Sharon Gayle,26,0,26,0
1713306029271,EDS 128B,A01,507293,Pappas; Elizabeth,30,0,30,0
1713306030294,EDS 139,A00,507294,Fargason; Sharon Gayle,30,0,30,0
1713306030294,EDS 139,B00,507313,Pappas; Elizabeth,30,0,30,0
1713306031319,EDS 201,A00,507315,Staff,26,0,30,4
1713306032350,EDS 203,A01,507317,Halter; Christopher P.,26,0,30,4
1713306033376,EDS 204R,A01,507319,Halter; Christopher P.,6,0,30,24
1713306033376,EDS 204R,B01,507331,Heinzman; Erica M.,30,0,30,0
1713306034401,EDS 206R,A00,507332,Staff,8,0,30,22
1713306034401,EDS 206R,B00,507343,Staff,29,0,30,1
1713306035426,EDS 250,A00,507344,Hemans; Patricia Ann Benitez,36,0,40,4
1713306036454,EDS 281,A00,507345,Daly; Alan J.,18,0,18,0
1713306037482,EDS 284,A00,507350,Daly; Alan J.,16,0,16,0
1713306038511,EDS 286,A00,507359,Fine; Sarah,18,0,18,0
1713306039536,EDS 289C,A01,507361,Daly; Alan J.,18,0,18,0
1713306040562,EDS 290,A00,507366,Hofstetter; Carolyn,15,0,15,0
1713306041593,LIGM 5A,A00,507421,Fischer-Grunski; Eva K,20,0,20,0
1713306042618,LIGM 5B,A00,507423,Fischer-Grunski; Eva K,20,0,20,0
1713306043650,LIGM 5C,A00,507425,Fischer-Grunski; Eva K,20,0,20,0
1713306044682,LIIT 5AS,A00,507427,Carnelos; Chiara,20,0,20,0
1713306045707,LIIT 5BS,A00,507430,Carnelos; Chiara,20,0,20,0
1713306046732,LIIT 5CS,A00,507432,Carnelos; Chiara,20,0,20,0
1713306047764,LISP 5A,A00,507541,Munoz Sanchez; Alicia,19,0,20,1
1713306048788,LISP 5B,A00,507671,Munoz Sanchez; Alicia,17,0,20,3
1713306049817,LISP 5C,A00,507696,Munoz Sanchez; Alicia,17,0,20,3
1713306050841,MAE 197,001,528363,Boechler; Nicholas Sebastia,9999,0,9999,0
1713306051866,MATH 197,001,523477,Kedlaya; Kiran S.,9999,0,9999,0
1713306051866,MATH 197,002,563811,Zhang; Danna,9999,0,9999,0
1713306052893,MCWP 40R,A00,518780,Staff,20,0,20,0
1713306052893,MCWP 40R,B00,518781,Staff,20,0,20,0
1713306052893,MCWP 40R,C00,518783,Staff,19,0,20,1
1713306053919,MCWP 50R,A00,518791,Staff,20,0,20,0
1713306053919,MCWP 50R,B00,518792,Staff,20,0,20,0
1713306053919,MCWP 50R,C00,518793,Staff,19,0,20,1
1713306053919,MCWP 50R,D00,518794,Staff,18,0,20,2
1713306053919,MCWP 50R,E00,518795,Staff,18,0,20,2
1713306053919,MCWP 50R,F00,518796,Staff,19,0,20,1
1713306053919,MCWP 50R,G00,518797,Staff,19,0,20,1
1713306054948,MMW 12R,A01,514034,Herbst; Matthew,16,0,16,0
1713306054948,MMW 12R,A02,514035,Herbst; Matthew,16,0,16,0
1713306055978,MMW 13R,A01,514037,Staff,15,0,16,1
1713306055978,MMW 13R,A02,514039,Staff,16,0,16,0
1713306057003,RMED 296,001,626776,Averbach; Sarah Helene,1,0,1,0
1713306058033,SIO 295LS,A00,523233,Staff,19,0,30,11
1713306059065,SIO 295S,A00,523232,Staff,19,0,30,11
1713306060095,SOCI 117,A01,494376,Staff,3,0,5,2
1713306061119,WES 237B,A00,494380,Staff,19,0,20,1
1713306063185,AESE 279B,A00,494370,Wade; Jon P,33,0,33,0
1713306064211,ANAR 135S,A00,494369,Braswell; Geoffrey E.,0,0,0,0
1713306065241,CAT 124RS,A01,519847,Geibel; William,17,0,20,3
1713306066266,CAT 125RS,A01,515971,Geibel; William,17,0,20,3
1713306067290,CLRE 250,A00,511389,Morris; Sheldon,9996,0,9999,3
1713306068320,CLRE 251,A00,507176,Mehta; Ravindra L.,9996,0,9999,3
1713306068320,CLRE 251,B00,511410,Mehta; Ravindra L.,9998,0,9999,1
1713306069343,CLRE 252,A00,507189,Cuomo; Raphael Eduardo,9998,0,9999,1
1713306070376,CLRE 253,A00,507199,Vaida; Florin,9997,0,9999,2
1713306070376,CLRE 253,B00,507202,Vaida; Florin,9999,0,9999,0
1713306071400,CLRE 259,A00,507211,Patel; Hemal,9996,0,9999,3
1713306072426,CLRE 260,A00,507221,Cuomo; Raphael Eduardo,9999,0,9999,0
1713306073450,CLRE 297,001,507242,Cuomo; Raphael Eduardo,9999,0,9999,0
1713306074475,CSE 191,A00,516875,Minnes Kemp; Mor Mia,9999,0,9999,0
1713306075499,CSS 201S,A01,494383,Staff,35,0,35,0
1713306076523,CSS 202S,A01,494387,Staff,35,0,35,0
1713306077554,EAP 100,A00,516065,Staff,9792,0,9999,207
1713306078579,ECE 45,A01,507414,Staff,56,0,60,4
1713306079607,ECE 100,A01,507416,Baghdadchi; Saharnaz,12,0,20,8
1713306079607,ECE 100,A02,507418,Baghdadchi; Saharnaz,20,0,20,0
1713306080636,ECE 111,A01,507420,Staff,40,0,50,10
1713306081661,ECE 197,001,548057,Sievenpiper; Daniel F.,9999,0,9999,0
1713306082686,EDS 115,A00,507243,Choi; Bailey Miyeon,28,0,28,0
1713306083715,EDS 117,A01,494379,Staff,25,0,25,0
1713306084740,EDS 125,A00,507246,Hopkins; Megan Beth,29,0,30,1
1713306085766,EDS 128A,A01,507264,Fargason; Sharon Gayle,26,0,26,0
1713306086797,EDS 128B,A01,507293,Pappas; Elizabeth,30,0,30,0
1713306087820,EDS 139,A00,507294,Fargason; Sharon Gayle,30,0,30,0
1713306087820,EDS 139,B00,507313,Pappas; Elizabeth,30,0,30,0
1713306088845,EDS 201,A00,507315,Staff,26,0,30,4
1713306089900,EDS 203,A01,507317,Halter; Christopher P.,26,0,30,4
1713306090931,EDS 204R,A01,507319,Halter; Christopher P.,6,0,30,24
1713306090931,EDS 204R,B01,507331,Heinzman; Erica M.,30,0,30,0
1713306091959,EDS 206R,A00,507332,Staff,8,0,30,22
1713306091959,EDS 206R,B00,507343,Staff,29,0,30,1
1713306092992,EDS 250,A00,507344,Hemans; Patricia Ann Benitez,36,0,40,4
1713306094076,EDS 281,A00,507345,Daly; Alan J.,18,0,18,0
1713306095113,EDS 284,A00,507350,Daly; Alan J.,16,0,16,0
1713306096139,EDS 286,A00,507359,Fine; Sarah,18,0,18,0
1713306097165,EDS 289C,A01,507361,Daly; Alan J.,18,0,18,0
1713306098190,EDS 290,A00,507366,Hofstetter; Carolyn,15,0,15,0
1713306099218,LIGM 5A,A00,507421,Fischer-Grunski; Eva K,20,0,20,0
1713306100247,LIGM 5B,A00,507423,Fischer-Grunski; Eva K,20,0,20,0
1713306101275,LIGM 5C,A00,507425,Fischer-Grunski; Eva K,20,0,20,0
1713306102301,LIIT 5AS,A00,507427,Carnelos; Chiara,20,0,20,0
1713306103327,LIIT 5BS,A00,507430,Carnelos; Chiara,20,0,20,0
1713306104353,LIIT 5CS,A00,507432,Carnelos; Chiara,20,0,20,0
1713306105380,LISP 5A,A00,507541,Munoz Sanchez; Alicia,19,0,20,1
1713306106404,LISP 5B,A00,507671,Munoz Sanchez; Alicia,17,0,20,3
1713306107434,LISP 5C,A00,507696,Munoz Sanchez; Alicia,17,0,20,3
1713306108461,MAE 197,001,528363,Boechler; Nicholas Sebastia,9999,0,9999,0
1713306109487,MATH 197,001,523477,Kedlaya; Kiran S.,9999,0,9999,0
1713306109487,MATH 197,002,563811,Zhang; Danna,9999,0,9999,0
1713306110514,MCWP 40R,A00,518780,Staff,20,0,20,0
1713306110514,MCWP 40R,B00,518781,Staff,20,0,20,0
1713306110514,MCWP 40R,C00,518783,Staff,19,0,20,1
1713306111540,MCWP 50R,A00,518791,Staff,20,0,20,0
1713306111540,MCWP 50R,B00,518792,Staff,19,0,20,1
1713306111540,MCWP 50R,C00,518793,Staff,19,0,20,1
1713306111540,MCWP 50R,D00,518794,Staff,18,0,20,2
1713306111540,MCWP 50R,E00,518795,Staff,18,0,20,2
1713306111540,MCWP 50R,F00,518796,Staff,19,0,20,1
1713306111540,MCWP 50R,G00,518797,Staff,19,0,20,1
1713306112566,MMW 12R,A01,514034,Herbst; Matthew,16,0,16,0
1713306112566,MMW 12R,A02,514035,Herbst; Matthew,16,0,16,0
1713306113593,MMW 13R,A01,514037,Staff,14,0,16,2
1713306113593,MMW 13R,A02,514039,Staff,16,0,16,0
1713306114619,RMED 296,001,626776,Averbach; Sarah Helene,1,0,1,0
1713306115662,SIO 295LS,A00,523233,Staff,19,0,30,11
1713306116701,SIO 295S,A00,523232,Staff,19,0,30,11
1713306117732,SOCI 117,A01,494376,Staff,3,0,5,2
1713306118758,WES 237B,A00,494380,Staff,19,0,20,1
1713306120819,AESE 279B,A00,494370,Wade; Jon P,33,0,33,0
1713306121844,ANAR 135S,A00,494369,Braswell; Geoffrey E.,0,0,0,0
1713306122871,CAT 124RS,A01,519847,Geibel; William,17,0,20,3
1713306123898,CAT 125RS,A01,515971,Geibel; William,17,0,20,3
1713306124924,CLRE 250,A00,511389,Morris; Sheldon,9996,0,9999,3
1713306125956,CLRE 251,A00,507176,Mehta; Ravindra L.,9996,0,9999,3
1713306125956,CLRE 251,B00,511410,Mehta; Ravindra L.,9998,0,9999,1
1713306126982,CLRE 252,A00,507189,Cuomo; Raphael Eduardo,9998,0,9999,1
1713306128008,CLRE 253,A00,507199,Vaida; Florin,9997,0,9999,2
1713306128008,CLRE 253,B00,507202,Vaida; Florin,9999,0,9999,0
1713306129032,CLRE 259,A00,507211,Patel; Hemal,9996,0,9999,3
1713306130057,CLRE 260,A00,507221,Cuomo; Raphael Eduardo,9999,0,9999,0
1713306131083,CLRE 297,001,507242,Cuomo; Raphael Eduardo,9999,0,9999,0
1713306132109,CSE 191,A00,516875,Minnes Kemp; Mor Mia,9999,0,9999,0
1713306133133,CSS 201S,A01,494383,Staff,35,0,35,0
1713306134164,CSS 202S,A01,494387,Staff,35,0,35,0
1713306135192,EAP 100,A00,516065,Staff,9792,0,9999,207
1713306136221,ECE 45,A01,507414,Staff,56,0,60,4
1713306137250,ECE 100,A01,507416,Baghdadchi; Saharnaz,12,0,20,8
1713306137250,ECE 100,A02,507418,Baghdadchi; Saharnaz,20,0,20,0
1713306138275,ECE 111,A01,507420,Staff,40,0,50,10
1713306139300,ECE 197,001,548057,Sievenpiper; Daniel F.,9999,0,9999,0
1713306140326,EDS 115,A00,507243,Choi; Bailey Miyeon,28,0,28,0
1713306141352,EDS 117,A01,494379,Staff,25,0,25,0
1713306142384,EDS 125,A00,507246,Hopkins; Megan Beth,29,0,30,1
1713306143413,EDS 128A,A01,507264,Fargason; Sharon Gayle,26,0,26,0
1713306144438,EDS 128B,A01,507293,Pappas; Elizabeth,30,0,30,0
1713306145462,EDS 139,A00,507294,Fargason; Sharon Gayle,30,0,30,0
1713306145462,EDS 139,B00,507313,Pappas; Elizabeth,30,0,30,0
1713306146494,EDS 201,A00,507315,Staff,26,0,30,4
1713306147524,EDS 203,A01,507317,Halter; Christopher P.,26,0,30,4
1713306148550,EDS 204R,A01,507319,Halter; Christopher P.,6,0,30,24
1713306148550,EDS 204R,B01,507331,Heinzman; Erica M.,30,0,30,0
1713306149578,EDS 206R,A00,507332,Staff,8,0,30,22
1713306149578,EDS 206R,B00,507343,Staff,29,0,30,1
1713306150608,EDS 250,A00,507344,Hemans; Patricia Ann Benitez,36,0,40,4
1713306151633,EDS 281,A00,507345,Daly; Alan J.,18,0,18,0
1713306152656,EDS 284,A00,507350,Daly; Alan J.,16,0,16,0
1713306153682,EDS 286,A00,507359,Fine; Sarah,18,0,18,0
1713306154706,EDS 289C,A01,507361,Daly; Alan J.,18,0,18,0
1713306155734,EDS 290,A00,507366,Hofstetter; Carolyn,15,0,15,0
1713306156764,LIGM 5A,A00,507421,Fischer-Grunski; Eva K,20,0,20,0
1713306157795,LIGM 5B,A00,507423,Fischer-Grunski; Eva K,20,0,20,0
1713306158822,LIGM 5C,A00,507425,Fischer-Grunski; Eva K,20,0,20,0
1713306159847,LIIT 5AS,A00,507427,Carnelos; Chiara,20,0,20,0
1713306160874,LIIT 5BS,A00,507430,Carnelos; Chiara,20,0,20,0
1713306161900,LIIT 5CS,A00,507432,Carnelos; Chiara,20,0,20,0
1713306162927,LISP 5A,A00,507541,Munoz Sanchez; Alicia,19,0,20,1
1713306163951,LISP 5B,A00,507671,Munoz Sanchez; Alicia,17,0,20,3
1713306164982,LISP 5C,A00,507696,Munoz Sanchez; Alicia,17,0,20,3
1713306166006,MAE 197,001,528363,Boechler; Nicholas Sebastia,9999,0,9999,0
1713306167040,MATH 197,001,523477,Kedlaya; Kiran S.,9999,0,9999,0
1713306167040,MATH 197,002,563811,Zhang; Danna,9999,0,9999,0
1713306168070,MCWP 40R,A00,518780,Staff,20,0,20,0
1713306168070,MCWP 40R,B00,518781,Staff,20,0,20,0
1713306168070,MCWP 40R,C00,518783,Staff,19,0,20,1
1713306169101,MCWP 50R,A00,518791,Staff,20,0,20,0
1713306169101,MCWP 50R,B00,518792,Staff,19,0,20,1
1713306169101,MCWP 50R,C00,518793,Staff,19,0,20,1
1713306169101,MCWP 50R,D00,518794,Staff,18,0,20,2
1713306169101,MCWP 50R,E00,518795,Staff,18,0,20,2
1713306169101,MCWP 50R,F00,518796,Staff,19,0,20,1
1713306169101,MCWP 50R,G00,518797,Staff,19,0,20,1
1713306170127,MMW 12R,A01,514034,Herbst; Matthew,16,0,16,0
1713306170127,MMW 12R,A02,514035,Herbst; Matthew,16,0,16,0
1713306171155,MMW 13R,A01,514037,Staff,14,0,16,2
1713306171155,MMW 13R,A02,514039,Staff,16,0,16,0
1713306172180,RMED 296,001,626776,Averbach; Sarah Helene,1,0,1,0
1713306173206,SIO 295LS,A00,523233,Staff,19,0,30,11
1713306174235,SIO 295S,A00,523232,Staff,19,0,30,11
1713306175260,SOCI 117,A01,494376,Staff,3,0,5,2
1713306176289,WES 237B,A00,494380,Staff,19,0,20,1
1713306178361,AESE 279B,A00,494370,Wade; Jon P,33,0,33,0
1713306179386,ANAR 135S,A00,494369,Braswell; Geoffrey E.,0,0,0,0
1713306180431,CAT 124RS,A01,519847,Geibel; William,17,0,20,3
1713306181456,CAT 125RS,A01,515971,Geibel; William,17,0,20,3
1713306182484,CLRE 250,A00,511389,Morris; Sheldon,9996,0,9999,3
1713306183510,CLRE 251,A00,507176,Mehta; Ravindra L.,9996,0,9999,3
1713306183510,CLRE 251,B00,511410,Mehta; Ravindra L.,9998,0,9999,1
1713306184534,CLRE 252,A00,507189,Cuomo; Raphael Eduardo,9998,0,9999,1
1713306185559,CLRE 253,A00,507199,Vaida; Florin,9997,0,9999,2
1713306185559,CLRE 253,B00,507202,Vaida; Florin,9999,0,9999,0
1713306186582,CLRE 259,A00,507211,Patel; Hemal,9996,0,9999,3
1713306187608,CLRE 260,A00,507221,Cuomo; Raphael Eduardo,9999,0,9999,0
1713306188635,CLRE 297,001,507242,Cuomo; Raphael Eduardo,9999,0,9999,0
1713306189660,CSE 191,A00,516875,Minnes Kemp; Mor Mia,9999,0,9999,0
1713306190689,CSS 201S,A01,494383,Staff,35,0,35,0
1713306191719,CSS 202S,A01,494387,Staff,35,0,35,0
1713306192743,EAP 100,A00,516065,Staff,9792,0,9999,207
1713306193783,ECE 45,A01,507414,Staff,56,0,60,4
1713306194808,ECE 100,A01,507416,Baghdadchi; Saharnaz,12,0,20,8
1713306194808,ECE 100,A02,507418,Baghdadchi; Saharnaz,20,0,20,0
1713306195832,ECE 111,A01,507420,Staff,40,0,50,10
1713306196862,ECE 197,001,548057,Sievenpiper; Daniel F.,9999,0,9999,0
1713306197942,EDS 115,A00,507243,Choi; Bailey Miyeon,28,0,28,0
1713306198967,EDS 117,A01,494379,Staff,25,0,25,0
1713306199999,EDS 125,A00,507246,Hopkins; Megan Beth,29,0,30,1
1713306201025,EDS 128A,A01,507264,Fargason; Sharon Gayle,26,0,26,0
1713306202093,EDS 128B,A01,507293,Pappas; Elizabeth,30,0,30,0
1713306203120,EDS 139,A00,507294,Fargason; Sharon Gayle,30,0,30,0
1713306203120,EDS 139,B00,507313,Pappas; Elizabeth,30,0,30,0
1713306204149,EDS 201,A00,507315,Staff,26,0,30,4
1713306205176,EDS 203,A01,507317,Halter; Christopher P.,26,0,30,4
1713306206200,EDS 204R,A01,507319,Halter; Christopher P.,6,0,30,24
1713306206200,EDS 204R,B01,507331,Heinzman; Erica M.,30,0,30,0
1713306207226,EDS 206R,A00,507332,Staff,8,0,30,22
1713306207226,EDS 206R,B00,507343,Staff,29,0,30,1
1713306208250,EDS 250,A00,507344,Hemans; Patricia Ann Benitez,36,0,40,4
1713306209274,EDS 281,A00,507345,Daly; Alan J.,18,0,18,0
1713306210298,EDS 284,A00,507350,Daly; Alan J.,16,0,16,0
1713306211324,EDS 286,A00,507359,Fine; Sarah,18,0,18,0
1713306212349,EDS 289C,A01,507361,Daly; Alan J.,18,0,18,0
1713306213375,EDS 290,A00,507366,Hofstetter; Carolyn,15,0,15,0
1713306214402,LIGM 5A,A00,507421,Fischer-Grunski; Eva K,20,0,20,0
1713306215433,LIGM 5B,A00,507423,Fischer-Grunski; Eva K,20,0,20,0
1713306216458,LIGM 5C,A00,507425,Fischer-Grunski; Eva K,20,0,20,0
1713306217483,LIIT 5AS,A00,507427,Carnelos; Chiara,20,0,20,0
1713306218514,LIIT 5BS,A00,507430,Carnelos; Chiara,20,0,20,0
1713306219543,LIIT 5CS,A00,507432,Carnelos; Chiara,20,0,20,0
1713306220573,LISP 5A,A00,507541,Munoz Sanchez; Alicia,19,0,20,1
1713306221599,LISP 5B,A00,507671,Munoz Sanchez; Alicia,17,0,20,3
1713306222630,LISP 5C,A00,507696,Munoz Sanchez; Alicia,17,0,20,3
1713306223656,MAE 197,001,528363,Boechler; Nicholas Sebastia,9999,0,9999,0
1713306224688,MATH 197,001,523477,Kedlaya; Kiran S.,9999,0,9999,0
1713306224688,MATH 197,002,563811,Zhang; Danna,9999,0,9999,0
1713306225719,MCWP 40R,A00,518780,Staff,20,0,20,0
1713306225719,MCWP 40R,B00,518781,Staff,20,0,20,0
1713306225719,MCWP 40R,C00,518783,Staff,19,0,20,1
1713306226746,MCWP 50R,A00,518791,Staff,20,0,20,0
1713306226746,MCWP 50R,B00,518792,Staff,19,0,20,1
1713306226746,MCWP 50R,C00,518793,Staff,19,0,20,1
1713306226746,MCWP 50R,D00,518794,Staff,18,0,20,2
1713306226746,MCWP 50R,E00,518795,Staff,18,0,20,2
1713306226746,MCWP 50R,F00,518796,Staff,19,0,20,1
1713306226746,MCWP 50R,G00,518797,Staff,19,0,20,1
1713306227776,MMW 12R,A01,514034,Herbst; Matthew,16,0,16,0
1713306227776,MMW 12R,A02,514035,Herbst; Matthew,16,0,16,0
1713306228802,MMW 13R,A01,514037,Staff,14,0,16,2
1713306228802,MMW 13R,A02,514039,Staff,16,0,16,0
1713306229830,RMED 296,001,626776,Averbach; Sarah Helene,1,0,1,0
1713306230859,SIO 295LS,A00,523233,Staff,19,0,30,11
1713306231883,SIO 295S,A00,523232,Staff,19,0,30,11
1713306232908,SOCI 117,A01,494376,Staff,3,0,5,2
1713306233933,WES 237B,A00,494380,Staff,19,0,20,1
1713306235998,AESE 279B,A00,494370,Wade; Jon P,33,0,33,0
1713306237025,ANAR 135S,A00,494369,Braswell; Geoffrey E.,0,0,0,0
1713306238052,CAT 124RS,A01,519847,Geibel; William,17,0,20,3
1713306239081,CAT 125RS,A01,515971,Geibel; William,17,0,20,3
1713306240106,CLRE 250,A00,511389,Morris; Sheldon,9996,0,9999,3
1713306241132,CLRE 251,A00,507176,Mehta; Ravindra L.,9996,0,9999,3
1713306241132,CLRE 251,B00,511410,Mehta; Ravindra L.,9998,0,9999,1
1713306242158,CLRE 252,A00,507189,Cuomo; Raphael Eduardo,9998,0,9999,1
1713306243184,CLRE 253,A00,507199,Vaida; Florin,9997,0,9999,2
1713306243184,CLRE 253,B00,507202,Vaida; Florin,9999,0,9999,0
1713306244212,CLRE 259,A00,507211,Patel; Hemal,9996,0,9999,3
1713306245239,CLRE 260,A00,507221,Cuomo; Raphael Eduardo,9999,0,9999,0
1713306246263,CLRE 297,001,507242,Cuomo; Raphael Eduardo,9999,0,9999,0
1713306247293,CSE 191,A00,516875,Minnes Kemp; Mor Mia,9999,0,9999,0
1713306248323,CSS 201S,A01,494383,Staff,35,0,35,0
1713306249350,CSS 202S,A01,494387,Staff,35,0,35,0
1713306250377,EAP 100,A00,516065,Staff,9792,0,9999,207
1713306251405,ECE 45,A01,507414,Staff,56,0,60,4
1713306252428,ECE 100,A01,507416,Baghdadchi; Saharnaz,12,0,20,8
1713306252428,ECE 100,A02,507418,Baghdadchi; Saharnaz,20,0,20,0
1713306253454,ECE 111,A01,507420,Staff,40,0,50,10
1713306254480,ECE 197,001,548057,Sievenpiper; Daniel F.,9999,0,9999,0
1713306255509,EDS 115,A00,507243,Choi; Bailey Miyeon,28,0,28,0
1713306256538,EDS 117,A01,494379,Staff,25,0,25,0
1713306257564,EDS 125,A00,507246,Hopkins; Megan Beth,29,0,30,1
1713306258592,EDS 128A,A01,507264,Fargason; Sharon Gayle,26,0,26,0
1713306259622,EDS 128B,A01,507293,Pappas; Elizabeth,30,0,30,0
1713306260651,EDS 139,A00,507294,Fargason; Sharon Gayle,30,0,30,0
1713306260651,EDS 139,B00,507313,Pappas; Elizabeth,30,0,30,0
1713306261677,EDS 201,A00,507315,Staff,26,0,30,4
1713306262702,EDS 203,A01,507317,Halter; Christopher P.,26,0,30,4
1713306263732,EDS 204R,A01,507319,Halter; Christopher P.,6,0,30,24
1713306263732,EDS 204R,B01,507331,Heinzman; Erica M.,30,0,30,0
1713306264761,EDS 206R,A00,507332,Staff,8,0,30,22
1713306264761,EDS 206R,B00,507343,Staff,29,0,30,1
1713306265786,EDS 250,A00,507344,Hemans; Patricia Ann Benitez,36,0,40,4
1713306266809,EDS 281,A00,507345,Daly; Alan J.,18,0,18,0
1713306267834,EDS 284,A00,507350,Daly; Alan J.,16,0,16,0
1713306268860,EDS 286,A00,507359,Fine; Sarah,18,0,18,0
1713306269890,EDS 289C,A01,507361,Daly; Alan J.,18,0,18,0
1713306270921,EDS 290,A00,507366,Hofstetter; Carolyn,15,0,15,0
1713306271956,LIGM 5A,A00,507421,Fischer-Grunski; Eva K,20,0,20,0
1713306272985,LIGM 5B,A00,507423,Fischer-Grunski; Eva K,20,0,20,0
1713306274016,LIGM 5C,A00,507425,Fischer-Grunski; Eva K,20,0,20,0
1713306275044,LIIT 5AS,A00,507427,Carnelos; Chiara,20,0,20,0
1713306276069,LIIT 5BS,A00,507430,Carnelos; Chiara,20,0,20,0
1713306277100,LIIT 5CS,A00,507432,Carnelos; Chiara,20,0,20,0
1713306278127,LISP 5A,A00,507541,Munoz Sanchez; Alicia,19,0,20,1
1713306279162,LISP 5B,A00,507671,Munoz Sanchez; Alicia,17,0,20,3
1713306280187,LISP 5C,A00,507696,Munoz Sanchez; Alicia,17,0,20,3
1713306281215,MAE 197,001,528363,Boechler; Nicholas Sebastia,9999,0,9999,0
1713306282243,MATH 197,001,523477,Kedlaya; Kiran S.,9999,0,9999,0
1713306282243,MATH 197,002,563811,Zhang; Danna,9999,0,9999,0
1713306283268,MCWP 40R,A00,518780,Staff,20,0,20,0
1713306283268,MCWP 40R,B00,518781,Staff,20,0,20,0
1713306283268,MCWP 40R,C00,518783,Staff,19,0,20,1
1713306284295,MCWP 50R,A00,518791,Staff,20,0,20,0
1713306284295,MCWP 50R,B00,518792,Staff,19,0,20,1
1713306284295,MCWP 50R,C00,518793,Staff,19,0,20,1
1713306284295,MCWP 50R,D00,518794,Staff,18,0,20,2
1713306284295,MCWP 50R,E00,518795,Staff,18,0,20,2
1713306284295,MCWP 50R,F00,518796,Staff,19,0,20,1
1713306284295,MCWP 50R,G00,518797,Staff,19,0,20,1
1713306285320,MMW 12R,A01,514034,Herbst; Matthew,16,0,16,0
1713306285320,MMW 12R,A02,514035,Herbst; Matthew,16,0,16,0
1713306286343,MMW 13R,A01,514037,Staff,14,0,16,2
1713306286343,MMW 13R,A02,514039,Staff,16,0,16,0
1713306287370,RMED 296,001,626776,Averbach; Sarah Helene,1,0,1,0
1713306288394,SIO 295LS,A00,523233,Staff,19,0,30,11
1713306289420,SIO 295S,A00,523232,Staff,19,0,30,11
1713306290444,SOCI 117,A01,494376,Staff,3,0,5,2
1713306291469,WES 237B,A00,494380,Staff,19,0,20,1
1713306293541,AESE 279B,A00,494370,Wade; Jon P,33,0,33,0
1713306294569,ANAR 135S,A00,494369,Braswell; Geoffrey E.,0,0,0,0
1713306295598,CAT 124RS,A01,519847,Geibel; William,17,0,20,3
1713306296629,CAT 125RS,A01,515971,Geibel; William,17,0,20,3
1713306297658,CLRE 250,A00,511389,Morris; Sheldon,9996,0,9999,3
1713306298689,CLRE 251,A00,507176,Mehta; Ravindra L.,9996,0,9999,3
1713306298689,CLRE 251,B00,511410,Mehta; Ravindra L.,9998,0,9999,1
1713306299716,CLRE 252,A00,507189,Cuomo; Raphael Eduardo,9998,0,9999,1
1713306300771,CLRE 253,A00,507199,Vaida; Florin,9997,0,9999,2
1713306300771,CLRE 253,B00,507202,Vaida; Florin,9999,0,9999,0
1713306301859,CLRE 259,A00,507211,Patel; Hemal,9996,0,9999,3
1713306302885,CLRE 260,A00,507221,Cuomo; Raphael Eduardo,9999,0,9999,0
1713306303911,CLRE 297,001,507242,Cuomo; Raphael Eduardo,9999,0,9999,0
1713306304937,CSE 191,A00,516875,Minnes Kemp; Mor Mia,9999,0,9999,0
1713306305963,CSS 201S,A01,494383,Staff,35,0,35,0
1713306306993,CSS 202S,A01,494387,Staff,35,0,35,0
1713306308019,EAP 100,A00,516065,Staff,9792,0,9999,207
1713306309044,ECE 45,A01,507414,Staff,56,0,60,4
1713306310071,ECE 100,A01,507416,Baghdadchi; Saharnaz,12,0,20,8
1713306310071,ECE 100,A02,507418,Baghdadchi; Saharnaz,20,0,20,0
1713306311099,ECE 111,A01,507420,Staff,40,0,50,10
1713306312123,ECE 197,001,548057,Sievenpiper; Daniel F.,9999,0,9999,0
1713306313149,EDS 115,A00,507243,Choi; Bailey Miyeon,28,0,28,0
1713306314177,EDS 117,A01,494379,Staff,25,0,25,0
1713306315206,EDS 125,A00,507246,Hopkins; Megan Beth,29,0,30,1
1713306316231,EDS 128A,A01,507264,Fargason; Sharon Gayle,26,0,26,0
1713306317255,EDS 128B,A01,507293,Pappas; Elizabeth,30,0,30,0
1713306318281,EDS 139,A00,507294,Fargason; Sharon Gayle,30,0,30,0
1713306318281,EDS 139,B00,507313,Pappas; Elizabeth,30,0,30,0
1713306319307,EDS 201,A00,507315,Staff,26,0,30,4
1713306320333,EDS 203,A01,507317,Halter; Christopher P.,26,0,30,4
1713306321362,EDS 204R,A01,507319,Halter; Christopher P.,6,0,30,24
1713306321362,EDS 204R,B01,507331,Heinzman; Erica M.,30,0,30,0
1713306322387,EDS 206R,A00,507332,Staff,8,0,30,22
1713306322387,EDS 206R,B00,507343,Staff,29,0,30,1
1713306323416,EDS 250,A00,507344,Hemans; Patricia Ann Benitez,36,0,40,4
1713306324441,EDS 281,A00,507345,Daly; Alan J.,18,0,18,0
1713306325465,EDS 284,A00,507350,Daly; Alan J.,16,0,16,0
1713306326491,EDS 286,A00,507359,Fine; Sarah,18,0,18,0
1713306327516,EDS 289C,A01,507361,Daly; Alan J.,18,0,18,0
1713306328540,EDS 290,A00,507366,Hofstetter; Carolyn,15,0,15,0
1713306329571,LIGM 5A,A00,507421,Fischer-Grunski; Eva K,20,0,20,0
1713306330597,LIGM 5B,A00,507423,Fischer-Grunski; Eva K,20,0,20,0
1713306331622,LIGM 5C,A00,507425,Fischer-Grunski; Eva K,20,0,20,0
1713306332653,LIIT 5AS,A00,507427,Carnelos; Chiara,20,0,20,0
1713306333683,LIIT 5BS,A00,507430,Carnelos; Chiara,20,0,20,0
1713306334711,LIIT 5CS,A00,507432,Carnelos; Chiara,20,0,20,0
1713306335740,LISP 5A,A00,507541,Munoz Sanchez; Alicia,19,0,20,1
1713306336766,LISP 5B,A00,507671,Munoz Sanchez; Alicia,17,0,20,3
1713306337790,LISP 5C,A00,507696,Munoz Sanchez; Alicia,17,0,20,3
1713306338817,MAE 197,001,528363,Boechler; Nicholas Sebastia,9999,0,9999,0
1713306339846,MATH 197,001,523477,Kedlaya; Kiran S.,9999,0,9999,0
1713306339846,MATH 197,002,563811,Zhang; Danna,9999,0,9999,0
1713306340871,MCWP 40R,A00,518780,Staff,20,0,20,0
1713306340871,MCWP 40R,B00,518781,Staff,20,0,20,0
1713306340871,MCWP 40R,C00,518783,Staff,19,0,20,1
1713306341896,MCWP 50R,A00,518791,Staff,20,0,20,0
1713306341896,MCWP 50R,B00,518792,Staff,19,0,20,1
1713306341896,MCWP 50R,C00,518793,Staff,19,0,20,1
1713306341896,MCWP 50R,D00,518794,Staff,18,0,20,2
1713306341896,MCWP 50R,E00,518795,Staff,18,0,20,2
1713306341896,MCWP 50R,F00,518796,Staff,19,0,20,1
1713306341896,MCWP 50R,G00,518797,Staff,19,0,20,1
1713306342926,MMW 12R,A01,514034,Herbst; Matthew,16,0,16,0
1713306342926,MMW 12R,A02,514035,Herbst; Matthew,16,0,16,0
1713306343950,MMW 13R,A01,514037,Staff,14,0,16,2
1713306343950,MMW 13R,A02,514039,Staff,16,0,16,0
1713306344976,RMED 296,001,626776,Averbach; Sarah Helene,1,0,1,0
1713306346002,SIO 295LS,A00,523233,Staff,19,0,30,11
1713306347027,SIO 295S,A00,523232,Staff,19,0,30,11
1713306348053,SOCI 117,A01,494376,Staff,3,0,5,2
1713306349082,WES 237B,A00,494380,Staff,19,0,20,1
1713306351149,AESE 279B,A00,494370,Wade; Jon P,33,0,33,0
1713306352179,ANAR 135S,A00,494369,Braswell; Geoffrey E.,0,0,0,0
1713306353205,CAT 124RS,A01,519847,Geibel; William,17,0,20,3
1713306354233,CAT 125RS,A01,515971,Geibel; William,17,0,20,3
1713306355258,CLRE 250,A00,511389,Morris; Sheldon,9996,0,9999,3
1713306356285,CLRE 251,A00,507176,Mehta; Ravindra L.,9996,0,9999,3
1713306356285,CLRE 251,B00,511410,Mehta; Ravindra L.,9998,0,9999,1
1713306357315,CLRE 252,A00,507189,Cuomo; Raphael Eduardo,9998,0,9999,1
1713306358339,CLRE 253,A00,507199,Vaida; Florin,9997,0,9999,2
1713306358339,CLRE 253,B00,507202,Vaida; Florin,9999,0,9999,0
1713306359367,CLRE 259,A00,507211,Patel; Hemal,9996,0,9999,3
1713306360391,CLRE 260,A00,507221,Cuomo; Raphael Eduardo,9999,0,9999,0
1713306361416,CLRE 297,001,507242,Cuomo; Raphael Eduardo,9999,0,9999,0
1713306362440,CSE 191,A00,516875,Minnes Kemp; Mor Mia,9999,0,9999,0
1713306363470,CSS 201S,A01,494383,Staff,35,0,35,0
1713306364501,CSS 202S,A01,494387,Staff,35,0,35,0
1713306365529,EAP 100,A00,516065,Staff,9792,0,9999,207
1713306366554,ECE 45,A01,507414,Staff,56,0,60,4
1713306367583,ECE 100,A01,507416,Baghdadchi; Saharnaz,12,0,20,8
1713306367583,ECE 100,A02,507418,Baghdadchi; Saharnaz,20,0,20,0
1713306368607,ECE 111,A01,507420,Staff,40,0,50,10
1713306369631,ECE 197,001,548057,Sievenpiper; Daniel F.,9999,0,9999,0
1713306370657,EDS 115,A00,507243,Choi; Bailey Miyeon,28,0,28,0
1713306371682,EDS 117,A01,494379,Staff,25,0,25,0
1713306372707,EDS 125,A00,507246,Hopkins; Megan Beth,29,0,30,1
1713306373733,EDS 128A,A01,507264,Fargason; Sharon Gayle,26,0,26,0
1713306374764,EDS 128B,A01,507293,Pappas; Elizabeth,30,0,30,0
1713306375796,EDS 139,A00,507294,Fargason; Sharon Gayle,30,0,30,0
1713306375796,EDS 139,B00,507313,Pappas; Elizabeth,30,0,30,0
1713306376819,EDS 201,A00,507315,Staff,26,0,30,4
1713306377847,EDS 203,A01,507317,Halter; Christopher P.,26,0,30,4
1713306378875,EDS 204R,A01,507319,Halter; Christopher P.,6,0,30,24
1713306378875,EDS 204R,B01,507331,Heinzman; Erica M.,30,0,30,0
1713306379902,EDS 206R,A00,507332,Staff,8,0,30,22
1713306379902,EDS 206R,B00,507343,Staff,29,0,30,1
1713306380929,EDS 250,A00,507344,Hemans; Patricia Ann Benitez,36,0,40,4
1713306381954,EDS 281,A00,507345,Daly; Alan J.,18,0,18,0
1713306382979,EDS 284,A00,507350,Daly; Alan J.,16,0,16,0
1713306384008,EDS 286,A00,507359,Fine; Sarah,18,0,18,0
1713306385032,EDS 289C,A01,507361,Daly; Alan J.,18,0,18,0
1713306386061,EDS 290,A00,507366,Hofstetter; Carolyn,15,0,15,0
1713306387085,LIGM 5A,A00,507421,Fischer-Grunski; Eva K,20,0,20,0
1713306388110,LIGM 5B,A00,507423,Fischer-Grunski; Eva K,20,0,20,0
1713306389134,LIGM 5C,A00,507425,Fischer-Grunski; Eva K,20,0,20,0
1713306390164,LIIT 5AS,A00,507427,Carnelos; Chiara,20,0,20,0
1713306391188,LIIT 5BS,A00,507430,Carnelos; Chiara,20,0,20,0
1713306392213,LIIT 5CS,A00,507432,Carnelos; Chiara,20,0,20,0
1713306393243,LISP 5A,A00,507541,Munoz Sanchez; Alicia,19,0,20,1
1713306394268,LISP 5B,A00,507671,Munoz Sanchez; Alicia,17,0,20,3
1713306395304,LISP 5C,A00,507696,Munoz Sanchez; Alicia,17,0,20,3
1713306396328,MAE 197,001,528363,Boechler; Nicholas Sebastia,9999,0,9999,0
1713306397355,MATH 197,001,523477,Kedlaya; Kiran S.,9999,0,9999,0
1713306397355,MATH 197,002,563811,Zhang; Danna,9999,0,9999,0
1713306398381,MCWP 40R,A00,518780,Staff,20,0,20,0
1713306398381,MCWP 40R,B00,518781,Staff,20,0,20,0
1713306398381,MCWP 40R,C00,518783,Staff,19,0,20,1
1713306399405,MCWP 50R,A00,518791,Staff,20,0,20,0
1713306399405,MCWP 50R,B00,518792,Staff,19,0,20,1
1713306399405,MCWP 50R,C00,518793,Staff,19,0,20,1
1713306399405,MCWP 50R,D00,518794,Staff,18,0,20,2
1713306399405,MCWP 50R,E00,518795,Staff,18,0,20,2
1713306399405,MCWP 50R,F00,518796,Staff,19,0,20,1
1713306399405,MCWP 50R,G00,518797,Staff,19,0,20,1
1713306400431,MMW 12R,A01,514034,Herbst; Matthew,16,0,16,0
1713306400431,MMW 12R,A02,514035,Herbst; Matthew,16,0,16,0
1713306401457,MMW 13R,A01,514037,Staff,14,0,16,2
1713306401457,MMW 13R,A02,514039,Staff,16,0,16,0
1713306402481,RMED 296,001,626776,Averbach; Sarah Helene,1,0,1,0
1713306403505,SIO 295LS,A00,523233,Staff,19,0,30,11
1713306404531,SIO 295S,A00,523232,Staff,19,0,30,11
1713306405613,SOCI 117,A01,494376,Staff,3,0,5,2
1713306406637,WES 237B,A00,494380,Staff,19,0,20,1
1713306408703,AESE 279B,A00,494370,Wade; Jon P,33,0,33,0
1713306409729,ANAR 135S,A00,494369,Braswell; Geoffrey E.,0,0,0,0
1713306410756,CAT 124RS,A01,519847,Geibel; William,17,0,20,3
1713306411781,CAT 125RS,A01,515971,Geibel; William,17,0,20,3
1713306412807,CLRE 250,A00,511389,Morris; Sheldon,9996,0,9999,3
1713306413834,CLRE 251,A00,507176,Mehta; Ravindra L.,9996,0,9999,3
1713306413834,CLRE 251,B00,511410,Mehta; Ravindra L.,9998,0,9999,1
1713306414860,CLRE 252,A00,507189,Cuomo; Raphael Eduardo,9998,0,9999,1
1713306415886,CLRE 253,A00,507199,Vaida; Florin,9997,0,9999,2
1713306415886,CLRE 253,B00,507202,Vaida; Florin,9999,0,9999,0
1713306416911,CLRE 259,A00,507211,Patel; Hemal,9996,0,9999,3
1713306417937,CLRE 260,A00,507221,Cuomo; Raphael Eduardo,9999,0,9999,0
1713306418962,CLRE 297,001,507242,Cuomo; Raphael Eduardo,9999,0,9999,0
1713306419991,CSE 191,A00,516875,Minnes Kemp; Mor Mia,9999,0,9999,0
1713306421022,CSS 201S,A01,494383,Staff,35,0,35,0
1713306422047,CSS 202S,A01,494387,Staff,35,0,35,0
1713306423071,EAP 100,A00,516065,Staff,9792,0,9999,207
1713306424097,ECE 45,A01,507414,Staff,56,0,60,4
1713306425122,ECE 100,A01,507416,Baghdadchi; Saharnaz,12,0,20,8
1713306425122,ECE 100,A02,507418,Baghdadchi; Saharnaz,20,0,20,0
1713306426149,ECE 111,A01,507420,Staff,40,0,50,10
1713306427174,ECE 197,001,548057,Sievenpiper; Daniel F.,9999,0,9999,0
1713306428198,EDS 115,A00,507243,Choi; Bailey Miyeon,28,0,28,0
1713306429223,EDS 117,A01,494379,Staff,25,0,25,0
1713306430247,EDS 125,A00,507246,Hopkins; Megan Beth,29,0,30,1
1713306431272,EDS 128A,A01,507264,Fargason; Sharon Gayle,26,0,26,0
1713306432301,EDS 128B,A01,507293,Pappas; Elizabeth,30,0,30,0
1713306433329,EDS 139,A00,507294,Fargason; Sharon Gayle,30,0,30,0
1713306433329,EDS 139,B00,507313,Pappas; Elizabeth,30,0,30,0
1713306434354,EDS 201,A00,507315,Staff,26,0,30,4
1713306435383,EDS 203,A01,507317,Halter; Christopher P.,26,0,30,4
1713306436407,EDS 204R,A01,507319,Halter; Christopher P.,6,0,30,24
1713306436407,EDS 204R,B01,507331,Heinzman; Erica M.,30,0,30,0
1713306437431,EDS 206R,A00,507332,Staff,8,0,30,22
1713306437431,EDS 206R,B00,507343,Staff,29,0,30,1
1713306438458,EDS 250,A00,507344,Hemans; Patricia Ann Benitez,36,0,40,4
1713306439483,EDS 281,A00,507345,Daly; Alan J.,18,0,18,0
1713306440508,EDS 284,A00,507350,Daly; Alan J.,16,0,16,0
1713306441532,EDS 286,A00,507359,Fine; Sarah,18,0,18,0
1713306442558,EDS 289C,A01,507361,Daly; Alan J.,18,0,18,0
1713306443588,EDS 290,A00,507366,Hofstetter; Carolyn,15,0,15,0
1713306444620,LIGM 5A,A00,507421,Fischer-Grunski; Eva K,20,0,20,0
1713306445647,LIGM 5B,A00,507423,Fischer-Grunski; Eva K,20,0,20,0
1713306446674,LIGM 5C,A00,507425,Fischer-Grunski; Eva K,20,0,20,0
1713306447703,LIIT 5AS,A00,507427,Carnelos; Chiara,20,0,20,0
1713306448732,LIIT 5BS,A00,507430,Carnelos; Chiara,20,0,20,0
1713306449761,LIIT 5CS,A00,507432,Carnelos; Chiara,20,0,20,0
1713306450787,LISP 5A,A00,507541,Munoz Sanchez; Alicia,19,0,20,1
1713306451811,LISP 5B,A00,507671,Munoz Sanchez; Alicia,17,0,20,3
1713306452836,LISP 5C,A00,507696,Munoz Sanchez; Alicia,17,0,20,3
1713306453871,MAE 197,001,528363,Boechler; Nicholas Sebastia,9999,0,9999,0
1713306454900,MATH 197,001,523477,Kedlaya; Kiran S.,9999,0,9999,0
1713306454900,MATH 197,002,563811,Zhang; Danna,9999,0,9999,0
1713306455925,MCWP 40R,A00,518780,Staff,20,0,20,0
1713306455925,MCWP 40R,B00,518781,Staff,20,0,20,0
1713306455925,MCWP 40R,C00,518783,Staff,19,0,20,1
1713306456955,MCWP 50R,A00,518791,Staff,20,0,20,0
1713306456955,MCWP 50R,B00,518792,Staff,19,0,20,1
1713306456955,MCWP 50R,C00,518793,Staff,19,0,20,1
1713306456955,MCWP 50R,D00,518794,Staff,18,0,20,2
1713306456955,MCWP 50R,E00,518795,Staff,18,0,20,2
1713306456955,MCWP 50R,F00,518796,Staff,19,0,20,1
1713306456955,MCWP 50R,G00,518797,Staff,19,0,20,1
1713306457985,MMW 12R,A01,514034,Herbst; Matthew,16,0,16,0
1713306457985,MMW 12R,A02,514035,Herbst; Matthew,16,0,16,0
1713306459013,MMW 13R,A01,514037,Staff,14,0,16,2
1713306459013,MMW 13R,A02,514039,Staff,16,0,16,0
1713306460038,RMED 296,001,626776,Averbach; Sarah Helene,1,0,1,0
1713306461067,SIO 295LS,A00,523233,Staff,19,0,30,11
1713306462092,SIO 295S,A00,523232,Staff,19,0,30,11
1713306463119,SOCI 117,A01,494376,Staff,3,0,5,2
1713306464144,WES 237B,A00,494380,Staff,19,0,20,1
1713306466214,AESE 279B,A00,494370,Wade; Jon P,33,0,33,0
1713306467240,ANAR 135S,A00,494369,Braswell; Geoffrey E.,0,0,0,0
1713306468264,CAT 124RS,A01,519847,Geibel; William,17,0,20,3
1713306469292,CAT 125RS,A01,515971,Geibel; William,17,0,20,3
1713306470317,CLRE 250,A00,511389,Morris; Sheldon,9996,0,9999,3
1713306471344,CLRE 251,A00,507176,Mehta; Ravindra L.,9996,0,9999,3
1713306471344,CLRE 251,B00,511410,Mehta; Ravindra L.,9998,0,9999,1
1713306472371,CLRE 252,A00,507189,Cuomo; Raphael Eduardo,9998,0,9999,1
1713306473400,CLRE 253,A00,507199,Vaida; Florin,9997,0,9999,2
1713306473400,CLRE 253,B00,507202,Vaida; Florin,9999,0,9999,0
1713306474425,CLRE 259,A00,507211,Patel; Hemal,9996,0,9999,3
1713306475453,CLRE 260,A00,507221,Cuomo; Raphael Eduardo,9999,0,9999,0
1713306476480,CLRE 297,001,507242,Cuomo; Raphael Eduardo,9999,0,9999,0
1713306477508,CSE 191,A00,516875,Minnes Kemp; Mor Mia,9999,0,9999,0
1713306478532,CSS 201S,A01,494383,Staff,35,0,35,0
1713306479560,CSS 202S,A01,494387,Staff,35,0,35,0
1713306480584,EAP 100,A00,516065,Staff,9792,0,9999,207
1713306481612,ECE 45,A01,507414,Staff,56,0,60,4
1713306482642,ECE 100,A01,507416,Baghdadchi; Saharnaz,12,0,20,8
1713306482642,ECE 100,A02,507418,Baghdadchi; Saharnaz,20,0,20,0
1713306483666,ECE 111,A01,507420,Staff,40,0,50,10
1713306484695,ECE 197,001,548057,Sievenpiper; Daniel F.,9999,0,9999,0
1713306485723,EDS 115,A00,507243,Choi; Bailey Miyeon,28,0,28,0
1713306486750,EDS 117,A01,494379,Staff,25,0,25,0
1713306487778,EDS 125,A00,507246,Hopkins; Megan Beth,29,0,30,1
1713306488804,EDS 128A,A01,507264,Fargason; Sharon Gayle,26,0,26,0
1713306489831,EDS 128B,A01,507293,Pappas; Elizabeth,30,0,30,0
1713306490857,EDS 139,A00,507294,Fargason; Sharon Gayle,30,0,30,0
1713306490857,EDS 139,B00,507313,Pappas; Elizabeth,30,0,30,0
1713306491884,EDS 201,A00,507315,Staff,26,0,30,4
1713306492920,EDS 203,A01,507317,Halter; Christopher P.,26,0,30,4
1713306493946,EDS 204R,A01,507319,Halter; Christopher P.,6,0,30,24
1713306493946,EDS 204R,B01,507331,Heinzman; Erica M.,30,0,30,0
1713306494974,EDS 206R,A00,507332,Staff,8,0,30,22
1713306494974,EDS 206R,B00,507343,Staff,29,0,30,1
1713306496013,EDS 250,A00,507344,Hemans; Patricia Ann Benitez,36,0,40,4
1713306497055,EDS 281,A00,507345,Daly; Alan J.,18,0,18,0
1713306498084,EDS 284,A00,507350,Daly; Alan J.,16,0,16,0
1713306499114,EDS 286,A00,507359,Fine; Sarah,18,0,18,0
1713306500139,EDS 289C,A01,507361,Daly; Alan J.,18,0,18,0
1713306501173,EDS 290,A00,507366,Hofstetter; Carolyn,15,0,15,0
1713306502239,LIGM 5A,A00,507421,Fischer-Grunski; Eva K,20,0,20,0
1713306503267,LIGM 5B,A00,507423,Fischer-Grunski; Eva K,20,0,20,0
1713306504290,LIGM 5C,A00,507425,Fischer-Grunski; Eva K,20,0,20,0
1713306505316,LIIT 5AS,A00,507427,Carnelos; Chiara,20,0,20,0
1713306506342,LIIT 5BS,A00,507430,Carnelos; Chiara,20,0,20,0
1713306507367,LIIT 5CS,A00,507432,Carnelos; Chiara,20,0,20,0
1713306508391,LISP 5A,A00,507541,Munoz Sanchez; Alicia,19,0,20,1
1713306509472,LISP 5B,A00,507671,Munoz Sanchez; Alicia,17,0,20,3
1713306510501,LISP 5C,A00,507696,Munoz Sanchez; Alicia,17,0,20,3
1713306511529,MAE 197,001,528363,Boechler; Nicholas Sebastia,9999,0,9999,0
1713306512558,MATH 197,001,523477,Kedlaya; Kiran S.,9999,0,9999,0
1713306512558,MATH 197,002,563811,Zhang; Danna,9999,0,9999,0
1713306513587,MCWP 40R,A00,518780,Staff,20,0,20,0
1713306513587,MCWP 40R,B00,518781,Staff,20,0,20,0
1713306513587,MCWP 40R,C00,518783,Staff,19,0,20,1
1713306514613,MCWP 50R,A00,518791,Staff,20,0,20,0
1713306514613,MCWP 50R,B00,518792,Staff,19,0,20,1
1713306514613,MCWP 50R,C00,518793,Staff,19,0,20,1
1713306514613,MCWP 50R,D00,518794,Staff,18,0,20,2
1713306514613,MCWP 50R,E00,518795,Staff,18,0,20,2
1713306514613,MCWP 50R,F00,518796,Staff,19,0,20,1
1713306514613,MCWP 50R,G00,518797,Staff,19,0,20,1
1713306515638,MMW 12R,A01,514034,Herbst; Matthew,16,0,16,0
1713306515638,MMW 12R,A02,514035,Herbst; Matthew,16,0,16,0
1713306516667,MMW 13R,A01,514037,Staff,14,0,16,2
1713306516667,MMW 13R,A02,514039,Staff,16,0,16,0
1713306517692,RMED 296,001,626776,Averbach; Sarah Helene,1,0,1,0
1713306518724,SIO 295LS,A00,523233,Staff,19,0,30,11
1713306519750,SIO 295S,A00,523232,Staff,19,0,30,11
1713306520777,SOCI 117,A01,494376,Staff,3,0,5,2
1713306521808,WES 237B,A00,494380,Staff,19,0,20,1
1713306523872,AESE 279B,A00,494370,Wade; Jon P,33,0,33,0
1713306524897,ANAR 135S,A00,494369,Braswell; Geoffrey E.,0,0,0,0
1713306525929,CAT 124RS,A01,519847,Geibel; William,17,0,20,3
1713306526953,CAT 125RS,A01,515971,Geibel; William,17,0,20,3
1713306527984,CLRE 250,A00,511389,Morris; Sheldon,9996,0,9999,3
1713306529012,CLRE 251,A00,507176,Mehta; Ravindra L.,9996,0,9999,3
1713306529012,CLRE 251,B00,511410,Mehta; Ravindra L.,9998,0,9999,1
1713306530038,CLRE 252,A00,507189,Cuomo; Raphael Eduardo,9998,0,9999,1
1713306531063,CLRE 253,A00,507199,Vaida; Florin,9997,0,9999,2
1713306531063,CLRE 253,B00,507202,Vaida; Florin,9999,0,9999,0
1713306532088,CLRE 259,A00,507211,Patel; Hemal,9996,0,9999,3
1713306533116,CLRE 260,A00,507221,Cuomo; Raphael Eduardo,9999,0,9999,0
1713306534142,CLRE 297,001,507242,Cuomo; Raphael Eduardo,9999,0,9999,0
1713306535169,CSE 191,A00,516875,Minnes Kemp; Mor Mia,9999,0,9999,0
1713306536195,CSS 201S,A01,494383,Staff,35,0,35,0
1713306537220,CSS 202S,A01,494387,Staff,35,0,35,0
1713306538245,EAP 100,A00,516065,Staff,9792,0,9999,207
1713306539276,ECE 45,A01,507414,Staff,56,0,60,4
1713306540300,ECE 100,A01,507416,Baghdadchi; Saharnaz,12,0,20,8
1713306540300,ECE 100,A02,507418,Baghdadchi; Saharnaz,20,0,20,0
1713306541348,ECE 111,A01,507420,Staff,40,0,50,10
1713306542373,ECE 197,001,548057,Sievenpiper; Daniel F.,9999,0,9999,0
1713306543399,EDS 115,A00,507243,Choi; Bailey Miyeon,28,0,28,0
1713306544429,EDS 117,A01,494379,Staff,25,0,25,0
1713306545455,EDS 125,A00,507246,Hopkins; Megan Beth,29,0,30,1
1713306546483,EDS 128A,A01,507264,Fargason; Sharon Gayle,26,0,26,0
1713306547515,EDS 128B,A01,507293,Pappas; Elizabeth,30,0,30,0
1713306548544,EDS 139,A00,507294,Fargason; Sharon Gayle,30,0,30,0
1713306548544,EDS 139,B00,507313,Pappas; Elizabeth,30,0,30,0
1713306549569,EDS 201,A00,507315,Staff,26,0,30,4
1713306550594,EDS 203,A01,507317,Halter; Christopher P.,26,0,30,4
1713306551624,EDS 204R,A01,507319,Halter; Christopher P.,6,0,30,24
1713306551624,EDS 204R,B01,507331,Heinzman; Erica M.,30,0,30,0
1713306552647,EDS 206R,A00,507332,Staff,8,0,30,22
1713306552647,EDS 206R,B00,507343,Staff,29,0,30,1
1713306553672,EDS 250,A00,507344,Hemans; Patricia Ann Benitez,36,0,40,4
1713306554701,EDS 281,A00,507345,Daly; Alan J.,18,0,18,0
1713306555725,EDS 284,A00,507350,Daly; Alan J.,16,0,16,0
1713306556755,EDS 286,A00,507359,Fine; Sarah,18,0,18,0
1713306557780,EDS 289C,A01,507361,Daly; Alan J.,18,0,18,0
1713306558806,EDS 290,A00,507366,Hofstetter; Carolyn,15,0,15,0
1713306559832,LIGM 5A,A00,507421,Fischer-Grunski; Eva K,20,0,20,0
1713306560858,LIGM 5B,A00,507423,Fischer-Grunski; Eva K,20,0,20,0
1713306561888,LIGM 5C,A00,507425,Fischer-Grunski; Eva K,20,0,20,0
1713306562914,LIIT 5AS,A00,507427,Carnelos; Chiara,20,0,20,0
1713306563941,LIIT 5BS,A00,507430,Carnelos; Chiara,20,0,20,0
1713306564967,LIIT 5CS,A00,507432,Carnelos; Chiara,20,0,20,0
1713306566042,LISP 5A,A00,507541,Munoz Sanchez; Alicia,19,0,20,1
1713306567067,LISP 5B,A00,507671,Munoz Sanchez; Alicia,17,0,20,3
1713306568093,LISP 5C,A00,507696,Munoz Sanchez; Alicia,17,0,20,3
1713306569119,MAE 197,001,528363,Boechler; Nicholas Sebastia,9999,0,9999,0
1713306570145,MATH 197,001,523477,Kedlaya; Kiran S.,9999,0,9999,0
1713306570145,MATH 197,002,563811,Zhang; Danna,9999,0,9999,0
1713306571171,MCWP 40R,A00,518780,Staff,20,0,20,0
1713306571171,MCWP 40R,B00,518781,Staff,20,0,20,0
1713306571171,MCWP 40R,C00,518783,Staff,19,0,20,1
1713306572199,MCWP 50R,A00,518791,Staff,20,0,20,0
1713306572199,MCWP 50R,B00,518792,Staff,19,0,20,1
1713306572199,MCWP 50R,C00,518793,Staff,19,0,20,1
1713306572199,MCWP 50R,D00,518794,Staff,18,0,20,2
1713306572199,MCWP 50R,E00,518795,Staff,18,0,20,2
1713306572199,MCWP 50R,F00,518796,Staff,19,0,20,1
1713306572199,MCWP 50R,G00,518797,Staff,19,0,20,1
1713306573223,MMW 12R,A01,514034,Herbst; Matthew,16,0,16,0
1713306573223,MMW 12R,A02,514035,Herbst; Matthew,16,0,16,0
1713306574253,MMW 13R,A01,514037,Staff,14,0,16,2
1713306574253,MMW 13R,A02,514039,Staff,16,0,16,0
1713306575283,RMED 296,001,626776,Averbach; Sarah Helene,1,0,1,0
1713306576307,SIO 295LS,A00,523233,Staff,19,0,30,11
1713306577332,SIO 295S,A00,523232,Staff,19,0,30,11
1713306578358,SOCI 117,A01,494376,Staff,3,0,5,2
1713306579382,WES 237B,A00,494380,Staff,19,0,20,1
1713306581462,AESE 279B,A00,494370,Wade; Jon P,33,0,33,0
1713306582485,ANAR 135S,A00,494369,Braswell; Geoffrey E.,0,0,0,0
1713306583509,CAT 124RS,A01,519847,Geibel; William,17,0,20,3
1713306584533,CAT 125RS,A01,515971,Geibel; William,17,0,20,3
1713306585562,CLRE 250,A00,511389,Morris; Sheldon,9996,0,9999,3
1713306586592,CLRE 251,A00,507176,Mehta; Ravindra L.,9996,0,9999,3
1713306586592,CLRE 251,B00,511410,Mehta; Ravindra L.,9998,0,9999,1
1713306587617,CLRE 252,A00,507189,Cuomo; Raphael Eduardo,9998,0,9999,1
1713306588645,CLRE 253,A00,507199,Vaida; Florin,9997,0,9999,2
1713306588645,CLRE 253,B00,507202,Vaida; Florin,9999,0,9999,0
1713306589766,CLRE 259,A00,507211,Patel; Hemal,9996,0,9999,3
1713306590792,CLRE 260,A00,507221,Cuomo; Raphael Eduardo,9999,0,9999,0
1713306591824,CLRE 297,001,507242,Cuomo; Raphael Eduardo,9999,0,9999,0
1713306592853,CSE 191,A00,516875,Minnes Kemp; Mor Mia,9999,0,9999,0
1713306593891,CSS 201S,A01,494383,Staff,35,0,35,0
1713306594916,CSS 202S,A01,494387,Staff,35,0,35,0
1713306595940,EAP 100,A00,516065,Staff,9792,0,9999,207
1713306596965,ECE 45,A01,507414,Staff,56,0,60,4
1713306597991,ECE 100,A01,507416,Baghdadchi; Saharnaz,12,0,20,8
1713306597991,ECE 100,A02,507418,Baghdadchi; Saharnaz,20,0,20,0
1713306599018,ECE 111,A01,507420,Staff,40,0,50,10
1713306600043,ECE 197,001,548057,Sievenpiper; Daniel F.,9999,0,9999,0
1713306601068,EDS 115,A00,507243,Choi; Bailey Miyeon,28,0,28,0
1713306602094,EDS 117,A01,494379,Staff,25,0,25,0
1713306603120,EDS 125,A00,507246,Hopkins; Megan Beth,29,0,30,1
1713306604145,EDS 128A,A01,507264,Fargason; Sharon Gayle,26,0,26,0
1713306605172,EDS 128B,A01,507293,Pappas; Elizabeth,30,0,30,0
1713306606197,EDS 139,A00,507294,Fargason; Sharon Gayle,30,0,30,0
1713306606197,EDS 139,B00,507313,Pappas; Elizabeth,30,0,30,0
1713306607226,EDS 201,A00,507315,Staff,26,0,30,4
1713306608255,EDS 203,A01,507317,Halter; Christopher P.,26,0,30,4
1713306609284,EDS 204R,A01,507319,Halter; Christopher P.,6,0,30,24
1713306609284,EDS 204R,B01,507331,Heinzman; Erica M.,30,0,30,0
1713306610309,EDS 206R,A00,507332,Staff,8,0,30,22
1713306610309,EDS 206R,B00,507343,Staff,29,0,30,1
1713306611341,EDS 250,A00,507344,Hemans; Patricia Ann Benitez,36,0,40,4
1713306612365,EDS 281,A00,507345,Daly; Alan J.,18,0,18,0
1713306613447,EDS 284,A00,507350,Daly; Alan J.,16,0,16,0
1713306614472,EDS 286,A00,507359,Fine; Sarah,18,0,18,0
1713306615499,EDS 289C,A01,507361,Daly; Alan J.,18,0,18,0
1713306616524,EDS 290,A00,507366,Hofstetter; Carolyn,15,0,15,0
1713306617549,LIGM 5A,A00,507421,Fischer-Grunski; Eva K,20,0,20,0
1713306618579,LIGM 5B,A00,507423,Fischer-Grunski; Eva K,20,0,20,0
1713306619603,LIGM 5C,A00,507425,Fischer-Grunski; Eva K,20,0,20,0
1713306620629,LIIT 5AS,A00,507427,Carnelos; Chiara,20,0,20,0
1713306621658,LIIT 5BS,A00,507430,Carnelos; Chiara,20,0,20,0
1713306622683,LIIT 5CS,A00,507432,Carnelos; Chiara,20,0,20,0
1713306623713,LISP 5A,A00,507541,Munoz Sanchez; Alicia,19,0,20,1
1713306624738,LISP 5B,A00,507671,Munoz Sanchez; Alicia,17,0,20,3
1713306625766,LISP 5C,A00,507696,Munoz Sanchez; Alicia,17,0,20,3
1713306626793,MAE 197,001,528363,Boechler; Nicholas Sebastia,9999,0,9999,0
1713306627825,MATH 197,001,523477,Kedlaya; Kiran S.,9999,0,9999,0
1713306627825,MATH 197,002,563811,Zhang; Danna,9999,0,9999,0
1713306628854,MCWP 40R,A00,518780,Staff,20,0,20,0
1713306628854,MCWP 40R,B00,518781,Staff,20,0,20,0
1713306628854,MCWP 40R,C00,518783,Staff,19,0,20,1
1713306629884,MCWP 50R,A00,518791,Staff,20,0,20,0
1713306629884,MCWP 50R,B00,518792,Staff,19,0,20,1
1713306629884,MCWP 50R,C00,518793,Staff,19,0,20,1
1713306629884,MCWP 50R,D00,518794,Staff,18,0,20,2
1713306629884,MCWP 50R,E00,518795,Staff,18,0,20,2
1713306629884,MCWP 50R,F00,518796,Staff,19,0,20,1
1713306629884,MCWP 50R,G00,518797,Staff,19,0,20,1
1713306630908,MMW 12R,A01,514034,Herbst; Matthew,16,0,16,0
1713306630908,MMW 12R,A02,514035,Herbst; Matthew,16,0,16,0
1713306631934,MMW 13R,A01,514037,Staff,14,0,16,2
1713306631934,MMW 13R,A02,514039,Staff,16,0,16,0
1713306632963,RMED 296,001,626776,Averbach; Sarah Helene,1,0,1,0
1713306633990,SIO 295LS,A00,523233,Staff,19,0,30,11
1713306635015,SIO 295S,A00,523232,Staff,19,0,30,11
1713306636041,SOCI 117,A01,494376,Staff,3,0,5,2
1713306637063,WES 237B,A00,494380,Staff,19,0,20,1
1713306639120,AESE 279B,A00,494370,Wade; Jon P,33,0,33,0
1713306640145,ANAR 135S,A00,494369,Braswell; Geoffrey E.,0,0,0,0
1713306641171,CAT 124RS,A01,519847,Geibel; William,17,0,20,3
1713306642196,CAT 125RS,A01,515971,Geibel; William,17,0,20,3
1713306643221,CLRE 250,A00,511389,Morris; Sheldon,9996,0,9999,3
1713306644249,CLRE 251,A00,507176,Mehta; Ravindra L.,9996,0,9999,3
1713306644249,CLRE 251,B00,511410,Mehta; Ravindra L.,9998,0,9999,1
1713306645272,CLRE 252,A00,507189,Cuomo; Raphael Eduardo,9998,0,9999,1
1713306646298,CLRE 253,A00,507199,Vaida; Florin,9997,0,9999,2
1713306646298,CLRE 253,B00,507202,Vaida; Florin,9999,0,9999,0
1713306647324,CLRE 259,A00,507211,Patel; Hemal,9996,0,9999,3
1713306648348,CLRE 260,A00,507221,Cuomo; Raphael Eduardo,9999,0,9999,0
1713306649374,CLRE 297,001,507242,Cuomo; Raphael Eduardo,9999,0,9999,0
1713306650407,CSE 191,A00,516875,Minnes Kemp; Mor Mia,9999,0,9999,0
1713306651431,CSS 201S,A01,494383,Staff,35,0,35,0
1713306652459,CSS 202S,A01,494387,Staff,35,0,35,0
1713306653484,EAP 100,A00,516065,Staff,9792,0,9999,207
1713306654512,ECE 45,A01,507414,Staff,56,0,60,4
1713306655540,ECE 100,A01,507416,Baghdadchi; Saharnaz,12,0,20,8
1713306655540,ECE 100,A02,507418,Baghdadchi; Saharnaz,20,0,20,0
1713306656568,ECE 111,A01,507420,Staff,40,0,50,10
1713306657596,ECE 197,001,548057,Sievenpiper; Daniel F.,9999,0,9999,0
1713306658625,EDS 115,A00,507243,Choi; Bailey Miyeon,28,0,28,0
1713306659650,EDS 117,A01,494379,Staff,25,0,25,0
1713306660674,EDS 125,A00,507246,Hopkins; Megan Beth,29,0,30,1
1713306661705,EDS 128A,A01,507264,Fargason; Sharon Gayle,26,0,26,0
1713306662732,EDS 128B,A01,507293,Pappas; Elizabeth,30,0,30,0
1713306663761,EDS 139,A00,507294,Fargason; Sharon Gayle,30,0,30,0
1713306663761,EDS 139,B00,507313,Pappas; Elizabeth,30,0,30,0
1713306664790,EDS 201,A00,507315,Staff,26,0,30,4
1713306665821,EDS 203,A01,507317,Halter; Christopher P.,26,0,30,4
1713306666851,EDS 204R,A01,507319,Halter; Christopher P.,6,0,30,24
1713306666851,EDS 204R,B01,507331,Heinzman; Erica M.,30,0,30,0
1713306667877,EDS 206R,A00,507332,Staff,8,0,30,22
1713306667877,EDS 206R,B00,507343,Staff,29,0,30,1
1713306668902,EDS 250,A00,507344,Hemans; Patricia Ann Benitez,36,0,40,4
1713306669931,EDS 281,A00,507345,Daly; Alan J.,18,0,18,0
1713306670957,EDS 284,A00,507350,Daly; Alan J.,16,0,16,0
1713306671984,EDS 286,A00,507359,Fine; Sarah,18,0,18,0
1713306673013,EDS 289C,A01,507361,Daly; Alan J.,18,0,18,0
1713306674039,EDS 290,A00,507366,Hofstetter; Carolyn,15,0,15,0
1713306675070,LIGM 5A,A00,507421,Fischer-Grunski; Eva K,20,0,20,0
1713306676097,LIGM 5B,A00,507423,Fischer-Grunski; Eva K,20,0,20,0
1713306677122,LIGM 5C,A00,507425,Fischer-Grunski; Eva K,20,0,20,0
1713306678148,LIIT 5AS,A00,507427,Carnelos; Chiara,20,0,20,0
1713306679174,LIIT 5BS,A00,507430,Carnelos; Chiara,20,0,20,0
1713306680199,LIIT 5CS,A00,507432,Carnelos; Chiara,20,0,20,0
1713306681226,LISP 5A,A00,507541,Munoz Sanchez; Alicia,19,0,20,1
1713306682257,LISP 5B,A00,507671,Munoz Sanchez; Alicia,17,0,20,3
1713306683285,LISP 5C,A00,507696,Munoz Sanchez; Alicia,17,0,20,3
1713306684308,MAE 197,001,528363,Boechler; Nicholas Sebastia,9999,0,9999,0
1713306685336,MATH 197,001,523477,Kedlaya; Kiran S.,9999,0,9999,0
1713306685336,MATH 197,002,563811,Zhang; Danna,9999,0,9999,0
1713306686361,MCWP 40R,A00,518780,Staff,20,0,20,0
1713306686361,MCWP 40R,B00,518781,Staff,20,0,20,0
1713306686361,MCWP 40R,C00,518783,Staff,19,0,20,1
1713306687385,MCWP 50R,A00,518791,Staff,20,0,20,0
1713306687385,MCWP 50R,B00,518792,Staff,19,0,20,1
1713306687385,MCWP 50R,C00,518793,Staff,19,0,20,1
1713306687385,MCWP 50R,D00,518794,Staff,18,0,20,2
1713306687385,MCWP 50R,E00,518795,Staff,18,0,20,2
1713306687385,MCWP 50R,F00,518796,Staff,19,0,20,1
1713306687385,MCWP 50R,G00,518797,Staff,19,0,20,1
1713306688414,MMW 12R,A01,514034,Herbst; Matthew,16,0,16,0
1713306688414,MMW 12R,A02,514035,Herbst; Matthew,16,0,16,0
1713306689443,MMW 13R,A01,514037,Staff,14,0,16,2
1713306689443,MMW 13R,A02,514039,Staff,16,0,16,0
1713306690467,RMED 296,001,626776,Averbach; Sarah Helene,1,0,1,0
1713306691493,SIO 295LS,A00,523233,Staff,19,0,30,11
1713306692520,SIO 295S,A00,523232,Staff,19,0,30,11
1713306693545,SOCI 117,A01,494376,Staff,3,0,5,2
1713306694572,WES 237B,A00,494380,Staff,19,0,20,1
1713306696635,AESE 279B,A00,494370,Wade; Jon P,33,0,33,0
1713306697663,ANAR 135S,A00,494369,Braswell; Geoffrey E.,0,0,0,0
1713306698690,CAT 124RS,A01,519847,Geibel; William,17,0,20,3
1713306699713,CAT 125RS,A01,515971,Geibel; William,17,0,20,3
1713306700739,CLRE 250,A00,511389,Morris; Sheldon,9996,0,9999,3
1713306701769,CLRE 251,A00,507176,Mehta; Ravindra L.,9996,0,9999,3
1713306701769,CLRE 251,B00,511410,Mehta; Ravindra L.,9998,0,9999,1
1713306702797,CLRE 252,A00,507189,Cuomo; Raphael Eduardo,9998,0,9999,1
1713306703820,CLRE 253,A00,507199,Vaida; Florin,9997,0,9999,2
1713306703820,CLRE 253,B00,507202,Vaida; Florin,9999,0,9999,0
1713306704843,CLRE 259,A00,507211,Patel; Hemal,9996,0,9999,3
1713306705868,CLRE 260,A00,507221,Cuomo; Raphael Eduardo,9999,0,9999,0
1713306706892,CLRE 297,001,507242,Cuomo; Raphael Eduardo,9999,0,9999,0
1713306707921,CSE 191,A00,516875,Minnes Kemp; Mor Mia,9999,0,9999,0
1713306708950,CSS 201S,A01,494383,Staff,35,0,35,0
1713306709977,CSS 202S,A01,494387,Staff,35,0,35,0
1713306711001,EAP 100,A00,516065,Staff,9792,0,9999,207
1713306712030,ECE 45,A01,507414,Staff,56,0,60,4
1713306713056,ECE 100,A01,507416,Baghdadchi; Saharnaz,12,0,20,8
1713306713056,ECE 100,A02,507418,Baghdadchi; Saharnaz,20,0,20,0
1713306714086,ECE 111,A01,507420,Staff,40,0,50,10
1713306715111,ECE 197,001,548057,Sievenpiper; Daniel F.,9999,0,9999,0
1713306716139,EDS 115,A00,507243,Choi; Bailey Miyeon,28,0,28,0
1713306717221,EDS 117,A01,494379,Staff,25,0,25,0
1713306718248,EDS 125,A00,507246,Hopkins; Megan Beth,29,0,30,1
1713306719276,EDS 128A,A01,507264,Fargason; Sharon Gayle,26,0,26,0
1713306720301,EDS 128B,A01,507293,Pappas; Elizabeth,30,0,30,0
1713306721326,EDS 139,A00,507294,Fargason; Sharon Gayle,30,0,30,0
1713306721326,EDS 139,B00,507313,Pappas; Elizabeth,30,0,30,0
1713306722353,EDS 201,A00,507315,Staff,26,0,30,4
1713306723377,EDS 203,A01,507317,Halter; Christopher P.,26,0,30,4
1713306724403,EDS 204R,A01,507319,Halter; Christopher P.,6,0,30,24
1713306724403,EDS 204R,B01,507331,Heinzman; Erica M.,30,0,30,0
1713306725428,EDS 206R,A00,507332,Staff,8,0,30,22
1713306725428,EDS 206R,B00,507343,Staff,29,0,30,1
1713306726457,EDS 250,A00,507344,Hemans; Patricia Ann Benitez,36,0,40,4
1713306727483,EDS 281,A00,507345,Daly; Alan J.,18,0,18,0
1713306728506,EDS 284,A00,507350,Daly; Alan J.,16,0,16,0
1713306729535,EDS 286,A00,507359,Fine; Sarah,18,0,18,0
1713306730560,EDS 289C,A01,507361,Daly; Alan J.,18,0,18,0
1713306731584,EDS 290,A00,507366,Hofstetter; Carolyn,15,0,15,0
1713306732614,LIGM 5A,A00,507421,Fischer-Grunski; Eva K,20,0,20,0
1713306733638,LIGM 5B,A00,507423,Fischer-Grunski; Eva K,20,0,20,0
1713306734668,LIGM 5C,A00,507425,Fischer-Grunski; Eva K,20,0,20,0
1713306735694,LIIT 5AS,A00,507427,Carnelos; Chiara,20,0,20,0
1713306736723,LIIT 5BS,A00,507430,Carnelos; Chiara,20,0,20,0
1713306737751,LIIT 5CS,A00,507432,Carnelos; Chiara,20,0,20,0
1713306738782,LISP 5A,A00,507541,Munoz Sanchez; Alicia,19,0,20,1
1713306739810,LISP 5B,A00,507671,Munoz Sanchez; Alicia,17,0,20,3
1713306740836,LISP 5C,A00,507696,Munoz Sanchez; Alicia,17,0,20,3
1713306741863,MAE 197,001,528363,Boechler; Nicholas Sebastia,9999,0,9999,0
1713306742892,MATH 197,001,523477,Kedlaya; Kiran S.,9999,0,9999,0
1713306742892,MATH 197,002,563811,Zhang; Danna,9999,0,9999,0
1713306743921,MCWP 40R,A00,518780,Staff,20,0,20,0
1713306743921,MCWP 40R,B00,518781,Staff,20,0,20,0
1713306743921,MCWP 40R,C00,518783,Staff,19,0,20,1
1713306744947,MCWP 50R,A00,518791,Staff,20,0,20,0
1713306744947,MCWP 50R,B00,518792,Staff,19,0,20,1
1713306744947,MCWP 50R,C00,518793,Staff,19,0,20,1
1713306744947,MCWP 50R,D00,518794,Staff,18,0,20,2
1713306744947,MCWP 50R,E00,518795,Staff,18,0,20,2
1713306744947,MCWP 50R,F00,518796,Staff,19,0,20,1
1713306744947,MCWP 50R,G00,518797,Staff,19,0,20,1
1713306745973,MMW 12R,A01,514034,Herbst; Matthew,16,0,16,0
1713306745973,MMW 12R,A02,514035,Herbst; Matthew,16,0,16,0
1713306746999,MMW 13R,A01,514037,Staff,14,0,16,2
1713306746999,MMW 13R,A02,514039,Staff,16,0,16,0
1713306748027,RMED 296,001,626776,Averbach; Sarah Helene,1,0,1,0
1713306749051,SIO 295LS,A00,523233,Staff,19,0,30,11
1713306750079,SIO 295S,A00,523232,Staff,19,0,30,11
1713306751103,SOCI 117,A01,494376,Staff,3,0,5,2
1713306752130,WES 237B,A00,494380,Staff,19,0,20,1
1713306754201,AESE 279B,A00,494370,Wade; Jon P,33,0,33,0
1713306755226,ANAR 135S,A00,494369,Braswell; Geoffrey E.,0,0,0,0
1713306756254,CAT 124RS,A01,519847,Geibel; William,17,0,20,3
1713306757290,CAT 125RS,A01,515971,Geibel; William,17,0,20,3
1713306758319,CLRE 250,A00,511389,Morris; Sheldon,9996,0,9999,3
1713306759345,CLRE 251,A00,507176,Mehta; Ravindra L.,9996,0,9999,3
1713306759345,CLRE 251,B00,511410,Mehta; Ravindra L.,9998,0,9999,1
1713306760372,CLRE 252,A00,507189,Cuomo; Raphael Eduardo,9998,0,9999,1
1713306761401,CLRE 253,A00,507199,Vaida; Florin,9997,0,9999,2
1713306761401,CLRE 253,B00,507202,Vaida; Florin,9999,0,9999,0
1713306762424,CLRE 259,A00,507211,Patel; Hemal,9996,0,9999,3
1713306763450,CLRE 260,A00,507221,Cuomo; Raphael Eduardo,9999,0,9999,0
1713306764473,CLRE 297,001,507242,Cuomo; Raphael Eduardo,9999,0,9999,0
1713306765500,CSE 191,A00,516875,Minnes Kemp; Mor Mia,9999,0,9999,0
1713306766527,CSS 201S,A01,494383,Staff,35,0,35,0
1713306767559,CSS 202S,A01,494387,Staff,35,0,35,0
1713306768587,EAP 100,A00,516065,Staff,9792,0,9999,207
1713306769611,ECE 45,A01,507414,Staff,56,0,60,4
1713306770640,ECE 100,A01,507416,Baghdadchi; Saharnaz,12,0,20,8
1713306770640,ECE 100,A02,507418,Baghdadchi; Saharnaz,20,0,20,0
1713306771670,ECE 111,A01,507420,Staff,40,0,50,10
1713306772695,ECE 197,001,548057,Sievenpiper; Daniel F.,9999,0,9999,0
1713306773731,EDS 115,A00,507243,Choi; Bailey Miyeon,28,0,28,0
1713306774756,EDS 117,A01,494379,Staff,25,0,25,0
1713306775781,EDS 125,A00,507246,Hopkins; Megan Beth,29,0,30,1
1713306776814,EDS 128A,A01,507264,Fargason; Sharon Gayle,26,0,26,0
1713306777842,EDS 128B,A01,507293,Pappas; Elizabeth,30,0,30,0
1713306778867,EDS 139,A00,507294,Fargason; Sharon Gayle,30,0,30,0
1713306778867,EDS 139,B00,507313,Pappas; Elizabeth,30,0,30,0
1713306779896,EDS 201,A00,507315,Staff,26,0,30,4
1713306780922,EDS 203,A01,507317,Halter; Christopher P.,26,0,30,4
1713306781948,EDS 204R,A01,507319,Halter; Christopher P.,6,0,30,24
1713306781948,EDS 204R,B01,507331,Heinzman; Erica M.,30,0,30,0
1713306782976,EDS 206R,A00,507332,Staff,8,0,30,22
1713306782976,EDS 206R,B00,507343,Staff,29,0,30,1
1713306784007,EDS 250,A00,507344,Hemans; Patricia Ann Benitez,36,0,40,4
1713306785031,EDS 281,A00,507345,Daly; Alan J.,18,0,18,0
1713306786056,EDS 284,A00,507350,Daly; Alan J.,16,0,16,0
1713306787083,EDS 286,A00,507359,Fine; Sarah,18,0,18,0
1713306788114,EDS 289C,A01,507361,Daly; Alan J.,18,0,18,0
1713306789139,EDS 290,A00,507366,Hofstetter; Carolyn,15,0,15,0
1713306790165,LIGM 5A,A00,507421,Fischer-Grunski; Eva K,20,0,20,0
1713306791194,LIGM 5B,A00,507423,Fischer-Grunski; Eva K,20,0,20,0
1713306792219,LIGM 5C,A00,507425,Fischer-Grunski; Eva K,20,0,20,0
1713306793244,LIIT 5AS,A00,507427,Carnelos; Chiara,20,0,20,0
1713306794276,LIIT 5BS,A00,507430,Carnelos; Chiara,20,0,20,0
1713306795305,LIIT 5CS,A00,507432,Carnelos; Chiara,20,0,20,0
1713306796333,LISP 5A,A00,507541,Munoz Sanchez; Alicia,19,0,20,1
1713306797363,LISP 5B,A00,507671,Munoz Sanchez; Alicia,17,0,20,3
1713306798391,LISP 5C,A00,507696,Munoz Sanchez; Alicia,17,0,20,3
1713306799414,MAE 197,001,528363,Boechler; Nicholas Sebastia,9999,0,9999,0
1713306800441,MATH 197,001,523477,Kedlaya; Kiran S.,9999,0,9999,0
1713306800441,MATH 197,002,563811,Zhang; Danna,9999,0,9999,0
1713306801465,MCWP 40R,A00,518780,Staff,20,0,20,0
1713306801465,MCWP 40R,B00,518781,Staff,20,0,20,0
1713306801465,MCWP 40R,C00,518783,Staff,19,0,20,1
1713306802490,MCWP 50R,A00,518791,Staff,20,0,20,0
1713306802490,MCWP 50R,B00,518792,Staff,19,0,20,1
1713306802490,MCWP 50R,C00,518793,Staff,19,0,20,1
1713306802490,MCWP 50R,D00,518794,Staff,18,0,20,2
1713306802490,MCWP 50R,E00,518795,Staff,18,0,20,2
1713306802490,MCWP 50R,F00,518796,Staff,19,0,20,1
1713306802490,MCWP 50R,G00,518797,Staff,19,0,20,1
1713306803515,MMW 12R,A01,514034,Herbst; Matthew,16,0,16,0
1713306803515,MMW 12R,A02,514035,Herbst; Matthew,16,0,16,0
1713306804542,MMW 13R,A01,514037,Staff,14,0,16,2
1713306804542,MMW 13R,A02,514039,Staff,16,0,16,0
1713306805567,RMED 296,001,626776,Averbach; Sarah Helene,1,0,1,0
1713306806591,SIO 295LS,A00,523233,Staff,19,0,30,11
1713306807617,SIO 295S,A00,523232,Staff,19,0,30,11
1713306808640,SOCI 117,A01,494376,Staff,3,0,5,2
1713306809665,WES 237B,A00,494380,Staff,19,0,20,1
1713306811751,AESE 279B,A00,494370,Wade; Jon P,33,0,33,0
1713306812777,ANAR 135S,A00,494369,Braswell; Geoffrey E.,0,0,0,0
1713306813806,CAT 124RS,A01,519847,Geibel; William,17,0,20,3
1713306814831,CAT 125RS,A01,515971,Geibel; William,17,0,20,3
1713306815859,CLRE 250,A00,511389,Morris; Sheldon,9996,0,9999,3
1713306816884,CLRE 251,A00,507176,Mehta; Ravindra L.,9996,0,9999,3
1713306816884,CLRE 251,B00,511410,Mehta; Ravindra L.,9998,0,9999,1
1713306817908,CLRE 252,A00,507189,Cuomo; Raphael Eduardo,9998,0,9999,1
1713306818938,CLRE 253,A00,507199,Vaida; Florin,9997,0,9999,2
1713306818938,CLRE 253,B00,507202,Vaida; Florin,9999,0,9999,0
1713306819967,CLRE 259,A00,507211,Patel; Hemal,9996,0,9999,3
1713306821049,CLRE 260,A00,507221,Cuomo; Raphael Eduardo,9999,0,9999,0
1713306822078,CLRE 297,001,507242,Cuomo; Raphael Eduardo,9999,0,9999,0
1713306823103,CSE 191,A00,516875,Minnes Kemp; Mor Mia,9999,0,9999,0
1713306824128,CSS 201S,A01,494383,Staff,35,0,35,0
1713306825156,CSS 202S,A01,494387,Staff,35,0,35,0
1713306826183,EAP 100,A00,516065,Staff,9792,0,9999,207
1713306827219,ECE 45,A01,507414,Staff,56,0,60,4
1713306828244,ECE 100,A01,507416,Baghdadchi; Saharnaz,12,0,20,8
1713306828244,ECE 100,A02,507418,Baghdadchi; Saharnaz,20,0,20,0
1713306829270,ECE 111,A01,507420,Staff,40,0,50,10
1713306830295,ECE 197,001,548057,Sievenpiper; Daniel F.,9999,0,9999,0
1713306831322,EDS 115,A00,507243,Choi; Bailey Miyeon,28,0,28,0
1713306832346,EDS 117,A01,494379,Staff,25,0,25,0
1713306833371,EDS 125,A00,507246,Hopkins; Megan Beth,29,0,30,1
1713306834397,EDS 128A,A01,507264,Fargason; Sharon Gayle,26,0,26,0
1713306835425,EDS 128B,A01,507293,Pappas; Elizabeth,30,0,30,0
1713306836453,EDS 139,A00,507294,Fargason; Sharon Gayle,30,0,30,0
1713306836453,EDS 139,B00,507313,Pappas; Elizabeth,30,0,30,0
1713306837482,EDS 201,A00,507315,Staff,26,0,30,4
1713306838510,EDS 203,A01,507317,Halter; Christopher P.,26,0,30,4
1713306839536,EDS 204R,A01,507319,Halter; Christopher P.,6,0,30,24
1713306839536,EDS 204R,B01,507331,Heinzman; Erica M.,30,0,30,0
1713306840564,EDS 206R,A00,507332,Staff,8,0,30,22
1713306840564,EDS 206R,B00,507343,Staff,29,0,30,1
1713306841599,EDS 250,A00,507344,Hemans; Patricia Ann Benitez,36,0,40,4
1713306842624,EDS 281,A00,507345,Daly; Alan J.,18,0,18,0
1713306843650,EDS 284,A00,507350,Daly; Alan J.,16,0,16,0
1713306844679,EDS 286,A00,507359,Fine; Sarah,18,0,18,0
1713306845708,EDS 289C,A01,507361,Daly; Alan J.,18,0,18,0
1713306846733,EDS 290,A00,507366,Hofstetter; Carolyn,15,0,15,0
1713306847771,LIGM 5A,A00,507421,Fischer-Grunski; Eva K,20,0,20,0
1713306848801,LIGM 5B,A00,507423,Fischer-Grunski; Eva K,20,0,20,0
1713306849850,LIGM 5C,A00,507425,Fischer-Grunski; Eva K,20,0,20,0
1713306850877,LIIT 5AS,A00,507427,Carnelos; Chiara,20,0,20,0
1713306851903,LIIT 5BS,A00,507430,Carnelos; Chiara,20,0,20,0
1713306852927,LIIT 5CS,A00,507432,Carnelos; Chiara,20,0,20,0
1713306853958,LISP 5A,A00,507541,Munoz Sanchez; Alicia,19,0,20,1
1713306854985,LISP 5B,A00,507671,Munoz Sanchez; Alicia,17,0,20,3
1713306856012,LISP 5C,A00,507696,Munoz Sanchez; Alicia,17,0,20,3
1713306857037,MAE 197,001,528363,Boechler; Nicholas Sebastia,9999,0,9999,0
1713306858068,MATH 197,001,523477,Kedlaya; Kiran S.,9999,0,9999,0
1713306858068,MATH 197,002,563811,Zhang; Danna,9999,0,9999,0
1713306859094,MCWP 40R,A00,518780,Staff,20,0,20,0
1713306859094,MCWP 40R,B00,518781,Staff,20,0,20,0
1713306859094,MCWP 40R,C00,518783,Staff,19,0,20,1
1713306860125,MCWP 50R,A00,518791,Staff,20,0,20,0
1713306860125,MCWP 50R,B00,518792,Staff,19,0,20,1
1713306860125,MCWP 50R,C00,518793,Staff,19,0,20,1
1713306860125,MCWP 50R,D00,518794,Staff,18,0,20,2
1713306860125,MCWP 50R,E00,518795,Staff,18,0,20,2
1713306860125,MCWP 50R,F00,518796,Staff,19,0,20,1
1713306860125,MCWP 50R,G00,518797,Staff,19,0,20,1
1713306861151,MMW 12R,A01,514034,Herbst; Matthew,16,0,16,0
1713306861151,MMW 12R,A02,514035,Herbst; Matthew,16,0,16,0
1713306862176,MMW 13R,A01,514037,Staff,14,0,16,2
1713306862176,MMW 13R,A02,514039,Staff,16,0,16,0
1713306863202,RMED 296,001,626776,Averbach; Sarah Helene,1,0,1,0
1713306864232,SIO 295LS,A00,523233,Staff,19,0,30,11
1713306865257,SIO 295S,A00,523232,Staff,19,0,30,11
1713306866282,SOCI 117,A01,494376,Staff,3,0,5,2
1713306867310,WES 237B,A00,494380,Staff,19,0,20,1
1713306869379,AESE 279B,A00,494370,Wade; Jon P,33,0,33,0
1713306870405,ANAR 135S,A00,494369,Braswell; Geoffrey E.,0,0,0,0
1713306871430,CAT 124RS,A01,519847,Geibel; William,17,0,20,3
1713306872459,CAT 125RS,A01,515971,Geibel; William,17,0,20,3
1713306873482,CLRE 250,A00,511389,Morris; Sheldon,9996,0,9999,3
1713306874510,CLRE 251,A00,507176,Mehta; Ravindra L.,9996,0,9999,3
1713306874510,CLRE 251,B00,511410,Mehta; Ravindra L.,9998,0,9999,1
1713306875539,CLRE 252,A00,507189,Cuomo; Raphael Eduardo,9998,0,9999,1
1713306876563,CLRE 253,A00,507199,Vaida; Florin,9997,0,9999,2
1713306876563,CLRE 253,B00,507202,Vaida; Florin,9999,0,9999,0
1713306877586,CLRE 259,A00,507211,Patel; Hemal,9996,0,9999,3
1713306878610,CLRE 260,A00,507221,Cuomo; Raphael Eduardo,9999,0,9999,0
1713306879635,CLRE 297,001,507242,Cuomo; Raphael Eduardo,9999,0,9999,0
1713306880660,CSE 191,A00,516875,Minnes Kemp; Mor Mia,9999,0,9999,0
1713306881687,CSS 201S,A01,494383,Staff,35,0,35,0
1713306882711,CSS 202S,A01,494387,Staff,35,0,35,0
1713306883740,EAP 100,A00,516065,Staff,9792,0,9999,207
1713306884766,ECE 45,A01,507414,Staff,56,0,60,4
1713306885789,ECE 100,A01,507416,Baghdadchi; Saharnaz,12,0,20,8
1713306885789,ECE 100,A02,507418,Baghdadchi; Saharnaz,20,0,20,0
1713306886815,ECE 111,A01,507420,Staff,40,0,50,10
1713306887841,ECE 197,001,548057,Sievenpiper; Daniel F.,9999,0,9999,0
1713306888871,EDS 115,A00,507243,Choi; Bailey Miyeon,28,0,28,0
1713306889900,EDS 117,A01,494379,Staff,25,0,25,0
1713306890925,EDS 125,A00,507246,Hopkins; Megan Beth,29,0,30,1
1713306891950,EDS 128A,A01,507264,Fargason; Sharon Gayle,26,0,26,0
1713306892977,EDS 128B,A01,507293,Pappas; Elizabeth,30,0,30,0
1713306894007,EDS 139,A00,507294,Fargason; Sharon Gayle,30,0,30,0
1713306894007,EDS 139,B00,507313,Pappas; Elizabeth,30,0,30,0
1713306895033,EDS 201,A00,507315,Staff,26,0,30,4
1713306896059,EDS 203,A01,507317,Halter; Christopher P.,26,0,30,4
1713306897085,EDS 204R,A01,507319,Halter; Christopher P.,6,0,30,24
1713306897085,EDS 204R,B01,507331,Heinzman; Erica M.,30,0,30,0
1713306898114,EDS 206R,A00,507332,Staff,8,0,30,22
1713306898114,EDS 206R,B00,507343,Staff,29,0,30,1
1713306899137,EDS 250,A00,507344,Hemans; Patricia Ann Benitez,36,0,40,4
1713306900162,EDS 281,A00,507345,Daly; Alan J.,18,0,18,0
1713306901187,EDS 284,A00,507350,Daly; Alan J.,16,0,16,0
1713306902213,EDS 286,A00,507359,Fine; Sarah,18,0,18,0
1713306903242,EDS 289C,A01,507361,Daly; Alan J.,18,0,18,0
1713306904268,EDS 290,A00,507366,Hofstetter; Carolyn,15,0,15,0
1713306905298,LIGM 5A,A00,507421,Fischer-Grunski; Eva K,20,0,20,0
1713306906327,LIGM 5B,A00,507423,Fischer-Grunski; Eva K,20,0,20,0
1713306907355,LIGM 5C,A00,507425,Fischer-Grunski; Eva K,20,0,20,0
1713306908380,LIIT 5AS,A00,507427,Carnelos; Chiara,20,0,20,0
1713306909409,LIIT 5BS,A00,507430,Carnelos; Chiara,20,0,20,0
1713306910435,LIIT 5CS,A00,507432,Carnelos; Chiara,20,0,20,0
1713306911466,LISP 5A,A00,507541,Munoz Sanchez; Alicia,19,0,20,1
1713306912492,LISP 5B,A00,507671,Munoz Sanchez; Alicia,17,0,20,3
1713306913518,LISP 5C,A00,507696,Munoz Sanchez; Alicia,17,0,20,3
1713306914547,MAE 197,001,528363,Boechler; Nicholas Sebastia,9999,0,9999,0
1713306915579,MATH 197,001,523477,Kedlaya; Kiran S.,9999,0,9999,0
1713306915579,MATH 197,002,563811,Zhang; Danna,9999,0,9999,0
1713306916607,MCWP 40R,A00,518780,Staff,20,0,20,0
1713306916607,MCWP 40R,B00,518781,Staff,20,0,20,0
1713306916607,MCWP 40R,C00,518783,Staff,19,0,20,1
1713306917635,MCWP 50R,A00,518791,Staff,20,0,20,0
1713306917635,MCWP 50R,B00,518792,Staff,19,0,20,1
1713306917635,MCWP 50R,C00,518793,Staff,19,0,20,1
1713306917635,MCWP 50R,D00,518794,Staff,18,0,20,2
1713306917635,MCWP 50R,E00,518795,Staff,18,0,20,2
1713306917635,MCWP 50R,F00,518796,Staff,19,0,20,1
1713306917635,MCWP 50R,G00,518797,Staff,19,0,20,1
1713306918665,MMW 12R,A01,514034,Herbst; Matthew,16,0,16,0
1713306918665,MMW 12R,A02,514035,Herbst; Matthew,16,0,16,0
1713306919690,MMW 13R,A01,514037,Staff,14,0,16,2
1713306919690,MMW 13R,A02,514039,Staff,16,0,16,0
1713306920716,RMED 296,001,626776,Averbach; Sarah Helene,1,0,1,0
1713306921741,SIO 295LS,A00,523233,Staff,19,0,30,11
1713306922769,SIO 295S,A00,523232,Staff,19,0,30,11
1713306923800,SOCI 117,A01,494376,Staff,3,0,5,2
1713306924880,WES 237B,A00,494380,Staff,19,0,20,1
1713306926946,AESE 279B,A00,494370,Wade; Jon P,33,0,33,0
1713306927970,ANAR 135S,A00,494369,Braswell; Geoffrey E.,0,0,0,0
1713306928997,CAT 124RS,A01,519847,Geibel; William,17,0,20,3
1713306930025,CAT 125RS,A01,515971,Geibel; William,17,0,20,3
1713306931057,CLRE 250,A00,511389,Morris; Sheldon,9996,0,9999,3
1713306932091,CLRE 251,A00,507176,Mehta; Ravindra L.,9996,0,9999,3
1713306932091,CLRE 251,B00,511410,Mehta; Ravindra L.,9998,0,9999,1
1713306933120,CLRE 252,A00,507189,Cuomo; Raphael Eduardo,9998,0,9999,1
1713306934148,CLRE 253,A00,507199,Vaida; Florin,9997,0,9999,2
1713306934148,CLRE 253,B00,507202,Vaida; Florin,9999,0,9999,0
1713306935177,CLRE 259,A00,507211,Patel; Hemal,9996,0,9999,3
1713306936202,CLRE 260,A00,507221,Cuomo; Raphael Eduardo,9999,0,9999,0
1713306937229,CLRE 297,001,507242,Cuomo; Raphael Eduardo,9999,0,9999,0
1713306938259,CSE 191,A00,516875,Minnes Kemp; Mor Mia,9999,0,9999,0
1713306939284,CSS 201S,A01,494383,Staff,35,0,35,0
1713306940307,CSS 202S,A01,494387,Staff,35,0,35,0
1713306941332,EAP 100,A00,516065,Staff,9792,0,9999,207
1713306942356,ECE 45,A01,507414,Staff,56,0,60,4
1713306943380,ECE 100,A01,507416,Baghdadchi; Saharnaz,12,0,20,8
1713306943380,ECE 100,A02,507418,Baghdadchi; Saharnaz,20,0,20,0
1713306944408,ECE 111,A01,507420,Staff,40,0,50,10
1713306945432,ECE 197,001,548057,Sievenpiper; Daniel F.,9999,0,9999,0
1713306946456,EDS 115,A00,507243,Choi; Bailey Miyeon,28,0,28,0
1713306947494,EDS 117,A01,494379,Staff,25,0,25,0
1713306948519,EDS 125,A00,507246,Hopkins; Megan Beth,29,0,30,1
1713306949554,EDS 128A,A01,507264,Fargason; Sharon Gayle,26,0,26,0
1713306950580,EDS 128B,A01,507293,Pappas; Elizabeth,30,0,30,0
1713306951612,EDS 139,A00,507294,Fargason; Sharon Gayle,30,0,30,0
1713306951612,EDS 139,B00,507313,Pappas; Elizabeth,30,0,30,0
1713306952636,EDS 201,A00,507315,Staff,26,0,30,4
1713306953663,EDS 203,A01,507317,Halter; Christopher P.,26,0,30,4
1713306954691,EDS 204R,A01,507319,Halter; Christopher P.,6,0,30,24
1713306954691,EDS 204R,B01,507331,Heinzman; Erica M.,30,0,30,0
1713306955717,EDS 206R,A00,507332,Staff,8,0,30,22
1713306955717,EDS 206R,B00,507343,Staff,29,0,30,1
1713306956745,EDS 250,A00,507344,Hemans; Patricia Ann Benitez,36,0,40,4
1713306957770,EDS 281,A00,507345,Daly; Alan J.,18,0,18,0
1713306958794,EDS 284,A00,507350,Daly; Alan J.,16,0,16,0
1713306959822,EDS 286,A00,507359,Fine; Sarah,18,0,18,0
1713306960847,EDS 289C,A01,507361,Daly; Alan J.,18,0,18,0
1713306961881,EDS 290,A00,507366,Hofstetter; Carolyn,15,0,15,0
1713306962909,LIGM 5A,A00,507421,Fischer-Grunski; Eva K,20,0,20,0
1713306963934,LIGM 5B,A00,507423,Fischer-Grunski; Eva K,20,0,20,0
1713306964960,LIGM 5C,A00,507425,Fischer-Grunski; Eva K,20,0,20,0
1713306965998,LIIT 5AS,A00,507427,Carnelos; Chiara,20,0,20,0
1713306967027,LIIT 5BS,A00,507430,Carnelos; Chiara,20,0,20,0
1713306968058,LIIT 5CS,A00,507432,Carnelos; Chiara,20,0,20,0
1713306969084,LISP 5A,A00,507541,Munoz Sanchez; Alicia,19,0,20,1
1713306970116,LISP 5B,A00,507671,Munoz Sanchez; Alicia,17,0,20,3
1713306971149,LISP 5C,A00,507696,Munoz Sanchez; Alicia,17,0,20,3
1713306972184,MAE 197,001,528363,Boechler; Nicholas Sebastia,9999,0,9999,0
1713306973217,MATH 197,001,523477,Kedlaya; Kiran S.,9999,0,9999,0
1713306973217,MATH 197,002,563811,Zhang; Danna,9999,0,9999,0
1713306974242,MCWP 40R,A00,518780,Staff,20,0,20,0
1713306974242,MCWP 40R,B00,518781,Staff,20,0,20,0
1713306974242,MCWP 40R,C00,518783,Staff,19,0,20,1
1713306975267,MCWP 50R,A00,518791,Staff,20,0,20,0
1713306975267,MCWP 50R,B00,518792,Staff,19,0,20,1
1713306975267,MCWP 50R,C00,518793,Staff,19,0,20,1
1713306975267,MCWP 50R,D00,518794,Staff,18,0,20,2
1713306975267,MCWP 50R,E00,518795,Staff,18,0,20,2
1713306975267,MCWP 50R,F00,518796,Staff,19,0,20,1
1713306975267,MCWP 50R,G00,518797,Staff,19,0,20,1
1713306976302,MMW 12R,A01,514034,Herbst; Matthew,16,0,16,0
1713306976302,MMW 12R,A02,514035,Herbst; Matthew,16,0,16,0
1713306977329,MMW 13R,A01,514037,Staff,14,0,16,2
1713306977329,MMW 13R,A02,514039,Staff,16,0,16,0
1713306978355,RMED 296,001,626776,Averbach; Sarah Helene,1,0,1,0
1713306979379,SIO 295LS,A00,523233,Staff,19,0,30,11
1713306980432,SIO 295S,A00,523232,Staff,19,0,30,11
1713306981457,SOCI 117,A01,494376,Staff,3,0,5,2
1713306982487,WES 237B,A00,494380,Staff,19,0,20,1
1713306984567,AESE 279B,A00,494370,Wade; Jon P,33,0,33,0
1713306985592,ANAR 135S,A00,494369,Braswell; Geoffrey E.,0,0,0,0
1713306986617,CAT 124RS,A01,519847,Geibel; William,17,0,20,3
1713306987655,CAT 125RS,A01,515971,Geibel; William,17,0,20,3
1713306988681,CLRE 250,A00,511389,Morris; Sheldon,9996,0,9999,3
1713306989704,CLRE 251,A00,507176,Mehta; Ravindra L.,9996,0,9999,3
1713306989704,CLRE 251,B00,511410,Mehta; Ravindra L.,9998,0,9999,1
1713306990733,CLRE 252,A00,507189,Cuomo; Raphael Eduardo,9998,0,9999,1
1713306991767,CLRE 253,A00,507199,Vaida; Florin,9997,0,9999,2
1713306991767,CLRE 253,B00,507202,Vaida; Florin,9999,0,9999,0
1713306992792,CLRE 259,A00,507211,Patel; Hemal,9996,0,9999,3
1713306993819,CLRE 260,A00,507221,Cuomo; Raphael Eduardo,9999,0,9999,0
1713306994842,CLRE 297,001,507242,Cuomo; Raphael Eduardo,9999,0,9999,0
1713306995869,CSE 191,A00,516875,Minnes Kemp; Mor Mia,9999,0,9999,0
1713306996898,CSS 201S,A01,494383,Staff,35,0,35,0
1713306997924,CSS 202S,A01,494387,Staff,35,0,35,0
1713306998948,EAP 100,A00,516065,Staff,9792,0,9999,207
1713306999975,ECE 45,A01,507414,Staff,56,0,60,4
1713307001001,ECE 100,A01,507416,Baghdadchi; Saharnaz,12,0,20,8
1713307001001,ECE 100,A02,507418,Baghdadchi; Saharnaz,20,0,20,0
1713307002032,ECE 111,A01,507420,Staff,40,0,50,10
1713307003064,ECE 197,001,548057,Sievenpiper; Daniel F.,9999,0,9999,0
1713307004091,EDS 115,A00,507243,Choi; Bailey Miyeon,28,0,28,0
1713307005116,EDS 117,A01,494379,Staff,25,0,25,0
1713307006143,EDS 125,A00,507246,Hopkins; Megan Beth,29,0,30,1
1713307007175,EDS 128A,A01,507264,Fargason; Sharon Gayle,26,0,26,0
1713307008201,EDS 128B,A01,507293,Pappas; Elizabeth,30,0,30,0
1713307009227,EDS 139,A00,507294,Fargason; Sharon Gayle,30,0,30,0
1713307009227,EDS 139,B00,507313,Pappas; Elizabeth,30,0,30,0
1713307010253,EDS 201,A00,507315,Staff,26,0,30,4
1713307011282,EDS 203,A01,507317,Halter; Christopher P.,26,0,30,4
1713307012396,EDS 204R,A01,507319,Halter; Christopher P.,6,0,30,24
1713307012396,EDS 204R,B01,507331,Heinzman; Erica M.,30,0,30,0
1713307013424,EDS 206R,A00,507332,Staff,8,0,30,22
1713307013424,EDS 206R,B00,507343,Staff,29,0,30,1
1713307014451,EDS 250,A00,507344,Hemans; Patricia Ann Benitez,36,0,40,4
1713307015480,EDS 281,A00,507345,Daly; Alan J.,18,0,18,0
1713307016508,EDS 284,A00,507350,Daly; Alan J.,16,0,16,0
1713307017541,EDS 286,A00,507359,Fine; Sarah,18,0,18,0
1713307018567,EDS 289C,A01,507361,Daly; Alan J.,18,0,18,0
1713307019592,EDS 290,A00,507366,Hofstetter; Carolyn,15,0,15,0
1713307020621,LIGM 5A,A00,507421,Fischer-Grunski; Eva K,20,0,20,0
1713307021651,LIGM 5B,A00,507423,Fischer-Grunski; Eva K,20,0,20,0
1713307022676,LIGM 5C,A00,507425,Fischer-Grunski; Eva K,20,0,20,0
1713307023705,LIIT 5AS,A00,507427,Carnelos; Chiara,20,0,20,0
1713307024729,LIIT 5BS,A00,507430,Carnelos; Chiara,20,0,20,0
1713307025753,LIIT 5CS,A00,507432,Carnelos; Chiara,20,0,20,0
1713307026781,LISP 5A,A00,507541,Munoz Sanchez; Alicia,19,0,20,1
1713307027808,LISP 5B,A00,507671,Munoz Sanchez; Alicia,17,0,20,3
1713307028896,LISP 5C,A00,507696,Munoz Sanchez; Alicia,17,0,20,3
1713307029923,MAE 197,001,528363,Boechler; Nicholas Sebastia,9999,0,9999,0
1713307030950,MATH 197,001,523477,Kedlaya; Kiran S.,9999,0,9999,0
1713307030950,MATH 197,002,563811,Zhang; Danna,9999,0,9999,0
1713307031981,MCWP 40R,A00,518780,Staff,20,0,20,0
1713307031981,MCWP 40R,B00,518781,Staff,20,0,20,0
1713307031981,MCWP 40R,C00,518783,Staff,19,0,20,1
1713307033010,MCWP 50R,A00,518791,Staff,20,0,20,0
1713307033010,MCWP 50R,B00,518792,Staff,19,0,20,1
1713307033010,MCWP 50R,C00,518793,Staff,19,0,20,1
1713307033010,MCWP 50R,D00,518794,Staff,18,0,20,2
1713307033010,MCWP 50R,E00,518795,Staff,18,0,20,2
1713307033010,MCWP 50R,F00,518796,Staff,19,0,20,1
1713307033010,MCWP 50R,G00,518797,Staff,19,0,20,1
1713307034040,MMW 12R,A01,514034,Herbst; Matthew,16,0,16,0
1713307034040,MMW 12R,A02,514035,Herbst; Matthew,16,0,16,0
1713307035069,MMW 13R,A01,514037,Staff,14,0,16,2
1713307035069,MMW 13R,A02,514039,Staff,16,0,16,0
1713307036094,RMED 296,001,626776,Averbach; Sarah Helene,1,0,1,0
1713307037124,SIO 295LS,A00,523233,Staff,19,0,30,11
1713307038154,SIO 295S,A00,523232,Staff,19,0,30,11
1713307039180,SOCI 117,A01,494376,Staff,3,0,5,2
1713307040204,WES 237B,A00,494380,Staff,19,0,20,1
1713307042274,AESE 279B,A00,494370,Wade; Jon P,33,0,33,0
1713307043299,ANAR 135S,A00,494369,Braswell; Geoffrey E.,0,0,0,0
1713307044325,CAT 124RS,A01,519847,Geibel; William,17,0,20,3
1713307045349,CAT 125RS,A01,515971,Geibel; William,17,0,20,3
1713307046381,CLRE 250,A00,511389,Morris; Sheldon,9996,0,9999,3
1713307047406,CLRE 251,A00,507176,Mehta; Ravindra L.,9996,0,9999,3
1713307047406,CLRE 251,B00,511410,Mehta; Ravindra L.,9998,0,9999,1
1713307048431,CLRE 252,A00,507189,Cuomo; Raphael Eduardo,9998,0,9999,1
1713307049455,CLRE 253,A00,507199,Vaida; Florin,9997,0,9999,2
1713307049455,CLRE 253,B00,507202,Vaida; Florin,9999,0,9999,0
1713307050479,CLRE 259,A00,507211,Patel; Hemal,9996,0,9999,3
1713307051508,CLRE 260,A00,507221,Cuomo; Raphael Eduardo,9999,0,9999,0
1713307052533,CLRE 297,001,507242,Cuomo; Raphael Eduardo,9999,0,9999,0
1713307053557,CSE 191,A00,516875,Minnes Kemp; Mor Mia,9999,0,9999,0
1713307054582,CSS 201S,A01,494383,Staff,35,0,35,0
1713307055608,CSS 202S,A01,494387,Staff,35,0,35,0
1713307056634,EAP 100,A00,516065,Staff,9792,0,9999,207
1713307057659,ECE 45,A01,507414,Staff,56,0,60,4
1713307058685,ECE 100,A01,507416,Baghdadchi; Saharnaz,12,0,20,8
1713307058685,ECE 100,A02,507418,Baghdadchi; Saharnaz,20,0,20,0
1713307059711,ECE 111,A01,507420,Staff,40,0,50,10
1713307060736,ECE 197,001,548057,Sievenpiper; Daniel F.,9999,0,9999,0
1713307061761,EDS 115,A00,507243,Choi; Bailey Miyeon,28,0,28,0
1713307062785,EDS 117,A01,494379,Staff,25,0,25,0
1713307063809,EDS 125,A00,507246,Hopkins; Megan Beth,29,0,30,1
1713307064835,EDS 128A,A01,507264,Fargason; Sharon Gayle,26,0,26,0
1713307065868,EDS 128B,A01,507293,Pappas; Elizabeth,30,0,30,0
1713307066894,EDS 139,A00,507294,Fargason; Sharon Gayle,30,0,30,0
1713307066894,EDS 139,B00,507313,Pappas; Elizabeth,30,0,30,0
1713307067921,EDS 201,A00,507315,Staff,26,0,30,4
1713307068947,EDS 203,A01,507317,Halter; Christopher P.,26,0,30,4
1713307069985,EDS 204R,A01,507319,Halter; Christopher P.,6,0,30,24
1713307069985,EDS 204R,B01,507331,Heinzman; Erica M.,30,0,30,0
1713307071013,EDS 206R,A00,507332,Staff,8,0,30,22
1713307071013,EDS 206R,B00,507343,Staff,29,0,30,1
1713307072038,EDS 250,A00,507344,Hemans; Patricia Ann Benitez,36,0,40,4
1713307073066,EDS 281,A00,507345,Daly; Alan J.,18,0,18,0
1713307074089,EDS 284,A00,507350,Daly; Alan J.,16,0,16,0
1713307075116,EDS 286,A00,507359,Fine; Sarah,18,0,18,0
1713307076146,EDS 289C,A01,507361,Daly; Alan J.,18,0,18,0
1713307077173,EDS 290,A00,507366,Hofstetter; Carolyn,15,0,15,0
1713307078201,LIGM 5A,A00,507421,Fischer-Grunski; Eva K,20,0,20,0
1713307079231,LIGM 5B,A00,507423,Fischer-Grunski; Eva K,20,0,20,0
1713307080257,LIGM 5C,A00,507425,Fischer-Grunski; Eva K,20,0,20,0
1713307081283,LIIT 5AS,A00,507427,Carnelos; Chiara,20,0,20,0
1713307082308,LIIT 5BS,A00,507430,Carnelos; Chiara,20,0,20,0
1713307083333,LIIT 5CS,A00,507432,Carnelos; Chiara,20,0,20,0
1713307084360,LISP 5A,A00,507541,Munoz Sanchez; Alicia,19,0,20,1
1713307085387,LISP 5B,A00,507671,Munoz Sanchez; Alicia,17,0,20,3
1713307086414,LISP 5C,A00,507696,Munoz Sanchez; Alicia,17,0,20,3
1713307087442,MAE 197,001,528363,Boechler; Nicholas Sebastia,9999,0,9999,0
1713307088479,MATH 197,001,523477,Kedlaya; Kiran S.,9999,0,9999,0
1713307088479,MATH 197,002,563811,Zhang; Danna,9999,0,9999,0
1713307089506,MCWP 40R,A00,518780,Staff,20,0,20,0
1713307089506,MCWP 40R,B00,518781,Staff,20,0,20,0
1713307089506,MCWP 40R,C00,518783,Staff,19,0,20,1
1713307090535,MCWP 50R,A00,518791,Staff,20,0,20,0
1713307090535,MCWP 50R,B00,518792,Staff,19,0,20,1
1713307090535,MCWP 50R,C00,518793,Staff,19,0,20,1
1713307090535,MCWP 50R,D00,518794,Staff,18,0,20,2
1713307090535,MCWP 50R,E00,518795,Staff,18,0,20,2
1713307090535,MCWP 50R,F00,518796,Staff,19,0,20,1
1713307090535,MCWP 50R,G00,518797,Staff,19,0,20,1
1713307091562,MMW 12R,A01,514034,Herbst; Matthew,16,0,16,0
1713307091562,MMW 12R,A02,514035,Herbst; Matthew,16,0,16,0
1713307092593,MMW 13R,A01,514037,Staff,14,0,16,2
1713307092593,MMW 13R,A02,514039,Staff,16,0,16,0
1713307094654,SIO 295LS,A00,523233,Staff,19,0,30,11
1713307095677,SIO 295S,A00,523232,Staff,19,0,30,11
1713307096701,SOCI 117,A01,494376,Staff,3,0,5,2
1713307097729,WES 237B,A00,494380,Staff,19,0,20,1
1713307099805,AESE 279B,A00,494370,Wade; Jon P,33,0,33,0
1713307100832,ANAR 135S,A00,494369,Braswell; Geoffrey E.,0,0,0,0
1713307101859,CAT 124RS,A01,519847,Geibel; William,17,0,20,3
1713307102883,CAT 125RS,A01,515971,Geibel; William,17,0,20,3
1713307103907,CLRE 250,A00,511389,Morris; Sheldon,9996,0,9999,3
1713307104931,CLRE 251,A00,507176,Mehta; Ravindra L.,9996,0,9999,3
1713307104931,CLRE 251,B00,511410,Mehta; Ravindra L.,9998,0,9999,1
1713307105960,CLRE 252,A00,507189,Cuomo; Raphael Eduardo,9998,0,9999,1
1713307106990,CLRE 253,A00,507199,Vaida; Florin,9997,0,9999,2
1713307106990,CLRE 253,B00,507202,Vaida; Florin,9999,0,9999,0
1713307108016,CLRE 259,A00,507211,Patel; Hemal,9996,0,9999,3
1713307109044,CLRE 260,A00,507221,Cuomo; Raphael Eduardo,9999,0,9999,0
1713307110069,CLRE 297,001,507242,Cuomo; Raphael Eduardo,9999,0,9999,0
1713307111094,CSE 191,A00,516875,Minnes Kemp; Mor Mia,9999,0,9999,0
1713307112124,CSS 201S,A01,494383,Staff,35,0,35,0
1713307113155,CSS 202S,A01,494387,Staff,35,0,35,0
1713307114182,EAP 100,A00,516065,Staff,9792,0,9999,207
1713307115207,ECE 45,A01,507414,Staff,56,0,60,4
1713307116235,ECE 100,A01,507416,Baghdadchi; Saharnaz,12,0,20,8
1713307116235,ECE 100,A02,507418,Baghdadchi; Saharnaz,20,0,20,0
1713307117261,ECE 111,A01,507420,Staff,40,0,50,10
1713307118290,ECE 197,001,548057,Sievenpiper; Daniel F.,9999,0,9999,0
1713307119315,EDS 115,A00,507243,Choi; Bailey Miyeon,28,0,28,0
1713307120339,EDS 117,A01,494379,Staff,25,0,25,0
1713307121364,EDS 125,A00,507246,Hopkins; Megan Beth,29,0,30,1
1713307122387,EDS 128A,A01,507264,Fargason; Sharon Gayle,26,0,26,0
1713307123418,EDS 128B,A01,507293,Pappas; Elizabeth,30,0,30,0
1713307124443,EDS 139,A00,507294,Fargason; Sharon Gayle,30,0,30,0
1713307124443,EDS 139,B00,507313,Pappas; Elizabeth,30,0,30,0
1713307125471,EDS 201,A00,507315,Staff,26,0,30,4
1713307126496,EDS 203,A01,507317,Halter; Christopher P.,26,0,30,4
1713307127527,EDS 204R,A01,507319,Halter; Christopher P.,6,0,30,24
1713307127527,EDS 204R,B01,507331,Heinzman; Erica M.,30,0,30,0
1713307128557,EDS 206R,A00,507332,Staff,8,0,30,22
1713307128557,EDS 206R,B00,507343,Staff,29,0,30,1
1713307129587,EDS 250,A00,507344,Hemans; Patricia Ann Benitez,36,0,40,4
1713307130614,EDS 281,A00,507345,Daly; Alan J.,18,0,18,0
1713307131645,EDS 284,A00,507350,Daly; Alan J.,16,0,16,0
1713307132732,EDS 286,A00,507359,Fine; Sarah,18,0,18,0
1713307133760,EDS 289C,A01,507361,Daly; Alan J.,18,0,18,0
1713307134785,EDS 290,A00,507366,Hofstetter; Carolyn,15,0,15,0
1713307135817,LIGM 5A,A00,507421,Fischer-Grunski; Eva K,20,0,20,0
1713307136842,LIGM 5B,A00,507423,Fischer-Grunski; Eva K,20,0,20,0
1713307137870,LIGM 5C,A00,507425,Fischer-Grunski; Eva K,20,0,20,0
1713307138895,LIIT 5AS,A00,507427,Carnelos; Chiara,20,0,20,0
1713307139924,LIIT 5BS,A00,507430,Carnelos; Chiara,20,0,20,0
1713307140949,LIIT 5CS,A00,507432,Carnelos; Chiara,20,0,20,0
1713307141974,LISP 5A,A00,507541,Munoz Sanchez; Alicia,19,0,20,1
1713307143000,LISP 5B,A00,507671,Munoz Sanchez; Alicia,17,0,20,3
1713307144025,LISP 5C,A00,507696,Munoz Sanchez; Alicia,17,0,20,3
1713307145061,MAE 197,001,528363,Boechler; Nicholas Sebastia,9999,0,9999,0
1713307146087,MATH 197,001,523477,Kedlaya; Kiran S.,9999,0,9999,0
1713307146087,MATH 197,002,563811,Zhang; Danna,9999,0,9999,0
1713307147116,MCWP 40R,A00,518780,Staff,20,0,20,0
1713307147116,MCWP 40R,B00,518781,Staff,20,0,20,0
1713307147116,MCWP 40R,C00,518783,Staff,19,0,20,1
1713307148141,MCWP 50R,A00,518791,Staff,20,0,20,0
1713307148141,MCWP 50R,B00,518792,Staff,19,0,20,1
1713307148141,MCWP 50R,C00,518793,Staff,19,0,20,1
1713307148141,MCWP 50R,D00,518794,Staff,18,0,20,2
1713307148141,MCWP 50R,E00,518795,Staff,18,0,20,2
1713307148141,MCWP 50R,F00,518796,Staff,19,0,20,1
1713307148141,MCWP 50R,G00,518797,Staff,19,0,20,1
1713307149169,MMW 12R,A01,514034,Herbst; Matthew,16,0,16,0
1713307149169,MMW 12R,A02,514035,Herbst; Matthew,16,0,16,0
1713307150195,MMW 13R,A01,514037,Staff,14,0,16,2
1713307150195,MMW 13R,A02,514039,Staff,16,0,16,0
1713307152255,SIO 295LS,A00,523233,Staff,19,0,30,11
1713307153285,SIO 295S,A00,523232,Staff,19,0,30,11
1713307154312,SOCI 117,A01,494376,Staff,3,0,5,2
1713307155341,WES 237B,A00,494380,Staff,19,0,20,1
1713307157410,AESE 279B,A00,494370,Wade; Jon P,33,0,33,0
1713307158434,ANAR 135S,A00,494369,Braswell; Geoffrey E.,0,0,0,0
1713307159459,CAT 124RS,A01,519847,Geibel; William,17,0,20,3
1713307160487,CAT 125RS,A01,515971,Geibel; William,17,0,20,3
1713307161511,CLRE 250,A00,511389,Morris; Sheldon,9996,0,9999,3
1713307162544,CLRE 251,A00,507176,Mehta; Ravindra L.,9996,0,9999,3
1713307162544,CLRE 251,B00,511410,Mehta; Ravindra L.,9998,0,9999,1
1713307163573,CLRE 252,A00,507189,Cuomo; Raphael Eduardo,9998,0,9999,1
1713307164603,CLRE 253,A00,507199,Vaida; Florin,9997,0,9999,2
1713307164603,CLRE 253,B00,507202,Vaida; Florin,9999,0,9999,0
1713307165632,CLRE 259,A00,507211,Patel; Hemal,9996,0,9999,3
1713307166657,CLRE 260,A00,507221,Cuomo; Raphael Eduardo,9999,0,9999,0
1713307167684,CLRE 297,001,507242,Cuomo; Raphael Eduardo,9999,0,9999,0
1713307168711,CSE 191,A00,516875,Minnes Kemp; Mor Mia,9999,0,9999,0
1713307169741,CSS 201S,A01,494383,Staff,35,0,35,0
1713307170767,CSS 202S,A01,494387,Staff,35,0,35,0
1713307171793,EAP 100,A00,516065,Staff,9792,0,9999,207
1713307172821,ECE 45,A01,507414,Staff,56,0,60,4
1713307173860,ECE 100,A01,507416,Baghdadchi; Saharnaz,12,0,20,8
1713307173860,ECE 100,A02,507418,Baghdadchi; Saharnaz,20,0,20,0
1713307174888,ECE 111,A01,507420,Staff,40,0,50,10
1713307175916,ECE 197,001,548057,Sievenpiper; Daniel F.,9999,0,9999,0
1713307176943,EDS 115,A00,507243,Choi; Bailey Miyeon,28,0,28,0
1713307177968,EDS 117,A01,494379,Staff,25,0,25,0
1713307178993,EDS 125,A00,507246,Hopkins; Megan Beth,29,0,30,1
1713307180025,EDS 128A,A01,507264,Fargason; Sharon Gayle,26,0,26,0
1713307181051,EDS 128B,A01,507293,Pappas; Elizabeth,30,0,30,0
1713307182075,EDS 139,A00,507294,Fargason; Sharon Gayle,30,0,30,0
1713307182075,EDS 139,B00,507313,Pappas; Elizabeth,30,0,30,0
1713307183102,EDS 201,A00,507315,Staff,26,0,30,4
1713307184133,EDS 203,A01,507317,Halter; Christopher P.,26,0,30,4
1713307185163,EDS 204R,A01,507319,Halter; Christopher P.,6,0,30,24
1713307185163,EDS 204R,B01,507331,Heinzman; Erica M.,30,0,30,0
1713307186189,EDS 206R,A00,507332,Staff,8,0,30,22
1713307186189,EDS 206R,B00,507343,Staff,29,0,30,1
1713307187219,EDS 250,A00,507344,Hemans; Patricia Ann Benitez,36,0,40,4
1713307188247,EDS 281,A00,507345,Daly; Alan J.,18,0,18,0
1713307189272,EDS 284,A00,507350,Daly; Alan J.,16,0,16,0
1713307190301,EDS 286,A00,507359,Fine; Sarah,18,0,18,0
1713307191327,EDS 289C,A01,507361,Daly; Alan J.,18,0,18,0
1713307192356,EDS 290,A00,507366,Hofstetter; Carolyn,15,0,15,0
1713307193385,LIGM 5A,A00,507421,Fischer-Grunski; Eva K,20,0,20,0
1713307194410,LIGM 5B,A00,507423,Fischer-Grunski; Eva K,20,0,20,0
1713307195439,LIGM 5C,A00,507425,Fischer-Grunski; Eva K,20,0,20,0
1713307196466,LIIT 5AS,A00,507427,Carnelos; Chiara,20,0,20,0
1713307197490,LIIT 5BS,A00,507430,Carnelos; Chiara,20,0,20,0
1713307198515,LIIT 5CS,A00,507432,Carnelos; Chiara,20,0,20,0
1713307199542,LISP 5A,A00,507541,Munoz Sanchez; Alicia,19,0,20,1
1713307200568,LISP 5B,A00,507671,Munoz Sanchez; Alicia,17,0,20,3
1713307201594,LISP 5C,A00,507696,Munoz Sanchez; Alicia,17,0,20,3
1713307202620,MAE 197,001,528363,Boechler; Nicholas Sebastia,9999,0,9999,0
1713307203645,MATH 197,001,523477,Kedlaya; Kiran S.,9999,0,9999,0
1713307203645,MATH 197,002,563811,Zhang; Danna,9999,0,9999,0
1713307204669,MCWP 40R,A00,518780,Staff,20,0,20,0
1713307204669,MCWP 40R,B00,518781,Staff,20,0,20,0
1713307204669,MCWP 40R,C00,518783,Staff,19,0,20,1
1713307205695,MCWP 50R,A00,518791,Staff,20,0,20,0
1713307205695,MCWP 50R,B00,518792,Staff,19,0,20,1
1713307205695,MCWP 50R,C00,518793,Staff,19,0,20,1
1713307205695,MCWP 50R,D00,518794,Staff,18,0,20,2
1713307205695,MCWP 50R,E00,518795,Staff,18,0,20,2
1713307205695,MCWP 50R,F00,518796,Staff,19,0,20,1
1713307205695,MCWP 50R,G00,518797,Staff,19,0,20,1
1713307206721,MMW 12R,A01,514034,Herbst; Matthew,16,0,16,0
1713307206721,MMW 12R,A02,514035,Herbst; Matthew,16,0,16,0
1713307207746,MMW 13R,A01,514037,Staff,14,0,16,2
1713307207746,MMW 13R,A02,514039,Staff,16,0,16,0
1713307209801,SIO 295LS,A00,523233,Staff,19,0,30,11
1713307210827,SIO 295S,A00,523232,Staff,19,0,30,11
1713307211854,SOCI 117,A01,494376,Staff,3,0,5,2
1713307212879,WES 237B,A00,494380,Staff,19,0,20,1
1713307214946,AESE 279B,A00,494370,Wade; Jon P,33,0,33,0
1713307215971,ANAR 135S,A00,494369,Braswell; Geoffrey E.,0,0,0,0
1713307217000,CAT 124RS,A01,519847,Geibel; William,17,0,20,3
1713307218025,CAT 125RS,A01,515971,Geibel; William,17,0,20,3
1713307219053,CLRE 250,A00,511389,Morris; Sheldon,9996,0,9999,3
1713307220085,CLRE 251,A00,507176,Mehta; Ravindra L.,9996,0,9999,3
1713307220085,CLRE 251,B00,511410,Mehta; Ravindra L.,9998,0,9999,1
1713307221111,CLRE 252,A00,507189,Cuomo; Raphael Eduardo,9998,0,9999,1
1713307222137,CLRE 253,A00,507199,Vaida; Florin,9997,0,9999,2
1713307222137,CLRE 253,B00,507202,Vaida; Florin,9999,0,9999,0
1713307223162,CLRE 259,A00,507211,Patel; Hemal,9996,0,9999,3
1713307224188,CLRE 260,A00,507221,Cuomo; Raphael Eduardo,9999,0,9999,0
1713307225212,CLRE 297,001,507242,Cuomo; Raphael Eduardo,9999,0,9999,0
1713307226236,CSE 191,A00,516875,Minnes Kemp; Mor Mia,9999,0,9999,0
1713307227260,CSS 201S,A01,494383,Staff,35,0,35,0
1713307228285,CSS 202S,A01,494387,Staff,35,0,35,0
1713307229311,EAP 100,A00,516065,Staff,9792,0,9999,207
1713307230339,ECE 45,A01,507414,Staff,56,0,60,4
1713307231368,ECE 100,A01,507416,Baghdadchi; Saharnaz,12,0,20,8
1713307231368,ECE 100,A02,507418,Baghdadchi; Saharnaz,20,0,20,0
1713307232393,ECE 111,A01,507420,Staff,40,0,50,10
1713307233419,ECE 197,001,548057,Sievenpiper; Daniel F.,9999,0,9999,0
1713307234446,EDS 115,A00,507243,Choi; Bailey Miyeon,28,0,28,0
1713307235475,EDS 117,A01,494379,Staff,25,0,25,0
1713307236560,EDS 125,A00,507246,Hopkins; Megan Beth,29,0,30,1
1713307237587,EDS 128A,A01,507264,Fargason; Sharon Gayle,26,0,26,0
1713307238612,EDS 128B,A01,507293,Pappas; Elizabeth,30,0,30,0
1713307239640,EDS 139,A00,507294,Fargason; Sharon Gayle,30,0,30,0
1713307239640,EDS 139,B00,507313,Pappas; Elizabeth,30,0,30,0
1713307240666,EDS 201,A00,507315,Staff,26,0,30,4
1713307241693,EDS 203,A01,507317,Halter; Christopher P.,26,0,30,4
1713307242717,EDS 204R,A01,507319,Halter; Christopher P.,6,0,30,24
1713307242717,EDS 204R,B01,507331,Heinzman; Erica M.,30,0,30,0
1713307243745,EDS 206R,A00,507332,Staff,8,0,30,22
1713307243745,EDS 206R,B00,507343,Staff,29,0,30,1
1713307244774,EDS 250,A00,507344,Hemans; Patricia Ann Benitez,36,0,40,4
1713307245805,EDS 281,A00,507345,Daly; Alan J.,18,0,18,0
1713307246829,EDS 284,A00,507350,Daly; Alan J.,16,0,16,0
1713307247855,EDS 286,A00,507359,Fine; Sarah,18,0,18,0
1713307248882,EDS 289C,A01,507361,Daly; Alan J.,18,0,18,0
1713307249907,EDS 290,A00,507366,Hofstetter; Carolyn,15,0,15,0
1713307250937,LIGM 5A,A00,507421,Fischer-Grunski; Eva K,20,0,20,0
1713307252084,LIGM 5B,A00,507423,Fischer-Grunski; Eva K,20,0,20,0
1713307253113,LIGM 5C,A00,507425,Fischer-Grunski; Eva K,20,0,20,0
1713307254146,LIIT 5AS,A00,507427,Carnelos; Chiara,20,0,20,0
1713307255178,LIIT 5BS,A00,507430,Carnelos; Chiara,20,0,20,0
1713307256207,LIIT 5CS,A00,507432,Carnelos; Chiara,20,0,20,0
1713307257238,LISP 5A,A00,507541,Munoz Sanchez; Alicia,19,0,20,1
1713307258268,LISP 5B,A00,507671,Munoz Sanchez; Alicia,17,0,20,3
1713307259292,LISP 5C,A00,507696,Munoz Sanchez; Alicia,17,0,20,3
1713307260317,MAE 197,001,528363,Boechler; Nicholas Sebastia,9999,0,9999,0
1713307261343,MATH 197,001,523477,Kedlaya; Kiran S.,9999,0,9999,0
1713307261343,MATH 197,002,563811,Zhang; Danna,9999,0,9999,0
1713307262369,MCWP 40R,A00,518780,Staff,20,0,20,0
1713307262369,MCWP 40R,B00,518781,Staff,20,0,20,0
1713307262369,MCWP 40R,C00,518783,Staff,19,0,20,1
1713307263401,MCWP 50R,A00,518791,Staff,20,0,20,0
1713307263401,MCWP 50R,B00,518792,Staff,19,0,20,1
1713307263401,MCWP 50R,C00,518793,Staff,19,0,20,1
1713307263401,MCWP 50R,D00,518794,Staff,18,0,20,2
1713307263401,MCWP 50R,E00,518795,Staff,18,0,20,2
1713307263401,MCWP 50R,F00,518796,Staff,19,0,20,1
1713307263401,MCWP 50R,G00,518797,Staff,19,0,20,1
1713307264427,MMW 12R,A01,514034,Herbst; Matthew,16,0,16,0
1713307264427,MMW 12R,A02,514035,Herbst; Matthew,16,0,16,0
1713307265454,MMW 13R,A01,514037,Staff,14,0,16,2
1713307265454,MMW 13R,A02,514039,Staff,16,0,16,0
1713307267510,SIO 295LS,A00,523233,Staff,19,0,30,11
1713307268535,SIO 295S,A00,523232,Staff,19,0,30,11
1713307269560,SOCI 117,A01,494376,Staff,3,0,5,2
1713307270585,WES 237B,A00,494380,Staff,19,0,20,1
1713307272649,AESE 279B,A00,494370,Wade; Jon P,33,0,33,0
1713307273677,ANAR 135S,A00,494369,Braswell; Geoffrey E.,0,0,0,0
1713307274709,CAT 124RS,A01,519847,Geibel; William,17,0,20,3
1713307275736,CAT 125RS,A01,515971,Geibel; William,17,0,20,3
1713307276762,CLRE 250,A00,511389,Morris; Sheldon,9996,0,9999,3
1713307277793,CLRE 251,A00,507176,Mehta; Ravindra L.,9996,0,9999,3
1713307277793,CLRE 251,B00,511410,Mehta; Ravindra L.,9998,0,9999,1
1713307278822,CLRE 252,A00,507189,Cuomo; Raphael Eduardo,9998,0,9999,1
1713307279853,CLRE 253,A00,507199,Vaida; Florin,9997,0,9999,2
1713307279853,CLRE 253,B00,507202,Vaida; Florin,9999,0,9999,0
1713307280878,CLRE 259,A00,507211,Patel; Hemal,9996,0,9999,3
1713307281902,CLRE 260,A00,507221,Cuomo; Raphael Eduardo,9999,0,9999,0
1713307282930,CLRE 297,001,507242,Cuomo; Raphael Eduardo,9999,0,9999,0
1713307283957,CSE 191,A00,516875,Minnes Kemp; Mor Mia,9999,0,9999,0
1713307284983,CSS 201S,A01,494383,Staff,35,0,35,0
1713307286008,CSS 202S,A01,494387,Staff,35,0,35,0
1713307287036,EAP 100,A00,516065,Staff,9792,0,9999,207
1713307288061,ECE 45,A01,507414,Staff,56,0,60,4
1713307289085,ECE 100,A01,507416,Baghdadchi; Saharnaz,12,0,20,8
1713307289085,ECE 100,A02,507418,Baghdadchi; Saharnaz,20,0,20,0
1713307290112,ECE 111,A01,507420,Staff,40,0,50,10
1713307291137,ECE 197,001,548057,Sievenpiper; Daniel F.,9999,0,9999,0
1713307292166,EDS 115,A00,507243,Choi; Bailey Miyeon,28,0,28,0
1713307293195,EDS 117,A01,494379,Staff,25,0,25,0
1713307294224,EDS 125,A00,507246,Hopkins; Megan Beth,29,0,30,1
1713307295249,EDS 128A,A01,507264,Fargason; Sharon Gayle,26,0,26,0
1713307296276,EDS 128B,A01,507293,Pappas; Elizabeth,30,0,30,0
1713307297301,EDS 139,A00,507294,Fargason; Sharon Gayle,30,0,30,0
1713307297301,EDS 139,B00,507313,Pappas; Elizabeth,30,0,30,0
1713307298325,EDS 201,A00,507315,Staff,26,0,30,4
1713307299356,EDS 203,A01,507317,Halter; Christopher P.,26,0,30,4
1713307300381,EDS 204R,A01,507319,Halter; Christopher P.,6,0,30,24
1713307300381,EDS 204R,B01,507331,Heinzman; Erica M.,30,0,30,0
1713307301406,EDS 206R,A00,507332,Staff,8,0,30,22
1713307301406,EDS 206R,B00,507343,Staff,29,0,30,1
1713307302430,EDS 250,A00,507344,Hemans; Patricia Ann Benitez,36,0,40,4
1713307303455,EDS 281,A00,507345,Daly; Alan J.,18,0,18,0
1713307304484,EDS 284,A00,507350,Daly; Alan J.,16,0,16,0
1713307305510,EDS 286,A00,507359,Fine; Sarah,18,0,18,0
1713307306537,EDS 289C,A01,507361,Daly; Alan J.,18,0,18,0
1713307307563,EDS 290,A00,507366,Hofstetter; Carolyn,15,0,15,0
1713307308589,LIGM 5A,A00,507421,Fischer-Grunski; Eva K,20,0,20,0
1713307309619,LIGM 5B,A00,507423,Fischer-Grunski; Eva K,20,0,20,0
1713307310643,LIGM 5C,A00,507425,Fischer-Grunski; Eva K,20,0,20,0
1713307311673,LIIT 5AS,A00,507427,Carnelos; Chiara,20,0,20,0
1713307312706,LIIT 5BS,A00,507430,Carnelos; Chiara,20,0,20,0
1713307313732,LIIT 5CS,A00,507432,Carnelos; Chiara,20,0,20,0
1713307314758,LISP 5A,A00,507541,Munoz Sanchez; Alicia,19,0,20,1
1713307315786,LISP 5B,A00,507671,Munoz Sanchez; Alicia,17,0,20,3
1713307316811,LISP 5C,A00,507696,Munoz Sanchez; Alicia,17,0,20,3
1713307317837,MAE 197,001,528363,Boechler; Nicholas Sebastia,9998,0,9999,1
1713307318868,MATH 197,001,523477,Kedlaya; Kiran S.,9999,0,9999,0
1713307318868,MATH 197,002,563811,Zhang; Danna,9999,0,9999,0
1713307319893,MCWP 40R,A00,518780,Staff,20,0,20,0
1713307319893,MCWP 40R,B00,518781,Staff,20,0,20,0
1713307319893,MCWP 40R,C00,518783,Staff,19,0,20,1
1713307320926,MCWP 50R,A00,518791,Staff,20,0,20,0
1713307320926,MCWP 50R,B00,518792,Staff,19,0,20,1
1713307320926,MCWP 50R,C00,518793,Staff,19,0,20,1
1713307320926,MCWP 50R,D00,518794,Staff,18,0,20,2
1713307320926,MCWP 50R,E00,518795,Staff,18,0,20,2
1713307320926,MCWP 50R,F00,518796,Staff,19,0,20,1
1713307320926,MCWP 50R,G00,518797,Staff,19,0,20,1
1713307321953,MMW 12R,A01,514034,Herbst; Matthew,16,0,16,0
1713307321953,MMW 12R,A02,514035,Herbst; Matthew,16,0,16,0
1713307322979,MMW 13R,A01,514037,Staff,14,0,16,2
1713307322979,MMW 13R,A02,514039,Staff,16,0,16,0
1713307325036,SIO 295LS,A00,523233,Staff,19,0,30,11
1713307326065,SIO 295S,A00,523232,Staff,19,0,30,11
1713307327088,SOCI 117,A01,494376,Staff,3,0,5,2
1713307328117,WES 237B,A00,494380,Staff,19,0,20,1
1713307330181,AESE 279B,A00,494370,Wade; Jon P,33,0,33,0
1713307331206,ANAR 135S,A00,494369,Braswell; Geoffrey E.,0,0,0,0
1713307332237,CAT 124RS,A01,519847,Geibel; William,17,0,20,3
1713307333262,CAT 125RS,A01,515971,Geibel; William,17,0,20,3
1713307334301,CLRE 250,A00,511389,Morris; Sheldon,9996,0,9999,3
1713307335330,CLRE 251,A00,507176,Mehta; Ravindra L.,9996,0,9999,3
1713307335330,CLRE 251,B00,511410,Mehta; Ravindra L.,9998,0,9999,1
1713307336355,CLRE 252,A00,507189,Cuomo; Raphael Eduardo,9998,0,9999,1
1713307337384,CLRE 253,A00,507199,Vaida; Florin,9997,0,9999,2
1713307337384,CLRE 253,B00,507202,Vaida; Florin,9999,0,9999,0
1713307338411,CLRE 259,A00,507211,Patel; Hemal,9996,0,9999,3
1713307339437,CLRE 260,A00,507221,Cuomo; Raphael Eduardo,9999,0,9999,0
1713307340517,CLRE 297,001,507242,Cuomo; Raphael Eduardo,9999,0,9999,0
1713307341546,CSE 191,A00,516875,Minnes Kemp; Mor Mia,9999,0,9999,0
1713307342713,CSS 201S,A01,494383,Staff,35,0,35,0
1713307343738,CSS 202S,A01,494387,Staff,35,0,35,0
1713307344764,EAP 100,A00,516065,Staff,9792,0,9999,207
1713307345787,ECE 45,A01,507414,Staff,56,0,60,4
1713307346812,ECE 100,A01,507416,Baghdadchi; Saharnaz,12,0,20,8
1713307346812,ECE 100,A02,507418,Baghdadchi; Saharnaz,20,0,20,0
1713307347837,ECE 111,A01,507420,Staff,40,0,50,10
1713307348862,ECE 197,001,548057,Sievenpiper; Daniel F.,9999,0,9999,0
1713307349889,EDS 115,A00,507243,Choi; Bailey Miyeon,28,0,28,0
1713307350919,EDS 117,A01,494379,Staff,25,0,25,0
1713307351950,EDS 125,A00,507246,Hopkins; Megan Beth,29,0,30,1
1713307352976,EDS 128A,A01,507264,Fargason; Sharon Gayle,26,0,26,0
1713307354001,EDS 128B,A01,507293,Pappas; Elizabeth,30,0,30,0
1713307355027,EDS 139,A00,507294,Fargason; Sharon Gayle,30,0,30,0
1713307355027,EDS 139,B00,507313,Pappas; Elizabeth,30,0,30,0
1713307356060,EDS 201,A00,507315,Staff,26,0,30,4
1713307357086,EDS 203,A01,507317,Halter; Christopher P.,26,0,30,4
1713307358118,EDS 204R,A01,507319,Halter; Christopher P.,6,0,30,24
1713307358118,EDS 204R,B01,507331,Heinzman; Erica M.,30,0,30,0
1713307359146,EDS 206R,A00,507332,Staff,8,0,30,22
1713307359146,EDS 206R,B00,507343,Staff,29,0,30,1
1713307360171,EDS 250,A00,507344,Hemans; Patricia Ann Benitez,36,0,40,4
1713307361199,EDS 281,A00,507345,Daly; Alan J.,18,0,18,0
1713307362229,EDS 284,A00,507350,Daly; Alan J.,16,0,16,0
1713307363256,EDS 286,A00,507359,Fine; Sarah,18,0,18,0
1713307364284,EDS 289C,A01,507361,Daly; Alan J.,18,0,18,0
1713307365313,EDS 290,A00,507366,Hofstetter; Carolyn,15,0,15,0
1713307366340,LIGM 5A,A00,507421,Fischer-Grunski; Eva K,20,0,20,0
1713307367365,LIGM 5B,A00,507423,Fischer-Grunski; Eva K,20,0,20,0
1713307368390,LIGM 5C,A00,507425,Fischer-Grunski; Eva K,20,0,20,0
1713307369415,LIIT 5AS,A00,507427,Carnelos; Chiara,20,0,20,0
1713307370440,LIIT 5BS,A00,507430,Carnelos; Chiara,20,0,20,0
1713307371465,LIIT 5CS,A00,507432,Carnelos; Chiara,20,0,20,0
1713307372491,LISP 5A,A00,507541,Munoz Sanchez; Alicia,19,0,20,1
1713307373516,LISP 5B,A00,507671,Munoz Sanchez; Alicia,17,0,20,3
1713307374541,LISP 5C,A00,507696,Munoz Sanchez; Alicia,17,0,20,3
1713307375566,MAE 197,001,528363,Boechler; Nicholas Sebastia,9998,0,9999,1
1713307376593,MATH 197,001,523477,Kedlaya; Kiran S.,9999,0,9999,0
1713307376593,MATH 197,002,563811,Zhang; Danna,9999,0,9999,0
1713307377620,MCWP 40R,A00,518780,Staff,20,0,20,0
1713307377620,MCWP 40R,B00,518781,Staff,20,0,20,0
1713307377620,MCWP 40R,C00,518783,Staff,19,0,20,1
1713307378646,MCWP 50R,A00,518791,Staff,20,0,20,0
1713307378646,MCWP 50R,B00,518792,Staff,19,0,20,1
1713307378646,MCWP 50R,C00,518793,Staff,19,0,20,1
1713307378646,MCWP 50R,D00,518794,Staff,18,0,20,2
1713307378646,MCWP 50R,E00,518795,Staff,18,0,20,2
1713307378646,MCWP 50R,F00,518796,Staff,19,0,20,1
1713307378646,MCWP 50R,G00,518797,Staff,19,0,20,1
1713307379672,MMW 12R,A01,514034,Herbst; Matthew,16,0,16,0
1713307379672,MMW 12R,A02,514035,Herbst; Matthew,16,0,16,0
1713307380696,MMW 13R,A01,514037,Staff,14,0,16,2
1713307380696,MMW 13R,A02,514039,Staff,16,0,16,0
1713307382750,SIO 295LS,A00,523233,Staff,19,0,30,11
1713307383778,SIO 295S,A00,523232,Staff,19,0,30,11
1713307384803,SOCI 117,A01,494376,Staff,3,0,5,2
1713307385831,WES 237B,A00,494380,Staff,19,0,20,1
1713307387899,AESE 279B,A00,494370,Wade; Jon P,33,0,33,0
1713307388922,ANAR 135S,A00,494369,Braswell; Geoffrey E.,0,0,0,0
1713307389952,CAT 124RS,A01,519847,Geibel; William,17,0,20,3
1713307390977,CAT 125RS,A01,515971,Geibel; William,17,0,20,3
1713307392005,CLRE 250,A00,511389,Morris; Sheldon,9996,0,9999,3
1713307393031,CLRE 251,A00,507176,Mehta; Ravindra L.,9996,0,9999,3
1713307393031,CLRE 251,B00,511410,Mehta; Ravindra L.,9998,0,9999,1
1713307394059,CLRE 252,A00,507189,Cuomo; Raphael Eduardo,9998,0,9999,1
1713307395085,CLRE 253,A00,507199,Vaida; Florin,9997,0,9999,2
1713307395085,CLRE 253,B00,507202,Vaida; Florin,9999,0,9999,0
1713307396110,CLRE 259,A00,507211,Patel; Hemal,9996,0,9999,3
1713307397137,CLRE 260,A00,507221,Cuomo; Raphael Eduardo,9999,0,9999,0
1713307398163,CLRE 297,001,507242,Cuomo; Raphael Eduardo,9999,0,9999,0
1713307399189,CSE 191,A00,516875,Minnes Kemp; Mor Mia,9999,0,9999,0
1713307400217,CSS 201S,A01,494383,Staff,35,0,35,0
1713307401243,CSS 202S,A01,494387,Staff,35,0,35,0
1713307402269,EAP 100,A00,516065,Staff,9792,0,9999,207
1713307403299,ECE 45,A01,507414,Staff,56,0,60,4
1713307404328,ECE 100,A01,507416,Baghdadchi; Saharnaz,12,0,20,8
1713307404328,ECE 100,A02,507418,Baghdadchi; Saharnaz,20,0,20,0
1713307405356,ECE 111,A01,507420,Staff,40,0,50,10
1713307406383,ECE 197,001,548057,Sievenpiper; Daniel F.,9998,0,9999,1
1713307407410,EDS 115,A00,507243,Choi; Bailey Miyeon,28,0,28,0
1713307408438,EDS 117,A01,494379,Staff,25,0,25,0
1713307409465,EDS 125,A00,507246,Hopkins; Megan Beth,29,0,30,1
1713307410490,EDS 128A,A01,507264,Fargason; Sharon Gayle,26,0,26,0
1713307411515,EDS 128B,A01,507293,Pappas; Elizabeth,30,0,30,0
1713307412539,EDS 139,A00,507294,Fargason; Sharon Gayle,30,0,30,0
1713307412539,EDS 139,B00,507313,Pappas; Elizabeth,30,0,30,0
1713307413565,EDS 201,A00,507315,Staff,26,0,30,4
1713307414589,EDS 203,A01,507317,Halter; Christopher P.,26,0,30,4
1713307415614,EDS 204R,A01,507319,Halter; Christopher P.,6,0,30,24
1713307415614,EDS 204R,B01,507331,Heinzman; Erica M.,30,0,30,0
1713307416643,EDS 206R,A00,507332,Staff,8,0,30,22
1713307416643,EDS 206R,B00,507343,Staff,29,0,30,1
1713307417670,EDS 250,A00,507344,Hemans; Patricia Ann Benitez,36,0,40,4
1713307418700,EDS 281,A00,507345,Daly; Alan J.,18,0,18,0
1713307419725,EDS 284,A00,507350,Daly; Alan J.,16,0,16,0
1713307420749,EDS 286,A00,507359,Fine; Sarah,18,0,18,0
1713307421779,EDS 289C,A01,507361,Daly; Alan J.,18,0,18,0
1713307422820,EDS 290,A00,507366,Hofstetter; Carolyn,15,0,15,0
1713307423860,LIGM 5A,A00,507421,Fischer-Grunski; Eva K,20,0,20,0
1713307424886,LIGM 5B,A00,507423,Fischer-Grunski; Eva K,20,0,20,0
1713307425912,LIGM 5C,A00,507425,Fischer-Grunski; Eva K,20,0,20,0
1713307426943,LIIT 5AS,A00,507427,Carnelos; Chiara,20,0,20,0
1713307427967,LIIT 5BS,A00,507430,Carnelos; Chiara,20,0,20,0
1713307429001,LIIT 5CS,A00,507432,Carnelos; Chiara,20,0,20,0
1713307430028,LISP 5A,A00,507541,Munoz Sanchez; Alicia,19,0,20,1
1713307431059,LISP 5B,A00,507671,Munoz Sanchez; Alicia,17,0,20,3
1713307432084,LISP 5C,A00,507696,Munoz Sanchez; Alicia,17,0,20,3
1713307433109,MAE 197,001,528363,Boechler; Nicholas Sebastia,9998,0,9999,1
1713307434140,MATH 197,001,523477,Kedlaya; Kiran S.,9999,0,9999,0
1713307434140,MATH 197,002,563811,Zhang; Danna,9999,0,9999,0
1713307435170,MCWP 40R,A00,518780,Staff,20,0,20,0
1713307435170,MCWP 40R,B00,518781,Staff,20,0,20,0
1713307435170,MCWP 40R,C00,518783,Staff,19,0,20,1
1713307436194,MCWP 50R,A00,518791,Staff,20,0,20,0
1713307436194,MCWP 50R,B00,518792,Staff,19,0,20,1
1713307436194,MCWP 50R,C00,518793,Staff,19,0,20,1
1713307436194,MCWP 50R,D00,518794,Staff,18,0,20,2
1713307436194,MCWP 50R,E00,518795,Staff,18,0,20,2
1713307436194,MCWP 50R,F00,518796,Staff,19,0,20,1
1713307436194,MCWP 50R,G00,518797,Staff,19,0,20,1
1713307437222,MMW 12R,A01,514034,Herbst; Matthew,16,0,16,0
1713307437222,MMW 12R,A02,514035,Herbst; Matthew,16,0,16,0
1713307438249,MMW 13R,A01,514037,Staff,14,0,16,2
1713307438249,MMW 13R,A02,514039,Staff,16,0,16,0
1713307440298,SIO 295LS,A00,523233,Staff,19,0,30,11
1713307441325,SIO 295S,A00,523232,Staff,19,0,30,11
1713307442350,SOCI 117,A01,494376,Staff,3,0,5,2
1713307443373,WES 237B,A00,494380,Staff,19,0,20,1
1713307445488,AESE 279B,A00,494370,Wade; Jon P,33,0,33,0
1713307446512,ANAR 135S,A00,494369,Braswell; Geoffrey E.,0,0,0,0
1713307447537,CAT 124RS,A01,519847,Geibel; William,17,0,20,3
1713307448565,CAT 125RS,A01,515971,Geibel; William,17,0,20,3
1713307449593,CLRE 250,A00,511389,Morris; Sheldon,9996,0,9999,3
1713307450620,CLRE 251,A00,507176,Mehta; Ravindra L.,9996,0,9999,3
1713307450620,CLRE 251,B00,511410,Mehta; Ravindra L.,9998,0,9999,1
1713307451649,CLRE 252,A00,507189,Cuomo; Raphael Eduardo,9998,0,9999,1
1713307452674,CLRE 253,A00,507199,Vaida; Florin,9997,0,9999,2
1713307452674,CLRE 253,B00,507202,Vaida; Florin,9999,0,9999,0
1713307453698,CLRE 259,A00,507211,Patel; Hemal,9996,0,9999,3
1713307454726,CLRE 260,A00,507221,Cuomo; Raphael Eduardo,9999,0,9999,0
1713307455752,CLRE 297,001,507242,Cuomo; Raphael Eduardo,9999,0,9999,0
1713307456903,CSE 191,A00,516875,Minnes Kemp; Mor Mia,9999,0,9999,0
1713307457933,CSS 201S,A01,494383,Staff,35,0,35,0
1713307458960,CSS 202S,A01,494387,Staff,35,0,35,0
1713307459986,EAP 100,A00,516065,Staff,9792,0,9999,207
1713307461015,ECE 45,A01,507414,Staff,56,0,60,4
1713307462041,ECE 100,A01,507416,Baghdadchi; Saharnaz,12,0,20,8
1713307462041,ECE 100,A02,507418,Baghdadchi; Saharnaz,20,0,20,0
1713307463066,ECE 111,A01,507420,Staff,40,0,50,10
1713307464091,ECE 197,001,548057,Sievenpiper; Daniel F.,9998,0,9999,1
1713307465118,EDS 115,A00,507243,Choi; Bailey Miyeon,28,0,28,0
1713307466142,EDS 117,A01,494379,Staff,25,0,25,0
1713307467167,EDS 125,A00,507246,Hopkins; Megan Beth,29,0,30,1
1713307468191,EDS 128A,A01,507264,Fargason; Sharon Gayle,26,0,26,0
1713307469217,EDS 128B,A01,507293,Pappas; Elizabeth,30,0,30,0
1713307470247,EDS 139,A00,507294,Fargason; Sharon Gayle,30,0,30,0
1713307470247,EDS 139,B00,507313,Pappas; Elizabeth,30,0,30,0
1713307471272,EDS 201,A00,507315,Staff,26,0,30,4
1713307472299,EDS 203,A01,507317,Halter; Christopher P.,26,0,30,4
1713307473323,EDS 204R,A01,507319,Halter; Christopher P.,6,0,30,24
1713307473323,EDS 204R,B01,507331,Heinzman; Erica M.,30,0,30,0
1713307474346,EDS 206R,A00,507332,Staff,8,0,30,22
1713307474346,EDS 206R,B00,507343,Staff,29,0,30,1
1713307475371,EDS 250,A00,507344,Hemans; Patricia Ann Benitez,36,0,40,4
1713307476396,EDS 281,A00,507345,Daly; Alan J.,18,0,18,0
1713307477419,EDS 284,A00,507350,Daly; Alan J.,16,0,16,0
1713307478447,EDS 286,A00,507359,Fine; Sarah,18,0,18,0
1713307479471,EDS 289C,A01,507361,Daly; Alan J.,18,0,18,0
1713307480499,EDS 290,A00,507366,Hofstetter; Carolyn,15,0,15,0
1713307481530,LIGM 5A,A00,507421,Fischer-Grunski; Eva K,20,0,20,0
1713307482556,LIGM 5B,A00,507423,Fischer-Grunski; Eva K,20,0,20,0
1713307483581,LIGM 5C,A00,507425,Fischer-Grunski; Eva K,20,0,20,0
1713307484607,LIIT 5AS,A00,507427,Carnelos; Chiara,20,0,20,0
1713307485637,LIIT 5BS,A00,507430,Carnelos; Chiara,20,0,20,0
1713307486818,LIIT 5CS,A00,507432,Carnelos; Chiara,20,0,20,0
1713307487844,LISP 5A,A00,507541,Munoz Sanchez; Alicia,19,0,20,1
1713307488875,LISP 5B,A00,507671,Munoz Sanchez; Alicia,17,0,20,3
1713307489905,LISP 5C,A00,507696,Munoz Sanchez; Alicia,17,0,20,3
1713307490932,MAE 197,001,528363,Boechler; Nicholas Sebastia,9998,0,9999,1
1713307491959,MATH 197,001,523477,Kedlaya; Kiran S.,9999,0,9999,0
1713307491959,MATH 197,002,563811,Zhang; Danna,9999,0,9999,0
1713307492987,MCWP 40R,A00,518780,Staff,20,0,20,0
1713307492987,MCWP 40R,B00,518781,Staff,20,0,20,0
1713307492987,MCWP 40R,C00,518783,Staff,19,0,20,1
1713307494014,MCWP 50R,A00,518791,Staff,20,0,20,0
1713307494014,MCWP 50R,B00,518792,Staff,19,0,20,1
1713307494014,MCWP 50R,C00,518793,Staff,19,0,20,1
1713307494014,MCWP 50R,D00,518794,Staff,18,0,20,2
1713307494014,MCWP 50R,E00,518795,Staff,18,0,20,2
1713307494014,MCWP 50R,F00,518796,Staff,19,0,20,1
1713307494014,MCWP 50R,G00,518797,Staff,19,0,20,1
1713307495042,MMW 12R,A01,514034,Herbst; Matthew,16,0,16,0
1713307495042,MMW 12R,A02,514035,Herbst; Matthew,16,0,16,0
1713307496069,MMW 13R,A01,514037,Staff,14,0,16,2
1713307496069,MMW 13R,A02,514039,Staff,16,0,16,0
1713307498123,SIO 295LS,A00,523233,Staff,19,0,30,11
1713307499149,SIO 295S,A00,523232,Staff,19,0,30,11
1713307500173,SOCI 117,A01,494376,Staff,3,0,5,2
1713307501201,WES 237B,A00,494380,Staff,19,0,20,1
1713307503264,AESE 279B,A00,494370,Wade; Jon P,33,0,33,0
1713307504296,ANAR 135S,A00,494369,Braswell; Geoffrey E.,0,0,0,0
1713307505321,CAT 124RS,A01,519847,Geibel; William,17,0,20,3
1713307506347,CAT 125RS,A01,515971,Geibel; William,17,0,20,3
1713307507378,CLRE 250,A00,511389,Morris; Sheldon,9996,0,9999,3
1713307508406,CLRE 251,A00,507176,Mehta; Ravindra L.,9996,0,9999,3
1713307508406,CLRE 251,B00,511410,Mehta; Ravindra L.,9998,0,9999,1
1713307509440,CLRE 252,A00,507189,Cuomo; Raphael Eduardo,9998,0,9999,1
1713307510472,CLRE 253,A00,507199,Vaida; Florin,9997,0,9999,2
1713307510472,CLRE 253,B00,507202,Vaida; Florin,9999,0,9999,0
1713307511500,CLRE 259,A00,507211,Patel; Hemal,9996,0,9999,3
1713307512525,CLRE 260,A00,507221,Cuomo; Raphael Eduardo,9999,0,9999,0
1713307513557,CLRE 297,001,507242,Cuomo; Raphael Eduardo,9999,0,9999,0
1713307514582,CSE 191,A00,516875,Minnes Kemp; Mor Mia,9999,0,9999,0
1713307515608,CSS 201S,A01,494383,Staff,35,0,35,0
1713307516632,CSS 202S,A01,494387,Staff,35,0,35,0
1713307517659,EAP 100,A00,516065,Staff,9792,0,9999,207
1713307518684,ECE 45,A01,507414,Staff,56,0,60,4
1713307519715,ECE 100,A01,507416,Baghdadchi; Saharnaz,12,0,20,8
1713307519715,ECE 100,A02,507418,Baghdadchi; Saharnaz,20,0,20,0
1713307520740,ECE 111,A01,507420,Staff,40,0,50,10
1713307521768,ECE 197,001,548057,Sievenpiper; Daniel F.,9998,0,9999,1
1713307522795,EDS 115,A00,507243,Choi; Bailey Miyeon,28,0,28,0
1713307523825,EDS 117,A01,494379,Staff,25,0,25,0
1713307524855,EDS 125,A00,507246,Hopkins; Megan Beth,29,0,30,1
1713307525885,EDS 128A,A01,507264,Fargason; Sharon Gayle,26,0,26,0
1713307526909,EDS 128B,A01,507293,Pappas; Elizabeth,30,0,30,0
1713307527939,EDS 139,A00,507294,Fargason; Sharon Gayle,30,0,30,0
1713307527939,EDS 139,B00,507313,Pappas; Elizabeth,30,0,30,0
1713307528963,EDS 201,A00,507315,Staff,26,0,30,4
1713307529990,EDS 203,A01,507317,Halter; Christopher P.,26,0,30,4
1713307531014,EDS 204R,A01,507319,Halter; Christopher P.,6,0,30,24
1713307531014,EDS 204R,B01,507331,Heinzman; Erica M.,30,0,30,0
1713307532040,EDS 206R,A00,507332,Staff,8,0,30,22
1713307532040,EDS 206R,B00,507343,Staff,29,0,30,1
1713307533064,EDS 250,A00,507344,Hemans; Patricia Ann Benitez,36,0,40,4
1713307534093,EDS 281,A00,507345,Daly; Alan J.,18,0,18,0
1713307535118,EDS 284,A00,507350,Daly; Alan J.,16,0,16,0
1713307536144,EDS 286,A00,507359,Fine; Sarah,18,0,18,0
1713307537194,EDS 289C,A01,507361,Daly; Alan J.,18,0,18,0
1713307538223,EDS 290,A00,507366,Hofstetter; Carolyn,15,0,15,0
1713307539252,LIGM 5A,A00,507421,Fischer-Grunski; Eva K,20,0,20,0
1713307540279,LIGM 5B,A00,507423,Fischer-Grunski; Eva K,20,0,20,0
1713307541307,LIGM 5C,A00,507425,Fischer-Grunski; Eva K,20,0,20,0
1713307542334,LIIT 5AS,A00,507427,Carnelos; Chiara,20,0,20,0
1713307543358,LIIT 5BS,A00,507430,Carnelos; Chiara,20,0,20,0
1713307544388,LIIT 5CS,A00,507432,Carnelos; Chiara,20,0,20,0
1713307545413,LISP 5A,A00,507541,Munoz Sanchez; Alicia,19,0,20,1
1713307546439,LISP 5B,A00,507671,Munoz Sanchez; Alicia,17,0,20,3
1713307547473,LISP 5C,A00,507696,Munoz Sanchez; Alicia,17,0,20,3
1713307548553,MAE 197,001,528363,Boechler; Nicholas Sebastia,9998,0,9999,1
1713307549578,MATH 197,001,523477,Kedlaya; Kiran S.,9999,0,9999,0
1713307549578,MATH 197,002,563811,Zhang; Danna,9999,0,9999,0
1713307550606,MCWP 40R,A00,518780,Staff,20,0,20,0
1713307550606,MCWP 40R,B00,518781,Staff,20,0,20,0
1713307550606,MCWP 40R,C00,518783,Staff,19,0,20,1
1713307551632,MCWP 50R,A00,518791,Staff,20,0,20,0
1713307551632,MCWP 50R,B00,518792,Staff,19,0,20,1
1713307551632,MCWP 50R,C00,518793,Staff,19,0,20,1
1713307551632,MCWP 50R,D00,518794,Staff,18,0,20,2
1713307551632,MCWP 50R,E00,518795,Staff,18,0,20,2
1713307551632,MCWP 50R,F00,518796,Staff,19,0,20,1
1713307551632,MCWP 50R,G00,518797,Staff,19,0,20,1
1713307552656,MMW 12R,A01,514034,Herbst; Matthew,16,0,16,0
1713307552656,MMW 12R,A02,514035,Herbst; Matthew,16,0,16,0
1713307553681,MMW 13R,A01,514037,Staff,14,0,16,2
1713307553681,MMW 13R,A02,514039,Staff,16,0,16,0
1713307555742,SIO 295LS,A00,523233,Staff,19,0,30,11
1713307556768,SIO 295S,A00,523232,Staff,19,0,30,11
1713307557792,SOCI 117,A01,494376,Staff,3,0,5,2
1713307558818,WES 237B,A00,494380,Staff,19,0,20,1
1713307560878,AESE 279B,A00,494370,Wade; Jon P,33,0,33,0
1713307561904,ANAR 135S,A00,494369,Braswell; Geoffrey E.,0,0,0,0
1713307562946,CAT 124RS,A01,519847,Geibel; William,17,0,20,3
1713307563983,CAT 125RS,A01,515971,Geibel; William,17,0,20,3
1713307565009,CLRE 250,A00,511389,Morris; Sheldon,9996,0,9999,3
1713307566038,CLRE 251,A00,507176,Mehta; Ravindra L.,9996,0,9999,3
1713307566038,CLRE 251,B00,511410,Mehta; Ravindra L.,9998,0,9999,1
1713307567068,CLRE 252,A00,507189,Cuomo; Raphael Eduardo,9998,0,9999,1
1713307568093,CLRE 253,A00,507199,Vaida; Florin,9997,0,9999,2
1713307568093,CLRE 253,B00,507202,Vaida; Florin,9999,0,9999,0
1713307569125,CLRE 259,A00,507211,Patel; Hemal,9996,0,9999,3
1713307570150,CLRE 260,A00,507221,Cuomo; Raphael Eduardo,9999,0,9999,0
1713307571180,CLRE 297,001,507242,Cuomo; Raphael Eduardo,9999,0,9999,0
1713307572208,CSE 191,A00,516875,Minnes Kemp; Mor Mia,9999,0,9999,0
1713307573234,CSS 201S,A01,494383,Staff,35,0,35,0
1713307574258,CSS 202S,A01,494387,Staff,35,0,35,0
1713307575284,EAP 100,A00,516065,Staff,9792,0,9999,207
1713307576314,ECE 45,A01,507414,Staff,56,0,60,4
1713307577342,ECE 100,A01,507416,Baghdadchi; Saharnaz,12,0,20,8
1713307577342,ECE 100,A02,507418,Baghdadchi; Saharnaz,20,0,20,0
1713307578366,ECE 111,A01,507420,Staff,40,0,50,10
1713307579396,ECE 197,001,548057,Sievenpiper; Daniel F.,9998,0,9999,1
1713307580428,EDS 115,A00,507243,Choi; Bailey Miyeon,28,0,28,0
1713307581453,EDS 117,A01,494379,Staff,25,0,25,0
1713307582481,EDS 125,A00,507246,Hopkins; Megan Beth,29,0,30,1
1713307583509,EDS 128A,A01,507264,Fargason; Sharon Gayle,26,0,26,0
1713307584536,EDS 128B,A01,507293,Pappas; Elizabeth,30,0,30,0
1713307585560,EDS 139,A00,507294,Fargason; Sharon Gayle,30,0,30,0
1713307585560,EDS 139,B00,507313,Pappas; Elizabeth,30,0,30,0
1713307586590,EDS 201,A00,507315,Staff,26,0,30,4
1713307587621,EDS 203,A01,507317,Halter; Christopher P.,26,0,30,4
1713307588648,EDS 204R,A01,507319,Halter; Christopher P.,6,0,30,24
1713307588648,EDS 204R,B01,507331,Heinzman; Erica M.,30,0,30,0
1713307589671,EDS 206R,A00,507332,Staff,8,0,30,22
1713307589671,EDS 206R,B00,507343,Staff,29,0,30,1
1713307590700,EDS 250,A00,507344,Hemans; Patricia Ann Benitez,36,0,40,4
1713307591868,EDS 281,A00,507345,Daly; Alan J.,18,0,18,0
1713307592893,EDS 284,A00,507350,Daly; Alan J.,16,0,16,0
1713307593921,EDS 286,A00,507359,Fine; Sarah,18,0,18,0
1713307594948,EDS 289C,A01,507361,Daly; Alan J.,18,0,18,0
1713307595976,EDS 290,A00,507366,Hofstetter; Carolyn,15,0,15,0
1713307597002,LIGM 5A,A00,507421,Fischer-Grunski; Eva K,20,0,20,0
1713307598029,LIGM 5B,A00,507423,Fischer-Grunski; Eva K,20,0,20,0
1713307599055,LIGM 5C,A00,507425,Fischer-Grunski; Eva K,20,0,20,0
1713307600080,LIIT 5AS,A00,507427,Carnelos; Chiara,20,0,20,0
1713307601106,LIIT 5BS,A00,507430,Carnelos; Chiara,20,0,20,0
1713307602129,LIIT 5CS,A00,507432,Carnelos; Chiara,20,0,20,0
1713307603159,LISP 5A,A00,507541,Munoz Sanchez; Alicia,19,0,20,1
1713307604189,LISP 5B,A00,507671,Munoz Sanchez; Alicia,17,0,20,3
1713307605213,LISP 5C,A00,507696,Munoz Sanchez; Alicia,17,0,20,3
1713307606239,MAE 197,001,528363,Boechler; Nicholas Sebastia,9998,0,9999,1
1713307607265,MATH 197,001,523477,Kedlaya; Kiran S.,9999,0,9999,0
1713307607265,MATH 197,002,563811,Zhang; Danna,9999,0,9999,0
1713307608293,MCWP 40R,A00,518780,Staff,20,0,20,0
1713307608293,MCWP 40R,B00,518781,Staff,20,0,20,0
1713307608293,MCWP 40R,C00,518783,Staff,19,0,20,1
1713307609318,MCWP 50R,A00,518791,Staff,20,0,20,0
1713307609318,MCWP 50R,B00,518792,Staff,19,0,20,1
1713307609318,MCWP 50R,C00,518793,Staff,19,0,20,1
1713307609318,MCWP 50R,D00,518794,Staff,18,0,20,2
1713307609318,MCWP 50R,E00,518795,Staff,18,0,20,2
1713307609318,MCWP 50R,F00,518796,Staff,19,0,20,1
1713307609318,MCWP 50R,G00,518797,Staff,19,0,20,1
1713307610344,MMW 12R,A01,514034,Herbst; Matthew,16,0,16,0
1713307610344,MMW 12R,A02,514035,Herbst; Matthew,16,0,16,0
1713307611369,MMW 13R,A01,514037,Staff,14,0,16,2
1713307611369,MMW 13R,A02,514039,Staff,16,0,16,0
1713307613423,SIO 295LS,A00,523233,Staff,19,0,30,11
1713307614448,SIO 295S,A00,523232,Staff,19,0,30,11
1713307615473,SOCI 117,A01,494376,Staff,3,0,5,2
1713307616501,WES 237B,A00,494380,Staff,19,0,20,1
1713307618558,AESE 279B,A00,494370,Wade; Jon P,33,0,33,0
1713307619583,ANAR 135S,A00,494369,Braswell; Geoffrey E.,0,0,0,0
1713307620613,CAT 124RS,A01,519847,Geibel; William,17,0,20,3
1713307621637,CAT 125RS,A01,515971,Geibel; William,17,0,20,3
1713307622665,CLRE 250,A00,511389,Morris; Sheldon,9996,0,9999,3
1713307623690,CLRE 251,A00,507176,Mehta; Ravindra L.,9996,0,9999,3
1713307623690,CLRE 251,B00,511410,Mehta; Ravindra L.,9998,0,9999,1
1713307624721,CLRE 252,A00,507189,Cuomo; Raphael Eduardo,9998,0,9999,1
1713307625746,CLRE 253,A00,507199,Vaida; Florin,9997,0,9999,2
1713307625746,CLRE 253,B00,507202,Vaida; Florin,9999,0,9999,0
1713307626772,CLRE 259,A00,507211,Patel; Hemal,9996,0,9999,3
1713307627797,CLRE 260,A00,507221,Cuomo; Raphael Eduardo,9999,0,9999,0
1713307628822,CLRE 297,001,507242,Cuomo; Raphael Eduardo,9999,0,9999,0
1713307629850,CSE 191,A00,516875,Minnes Kemp; Mor Mia,9999,0,9999,0
1713307630881,CSS 201S,A01,494383,Staff,35,0,35,0
1713307631905,CSS 202S,A01,494387,Staff,35,0,35,0
1713307632930,EAP 100,A00,516065,Staff,9792,0,9999,207
1713307633960,ECE 45,A01,507414,Staff,56,0,60,4
1713307634983,ECE 100,A01,507416,Baghdadchi; Saharnaz,12,0,20,8
1713307634983,ECE 100,A02,507418,Baghdadchi; Saharnaz,20,0,20,0
1713307636012,ECE 111,A01,507420,Staff,40,0,50,10
1713307637036,ECE 197,001,548057,Sievenpiper; Daniel F.,9998,0,9999,1
1713307638062,EDS 115,A00,507243,Choi; Bailey Miyeon,28,0,28,0
1713307639088,EDS 117,A01,494379,Staff,25,0,25,0
1713307640114,EDS 125,A00,507246,Hopkins; Megan Beth,29,0,30,1
1713307641145,EDS 128A,A01,507264,Fargason; Sharon Gayle,26,0,26,0
1713307642175,EDS 128B,A01,507293,Pappas; Elizabeth,30,0,30,0
1713307643202,EDS 139,A00,507294,Fargason; Sharon Gayle,30,0,30,0
1713307643202,EDS 139,B00,507313,Pappas; Elizabeth,30,0,30,0
1713307644227,EDS 201,A00,507315,Staff,26,0,30,4
1713307645253,EDS 203,A01,507317,Halter; Christopher P.,26,0,30,4
1713307646283,EDS 204R,A01,507319,Halter; Christopher P.,6,0,30,24
1713307646283,EDS 204R,B01,507331,Heinzman; Erica M.,30,0,30,0
1713307647310,EDS 206R,A00,507332,Staff,8,0,30,22
1713307647310,EDS 206R,B00,507343,Staff,29,0,30,1
1713307648336,EDS 250,A00,507344,Hemans; Patricia Ann Benitez,36,0,40,4
1713307649361,EDS 281,A00,507345,Daly; Alan J.,18,0,18,0
1713307650384,EDS 284,A00,507350,Daly; Alan J.,16,0,16,0
1713307651413,EDS 286,A00,507359,Fine; Sarah,18,0,18,0
1713307652493,EDS 289C,A01,507361,Daly; Alan J.,18,0,18,0
1713307653522,EDS 290,A00,507366,Hofstetter; Carolyn,15,0,15,0
1713307654551,LIGM 5A,A00,507421,Fischer-Grunski; Eva K,20,0,20,0
1713307655579,LIGM 5B,A00,507423,Fischer-Grunski; Eva K,20,0,20,0
1713307656604,LIGM 5C,A00,507425,Fischer-Grunski; Eva K,20,0,20,0
1713307657634,LIIT 5AS,A00,507427,Carnelos; Chiara,20,0,20,0
1713307658659,LIIT 5BS,A00,507430,Carnelos; Chiara,20,0,20,0
1713307659684,LIIT 5CS,A00,507432,Carnelos; Chiara,20,0,20,0
1713307660709,LISP 5A,A00,507541,Munoz Sanchez; Alicia,19,0,20,1
1713307661735,LISP 5B,A00,507671,Munoz Sanchez; Alicia,17,0,20,3
1713307662760,LISP 5C,A00,507696,Munoz Sanchez; Alicia,17,0,20,3
1713307663787,MAE 197,001,528363,Boechler; Nicholas Sebastia,9998,0,9999,1
1713307664818,MATH 197,001,523477,Kedlaya; Kiran S.,9999,0,9999,0
1713307664818,MATH 197,002,563811,Zhang; Danna,9999,0,9999,0
1713307665846,MCWP 40R,A00,518780,Staff,20,0,20,0
1713307665846,MCWP 40R,B00,518781,Staff,20,0,20,0
1713307665846,MCWP 40R,C00,518783,Staff,19,0,20,1
1713307666874,MCWP 50R,A00,518791,Staff,20,0,20,0
1713307666874,MCWP 50R,B00,518792,Staff,19,0,20,1
1713307666874,MCWP 50R,C00,518793,Staff,19,0,20,1
1713307666874,MCWP 50R,D00,518794,Staff,18,0,20,2
1713307666874,MCWP 50R,E00,518795,Staff,18,0,20,2
1713307666874,MCWP 50R,F00,518796,Staff,19,0,20,1
1713307666874,MCWP 50R,G00,518797,Staff,19,0,20,1
1713307667900,MMW 12R,A01,514034,Herbst; Matthew,16,0,16,0
1713307667900,MMW 12R,A02,514035,Herbst; Matthew,16,0,16,0
1713307668928,MMW 13R,A01,514037,Staff,14,0,16,2
1713307668928,MMW 13R,A02,514039,Staff,16,0,16,0
1713307670982,SIO 295LS,A00,523233,Staff,19,0,30,11
1713307672008,SIO 295S,A00,523232,Staff,19,0,30,11
1713307673034,SOCI 117,A01,494376,Staff,3,0,5,2
1713307674062,WES 237B,A00,494380,Staff,19,0,20,1
1713307676126,AESE 279B,A00,494370,Wade; Jon P,33,0,33,0
1713307677156,ANAR 135S,A00,494369,Braswell; Geoffrey E.,0,0,0,0
1713307678180,CAT 124RS,A01,519847,Geibel; William,17,0,20,3
1713307679205,CAT 125RS,A01,515971,Geibel; William,17,0,20,3
1713307680231,CLRE 250,A00,511389,Morris; Sheldon,9996,0,9999,3
1713307681261,CLRE 251,A00,507176,Mehta; Ravindra L.,9996,0,9999,3
1713307681261,CLRE 251,B00,511410,Mehta; Ravindra L.,9998,0,9999,1
1713307682288,CLRE 252,A00,507189,Cuomo; Raphael Eduardo,9998,0,9999,1
1713307683314,CLRE 253,A00,507199,Vaida; Florin,9997,0,9999,2
1713307683314,CLRE 253,B00,507202,Vaida; Florin,9999,0,9999,0
1713307684343,CLRE 259,A00,507211,Patel; Hemal,9996,0,9999,3
1713307685368,CLRE 260,A00,507221,Cuomo; Raphael Eduardo,9999,0,9999,0
1713307686393,CLRE 297,001,507242,Cuomo; Raphael Eduardo,9999,0,9999,0
1713307687424,CSE 191,A00,516875,Minnes Kemp; Mor Mia,9999,0,9999,0
1713307688450,CSS 201S,A01,494383,Staff,35,0,35,0
1713307689481,CSS 202S,A01,494387,Staff,35,0,35,0
1713307690508,EAP 100,A00,516065,Staff,9792,0,9999,207
1713307691533,ECE 45,A01,507414,Staff,56,0,60,4
1713307692563,ECE 100,A01,507416,Baghdadchi; Saharnaz,12,0,20,8
1713307692563,ECE 100,A02,507418,Baghdadchi; Saharnaz,20,0,20,0
1713307693590,ECE 111,A01,507420,Staff,40,0,50,10
1713307694627,ECE 197,001,548057,Sievenpiper; Daniel F.,9998,0,9999,1
1713307695659,EDS 115,A00,507243,Choi; Bailey Miyeon,28,0,28,0
1713307696684,EDS 117,A01,494379,Staff,25,0,25,0
1713307697712,EDS 125,A00,507246,Hopkins; Megan Beth,29,0,30,1
1713307698738,EDS 128A,A01,507264,Fargason; Sharon Gayle,26,0,26,0
1713307699763,EDS 128B,A01,507293,Pappas; Elizabeth,30,0,30,0
1713307700788,EDS 139,A00,507294,Fargason; Sharon Gayle,30,0,30,0
1713307700788,EDS 139,B00,507313,Pappas; Elizabeth,30,0,30,0
1713307701814,EDS 201,A00,507315,Staff,26,0,30,4
1713307702841,EDS 203,A01,507317,Halter; Christopher P.,26,0,30,4
1713307703867,EDS 204R,A01,507319,Halter; Christopher P.,6,0,30,24
1713307703867,EDS 204R,B01,507331,Heinzman; Erica M.,30,0,30,0
1713307704895,EDS 206R,A00,507332,Staff,8,0,30,22
1713307704895,EDS 206R,B00,507343,Staff,29,0,30,1
1713307705924,EDS 250,A00,507344,Hemans; Patricia Ann Benitez,36,0,40,4
1713307706953,EDS 281,A00,507345,Daly; Alan J.,18,0,18,0
1713307707988,EDS 284,A00,507350,Daly; Alan J.,16,0,16,0
1713307709019,EDS 286,A00,507359,Fine; Sarah,18,0,18,0
1713307710047,EDS 289C,A01,507361,Daly; Alan J.,18,0,18,0
1713307711075,EDS 290,A00,507366,Hofstetter; Carolyn,15,0,15,0
1713307712101,LIGM 5A,A00,507421,Fischer-Grunski; Eva K,20,0,20,0
1713307713126,LIGM 5B,A00,507423,Fischer-Grunski; Eva K,20,0,20,0
1713307714151,LIGM 5C,A00,507425,Fischer-Grunski; Eva K,20,0,20,0
1713307715177,LIIT 5AS,A00,507427,Carnelos; Chiara,20,0,20,0
1713307716206,LIIT 5BS,A00,507430,Carnelos; Chiara,20,0,20,0
1713307717231,LIIT 5CS,A00,507432,Carnelos; Chiara,20,0,20,0
1713307718262,LISP 5A,A00,507541,Munoz Sanchez; Alicia,19,0,20,1
1713307719292,LISP 5B,A00,507671,Munoz Sanchez; Alicia,17,0,20,3
1713307720317,LISP 5C,A00,507696,Munoz Sanchez; Alicia,17,0,20,3
1713307721347,MAE 197,001,528363,Boechler; Nicholas Sebastia,9998,0,9999,1
1713307722372,MATH 197,001,523477,Kedlaya; Kiran S.,9999,0,9999,0
1713307722372,MATH 197,002,563811,Zhang; Danna,9999,0,9999,0
1713307723398,MCWP 40R,A00,518780,Staff,20,0,20,0
1713307723398,MCWP 40R,B00,518781,Staff,20,0,20,0
1713307723398,MCWP 40R,C00,518783,Staff,19,0,20,1
1713307724426,MCWP 50R,A00,518791,Staff,20,0,20,0
1713307724426,MCWP 50R,B00,518792,Staff,19,0,20,1
1713307724426,MCWP 50R,C00,518793,Staff,19,0,20,1
1713307724426,MCWP 50R,D00,518794,Staff,18,0,20,2
1713307724426,MCWP 50R,E00,518795,Staff,18,0,20,2
1713307724426,MCWP 50R,F00,518796,Staff,19,0,20,1
1713307724426,MCWP 50R,G00,518797,Staff,19,0,20,1
1713307725454,MMW 12R,A01,514034,Herbst; Matthew,16,0,16,0
1713307725454,MMW 12R,A02,514035,Herbst; Matthew,16,0,16,0
1713307726478,MMW 13R,A01,514037,Staff,14,0,16,2
1713307726478,MMW 13R,A02,514039,Staff,16,0,16,0
1713307728531,SIO 295LS,A00,523233,Staff,19,0,30,11
1713307729572,SIO 295S,A00,523232,Staff,19,0,30,11
1713307730597,SOCI 117,A01,494376,Staff,3,0,5,2
1713307731622,WES 237B,A00,494380,Staff,19,0,20,1
1713307733694,AESE 279B,A00,494370,Wade; Jon P,33,0,33,0
1713307734720,ANAR 135S,A00,494369,Braswell; Geoffrey E.,0,0,0,0
1713307735750,CAT 124RS,A01,519847,Geibel; William,17,0,20,3
1713307736775,CAT 125RS,A01,515971,Geibel; William,17,0,20,3
1713307737801,CLRE 250,A00,511389,Morris; Sheldon,9996,0,9999,3
1713307738826,CLRE 251,A00,507176,Mehta; Ravindra L.,9996,0,9999,3
1713307738826,CLRE 251,B00,511410,Mehta; Ravindra L.,9998,0,9999,1
1713307739850,CLRE 252,A00,507189,Cuomo; Raphael Eduardo,9998,0,9999,1
1713307740879,CLRE 253,A00,507199,Vaida; Florin,9997,0,9999,2
1713307740879,CLRE 253,B00,507202,Vaida; Florin,9999,0,9999,0
1713307741908,CLRE 259,A00,507211,Patel; Hemal,9996,0,9999,3
1713307742933,CLRE 260,A00,507221,Cuomo; Raphael Eduardo,9999,0,9999,0
1713307743961,CLRE 297,001,507242,Cuomo; Raphael Eduardo,9999,0,9999,0
1713307744989,CSE 191,A00,516875,Minnes Kemp; Mor Mia,9999,0,9999,0
1713307746019,CSS 201S,A01,494383,Staff,35,0,35,0
1713307747048,CSS 202S,A01,494387,Staff,35,0,35,0
1713307748077,EAP 100,A00,516065,Staff,9792,0,9999,207
1713307749104,ECE 45,A01,507414,Staff,56,0,60,4
1713307750133,ECE 100,A01,507416,Baghdadchi; Saharnaz,12,0,20,8
1713307750133,ECE 100,A02,507418,Baghdadchi; Saharnaz,20,0,20,0
1713307751156,ECE 111,A01,507420,Staff,40,0,50,10
1713307752182,ECE 197,001,548057,Sievenpiper; Daniel F.,9998,0,9999,1
1713307753207,EDS 115,A00,507243,Choi; Bailey Miyeon,28,0,28,0
1713307754236,EDS 117,A01,494379,Staff,25,0,25,0
1713307755262,EDS 125,A00,507246,Hopkins; Megan Beth,29,0,30,1
1713307756340,EDS 128A,A01,507264,Fargason; Sharon Gayle,26,0,26,0
1713307757365,EDS 128B,A01,507293,Pappas; Elizabeth,30,0,30,0
1713307758394,EDS 139,A00,507294,Fargason; Sharon Gayle,30,0,30,0
1713307758394,EDS 139,B00,507313,Pappas; Elizabeth,30,0,30,0
1713307759419,EDS 201,A00,507315,Staff,26,0,30,4
1713307760444,EDS 203,A01,507317,Halter; Christopher P.,26,0,30,4
1713307761470,EDS 204R,A01,507319,Halter; Christopher P.,6,0,30,24
1713307761470,EDS 204R,B01,507331,Heinzman; Erica M.,30,0,30,0
1713307762497,EDS 206R,A00,507332,Staff,8,0,30,22
1713307762497,EDS 206R,B00,507343,Staff,29,0,30,1
1713307763522,EDS 250,A00,507344,Hemans; Patricia Ann Benitez,36,0,40,4
1713307764546,EDS 281,A00,507345,Daly; Alan J.,18,0,18,0
1713307765570,EDS 284,A00,507350,Daly; Alan J.,16,0,16,0
1713307766597,EDS 286,A00,507359,Fine; Sarah,18,0,18,0
1713307767623,EDS 289C,A01,507361,Daly; Alan J.,18,0,18,0
1713307768652,EDS 290,A00,507366,Hofstetter; Carolyn,15,0,15,0
1713307769677,LIGM 5A,A00,507421,Fischer-Grunski; Eva K,20,0,20,0
1713307770706,LIGM 5B,A00,507423,Fischer-Grunski; Eva K,20,0,20,0
1713307771732,LIGM 5C,A00,507425,Fischer-Grunski; Eva K,20,0,20,0
1713307772761,LIIT 5AS,A00,507427,Carnelos; Chiara,20,0,20,0
1713307773792,LIIT 5BS,A00,507430,Carnelos; Chiara,20,0,20,0
1713307774817,LIIT 5CS,A00,507432,Carnelos; Chiara,20,0,20,0
1713307775842,LISP 5A,A00,507541,Munoz Sanchez; Alicia,19,0,20,1
1713307776866,LISP 5B,A00,507671,Munoz Sanchez; Alicia,17,0,20,3
1713307777892,LISP 5C,A00,507696,Munoz Sanchez; Alicia,17,0,20,3
1713307778923,MAE 197,001,528363,Boechler; Nicholas Sebastia,9998,0,9999,1
1713307779950,MATH 197,001,523477,Kedlaya; Kiran S.,9999,0,9999,0
1713307779950,MATH 197,002,563811,Zhang; Danna,9999,0,9999,0
1713307780975,MCWP 40R,A00,518780,Staff,20,0,20,0
1713307780975,MCWP 40R,B00,518781,Staff,20,0,20,0
1713307780975,MCWP 40R,C00,518783,Staff,19,0,20,1
1713307782006,MCWP 50R,A00,518791,Staff,20,0,20,0
1713307782006,MCWP 50R,B00,518792,Staff,19,0,20,1
1713307782006,MCWP 50R,C00,518793,Staff,19,0,20,1
1713307782006,MCWP 50R,D00,518794,Staff,18,0,20,2
1713307782006,MCWP 50R,E00,518795,Staff,18,0,20,2
1713307782006,MCWP 50R,F00,518796,Staff,19,0,20,1
1713307782006,MCWP 50R,G00,518797,Staff,19,0,20,1
1713307783032,MMW 12R,A01,514034,Herbst; Matthew,16,0,16,0
1713307783032,MMW 12R,A02,514035,Herbst; Matthew,16,0,16,0
1713307784059,MMW 13R,A01,514037,Staff,14,0,16,2
1713307784059,MMW 13R,A02,514039,Staff,16,0,16,0
1713307786114,SIO 295LS,A00,523233,Staff,19,0,30,11
1713307787145,SIO 295S,A00,523232,Staff,19,0,30,11
1713307788171,SOCI 117,A01,494376,Staff,3,0,5,2
1713307789199,WES 237B,A00,494380,Staff,19,0,20,1
1713307791278,AESE 279B,A00,494370,Wade; Jon P,33,0,33,0
1713307792303,ANAR 135S,A00,494369,Braswell; Geoffrey E.,0,0,0,0
1713307793329,CAT 124RS,A01,519847,Geibel; William,17,0,20,3
1713307794353,CAT 125RS,A01,515971,Geibel; William,17,0,20,3
1713307795381,CLRE 250,A00,511389,Morris; Sheldon,9996,0,9999,3
1713307796411,CLRE 251,A00,507176,Mehta; Ravindra L.,9996,0,9999,3
1713307796411,CLRE 251,B00,511410,Mehta; Ravindra L.,9998,0,9999,1
1713307797437,CLRE 252,A00,507189,Cuomo; Raphael Eduardo,9998,0,9999,1
1713307798462,CLRE 253,A00,507199,Vaida; Florin,9997,0,9999,2
1713307798462,CLRE 253,B00,507202,Vaida; Florin,9999,0,9999,0
1713307799490,CLRE 259,A00,507211,Patel; Hemal,9996,0,9999,3
1713307800516,CLRE 260,A00,507221,Cuomo; Raphael Eduardo,9999,0,9999,0
1713307801547,CLRE 297,001,507242,Cuomo; Raphael Eduardo,9999,0,9999,0
1713307802576,CSE 191,A00,516875,Minnes Kemp; Mor Mia,9999,0,9999,0
1713307803615,CSS 201S,A01,494383,Staff,35,0,35,0
1713307804643,CSS 202S,A01,494387,Staff,35,0,35,0
1713307805672,EAP 100,A00,516065,Staff,9792,0,9999,207
1713307806699,ECE 45,A01,507414,Staff,56,0,60,4
1713307807733,ECE 100,A01,507416,Baghdadchi; Saharnaz,12,0,20,8
1713307807733,ECE 100,A02,507418,Baghdadchi; Saharnaz,20,0,20,0
1713307808766,ECE 111,A01,507420,Staff,40,0,50,10
1713307809792,ECE 197,001,548057,Sievenpiper; Daniel F.,9998,0,9999,1
1713307810822,EDS 115,A00,507243,Choi; Bailey Miyeon,28,0,28,0
1713307811855,EDS 117,A01,494379,Staff,25,0,25,0
1713307812886,EDS 125,A00,507246,Hopkins; Megan Beth,29,0,30,1
1713307813913,EDS 128A,A01,507264,Fargason; Sharon Gayle,26,0,26,0
1713307814944,EDS 128B,A01,507293,Pappas; Elizabeth,30,0,30,0
1713307815970,EDS 139,A00,507294,Fargason; Sharon Gayle,30,0,30,0
1713307815970,EDS 139,B00,507313,Pappas; Elizabeth,30,0,30,0
1713307816997,EDS 201,A00,507315,Staff,26,0,30,4
1713307818025,EDS 203,A01,507317,Halter; Christopher P.,26,0,30,4
1713307819052,EDS 204R,A01,507319,Halter; Christopher P.,6,0,30,24
1713307819052,EDS 204R,B01,507331,Heinzman; Erica M.,30,0,30,0
1713307820080,EDS 206R,A00,507332,Staff,8,0,30,22
1713307820080,EDS 206R,B00,507343,Staff,29,0,30,1
1713307821105,EDS 250,A00,507344,Hemans; Patricia Ann Benitez,36,0,40,4
1713307822137,EDS 281,A00,507345,Daly; Alan J.,18,0,18,0
1713307823248,EDS 284,A00,507350,Daly; Alan J.,16,0,16,0
1713307824278,EDS 286,A00,507359,Fine; Sarah,18,0,18,0
1713307825302,EDS 289C,A01,507361,Daly; Alan J.,18,0,18,0
1713307826325,EDS 290,A00,507366,Hofstetter; Carolyn,15,0,15,0
1713307827351,LIGM 5A,A00,507421,Fischer-Grunski; Eva K,20,0,20,0
1713307828381,LIGM 5B,A00,507423,Fischer-Grunski; Eva K,20,0,20,0
1713307829411,LIGM 5C,A00,507425,Fischer-Grunski; Eva K,20,0,20,0
1713307830440,LIIT 5AS,A00,507427,Carnelos; Chiara,20,0,20,0
1713307831465,LIIT 5BS,A00,507430,Carnelos; Chiara,20,0,20,0
1713307832490,LIIT 5CS,A00,507432,Carnelos; Chiara,20,0,20,0
1713307833514,LISP 5A,A00,507541,Munoz Sanchez; Alicia,19,0,20,1
1713307834539,LISP 5B,A00,507671,Munoz Sanchez; Alicia,17,0,20,3
1713307835564,LISP 5C,A00,507696,Munoz Sanchez; Alicia,17,0,20,3
1713307836595,MAE 197,001,528363,Boechler; Nicholas Sebastia,9998,0,9999,1
1713307837625,MATH 197,001,523477,Kedlaya; Kiran S.,9999,0,9999,0
1713307837625,MATH 197,002,563811,Zhang; Danna,9999,0,9999,0
1713307838650,MCWP 40R,A00,518780,Staff,20,0,20,0
1713307838650,MCWP 40R,B00,518781,Staff,20,0,20,0
1713307838650,MCWP 40R,C00,518783,Staff,19,0,20,1
1713307839680,MCWP 50R,A00,518791,Staff,20,0,20,0
1713307839680,MCWP 50R,B00,518792,Staff,19,0,20,1
1713307839680,MCWP 50R,C00,518793,Staff,19,0,20,1
1713307839680,MCWP 50R,D00,518794,Staff,18,0,20,2
1713307839680,MCWP 50R,E00,518795,Staff,18,0,20,2
1713307839680,MCWP 50R,F00,518796,Staff,19,0,20,1
1713307839680,MCWP 50R,G00,518797,Staff,19,0,20,1
1713307840711,MMW 12R,A01,514034,Herbst; Matthew,16,0,16,0
1713307840711,MMW 12R,A02,514035,Herbst; Matthew,16,0,16,0
1713307841736,MMW 13R,A01,514037,Staff,14,0,16,2
1713307841736,MMW 13R,A02,514039,Staff,16,0,16,0
1713307843794,SIO 295LS,A00,523233,Staff,19,0,30,11
1713307844818,SIO 295S,A00,523232,Staff,19,0,30,11
1713307845846,SOCI 117,A01,494376,Staff,3,0,5,2
1713307846874,WES 237B,A00,494380,Staff,19,0,20,1
1713307848954,AESE 279B,A00,494370,Wade; Jon P,33,0,33,0
1713307849980,ANAR 135S,A00,494369,Braswell; Geoffrey E.,0,0,0,0
1713307851009,CAT 124RS,A01,519847,Geibel; William,17,0,20,3
1713307852038,CAT 125RS,A01,515971,Geibel; William,17,0,20,3
1713307853063,CLRE 250,A00,511389,Morris; Sheldon,9996,0,9999,3
1713307854095,CLRE 251,A00,507176,Mehta; Ravindra L.,9996,0,9999,3
1713307854095,CLRE 251,B00,511410,Mehta; Ravindra L.,9998,0,9999,1
1713307855120,CLRE 252,A00,507189,Cuomo; Raphael Eduardo,9998,0,9999,1
1713307856146,CLRE 253,A00,507199,Vaida; Florin,9997,0,9999,2
1713307856146,CLRE 253,B00,507202,Vaida; Florin,9999,0,9999,0
1713307857170,CLRE 259,A00,507211,Patel; Hemal,9996,0,9999,3
1713307858202,CLRE 260,A00,507221,Cuomo; Raphael Eduardo,9999,0,9999,0
1713307859226,CLRE 297,001,507242,Cuomo; Raphael Eduardo,9999,0,9999,0
1713307860308,CSE 191,A00,516875,Minnes Kemp; Mor Mia,9999,0,9999,0
1713307861341,CSS 201S,A01,494383,Staff,35,0,35,0
1713307862366,CSS 202S,A01,494387,Staff,35,0,35,0
1713307863392,EAP 100,A00,516065,Staff,9792,0,9999,207
1713307864420,ECE 45,A01,507414,Staff,56,0,60,4
1713307865451,ECE 100,A01,507416,Baghdadchi; Saharnaz,12,0,20,8
1713307865451,ECE 100,A02,507418,Baghdadchi; Saharnaz,20,0,20,0
1713307866481,ECE 111,A01,507420,Staff,40,0,50,10
1713307867512,ECE 197,001,548057,Sievenpiper; Daniel F.,9998,0,9999,1
1713307868553,EDS 115,A00,507243,Choi; Bailey Miyeon,28,0,28,0
1713307869588,EDS 117,A01,494379,Staff,25,0,25,0
1713307870615,EDS 125,A00,507246,Hopkins; Megan Beth,29,0,30,1
1713307871642,EDS 128A,A01,507264,Fargason; Sharon Gayle,26,0,26,0
1713307872669,EDS 128B,A01,507293,Pappas; Elizabeth,30,0,30,0
1713307873693,EDS 139,A00,507294,Fargason; Sharon Gayle,30,0,30,0
1713307873693,EDS 139,B00,507313,Pappas; Elizabeth,30,0,30,0
1713307874719,EDS 201,A00,507315,Staff,26,0,30,4
1713307875746,EDS 203,A01,507317,Halter; Christopher P.,26,0,30,4
1713307876780,EDS 204R,A01,507319,Halter; Christopher P.,6,0,30,24
1713307876780,EDS 204R,B01,507331,Heinzman; Erica M.,30,0,30,0
1713307877809,EDS 206R,A00,507332,Staff,8,0,30,22
1713307877809,EDS 206R,B00,507343,Staff,29,0,30,1
1713307878834,EDS 250,A00,507344,Hemans; Patricia Ann Benitez,36,0,40,4
1713307879858,EDS 281,A00,507345,Daly; Alan J.,18,0,18,0
1713307880884,EDS 284,A00,507350,Daly; Alan J.,16,0,16,0
1713307881909,EDS 286,A00,507359,Fine; Sarah,18,0,18,0
1713307882934,EDS 289C,A01,507361,Daly; Alan J.,18,0,18,0
1713307883964,EDS 290,A00,507366,Hofstetter; Carolyn,15,0,15,0
1713307884996,LIGM 5A,A00,507421,Fischer-Grunski; Eva K,20,0,20,0
1713307886029,LIGM 5B,A00,507423,Fischer-Grunski; Eva K,20,0,20,0
1713307887055,LIGM 5C,A00,507425,Fischer-Grunski; Eva K,20,0,20,0
1713307888079,LIIT 5AS,A00,507427,Carnelos; Chiara,20,0,20,0
1713307889104,LIIT 5BS,A00,507430,Carnelos; Chiara,20,0,20,0
1713307890130,LIIT 5CS,A00,507432,Carnelos; Chiara,20,0,20,0
1713307891157,LISP 5A,A00,507541,Munoz Sanchez; Alicia,19,0,20,1
1713307892188,LISP 5B,A00,507671,Munoz Sanchez; Alicia,17,0,20,3
1713307893213,LISP 5C,A00,507696,Munoz Sanchez; Alicia,17,0,20,3
1713307894242,MAE 197,001,528363,Boechler; Nicholas Sebastia,9998,0,9999,1
1713307895274,MATH 197,001,523477,Kedlaya; Kiran S.,9999,0,9999,0
1713307895274,MATH 197,002,563811,Zhang; Danna,9999,0,9999,0
1713307896302,MCWP 40R,A00,518780,Staff,20,0,20,0
1713307896302,MCWP 40R,B00,518781,Staff,20,0,20,0
1713307896302,MCWP 40R,C00,518783,Staff,19,0,20,1
1713307897328,MCWP 50R,A00,518791,Staff,20,0,20,0
1713307897328,MCWP 50R,B00,518792,Staff,19,0,20,1
1713307897328,MCWP 50R,C00,518793,Staff,19,0,20,1
1713307897328,MCWP 50R,D00,518794,Staff,18,0,20,2
1713307897328,MCWP 50R,E00,518795,Staff,18,0,20,2
1713307897328,MCWP 50R,F00,518796,Staff,19,0,20,1
1713307897328,MCWP 50R,G00,518797,Staff,19,0,20,1
1713307898353,MMW 12R,A01,514034,Herbst; Matthew,16,0,16,0
1713307898353,MMW 12R,A02,514035,Herbst; Matthew,16,0,16,0
1713307899382,MMW 13R,A01,514037,Staff,14,0,16,2
1713307899382,MMW 13R,A02,514039,Staff,16,0,16,0
1713307901433,SIO 295LS,A00,523233,Staff,19,0,30,11
1713307902460,SIO 295S,A00,523232,Staff,19,0,30,11
1713307903487,SOCI 117,A01,494376,Staff,3,0,5,2
1713307904512,WES 237B,A00,494380,Staff,19,0,20,1
1713307906693,AESE 279B,A00,494370,Wade; Jon P,33,0,33,0
1713307907723,ANAR 135S,A00,494369,Braswell; Geoffrey E.,0,0,0,0
1713307908749,CAT 124RS,A01,519847,Geibel; William,17,0,20,3
1713307909774,CAT 125RS,A01,515971,Geibel; William,17,0,20,3
1713307910803,CLRE 250,A00,511389,Morris; Sheldon,9996,0,9999,3
1713307911836,CLRE 251,A00,507176,Mehta; Ravindra L.,9996,0,9999,3
1713307911836,CLRE 251,B00,511410,Mehta; Ravindra L.,9998,0,9999,1
1713307912868,CLRE 252,A00,507189,Cuomo; Raphael Eduardo,9998,0,9999,1
1713307913893,CLRE 253,A00,507199,Vaida; Florin,9997,0,9999,2
1713307913893,CLRE 253,B00,507202,Vaida; Florin,9999,0,9999,0
1713307914919,CLRE 259,A00,507211,Patel; Hemal,9996,0,9999,3
1713307915943,CLRE 260,A00,507221,Cuomo; Raphael Eduardo,9999,0,9999,0
1713307916971,CLRE 297,001,507242,Cuomo; Raphael Eduardo,9999,0,9999,0
1713307917999,CSE 191,A00,516875,Minnes Kemp; Mor Mia,9999,0,9999,0
1713307919025,CSS 201S,A01,494383,Staff,35,0,35,0
1713307920051,CSS 202S,A01,494387,Staff,35,0,35,0
1713307921075,EAP 100,A00,516065,Staff,9792,0,9999,207
1713307922101,ECE 45,A01,507414,Staff,56,0,60,4
1713307923126,ECE 100,A01,507416,Baghdadchi; Saharnaz,12,0,20,8
1713307923126,ECE 100,A02,507418,Baghdadchi; Saharnaz,20,0,20,0
1713307924155,ECE 111,A01,507420,Staff,40,0,50,10
1713307925181,ECE 197,001,548057,Sievenpiper; Daniel F.,9998,0,9999,1
1713307926205,EDS 115,A00,507243,Choi; Bailey Miyeon,28,0,28,0
1713307927231,EDS 117,A01,494379,Staff,25,0,25,0
1713307928258,EDS 125,A00,507246,Hopkins; Megan Beth,29,0,30,1
1713307929281,EDS 128A,A01,507264,Fargason; Sharon Gayle,26,0,26,0
1713307930308,EDS 128B,A01,507293,Pappas; Elizabeth,30,0,30,0
1713307931331,EDS 139,A00,507294,Fargason; Sharon Gayle,30,0,30,0
1713307931331,EDS 139,B00,507313,Pappas; Elizabeth,30,0,30,0
1713307932356,EDS 201,A00,507315,Staff,26,0,30,4
1713307933382,EDS 203,A01,507317,Halter; Christopher P.,26,0,30,4
1713307934409,EDS 204R,A01,507319,Halter; Christopher P.,6,0,30,24
1713307934409,EDS 204R,B01,507331,Heinzman; Erica M.,30,0,30,0
1713307935435,EDS 206R,A00,507332,Staff,8,0,30,22
1713307935435,EDS 206R,B00,507343,Staff,29,0,30,1
1713307936461,EDS 250,A00,507344,Hemans; Patricia Ann Benitez,36,0,40,4
1713307937485,EDS 281,A00,507345,Daly; Alan J.,18,0,18,0
1713307938512,EDS 284,A00,507350,Daly; Alan J.,16,0,16,0
1713307939536,EDS 286,A00,507359,Fine; Sarah,18,0,18,0
1713307940566,EDS 289C,A01,507361,Daly; Alan J.,18,0,18,0
1713307941592,EDS 290,A00,507366,Hofstetter; Carolyn,15,0,15,0
1713307942622,LIGM 5A,A00,507421,Fischer-Grunski; Eva K,20,0,20,0
1713307943649,LIGM 5B,A00,507423,Fischer-Grunski; Eva K,20,0,20,0
1713307944673,LIGM 5C,A00,507425,Fischer-Grunski; Eva K,20,0,20,0
1713307945700,LIIT 5AS,A00,507427,Carnelos; Chiara,20,0,20,0
1713307946728,LIIT 5BS,A00,507430,Carnelos; Chiara,20,0,20,0
1713307947754,LIIT 5CS,A00,507432,Carnelos; Chiara,20,0,20,0
1713307948784,LISP 5A,A00,507541,Munoz Sanchez; Alicia,19,0,20,1
1713307949808,LISP 5B,A00,507671,Munoz Sanchez; Alicia,17,0,20,3
1713307950833,LISP 5C,A00,507696,Munoz Sanchez; Alicia,17,0,20,3
1713307951862,MAE 197,001,528363,Boechler; Nicholas Sebastia,9998,0,9999,1
1713307952896,MATH 197,001,523477,Kedlaya; Kiran S.,9999,0,9999,0
1713307952896,MATH 197,002,563811,Zhang; Danna,9999,0,9999,0
1713307953922,MCWP 40R,A00,518780,Staff,20,0,20,0
1713307953922,MCWP 40R,B00,518781,Staff,20,0,20,0
1713307953922,MCWP 40R,C00,518783,Staff,19,0,20,1
1713307954953,MCWP 50R,A00,518791,Staff,20,0,20,0
1713307954953,MCWP 50R,B00,518792,Staff,19,0,20,1
1713307954953,MCWP 50R,C00,518793,Staff,19,0,20,1
1713307954953,MCWP 50R,D00,518794,Staff,18,0,20,2
1713307954953,MCWP 50R,E00,518795,Staff,18,0,20,2
1713307954953,MCWP 50R,F00,518796,Staff,19,0,20,1
1713307954953,MCWP 50R,G00,518797,Staff,19,0,20,1
1713307955979,MMW 12R,A01,514034,Herbst; Matthew,16,0,16,0
1713307955979,MMW 12R,A02,514035,Herbst; Matthew,16,0,16,0
1713307957007,MMW 13R,A01,514037,Staff,14,0,16,2
1713307957007,MMW 13R,A02,514039,Staff,16,0,16,0
1713307959059,SIO 295LS,A00,523233,Staff,19,0,30,11
1713307960084,SIO 295S,A00,523232,Staff,19,0,30,11
1713307961111,SOCI 117,A01,494376,Staff,3,0,5,2
1713307962141,WES 237B,A00,494380,Staff,19,0,20,1
1713307964260,AESE 279B,A00,494370,Wade; Jon P,33,0,33,0
1713307965284,ANAR 135S,A00,494369,Braswell; Geoffrey E.,0,0,0,0
1713307966309,CAT 124RS,A01,519847,Geibel; William,17,0,20,3
1713307967337,CAT 125RS,A01,515971,Geibel; William,17,0,20,3
1713307968366,CLRE 250,A00,511389,Morris; Sheldon,9996,0,9999,3
1713307969394,CLRE 251,A00,507176,Mehta; Ravindra L.,9996,0,9999,3
1713307969394,CLRE 251,B00,511410,Mehta; Ravindra L.,9998,0,9999,1
1713307970425,CLRE 252,A00,507189,Cuomo; Raphael Eduardo,9998,0,9999,1
1713307971451,CLRE 253,A00,507199,Vaida; Florin,9997,0,9999,2
1713307971451,CLRE 253,B00,507202,Vaida; Florin,9999,0,9999,0
1713307972481,CLRE 259,A00,507211,Patel; Hemal,9996,0,9999,3
1713307973505,CLRE 260,A00,507221,Cuomo; Raphael Eduardo,9999,0,9999,0
1713307974535,CLRE 297,001,507242,Cuomo; Raphael Eduardo,9999,0,9999,0
1713307975560,CSE 191,A00,516875,Minnes Kemp; Mor Mia,9999,0,9999,0
1713307976587,CSS 201S,A01,494383,Staff,35,0,35,0
1713307977611,CSS 202S,A01,494387,Staff,35,0,35,0
1713307978639,EAP 100,A00,516065,Staff,9792,0,9999,207
1713307979663,ECE 45,A01,507414,Staff,56,0,60,4
1713307980687,ECE 100,A01,507416,Baghdadchi; Saharnaz,12,0,20,8
1713307980687,ECE 100,A02,507418,Baghdadchi; Saharnaz,20,0,20,0
1713307981711,ECE 111,A01,507420,Staff,40,0,50,10
1713307982739,ECE 197,001,548057,Sievenpiper; Daniel F.,9998,0,9999,1
1713307983765,EDS 115,A00,507243,Choi; Bailey Miyeon,28,0,28,0
1713307984792,EDS 117,A01,494379,Staff,25,0,25,0
1713307985818,EDS 125,A00,507246,Hopkins; Megan Beth,29,0,30,1
1713307986843,EDS 128A,A01,507264,Fargason; Sharon Gayle,26,0,26,0
1713307987873,EDS 128B,A01,507293,Pappas; Elizabeth,30,0,30,0
1713307988899,EDS 139,A00,507294,Fargason; Sharon Gayle,30,0,30,0
1713307988899,EDS 139,B00,507313,Pappas; Elizabeth,30,0,30,0
1713307989926,EDS 201,A00,507315,Staff,26,0,30,4
1713307990952,EDS 203,A01,507317,Halter; Christopher P.,26,0,30,4
1713307991985,EDS 204R,A01,507319,Halter; Christopher P.,6,0,30,24
1713307991985,EDS 204R,B01,507331,Heinzman; Erica M.,30,0,30,0
1713307993010,EDS 206R,A00,507332,Staff,8,0,30,22
1713307993010,EDS 206R,B00,507343,Staff,29,0,30,1
1713307994034,EDS 250,A00,507344,Hemans; Patricia Ann Benitez,36,0,40,4
1713307995058,EDS 281,A00,507345,Daly; Alan J.,18,0,18,0
1713307996086,EDS 284,A00,507350,Daly; Alan J.,16,0,16,0
1713307997112,EDS 286,A00,507359,Fine; Sarah,18,0,18,0
1713307998138,EDS 289C,A01,507361,Daly; Alan J.,18,0,18,0
1713307999167,EDS 290,A00,507366,Hofstetter; Carolyn,15,0,15,0
1713308000201,LIGM 5A,A00,507421,Fischer-Grunski; Eva K,20,0,20,0
1713308001227,LIGM 5B,A00,507423,Fischer-Grunski; Eva K,20,0,20,0
1713308002258,LIGM 5C,A00,507425,Fischer-Grunski; Eva K,20,0,20,0
1713308003287,LIIT 5AS,A00,507427,Carnelos; Chiara,20,0,20,0
1713308004313,LIIT 5BS,A00,507430,Carnelos; Chiara,20,0,20,0
1713308005338,LIIT 5CS,A00,507432,Carnelos; Chiara,20,0,20,0
1713308006366,LISP 5A,A00,507541,Munoz Sanchez; Alicia,19,0,20,1
1713308007394,LISP 5B,A00,507671,Munoz Sanchez; Alicia,17,0,20,3
1713308008423,LISP 5C,A00,507696,Munoz Sanchez; Alicia,17,0,20,3
1713308009450,MAE 197,001,528363,Boechler; Nicholas Sebastia,9998,0,9999,1
1713308010477,MATH 197,001,523477,Kedlaya; Kiran S.,9999,0,9999,0
1713308010477,MATH 197,002,563811,Zhang; Danna,9999,0,9999,0
1713308011505,MCWP 40R,A00,518780,Staff,20,0,20,0
1713308011505,MCWP 40R,B00,518781,Staff,20,0,20,0
1713308011505,MCWP 40R,C00,518783,Staff,19,0,20,1
1713308012535,MCWP 50R,A00,518791,Staff,20,0,20,0
1713308012535,MCWP 50R,B00,518792,Staff,19,0,20,1
1713308012535,MCWP 50R,C00,518793,Staff,19,0,20,1
1713308012535,MCWP 50R,D00,518794,Staff,18,0,20,2
1713308012535,MCWP 50R,E00,518795,Staff,18,0,20,2
1713308012535,MCWP 50R,F00,518796,Staff,19,0,20,1
1713308012535,MCWP 50R,G00,518797,Staff,19,0,20,1
1713308013562,MMW 12R,A01,514034,Herbst; Matthew,16,0,16,0
1713308013562,MMW 12R,A02,514035,Herbst; Matthew,16,0,16,0
1713308014588,MMW 13R,A01,514037,Staff,14,0,16,2
1713308014588,MMW 13R,A02,514039,Staff,16,0,16,0
1713308016637,SIO 295LS,A00,523233,Staff,19,0,30,11
1713308017663,SIO 295S,A00,523232,Staff,19,0,30,11
1713308018691,SOCI 117,A01,494376,Staff,3,0,5,2
1713308019717,WES 237B,A00,494380,Staff,19,0,20,1
1713308021794,AESE 279B,A00,494370,Wade; Jon P,33,0,33,0
1713308022820,ANAR 135S,A00,494369,Braswell; Geoffrey E.,0,0,0,0
1713308023865,CAT 124RS,A01,519847,Geibel; William,17,0,20,3
1713308024891,CAT 125RS,A01,515971,Geibel; William,17,0,20,3
1713308025918,CLRE 250,A00,511389,Morris; Sheldon,9996,0,9999,3
1713308026945,CLRE 251,A00,507176,Mehta; Ravindra L.,9996,0,9999,3
1713308026945,CLRE 251,B00,511410,Mehta; Ravindra L.,9998,0,9999,1
1713308027977,CLRE 252,A00,507189,Cuomo; Raphael Eduardo,9998,0,9999,1
1713308029002,CLRE 253,A00,507199,Vaida; Florin,9997,0,9999,2
1713308029002,CLRE 253,B00,507202,Vaida; Florin,9999,0,9999,0
1713308030027,CLRE 259,A00,507211,Patel; Hemal,9996,0,9999,3
1713308031056,CLRE 260,A00,507221,Cuomo; Raphael Eduardo,9999,0,9999,0
1713308032079,CLRE 297,001,507242,Cuomo; Raphael Eduardo,9999,0,9999,0
1713308033107,CSE 191,A00,516875,Minnes Kemp; Mor Mia,9999,0,9999,0
1713308034133,CSS 201S,A01,494383,Staff,35,0,35,0
1713308035158,CSS 202S,A01,494387,Staff,35,0,35,0
1713308036185,EAP 100,A00,516065,Staff,9792,0,9999,207
1713308037211,ECE 45,A01,507414,Staff,56,0,60,4
1713308038244,ECE 100,A01,507416,Baghdadchi; Saharnaz,12,0,20,8
1713308038244,ECE 100,A02,507418,Baghdadchi; Saharnaz,20,0,20,0
1713308039268,ECE 111,A01,507420,Staff,40,0,50,10
1713308040297,ECE 197,001,548057,Sievenpiper; Daniel F.,9998,0,9999,1
1713308041323,EDS 115,A00,507243,Choi; Bailey Miyeon,28,0,28,0
1713308042349,EDS 117,A01,494379,Staff,25,0,25,0
1713308043375,EDS 125,A00,507246,Hopkins; Megan Beth,29,0,30,1
1713308044403,EDS 128A,A01,507264,Fargason; Sharon Gayle,26,0,26,0
1713308045436,EDS 128B,A01,507293,Pappas; Elizabeth,30,0,30,0
1713308046459,EDS 139,A00,507294,Fargason; Sharon Gayle,30,0,30,0
1713308046459,EDS 139,B00,507313,Pappas; Elizabeth,30,0,30,0
1713308047485,EDS 201,A00,507315,Staff,26,0,30,4
1713308048508,EDS 203,A01,507317,Halter; Christopher P.,26,0,30,4
1713308049534,EDS 204R,A01,507319,Halter; Christopher P.,6,0,30,24
1713308049534,EDS 204R,B01,507331,Heinzman; Erica M.,30,0,30,0
1713308050562,EDS 206R,A00,507332,Staff,8,0,30,22
1713308050562,EDS 206R,B00,507343,Staff,29,0,30,1
1713308051587,EDS 250,A00,507344,Hemans; Patricia Ann Benitez,36,0,40,4
1713308052613,EDS 281,A00,507345,Daly; Alan J.,18,0,18,0
1713308053639,EDS 284,A00,507350,Daly; Alan J.,16,0,16,0
1713308054666,EDS 286,A00,507359,Fine; Sarah,18,0,18,0
1713308055691,EDS 289C,A01,507361,Daly; Alan J.,18,0,18,0
1713308056717,EDS 290,A00,507366,Hofstetter; Carolyn,15,0,15,0
1713308057742,LIGM 5A,A00,507421,Fischer-Grunski; Eva K,20,0,20,0
1713308058773,LIGM 5B,A00,507423,Fischer-Grunski; Eva K,20,0,20,0
1713308059798,LIGM 5C,A00,507425,Fischer-Grunski; Eva K,20,0,20,0
1713308060824,LIIT 5AS,A00,507427,Carnelos; Chiara,20,0,20,0
1713308061850,LIIT 5BS,A00,507430,Carnelos; Chiara,20,0,20,0
1713308062877,LIIT 5CS,A00,507432,Carnelos; Chiara,20,0,20,0
1713308063905,LISP 5A,A00,507541,Munoz Sanchez; Alicia,19,0,20,1
1713308064936,LISP 5B,A00,507671,Munoz Sanchez; Alicia,17,0,20,3
1713308065966,LISP 5C,A00,507696,Munoz Sanchez; Alicia,17,0,20,3
1713308066992,MAE 197,001,528363,Boechler; Nicholas Sebastia,9998,0,9999,1
1713308068073,MATH 197,001,523477,Kedlaya; Kiran S.,9999,0,9999,0
1713308068073,MATH 197,002,563811,Zhang; Danna,9999,0,9999,0
1713308069098,MCWP 40R,A00,518780,Staff,20,0,20,0
1713308069098,MCWP 40R,B00,518781,Staff,20,0,20,0
1713308069098,MCWP 40R,C00,518783,Staff,19,0,20,1
1713308070124,MCWP 50R,A00,518791,Staff,20,0,20,0
1713308070124,MCWP 50R,B00,518792,Staff,19,0,20,1
1713308070124,MCWP 50R,C00,518793,Staff,19,0,20,1
1713308070124,MCWP 50R,D00,518794,Staff,18,0,20,2
1713308070124,MCWP 50R,E00,518795,Staff,18,0,20,2
1713308070124,MCWP 50R,F00,518796,Staff,19,0,20,1
1713308070124,MCWP 50R,G00,518797,Staff,19,0,20,1
1713308071149,MMW 12R,A01,514034,Herbst; Matthew,16,0,16,0
1713308071149,MMW 12R,A02,514035,Herbst; Matthew,16,0,16,0
1713308072172,MMW 13R,A01,514037,Staff,14,0,16,2
1713308072172,MMW 13R,A02,514039,Staff,16,0,16,0
1713308074225,SIO 295LS,A00,523233,Staff,19,0,30,11
1713308075253,SIO 295S,A00,523232,Staff,19,0,30,11
1713308076278,SOCI 117,A01,494376,Staff,3,0,5,2
1713308077303,WES 237B,A00,494380,Staff,19,0,20,1
1713308079361,AESE 279B,A00,494370,Wade; Jon P,33,0,33,0
1713308080389,ANAR 135S,A00,494369,Braswell; Geoffrey E.,0,0,0,0
1713308081415,CAT 124RS,A01,519847,Geibel; William,17,0,20,3
1713308082443,CAT 125RS,A01,515971,Geibel; William,17,0,20,3
1713308083470,CLRE 250,A00,511389,Morris; Sheldon,9996,0,9999,3
1713308084496,CLRE 251,A00,507176,Mehta; Ravindra L.,9996,0,9999,3
1713308084496,CLRE 251,B00,511410,Mehta; Ravindra L.,9998,0,9999,1
1713308085525,CLRE 252,A00,507189,Cuomo; Raphael Eduardo,9998,0,9999,1
1713308086555,CLRE 253,A00,507199,Vaida; Florin,9997,0,9999,2
1713308086555,CLRE 253,B00,507202,Vaida; Florin,9999,0,9999,0
1713308087586,CLRE 259,A00,507211,Patel; Hemal,9996,0,9999,3
1713308088611,CLRE 260,A00,507221,Cuomo; Raphael Eduardo,9999,0,9999,0
1713308089638,CLRE 297,001,507242,Cuomo; Raphael Eduardo,9999,0,9999,0
1713308090667,CSE 191,A00,516875,Minnes Kemp; Mor Mia,9999,0,9999,0
1713308091696,CSS 201S,A01,494383,Staff,35,0,35,0
1713308092722,CSS 202S,A01,494387,Staff,35,0,35,0
1713308093746,EAP 100,A00,516065,Staff,9792,0,9999,207
1713308094772,ECE 45,A01,507414,Staff,56,0,60,4
1713308095799,ECE 100,A01,507416,Baghdadchi; Saharnaz,12,0,20,8
1713308095799,ECE 100,A02,507418,Baghdadchi; Saharnaz,20,0,20,0
1713308096825,ECE 111,A01,507420,Staff,40,0,50,10
1713308097852,ECE 197,001,548057,Sievenpiper; Daniel F.,9998,0,9999,1
1713308098881,EDS 115,A00,507243,Choi; Bailey Miyeon,28,0,28,0
1713308099909,EDS 117,A01,494379,Staff,25,0,25,0
1713308100935,EDS 125,A00,507246,Hopkins; Megan Beth,29,0,30,1
1713308101966,EDS 128A,A01,507264,Fargason; Sharon Gayle,26,0,26,0
1713308102994,EDS 128B,A01,507293,Pappas; Elizabeth,30,0,30,0
1713308104019,EDS 139,A00,507294,Fargason; Sharon Gayle,30,0,30,0
1713308104019,EDS 139,B00,507313,Pappas; Elizabeth,30,0,30,0
1713308105044,EDS 201,A00,507315,Staff,26,0,30,4
1713308106075,EDS 203,A01,507317,Halter; Christopher P.,26,0,30,4
1713308107101,EDS 204R,A01,507319,Halter; Christopher P.,5,0,30,25
1713308107101,EDS 204R,B01,507331,Heinzman; Erica M.,30,0,30,0
1713308108129,EDS 206R,A00,507332,Staff,8,0,30,22
1713308108129,EDS 206R,B00,507343,Staff,29,0,30,1
1713308109154,EDS 250,A00,507344,Hemans; Patricia Ann Benitez,36,0,40,4
1713308110178,EDS 281,A00,507345,Daly; Alan J.,18,0,18,0
1713308111207,EDS 284,A00,507350,Daly; Alan J.,16,0,16,0
1713308112232,EDS 286,A00,507359,Fine; Sarah,18,0,18,0
1713308113261,EDS 289C,A01,507361,Daly; Alan J.,18,0,18,0
1713308114291,EDS 290,A00,507366,Hofstetter; Carolyn,15,0,15,0
1713308115321,LIGM 5A,A00,507421,Fischer-Grunski; Eva K,20,0,20,0
1713308116350,LIGM 5B,A00,507423,Fischer-Grunski; Eva K,20,0,20,0
1713308117376,LIGM 5C,A00,507425,Fischer-Grunski; Eva K,20,0,20,0
1713308118398,LIIT 5AS,A00,507427,Carnelos; Chiara,20,0,20,0
1713308119423,LIIT 5BS,A00,507430,Carnelos; Chiara,20,0,20,0
1713308120448,LIIT 5CS,A00,507432,Carnelos; Chiara,20,0,20,0
1713308121471,LISP 5A,A00,507541,Munoz Sanchez; Alicia,19,0,20,1
1713308122496,LISP 5B,A00,507671,Munoz Sanchez; Alicia,17,0,20,3
1713308123520,LISP 5C,A00,507696,Munoz Sanchez; Alicia,17,0,20,3
1713308124545,MAE 197,001,528363,Boechler; Nicholas Sebastia,9998,0,9999,1
1713308125574,MATH 197,001,523477,Kedlaya; Kiran S.,9999,0,9999,0
1713308125574,MATH 197,002,563811,Zhang; Danna,9999,0,9999,0
1713308126602,MCWP 40R,A00,518780,Staff,20,0,20,0
1713308126602,MCWP 40R,B00,518781,Staff,20,0,20,0
1713308126602,MCWP 40R,C00,518783,Staff,19,0,20,1
1713308127631,MCWP 50R,A00,518791,Staff,20,0,20,0
1713308127631,MCWP 50R,B00,518792,Staff,19,0,20,1
1713308127631,MCWP 50R,C00,518793,Staff,19,0,20,1
1713308127631,MCWP 50R,D00,518794,Staff,18,0,20,2
1713308127631,MCWP 50R,E00,518795,Staff,18,0,20,2
1713308127631,MCWP 50R,F00,518796,Staff,19,0,20,1
1713308127631,MCWP 50R,G00,518797,Staff,19,0,20,1
1713308128655,MMW 12R,A01,514034,Herbst; Matthew,16,0,16,0
1713308128655,MMW 12R,A02,514035,Herbst; Matthew,16,0,16,0
1713308129682,MMW 13R,A01,514037,Staff,14,0,16,2
1713308129682,MMW 13R,A02,514039,Staff,16,0,16,0
1713308131739,SIO 295LS,A00,523233,Staff,19,0,30,11
1713308132763,SIO 295S,A00,523232,Staff,19,0,30,11
1713308133790,SOCI 117,A01,494376,Staff,3,0,5,2
1713308134814,WES 237B,A00,494380,Staff,19,0,20,1
1713308136878,AESE 279B,A00,494370,Wade; Jon P,33,0,33,0
1713308137906,ANAR 135S,A00,494369,Braswell; Geoffrey E.,0,0,0,0
1713308138938,CAT 124RS,A01,519847,Geibel; William,17,0,20,3
1713308139967,CAT 125RS,A01,515971,Geibel; William,17,0,20,3
1713308140993,CLRE 250,A00,511389,Morris; Sheldon,9996,0,9999,3
1713308142021,CLRE 251,A00,507176,Mehta; Ravindra L.,9996,0,9999,3
1713308142021,CLRE 251,B00,511410,Mehta; Ravindra L.,9998,0,9999,1
1713308143047,CLRE 252,A00,507189,Cuomo; Raphael Eduardo,9998,0,9999,1
1713308144073,CLRE 253,A00,507199,Vaida; Florin,9997,0,9999,2
1713308144073,CLRE 253,B00,507202,Vaida; Florin,9999,0,9999,0
1713308145103,CLRE 259,A00,507211,Patel; Hemal,9996,0,9999,3
1713308146129,CLRE 260,A00,507221,Cuomo; Raphael Eduardo,9999,0,9999,0
1713308147158,CLRE 297,001,507242,Cuomo; Raphael Eduardo,9999,0,9999,0
1713308148189,CSE 191,A00,516875,Minnes Kemp; Mor Mia,9999,0,9999,0
1713308149215,CSS 201S,A01,494383,Staff,35,0,35,0
1713308150247,CSS 202S,A01,494387,Staff,35,0,35,0
1713308151273,EAP 100,A00,516065,Staff,9792,0,9999,207
1713308152296,ECE 45,A01,507414,Staff,56,0,60,4
1713308153328,ECE 100,A01,507416,Baghdadchi; Saharnaz,12,0,20,8
1713308153328,ECE 100,A02,507418,Baghdadchi; Saharnaz,20,0,20,0
1713308154357,ECE 111,A01,507420,Staff,40,0,50,10
1713308155381,ECE 197,001,548057,Sievenpiper; Daniel F.,9998,0,9999,1
1713308156408,EDS 115,A00,507243,Choi; Bailey Miyeon,28,0,28,0
1713308157432,EDS 117,A01,494379,Staff,25,0,25,0
1713308158462,EDS 125,A00,507246,Hopkins; Megan Beth,29,0,30,1
1713308159487,EDS 128A,A01,507264,Fargason; Sharon Gayle,26,0,26,0
1713308160512,EDS 128B,A01,507293,Pappas; Elizabeth,30,0,30,0
1713308161537,EDS 139,A00,507294,Fargason; Sharon Gayle,30,0,30,0
1713308161537,EDS 139,B00,507313,Pappas; Elizabeth,30,0,30,0
1713308162563,EDS 201,A00,507315,Staff,26,0,30,4
1713308163590,EDS 203,A01,507317,Halter; Christopher P.,26,0,30,4
1713308164618,EDS 204R,A01,507319,Halter; Christopher P.,5,0,30,25
1713308164618,EDS 204R,B01,507331,Heinzman; Erica M.,30,0,30,0
1713308165644,EDS 206R,A00,507332,Staff,8,0,30,22
1713308165644,EDS 206R,B00,507343,Staff,29,0,30,1
1713308166673,EDS 250,A00,507344,Hemans; Patricia Ann Benitez,36,0,40,4
1713308167699,EDS 281,A00,507345,Daly; Alan J.,18,0,18,0
1713308168725,EDS 284,A00,507350,Daly; Alan J.,16,0,16,0
1713308169750,EDS 286,A00,507359,Fine; Sarah,18,0,18,0
1713308170780,EDS 289C,A01,507361,Daly; Alan J.,18,0,18,0
1713308171875,EDS 290,A00,507366,Hofstetter; Carolyn,15,0,15,0
1713308172901,LIGM 5A,A00,507421,Fischer-Grunski; Eva K,20,0,20,0
1713308173926,LIGM 5B,A00,507423,Fischer-Grunski; Eva K,20,0,20,0
1713308174954,LIGM 5C,A00,507425,Fischer-Grunski; Eva K,20,0,20,0
1713308175979,LIIT 5AS,A00,507427,Carnelos; Chiara,20,0,20,0
1713308177005,LIIT 5BS,A00,507430,Carnelos; Chiara,20,0,20,0
1713308178030,LIIT 5CS,A00,507432,Carnelos; Chiara,20,0,20,0
1713308179056,LISP 5A,A00,507541,Munoz Sanchez; Alicia,19,0,20,1
1713308180086,LISP 5B,A00,507671,Munoz Sanchez; Alicia,17,0,20,3
1713308181117,LISP 5C,A00,507696,Munoz Sanchez; Alicia,17,0,20,3
1713308182143,MAE 197,001,528363,Boechler; Nicholas Sebastia,9998,0,9999,1
1713308183172,MATH 197,001,523477,Kedlaya; Kiran S.,9999,0,9999,0
1713308183172,MATH 197,002,563811,Zhang; Danna,9999,0,9999,0
1713308184199,MCWP 40R,A00,518780,Staff,20,0,20,0
1713308184199,MCWP 40R,B00,518781,Staff,20,0,20,0
1713308184199,MCWP 40R,C00,518783,Staff,19,0,20,1
1713308185229,MCWP 50R,A00,518791,Staff,20,0,20,0
1713308185229,MCWP 50R,B00,518792,Staff,19,0,20,1
1713308185229,MCWP 50R,C00,518793,Staff,19,0,20,1
1713308185229,MCWP 50R,D00,518794,Staff,18,0,20,2
1713308185229,MCWP 50R,E00,518795,Staff,18,0,20,2
1713308185229,MCWP 50R,F00,518796,Staff,19,0,20,1
1713308185229,MCWP 50R,G00,518797,Staff,19,0,20,1
1713308186256,MMW 12R,A01,514034,Herbst; Matthew,16,0,16,0
1713308186256,MMW 12R,A02,514035,Herbst; Matthew,16,0,16,0
1713308187280,MMW 13R,A01,514037,Staff,14,0,16,2
1713308187280,MMW 13R,A02,514039,Staff,16,0,16,0
1713308189331,SIO 295LS,A00,523233,Staff,19,0,30,11
1713308190355,SIO 295S,A00,523232,Staff,19,0,30,11
1713308191379,SOCI 117,A01,494376,Staff,3,0,5,2
1713308192406,WES 237B,A00,494380,Staff,19,0,20,1
1713308194483,AESE 279B,A00,494370,Wade; Jon P,33,0,33,0
1713308195508,ANAR 135S,A00,494369,Braswell; Geoffrey E.,0,0,0,0
1713308196532,CAT 124RS,A01,519847,Geibel; William,17,0,20,3
1713308197557,CAT 125RS,A01,515971,Geibel; William,17,0,20,3
1713308198582,CLRE 250,A00,511389,Morris; Sheldon,9996,0,9999,3
1713308199614,CLRE 251,A00,507176,Mehta; Ravindra L.,9996,0,9999,3
1713308199614,CLRE 251,B00,511410,Mehta; Ravindra L.,9998,0,9999,1
1713308200639,CLRE 252,A00,507189,Cuomo; Raphael Eduardo,9998,0,9999,1
1713308201670,CLRE 253,A00,507199,Vaida; Florin,9997,0,9999,2
1713308201670,CLRE 253,B00,507202,Vaida; Florin,9999,0,9999,0
1713308202700,CLRE 259,A00,507211,Patel; Hemal,9996,0,9999,3
1713308203725,CLRE 260,A00,507221,Cuomo; Raphael Eduardo,9999,0,9999,0
1713308204750,CLRE 297,001,507242,Cuomo; Raphael Eduardo,9999,0,9999,0
1713308205774,CSE 191,A00,516875,Minnes Kemp; Mor Mia,9999,0,9999,0
1713308206803,CSS 201S,A01,494383,Staff,35,0,35,0
1713308207829,CSS 202S,A01,494387,Staff,35,0,35,0
1713308208857,EAP 100,A00,516065,Staff,9792,0,9999,207
1713308209881,ECE 45,A01,507414,Staff,56,0,60,4
1713308210906,ECE 100,A01,507416,Baghdadchi; Saharnaz,12,0,20,8
1713308210906,ECE 100,A02,507418,Baghdadchi; Saharnaz,20,0,20,0
1713308211932,ECE 111,A01,507420,Staff,40,0,50,10
1713308212958,ECE 197,001,548057,Sievenpiper; Daniel F.,9998,0,9999,1
1713308213983,EDS 115,A00,507243,Choi; Bailey Miyeon,28,0,28,0
1713308215012,EDS 117,A01,494379,Staff,25,0,25,0
1713308216040,EDS 125,A00,507246,Hopkins; Megan Beth,29,0,30,1
1713308217065,EDS 128A,A01,507264,Fargason; Sharon Gayle,26,0,26,0
1713308218091,EDS 128B,A01,507293,Pappas; Elizabeth,30,0,30,0
1713308219123,EDS 139,A00,507294,Fargason; Sharon Gayle,30,0,30,0
1713308219123,EDS 139,B00,507313,Pappas; Elizabeth,30,0,30,0
1713308220153,EDS 201,A00,507315,Staff,26,0,30,4
1713308221179,EDS 203,A01,507317,Halter; Christopher P.,26,0,30,4
1713308222205,EDS 204R,A01,507319,Halter; Christopher P.,5,0,30,25
1713308222205,EDS 204R,B01,507331,Heinzman; Erica M.,30,0,30,0
1713308223230,EDS 206R,A00,507332,Staff,7,0,30,23
1713308223230,EDS 206R,B00,507343,Staff,29,0,30,1
1713308224259,EDS 250,A00,507344,Hemans; Patricia Ann Benitez,36,0,40,4
1713308225284,EDS 281,A00,507345,Daly; Alan J.,18,0,18,0
1713308226309,EDS 284,A00,507350,Daly; Alan J.,16,0,16,0
1713308227333,EDS 286,A00,507359,Fine; Sarah,18,0,18,0
1713308228360,EDS 289C,A01,507361,Daly; Alan J.,18,0,18,0
1713308229387,EDS 290,A00,507366,Hofstetter; Carolyn,15,0,15,0
1713308230414,LIGM 5A,A00,507421,Fischer-Grunski; Eva K,20,0,20,0
1713308231440,LIGM 5B,A00,507423,Fischer-Grunski; Eva K,20,0,20,0
1713308232464,LIGM 5C,A00,507425,Fischer-Grunski; Eva K,20,0,20,0
1713308233491,LIIT 5AS,A00,507427,Carnelos; Chiara,20,0,20,0
1713308234522,LIIT 5BS,A00,507430,Carnelos; Chiara,20,0,20,0
1713308235548,LIIT 5CS,A00,507432,Carnelos; Chiara,20,0,20,0
1713308236575,LISP 5A,A00,507541,Munoz Sanchez; Alicia,19,0,20,1
1713308237600,LISP 5B,A00,507671,Munoz Sanchez; Alicia,17,0,20,3
1713308238639,LISP 5C,A00,507696,Munoz Sanchez; Alicia,17,0,20,3
1713308239668,MAE 197,001,528363,Boechler; Nicholas Sebastia,9998,0,9999,1
1713308240697,MATH 197,001,523477,Kedlaya; Kiran S.,9999,0,9999,0
1713308240697,MATH 197,002,563811,Zhang; Danna,9999,0,9999,0
1713308241724,MCWP 40R,A00,518780,Staff,20,0,20,0
1713308241724,MCWP 40R,B00,518781,Staff,20,0,20,0
1713308241724,MCWP 40R,C00,518783,Staff,19,0,20,1
1713308242756,MCWP 50R,A00,518791,Staff,20,0,20,0
1713308242756,MCWP 50R,B00,518792,Staff,19,0,20,1
1713308242756,MCWP 50R,C00,518793,Staff,19,0,20,1
1713308242756,MCWP 50R,D00,518794,Staff,18,0,20,2
1713308242756,MCWP 50R,E00,518795,Staff,18,0,20,2
1713308242756,MCWP 50R,F00,518796,Staff,19,0,20,1
1713308242756,MCWP 50R,G00,518797,Staff,19,0,20,1
1713308243787,MMW 12R,A01,514034,Herbst; Matthew,16,0,16,0
1713308243787,MMW 12R,A02,514035,Herbst; Matthew,16,0,16,0
1713308244818,MMW 13R,A01,514037,Staff,14,0,16,2
1713308244818,MMW 13R,A02,514039,Staff,16,0,16,0
1713308246870,SIO 295LS,A00,523233,Staff,19,0,30,11
1713308247895,SIO 295S,A00,523232,Staff,19,0,30,11
1713308248919,SOCI 117,A01,494376,Staff,3,0,5,2
1713308249943,WES 237B,A00,494380,Staff,19,0,20,1
1713308252016,AESE 279B,A00,494370,Wade; Jon P,33,0,33,0
1713308253043,ANAR 135S,A00,494369,Braswell; Geoffrey E.,0,0,0,0
1713308254071,CAT 124RS,A01,519847,Geibel; William,17,0,20,3
1713308255095,CAT 125RS,A01,515971,Geibel; William,17,0,20,3
1713308256121,CLRE 250,A00,511389,Morris; Sheldon,9996,0,9999,3
1713308257149,CLRE 251,A00,507176,Mehta; Ravindra L.,9996,0,9999,3
1713308257149,CLRE 251,B00,511410,Mehta; Ravindra L.,9998,0,9999,1
1713308258176,CLRE 252,A00,507189,Cuomo; Raphael Eduardo,9998,0,9999,1
1713308259202,CLRE 253,A00,507199,Vaida; Florin,9997,0,9999,2
1713308259202,CLRE 253,B00,507202,Vaida; Florin,9999,0,9999,0
1713308260230,CLRE 259,A00,507211,Patel; Hemal,9996,0,9999,3
1713308261255,CLRE 260,A00,507221,Cuomo; Raphael Eduardo,9999,0,9999,0
1713308262277,CLRE 297,001,507242,Cuomo; Raphael Eduardo,9999,0,9999,0
1713308263305,CSE 191,A00,516875,Minnes Kemp; Mor Mia,9999,0,9999,0
1713308264329,CSS 201S,A01,494383,Staff,35,0,35,0
1713308265356,CSS 202S,A01,494387,Staff,35,0,35,0
1713308266382,EAP 100,A00,516065,Staff,9792,0,9999,207
1713308267406,ECE 45,A01,507414,Staff,56,0,60,4
1713308268434,ECE 100,A01,507416,Baghdadchi; Saharnaz,12,0,20,8
1713308268434,ECE 100,A02,507418,Baghdadchi; Saharnaz,20,0,20,0
1713308269459,ECE 111,A01,507420,Staff,40,0,50,10
1713308270488,ECE 197,001,548057,Sievenpiper; Daniel F.,9998,0,9999,1
1713308271520,EDS 115,A00,507243,Choi; Bailey Miyeon,28,0,28,0
1713308272545,EDS 117,A01,494379,Staff,25,0,25,0
1713308273576,EDS 125,A00,507246,Hopkins; Megan Beth,29,0,30,1
1713308274602,EDS 128A,A01,507264,Fargason; Sharon Gayle,26,0,26,0
1713308275682,EDS 128B,A01,507293,Pappas; Elizabeth,30,0,30,0
1713308276705,EDS 139,A00,507294,Fargason; Sharon Gayle,30,0,30,0
1713308276705,EDS 139,B00,507313,Pappas; Elizabeth,30,0,30,0
1713308277729,EDS 201,A00,507315,Staff,26,0,30,4
1713308278754,EDS 203,A01,507317,Halter; Christopher P.,26,0,30,4
1713308279778,EDS 204R,A01,507319,Halter; Christopher P.,5,0,30,25
1713308279778,EDS 204R,B01,507331,Heinzman; Erica M.,30,0,30,0
1713308280803,EDS 206R,A00,507332,Staff,7,0,30,23
1713308280803,EDS 206R,B00,507343,Staff,29,0,30,1
1713308281827,EDS 250,A00,507344,Hemans; Patricia Ann Benitez,36,0,40,4
1713308282851,EDS 281,A00,507345,Daly; Alan J.,18,0,18,0
1713308283878,EDS 284,A00,507350,Daly; Alan J.,16,0,16,0
1713308284902,EDS 286,A00,507359,Fine; Sarah,18,0,18,0
1713308285928,EDS 289C,A01,507361,Daly; Alan J.,18,0,18,0
1713308286954,EDS 290,A00,507366,Hofstetter; Carolyn,15,0,15,0
1713308287980,LIGM 5A,A00,507421,Fischer-Grunski; Eva K,20,0,20,0
1713308289006,LIGM 5B,A00,507423,Fischer-Grunski; Eva K,20,0,20,0
1713308290039,LIGM 5C,A00,507425,Fischer-Grunski; Eva K,20,0,20,0
1713308291062,LIIT 5AS,A00,507427,Carnelos; Chiara,20,0,20,0
1713308292088,LIIT 5BS,A00,507430,Carnelos; Chiara,20,0,20,0
1713308293121,LIIT 5CS,A00,507432,Carnelos; Chiara,20,0,20,0
1713308294148,LISP 5A,A00,507541,Munoz Sanchez; Alicia,19,0,20,1
1713308295173,LISP 5B,A00,507671,Munoz Sanchez; Alicia,17,0,20,3
1713308296198,LISP 5C,A00,507696,Munoz Sanchez; Alicia,17,0,20,3
1713308297228,MAE 197,001,528363,Boechler; Nicholas Sebastia,9998,0,9999,1
1713308298253,MATH 197,001,523477,Kedlaya; Kiran S.,9999,0,9999,0
1713308298253,MATH 197,002,563811,Zhang; Danna,9999,0,9999,0
1713308299279,MCWP 40R,A00,518780,Staff,20,0,20,0
1713308299279,MCWP 40R,B00,518781,Staff,20,0,20,0
1713308299279,MCWP 40R,C00,518783,Staff,19,0,20,1
1713308300303,MCWP 50R,A00,518791,Staff,20,0,20,0
1713308300303,MCWP 50R,B00,518792,Staff,19,0,20,1
1713308300303,MCWP 50R,C00,518793,Staff,19,0,20,1
1713308300303,MCWP 50R,D00,518794,Staff,18,0,20,2
1713308300303,MCWP 50R,E00,518795,Staff,18,0,20,2
1713308300303,MCWP 50R,F00,518796,Staff,19,0,20,1
1713308300303,MCWP 50R,G00,518797,Staff,19,0,20,1
1713308301326,MMW 12R,A01,514034,Herbst; Matthew,16,0,16,0
1713308301326,MMW 12R,A02,514035,Herbst; Matthew,16,0,16,0
1713308302353,MMW 13R,A01,514037,Staff,14,0,16,2
1713308302353,MMW 13R,A02,514039,Staff,16,0,16,0
1713308304408,SIO 295LS,A00,523233,Staff,19,0,30,11
1713308305438,SIO 295S,A00,523232,Staff,19,0,30,11
1713308306468,SOCI 117,A01,494376,Staff,3,0,5,2
1713308307495,WES 237B,A00,494380,Staff,19,0,20,1
1713308309570,AESE 279B,A00,494370,Wade; Jon P,33,0,33,0
1713308310593,ANAR 135S,A00,494369,Braswell; Geoffrey E.,0,0,0,0
1713308311616,CAT 124RS,A01,519847,Geibel; William,17,0,20,3
1713308312646,CAT 125RS,A01,515971,Geibel; William,17,0,20,3
1713308313672,CLRE 250,A00,511389,Morris; Sheldon,9996,0,9999,3
1713308314700,CLRE 251,A00,507176,Mehta; Ravindra L.,9996,0,9999,3
1713308314700,CLRE 251,B00,511410,Mehta; Ravindra L.,9998,0,9999,1
1713308315725,CLRE 252,A00,507189,Cuomo; Raphael Eduardo,9998,0,9999,1
1713308316856,CLRE 253,A00,507199,Vaida; Florin,9997,0,9999,2
1713308316856,CLRE 253,B00,507202,Vaida; Florin,9999,0,9999,0
1713308317883,CLRE 259,A00,507211,Patel; Hemal,9996,0,9999,3
1713308318906,CLRE 260,A00,507221,Cuomo; Raphael Eduardo,9999,0,9999,0
1713308319934,CLRE 297,001,507242,Cuomo; Raphael Eduardo,9999,0,9999,0
1713308320958,CSE 191,A00,516875,Minnes Kemp; Mor Mia,9999,0,9999,0
1713308321989,CSS 201S,A01,494383,Staff,35,0,35,0
1713308323015,CSS 202S,A01,494387,Staff,35,0,35,0
1713308324038,EAP 100,A00,516065,Staff,9792,0,9999,207
1713308325077,ECE 45,A01,507414,Staff,56,0,60,4
1713308326103,ECE 100,A01,507416,Baghdadchi; Saharnaz,12,0,20,8
1713308326103,ECE 100,A02,507418,Baghdadchi; Saharnaz,20,0,20,0
1713308327134,ECE 111,A01,507420,Staff,40,0,50,10
1713308328160,ECE 197,001,548057,Sievenpiper; Daniel F.,9998,0,9999,1
1713308329185,EDS 115,A00,507243,Choi; Bailey Miyeon,28,0,28,0
1713308330214,EDS 117,A01,494379,Staff,25,0,25,0
1713308331237,EDS 125,A00,507246,Hopkins; Megan Beth,29,0,30,1
1713308332265,EDS 128A,A01,507264,Fargason; Sharon Gayle,26,0,26,0
1713308333290,EDS 128B,A01,507293,Pappas; Elizabeth,30,0,30,0
1713308334315,EDS 139,A00,507294,Fargason; Sharon Gayle,30,0,30,0
1713308334315,EDS 139,B00,507313,Pappas; Elizabeth,30,0,30,0
1713308335346,EDS 201,A00,507315,Staff,26,0,30,4
1713308336375,EDS 203,A01,507317,Halter; Christopher P.,26,0,30,4
1713308337400,EDS 204R,A01,507319,Halter; Christopher P.,5,0,30,25
1713308337400,EDS 204R,B01,507331,Heinzman; Erica M.,30,0,30,0
1713308338430,EDS 206R,A00,507332,Staff,7,0,30,23
1713308338430,EDS 206R,B00,507343,Staff,29,0,30,1
1713308339454,EDS 250,A00,507344,Hemans; Patricia Ann Benitez,36,0,40,4
1713308340479,EDS 281,A00,507345,Daly; Alan J.,18,0,18,0
1713308341504,EDS 284,A00,507350,Daly; Alan J.,16,0,16,0
1713308342531,EDS 286,A00,507359,Fine; Sarah,18,0,18,0
1713308343556,EDS 289C,A01,507361,Daly; Alan J.,18,0,18,0
1713308344585,EDS 290,A00,507366,Hofstetter; Carolyn,15,0,15,0
1713308345611,LIGM 5A,A00,507421,Fischer-Grunski; Eva K,20,0,20,0
1713308346635,LIGM 5B,A00,507423,Fischer-Grunski; Eva K,20,0,20,0
1713308347661,LIGM 5C,A00,507425,Fischer-Grunski; Eva K,20,0,20,0
1713308348689,LIIT 5AS,A00,507427,Carnelos; Chiara,20,0,20,0
1713308349720,LIIT 5BS,A00,507430,Carnelos; Chiara,20,0,20,0
1713308350750,LIIT 5CS,A00,507432,Carnelos; Chiara,20,0,20,0
1713308351776,LISP 5A,A00,507541,Munoz Sanchez; Alicia,19,0,20,1
1713308352801,LISP 5B,A00,507671,Munoz Sanchez; Alicia,17,0,20,3
1713308353828,LISP 5C,A00,507696,Munoz Sanchez; Alicia,17,0,20,3
1713308354856,MAE 197,001,528363,Boechler; Nicholas Sebastia,9998,0,9999,1
1713308355884,MATH 197,001,523477,Kedlaya; Kiran S.,9999,0,9999,0
1713308355884,MATH 197,002,563811,Zhang; Danna,9999,0,9999,0
1713308356915,MCWP 40R,A00,518780,Staff,20,0,20,0
1713308356915,MCWP 40R,B00,518781,Staff,20,0,20,0
1713308356915,MCWP 40R,C00,518783,Staff,19,0,20,1
1713308357941,MCWP 50R,A00,518791,Staff,20,0,20,0
1713308357941,MCWP 50R,B00,518792,Staff,19,0,20,1
1713308357941,MCWP 50R,C00,518793,Staff,19,0,20,1
1713308357941,MCWP 50R,D00,518794,Staff,18,0,20,2
1713308357941,MCWP 50R,E00,518795,Staff,18,0,20,2
1713308357941,MCWP 50R,F00,518796,Staff,19,0,20,1
1713308357941,MCWP 50R,G00,518797,Staff,19,0,20,1
1713308358966,MMW 12R,A01,514034,Herbst; Matthew,16,0,16,0
1713308358966,MMW 12R,A02,514035,Herbst; Matthew,16,0,16,0
1713308359991,MMW 13R,A01,514037,Staff,14,0,16,2
1713308359991,MMW 13R,A02,514039,Staff,16,0,16,0
1713308362040,SIO 295LS,A00,523233,Staff,19,0,30,11
1713308363071,SIO 295S,A00,523232,Staff,19,0,30,11
1713308364101,SOCI 117,A01,494376,Staff,3,0,5,2
1713308365126,WES 237B,A00,494380,Staff,19,0,20,1
1713308367198,AESE 279B,A00,494370,Wade; Jon P,33,0,33,0
1713308368227,ANAR 135S,A00,494369,Braswell; Geoffrey E.,0,0,0,0
1713308369251,CAT 124RS,A01,519847,Geibel; William,17,0,20,3
1713308370279,CAT 125RS,A01,515971,Geibel; William,17,0,20,3
1713308371306,CLRE 250,A00,511389,Morris; Sheldon,9996,0,9999,3
1713308372330,CLRE 251,A00,507176,Mehta; Ravindra L.,9996,0,9999,3
1713308372330,CLRE 251,B00,511410,Mehta; Ravindra L.,9998,0,9999,1
1713308373353,CLRE 252,A00,507189,Cuomo; Raphael Eduardo,9998,0,9999,1
1713308374377,CLRE 253,A00,507199,Vaida; Florin,9997,0,9999,2
1713308374377,CLRE 253,B00,507202,Vaida; Florin,9999,0,9999,0
1713308375404,CLRE 259,A00,507211,Patel; Hemal,9996,0,9999,3
1713308376432,CLRE 260,A00,507221,Cuomo; Raphael Eduardo,9999,0,9999,0
1713308377459,CLRE 297,001,507242,Cuomo; Raphael Eduardo,9999,0,9999,0
1713308378486,CSE 191,A00,516875,Minnes Kemp; Mor Mia,9999,0,9999,0
1713308379568,CSS 201S,A01,494383,Staff,35,0,35,0
1713308380677,CSS 202S,A01,494387,Staff,35,0,35,0
1713308381702,EAP 100,A00,516065,Staff,9792,0,9999,207
1713308382731,ECE 45,A01,507414,Staff,56,0,60,4
1713308383760,ECE 100,A01,507416,Baghdadchi; Saharnaz,11,0,20,9
1713308383760,ECE 100,A02,507418,Baghdadchi; Saharnaz,20,0,20,0
1713308384786,ECE 111,A01,507420,Staff,40,0,50,10
1713308385812,ECE 197,001,548057,Sievenpiper; Daniel F.,9998,0,9999,1
1713308386840,EDS 115,A00,507243,Choi; Bailey Miyeon,28,0,28,0
1713308387868,EDS 117,A01,494379,Staff,25,0,25,0
1713308388893,EDS 125,A00,507246,Hopkins; Megan Beth,29,0,30,1
1713308389925,EDS 128A,A01,507264,Fargason; Sharon Gayle,26,0,26,0
1713308390950,EDS 128B,A01,507293,Pappas; Elizabeth,30,0,30,0
1713308391978,EDS 139,A00,507294,Fargason; Sharon Gayle,30,0,30,0
1713308391978,EDS 139,B00,507313,Pappas; Elizabeth,30,0,30,0
1713308393001,EDS 201,A00,507315,Staff,26,0,30,4
1713308394032,EDS 203,A01,507317,Halter; Christopher P.,26,0,30,4
1713308395062,EDS 204R,A01,507319,Halter; Christopher P.,5,0,30,25
1713308395062,EDS 204R,B01,507331,Heinzman; Erica M.,30,0,30,0
1713308396087,EDS 206R,A00,507332,Staff,7,0,30,23
1713308396087,EDS 206R,B00,507343,Staff,29,0,30,1
1713308397112,EDS 250,A00,507344,Hemans; Patricia Ann Benitez,36,0,40,4
1713308398141,EDS 281,A00,507345,Daly; Alan J.,18,0,18,0
1713308399170,EDS 284,A00,507350,Daly; Alan J.,16,0,16,0
1713308400194,EDS 286,A00,507359,Fine; Sarah,18,0,18,0
1713308401218,EDS 289C,A01,507361,Daly; Alan J.,18,0,18,0
1713308402255,EDS 290,A00,507366,Hofstetter; Carolyn,15,0,15,0
1713308403282,LIGM 5A,A00,507421,Fischer-Grunski; Eva K,20,0,20,0
1713308404309,LIGM 5B,A00,507423,Fischer-Grunski; Eva K,20,0,20,0
1713308405337,LIGM 5C,A00,507425,Fischer-Grunski; Eva K,20,0,20,0
1713308406365,LIIT 5AS,A00,507427,Carnelos; Chiara,20,0,20,0
1713308407389,LIIT 5BS,A00,507430,Carnelos; Chiara,20,0,20,0
1713308408418,LIIT 5CS,A00,507432,Carnelos; Chiara,20,0,20,0
1713308409448,LISP 5A,A00,507541,Munoz Sanchez; Alicia,19,0,20,1
1713308410484,LISP 5B,A00,507671,Munoz Sanchez; Alicia,17,0,20,3
1713308411515,LISP 5C,A00,507696,Munoz Sanchez; Alicia,17,0,20,3
1713308412545,MAE 197,001,528363,Boechler; Nicholas Sebastia,9998,0,9999,1
1713308413577,MATH 197,001,523477,Kedlaya; Kiran S.,9999,0,9999,0
1713308413577,MATH 197,002,563811,Zhang; Danna,9999,0,9999,0
1713308414605,MCWP 40R,A00,518780,Staff,20,0,20,0
1713308414605,MCWP 40R,B00,518781,Staff,20,0,20,0
1713308414605,MCWP 40R,C00,518783,Staff,19,0,20,1
1713308415629,MCWP 50R,A00,518791,Staff,20,0,20,0
1713308415629,MCWP 50R,B00,518792,Staff,19,0,20,1
1713308415629,MCWP 50R,C00,518793,Staff,19,0,20,1
1713308415629,MCWP 50R,D00,518794,Staff,18,0,20,2
1713308415629,MCWP 50R,E00,518795,Staff,18,0,20,2
1713308415629,MCWP 50R,F00,518796,Staff,19,0,20,1
1713308415629,MCWP 50R,G00,518797,Staff,19,0,20,1
1713308416656,MMW 12R,A01,514034,Herbst; Matthew,16,0,16,0
1713308416656,MMW 12R,A02,514035,Herbst; Matthew,16,0,16,0
1713308417682,MMW 13R,A01,514037,Staff,14,0,16,2
1713308417682,MMW 13R,A02,514039,Staff,16,0,16,0
1713308419742,SIO 295LS,A00,523233,Staff,19,0,30,11
1713308420771,SIO 295S,A00,523232,Staff,19,0,30,11
1713308421802,SOCI 117,A01,494376,Staff,3,0,5,2
1713308422831,WES 237B,A00,494380,Staff,19,0,20,1
1713308424936,AESE 279B,A00,494370,Wade; Jon P,33,0,33,0
1713308425965,ANAR 135S,A00,494369,Braswell; Geoffrey E.,0,0,0,0
1713308426989,CAT 124RS,A01,519847,Geibel; William,17,0,20,3
1713308428014,CAT 125RS,A01,515971,Geibel; William,17,0,20,3
1713308429044,CLRE 250,A00,511389,Morris; Sheldon,9996,0,9999,3
1713308430071,CLRE 251,A00,507176,Mehta; Ravindra L.,9996,0,9999,3
1713308430071,CLRE 251,B00,511410,Mehta; Ravindra L.,9998,0,9999,1
1713308431103,CLRE 252,A00,507189,Cuomo; Raphael Eduardo,9998,0,9999,1
1713308432129,CLRE 253,A00,507199,Vaida; Florin,9997,0,9999,2
1713308432129,CLRE 253,B00,507202,Vaida; Florin,9999,0,9999,0
1713308433153,CLRE 259,A00,507211,Patel; Hemal,9996,0,9999,3
1713308434181,CLRE 260,A00,507221,Cuomo; Raphael Eduardo,9999,0,9999,0
1713308435204,CLRE 297,001,507242,Cuomo; Raphael Eduardo,9999,0,9999,0
1713308436237,CSE 191,A00,516875,Minnes Kemp; Mor Mia,9999,0,9999,0
1713308437263,CSS 201S,A01,494383,Staff,35,0,35,0
1713308438292,CSS 202S,A01,494387,Staff,35,0,35,0
1713308439317,EAP 100,A00,516065,Staff,9792,0,9999,207
1713308440342,ECE 45,A01,507414,Staff,56,0,60,4
1713308441371,ECE 100,A01,507416,Baghdadchi; Saharnaz,11,0,20,9
1713308441371,ECE 100,A02,507418,Baghdadchi; Saharnaz,20,0,20,0
1713308442393,ECE 111,A01,507420,Staff,40,0,50,10
1713308443424,ECE 197,001,548057,Sievenpiper; Daniel F.,9998,0,9999,1
1713308444448,EDS 115,A00,507243,Choi; Bailey Miyeon,28,0,28,0
1713308445477,EDS 117,A01,494379,Staff,25,0,25,0
1713308446504,EDS 125,A00,507246,Hopkins; Megan Beth,29,0,30,1
1713308447534,EDS 128A,A01,507264,Fargason; Sharon Gayle,26,0,26,0
1713308448559,EDS 128B,A01,507293,Pappas; Elizabeth,30,0,30,0
1713308449586,EDS 139,A00,507294,Fargason; Sharon Gayle,30,0,30,0
1713308449586,EDS 139,B00,507313,Pappas; Elizabeth,30,0,30,0
1713308450610,EDS 201,A00,507315,Staff,26,0,30,4
1713308451635,EDS 203,A01,507317,Halter; Christopher P.,26,0,30,4
1713308452664,EDS 204R,A01,507319,Halter; Christopher P.,5,0,30,25
1713308452664,EDS 204R,B01,507331,Heinzman; Erica M.,30,0,30,0
1713308453692,EDS 206R,A00,507332,Staff,7,0,30,23
1713308453692,EDS 206R,B00,507343,Staff,29,0,30,1
1713308454718,EDS 250,A00,507344,Hemans; Patricia Ann Benitez,36,0,40,4
1713308455746,EDS 281,A00,507345,Daly; Alan J.,18,0,18,0
1713308456769,EDS 284,A00,507350,Daly; Alan J.,16,0,16,0
1713308457799,EDS 286,A00,507359,Fine; Sarah,18,0,18,0
1713308458823,EDS 289C,A01,507361,Daly; Alan J.,18,0,18,0
1713308459852,EDS 290,A00,507366,Hofstetter; Carolyn,15,0,15,0
1713308460879,LIGM 5A,A00,507421,Fischer-Grunski; Eva K,20,0,20,0
1713308461908,LIGM 5B,A00,507423,Fischer-Grunski; Eva K,20,0,20,0
1713308462933,LIGM 5C,A00,507425,Fischer-Grunski; Eva K,20,0,20,0
1713308463964,LIIT 5AS,A00,507427,Carnelos; Chiara,20,0,20,0
1713308464997,LIIT 5BS,A00,507430,Carnelos; Chiara,20,0,20,0
1713308466023,LIIT 5CS,A00,507432,Carnelos; Chiara,20,0,20,0
1713308467048,LISP 5A,A00,507541,Munoz Sanchez; Alicia,19,0,20,1
1713308468083,LISP 5B,A00,507671,Munoz Sanchez; Alicia,17,0,20,3
1713308469107,LISP 5C,A00,507696,Munoz Sanchez; Alicia,17,0,20,3
1713308470136,MAE 197,001,528363,Boechler; Nicholas Sebastia,9998,0,9999,1
1713308471163,MATH 197,001,523477,Kedlaya; Kiran S.,9999,0,9999,0
1713308471163,MATH 197,002,563811,Zhang; Danna,9999,0,9999,0
1713308472187,MCWP 40R,A00,518780,Staff,20,0,20,0
1713308472187,MCWP 40R,B00,518781,Staff,20,0,20,0
1713308472187,MCWP 40R,C00,518783,Staff,19,0,20,1
1713308473212,MCWP 50R,A00,518791,Staff,20,0,20,0
1713308473212,MCWP 50R,B00,518792,Staff,19,0,20,1
1713308473212,MCWP 50R,C00,518793,Staff,19,0,20,1
1713308473212,MCWP 50R,D00,518794,Staff,18,0,20,2
1713308473212,MCWP 50R,E00,518795,Staff,18,0,20,2
1713308473212,MCWP 50R,F00,518796,Staff,19,0,20,1
1713308473212,MCWP 50R,G00,518797,Staff,19,0,20,1
1713308474237,MMW 12R,A01,514034,Herbst; Matthew,16,0,16,0
1713308474237,MMW 12R,A02,514035,Herbst; Matthew,16,0,16,0
1713308475262,MMW 13R,A01,514037,Staff,14,0,16,2
1713308475262,MMW 13R,A02,514039,Staff,16,0,16,0
1713308477318,SIO 295LS,A00,523233,Staff,19,0,30,11
1713308478342,SIO 295S,A00,523232,Staff,19,0,30,11
1713308479367,SOCI 117,A01,494376,Staff,3,0,5,2
1713308480393,WES 237B,A00,494380,Staff,19,0,20,1
1713308482469,AESE 279B,A00,494370,Wade; Jon P,33,0,33,0
1713308483552,ANAR 135S,A00,494369,Braswell; Geoffrey E.,0,0,0,0
1713308484578,CAT 124RS,A01,519847,Geibel; William,17,0,20,3
1713308485604,CAT 125RS,A01,515971,Geibel; William,17,0,20,3
1713308486629,CLRE 250,A00,511389,Morris; Sheldon,9996,0,9999,3
1713308487660,CLRE 251,A00,507176,Mehta; Ravindra L.,9996,0,9999,3
1713308487660,CLRE 251,B00,511410,Mehta; Ravindra L.,9998,0,9999,1
1713308488689,CLRE 252,A00,507189,Cuomo; Raphael Eduardo,9998,0,9999,1
1713308489714,CLRE 253,A00,507199,Vaida; Florin,9997,0,9999,2
1713308489714,CLRE 253,B00,507202,Vaida; Florin,9999,0,9999,0
1713308490746,CLRE 259,A00,507211,Patel; Hemal,9996,0,9999,3
1713308491771,CLRE 260,A00,507221,Cuomo; Raphael Eduardo,9999,0,9999,0
1713308492798,CLRE 297,001,507242,Cuomo; Raphael Eduardo,9999,0,9999,0
1713308493824,CSE 191,A00,516875,Minnes Kemp; Mor Mia,9999,0,9999,0
1713308494853,CSS 201S,A01,494383,Staff,35,0,35,0
1713308495882,CSS 202S,A01,494387,Staff,35,0,35,0
1713308496908,EAP 100,A00,516065,Staff,9792,0,9999,207
1713308497934,ECE 45,A01,507414,Staff,56,0,60,4
1713308498962,ECE 100,A01,507416,Baghdadchi; Saharnaz,11,0,20,9
1713308498962,ECE 100,A02,507418,Baghdadchi; Saharnaz,20,0,20,0
1713308499990,ECE 111,A01,507420,Staff,40,0,50,10
1713308501015,ECE 197,001,548057,Sievenpiper; Daniel F.,9998,0,9999,1
1713308502040,EDS 115,A00,507243,Choi; Bailey Miyeon,28,0,28,0
1713308503068,EDS 117,A01,494379,Staff,25,0,25,0
1713308504093,EDS 125,A00,507246,Hopkins; Megan Beth,29,0,30,1
1713308505118,EDS 128A,A01,507264,Fargason; Sharon Gayle,26,0,26,0
1713308506147,EDS 128B,A01,507293,Pappas; Elizabeth,30,0,30,0
1713308507173,EDS 139,A00,507294,Fargason; Sharon Gayle,30,0,30,0
1713308507173,EDS 139,B00,507313,Pappas; Elizabeth,30,0,30,0
1713308508203,EDS 201,A00,507315,Staff,26,0,30,4
1713308509229,EDS 203,A01,507317,Halter; Christopher P.,26,0,30,4
1713308510257,EDS 204R,A01,507319,Halter; Christopher P.,5,0,30,25
1713308510257,EDS 204R,B01,507331,Heinzman; Erica M.,30,0,30,0
1713308511282,EDS 206R,A00,507332,Staff,7,0,30,23
1713308511282,EDS 206R,B00,507343,Staff,29,0,30,1
1713308512306,EDS 250,A00,507344,Hemans; Patricia Ann Benitez,36,0,40,4
1713308513331,EDS 281,A00,507345,Daly; Alan J.,18,0,18,0
1713308514359,EDS 284,A00,507350,Daly; Alan J.,16,0,16,0
1713308515385,EDS 286,A00,507359,Fine; Sarah,18,0,18,0
1713308516412,EDS 289C,A01,507361,Daly; Alan J.,18,0,18,0
1713308517438,EDS 290,A00,507366,Hofstetter; Carolyn,15,0,15,0
1713308518470,LIGM 5A,A00,507421,Fischer-Grunski; Eva K,20,0,20,0
1713308519499,LIGM 5B,A00,507423,Fischer-Grunski; Eva K,20,0,20,0
1713308520529,LIGM 5C,A00,507425,Fischer-Grunski; Eva K,20,0,20,0
1713308521558,LIIT 5AS,A00,507427,Carnelos; Chiara,20,0,20,0
1713308522586,LIIT 5BS,A00,507430,Carnelos; Chiara,20,0,20,0
1713308523610,LIIT 5CS,A00,507432,Carnelos; Chiara,20,0,20,0
1713308524636,LISP 5A,A00,507541,Munoz Sanchez; Alicia,19,0,20,1
1713308525660,LISP 5B,A00,507671,Munoz Sanchez; Alicia,17,0,20,3
1713308526686,LISP 5C,A00,507696,Munoz Sanchez; Alicia,17,0,20,3
1713308527711,MAE 197,001,528363,Boechler; Nicholas Sebastia,9998,0,9999,1
1713308528740,MATH 197,001,523477,Kedlaya; Kiran S.,9999,0,9999,0
1713308528740,MATH 197,002,563811,Zhang; Danna,9999,0,9999,0
1713308529767,MCWP 40R,A00,518780,Staff,20,0,20,0
1713308529767,MCWP 40R,B00,518781,Staff,20,0,20,0
1713308529767,MCWP 40R,C00,518783,Staff,19,0,20,1
1713308530793,MCWP 50R,A00,518791,Staff,20,0,20,0
1713308530793,MCWP 50R,B00,518792,Staff,19,0,20,1
1713308530793,MCWP 50R,C00,518793,Staff,19,0,20,1
1713308530793,MCWP 50R,D00,518794,Staff,18,0,20,2
1713308530793,MCWP 50R,E00,518795,Staff,18,0,20,2
1713308530793,MCWP 50R,F00,518796,Staff,19,0,20,1
1713308530793,MCWP 50R,G00,518797,Staff,19,0,20,1
1713308531823,MMW 12R,A01,514034,Herbst; Matthew,16,0,16,0
1713308531823,MMW 12R,A02,514035,Herbst; Matthew,16,0,16,0
1713308532852,MMW 13R,A01,514037,Staff,14,0,16,2
1713308532852,MMW 13R,A02,514039,Staff,16,0,16,0
1713308534904,SIO 295LS,A00,523233,Staff,19,0,30,11
1713308535934,SIO 295S,A00,523232,Staff,19,0,30,11
1713308536959,SOCI 117,A01,494376,Staff,3,0,5,2
1713308537986,WES 237B,A00,494380,Staff,19,0,20,1
1713308540058,AESE 279B,A00,494370,Wade; Jon P,33,0,33,0
1713308541085,ANAR 135S,A00,494369,Braswell; Geoffrey E.,0,0,0,0
1713308542123,CAT 124RS,A01,519847,Geibel; William,17,0,20,3
1713308543148,CAT 125RS,A01,515971,Geibel; William,17,0,20,3
1713308544174,CLRE 250,A00,511389,Morris; Sheldon,9996,0,9999,3
1713308545203,CLRE 251,A00,507176,Mehta; Ravindra L.,9996,0,9999,3
1713308545203,CLRE 251,B00,511410,Mehta; Ravindra L.,9998,0,9999,1
1713308546234,CLRE 252,A00,507189,Cuomo; Raphael Eduardo,9998,0,9999,1
1713308547260,CLRE 253,A00,507199,Vaida; Florin,9997,0,9999,2
1713308547260,CLRE 253,B00,507202,Vaida; Florin,9999,0,9999,0
1713308548288,CLRE 259,A00,507211,Patel; Hemal,9996,0,9999,3
1713308549313,CLRE 260,A00,507221,Cuomo; Raphael Eduardo,9999,0,9999,0
1713308550339,CLRE 297,001,507242,Cuomo; Raphael Eduardo,9999,0,9999,0
1713308551369,CSE 191,A00,516875,Minnes Kemp; Mor Mia,9999,0,9999,0
1713308552395,CSS 201S,A01,494383,Staff,35,0,35,0
1713308553425,CSS 202S,A01,494387,Staff,35,0,35,0
1713308554451,EAP 100,A00,516065,Staff,9792,0,9999,207
1713308555477,ECE 45,A01,507414,Staff,56,0,60,4
1713308556503,ECE 100,A01,507416,Baghdadchi; Saharnaz,11,0,20,9
1713308556503,ECE 100,A02,507418,Baghdadchi; Saharnaz,20,0,20,0
1713308557532,ECE 111,A01,507420,Staff,40,0,50,10
1713308558557,ECE 197,001,548057,Sievenpiper; Daniel F.,9998,0,9999,1
1713308559586,EDS 115,A00,507243,Choi; Bailey Miyeon,28,0,28,0
1713308560611,EDS 117,A01,494379,Staff,25,0,25,0
1713308561635,EDS 125,A00,507246,Hopkins; Megan Beth,29,0,30,1
1713308562662,EDS 128A,A01,507264,Fargason; Sharon Gayle,26,0,26,0
1713308563690,EDS 128B,A01,507293,Pappas; Elizabeth,30,0,30,0
1713308564715,EDS 139,A00,507294,Fargason; Sharon Gayle,30,0,30,0
1713308564715,EDS 139,B00,507313,Pappas; Elizabeth,30,0,30,0
1713308565742,EDS 201,A00,507315,Staff,26,0,30,4
1713308566770,EDS 203,A01,507317,Halter; Christopher P.,26,0,30,4
1713308567797,EDS 204R,A01,507319,Halter; Christopher P.,5,0,30,25
1713308567797,EDS 204R,B01,507331,Heinzman; Erica M.,30,0,30,0
1713308568821,EDS 206R,A00,507332,Staff,7,0,30,23
1713308568821,EDS 206R,B00,507343,Staff,29,0,30,1
1713308569846,EDS 250,A00,507344,Hemans; Patricia Ann Benitez,36,0,40,4
1713308570873,EDS 281,A00,507345,Daly; Alan J.,18,0,18,0
1713308571900,EDS 284,A00,507350,Daly; Alan J.,16,0,16,0
1713308572931,EDS 286,A00,507359,Fine; Sarah,18,0,18,0
1713308573957,EDS 289C,A01,507361,Daly; Alan J.,18,0,18,0
1713308574981,EDS 290,A00,507366,Hofstetter; Carolyn,15,0,15,0
1713308576009,LIGM 5A,A00,507421,Fischer-Grunski; Eva K,20,0,20,0
1713308577035,LIGM 5B,A00,507423,Fischer-Grunski; Eva K,20,0,20,0
1713308578060,LIGM 5C,A00,507425,Fischer-Grunski; Eva K,20,0,20,0
1713308579091,LIIT 5AS,A00,507427,Carnelos; Chiara,20,0,20,0
1713308580116,LIIT 5BS,A00,507430,Carnelos; Chiara,20,0,20,0
1713308581143,LIIT 5CS,A00,507432,Carnelos; Chiara,20,0,20,0
1713308582169,LISP 5A,A00,507541,Munoz Sanchez; Alicia,19,0,20,1
1713308583211,LISP 5B,A00,507671,Munoz Sanchez; Alicia,17,0,20,3
1713308584243,LISP 5C,A00,507696,Munoz Sanchez; Alicia,17,0,20,3
1713308585272,MAE 197,001,528363,Boechler; Nicholas Sebastia,9998,0,9999,1
1713308586305,MATH 197,001,523477,Kedlaya; Kiran S.,9999,0,9999,0
1713308586305,MATH 197,002,563811,Zhang; Danna,9999,0,9999,0
1713308587388,MCWP 40R,A00,518780,Staff,20,0,20,0
1713308587388,MCWP 40R,B00,518781,Staff,20,0,20,0
1713308587388,MCWP 40R,C00,518783,Staff,19,0,20,1
1713308588413,MCWP 50R,A00,518791,Staff,20,0,20,0
1713308588413,MCWP 50R,B00,518792,Staff,19,0,20,1
1713308588413,MCWP 50R,C00,518793,Staff,19,0,20,1
1713308588413,MCWP 50R,D00,518794,Staff,18,0,20,2
1713308588413,MCWP 50R,E00,518795,Staff,18,0,20,2
1713308588413,MCWP 50R,F00,518796,Staff,19,0,20,1
1713308588413,MCWP 50R,G00,518797,Staff,19,0,20,1
1713308589439,MMW 12R,A01,514034,Herbst; Matthew,16,0,16,0
1713308589439,MMW 12R,A02,514035,Herbst; Matthew,16,0,16,0
1713308590463,MMW 13R,A01,514037,Staff,14,0,16,2
1713308590463,MMW 13R,A02,514039,Staff,16,0,16,0
1713308592517,SIO 295LS,A00,523233,Staff,19,0,30,11
1713308593547,SIO 295S,A00,523232,Staff,19,0,30,11
1713308594570,SOCI 117,A01,494376,Staff,3,0,5,2
1713308595594,WES 237B,A00,494380,Staff,19,0,20,1
1713308597660,AESE 279B,A00,494370,Wade; Jon P,33,0,33,0
1713308598686,ANAR 135S,A00,494369,Braswell; Geoffrey E.,0,0,0,0
1713308599715,CAT 124RS,A01,519847,Geibel; William,17,0,20,3
1713308600740,CAT 125RS,A01,515971,Geibel; William,17,0,20,3
1713308601766,CLRE 250,A00,511389,Morris; Sheldon,9996,0,9999,3
1713308602800,CLRE 251,A00,507176,Mehta; Ravindra L.,9996,0,9999,3
1713308602800,CLRE 251,B00,511410,Mehta; Ravindra L.,9998,0,9999,1
1713308603832,CLRE 252,A00,507189,Cuomo; Raphael Eduardo,9998,0,9999,1
1713308604858,CLRE 253,A00,507199,Vaida; Florin,9997,0,9999,2
1713308604858,CLRE 253,B00,507202,Vaida; Florin,9999,0,9999,0
1713308605882,CLRE 259,A00,507211,Patel; Hemal,9996,0,9999,3
1713308606906,CLRE 260,A00,507221,Cuomo; Raphael Eduardo,9999,0,9999,0
1713308607931,CLRE 297,001,507242,Cuomo; Raphael Eduardo,9999,0,9999,0
1713308608955,CSE 191,A00,516875,Minnes Kemp; Mor Mia,9999,0,9999,0
1713308609987,CSS 201S,A01,494383,Staff,35,0,35,0
1713308611018,CSS 202S,A01,494387,Staff,35,0,35,0
1713308612042,EAP 100,A00,516065,Staff,9792,0,9999,207
1713308613072,ECE 45,A01,507414,Staff,56,0,60,4
1713308614101,ECE 100,A01,507416,Baghdadchi; Saharnaz,11,0,20,9
1713308614101,ECE 100,A02,507418,Baghdadchi; Saharnaz,20,0,20,0
1713308615126,ECE 111,A01,507420,Staff,40,0,50,10
1713308616154,ECE 197,001,548057,Sievenpiper; Daniel F.,9998,0,9999,1
1713308617185,EDS 115,A00,507243,Choi; Bailey Miyeon,28,0,28,0
1713308618214,EDS 117,A01,494379,Staff,25,0,25,0
1713308619238,EDS 125,A00,507246,Hopkins; Megan Beth,29,0,30,1
1713308620268,EDS 128A,A01,507264,Fargason; Sharon Gayle,26,0,26,0
1713308621298,EDS 128B,A01,507293,Pappas; Elizabeth,30,0,30,0
1713308622323,EDS 139,A00,507294,Fargason; Sharon Gayle,30,0,30,0
1713308622323,EDS 139,B00,507313,Pappas; Elizabeth,30,0,30,0
1713308623348,EDS 201,A00,507315,Staff,26,0,30,4
1713308624374,EDS 203,A01,507317,Halter; Christopher P.,26,0,30,4
1713308625399,EDS 204R,A01,507319,Halter; Christopher P.,5,0,30,25
1713308625399,EDS 204R,B01,507331,Heinzman; Erica M.,30,0,30,0
1713308626426,EDS 206R,A00,507332,Staff,7,0,30,23
1713308626426,EDS 206R,B00,507343,Staff,29,0,30,1
1713308627455,EDS 250,A00,507344,Hemans; Patricia Ann Benitez,36,0,40,4
1713308628480,EDS 281,A00,507345,Daly; Alan J.,18,0,18,0
1713308629506,EDS 284,A00,507350,Daly; Alan J.,16,0,16,0
1713308630533,EDS 286,A00,507359,Fine; Sarah,18,0,18,0
1713308631559,EDS 289C,A01,507361,Daly; Alan J.,18,0,18,0
1713308632585,EDS 290,A00,507366,Hofstetter; Carolyn,15,0,15,0
1713308633610,LIGM 5A,A00,507421,Fischer-Grunski; Eva K,20,0,20,0
1713308634640,LIGM 5B,A00,507423,Fischer-Grunski; Eva K,20,0,20,0
1713308635673,LIGM 5C,A00,507425,Fischer-Grunski; Eva K,20,0,20,0
1713308636699,LIIT 5AS,A00,507427,Carnelos; Chiara,20,0,20,0
1713308637728,LIIT 5BS,A00,507430,Carnelos; Chiara,20,0,20,0
1713308638754,LIIT 5CS,A00,507432,Carnelos; Chiara,20,0,20,0
1713308639779,LISP 5A,A00,507541,Munoz Sanchez; Alicia,19,0,20,1
1713308640805,LISP 5B,A00,507671,Munoz Sanchez; Alicia,17,0,20,3
1713308641832,LISP 5C,A00,507696,Munoz Sanchez; Alicia,17,0,20,3
1713308642858,MAE 197,001,528363,Boechler; Nicholas Sebastia,9998,0,9999,1
1713308643884,MATH 197,001,523477,Kedlaya; Kiran S.,9999,0,9999,0
1713308643884,MATH 197,002,563811,Zhang; Danna,9999,0,9999,0
1713308644909,MCWP 40R,A00,518780,Staff,20,0,20,0
1713308644909,MCWP 40R,B00,518781,Staff,20,0,20,0
1713308644909,MCWP 40R,C00,518783,Staff,19,0,20,1
1713308645939,MCWP 50R,A00,518791,Staff,20,0,20,0
1713308645939,MCWP 50R,B00,518792,Staff,19,0,20,1
1713308645939,MCWP 50R,C00,518793,Staff,19,0,20,1
1713308645939,MCWP 50R,D00,518794,Staff,18,0,20,2
1713308645939,MCWP 50R,E00,518795,Staff,18,0,20,2
1713308645939,MCWP 50R,F00,518796,Staff,19,0,20,1
1713308645939,MCWP 50R,G00,518797,Staff,19,0,20,1
1713308646964,MMW 12R,A01,514034,Herbst; Matthew,16,0,16,0
1713308646964,MMW 12R,A02,514035,Herbst; Matthew,16,0,16,0
1713308647994,MMW 13R,A01,514037,Staff,14,0,16,2
1713308647994,MMW 13R,A02,514039,Staff,16,0,16,0
1713308650051,SIO 295LS,A00,523233,Staff,19,0,30,11
1713308651083,SIO 295S,A00,523232,Staff,19,0,30,11
1713308652112,SOCI 117,A01,494376,Staff,3,0,5,2
1713308653136,WES 237B,A00,494380,Staff,19,0,20,1
1713308655216,AESE 279B,A00,494370,Wade; Jon P,33,0,33,0
1713308656243,ANAR 135S,A00,494369,Braswell; Geoffrey E.,0,0,0,0
1713308657270,CAT 124RS,A01,519847,Geibel; William,17,0,20,3
1713308658299,CAT 125RS,A01,515971,Geibel; William,17,0,20,3
1713308659324,CLRE 250,A00,511389,Morris; Sheldon,9996,0,9999,3
1713308660356,CLRE 251,A00,507176,Mehta; Ravindra L.,9996,0,9999,3
1713308660356,CLRE 251,B00,511410,Mehta; Ravindra L.,9998,0,9999,1
1713308661384,CLRE 252,A00,507189,Cuomo; Raphael Eduardo,9998,0,9999,1
1713308662409,CLRE 253,A00,507199,Vaida; Florin,9997,0,9999,2
1713308662409,CLRE 253,B00,507202,Vaida; Florin,9999,0,9999,0
1713308663440,CLRE 259,A00,507211,Patel; Hemal,9996,0,9999,3
1713308664465,CLRE 260,A00,507221,Cuomo; Raphael Eduardo,9999,0,9999,0
1713308665494,CLRE 297,001,507242,Cuomo; Raphael Eduardo,9999,0,9999,0
1713308666519,CSE 191,A00,516875,Minnes Kemp; Mor Mia,9999,0,9999,0
1713308667545,CSS 201S,A01,494383,Staff,35,0,35,0
1713308668570,CSS 202S,A01,494387,Staff,35,0,35,0
1713308669595,EAP 100,A00,516065,Staff,9792,0,9999,207
1713308670626,ECE 45,A01,507414,Staff,56,0,60,4
1713308671652,ECE 100,A01,507416,Baghdadchi; Saharnaz,11,0,20,9
1713308671652,ECE 100,A02,507418,Baghdadchi; Saharnaz,20,0,20,0
1713308672682,ECE 111,A01,507420,Staff,40,0,50,10
1713308673710,ECE 197,001,548057,Sievenpiper; Daniel F.,9998,0,9999,1
1713308674742,EDS 115,A00,507243,Choi; Bailey Miyeon,28,0,28,0
1713308675772,EDS 117,A01,494379,Staff,25,0,25,0
1713308676801,EDS 125,A00,507246,Hopkins; Megan Beth,29,0,30,1
1713308677831,EDS 128A,A01,507264,Fargason; Sharon Gayle,26,0,26,0
1713308678861,EDS 128B,A01,507293,Pappas; Elizabeth,30,0,30,0
1713308679887,EDS 139,A00,507294,Fargason; Sharon Gayle,30,0,30,0
1713308679887,EDS 139,B00,507313,Pappas; Elizabeth,30,0,30,0
1713308680911,EDS 201,A00,507315,Staff,26,0,30,4
1713308681937,EDS 203,A01,507317,Halter; Christopher P.,26,0,30,4
1713308682963,EDS 204R,A01,507319,Halter; Christopher P.,5,0,30,25
1713308682963,EDS 204R,B01,507331,Heinzman; Erica M.,30,0,30,0
1713308683989,EDS 206R,A00,507332,Staff,7,0,30,23
1713308683989,EDS 206R,B00,507343,Staff,29,0,30,1
1713308685015,EDS 250,A00,507344,Hemans; Patricia Ann Benitez,36,0,40,4
1713308686040,EDS 281,A00,507345,Daly; Alan J.,18,0,18,0
1713308687065,EDS 284,A00,507350,Daly; Alan J.,16,0,16,0
1713308688094,EDS 286,A00,507359,Fine; Sarah,18,0,18,0
1713308689124,EDS 289C,A01,507361,Daly; Alan J.,18,0,18,0
1713308690150,EDS 290,A00,507366,Hofstetter; Carolyn,15,0,15,0
1713308691231,LIGM 5A,A00,507421,Fischer-Grunski; Eva K,20,0,20,0
1713308692256,LIGM 5B,A00,507423,Fischer-Grunski; Eva K,20,0,20,0
1713308693287,LIGM 5C,A00,507425,Fischer-Grunski; Eva K,20,0,20,0
1713308694313,LIIT 5AS,A00,507427,Carnelos; Chiara,20,0,20,0
1713308695342,LIIT 5BS,A00,507430,Carnelos; Chiara,20,0,20,0
1713308696373,LIIT 5CS,A00,507432,Carnelos; Chiara,20,0,20,0
1713308697399,LISP 5A,A00,507541,Munoz Sanchez; Alicia,19,0,20,1
1713308698425,LISP 5B,A00,507671,Munoz Sanchez; Alicia,17,0,20,3
1713308699450,LISP 5C,A00,507696,Munoz Sanchez; Alicia,17,0,20,3
1713308700482,MAE 197,001,528363,Boechler; Nicholas Sebastia,9998,0,9999,1
1713308701508,MATH 197,001,523477,Kedlaya; Kiran S.,9999,0,9999,0
1713308701508,MATH 197,002,563811,Zhang; Danna,9999,0,9999,0
1713308702537,MCWP 40R,A00,518780,Staff,20,0,20,0
1713308702537,MCWP 40R,B00,518781,Staff,20,0,20,0
1713308702537,MCWP 40R,C00,518783,Staff,19,0,20,1
1713308703569,MCWP 50R,A00,518791,Staff,20,0,20,0
1713308703569,MCWP 50R,B00,518792,Staff,19,0,20,1
1713308703569,MCWP 50R,C00,518793,Staff,19,0,20,1
1713308703569,MCWP 50R,D00,518794,Staff,18,0,20,2
1713308703569,MCWP 50R,E00,518795,Staff,18,0,20,2
1713308703569,MCWP 50R,F00,518796,Staff,19,0,20,1
1713308703569,MCWP 50R,G00,518797,Staff,19,0,20,1
1713308704595,MMW 12R,A01,514034,Herbst; Matthew,16,0,16,0
1713308704595,MMW 12R,A02,514035,Herbst; Matthew,16,0,16,0
1713308705624,MMW 13R,A01,514037,Staff,14,0,16,2
1713308705624,MMW 13R,A02,514039,Staff,16,0,16,0
1713308707674,SIO 295LS,A00,523233,Staff,19,0,30,11
1713308708701,SIO 295S,A00,523232,Staff,19,0,30,11
1713308709732,SOCI 117,A01,494376,Staff,3,0,5,2
1713308710759,WES 237B,A00,494380,Staff,19,0,20,1
1713308712819,AESE 279B,A00,494370,Wade; Jon P,33,0,33,0
1713308713846,ANAR 135S,A00,494369,Braswell; Geoffrey E.,0,0,0,0
1713308714879,CAT 124RS,A01,519847,Geibel; William,17,0,20,3
1713308715904,CAT 125RS,A01,515971,Geibel; William,17,0,20,3
1713308716930,CLRE 250,A00,511389,Morris; Sheldon,9996,0,9999,3
1713308717957,CLRE 251,A00,507176,Mehta; Ravindra L.,9996,0,9999,3
1713308717957,CLRE 251,B00,511410,Mehta; Ravindra L.,9998,0,9999,1
1713308718985,CLRE 252,A00,507189,Cuomo; Raphael Eduardo,9998,0,9999,1
1713308720014,CLRE 253,A00,507199,Vaida; Florin,9997,0,9999,2
1713308720014,CLRE 253,B00,507202,Vaida; Florin,9999,0,9999,0
1713308721041,CLRE 259,A00,507211,Patel; Hemal,9996,0,9999,3
1713308722065,CLRE 260,A00,507221,Cuomo; Raphael Eduardo,9999,0,9999,0
1713308723096,CLRE 297,001,507242,Cuomo; Raphael Eduardo,9999,0,9999,0
1713308724121,CSE 191,A00,516875,Minnes Kemp; Mor Mia,9999,0,9999,0
1713308725154,CSS 201S,A01,494383,Staff,35,0,35,0
1713308726179,CSS 202S,A01,494387,Staff,35,0,35,0
1713308727207,EAP 100,A00,516065,Staff,9792,0,9999,207
1713308728242,ECE 45,A01,507414,Staff,56,0,60,4
1713308729272,ECE 100,A01,507416,Baghdadchi; Saharnaz,11,0,20,9
1713308729272,ECE 100,A02,507418,Baghdadchi; Saharnaz,20,0,20,0
1713308730300,ECE 111,A01,507420,Staff,40,0,50,10
1713308731323,ECE 197,001,548057,Sievenpiper; Daniel F.,9998,0,9999,1
1713308732355,EDS 115,A00,507243,Choi; Bailey Miyeon,28,0,28,0
1713308733381,EDS 117,A01,494379,Staff,25,0,25,0
1713308734408,EDS 125,A00,507246,Hopkins; Megan Beth,29,0,30,1
1713308735436,EDS 128A,A01,507264,Fargason; Sharon Gayle,26,0,26,0
1713308736460,EDS 128B,A01,507293,Pappas; Elizabeth,30,0,30,0
1713308737487,EDS 139,A00,507294,Fargason; Sharon Gayle,30,0,30,0
1713308737487,EDS 139,B00,507313,Pappas; Elizabeth,30,0,30,0
1713308738514,EDS 201,A00,507315,Staff,26,0,30,4
1713308739538,EDS 203,A01,507317,Halter; Christopher P.,26,0,30,4
1713308740565,EDS 204R,A01,507319,Halter; Christopher P.,5,0,30,25
1713308740565,EDS 204R,B01,507331,Heinzman; Erica M.,30,0,30,0
1713308741589,EDS 206R,A00,507332,Staff,7,0,30,23
1713308741589,EDS 206R,B00,507343,Staff,29,0,30,1
1713308742615,EDS 250,A00,507344,Hemans; Patricia Ann Benitez,36,0,40,4
1713308743641,EDS 281,A00,507345,Daly; Alan J.,18,0,18,0
1713308744666,EDS 284,A00,507350,Daly; Alan J.,16,0,16,0
1713308745690,EDS 286,A00,507359,Fine; Sarah,18,0,18,0
1713308746779,EDS 289C,A01,507361,Daly; Alan J.,18,0,18,0
1713308747806,EDS 290,A00,507366,Hofstetter; Carolyn,15,0,15,0
1713308748830,LIGM 5A,A00,507421,Fischer-Grunski; Eva K,20,0,20,0
1713308749857,LIGM 5B,A00,507423,Fischer-Grunski; Eva K,20,0,20,0
1713308750883,LIGM 5C,A00,507425,Fischer-Grunski; Eva K,20,0,20,0
1713308751915,LIIT 5AS,A00,507427,Carnelos; Chiara,20,0,20,0
1713308752939,LIIT 5BS,A00,507430,Carnelos; Chiara,20,0,20,0
1713308753972,LIIT 5CS,A00,507432,Carnelos; Chiara,20,0,20,0
1713308755001,LISP 5A,A00,507541,Munoz Sanchez; Alicia,19,0,20,1
1713308756027,LISP 5B,A00,507671,Munoz Sanchez; Alicia,17,0,20,3
1713308757052,LISP 5C,A00,507696,Munoz Sanchez; Alicia,17,0,20,3
1713308758080,MAE 197,001,528363,Boechler; Nicholas Sebastia,9998,0,9999,1
1713308759104,MATH 197,001,523477,Kedlaya; Kiran S.,9999,0,9999,0
1713308759104,MATH 197,002,563811,Zhang; Danna,9999,0,9999,0
1713308760134,MCWP 40R,A00,518780,Staff,20,0,20,0
1713308760134,MCWP 40R,B00,518781,Staff,20,0,20,0
1713308760134,MCWP 40R,C00,518783,Staff,19,0,20,1
1713308761161,MCWP 50R,A00,518791,Staff,20,0,20,0
1713308761161,MCWP 50R,B00,518792,Staff,19,0,20,1
1713308761161,MCWP 50R,C00,518793,Staff,19,0,20,1
1713308761161,MCWP 50R,D00,518794,Staff,18,0,20,2
1713308761161,MCWP 50R,E00,518795,Staff,18,0,20,2
1713308761161,MCWP 50R,F00,518796,Staff,19,0,20,1
1713308761161,MCWP 50R,G00,518797,Staff,19,0,20,1
1713308762190,MMW 12R,A01,514034,Herbst; Matthew,16,0,16,0
1713308762190,MMW 12R,A02,514035,Herbst; Matthew,16,0,16,0
1713308763214,MMW 13R,A01,514037,Staff,14,0,16,2
1713308763214,MMW 13R,A02,514039,Staff,16,0,16,0
1713308765269,SIO 295LS,A00,523233,Staff,19,0,30,11
1713308766291,SIO 295S,A00,523232,Staff,19,0,30,11
1713308767324,SOCI 117,A01,494376,Staff,3,0,5,2
1713308768351,WES 237B,A00,494380,Staff,19,0,20,1
1713308770410,AESE 279B,A00,494370,Wade; Jon P,33,0,33,0
1713308771439,ANAR 135S,A00,494369,Braswell; Geoffrey E.,0,0,0,0
1713308772464,CAT 124RS,A01,519847,Geibel; William,17,0,20,3
1713308773495,CAT 125RS,A01,515971,Geibel; William,17,0,20,3
1713308774524,CLRE 250,A00,511389,Morris; Sheldon,9996,0,9999,3
1713308775556,CLRE 251,A00,507176,Mehta; Ravindra L.,9996,0,9999,3
1713308775556,CLRE 251,B00,511410,Mehta; Ravindra L.,9998,0,9999,1
1713308776586,CLRE 252,A00,507189,Cuomo; Raphael Eduardo,9998,0,9999,1
1713308777611,CLRE 253,A00,507199,Vaida; Florin,9997,0,9999,2
1713308777611,CLRE 253,B00,507202,Vaida; Florin,9999,0,9999,0
1713308778640,CLRE 259,A00,507211,Patel; Hemal,9996,0,9999,3
1713308779666,CLRE 260,A00,507221,Cuomo; Raphael Eduardo,9999,0,9999,0
1713308780691,CLRE 297,001,507242,Cuomo; Raphael Eduardo,9999,0,9999,0
1713308781721,CSE 191,A00,516875,Minnes Kemp; Mor Mia,9999,0,9999,0
1713308782749,CSS 201S,A01,494383,Staff,35,0,35,0
1713308783776,CSS 202S,A01,494387,Staff,35,0,35,0
1713308784803,EAP 100,A00,516065,Staff,9792,0,9999,207
1713308785829,ECE 45,A01,507414,Staff,56,0,60,4
1713308786861,ECE 100,A01,507416,Baghdadchi; Saharnaz,11,0,20,9
1713308786861,ECE 100,A02,507418,Baghdadchi; Saharnaz,20,0,20,0
1713308787885,ECE 111,A01,507420,Staff,40,0,50,10
1713308788910,ECE 197,001,548057,Sievenpiper; Daniel F.,9998,0,9999,1
1713308789937,EDS 115,A00,507243,Choi; Bailey Miyeon,28,0,28,0
1713308790968,EDS 117,A01,494379,Staff,25,0,25,0
1713308791997,EDS 125,A00,507246,Hopkins; Megan Beth,29,0,30,1
1713308793020,EDS 128A,A01,507264,Fargason; Sharon Gayle,26,0,26,0
1713308794046,EDS 128B,A01,507293,Pappas; Elizabeth,30,0,30,0
1713308795131,EDS 139,A00,507294,Fargason; Sharon Gayle,30,0,30,0
1713308795131,EDS 139,B00,507313,Pappas; Elizabeth,30,0,30,0
1713308796159,EDS 201,A00,507315,Staff,26,0,30,4
1713308797185,EDS 203,A01,507317,Halter; Christopher P.,26,0,30,4
1713308798215,EDS 204R,A01,507319,Halter; Christopher P.,5,0,30,25
1713308798215,EDS 204R,B01,507331,Heinzman; Erica M.,30,0,30,0
1713308799240,EDS 206R,A00,507332,Staff,7,0,30,23
1713308799240,EDS 206R,B00,507343,Staff,29,0,30,1
1713308800271,EDS 250,A00,507344,Hemans; Patricia Ann Benitez,36,0,40,4
1713308801298,EDS 281,A00,507345,Daly; Alan J.,18,0,18,0
1713308802322,EDS 284,A00,507350,Daly; Alan J.,16,0,16,0
1713308803349,EDS 286,A00,507359,Fine; Sarah,18,0,18,0
1713308804379,EDS 289C,A01,507361,Daly; Alan J.,18,0,18,0
1713308805405,EDS 290,A00,507366,Hofstetter; Carolyn,15,0,15,0
1713308806430,LIGM 5A,A00,507421,Fischer-Grunski; Eva K,20,0,20,0
1713308807458,LIGM 5B,A00,507423,Fischer-Grunski; Eva K,20,0,20,0
1713308808482,LIGM 5C,A00,507425,Fischer-Grunski; Eva K,20,0,20,0
1713308809512,LIIT 5AS,A00,507427,Carnelos; Chiara,20,0,20,0
1713308810539,LIIT 5BS,A00,507430,Carnelos; Chiara,20,0,20,0
1713308811563,LIIT 5CS,A00,507432,Carnelos; Chiara,20,0,20,0
1713308812589,LISP 5A,A00,507541,Munoz Sanchez; Alicia,19,0,20,1
1713308813619,LISP 5B,A00,507671,Munoz Sanchez; Alicia,17,0,20,3
1713308814650,LISP 5C,A00,507696,Munoz Sanchez; Alicia,17,0,20,3
1713308815679,MAE 197,001,528363,Boechler; Nicholas Sebastia,9998,0,9999,1
1713308816707,MATH 197,001,523477,Kedlaya; Kiran S.,9999,0,9999,0
1713308816707,MATH 197,002,563811,Zhang; Danna,9999,0,9999,0
1713308817739,MCWP 40R,A00,518780,Staff,20,0,20,0
1713308817739,MCWP 40R,B00,518781,Staff,20,0,20,0
1713308817739,MCWP 40R,C00,518783,Staff,19,0,20,1
1713308818767,MCWP 50R,A00,518791,Staff,20,0,20,0
1713308818767,MCWP 50R,B00,518792,Staff,19,0,20,1
1713308818767,MCWP 50R,C00,518793,Staff,19,0,20,1
1713308818767,MCWP 50R,D00,518794,Staff,18,0,20,2
1713308818767,MCWP 50R,E00,518795,Staff,18,0,20,2
1713308818767,MCWP 50R,F00,518796,Staff,19,0,20,1
1713308818767,MCWP 50R,G00,518797,Staff,19,0,20,1
1713308819798,MMW 12R,A01,514034,Herbst; Matthew,16,0,16,0
1713308819798,MMW 12R,A02,514035,Herbst; Matthew,16,0,16,0
1713308820831,MMW 13R,A01,514037,Staff,14,0,16,2
1713308820831,MMW 13R,A02,514039,Staff,16,0,16,0
1713308822894,SIO 295LS,A00,523233,Staff,19,0,30,11
1713308823920,SIO 295S,A00,523232,Staff,19,0,30,11
1713308824944,SOCI 117,A01,494376,Staff,3,0,5,2
1713308825971,WES 237B,A00,494380,Staff,19,0,20,1
1713308828045,AESE 279B,A00,494370,Wade; Jon P,33,0,33,0
1713308829072,ANAR 135S,A00,494369,Braswell; Geoffrey E.,0,0,0,0
1713308830099,CAT 124RS,A01,519847,Geibel; William,17,0,20,3
1713308831127,CAT 125RS,A01,515971,Geibel; William,17,0,20,3
1713308832152,CLRE 250,A00,511389,Morris; Sheldon,9996,0,9999,3
1713308833178,CLRE 251,A00,507176,Mehta; Ravindra L.,9996,0,9999,3
1713308833178,CLRE 251,B00,511410,Mehta; Ravindra L.,9998,0,9999,1
1713308834208,CLRE 252,A00,507189,Cuomo; Raphael Eduardo,9998,0,9999,1
1713308835235,CLRE 253,A00,507199,Vaida; Florin,9997,0,9999,2
1713308835235,CLRE 253,B00,507202,Vaida; Florin,9999,0,9999,0
1713308836261,CLRE 259,A00,507211,Patel; Hemal,9996,0,9999,3
1713308837290,CLRE 260,A00,507221,Cuomo; Raphael Eduardo,9999,0,9999,0
1713308838318,CLRE 297,001,507242,Cuomo; Raphael Eduardo,9999,0,9999,0
1713308839345,CSE 191,A00,516875,Minnes Kemp; Mor Mia,9999,0,9999,0
1713308840543,CSS 201S,A01,494383,Staff,35,0,35,0
1713308841575,CSS 202S,A01,494387,Staff,35,0,35,0
1713308842603,EAP 100,A00,516065,Staff,9792,0,9999,207
1713308843631,ECE 45,A01,507414,Staff,56,0,60,4
1713308844661,ECE 100,A01,507416,Baghdadchi; Saharnaz,11,0,20,9
1713308844661,ECE 100,A02,507418,Baghdadchi; Saharnaz,20,0,20,0
1713308845691,ECE 111,A01,507420,Staff,40,0,50,10
1713308846716,ECE 197,001,548057,Sievenpiper; Daniel F.,9998,0,9999,1
1713308847744,EDS 115,A00,507243,Choi; Bailey Miyeon,28,0,28,0
1713308848769,EDS 117,A01,494379,Staff,25,0,25,0
1713308849799,EDS 125,A00,507246,Hopkins; Megan Beth,29,0,30,1
1713308850826,EDS 128A,A01,507264,Fargason; Sharon Gayle,26,0,26,0
1713308851854,EDS 128B,A01,507293,Pappas; Elizabeth,30,0,30,0
1713308852878,EDS 139,A00,507294,Fargason; Sharon Gayle,30,0,30,0
1713308852878,EDS 139,B00,507313,Pappas; Elizabeth,30,0,30,0
1713308853908,EDS 201,A00,507315,Staff,26,0,30,4
1713308854939,EDS 203,A01,507317,Halter; Christopher P.,26,0,30,4
1713308855964,EDS 204R,A01,507319,Halter; Christopher P.,5,0,30,25
1713308855964,EDS 204R,B01,507331,Heinzman; Erica M.,30,0,30,0
1713308856993,EDS 206R,A00,507332,Staff,7,0,30,23
1713308856993,EDS 206R,B00,507343,Staff,29,0,30,1
1713308858018,EDS 250,A00,507344,Hemans; Patricia Ann Benitez,36,0,40,4
1713308859041,EDS 281,A00,507345,Daly; Alan J.,18,0,18,0
1713308860067,EDS 284,A00,507350,Daly; Alan J.,16,0,16,0
1713308861097,EDS 286,A00,507359,Fine; Sarah,18,0,18,0
1713308862123,EDS 289C,A01,507361,Daly; Alan J.,18,0,18,0
1713308863153,EDS 290,A00,507366,Hofstetter; Carolyn,15,0,15,0
1713308864177,LIGM 5A,A00,507421,Fischer-Grunski; Eva K,20,0,20,0
1713308865199,LIGM 5B,A00,507423,Fischer-Grunski; Eva K,20,0,20,0
1713308866227,LIGM 5C,A00,507425,Fischer-Grunski; Eva K,20,0,20,0
1713308867252,LIIT 5AS,A00,507427,Carnelos; Chiara,20,0,20,0
1713308868276,LIIT 5BS,A00,507430,Carnelos; Chiara,20,0,20,0
1713308869306,LIIT 5CS,A00,507432,Carnelos; Chiara,20,0,20,0
1713308870333,LISP 5A,A00,507541,Munoz Sanchez; Alicia,19,0,20,1
1713308871358,LISP 5B,A00,507671,Munoz Sanchez; Alicia,17,0,20,3
1713308872383,LISP 5C,A00,507696,Munoz Sanchez; Alicia,17,0,20,3
1713308873407,MAE 197,001,528363,Boechler; Nicholas Sebastia,9998,0,9999,1
1713308874432,MATH 197,001,523477,Kedlaya; Kiran S.,9999,0,9999,0
1713308874432,MATH 197,002,563811,Zhang; Danna,9999,0,9999,0
1713308875461,MCWP 40R,A00,518780,Staff,20,0,20,0
1713308875461,MCWP 40R,B00,518781,Staff,20,0,20,0
1713308875461,MCWP 40R,C00,518783,Staff,19,0,20,1
1713308876494,MCWP 50R,A00,518791,Staff,20,0,20,0
1713308876494,MCWP 50R,B00,518792,Staff,19,0,20,1
1713308876494,MCWP 50R,C00,518793,Staff,19,0,20,1
1713308876494,MCWP 50R,D00,518794,Staff,18,0,20,2
1713308876494,MCWP 50R,E00,518795,Staff,18,0,20,2
1713308876494,MCWP 50R,F00,518796,Staff,19,0,20,1
1713308876494,MCWP 50R,G00,518797,Staff,19,0,20,1
1713308877519,MMW 12R,A01,514034,Herbst; Matthew,16,0,16,0
1713308877519,MMW 12R,A02,514035,Herbst; Matthew,16,0,16,0
1713308878547,MMW 13R,A01,514037,Staff,14,0,16,2
1713308878547,MMW 13R,A02,514039,Staff,16,0,16,0
1713308880601,SIO 295LS,A00,523233,Staff,19,0,30,11
1713308881627,SIO 295S,A00,523232,Staff,19,0,30,11
1713308882656,SOCI 117,A01,494376,Staff,3,0,5,2
1713308883685,WES 237B,A00,494380,Staff,19,0,20,1
1713308885753,AESE 279B,A00,494370,Wade; Jon P,33,0,33,0
1713308886780,ANAR 135S,A00,494369,Braswell; Geoffrey E.,0,0,0,0
1713308887806,CAT 124RS,A01,519847,Geibel; William,17,0,20,3
1713308888835,CAT 125RS,A01,515971,Geibel; William,17,0,20,3
1713308889861,CLRE 250,A00,511389,Morris; Sheldon,9996,0,9999,3
1713308890890,CLRE 251,A00,507176,Mehta; Ravindra L.,9996,0,9999,3
1713308890890,CLRE 251,B00,511410,Mehta; Ravindra L.,9998,0,9999,1
1713308891918,CLRE 252,A00,507189,Cuomo; Raphael Eduardo,9998,0,9999,1
1713308892945,CLRE 253,A00,507199,Vaida; Florin,9997,0,9999,2
1713308892945,CLRE 253,B00,507202,Vaida; Florin,9999,0,9999,0
1713308893971,CLRE 259,A00,507211,Patel; Hemal,9996,0,9999,3
1713308894995,CLRE 260,A00,507221,Cuomo; Raphael Eduardo,9999,0,9999,0
1713308896023,CLRE 297,001,507242,Cuomo; Raphael Eduardo,9999,0,9999,0
1713308897052,CSE 191,A00,516875,Minnes Kemp; Mor Mia,9999,0,9999,0
1713308898080,CSS 201S,A01,494383,Staff,35,0,35,0
1713308899160,CSS 202S,A01,494387,Staff,35,0,35,0
1713308900184,EAP 100,A00,516065,Staff,9792,0,9999,207
1713308901207,ECE 45,A01,507414,Staff,56,0,60,4
1713308902233,ECE 100,A01,507416,Baghdadchi; Saharnaz,11,0,20,9
1713308902233,ECE 100,A02,507418,Baghdadchi; Saharnaz,20,0,20,0
1713308903258,ECE 111,A01,507420,Staff,40,0,50,10
1713308904283,ECE 197,001,548057,Sievenpiper; Daniel F.,9998,0,9999,1
1713308905311,EDS 115,A00,507243,Choi; Bailey Miyeon,28,0,28,0
1713308906335,EDS 117,A01,494379,Staff,25,0,25,0
1713308907359,EDS 125,A00,507246,Hopkins; Megan Beth,29,0,30,1
1713308908387,EDS 128A,A01,507264,Fargason; Sharon Gayle,26,0,26,0
1713308909412,EDS 128B,A01,507293,Pappas; Elizabeth,30,0,30,0
1713308910436,EDS 139,A00,507294,Fargason; Sharon Gayle,30,0,30,0
1713308910436,EDS 139,B00,507313,Pappas; Elizabeth,30,0,30,0
1713308911461,EDS 201,A00,507315,Staff,26,0,30,4
1713308912488,EDS 203,A01,507317,Halter; Christopher P.,26,0,30,4
1713308913512,EDS 204R,A01,507319,Halter; Christopher P.,5,0,30,25
1713308913512,EDS 204R,B01,507331,Heinzman; Erica M.,30,0,30,0
1713308914539,EDS 206R,A00,507332,Staff,7,0,30,23
1713308914539,EDS 206R,B00,507343,Staff,29,0,30,1
1713308915568,EDS 250,A00,507344,Hemans; Patricia Ann Benitez,36,0,40,4
1713308916593,EDS 281,A00,507345,Daly; Alan J.,18,0,18,0
1713308917618,EDS 284,A00,507350,Daly; Alan J.,16,0,16,0
1713308918642,EDS 286,A00,507359,Fine; Sarah,18,0,18,0
1713308919666,EDS 289C,A01,507361,Daly; Alan J.,18,0,18,0
1713308920695,EDS 290,A00,507366,Hofstetter; Carolyn,15,0,15,0
1713308921722,LIGM 5A,A00,507421,Fischer-Grunski; Eva K,20,0,20,0
1713308922748,LIGM 5B,A00,507423,Fischer-Grunski; Eva K,20,0,20,0
1713308923776,LIGM 5C,A00,507425,Fischer-Grunski; Eva K,20,0,20,0
1713308924801,LIIT 5AS,A00,507427,Carnelos; Chiara,20,0,20,0
1713308925831,LIIT 5BS,A00,507430,Carnelos; Chiara,20,0,20,0
1713308926854,LIIT 5CS,A00,507432,Carnelos; Chiara,20,0,20,0
1713308927881,LISP 5A,A00,507541,Munoz Sanchez; Alicia,19,0,20,1
1713308928906,LISP 5B,A00,507671,Munoz Sanchez; Alicia,17,0,20,3
1713308929932,LISP 5C,A00,507696,Munoz Sanchez; Alicia,17,0,20,3
1713308930963,MAE 197,001,528363,Boechler; Nicholas Sebastia,9998,0,9999,1
1713308931992,MATH 197,001,523477,Kedlaya; Kiran S.,9999,0,9999,0
1713308931992,MATH 197,002,563811,Zhang; Danna,9999,0,9999,0
1713308933018,MCWP 40R,A00,518780,Staff,20,0,20,0
1713308933018,MCWP 40R,B00,518781,Staff,20,0,20,0
1713308933018,MCWP 40R,C00,518783,Staff,19,0,20,1
1713308934044,MCWP 50R,A00,518791,Staff,20,0,20,0
1713308934044,MCWP 50R,B00,518792,Staff,19,0,20,1
1713308934044,MCWP 50R,C00,518793,Staff,19,0,20,1
1713308934044,MCWP 50R,D00,518794,Staff,18,0,20,2
1713308934044,MCWP 50R,E00,518795,Staff,18,0,20,2
1713308934044,MCWP 50R,F00,518796,Staff,19,0,20,1
1713308934044,MCWP 50R,G00,518797,Staff,19,0,20,1
1713308935071,MMW 12R,A01,514034,Herbst; Matthew,16,0,16,0
1713308935071,MMW 12R,A02,514035,Herbst; Matthew,16,0,16,0
1713308936097,MMW 13R,A01,514037,Staff,14,0,16,2
1713308936097,MMW 13R,A02,514039,Staff,16,0,16,0
1713308938151,SIO 295LS,A00,523233,Staff,19,0,30,11
1713308939182,SIO 295S,A00,523232,Staff,19,0,30,11
1713308940209,SOCI 117,A01,494376,Staff,3,0,5,2
1713308941235,WES 237B,A00,494380,Staff,19,0,20,1
1713308943297,AESE 279B,A00,494370,Wade; Jon P,33,0,33,0
1713308944326,ANAR 135S,A00,494369,Braswell; Geoffrey E.,0,0,0,0
1713308945356,CAT 124RS,A01,519847,Geibel; William,17,0,20,3
1713308946383,CAT 125RS,A01,515971,Geibel; William,17,0,20,3
1713308947412,CLRE 250,A00,511389,Morris; Sheldon,9996,0,9999,3
1713308948439,CLRE 251,A00,507176,Mehta; Ravindra L.,9996,0,9999,3
1713308948439,CLRE 251,B00,511410,Mehta; Ravindra L.,9998,0,9999,1
1713308949495,CLRE 252,A00,507189,Cuomo; Raphael Eduardo,9998,0,9999,1
1713308950518,CLRE 253,A00,507199,Vaida; Florin,9997,0,9999,2
1713308950518,CLRE 253,B00,507202,Vaida; Florin,9999,0,9999,0
1713308951544,CLRE 259,A00,507211,Patel; Hemal,9996,0,9999,3
1713308952570,CLRE 260,A00,507221,Cuomo; Raphael Eduardo,9999,0,9999,0
1713308953594,CLRE 297,001,507242,Cuomo; Raphael Eduardo,9999,0,9999,0
1713308954619,CSE 191,A00,516875,Minnes Kemp; Mor Mia,9999,0,9999,0
1713308955649,CSS 201S,A01,494383,Staff,35,0,35,0
1713308956680,CSS 202S,A01,494387,Staff,35,0,35,0
1713308957706,EAP 100,A00,516065,Staff,9792,0,9999,207
1713308958736,ECE 45,A01,507414,Staff,56,0,60,4
1713308959761,ECE 100,A01,507416,Baghdadchi; Saharnaz,11,0,20,9
1713308959761,ECE 100,A02,507418,Baghdadchi; Saharnaz,20,0,20,0
1713308960787,ECE 111,A01,507420,Staff,40,0,50,10
1713308961813,ECE 197,001,548057,Sievenpiper; Daniel F.,9998,0,9999,1
1713308962841,EDS 115,A00,507243,Choi; Bailey Miyeon,28,0,28,0
1713308963871,EDS 117,A01,494379,Staff,25,0,25,0
1713308964898,EDS 125,A00,507246,Hopkins; Megan Beth,29,0,30,1
1713308965924,EDS 128A,A01,507264,Fargason; Sharon Gayle,26,0,26,0
1713308966953,EDS 128B,A01,507293,Pappas; Elizabeth,30,0,30,0
1713308967984,EDS 139,A00,507294,Fargason; Sharon Gayle,30,0,30,0
1713308967984,EDS 139,B00,507313,Pappas; Elizabeth,30,0,30,0
1713308969011,EDS 201,A00,507315,Staff,26,0,30,4
1713308970037,EDS 203,A01,507317,Halter; Christopher P.,26,0,30,4
1713308971061,EDS 204R,A01,507319,Halter; Christopher P.,5,0,30,25
1713308971061,EDS 204R,B01,507331,Heinzman; Erica M.,30,0,30,0
1713308972086,EDS 206R,A00,507332,Staff,7,0,30,23
1713308972086,EDS 206R,B00,507343,Staff,29,0,30,1
1713308973115,EDS 250,A00,507344,Hemans; Patricia Ann Benitez,36,0,40,4
1713308974144,EDS 281,A00,507345,Daly; Alan J.,18,0,18,0
1713308975175,EDS 284,A00,507350,Daly; Alan J.,16,0,16,0
1713308976199,EDS 286,A00,507359,Fine; Sarah,18,0,18,0
1713308977225,EDS 289C,A01,507361,Daly; Alan J.,18,0,18,0
1713308978250,EDS 290,A00,507366,Hofstetter; Carolyn,15,0,15,0
1713308979279,LIGM 5A,A00,507421,Fischer-Grunski; Eva K,20,0,20,0
1713308980304,LIGM 5B,A00,507423,Fischer-Grunski; Eva K,20,0,20,0
1713308981334,LIGM 5C,A00,507425,Fischer-Grunski; Eva K,20,0,20,0
1713308982364,LIIT 5AS,A00,507427,Carnelos; Chiara,20,0,20,0
1713308983389,LIIT 5BS,A00,507430,Carnelos; Chiara,20,0,20,0
1713308984414,LIIT 5CS,A00,507432,Carnelos; Chiara,20,0,20,0
1713308985441,LISP 5A,A00,507541,Munoz Sanchez; Alicia,19,0,20,1
1713308986467,LISP 5B,A00,507671,Munoz Sanchez; Alicia,17,0,20,3
1713308987497,LISP 5C,A00,507696,Munoz Sanchez; Alicia,17,0,20,3
1713308988520,MAE 197,001,528363,Boechler; Nicholas Sebastia,9998,0,9999,1
1713308989553,MATH 197,001,523477,Kedlaya; Kiran S.,9999,0,9999,0
1713308989553,MATH 197,002,563811,Zhang; Danna,9999,0,9999,0
1713308990578,MCWP 40R,A00,518780,Staff,20,0,20,0
1713308990578,MCWP 40R,B00,518781,Staff,19,0,20,1
1713308990578,MCWP 40R,C00,518783,Staff,19,0,20,1
1713308991605,MCWP 50R,A00,518791,Staff,20,0,20,0
1713308991605,MCWP 50R,B00,518792,Staff,19,0,20,1
1713308991605,MCWP 50R,C00,518793,Staff,19,0,20,1
1713308991605,MCWP 50R,D00,518794,Staff,18,0,20,2
1713308991605,MCWP 50R,E00,518795,Staff,18,0,20,2
1713308991605,MCWP 50R,F00,518796,Staff,19,0,20,1
1713308991605,MCWP 50R,G00,518797,Staff,19,0,20,1
1713308992637,MMW 12R,A01,514034,Herbst; Matthew,16,0,16,0
1713308992637,MMW 12R,A02,514035,Herbst; Matthew,16,0,16,0
1713308993665,MMW 13R,A01,514037,Staff,14,0,16,2
1713308993665,MMW 13R,A02,514039,Staff,16,0,16,0
1713308995720,SIO 295LS,A00,523233,Staff,19,0,30,11
1713308996743,SIO 295S,A00,523232,Staff,19,0,30,11
1713308997769,SOCI 117,A01,494376,Staff,3,0,5,2
1713308998796,WES 237B,A00,494380,Staff,19,0,20,1
1713309000859,AESE 279B,A00,494370,Wade; Jon P,33,0,33,0
1713309001890,ANAR 135S,A00,494369,Braswell; Geoffrey E.,0,0,0,0
1713309002971,CAT 124RS,A01,519847,Geibel; William,17,0,20,3
1713309004109,CAT 125RS,A01,515971,Geibel; William,17,0,20,3
1713309005137,CLRE 250,A00,511389,Morris; Sheldon,9996,0,9999,3
1713309006163,CLRE 251,A00,507176,Mehta; Ravindra L.,9996,0,9999,3
1713309006163,CLRE 251,B00,511410,Mehta; Ravindra L.,9998,0,9999,1
1713309007194,CLRE 252,A00,507189,Cuomo; Raphael Eduardo,9998,0,9999,1
1713309008228,CLRE 253,A00,507199,Vaida; Florin,9997,0,9999,2
1713309008228,CLRE 253,B00,507202,Vaida; Florin,9999,0,9999,0
1713309009257,CLRE 259,A00,507211,Patel; Hemal,9996,0,9999,3
1713309010285,CLRE 260,A00,507221,Cuomo; Raphael Eduardo,9999,0,9999,0
1713309011311,CLRE 297,001,507242,Cuomo; Raphael Eduardo,9999,0,9999,0
1713309012342,CSE 191,A00,516875,Minnes Kemp; Mor Mia,9999,0,9999,0
1713309013368,CSS 201S,A01,494383,Staff,35,0,35,0
1713309014400,CSS 202S,A01,494387,Staff,35,0,35,0
1713309015427,EAP 100,A00,516065,Staff,9792,0,9999,207
1713309016452,ECE 45,A01,507414,Staff,55,0,60,5
1713309017482,ECE 100,A01,507416,Baghdadchi; Saharnaz,11,0,20,9
1713309017482,ECE 100,A02,507418,Baghdadchi; Saharnaz,20,0,20,0
1713309018507,ECE 111,A01,507420,Staff,40,0,50,10
1713309019533,ECE 197,001,548057,Sievenpiper; Daniel F.,9998,0,9999,1
1713309020558,EDS 115,A00,507243,Choi; Bailey Miyeon,28,0,28,0
1713309021590,EDS 117,A01,494379,Staff,25,0,25,0
1713309022615,EDS 125,A00,507246,Hopkins; Megan Beth,29,0,30,1
1713309023642,EDS 128A,A01,507264,Fargason; Sharon Gayle,26,0,26,0
1713309024665,EDS 128B,A01,507293,Pappas; Elizabeth,30,0,30,0
1713309025689,EDS 139,A00,507294,Fargason; Sharon Gayle,30,0,30,0
1713309025689,EDS 139,B00,507313,Pappas; Elizabeth,30,0,30,0
1713309026719,EDS 201,A00,507315,Staff,26,0,30,4
1713309027745,EDS 203,A01,507317,Halter; Christopher P.,26,0,30,4
1713309028775,EDS 204R,A01,507319,Halter; Christopher P.,5,0,30,25
1713309028775,EDS 204R,B01,507331,Heinzman; Erica M.,30,0,30,0
1713309029799,EDS 206R,A00,507332,Staff,7,0,30,23
1713309029799,EDS 206R,B00,507343,Staff,29,0,30,1
1713309030825,EDS 250,A00,507344,Hemans; Patricia Ann Benitez,36,0,40,4
1713309031849,EDS 281,A00,507345,Daly; Alan J.,18,0,18,0
1713309032874,EDS 284,A00,507350,Daly; Alan J.,16,0,16,0
1713309033912,EDS 286,A00,507359,Fine; Sarah,18,0,18,0
1713309034941,EDS 289C,A01,507361,Daly; Alan J.,18,0,18,0
1713309035966,EDS 290,A00,507366,Hofstetter; Carolyn,15,0,15,0
1713309036996,LIGM 5A,A00,507421,Fischer-Grunski; Eva K,20,0,20,0
1713309038025,LIGM 5B,A00,507423,Fischer-Grunski; Eva K,20,0,20,0
1713309039052,LIGM 5C,A00,507425,Fischer-Grunski; Eva K,20,0,20,0
1713309040078,LIIT 5AS,A00,507427,Carnelos; Chiara,20,0,20,0
1713309041103,LIIT 5BS,A00,507430,Carnelos; Chiara,20,0,20,0
1713309042127,LIIT 5CS,A00,507432,Carnelos; Chiara,20,0,20,0
1713309043153,LISP 5A,A00,507541,Munoz Sanchez; Alicia,19,0,20,1
1713309044188,LISP 5B,A00,507671,Munoz Sanchez; Alicia,17,0,20,3
1713309045214,LISP 5C,A00,507696,Munoz Sanchez; Alicia,17,0,20,3
1713309046240,MAE 197,001,528363,Boechler; Nicholas Sebastia,9998,0,9999,1
1713309047266,MATH 197,001,523477,Kedlaya; Kiran S.,9999,0,9999,0
1713309047266,MATH 197,002,563811,Zhang; Danna,9999,0,9999,0
1713309048298,MCWP 40R,A00,518780,Staff,20,0,20,0
1713309048298,MCWP 40R,B00,518781,Staff,19,0,20,1
1713309048298,MCWP 40R,C00,518783,Staff,19,0,20,1
1713309049326,MCWP 50R,A00,518791,Staff,20,0,20,0
1713309049326,MCWP 50R,B00,518792,Staff,19,0,20,1
1713309049326,MCWP 50R,C00,518793,Staff,19,0,20,1
1713309049326,MCWP 50R,D00,518794,Staff,18,0,20,2
1713309049326,MCWP 50R,E00,518795,Staff,18,0,20,2
1713309049326,MCWP 50R,F00,518796,Staff,19,0,20,1
1713309049326,MCWP 50R,G00,518797,Staff,19,0,20,1
1713309050352,MMW 12R,A01,514034,Herbst; Matthew,16,0,16,0
1713309050352,MMW 12R,A02,514035,Herbst; Matthew,16,0,16,0
1713309051381,MMW 13R,A01,514037,Staff,14,0,16,2
1713309051381,MMW 13R,A02,514039,Staff,16,0,16,0
1713309053433,SIO 295LS,A00,523233,Staff,19,0,30,11
1713309054461,SIO 295S,A00,523232,Staff,19,0,30,11
1713309055491,SOCI 117,A01,494376,Staff,3,0,5,2
1713309056519,WES 237B,A00,494380,Staff,19,0,20,1
1713309058597,AESE 279B,A00,494370,Wade; Jon P,33,0,33,0
1713309059622,ANAR 135S,A00,494369,Braswell; Geoffrey E.,0,0,0,0
1713309060653,CAT 124RS,A01,519847,Geibel; William,17,0,20,3
1713309061681,CAT 125RS,A01,515971,Geibel; William,17,0,20,3
1713309062708,CLRE 250,A00,511389,Morris; Sheldon,9996,0,9999,3
1713309063740,CLRE 251,A00,507176,Mehta; Ravindra L.,9996,0,9999,3
1713309063740,CLRE 251,B00,511410,Mehta; Ravindra L.,9998,0,9999,1
1713309064765,CLRE 252,A00,507189,Cuomo; Raphael Eduardo,9998,0,9999,1
1713309065794,CLRE 253,A00,507199,Vaida; Florin,9997,0,9999,2
1713309065794,CLRE 253,B00,507202,Vaida; Florin,9999,0,9999,0
1713309066819,CLRE 259,A00,507211,Patel; Hemal,9996,0,9999,3
1713309067851,CLRE 260,A00,507221,Cuomo; Raphael Eduardo,9999,0,9999,0
1713309068876,CLRE 297,001,507242,Cuomo; Raphael Eduardo,9999,0,9999,0
1713309069907,CSE 191,A00,516875,Minnes Kemp; Mor Mia,9999,0,9999,0
1713309070933,CSS 201S,A01,494383,Staff,35,0,35,0
1713309071961,CSS 202S,A01,494387,Staff,35,0,35,0
1713309072985,EAP 100,A00,516065,Staff,9792,0,9999,207
1713309074011,ECE 45,A01,507414,Staff,55,0,60,5
1713309075040,ECE 100,A01,507416,Baghdadchi; Saharnaz,11,0,20,9
1713309075040,ECE 100,A02,507418,Baghdadchi; Saharnaz,20,0,20,0
1713309076068,ECE 111,A01,507420,Staff,40,0,50,10
1713309077094,ECE 197,001,548057,Sievenpiper; Daniel F.,9998,0,9999,1
1713309078123,EDS 115,A00,507243,Choi; Bailey Miyeon,28,0,28,0
1713309079148,EDS 117,A01,494379,Staff,25,0,25,0
1713309080173,EDS 125,A00,507246,Hopkins; Megan Beth,29,0,30,1
1713309081198,EDS 128A,A01,507264,Fargason; Sharon Gayle,26,0,26,0
1713309082227,EDS 128B,A01,507293,Pappas; Elizabeth,30,0,30,0
1713309083256,EDS 139,A00,507294,Fargason; Sharon Gayle,30,0,30,0
1713309083256,EDS 139,B00,507313,Pappas; Elizabeth,30,0,30,0
1713309084281,EDS 201,A00,507315,Staff,26,0,30,4
1713309085309,EDS 203,A01,507317,Halter; Christopher P.,26,0,30,4
1713309086335,EDS 204R,A01,507319,Halter; Christopher P.,5,0,30,25
1713309086335,EDS 204R,B01,507331,Heinzman; Erica M.,30,0,30,0
1713309087360,EDS 206R,A00,507332,Staff,7,0,30,23
1713309087360,EDS 206R,B00,507343,Staff,29,0,30,1
1713309088389,EDS 250,A00,507344,Hemans; Patricia Ann Benitez,36,0,40,4
1713309089418,EDS 281,A00,507345,Daly; Alan J.,18,0,18,0
1713309090443,EDS 284,A00,507350,Daly; Alan J.,16,0,16,0
1713309091469,EDS 286,A00,507359,Fine; Sarah,18,0,18,0
1713309092494,EDS 289C,A01,507361,Daly; Alan J.,18,0,18,0
1713309093518,EDS 290,A00,507366,Hofstetter; Carolyn,15,0,15,0
1713309094543,LIGM 5A,A00,507421,Fischer-Grunski; Eva K,20,0,20,0
1713309095569,LIGM 5B,A00,507423,Fischer-Grunski; Eva K,20,0,20,0
1713309096595,LIGM 5C,A00,507425,Fischer-Grunski; Eva K,20,0,20,0
1713309097621,LIIT 5AS,A00,507427,Carnelos; Chiara,20,0,20,0
1713309098646,LIIT 5BS,A00,507430,Carnelos; Chiara,20,0,20,0
1713309099674,LIIT 5CS,A00,507432,Carnelos; Chiara,20,0,20,0
1713309100707,LISP 5A,A00,507541,Munoz Sanchez; Alicia,19,0,20,1
1713309101737,LISP 5B,A00,507671,Munoz Sanchez; Alicia,17,0,20,3
1713309102762,LISP 5C,A00,507696,Munoz Sanchez; Alicia,17,0,20,3
1713309103792,MAE 197,001,528363,Boechler; Nicholas Sebastia,9998,0,9999,1
1713309104823,MATH 197,001,523477,Kedlaya; Kiran S.,9999,0,9999,0
1713309104823,MATH 197,002,563811,Zhang; Danna,9999,0,9999,0
1713309105849,MCWP 40R,A00,518780,Staff,20,0,20,0
1713309105849,MCWP 40R,B00,518781,Staff,19,0,20,1
1713309105849,MCWP 40R,C00,518783,Staff,19,0,20,1
1713309106938,MCWP 50R,A00,518791,Staff,20,0,20,0
1713309106938,MCWP 50R,B00,518792,Staff,19,0,20,1
1713309106938,MCWP 50R,C00,518793,Staff,19,0,20,1
1713309106938,MCWP 50R,D00,518794,Staff,18,0,20,2
1713309106938,MCWP 50R,E00,518795,Staff,18,0,20,2
1713309106938,MCWP 50R,F00,518796,Staff,19,0,20,1
1713309106938,MCWP 50R,G00,518797,Staff,19,0,20,1
1713309107965,MMW 12R,A01,514034,Herbst; Matthew,16,0,16,0
1713309107965,MMW 12R,A02,514035,Herbst; Matthew,16,0,16,0
1713309108988,MMW 13R,A01,514037,Staff,14,0,16,2
1713309108988,MMW 13R,A02,514039,Staff,16,0,16,0
1713309111043,SIO 295LS,A00,523233,Staff,19,0,30,11
1713309112068,SIO 295S,A00,523232,Staff,19,0,30,11
1713309113098,SOCI 117,A01,494376,Staff,3,0,5,2
1713309114124,WES 237B,A00,494380,Staff,19,0,20,1
1713309116188,AESE 279B,A00,494370,Wade; Jon P,33,0,33,0
1713309117212,ANAR 135S,A00,494369,Braswell; Geoffrey E.,0,0,0,0
1713309118241,CAT 124RS,A01,519847,Geibel; William,17,0,20,3
1713309119270,CAT 125RS,A01,515971,Geibel; William,17,0,20,3
1713309120293,CLRE 250,A00,511389,Morris; Sheldon,9996,0,9999,3
1713309121320,CLRE 251,A00,507176,Mehta; Ravindra L.,9996,0,9999,3
1713309121320,CLRE 251,B00,511410,Mehta; Ravindra L.,9998,0,9999,1
1713309122344,CLRE 252,A00,507189,Cuomo; Raphael Eduardo,9998,0,9999,1
1713309123373,CLRE 253,A00,507199,Vaida; Florin,9997,0,9999,2
1713309123373,CLRE 253,B00,507202,Vaida; Florin,9999,0,9999,0
1713309124398,CLRE 259,A00,507211,Patel; Hemal,9996,0,9999,3
1713309125427,CLRE 260,A00,507221,Cuomo; Raphael Eduardo,9999,0,9999,0
1713309126452,CLRE 297,001,507242,Cuomo; Raphael Eduardo,9999,0,9999,0
1713309127481,CSE 191,A00,516875,Minnes Kemp; Mor Mia,9999,0,9999,0
1713309128506,CSS 201S,A01,494383,Staff,35,0,35,0
1713309129533,CSS 202S,A01,494387,Staff,35,0,35,0
1713309130558,EAP 100,A00,516065,Staff,9792,0,9999,207
1713309131584,ECE 45,A01,507414,Staff,55,0,60,5
1713309132609,ECE 100,A01,507416,Baghdadchi; Saharnaz,11,0,20,9
1713309132609,ECE 100,A02,507418,Baghdadchi; Saharnaz,20,0,20,0
1713309133637,ECE 111,A01,507420,Staff,40,0,50,10
1713309134664,ECE 197,001,548057,Sievenpiper; Daniel F.,9998,0,9999,1
1713309135698,EDS 115,A00,507243,Choi; Bailey Miyeon,28,0,28,0
1713309136726,EDS 117,A01,494379,Staff,25,0,25,0
1713309137752,EDS 125,A00,507246,Hopkins; Megan Beth,29,0,30,1
1713309138781,EDS 128A,A01,507264,Fargason; Sharon Gayle,26,0,26,0
1713309139806,EDS 128B,A01,507293,Pappas; Elizabeth,30,0,30,0
1713309140832,EDS 139,A00,507294,Fargason; Sharon Gayle,30,0,30,0
1713309140832,EDS 139,B00,507313,Pappas; Elizabeth,30,0,30,0
1713309141856,EDS 201,A00,507315,Staff,26,0,30,4
1713309142882,EDS 203,A01,507317,Halter; Christopher P.,26,0,30,4
1713309143909,EDS 204R,A01,507319,Halter; Christopher P.,5,0,30,25
1713309143909,EDS 204R,B01,507331,Heinzman; Erica M.,30,0,30,0
1713309144935,EDS 206R,A00,507332,Staff,7,0,30,23
1713309144935,EDS 206R,B00,507343,Staff,29,0,30,1
1713309145964,EDS 250,A00,507344,Hemans; Patricia Ann Benitez,36,0,40,4
1713309146990,EDS 281,A00,507345,Daly; Alan J.,18,0,18,0
1713309148015,EDS 284,A00,507350,Daly; Alan J.,16,0,16,0
1713309149044,EDS 286,A00,507359,Fine; Sarah,18,0,18,0
1713309150069,EDS 289C,A01,507361,Daly; Alan J.,18,0,18,0
1713309151095,EDS 290,A00,507366,Hofstetter; Carolyn,15,0,15,0
1713309152120,LIGM 5A,A00,507421,Fischer-Grunski; Eva K,20,0,20,0
1713309153311,LIGM 5B,A00,507423,Fischer-Grunski; Eva K,20,0,20,0
1713309154339,LIGM 5C,A00,507425,Fischer-Grunski; Eva K,20,0,20,0
1713309155364,LIIT 5AS,A00,507427,Carnelos; Chiara,20,0,20,0
1713309156390,LIIT 5BS,A00,507430,Carnelos; Chiara,20,0,20,0
1713309157415,LIIT 5CS,A00,507432,Carnelos; Chiara,20,0,20,0
1713309158441,LISP 5A,A00,507541,Munoz Sanchez; Alicia,19,0,20,1
1713309159469,LISP 5B,A00,507671,Munoz Sanchez; Alicia,17,0,20,3
1713309160495,LISP 5C,A00,507696,Munoz Sanchez; Alicia,17,0,20,3
1713309161525,MAE 197,001,528363,Boechler; Nicholas Sebastia,9998,0,9999,1
1713309162553,MATH 197,001,523477,Kedlaya; Kiran S.,9999,0,9999,0
1713309162553,MATH 197,002,563811,Zhang; Danna,9999,0,9999,0
1713309163585,MCWP 40R,A00,518780,Staff,20,0,20,0
1713309163585,MCWP 40R,B00,518781,Staff,19,0,20,1
1713309163585,MCWP 40R,C00,518783,Staff,19,0,20,1
1713309164612,MCWP 50R,A00,518791,Staff,20,0,20,0
1713309164612,MCWP 50R,B00,518792,Staff,19,0,20,1
1713309164612,MCWP 50R,C00,518793,Staff,19,0,20,1
1713309164612,MCWP 50R,D00,518794,Staff,18,0,20,2
1713309164612,MCWP 50R,E00,518795,Staff,18,0,20,2
1713309164612,MCWP 50R,F00,518796,Staff,19,0,20,1
1713309164612,MCWP 50R,G00,518797,Staff,19,0,20,1
1713309165644,MMW 12R,A01,514034,Herbst; Matthew,16,0,16,0
1713309165644,MMW 12R,A02,514035,Herbst; Matthew,16,0,16,0
1713309166668,MMW 13R,A01,514037,Staff,14,0,16,2
1713309166668,MMW 13R,A02,514039,Staff,16,0,16,0
1713309168722,SIO 295LS,A00,523233,Staff,19,0,30,11
1713309169750,SIO 295S,A00,523232,Staff,19,0,30,11
1713309170775,SOCI 117,A01,494376,Staff,3,0,5,2
1713309171800,WES 237B,A00,494380,Staff,19,0,20,1
1713309173878,AESE 279B,A00,494370,Wade; Jon P,33,0,33,0
1713309174903,ANAR 135S,A00,494369,Braswell; Geoffrey E.,0,0,0,0
1713309175929,CAT 124RS,A01,519847,Geibel; William,17,0,20,3
1713309176957,CAT 125RS,A01,515971,Geibel; William,17,0,20,3
1713309177985,CLRE 250,A00,511389,Morris; Sheldon,9996,0,9999,3
1713309179017,CLRE 251,A00,507176,Mehta; Ravindra L.,9996,0,9999,3
1713309179017,CLRE 251,B00,511410,Mehta; Ravindra L.,9998,0,9999,1
1713309180042,CLRE 252,A00,507189,Cuomo; Raphael Eduardo,9998,0,9999,1
1713309181069,CLRE 253,A00,507199,Vaida; Florin,9997,0,9999,2
1713309181069,CLRE 253,B00,507202,Vaida; Florin,9999,0,9999,0
1713309182099,CLRE 259,A00,507211,Patel; Hemal,9996,0,9999,3
1713309183129,CLRE 260,A00,507221,Cuomo; Raphael Eduardo,9999,0,9999,0
1713309184154,CLRE 297,001,507242,Cuomo; Raphael Eduardo,9999,0,9999,0
1713309185178,CSE 191,A00,516875,Minnes Kemp; Mor Mia,9999,0,9999,0
1713309186202,CSS 201S,A01,494383,Staff,35,0,35,0
1713309187227,CSS 202S,A01,494387,Staff,35,0,35,0
1713309188254,EAP 100,A00,516065,Staff,9792,0,9999,207
1713309189281,ECE 45,A01,507414,Staff,54,0,60,6
1713309190306,ECE 100,A01,507416,Baghdadchi; Saharnaz,11,0,20,9
1713309190306,ECE 100,A02,507418,Baghdadchi; Saharnaz,20,0,20,0
1713309191330,ECE 111,A01,507420,Staff,40,0,50,10
1713309192353,ECE 197,001,548057,Sievenpiper; Daniel F.,9998,0,9999,1
1713309193380,EDS 115,A00,507243,Choi; Bailey Miyeon,28,0,28,0
1713309194403,EDS 117,A01,494379,Staff,25,0,25,0
1713309195427,EDS 125,A00,507246,Hopkins; Megan Beth,29,0,30,1
1713309196456,EDS 128A,A01,507264,Fargason; Sharon Gayle,26,0,26,0
1713309197481,EDS 128B,A01,507293,Pappas; Elizabeth,30,0,30,0
1713309198506,EDS 139,A00,507294,Fargason; Sharon Gayle,30,0,30,0
1713309198506,EDS 139,B00,507313,Pappas; Elizabeth,30,0,30,0
1713309199531,EDS 201,A00,507315,Staff,26,0,30,4
1713309200555,EDS 203,A01,507317,Halter; Christopher P.,26,0,30,4
1713309201584,EDS 204R,A01,507319,Halter; Christopher P.,5,0,30,25
1713309201584,EDS 204R,B01,507331,Heinzman; Erica M.,30,0,30,0
1713309202612,EDS 206R,A00,507332,Staff,7,0,30,23
1713309202612,EDS 206R,B00,507343,Staff,29,0,30,1
1713309203639,EDS 250,A00,507344,Hemans; Patricia Ann Benitez,36,0,40,4
1713309204666,EDS 281,A00,507345,Daly; Alan J.,18,0,18,0
1713309205695,EDS 284,A00,507350,Daly; Alan J.,16,0,16,0
1713309206734,EDS 286,A00,507359,Fine; Sarah,18,0,18,0
1713309207759,EDS 289C,A01,507361,Daly; Alan J.,18,0,18,0
1713309208785,EDS 290,A00,507366,Hofstetter; Carolyn,15,0,15,0
1713309209816,LIGM 5A,A00,507421,Fischer-Grunski; Eva K,20,0,20,0
1713309210896,LIGM 5B,A00,507423,Fischer-Grunski; Eva K,20,0,20,0
1713309211921,LIGM 5C,A00,507425,Fischer-Grunski; Eva K,20,0,20,0
1713309212945,LIIT 5AS,A00,507427,Carnelos; Chiara,20,0,20,0
1713309213975,LIIT 5BS,A00,507430,Carnelos; Chiara,20,0,20,0
1713309215004,LIIT 5CS,A00,507432,Carnelos; Chiara,20,0,20,0
1713309216030,LISP 5A,A00,507541,Munoz Sanchez; Alicia,19,0,20,1
1713309217062,LISP 5B,A00,507671,Munoz Sanchez; Alicia,17,0,20,3
1713309218087,LISP 5C,A00,507696,Munoz Sanchez; Alicia,17,0,20,3
1713309219115,MAE 197,001,528363,Boechler; Nicholas Sebastia,9998,0,9999,1
1713309220139,MATH 197,001,523477,Kedlaya; Kiran S.,9999,0,9999,0
1713309220139,MATH 197,002,563811,Zhang; Danna,9999,0,9999,0
1713309221168,MCWP 40R,A00,518780,Staff,20,0,20,0
1713309221168,MCWP 40R,B00,518781,Staff,19,0,20,1
1713309221168,MCWP 40R,C00,518783,Staff,19,0,20,1
1713309222199,MCWP 50R,A00,518791,Staff,20,0,20,0
1713309222199,MCWP 50R,B00,518792,Staff,19,0,20,1
1713309222199,MCWP 50R,C00,518793,Staff,19,0,20,1
1713309222199,MCWP 50R,D00,518794,Staff,18,0,20,2
1713309222199,MCWP 50R,E00,518795,Staff,18,0,20,2
1713309222199,MCWP 50R,F00,518796,Staff,19,0,20,1
1713309222199,MCWP 50R,G00,518797,Staff,19,0,20,1
1713309223223,MMW 12R,A01,514034,Herbst; Matthew,16,0,16,0
1713309223223,MMW 12R,A02,514035,Herbst; Matthew,16,0,16,0
1713309224250,MMW 13R,A01,514037,Staff,14,0,16,2
1713309224250,MMW 13R,A02,514039,Staff,16,0,16,0
1713309226303,SIO 295LS,A00,523233,Staff,19,0,30,11
1713309227332,SIO 295S,A00,523232,Staff,19,0,30,11
1713309228362,SOCI 117,A01,494376,Staff,3,0,5,2
1713309229388,WES 237B,A00,494380,Staff,19,0,20,1
1713309231457,AESE 279B,A00,494370,Wade; Jon P,33,0,33,0
1713309232485,ANAR 135S,A00,494369,Braswell; Geoffrey E.,0,0,0,0
1713309233510,CAT 124RS,A01,519847,Geibel; William,17,0,20,3
1713309234538,CAT 125RS,A01,515971,Geibel; William,17,0,20,3
1713309235563,CLRE 250,A00,511389,Morris; Sheldon,9996,0,9999,3
1713309236593,CLRE 251,A00,507176,Mehta; Ravindra L.,9996,0,9999,3
1713309236593,CLRE 251,B00,511410,Mehta; Ravindra L.,9998,0,9999,1
1713309237618,CLRE 252,A00,507189,Cuomo; Raphael Eduardo,9998,0,9999,1
1713309238646,CLRE 253,A00,507199,Vaida; Florin,9997,0,9999,2
1713309238646,CLRE 253,B00,507202,Vaida; Florin,9999,0,9999,0
1713309239674,CLRE 259,A00,507211,Patel; Hemal,9996,0,9999,3
1713309240704,CLRE 260,A00,507221,Cuomo; Raphael Eduardo,9999,0,9999,0
1713309241731,CLRE 297,001,507242,Cuomo; Raphael Eduardo,9999,0,9999,0
1713309242756,CSE 191,A00,516875,Minnes Kemp; Mor Mia,9999,0,9999,0
1713309243780,CSS 201S,A01,494383,Staff,35,0,35,0
1713309244805,CSS 202S,A01,494387,Staff,35,0,35,0
1713309245830,EAP 100,A00,516065,Staff,9792,0,9999,207
1713309246861,ECE 45,A01,507414,Staff,54,0,60,6
1713309247887,ECE 100,A01,507416,Baghdadchi; Saharnaz,11,0,20,9
1713309247887,ECE 100,A02,507418,Baghdadchi; Saharnaz,20,0,20,0
1713309248914,ECE 111,A01,507420,Staff,40,0,50,10
1713309249941,ECE 197,001,548057,Sievenpiper; Daniel F.,9998,0,9999,1
1713309250969,EDS 115,A00,507243,Choi; Bailey Miyeon,28,0,28,0
1713309251998,EDS 117,A01,494379,Staff,25,0,25,0
1713309253023,EDS 125,A00,507246,Hopkins; Megan Beth,29,0,30,1
1713309254059,EDS 128A,A01,507264,Fargason; Sharon Gayle,26,0,26,0
1713309255085,EDS 128B,A01,507293,Pappas; Elizabeth,30,0,30,0
1713309256111,EDS 139,A00,507294,Fargason; Sharon Gayle,30,0,30,0
1713309256111,EDS 139,B00,507313,Pappas; Elizabeth,30,0,30,0
1713309257137,EDS 201,A00,507315,Staff,26,0,30,4
1713309258169,EDS 203,A01,507317,Halter; Christopher P.,26,0,30,4
1713309259194,EDS 204R,A01,507319,Halter; Christopher P.,5,0,30,25
1713309259194,EDS 204R,B01,507331,Heinzman; Erica M.,30,0,30,0
1713309260218,EDS 206R,A00,507332,Staff,7,0,30,23
1713309260218,EDS 206R,B00,507343,Staff,29,0,30,1
1713309261242,EDS 250,A00,507344,Hemans; Patricia Ann Benitez,36,0,40,4
1713309262267,EDS 281,A00,507345,Daly; Alan J.,18,0,18,0
1713309263292,EDS 284,A00,507350,Daly; Alan J.,16,0,16,0
1713309264317,EDS 286,A00,507359,Fine; Sarah,18,0,18,0
1713309265344,EDS 289C,A01,507361,Daly; Alan J.,18,0,18,0
1713309266372,EDS 290,A00,507366,Hofstetter; Carolyn,15,0,15,0
1713309267398,LIGM 5A,A00,507421,Fischer-Grunski; Eva K,20,0,20,0
1713309268423,LIGM 5B,A00,507423,Fischer-Grunski; Eva K,20,0,20,0
1713309269447,LIGM 5C,A00,507425,Fischer-Grunski; Eva K,20,0,20,0
1713309270477,LIIT 5AS,A00,507427,Carnelos; Chiara,20,0,20,0
1713309271500,LIIT 5BS,A00,507430,Carnelos; Chiara,20,0,20,0
1713309272526,LIIT 5CS,A00,507432,Carnelos; Chiara,20,0,20,0
1713309273550,LISP 5A,A00,507541,Munoz Sanchez; Alicia,19,0,20,1
1713309274578,LISP 5B,A00,507671,Munoz Sanchez; Alicia,17,0,20,3
1713309275608,LISP 5C,A00,507696,Munoz Sanchez; Alicia,17,0,20,3
1713309276634,MAE 197,001,528363,Boechler; Nicholas Sebastia,9998,0,9999,1
1713309277660,MATH 197,001,523477,Kedlaya; Kiran S.,9999,0,9999,0
1713309277660,MATH 197,002,563811,Zhang; Danna,9999,0,9999,0
1713309278687,MCWP 40R,A00,518780,Staff,20,0,20,0
1713309278687,MCWP 40R,B00,518781,Staff,19,0,20,1
1713309278687,MCWP 40R,C00,518783,Staff,19,0,20,1
1713309279718,MCWP 50R,A00,518791,Staff,20,0,20,0
1713309279718,MCWP 50R,B00,518792,Staff,19,0,20,1
1713309279718,MCWP 50R,C00,518793,Staff,19,0,20,1
1713309279718,MCWP 50R,D00,518794,Staff,18,0,20,2
1713309279718,MCWP 50R,E00,518795,Staff,18,0,20,2
1713309279718,MCWP 50R,F00,518796,Staff,19,0,20,1
1713309279718,MCWP 50R,G00,518797,Staff,19,0,20,1
1713309280744,MMW 12R,A01,514034,Herbst; Matthew,16,0,16,0
1713309280744,MMW 12R,A02,514035,Herbst; Matthew,16,0,16,0
1713309281774,MMW 13R,A01,514037,Staff,14,0,16,2
1713309281774,MMW 13R,A02,514039,Staff,16,0,16,0
1713309283835,SIO 295LS,A00,523233,Staff,19,0,30,11
1713309284864,SIO 295S,A00,523232,Staff,19,0,30,11
1713309285888,SOCI 117,A01,494376,Staff,3,0,5,2
1713309286915,WES 237B,A00,494380,Staff,19,0,20,1
1713309288988,AESE 279B,A00,494370,Wade; Jon P,33,0,33,0
1713309290021,ANAR 135S,A00,494369,Braswell; Geoffrey E.,0,0,0,0
1713309291047,CAT 124RS,A01,519847,Geibel; William,17,0,20,3
1713309292072,CAT 125RS,A01,515971,Geibel; William,17,0,20,3
1713309293097,CLRE 250,A00,511389,Morris; Sheldon,9996,0,9999,3
1713309294128,CLRE 251,A00,507176,Mehta; Ravindra L.,9996,0,9999,3
1713309294128,CLRE 251,B00,511410,Mehta; Ravindra L.,9998,0,9999,1
1713309295154,CLRE 252,A00,507189,Cuomo; Raphael Eduardo,9998,0,9999,1
1713309296180,CLRE 253,A00,507199,Vaida; Florin,9997,0,9999,2
1713309296180,CLRE 253,B00,507202,Vaida; Florin,9999,0,9999,0
1713309297210,CLRE 259,A00,507211,Patel; Hemal,9996,0,9999,3
1713309298238,CLRE 260,A00,507221,Cuomo; Raphael Eduardo,9999,0,9999,0
1713309299262,CLRE 297,001,507242,Cuomo; Raphael Eduardo,9999,0,9999,0
1713309300287,CSE 191,A00,516875,Minnes Kemp; Mor Mia,9999,0,9999,0
1713309301315,CSS 201S,A01,494383,Staff,35,0,35,0
1713309302338,CSS 202S,A01,494387,Staff,35,0,35,0
1713309303362,EAP 100,A00,516065,Staff,9792,0,9999,207
1713309304387,ECE 45,A01,507414,Staff,54,0,60,6
1713309305413,ECE 100,A01,507416,Baghdadchi; Saharnaz,11,0,20,9
1713309305413,ECE 100,A02,507418,Baghdadchi; Saharnaz,20,0,20,0
1713309306445,ECE 111,A01,507420,Staff,40,0,50,10
1713309307480,ECE 197,001,548057,Sievenpiper; Daniel F.,9998,0,9999,1
1713309308504,EDS 115,A00,507243,Choi; Bailey Miyeon,28,0,28,0
1713309309533,EDS 117,A01,494379,Staff,25,0,25,0
1713309310557,EDS 125,A00,507246,Hopkins; Megan Beth,29,0,30,1
1713309311582,EDS 128A,A01,507264,Fargason; Sharon Gayle,26,0,26,0
1713309312610,EDS 128B,A01,507293,Pappas; Elizabeth,30,0,30,0
1713309313638,EDS 139,A00,507294,Fargason; Sharon Gayle,30,0,30,0
1713309313638,EDS 139,B00,507313,Pappas; Elizabeth,30,0,30,0
1713309314718,EDS 201,A00,507315,Staff,26,0,30,4
1713309315743,EDS 203,A01,507317,Halter; Christopher P.,26,0,30,4
1713309316768,EDS 204R,A01,507319,Halter; Christopher P.,5,0,30,25
1713309316768,EDS 204R,B01,507331,Heinzman; Erica M.,30,0,30,0
1713309317796,EDS 206R,A00,507332,Staff,7,0,30,23
1713309317796,EDS 206R,B00,507343,Staff,29,0,30,1
1713309318820,EDS 250,A00,507344,Hemans; Patricia Ann Benitez,36,0,40,4
1713309319844,EDS 281,A00,507345,Daly; Alan J.,18,0,18,0
1713309320869,EDS 284,A00,507350,Daly; Alan J.,16,0,16,0
1713309321897,EDS 286,A00,507359,Fine; Sarah,18,0,18,0
1713309322920,EDS 289C,A01,507361,Daly; Alan J.,18,0,18,0
1713309323947,EDS 290,A00,507366,Hofstetter; Carolyn,15,0,15,0
1713309324979,LIGM 5A,A00,507421,Fischer-Grunski; Eva K,20,0,20,0
1713309326005,LIGM 5B,A00,507423,Fischer-Grunski; Eva K,20,0,20,0
1713309327030,LIGM 5C,A00,507425,Fischer-Grunski; Eva K,20,0,20,0
1713309328058,LIIT 5AS,A00,507427,Carnelos; Chiara,20,0,20,0
1713309329086,LIIT 5BS,A00,507430,Carnelos; Chiara,20,0,20,0
1713309330114,LIIT 5CS,A00,507432,Carnelos; Chiara,20,0,20,0
1713309331139,LISP 5A,A00,507541,Munoz Sanchez; Alicia,19,0,20,1
1713309332167,LISP 5B,A00,507671,Munoz Sanchez; Alicia,17,0,20,3
1713309333192,LISP 5C,A00,507696,Munoz Sanchez; Alicia,17,0,20,3
1713309334217,MAE 197,001,528363,Boechler; Nicholas Sebastia,9998,0,9999,1
1713309335242,MATH 197,001,523477,Kedlaya; Kiran S.,9999,0,9999,0
1713309335242,MATH 197,002,563811,Zhang; Danna,9999,0,9999,0
1713309336264,MCWP 40R,A00,518780,Staff,20,0,20,0
1713309336264,MCWP 40R,B00,518781,Staff,19,0,20,1
1713309336264,MCWP 40R,C00,518783,Staff,19,0,20,1
1713309337294,MCWP 50R,A00,518791,Staff,20,0,20,0
1713309337294,MCWP 50R,B00,518792,Staff,19,0,20,1
1713309337294,MCWP 50R,C00,518793,Staff,19,0,20,1
1713309337294,MCWP 50R,D00,518794,Staff,18,0,20,2
1713309337294,MCWP 50R,E00,518795,Staff,18,0,20,2
1713309337294,MCWP 50R,F00,518796,Staff,19,0,20,1
1713309337294,MCWP 50R,G00,518797,Staff,19,0,20,1
1713309338320,MMW 12R,A01,514034,Herbst; Matthew,16,0,16,0
1713309338320,MMW 12R,A02,514035,Herbst; Matthew,16,0,16,0
1713309339345,MMW 13R,A01,514037,Staff,14,0,16,2
1713309339345,MMW 13R,A02,514039,Staff,16,0,16,0
1713309341398,SIO 295LS,A00,523233,Staff,19,0,30,11
1713309342423,SIO 295S,A00,523232,Staff,19,0,30,11
1713309343448,SOCI 117,A01,494376,Staff,3,0,5,2
1713309344473,WES 237B,A00,494380,Staff,19,0,20,1
1713309346548,AESE 279B,A00,494370,Wade; Jon P,33,0,33,0
1713309347579,ANAR 135S,A00,494369,Braswell; Geoffrey E.,0,0,0,0
1713309348605,CAT 124RS,A01,519847,Geibel; William,17,0,20,3
1713309349633,CAT 125RS,A01,515971,Geibel; William,17,0,20,3
1713309350662,CLRE 250,A00,511389,Morris; Sheldon,9996,0,9999,3
1713309351691,CLRE 251,A00,507176,Mehta; Ravindra L.,9996,0,9999,3
1713309351691,CLRE 251,B00,511410,Mehta; Ravindra L.,9998,0,9999,1
1713309352718,CLRE 252,A00,507189,Cuomo; Raphael Eduardo,9998,0,9999,1
1713309353744,CLRE 253,A00,507199,Vaida; Florin,9997,0,9999,2
1713309353744,CLRE 253,B00,507202,Vaida; Florin,9999,0,9999,0
1713309354770,CLRE 259,A00,507211,Patel; Hemal,9996,0,9999,3
1713309355796,CLRE 260,A00,507221,Cuomo; Raphael Eduardo,9999,0,9999,0
1713309356820,CLRE 297,001,507242,Cuomo; Raphael Eduardo,9999,0,9999,0
1713309357845,CSE 191,A00,516875,Minnes Kemp; Mor Mia,9999,0,9999,0
1713309358875,CSS 201S,A01,494383,Staff,35,0,35,0
1713309359900,CSS 202S,A01,494387,Staff,35,0,35,0
1713309360925,EAP 100,A00,516065,Staff,9792,0,9999,207
1713309361950,ECE 45,A01,507414,Staff,54,0,60,6
1713309362976,ECE 100,A01,507416,Baghdadchi; Saharnaz,11,0,20,9
1713309362976,ECE 100,A02,507418,Baghdadchi; Saharnaz,20,0,20,0
1713309364005,ECE 111,A01,507420,Staff,40,0,50,10
1713309365030,ECE 197,001,548057,Sievenpiper; Daniel F.,9998,0,9999,1
1713309366056,EDS 115,A00,507243,Choi; Bailey Miyeon,28,0,28,0
1713309367081,EDS 117,A01,494379,Staff,25,0,25,0
1713309368111,EDS 125,A00,507246,Hopkins; Megan Beth,29,0,30,1
1713309369136,EDS 128A,A01,507264,Fargason; Sharon Gayle,26,0,26,0
1713309370163,EDS 128B,A01,507293,Pappas; Elizabeth,30,0,30,0
1713309371194,EDS 139,A00,507294,Fargason; Sharon Gayle,30,0,30,0
1713309371194,EDS 139,B00,507313,Pappas; Elizabeth,30,0,30,0
1713309372219,EDS 201,A00,507315,Staff,26,0,30,4
1713309373245,EDS 203,A01,507317,Halter; Christopher P.,26,0,30,4
1713309374270,EDS 204R,A01,507319,Halter; Christopher P.,5,0,30,25
1713309374270,EDS 204R,B01,507331,Heinzman; Erica M.,30,0,30,0
1713309375294,EDS 206R,A00,507332,Staff,7,0,30,23
1713309375294,EDS 206R,B00,507343,Staff,29,0,30,1
1713309376332,EDS 250,A00,507344,Hemans; Patricia Ann Benitez,36,0,40,4
1713309377365,EDS 281,A00,507345,Daly; Alan J.,18,0,18,0
1713309378391,EDS 284,A00,507350,Daly; Alan J.,16,0,16,0
1713309379417,EDS 286,A00,507359,Fine; Sarah,18,0,18,0
1713309380445,EDS 289C,A01,507361,Daly; Alan J.,18,0,18,0
1713309381473,EDS 290,A00,507366,Hofstetter; Carolyn,15,0,15,0
1713309382502,LIGM 5A,A00,507421,Fischer-Grunski; Eva K,20,0,20,0
1713309383532,LIGM 5B,A00,507423,Fischer-Grunski; Eva K,20,0,20,0
1713309384556,LIGM 5C,A00,507425,Fischer-Grunski; Eva K,20,0,20,0
1713309385585,LIIT 5AS,A00,507427,Carnelos; Chiara,20,0,20,0
1713309386615,LIIT 5BS,A00,507430,Carnelos; Chiara,20,0,20,0
1713309387639,LIIT 5CS,A00,507432,Carnelos; Chiara,20,0,20,0
1713309388664,LISP 5A,A00,507541,Munoz Sanchez; Alicia,19,0,20,1
1713309389689,LISP 5B,A00,507671,Munoz Sanchez; Alicia,17,0,20,3
1713309390718,LISP 5C,A00,507696,Munoz Sanchez; Alicia,17,0,20,3
1713309391744,MAE 197,001,528363,Boechler; Nicholas Sebastia,9998,0,9999,1
1713309392776,MATH 197,001,523477,Kedlaya; Kiran S.,9999,0,9999,0
1713309392776,MATH 197,002,563811,Zhang; Danna,9999,0,9999,0
1713309393801,MCWP 40R,A00,518780,Staff,20,0,20,0
1713309393801,MCWP 40R,B00,518781,Staff,19,0,20,1
1713309393801,MCWP 40R,C00,518783,Staff,19,0,20,1
1713309394825,MCWP 50R,A00,518791,Staff,20,0,20,0
1713309394825,MCWP 50R,B00,518792,Staff,19,0,20,1
1713309394825,MCWP 50R,C00,518793,Staff,19,0,20,1
1713309394825,MCWP 50R,D00,518794,Staff,18,0,20,2
1713309394825,MCWP 50R,E00,518795,Staff,18,0,20,2
1713309394825,MCWP 50R,F00,518796,Staff,19,0,20,1
1713309394825,MCWP 50R,G00,518797,Staff,19,0,20,1
1713309395853,MMW 12R,A01,514034,Herbst; Matthew,16,0,16,0
1713309395853,MMW 12R,A02,514035,Herbst; Matthew,16,0,16,0
1713309396878,MMW 13R,A01,514037,Staff,14,0,16,2
1713309396878,MMW 13R,A02,514039,Staff,16,0,16,0
1713309398929,SIO 295LS,A00,523233,Staff,19,0,30,11
1713309399955,SIO 295S,A00,523232,Staff,19,0,30,11
1713309400981,SOCI 117,A01,494376,Staff,3,0,5,2
1713309402010,WES 237B,A00,494380,Staff,19,0,20,1
1713309404073,AESE 279B,A00,494370,Wade; Jon P,33,0,33,0
1713309405098,ANAR 135S,A00,494369,Braswell; Geoffrey E.,0,0,0,0
1713309406127,CAT 124RS,A01,519847,Geibel; William,17,0,20,3
1713309407155,CAT 125RS,A01,515971,Geibel; William,17,0,20,3
1713309408180,CLRE 250,A00,511389,Morris; Sheldon,9996,0,9999,3
1713309409209,CLRE 251,A00,507176,Mehta; Ravindra L.,9996,0,9999,3
1713309409209,CLRE 251,B00,511410,Mehta; Ravindra L.,9998,0,9999,1
1713309410235,CLRE 252,A00,507189,Cuomo; Raphael Eduardo,9998,0,9999,1
1713309411263,CLRE 253,A00,507199,Vaida; Florin,9997,0,9999,2
1713309411263,CLRE 253,B00,507202,Vaida; Florin,9999,0,9999,0
1713309412288,CLRE 259,A00,507211,Patel; Hemal,9996,0,9999,3
1713309413319,CLRE 260,A00,507221,Cuomo; Raphael Eduardo,9999,0,9999,0
1713309414342,CLRE 297,001,507242,Cuomo; Raphael Eduardo,9999,0,9999,0
1713309415366,CSE 191,A00,516875,Minnes Kemp; Mor Mia,9999,0,9999,0
1713309416392,CSS 201S,A01,494383,Staff,35,0,35,0
1713309417422,CSS 202S,A01,494387,Staff,35,0,35,0
1713309418504,EAP 100,A00,516065,Staff,9792,0,9999,207
1713309419530,ECE 45,A01,507414,Staff,54,0,60,6
1713309420556,ECE 100,A01,507416,Baghdadchi; Saharnaz,11,0,20,9
1713309420556,ECE 100,A02,507418,Baghdadchi; Saharnaz,20,0,20,0
1713309421581,ECE 111,A01,507420,Staff,40,0,50,10
1713309422610,ECE 197,001,548057,Sievenpiper; Daniel F.,9998,0,9999,1
1713309423637,EDS 115,A00,507243,Choi; Bailey Miyeon,28,0,28,0
1713309424661,EDS 117,A01,494379,Staff,25,0,25,0
1713309425686,EDS 125,A00,507246,Hopkins; Megan Beth,29,0,30,1
1713309426711,EDS 128A,A01,507264,Fargason; Sharon Gayle,26,0,26,0
1713309427739,EDS 128B,A01,507293,Pappas; Elizabeth,30,0,30,0
1713309428764,EDS 139,A00,507294,Fargason; Sharon Gayle,30,0,30,0
1713309428764,EDS 139,B00,507313,Pappas; Elizabeth,30,0,30,0
1713309429788,EDS 201,A00,507315,Staff,26,0,30,4
1713309430814,EDS 203,A01,507317,Halter; Christopher P.,26,0,30,4
1713309431845,EDS 204R,A01,507319,Halter; Christopher P.,5,0,30,25
1713309431845,EDS 204R,B01,507331,Heinzman; Erica M.,30,0,30,0
1713309432869,EDS 206R,A00,507332,Staff,7,0,30,23
1713309432869,EDS 206R,B00,507343,Staff,29,0,30,1
1713309433893,EDS 250,A00,507344,Hemans; Patricia Ann Benitez,36,0,40,4
1713309434920,EDS 281,A00,507345,Daly; Alan J.,18,0,18,0
1713309435944,EDS 284,A00,507350,Daly; Alan J.,16,0,16,0
1713309436968,EDS 286,A00,507359,Fine; Sarah,18,0,18,0
1713309437995,EDS 289C,A01,507361,Daly; Alan J.,18,0,18,0
1713309439022,EDS 290,A00,507366,Hofstetter; Carolyn,15,0,15,0
1713309440047,LIGM 5A,A00,507421,Fischer-Grunski; Eva K,20,0,20,0
1713309441116,LIGM 5B,A00,507423,Fischer-Grunski; Eva K,20,0,20,0
1713309442146,LIGM 5C,A00,507425,Fischer-Grunski; Eva K,20,0,20,0
1713309443176,LIIT 5AS,A00,507427,Carnelos; Chiara,20,0,20,0
1713309444207,LIIT 5BS,A00,507430,Carnelos; Chiara,20,0,20,0
1713309445233,LIIT 5CS,A00,507432,Carnelos; Chiara,20,0,20,0
1713309446259,LISP 5A,A00,507541,Munoz Sanchez; Alicia,19,0,20,1
1713309447283,LISP 5B,A00,507671,Munoz Sanchez; Alicia,17,0,20,3
1713309448310,LISP 5C,A00,507696,Munoz Sanchez; Alicia,17,0,20,3
1713309449335,MAE 197,001,528363,Boechler; Nicholas Sebastia,9998,0,9999,1
1713309450364,MATH 197,001,523477,Kedlaya; Kiran S.,9999,0,9999,0
1713309450364,MATH 197,002,563811,Zhang; Danna,9999,0,9999,0
1713309451391,MCWP 40R,A00,518780,Staff,20,0,20,0
1713309451391,MCWP 40R,B00,518781,Staff,19,0,20,1
1713309451391,MCWP 40R,C00,518783,Staff,19,0,20,1
1713309452421,MCWP 50R,A00,518791,Staff,20,0,20,0
1713309452421,MCWP 50R,B00,518792,Staff,19,0,20,1
1713309452421,MCWP 50R,C00,518793,Staff,19,0,20,1
1713309452421,MCWP 50R,D00,518794,Staff,18,0,20,2
1713309452421,MCWP 50R,E00,518795,Staff,18,0,20,2
1713309452421,MCWP 50R,F00,518796,Staff,19,0,20,1
1713309452421,MCWP 50R,G00,518797,Staff,19,0,20,1
1713309453452,MMW 12R,A01,514034,Herbst; Matthew,16,0,16,0
1713309453452,MMW 12R,A02,514035,Herbst; Matthew,16,0,16,0
1713309454476,MMW 13R,A01,514037,Staff,14,0,16,2
1713309454476,MMW 13R,A02,514039,Staff,16,0,16,0
1713309456530,SIO 295LS,A00,523233,Staff,19,0,30,11
1713309457556,SIO 295S,A00,523232,Staff,19,0,30,11
1713309458586,SOCI 117,A01,494376,Staff,3,0,5,2
1713309459610,WES 237B,A00,494380,Staff,19,0,20,1
1713309461674,AESE 279B,A00,494370,Wade; Jon P,33,0,33,0
1713309462703,ANAR 135S,A00,494369,Braswell; Geoffrey E.,0,0,0,0
1713309463729,CAT 124RS,A01,519847,Geibel; William,17,0,20,3
1713309464753,CAT 125RS,A01,515971,Geibel; William,17,0,20,3
1713309465777,CLRE 250,A00,511389,Morris; Sheldon,9996,0,9999,3
1713309466803,CLRE 251,A00,507176,Mehta; Ravindra L.,9996,0,9999,3
1713309466803,CLRE 251,B00,511410,Mehta; Ravindra L.,9998,0,9999,1
1713309467829,CLRE 252,A00,507189,Cuomo; Raphael Eduardo,9998,0,9999,1
1713309468853,CLRE 253,A00,507199,Vaida; Florin,9997,0,9999,2
1713309468853,CLRE 253,B00,507202,Vaida; Florin,9999,0,9999,0
1713309469880,CLRE 259,A00,507211,Patel; Hemal,9996,0,9999,3
1713309470907,CLRE 260,A00,507221,Cuomo; Raphael Eduardo,9999,0,9999,0
1713309471931,CLRE 297,001,507242,Cuomo; Raphael Eduardo,9999,0,9999,0
1713309472957,CSE 191,A00,516875,Minnes Kemp; Mor Mia,9999,0,9999,0
1713309473987,CSS 201S,A01,494383,Staff,35,0,35,0
1713309475017,CSS 202S,A01,494387,Staff,35,0,35,0
1713309476041,EAP 100,A00,516065,Staff,9792,0,9999,207
1713309477068,ECE 45,A01,507414,Staff,54,0,60,6
1713309478094,ECE 100,A01,507416,Baghdadchi; Saharnaz,11,0,20,9
1713309478094,ECE 100,A02,507418,Baghdadchi; Saharnaz,20,0,20,0
1713309479127,ECE 111,A01,507420,Staff,40,0,50,10
1713309480157,ECE 197,001,548057,Sievenpiper; Daniel F.,9998,0,9999,1
1713309481182,EDS 115,A00,507243,Choi; Bailey Miyeon,28,0,28,0
1713309482207,EDS 117,A01,494379,Staff,25,0,25,0
1713309483232,EDS 125,A00,507246,Hopkins; Megan Beth,29,0,30,1
1713309484258,EDS 128A,A01,507264,Fargason; Sharon Gayle,26,0,26,0
1713309485284,EDS 128B,A01,507293,Pappas; Elizabeth,30,0,30,0
1713309486311,EDS 139,A00,507294,Fargason; Sharon Gayle,30,0,30,0
1713309486311,EDS 139,B00,507313,Pappas; Elizabeth,30,0,30,0
1713309487337,EDS 201,A00,507315,Staff,26,0,30,4
1713309488365,EDS 203,A01,507317,Halter; Christopher P.,26,0,30,4
1713309489389,EDS 204R,A01,507319,Halter; Christopher P.,5,0,30,25
1713309489389,EDS 204R,B01,507331,Heinzman; Erica M.,30,0,30,0
1713309490415,EDS 206R,A00,507332,Staff,7,0,30,23
1713309490415,EDS 206R,B00,507343,Staff,29,0,30,1
1713309491442,EDS 250,A00,507344,Hemans; Patricia Ann Benitez,36,0,40,4
1713309492465,EDS 281,A00,507345,Daly; Alan J.,18,0,18,0
1713309493490,EDS 284,A00,507350,Daly; Alan J.,16,0,16,0
1713309494518,EDS 286,A00,507359,Fine; Sarah,18,0,18,0
1713309495545,EDS 289C,A01,507361,Daly; Alan J.,18,0,18,0
1713309496571,EDS 290,A00,507366,Hofstetter; Carolyn,15,0,15,0
1713309497597,LIGM 5A,A00,507421,Fischer-Grunski; Eva K,20,0,20,0
1713309498622,LIGM 5B,A00,507423,Fischer-Grunski; Eva K,20,0,20,0
1713309499648,LIGM 5C,A00,507425,Fischer-Grunski; Eva K,20,0,20,0
1713309500681,LIIT 5AS,A00,507427,Carnelos; Chiara,20,0,20,0
1713309501705,LIIT 5BS,A00,507430,Carnelos; Chiara,20,0,20,0
1713309502738,LIIT 5CS,A00,507432,Carnelos; Chiara,20,0,20,0
1713309503764,LISP 5A,A00,507541,Munoz Sanchez; Alicia,19,0,20,1
1713309504789,LISP 5B,A00,507671,Munoz Sanchez; Alicia,17,0,20,3
1713309505814,LISP 5C,A00,507696,Munoz Sanchez; Alicia,17,0,20,3
1713309506841,MAE 197,001,528363,Boechler; Nicholas Sebastia,9998,0,9999,1
1713309507867,MATH 197,001,523477,Kedlaya; Kiran S.,9999,0,9999,0
1713309507867,MATH 197,002,563811,Zhang; Danna,9999,0,9999,0
1713309508896,MCWP 40R,A00,518780,Staff,20,0,20,0
1713309508896,MCWP 40R,B00,518781,Staff,19,0,20,1
1713309508896,MCWP 40R,C00,518783,Staff,19,0,20,1
1713309509922,MCWP 50R,A00,518791,Staff,20,0,20,0
1713309509922,MCWP 50R,B00,518792,Staff,19,0,20,1
1713309509922,MCWP 50R,C00,518793,Staff,19,0,20,1
1713309509922,MCWP 50R,D00,518794,Staff,18,0,20,2
1713309509922,MCWP 50R,E00,518795,Staff,18,0,20,2
1713309509922,MCWP 50R,F00,518796,Staff,19,0,20,1
1713309509922,MCWP 50R,G00,518797,Staff,19,0,20,1
1713309510952,MMW 12R,A01,514034,Herbst; Matthew,16,0,16,0
1713309510952,MMW 12R,A02,514035,Herbst; Matthew,16,0,16,0
1713309511977,MMW 13R,A01,514037,Staff,14,0,16,2
1713309511977,MMW 13R,A02,514039,Staff,16,0,16,0
1713309514026,SIO 295LS,A00,523233,Staff,19,0,30,11
1713309515050,SIO 295S,A00,523232,Staff,19,0,30,11
1713309516076,SOCI 117,A01,494376,Staff,3,0,5,2
1713309517107,WES 237B,A00,494380,Staff,19,0,20,1
1713309519170,AESE 279B,A00,494370,Wade; Jon P,33,0,33,0
1713309520194,ANAR 135S,A00,494369,Braswell; Geoffrey E.,0,0,0,0
1713309521224,CAT 124RS,A01,519847,Geibel; William,17,0,20,3
1713309522303,CAT 125RS,A01,515971,Geibel; William,17,0,20,3
1713309523330,CLRE 250,A00,511389,Morris; Sheldon,9996,0,9999,3
1713309524357,CLRE 251,A00,507176,Mehta; Ravindra L.,9996,0,9999,3
1713309524357,CLRE 251,B00,511410,Mehta; Ravindra L.,9998,0,9999,1
1713309525383,CLRE 252,A00,507189,Cuomo; Raphael Eduardo,9998,0,9999,1
1713309526408,CLRE 253,A00,507199,Vaida; Florin,9997,0,9999,2
1713309526408,CLRE 253,B00,507202,Vaida; Florin,9999,0,9999,0
1713309527433,CLRE 259,A00,507211,Patel; Hemal,9996,0,9999,3
1713309528463,CLRE 260,A00,507221,Cuomo; Raphael Eduardo,9999,0,9999,0
1713309529489,CLRE 297,001,507242,Cuomo; Raphael Eduardo,9999,0,9999,0
1713309530516,CSE 191,A00,516875,Minnes Kemp; Mor Mia,9999,0,9999,0
1713309531542,CSS 201S,A01,494383,Staff,35,0,35,0
1713309532570,CSS 202S,A01,494387,Staff,35,0,35,0
1713309533598,EAP 100,A00,516065,Staff,9792,0,9999,207
1713309534622,ECE 45,A01,507414,Staff,54,0,60,6
1713309535647,ECE 100,A01,507416,Baghdadchi; Saharnaz,11,0,20,9
1713309535647,ECE 100,A02,507418,Baghdadchi; Saharnaz,20,0,20,0
1713309536676,ECE 111,A01,507420,Staff,40,0,50,10
1713309537704,ECE 197,001,548057,Sievenpiper; Daniel F.,9998,0,9999,1
1713309538729,EDS 115,A00,507243,Choi; Bailey Miyeon,28,0,28,0
1713309539756,EDS 117,A01,494379,Staff,25,0,25,0
1713309540781,EDS 125,A00,507246,Hopkins; Megan Beth,29,0,30,1
1713309541811,EDS 128A,A01,507264,Fargason; Sharon Gayle,26,0,26,0
1713309542837,EDS 128B,A01,507293,Pappas; Elizabeth,30,0,30,0
1713309543863,EDS 139,A00,507294,Fargason; Sharon Gayle,30,0,30,0
1713309543863,EDS 139,B00,507313,Pappas; Elizabeth,30,0,30,0
1713309544888,EDS 201,A00,507315,Staff,26,0,30,4
1713309545912,EDS 203,A01,507317,Halter; Christopher P.,26,0,30,4
1713309546943,EDS 204R,A01,507319,Halter; Christopher P.,5,0,30,25
1713309546943,EDS 204R,B01,507331,Heinzman; Erica M.,30,0,30,0
1713309547968,EDS 206R,A00,507332,Staff,7,0,30,23
1713309547968,EDS 206R,B00,507343,Staff,29,0,30,1
1713309548993,EDS 250,A00,507344,Hemans; Patricia Ann Benitez,36,0,40,4
1713309550021,EDS 281,A00,507345,Daly; Alan J.,18,0,18,0
1713309551058,EDS 284,A00,507350,Daly; Alan J.,16,0,16,0
1713309552084,EDS 286,A00,507359,Fine; Sarah,18,0,18,0
1713309553109,EDS 289C,A01,507361,Daly; Alan J.,18,0,18,0
1713309554132,EDS 290,A00,507366,Hofstetter; Carolyn,15,0,15,0
1713309555159,LIGM 5A,A00,507421,Fischer-Grunski; Eva K,20,0,20,0
1713309556184,LIGM 5B,A00,507423,Fischer-Grunski; Eva K,20,0,20,0
1713309557208,LIGM 5C,A00,507425,Fischer-Grunski; Eva K,20,0,20,0
1713309558237,LIIT 5AS,A00,507427,Carnelos; Chiara,20,0,20,0
1713309559262,LIIT 5BS,A00,507430,Carnelos; Chiara,20,0,20,0
1713309560291,LIIT 5CS,A00,507432,Carnelos; Chiara,20,0,20,0
1713309561317,LISP 5A,A00,507541,Munoz Sanchez; Alicia,19,0,20,1
1713309562346,LISP 5B,A00,507671,Munoz Sanchez; Alicia,17,0,20,3
1713309563372,LISP 5C,A00,507696,Munoz Sanchez; Alicia,17,0,20,3
1713309564398,MAE 197,001,528363,Boechler; Nicholas Sebastia,9998,0,9999,1
1713309565424,MATH 197,001,523477,Kedlaya; Kiran S.,9999,0,9999,0
1713309565424,MATH 197,002,563811,Zhang; Danna,9999,0,9999,0
1713309566448,MCWP 40R,A00,518780,Staff,20,0,20,0
1713309566448,MCWP 40R,B00,518781,Staff,19,0,20,1
1713309566448,MCWP 40R,C00,518783,Staff,19,0,20,1
1713309567473,MCWP 50R,A00,518791,Staff,20,0,20,0
1713309567473,MCWP 50R,B00,518792,Staff,19,0,20,1
1713309567473,MCWP 50R,C00,518793,Staff,19,0,20,1
1713309567473,MCWP 50R,D00,518794,Staff,18,0,20,2
1713309567473,MCWP 50R,E00,518795,Staff,18,0,20,2
1713309567473,MCWP 50R,F00,518796,Staff,19,0,20,1
1713309567473,MCWP 50R,G00,518797,Staff,19,0,20,1
1713309568497,MMW 12R,A01,514034,Herbst; Matthew,16,0,16,0
1713309568497,MMW 12R,A02,514035,Herbst; Matthew,16,0,16,0
1713309569523,MMW 13R,A01,514037,Staff,14,0,16,2
1713309569523,MMW 13R,A02,514039,Staff,16,0,16,0
1713309571571,SIO 295LS,A00,523233,Staff,19,0,30,11
1713309572598,SIO 295S,A00,523232,Staff,19,0,30,11
1713309573624,SOCI 117,A01,494376,Staff,3,0,5,2
1713309574651,WES 237B,A00,494380,Staff,19,0,20,1
1713309576720,AESE 279B,A00,494370,Wade; Jon P,33,0,33,0
1713309577745,ANAR 135S,A00,494369,Braswell; Geoffrey E.,0,0,0,0
1713309578771,CAT 124RS,A01,519847,Geibel; William,17,0,20,3
1713309579794,CAT 125RS,A01,515971,Geibel; William,17,0,20,3
1713309580820,CLRE 250,A00,511389,Morris; Sheldon,9996,0,9999,3
1713309581850,CLRE 251,A00,507176,Mehta; Ravindra L.,9996,0,9999,3
1713309581850,CLRE 251,B00,511410,Mehta; Ravindra L.,9998,0,9999,1
1713309582881,CLRE 252,A00,507189,Cuomo; Raphael Eduardo,9998,0,9999,1
1713309583907,CLRE 253,A00,507199,Vaida; Florin,9997,0,9999,2
1713309583907,CLRE 253,B00,507202,Vaida; Florin,9999,0,9999,0
1713309584936,CLRE 259,A00,507211,Patel; Hemal,9996,0,9999,3
1713309585964,CLRE 260,A00,507221,Cuomo; Raphael Eduardo,9999,0,9999,0
1713309586994,CLRE 297,001,507242,Cuomo; Raphael Eduardo,9999,0,9999,0
1713309588020,CSE 191,A00,516875,Minnes Kemp; Mor Mia,9999,0,9999,0
1713309589045,CSS 201S,A01,494383,Staff,35,0,35,0
1713309590073,CSS 202S,A01,494387,Staff,35,0,35,0
1713309591101,EAP 100,A00,516065,Staff,9792,0,9999,207
1713309592126,ECE 45,A01,507414,Staff,54,0,60,6
1713309593151,ECE 100,A01,507416,Baghdadchi; Saharnaz,11,0,20,9
1713309593151,ECE 100,A02,507418,Baghdadchi; Saharnaz,20,0,20,0
1713309594176,ECE 111,A01,507420,Staff,40,0,50,10
1713309595203,ECE 197,001,548057,Sievenpiper; Daniel F.,9998,0,9999,1
1713309596229,EDS 115,A00,507243,Choi; Bailey Miyeon,28,0,28,0
1713309597253,EDS 117,A01,494379,Staff,25,0,25,0
1713309598290,EDS 125,A00,507246,Hopkins; Megan Beth,29,0,30,1
1713309599320,EDS 128A,A01,507264,Fargason; Sharon Gayle,26,0,26,0
1713309600347,EDS 128B,A01,507293,Pappas; Elizabeth,30,0,30,0
1713309601373,EDS 139,A00,507294,Fargason; Sharon Gayle,30,0,30,0
1713309601373,EDS 139,B00,507313,Pappas; Elizabeth,30,0,30,0
1713309602398,EDS 201,A00,507315,Staff,26,0,30,4
1713309603424,EDS 203,A01,507317,Halter; Christopher P.,26,0,30,4
1713309604455,EDS 204R,A01,507319,Halter; Christopher P.,5,0,30,25
1713309604455,EDS 204R,B01,507331,Heinzman; Erica M.,30,0,30,0
1713309605481,EDS 206R,A00,507332,Staff,7,0,30,23
1713309605481,EDS 206R,B00,507343,Staff,29,0,30,1
1713309606511,EDS 250,A00,507344,Hemans; Patricia Ann Benitez,36,0,40,4
1713309607537,EDS 281,A00,507345,Daly; Alan J.,18,0,18,0
1713309608563,EDS 284,A00,507350,Daly; Alan J.,16,0,16,0
1713309609593,EDS 286,A00,507359,Fine; Sarah,18,0,18,0
1713309610617,EDS 289C,A01,507361,Daly; Alan J.,18,0,18,0
1713309611642,EDS 290,A00,507366,Hofstetter; Carolyn,15,0,15,0
1713309612670,LIGM 5A,A00,507421,Fischer-Grunski; Eva K,20,0,20,0
1713309613694,LIGM 5B,A00,507423,Fischer-Grunski; Eva K,20,0,20,0
1713309614723,LIGM 5C,A00,507425,Fischer-Grunski; Eva K,20,0,20,0
1713309615753,LIIT 5AS,A00,507427,Carnelos; Chiara,20,0,20,0
1713309616780,LIIT 5BS,A00,507430,Carnelos; Chiara,20,0,20,0
1713309617808,LIIT 5CS,A00,507432,Carnelos; Chiara,20,0,20,0
1713309618839,LISP 5A,A00,507541,Munoz Sanchez; Alicia,19,0,20,1
1713309619869,LISP 5B,A00,507671,Munoz Sanchez; Alicia,17,0,20,3
1713309620900,LISP 5C,A00,507696,Munoz Sanchez; Alicia,17,0,20,3
1713309621925,MAE 197,001,528363,Boechler; Nicholas Sebastia,9998,0,9999,1
1713309622953,MATH 197,001,523477,Kedlaya; Kiran S.,9999,0,9999,0
1713309622953,MATH 197,002,563811,Zhang; Danna,9999,0,9999,0
1713309623982,MCWP 40R,A00,518780,Staff,20,0,20,0
1713309623982,MCWP 40R,B00,518781,Staff,19,0,20,1
1713309623982,MCWP 40R,C00,518783,Staff,19,0,20,1
1713309625009,MCWP 50R,A00,518791,Staff,20,0,20,0
1713309625009,MCWP 50R,B00,518792,Staff,19,0,20,1
1713309625009,MCWP 50R,C00,518793,Staff,19,0,20,1
1713309625009,MCWP 50R,D00,518794,Staff,18,0,20,2
1713309625009,MCWP 50R,E00,518795,Staff,18,0,20,2
1713309625009,MCWP 50R,F00,518796,Staff,19,0,20,1
1713309625009,MCWP 50R,G00,518797,Staff,19,0,20,1
1713309626093,MMW 12R,A01,514034,Herbst; Matthew,16,0,16,0
1713309626093,MMW 12R,A02,514035,Herbst; Matthew,16,0,16,0
1713309627119,MMW 13R,A01,514037,Staff,14,0,16,2
1713309627119,MMW 13R,A02,514039,Staff,16,0,16,0
1713309629172,SIO 295LS,A00,523233,Staff,19,0,30,11
1713309630197,SIO 295S,A00,523232,Staff,19,0,30,11
1713309631225,SOCI 117,A01,494376,Staff,3,0,5,2
1713309632250,WES 237B,A00,494380,Staff,19,0,20,1
1713309634324,AESE 279B,A00,494370,Wade; Jon P,33,0,33,0
1713309635348,ANAR 135S,A00,494369,Braswell; Geoffrey E.,0,0,0,0
1713309636376,CAT 124RS,A01,519847,Geibel; William,17,0,20,3
1713309637406,CAT 125RS,A01,515971,Geibel; William,17,0,20,3
1713309638432,CLRE 250,A00,511389,Morris; Sheldon,9996,0,9999,3
1713309639457,CLRE 251,A00,507176,Mehta; Ravindra L.,9996,0,9999,3
1713309639457,CLRE 251,B00,511410,Mehta; Ravindra L.,9998,0,9999,1
1713309640484,CLRE 252,A00,507189,Cuomo; Raphael Eduardo,9998,0,9999,1
1713309641510,CLRE 253,A00,507199,Vaida; Florin,9997,0,9999,2
1713309641510,CLRE 253,B00,507202,Vaida; Florin,9999,0,9999,0
1713309642534,CLRE 259,A00,507211,Patel; Hemal,9996,0,9999,3
1713309643563,CLRE 260,A00,507221,Cuomo; Raphael Eduardo,9999,0,9999,0
1713309644587,CLRE 297,001,507242,Cuomo; Raphael Eduardo,9999,0,9999,0
1713309645617,CSE 191,A00,516875,Minnes Kemp; Mor Mia,9999,0,9999,0
1713309646643,CSS 201S,A01,494383,Staff,35,0,35,0
1713309647669,CSS 202S,A01,494387,Staff,35,0,35,0
1713309648694,EAP 100,A00,516065,Staff,9792,0,9999,207
1713309649719,ECE 45,A01,507414,Staff,54,0,60,6
1713309650747,ECE 100,A01,507416,Baghdadchi; Saharnaz,11,0,20,9
1713309650747,ECE 100,A02,507418,Baghdadchi; Saharnaz,20,0,20,0
1713309651776,ECE 111,A01,507420,Staff,40,0,50,10
1713309652800,ECE 197,001,548057,Sievenpiper; Daniel F.,9998,0,9999,1
1713309653826,EDS 115,A00,507243,Choi; Bailey Miyeon,28,0,28,0
1713309654853,EDS 117,A01,494379,Staff,25,0,25,0
1713309655879,EDS 125,A00,507246,Hopkins; Megan Beth,29,0,30,1
1713309656906,EDS 128A,A01,507264,Fargason; Sharon Gayle,26,0,26,0
1713309657939,EDS 128B,A01,507293,Pappas; Elizabeth,30,0,30,0
1713309658964,EDS 139,A00,507294,Fargason; Sharon Gayle,30,0,30,0
1713309658964,EDS 139,B00,507313,Pappas; Elizabeth,30,0,30,0
1713309659990,EDS 201,A00,507315,Staff,26,0,30,4
1713309661016,EDS 203,A01,507317,Halter; Christopher P.,26,0,30,4
1713309662046,EDS 204R,A01,507319,Halter; Christopher P.,5,0,30,25
1713309662046,EDS 204R,B01,507331,Heinzman; Erica M.,30,0,30,0
1713309663072,EDS 206R,A00,507332,Staff,7,0,30,23
1713309663072,EDS 206R,B00,507343,Staff,29,0,30,1
1713309664102,EDS 250,A00,507344,Hemans; Patricia Ann Benitez,36,0,40,4
1713309665129,EDS 281,A00,507345,Daly; Alan J.,18,0,18,0
1713309666154,EDS 284,A00,507350,Daly; Alan J.,16,0,16,0
1713309667182,EDS 286,A00,507359,Fine; Sarah,18,0,18,0
1713309668210,EDS 289C,A01,507361,Daly; Alan J.,18,0,18,0
1713309669234,EDS 290,A00,507366,Hofstetter; Carolyn,15,0,15,0
1713309670260,LIGM 5A,A00,507421,Fischer-Grunski; Eva K,20,0,20,0
1713309671291,LIGM 5B,A00,507423,Fischer-Grunski; Eva K,20,0,20,0
1713309672318,LIGM 5C,A00,507425,Fischer-Grunski; Eva K,20,0,20,0
1713309673343,LIIT 5AS,A00,507427,Carnelos; Chiara,20,0,20,0
1713309674368,LIIT 5BS,A00,507430,Carnelos; Chiara,20,0,20,0
1713309675397,LIIT 5CS,A00,507432,Carnelos; Chiara,20,0,20,0
1713309676421,LISP 5A,A00,507541,Munoz Sanchez; Alicia,19,0,20,1
1713309677444,LISP 5B,A00,507671,Munoz Sanchez; Alicia,17,0,20,3
1713309678468,LISP 5C,A00,507696,Munoz Sanchez; Alicia,17,0,20,3
1713309679491,MAE 197,001,528363,Boechler; Nicholas Sebastia,9998,0,9999,1
1713309680517,MATH 197,001,523477,Kedlaya; Kiran S.,9999,0,9999,0
1713309680517,MATH 197,002,563811,Zhang; Danna,9999,0,9999,0
1713309681542,MCWP 40R,A00,518780,Staff,20,0,20,0
1713309681542,MCWP 40R,B00,518781,Staff,19,0,20,1
1713309681542,MCWP 40R,C00,518783,Staff,19,0,20,1
1713309682576,MCWP 50R,A00,518791,Staff,20,0,20,0
1713309682576,MCWP 50R,B00,518792,Staff,19,0,20,1
1713309682576,MCWP 50R,C00,518793,Staff,19,0,20,1
1713309682576,MCWP 50R,D00,518794,Staff,18,0,20,2
1713309682576,MCWP 50R,E00,518795,Staff,18,0,20,2
1713309682576,MCWP 50R,F00,518796,Staff,19,0,20,1
1713309682576,MCWP 50R,G00,518797,Staff,19,0,20,1
1713309683606,MMW 12R,A01,514034,Herbst; Matthew,16,0,16,0
1713309683606,MMW 12R,A02,514035,Herbst; Matthew,16,0,16,0
1713309684631,MMW 13R,A01,514037,Staff,14,0,16,2
1713309684631,MMW 13R,A02,514039,Staff,16,0,16,0
1713309686685,SIO 295LS,A00,523233,Staff,19,0,30,11
1713309687711,SIO 295S,A00,523232,Staff,19,0,30,11
1713309688740,SOCI 117,A01,494376,Staff,3,0,5,2
1713309689770,WES 237B,A00,494380,Staff,19,0,20,1
1713309691835,AESE 279B,A00,494370,Wade; Jon P,33,0,33,0
1713309692861,ANAR 135S,A00,494369,Braswell; Geoffrey E.,0,0,0,0
1713309693894,CAT 124RS,A01,519847,Geibel; William,17,0,20,3
1713309694918,CAT 125RS,A01,515971,Geibel; William,17,0,20,3
1713309695944,CLRE 250,A00,511389,Morris; Sheldon,9996,0,9999,3
1713309696970,CLRE 251,A00,507176,Mehta; Ravindra L.,9996,0,9999,3
1713309696970,CLRE 251,B00,511410,Mehta; Ravindra L.,9998,0,9999,1
1713309697995,CLRE 252,A00,507189,Cuomo; Raphael Eduardo,9998,0,9999,1
1713309699024,CLRE 253,A00,507199,Vaida; Florin,9997,0,9999,2
1713309699024,CLRE 253,B00,507202,Vaida; Florin,9999,0,9999,0
1713309700049,CLRE 259,A00,507211,Patel; Hemal,9996,0,9999,3
1713309701077,CLRE 260,A00,507221,Cuomo; Raphael Eduardo,9999,0,9999,0
1713309702106,CLRE 297,001,507242,Cuomo; Raphael Eduardo,9999,0,9999,0
1713309703131,CSE 191,A00,516875,Minnes Kemp; Mor Mia,9999,0,9999,0
1713309704157,CSS 201S,A01,494383,Staff,35,0,35,0
1713309705185,CSS 202S,A01,494387,Staff,35,0,35,0
1713309706213,EAP 100,A00,516065,Staff,9792,0,9999,207
1713309707240,ECE 45,A01,507414,Staff,54,0,60,6
1713309708271,ECE 100,A01,507416,Baghdadchi; Saharnaz,11,0,20,9
1713309708271,ECE 100,A02,507418,Baghdadchi; Saharnaz,20,0,20,0
1713309709300,ECE 111,A01,507420,Staff,40,0,50,10
1713309710332,ECE 197,001,548057,Sievenpiper; Daniel F.,9998,0,9999,1
1713309711359,EDS 115,A00,507243,Choi; Bailey Miyeon,28,0,28,0
1713309712385,EDS 117,A01,494379,Staff,25,0,25,0
1713309713414,EDS 125,A00,507246,Hopkins; Megan Beth,29,0,30,1
1713309714441,EDS 128A,A01,507264,Fargason; Sharon Gayle,26,0,26,0
1713309715470,EDS 128B,A01,507293,Pappas; Elizabeth,30,0,30,0
1713309716496,EDS 139,A00,507294,Fargason; Sharon Gayle,30,0,30,0
1713309716496,EDS 139,B00,507313,Pappas; Elizabeth,30,0,30,0
1713309717522,EDS 201,A00,507315,Staff,26,0,30,4
1713309718552,EDS 203,A01,507317,Halter; Christopher P.,26,0,30,4
1713309719578,EDS 204R,A01,507319,Halter; Christopher P.,5,0,30,25
1713309719578,EDS 204R,B01,507331,Heinzman; Erica M.,30,0,30,0
1713309720606,EDS 206R,A00,507332,Staff,7,0,30,23
1713309720606,EDS 206R,B00,507343,Staff,29,0,30,1
1713309721630,EDS 250,A00,507344,Hemans; Patricia Ann Benitez,36,0,40,4
1713309722655,EDS 281,A00,507345,Daly; Alan J.,18,0,18,0
1713309723680,EDS 284,A00,507350,Daly; Alan J.,16,0,16,0
1713309724705,EDS 286,A00,507359,Fine; Sarah,18,0,18,0
1713309725733,EDS 289C,A01,507361,Daly; Alan J.,18,0,18,0
1713309726759,EDS 290,A00,507366,Hofstetter; Carolyn,15,0,15,0
1713309727785,LIGM 5A,A00,507421,Fischer-Grunski; Eva K,20,0,20,0
1713309728811,LIGM 5B,A00,507423,Fischer-Grunski; Eva K,20,0,20,0
1713309729895,LIGM 5C,A00,507425,Fischer-Grunski; Eva K,20,0,20,0
1713309730931,LIIT 5AS,A00,507427,Carnelos; Chiara,20,0,20,0
1713309731956,LIIT 5BS,A00,507430,Carnelos; Chiara,20,0,20,0
1713309732981,LIIT 5CS,A00,507432,Carnelos; Chiara,20,0,20,0
1713309734009,LISP 5A,A00,507541,Munoz Sanchez; Alicia,19,0,20,1
1713309735034,LISP 5B,A00,507671,Munoz Sanchez; Alicia,17,0,20,3
1713309736060,LISP 5C,A00,507696,Munoz Sanchez; Alicia,17,0,20,3
1713309737089,MAE 197,001,528363,Boechler; Nicholas Sebastia,9998,0,9999,1
1713309738116,MATH 197,001,523477,Kedlaya; Kiran S.,9999,0,9999,0
1713309738116,MATH 197,002,563811,Zhang; Danna,9999,0,9999,0
1713309739142,MCWP 40R,A00,518780,Staff,20,0,20,0
1713309739142,MCWP 40R,B00,518781,Staff,19,0,20,1
1713309739142,MCWP 40R,C00,518783,Staff,19,0,20,1
1713309740166,MCWP 50R,A00,518791,Staff,20,0,20,0
1713309740166,MCWP 50R,B00,518792,Staff,19,0,20,1
1713309740166,MCWP 50R,C00,518793,Staff,19,0,20,1
1713309740166,MCWP 50R,D00,518794,Staff,18,0,20,2
1713309740166,MCWP 50R,E00,518795,Staff,18,0,20,2
1713309740166,MCWP 50R,F00,518796,Staff,19,0,20,1
1713309740166,MCWP 50R,G00,518797,Staff,19,0,20,1
1713309741196,MMW 12R,A01,514034,Herbst; Matthew,16,0,16,0
1713309741196,MMW 12R,A02,514035,Herbst; Matthew,16,0,16,0
1713309742221,MMW 13R,A01,514037,Staff,14,0,16,2
1713309742221,MMW 13R,A02,514039,Staff,16,0,16,0
1713309744276,SIO 295LS,A00,523233,Staff,19,0,30,11
1713309745301,SIO 295S,A00,523232,Staff,19,0,30,11
1713309746326,SOCI 117,A01,494376,Staff,3,0,5,2
1713309747351,WES 237B,A00,494380,Staff,19,0,20,1
1713309749418,AESE 279B,A00,494370,Wade; Jon P,33,0,33,0
1713309750442,ANAR 135S,A00,494369,Braswell; Geoffrey E.,0,0,0,0
1713309751473,CAT 124RS,A01,519847,Geibel; William,17,0,20,3
1713309752497,CAT 125RS,A01,515971,Geibel; William,17,0,20,3
1713309753521,CLRE 250,A00,511389,Morris; Sheldon,9996,0,9999,3
1713309754549,CLRE 251,A00,507176,Mehta; Ravindra L.,9996,0,9999,3
1713309754549,CLRE 251,B00,511410,Mehta; Ravindra L.,9998,0,9999,1
1713309755579,CLRE 252,A00,507189,Cuomo; Raphael Eduardo,9998,0,9999,1
1713309756606,CLRE 253,A00,507199,Vaida; Florin,9997,0,9999,2
1713309756606,CLRE 253,B00,507202,Vaida; Florin,9999,0,9999,0
1713309757637,CLRE 259,A00,507211,Patel; Hemal,9996,0,9999,3
1713309758665,CLRE 260,A00,507221,Cuomo; Raphael Eduardo,9999,0,9999,0
1713309759697,CLRE 297,001,507242,Cuomo; Raphael Eduardo,9999,0,9999,0
1713309760723,CSE 191,A00,516875,Minnes Kemp; Mor Mia,9999,0,9999,0
1713309761755,CSS 201S,A01,494383,Staff,35,0,35,0
1713309762783,CSS 202S,A01,494387,Staff,35,0,35,0
1713309763810,EAP 100,A00,516065,Staff,9792,0,9999,207
1713309764834,ECE 45,A01,507414,Staff,54,0,60,6
1713309765862,ECE 100,A01,507416,Baghdadchi; Saharnaz,11,0,20,9
1713309765862,ECE 100,A02,507418,Baghdadchi; Saharnaz,20,0,20,0
1713309766887,ECE 111,A01,507420,Staff,40,0,50,10
1713309767912,ECE 197,001,548057,Sievenpiper; Daniel F.,9998,0,9999,1
1713309768942,EDS 115,A00,507243,Choi; Bailey Miyeon,28,0,28,0
1713309769971,EDS 117,A01,494379,Staff,25,0,25,0
1713309771002,EDS 125,A00,507246,Hopkins; Megan Beth,29,0,30,1
1713309772028,EDS 128A,A01,507264,Fargason; Sharon Gayle,26,0,26,0
1713309773054,EDS 128B,A01,507293,Pappas; Elizabeth,30,0,30,0
1713309774078,EDS 139,A00,507294,Fargason; Sharon Gayle,30,0,30,0
1713309774078,EDS 139,B00,507313,Pappas; Elizabeth,30,0,30,0
1713309775103,EDS 201,A00,507315,Staff,26,0,30,4
1713309776131,EDS 203,A01,507317,Halter; Christopher P.,26,0,30,4
1713309777158,EDS 204R,A01,507319,Halter; Christopher P.,5,0,30,25
1713309777158,EDS 204R,B01,507331,Heinzman; Erica M.,30,0,30,0
1713309778183,EDS 206R,A00,507332,Staff,7,0,30,23
1713309778183,EDS 206R,B00,507343,Staff,29,0,30,1
1713309779213,EDS 250,A00,507344,Hemans; Patricia Ann Benitez,36,0,40,4
1713309780241,EDS 281,A00,507345,Daly; Alan J.,18,0,18,0
1713309781267,EDS 284,A00,507350,Daly; Alan J.,16,0,16,0
1713309782298,EDS 286,A00,507359,Fine; Sarah,18,0,18,0
1713309783337,EDS 289C,A01,507361,Daly; Alan J.,18,0,18,0
1713309784372,EDS 290,A00,507366,Hofstetter; Carolyn,15,0,15,0
1713309785400,LIGM 5A,A00,507421,Fischer-Grunski; Eva K,20,0,20,0
1713309786424,LIGM 5B,A00,507423,Fischer-Grunski; Eva K,20,0,20,0
1713309787447,LIGM 5C,A00,507425,Fischer-Grunski; Eva K,20,0,20,0
1713309788474,LIIT 5AS,A00,507427,Carnelos; Chiara,20,0,20,0
1713309789508,LIIT 5BS,A00,507430,Carnelos; Chiara,20,0,20,0
1713309790535,LIIT 5CS,A00,507432,Carnelos; Chiara,20,0,20,0
1713309791560,LISP 5A,A00,507541,Munoz Sanchez; Alicia,19,0,20,1
1713309792588,LISP 5B,A00,507671,Munoz Sanchez; Alicia,17,0,20,3
1713309793649,LISP 5C,A00,507696,Munoz Sanchez; Alicia,17,0,20,3
1713309794674,MAE 197,001,528363,Boechler; Nicholas Sebastia,9998,0,9999,1
1713309795700,MATH 197,001,523477,Kedlaya; Kiran S.,9999,0,9999,0
1713309795700,MATH 197,002,563811,Zhang; Danna,9999,0,9999,0
1713309796726,MCWP 40R,A00,518780,Staff,20,0,20,0
1713309796726,MCWP 40R,B00,518781,Staff,19,0,20,1
1713309796726,MCWP 40R,C00,518783,Staff,19,0,20,1
1713309797750,MCWP 50R,A00,518791,Staff,20,0,20,0
1713309797750,MCWP 50R,B00,518792,Staff,19,0,20,1
1713309797750,MCWP 50R,C00,518793,Staff,19,0,20,1
1713309797750,MCWP 50R,D00,518794,Staff,18,0,20,2
1713309797750,MCWP 50R,E00,518795,Staff,18,0,20,2
1713309797750,MCWP 50R,F00,518796,Staff,19,0,20,1
1713309797750,MCWP 50R,G00,518797,Staff,19,0,20,1
1713309798777,MMW 12R,A01,514034,Herbst; Matthew,16,0,16,0
1713309798777,MMW 12R,A02,514035,Herbst; Matthew,16,0,16,0
1713309799801,MMW 13R,A01,514037,Staff,14,0,16,2
1713309799801,MMW 13R,A02,514039,Staff,16,0,16,0
1713309801858,SIO 295LS,A00,523233,Staff,19,0,30,11
1713309802884,SIO 295S,A00,523232,Staff,19,0,30,11
1713309803915,SOCI 117,A01,494376,Staff,3,0,5,2
1713309804943,WES 237B,A00,494380,Staff,19,0,20,1
1713309807017,AESE 279B,A00,494370,Wade; Jon P,33,0,33,0
1713309808040,ANAR 135S,A00,494369,Braswell; Geoffrey E.,0,0,0,0
1713309809064,CAT 124RS,A01,519847,Geibel; William,17,0,20,3
1713309810089,CAT 125RS,A01,515971,Geibel; William,17,0,20,3
1713309811114,CLRE 250,A00,511389,Morris; Sheldon,9996,0,9999,3
1713309812139,CLRE 251,A00,507176,Mehta; Ravindra L.,9996,0,9999,3
1713309812139,CLRE 251,B00,511410,Mehta; Ravindra L.,9998,0,9999,1
1713309813163,CLRE 252,A00,507189,Cuomo; Raphael Eduardo,9998,0,9999,1
1713309814192,CLRE 253,A00,507199,Vaida; Florin,9997,0,9999,2
1713309814192,CLRE 253,B00,507202,Vaida; Florin,9999,0,9999,0
1713309815217,CLRE 259,A00,507211,Patel; Hemal,9996,0,9999,3
1713309816241,CLRE 260,A00,507221,Cuomo; Raphael Eduardo,9999,0,9999,0
1713309817266,CLRE 297,001,507242,Cuomo; Raphael Eduardo,9999,0,9999,0
1713309818290,CSE 191,A00,516875,Minnes Kemp; Mor Mia,9999,0,9999,0
1713309819313,CSS 201S,A01,494383,Staff,35,0,35,0
1713309820340,CSS 202S,A01,494387,Staff,35,0,35,0
1713309821368,EAP 100,A00,516065,Staff,9792,0,9999,207
1713309822396,ECE 45,A01,507414,Staff,54,0,60,6
1713309823420,ECE 100,A01,507416,Baghdadchi; Saharnaz,11,0,20,9
1713309823420,ECE 100,A02,507418,Baghdadchi; Saharnaz,20,0,20,0
1713309824481,ECE 111,A01,507420,Staff,40,0,50,10
1713309825507,ECE 197,001,548057,Sievenpiper; Daniel F.,9998,0,9999,1
1713309826533,EDS 115,A00,507243,Choi; Bailey Miyeon,28,0,28,0
1713309827560,EDS 117,A01,494379,Staff,25,0,25,0
1713309828589,EDS 125,A00,507246,Hopkins; Megan Beth,29,0,30,1
1713309829613,EDS 128A,A01,507264,Fargason; Sharon Gayle,26,0,26,0
1713309830639,EDS 128B,A01,507293,Pappas; Elizabeth,30,0,30,0
1713309831665,EDS 139,A00,507294,Fargason; Sharon Gayle,30,0,30,0
1713309831665,EDS 139,B00,507313,Pappas; Elizabeth,30,0,30,0
1713309832689,EDS 201,A00,507315,Staff,26,0,30,4
1713309833773,EDS 203,A01,507317,Halter; Christopher P.,26,0,30,4
1713309834801,EDS 204R,A01,507319,Halter; Christopher P.,5,0,30,25
1713309834801,EDS 204R,B01,507331,Heinzman; Erica M.,30,0,30,0
1713309835825,EDS 206R,A00,507332,Staff,7,0,30,23
1713309835825,EDS 206R,B00,507343,Staff,29,0,30,1
1713309836852,EDS 250,A00,507344,Hemans; Patricia Ann Benitez,36,0,40,4
1713309837876,EDS 281,A00,507345,Daly; Alan J.,18,0,18,0
1713309838901,EDS 284,A00,507350,Daly; Alan J.,16,0,16,0
1713309839929,EDS 286,A00,507359,Fine; Sarah,18,0,18,0
1713309840954,EDS 289C,A01,507361,Daly; Alan J.,18,0,18,0
1713309841981,EDS 290,A00,507366,Hofstetter; Carolyn,15,0,15,0
1713309843008,LIGM 5A,A00,507421,Fischer-Grunski; Eva K,20,0,20,0
1713309844033,LIGM 5B,A00,507423,Fischer-Grunski; Eva K,20,0,20,0
1713309845060,LIGM 5C,A00,507425,Fischer-Grunski; Eva K,20,0,20,0
1713309846085,LIIT 5AS,A00,507427,Carnelos; Chiara,20,0,20,0
1713309847117,LIIT 5BS,A00,507430,Carnelos; Chiara,20,0,20,0
1713309848149,LIIT 5CS,A00,507432,Carnelos; Chiara,20,0,20,0
1713309849177,LISP 5A,A00,507541,Munoz Sanchez; Alicia,19,0,20,1
1713309850205,LISP 5B,A00,507671,Munoz Sanchez; Alicia,17,0,20,3
1713309851237,LISP 5C,A00,507696,Munoz Sanchez; Alicia,17,0,20,3
1713309852266,MAE 197,001,528363,Boechler; Nicholas Sebastia,9998,0,9999,1
1713309853295,MATH 197,001,523477,Kedlaya; Kiran S.,9999,0,9999,0
1713309853295,MATH 197,002,563811,Zhang; Danna,9999,0,9999,0
1713309854323,MCWP 40R,A00,518780,Staff,20,0,20,0
1713309854323,MCWP 40R,B00,518781,Staff,19,0,20,1
1713309854323,MCWP 40R,C00,518783,Staff,19,0,20,1
1713309855348,MCWP 50R,A00,518791,Staff,20,0,20,0
1713309855348,MCWP 50R,B00,518792,Staff,19,0,20,1
1713309855348,MCWP 50R,C00,518793,Staff,19,0,20,1
1713309855348,MCWP 50R,D00,518794,Staff,18,0,20,2
1713309855348,MCWP 50R,E00,518795,Staff,18,0,20,2
1713309855348,MCWP 50R,F00,518796,Staff,19,0,20,1
1713309855348,MCWP 50R,G00,518797,Staff,19,0,20,1
1713309856373,MMW 12R,A01,514034,Herbst; Matthew,16,0,16,0
1713309856373,MMW 12R,A02,514035,Herbst; Matthew,16,0,16,0
1713309857398,MMW 13R,A01,514037,Staff,14,0,16,2
1713309857398,MMW 13R,A02,514039,Staff,16,0,16,0
1713309859455,SIO 295LS,A00,523233,Staff,19,0,30,11
1713309860479,SIO 295S,A00,523232,Staff,19,0,30,11
1713309861506,SOCI 117,A01,494376,Staff,3,0,5,2
1713309862531,WES 237B,A00,494380,Staff,19,0,20,1
1713309864590,AESE 279B,A00,494370,Wade; Jon P,33,0,33,0
1713309865615,ANAR 135S,A00,494369,Braswell; Geoffrey E.,0,0,0,0
1713309866646,CAT 124RS,A01,519847,Geibel; William,17,0,20,3
1713309867670,CAT 125RS,A01,515971,Geibel; William,17,0,20,3
1713309868695,CLRE 250,A00,511389,Morris; Sheldon,9996,0,9999,3
1713309869725,CLRE 251,A00,507176,Mehta; Ravindra L.,9996,0,9999,3
1713309869725,CLRE 251,B00,511410,Mehta; Ravindra L.,9998,0,9999,1
1713309870752,CLRE 252,A00,507189,Cuomo; Raphael Eduardo,9998,0,9999,1
1713309871779,CLRE 253,A00,507199,Vaida; Florin,9997,0,9999,2
1713309871779,CLRE 253,B00,507202,Vaida; Florin,9999,0,9999,0
1713309872805,CLRE 259,A00,507211,Patel; Hemal,9996,0,9999,3
1713309873833,CLRE 260,A00,507221,Cuomo; Raphael Eduardo,9999,0,9999,0
1713309874860,CLRE 297,001,507242,Cuomo; Raphael Eduardo,9999,0,9999,0
1713309875884,CSE 191,A00,516875,Minnes Kemp; Mor Mia,9999,0,9999,0
1713309876910,CSS 201S,A01,494383,Staff,35,0,35,0
1713309877935,CSS 202S,A01,494387,Staff,35,0,35,0
1713309878959,EAP 100,A00,516065,Staff,9792,0,9999,207
1713309879986,ECE 45,A01,507414,Staff,54,0,60,6
1713309881010,ECE 100,A01,507416,Baghdadchi; Saharnaz,11,0,20,9
1713309881010,ECE 100,A02,507418,Baghdadchi; Saharnaz,20,0,20,0
1713309882036,ECE 111,A01,507420,Staff,40,0,50,10
1713309883061,ECE 197,001,548057,Sievenpiper; Daniel F.,9998,0,9999,1
1713309884090,EDS 115,A00,507243,Choi; Bailey Miyeon,28,0,28,0
1713309885115,EDS 117,A01,494379,Staff,25,0,25,0
1713309886140,EDS 125,A00,507246,Hopkins; Megan Beth,29,0,30,1
1713309887164,EDS 128A,A01,507264,Fargason; Sharon Gayle,26,0,26,0
1713309888191,EDS 128B,A01,507293,Pappas; Elizabeth,30,0,30,0
1713309889219,EDS 139,A00,507294,Fargason; Sharon Gayle,30,0,30,0
1713309889219,EDS 139,B00,507313,Pappas; Elizabeth,30,0,30,0
1713309890244,EDS 201,A00,507315,Staff,26,0,30,4
1713309891270,EDS 203,A01,507317,Halter; Christopher P.,26,0,30,4
1713309892297,EDS 204R,A01,507319,Halter; Christopher P.,5,0,30,25
1713309892297,EDS 204R,B01,507331,Heinzman; Erica M.,30,0,30,0
1713309893323,EDS 206R,A00,507332,Staff,7,0,30,23
1713309893323,EDS 206R,B00,507343,Staff,29,0,30,1
1713309894350,EDS 250,A00,507344,Hemans; Patricia Ann Benitez,36,0,40,4
1713309895378,EDS 281,A00,507345,Daly; Alan J.,18,0,18,0
1713309896404,EDS 284,A00,507350,Daly; Alan J.,16,0,16,0
1713309897430,EDS 286,A00,507359,Fine; Sarah,18,0,18,0
1713309898453,EDS 289C,A01,507361,Daly; Alan J.,18,0,18,0
1713309899482,EDS 290,A00,507366,Hofstetter; Carolyn,15,0,15,0
1713309900511,LIGM 5A,A00,507421,Fischer-Grunski; Eva K,20,0,20,0
1713309901544,LIGM 5B,A00,507423,Fischer-Grunski; Eva K,20,0,20,0
1713309902573,LIGM 5C,A00,507425,Fischer-Grunski; Eva K,20,0,20,0
1713309903597,LIIT 5AS,A00,507427,Carnelos; Chiara,20,0,20,0
1713309904622,LIIT 5BS,A00,507430,Carnelos; Chiara,20,0,20,0
1713309905647,LIIT 5CS,A00,507432,Carnelos; Chiara,20,0,20,0
1713309906674,LISP 5A,A00,507541,Munoz Sanchez; Alicia,19,0,20,1
1713309907699,LISP 5B,A00,507671,Munoz Sanchez; Alicia,17,0,20,3
1713309908725,LISP 5C,A00,507696,Munoz Sanchez; Alicia,17,0,20,3
1713309909752,MAE 197,001,528363,Boechler; Nicholas Sebastia,9998,0,9999,1
1713309910777,MATH 197,001,523477,Kedlaya; Kiran S.,9999,0,9999,0
1713309910777,MATH 197,002,563811,Zhang; Danna,9999,0,9999,0
1713309911804,MCWP 40R,A00,518780,Staff,20,0,20,0
1713309911804,MCWP 40R,B00,518781,Staff,19,0,20,1
1713309911804,MCWP 40R,C00,518783,Staff,19,0,20,1
1713309912831,MCWP 50R,A00,518791,Staff,20,0,20,0
1713309912831,MCWP 50R,B00,518792,Staff,19,0,20,1
1713309912831,MCWP 50R,C00,518793,Staff,19,0,20,1
1713309912831,MCWP 50R,D00,518794,Staff,18,0,20,2
1713309912831,MCWP 50R,E00,518795,Staff,18,0,20,2
1713309912831,MCWP 50R,F00,518796,Staff,19,0,20,1
1713309912831,MCWP 50R,G00,518797,Staff,19,0,20,1
1713309913927,MMW 12R,A01,514034,Herbst; Matthew,16,0,16,0
1713309913927,MMW 12R,A02,514035,Herbst; Matthew,16,0,16,0
1713309914954,MMW 13R,A01,514037,Staff,14,0,16,2
1713309914954,MMW 13R,A02,514039,Staff,16,0,16,0
1713309917006,SIO 295LS,A00,523233,Staff,19,0,30,11
1713309918031,SIO 295S,A00,523232,Staff,19,0,30,11
1713309919058,SOCI 117,A01,494376,Staff,3,0,5,2
1713309920088,WES 237B,A00,494380,Staff,19,0,20,1
1713309922163,AESE 279B,A00,494370,Wade; Jon P,33,0,33,0
1713309923186,ANAR 135S,A00,494369,Braswell; Geoffrey E.,0,0,0,0
1713309924216,CAT 124RS,A01,519847,Geibel; William,17,0,20,3
1713309925241,CAT 125RS,A01,515971,Geibel; William,17,0,20,3
1713309926270,CLRE 250,A00,511389,Morris; Sheldon,9996,0,9999,3
1713309927301,CLRE 251,A00,507176,Mehta; Ravindra L.,9996,0,9999,3
1713309927301,CLRE 251,B00,511410,Mehta; Ravindra L.,9998,0,9999,1
1713309928327,CLRE 252,A00,507189,Cuomo; Raphael Eduardo,9998,0,9999,1
1713309929351,CLRE 253,A00,507199,Vaida; Florin,9997,0,9999,2
1713309929351,CLRE 253,B00,507202,Vaida; Florin,9999,0,9999,0
1713309930379,CLRE 259,A00,507211,Patel; Hemal,9996,0,9999,3
1713309931405,CLRE 260,A00,507221,Cuomo; Raphael Eduardo,9999,0,9999,0
1713309932430,CLRE 297,001,507242,Cuomo; Raphael Eduardo,9999,0,9999,0
1713309933455,CSE 191,A00,516875,Minnes Kemp; Mor Mia,9999,0,9999,0
1713309934482,CSS 201S,A01,494383,Staff,35,0,35,0
1713309935512,CSS 202S,A01,494387,Staff,35,0,35,0
1713309936536,EAP 100,A00,516065,Staff,9792,0,9999,207
1713309937614,ECE 45,A01,507414,Staff,54,0,60,6
1713309938643,ECE 100,A01,507416,Baghdadchi; Saharnaz,11,0,20,9
1713309938643,ECE 100,A02,507418,Baghdadchi; Saharnaz,20,0,20,0
1713309939668,ECE 111,A01,507420,Staff,40,0,50,10
1713309940694,ECE 197,001,548057,Sievenpiper; Daniel F.,9998,0,9999,1
1713309941725,EDS 115,A00,507243,Choi; Bailey Miyeon,28,0,28,0
1713309942753,EDS 117,A01,494379,Staff,25,0,25,0
1713309943779,EDS 125,A00,507246,Hopkins; Megan Beth,29,0,30,1
1713309944806,EDS 128A,A01,507264,Fargason; Sharon Gayle,26,0,26,0
1713309945833,EDS 128B,A01,507293,Pappas; Elizabeth,30,0,30,0
1713309946858,EDS 139,A00,507294,Fargason; Sharon Gayle,30,0,30,0
1713309946858,EDS 139,B00,507313,Pappas; Elizabeth,30,0,30,0
1713309947883,EDS 201,A00,507315,Staff,26,0,30,4
1713309948908,EDS 203,A01,507317,Halter; Christopher P.,26,0,30,4
1713309949931,EDS 204R,A01,507319,Halter; Christopher P.,5,0,30,25
1713309949931,EDS 204R,B01,507331,Heinzman; Erica M.,30,0,30,0
1713309950959,EDS 206R,A00,507332,Staff,7,0,30,23
1713309950959,EDS 206R,B00,507343,Staff,29,0,30,1
1713309951989,EDS 250,A00,507344,Hemans; Patricia Ann Benitez,36,0,40,4
1713309953015,EDS 281,A00,507345,Daly; Alan J.,18,0,18,0
1713309954044,EDS 284,A00,507350,Daly; Alan J.,16,0,16,0
1713309955071,EDS 286,A00,507359,Fine; Sarah,18,0,18,0
1713309956097,EDS 289C,A01,507361,Daly; Alan J.,18,0,18,0
1713309957122,EDS 290,A00,507366,Hofstetter; Carolyn,15,0,15,0
1713309958149,LIGM 5A,A00,507421,Fischer-Grunski; Eva K,20,0,20,0
1713309959173,LIGM 5B,A00,507423,Fischer-Grunski; Eva K,20,0,20,0
1713309960198,LIGM 5C,A00,507425,Fischer-Grunski; Eva K,20,0,20,0
1713309961224,LIIT 5AS,A00,507427,Carnelos; Chiara,20,0,20,0
1713309962250,LIIT 5BS,A00,507430,Carnelos; Chiara,20,0,20,0
1713309963277,LIIT 5CS,A00,507432,Carnelos; Chiara,20,0,20,0
1713309964307,LISP 5A,A00,507541,Munoz Sanchez; Alicia,19,0,20,1
1713309965331,LISP 5B,A00,507671,Munoz Sanchez; Alicia,17,0,20,3
1713309966360,LISP 5C,A00,507696,Munoz Sanchez; Alicia,17,0,20,3
1713309967384,MAE 197,001,528363,Boechler; Nicholas Sebastia,9998,0,9999,1
1713309968411,MATH 197,001,523477,Kedlaya; Kiran S.,9999,0,9999,0
1713309968411,MATH 197,002,563811,Zhang; Danna,9999,0,9999,0
1713309969434,MCWP 40R,A00,518780,Staff,20,0,20,0
1713309969434,MCWP 40R,B00,518781,Staff,19,0,20,1
1713309969434,MCWP 40R,C00,518783,Staff,19,0,20,1
1713309970459,MCWP 50R,A00,518791,Staff,20,0,20,0
1713309970459,MCWP 50R,B00,518792,Staff,19,0,20,1
1713309970459,MCWP 50R,C00,518793,Staff,19,0,20,1
1713309970459,MCWP 50R,D00,518794,Staff,18,0,20,2
1713309970459,MCWP 50R,E00,518795,Staff,18,0,20,2
1713309970459,MCWP 50R,F00,518796,Staff,19,0,20,1
1713309970459,MCWP 50R,G00,518797,Staff,19,0,20,1
1713309971487,MMW 12R,A01,514034,Herbst; Matthew,16,0,16,0
1713309971487,MMW 12R,A02,514035,Herbst; Matthew,16,0,16,0
1713309972513,MMW 13R,A01,514037,Staff,14,0,16,2
1713309972513,MMW 13R,A02,514039,Staff,16,0,16,0
1713309974570,SIO 295LS,A00,523233,Staff,19,0,30,11
1713309975596,SIO 295S,A00,523232,Staff,19,0,30,11
1713309976624,SOCI 117,A01,494376,Staff,3,0,5,2
1713309977655,WES 237B,A00,494380,Staff,19,0,20,1
1713309979743,AESE 279B,A00,494370,Wade; Jon P,33,0,33,0
1713309980769,ANAR 135S,A00,494369,Braswell; Geoffrey E.,0,0,0,0
1713309981799,CAT 124RS,A01,519847,Geibel; William,17,0,20,3
1713309982833,CAT 125RS,A01,515971,Geibel; William,17,0,20,3
1713309983857,CLRE 250,A00,511389,Morris; Sheldon,9996,0,9999,3
1713309984890,CLRE 251,A00,507176,Mehta; Ravindra L.,9996,0,9999,3
1713309984890,CLRE 251,B00,511410,Mehta; Ravindra L.,9998,0,9999,1
1713309985917,CLRE 252,A00,507189,Cuomo; Raphael Eduardo,9998,0,9999,1
1713309986949,CLRE 253,A00,507199,Vaida; Florin,9997,0,9999,2
1713309986949,CLRE 253,B00,507202,Vaida; Florin,9999,0,9999,0
1713309987974,CLRE 259,A00,507211,Patel; Hemal,9996,0,9999,3
1713309989000,CLRE 260,A00,507221,Cuomo; Raphael Eduardo,9999,0,9999,0
1713309990025,CLRE 297,001,507242,Cuomo; Raphael Eduardo,9999,0,9999,0
1713309991053,CSE 191,A00,516875,Minnes Kemp; Mor Mia,9999,0,9999,0
1713309992078,CSS 201S,A01,494383,Staff,35,0,35,0
1713309993107,CSS 202S,A01,494387,Staff,35,0,35,0
1713309994134,EAP 100,A00,516065,Staff,9792,0,9999,207
1713309995163,ECE 45,A01,507414,Staff,54,0,60,6
1713309996187,ECE 100,A01,507416,Baghdadchi; Saharnaz,11,0,20,9
1713309996187,ECE 100,A02,507418,Baghdadchi; Saharnaz,20,0,20,0
1713309997214,ECE 111,A01,507420,Staff,40,0,50,10
1713309998239,ECE 197,001,548057,Sievenpiper; Daniel F.,9998,0,9999,1
1713309999269,EDS 115,A00,507243,Choi; Bailey Miyeon,28,0,28,0
1713310000298,EDS 117,A01,494379,Staff,25,0,25,0
1713310001428,EDS 125,A00,507246,Hopkins; Megan Beth,29,0,30,1
1713310002452,EDS 128A,A01,507264,Fargason; Sharon Gayle,26,0,26,0
1713310003480,EDS 128B,A01,507293,Pappas; Elizabeth,30,0,30,0
1713310004506,EDS 139,A00,507294,Fargason; Sharon Gayle,30,0,30,0
1713310004506,EDS 139,B00,507313,Pappas; Elizabeth,30,0,30,0
1713310005533,EDS 201,A00,507315,Staff,26,0,30,4
1713310006559,EDS 203,A01,507317,Halter; Christopher P.,26,0,30,4
1713310007588,EDS 204R,A01,507319,Halter; Christopher P.,5,0,30,25
1713310007588,EDS 204R,B01,507331,Heinzman; Erica M.,30,0,30,0
1713310008620,EDS 206R,A00,507332,Staff,7,0,30,23
1713310008620,EDS 206R,B00,507343,Staff,29,0,30,1
1713310009650,EDS 250,A00,507344,Hemans; Patricia Ann Benitez,36,0,40,4
1713310010680,EDS 281,A00,507345,Daly; Alan J.,18,0,18,0
1713310011704,EDS 284,A00,507350,Daly; Alan J.,16,0,16,0
1713310012732,EDS 286,A00,507359,Fine; Sarah,18,0,18,0
1713310013760,EDS 289C,A01,507361,Daly; Alan J.,18,0,18,0
1713310014787,EDS 290,A00,507366,Hofstetter; Carolyn,15,0,15,0
1713310015814,LIGM 5A,A00,507421,Fischer-Grunski; Eva K,20,0,20,0
1713310016842,LIGM 5B,A00,507423,Fischer-Grunski; Eva K,20,0,20,0
1713310017870,LIGM 5C,A00,507425,Fischer-Grunski; Eva K,20,0,20,0
1713310018897,LIIT 5AS,A00,507427,Carnelos; Chiara,20,0,20,0
1713310019922,LIIT 5BS,A00,507430,Carnelos; Chiara,20,0,20,0
1713310020947,LIIT 5CS,A00,507432,Carnelos; Chiara,20,0,20,0
1713310021978,LISP 5A,A00,507541,Munoz Sanchez; Alicia,19,0,20,1
1713310023007,LISP 5B,A00,507671,Munoz Sanchez; Alicia,17,0,20,3
1713310024034,LISP 5C,A00,507696,Munoz Sanchez; Alicia,17,0,20,3
1713310025063,MAE 197,001,528363,Boechler; Nicholas Sebastia,9998,0,9999,1
1713310026089,MATH 197,001,523477,Kedlaya; Kiran S.,9999,0,9999,0
1713310026089,MATH 197,002,563811,Zhang; Danna,9999,0,9999,0
1713310027118,MCWP 40R,A00,518780,Staff,20,0,20,0
1713310027118,MCWP 40R,B00,518781,Staff,19,0,20,1
1713310027118,MCWP 40R,C00,518783,Staff,19,0,20,1
1713310028150,MCWP 50R,A00,518791,Staff,20,0,20,0
1713310028150,MCWP 50R,B00,518792,Staff,19,0,20,1
1713310028150,MCWP 50R,C00,518793,Staff,19,0,20,1
1713310028150,MCWP 50R,D00,518794,Staff,18,0,20,2
1713310028150,MCWP 50R,E00,518795,Staff,18,0,20,2
1713310028150,MCWP 50R,F00,518796,Staff,19,0,20,1
1713310028150,MCWP 50R,G00,518797,Staff,19,0,20,1
1713310029173,MMW 12R,A01,514034,Herbst; Matthew,16,0,16,0
1713310029173,MMW 12R,A02,514035,Herbst; Matthew,16,0,16,0
1713310030201,MMW 13R,A01,514037,Staff,14,0,16,2
1713310030201,MMW 13R,A02,514039,Staff,16,0,16,0
1713310032257,SIO 295LS,A00,523233,Staff,19,0,30,11
1713310033284,SIO 295S,A00,523232,Staff,19,0,30,11
1713310034309,SOCI 117,A01,494376,Staff,3,0,5,2
1713310035334,WES 237B,A00,494380,Staff,19,0,20,1
1713310037394,AESE 279B,A00,494370,Wade; Jon P,33,0,33,0
1713310038419,ANAR 135S,A00,494369,Braswell; Geoffrey E.,0,0,0,0
1713310039445,CAT 124RS,A01,519847,Geibel; William,17,0,20,3
1713310040473,CAT 125RS,A01,515971,Geibel; William,17,0,20,3
1713310041558,CLRE 250,A00,511389,Morris; Sheldon,9996,0,9999,3
1713310042586,CLRE 251,A00,507176,Mehta; Ravindra L.,9996,0,9999,3
1713310042586,CLRE 251,B00,511410,Mehta; Ravindra L.,9998,0,9999,1
1713310043614,CLRE 252,A00,507189,Cuomo; Raphael Eduardo,9998,0,9999,1
1713310044644,CLRE 253,A00,507199,Vaida; Florin,9997,0,9999,2
1713310044644,CLRE 253,B00,507202,Vaida; Florin,9999,0,9999,0
1713310045669,CLRE 259,A00,507211,Patel; Hemal,9996,0,9999,3
1713310046695,CLRE 260,A00,507221,Cuomo; Raphael Eduardo,9999,0,9999,0
1713310047721,CLRE 297,001,507242,Cuomo; Raphael Eduardo,9999,0,9999,0
1713310048750,CSE 191,A00,516875,Minnes Kemp; Mor Mia,9999,0,9999,0
1713310049775,CSS 201S,A01,494383,Staff,35,0,35,0
1713310050802,CSS 202S,A01,494387,Staff,35,0,35,0
1713310051830,EAP 100,A00,516065,Staff,9792,0,9999,207
1713310052854,ECE 45,A01,507414,Staff,54,0,60,6
1713310053884,ECE 100,A01,507416,Baghdadchi; Saharnaz,11,0,20,9
1713310053884,ECE 100,A02,507418,Baghdadchi; Saharnaz,20,0,20,0
1713310054911,ECE 111,A01,507420,Staff,40,0,50,10
1713310055936,ECE 197,001,548057,Sievenpiper; Daniel F.,9998,0,9999,1
1713310056968,EDS 115,A00,507243,Choi; Bailey Miyeon,28,0,28,0
1713310057992,EDS 117,A01,494379,Staff,25,0,25,0
1713310059016,EDS 125,A00,507246,Hopkins; Megan Beth,29,0,30,1
1713310060041,EDS 128A,A01,507264,Fargason; Sharon Gayle,26,0,26,0
1713310061067,EDS 128B,A01,507293,Pappas; Elizabeth,30,0,30,0
1713310062095,EDS 139,A00,507294,Fargason; Sharon Gayle,30,0,30,0
1713310062095,EDS 139,B00,507313,Pappas; Elizabeth,30,0,30,0
1713310063120,EDS 201,A00,507315,Staff,26,0,30,4
1713310064148,EDS 203,A01,507317,Halter; Christopher P.,26,0,30,4
1713310065172,EDS 204R,A01,507319,Halter; Christopher P.,5,0,30,25
1713310065172,EDS 204R,B01,507331,Heinzman; Erica M.,30,0,30,0
1713310066199,EDS 206R,A00,507332,Staff,7,0,30,23
1713310066199,EDS 206R,B00,507343,Staff,29,0,30,1
1713310067228,EDS 250,A00,507344,Hemans; Patricia Ann Benitez,36,0,40,4
1713310068253,EDS 281,A00,507345,Daly; Alan J.,18,0,18,0
1713310069278,EDS 284,A00,507350,Daly; Alan J.,16,0,16,0
1713310070304,EDS 286,A00,507359,Fine; Sarah,18,0,18,0
1713310071328,EDS 289C,A01,507361,Daly; Alan J.,18,0,18,0
1713310072352,EDS 290,A00,507366,Hofstetter; Carolyn,15,0,15,0
1713310073382,LIGM 5A,A00,507421,Fischer-Grunski; Eva K,20,0,20,0
1713310074407,LIGM 5B,A00,507423,Fischer-Grunski; Eva K,20,0,20,0
1713310075435,LIGM 5C,A00,507425,Fischer-Grunski; Eva K,20,0,20,0
1713310076464,LIIT 5AS,A00,507427,Carnelos; Chiara,20,0,20,0
1713310077490,LIIT 5BS,A00,507430,Carnelos; Chiara,20,0,20,0
1713310078515,LIIT 5CS,A00,507432,Carnelos; Chiara,20,0,20,0
1713310079541,LISP 5A,A00,507541,Munoz Sanchez; Alicia,19,0,20,1
1713310080571,LISP 5B,A00,507671,Munoz Sanchez; Alicia,17,0,20,3
1713310081596,LISP 5C,A00,507696,Munoz Sanchez; Alicia,17,0,20,3
1713310082624,MAE 197,001,528363,Boechler; Nicholas Sebastia,9998,0,9999,1
1713310083651,MATH 197,001,523477,Kedlaya; Kiran S.,9999,0,9999,0
1713310083651,MATH 197,002,563811,Zhang; Danna,9999,0,9999,0
1713310084675,MCWP 40R,A00,518780,Staff,20,0,20,0
1713310084675,MCWP 40R,B00,518781,Staff,19,0,20,1
1713310084675,MCWP 40R,C00,518783,Staff,19,0,20,1
1713310085702,MCWP 50R,A00,518791,Staff,20,0,20,0
1713310085702,MCWP 50R,B00,518792,Staff,19,0,20,1
1713310085702,MCWP 50R,C00,518793,Staff,19,0,20,1
1713310085702,MCWP 50R,D00,518794,Staff,18,0,20,2
1713310085702,MCWP 50R,E00,518795,Staff,18,0,20,2
1713310085702,MCWP 50R,F00,518796,Staff,19,0,20,1
1713310085702,MCWP 50R,G00,518797,Staff,19,0,20,1
1713310086727,MMW 12R,A01,514034,Herbst; Matthew,16,0,16,0
1713310086727,MMW 12R,A02,514035,Herbst; Matthew,16,0,16,0
1713310087756,MMW 13R,A01,514037,Staff,14,0,16,2
1713310087756,MMW 13R,A02,514039,Staff,16,0,16,0
1713310089808,SIO 295LS,A00,523233,Staff,19,0,30,11
1713310090834,SIO 295S,A00,523232,Staff,19,0,30,11
1713310091859,SOCI 117,A01,494376,Staff,3,0,5,2
1713310092887,WES 237B,A00,494380,Staff,19,0,20,1
1713310094952,AESE 279B,A00,494370,Wade; Jon P,33,0,33,0
1713310095980,ANAR 135S,A00,494369,Braswell; Geoffrey E.,0,0,0,0
1713310097005,CAT 124RS,A01,519847,Geibel; William,17,0,20,3
1713310098030,CAT 125RS,A01,515971,Geibel; William,17,0,20,3
1713310099056,CLRE 250,A00,511389,Morris; Sheldon,9996,0,9999,3
1713310100087,CLRE 251,A00,507176,Mehta; Ravindra L.,9996,0,9999,3
1713310100087,CLRE 251,B00,511410,Mehta; Ravindra L.,9998,0,9999,1
1713310101115,CLRE 252,A00,507189,Cuomo; Raphael Eduardo,9998,0,9999,1
1713310102145,CLRE 253,A00,507199,Vaida; Florin,9997,0,9999,2
1713310102145,CLRE 253,B00,507202,Vaida; Florin,9999,0,9999,0
1713310103169,CLRE 259,A00,507211,Patel; Hemal,9996,0,9999,3
1713310104192,CLRE 260,A00,507221,Cuomo; Raphael Eduardo,9999,0,9999,0
1713310105220,CLRE 297,001,507242,Cuomo; Raphael Eduardo,9999,0,9999,0
1713310106257,CSE 191,A00,516875,Minnes Kemp; Mor Mia,9999,0,9999,0
1713310107286,CSS 201S,A01,494383,Staff,35,0,35,0
1713310108317,CSS 202S,A01,494387,Staff,35,0,35,0
1713310109343,EAP 100,A00,516065,Staff,9792,0,9999,207
1713310110373,ECE 45,A01,507414,Staff,54,0,60,6
1713310111400,ECE 100,A01,507416,Baghdadchi; Saharnaz,11,0,20,9
1713310111400,ECE 100,A02,507418,Baghdadchi; Saharnaz,20,0,20,0
1713310112425,ECE 111,A01,507420,Staff,40,0,50,10
1713310113454,ECE 197,001,548057,Sievenpiper; Daniel F.,9998,0,9999,1
1713310114480,EDS 115,A00,507243,Choi; Bailey Miyeon,28,0,28,0
1713310115509,EDS 117,A01,494379,Staff,25,0,25,0
1713310116533,EDS 125,A00,507246,Hopkins; Megan Beth,29,0,30,1
1713310117560,EDS 128A,A01,507264,Fargason; Sharon Gayle,26,0,26,0
1713310118590,EDS 128B,A01,507293,Pappas; Elizabeth,30,0,30,0
1713310119616,EDS 139,A00,507294,Fargason; Sharon Gayle,30,0,30,0
1713310119616,EDS 139,B00,507313,Pappas; Elizabeth,30,0,30,0
1713310120643,EDS 201,A00,507315,Staff,26,0,30,4
1713310121667,EDS 203,A01,507317,Halter; Christopher P.,26,0,30,4
1713310122693,EDS 204R,A01,507319,Halter; Christopher P.,5,0,30,25
1713310122693,EDS 204R,B01,507331,Heinzman; Erica M.,30,0,30,0
1713310123719,EDS 206R,A00,507332,Staff,7,0,30,23
1713310123719,EDS 206R,B00,507343,Staff,29,0,30,1
1713310124746,EDS 250,A00,507344,Hemans; Patricia Ann Benitez,36,0,40,4
1713310125772,EDS 281,A00,507345,Daly; Alan J.,18,0,18,0
1713310126796,EDS 284,A00,507350,Daly; Alan J.,16,0,16,0
1713310127821,EDS 286,A00,507359,Fine; Sarah,18,0,18,0
1713310128846,EDS 289C,A01,507361,Daly; Alan J.,18,0,18,0
1713310129871,EDS 290,A00,507366,Hofstetter; Carolyn,15,0,15,0
1713310130896,LIGM 5A,A00,507421,Fischer-Grunski; Eva K,20,0,20,0
1713310131920,LIGM 5B,A00,507423,Fischer-Grunski; Eva K,20,0,20,0
1713310132944,LIGM 5C,A00,507425,Fischer-Grunski; Eva K,20,0,20,0
1713310133973,LIIT 5AS,A00,507427,Carnelos; Chiara,20,0,20,0
1713310135002,LIIT 5BS,A00,507430,Carnelos; Chiara,20,0,20,0
1713310136027,LIIT 5CS,A00,507432,Carnelos; Chiara,20,0,20,0
1713310137053,LISP 5A,A00,507541,Munoz Sanchez; Alicia,19,0,20,1
1713310138078,LISP 5B,A00,507671,Munoz Sanchez; Alicia,17,0,20,3
1713310139105,LISP 5C,A00,507696,Munoz Sanchez; Alicia,17,0,20,3
1713310140132,MAE 197,001,528363,Boechler; Nicholas Sebastia,9998,0,9999,1
1713310141159,MATH 197,001,523477,Kedlaya; Kiran S.,9999,0,9999,0
1713310141159,MATH 197,002,563811,Zhang; Danna,9999,0,9999,0
1713310142185,MCWP 40R,A00,518780,Staff,20,0,20,0
1713310142185,MCWP 40R,B00,518781,Staff,19,0,20,1
1713310142185,MCWP 40R,C00,518783,Staff,19,0,20,1
1713310143219,MCWP 50R,A00,518791,Staff,20,0,20,0
1713310143219,MCWP 50R,B00,518792,Staff,19,0,20,1
1713310143219,MCWP 50R,C00,518793,Staff,19,0,20,1
1713310143219,MCWP 50R,D00,518794,Staff,18,0,20,2
1713310143219,MCWP 50R,E00,518795,Staff,18,0,20,2
1713310143219,MCWP 50R,F00,518796,Staff,19,0,20,1
1713310143219,MCWP 50R,G00,518797,Staff,19,0,20,1
1713310144245,MMW 12R,A01,514034,Herbst; Matthew,16,0,16,0
1713310144245,MMW 12R,A02,514035,Herbst; Matthew,16,0,16,0
1713310145324,MMW 13R,A01,514037,Staff,14,0,16,2
1713310145324,MMW 13R,A02,514039,Staff,16,0,16,0
1713310147379,SIO 295LS,A00,523233,Staff,19,0,30,11
1713310148407,SIO 295S,A00,523232,Staff,19,0,30,11
1713310149433,SOCI 117,A01,494376,Staff,3,0,5,2
1713310150461,WES 237B,A00,494380,Staff,19,0,20,1
1713310152528,AESE 279B,A00,494370,Wade; Jon P,33,0,33,0
1713310153554,ANAR 135S,A00,494369,Braswell; Geoffrey E.,0,0,0,0
1713310154584,CAT 124RS,A01,519847,Geibel; William,17,0,20,3
1713310155609,CAT 125RS,A01,515971,Geibel; William,17,0,20,3
1713310156635,CLRE 250,A00,511389,Morris; Sheldon,9996,0,9999,3
1713310157661,CLRE 251,A00,507176,Mehta; Ravindra L.,9996,0,9999,3
1713310157661,CLRE 251,B00,511410,Mehta; Ravindra L.,9998,0,9999,1
1713310158687,CLRE 252,A00,507189,Cuomo; Raphael Eduardo,9998,0,9999,1
1713310159713,CLRE 253,A00,507199,Vaida; Florin,9997,0,9999,2
1713310159713,CLRE 253,B00,507202,Vaida; Florin,9999,0,9999,0
1713310160739,CLRE 259,A00,507211,Patel; Hemal,9996,0,9999,3
1713310161767,CLRE 260,A00,507221,Cuomo; Raphael Eduardo,9999,0,9999,0
1713310162792,CLRE 297,001,507242,Cuomo; Raphael Eduardo,9999,0,9999,0
1713310163819,CSE 191,A00,516875,Minnes Kemp; Mor Mia,9999,0,9999,0
1713310164846,CSS 201S,A01,494383,Staff,35,0,35,0
1713310165876,CSS 202S,A01,494387,Staff,35,0,35,0
1713310166901,EAP 100,A00,516065,Staff,9792,0,9999,207
1713310167927,ECE 45,A01,507414,Staff,54,0,60,6
1713310168952,ECE 100,A01,507416,Baghdadchi; Saharnaz,11,0,20,9
1713310168952,ECE 100,A02,507418,Baghdadchi; Saharnaz,20,0,20,0
1713310169980,ECE 111,A01,507420,Staff,40,0,50,10
1713310171007,ECE 197,001,548057,Sievenpiper; Daniel F.,9998,0,9999,1
1713310172031,EDS 115,A00,507243,Choi; Bailey Miyeon,28,0,28,0
1713310173057,EDS 117,A01,494379,Staff,25,0,25,0
1713310174085,EDS 125,A00,507246,Hopkins; Megan Beth,29,0,30,1
1713310175117,EDS 128A,A01,507264,Fargason; Sharon Gayle,26,0,26,0
1713310176142,EDS 128B,A01,507293,Pappas; Elizabeth,30,0,30,0
1713310177168,EDS 139,A00,507294,Fargason; Sharon Gayle,30,0,30,0
1713310177168,EDS 139,B00,507313,Pappas; Elizabeth,30,0,30,0
1713310178197,EDS 201,A00,507315,Staff,26,0,30,4
1713310179226,EDS 203,A01,507317,Halter; Christopher P.,26,0,30,4
1713310180258,EDS 204R,A01,507319,Halter; Christopher P.,5,0,30,25
1713310180258,EDS 204R,B01,507331,Heinzman; Erica M.,30,0,30,0
1713310181288,EDS 206R,A00,507332,Staff,7,0,30,23
1713310181288,EDS 206R,B00,507343,Staff,29,0,30,1
1713310182312,EDS 250,A00,507344,Hemans; Patricia Ann Benitez,36,0,40,4
1713310183339,EDS 281,A00,507345,Daly; Alan J.,18,0,18,0
1713310184363,EDS 284,A00,507350,Daly; Alan J.,16,0,16,0
1713310185392,EDS 286,A00,507359,Fine; Sarah,18,0,18,0
1713310186420,EDS 289C,A01,507361,Daly; Alan J.,18,0,18,0
1713310187445,EDS 290,A00,507366,Hofstetter; Carolyn,15,0,15,0
1713310188476,LIGM 5A,A00,507421,Fischer-Grunski; Eva K,20,0,20,0
1713310189504,LIGM 5B,A00,507423,Fischer-Grunski; Eva K,20,0,20,0
1713310190530,LIGM 5C,A00,507425,Fischer-Grunski; Eva K,20,0,20,0
1713310191556,LIIT 5AS,A00,507427,Carnelos; Chiara,20,0,20,0
1713310192580,LIIT 5BS,A00,507430,Carnelos; Chiara,20,0,20,0
1713310193606,LIIT 5CS,A00,507432,Carnelos; Chiara,20,0,20,0
1713310194632,LISP 5A,A00,507541,Munoz Sanchez; Alicia,19,0,20,1
1713310195661,LISP 5B,A00,507671,Munoz Sanchez; Alicia,17,0,20,3
1713310196691,LISP 5C,A00,507696,Munoz Sanchez; Alicia,17,0,20,3
1713310197719,MAE 197,001,528363,Boechler; Nicholas Sebastia,9998,0,9999,1
1713310198750,MATH 197,001,523477,Kedlaya; Kiran S.,9999,0,9999,0
1713310198750,MATH 197,002,563811,Zhang; Danna,9999,0,9999,0
1713310199780,MCWP 40R,A00,518780,Staff,20,0,20,0
1713310199780,MCWP 40R,B00,518781,Staff,19,0,20,1
1713310199780,MCWP 40R,C00,518783,Staff,19,0,20,1
1713310200812,MCWP 50R,A00,518791,Staff,20,0,20,0
1713310200812,MCWP 50R,B00,518792,Staff,19,0,20,1
1713310200812,MCWP 50R,C00,518793,Staff,19,0,20,1
1713310200812,MCWP 50R,D00,518794,Staff,18,0,20,2
1713310200812,MCWP 50R,E00,518795,Staff,18,0,20,2
1713310200812,MCWP 50R,F00,518796,Staff,19,0,20,1
1713310200812,MCWP 50R,G00,518797,Staff,19,0,20,1
1713310201844,MMW 12R,A01,514034,Herbst; Matthew,16,0,16,0
1713310201844,MMW 12R,A02,514035,Herbst; Matthew,16,0,16,0
1713310202871,MMW 13R,A01,514037,Staff,14,0,16,2
1713310202871,MMW 13R,A02,514039,Staff,16,0,16,0
1713310204930,SIO 295LS,A00,523233,Staff,19,0,30,11
1713310205957,SIO 295S,A00,523232,Staff,19,0,30,11
1713310206984,SOCI 117,A01,494376,Staff,3,0,5,2
1713310208012,WES 237B,A00,494380,Staff,19,0,20,1
1713310210104,AESE 279B,A00,494370,Wade; Jon P,33,0,33,0
1713310211130,ANAR 135S,A00,494369,Braswell; Geoffrey E.,0,0,0,0
1713310212156,CAT 124RS,A01,519847,Geibel; William,17,0,20,3
1713310213183,CAT 125RS,A01,515971,Geibel; William,17,0,20,3
1713310214208,CLRE 250,A00,511389,Morris; Sheldon,9996,0,9999,3
1713310215235,CLRE 251,A00,507176,Mehta; Ravindra L.,9996,0,9999,3
1713310215235,CLRE 251,B00,511410,Mehta; Ravindra L.,9998,0,9999,1
1713310216265,CLRE 252,A00,507189,Cuomo; Raphael Eduardo,9998,0,9999,1
1713310217295,CLRE 253,A00,507199,Vaida; Florin,9997,0,9999,2
1713310217295,CLRE 253,B00,507202,Vaida; Florin,9999,0,9999,0
1713310218320,CLRE 259,A00,507211,Patel; Hemal,9996,0,9999,3
1713310219349,CLRE 260,A00,507221,Cuomo; Raphael Eduardo,9999,0,9999,0
1713310220375,CLRE 297,001,507242,Cuomo; Raphael Eduardo,9999,0,9999,0
1713310221403,CSE 191,A00,516875,Minnes Kemp; Mor Mia,9999,0,9999,0
1713310222429,CSS 201S,A01,494383,Staff,35,0,35,0
1713310233349,CSS 202S,A01,494387,Staff,35,0,35,0
1713310234376,EAP 100,A00,516065,Staff,9792,0,9999,207
1713310235401,ECE 45,A01,507414,Staff,54,0,60,6
1713310236432,ECE 100,A01,507416,Baghdadchi; Saharnaz,11,0,20,9
1713310236432,ECE 100,A02,507418,Baghdadchi; Saharnaz,20,0,20,0
1713310237459,ECE 111,A01,507420,Staff,40,0,50,10
1713310238490,ECE 197,001,548057,Sievenpiper; Daniel F.,9998,0,9999,1
1713310239521,EDS 115,A00,507243,Choi; Bailey Miyeon,28,0,28,0
1713310240547,EDS 117,A01,494379,Staff,25,0,25,0
1713310241573,EDS 125,A00,507246,Hopkins; Megan Beth,29,0,30,1
1713310242601,EDS 128A,A01,507264,Fargason; Sharon Gayle,26,0,26,0
1713310243626,EDS 128B,A01,507293,Pappas; Elizabeth,30,0,30,0
1713310244656,EDS 139,A00,507294,Fargason; Sharon Gayle,30,0,30,0
1713310244656,EDS 139,B00,507313,Pappas; Elizabeth,30,0,30,0
1713310245685,EDS 201,A00,507315,Staff,26,0,30,4
1713310246717,EDS 203,A01,507317,Halter; Christopher P.,26,0,30,4
1713310247742,EDS 204R,A01,507319,Halter; Christopher P.,5,0,30,25
1713310247742,EDS 204R,B01,507331,Heinzman; Erica M.,30,0,30,0
1713310248771,EDS 206R,A00,507332,Staff,7,0,30,23
1713310248771,EDS 206R,B00,507343,Staff,29,0,30,1
1713310249798,EDS 250,A00,507344,Hemans; Patricia Ann Benitez,36,0,40,4
1713310250823,EDS 281,A00,507345,Daly; Alan J.,18,0,18,0
1713310251846,EDS 284,A00,507350,Daly; Alan J.,16,0,16,0
1713310252873,EDS 286,A00,507359,Fine; Sarah,18,0,18,0
1713310253898,EDS 289C,A01,507361,Daly; Alan J.,18,0,18,0
1713310254924,EDS 290,A00,507366,Hofstetter; Carolyn,15,0,15,0
1713310255953,LIGM 5A,A00,507421,Fischer-Grunski; Eva K,20,0,20,0
1713310256983,LIGM 5B,A00,507423,Fischer-Grunski; Eva K,20,0,20,0
1713310258008,LIGM 5C,A00,507425,Fischer-Grunski; Eva K,20,0,20,0
1713310259087,LIIT 5AS,A00,507427,Carnelos; Chiara,20,0,20,0
1713310260113,LIIT 5BS,A00,507430,Carnelos; Chiara,20,0,20,0
1713310261141,LIIT 5CS,A00,507432,Carnelos; Chiara,20,0,20,0
1713310262170,LISP 5A,A00,507541,Munoz Sanchez; Alicia,19,0,20,1
1713310263196,LISP 5B,A00,507671,Munoz Sanchez; Alicia,17,0,20,3
1713310264220,LISP 5C,A00,507696,Munoz Sanchez; Alicia,17,0,20,3
1713310265246,MAE 197,001,528363,Boechler; Nicholas Sebastia,9998,0,9999,1
1713310266269,MATH 197,001,523477,Kedlaya; Kiran S.,9999,0,9999,0
1713310266269,MATH 197,002,563811,Zhang; Danna,9999,0,9999,0
1713310267295,MCWP 40R,A00,518780,Staff,20,0,20,0
1713310267295,MCWP 40R,B00,518781,Staff,19,0,20,1
1713310267295,MCWP 40R,C00,518783,Staff,19,0,20,1
1713310268321,MCWP 50R,A00,518791,Staff,20,0,20,0
1713310268321,MCWP 50R,B00,518792,Staff,19,0,20,1
1713310268321,MCWP 50R,C00,518793,Staff,19,0,20,1
1713310268321,MCWP 50R,D00,518794,Staff,18,0,20,2
1713310268321,MCWP 50R,E00,518795,Staff,18,0,20,2
1713310268321,MCWP 50R,F00,518796,Staff,19,0,20,1
1713310268321,MCWP 50R,G00,518797,Staff,19,0,20,1
1713310269345,MMW 12R,A01,514034,Herbst; Matthew,16,0,16,0
1713310269345,MMW 12R,A02,514035,Herbst; Matthew,16,0,16,0
1713310270375,MMW 13R,A01,514037,Staff,14,0,16,2
1713310270375,MMW 13R,A02,514039,Staff,16,0,16,0
1713310272428,SIO 295LS,A00,523233,Staff,19,0,30,11
1713310273452,SIO 295S,A00,523232,Staff,19,0,30,11
1713310274480,SOCI 117,A01,494376,Staff,3,0,5,2
1713310275506,WES 237B,A00,494380,Staff,19,0,20,1
1713310277578,AESE 279B,A00,494370,Wade; Jon P,33,0,33,0
1713310278604,ANAR 135S,A00,494369,Braswell; Geoffrey E.,0,0,0,0
1713310279634,CAT 124RS,A01,519847,Geibel; William,17,0,20,3
1713310280657,CAT 125RS,A01,515971,Geibel; William,17,0,20,3
1713310281687,CLRE 250,A00,511389,Morris; Sheldon,9996,0,9999,3
1713310282716,CLRE 251,A00,507176,Mehta; Ravindra L.,9996,0,9999,3
1713310282716,CLRE 251,B00,511410,Mehta; Ravindra L.,9998,0,9999,1
1713310283745,CLRE 252,A00,507189,Cuomo; Raphael Eduardo,9998,0,9999,1
1713310284772,CLRE 253,A00,507199,Vaida; Florin,9997,0,9999,2
1713310284772,CLRE 253,B00,507202,Vaida; Florin,9999,0,9999,0
1713310285797,CLRE 259,A00,507211,Patel; Hemal,9996,0,9999,3
1713310286822,CLRE 260,A00,507221,Cuomo; Raphael Eduardo,9999,0,9999,0
1713310287848,CLRE 297,001,507242,Cuomo; Raphael Eduardo,9999,0,9999,0
1713310288874,CSE 191,A00,516875,Minnes Kemp; Mor Mia,9999,0,9999,0
1713310289903,CSS 201S,A01,494383,Staff,35,0,35,0
1713310290932,CSS 202S,A01,494387,Staff,35,0,35,0
1713310291960,EAP 100,A00,516065,Staff,9792,0,9999,207
1713310292985,ECE 45,A01,507414,Staff,54,0,60,6
1713310294015,ECE 100,A01,507416,Baghdadchi; Saharnaz,11,0,20,9
1713310294015,ECE 100,A02,507418,Baghdadchi; Saharnaz,20,0,20,0
1713310295043,ECE 111,A01,507420,Staff,40,0,50,10
1713310296069,ECE 197,001,548057,Sievenpiper; Daniel F.,9998,0,9999,1
1713310297097,EDS 115,A00,507243,Choi; Bailey Miyeon,28,0,28,0
1713310298123,EDS 117,A01,494379,Staff,25,0,25,0
1713310299149,EDS 125,A00,507246,Hopkins; Megan Beth,29,0,30,1
1713310300174,EDS 128A,A01,507264,Fargason; Sharon Gayle,26,0,26,0
1713310301198,EDS 128B,A01,507293,Pappas; Elizabeth,30,0,30,0
1713310302220,EDS 139,A00,507294,Fargason; Sharon Gayle,30,0,30,0
1713310302220,EDS 139,B00,507313,Pappas; Elizabeth,30,0,30,0
1713310303245,EDS 201,A00,507315,Staff,26,0,30,4
1713310304274,EDS 203,A01,507317,Halter; Christopher P.,26,0,30,4
1713310305299,EDS 204R,A01,507319,Halter; Christopher P.,5,0,30,25
1713310305299,EDS 204R,B01,507331,Heinzman; Erica M.,30,0,30,0
1713310306325,EDS 206R,A00,507332,Staff,7,0,30,23
1713310306325,EDS 206R,B00,507343,Staff,29,0,30,1
1713310307353,EDS 250,A00,507344,Hemans; Patricia Ann Benitez,36,0,40,4
1713310308382,EDS 281,A00,507345,Daly; Alan J.,18,0,18,0
1713310309410,EDS 284,A00,507350,Daly; Alan J.,16,0,16,0
1713310310436,EDS 286,A00,507359,Fine; Sarah,18,0,18,0
1713310311460,EDS 289C,A01,507361,Daly; Alan J.,18,0,18,0
1713310312485,EDS 290,A00,507366,Hofstetter; Carolyn,15,0,15,0
1713310313513,LIGM 5A,A00,507421,Fischer-Grunski; Eva K,20,0,20,0
1713310314542,LIGM 5B,A00,507423,Fischer-Grunski; Eva K,20,0,20,0
1713310315567,LIGM 5C,A00,507425,Fischer-Grunski; Eva K,20,0,20,0
1713310316597,LIIT 5AS,A00,507427,Carnelos; Chiara,20,0,20,0
1713310317627,LIIT 5BS,A00,507430,Carnelos; Chiara,20,0,20,0
1713310318653,LIIT 5CS,A00,507432,Carnelos; Chiara,20,0,20,0
1713310319685,LISP 5A,A00,507541,Munoz Sanchez; Alicia,19,0,20,1
1713310320714,LISP 5B,A00,507671,Munoz Sanchez; Alicia,17,0,20,3
1713310321744,LISP 5C,A00,507696,Munoz Sanchez; Alicia,17,0,20,3
1713310322767,MAE 197,001,528363,Boechler; Nicholas Sebastia,9998,0,9999,1
1713310323793,MATH 197,001,523477,Kedlaya; Kiran S.,9999,0,9999,0
1713310323793,MATH 197,002,563811,Zhang; Danna,9999,0,9999,0
1713310324819,MCWP 40R,A00,518780,Staff,20,0,20,0
1713310324819,MCWP 40R,B00,518781,Staff,19,0,20,1
1713310324819,MCWP 40R,C00,518783,Staff,19,0,20,1
1713310325846,MCWP 50R,A00,518791,Staff,20,0,20,0
1713310325846,MCWP 50R,B00,518792,Staff,19,0,20,1
1713310325846,MCWP 50R,C00,518793,Staff,19,0,20,1
1713310325846,MCWP 50R,D00,518794,Staff,18,0,20,2
1713310325846,MCWP 50R,E00,518795,Staff,18,0,20,2
1713310325846,MCWP 50R,F00,518796,Staff,19,0,20,1
1713310325846,MCWP 50R,G00,518797,Staff,19,0,20,1
1713310326877,MMW 12R,A01,514034,Herbst; Matthew,16,0,16,0
1713310326877,MMW 12R,A02,514035,Herbst; Matthew,16,0,16,0
1713310327901,MMW 13R,A01,514037,Staff,13,0,16,3
1713310327901,MMW 13R,A02,514039,Staff,16,0,16,0
1713310329966,SIO 295LS,A00,523233,Staff,19,0,30,11
1713310330991,SIO 295S,A00,523232,Staff,19,0,30,11
1713310332017,SOCI 117,A01,494376,Staff,3,0,5,2
1713310333045,WES 237B,A00,494380,Staff,19,0,20,1
1713310335122,AESE 279B,A00,494370,Wade; Jon P,33,0,33,0
1713310336149,ANAR 135S,A00,494369,Braswell; Geoffrey E.,0,0,0,0
1713310337177,CAT 124RS,A01,519847,Geibel; William,17,0,20,3
1713310338202,CAT 125RS,A01,515971,Geibel; William,17,0,20,3
1713310339228,CLRE 250,A00,511389,Morris; Sheldon,9996,0,9999,3
1713310340253,CLRE 251,A00,507176,Mehta; Ravindra L.,9996,0,9999,3
1713310340253,CLRE 251,B00,511410,Mehta; Ravindra L.,9998,0,9999,1
1713310341277,CLRE 252,A00,507189,Cuomo; Raphael Eduardo,9998,0,9999,1
1713310342309,CLRE 253,A00,507199,Vaida; Florin,9997,0,9999,2
1713310342309,CLRE 253,B00,507202,Vaida; Florin,9999,0,9999,0
1713310343333,CLRE 259,A00,507211,Patel; Hemal,9996,0,9999,3
1713310344357,CLRE 260,A00,507221,Cuomo; Raphael Eduardo,9999,0,9999,0
1713310345386,CLRE 297,001,507242,Cuomo; Raphael Eduardo,9999,0,9999,0
1713310346410,CSE 191,A00,516875,Minnes Kemp; Mor Mia,9999,0,9999,0
1713310347433,CSS 201S,A01,494383,Staff,35,0,35,0
1713310348459,CSS 202S,A01,494387,Staff,35,0,35,0
1713310349484,EAP 100,A00,516065,Staff,9792,0,9999,207
1713310350513,ECE 45,A01,507414,Staff,54,0,60,6
1713310351541,ECE 100,A01,507416,Baghdadchi; Saharnaz,11,0,20,9
1713310351541,ECE 100,A02,507418,Baghdadchi; Saharnaz,20,0,20,0
1713310352564,ECE 111,A01,507420,Staff,40,0,50,10
1713310353587,ECE 197,001,548057,Sievenpiper; Daniel F.,9998,0,9999,1
1713310354612,EDS 115,A00,507243,Choi; Bailey Miyeon,28,0,28,0
1713310355636,EDS 117,A01,494379,Staff,25,0,25,0
1713310356664,EDS 125,A00,507246,Hopkins; Megan Beth,29,0,30,1
1713310357688,EDS 128A,A01,507264,Fargason; Sharon Gayle,26,0,26,0
1713310358713,EDS 128B,A01,507293,Pappas; Elizabeth,30,0,30,0
1713310359738,EDS 139,A00,507294,Fargason; Sharon Gayle,30,0,30,0
1713310359738,EDS 139,B00,507313,Pappas; Elizabeth,30,0,30,0
1713310360767,EDS 201,A00,507315,Staff,26,0,30,4
1713310361796,EDS 203,A01,507317,Halter; Christopher P.,26,0,30,4
1713310362880,EDS 204R,A01,507319,Halter; Christopher P.,5,0,30,25
1713310362880,EDS 204R,B01,507331,Heinzman; Erica M.,30,0,30,0
1713310363909,EDS 206R,A00,507332,Staff,7,0,30,23
1713310363909,EDS 206R,B00,507343,Staff,29,0,30,1
1713310364938,EDS 250,A00,507344,Hemans; Patricia Ann Benitez,36,0,40,4
1713310365967,EDS 281,A00,507345,Daly; Alan J.,18,0,18,0
1713310366991,EDS 284,A00,507350,Daly; Alan J.,16,0,16,0
1713310368017,EDS 286,A00,507359,Fine; Sarah,18,0,18,0
1713310369042,EDS 289C,A01,507361,Daly; Alan J.,18,0,18,0
1713310370066,EDS 290,A00,507366,Hofstetter; Carolyn,15,0,15,0
1713310371093,LIGM 5A,A00,507421,Fischer-Grunski; Eva K,20,0,20,0
1713310372118,LIGM 5B,A00,507423,Fischer-Grunski; Eva K,20,0,20,0
1713310373145,LIGM 5C,A00,507425,Fischer-Grunski; Eva K,20,0,20,0
1713310374169,LIIT 5AS,A00,507427,Carnelos; Chiara,20,0,20,0
1713310375195,LIIT 5BS,A00,507430,Carnelos; Chiara,20,0,20,0
1713310376222,LIIT 5CS,A00,507432,Carnelos; Chiara,20,0,20,0
1713310377247,LISP 5A,A00,507541,Munoz Sanchez; Alicia,19,0,20,1
1713310378277,LISP 5B,A00,507671,Munoz Sanchez; Alicia,17,0,20,3
1713310379302,LISP 5C,A00,507696,Munoz Sanchez; Alicia,17,0,20,3
1713310380328,MAE 197,001,528363,Boechler; Nicholas Sebastia,9998,0,9999,1
1713310381354,MATH 197,001,523477,Kedlaya; Kiran S.,9999,0,9999,0
1713310381354,MATH 197,002,563811,Zhang; Danna,9999,0,9999,0
1713310382380,MCWP 40R,A00,518780,Staff,20,0,20,0
1713310382380,MCWP 40R,B00,518781,Staff,19,0,20,1
1713310382380,MCWP 40R,C00,518783,Staff,19,0,20,1
1713310383409,MCWP 50R,A00,518791,Staff,20,0,20,0
1713310383409,MCWP 50R,B00,518792,Staff,19,0,20,1
1713310383409,MCWP 50R,C00,518793,Staff,19,0,20,1
1713310383409,MCWP 50R,D00,518794,Staff,18,0,20,2
1713310383409,MCWP 50R,E00,518795,Staff,18,0,20,2
1713310383409,MCWP 50R,F00,518796,Staff,19,0,20,1
1713310383409,MCWP 50R,G00,518797,Staff,19,0,20,1
1713310384436,MMW 12R,A01,514034,Herbst; Matthew,16,0,16,0
1713310384436,MMW 12R,A02,514035,Herbst; Matthew,16,0,16,0
1713310385463,MMW 13R,A01,514037,Staff,13,0,16,3
1713310385463,MMW 13R,A02,514039,Staff,16,0,16,0
1713310387511,SIO 295LS,A00,523233,Staff,19,0,30,11
1713310388537,SIO 295S,A00,523232,Staff,19,0,30,11
1713310389564,SOCI 117,A01,494376,Staff,3,0,5,2
1713310390587,WES 237B,A00,494380,Staff,19,0,20,1
1713310392674,AESE 279B,A00,494370,Wade; Jon P,33,0,33,0
1713310393697,ANAR 135S,A00,494369,Braswell; Geoffrey E.,0,0,0,0
1713310394721,CAT 124RS,A01,519847,Geibel; William,17,0,20,3
1713310395744,CAT 125RS,A01,515971,Geibel; William,17,0,20,3
1713310396773,CLRE 250,A00,511389,Morris; Sheldon,9996,0,9999,3
1713310397804,CLRE 251,A00,507176,Mehta; Ravindra L.,9996,0,9999,3
1713310397804,CLRE 251,B00,511410,Mehta; Ravindra L.,9998,0,9999,1
1713310398828,CLRE 252,A00,507189,Cuomo; Raphael Eduardo,9998,0,9999,1
1713310399853,CLRE 253,A00,507199,Vaida; Florin,9997,0,9999,2
1713310399853,CLRE 253,B00,507202,Vaida; Florin,9999,0,9999,0
1713310400878,CLRE 259,A00,507211,Patel; Hemal,9996,0,9999,3
1713310401907,CLRE 260,A00,507221,Cuomo; Raphael Eduardo,9999,0,9999,0
1713310402930,CLRE 297,001,507242,Cuomo; Raphael Eduardo,9999,0,9999,0
1713310403955,CSE 191,A00,516875,Minnes Kemp; Mor Mia,9999,0,9999,0
1713310404979,CSS 201S,A01,494383,Staff,35,0,35,0
1713310406145,CSS 202S,A01,494387,Staff,35,0,35,0
1713310407169,EAP 100,A00,516065,Staff,9792,0,9999,207
1713310408193,ECE 45,A01,507414,Staff,54,0,60,6
1713310409222,ECE 100,A01,507416,Baghdadchi; Saharnaz,11,0,20,9
1713310409222,ECE 100,A02,507418,Baghdadchi; Saharnaz,20,0,20,0
1713310410248,ECE 111,A01,507420,Staff,40,0,50,10
1713310411274,ECE 197,001,548057,Sievenpiper; Daniel F.,9998,0,9999,1
1713310412302,EDS 115,A00,507243,Choi; Bailey Miyeon,28,0,28,0
1713310413330,EDS 117,A01,494379,Staff,25,0,25,0
1713310414353,EDS 125,A00,507246,Hopkins; Megan Beth,29,0,30,1
1713310415379,EDS 128A,A01,507264,Fargason; Sharon Gayle,26,0,26,0
1713310416410,EDS 128B,A01,507293,Pappas; Elizabeth,30,0,30,0
1713310417436,EDS 139,A00,507294,Fargason; Sharon Gayle,30,0,30,0
1713310417436,EDS 139,B00,507313,Pappas; Elizabeth,30,0,30,0
1713310418461,EDS 201,A00,507315,Staff,26,0,30,4
1713310419491,EDS 203,A01,507317,Halter; Christopher P.,26,0,30,4
1713310420516,EDS 204R,A01,507319,Halter; Christopher P.,5,0,30,25
1713310420516,EDS 204R,B01,507331,Heinzman; Erica M.,30,0,30,0
1713310421541,EDS 206R,A00,507332,Staff,7,0,30,23
1713310421541,EDS 206R,B00,507343,Staff,29,0,30,1
1713310422573,EDS 250,A00,507344,Hemans; Patricia Ann Benitez,36,0,40,4
1713310423599,EDS 281,A00,507345,Daly; Alan J.,18,0,18,0
1713310424627,EDS 284,A00,507350,Daly; Alan J.,16,0,16,0
1713310425656,EDS 286,A00,507359,Fine; Sarah,18,0,18,0
1713310426682,EDS 289C,A01,507361,Daly; Alan J.,18,0,18,0
1713310427707,EDS 290,A00,507366,Hofstetter; Carolyn,15,0,15,0
1713310428734,LIGM 5A,A00,507421,Fischer-Grunski; Eva K,20,0,20,0
1713310429761,LIGM 5B,A00,507423,Fischer-Grunski; Eva K,20,0,20,0
1713310430914,LIGM 5C,A00,507425,Fischer-Grunski; Eva K,20,0,20,0
1713310431938,LIIT 5AS,A00,507427,Carnelos; Chiara,20,0,20,0
1713310432962,LIIT 5BS,A00,507430,Carnelos; Chiara,20,0,20,0
1713310433987,LIIT 5CS,A00,507432,Carnelos; Chiara,20,0,20,0
1713310435013,LISP 5A,A00,507541,Munoz Sanchez; Alicia,19,0,20,1
1713310436039,LISP 5B,A00,507671,Munoz Sanchez; Alicia,17,0,20,3
1713310437067,LISP 5C,A00,507696,Munoz Sanchez; Alicia,17,0,20,3
1713310438097,MAE 197,001,528363,Boechler; Nicholas Sebastia,9998,0,9999,1
1713310439124,MATH 197,001,523477,Kedlaya; Kiran S.,9999,0,9999,0
1713310439124,MATH 197,002,563811,Zhang; Danna,9999,0,9999,0
1713310440156,MCWP 40R,A00,518780,Staff,20,0,20,0
1713310440156,MCWP 40R,B00,518781,Staff,19,0,20,1
1713310440156,MCWP 40R,C00,518783,Staff,19,0,20,1
1713310441186,MCWP 50R,A00,518791,Staff,20,0,20,0
1713310441186,MCWP 50R,B00,518792,Staff,19,0,20,1
1713310441186,MCWP 50R,C00,518793,Staff,19,0,20,1
1713310441186,MCWP 50R,D00,518794,Staff,18,0,20,2
1713310441186,MCWP 50R,E00,518795,Staff,18,0,20,2
1713310441186,MCWP 50R,F00,518796,Staff,19,0,20,1
1713310441186,MCWP 50R,G00,518797,Staff,19,0,20,1
1713310442215,MMW 12R,A01,514034,Herbst; Matthew,16,0,16,0
1713310442215,MMW 12R,A02,514035,Herbst; Matthew,16,0,16,0
1713310443239,MMW 13R,A01,514037,Staff,13,0,16,3
1713310443239,MMW 13R,A02,514039,Staff,16,0,16,0
1713310445292,SIO 295LS,A00,523233,Staff,19,0,30,11
1713310446317,SIO 295S,A00,523232,Staff,19,0,30,11
1713310447344,SOCI 117,A01,494376,Staff,3,0,5,2
1713310448372,WES 237B,A00,494380,Staff,19,0,20,1
1713310450428,AESE 279B,A00,494370,Wade; Jon P,33,0,33,0
1713310451453,ANAR 135S,A00,494369,Braswell; Geoffrey E.,0,0,0,0
1713310452477,CAT 124RS,A01,519847,Geibel; William,17,0,20,3
1713310453505,CAT 125RS,A01,515971,Geibel; William,17,0,20,3
1713310454530,CLRE 250,A00,511389,Morris; Sheldon,9996,0,9999,3
1713310455556,CLRE 251,A00,507176,Mehta; Ravindra L.,9996,0,9999,3
1713310455556,CLRE 251,B00,511410,Mehta; Ravindra L.,9998,0,9999,1
1713310456581,CLRE 252,A00,507189,Cuomo; Raphael Eduardo,9998,0,9999,1
1713310457610,CLRE 253,A00,507199,Vaida; Florin,9997,0,9999,2
1713310457610,CLRE 253,B00,507202,Vaida; Florin,9999,0,9999,0
1713310458638,CLRE 259,A00,507211,Patel; Hemal,9996,0,9999,3
1713310459663,CLRE 260,A00,507221,Cuomo; Raphael Eduardo,9999,0,9999,0
1713310460689,CLRE 297,001,507242,Cuomo; Raphael Eduardo,9999,0,9999,0
1713310461714,CSE 191,A00,516875,Minnes Kemp; Mor Mia,9999,0,9999,0
1713310462739,CSS 201S,A01,494383,Staff,35,0,35,0
1713310463763,CSS 202S,A01,494387,Staff,35,0,35,0
1713310464791,EAP 100,A00,516065,Staff,9792,0,9999,207
1713310465817,ECE 45,A01,507414,Staff,54,0,60,6
1713310466898,ECE 100,A01,507416,Baghdadchi; Saharnaz,11,0,20,9
1713310466898,ECE 100,A02,507418,Baghdadchi; Saharnaz,20,0,20,0
1713310467924,ECE 111,A01,507420,Staff,40,0,50,10
1713310468950,ECE 197,001,548057,Sievenpiper; Daniel F.,9998,0,9999,1
1713310469978,EDS 115,A00,507243,Choi; Bailey Miyeon,28,0,28,0
1713310471006,EDS 117,A01,494379,Staff,25,0,25,0
1713310472035,EDS 125,A00,507246,Hopkins; Megan Beth,29,0,30,1
1713310473060,EDS 128A,A01,507264,Fargason; Sharon Gayle,26,0,26,0
1713310474089,EDS 128B,A01,507293,Pappas; Elizabeth,30,0,30,0
1713310475117,EDS 139,A00,507294,Fargason; Sharon Gayle,30,0,30,0
1713310475117,EDS 139,B00,507313,Pappas; Elizabeth,30,0,30,0
1713310476141,EDS 201,A00,507315,Staff,26,0,30,4
1713310477167,EDS 203,A01,507317,Halter; Christopher P.,26,0,30,4
1713310478196,EDS 204R,A01,507319,Halter; Christopher P.,5,0,30,25
1713310478196,EDS 204R,B01,507331,Heinzman; Erica M.,30,0,30,0
1713310479224,EDS 206R,A00,507332,Staff,7,0,30,23
1713310479224,EDS 206R,B00,507343,Staff,29,0,30,1
1713310480253,EDS 250,A00,507344,Hemans; Patricia Ann Benitez,36,0,40,4
1713310481278,EDS 281,A00,507345,Daly; Alan J.,18,0,18,0
1713310482303,EDS 284,A00,507350,Daly; Alan J.,16,0,16,0
1713310483330,EDS 286,A00,507359,Fine; Sarah,18,0,18,0
1713310484359,EDS 289C,A01,507361,Daly; Alan J.,18,0,18,0
1713310485383,EDS 290,A00,507366,Hofstetter; Carolyn,15,0,15,0
1713310486411,LIGM 5A,A00,507421,Fischer-Grunski; Eva K,20,0,20,0
1713310487436,LIGM 5B,A00,507423,Fischer-Grunski; Eva K,20,0,20,0
1713310488461,LIGM 5C,A00,507425,Fischer-Grunski; Eva K,20,0,20,0
1713310489487,LIIT 5AS,A00,507427,Carnelos; Chiara,20,0,20,0
1713310490512,LIIT 5BS,A00,507430,Carnelos; Chiara,20,0,20,0
1713310491537,LIIT 5CS,A00,507432,Carnelos; Chiara,20,0,20,0
1713310492562,LISP 5A,A00,507541,Munoz Sanchez; Alicia,19,0,20,1
1713310493587,LISP 5B,A00,507671,Munoz Sanchez; Alicia,17,0,20,3
1713310494612,LISP 5C,A00,507696,Munoz Sanchez; Alicia,17,0,20,3
1713310495637,MAE 197,001,528363,Boechler; Nicholas Sebastia,9998,0,9999,1
1713310496669,MATH 197,001,523477,Kedlaya; Kiran S.,9999,0,9999,0
1713310496669,MATH 197,002,563811,Zhang; Danna,9999,0,9999,0
1713310497698,MCWP 40R,A00,518780,Staff,20,0,20,0
1713310497698,MCWP 40R,B00,518781,Staff,19,0,20,1
1713310497698,MCWP 40R,C00,518783,Staff,19,0,20,1
1713310498727,MCWP 50R,A00,518791,Staff,20,0,20,0
1713310498727,MCWP 50R,B00,518792,Staff,19,0,20,1
1713310498727,MCWP 50R,C00,518793,Staff,19,0,20,1
1713310498727,MCWP 50R,D00,518794,Staff,18,0,20,2
1713310498727,MCWP 50R,E00,518795,Staff,18,0,20,2
1713310498727,MCWP 50R,F00,518796,Staff,19,0,20,1
1713310498727,MCWP 50R,G00,518797,Staff,19,0,20,1
1713310499752,MMW 12R,A01,514034,Herbst; Matthew,16,0,16,0
1713310499752,MMW 12R,A02,514035,Herbst; Matthew,16,0,16,0
1713310500780,MMW 13R,A01,514037,Staff,13,0,16,3
1713310500780,MMW 13R,A02,514039,Staff,16,0,16,0
1713310502829,SIO 295LS,A00,523233,Staff,19,0,30,11
1713310503867,SIO 295S,A00,523232,Staff,19,0,30,11
1713310504892,SOCI 117,A01,494376,Staff,3,0,5,2
1713310505919,WES 237B,A00,494380,Staff,19,0,20,1
1713310507984,AESE 279B,A00,494370,Wade; Jon P,33,0,33,0
1713310509009,ANAR 135S,A00,494369,Braswell; Geoffrey E.,0,0,0,0
1713310510036,CAT 124RS,A01,519847,Geibel; William,17,0,20,3
1713310511063,CAT 125RS,A01,515971,Geibel; William,17,0,20,3
1713310512089,CLRE 250,A00,511389,Morris; Sheldon,9996,0,9999,3
1713310513113,CLRE 251,A00,507176,Mehta; Ravindra L.,9996,0,9999,3
1713310513113,CLRE 251,B00,511410,Mehta; Ravindra L.,9998,0,9999,1
1713310514141,CLRE 252,A00,507189,Cuomo; Raphael Eduardo,9998,0,9999,1
1713310515170,CLRE 253,A00,507199,Vaida; Florin,9997,0,9999,2
1713310515170,CLRE 253,B00,507202,Vaida; Florin,9999,0,9999,0
1713310516193,CLRE 259,A00,507211,Patel; Hemal,9996,0,9999,3
1713310517218,CLRE 260,A00,507221,Cuomo; Raphael Eduardo,9999,0,9999,0
1713310518246,CLRE 297,001,507242,Cuomo; Raphael Eduardo,9999,0,9999,0
1713310519274,CSE 191,A00,516875,Minnes Kemp; Mor Mia,9999,0,9999,0
1713310520302,CSS 201S,A01,494383,Staff,35,0,35,0
1713310521328,CSS 202S,A01,494387,Staff,35,0,35,0
1713310522356,EAP 100,A00,516065,Staff,9792,0,9999,207
1713310523385,ECE 45,A01,507414,Staff,54,0,60,6
1713310524410,ECE 100,A01,507416,Baghdadchi; Saharnaz,11,0,20,9
1713310524410,ECE 100,A02,507418,Baghdadchi; Saharnaz,20,0,20,0
1713310525436,ECE 111,A01,507420,Staff,40,0,50,10
1713310526461,ECE 197,001,548057,Sievenpiper; Daniel F.,9998,0,9999,1
1713310527489,EDS 115,A00,507243,Choi; Bailey Miyeon,28,0,28,0
1713310528513,EDS 117,A01,494379,Staff,25,0,25,0
1713310529544,EDS 125,A00,507246,Hopkins; Megan Beth,29,0,30,1
1713310530568,EDS 128A,A01,507264,Fargason; Sharon Gayle,26,0,26,0
1713310531593,EDS 128B,A01,507293,Pappas; Elizabeth,30,0,30,0
1713310532623,EDS 139,A00,507294,Fargason; Sharon Gayle,30,0,30,0
1713310532623,EDS 139,B00,507313,Pappas; Elizabeth,30,0,30,0
1713310533651,EDS 201,A00,507315,Staff,26,0,30,4
1713310534681,EDS 203,A01,507317,Halter; Christopher P.,26,0,30,4
1713310535706,EDS 204R,A01,507319,Halter; Christopher P.,5,0,30,25
1713310535706,EDS 204R,B01,507331,Heinzman; Erica M.,30,0,30,0
1713310536730,EDS 206R,A00,507332,Staff,7,0,30,23
1713310536730,EDS 206R,B00,507343,Staff,29,0,30,1
1713310537760,EDS 250,A00,507344,Hemans; Patricia Ann Benitez,36,0,40,4
1713310538784,EDS 281,A00,507345,Daly; Alan J.,18,0,18,0
1713310539811,EDS 284,A00,507350,Daly; Alan J.,16,0,16,0
1713310540835,EDS 286,A00,507359,Fine; Sarah,18,0,18,0
1713310541861,EDS 289C,A01,507361,Daly; Alan J.,18,0,18,0
1713310542888,EDS 290,A00,507366,Hofstetter; Carolyn,15,0,15,0
1713310543914,LIGM 5A,A00,507421,Fischer-Grunski; Eva K,20,0,20,0
1713310544939,LIGM 5B,A00,507423,Fischer-Grunski; Eva K,20,0,20,0
1713310545969,LIGM 5C,A00,507425,Fischer-Grunski; Eva K,20,0,20,0
1713310546997,LIIT 5AS,A00,507427,Carnelos; Chiara,20,0,20,0
1713310548022,LIIT 5BS,A00,507430,Carnelos; Chiara,20,0,20,0
1713310549051,LIIT 5CS,A00,507432,Carnelos; Chiara,20,0,20,0
1713310550076,LISP 5A,A00,507541,Munoz Sanchez; Alicia,19,0,20,1
1713310551104,LISP 5B,A00,507671,Munoz Sanchez; Alicia,17,0,20,3
1713310552133,LISP 5C,A00,507696,Munoz Sanchez; Alicia,17,0,20,3
1713310553162,MAE 197,001,528363,Boechler; Nicholas Sebastia,9998,0,9999,1
1713310554192,MATH 197,001,523477,Kedlaya; Kiran S.,9999,0,9999,0
1713310554192,MATH 197,002,563811,Zhang; Danna,9999,0,9999,0
1713310555217,MCWP 40R,A00,518780,Staff,20,0,20,0
1713310555217,MCWP 40R,B00,518781,Staff,19,0,20,1
1713310555217,MCWP 40R,C00,518783,Staff,19,0,20,1
1713310556249,MCWP 50R,A00,518791,Staff,20,0,20,0
1713310556249,MCWP 50R,B00,518792,Staff,19,0,20,1
1713310556249,MCWP 50R,C00,518793,Staff,19,0,20,1
1713310556249,MCWP 50R,D00,518794,Staff,18,0,20,2
1713310556249,MCWP 50R,E00,518795,Staff,18,0,20,2
1713310556249,MCWP 50R,F00,518796,Staff,19,0,20,1
1713310556249,MCWP 50R,G00,518797,Staff,19,0,20,1
1713310557277,MMW 12R,A01,514034,Herbst; Matthew,16,0,16,0
1713310557277,MMW 12R,A02,514035,Herbst; Matthew,16,0,16,0
1713310558303,MMW 13R,A01,514037,Staff,13,0,16,3
1713310558303,MMW 13R,A02,514039,Staff,16,0,16,0
1713310560352,SIO 295LS,A00,523233,Staff,19,0,30,11
1713310561379,SIO 295S,A00,523232,Staff,19,0,30,11
1713310562404,SOCI 117,A01,494376,Staff,3,0,5,2
1713310563430,WES 237B,A00,494380,Staff,19,0,20,1
1713310565491,AESE 279B,A00,494370,Wade; Jon P,33,0,33,0
1713310566515,ANAR 135S,A00,494369,Braswell; Geoffrey E.,0,0,0,0
1713310567540,CAT 124RS,A01,519847,Geibel; William,17,0,20,3
1713310568567,CAT 125RS,A01,515971,Geibel; William,17,0,20,3
1713310569593,CLRE 250,A00,511389,Morris; Sheldon,9996,0,9999,3
1713310570677,CLRE 251,A00,507176,Mehta; Ravindra L.,9996,0,9999,3
1713310570677,CLRE 251,B00,511410,Mehta; Ravindra L.,9998,0,9999,1
1713310571706,CLRE 252,A00,507189,Cuomo; Raphael Eduardo,9998,0,9999,1
1713310572734,CLRE 253,A00,507199,Vaida; Florin,9997,0,9999,2
1713310572734,CLRE 253,B00,507202,Vaida; Florin,9999,0,9999,0
1713310573868,CLRE 259,A00,507211,Patel; Hemal,9996,0,9999,3
1713310574892,CLRE 260,A00,507221,Cuomo; Raphael Eduardo,9999,0,9999,0
1713310575919,CLRE 297,001,507242,Cuomo; Raphael Eduardo,9999,0,9999,0
1713310576945,CSE 191,A00,516875,Minnes Kemp; Mor Mia,9999,0,9999,0
1713310577971,CSS 201S,A01,494383,Staff,35,0,35,0
1713310579002,CSS 202S,A01,494387,Staff,35,0,35,0
1713310580027,EAP 100,A00,516065,Staff,9792,0,9999,207
1713310581053,ECE 45,A01,507414,Staff,54,0,60,6
1713310582079,ECE 100,A01,507416,Baghdadchi; Saharnaz,11,0,20,9
1713310582079,ECE 100,A02,507418,Baghdadchi; Saharnaz,20,0,20,0
1713310583106,ECE 111,A01,507420,Staff,40,0,50,10
1713310584136,ECE 197,001,548057,Sievenpiper; Daniel F.,9998,0,9999,1
1713310585165,EDS 115,A00,507243,Choi; Bailey Miyeon,28,0,28,0
1713310586194,EDS 117,A01,494379,Staff,25,0,25,0
1713310587220,EDS 125,A00,507246,Hopkins; Megan Beth,29,0,30,1
1713310588247,EDS 128A,A01,507264,Fargason; Sharon Gayle,26,0,26,0
1713310589277,EDS 128B,A01,507293,Pappas; Elizabeth,30,0,30,0
1713310590303,EDS 139,A00,507294,Fargason; Sharon Gayle,30,0,30,0
1713310590303,EDS 139,B00,507313,Pappas; Elizabeth,30,0,30,0
1713310591328,EDS 201,A00,507315,Staff,26,0,30,4
1713310592357,EDS 203,A01,507317,Halter; Christopher P.,26,0,30,4
1713310593387,EDS 204R,A01,507319,Halter; Christopher P.,5,0,30,25
1713310593387,EDS 204R,B01,507331,Heinzman; Erica M.,30,0,30,0
1713310594413,EDS 206R,A00,507332,Staff,7,0,30,23
1713310594413,EDS 206R,B00,507343,Staff,29,0,30,1
1713310595442,EDS 250,A00,507344,Hemans; Patricia Ann Benitez,36,0,40,4
1713310596466,EDS 281,A00,507345,Daly; Alan J.,18,0,18,0
1713310597491,EDS 284,A00,507350,Daly; Alan J.,16,0,16,0
1713310598600,EDS 286,A00,507359,Fine; Sarah,18,0,18,0
1713310599630,EDS 289C,A01,507361,Daly; Alan J.,18,0,18,0
1713310600655,EDS 290,A00,507366,Hofstetter; Carolyn,15,0,15,0
1713310601682,LIGM 5A,A00,507421,Fischer-Grunski; Eva K,20,0,20,0
1713310602711,LIGM 5B,A00,507423,Fischer-Grunski; Eva K,20,0,20,0
1713310603738,LIGM 5C,A00,507425,Fischer-Grunski; Eva K,20,0,20,0
1713310604763,LIIT 5AS,A00,507427,Carnelos; Chiara,20,0,20,0
1713310605788,LIIT 5BS,A00,507430,Carnelos; Chiara,20,0,20,0
1713310606817,LIIT 5CS,A00,507432,Carnelos; Chiara,20,0,20,0
1713310607846,LISP 5A,A00,507541,Munoz Sanchez; Alicia,19,0,20,1
1713310608870,LISP 5B,A00,507671,Munoz Sanchez; Alicia,17,0,20,3
1713310609896,LISP 5C,A00,507696,Munoz Sanchez; Alicia,17,0,20,3
1713310610921,MAE 197,001,528363,Boechler; Nicholas Sebastia,9998,0,9999,1
1713310611951,MATH 197,001,523477,Kedlaya; Kiran S.,9999,0,9999,0
1713310611951,MATH 197,002,563811,Zhang; Danna,9999,0,9999,0
1713310612980,MCWP 40R,A00,518780,Staff,20,0,20,0
1713310612980,MCWP 40R,B00,518781,Staff,19,0,20,1
1713310612980,MCWP 40R,C00,518783,Staff,19,0,20,1
1713310614008,MCWP 50R,A00,518791,Staff,20,0,20,0
1713310614008,MCWP 50R,B00,518792,Staff,19,0,20,1
1713310614008,MCWP 50R,C00,518793,Staff,19,0,20,1
1713310614008,MCWP 50R,D00,518794,Staff,18,0,20,2
1713310614008,MCWP 50R,E00,518795,Staff,18,0,20,2
1713310614008,MCWP 50R,F00,518796,Staff,19,0,20,1
1713310614008,MCWP 50R,G00,518797,Staff,19,0,20,1
1713310615038,MMW 12R,A01,514034,Herbst; Matthew,16,0,16,0
1713310615038,MMW 12R,A02,514035,Herbst; Matthew,16,0,16,0
1713310616064,MMW 13R,A01,514037,Staff,13,0,16,3
1713310616064,MMW 13R,A02,514039,Staff,16,0,16,0
1713310618114,SIO 295LS,A00,523233,Staff,19,0,30,11
1713310619139,SIO 295S,A00,523232,Staff,19,0,30,11
1713310620169,SOCI 117,A01,494376,Staff,3,0,5,2
1713310621198,WES 237B,A00,494380,Staff,19,0,20,1
1713310623261,AESE 279B,A00,494370,Wade; Jon P,33,0,33,0
1713310624285,ANAR 135S,A00,494369,Braswell; Geoffrey E.,0,0,0,0
1713310625314,CAT 124RS,A01,519847,Geibel; William,17,0,20,3
1713310626339,CAT 125RS,A01,515971,Geibel; William,17,0,20,3
1713310627364,CLRE 250,A00,511389,Morris; Sheldon,9996,0,9999,3
1713310628393,CLRE 251,A00,507176,Mehta; Ravindra L.,9996,0,9999,3
1713310628393,CLRE 251,B00,511410,Mehta; Ravindra L.,9998,0,9999,1
1713310629416,CLRE 252,A00,507189,Cuomo; Raphael Eduardo,9998,0,9999,1
1713310630449,CLRE 253,A00,507199,Vaida; Florin,9997,0,9999,2
1713310630449,CLRE 253,B00,507202,Vaida; Florin,9999,0,9999,0
1713310631475,CLRE 259,A00,507211,Patel; Hemal,9996,0,9999,3
1713310632506,CLRE 260,A00,507221,Cuomo; Raphael Eduardo,9999,0,9999,0
1713310633532,CLRE 297,001,507242,Cuomo; Raphael Eduardo,9999,0,9999,0
1713310634557,CSE 191,A00,516875,Minnes Kemp; Mor Mia,9999,0,9999,0
1713310635584,CSS 201S,A01,494383,Staff,35,0,35,0
1713310636609,CSS 202S,A01,494387,Staff,35,0,35,0
1713310637633,EAP 100,A00,516065,Staff,9792,0,9999,207
1713310638659,ECE 45,A01,507414,Staff,54,0,60,6
1713310639686,ECE 100,A01,507416,Baghdadchi; Saharnaz,11,0,20,9
1713310639686,ECE 100,A02,507418,Baghdadchi; Saharnaz,20,0,20,0
1713310640714,ECE 111,A01,507420,Staff,40,0,50,10
1713310641737,ECE 197,001,548057,Sievenpiper; Daniel F.,9998,0,9999,1
1713310642766,EDS 115,A00,507243,Choi; Bailey Miyeon,28,0,28,0
1713310643790,EDS 117,A01,494379,Staff,25,0,25,0
1713310644817,EDS 125,A00,507246,Hopkins; Megan Beth,29,0,30,1
1713310645844,EDS 128A,A01,507264,Fargason; Sharon Gayle,26,0,26,0
1713310646869,EDS 128B,A01,507293,Pappas; Elizabeth,30,0,30,0
1713310647900,EDS 139,A00,507294,Fargason; Sharon Gayle,30,0,30,0
1713310647900,EDS 139,B00,507313,Pappas; Elizabeth,30,0,30,0
1713310648927,EDS 201,A00,507315,Staff,26,0,30,4
1713310649954,EDS 203,A01,507317,Halter; Christopher P.,26,0,30,4
1713310650981,EDS 204R,A01,507319,Halter; Christopher P.,5,0,30,25
1713310650981,EDS 204R,B01,507331,Heinzman; Erica M.,30,0,30,0
1713310652006,EDS 206R,A00,507332,Staff,7,0,30,23
1713310652006,EDS 206R,B00,507343,Staff,29,0,30,1
1713310653032,EDS 250,A00,507344,Hemans; Patricia Ann Benitez,36,0,40,4
1713310654059,EDS 281,A00,507345,Daly; Alan J.,18,0,18,0
1713310655085,EDS 284,A00,507350,Daly; Alan J.,16,0,16,0
1713310656114,EDS 286,A00,507359,Fine; Sarah,18,0,18,0
1713310657142,EDS 289C,A01,507361,Daly; Alan J.,18,0,18,0
1713310658167,EDS 290,A00,507366,Hofstetter; Carolyn,15,0,15,0
1713310659194,LIGM 5A,A00,507421,Fischer-Grunski; Eva K,20,0,20,0
1713310660220,LIGM 5B,A00,507423,Fischer-Grunski; Eva K,20,0,20,0
1713310661247,LIGM 5C,A00,507425,Fischer-Grunski; Eva K,20,0,20,0
1713310662276,LIIT 5AS,A00,507427,Carnelos; Chiara,20,0,20,0
1713310663303,LIIT 5BS,A00,507430,Carnelos; Chiara,20,0,20,0
1713310664328,LIIT 5CS,A00,507432,Carnelos; Chiara,20,0,20,0
1713310665352,LISP 5A,A00,507541,Munoz Sanchez; Alicia,19,0,20,1
1713310666381,LISP 5B,A00,507671,Munoz Sanchez; Alicia,17,0,20,3
1713310667406,LISP 5C,A00,507696,Munoz Sanchez; Alicia,17,0,20,3
1713310668432,MAE 197,001,528363,Boechler; Nicholas Sebastia,9998,0,9999,1
1713310669459,MATH 197,001,523477,Kedlaya; Kiran S.,9999,0,9999,0
1713310669459,MATH 197,002,563811,Zhang; Danna,9999,0,9999,0
1713310670487,MCWP 40R,A00,518780,Staff,20,0,20,0
1713310670487,MCWP 40R,B00,518781,Staff,19,0,20,1
1713310670487,MCWP 40R,C00,518783,Staff,19,0,20,1
1713310671517,MCWP 50R,A00,518791,Staff,20,0,20,0
1713310671517,MCWP 50R,B00,518792,Staff,19,0,20,1
1713310671517,MCWP 50R,C00,518793,Staff,19,0,20,1
1713310671517,MCWP 50R,D00,518794,Staff,18,0,20,2
1713310671517,MCWP 50R,E00,518795,Staff,18,0,20,2
1713310671517,MCWP 50R,F00,518796,Staff,19,0,20,1
1713310671517,MCWP 50R,G00,518797,Staff,19,0,20,1
1713310672542,MMW 12R,A01,514034,Herbst; Matthew,16,0,16,0
1713310672542,MMW 12R,A02,514035,Herbst; Matthew,16,0,16,0
1713310673571,MMW 13R,A01,514037,Staff,13,0,16,3
1713310673571,MMW 13R,A02,514039,Staff,16,0,16,0
1713310675677,SIO 295LS,A00,523233,Staff,19,0,30,11
1713310676706,SIO 295S,A00,523232,Staff,19,0,30,11
1713310677735,SOCI 117,A01,494376,Staff,3,0,5,2
1713310678760,WES 237B,A00,494380,Staff,19,0,20,1
1713310680823,AESE 279B,A00,494370,Wade; Jon P,33,0,33,0
1713310681852,ANAR 135S,A00,494369,Braswell; Geoffrey E.,0,0,0,0
1713310682877,CAT 124RS,A01,519847,Geibel; William,17,0,20,3
1713310683906,CAT 125RS,A01,515971,Geibel; William,17,0,20,3
1713310684933,CLRE 250,A00,511389,Morris; Sheldon,9996,0,9999,3
1713310685960,CLRE 251,A00,507176,Mehta; Ravindra L.,9996,0,9999,3
1713310685960,CLRE 251,B00,511410,Mehta; Ravindra L.,9998,0,9999,1
1713310686986,CLRE 252,A00,507189,Cuomo; Raphael Eduardo,9998,0,9999,1
1713310688012,CLRE 253,A00,507199,Vaida; Florin,9997,0,9999,2
1713310688012,CLRE 253,B00,507202,Vaida; Florin,9999,0,9999,0
1713310689038,CLRE 259,A00,507211,Patel; Hemal,9996,0,9999,3
1713310690065,CLRE 260,A00,507221,Cuomo; Raphael Eduardo,9999,0,9999,0
1713310691090,CLRE 297,001,507242,Cuomo; Raphael Eduardo,9999,0,9999,0
1713310692118,CSE 191,A00,516875,Minnes Kemp; Mor Mia,9999,0,9999,0
1713310693150,CSS 201S,A01,494383,Staff,35,0,35,0
1713310694178,CSS 202S,A01,494387,Staff,35,0,35,0
1713310695208,EAP 100,A00,516065,Staff,9792,0,9999,207
1713310696239,ECE 45,A01,507414,Staff,54,0,60,6
1713310697264,ECE 100,A01,507416,Baghdadchi; Saharnaz,11,0,20,9
1713310697264,ECE 100,A02,507418,Baghdadchi; Saharnaz,20,0,20,0
1713310698293,ECE 111,A01,507420,Staff,40,0,50,10
1713310699320,ECE 197,001,548057,Sievenpiper; Daniel F.,9998,0,9999,1
1713310700348,EDS 115,A00,507243,Choi; Bailey Miyeon,28,0,28,0
1713310701373,EDS 117,A01,494379,Staff,25,0,25,0
1713310702401,EDS 125,A00,507246,Hopkins; Megan Beth,29,0,30,1
1713310703426,EDS 128A,A01,507264,Fargason; Sharon Gayle,26,0,26,0
1713310704449,EDS 128B,A01,507293,Pappas; Elizabeth,30,0,30,0
1713310705477,EDS 139,A00,507294,Fargason; Sharon Gayle,30,0,30,0
1713310705477,EDS 139,B00,507313,Pappas; Elizabeth,30,0,30,0
1713310706503,EDS 201,A00,507315,Staff,26,0,30,4
1713310707532,EDS 203,A01,507317,Halter; Christopher P.,26,0,30,4
1713310708556,EDS 204R,A01,507319,Halter; Christopher P.,5,0,30,25
1713310708556,EDS 204R,B01,507331,Heinzman; Erica M.,30,0,30,0
1713310709581,EDS 206R,A00,507332,Staff,7,0,30,23
1713310709581,EDS 206R,B00,507343,Staff,29,0,30,1
1713310710608,EDS 250,A00,507344,Hemans; Patricia Ann Benitez,36,0,40,4
1713310711638,EDS 281,A00,507345,Daly; Alan J.,18,0,18,0
1713310712663,EDS 284,A00,507350,Daly; Alan J.,16,0,16,0
1713310713690,EDS 286,A00,507359,Fine; Sarah,18,0,18,0
1713310714715,EDS 289C,A01,507361,Daly; Alan J.,18,0,18,0
1713310715741,EDS 290,A00,507366,Hofstetter; Carolyn,15,0,15,0
1713310716768,LIGM 5A,A00,507421,Fischer-Grunski; Eva K,20,0,20,0
1713310717798,LIGM 5B,A00,507423,Fischer-Grunski; Eva K,20,0,20,0
1713310718827,LIGM 5C,A00,507425,Fischer-Grunski; Eva K,20,0,20,0
1713310719858,LIIT 5AS,A00,507427,Carnelos; Chiara,20,0,20,0
1713310720884,LIIT 5BS,A00,507430,Carnelos; Chiara,20,0,20,0
1713310721909,LIIT 5CS,A00,507432,Carnelos; Chiara,20,0,20,0
1713310722932,LISP 5A,A00,507541,Munoz Sanchez; Alicia,19,0,20,1
1713310723957,LISP 5B,A00,507671,Munoz Sanchez; Alicia,17,0,20,3
1713310724986,LISP 5C,A00,507696,Munoz Sanchez; Alicia,17,0,20,3
1713310726015,MAE 197,001,528363,Boechler; Nicholas Sebastia,9998,0,9999,1
1713310727046,MATH 197,001,523477,Kedlaya; Kiran S.,9999,0,9999,0
1713310727046,MATH 197,002,563811,Zhang; Danna,9999,0,9999,0
1713310728075,MCWP 40R,A00,518780,Staff,20,0,20,0
1713310728075,MCWP 40R,B00,518781,Staff,19,0,20,1
1713310728075,MCWP 40R,C00,518783,Staff,19,0,20,1
1713310729102,MCWP 50R,A00,518791,Staff,20,0,20,0
1713310729102,MCWP 50R,B00,518792,Staff,19,0,20,1
1713310729102,MCWP 50R,C00,518793,Staff,19,0,20,1
1713310729102,MCWP 50R,D00,518794,Staff,18,0,20,2
1713310729102,MCWP 50R,E00,518795,Staff,18,0,20,2
1713310729102,MCWP 50R,F00,518796,Staff,19,0,20,1
1713310729102,MCWP 50R,G00,518797,Staff,19,0,20,1
1713310730131,MMW 12R,A01,514034,Herbst; Matthew,16,0,16,0
1713310730131,MMW 12R,A02,514035,Herbst; Matthew,16,0,16,0
1713310731155,MMW 13R,A01,514037,Staff,13,0,16,3
1713310731155,MMW 13R,A02,514039,Staff,16,0,16,0
1713310733208,SIO 295LS,A00,523233,Staff,19,0,30,11
1713310734234,SIO 295S,A00,523232,Staff,19,0,30,11
1713310735259,SOCI 117,A01,494376,Staff,3,0,5,2
1713310736283,WES 237B,A00,494380,Staff,19,0,20,1
1713310738358,AESE 279B,A00,494370,Wade; Jon P,33,0,33,0
1713310739386,ANAR 135S,A00,494369,Braswell; Geoffrey E.,0,0,0,0
1713310740417,CAT 124RS,A01,519847,Geibel; William,17,0,20,3
1713310741442,CAT 125RS,A01,515971,Geibel; William,17,0,20,3
1713310742469,CLRE 250,A00,511389,Morris; Sheldon,9996,0,9999,3
1713310743497,CLRE 251,A00,507176,Mehta; Ravindra L.,9996,0,9999,3
1713310743497,CLRE 251,B00,511410,Mehta; Ravindra L.,9998,0,9999,1
1713310744520,CLRE 252,A00,507189,Cuomo; Raphael Eduardo,9998,0,9999,1
1713310745545,CLRE 253,A00,507199,Vaida; Florin,9997,0,9999,2
1713310745545,CLRE 253,B00,507202,Vaida; Florin,9999,0,9999,0
1713310746573,CLRE 259,A00,507211,Patel; Hemal,9996,0,9999,3
1713310747598,CLRE 260,A00,507221,Cuomo; Raphael Eduardo,9999,0,9999,0
1713310748622,CLRE 297,001,507242,Cuomo; Raphael Eduardo,9999,0,9999,0
1713310749647,CSE 191,A00,516875,Minnes Kemp; Mor Mia,9999,0,9999,0
1713310750671,CSS 201S,A01,494383,Staff,35,0,35,0
1713310751701,CSS 202S,A01,494387,Staff,35,0,35,0
1713310752724,EAP 100,A00,516065,Staff,9792,0,9999,207
1713310753748,ECE 45,A01,507414,Staff,54,0,60,6
1713310754771,ECE 100,A01,507416,Baghdadchi; Saharnaz,11,0,20,9
1713310754771,ECE 100,A02,507418,Baghdadchi; Saharnaz,20,0,20,0
1713310755800,ECE 111,A01,507420,Staff,40,0,50,10
1713310756827,ECE 197,001,548057,Sievenpiper; Daniel F.,9998,0,9999,1
1713310757854,EDS 115,A00,507243,Choi; Bailey Miyeon,28,0,28,0
1713310758878,EDS 117,A01,494379,Staff,25,0,25,0
1713310759909,EDS 125,A00,507246,Hopkins; Megan Beth,29,0,30,1
1713310760935,EDS 128A,A01,507264,Fargason; Sharon Gayle,26,0,26,0
1713310761959,EDS 128B,A01,507293,Pappas; Elizabeth,30,0,30,0
1713310762985,EDS 139,A00,507294,Fargason; Sharon Gayle,30,0,30,0
1713310762985,EDS 139,B00,507313,Pappas; Elizabeth,30,0,30,0
1713310764010,EDS 201,A00,507315,Staff,26,0,30,4
1713310765057,EDS 203,A01,507317,Halter; Christopher P.,26,0,30,4
1713310766082,EDS 204R,A01,507319,Halter; Christopher P.,5,0,30,25
1713310766082,EDS 204R,B01,507331,Heinzman; Erica M.,30,0,30,0
1713310767106,EDS 206R,A00,507332,Staff,7,0,30,23
1713310767106,EDS 206R,B00,507343,Staff,29,0,30,1
1713310768131,EDS 250,A00,507344,Hemans; Patricia Ann Benitez,36,0,40,4
1713310769163,EDS 281,A00,507345,Daly; Alan J.,18,0,18,0
1713310770191,EDS 284,A00,507350,Daly; Alan J.,16,0,16,0
1713310771217,EDS 286,A00,507359,Fine; Sarah,18,0,18,0
1713310772243,EDS 289C,A01,507361,Daly; Alan J.,18,0,18,0
1713310773272,EDS 290,A00,507366,Hofstetter; Carolyn,15,0,15,0
1713310774298,LIGM 5A,A00,507421,Fischer-Grunski; Eva K,20,0,20,0
1713310775327,LIGM 5B,A00,507423,Fischer-Grunski; Eva K,20,0,20,0
1713310776355,LIGM 5C,A00,507425,Fischer-Grunski; Eva K,20,0,20,0
1713310777380,LIIT 5AS,A00,507427,Carnelos; Chiara,20,0,20,0
1713310778461,LIIT 5BS,A00,507430,Carnelos; Chiara,20,0,20,0
1713310779488,LIIT 5CS,A00,507432,Carnelos; Chiara,20,0,20,0
1713310780519,LISP 5A,A00,507541,Munoz Sanchez; Alicia,19,0,20,1
1713310781546,LISP 5B,A00,507671,Munoz Sanchez; Alicia,17,0,20,3
1713310782571,LISP 5C,A00,507696,Munoz Sanchez; Alicia,17,0,20,3
1713310783597,MAE 197,001,528363,Boechler; Nicholas Sebastia,9998,0,9999,1
1713310784625,MATH 197,001,523477,Kedlaya; Kiran S.,9999,0,9999,0
1713310784625,MATH 197,002,563811,Zhang; Danna,9999,0,9999,0
1713310785654,MCWP 40R,A00,518780,Staff,20,0,20,0
1713310785654,MCWP 40R,B00,518781,Staff,19,0,20,1
1713310785654,MCWP 40R,C00,518783,Staff,19,0,20,1
1713310786685,MCWP 50R,A00,518791,Staff,20,0,20,0
1713310786685,MCWP 50R,B00,518792,Staff,19,0,20,1
1713310786685,MCWP 50R,C00,518793,Staff,19,0,20,1
1713310786685,MCWP 50R,D00,518794,Staff,18,0,20,2
1713310786685,MCWP 50R,E00,518795,Staff,18,0,20,2
1713310786685,MCWP 50R,F00,518796,Staff,19,0,20,1
1713310786685,MCWP 50R,G00,518797,Staff,19,0,20,1
1713310787711,MMW 12R,A01,514034,Herbst; Matthew,16,0,16,0
1713310787711,MMW 12R,A02,514035,Herbst; Matthew,16,0,16,0
1713310788735,MMW 13R,A01,514037,Staff,13,0,16,3
1713310788735,MMW 13R,A02,514039,Staff,16,0,16,0
1713310790784,SIO 295LS,A00,523233,Staff,19,0,30,11
1713310791807,SIO 295S,A00,523232,Staff,19,0,30,11
1713310792836,SOCI 117,A01,494376,Staff,3,0,5,2
1713310793863,WES 237B,A00,494380,Staff,19,0,20,1
1713310795939,AESE 279B,A00,494370,Wade; Jon P,33,0,33,0
1713310796968,ANAR 135S,A00,494369,Braswell; Geoffrey E.,0,0,0,0
1713310797992,CAT 124RS,A01,519847,Geibel; William,17,0,20,3
1713310799020,CAT 125RS,A01,515971,Geibel; William,17,0,20,3
1713310800053,CLRE 250,A00,511389,Morris; Sheldon,9996,0,9999,3
1713310801080,CLRE 251,A00,507176,Mehta; Ravindra L.,9996,0,9999,3
1713310801080,CLRE 251,B00,511410,Mehta; Ravindra L.,9998,0,9999,1
1713310802105,CLRE 252,A00,507189,Cuomo; Raphael Eduardo,9998,0,9999,1
1713310803135,CLRE 253,A00,507199,Vaida; Florin,9997,0,9999,2
1713310803135,CLRE 253,B00,507202,Vaida; Florin,9999,0,9999,0
1713310804164,CLRE 259,A00,507211,Patel; Hemal,9996,0,9999,3
1713310805191,CLRE 260,A00,507221,Cuomo; Raphael Eduardo,9999,0,9999,0
1713310806220,CLRE 297,001,507242,Cuomo; Raphael Eduardo,9999,0,9999,0
1713310807244,CSE 191,A00,516875,Minnes Kemp; Mor Mia,9999,0,9999,0
1713310808273,CSS 201S,A01,494383,Staff,35,0,35,0
1713310809302,CSS 202S,A01,494387,Staff,35,0,35,0
1713310810328,EAP 100,A00,516065,Staff,9792,0,9999,207
1713310811358,ECE 45,A01,507414,Staff,54,0,60,6
1713310812422,ECE 100,A01,507416,Baghdadchi; Saharnaz,11,0,20,9
1713310812422,ECE 100,A02,507418,Baghdadchi; Saharnaz,20,0,20,0
1713310813448,ECE 111,A01,507420,Staff,40,0,50,10
1713310814473,ECE 197,001,548057,Sievenpiper; Daniel F.,9998,0,9999,1
1713310815498,EDS 115,A00,507243,Choi; Bailey Miyeon,28,0,28,0
1713310816523,EDS 117,A01,494379,Staff,25,0,25,0
1713310817551,EDS 125,A00,507246,Hopkins; Megan Beth,29,0,30,1
1713310818577,EDS 128A,A01,507264,Fargason; Sharon Gayle,26,0,26,0
1713310819607,EDS 128B,A01,507293,Pappas; Elizabeth,30,0,30,0
1713310820637,EDS 139,A00,507294,Fargason; Sharon Gayle,30,0,30,0
1713310820637,EDS 139,B00,507313,Pappas; Elizabeth,30,0,30,0
1713310821662,EDS 201,A00,507315,Staff,26,0,30,4
1713310822688,EDS 203,A01,507317,Halter; Christopher P.,26,0,30,4
1713310823714,EDS 204R,A01,507319,Halter; Christopher P.,5,0,30,25
1713310823714,EDS 204R,B01,507331,Heinzman; Erica M.,30,0,30,0
1713310824738,EDS 206R,A00,507332,Staff,7,0,30,23
1713310824738,EDS 206R,B00,507343,Staff,29,0,30,1
1713310825764,EDS 250,A00,507344,Hemans; Patricia Ann Benitez,36,0,40,4
1713310826791,EDS 281,A00,507345,Daly; Alan J.,18,0,18,0
1713310827819,EDS 284,A00,507350,Daly; Alan J.,16,0,16,0
1713310828845,EDS 286,A00,507359,Fine; Sarah,18,0,18,0
1713310829870,EDS 289C,A01,507361,Daly; Alan J.,18,0,18,0
1713310830896,EDS 290,A00,507366,Hofstetter; Carolyn,15,0,15,0
1713310831924,LIGM 5A,A00,507421,Fischer-Grunski; Eva K,20,0,20,0
1713310832954,LIGM 5B,A00,507423,Fischer-Grunski; Eva K,20,0,20,0
1713310833979,LIGM 5C,A00,507425,Fischer-Grunski; Eva K,20,0,20,0
1713310835007,LIIT 5AS,A00,507427,Carnelos; Chiara,20,0,20,0
1713310836032,LIIT 5BS,A00,507430,Carnelos; Chiara,20,0,20,0
1713310837061,LIIT 5CS,A00,507432,Carnelos; Chiara,20,0,20,0
1713310838091,LISP 5A,A00,507541,Munoz Sanchez; Alicia,19,0,20,1
1713310839115,LISP 5B,A00,507671,Munoz Sanchez; Alicia,17,0,20,3
1713310840144,LISP 5C,A00,507696,Munoz Sanchez; Alicia,17,0,20,3
1713310841169,MAE 197,001,528363,Boechler; Nicholas Sebastia,9998,0,9999,1
1713310842197,MATH 197,001,523477,Kedlaya; Kiran S.,9999,0,9999,0
1713310842197,MATH 197,002,563811,Zhang; Danna,9999,0,9999,0
1713310843222,MCWP 40R,A00,518780,Staff,20,0,20,0
1713310843222,MCWP 40R,B00,518781,Staff,19,0,20,1
1713310843222,MCWP 40R,C00,518783,Staff,19,0,20,1
1713310844248,MCWP 50R,A00,518791,Staff,20,0,20,0
1713310844248,MCWP 50R,B00,518792,Staff,19,0,20,1
1713310844248,MCWP 50R,C00,518793,Staff,19,0,20,1
1713310844248,MCWP 50R,D00,518794,Staff,18,0,20,2
1713310844248,MCWP 50R,E00,518795,Staff,18,0,20,2
1713310844248,MCWP 50R,F00,518796,Staff,19,0,20,1
1713310844248,MCWP 50R,G00,518797,Staff,19,0,20,1
1713310845273,MMW 12R,A01,514034,Herbst; Matthew,16,0,16,0
1713310845273,MMW 12R,A02,514035,Herbst; Matthew,16,0,16,0
1713310846298,MMW 13R,A01,514037,Staff,13,0,16,3
1713310846298,MMW 13R,A02,514039,Staff,16,0,16,0
1713310848349,SIO 295LS,A00,523233,Staff,19,0,30,11
1713310849374,SIO 295S,A00,523232,Staff,19,0,30,11
1713310850399,SOCI 117,A01,494376,Staff,3,0,5,2
1713310851422,WES 237B,A00,494380,Staff,19,0,20,1
1713310853498,AESE 279B,A00,494370,Wade; Jon P,33,0,33,0
1713310854526,ANAR 135S,A00,494369,Braswell; Geoffrey E.,0,0,0,0
1713310855554,CAT 124RS,A01,519847,Geibel; William,17,0,20,3
1713310856580,CAT 125RS,A01,515971,Geibel; William,17,0,20,3
1713310857605,CLRE 250,A00,511389,Morris; Sheldon,9996,0,9999,3
1713310858631,CLRE 251,A00,507176,Mehta; Ravindra L.,9996,0,9999,3
1713310858631,CLRE 251,B00,511410,Mehta; Ravindra L.,9998,0,9999,1
1713310859655,CLRE 252,A00,507189,Cuomo; Raphael Eduardo,9998,0,9999,1
1713310860683,CLRE 253,A00,507199,Vaida; Florin,9997,0,9999,2
1713310860683,CLRE 253,B00,507202,Vaida; Florin,9999,0,9999,0
1713310861709,CLRE 259,A00,507211,Patel; Hemal,9996,0,9999,3
1713310862733,CLRE 260,A00,507221,Cuomo; Raphael Eduardo,9999,0,9999,0
1713310863758,CLRE 297,001,507242,Cuomo; Raphael Eduardo,9999,0,9999,0
1713310864783,CSE 191,A00,516875,Minnes Kemp; Mor Mia,9999,0,9999,0
1713310865813,CSS 201S,A01,494383,Staff,35,0,35,0
1713310866838,CSS 202S,A01,494387,Staff,35,0,35,0
1713310867862,EAP 100,A00,516065,Staff,9792,0,9999,207
1713310868891,ECE 45,A01,507414,Staff,54,0,60,6
1713310869917,ECE 100,A01,507416,Baghdadchi; Saharnaz,11,0,20,9
1713310869917,ECE 100,A02,507418,Baghdadchi; Saharnaz,20,0,20,0
1713310870945,ECE 111,A01,507420,Staff,40,0,50,10
1713310871973,ECE 197,001,548057,Sievenpiper; Daniel F.,9998,0,9999,1
1713310872999,EDS 115,A00,507243,Choi; Bailey Miyeon,28,0,28,0
1713310874025,EDS 117,A01,494379,Staff,25,0,25,0
1713310875051,EDS 125,A00,507246,Hopkins; Megan Beth,29,0,30,1
1713310876075,EDS 128A,A01,507264,Fargason; Sharon Gayle,26,0,26,0
1713310877103,EDS 128B,A01,507293,Pappas; Elizabeth,30,0,30,0
1713310878129,EDS 139,A00,507294,Fargason; Sharon Gayle,30,0,30,0
1713310878129,EDS 139,B00,507313,Pappas; Elizabeth,30,0,30,0
1713310879154,EDS 201,A00,507315,Staff,26,0,30,4
1713310881241,EDS 203,A01,507317,Halter; Christopher P.,26,0,30,4
1713310882271,EDS 204R,A01,507319,Halter; Christopher P.,5,0,30,25
1713310882271,EDS 204R,B01,507331,Heinzman; Erica M.,30,0,30,0
1713310883348,EDS 206R,A00,507332,Staff,7,0,30,23
1713310883348,EDS 206R,B00,507343,Staff,29,0,30,1
1713310884372,EDS 250,A00,507344,Hemans; Patricia Ann Benitez,36,0,40,4
1713310885398,EDS 281,A00,507345,Daly; Alan J.,18,0,18,0
1713310886426,EDS 284,A00,507350,Daly; Alan J.,16,0,16,0
1713310887452,EDS 286,A00,507359,Fine; Sarah,18,0,18,0
1713310888476,EDS 289C,A01,507361,Daly; Alan J.,18,0,18,0
1713310889504,EDS 290,A00,507366,Hofstetter; Carolyn,15,0,15,0
1713310890530,LIGM 5A,A00,507421,Fischer-Grunski; Eva K,20,0,20,0
1713310891567,LIGM 5B,A00,507423,Fischer-Grunski; Eva K,20,0,20,0
1713310892610,LIGM 5C,A00,507425,Fischer-Grunski; Eva K,20,0,20,0
1713310893641,LIIT 5AS,A00,507427,Carnelos; Chiara,20,0,20,0
1713310894666,LIIT 5BS,A00,507430,Carnelos; Chiara,20,0,20,0
1713310895692,LIIT 5CS,A00,507432,Carnelos; Chiara,20,0,20,0
1713310896719,LISP 5A,A00,507541,Munoz Sanchez; Alicia,19,0,20,1
1713310897748,LISP 5B,A00,507671,Munoz Sanchez; Alicia,17,0,20,3
1713310898773,LISP 5C,A00,507696,Munoz Sanchez; Alicia,17,0,20,3
1713310899799,MAE 197,001,528363,Boechler; Nicholas Sebastia,9998,0,9999,1
1713310900826,MATH 197,001,523477,Kedlaya; Kiran S.,9999,0,9999,0
1713310900826,MATH 197,002,563811,Zhang; Danna,9999,0,9999,0
1713310901852,MCWP 40R,A00,518780,Staff,20,0,20,0
1713310901852,MCWP 40R,B00,518781,Staff,19,0,20,1
1713310901852,MCWP 40R,C00,518783,Staff,19,0,20,1
1713310902881,MCWP 50R,A00,518791,Staff,20,0,20,0
1713310902881,MCWP 50R,B00,518792,Staff,19,0,20,1
1713310902881,MCWP 50R,C00,518793,Staff,19,0,20,1
1713310902881,MCWP 50R,D00,518794,Staff,18,0,20,2
1713310902881,MCWP 50R,E00,518795,Staff,18,0,20,2
1713310902881,MCWP 50R,F00,518796,Staff,19,0,20,1
1713310902881,MCWP 50R,G00,518797,Staff,19,0,20,1
1713310903907,MMW 12R,A01,514034,Herbst; Matthew,16,0,16,0
1713310903907,MMW 12R,A02,514035,Herbst; Matthew,16,0,16,0
1713310904948,MMW 13R,A01,514037,Staff,13,0,16,3
1713310904948,MMW 13R,A02,514039,Staff,16,0,16,0
1713310907006,SIO 295LS,A00,523233,Staff,19,0,30,11
1713310908036,SIO 295S,A00,523232,Staff,19,0,30,11
1713310909061,SOCI 117,A01,494376,Staff,3,0,5,2
1713310910087,WES 237B,A00,494380,Staff,19,0,20,1
1713310912165,AESE 279B,A00,494370,Wade; Jon P,33,0,33,0
1713310913191,ANAR 135S,A00,494369,Braswell; Geoffrey E.,0,0,0,0
1713310914222,CAT 124RS,A01,519847,Geibel; William,17,0,20,3
1713310915246,CAT 125RS,A01,515971,Geibel; William,17,0,20,3
1713310916275,CLRE 250,A00,511389,Morris; Sheldon,9996,0,9999,3
1713310917304,CLRE 251,A00,507176,Mehta; Ravindra L.,9996,0,9999,3
1713310917304,CLRE 251,B00,511410,Mehta; Ravindra L.,9998,0,9999,1
1713310918329,CLRE 252,A00,507189,Cuomo; Raphael Eduardo,9998,0,9999,1
1713310919355,CLRE 253,A00,507199,Vaida; Florin,9997,0,9999,2
1713310919355,CLRE 253,B00,507202,Vaida; Florin,9999,0,9999,0
1713310920385,CLRE 259,A00,507211,Patel; Hemal,9996,0,9999,3
1713310921410,CLRE 260,A00,507221,Cuomo; Raphael Eduardo,9999,0,9999,0
1713310922434,CLRE 297,001,507242,Cuomo; Raphael Eduardo,9999,0,9999,0
1713310923462,CSE 191,A00,516875,Minnes Kemp; Mor Mia,9999,0,9999,0
1713310924493,CSS 201S,A01,494383,Staff,35,0,35,0
1713310925522,CSS 202S,A01,494387,Staff,35,0,35,0
1713310926546,EAP 100,A00,516065,Staff,9792,0,9999,207
1713310927576,ECE 45,A01,507414,Staff,54,0,60,6
1713310928602,ECE 100,A01,507416,Baghdadchi; Saharnaz,11,0,20,9
1713310928602,ECE 100,A02,507418,Baghdadchi; Saharnaz,20,0,20,0
1713310929626,ECE 111,A01,507420,Staff,40,0,50,10
1713310930652,ECE 197,001,548057,Sievenpiper; Daniel F.,9998,0,9999,1
1713310931681,EDS 115,A00,507243,Choi; Bailey Miyeon,28,0,28,0
1713310932709,EDS 117,A01,494379,Staff,25,0,25,0
1713310933733,EDS 125,A00,507246,Hopkins; Megan Beth,29,0,30,1
1713310934758,EDS 128A,A01,507264,Fargason; Sharon Gayle,26,0,26,0
1713310935788,EDS 128B,A01,507293,Pappas; Elizabeth,30,0,30,0
1713310936816,EDS 139,A00,507294,Fargason; Sharon Gayle,30,0,30,0
1713310936816,EDS 139,B00,507313,Pappas; Elizabeth,30,0,30,0
1713310937844,EDS 201,A00,507315,Staff,26,0,30,4
1713310938874,EDS 203,A01,507317,Halter; Christopher P.,26,0,30,4
1713310939902,EDS 204R,A01,507319,Halter; Christopher P.,5,0,30,25
1713310939902,EDS 204R,B01,507331,Heinzman; Erica M.,30,0,30,0
1713310940928,EDS 206R,A00,507332,Staff,7,0,30,23
1713310940928,EDS 206R,B00,507343,Staff,29,0,30,1
1713310941960,EDS 250,A00,507344,Hemans; Patricia Ann Benitez,36,0,40,4
1713310942985,EDS 281,A00,507345,Daly; Alan J.,18,0,18,0
1713310944010,EDS 284,A00,507350,Daly; Alan J.,16,0,16,0
1713310945038,EDS 286,A00,507359,Fine; Sarah,18,0,18,0
1713310946063,EDS 289C,A01,507361,Daly; Alan J.,18,0,18,0
1713310947088,EDS 290,A00,507366,Hofstetter; Carolyn,15,0,15,0
1713310948114,LIGM 5A,A00,507421,Fischer-Grunski; Eva K,20,0,20,0
1713310949140,LIGM 5B,A00,507423,Fischer-Grunski; Eva K,20,0,20,0
1713310950168,LIGM 5C,A00,507425,Fischer-Grunski; Eva K,20,0,20,0
1713310951196,LIIT 5AS,A00,507427,Carnelos; Chiara,20,0,20,0
1713310952234,LIIT 5BS,A00,507430,Carnelos; Chiara,20,0,20,0
1713310953262,LIIT 5CS,A00,507432,Carnelos; Chiara,20,0,20,0
1713310954289,LISP 5A,A00,507541,Munoz Sanchez; Alicia,19,0,20,1
1713310955316,LISP 5B,A00,507671,Munoz Sanchez; Alicia,17,0,20,3
1713310956342,LISP 5C,A00,507696,Munoz Sanchez; Alicia,17,0,20,3
1713310957369,MAE 197,001,528363,Boechler; Nicholas Sebastia,9998,0,9999,1
1713310958406,MATH 197,001,523477,Kedlaya; Kiran S.,9999,0,9999,0
1713310958406,MATH 197,002,563811,Zhang; Danna,9999,0,9999,0
1713310959430,MCWP 40R,A00,518780,Staff,20,0,20,0
1713310959430,MCWP 40R,B00,518781,Staff,19,0,20,1
1713310959430,MCWP 40R,C00,518783,Staff,19,0,20,1
1713310960457,MCWP 50R,A00,518791,Staff,20,0,20,0
1713310960457,MCWP 50R,B00,518792,Staff,19,0,20,1
1713310960457,MCWP 50R,C00,518793,Staff,19,0,20,1
1713310960457,MCWP 50R,D00,518794,Staff,18,0,20,2
1713310960457,MCWP 50R,E00,518795,Staff,18,0,20,2
1713310960457,MCWP 50R,F00,518796,Staff,19,0,20,1
1713310960457,MCWP 50R,G00,518797,Staff,19,0,20,1
1713310961486,MMW 12R,A01,514034,Herbst; Matthew,16,0,16,0
1713310961486,MMW 12R,A02,514035,Herbst; Matthew,16,0,16,0
1713310962509,MMW 13R,A01,514037,Staff,13,0,16,3
1713310962509,MMW 13R,A02,514039,Staff,16,0,16,0
1713310964567,SIO 295LS,A00,523233,Staff,19,0,30,11
1713310965592,SIO 295S,A00,523232,Staff,19,0,30,11
1713310966620,SOCI 117,A01,494376,Staff,3,0,5,2
1713310967648,WES 237B,A00,494380,Staff,19,0,20,1
1713310969720,AESE 279B,A00,494370,Wade; Jon P,33,0,33,0
1713310970748,ANAR 135S,A00,494369,Braswell; Geoffrey E.,0,0,0,0
1713310971774,CAT 124RS,A01,519847,Geibel; William,17,0,20,3
1713310972804,CAT 125RS,A01,515971,Geibel; William,17,0,20,3
1713310973831,CLRE 250,A00,511389,Morris; Sheldon,9996,0,9999,3
1713310974862,CLRE 251,A00,507176,Mehta; Ravindra L.,9996,0,9999,3
1713310974862,CLRE 251,B00,511410,Mehta; Ravindra L.,9998,0,9999,1
1713310975889,CLRE 252,A00,507189,Cuomo; Raphael Eduardo,9998,0,9999,1
1713310976916,CLRE 253,A00,507199,Vaida; Florin,9997,0,9999,2
1713310976916,CLRE 253,B00,507202,Vaida; Florin,9999,0,9999,0
1713310977941,CLRE 259,A00,507211,Patel; Hemal,9996,0,9999,3
1713310978969,CLRE 260,A00,507221,Cuomo; Raphael Eduardo,9999,0,9999,0
1713310979996,CLRE 297,001,507242,Cuomo; Raphael Eduardo,9999,0,9999,0
1713310981020,CSE 191,A00,516875,Minnes Kemp; Mor Mia,9999,0,9999,0
1713310982046,CSS 201S,A01,494383,Staff,35,0,35,0
1713310983070,CSS 202S,A01,494387,Staff,35,0,35,0
1713310984094,EAP 100,A00,516065,Staff,9792,0,9999,207
1713310985122,ECE 45,A01,507414,Staff,54,0,60,6
1713310986152,ECE 100,A01,507416,Baghdadchi; Saharnaz,11,0,20,9
1713310986152,ECE 100,A02,507418,Baghdadchi; Saharnaz,20,0,20,0
1713310987233,ECE 111,A01,507420,Staff,40,0,50,10
1713310988264,ECE 197,001,548057,Sievenpiper; Daniel F.,9998,0,9999,1
1713310989289,EDS 115,A00,507243,Choi; Bailey Miyeon,28,0,28,0
1713310990314,EDS 117,A01,494379,Staff,25,0,25,0
1713310991339,EDS 125,A00,507246,Hopkins; Megan Beth,29,0,30,1
1713310992364,EDS 128A,A01,507264,Fargason; Sharon Gayle,26,0,26,0
1713310993388,EDS 128B,A01,507293,Pappas; Elizabeth,30,0,30,0
1713310994419,EDS 139,A00,507294,Fargason; Sharon Gayle,30,0,30,0
1713310994419,EDS 139,B00,507313,Pappas; Elizabeth,30,0,30,0
1713310995447,EDS 201,A00,507315,Staff,26,0,30,4
1713310996476,EDS 203,A01,507317,Halter; Christopher P.,26,0,30,4
1713310998805,EDS 204R,A01,507319,Halter; Christopher P.,5,0,30,25
1713310998805,EDS 204R,B01,507331,Heinzman; Erica M.,30,0,30,0
1713310999829,EDS 206R,A00,507332,Staff,7,0,30,23
1713310999829,EDS 206R,B00,507343,Staff,29,0,30,1
1713311000858,EDS 250,A00,507344,Hemans; Patricia Ann Benitez,36,0,40,4
1713311002468,EDS 281,A00,507345,Daly; Alan J.,18,0,18,0
1713311003497,EDS 284,A00,507350,Daly; Alan J.,16,0,16,0
1713311004526,EDS 286,A00,507359,Fine; Sarah,18,0,18,0
1713311005553,EDS 289C,A01,507361,Daly; Alan J.,18,0,18,0
1713311006581,EDS 290,A00,507366,Hofstetter; Carolyn,15,0,15,0
1713311007605,LIGM 5A,A00,507421,Fischer-Grunski; Eva K,20,0,20,0
1713311008634,LIGM 5B,A00,507423,Fischer-Grunski; Eva K,20,0,20,0
1713311009661,LIGM 5C,A00,507425,Fischer-Grunski; Eva K,20,0,20,0
1713311010685,LIIT 5AS,A00,507427,Carnelos; Chiara,20,0,20,0
1713311011708,LIIT 5BS,A00,507430,Carnelos; Chiara,20,0,20,0
1713311012735,LIIT 5CS,A00,507432,Carnelos; Chiara,20,0,20,0
1713311013761,LISP 5A,A00,507541,Munoz Sanchez; Alicia,19,0,20,1
1713311014785,LISP 5B,A00,507671,Munoz Sanchez; Alicia,17,0,20,3
1713311015809,LISP 5C,A00,507696,Munoz Sanchez; Alicia,17,0,20,3
1713311016834,MAE 197,001,528363,Boechler; Nicholas Sebastia,9998,0,9999,1
1713311017858,MATH 197,001,523477,Kedlaya; Kiran S.,9999,0,9999,0
1713311017858,MATH 197,002,563811,Zhang; Danna,9999,0,9999,0
1713311018883,MCWP 40R,A00,518780,Staff,20,0,20,0
1713311018883,MCWP 40R,B00,518781,Staff,19,0,20,1
1713311018883,MCWP 40R,C00,518783,Staff,19,0,20,1
1713311019914,MCWP 50R,A00,518791,Staff,20,0,20,0
1713311019914,MCWP 50R,B00,518792,Staff,19,0,20,1
1713311019914,MCWP 50R,C00,518793,Staff,19,0,20,1
1713311019914,MCWP 50R,D00,518794,Staff,18,0,20,2
1713311019914,MCWP 50R,E00,518795,Staff,18,0,20,2
1713311019914,MCWP 50R,F00,518796,Staff,19,0,20,1
1713311019914,MCWP 50R,G00,518797,Staff,19,0,20,1
1713311020937,MMW 12R,A01,514034,Herbst; Matthew,16,0,16,0
1713311020937,MMW 12R,A02,514035,Herbst; Matthew,16,0,16,0
1713311021961,MMW 13R,A01,514037,Staff,13,0,16,3
1713311021961,MMW 13R,A02,514039,Staff,16,0,16,0
1713311024014,SIO 295LS,A00,523233,Staff,19,0,30,11
1713311025036,SIO 295S,A00,523232,Staff,19,0,30,11
1713311026069,SOCI 117,A01,494376,Staff,3,0,5,2
1713311027094,WES 237B,A00,494380,Staff,19,0,20,1
1713311029181,AESE 279B,A00,494370,Wade; Jon P,33,0,33,0
1713311030216,ANAR 135S,A00,494369,Braswell; Geoffrey E.,0,0,0,0
1713311031244,CAT 124RS,A01,519847,Geibel; William,17,0,20,3
1713311032269,CAT 125RS,A01,515971,Geibel; William,17,0,20,3
1713311033294,CLRE 250,A00,511389,Morris; Sheldon,9996,0,9999,3
1713311034319,CLRE 251,A00,507176,Mehta; Ravindra L.,9996,0,9999,3
1713311034319,CLRE 251,B00,511410,Mehta; Ravindra L.,9998,0,9999,1
1713311035345,CLRE 252,A00,507189,Cuomo; Raphael Eduardo,9998,0,9999,1
1713311036370,CLRE 253,A00,507199,Vaida; Florin,9997,0,9999,2
1713311036370,CLRE 253,B00,507202,Vaida; Florin,9999,0,9999,0
1713311037400,CLRE 259,A00,507211,Patel; Hemal,9996,0,9999,3
1713311038426,CLRE 260,A00,507221,Cuomo; Raphael Eduardo,9999,0,9999,0
1713311039453,CLRE 297,001,507242,Cuomo; Raphael Eduardo,9999,0,9999,0
1713311040477,CSE 191,A00,516875,Minnes Kemp; Mor Mia,9999,0,9999,0
1713311041500,CSS 201S,A01,494383,Staff,35,0,35,0
1713311042531,CSS 202S,A01,494387,Staff,35,0,35,0
1713311043559,EAP 100,A00,516065,Staff,9792,0,9999,207
1713311044583,ECE 45,A01,507414,Staff,54,0,60,6
1713311045613,ECE 100,A01,507416,Baghdadchi; Saharnaz,11,0,20,9
1713311045613,ECE 100,A02,507418,Baghdadchi; Saharnaz,20,0,20,0
1713311046638,ECE 111,A01,507420,Staff,40,0,50,10
1713311047665,ECE 197,001,548057,Sievenpiper; Daniel F.,9998,0,9999,1
1713311048694,EDS 115,A00,507243,Choi; Bailey Miyeon,28,0,28,0
1713311049719,EDS 117,A01,494379,Staff,25,0,25,0
1713311050747,EDS 125,A00,507246,Hopkins; Megan Beth,29,0,30,1
1713311051773,EDS 128A,A01,507264,Fargason; Sharon Gayle,26,0,26,0
1713311052804,EDS 128B,A01,507293,Pappas; Elizabeth,30,0,30,0
1713311053831,EDS 139,A00,507294,Fargason; Sharon Gayle,30,0,30,0
1713311053831,EDS 139,B00,507313,Pappas; Elizabeth,30,0,30,0
1713311054860,EDS 201,A00,507315,Staff,26,0,30,4
1713311055890,EDS 203,A01,507317,Halter; Christopher P.,26,0,30,4
1713311056915,EDS 204R,A01,507319,Halter; Christopher P.,5,0,30,25
1713311056915,EDS 204R,B01,507331,Heinzman; Erica M.,30,0,30,0
1713311057943,EDS 206R,A00,507332,Staff,7,0,30,23
1713311057943,EDS 206R,B00,507343,Staff,29,0,30,1
1713311058968,EDS 250,A00,507344,Hemans; Patricia Ann Benitez,36,0,40,4
1713311059995,EDS 281,A00,507345,Daly; Alan J.,18,0,18,0
1713311061019,EDS 284,A00,507350,Daly; Alan J.,16,0,16,0
1713311062045,EDS 286,A00,507359,Fine; Sarah,18,0,18,0
1713311063073,EDS 289C,A01,507361,Daly; Alan J.,18,0,18,0
1713311064103,EDS 290,A00,507366,Hofstetter; Carolyn,15,0,15,0
1713311065129,LIGM 5A,A00,507421,Fischer-Grunski; Eva K,20,0,20,0
1713311066154,LIGM 5B,A00,507423,Fischer-Grunski; Eva K,20,0,20,0
1713311067183,LIGM 5C,A00,507425,Fischer-Grunski; Eva K,20,0,20,0
1713311068212,LIIT 5AS,A00,507427,Carnelos; Chiara,20,0,20,0
1713311069238,LIIT 5BS,A00,507430,Carnelos; Chiara,20,0,20,0
1713311070264,LIIT 5CS,A00,507432,Carnelos; Chiara,20,0,20,0
1713311071289,LISP 5A,A00,507541,Munoz Sanchez; Alicia,19,0,20,1
1713311072314,LISP 5B,A00,507671,Munoz Sanchez; Alicia,17,0,20,3
1713311073337,LISP 5C,A00,507696,Munoz Sanchez; Alicia,17,0,20,3
1713311074365,MAE 197,001,528363,Boechler; Nicholas Sebastia,9998,0,9999,1
1713311075392,MATH 197,001,523477,Kedlaya; Kiran S.,9999,0,9999,0
1713311075392,MATH 197,002,563811,Zhang; Danna,9999,0,9999,0
1713311076416,MCWP 40R,A00,518780,Staff,20,0,20,0
1713311076416,MCWP 40R,B00,518781,Staff,19,0,20,1
1713311076416,MCWP 40R,C00,518783,Staff,19,0,20,1
1713311077443,MCWP 50R,A00,518791,Staff,20,0,20,0
1713311077443,MCWP 50R,B00,518792,Staff,19,0,20,1
1713311077443,MCWP 50R,C00,518793,Staff,19,0,20,1
1713311077443,MCWP 50R,D00,518794,Staff,18,0,20,2
1713311077443,MCWP 50R,E00,518795,Staff,18,0,20,2
1713311077443,MCWP 50R,F00,518796,Staff,19,0,20,1
1713311077443,MCWP 50R,G00,518797,Staff,19,0,20,1
1713311078471,MMW 12R,A01,514034,Herbst; Matthew,16,0,16,0
1713311078471,MMW 12R,A02,514035,Herbst; Matthew,16,0,16,0
1713311079499,MMW 13R,A01,514037,Staff,13,0,16,3
1713311079499,MMW 13R,A02,514039,Staff,16,0,16,0
1713311081552,SIO 295LS,A00,523233,Staff,19,0,30,11
1713311082580,SIO 295S,A00,523232,Staff,19,0,30,11
1713311083605,SOCI 117,A01,494376,Staff,3,0,5,2
1713311084630,WES 237B,A00,494380,Staff,19,0,20,1
1713311086700,AESE 279B,A00,494370,Wade; Jon P,33,0,33,0
1713311087725,ANAR 135S,A00,494369,Braswell; Geoffrey E.,0,0,0,0
1713311088750,CAT 124RS,A01,519847,Geibel; William,17,0,20,3
1713311089775,CAT 125RS,A01,515971,Geibel; William,17,0,20,3
1713311090802,CLRE 250,A00,511389,Morris; Sheldon,9996,0,9999,3
1713311091833,CLRE 251,A00,507176,Mehta; Ravindra L.,9996,0,9999,3
1713311091833,CLRE 251,B00,511410,Mehta; Ravindra L.,9998,0,9999,1
1713311092912,CLRE 252,A00,507189,Cuomo; Raphael Eduardo,9998,0,9999,1
1713311093937,CLRE 253,A00,507199,Vaida; Florin,9997,0,9999,2
1713311093937,CLRE 253,B00,507202,Vaida; Florin,9999,0,9999,0
1713311094962,CLRE 259,A00,507211,Patel; Hemal,9996,0,9999,3
1713311095987,CLRE 260,A00,507221,Cuomo; Raphael Eduardo,9999,0,9999,0
1713311097013,CLRE 297,001,507242,Cuomo; Raphael Eduardo,9999,0,9999,0
1713311098038,CSE 191,A00,516875,Minnes Kemp; Mor Mia,9999,0,9999,0
1713311099064,CSS 201S,A01,494383,Staff,35,0,35,0
1713311100094,CSS 202S,A01,494387,Staff,35,0,35,0
1713311101119,EAP 100,A00,516065,Staff,9792,0,9999,207
1713311102149,ECE 45,A01,507414,Staff,54,0,60,6
1713311103177,ECE 100,A01,507416,Baghdadchi; Saharnaz,11,0,20,9
1713311103177,ECE 100,A02,507418,Baghdadchi; Saharnaz,20,0,20,0
1713311104205,ECE 111,A01,507420,Staff,40,0,50,10
1713311105235,ECE 197,001,548057,Sievenpiper; Daniel F.,9998,0,9999,1
1713311106260,EDS 115,A00,507243,Choi; Bailey Miyeon,28,0,28,0
1713311107284,EDS 117,A01,494379,Staff,25,0,25,0
1713311108313,EDS 125,A00,507246,Hopkins; Megan Beth,29,0,30,1
1713311109347,EDS 128A,A01,507264,Fargason; Sharon Gayle,26,0,26,0
1713311110371,EDS 128B,A01,507293,Pappas; Elizabeth,30,0,30,0
1713311111396,EDS 139,A00,507294,Fargason; Sharon Gayle,30,0,30,0
1713311111396,EDS 139,B00,507313,Pappas; Elizabeth,30,0,30,0
1713311112424,EDS 201,A00,507315,Staff,26,0,30,4
1713311113456,EDS 203,A01,507317,Halter; Christopher P.,26,0,30,4
1713311114489,EDS 204R,A01,507319,Halter; Christopher P.,5,0,30,25
1713311114489,EDS 204R,B01,507331,Heinzman; Erica M.,30,0,30,0
1713311115516,EDS 206R,A00,507332,Staff,7,0,30,23
1713311115516,EDS 206R,B00,507343,Staff,29,0,30,1
1713311116547,EDS 250,A00,507344,Hemans; Patricia Ann Benitez,36,0,40,4
1713311117575,EDS 281,A00,507345,Daly; Alan J.,18,0,18,0
1713311118600,EDS 284,A00,507350,Daly; Alan J.,16,0,16,0
1713311119626,EDS 286,A00,507359,Fine; Sarah,18,0,18,0
1713311120654,EDS 289C,A01,507361,Daly; Alan J.,18,0,18,0
1713311121679,EDS 290,A00,507366,Hofstetter; Carolyn,15,0,15,0
1713311122705,LIGM 5A,A00,507421,Fischer-Grunski; Eva K,20,0,20,0
1713311123734,LIGM 5B,A00,507423,Fischer-Grunski; Eva K,20,0,20,0
1713311124759,LIGM 5C,A00,507425,Fischer-Grunski; Eva K,20,0,20,0
1713311125782,LIIT 5AS,A00,507427,Carnelos; Chiara,20,0,20,0
1713311126810,LIIT 5BS,A00,507430,Carnelos; Chiara,20,0,20,0
1713311127839,LIIT 5CS,A00,507432,Carnelos; Chiara,20,0,20,0
1713311128865,LISP 5A,A00,507541,Munoz Sanchez; Alicia,19,0,20,1
1713311129894,LISP 5B,A00,507671,Munoz Sanchez; Alicia,17,0,20,3
1713311130924,LISP 5C,A00,507696,Munoz Sanchez; Alicia,17,0,20,3
1713311131954,MAE 197,001,528363,Boechler; Nicholas Sebastia,9998,0,9999,1
1713311132979,MATH 197,001,523477,Kedlaya; Kiran S.,9999,0,9999,0
1713311132979,MATH 197,002,563811,Zhang; Danna,9999,0,9999,0
1713311134004,MCWP 40R,A00,518780,Staff,20,0,20,0
1713311134004,MCWP 40R,B00,518781,Staff,19,0,20,1
1713311134004,MCWP 40R,C00,518783,Staff,19,0,20,1
1713311135033,MCWP 50R,A00,518791,Staff,20,0,20,0
1713311135033,MCWP 50R,B00,518792,Staff,19,0,20,1
1713311135033,MCWP 50R,C00,518793,Staff,19,0,20,1
1713311135033,MCWP 50R,D00,518794,Staff,18,0,20,2
1713311135033,MCWP 50R,E00,518795,Staff,18,0,20,2
1713311135033,MCWP 50R,F00,518796,Staff,19,0,20,1
1713311135033,MCWP 50R,G00,518797,Staff,19,0,20,1
1713311136059,MMW 12R,A01,514034,Herbst; Matthew,16,0,16,0
1713311136059,MMW 12R,A02,514035,Herbst; Matthew,16,0,16,0
1713311137084,MMW 13R,A01,514037,Staff,13,0,16,3
1713311137084,MMW 13R,A02,514039,Staff,16,0,16,0
1713311139136,SIO 295LS,A00,523233,Staff,19,0,30,11
1713311140163,SIO 295S,A00,523232,Staff,19,0,30,11
1713311141190,SOCI 117,A01,494376,Staff,3,0,5,2
1713311142217,WES 237B,A00,494380,Staff,19,0,20,1
1713311144284,AESE 279B,A00,494370,Wade; Jon P,33,0,33,0
1713311145351,ANAR 135S,A00,494369,Braswell; Geoffrey E.,0,0,0,0
1713311146379,CAT 124RS,A01,519847,Geibel; William,17,0,20,3
1713311147403,CAT 125RS,A01,515971,Geibel; William,17,0,20,3
1713311148433,CLRE 250,A00,511389,Morris; Sheldon,9996,0,9999,3
1713311149459,CLRE 251,A00,507176,Mehta; Ravindra L.,9996,0,9999,3
1713311149459,CLRE 251,B00,511410,Mehta; Ravindra L.,9998,0,9999,1
1713311150486,CLRE 252,A00,507189,Cuomo; Raphael Eduardo,9998,0,9999,1
1713311151511,CLRE 253,A00,507199,Vaida; Florin,9997,0,9999,2
1713311151511,CLRE 253,B00,507202,Vaida; Florin,9999,0,9999,0
1713311152537,CLRE 259,A00,507211,Patel; Hemal,9996,0,9999,3
1713311153562,CLRE 260,A00,507221,Cuomo; Raphael Eduardo,9999,0,9999,0
1713311154587,CLRE 297,001,507242,Cuomo; Raphael Eduardo,9999,0,9999,0
1713311155613,CSE 191,A00,516875,Minnes Kemp; Mor Mia,9999,0,9999,0
1713311156640,CSS 201S,A01,494383,Staff,35,0,35,0
1713311157666,CSS 202S,A01,494387,Staff,35,0,35,0
1713311158694,EAP 100,A00,516065,Staff,9792,0,9999,207
1713311159720,ECE 45,A01,507414,Staff,54,0,60,6
1713311160748,ECE 100,A01,507416,Baghdadchi; Saharnaz,11,0,20,9
1713311160748,ECE 100,A02,507418,Baghdadchi; Saharnaz,20,0,20,0
1713311161773,ECE 111,A01,507420,Staff,40,0,50,10
1713311162799,ECE 197,001,548057,Sievenpiper; Daniel F.,9998,0,9999,1
1713311163831,EDS 115,A00,507243,Choi; Bailey Miyeon,28,0,28,0
1713311164861,EDS 117,A01,494379,Staff,25,0,25,0
1713311165885,EDS 125,A00,507246,Hopkins; Megan Beth,29,0,30,1
1713311166915,EDS 128A,A01,507264,Fargason; Sharon Gayle,26,0,26,0
1713311167943,EDS 128B,A01,507293,Pappas; Elizabeth,30,0,30,0
1713311168972,EDS 139,A00,507294,Fargason; Sharon Gayle,30,0,30,0
1713311168972,EDS 139,B00,507313,Pappas; Elizabeth,30,0,30,0
1713311169996,EDS 201,A00,507315,Staff,26,0,30,4
1713311171029,EDS 203,A01,507317,Halter; Christopher P.,26,0,30,4
1713311172058,EDS 204R,A01,507319,Halter; Christopher P.,5,0,30,25
1713311172058,EDS 204R,B01,507331,Heinzman; Erica M.,30,0,30,0
1713311173089,EDS 206R,A00,507332,Staff,7,0,30,23
1713311173089,EDS 206R,B00,507343,Staff,29,0,30,1
1713311174117,EDS 250,A00,507344,Hemans; Patricia Ann Benitez,36,0,40,4
1713311175143,EDS 281,A00,507345,Daly; Alan J.,18,0,18,0
1713311176182,EDS 284,A00,507350,Daly; Alan J.,16,0,16,0
1713311177213,EDS 286,A00,507359,Fine; Sarah,18,0,18,0
1713311178237,EDS 289C,A01,507361,Daly; Alan J.,18,0,18,0
1713311179267,EDS 290,A00,507366,Hofstetter; Carolyn,15,0,15,0
1713311180295,LIGM 5A,A00,507421,Fischer-Grunski; Eva K,20,0,20,0
1713311181322,LIGM 5B,A00,507423,Fischer-Grunski; Eva K,20,0,20,0
1713311182351,LIGM 5C,A00,507425,Fischer-Grunski; Eva K,20,0,20,0
1713311183376,LIIT 5AS,A00,507427,Carnelos; Chiara,20,0,20,0
1713311184407,LIIT 5BS,A00,507430,Carnelos; Chiara,20,0,20,0
1713311185434,LIIT 5CS,A00,507432,Carnelos; Chiara,20,0,20,0
1713311186459,LISP 5A,A00,507541,Munoz Sanchez; Alicia,19,0,20,1
1713311187486,LISP 5B,A00,507671,Munoz Sanchez; Alicia,17,0,20,3
1713311188519,LISP 5C,A00,507696,Munoz Sanchez; Alicia,17,0,20,3
1713311189547,MAE 197,001,528363,Boechler; Nicholas Sebastia,9998,0,9999,1
1713311190574,MATH 197,001,523477,Kedlaya; Kiran S.,9999,0,9999,0
1713311190574,MATH 197,002,563811,Zhang; Danna,9999,0,9999,0
1713311191606,MCWP 40R,A00,518780,Staff,20,0,20,0
1713311191606,MCWP 40R,B00,518781,Staff,19,0,20,1
1713311191606,MCWP 40R,C00,518783,Staff,19,0,20,1
1713311192635,MCWP 50R,A00,518791,Staff,20,0,20,0
1713311192635,MCWP 50R,B00,518792,Staff,19,0,20,1
1713311192635,MCWP 50R,C00,518793,Staff,19,0,20,1
1713311192635,MCWP 50R,D00,518794,Staff,18,0,20,2
1713311192635,MCWP 50R,E00,518795,Staff,18,0,20,2
1713311192635,MCWP 50R,F00,518796,Staff,19,0,20,1
1713311192635,MCWP 50R,G00,518797,Staff,19,0,20,1
1713311193662,MMW 12R,A01,514034,Herbst; Matthew,16,0,16,0
1713311193662,MMW 12R,A02,514035,Herbst; Matthew,16,0,16,0
1713311194689,MMW 13R,A01,514037,Staff,13,0,16,3
1713311194689,MMW 13R,A02,514039,Staff,16,0,16,0
1713311196797,SIO 295LS,A00,523233,Staff,19,0,30,11
1713311197824,SIO 295S,A00,523232,Staff,19,0,30,11
1713311198850,SOCI 117,A01,494376,Staff,3,0,5,2
1713311199877,WES 237B,A00,494380,Staff,19,0,20,1
1713311201943,AESE 279B,A00,494370,Wade; Jon P,33,0,33,0
1713311202974,ANAR 135S,A00,494369,Braswell; Geoffrey E.,0,0,0,0
1713311204000,CAT 124RS,A01,519847,Geibel; William,17,0,20,3
1713311205025,CAT 125RS,A01,515971,Geibel; William,17,0,20,3
1713311206051,CLRE 250,A00,511389,Morris; Sheldon,9996,0,9999,3
1713311207080,CLRE 251,A00,507176,Mehta; Ravindra L.,9996,0,9999,3
1713311207080,CLRE 251,B00,511410,Mehta; Ravindra L.,9998,0,9999,1
1713311208107,CLRE 252,A00,507189,Cuomo; Raphael Eduardo,9998,0,9999,1
1713311209134,CLRE 253,A00,507199,Vaida; Florin,9997,0,9999,2
1713311209134,CLRE 253,B00,507202,Vaida; Florin,9999,0,9999,0
1713311210160,CLRE 259,A00,507211,Patel; Hemal,9996,0,9999,3
1713311211185,CLRE 260,A00,507221,Cuomo; Raphael Eduardo,9999,0,9999,0
1713311212210,CLRE 297,001,507242,Cuomo; Raphael Eduardo,9999,0,9999,0
1713311213235,CSE 191,A00,516875,Minnes Kemp; Mor Mia,9999,0,9999,0
1713311214262,CSS 201S,A01,494383,Staff,35,0,35,0
1713311215291,CSS 202S,A01,494387,Staff,35,0,35,0
1713311216318,EAP 100,A00,516065,Staff,9792,0,9999,207
1713311217342,ECE 45,A01,507414,Staff,54,0,60,6
1713311218369,ECE 100,A01,507416,Baghdadchi; Saharnaz,11,0,20,9
1713311218369,ECE 100,A02,507418,Baghdadchi; Saharnaz,20,0,20,0
1713311219393,ECE 111,A01,507420,Staff,40,0,50,10
1713311220419,ECE 197,001,548057,Sievenpiper; Daniel F.,9998,0,9999,1
1713311221445,EDS 115,A00,507243,Choi; Bailey Miyeon,28,0,28,0
1713311222476,EDS 117,A01,494379,Staff,25,0,25,0
1713311223571,EDS 125,A00,507246,Hopkins; Megan Beth,29,0,30,1
1713311224599,EDS 128A,A01,507264,Fargason; Sharon Gayle,26,0,26,0
1713311225625,EDS 128B,A01,507293,Pappas; Elizabeth,30,0,30,0
1713311226650,EDS 139,A00,507294,Fargason; Sharon Gayle,30,0,30,0
1713311226650,EDS 139,B00,507313,Pappas; Elizabeth,30,0,30,0
1713311227676,EDS 201,A00,507315,Staff,26,0,30,4
1713311228707,EDS 203,A01,507317,Halter; Christopher P.,26,0,30,4
1713311229732,EDS 204R,A01,507319,Halter; Christopher P.,5,0,30,25
1713311229732,EDS 204R,B01,507331,Heinzman; Erica M.,30,0,30,0
1713311230756,EDS 206R,A00,507332,Staff,7,0,30,23
1713311230756,EDS 206R,B00,507343,Staff,29,0,30,1
1713311231782,EDS 250,A00,507344,Hemans; Patricia Ann Benitez,36,0,40,4
1713311232811,EDS 281,A00,507345,Daly; Alan J.,18,0,18,0
1713311233836,EDS 284,A00,507350,Daly; Alan J.,16,0,16,0
1713311234862,EDS 286,A00,507359,Fine; Sarah,18,0,18,0
1713311235888,EDS 289C,A01,507361,Daly; Alan J.,18,0,18,0
1713311236915,EDS 290,A00,507366,Hofstetter; Carolyn,15,0,15,0
1713311237947,LIGM 5A,A00,507421,Fischer-Grunski; Eva K,20,0,20,0
1713311238974,LIGM 5B,A00,507423,Fischer-Grunski; Eva K,20,0,20,0
1713311240005,LIGM 5C,A00,507425,Fischer-Grunski; Eva K,20,0,20,0
1713311241031,LIIT 5AS,A00,507427,Carnelos; Chiara,20,0,20,0
1713311242057,LIIT 5BS,A00,507430,Carnelos; Chiara,20,0,20,0
1713311243083,LIIT 5CS,A00,507432,Carnelos; Chiara,20,0,20,0
1713311244109,LISP 5A,A00,507541,Munoz Sanchez; Alicia,19,0,20,1
1713311245140,LISP 5B,A00,507671,Munoz Sanchez; Alicia,17,0,20,3
1713311246170,LISP 5C,A00,507696,Munoz Sanchez; Alicia,17,0,20,3
1713311247194,MAE 197,001,528363,Boechler; Nicholas Sebastia,9998,0,9999,1
1713311248219,MATH 197,001,523477,Kedlaya; Kiran S.,9999,0,9999,0
1713311248219,MATH 197,002,563811,Zhang; Danna,9999,0,9999,0
1713311249243,MCWP 40R,A00,518780,Staff,20,0,20,0
1713311249243,MCWP 40R,B00,518781,Staff,19,0,20,1
1713311249243,MCWP 40R,C00,518783,Staff,19,0,20,1
1713311250272,MCWP 50R,A00,518791,Staff,20,0,20,0
1713311250272,MCWP 50R,B00,518792,Staff,19,0,20,1
1713311250272,MCWP 50R,C00,518793,Staff,19,0,20,1
1713311250272,MCWP 50R,D00,518794,Staff,18,0,20,2
1713311250272,MCWP 50R,E00,518795,Staff,18,0,20,2
1713311250272,MCWP 50R,F00,518796,Staff,19,0,20,1
1713311250272,MCWP 50R,G00,518797,Staff,19,0,20,1
1713311251302,MMW 12R,A01,514034,Herbst; Matthew,16,0,16,0
1713311251302,MMW 12R,A02,514035,Herbst; Matthew,16,0,16,0
1713311252327,MMW 13R,A01,514037,Staff,13,0,16,3
1713311252327,MMW 13R,A02,514039,Staff,16,0,16,0
1713311254380,SIO 295LS,A00,523233,Staff,19,0,30,11
1713311255417,SIO 295S,A00,523232,Staff,19,0,30,11
1713311256446,SOCI 117,A01,494376,Staff,3,0,5,2
1713311257473,WES 237B,A00,494380,Staff,19,0,20,1
1713311259540,AESE 279B,A00,494370,Wade; Jon P,33,0,33,0
1713311260570,ANAR 135S,A00,494369,Braswell; Geoffrey E.,0,0,0,0
1713311261594,CAT 124RS,A01,519847,Geibel; William,17,0,20,3
1713311262618,CAT 125RS,A01,515971,Geibel; William,17,0,20,3
1713311263642,CLRE 250,A00,511389,Morris; Sheldon,9996,0,9999,3
1713311264668,CLRE 251,A00,507176,Mehta; Ravindra L.,9996,0,9999,3
1713311264668,CLRE 251,B00,511410,Mehta; Ravindra L.,9998,0,9999,1
1713311265696,CLRE 252,A00,507189,Cuomo; Raphael Eduardo,9998,0,9999,1
1713311266722,CLRE 253,A00,507199,Vaida; Florin,9997,0,9999,2
1713311266722,CLRE 253,B00,507202,Vaida; Florin,9999,0,9999,0
1713311267748,CLRE 259,A00,507211,Patel; Hemal,9996,0,9999,3
1713311268776,CLRE 260,A00,507221,Cuomo; Raphael Eduardo,9999,0,9999,0
1713311269800,CLRE 297,001,507242,Cuomo; Raphael Eduardo,9999,0,9999,0
1713311270825,CSE 191,A00,516875,Minnes Kemp; Mor Mia,9999,0,9999,0
1713311271850,CSS 201S,A01,494383,Staff,35,0,35,0
1713311272877,CSS 202S,A01,494387,Staff,35,0,35,0
1713311273905,EAP 100,A00,516065,Staff,9792,0,9999,207
1713311274929,ECE 45,A01,507414,Staff,54,0,60,6
1713311275958,ECE 100,A01,507416,Baghdadchi; Saharnaz,11,0,20,9
1713311275958,ECE 100,A02,507418,Baghdadchi; Saharnaz,20,0,20,0
1713311276989,ECE 111,A01,507420,Staff,40,0,50,10
1713311278014,ECE 197,001,548057,Sievenpiper; Daniel F.,9998,0,9999,1
1713311279042,EDS 115,A00,507243,Choi; Bailey Miyeon,28,0,28,0
1713311280067,EDS 117,A01,494379,Staff,25,0,25,0
1713311281099,EDS 125,A00,507246,Hopkins; Megan Beth,29,0,30,1
1713311282125,EDS 128A,A01,507264,Fargason; Sharon Gayle,26,0,26,0
1713311283157,EDS 128B,A01,507293,Pappas; Elizabeth,30,0,30,0
1713311284186,EDS 139,A00,507294,Fargason; Sharon Gayle,30,0,30,0
1713311284186,EDS 139,B00,507313,Pappas; Elizabeth,30,0,30,0
1713311285211,EDS 201,A00,507315,Staff,26,0,30,4
1713311286235,EDS 203,A01,507317,Halter; Christopher P.,26,0,30,4
1713311287262,EDS 204R,A01,507319,Halter; Christopher P.,5,0,30,25
1713311287262,EDS 204R,B01,507331,Heinzman; Erica M.,30,0,30,0
1713311288289,EDS 206R,A00,507332,Staff,7,0,30,23
1713311288289,EDS 206R,B00,507343,Staff,29,0,30,1
1713311289314,EDS 250,A00,507344,Hemans; Patricia Ann Benitez,36,0,40,4
1713311290342,EDS 281,A00,507345,Daly; Alan J.,18,0,18,0
1713311291368,EDS 284,A00,507350,Daly; Alan J.,16,0,16,0
1713311292395,EDS 286,A00,507359,Fine; Sarah,18,0,18,0
1713311293420,EDS 289C,A01,507361,Daly; Alan J.,18,0,18,0
1713311294449,EDS 290,A00,507366,Hofstetter; Carolyn,15,0,15,0
1713311295476,LIGM 5A,A00,507421,Fischer-Grunski; Eva K,20,0,20,0
1713311296503,LIGM 5B,A00,507423,Fischer-Grunski; Eva K,20,0,20,0
1713311297528,LIGM 5C,A00,507425,Fischer-Grunski; Eva K,20,0,20,0
1713311298553,LIIT 5AS,A00,507427,Carnelos; Chiara,20,0,20,0
1713311299584,LIIT 5BS,A00,507430,Carnelos; Chiara,20,0,20,0
1713311300662,LIIT 5CS,A00,507432,Carnelos; Chiara,20,0,20,0
1713311301688,LISP 5A,A00,507541,Munoz Sanchez; Alicia,19,0,20,1
1713311302713,LISP 5B,A00,507671,Munoz Sanchez; Alicia,17,0,20,3
1713311303738,LISP 5C,A00,507696,Munoz Sanchez; Alicia,17,0,20,3
1713311304763,MAE 197,001,528363,Boechler; Nicholas Sebastia,9998,0,9999,1
1713311305790,MATH 197,001,523477,Kedlaya; Kiran S.,9999,0,9999,0
1713311305790,MATH 197,002,563811,Zhang; Danna,9999,0,9999,0
1713311306820,MCWP 40R,A00,518780,Staff,20,0,20,0
1713311306820,MCWP 40R,B00,518781,Staff,19,0,20,1
1713311306820,MCWP 40R,C00,518783,Staff,19,0,20,1
1713311307849,MCWP 50R,A00,518791,Staff,20,0,20,0
1713311307849,MCWP 50R,B00,518792,Staff,19,0,20,1
1713311307849,MCWP 50R,C00,518793,Staff,19,0,20,1
1713311307849,MCWP 50R,D00,518794,Staff,18,0,20,2
1713311307849,MCWP 50R,E00,518795,Staff,18,0,20,2
1713311307849,MCWP 50R,F00,518796,Staff,19,0,20,1
1713311307849,MCWP 50R,G00,518797,Staff,19,0,20,1
1713311308878,MMW 12R,A01,514034,Herbst; Matthew,16,0,16,0
1713311308878,MMW 12R,A02,514035,Herbst; Matthew,16,0,16,0
1713311309906,MMW 13R,A01,514037,Staff,13,0,16,3
1713311309906,MMW 13R,A02,514039,Staff,16,0,16,0
1713311311960,SIO 295LS,A00,523233,Staff,19,0,30,11
1713311312988,SIO 295S,A00,523232,Staff,19,0,30,11
1713311314021,SOCI 117,A01,494376,Staff,3,0,5,2
1713311315046,WES 237B,A00,494380,Staff,19,0,20,1
1713311317110,AESE 279B,A00,494370,Wade; Jon P,33,0,33,0
1713311318135,ANAR 135S,A00,494369,Braswell; Geoffrey E.,0,0,0,0
1713311319160,CAT 124RS,A01,519847,Geibel; William,17,0,20,3
1713311320187,CAT 125RS,A01,515971,Geibel; William,17,0,20,3
1713311321213,CLRE 250,A00,511389,Morris; Sheldon,9996,0,9999,3
1713311322240,CLRE 251,A00,507176,Mehta; Ravindra L.,9996,0,9999,3
1713311322240,CLRE 251,B00,511410,Mehta; Ravindra L.,9998,0,9999,1
1713311323266,CLRE 252,A00,507189,Cuomo; Raphael Eduardo,9998,0,9999,1
1713311324292,CLRE 253,A00,507199,Vaida; Florin,9997,0,9999,2
1713311324292,CLRE 253,B00,507202,Vaida; Florin,9999,0,9999,0
1713311325320,CLRE 259,A00,507211,Patel; Hemal,9996,0,9999,3
1713311326349,CLRE 260,A00,507221,Cuomo; Raphael Eduardo,9999,0,9999,0
1713311327375,CLRE 297,001,507242,Cuomo; Raphael Eduardo,9999,0,9999,0
1713311328401,CSE 191,A00,516875,Minnes Kemp; Mor Mia,9999,0,9999,0
1713311329429,CSS 201S,A01,494383,Staff,35,0,35,0
1713311330459,CSS 202S,A01,494387,Staff,35,0,35,0
1713311331484,EAP 100,A00,516065,Staff,9792,0,9999,207
1713311332508,ECE 45,A01,507414,Staff,54,0,60,6
1713311333537,ECE 100,A01,507416,Baghdadchi; Saharnaz,11,0,20,9
1713311333537,ECE 100,A02,507418,Baghdadchi; Saharnaz,20,0,20,0
1713311334565,ECE 111,A01,507420,Staff,40,0,50,10
1713311335592,ECE 197,001,548057,Sievenpiper; Daniel F.,9998,0,9999,1
1713311336618,EDS 115,A00,507243,Choi; Bailey Miyeon,28,0,28,0
1713311337646,EDS 117,A01,494379,Staff,25,0,25,0
1713311338672,EDS 125,A00,507246,Hopkins; Megan Beth,29,0,30,1
1713311339701,EDS 128A,A01,507264,Fargason; Sharon Gayle,26,0,26,0
1713311340732,EDS 128B,A01,507293,Pappas; Elizabeth,30,0,30,0
1713311341758,EDS 139,A00,507294,Fargason; Sharon Gayle,30,0,30,0
1713311341758,EDS 139,B00,507313,Pappas; Elizabeth,30,0,30,0
1713311342788,EDS 201,A00,507315,Staff,26,0,30,4
1713311343816,EDS 203,A01,507317,Halter; Christopher P.,26,0,30,4
1713311344840,EDS 204R,A01,507319,Halter; Christopher P.,5,0,30,25
1713311344840,EDS 204R,B01,507331,Heinzman; Erica M.,29,0,30,1
1713311345866,EDS 206R,A00,507332,Staff,7,0,30,23
1713311345866,EDS 206R,B00,507343,Staff,28,0,30,2
1713311346896,EDS 250,A00,507344,Hemans; Patricia Ann Benitez,36,0,40,4
1713311347930,EDS 281,A00,507345,Daly; Alan J.,18,0,18,0
1713311348954,EDS 284,A00,507350,Daly; Alan J.,16,0,16,0
1713311349984,EDS 286,A00,507359,Fine; Sarah,18,0,18,0
1713311351012,EDS 289C,A01,507361,Daly; Alan J.,18,0,18,0
1713311352036,EDS 290,A00,507366,Hofstetter; Carolyn,15,0,15,0
1713311353063,LIGM 5A,A00,507421,Fischer-Grunski; Eva K,20,0,20,0
1713311354088,LIGM 5B,A00,507423,Fischer-Grunski; Eva K,20,0,20,0
1713311355118,LIGM 5C,A00,507425,Fischer-Grunski; Eva K,20,0,20,0
1713311356146,LIIT 5AS,A00,507427,Carnelos; Chiara,20,0,20,0
1713311357172,LIIT 5BS,A00,507430,Carnelos; Chiara,20,0,20,0
1713311358197,LIIT 5CS,A00,507432,Carnelos; Chiara,20,0,20,0
1713311359224,LISP 5A,A00,507541,Munoz Sanchez; Alicia,19,0,20,1
1713311360250,LISP 5B,A00,507671,Munoz Sanchez; Alicia,17,0,20,3
1713311361274,LISP 5C,A00,507696,Munoz Sanchez; Alicia,17,0,20,3
1713311362301,MAE 197,001,528363,Boechler; Nicholas Sebastia,9998,0,9999,1
1713311363330,MATH 197,001,523477,Kedlaya; Kiran S.,9999,0,9999,0
1713311363330,MATH 197,002,563811,Zhang; Danna,9999,0,9999,0
1713311364354,MCWP 40R,A00,518780,Staff,20,0,20,0
1713311364354,MCWP 40R,B00,518781,Staff,19,0,20,1
1713311364354,MCWP 40R,C00,518783,Staff,19,0,20,1
1713311365381,MCWP 50R,A00,518791,Staff,20,0,20,0
1713311365381,MCWP 50R,B00,518792,Staff,19,0,20,1
1713311365381,MCWP 50R,C00,518793,Staff,19,0,20,1
1713311365381,MCWP 50R,D00,518794,Staff,18,0,20,2
1713311365381,MCWP 50R,E00,518795,Staff,18,0,20,2
1713311365381,MCWP 50R,F00,518796,Staff,19,0,20,1
1713311365381,MCWP 50R,G00,518797,Staff,19,0,20,1
1713311366410,MMW 12R,A01,514034,Herbst; Matthew,16,0,16,0
1713311366410,MMW 12R,A02,514035,Herbst; Matthew,16,0,16,0
1713311367434,MMW 13R,A01,514037,Staff,13,0,16,3
1713311367434,MMW 13R,A02,514039,Staff,16,0,16,0
1713311369491,SIO 295LS,A00,523233,Staff,19,0,30,11
1713311370515,SIO 295S,A00,523232,Staff,19,0,30,11
1713311371540,SOCI 117,A01,494376,Staff,3,0,5,2
1713311372567,WES 237B,A00,494380,Staff,19,0,20,1
1713311374634,AESE 279B,A00,494370,Wade; Jon P,33,0,33,0
1713311375659,ANAR 135S,A00,494369,Braswell; Geoffrey E.,0,0,0,0
1713311376684,CAT 124RS,A01,519847,Geibel; William,17,0,20,3
1713311377708,CAT 125RS,A01,515971,Geibel; William,17,0,20,3
1713311378737,CLRE 250,A00,511389,Morris; Sheldon,9996,0,9999,3
1713311379765,CLRE 251,A00,507176,Mehta; Ravindra L.,9996,0,9999,3
1713311379765,CLRE 251,B00,511410,Mehta; Ravindra L.,9998,0,9999,1
1713311380795,CLRE 252,A00,507189,Cuomo; Raphael Eduardo,9998,0,9999,1
1713311381826,CLRE 253,A00,507199,Vaida; Florin,9997,0,9999,2
1713311381826,CLRE 253,B00,507202,Vaida; Florin,9999,0,9999,0
1713311382855,CLRE 259,A00,507211,Patel; Hemal,9996,0,9999,3
1713311383879,CLRE 260,A00,507221,Cuomo; Raphael Eduardo,9999,0,9999,0
1713311384901,CLRE 297,001,507242,Cuomo; Raphael Eduardo,9999,0,9999,0
1713311385925,CSE 191,A00,516875,Minnes Kemp; Mor Mia,9999,0,9999,0
1713311386949,CSS 201S,A01,494383,Staff,35,0,35,0
1713311387975,CSS 202S,A01,494387,Staff,35,0,35,0
1713311389001,EAP 100,A00,516065,Staff,9792,0,9999,207
1713311390026,ECE 45,A01,507414,Staff,54,0,60,6
1713311391056,ECE 100,A01,507416,Baghdadchi; Saharnaz,11,0,20,9
1713311391056,ECE 100,A02,507418,Baghdadchi; Saharnaz,20,0,20,0
1713311392084,ECE 111,A01,507420,Staff,40,0,50,10
1713311393113,ECE 197,001,548057,Sievenpiper; Daniel F.,9998,0,9999,1
1713311394137,EDS 115,A00,507243,Choi; Bailey Miyeon,28,0,28,0
1713311395162,EDS 117,A01,494379,Staff,25,0,25,0
1713311396187,EDS 125,A00,507246,Hopkins; Megan Beth,29,0,30,1
1713311397212,EDS 128A,A01,507264,Fargason; Sharon Gayle,26,0,26,0
1713311398237,EDS 128B,A01,507293,Pappas; Elizabeth,30,0,30,0
1713311399265,EDS 139,A00,507294,Fargason; Sharon Gayle,30,0,30,0
1713311399265,EDS 139,B00,507313,Pappas; Elizabeth,30,0,30,0
1713311400292,EDS 201,A00,507315,Staff,26,0,30,4
1713311401322,EDS 203,A01,507317,Halter; Christopher P.,26,0,30,4
1713311402352,EDS 204R,A01,507319,Halter; Christopher P.,5,0,30,25
1713311402352,EDS 204R,B01,507331,Heinzman; Erica M.,29,0,30,1
1713311403376,EDS 206R,A00,507332,Staff,7,0,30,23
1713311403376,EDS 206R,B00,507343,Staff,28,0,30,2
1713311404455,EDS 250,A00,507344,Hemans; Patricia Ann Benitez,36,0,40,4
1713311405481,EDS 281,A00,507345,Daly; Alan J.,18,0,18,0
1713311406509,EDS 284,A00,507350,Daly; Alan J.,16,0,16,0
1713311407533,EDS 286,A00,507359,Fine; Sarah,18,0,18,0
1713311408559,EDS 289C,A01,507361,Daly; Alan J.,18,0,18,0
1713311409582,EDS 290,A00,507366,Hofstetter; Carolyn,15,0,15,0
1713311410612,LIGM 5A,A00,507421,Fischer-Grunski; Eva K,20,0,20,0
1713311411636,LIGM 5B,A00,507423,Fischer-Grunski; Eva K,20,0,20,0
1713311412665,LIGM 5C,A00,507425,Fischer-Grunski; Eva K,20,0,20,0
1713311413691,LIIT 5AS,A00,507427,Carnelos; Chiara,20,0,20,0
1713311414720,LIIT 5BS,A00,507430,Carnelos; Chiara,20,0,20,0
1713311415745,LIIT 5CS,A00,507432,Carnelos; Chiara,20,0,20,0
1713311416769,LISP 5A,A00,507541,Munoz Sanchez; Alicia,19,0,20,1
1713311417794,LISP 5B,A00,507671,Munoz Sanchez; Alicia,17,0,20,3
1713311418819,LISP 5C,A00,507696,Munoz Sanchez; Alicia,17,0,20,3
1713311419843,MAE 197,001,528363,Boechler; Nicholas Sebastia,9998,0,9999,1
1713311420869,MATH 197,001,523477,Kedlaya; Kiran S.,9999,0,9999,0
1713311420869,MATH 197,002,563811,Zhang; Danna,9999,0,9999,0
1713311421893,MCWP 40R,A00,518780,Staff,20,0,20,0
1713311421893,MCWP 40R,B00,518781,Staff,19,0,20,1
1713311421893,MCWP 40R,C00,518783,Staff,19,0,20,1
1713311422918,MCWP 50R,A00,518791,Staff,20,0,20,0
1713311422918,MCWP 50R,B00,518792,Staff,19,0,20,1
1713311422918,MCWP 50R,C00,518793,Staff,19,0,20,1
1713311422918,MCWP 50R,D00,518794,Staff,18,0,20,2
1713311422918,MCWP 50R,E00,518795,Staff,18,0,20,2
1713311422918,MCWP 50R,F00,518796,Staff,19,0,20,1
1713311422918,MCWP 50R,G00,518797,Staff,19,0,20,1
1713311423947,MMW 12R,A01,514034,Herbst; Matthew,16,0,16,0
1713311423947,MMW 12R,A02,514035,Herbst; Matthew,16,0,16,0
1713311424976,MMW 13R,A01,514037,Staff,13,0,16,3
1713311424976,MMW 13R,A02,514039,Staff,16,0,16,0
1713311427028,SIO 295LS,A00,523233,Staff,19,0,30,11
1713311428053,SIO 295S,A00,523232,Staff,19,0,30,11
1713311429081,SOCI 117,A01,494376,Staff,3,0,5,2
1713311430111,WES 237B,A00,494380,Staff,19,0,20,1
1713311432177,AESE 279B,A00,494370,Wade; Jon P,33,0,33,0
1713311433205,ANAR 135S,A00,494369,Braswell; Geoffrey E.,0,0,0,0
1713311434229,CAT 124RS,A01,519847,Geibel; William,17,0,20,3
1713311435252,CAT 125RS,A01,515971,Geibel; William,17,0,20,3
1713311436283,CLRE 250,A00,511389,Morris; Sheldon,9996,0,9999,3
1713311437316,CLRE 251,A00,507176,Mehta; Ravindra L.,9996,0,9999,3
1713311437316,CLRE 251,B00,511410,Mehta; Ravindra L.,9998,0,9999,1
1713311438345,CLRE 252,A00,507189,Cuomo; Raphael Eduardo,9998,0,9999,1
1713311439369,CLRE 253,A00,507199,Vaida; Florin,9997,0,9999,2
1713311439369,CLRE 253,B00,507202,Vaida; Florin,9999,0,9999,0
1713311440393,CLRE 259,A00,507211,Patel; Hemal,9996,0,9999,3
1713311441422,CLRE 260,A00,507221,Cuomo; Raphael Eduardo,9999,0,9999,0
1713311442449,CLRE 297,001,507242,Cuomo; Raphael Eduardo,9999,0,9999,0
1713311443474,CSE 191,A00,516875,Minnes Kemp; Mor Mia,9999,0,9999,0
1713311444499,CSS 201S,A01,494383,Staff,35,0,35,0
1713311445571,CSS 202S,A01,494387,Staff,35,0,35,0
1713311446600,EAP 100,A00,516065,Staff,9792,0,9999,207
1713311447625,ECE 45,A01,507414,Staff,54,0,60,6
1713311448652,ECE 100,A01,507416,Baghdadchi; Saharnaz,11,0,20,9
1713311448652,ECE 100,A02,507418,Baghdadchi; Saharnaz,20,0,20,0
1713311449676,ECE 111,A01,507420,Staff,40,0,50,10
1713311450706,ECE 197,001,548057,Sievenpiper; Daniel F.,9998,0,9999,1
1713311451732,EDS 115,A00,507243,Choi; Bailey Miyeon,28,0,28,0
1713311452758,EDS 117,A01,494379,Staff,25,0,25,0
1713311453785,EDS 125,A00,507246,Hopkins; Megan Beth,29,0,30,1
1713311454810,EDS 128A,A01,507264,Fargason; Sharon Gayle,26,0,26,0
1713311455838,EDS 128B,A01,507293,Pappas; Elizabeth,30,0,30,0
1713311456867,EDS 139,A00,507294,Fargason; Sharon Gayle,30,0,30,0
1713311456867,EDS 139,B00,507313,Pappas; Elizabeth,30,0,30,0
1713311457892,EDS 201,A00,507315,Staff,26,0,30,4
1713311458920,EDS 203,A01,507317,Halter; Christopher P.,26,0,30,4
1713311459946,EDS 204R,A01,507319,Halter; Christopher P.,5,0,30,25
1713311459946,EDS 204R,B01,507331,Heinzman; Erica M.,29,0,30,1
1713311460970,EDS 206R,A00,507332,Staff,7,0,30,23
1713311460970,EDS 206R,B00,507343,Staff,28,0,30,2
1713311462000,EDS 250,A00,507344,Hemans; Patricia Ann Benitez,36,0,40,4
1713311463026,EDS 281,A00,507345,Daly; Alan J.,18,0,18,0
1713311464054,EDS 284,A00,507350,Daly; Alan J.,16,0,16,0
1713311465082,EDS 286,A00,507359,Fine; Sarah,18,0,18,0
1713311466106,EDS 289C,A01,507361,Daly; Alan J.,18,0,18,0
1713311467134,EDS 290,A00,507366,Hofstetter; Carolyn,15,0,15,0
1713311468158,LIGM 5A,A00,507421,Fischer-Grunski; Eva K,20,0,20,0
1713311469202,LIGM 5B,A00,507423,Fischer-Grunski; Eva K,20,0,20,0
1713311470228,LIGM 5C,A00,507425,Fischer-Grunski; Eva K,20,0,20,0
1713311471257,LIIT 5AS,A00,507427,Carnelos; Chiara,20,0,20,0
1713311472282,LIIT 5BS,A00,507430,Carnelos; Chiara,20,0,20,0
1713311473308,LIIT 5CS,A00,507432,Carnelos; Chiara,20,0,20,0
1713311474333,LISP 5A,A00,507541,Munoz Sanchez; Alicia,19,0,20,1
1713311475358,LISP 5B,A00,507671,Munoz Sanchez; Alicia,17,0,20,3
1713311476383,LISP 5C,A00,507696,Munoz Sanchez; Alicia,17,0,20,3
1713311477413,MAE 197,001,528363,Boechler; Nicholas Sebastia,9998,0,9999,1
1713311478463,MATH 197,001,523477,Kedlaya; Kiran S.,9999,0,9999,0
1713311478463,MATH 197,002,563811,Zhang; Danna,9999,0,9999,0
1713311479489,MCWP 40R,A00,518780,Staff,20,0,20,0
1713311479489,MCWP 40R,B00,518781,Staff,19,0,20,1
1713311479489,MCWP 40R,C00,518783,Staff,19,0,20,1
1713311480519,MCWP 50R,A00,518791,Staff,20,0,20,0
1713311480519,MCWP 50R,B00,518792,Staff,19,0,20,1
1713311480519,MCWP 50R,C00,518793,Staff,19,0,20,1
1713311480519,MCWP 50R,D00,518794,Staff,18,0,20,2
1713311480519,MCWP 50R,E00,518795,Staff,18,0,20,2
1713311480519,MCWP 50R,F00,518796,Staff,19,0,20,1
1713311480519,MCWP 50R,G00,518797,Staff,19,0,20,1
1713311481545,MMW 12R,A01,514034,Herbst; Matthew,16,0,16,0
1713311481545,MMW 12R,A02,514035,Herbst; Matthew,16,0,16,0
1713311482569,MMW 13R,A01,514037,Staff,13,0,16,3
1713311482569,MMW 13R,A02,514039,Staff,16,0,16,0
1713311484626,SIO 295LS,A00,523233,Staff,19,0,30,11
1713311485654,SIO 295S,A00,523232,Staff,19,0,30,11
1713311486682,SOCI 117,A01,494376,Staff,3,0,5,2
1713311487707,WES 237B,A00,494380,Staff,19,0,20,1
1713311489778,AESE 279B,A00,494370,Wade; Jon P,33,0,33,0
1713311490805,ANAR 135S,A00,494369,Braswell; Geoffrey E.,0,0,0,0
1713311491830,CAT 124RS,A01,519847,Geibel; William,17,0,20,3
1713311492858,CAT 125RS,A01,515971,Geibel; William,17,0,20,3
1713311493894,CLRE 250,A00,511389,Morris; Sheldon,9996,0,9999,3
1713311494921,CLRE 251,A00,507176,Mehta; Ravindra L.,9996,0,9999,3
1713311494921,CLRE 251,B00,511410,Mehta; Ravindra L.,9998,0,9999,1
1713311495946,CLRE 252,A00,507189,Cuomo; Raphael Eduardo,9998,0,9999,1
1713311496977,CLRE 253,A00,507199,Vaida; Florin,9997,0,9999,2
1713311496977,CLRE 253,B00,507202,Vaida; Florin,9999,0,9999,0
1713311498003,CLRE 259,A00,507211,Patel; Hemal,9996,0,9999,3
1713311499028,CLRE 260,A00,507221,Cuomo; Raphael Eduardo,9999,0,9999,0
1713311500058,CLRE 297,001,507242,Cuomo; Raphael Eduardo,9999,0,9999,0
1713311501087,CSE 191,A00,516875,Minnes Kemp; Mor Mia,9999,0,9999,0
1713311502112,CSS 201S,A01,494383,Staff,35,0,35,0
1713311503141,CSS 202S,A01,494387,Staff,35,0,35,0
1713311504165,EAP 100,A00,516065,Staff,9792,0,9999,207
1713311505196,ECE 45,A01,507414,Staff,54,0,60,6
1713311506222,ECE 100,A01,507416,Baghdadchi; Saharnaz,11,0,20,9
1713311506222,ECE 100,A02,507418,Baghdadchi; Saharnaz,20,0,20,0
1713311507252,ECE 111,A01,507420,Staff,40,0,50,10
1713311508344,ECE 197,001,548057,Sievenpiper; Daniel F.,9998,0,9999,1
1713311509373,EDS 115,A00,507243,Choi; Bailey Miyeon,28,0,28,0
1713311510401,EDS 117,A01,494379,Staff,25,0,25,0
1713311511425,EDS 125,A00,507246,Hopkins; Megan Beth,29,0,30,1
1713311512452,EDS 128A,A01,507264,Fargason; Sharon Gayle,26,0,26,0
1713311513478,EDS 128B,A01,507293,Pappas; Elizabeth,30,0,30,0
1713311514500,EDS 139,A00,507294,Fargason; Sharon Gayle,30,0,30,0
1713311514500,EDS 139,B00,507313,Pappas; Elizabeth,30,0,30,0
1713311515525,EDS 201,A00,507315,Staff,26,0,30,4
1713311516551,EDS 203,A01,507317,Halter; Christopher P.,26,0,30,4
1713311517578,EDS 204R,A01,507319,Halter; Christopher P.,5,0,30,25
1713311517578,EDS 204R,B01,507331,Heinzman; Erica M.,29,0,30,1
1713311518608,EDS 206R,A00,507332,Staff,7,0,30,23
1713311518608,EDS 206R,B00,507343,Staff,28,0,30,2
1713311519637,EDS 250,A00,507344,Hemans; Patricia Ann Benitez,36,0,40,4
1713311520662,EDS 281,A00,507345,Daly; Alan J.,18,0,18,0
1713311521690,EDS 284,A00,507350,Daly; Alan J.,16,0,16,0
1713311522715,EDS 286,A00,507359,Fine; Sarah,18,0,18,0
1713311523743,EDS 289C,A01,507361,Daly; Alan J.,18,0,18,0
1713311524884,EDS 290,A00,507366,Hofstetter; Carolyn,15,0,15,0
1713311525914,LIGM 5A,A00,507421,Fischer-Grunski; Eva K,20,0,20,0
1713311526942,LIGM 5B,A00,507423,Fischer-Grunski; Eva K,20,0,20,0
1713311527973,LIGM 5C,A00,507425,Fischer-Grunski; Eva K,20,0,20,0
1713311529000,LIIT 5AS,A00,507427,Carnelos; Chiara,20,0,20,0
1713311530052,LIIT 5BS,A00,507430,Carnelos; Chiara,20,0,20,0
1713311531082,LIIT 5CS,A00,507432,Carnelos; Chiara,20,0,20,0
1713311532106,LISP 5A,A00,507541,Munoz Sanchez; Alicia,19,0,20,1
1713311533136,LISP 5B,A00,507671,Munoz Sanchez; Alicia,17,0,20,3
1713311534162,LISP 5C,A00,507696,Munoz Sanchez; Alicia,17,0,20,3
1713311535192,MAE 197,001,528363,Boechler; Nicholas Sebastia,9998,0,9999,1
1713311536220,MATH 197,001,523477,Kedlaya; Kiran S.,9999,0,9999,0
1713311536220,MATH 197,002,563811,Zhang; Danna,9999,0,9999,0
1713311537247,MCWP 40R,A00,518780,Staff,20,0,20,0
1713311537247,MCWP 40R,B00,518781,Staff,19,0,20,1
1713311537247,MCWP 40R,C00,518783,Staff,19,0,20,1
1713311538280,MCWP 50R,A00,518791,Staff,20,0,20,0
1713311538280,MCWP 50R,B00,518792,Staff,19,0,20,1
1713311538280,MCWP 50R,C00,518793,Staff,19,0,20,1
1713311538280,MCWP 50R,D00,518794,Staff,18,0,20,2
1713311538280,MCWP 50R,E00,518795,Staff,18,0,20,2
1713311538280,MCWP 50R,F00,518796,Staff,19,0,20,1
1713311538280,MCWP 50R,G00,518797,Staff,19,0,20,1
1713311539303,MMW 12R,A01,514034,Herbst; Matthew,16,0,16,0
1713311539303,MMW 12R,A02,514035,Herbst; Matthew,16,0,16,0
1713311540332,MMW 13R,A01,514037,Staff,13,0,16,3
1713311540332,MMW 13R,A02,514039,Staff,16,0,16,0
1713311542382,SIO 295LS,A00,523233,Staff,19,0,30,11
1713311543410,SIO 295S,A00,523232,Staff,19,0,30,11
1713311544436,SOCI 117,A01,494376,Staff,3,0,5,2
1713311545465,WES 237B,A00,494380,Staff,19,0,20,1
1713311547552,AESE 279B,A00,494370,Wade; Jon P,33,0,33,0
1713311548579,ANAR 135S,A00,494369,Braswell; Geoffrey E.,0,0,0,0
1713311549603,CAT 124RS,A01,519847,Geibel; William,17,0,20,3
1713311550627,CAT 125RS,A01,515971,Geibel; William,17,0,20,3
1713311551656,CLRE 250,A00,511389,Morris; Sheldon,9996,0,9999,3
1713311552785,CLRE 251,A00,507176,Mehta; Ravindra L.,9996,0,9999,3
1713311552785,CLRE 251,B00,511410,Mehta; Ravindra L.,9998,0,9999,1
1713311553810,CLRE 252,A00,507189,Cuomo; Raphael Eduardo,9998,0,9999,1
1713311554837,CLRE 253,A00,507199,Vaida; Florin,9997,0,9999,2
1713311554837,CLRE 253,B00,507202,Vaida; Florin,9999,0,9999,0
1713311555864,CLRE 259,A00,507211,Patel; Hemal,9996,0,9999,3
1713311556889,CLRE 260,A00,507221,Cuomo; Raphael Eduardo,9999,0,9999,0
1713311557916,CLRE 297,001,507242,Cuomo; Raphael Eduardo,9999,0,9999,0
1713311558943,CSE 191,A00,516875,Minnes Kemp; Mor Mia,9999,0,9999,0
1713311559973,CSS 201S,A01,494383,Staff,35,0,35,0
1713311560998,CSS 202S,A01,494387,Staff,35,0,35,0
1713311562024,EAP 100,A00,516065,Staff,9792,0,9999,207
1713311563048,ECE 45,A01,507414,Staff,54,0,60,6
1713311564074,ECE 100,A01,507416,Baghdadchi; Saharnaz,11,0,20,9
1713311564074,ECE 100,A02,507418,Baghdadchi; Saharnaz,20,0,20,0
1713311565102,ECE 111,A01,507420,Staff,40,0,50,10
1713311566208,ECE 197,001,548057,Sievenpiper; Daniel F.,9998,0,9999,1
1713311567236,EDS 115,A00,507243,Choi; Bailey Miyeon,28,0,28,0
1713311568263,EDS 117,A01,494379,Staff,25,0,25,0
1713311569293,EDS 125,A00,507246,Hopkins; Megan Beth,29,0,30,1
1713311570323,EDS 128A,A01,507264,Fargason; Sharon Gayle,26,0,26,0
1713311571353,EDS 128B,A01,507293,Pappas; Elizabeth,30,0,30,0
1713311572376,EDS 139,A00,507294,Fargason; Sharon Gayle,30,0,30,0
1713311572376,EDS 139,B00,507313,Pappas; Elizabeth,30,0,30,0
1713311573407,EDS 201,A00,507315,Staff,26,0,30,4
1713311574433,EDS 203,A01,507317,Halter; Christopher P.,26,0,30,4
1713311575458,EDS 204R,A01,507319,Halter; Christopher P.,5,0,30,25
1713311575458,EDS 204R,B01,507331,Heinzman; Erica M.,29,0,30,1
1713311576483,EDS 206R,A00,507332,Staff,7,0,30,23
1713311576483,EDS 206R,B00,507343,Staff,28,0,30,2
1713311577512,EDS 250,A00,507344,Hemans; Patricia Ann Benitez,36,0,40,4
1713311578539,EDS 281,A00,507345,Daly; Alan J.,18,0,18,0
1713311579563,EDS 284,A00,507350,Daly; Alan J.,16,0,16,0
1713311580589,EDS 286,A00,507359,Fine; Sarah,18,0,18,0
1713311581617,EDS 289C,A01,507361,Daly; Alan J.,18,0,18,0
1713311582642,EDS 290,A00,507366,Hofstetter; Carolyn,15,0,15,0
1713311583671,LIGM 5A,A00,507421,Fischer-Grunski; Eva K,20,0,20,0
1713311584696,LIGM 5B,A00,507423,Fischer-Grunski; Eva K,20,0,20,0
1713311585720,LIGM 5C,A00,507425,Fischer-Grunski; Eva K,20,0,20,0
1713311586746,LIIT 5AS,A00,507427,Carnelos; Chiara,20,0,20,0
1713311587776,LIIT 5BS,A00,507430,Carnelos; Chiara,20,0,20,0
1713311588801,LIIT 5CS,A00,507432,Carnelos; Chiara,20,0,20,0
1713311589829,LISP 5A,A00,507541,Munoz Sanchez; Alicia,19,0,20,1
1713311590853,LISP 5B,A00,507671,Munoz Sanchez; Alicia,17,0,20,3
1713311591878,LISP 5C,A00,507696,Munoz Sanchez; Alicia,17,0,20,3
1713311592904,MAE 197,001,528363,Boechler; Nicholas Sebastia,9998,0,9999,1
1713311593929,MATH 197,001,523477,Kedlaya; Kiran S.,9999,0,9999,0
1713311593929,MATH 197,002,563811,Zhang; Danna,9999,0,9999,0
1713311594954,MCWP 40R,A00,518780,Staff,20,0,20,0
1713311594954,MCWP 40R,B00,518781,Staff,19,0,20,1
1713311594954,MCWP 40R,C00,518783,Staff,19,0,20,1
1713311595979,MCWP 50R,A00,518791,Staff,20,0,20,0
1713311595979,MCWP 50R,B00,518792,Staff,19,0,20,1
1713311595979,MCWP 50R,C00,518793,Staff,19,0,20,1
1713311595979,MCWP 50R,D00,518794,Staff,18,0,20,2
1713311595979,MCWP 50R,E00,518795,Staff,18,0,20,2
1713311595979,MCWP 50R,F00,518796,Staff,19,0,20,1
1713311595979,MCWP 50R,G00,518797,Staff,19,0,20,1
1713311597004,MMW 12R,A01,514034,Herbst; Matthew,16,0,16,0
1713311597004,MMW 12R,A02,514035,Herbst; Matthew,16,0,16,0
1713311598032,MMW 13R,A01,514037,Staff,13,0,16,3
1713311598032,MMW 13R,A02,514039,Staff,16,0,16,0
1713311600082,SIO 295LS,A00,523233,Staff,19,0,30,11
1713311601110,SIO 295S,A00,523232,Staff,19,0,30,11
1713311602140,SOCI 117,A01,494376,Staff,3,0,5,2
1713311603167,WES 237B,A00,494380,Staff,19,0,20,1
1713311605231,AESE 279B,A00,494370,Wade; Jon P,33,0,33,0
1713311606257,ANAR 135S,A00,494369,Braswell; Geoffrey E.,0,0,0,0
1713311607287,CAT 124RS,A01,519847,Geibel; William,17,0,20,3
1713311608318,CAT 125RS,A01,515971,Geibel; William,17,0,20,3
1713311609343,CLRE 250,A00,511389,Morris; Sheldon,9996,0,9999,3
1713311610368,CLRE 251,A00,507176,Mehta; Ravindra L.,9996,0,9999,3
1713311610368,CLRE 251,B00,511410,Mehta; Ravindra L.,9998,0,9999,1
1713311611392,CLRE 252,A00,507189,Cuomo; Raphael Eduardo,9998,0,9999,1
1713311612479,CLRE 253,A00,507199,Vaida; Florin,9997,0,9999,2
1713311612479,CLRE 253,B00,507202,Vaida; Florin,9999,0,9999,0
1713311613502,CLRE 259,A00,507211,Patel; Hemal,9996,0,9999,3
1713311614526,CLRE 260,A00,507221,Cuomo; Raphael Eduardo,9999,0,9999,0
1713311615553,CLRE 297,001,507242,Cuomo; Raphael Eduardo,9999,0,9999,0
1713311616581,CSE 191,A00,516875,Minnes Kemp; Mor Mia,9999,0,9999,0
1713311617607,CSS 201S,A01,494383,Staff,35,0,35,0
1713311618632,CSS 202S,A01,494387,Staff,35,0,35,0
1713311619658,EAP 100,A00,516065,Staff,9792,0,9999,207
1713311620683,ECE 45,A01,507414,Staff,54,0,60,6
1713311621710,ECE 100,A01,507416,Baghdadchi; Saharnaz,11,0,20,9
1713311621710,ECE 100,A02,507418,Baghdadchi; Saharnaz,20,0,20,0
1713311622739,ECE 111,A01,507420,Staff,40,0,50,10
1713311623769,ECE 197,001,548057,Sievenpiper; Daniel F.,9998,0,9999,1
1713311624796,EDS 115,A00,507243,Choi; Bailey Miyeon,28,0,28,0
1713311625824,EDS 117,A01,494379,Staff,25,0,25,0
1713311626851,EDS 125,A00,507246,Hopkins; Megan Beth,29,0,30,1
1713311627878,EDS 128A,A01,507264,Fargason; Sharon Gayle,26,0,26,0
1713311628905,EDS 128B,A01,507293,Pappas; Elizabeth,30,0,30,0
1713311629936,EDS 139,A00,507294,Fargason; Sharon Gayle,30,0,30,0
1713311629936,EDS 139,B00,507313,Pappas; Elizabeth,30,0,30,0
1713311630961,EDS 201,A00,507315,Staff,26,0,30,4
1713311631987,EDS 203,A01,507317,Halter; Christopher P.,26,0,30,4
1713311633017,EDS 204R,A01,507319,Halter; Christopher P.,5,0,30,25
1713311633017,EDS 204R,B01,507331,Heinzman; Erica M.,28,0,30,2
1713311634043,EDS 206R,A00,507332,Staff,7,0,30,23
1713311634043,EDS 206R,B00,507343,Staff,28,0,30,2
1713311635072,EDS 250,A00,507344,Hemans; Patricia Ann Benitez,36,0,40,4
1713311636097,EDS 281,A00,507345,Daly; Alan J.,18,0,18,0
1713311637121,EDS 284,A00,507350,Daly; Alan J.,16,0,16,0
1713311638148,EDS 286,A00,507359,Fine; Sarah,18,0,18,0
1713311639172,EDS 289C,A01,507361,Daly; Alan J.,18,0,18,0
1713311640198,EDS 290,A00,507366,Hofstetter; Carolyn,15,0,15,0
1713311641225,LIGM 5A,A00,507421,Fischer-Grunski; Eva K,20,0,20,0
1713311642251,LIGM 5B,A00,507423,Fischer-Grunski; Eva K,20,0,20,0
1713311643277,LIGM 5C,A00,507425,Fischer-Grunski; Eva K,20,0,20,0
1713311644302,LIIT 5AS,A00,507427,Carnelos; Chiara,20,0,20,0
1713311645328,LIIT 5BS,A00,507430,Carnelos; Chiara,20,0,20,0
1713311646353,LIIT 5CS,A00,507432,Carnelos; Chiara,20,0,20,0
1713311647377,LISP 5A,A00,507541,Munoz Sanchez; Alicia,19,0,20,1
1713311648403,LISP 5B,A00,507671,Munoz Sanchez; Alicia,17,0,20,3
1713311649431,LISP 5C,A00,507696,Munoz Sanchez; Alicia,17,0,20,3
1713311650456,MAE 197,001,528363,Boechler; Nicholas Sebastia,9998,0,9999,1
1713311651480,MATH 197,001,523477,Kedlaya; Kiran S.,9999,0,9999,0
1713311651480,MATH 197,002,563811,Zhang; Danna,9999,0,9999,0
1713311652504,MCWP 40R,A00,518780,Staff,20,0,20,0
1713311652504,MCWP 40R,B00,518781,Staff,19,0,20,1
1713311652504,MCWP 40R,C00,518783,Staff,19,0,20,1
1713311653533,MCWP 50R,A00,518791,Staff,20,0,20,0
1713311653533,MCWP 50R,B00,518792,Staff,19,0,20,1
1713311653533,MCWP 50R,C00,518793,Staff,19,0,20,1
1713311653533,MCWP 50R,D00,518794,Staff,18,0,20,2
1713311653533,MCWP 50R,E00,518795,Staff,18,0,20,2
1713311653533,MCWP 50R,F00,518796,Staff,19,0,20,1
1713311653533,MCWP 50R,G00,518797,Staff,19,0,20,1
1713311654558,MMW 12R,A01,514034,Herbst; Matthew,16,0,16,0
1713311654558,MMW 12R,A02,514035,Herbst; Matthew,16,0,16,0
1713311655585,MMW 13R,A01,514037,Staff,13,0,16,3
1713311655585,MMW 13R,A02,514039,Staff,16,0,16,0
1713311657638,SIO 295LS,A00,523233,Staff,19,0,30,11
1713311658665,SIO 295S,A00,523232,Staff,19,0,30,11
1713311659690,SOCI 117,A01,494376,Staff,3,0,5,2
1713311660714,WES 237B,A00,494380,Staff,19,0,20,1
1713311662781,AESE 279B,A00,494370,Wade; Jon P,33,0,33,0
1713311663806,ANAR 135S,A00,494369,Braswell; Geoffrey E.,0,0,0,0
1713311664831,CAT 124RS,A01,519847,Geibel; William,17,0,20,3
1713311665857,CAT 125RS,A01,515971,Geibel; William,17,0,20,3
1713311666882,CLRE 250,A00,511389,Morris; Sheldon,9996,0,9999,3
1713311667908,CLRE 251,A00,507176,Mehta; Ravindra L.,9996,0,9999,3
1713311667908,CLRE 251,B00,511410,Mehta; Ravindra L.,9998,0,9999,1
1713311668933,CLRE 252,A00,507189,Cuomo; Raphael Eduardo,9998,0,9999,1
1713311669963,CLRE 253,A00,507199,Vaida; Florin,9997,0,9999,2
1713311669963,CLRE 253,B00,507202,Vaida; Florin,9999,0,9999,0
1713311670987,CLRE 259,A00,507211,Patel; Hemal,9996,0,9999,3
1713311672012,CLRE 260,A00,507221,Cuomo; Raphael Eduardo,9999,0,9999,0
1713311673037,CLRE 297,001,507242,Cuomo; Raphael Eduardo,9999,0,9999,0
1713311674063,CSE 191,A00,516875,Minnes Kemp; Mor Mia,9999,0,9999,0
1713311675088,CSS 201S,A01,494383,Staff,35,0,35,0
1713311676113,CSS 202S,A01,494387,Staff,35,0,35,0
1713311677139,EAP 100,A00,516065,Staff,9792,0,9999,207
1713311678168,ECE 45,A01,507414,Staff,54,0,60,6
1713311679194,ECE 100,A01,507416,Baghdadchi; Saharnaz,11,0,20,9
1713311679194,ECE 100,A02,507418,Baghdadchi; Saharnaz,20,0,20,0
1713311680218,ECE 111,A01,507420,Staff,40,0,50,10
1713311681243,ECE 197,001,548057,Sievenpiper; Daniel F.,9998,0,9999,1
1713311682270,EDS 115,A00,507243,Choi; Bailey Miyeon,28,0,28,0
1713311683298,EDS 117,A01,494379,Staff,25,0,25,0
1713311684328,EDS 125,A00,507246,Hopkins; Megan Beth,29,0,30,1
1713311685352,EDS 128A,A01,507264,Fargason; Sharon Gayle,26,0,26,0
1713311686378,EDS 128B,A01,507293,Pappas; Elizabeth,30,0,30,0
1713311687403,EDS 139,A00,507294,Fargason; Sharon Gayle,30,0,30,0
1713311687403,EDS 139,B00,507313,Pappas; Elizabeth,30,0,30,0
1713311688430,EDS 201,A00,507315,Staff,26,0,30,4
1713311689460,EDS 203,A01,507317,Halter; Christopher P.,26,0,30,4
1713311690492,EDS 204R,A01,507319,Halter; Christopher P.,5,0,30,25
1713311690492,EDS 204R,B01,507331,Heinzman; Erica M.,28,0,30,2
1713311691516,EDS 206R,A00,507332,Staff,7,0,30,23
1713311691516,EDS 206R,B00,507343,Staff,28,0,30,2
1713311692547,EDS 250,A00,507344,Hemans; Patricia Ann Benitez,36,0,40,4
1713311693571,EDS 281,A00,507345,Daly; Alan J.,18,0,18,0
1713311694598,EDS 284,A00,507350,Daly; Alan J.,16,0,16,0
1713311695628,EDS 286,A00,507359,Fine; Sarah,18,0,18,0
1713311696652,EDS 289C,A01,507361,Daly; Alan J.,18,0,18,0
1713311697679,EDS 290,A00,507366,Hofstetter; Carolyn,15,0,15,0
1713311698705,LIGM 5A,A00,507421,Fischer-Grunski; Eva K,20,0,20,0
1713311699733,LIGM 5B,A00,507423,Fischer-Grunski; Eva K,20,0,20,0
1713311700758,LIGM 5C,A00,507425,Fischer-Grunski; Eva K,20,0,20,0
1713311701786,LIIT 5AS,A00,507427,Carnelos; Chiara,20,0,20,0
1713311702811,LIIT 5BS,A00,507430,Carnelos; Chiara,20,0,20,0
1713311703842,LIIT 5CS,A00,507432,Carnelos; Chiara,20,0,20,0
1713311704869,LISP 5A,A00,507541,Munoz Sanchez; Alicia,19,0,20,1
1713311705894,LISP 5B,A00,507671,Munoz Sanchez; Alicia,17,0,20,3
1713311706925,LISP 5C,A00,507696,Munoz Sanchez; Alicia,17,0,20,3
1713311707957,MAE 197,001,528363,Boechler; Nicholas Sebastia,9998,0,9999,1
1713311708982,MATH 197,001,523477,Kedlaya; Kiran S.,9999,0,9999,0
1713311708982,MATH 197,002,563811,Zhang; Danna,9999,0,9999,0
1713311710009,MCWP 40R,A00,518780,Staff,20,0,20,0
1713311710009,MCWP 40R,B00,518781,Staff,19,0,20,1
1713311710009,MCWP 40R,C00,518783,Staff,19,0,20,1
1713311711038,MCWP 50R,A00,518791,Staff,20,0,20,0
1713311711038,MCWP 50R,B00,518792,Staff,19,0,20,1
1713311711038,MCWP 50R,C00,518793,Staff,19,0,20,1
1713311711038,MCWP 50R,D00,518794,Staff,18,0,20,2
1713311711038,MCWP 50R,E00,518795,Staff,18,0,20,2
1713311711038,MCWP 50R,F00,518796,Staff,19,0,20,1
1713311711038,MCWP 50R,G00,518797,Staff,19,0,20,1
1713311712065,MMW 12R,A01,514034,Herbst; Matthew,16,0,16,0
1713311712065,MMW 12R,A02,514035,Herbst; Matthew,16,0,16,0
1713311713090,MMW 13R,A01,514037,Staff,13,0,16,3
1713311713090,MMW 13R,A02,514039,Staff,16,0,16,0
1713311715144,SIO 295LS,A00,523233,Staff,19,0,30,11
1713311716223,SIO 295S,A00,523232,Staff,19,0,30,11
1713311717251,SOCI 117,A01,494376,Staff,3,0,5,2
1713311718280,WES 237B,A00,494380,Staff,19,0,20,1
1713311720355,AESE 279B,A00,494370,Wade; Jon P,33,0,33,0
1713311721378,ANAR 135S,A00,494369,Braswell; Geoffrey E.,0,0,0,0
1713311722403,CAT 124RS,A01,519847,Geibel; William,17,0,20,3
1713311723433,CAT 125RS,A01,515971,Geibel; William,17,0,20,3
1713311724458,CLRE 250,A00,511389,Morris; Sheldon,9996,0,9999,3
1713311725487,CLRE 251,A00,507176,Mehta; Ravindra L.,9996,0,9999,3
1713311725487,CLRE 251,B00,511410,Mehta; Ravindra L.,9998,0,9999,1
1713311726516,CLRE 252,A00,507189,Cuomo; Raphael Eduardo,9998,0,9999,1
1713311727541,CLRE 253,A00,507199,Vaida; Florin,9997,0,9999,2
1713311727541,CLRE 253,B00,507202,Vaida; Florin,9999,0,9999,0
1713311728568,CLRE 259,A00,507211,Patel; Hemal,9996,0,9999,3
1713311729595,CLRE 260,A00,507221,Cuomo; Raphael Eduardo,9999,0,9999,0
1713311730619,CLRE 297,001,507242,Cuomo; Raphael Eduardo,9999,0,9999,0
1713311731649,CSE 191,A00,516875,Minnes Kemp; Mor Mia,9999,0,9999,0
1713311732679,CSS 201S,A01,494383,Staff,35,0,35,0
1713311733705,CSS 202S,A01,494387,Staff,35,0,35,0
1713311734729,EAP 100,A00,516065,Staff,9792,0,9999,207
1713311735755,ECE 45,A01,507414,Staff,54,0,60,6
1713311736785,ECE 100,A01,507416,Baghdadchi; Saharnaz,11,0,20,9
1713311736785,ECE 100,A02,507418,Baghdadchi; Saharnaz,20,0,20,0
1713311737813,ECE 111,A01,507420,Staff,40,0,50,10
1713311738838,ECE 197,001,548057,Sievenpiper; Daniel F.,9998,0,9999,1
1713311739868,EDS 115,A00,507243,Choi; Bailey Miyeon,28,0,28,0
1713311740894,EDS 117,A01,494379,Staff,25,0,25,0
1713311741919,EDS 125,A00,507246,Hopkins; Megan Beth,29,0,30,1
1713311742945,EDS 128A,A01,507264,Fargason; Sharon Gayle,26,0,26,0
1713311743972,EDS 128B,A01,507293,Pappas; Elizabeth,30,0,30,0
1713311744997,EDS 139,A00,507294,Fargason; Sharon Gayle,30,0,30,0
1713311744997,EDS 139,B00,507313,Pappas; Elizabeth,30,0,30,0
1713311746024,EDS 201,A00,507315,Staff,26,0,30,4
1713311747052,EDS 203,A01,507317,Halter; Christopher P.,26,0,30,4
1713311748077,EDS 204R,A01,507319,Halter; Christopher P.,5,0,30,25
1713311748077,EDS 204R,B01,507331,Heinzman; Erica M.,28,0,30,2
1713311749103,EDS 206R,A00,507332,Staff,7,0,30,23
1713311749103,EDS 206R,B00,507343,Staff,28,0,30,2
1713311750129,EDS 250,A00,507344,Hemans; Patricia Ann Benitez,36,0,40,4
1713311751154,EDS 281,A00,507345,Daly; Alan J.,18,0,18,0
1713311752179,EDS 284,A00,507350,Daly; Alan J.,16,0,16,0
1713311753209,EDS 286,A00,507359,Fine; Sarah,18,0,18,0
1713311754233,EDS 289C,A01,507361,Daly; Alan J.,18,0,18,0
1713311755259,EDS 290,A00,507366,Hofstetter; Carolyn,15,0,15,0
1713311756284,LIGM 5A,A00,507421,Fischer-Grunski; Eva K,20,0,20,0
1713311757313,LIGM 5B,A00,507423,Fischer-Grunski; Eva K,20,0,20,0
1713311758338,LIGM 5C,A00,507425,Fischer-Grunski; Eva K,20,0,20,0
1713311759363,LIIT 5AS,A00,507427,Carnelos; Chiara,20,0,20,0
1713311760388,LIIT 5BS,A00,507430,Carnelos; Chiara,20,0,20,0
1713311761412,LIIT 5CS,A00,507432,Carnelos; Chiara,20,0,20,0
1713311762442,LISP 5A,A00,507541,Munoz Sanchez; Alicia,19,0,20,1
1713311763466,LISP 5B,A00,507671,Munoz Sanchez; Alicia,17,0,20,3
1713311764496,LISP 5C,A00,507696,Munoz Sanchez; Alicia,17,0,20,3
1713311765521,MAE 197,001,528363,Boechler; Nicholas Sebastia,9998,0,9999,1
1713311766551,MATH 197,001,523477,Kedlaya; Kiran S.,9999,0,9999,0
1713311766551,MATH 197,002,563811,Zhang; Danna,9999,0,9999,0
1713311767577,MCWP 40R,A00,518780,Staff,20,0,20,0
1713311767577,MCWP 40R,B00,518781,Staff,19,0,20,1
1713311767577,MCWP 40R,C00,518783,Staff,19,0,20,1
1713311768605,MCWP 50R,A00,518791,Staff,20,0,20,0
1713311768605,MCWP 50R,B00,518792,Staff,19,0,20,1
1713311768605,MCWP 50R,C00,518793,Staff,19,0,20,1
1713311768605,MCWP 50R,D00,518794,Staff,18,0,20,2
1713311768605,MCWP 50R,E00,518795,Staff,18,0,20,2
1713311768605,MCWP 50R,F00,518796,Staff,19,0,20,1
1713311768605,MCWP 50R,G00,518797,Staff,19,0,20,1
1713311769630,MMW 12R,A01,514034,Herbst; Matthew,16,0,16,0
1713311769630,MMW 12R,A02,514035,Herbst; Matthew,16,0,16,0
1713311770657,MMW 13R,A01,514037,Staff,13,0,16,3
1713311770657,MMW 13R,A02,514039,Staff,16,0,16,0
1713311772708,SIO 295LS,A00,523233,Staff,19,0,30,11
1713311773737,SIO 295S,A00,523232,Staff,19,0,30,11
1713311774765,SOCI 117,A01,494376,Staff,3,0,5,2
1713311775794,WES 237B,A00,494380,Staff,19,0,20,1
1713311777866,AESE 279B,A00,494370,Wade; Jon P,33,0,33,0
1713311778892,ANAR 135S,A00,494369,Braswell; Geoffrey E.,0,0,0,0
1713311779921,CAT 124RS,A01,519847,Geibel; William,17,0,20,3
1713311780950,CAT 125RS,A01,515971,Geibel; William,17,0,20,3
1713311781977,CLRE 250,A00,511389,Morris; Sheldon,9996,0,9999,3
1713311783002,CLRE 251,A00,507176,Mehta; Ravindra L.,9996,0,9999,3
1713311783002,CLRE 251,B00,511410,Mehta; Ravindra L.,9998,0,9999,1
1713311784029,CLRE 252,A00,507189,Cuomo; Raphael Eduardo,9998,0,9999,1
1713311785057,CLRE 253,A00,507199,Vaida; Florin,9997,0,9999,2
1713311785057,CLRE 253,B00,507202,Vaida; Florin,9999,0,9999,0
1713311786083,CLRE 259,A00,507211,Patel; Hemal,9996,0,9999,3
1713311787108,CLRE 260,A00,507221,Cuomo; Raphael Eduardo,9999,0,9999,0
1713311788132,CLRE 297,001,507242,Cuomo; Raphael Eduardo,9999,0,9999,0
1713311789156,CSE 191,A00,516875,Minnes Kemp; Mor Mia,9999,0,9999,0
1713311790182,CSS 201S,A01,494383,Staff,35,0,35,0
1713311791207,CSS 202S,A01,494387,Staff,35,0,35,0
1713311792234,EAP 100,A00,516065,Staff,9792,0,9999,207
1713311793260,ECE 45,A01,507414,Staff,54,0,60,6
1713311794286,ECE 100,A01,507416,Baghdadchi; Saharnaz,11,0,20,9
1713311794286,ECE 100,A02,507418,Baghdadchi; Saharnaz,20,0,20,0
1713311795311,ECE 111,A01,507420,Staff,40,0,50,10
1713311796335,ECE 197,001,548057,Sievenpiper; Daniel F.,9998,0,9999,1
1713311797361,EDS 115,A00,507243,Choi; Bailey Miyeon,28,0,28,0
1713311798387,EDS 117,A01,494379,Staff,25,0,25,0
1713311799412,EDS 125,A00,507246,Hopkins; Megan Beth,29,0,30,1
1713311800437,EDS 128A,A01,507264,Fargason; Sharon Gayle,26,0,26,0
1713311801461,EDS 128B,A01,507293,Pappas; Elizabeth,30,0,30,0
1713311802486,EDS 139,A00,507294,Fargason; Sharon Gayle,30,0,30,0
1713311802486,EDS 139,B00,507313,Pappas; Elizabeth,30,0,30,0
1713311803510,EDS 201,A00,507315,Staff,26,0,30,4
1713311804535,EDS 203,A01,507317,Halter; Christopher P.,26,0,30,4
1713311805561,EDS 204R,A01,507319,Halter; Christopher P.,5,0,30,25
1713311805561,EDS 204R,B01,507331,Heinzman; Erica M.,28,0,30,2
1713311806586,EDS 206R,A00,507332,Staff,7,0,30,23
1713311806586,EDS 206R,B00,507343,Staff,27,0,30,3
1713311807614,EDS 250,A00,507344,Hemans; Patricia Ann Benitez,36,0,40,4
1713311808643,EDS 281,A00,507345,Daly; Alan J.,18,0,18,0
1713311809669,EDS 284,A00,507350,Daly; Alan J.,16,0,16,0
1713311810693,EDS 286,A00,507359,Fine; Sarah,18,0,18,0
1713311811724,EDS 289C,A01,507361,Daly; Alan J.,18,0,18,0
1713311812754,EDS 290,A00,507366,Hofstetter; Carolyn,15,0,15,0
1713311813780,LIGM 5A,A00,507421,Fischer-Grunski; Eva K,20,0,20,0
1713311814806,LIGM 5B,A00,507423,Fischer-Grunski; Eva K,20,0,20,0
1713311815831,LIGM 5C,A00,507425,Fischer-Grunski; Eva K,20,0,20,0
1713311816857,LIIT 5AS,A00,507427,Carnelos; Chiara,20,0,20,0
1713311817884,LIIT 5BS,A00,507430,Carnelos; Chiara,20,0,20,0
1713311818909,LIIT 5CS,A00,507432,Carnelos; Chiara,20,0,20,0
1713311820002,LISP 5A,A00,507541,Munoz Sanchez; Alicia,19,0,20,1
1713311821032,LISP 5B,A00,507671,Munoz Sanchez; Alicia,17,0,20,3
1713311822056,LISP 5C,A00,507696,Munoz Sanchez; Alicia,17,0,20,3
1713311823082,MAE 197,001,528363,Boechler; Nicholas Sebastia,9998,0,9999,1
1713311824109,MATH 197,001,523477,Kedlaya; Kiran S.,9999,0,9999,0
1713311824109,MATH 197,002,563811,Zhang; Danna,9999,0,9999,0
1713311825133,MCWP 40R,A00,518780,Staff,20,0,20,0
1713311825133,MCWP 40R,B00,518781,Staff,19,0,20,1
1713311825133,MCWP 40R,C00,518783,Staff,19,0,20,1
1713311826157,MCWP 50R,A00,518791,Staff,20,0,20,0
1713311826157,MCWP 50R,B00,518792,Staff,19,0,20,1
1713311826157,MCWP 50R,C00,518793,Staff,19,0,20,1
1713311826157,MCWP 50R,D00,518794,Staff,18,0,20,2
1713311826157,MCWP 50R,E00,518795,Staff,18,0,20,2
1713311826157,MCWP 50R,F00,518796,Staff,19,0,20,1
1713311826157,MCWP 50R,G00,518797,Staff,19,0,20,1
1713311827183,MMW 12R,A01,514034,Herbst; Matthew,16,0,16,0
1713311827183,MMW 12R,A02,514035,Herbst; Matthew,16,0,16,0
1713311828208,MMW 13R,A01,514037,Staff,13,0,16,3
1713311828208,MMW 13R,A02,514039,Staff,16,0,16,0
1713311830261,SIO 295LS,A00,523233,Staff,19,0,30,11
1713311831289,SIO 295S,A00,523232,Staff,19,0,30,11
1713311832314,SOCI 117,A01,494376,Staff,3,0,5,2
1713311833339,WES 237B,A00,494380,Staff,19,0,20,1
1713311835404,AESE 279B,A00,494370,Wade; Jon P,33,0,33,0
1713311836429,ANAR 135S,A00,494369,Braswell; Geoffrey E.,0,0,0,0
1713311837454,CAT 124RS,A01,519847,Geibel; William,17,0,20,3
1713311838483,CAT 125RS,A01,515971,Geibel; William,17,0,20,3
1713311839512,CLRE 250,A00,511389,Morris; Sheldon,9996,0,9999,3
1713311840542,CLRE 251,A00,507176,Mehta; Ravindra L.,9996,0,9999,3
1713311840542,CLRE 251,B00,511410,Mehta; Ravindra L.,9998,0,9999,1
1713311841567,CLRE 252,A00,507189,Cuomo; Raphael Eduardo,9998,0,9999,1
1713311842592,CLRE 253,A00,507199,Vaida; Florin,9997,0,9999,2
1713311842592,CLRE 253,B00,507202,Vaida; Florin,9999,0,9999,0
1713311843623,CLRE 259,A00,507211,Patel; Hemal,9996,0,9999,3
1713311844652,CLRE 260,A00,507221,Cuomo; Raphael Eduardo,9999,0,9999,0
1713311845682,CLRE 297,001,507242,Cuomo; Raphael Eduardo,9999,0,9999,0
1713311846707,CSE 191,A00,516875,Minnes Kemp; Mor Mia,9999,0,9999,0
1713311847734,CSS 201S,A01,494383,Staff,35,0,35,0
1713311848759,CSS 202S,A01,494387,Staff,35,0,35,0
1713311849784,EAP 100,A00,516065,Staff,9792,0,9999,207
1713311850810,ECE 45,A01,507414,Staff,54,0,60,6
1713311851837,ECE 100,A01,507416,Baghdadchi; Saharnaz,11,0,20,9
1713311851837,ECE 100,A02,507418,Baghdadchi; Saharnaz,20,0,20,0
1713311852862,ECE 111,A01,507420,Staff,40,0,50,10
1713311853900,ECE 197,001,548057,Sievenpiper; Daniel F.,9998,0,9999,1
1713311854926,EDS 115,A00,507243,Choi; Bailey Miyeon,28,0,28,0
1713311855955,EDS 117,A01,494379,Staff,25,0,25,0
1713311856982,EDS 125,A00,507246,Hopkins; Megan Beth,29,0,30,1
1713311858008,EDS 128A,A01,507264,Fargason; Sharon Gayle,26,0,26,0
1713311859038,EDS 128B,A01,507293,Pappas; Elizabeth,30,0,30,0
1713311860064,EDS 139,A00,507294,Fargason; Sharon Gayle,30,0,30,0
1713311860064,EDS 139,B00,507313,Pappas; Elizabeth,30,0,30,0
1713311861095,EDS 201,A00,507315,Staff,26,0,30,4
1713311862119,EDS 203,A01,507317,Halter; Christopher P.,26,0,30,4
1713311863150,EDS 204R,A01,507319,Halter; Christopher P.,5,0,30,25
1713311863150,EDS 204R,B01,507331,Heinzman; Erica M.,28,0,30,2
1713311864175,EDS 206R,A00,507332,Staff,7,0,30,23
1713311864175,EDS 206R,B00,507343,Staff,27,0,30,3
1713311865201,EDS 250,A00,507344,Hemans; Patricia Ann Benitez,36,0,40,4
1713311866232,EDS 281,A00,507345,Daly; Alan J.,18,0,18,0
1713311867258,EDS 284,A00,507350,Daly; Alan J.,16,0,16,0
1713311868284,EDS 286,A00,507359,Fine; Sarah,18,0,18,0
1713311869309,EDS 289C,A01,507361,Daly; Alan J.,18,0,18,0
1713311870333,EDS 290,A00,507366,Hofstetter; Carolyn,15,0,15,0
1713311871362,LIGM 5A,A00,507421,Fischer-Grunski; Eva K,20,0,20,0
1713311872387,LIGM 5B,A00,507423,Fischer-Grunski; Eva K,20,0,20,0
1713311873416,LIGM 5C,A00,507425,Fischer-Grunski; Eva K,20,0,20,0
1713311874444,LIIT 5AS,A00,507427,Carnelos; Chiara,20,0,20,0
1713311875469,LIIT 5BS,A00,507430,Carnelos; Chiara,20,0,20,0
1713311876500,LIIT 5CS,A00,507432,Carnelos; Chiara,20,0,20,0
1713311877524,LISP 5A,A00,507541,Munoz Sanchez; Alicia,19,0,20,1
1713311878549,LISP 5B,A00,507671,Munoz Sanchez; Alicia,17,0,20,3
1713311879572,LISP 5C,A00,507696,Munoz Sanchez; Alicia,17,0,20,3
1713311880597,MAE 197,001,528363,Boechler; Nicholas Sebastia,9998,0,9999,1
1713311881625,MATH 197,001,523477,Kedlaya; Kiran S.,9999,0,9999,0
1713311881625,MATH 197,002,563811,Zhang; Danna,9999,0,9999,0
1713311882654,MCWP 40R,A00,518780,Staff,20,0,20,0
1713311882654,MCWP 40R,B00,518781,Staff,19,0,20,1
1713311882654,MCWP 40R,C00,518783,Staff,19,0,20,1
1713311883683,MCWP 50R,A00,518791,Staff,20,0,20,0
1713311883683,MCWP 50R,B00,518792,Staff,19,0,20,1
1713311883683,MCWP 50R,C00,518793,Staff,19,0,20,1
1713311883683,MCWP 50R,D00,518794,Staff,18,0,20,2
1713311883683,MCWP 50R,E00,518795,Staff,18,0,20,2
1713311883683,MCWP 50R,F00,518796,Staff,19,0,20,1
1713311883683,MCWP 50R,G00,518797,Staff,19,0,20,1
1713311884707,MMW 12R,A01,514034,Herbst; Matthew,16,0,16,0
1713311884707,MMW 12R,A02,514035,Herbst; Matthew,16,0,16,0
1713311885736,MMW 13R,A01,514037,Staff,13,0,16,3
1713311885736,MMW 13R,A02,514039,Staff,16,0,16,0
1713311887788,SIO 295LS,A00,523233,Staff,19,0,30,11
1713311888813,SIO 295S,A00,523232,Staff,19,0,30,11
1713311889841,SOCI 117,A01,494376,Staff,3,0,5,2
1713311890870,WES 237B,A00,494380,Staff,19,0,20,1
1713311892942,AESE 279B,A00,494370,Wade; Jon P,33,0,33,0
1713311893966,ANAR 135S,A00,494369,Braswell; Geoffrey E.,0,0,0,0
1713311894993,CAT 124RS,A01,519847,Geibel; William,17,0,20,3
1713311896018,CAT 125RS,A01,515971,Geibel; William,17,0,20,3
1713311897041,CLRE 250,A00,511389,Morris; Sheldon,9996,0,9999,3
1713311898072,CLRE 251,A00,507176,Mehta; Ravindra L.,9996,0,9999,3
1713311898072,CLRE 251,B00,511410,Mehta; Ravindra L.,9998,0,9999,1
1713311899099,CLRE 252,A00,507189,Cuomo; Raphael Eduardo,9998,0,9999,1
1713311900127,CLRE 253,A00,507199,Vaida; Florin,9997,0,9999,2
1713311900127,CLRE 253,B00,507202,Vaida; Florin,9999,0,9999,0
1713311901153,CLRE 259,A00,507211,Patel; Hemal,9996,0,9999,3
1713311902181,CLRE 260,A00,507221,Cuomo; Raphael Eduardo,9999,0,9999,0
1713311903209,CLRE 297,001,507242,Cuomo; Raphael Eduardo,9999,0,9999,0
1713311904234,CSE 191,A00,516875,Minnes Kemp; Mor Mia,9999,0,9999,0
1713311905260,CSS 201S,A01,494383,Staff,35,0,35,0
1713311906291,CSS 202S,A01,494387,Staff,35,0,35,0
1713311907319,EAP 100,A00,516065,Staff,9792,0,9999,207
1713311908348,ECE 45,A01,507414,Staff,54,0,60,6
1713311909378,ECE 100,A01,507416,Baghdadchi; Saharnaz,11,0,20,9
1713311909378,ECE 100,A02,507418,Baghdadchi; Saharnaz,20,0,20,0
1713311910403,ECE 111,A01,507420,Staff,40,0,50,10
1713311911428,ECE 197,001,548057,Sievenpiper; Daniel F.,9998,0,9999,1
1713311912455,EDS 115,A00,507243,Choi; Bailey Miyeon,28,0,28,0
1713311913482,EDS 117,A01,494379,Staff,25,0,25,0
1713311914508,EDS 125,A00,507246,Hopkins; Megan Beth,29,0,30,1
1713311915538,EDS 128A,A01,507264,Fargason; Sharon Gayle,26,0,26,0
1713311916566,EDS 128B,A01,507293,Pappas; Elizabeth,30,0,30,0
1713311917592,EDS 139,A00,507294,Fargason; Sharon Gayle,30,0,30,0
1713311917592,EDS 139,B00,507313,Pappas; Elizabeth,30,0,30,0
1713311918617,EDS 201,A00,507315,Staff,26,0,30,4
1713311919644,EDS 203,A01,507317,Halter; Christopher P.,26,0,30,4
1713311920674,EDS 204R,A01,507319,Halter; Christopher P.,5,0,30,25
1713311920674,EDS 204R,B01,507331,Heinzman; Erica M.,28,0,30,2
1713311921702,EDS 206R,A00,507332,Staff,7,0,30,23
1713311921702,EDS 206R,B00,507343,Staff,27,0,30,3
1713311922727,EDS 250,A00,507344,Hemans; Patricia Ann Benitez,36,0,40,4
1713311923812,EDS 281,A00,507345,Daly; Alan J.,18,0,18,0
1713311924840,EDS 284,A00,507350,Daly; Alan J.,16,0,16,0
1713311925883,EDS 286,A00,507359,Fine; Sarah,18,0,18,0
1713311926909,EDS 289C,A01,507361,Daly; Alan J.,18,0,18,0
1713311927939,EDS 290,A00,507366,Hofstetter; Carolyn,15,0,15,0
1713311928966,LIGM 5A,A00,507421,Fischer-Grunski; Eva K,20,0,20,0
1713311929991,LIGM 5B,A00,507423,Fischer-Grunski; Eva K,20,0,20,0
1713311931017,LIGM 5C,A00,507425,Fischer-Grunski; Eva K,20,0,20,0
1713311932043,LIIT 5AS,A00,507427,Carnelos; Chiara,20,0,20,0
1713311933071,LIIT 5BS,A00,507430,Carnelos; Chiara,20,0,20,0
1713311934102,LIIT 5CS,A00,507432,Carnelos; Chiara,20,0,20,0
1713311935128,LISP 5A,A00,507541,Munoz Sanchez; Alicia,19,0,20,1
1713311936154,LISP 5B,A00,507671,Munoz Sanchez; Alicia,17,0,20,3
1713311937179,LISP 5C,A00,507696,Munoz Sanchez; Alicia,17,0,20,3
1713311938205,MAE 197,001,528363,Boechler; Nicholas Sebastia,9998,0,9999,1
1713311939231,MATH 197,001,523477,Kedlaya; Kiran S.,9999,0,9999,0
1713311939231,MATH 197,002,563811,Zhang; Danna,9999,0,9999,0
1713311940257,MCWP 40R,A00,518780,Staff,20,0,20,0
1713311940257,MCWP 40R,B00,518781,Staff,19,0,20,1
1713311940257,MCWP 40R,C00,518783,Staff,19,0,20,1
1713311941287,MCWP 50R,A00,518791,Staff,20,0,20,0
1713311941287,MCWP 50R,B00,518792,Staff,19,0,20,1
1713311941287,MCWP 50R,C00,518793,Staff,19,0,20,1
1713311941287,MCWP 50R,D00,518794,Staff,18,0,20,2
1713311941287,MCWP 50R,E00,518795,Staff,18,0,20,2
1713311941287,MCWP 50R,F00,518796,Staff,19,0,20,1
1713311941287,MCWP 50R,G00,518797,Staff,19,0,20,1
1713311942317,MMW 12R,A01,514034,Herbst; Matthew,16,0,16,0
1713311942317,MMW 12R,A02,514035,Herbst; Matthew,16,0,16,0
1713311943341,MMW 13R,A01,514037,Staff,13,0,16,3
1713311943341,MMW 13R,A02,514039,Staff,16,0,16,0
1713311945391,SIO 295LS,A00,523233,Staff,19,0,30,11
1713311946419,SIO 295S,A00,523232,Staff,19,0,30,11
1713311947448,SOCI 117,A01,494376,Staff,3,0,5,2
1713311948473,WES 237B,A00,494380,Staff,19,0,20,1
1713311950544,AESE 279B,A00,494370,Wade; Jon P,33,0,33,0
1713311951570,ANAR 135S,A00,494369,Braswell; Geoffrey E.,0,0,0,0
1713311952595,CAT 124RS,A01,519847,Geibel; William,17,0,20,3
1713311953623,CAT 125RS,A01,515971,Geibel; William,17,0,20,3
1713311954648,CLRE 250,A00,511389,Morris; Sheldon,9996,0,9999,3
1713311955675,CLRE 251,A00,507176,Mehta; Ravindra L.,9996,0,9999,3
1713311955675,CLRE 251,B00,511410,Mehta; Ravindra L.,9998,0,9999,1
1713311956703,CLRE 252,A00,507189,Cuomo; Raphael Eduardo,9998,0,9999,1
1713311957729,CLRE 253,A00,507199,Vaida; Florin,9997,0,9999,2
1713311957729,CLRE 253,B00,507202,Vaida; Florin,9999,0,9999,0
1713311958754,CLRE 259,A00,507211,Patel; Hemal,9996,0,9999,3
1713311959778,CLRE 260,A00,507221,Cuomo; Raphael Eduardo,9999,0,9999,0
1713311960803,CLRE 297,001,507242,Cuomo; Raphael Eduardo,9999,0,9999,0
1713311961829,CSE 191,A00,516875,Minnes Kemp; Mor Mia,9999,0,9999,0
1713311962855,CSS 201S,A01,494383,Staff,35,0,35,0
1713311963884,CSS 202S,A01,494387,Staff,35,0,35,0
1713311964910,EAP 100,A00,516065,Staff,9792,0,9999,207
1713311965936,ECE 45,A01,507414,Staff,54,0,60,6
1713311966962,ECE 100,A01,507416,Baghdadchi; Saharnaz,11,0,20,9
1713311966962,ECE 100,A02,507418,Baghdadchi; Saharnaz,20,0,20,0
1713311967987,ECE 111,A01,507420,Staff,40,0,50,10
1713311969012,ECE 197,001,548057,Sievenpiper; Daniel F.,9998,0,9999,1
1713311970037,EDS 115,A00,507243,Choi; Bailey Miyeon,28,0,28,0
1713311971066,EDS 117,A01,494379,Staff,25,0,25,0
1713311972092,EDS 125,A00,507246,Hopkins; Megan Beth,29,0,30,1
1713311973124,EDS 128A,A01,507264,Fargason; Sharon Gayle,26,0,26,0
1713311974152,EDS 128B,A01,507293,Pappas; Elizabeth,30,0,30,0
1713311975176,EDS 139,A00,507294,Fargason; Sharon Gayle,30,0,30,0
1713311975176,EDS 139,B00,507313,Pappas; Elizabeth,30,0,30,0
1713311976201,EDS 201,A00,507315,Staff,26,0,30,4
1713311977232,EDS 203,A01,507317,Halter; Christopher P.,26,0,30,4
1713311978263,EDS 204R,A01,507319,Halter; Christopher P.,5,0,30,25
1713311978263,EDS 204R,B01,507331,Heinzman; Erica M.,28,0,30,2
1713311979291,EDS 206R,A00,507332,Staff,7,0,30,23
1713311979291,EDS 206R,B00,507343,Staff,27,0,30,3
1713311980321,EDS 250,A00,507344,Hemans; Patricia Ann Benitez,36,0,40,4
1713311981347,EDS 281,A00,507345,Daly; Alan J.,18,0,18,0
1713311982375,EDS 284,A00,507350,Daly; Alan J.,16,0,16,0
1713311983401,EDS 286,A00,507359,Fine; Sarah,18,0,18,0
1713311984427,EDS 289C,A01,507361,Daly; Alan J.,18,0,18,0
1713311985453,EDS 290,A00,507366,Hofstetter; Carolyn,15,0,15,0
1713311986483,LIGM 5A,A00,507421,Fischer-Grunski; Eva K,20,0,20,0
1713311987512,LIGM 5B,A00,507423,Fischer-Grunski; Eva K,20,0,20,0
1713311988536,LIGM 5C,A00,507425,Fischer-Grunski; Eva K,20,0,20,0
1713311989566,LIIT 5AS,A00,507427,Carnelos; Chiara,20,0,20,0
1713311990591,LIIT 5BS,A00,507430,Carnelos; Chiara,20,0,20,0
1713311991616,LIIT 5CS,A00,507432,Carnelos; Chiara,20,0,20,0
1713311992645,LISP 5A,A00,507541,Munoz Sanchez; Alicia,19,0,20,1
1713311993669,LISP 5B,A00,507671,Munoz Sanchez; Alicia,17,0,20,3
1713311994699,LISP 5C,A00,507696,Munoz Sanchez; Alicia,17,0,20,3
1713311995724,MAE 197,001,528363,Boechler; Nicholas Sebastia,9998,0,9999,1
1713311996755,MATH 197,001,523477,Kedlaya; Kiran S.,9999,0,9999,0
1713311996755,MATH 197,002,563811,Zhang; Danna,9999,0,9999,0
1713311997781,MCWP 40R,A00,518780,Staff,20,0,20,0
1713311997781,MCWP 40R,B00,518781,Staff,19,0,20,1
1713311997781,MCWP 40R,C00,518783,Staff,19,0,20,1
1713311998810,MCWP 50R,A00,518791,Staff,20,0,20,0
1713311998810,MCWP 50R,B00,518792,Staff,19,0,20,1
1713311998810,MCWP 50R,C00,518793,Staff,19,0,20,1
1713311998810,MCWP 50R,D00,518794,Staff,18,0,20,2
1713311998810,MCWP 50R,E00,518795,Staff,18,0,20,2
1713311998810,MCWP 50R,F00,518796,Staff,19,0,20,1
1713311998810,MCWP 50R,G00,518797,Staff,19,0,20,1
1713311999839,MMW 12R,A01,514034,Herbst; Matthew,16,0,16,0
1713311999839,MMW 12R,A02,514035,Herbst; Matthew,16,0,16,0
1713312000865,MMW 13R,A01,514037,Staff,13,0,16,3
1713312000865,MMW 13R,A02,514039,Staff,16,0,16,0
1713312002920,SIO 295LS,A00,523233,Staff,19,0,30,11
1713312003946,SIO 295S,A00,523232,Staff,19,0,30,11
1713312004970,SOCI 117,A01,494376,Staff,3,0,5,2
1713312005997,WES 237B,A00,494380,Staff,19,0,20,1
1713312008062,AESE 279B,A00,494370,Wade; Jon P,33,0,33,0
1713312009088,ANAR 135S,A00,494369,Braswell; Geoffrey E.,0,0,0,0
1713312010113,CAT 124RS,A01,519847,Geibel; William,17,0,20,3
1713312011140,CAT 125RS,A01,515971,Geibel; William,17,0,20,3
1713312012166,CLRE 250,A00,511389,Morris; Sheldon,9996,0,9999,3
1713312013200,CLRE 251,A00,507176,Mehta; Ravindra L.,9996,0,9999,3
1713312013200,CLRE 251,B00,511410,Mehta; Ravindra L.,9998,0,9999,1
1713312014229,CLRE 252,A00,507189,Cuomo; Raphael Eduardo,9998,0,9999,1
1713312015261,CLRE 253,A00,507199,Vaida; Florin,9997,0,9999,2
1713312015261,CLRE 253,B00,507202,Vaida; Florin,9999,0,9999,0
1713312016290,CLRE 259,A00,507211,Patel; Hemal,9996,0,9999,3
1713312017317,CLRE 260,A00,507221,Cuomo; Raphael Eduardo,9999,0,9999,0
1713312018343,CLRE 297,001,507242,Cuomo; Raphael Eduardo,9999,0,9999,0
1713312019371,CSE 191,A00,516875,Minnes Kemp; Mor Mia,9999,0,9999,0
1713312020396,CSS 201S,A01,494383,Staff,35,0,35,0
1713312021425,CSS 202S,A01,494387,Staff,35,0,35,0
1713312022453,EAP 100,A00,516065,Staff,9792,0,9999,207
1713312023479,ECE 45,A01,507414,Staff,54,0,60,6
1713312024504,ECE 100,A01,507416,Baghdadchi; Saharnaz,11,0,20,9
1713312024504,ECE 100,A02,507418,Baghdadchi; Saharnaz,20,0,20,0
1713312025532,ECE 111,A01,507420,Staff,40,0,50,10
1713312026558,ECE 197,001,548057,Sievenpiper; Daniel F.,9998,0,9999,1
1713312027640,EDS 115,A00,507243,Choi; Bailey Miyeon,28,0,28,0
1713312028669,EDS 117,A01,494379,Staff,25,0,25,0
1713312029694,EDS 125,A00,507246,Hopkins; Megan Beth,29,0,30,1
1713312030725,EDS 128A,A01,507264,Fargason; Sharon Gayle,26,0,26,0
1713312031751,EDS 128B,A01,507293,Pappas; Elizabeth,30,0,30,0
1713312032776,EDS 139,A00,507294,Fargason; Sharon Gayle,30,0,30,0
1713312032776,EDS 139,B00,507313,Pappas; Elizabeth,30,0,30,0
1713312033800,EDS 201,A00,507315,Staff,26,0,30,4
1713312034824,EDS 203,A01,507317,Halter; Christopher P.,26,0,30,4
1713312035852,EDS 204R,A01,507319,Halter; Christopher P.,5,0,30,25
1713312035852,EDS 204R,B01,507331,Heinzman; Erica M.,28,0,30,2
1713312036878,EDS 206R,A00,507332,Staff,7,0,30,23
1713312036878,EDS 206R,B00,507343,Staff,27,0,30,3
1713312037904,EDS 250,A00,507344,Hemans; Patricia Ann Benitez,36,0,40,4
1713312038934,EDS 281,A00,507345,Daly; Alan J.,18,0,18,0
1713312039962,EDS 284,A00,507350,Daly; Alan J.,16,0,16,0
1713312040987,EDS 286,A00,507359,Fine; Sarah,18,0,18,0
1713312042012,EDS 289C,A01,507361,Daly; Alan J.,18,0,18,0
1713312043038,EDS 290,A00,507366,Hofstetter; Carolyn,15,0,15,0
1713312044065,LIGM 5A,A00,507421,Fischer-Grunski; Eva K,20,0,20,0
1713312045100,LIGM 5B,A00,507423,Fischer-Grunski; Eva K,20,0,20,0
1713312046127,LIGM 5C,A00,507425,Fischer-Grunski; Eva K,20,0,20,0
1713312047156,LIIT 5AS,A00,507427,Carnelos; Chiara,20,0,20,0
1713312048181,LIIT 5BS,A00,507430,Carnelos; Chiara,20,0,20,0
1713312049205,LIIT 5CS,A00,507432,Carnelos; Chiara,20,0,20,0
1713312050230,LISP 5A,A00,507541,Munoz Sanchez; Alicia,19,0,20,1
1713312051255,LISP 5B,A00,507671,Munoz Sanchez; Alicia,17,0,20,3
1713312052282,LISP 5C,A00,507696,Munoz Sanchez; Alicia,17,0,20,3
1713312053306,MAE 197,001,528363,Boechler; Nicholas Sebastia,9998,0,9999,1
1713312054337,MATH 197,001,523477,Kedlaya; Kiran S.,9999,0,9999,0
1713312054337,MATH 197,002,563811,Zhang; Danna,9999,0,9999,0
1713312055363,MCWP 40R,A00,518780,Staff,20,0,20,0
1713312055363,MCWP 40R,B00,518781,Staff,19,0,20,1
1713312055363,MCWP 40R,C00,518783,Staff,19,0,20,1
1713312056388,MCWP 50R,A00,518791,Staff,20,0,20,0
1713312056388,MCWP 50R,B00,518792,Staff,19,0,20,1
1713312056388,MCWP 50R,C00,518793,Staff,19,0,20,1
1713312056388,MCWP 50R,D00,518794,Staff,18,0,20,2
1713312056388,MCWP 50R,E00,518795,Staff,18,0,20,2
1713312056388,MCWP 50R,F00,518796,Staff,19,0,20,1
1713312056388,MCWP 50R,G00,518797,Staff,19,0,20,1
1713312057416,MMW 12R,A01,514034,Herbst; Matthew,16,0,16,0
1713312057416,MMW 12R,A02,514035,Herbst; Matthew,16,0,16,0
1713312058445,MMW 13R,A01,514037,Staff,13,0,16,3
1713312058445,MMW 13R,A02,514039,Staff,16,0,16,0
1713312060492,SIO 295LS,A00,523233,Staff,19,0,30,11
1713312061524,SIO 295S,A00,523232,Staff,19,0,30,11
1713312062555,SOCI 117,A01,494376,Staff,3,0,5,2
1713312063581,WES 237B,A00,494380,Staff,19,0,20,1
1713312065647,AESE 279B,A00,494370,Wade; Jon P,33,0,33,0
1713312066674,ANAR 135S,A00,494369,Braswell; Geoffrey E.,0,0,0,0
1713312067705,CAT 124RS,A01,519847,Geibel; William,17,0,20,3
1713312068730,CAT 125RS,A01,515971,Geibel; William,17,0,20,3
1713312069756,CLRE 250,A00,511389,Morris; Sheldon,9996,0,9999,3
1713312070790,CLRE 251,A00,507176,Mehta; Ravindra L.,9996,0,9999,3
1713312070790,CLRE 251,B00,511410,Mehta; Ravindra L.,9998,0,9999,1
1713312071818,CLRE 252,A00,507189,Cuomo; Raphael Eduardo,9998,0,9999,1
1713312072847,CLRE 253,A00,507199,Vaida; Florin,9997,0,9999,2
1713312072847,CLRE 253,B00,507202,Vaida; Florin,9999,0,9999,0
1713312073876,CLRE 259,A00,507211,Patel; Hemal,9996,0,9999,3
1713312074902,CLRE 260,A00,507221,Cuomo; Raphael Eduardo,9999,0,9999,0
1713312075930,CLRE 297,001,507242,Cuomo; Raphael Eduardo,9999,0,9999,0
1713312076960,CSE 191,A00,516875,Minnes Kemp; Mor Mia,9999,0,9999,0
1713312077986,CSS 201S,A01,494383,Staff,35,0,35,0
1713312079018,CSS 202S,A01,494387,Staff,35,0,35,0
1713312080047,EAP 100,A00,516065,Staff,9792,0,9999,207
1713312081074,ECE 45,A01,507414,Staff,54,0,60,6
1713312082099,ECE 100,A01,507416,Baghdadchi; Saharnaz,11,0,20,9
1713312082099,ECE 100,A02,507418,Baghdadchi; Saharnaz,20,0,20,0
1713312083125,ECE 111,A01,507420,Staff,40,0,50,10
1713312084151,ECE 197,001,548057,Sievenpiper; Daniel F.,9998,0,9999,1
1713312085182,EDS 115,A00,507243,Choi; Bailey Miyeon,28,0,28,0
1713312086211,EDS 117,A01,494379,Staff,25,0,25,0
1713312087237,EDS 125,A00,507246,Hopkins; Megan Beth,29,0,30,1
1713312088261,EDS 128A,A01,507264,Fargason; Sharon Gayle,26,0,26,0
1713312089288,EDS 128B,A01,507293,Pappas; Elizabeth,30,0,30,0
1713312090312,EDS 139,A00,507294,Fargason; Sharon Gayle,30,0,30,0
1713312090312,EDS 139,B00,507313,Pappas; Elizabeth,30,0,30,0
1713312091339,EDS 201,A00,507315,Staff,26,0,30,4
1713312092365,EDS 203,A01,507317,Halter; Christopher P.,26,0,30,4
1713312093389,EDS 204R,A01,507319,Halter; Christopher P.,5,0,30,25
1713312093389,EDS 204R,B01,507331,Heinzman; Erica M.,28,0,30,2
1713312094416,EDS 206R,A00,507332,Staff,7,0,30,23
1713312094416,EDS 206R,B00,507343,Staff,27,0,30,3
1713312095442,EDS 250,A00,507344,Hemans; Patricia Ann Benitez,36,0,40,4
1713312096469,EDS 281,A00,507345,Daly; Alan J.,18,0,18,0
1713312097492,EDS 284,A00,507350,Daly; Alan J.,16,0,16,0
1713312098518,EDS 286,A00,507359,Fine; Sarah,18,0,18,0
1713312099542,EDS 289C,A01,507361,Daly; Alan J.,18,0,18,0
1713312100567,EDS 290,A00,507366,Hofstetter; Carolyn,15,0,15,0
1713312101593,LIGM 5A,A00,507421,Fischer-Grunski; Eva K,20,0,20,0
1713312102623,LIGM 5B,A00,507423,Fischer-Grunski; Eva K,20,0,20,0
1713312103654,LIGM 5C,A00,507425,Fischer-Grunski; Eva K,20,0,20,0
1713312104680,LIIT 5AS,A00,507427,Carnelos; Chiara,20,0,20,0
1713312105709,LIIT 5BS,A00,507430,Carnelos; Chiara,20,0,20,0
1713312106736,LIIT 5CS,A00,507432,Carnelos; Chiara,20,0,20,0
1713312107762,LISP 5A,A00,507541,Munoz Sanchez; Alicia,19,0,20,1
1713312108787,LISP 5B,A00,507671,Munoz Sanchez; Alicia,17,0,20,3
1713312109813,LISP 5C,A00,507696,Munoz Sanchez; Alicia,17,0,20,3
1713312110840,MAE 197,001,528363,Boechler; Nicholas Sebastia,9998,0,9999,1
1713312111866,MATH 197,001,523477,Kedlaya; Kiran S.,9999,0,9999,0
1713312111866,MATH 197,002,563811,Zhang; Danna,9999,0,9999,0
1713312112893,MCWP 40R,A00,518780,Staff,20,0,20,0
1713312112893,MCWP 40R,B00,518781,Staff,19,0,20,1
1713312112893,MCWP 40R,C00,518783,Staff,19,0,20,1
1713312113918,MCWP 50R,A00,518791,Staff,20,0,20,0
1713312113918,MCWP 50R,B00,518792,Staff,18,0,20,2
1713312113918,MCWP 50R,C00,518793,Staff,19,0,20,1
1713312113918,MCWP 50R,D00,518794,Staff,18,0,20,2
1713312113918,MCWP 50R,E00,518795,Staff,18,0,20,2
1713312113918,MCWP 50R,F00,518796,Staff,19,0,20,1
1713312113918,MCWP 50R,G00,518797,Staff,19,0,20,1
1713312114944,MMW 12R,A01,514034,Herbst; Matthew,16,0,16,0
1713312114944,MMW 12R,A02,514035,Herbst; Matthew,16,0,16,0
1713312115995,MMW 13R,A01,514037,Staff,13,0,16,3
1713312115995,MMW 13R,A02,514039,Staff,16,0,16,0
1713312118050,SIO 295LS,A00,523233,Staff,19,0,30,11
1713312119075,SIO 295S,A00,523232,Staff,19,0,30,11
1713312120101,SOCI 117,A01,494376,Staff,3,0,5,2
1713312121127,WES 237B,A00,494380,Staff,19,0,20,1
1713312123203,AESE 279B,A00,494370,Wade; Jon P,33,0,33,0
1713312124227,ANAR 135S,A00,494369,Braswell; Geoffrey E.,0,0,0,0
1713312125253,CAT 124RS,A01,519847,Geibel; William,17,0,20,3
1713312126282,CAT 125RS,A01,515971,Geibel; William,17,0,20,3
1713312127311,CLRE 250,A00,511389,Morris; Sheldon,9996,0,9999,3
1713312128337,CLRE 251,A00,507176,Mehta; Ravindra L.,9996,0,9999,3
1713312128337,CLRE 251,B00,511410,Mehta; Ravindra L.,9998,0,9999,1
1713312129361,CLRE 252,A00,507189,Cuomo; Raphael Eduardo,9998,0,9999,1
1713312130392,CLRE 253,A00,507199,Vaida; Florin,9997,0,9999,2
1713312130392,CLRE 253,B00,507202,Vaida; Florin,9999,0,9999,0
1713312131471,CLRE 259,A00,507211,Patel; Hemal,9996,0,9999,3
1713312132496,CLRE 260,A00,507221,Cuomo; Raphael Eduardo,9999,0,9999,0
1713312133521,CLRE 297,001,507242,Cuomo; Raphael Eduardo,9999,0,9999,0
1713312134545,CSE 191,A00,516875,Minnes Kemp; Mor Mia,9999,0,9999,0
1713312135571,CSS 201S,A01,494383,Staff,35,0,35,0
1713312136596,CSS 202S,A01,494387,Staff,35,0,35,0
1713312137625,EAP 100,A00,516065,Staff,9792,0,9999,207
1713312138652,ECE 45,A01,507414,Staff,54,0,60,6
1713312139679,ECE 100,A01,507416,Baghdadchi; Saharnaz,11,0,20,9
1713312139679,ECE 100,A02,507418,Baghdadchi; Saharnaz,20,0,20,0
1713312140707,ECE 111,A01,507420,Staff,40,0,50,10
1713312141733,ECE 197,001,548057,Sievenpiper; Daniel F.,9998,0,9999,1
1713312142761,EDS 115,A00,507243,Choi; Bailey Miyeon,28,0,28,0
1713312143786,EDS 117,A01,494379,Staff,25,0,25,0
1713312144816,EDS 125,A00,507246,Hopkins; Megan Beth,29,0,30,1
1713312145843,EDS 128A,A01,507264,Fargason; Sharon Gayle,26,0,26,0
1713312146866,EDS 128B,A01,507293,Pappas; Elizabeth,30,0,30,0
1713312147893,EDS 139,A00,507294,Fargason; Sharon Gayle,30,0,30,0
1713312147893,EDS 139,B00,507313,Pappas; Elizabeth,30,0,30,0
1713312148917,EDS 201,A00,507315,Staff,26,0,30,4
1713312149942,EDS 203,A01,507317,Halter; Christopher P.,26,0,30,4
1713312150971,EDS 204R,A01,507319,Halter; Christopher P.,5,0,30,25
1713312150971,EDS 204R,B01,507331,Heinzman; Erica M.,28,0,30,2
1713312151999,EDS 206R,A00,507332,Staff,7,0,30,23
1713312151999,EDS 206R,B00,507343,Staff,27,0,30,3
1713312153025,EDS 250,A00,507344,Hemans; Patricia Ann Benitez,36,0,40,4
1713312154050,EDS 281,A00,507345,Daly; Alan J.,18,0,18,0
1713312155079,EDS 284,A00,507350,Daly; Alan J.,16,0,16,0
1713312156107,EDS 286,A00,507359,Fine; Sarah,18,0,18,0
1713312157137,EDS 289C,A01,507361,Daly; Alan J.,18,0,18,0
1713312158164,EDS 290,A00,507366,Hofstetter; Carolyn,15,0,15,0
1713312159192,LIGM 5A,A00,507421,Fischer-Grunski; Eva K,20,0,20,0
1713312160222,LIGM 5B,A00,507423,Fischer-Grunski; Eva K,20,0,20,0
1713312161251,LIGM 5C,A00,507425,Fischer-Grunski; Eva K,20,0,20,0
1713312162278,LIIT 5AS,A00,507427,Carnelos; Chiara,20,0,20,0
1713312163302,LIIT 5BS,A00,507430,Carnelos; Chiara,20,0,20,0
1713312164328,LIIT 5CS,A00,507432,Carnelos; Chiara,20,0,20,0
1713312165353,LISP 5A,A00,507541,Munoz Sanchez; Alicia,19,0,20,1
1713312166379,LISP 5B,A00,507671,Munoz Sanchez; Alicia,17,0,20,3
1713312167405,LISP 5C,A00,507696,Munoz Sanchez; Alicia,17,0,20,3
1713312168432,MAE 197,001,528363,Boechler; Nicholas Sebastia,9998,0,9999,1
1713312169461,MATH 197,001,523477,Kedlaya; Kiran S.,9999,0,9999,0
1713312169461,MATH 197,002,563811,Zhang; Danna,9999,0,9999,0
1713312170490,MCWP 40R,A00,518780,Staff,20,0,20,0
1713312170490,MCWP 40R,B00,518781,Staff,19,0,20,1
1713312170490,MCWP 40R,C00,518783,Staff,19,0,20,1
1713312171515,MCWP 50R,A00,518791,Staff,20,0,20,0
1713312171515,MCWP 50R,B00,518792,Staff,18,0,20,2
1713312171515,MCWP 50R,C00,518793,Staff,19,0,20,1
1713312171515,MCWP 50R,D00,518794,Staff,18,0,20,2
1713312171515,MCWP 50R,E00,518795,Staff,18,0,20,2
1713312171515,MCWP 50R,F00,518796,Staff,19,0,20,1
1713312171515,MCWP 50R,G00,518797,Staff,19,0,20,1
1713312172539,MMW 12R,A01,514034,Herbst; Matthew,16,0,16,0
1713312172539,MMW 12R,A02,514035,Herbst; Matthew,16,0,16,0
1713312173567,MMW 13R,A01,514037,Staff,13,0,16,3
1713312173567,MMW 13R,A02,514039,Staff,16,0,16,0
1713312175621,SIO 295LS,A00,523233,Staff,19,0,30,11
1713312176646,SIO 295S,A00,523232,Staff,19,0,30,11
1713312177671,SOCI 117,A01,494376,Staff,3,0,5,2
1713312178695,WES 237B,A00,494380,Staff,19,0,20,1
1713312180770,AESE 279B,A00,494370,Wade; Jon P,33,0,33,0
1713312181801,ANAR 135S,A00,494369,Braswell; Geoffrey E.,0,0,0,0
1713312182827,CAT 124RS,A01,519847,Geibel; William,17,0,20,3
1713312183862,CAT 125RS,A01,515971,Geibel; William,17,0,20,3
1713312184891,CLRE 250,A00,511389,Morris; Sheldon,9996,0,9999,3
1713312185918,CLRE 251,A00,507176,Mehta; Ravindra L.,9996,0,9999,3
1713312185918,CLRE 251,B00,511410,Mehta; Ravindra L.,9998,0,9999,1
1713312186946,CLRE 252,A00,507189,Cuomo; Raphael Eduardo,9998,0,9999,1
1713312187970,CLRE 253,A00,507199,Vaida; Florin,9997,0,9999,2
1713312187970,CLRE 253,B00,507202,Vaida; Florin,9999,0,9999,0
1713312188998,CLRE 259,A00,507211,Patel; Hemal,9996,0,9999,3
1713312190023,CLRE 260,A00,507221,Cuomo; Raphael Eduardo,9999,0,9999,0
1713312191056,CLRE 297,001,507242,Cuomo; Raphael Eduardo,9999,0,9999,0
1713312192080,CSE 191,A00,516875,Minnes Kemp; Mor Mia,9999,0,9999,0
1713312193110,CSS 201S,A01,494383,Staff,35,0,35,0
1713312194135,CSS 202S,A01,494387,Staff,35,0,35,0
1713312195162,EAP 100,A00,516065,Staff,9792,0,9999,207
1713312196191,ECE 45,A01,507414,Staff,54,0,60,6
1713312197217,ECE 100,A01,507416,Baghdadchi; Saharnaz,11,0,20,9
1713312197217,ECE 100,A02,507418,Baghdadchi; Saharnaz,20,0,20,0
1713312198246,ECE 111,A01,507420,Staff,40,0,50,10
1713312199274,ECE 197,001,548057,Sievenpiper; Daniel F.,9998,0,9999,1
1713312200304,EDS 115,A00,507243,Choi; Bailey Miyeon,28,0,28,0
1713312201337,EDS 117,A01,494379,Staff,25,0,25,0
1713312202361,EDS 125,A00,507246,Hopkins; Megan Beth,29,0,30,1
1713312203393,EDS 128A,A01,507264,Fargason; Sharon Gayle,26,0,26,0
1713312204418,EDS 128B,A01,507293,Pappas; Elizabeth,30,0,30,0
1713312205447,EDS 139,A00,507294,Fargason; Sharon Gayle,30,0,30,0
1713312205447,EDS 139,B00,507313,Pappas; Elizabeth,30,0,30,0
1713312206474,EDS 201,A00,507315,Staff,26,0,30,4
1713312207498,EDS 203,A01,507317,Halter; Christopher P.,26,0,30,4
1713312208524,EDS 204R,A01,507319,Halter; Christopher P.,5,0,30,25
1713312208524,EDS 204R,B01,507331,Heinzman; Erica M.,28,0,30,2
1713312209553,EDS 206R,A00,507332,Staff,7,0,30,23
1713312209553,EDS 206R,B00,507343,Staff,27,0,30,3
1713312210583,EDS 250,A00,507344,Hemans; Patricia Ann Benitez,36,0,40,4
1713312211609,EDS 281,A00,507345,Daly; Alan J.,18,0,18,0
1713312212635,EDS 284,A00,507350,Daly; Alan J.,16,0,16,0
1713312213661,EDS 286,A00,507359,Fine; Sarah,18,0,18,0
1713312214687,EDS 289C,A01,507361,Daly; Alan J.,18,0,18,0
1713312215715,EDS 290,A00,507366,Hofstetter; Carolyn,15,0,15,0
1713312216745,LIGM 5A,A00,507421,Fischer-Grunski; Eva K,20,0,20,0
1713312217774,LIGM 5B,A00,507423,Fischer-Grunski; Eva K,20,0,20,0
1713312218804,LIGM 5C,A00,507425,Fischer-Grunski; Eva K,20,0,20,0
1713312219830,LIIT 5AS,A00,507427,Carnelos; Chiara,20,0,20,0
1713312220859,LIIT 5BS,A00,507430,Carnelos; Chiara,20,0,20,0
1713312221885,LIIT 5CS,A00,507432,Carnelos; Chiara,20,0,20,0
1713312222911,LISP 5A,A00,507541,Munoz Sanchez; Alicia,19,0,20,1
1713312223936,LISP 5B,A00,507671,Munoz Sanchez; Alicia,17,0,20,3
1713312224966,LISP 5C,A00,507696,Munoz Sanchez; Alicia,17,0,20,3
1713312225992,MAE 197,001,528363,Boechler; Nicholas Sebastia,9998,0,9999,1
1713312227018,MATH 197,001,523477,Kedlaya; Kiran S.,9999,0,9999,0
1713312227018,MATH 197,002,563811,Zhang; Danna,9999,0,9999,0
1713312228044,MCWP 40R,A00,518780,Staff,20,0,20,0
1713312228044,MCWP 40R,B00,518781,Staff,19,0,20,1
1713312228044,MCWP 40R,C00,518783,Staff,19,0,20,1
1713312229069,MCWP 50R,A00,518791,Staff,20,0,20,0
1713312229069,MCWP 50R,B00,518792,Staff,18,0,20,2
1713312229069,MCWP 50R,C00,518793,Staff,19,0,20,1
1713312229069,MCWP 50R,D00,518794,Staff,18,0,20,2
1713312229069,MCWP 50R,E00,518795,Staff,18,0,20,2
1713312229069,MCWP 50R,F00,518796,Staff,19,0,20,1
1713312229069,MCWP 50R,G00,518797,Staff,19,0,20,1
1713312230094,MMW 12R,A01,514034,Herbst; Matthew,16,0,16,0
1713312230094,MMW 12R,A02,514035,Herbst; Matthew,16,0,16,0
1713312231120,MMW 13R,A01,514037,Staff,13,0,16,3
1713312231120,MMW 13R,A02,514039,Staff,16,0,16,0
1713312233174,SIO 295LS,A00,523233,Staff,19,0,30,11
1713312234206,SIO 295S,A00,523232,Staff,19,0,30,11
1713312235285,SOCI 117,A01,494376,Staff,3,0,5,2
1713312236312,WES 237B,A00,494380,Staff,19,0,20,1
1713312238386,AESE 279B,A00,494370,Wade; Jon P,33,0,33,0
1713312239413,ANAR 135S,A00,494369,Braswell; Geoffrey E.,0,0,0,0
1713312240437,CAT 124RS,A01,519847,Geibel; William,17,0,20,3
1713312241463,CAT 125RS,A01,515971,Geibel; William,17,0,20,3
1713312242490,CLRE 250,A00,511389,Morris; Sheldon,9996,0,9999,3
1713312243522,CLRE 251,A00,507176,Mehta; Ravindra L.,9996,0,9999,3
1713312243522,CLRE 251,B00,511410,Mehta; Ravindra L.,9998,0,9999,1
1713312244547,CLRE 252,A00,507189,Cuomo; Raphael Eduardo,9998,0,9999,1
1713312245576,CLRE 253,A00,507199,Vaida; Florin,9997,0,9999,2
1713312245576,CLRE 253,B00,507202,Vaida; Florin,9999,0,9999,0
1713312246605,CLRE 259,A00,507211,Patel; Hemal,9996,0,9999,3
1713312247631,CLRE 260,A00,507221,Cuomo; Raphael Eduardo,9999,0,9999,0
1713312248660,CLRE 297,001,507242,Cuomo; Raphael Eduardo,9999,0,9999,0
1713312249686,CSE 191,A00,516875,Minnes Kemp; Mor Mia,9999,0,9999,0
1713312250712,CSS 201S,A01,494383,Staff,35,0,35,0
1713312251737,CSS 202S,A01,494387,Staff,35,0,35,0
1713312252766,EAP 100,A00,516065,Staff,9792,0,9999,207
1713312253791,ECE 45,A01,507414,Staff,54,0,60,6
1713312254823,ECE 100,A01,507416,Baghdadchi; Saharnaz,11,0,20,9
1713312254823,ECE 100,A02,507418,Baghdadchi; Saharnaz,20,0,20,0
1713312255848,ECE 111,A01,507420,Staff,40,0,50,10
1713312256876,ECE 197,001,548057,Sievenpiper; Daniel F.,9998,0,9999,1
1713312257901,EDS 115,A00,507243,Choi; Bailey Miyeon,28,0,28,0
1713312258928,EDS 117,A01,494379,Staff,25,0,25,0
1713312259954,EDS 125,A00,507246,Hopkins; Megan Beth,29,0,30,1
1713312260980,EDS 128A,A01,507264,Fargason; Sharon Gayle,26,0,26,0
1713312262006,EDS 128B,A01,507293,Pappas; Elizabeth,30,0,30,0
1713312263030,EDS 139,A00,507294,Fargason; Sharon Gayle,30,0,30,0
1713312263030,EDS 139,B00,507313,Pappas; Elizabeth,30,0,30,0
1713312264054,EDS 201,A00,507315,Staff,26,0,30,4
1713312265080,EDS 203,A01,507317,Halter; Christopher P.,26,0,30,4
1713312266113,EDS 204R,A01,507319,Halter; Christopher P.,5,0,30,25
1713312266113,EDS 204R,B01,507331,Heinzman; Erica M.,28,0,30,2
1713312267142,EDS 206R,A00,507332,Staff,7,0,30,23
1713312267142,EDS 206R,B00,507343,Staff,27,0,30,3
1713312268168,EDS 250,A00,507344,Hemans; Patricia Ann Benitez,36,0,40,4
1713312269194,EDS 281,A00,507345,Daly; Alan J.,18,0,18,0
1713312270218,EDS 284,A00,507350,Daly; Alan J.,16,0,16,0
1713312271252,EDS 286,A00,507359,Fine; Sarah,18,0,18,0
1713312272278,EDS 289C,A01,507361,Daly; Alan J.,18,0,18,0
1713312273309,EDS 290,A00,507366,Hofstetter; Carolyn,15,0,15,0
1713312274334,LIGM 5A,A00,507421,Fischer-Grunski; Eva K,20,0,20,0
1713312275360,LIGM 5B,A00,507423,Fischer-Grunski; Eva K,20,0,20,0
1713312276384,LIGM 5C,A00,507425,Fischer-Grunski; Eva K,20,0,20,0
1713312277413,LIIT 5AS,A00,507427,Carnelos; Chiara,20,0,20,0
1713312278439,LIIT 5BS,A00,507430,Carnelos; Chiara,20,0,20,0
1713312279467,LIIT 5CS,A00,507432,Carnelos; Chiara,20,0,20,0
1713312280493,LISP 5A,A00,507541,Munoz Sanchez; Alicia,19,0,20,1
1713312281519,LISP 5B,A00,507671,Munoz Sanchez; Alicia,17,0,20,3
1713312282543,LISP 5C,A00,507696,Munoz Sanchez; Alicia,17,0,20,3
1713312283575,MAE 197,001,528363,Boechler; Nicholas Sebastia,9998,0,9999,1
1713312284603,MATH 197,001,523477,Kedlaya; Kiran S.,9999,0,9999,0
1713312284603,MATH 197,002,563811,Zhang; Danna,9999,0,9999,0
1713312285633,MCWP 40R,A00,518780,Staff,20,0,20,0
1713312285633,MCWP 40R,B00,518781,Staff,19,0,20,1
1713312285633,MCWP 40R,C00,518783,Staff,19,0,20,1
1713312286662,MCWP 50R,A00,518791,Staff,20,0,20,0
1713312286662,MCWP 50R,B00,518792,Staff,18,0,20,2
1713312286662,MCWP 50R,C00,518793,Staff,19,0,20,1
1713312286662,MCWP 50R,D00,518794,Staff,18,0,20,2
1713312286662,MCWP 50R,E00,518795,Staff,18,0,20,2
1713312286662,MCWP 50R,F00,518796,Staff,19,0,20,1
1713312286662,MCWP 50R,G00,518797,Staff,19,0,20,1
1713312287688,MMW 12R,A01,514034,Herbst; Matthew,16,0,16,0
1713312287688,MMW 12R,A02,514035,Herbst; Matthew,16,0,16,0
1713312288716,MMW 13R,A01,514037,Staff,13,0,16,3
1713312288716,MMW 13R,A02,514039,Staff,16,0,16,0
1713312290767,SIO 295LS,A00,523233,Staff,19,0,30,11
1713312291793,SIO 295S,A00,523232,Staff,19,0,30,11
1713312292821,SOCI 117,A01,494376,Staff,3,0,5,2
1713312293863,WES 237B,A00,494380,Staff,19,0,20,1
1713312295930,AESE 279B,A00,494370,Wade; Jon P,33,0,33,0
1713312297009,ANAR 135S,A00,494369,Braswell; Geoffrey E.,0,0,0,0
1713312298042,CAT 124RS,A01,519847,Geibel; William,17,0,20,3
1713312299067,CAT 125RS,A01,515971,Geibel; William,17,0,20,3
1713312300093,CLRE 250,A00,511389,Morris; Sheldon,9996,0,9999,3
1713312301125,CLRE 251,A00,507176,Mehta; Ravindra L.,9996,0,9999,3
1713312301125,CLRE 251,B00,511410,Mehta; Ravindra L.,9998,0,9999,1
1713312302177,CLRE 252,A00,507189,Cuomo; Raphael Eduardo,9998,0,9999,1
1713312303217,CLRE 253,A00,507199,Vaida; Florin,9997,0,9999,2
1713312303217,CLRE 253,B00,507202,Vaida; Florin,9999,0,9999,0
1713312304247,CLRE 259,A00,507211,Patel; Hemal,9996,0,9999,3
1713312305276,CLRE 260,A00,507221,Cuomo; Raphael Eduardo,9999,0,9999,0
1713312306312,CLRE 297,001,507242,Cuomo; Raphael Eduardo,9999,0,9999,0
1713312307340,CSE 191,A00,516875,Minnes Kemp; Mor Mia,9999,0,9999,0
1713312308366,CSS 201S,A01,494383,Staff,35,0,35,0
1713312309390,CSS 202S,A01,494387,Staff,35,0,35,0
1713312310414,EAP 100,A00,516065,Staff,9792,0,9999,207
1713312311440,ECE 45,A01,507414,Staff,54,0,60,6
1713312312466,ECE 100,A01,507416,Baghdadchi; Saharnaz,11,0,20,9
1713312312466,ECE 100,A02,507418,Baghdadchi; Saharnaz,20,0,20,0
1713312313491,ECE 111,A01,507420,Staff,40,0,50,10
1713312314522,ECE 197,001,548057,Sievenpiper; Daniel F.,9998,0,9999,1
1713312315549,EDS 115,A00,507243,Choi; Bailey Miyeon,28,0,28,0
1713312316577,EDS 117,A01,494379,Staff,25,0,25,0
1713312317601,EDS 125,A00,507246,Hopkins; Megan Beth,29,0,30,1
1713312318631,EDS 128A,A01,507264,Fargason; Sharon Gayle,26,0,26,0
1713312319661,EDS 128B,A01,507293,Pappas; Elizabeth,30,0,30,0
1713312320685,EDS 139,A00,507294,Fargason; Sharon Gayle,30,0,30,0
1713312320685,EDS 139,B00,507313,Pappas; Elizabeth,30,0,30,0
1713312321710,EDS 201,A00,507315,Staff,26,0,30,4
1713312322740,EDS 203,A01,507317,Halter; Christopher P.,26,0,30,4
1713312323765,EDS 204R,A01,507319,Halter; Christopher P.,5,0,30,25
1713312323765,EDS 204R,B01,507331,Heinzman; Erica M.,28,0,30,2
1713312324790,EDS 206R,A00,507332,Staff,7,0,30,23
1713312324790,EDS 206R,B00,507343,Staff,27,0,30,3
1713312325815,EDS 250,A00,507344,Hemans; Patricia Ann Benitez,36,0,40,4
1713312326841,EDS 281,A00,507345,Daly; Alan J.,18,0,18,0
1713312327866,EDS 284,A00,507350,Daly; Alan J.,16,0,16,0
1713312328891,EDS 286,A00,507359,Fine; Sarah,18,0,18,0
1713312329920,EDS 289C,A01,507361,Daly; Alan J.,18,0,18,0
1713312330948,EDS 290,A00,507366,Hofstetter; Carolyn,15,0,15,0
1713312331978,LIGM 5A,A00,507421,Fischer-Grunski; Eva K,20,0,20,0
1713312333010,LIGM 5B,A00,507423,Fischer-Grunski; Eva K,20,0,20,0
1713312334036,LIGM 5C,A00,507425,Fischer-Grunski; Eva K,20,0,20,0
1713312335064,LIIT 5AS,A00,507427,Carnelos; Chiara,20,0,20,0
1713312336093,LIIT 5BS,A00,507430,Carnelos; Chiara,20,0,20,0
1713312337118,LIIT 5CS,A00,507432,Carnelos; Chiara,20,0,20,0
1713312338144,LISP 5A,A00,507541,Munoz Sanchez; Alicia,19,0,20,1
1713312339224,LISP 5B,A00,507671,Munoz Sanchez; Alicia,17,0,20,3
1713312340251,LISP 5C,A00,507696,Munoz Sanchez; Alicia,17,0,20,3
1713312341281,MAE 197,001,528363,Boechler; Nicholas Sebastia,9998,0,9999,1
1713312342311,MATH 197,001,523477,Kedlaya; Kiran S.,9999,0,9999,0
1713312342311,MATH 197,002,563811,Zhang; Danna,9999,0,9999,0
1713312343336,MCWP 40R,A00,518780,Staff,20,0,20,0
1713312343336,MCWP 40R,B00,518781,Staff,19,0,20,1
1713312343336,MCWP 40R,C00,518783,Staff,19,0,20,1
1713312344363,MCWP 50R,A00,518791,Staff,20,0,20,0
1713312344363,MCWP 50R,B00,518792,Staff,18,0,20,2
1713312344363,MCWP 50R,C00,518793,Staff,19,0,20,1
1713312344363,MCWP 50R,D00,518794,Staff,18,0,20,2
1713312344363,MCWP 50R,E00,518795,Staff,18,0,20,2
1713312344363,MCWP 50R,F00,518796,Staff,19,0,20,1
1713312344363,MCWP 50R,G00,518797,Staff,19,0,20,1
1713312345389,MMW 12R,A01,514034,Herbst; Matthew,16,0,16,0
1713312345389,MMW 12R,A02,514035,Herbst; Matthew,16,0,16,0
1713312346415,MMW 13R,A01,514037,Staff,13,0,16,3
1713312346415,MMW 13R,A02,514039,Staff,16,0,16,0
1713312348472,SIO 295LS,A00,523233,Staff,19,0,30,11
1713312349497,SIO 295S,A00,523232,Staff,19,0,30,11
1713312350522,SOCI 117,A01,494376,Staff,3,0,5,2
1713312351558,WES 237B,A00,494380,Staff,19,0,20,1
1713312353631,AESE 279B,A00,494370,Wade; Jon P,33,0,33,0
1713312354657,ANAR 135S,A00,494369,Braswell; Geoffrey E.,0,0,0,0
1713312355683,CAT 124RS,A01,519847,Geibel; William,17,0,20,3
1713312356708,CAT 125RS,A01,515971,Geibel; William,17,0,20,3
1713312357735,CLRE 250,A00,511389,Morris; Sheldon,9996,0,9999,3
1713312358762,CLRE 251,A00,507176,Mehta; Ravindra L.,9996,0,9999,3
1713312358762,CLRE 251,B00,511410,Mehta; Ravindra L.,9998,0,9999,1
1713312359793,CLRE 252,A00,507189,Cuomo; Raphael Eduardo,9998,0,9999,1
1713312360825,CLRE 253,A00,507199,Vaida; Florin,9997,0,9999,2
1713312360825,CLRE 253,B00,507202,Vaida; Florin,9999,0,9999,0
1713312361857,CLRE 259,A00,507211,Patel; Hemal,9996,0,9999,3
1713312362882,CLRE 260,A00,507221,Cuomo; Raphael Eduardo,9999,0,9999,0
1713312363906,CLRE 297,001,507242,Cuomo; Raphael Eduardo,9999,0,9999,0
1713312364934,CSE 191,A00,516875,Minnes Kemp; Mor Mia,9999,0,9999,0
1713312365975,CSS 201S,A01,494383,Staff,35,0,35,0
1713312367007,CSS 202S,A01,494387,Staff,35,0,35,0
1713312368032,EAP 100,A00,516065,Staff,9792,0,9999,207
1713312369061,ECE 45,A01,507414,Staff,54,0,60,6
1713312370093,ECE 100,A01,507416,Baghdadchi; Saharnaz,11,0,20,9
1713312370093,ECE 100,A02,507418,Baghdadchi; Saharnaz,20,0,20,0
1713312371117,ECE 111,A01,507420,Staff,40,0,50,10
1713312372148,ECE 197,001,548057,Sievenpiper; Daniel F.,9998,0,9999,1
1713312373180,EDS 115,A00,507243,Choi; Bailey Miyeon,28,0,28,0
1713312374206,EDS 117,A01,494379,Staff,25,0,25,0
1713312375231,EDS 125,A00,507246,Hopkins; Megan Beth,29,0,30,1
1713312376257,EDS 128A,A01,507264,Fargason; Sharon Gayle,26,0,26,0
1713312377284,EDS 128B,A01,507293,Pappas; Elizabeth,30,0,30,0
1713312378313,EDS 139,A00,507294,Fargason; Sharon Gayle,30,0,30,0
1713312378313,EDS 139,B00,507313,Pappas; Elizabeth,30,0,30,0
1713312379349,EDS 201,A00,507315,Staff,26,0,30,4
1713312380375,EDS 203,A01,507317,Halter; Christopher P.,26,0,30,4
1713312381401,EDS 204R,A01,507319,Halter; Christopher P.,5,0,30,25
1713312381401,EDS 204R,B01,507331,Heinzman; Erica M.,28,0,30,2
1713312382428,EDS 206R,A00,507332,Staff,7,0,30,23
1713312382428,EDS 206R,B00,507343,Staff,27,0,30,3
1713312383451,EDS 250,A00,507344,Hemans; Patricia Ann Benitez,36,0,40,4
1713312384476,EDS 281,A00,507345,Daly; Alan J.,18,0,18,0
1713312385500,EDS 284,A00,507350,Daly; Alan J.,16,0,16,0
1713312386530,EDS 286,A00,507359,Fine; Sarah,18,0,18,0
1713312387559,EDS 289C,A01,507361,Daly; Alan J.,18,0,18,0
1713312388589,EDS 290,A00,507366,Hofstetter; Carolyn,15,0,15,0
1713312389614,LIGM 5A,A00,507421,Fischer-Grunski; Eva K,20,0,20,0
1713312390642,LIGM 5B,A00,507423,Fischer-Grunski; Eva K,20,0,20,0
1713312391668,LIGM 5C,A00,507425,Fischer-Grunski; Eva K,20,0,20,0
1713312392693,LIIT 5AS,A00,507427,Carnelos; Chiara,20,0,20,0
1713312393718,LIIT 5BS,A00,507430,Carnelos; Chiara,20,0,20,0
1713312394747,LIIT 5CS,A00,507432,Carnelos; Chiara,20,0,20,0
1713312395774,LISP 5A,A00,507541,Munoz Sanchez; Alicia,19,0,20,1
1713312396807,LISP 5B,A00,507671,Munoz Sanchez; Alicia,17,0,20,3
1713312397833,LISP 5C,A00,507696,Munoz Sanchez; Alicia,17,0,20,3
1713312398871,MAE 197,001,528363,Boechler; Nicholas Sebastia,9998,0,9999,1
1713312399903,MATH 197,001,523477,Kedlaya; Kiran S.,9999,0,9999,0
1713312399903,MATH 197,002,563811,Zhang; Danna,9999,0,9999,0
1713312400928,MCWP 40R,A00,518780,Staff,20,0,20,0
1713312400928,MCWP 40R,B00,518781,Staff,19,0,20,1
1713312400928,MCWP 40R,C00,518783,Staff,19,0,20,1
1713312401958,MCWP 50R,A00,518791,Staff,20,0,20,0
1713312401958,MCWP 50R,B00,518792,Staff,18,0,20,2
1713312401958,MCWP 50R,C00,518793,Staff,19,0,20,1
1713312401958,MCWP 50R,D00,518794,Staff,18,0,20,2
1713312401958,MCWP 50R,E00,518795,Staff,18,0,20,2
1713312401958,MCWP 50R,F00,518796,Staff,19,0,20,1
1713312401958,MCWP 50R,G00,518797,Staff,19,0,20,1
1713312402983,MMW 12R,A01,514034,Herbst; Matthew,16,0,16,0
1713312402983,MMW 12R,A02,514035,Herbst; Matthew,16,0,16,0
1713312404007,MMW 13R,A01,514037,Staff,13,0,16,3
1713312404007,MMW 13R,A02,514039,Staff,16,0,16,0
1713312406060,SIO 295LS,A00,523233,Staff,19,0,30,11
1713312407085,SIO 295S,A00,523232,Staff,19,0,30,11
1713312408111,SOCI 117,A01,494376,Staff,3,0,5,2
1713312409137,WES 237B,A00,494380,Staff,19,0,20,1
1713312411201,AESE 279B,A00,494370,Wade; Jon P,33,0,33,0
1713312412226,ANAR 135S,A00,494369,Braswell; Geoffrey E.,0,0,0,0
1713312413253,CAT 124RS,A01,519847,Geibel; William,17,0,20,3
1713312414281,CAT 125RS,A01,515971,Geibel; William,17,0,20,3
1713312415306,CLRE 250,A00,511389,Morris; Sheldon,9996,0,9999,3
1713312416332,CLRE 251,A00,507176,Mehta; Ravindra L.,9996,0,9999,3
1713312416332,CLRE 251,B00,511410,Mehta; Ravindra L.,9998,0,9999,1
1713312417357,CLRE 252,A00,507189,Cuomo; Raphael Eduardo,9998,0,9999,1
1713312418383,CLRE 253,A00,507199,Vaida; Florin,9997,0,9999,2
1713312418383,CLRE 253,B00,507202,Vaida; Florin,9999,0,9999,0
1713312419410,CLRE 259,A00,507211,Patel; Hemal,9996,0,9999,3
1713312420436,CLRE 260,A00,507221,Cuomo; Raphael Eduardo,9999,0,9999,0
1713312421461,CLRE 297,001,507242,Cuomo; Raphael Eduardo,9999,0,9999,0
1713312422486,CSE 191,A00,516875,Minnes Kemp; Mor Mia,9999,0,9999,0
1713312423510,CSS 201S,A01,494383,Staff,35,0,35,0
1713312424541,CSS 202S,A01,494387,Staff,35,0,35,0
1713312425568,EAP 100,A00,516065,Staff,9792,0,9999,207
1713312426596,ECE 45,A01,507414,Staff,54,0,60,6
1713312427626,ECE 100,A01,507416,Baghdadchi; Saharnaz,11,0,20,9
1713312427626,ECE 100,A02,507418,Baghdadchi; Saharnaz,20,0,20,0
1713312428651,ECE 111,A01,507420,Staff,40,0,50,10
1713312429676,ECE 197,001,548057,Sievenpiper; Daniel F.,9998,0,9999,1
1713312430701,EDS 115,A00,507243,Choi; Bailey Miyeon,28,0,28,0
1713312431732,EDS 117,A01,494379,Staff,25,0,25,0
1713312432763,EDS 125,A00,507246,Hopkins; Megan Beth,29,0,30,1
1713312433803,EDS 128A,A01,507264,Fargason; Sharon Gayle,26,0,26,0
1713312434828,EDS 128B,A01,507293,Pappas; Elizabeth,30,0,30,0
1713312435856,EDS 139,A00,507294,Fargason; Sharon Gayle,30,0,30,0
1713312435856,EDS 139,B00,507313,Pappas; Elizabeth,30,0,30,0
1713312436887,EDS 201,A00,507315,Staff,26,0,30,4
1713312437913,EDS 203,A01,507317,Halter; Christopher P.,26,0,30,4
1713312438938,EDS 204R,A01,507319,Halter; Christopher P.,5,0,30,25
1713312438938,EDS 204R,B01,507331,Heinzman; Erica M.,28,0,30,2
1713312439971,EDS 206R,A00,507332,Staff,7,0,30,23
1713312439971,EDS 206R,B00,507343,Staff,27,0,30,3
1713312440996,EDS 250,A00,507344,Hemans; Patricia Ann Benitez,36,0,40,4
1713312442025,EDS 281,A00,507345,Daly; Alan J.,18,0,18,0
1713312443105,EDS 284,A00,507350,Daly; Alan J.,16,0,16,0
1713312444139,EDS 286,A00,507359,Fine; Sarah,18,0,18,0
1713312445165,EDS 289C,A01,507361,Daly; Alan J.,18,0,18,0
1713312446217,EDS 290,A00,507366,Hofstetter; Carolyn,15,0,15,0
1713312447242,LIGM 5A,A00,507421,Fischer-Grunski; Eva K,20,0,20,0
1713312448268,LIGM 5B,A00,507423,Fischer-Grunski; Eva K,20,0,20,0
1713312449298,LIGM 5C,A00,507425,Fischer-Grunski; Eva K,20,0,20,0
1713312450329,LIIT 5AS,A00,507427,Carnelos; Chiara,20,0,20,0
1713312451358,LIIT 5BS,A00,507430,Carnelos; Chiara,20,0,20,0
1713312452389,LIIT 5CS,A00,507432,Carnelos; Chiara,20,0,20,0
1713312453414,LISP 5A,A00,507541,Munoz Sanchez; Alicia,19,0,20,1
1713312454444,LISP 5B,A00,507671,Munoz Sanchez; Alicia,17,0,20,3
1713312455473,LISP 5C,A00,507696,Munoz Sanchez; Alicia,17,0,20,3
1713312456499,MAE 197,001,528363,Boechler; Nicholas Sebastia,9998,0,9999,1
1713312457526,MATH 197,001,523477,Kedlaya; Kiran S.,9999,0,9999,0
1713312457526,MATH 197,002,563811,Zhang; Danna,9999,0,9999,0
1713312458552,MCWP 40R,A00,518780,Staff,20,0,20,0
1713312458552,MCWP 40R,B00,518781,Staff,19,0,20,1
1713312458552,MCWP 40R,C00,518783,Staff,19,0,20,1
1713312459584,MCWP 50R,A00,518791,Staff,20,0,20,0
1713312459584,MCWP 50R,B00,518792,Staff,18,0,20,2
1713312459584,MCWP 50R,C00,518793,Staff,19,0,20,1
1713312459584,MCWP 50R,D00,518794,Staff,18,0,20,2
1713312459584,MCWP 50R,E00,518795,Staff,18,0,20,2
1713312459584,MCWP 50R,F00,518796,Staff,19,0,20,1
1713312459584,MCWP 50R,G00,518797,Staff,19,0,20,1
1713312460610,MMW 12R,A01,514034,Herbst; Matthew,16,0,16,0
1713312460610,MMW 12R,A02,514035,Herbst; Matthew,16,0,16,0
1713312461639,MMW 13R,A01,514037,Staff,13,0,16,3
1713312461639,MMW 13R,A02,514039,Staff,16,0,16,0
1713312463692,SIO 295LS,A00,523233,Staff,19,0,30,11
1713312464721,SIO 295S,A00,523232,Staff,19,0,30,11
1713312465750,SOCI 117,A01,494376,Staff,3,0,5,2
1713312466777,WES 237B,A00,494380,Staff,19,0,20,1
1713312468844,AESE 279B,A00,494370,Wade; Jon P,33,0,33,0
1713312469870,ANAR 135S,A00,494369,Braswell; Geoffrey E.,0,0,0,0
1713312470896,CAT 124RS,A01,519847,Geibel; William,17,0,20,3
1713312471925,CAT 125RS,A01,515971,Geibel; William,17,0,20,3
1713312472951,CLRE 250,A00,511389,Morris; Sheldon,9996,0,9999,3
1713312473978,CLRE 251,A00,507176,Mehta; Ravindra L.,9996,0,9999,3
1713312473978,CLRE 251,B00,511410,Mehta; Ravindra L.,9998,0,9999,1
1713312475004,CLRE 252,A00,507189,Cuomo; Raphael Eduardo,9998,0,9999,1
1713312476029,CLRE 253,A00,507199,Vaida; Florin,9997,0,9999,2
1713312476029,CLRE 253,B00,507202,Vaida; Florin,9999,0,9999,0
1713312477056,CLRE 259,A00,507211,Patel; Hemal,9996,0,9999,3
1713312478080,CLRE 260,A00,507221,Cuomo; Raphael Eduardo,9999,0,9999,0
1713312479106,CLRE 297,001,507242,Cuomo; Raphael Eduardo,9999,0,9999,0
1713312480135,CSE 191,A00,516875,Minnes Kemp; Mor Mia,9999,0,9999,0
1713312481164,CSS 201S,A01,494383,Staff,35,0,35,0
1713312482190,CSS 202S,A01,494387,Staff,35,0,35,0
1713312483218,EAP 100,A00,516065,Staff,9792,0,9999,207
1713312484248,ECE 45,A01,507414,Staff,54,0,60,6
1713312485279,ECE 100,A01,507416,Baghdadchi; Saharnaz,11,0,20,9
1713312485279,ECE 100,A02,507418,Baghdadchi; Saharnaz,20,0,20,0
1713312486304,ECE 111,A01,507420,Staff,40,0,50,10
1713312487333,ECE 197,001,548057,Sievenpiper; Daniel F.,9998,0,9999,1
1713312488360,EDS 115,A00,507243,Choi; Bailey Miyeon,28,0,28,0
1713312489385,EDS 117,A01,494379,Staff,25,0,25,0
1713312490415,EDS 125,A00,507246,Hopkins; Megan Beth,29,0,30,1
1713312491445,EDS 128A,A01,507264,Fargason; Sharon Gayle,26,0,26,0
1713312492470,EDS 128B,A01,507293,Pappas; Elizabeth,30,0,30,0
1713312493496,EDS 139,A00,507294,Fargason; Sharon Gayle,30,0,30,0
1713312493496,EDS 139,B00,507313,Pappas; Elizabeth,30,0,30,0
1713312494521,EDS 201,A00,507315,Staff,26,0,30,4
1713312495549,EDS 203,A01,507317,Halter; Christopher P.,26,0,30,4
1713312496575,EDS 204R,A01,507319,Halter; Christopher P.,5,0,30,25
1713312496575,EDS 204R,B01,507331,Heinzman; Erica M.,28,0,30,2
1713312497602,EDS 206R,A00,507332,Staff,7,0,30,23
1713312497602,EDS 206R,B00,507343,Staff,27,0,30,3
1713312498628,EDS 250,A00,507344,Hemans; Patricia Ann Benitez,36,0,40,4
1713312499661,EDS 281,A00,507345,Daly; Alan J.,18,0,18,0
1713312500685,EDS 284,A00,507350,Daly; Alan J.,16,0,16,0
1713312501711,EDS 286,A00,507359,Fine; Sarah,18,0,18,0
1713312502736,EDS 289C,A01,507361,Daly; Alan J.,18,0,18,0
1713312503764,EDS 290,A00,507366,Hofstetter; Carolyn,15,0,15,0
1713312504789,LIGM 5A,A00,507421,Fischer-Grunski; Eva K,20,0,20,0
1713312505820,LIGM 5B,A00,507423,Fischer-Grunski; Eva K,20,0,20,0
1713312506845,LIGM 5C,A00,507425,Fischer-Grunski; Eva K,20,0,20,0
1713312507869,LIIT 5AS,A00,507427,Carnelos; Chiara,20,0,20,0
1713312508894,LIIT 5BS,A00,507430,Carnelos; Chiara,20,0,20,0
1713312509919,LIIT 5CS,A00,507432,Carnelos; Chiara,20,0,20,0
1713312510943,LISP 5A,A00,507541,Munoz Sanchez; Alicia,19,0,20,1
1713312511974,LISP 5B,A00,507671,Munoz Sanchez; Alicia,17,0,20,3
1713312513000,LISP 5C,A00,507696,Munoz Sanchez; Alicia,17,0,20,3
1713312514025,MAE 197,001,528363,Boechler; Nicholas Sebastia,9998,0,9999,1
1713312515054,MATH 197,001,523477,Kedlaya; Kiran S.,9999,0,9999,0
1713312515054,MATH 197,002,563811,Zhang; Danna,9999,0,9999,0
1713312516083,MCWP 40R,A00,518780,Staff,20,0,20,0
1713312516083,MCWP 40R,B00,518781,Staff,19,0,20,1
1713312516083,MCWP 40R,C00,518783,Staff,19,0,20,1
1713312517111,MCWP 50R,A00,518791,Staff,20,0,20,0
1713312517111,MCWP 50R,B00,518792,Staff,18,0,20,2
1713312517111,MCWP 50R,C00,518793,Staff,19,0,20,1
1713312517111,MCWP 50R,D00,518794,Staff,18,0,20,2
1713312517111,MCWP 50R,E00,518795,Staff,18,0,20,2
1713312517111,MCWP 50R,F00,518796,Staff,19,0,20,1
1713312517111,MCWP 50R,G00,518797,Staff,19,0,20,1
1713312518140,MMW 12R,A01,514034,Herbst; Matthew,16,0,16,0
1713312518140,MMW 12R,A02,514035,Herbst; Matthew,16,0,16,0
1713312519164,MMW 13R,A01,514037,Staff,13,0,16,3
1713312519164,MMW 13R,A02,514039,Staff,16,0,16,0
1713312521218,SIO 295LS,A00,523233,Staff,19,0,30,11
1713312522243,SIO 295S,A00,523232,Staff,19,0,30,11
1713312523269,SOCI 117,A01,494376,Staff,3,0,5,2
1713312524296,WES 237B,A00,494380,Staff,19,0,20,1
1713312526364,AESE 279B,A00,494370,Wade; Jon P,33,0,33,0
1713312527389,ANAR 135S,A00,494369,Braswell; Geoffrey E.,0,0,0,0
1713312528416,CAT 124RS,A01,519847,Geibel; William,17,0,20,3
1713312529445,CAT 125RS,A01,515971,Geibel; William,17,0,20,3
1713312530473,CLRE 250,A00,511389,Morris; Sheldon,9996,0,9999,3
1713312531497,CLRE 251,A00,507176,Mehta; Ravindra L.,9996,0,9999,3
1713312531497,CLRE 251,B00,511410,Mehta; Ravindra L.,9998,0,9999,1
1713312532523,CLRE 252,A00,507189,Cuomo; Raphael Eduardo,9998,0,9999,1
1713312533556,CLRE 253,A00,507199,Vaida; Florin,9997,0,9999,2
1713312533556,CLRE 253,B00,507202,Vaida; Florin,9999,0,9999,0
1713312534587,CLRE 259,A00,507211,Patel; Hemal,9996,0,9999,3
1713312535617,CLRE 260,A00,507221,Cuomo; Raphael Eduardo,9999,0,9999,0
1713312536644,CLRE 297,001,507242,Cuomo; Raphael Eduardo,9999,0,9999,0
1713312537672,CSE 191,A00,516875,Minnes Kemp; Mor Mia,9999,0,9999,0
1713312538697,CSS 201S,A01,494383,Staff,35,0,35,0
1713312539723,CSS 202S,A01,494387,Staff,35,0,35,0
1713312540748,EAP 100,A00,516065,Staff,9792,0,9999,207
1713312541776,ECE 45,A01,507414,Staff,54,0,60,6
1713312542806,ECE 100,A01,507416,Baghdadchi; Saharnaz,11,0,20,9
1713312542806,ECE 100,A02,507418,Baghdadchi; Saharnaz,20,0,20,0
1713312543832,ECE 111,A01,507420,Staff,40,0,50,10
1713312544864,ECE 197,001,548057,Sievenpiper; Daniel F.,9998,0,9999,1
1713312545888,EDS 115,A00,507243,Choi; Bailey Miyeon,28,0,28,0
1713312546968,EDS 117,A01,494379,Staff,25,0,25,0
1713312547992,EDS 125,A00,507246,Hopkins; Megan Beth,29,0,30,1
1713312549022,EDS 128A,A01,507264,Fargason; Sharon Gayle,26,0,26,0
1713312550051,EDS 128B,A01,507293,Pappas; Elizabeth,30,0,30,0
1713312551082,EDS 139,A00,507294,Fargason; Sharon Gayle,30,0,30,0
1713312551082,EDS 139,B00,507313,Pappas; Elizabeth,30,0,30,0
1713312552111,EDS 201,A00,507315,Staff,26,0,30,4
1713312553138,EDS 203,A01,507317,Halter; Christopher P.,26,0,30,4
1713312554162,EDS 204R,A01,507319,Halter; Christopher P.,5,0,30,25
1713312554162,EDS 204R,B01,507331,Heinzman; Erica M.,28,0,30,2
1713312555191,EDS 206R,A00,507332,Staff,7,0,30,23
1713312555191,EDS 206R,B00,507343,Staff,27,0,30,3
1713312556219,EDS 250,A00,507344,Hemans; Patricia Ann Benitez,36,0,40,4
1713312557247,EDS 281,A00,507345,Daly; Alan J.,18,0,18,0
1713312558274,EDS 284,A00,507350,Daly; Alan J.,16,0,16,0
1713312559305,EDS 286,A00,507359,Fine; Sarah,18,0,18,0
1713312560330,EDS 289C,A01,507361,Daly; Alan J.,18,0,18,0
1713312561358,EDS 290,A00,507366,Hofstetter; Carolyn,15,0,15,0
1713312562385,LIGM 5A,A00,507421,Fischer-Grunski; Eva K,20,0,20,0
1713312563409,LIGM 5B,A00,507423,Fischer-Grunski; Eva K,20,0,20,0
1713312564439,LIGM 5C,A00,507425,Fischer-Grunski; Eva K,20,0,20,0
1713312565465,LIIT 5AS,A00,507427,Carnelos; Chiara,20,0,20,0
1713312566494,LIIT 5BS,A00,507430,Carnelos; Chiara,20,0,20,0
1713312567614,LIIT 5CS,A00,507432,Carnelos; Chiara,20,0,20,0
1713312568644,LISP 5A,A00,507541,Munoz Sanchez; Alicia,19,0,20,1
1713312569671,LISP 5B,A00,507671,Munoz Sanchez; Alicia,17,0,20,3
1713312570697,LISP 5C,A00,507696,Munoz Sanchez; Alicia,17,0,20,3
1713312571723,MAE 197,001,528363,Boechler; Nicholas Sebastia,9998,0,9999,1
1713312572750,MATH 197,001,523477,Kedlaya; Kiran S.,9999,0,9999,0
1713312572750,MATH 197,002,563811,Zhang; Danna,9999,0,9999,0
1713312573778,MCWP 40R,A00,518780,Staff,20,0,20,0
1713312573778,MCWP 40R,B00,518781,Staff,19,0,20,1
1713312573778,MCWP 40R,C00,518783,Staff,19,0,20,1
1713312574801,MCWP 50R,A00,518791,Staff,20,0,20,0
1713312574801,MCWP 50R,B00,518792,Staff,18,0,20,2
1713312574801,MCWP 50R,C00,518793,Staff,19,0,20,1
1713312574801,MCWP 50R,D00,518794,Staff,18,0,20,2
1713312574801,MCWP 50R,E00,518795,Staff,18,0,20,2
1713312574801,MCWP 50R,F00,518796,Staff,19,0,20,1
1713312574801,MCWP 50R,G00,518797,Staff,19,0,20,1
1713312575830,MMW 12R,A01,514034,Herbst; Matthew,16,0,16,0
1713312575830,MMW 12R,A02,514035,Herbst; Matthew,16,0,16,0
1713312576854,MMW 13R,A01,514037,Staff,13,0,16,3
1713312576854,MMW 13R,A02,514039,Staff,16,0,16,0
1713312578911,SIO 295LS,A00,523233,Staff,19,0,30,11
1713312579941,SIO 295S,A00,523232,Staff,19,0,30,11
1713312580970,SOCI 117,A01,494376,Staff,3,0,5,2
1713312581997,WES 237B,A00,494380,Staff,19,0,20,1
1713312584075,AESE 279B,A00,494370,Wade; Jon P,33,0,33,0
1713312585099,ANAR 135S,A00,494369,Braswell; Geoffrey E.,0,0,0,0
1713312586124,CAT 124RS,A01,519847,Geibel; William,17,0,20,3
1713312587148,CAT 125RS,A01,515971,Geibel; William,17,0,20,3
1713312588171,CLRE 250,A00,511389,Morris; Sheldon,9996,0,9999,3
1713312589198,CLRE 251,A00,507176,Mehta; Ravindra L.,9996,0,9999,3
1713312589198,CLRE 251,B00,511410,Mehta; Ravindra L.,9998,0,9999,1
1713312590223,CLRE 252,A00,507189,Cuomo; Raphael Eduardo,9998,0,9999,1
1713312591248,CLRE 253,A00,507199,Vaida; Florin,9997,0,9999,2
1713312591248,CLRE 253,B00,507202,Vaida; Florin,9999,0,9999,0
1713312592275,CLRE 259,A00,507211,Patel; Hemal,9996,0,9999,3
1713312593303,CLRE 260,A00,507221,Cuomo; Raphael Eduardo,9999,0,9999,0
1713312594333,CLRE 297,001,507242,Cuomo; Raphael Eduardo,9999,0,9999,0
1713312595359,CSE 191,A00,516875,Minnes Kemp; Mor Mia,9999,0,9999,0
1713312596390,CSS 201S,A01,494383,Staff,35,0,35,0
1713312597414,CSS 202S,A01,494387,Staff,35,0,35,0
1713312598439,EAP 100,A00,516065,Staff,9792,0,9999,207
1713312599464,ECE 45,A01,507414,Staff,54,0,60,6
1713312600504,ECE 100,A01,507416,Baghdadchi; Saharnaz,11,0,20,9
1713312600504,ECE 100,A02,507418,Baghdadchi; Saharnaz,20,0,20,0
1713312601534,ECE 111,A01,507420,Staff,40,0,50,10
1713312602560,ECE 197,001,548057,Sievenpiper; Daniel F.,9998,0,9999,1
1713312603584,EDS 115,A00,507243,Choi; Bailey Miyeon,28,0,28,0
1713312604611,EDS 117,A01,494379,Staff,25,0,25,0
1713312605640,EDS 125,A00,507246,Hopkins; Megan Beth,29,0,30,1
1713312606672,EDS 128A,A01,507264,Fargason; Sharon Gayle,26,0,26,0
1713312607697,EDS 128B,A01,507293,Pappas; Elizabeth,30,0,30,0
1713312608727,EDS 139,A00,507294,Fargason; Sharon Gayle,30,0,30,0
1713312608727,EDS 139,B00,507313,Pappas; Elizabeth,30,0,30,0
1713312609752,EDS 201,A00,507315,Staff,26,0,30,4
1713312610777,EDS 203,A01,507317,Halter; Christopher P.,26,0,30,4
1713312611805,EDS 204R,A01,507319,Halter; Christopher P.,5,0,30,25
1713312611805,EDS 204R,B01,507331,Heinzman; Erica M.,28,0,30,2
1713312612830,EDS 206R,A00,507332,Staff,7,0,30,23
1713312612830,EDS 206R,B00,507343,Staff,27,0,30,3
1713312613862,EDS 250,A00,507344,Hemans; Patricia Ann Benitez,36,0,40,4
1713312614888,EDS 281,A00,507345,Daly; Alan J.,18,0,18,0
1713312615918,EDS 284,A00,507350,Daly; Alan J.,16,0,16,0
1713312616944,EDS 286,A00,507359,Fine; Sarah,18,0,18,0
1713312617974,EDS 289C,A01,507361,Daly; Alan J.,18,0,18,0
1713312619003,EDS 290,A00,507366,Hofstetter; Carolyn,15,0,15,0
1713312620029,LIGM 5A,A00,507421,Fischer-Grunski; Eva K,20,0,20,0
1713312621059,LIGM 5B,A00,507423,Fischer-Grunski; Eva K,20,0,20,0
1713312622090,LIGM 5C,A00,507425,Fischer-Grunski; Eva K,20,0,20,0
1713312623115,LIIT 5AS,A00,507427,Carnelos; Chiara,20,0,20,0
1713312624146,LIIT 5BS,A00,507430,Carnelos; Chiara,20,0,20,0
1713312625177,LIIT 5CS,A00,507432,Carnelos; Chiara,20,0,20,0
1713312626203,LISP 5A,A00,507541,Munoz Sanchez; Alicia,19,0,20,1
1713312627231,LISP 5B,A00,507671,Munoz Sanchez; Alicia,17,0,20,3
1713312628257,LISP 5C,A00,507696,Munoz Sanchez; Alicia,17,0,20,3
1713312629285,MAE 197,001,528363,Boechler; Nicholas Sebastia,9998,0,9999,1
1713312630316,MATH 197,001,523477,Kedlaya; Kiran S.,9999,0,9999,0
1713312630316,MATH 197,002,563811,Zhang; Danna,9999,0,9999,0
1713312631344,MCWP 40R,A00,518780,Staff,20,0,20,0
1713312631344,MCWP 40R,B00,518781,Staff,19,0,20,1
1713312631344,MCWP 40R,C00,518783,Staff,19,0,20,1
1713312632378,MCWP 50R,A00,518791,Staff,20,0,20,0
1713312632378,MCWP 50R,B00,518792,Staff,18,0,20,2
1713312632378,MCWP 50R,C00,518793,Staff,19,0,20,1
1713312632378,MCWP 50R,D00,518794,Staff,18,0,20,2
1713312632378,MCWP 50R,E00,518795,Staff,18,0,20,2
1713312632378,MCWP 50R,F00,518796,Staff,19,0,20,1
1713312632378,MCWP 50R,G00,518797,Staff,19,0,20,1
1713312633411,MMW 12R,A01,514034,Herbst; Matthew,16,0,16,0
1713312633411,MMW 12R,A02,514035,Herbst; Matthew,16,0,16,0
1713312634438,MMW 13R,A01,514037,Staff,13,0,16,3
1713312634438,MMW 13R,A02,514039,Staff,16,0,16,0
1713312636493,SIO 295LS,A00,523233,Staff,19,0,30,11
1713312637516,SIO 295S,A00,523232,Staff,19,0,30,11
1713312638543,SOCI 117,A01,494376,Staff,3,0,5,2
1713312639568,WES 237B,A00,494380,Staff,19,0,20,1
1713312641632,AESE 279B,A00,494370,Wade; Jon P,33,0,33,0
1713312642661,ANAR 135S,A00,494369,Braswell; Geoffrey E.,0,0,0,0
1713312643690,CAT 124RS,A01,519847,Geibel; William,17,0,20,3
1713312644715,CAT 125RS,A01,515971,Geibel; William,17,0,20,3
1713312645740,CLRE 250,A00,511389,Morris; Sheldon,9996,0,9999,3
1713312646768,CLRE 251,A00,507176,Mehta; Ravindra L.,9996,0,9999,3
1713312646768,CLRE 251,B00,511410,Mehta; Ravindra L.,9998,0,9999,1
1713312647800,CLRE 252,A00,507189,Cuomo; Raphael Eduardo,9998,0,9999,1
1713312648830,CLRE 253,A00,507199,Vaida; Florin,9997,0,9999,2
1713312648830,CLRE 253,B00,507202,Vaida; Florin,9999,0,9999,0
1713312649857,CLRE 259,A00,507211,Patel; Hemal,9996,0,9999,3
1713312650945,CLRE 260,A00,507221,Cuomo; Raphael Eduardo,9999,0,9999,0
1713312651971,CLRE 297,001,507242,Cuomo; Raphael Eduardo,9999,0,9999,0
1713312652997,CSE 191,A00,516875,Minnes Kemp; Mor Mia,9999,0,9999,0
1713312654028,CSS 201S,A01,494383,Staff,35,0,35,0
1713312655054,CSS 202S,A01,494387,Staff,35,0,35,0
1713312656082,EAP 100,A00,516065,Staff,9792,0,9999,207
1713312657108,ECE 45,A01,507414,Staff,54,0,60,6
1713312658133,ECE 100,A01,507416,Baghdadchi; Saharnaz,11,0,20,9
1713312658133,ECE 100,A02,507418,Baghdadchi; Saharnaz,20,0,20,0
1713312659158,ECE 111,A01,507420,Staff,40,0,50,10
1713312660187,ECE 197,001,548057,Sievenpiper; Daniel F.,9998,0,9999,1
1713312661213,EDS 115,A00,507243,Choi; Bailey Miyeon,28,0,28,0
1713312662242,EDS 117,A01,494379,Staff,25,0,25,0
1713312663270,EDS 125,A00,507246,Hopkins; Megan Beth,29,0,30,1
1713312664307,EDS 128A,A01,507264,Fargason; Sharon Gayle,26,0,26,0
1713312665341,EDS 128B,A01,507293,Pappas; Elizabeth,30,0,30,0
1713312666372,EDS 139,A00,507294,Fargason; Sharon Gayle,30,0,30,0
1713312666372,EDS 139,B00,507313,Pappas; Elizabeth,30,0,30,0
1713312667397,EDS 201,A00,507315,Staff,26,0,30,4
1713312668423,EDS 203,A01,507317,Halter; Christopher P.,26,0,30,4
1713312669450,EDS 204R,A01,507319,Halter; Christopher P.,5,0,30,25
1713312669450,EDS 204R,B01,507331,Heinzman; Erica M.,28,0,30,2
1713312670475,EDS 206R,A00,507332,Staff,7,0,30,23
1713312670475,EDS 206R,B00,507343,Staff,27,0,30,3
1713312671501,EDS 250,A00,507344,Hemans; Patricia Ann Benitez,36,0,40,4
1713312672535,EDS 281,A00,507345,Daly; Alan J.,18,0,18,0
1713312673562,EDS 284,A00,507350,Daly; Alan J.,16,0,16,0
1713312674588,EDS 286,A00,507359,Fine; Sarah,18,0,18,0
1713312675615,EDS 289C,A01,507361,Daly; Alan J.,18,0,18,0
1713312676642,EDS 290,A00,507366,Hofstetter; Carolyn,15,0,15,0
1713312677675,LIGM 5A,A00,507421,Fischer-Grunski; Eva K,20,0,20,0
1713312678702,LIGM 5B,A00,507423,Fischer-Grunski; Eva K,20,0,20,0
1713312679729,LIGM 5C,A00,507425,Fischer-Grunski; Eva K,20,0,20,0
1713312680754,LIIT 5AS,A00,507427,Carnelos; Chiara,20,0,20,0
1713312681780,LIIT 5BS,A00,507430,Carnelos; Chiara,20,0,20,0
1713312682809,LIIT 5CS,A00,507432,Carnelos; Chiara,20,0,20,0
1713312683835,LISP 5A,A00,507541,Munoz Sanchez; Alicia,19,0,20,1
1713312684862,LISP 5B,A00,507671,Munoz Sanchez; Alicia,17,0,20,3
1713312685892,LISP 5C,A00,507696,Munoz Sanchez; Alicia,17,0,20,3
1713312686917,MAE 197,001,528363,Boechler; Nicholas Sebastia,9998,0,9999,1
1713312687943,MATH 197,001,523477,Kedlaya; Kiran S.,9999,0,9999,0
1713312687943,MATH 197,002,563811,Zhang; Danna,9999,0,9999,0
1713312688974,MCWP 40R,A00,518780,Staff,20,0,20,0
1713312688974,MCWP 40R,B00,518781,Staff,19,0,20,1
1713312688974,MCWP 40R,C00,518783,Staff,19,0,20,1
1713312690001,MCWP 50R,A00,518791,Staff,20,0,20,0
1713312690001,MCWP 50R,B00,518792,Staff,18,0,20,2
1713312690001,MCWP 50R,C00,518793,Staff,19,0,20,1
1713312690001,MCWP 50R,D00,518794,Staff,18,0,20,2
1713312690001,MCWP 50R,E00,518795,Staff,18,0,20,2
1713312690001,MCWP 50R,F00,518796,Staff,19,0,20,1
1713312690001,MCWP 50R,G00,518797,Staff,19,0,20,1
1713312691037,MMW 12R,A01,514034,Herbst; Matthew,16,0,16,0
1713312691037,MMW 12R,A02,514035,Herbst; Matthew,16,0,16,0
1713312692067,MMW 13R,A01,514037,Staff,13,0,16,3
1713312692067,MMW 13R,A02,514039,Staff,16,0,16,0
1713312694123,SIO 295LS,A00,523233,Staff,19,0,30,11
1713312695153,SIO 295S,A00,523232,Staff,19,0,30,11
1713312696179,SOCI 117,A01,494376,Staff,3,0,5,2
1713312697205,WES 237B,A00,494380,Staff,19,0,20,1
1713312699290,AESE 279B,A00,494370,Wade; Jon P,33,0,33,0
1713312700321,ANAR 135S,A00,494369,Braswell; Geoffrey E.,0,0,0,0
1713312701351,CAT 124RS,A01,519847,Geibel; William,17,0,20,3
1713312702377,CAT 125RS,A01,515971,Geibel; William,17,0,20,3
1713312703408,CLRE 250,A00,511389,Morris; Sheldon,9996,0,9999,3
1713312704436,CLRE 251,A00,507176,Mehta; Ravindra L.,9996,0,9999,3
1713312704436,CLRE 251,B00,511410,Mehta; Ravindra L.,9998,0,9999,1
1713312705469,CLRE 252,A00,507189,Cuomo; Raphael Eduardo,9998,0,9999,1
1713312706498,CLRE 253,A00,507199,Vaida; Florin,9997,0,9999,2
1713312706498,CLRE 253,B00,507202,Vaida; Florin,9999,0,9999,0
1713312707526,CLRE 259,A00,507211,Patel; Hemal,9996,0,9999,3
1713312708554,CLRE 260,A00,507221,Cuomo; Raphael Eduardo,9999,0,9999,0
1713312709582,CLRE 297,001,507242,Cuomo; Raphael Eduardo,9999,0,9999,0
1713312710615,CSE 191,A00,516875,Minnes Kemp; Mor Mia,9999,0,9999,0
1713312711646,CSS 201S,A01,494383,Staff,35,0,35,0
1713312712671,CSS 202S,A01,494387,Staff,35,0,35,0
1713312713698,EAP 100,A00,516065,Staff,9792,0,9999,207
1713312714725,ECE 45,A01,507414,Staff,54,0,60,6
1713312715756,ECE 100,A01,507416,Baghdadchi; Saharnaz,11,0,20,9
1713312715756,ECE 100,A02,507418,Baghdadchi; Saharnaz,20,0,20,0
1713312716781,ECE 111,A01,507420,Staff,40,0,50,10
1713312717808,ECE 197,001,548057,Sievenpiper; Daniel F.,9998,0,9999,1
1713312718840,EDS 115,A00,507243,Choi; Bailey Miyeon,28,0,28,0
1713312719868,EDS 117,A01,494379,Staff,25,0,25,0
1713312720893,EDS 125,A00,507246,Hopkins; Megan Beth,29,0,30,1
1713312721925,EDS 128A,A01,507264,Fargason; Sharon Gayle,26,0,26,0
1713312722957,EDS 128B,A01,507293,Pappas; Elizabeth,30,0,30,0
1713312723984,EDS 139,A00,507294,Fargason; Sharon Gayle,30,0,30,0
1713312723984,EDS 139,B00,507313,Pappas; Elizabeth,30,0,30,0
1713312725012,EDS 201,A00,507315,Staff,26,0,30,4
1713312726039,EDS 203,A01,507317,Halter; Christopher P.,26,0,30,4
1713312727072,EDS 204R,A01,507319,Halter; Christopher P.,5,0,30,25
1713312727072,EDS 204R,B01,507331,Heinzman; Erica M.,28,0,30,2
1713312728099,EDS 206R,A00,507332,Staff,7,0,30,23
1713312728099,EDS 206R,B00,507343,Staff,27,0,30,3
1713312729156,EDS 250,A00,507344,Hemans; Patricia Ann Benitez,36,0,40,4
1713312730185,EDS 281,A00,507345,Daly; Alan J.,18,0,18,0
1713312731225,EDS 284,A00,507350,Daly; Alan J.,16,0,16,0
1713312732250,EDS 286,A00,507359,Fine; Sarah,18,0,18,0
1713312733276,EDS 289C,A01,507361,Daly; Alan J.,18,0,18,0
1713312734304,EDS 290,A00,507366,Hofstetter; Carolyn,15,0,15,0
1713312735334,LIGM 5A,A00,507421,Fischer-Grunski; Eva K,20,0,20,0
1713312736365,LIGM 5B,A00,507423,Fischer-Grunski; Eva K,20,0,20,0
1713312737391,LIGM 5C,A00,507425,Fischer-Grunski; Eva K,20,0,20,0
1713312738425,LIIT 5AS,A00,507427,Carnelos; Chiara,20,0,20,0
1713312739457,LIIT 5BS,A00,507430,Carnelos; Chiara,20,0,20,0
1713312740482,LIIT 5CS,A00,507432,Carnelos; Chiara,20,0,20,0
1713312741512,LISP 5A,A00,507541,Munoz Sanchez; Alicia,19,0,20,1
1713312742536,LISP 5B,A00,507671,Munoz Sanchez; Alicia,17,0,20,3
1713312743566,LISP 5C,A00,507696,Munoz Sanchez; Alicia,17,0,20,3
1713312744597,MAE 197,001,528363,Boechler; Nicholas Sebastia,9998,0,9999,1
1713312745638,MATH 197,001,523477,Kedlaya; Kiran S.,9999,0,9999,0
1713312745638,MATH 197,002,563811,Zhang; Danna,9999,0,9999,0
1713312746671,MCWP 40R,A00,518780,Staff,20,0,20,0
1713312746671,MCWP 40R,B00,518781,Staff,19,0,20,1
1713312746671,MCWP 40R,C00,518783,Staff,19,0,20,1
1713312747704,MCWP 50R,A00,518791,Staff,20,0,20,0
1713312747704,MCWP 50R,B00,518792,Staff,18,0,20,2
1713312747704,MCWP 50R,C00,518793,Staff,19,0,20,1
1713312747704,MCWP 50R,D00,518794,Staff,18,0,20,2
1713312747704,MCWP 50R,E00,518795,Staff,18,0,20,2
1713312747704,MCWP 50R,F00,518796,Staff,19,0,20,1
1713312747704,MCWP 50R,G00,518797,Staff,19,0,20,1
1713312748730,MMW 12R,A01,514034,Herbst; Matthew,16,0,16,0
1713312748730,MMW 12R,A02,514035,Herbst; Matthew,16,0,16,0
1713312749756,MMW 13R,A01,514037,Staff,13,0,16,3
1713312749756,MMW 13R,A02,514039,Staff,16,0,16,0
1713312751812,SIO 295LS,A00,523233,Staff,19,0,30,11
1713312752866,SIO 295S,A00,523232,Staff,19,0,30,11
1713312753896,SOCI 117,A01,494376,Staff,3,0,5,2
1713312754991,WES 237B,A00,494380,Staff,19,0,20,1
1713312757063,AESE 279B,A00,494370,Wade; Jon P,33,0,33,0
1713312758093,ANAR 135S,A00,494369,Braswell; Geoffrey E.,0,0,0,0
1713312759120,CAT 124RS,A01,519847,Geibel; William,17,0,20,3
1713312760149,CAT 125RS,A01,515971,Geibel; William,17,0,20,3
1713312761174,CLRE 250,A00,511389,Morris; Sheldon,9996,0,9999,3
1713312762206,CLRE 251,A00,507176,Mehta; Ravindra L.,9996,0,9999,3
1713312762206,CLRE 251,B00,511410,Mehta; Ravindra L.,9998,0,9999,1
1713312763239,CLRE 252,A00,507189,Cuomo; Raphael Eduardo,9998,0,9999,1
1713312764266,CLRE 253,A00,507199,Vaida; Florin,9997,0,9999,2
1713312764266,CLRE 253,B00,507202,Vaida; Florin,9999,0,9999,0
1713312765299,CLRE 259,A00,507211,Patel; Hemal,9996,0,9999,3
1713312766326,CLRE 260,A00,507221,Cuomo; Raphael Eduardo,9999,0,9999,0
1713312767352,CLRE 297,001,507242,Cuomo; Raphael Eduardo,9999,0,9999,0
1713312768381,CSE 191,A00,516875,Minnes Kemp; Mor Mia,9999,0,9999,0
1713312769422,CSS 201S,A01,494383,Staff,35,0,35,0
1713312770449,CSS 202S,A01,494387,Staff,35,0,35,0
1713312771482,EAP 100,A00,516065,Staff,9792,0,9999,207
1713312772507,ECE 45,A01,507414,Staff,54,0,60,6
1713312773534,ECE 100,A01,507416,Baghdadchi; Saharnaz,11,0,20,9
1713312773534,ECE 100,A02,507418,Baghdadchi; Saharnaz,20,0,20,0
1713312774566,ECE 111,A01,507420,Staff,40,0,50,10
1713312775591,ECE 197,001,548057,Sievenpiper; Daniel F.,9998,0,9999,1
1713312776620,EDS 115,A00,507243,Choi; Bailey Miyeon,28,0,28,0
1713312777652,EDS 117,A01,494379,Staff,25,0,25,0
1713312778677,EDS 125,A00,507246,Hopkins; Megan Beth,29,0,30,1
1713312779709,EDS 128A,A01,507264,Fargason; Sharon Gayle,26,0,26,0
1713312780744,EDS 128B,A01,507293,Pappas; Elizabeth,30,0,30,0
1713312781769,EDS 139,A00,507294,Fargason; Sharon Gayle,30,0,30,0
1713312781769,EDS 139,B00,507313,Pappas; Elizabeth,30,0,30,0
1713312782796,EDS 201,A00,507315,Staff,26,0,30,4
1713312783821,EDS 203,A01,507317,Halter; Christopher P.,26,0,30,4
1713312784846,EDS 204R,A01,507319,Halter; Christopher P.,5,0,30,25
1713312784846,EDS 204R,B01,507331,Heinzman; Erica M.,28,0,30,2
1713312785871,EDS 206R,A00,507332,Staff,7,0,30,23
1713312785871,EDS 206R,B00,507343,Staff,27,0,30,3
1713312786905,EDS 250,A00,507344,Hemans; Patricia Ann Benitez,36,0,40,4
1713312787932,EDS 281,A00,507345,Daly; Alan J.,18,0,18,0
1713312788958,EDS 284,A00,507350,Daly; Alan J.,16,0,16,0
1713312790002,EDS 286,A00,507359,Fine; Sarah,18,0,18,0
1713312791027,EDS 289C,A01,507361,Daly; Alan J.,18,0,18,0
1713312792052,EDS 290,A00,507366,Hofstetter; Carolyn,15,0,15,0
1713312793077,LIGM 5A,A00,507421,Fischer-Grunski; Eva K,20,0,20,0
1713312794104,LIGM 5B,A00,507423,Fischer-Grunski; Eva K,20,0,20,0
1713312795131,LIGM 5C,A00,507425,Fischer-Grunski; Eva K,20,0,20,0
1713312796156,LIIT 5AS,A00,507427,Carnelos; Chiara,20,0,20,0
1713312797183,LIIT 5BS,A00,507430,Carnelos; Chiara,20,0,20,0
1713312798207,LIIT 5CS,A00,507432,Carnelos; Chiara,20,0,20,0
1713312799242,LISP 5A,A00,507541,Munoz Sanchez; Alicia,19,0,20,1
1713312800274,LISP 5B,A00,507671,Munoz Sanchez; Alicia,17,0,20,3
1713312801301,LISP 5C,A00,507696,Munoz Sanchez; Alicia,17,0,20,3
1713312802329,MAE 197,001,528363,Boechler; Nicholas Sebastia,9998,0,9999,1
1713312803374,MATH 197,001,523477,Kedlaya; Kiran S.,9999,0,9999,0
1713312803374,MATH 197,002,563811,Zhang; Danna,9999,0,9999,0
1713312804400,MCWP 40R,A00,518780,Staff,20,0,20,0
1713312804400,MCWP 40R,B00,518781,Staff,19,0,20,1
1713312804400,MCWP 40R,C00,518783,Staff,19,0,20,1
1713312805429,MCWP 50R,A00,518791,Staff,20,0,20,0
1713312805429,MCWP 50R,B00,518792,Staff,18,0,20,2
1713312805429,MCWP 50R,C00,518793,Staff,19,0,20,1
1713312805429,MCWP 50R,D00,518794,Staff,18,0,20,2
1713312805429,MCWP 50R,E00,518795,Staff,18,0,20,2
1713312805429,MCWP 50R,F00,518796,Staff,19,0,20,1
1713312805429,MCWP 50R,G00,518797,Staff,19,0,20,1
1713312806456,MMW 12R,A01,514034,Herbst; Matthew,16,0,16,0
1713312806456,MMW 12R,A02,514035,Herbst; Matthew,16,0,16,0
1713312807487,MMW 13R,A01,514037,Staff,13,0,16,3
1713312807487,MMW 13R,A02,514039,Staff,16,0,16,0
1713312809544,SIO 295LS,A00,523233,Staff,19,0,30,11
1713312810588,SIO 295S,A00,523232,Staff,19,0,30,11
1713312811615,SOCI 117,A01,494376,Staff,3,0,5,2
1713312812642,WES 237B,A00,494380,Staff,19,0,20,1
1713312814733,AESE 279B,A00,494370,Wade; Jon P,33,0,33,0
1713312815769,ANAR 135S,A00,494369,Braswell; Geoffrey E.,0,0,0,0
1713312816794,CAT 124RS,A01,519847,Geibel; William,17,0,20,3
1713312817820,CAT 125RS,A01,515971,Geibel; William,17,0,20,3
1713312818856,CLRE 250,A00,511389,Morris; Sheldon,9996,0,9999,3
1713312819891,CLRE 251,A00,507176,Mehta; Ravindra L.,9996,0,9999,3
1713312819891,CLRE 251,B00,511410,Mehta; Ravindra L.,9998,0,9999,1
1713312820916,CLRE 252,A00,507189,Cuomo; Raphael Eduardo,9998,0,9999,1
1713312821942,CLRE 253,A00,507199,Vaida; Florin,9997,0,9999,2
1713312821942,CLRE 253,B00,507202,Vaida; Florin,9999,0,9999,0
1713312822973,CLRE 259,A00,507211,Patel; Hemal,9996,0,9999,3
1713312824010,CLRE 260,A00,507221,Cuomo; Raphael Eduardo,9999,0,9999,0
1713312825036,CLRE 297,001,507242,Cuomo; Raphael Eduardo,9999,0,9999,0
1713312826069,CSE 191,A00,516875,Minnes Kemp; Mor Mia,9999,0,9999,0
1713312827094,CSS 201S,A01,494383,Staff,35,0,35,0
1713312828120,CSS 202S,A01,494387,Staff,35,0,35,0
1713312829149,EAP 100,A00,516065,Staff,9792,0,9999,207
1713312830174,ECE 45,A01,507414,Staff,54,0,60,6
1713312831201,ECE 100,A01,507416,Baghdadchi; Saharnaz,11,0,20,9
1713312831201,ECE 100,A02,507418,Baghdadchi; Saharnaz,20,0,20,0
1713312832227,ECE 111,A01,507420,Staff,40,0,50,10
1713312833252,ECE 197,001,548057,Sievenpiper; Daniel F.,9998,0,9999,1
1713312834278,EDS 115,A00,507243,Choi; Bailey Miyeon,28,0,28,0
1713312835309,EDS 117,A01,494379,Staff,25,0,25,0
1713312836335,EDS 125,A00,507246,Hopkins; Megan Beth,29,0,30,1
1713312837369,EDS 128A,A01,507264,Fargason; Sharon Gayle,26,0,26,0
1713312838395,EDS 128B,A01,507293,Pappas; Elizabeth,30,0,30,0
1713312839421,EDS 139,A00,507294,Fargason; Sharon Gayle,30,0,30,0
1713312839421,EDS 139,B00,507313,Pappas; Elizabeth,30,0,30,0
1713312840447,EDS 201,A00,507315,Staff,26,0,30,4
1713312841472,EDS 203,A01,507317,Halter; Christopher P.,26,0,30,4
1713312842498,EDS 204R,A01,507319,Halter; Christopher P.,5,0,30,25
1713312842498,EDS 204R,B01,507331,Heinzman; Erica M.,28,0,30,2
1713312843523,EDS 206R,A00,507332,Staff,7,0,30,23
1713312843523,EDS 206R,B00,507343,Staff,27,0,30,3
1713312844552,EDS 250,A00,507344,Hemans; Patricia Ann Benitez,36,0,40,4
1713312845580,EDS 281,A00,507345,Daly; Alan J.,18,0,18,0
1713312846607,EDS 284,A00,507350,Daly; Alan J.,16,0,16,0
1713312847634,EDS 286,A00,507359,Fine; Sarah,18,0,18,0
1713312848673,EDS 289C,A01,507361,Daly; Alan J.,18,0,18,0
1713312849707,EDS 290,A00,507366,Hofstetter; Carolyn,15,0,15,0
1713312850734,LIGM 5A,A00,507421,Fischer-Grunski; Eva K,20,0,20,0
1713312851760,LIGM 5B,A00,507423,Fischer-Grunski; Eva K,20,0,20,0
1713312852786,LIGM 5C,A00,507425,Fischer-Grunski; Eva K,20,0,20,0
1713312853830,LIIT 5AS,A00,507427,Carnelos; Chiara,20,0,20,0
1713312854870,LIIT 5BS,A00,507430,Carnelos; Chiara,20,0,20,0
1713312855896,LIIT 5CS,A00,507432,Carnelos; Chiara,20,0,20,0
1713312856929,LISP 5A,A00,507541,Munoz Sanchez; Alicia,19,0,20,1
1713312857955,LISP 5B,A00,507671,Munoz Sanchez; Alicia,17,0,20,3
1713312859036,LISP 5C,A00,507696,Munoz Sanchez; Alicia,17,0,20,3
1713312860075,MAE 197,001,528363,Boechler; Nicholas Sebastia,9998,0,9999,1
1713312861100,MATH 197,001,523477,Kedlaya; Kiran S.,9999,0,9999,0
1713312861100,MATH 197,002,563811,Zhang; Danna,9999,0,9999,0
1713312862133,MCWP 40R,A00,518780,Staff,20,0,20,0
1713312862133,MCWP 40R,B00,518781,Staff,19,0,20,1
1713312862133,MCWP 40R,C00,518783,Staff,19,0,20,1
1713312863166,MCWP 50R,A00,518791,Staff,20,0,20,0
1713312863166,MCWP 50R,B00,518792,Staff,18,0,20,2
1713312863166,MCWP 50R,C00,518793,Staff,19,0,20,1
1713312863166,MCWP 50R,D00,518794,Staff,18,0,20,2
1713312863166,MCWP 50R,E00,518795,Staff,18,0,20,2
1713312863166,MCWP 50R,F00,518796,Staff,19,0,20,1
1713312863166,MCWP 50R,G00,518797,Staff,19,0,20,1
1713312864201,MMW 12R,A01,514034,Herbst; Matthew,16,0,16,0
1713312864201,MMW 12R,A02,514035,Herbst; Matthew,16,0,16,0
1713312865230,MMW 13R,A01,514037,Staff,13,0,16,3
1713312865230,MMW 13R,A02,514039,Staff,16,0,16,0
1713312867291,SIO 295LS,A00,523233,Staff,19,0,30,11
1713312868317,SIO 295S,A00,523232,Staff,19,0,30,11
1713312869349,SOCI 117,A01,494376,Staff,3,0,5,2
1713312870374,WES 237B,A00,494380,Staff,19,0,20,1
1713312872450,AESE 279B,A00,494370,Wade; Jon P,33,0,33,0
1713312873476,ANAR 135S,A00,494369,Braswell; Geoffrey E.,0,0,0,0
1713312874505,CAT 124RS,A01,519847,Geibel; William,17,0,20,3
1713312875535,CAT 125RS,A01,515971,Geibel; William,17,0,20,3
1713312876560,CLRE 250,A00,511389,Morris; Sheldon,9996,0,9999,3
1713312877586,CLRE 251,A00,507176,Mehta; Ravindra L.,9996,0,9999,3
1713312877586,CLRE 251,B00,511410,Mehta; Ravindra L.,9998,0,9999,1
1713312878611,CLRE 252,A00,507189,Cuomo; Raphael Eduardo,9998,0,9999,1
1713312879637,CLRE 253,A00,507199,Vaida; Florin,9997,0,9999,2
1713312879637,CLRE 253,B00,507202,Vaida; Florin,9999,0,9999,0
1713312880664,CLRE 259,A00,507211,Patel; Hemal,9996,0,9999,3
1713312881696,CLRE 260,A00,507221,Cuomo; Raphael Eduardo,9999,0,9999,0
1713312882728,CLRE 297,001,507242,Cuomo; Raphael Eduardo,9999,0,9999,0
1713312883759,CSE 191,A00,516875,Minnes Kemp; Mor Mia,9999,0,9999,0
1713312884785,CSS 201S,A01,494383,Staff,35,0,35,0
1713312885811,CSS 202S,A01,494387,Staff,35,0,35,0
1713312886841,EAP 100,A00,516065,Staff,9792,0,9999,207
1713312887868,ECE 45,A01,507414,Staff,54,0,60,6
1713312888894,ECE 100,A01,507416,Baghdadchi; Saharnaz,11,0,20,9
1713312888894,ECE 100,A02,507418,Baghdadchi; Saharnaz,20,0,20,0
1713312889923,ECE 111,A01,507420,Staff,40,0,50,10
1713312890949,ECE 197,001,548057,Sievenpiper; Daniel F.,9998,0,9999,1
1713312891981,EDS 115,A00,507243,Choi; Bailey Miyeon,28,0,28,0
1713312893006,EDS 117,A01,494379,Staff,25,0,25,0
1713312894033,EDS 125,A00,507246,Hopkins; Megan Beth,29,0,30,1
1713312895061,EDS 128A,A01,507264,Fargason; Sharon Gayle,26,0,26,0
1713312896091,EDS 128B,A01,507293,Pappas; Elizabeth,30,0,30,0
1713312897117,EDS 139,A00,507294,Fargason; Sharon Gayle,30,0,30,0
1713312897117,EDS 139,B00,507313,Pappas; Elizabeth,30,0,30,0
1713312898142,EDS 201,A00,507315,Staff,26,0,30,4
1713312899178,EDS 203,A01,507317,Halter; Christopher P.,26,0,30,4
1713312900204,EDS 204R,A01,507319,Halter; Christopher P.,5,0,30,25
1713312900204,EDS 204R,B01,507331,Heinzman; Erica M.,28,0,30,2
1713312901233,EDS 206R,A00,507332,Staff,7,0,30,23
1713312901233,EDS 206R,B00,507343,Staff,27,0,30,3
1713312902263,EDS 250,A00,507344,Hemans; Patricia Ann Benitez,36,0,40,4
1713312903296,EDS 281,A00,507345,Daly; Alan J.,18,0,18,0
1713312904320,EDS 284,A00,507350,Daly; Alan J.,16,0,16,0
1713312905349,EDS 286,A00,507359,Fine; Sarah,18,0,18,0
1713312906373,EDS 289C,A01,507361,Daly; Alan J.,18,0,18,0
1713312907401,EDS 290,A00,507366,Hofstetter; Carolyn,15,0,15,0
1713312908437,LIGM 5A,A00,507421,Fischer-Grunski; Eva K,20,0,20,0
1713312909461,LIGM 5B,A00,507423,Fischer-Grunski; Eva K,20,0,20,0
1713312910486,LIGM 5C,A00,507425,Fischer-Grunski; Eva K,20,0,20,0
1713312911513,LIIT 5AS,A00,507427,Carnelos; Chiara,20,0,20,0
1713312912543,LIIT 5BS,A00,507430,Carnelos; Chiara,20,0,20,0
1713312913570,LIIT 5CS,A00,507432,Carnelos; Chiara,20,0,20,0
1713312914594,LISP 5A,A00,507541,Munoz Sanchez; Alicia,19,0,20,1
1713312915626,LISP 5B,A00,507671,Munoz Sanchez; Alicia,17,0,20,3
1713312916652,LISP 5C,A00,507696,Munoz Sanchez; Alicia,17,0,20,3
1713312917683,MAE 197,001,528363,Boechler; Nicholas Sebastia,9998,0,9999,1
1713312918709,MATH 197,001,523477,Kedlaya; Kiran S.,9999,0,9999,0
1713312918709,MATH 197,002,563811,Zhang; Danna,9999,0,9999,0
1713312919734,MCWP 40R,A00,518780,Staff,20,0,20,0
1713312919734,MCWP 40R,B00,518781,Staff,19,0,20,1
1713312919734,MCWP 40R,C00,518783,Staff,19,0,20,1
1713312920763,MCWP 50R,A00,518791,Staff,20,0,20,0
1713312920763,MCWP 50R,B00,518792,Staff,18,0,20,2
1713312920763,MCWP 50R,C00,518793,Staff,19,0,20,1
1713312920763,MCWP 50R,D00,518794,Staff,18,0,20,2
1713312920763,MCWP 50R,E00,518795,Staff,18,0,20,2
1713312920763,MCWP 50R,F00,518796,Staff,19,0,20,1
1713312920763,MCWP 50R,G00,518797,Staff,19,0,20,1
1713312921791,MMW 12R,A01,514034,Herbst; Matthew,16,0,16,0
1713312921791,MMW 12R,A02,514035,Herbst; Matthew,16,0,16,0
1713312922815,MMW 13R,A01,514037,Staff,13,0,16,3
1713312922815,MMW 13R,A02,514039,Staff,16,0,16,0
1713312924866,SIO 295LS,A00,523233,Staff,19,0,30,11
1713312925893,SIO 295S,A00,523232,Staff,19,0,30,11
1713312926920,SOCI 117,A01,494376,Staff,3,0,5,2
1713312927950,WES 237B,A00,494380,Staff,19,0,20,1
1713312930028,AESE 279B,A00,494370,Wade; Jon P,33,0,33,0
1713312931054,ANAR 135S,A00,494369,Braswell; Geoffrey E.,0,0,0,0
1713312932080,CAT 124RS,A01,519847,Geibel; William,17,0,20,3
1713312933112,CAT 125RS,A01,515971,Geibel; William,17,0,20,3
1713312934139,CLRE 250,A00,511389,Morris; Sheldon,9996,0,9999,3
1713312935165,CLRE 251,A00,507176,Mehta; Ravindra L.,9996,0,9999,3
1713312935165,CLRE 251,B00,511410,Mehta; Ravindra L.,9998,0,9999,1
1713312936190,CLRE 252,A00,507189,Cuomo; Raphael Eduardo,9998,0,9999,1
1713312937216,CLRE 253,A00,507199,Vaida; Florin,9997,0,9999,2
1713312937216,CLRE 253,B00,507202,Vaida; Florin,9999,0,9999,0
1713312938241,CLRE 259,A00,507211,Patel; Hemal,9996,0,9999,3
1713312939265,CLRE 260,A00,507221,Cuomo; Raphael Eduardo,9999,0,9999,0
1713312940291,CLRE 297,001,507242,Cuomo; Raphael Eduardo,9999,0,9999,0
1713312941323,CSE 191,A00,516875,Minnes Kemp; Mor Mia,9999,0,9999,0
1713312942349,CSS 201S,A01,494383,Staff,35,0,35,0
1713312943377,CSS 202S,A01,494387,Staff,35,0,35,0
1713312944408,EAP 100,A00,516065,Staff,9792,0,9999,207
1713312945437,ECE 45,A01,507414,Staff,54,0,60,6
1713312946467,ECE 100,A01,507416,Baghdadchi; Saharnaz,11,0,20,9
1713312946467,ECE 100,A02,507418,Baghdadchi; Saharnaz,20,0,20,0
1713312947493,ECE 111,A01,507420,Staff,40,0,50,10
1713312948519,ECE 197,001,548057,Sievenpiper; Daniel F.,9998,0,9999,1
1713312949546,EDS 115,A00,507243,Choi; Bailey Miyeon,28,0,28,0
1713312950580,EDS 117,A01,494379,Staff,24,0,25,1
1713312951614,EDS 125,A00,507246,Hopkins; Megan Beth,29,0,30,1
1713312952644,EDS 128A,A01,507264,Fargason; Sharon Gayle,26,0,26,0
1713312953671,EDS 128B,A01,507293,Pappas; Elizabeth,30,0,30,0
1713312954703,EDS 139,A00,507294,Fargason; Sharon Gayle,30,0,30,0
1713312954703,EDS 139,B00,507313,Pappas; Elizabeth,30,0,30,0
1713312955728,EDS 201,A00,507315,Staff,26,0,30,4
1713312956761,EDS 203,A01,507317,Halter; Christopher P.,26,0,30,4
1713312957788,EDS 204R,A01,507319,Halter; Christopher P.,5,0,30,25
1713312957788,EDS 204R,B01,507331,Heinzman; Erica M.,28,0,30,2
1713312958833,EDS 206R,A00,507332,Staff,7,0,30,23
1713312958833,EDS 206R,B00,507343,Staff,27,0,30,3
1713312959862,EDS 250,A00,507344,Hemans; Patricia Ann Benitez,36,0,40,4
1713312960892,EDS 281,A00,507345,Daly; Alan J.,18,0,18,0
1713312961916,EDS 284,A00,507350,Daly; Alan J.,16,0,16,0
1713312963000,EDS 286,A00,507359,Fine; Sarah,18,0,18,0
1713312964030,EDS 289C,A01,507361,Daly; Alan J.,18,0,18,0
1713312965068,EDS 290,A00,507366,Hofstetter; Carolyn,15,0,15,0
1713312966097,LIGM 5A,A00,507421,Fischer-Grunski; Eva K,20,0,20,0
1713312967122,LIGM 5B,A00,507423,Fischer-Grunski; Eva K,20,0,20,0
1713312968149,LIGM 5C,A00,507425,Fischer-Grunski; Eva K,20,0,20,0
1713312969176,LIIT 5AS,A00,507427,Carnelos; Chiara,20,0,20,0
1713312970201,LIIT 5BS,A00,507430,Carnelos; Chiara,20,0,20,0
1713312971229,LIIT 5CS,A00,507432,Carnelos; Chiara,20,0,20,0
1713312972256,LISP 5A,A00,507541,Munoz Sanchez; Alicia,19,0,20,1
1713312973280,LISP 5B,A00,507671,Munoz Sanchez; Alicia,17,0,20,3
1713312974306,LISP 5C,A00,507696,Munoz Sanchez; Alicia,17,0,20,3
1713312975335,MAE 197,001,528363,Boechler; Nicholas Sebastia,9998,0,9999,1
1713312976360,MATH 197,001,523477,Kedlaya; Kiran S.,9999,0,9999,0
1713312976360,MATH 197,002,563811,Zhang; Danna,9999,0,9999,0
1713312977386,MCWP 40R,A00,518780,Staff,20,0,20,0
1713312977386,MCWP 40R,B00,518781,Staff,19,0,20,1
1713312977386,MCWP 40R,C00,518783,Staff,19,0,20,1
1713312978566,MCWP 50R,A00,518791,Staff,20,0,20,0
1713312978566,MCWP 50R,B00,518792,Staff,18,0,20,2
1713312978566,MCWP 50R,C00,518793,Staff,19,0,20,1
1713312978566,MCWP 50R,D00,518794,Staff,18,0,20,2
1713312978566,MCWP 50R,E00,518795,Staff,18,0,20,2
1713312978566,MCWP 50R,F00,518796,Staff,19,0,20,1
1713312978566,MCWP 50R,G00,518797,Staff,19,0,20,1
1713312979597,MMW 12R,A01,514034,Herbst; Matthew,16,0,16,0
1713312979597,MMW 12R,A02,514035,Herbst; Matthew,16,0,16,0
1713312980622,MMW 13R,A01,514037,Staff,13,0,16,3
1713312980622,MMW 13R,A02,514039,Staff,16,0,16,0
1713312982669,SIO 295LS,A00,523233,Staff,19,0,30,11
1713312983700,SIO 295S,A00,523232,Staff,19,0,30,11
1713312984727,SOCI 117,A01,494376,Staff,3,0,5,2
1713312985752,WES 237B,A00,494380,Staff,19,0,20,1
1713312987830,AESE 279B,A00,494370,Wade; Jon P,33,0,33,0
1713312988854,ANAR 135S,A00,494369,Braswell; Geoffrey E.,0,0,0,0
1713312989881,CAT 124RS,A01,519847,Geibel; William,17,0,20,3
1713312990908,CAT 125RS,A01,515971,Geibel; William,17,0,20,3
1713312991934,CLRE 250,A00,511389,Morris; Sheldon,9996,0,9999,3
1713312992959,CLRE 251,A00,507176,Mehta; Ravindra L.,9996,0,9999,3
1713312992959,CLRE 251,B00,511410,Mehta; Ravindra L.,9998,0,9999,1
1713312993985,CLRE 252,A00,507189,Cuomo; Raphael Eduardo,9998,0,9999,1
1713312995011,CLRE 253,A00,507199,Vaida; Florin,9997,0,9999,2
1713312995011,CLRE 253,B00,507202,Vaida; Florin,9999,0,9999,0
1713312996036,CLRE 259,A00,507211,Patel; Hemal,9996,0,9999,3
1713312997063,CLRE 260,A00,507221,Cuomo; Raphael Eduardo,9999,0,9999,0
1713312998092,CLRE 297,001,507242,Cuomo; Raphael Eduardo,9999,0,9999,0
1713312999117,CSE 191,A00,516875,Minnes Kemp; Mor Mia,9999,0,9999,0
1713313000144,CSS 201S,A01,494383,Staff,35,0,35,0
1713313001169,CSS 202S,A01,494387,Staff,35,0,35,0
1713313002197,EAP 100,A00,516065,Staff,9792,0,9999,207
1713313003225,ECE 45,A01,507414,Staff,54,0,60,6
1713313004257,ECE 100,A01,507416,Baghdadchi; Saharnaz,11,0,20,9
1713313004257,ECE 100,A02,507418,Baghdadchi; Saharnaz,20,0,20,0
1713313005284,ECE 111,A01,507420,Staff,40,0,50,10
1713313006312,ECE 197,001,548057,Sievenpiper; Daniel F.,9998,0,9999,1
1713313007337,EDS 115,A00,507243,Choi; Bailey Miyeon,28,0,28,0
1713313008365,EDS 117,A01,494379,Staff,24,0,25,1
1713313009391,EDS 125,A00,507246,Hopkins; Megan Beth,29,0,30,1
1713313010416,EDS 128A,A01,507264,Fargason; Sharon Gayle,26,0,26,0
1713313011441,EDS 128B,A01,507293,Pappas; Elizabeth,30,0,30,0
1713313012465,EDS 139,A00,507294,Fargason; Sharon Gayle,30,0,30,0
1713313012465,EDS 139,B00,507313,Pappas; Elizabeth,30,0,30,0
1713313013494,EDS 201,A00,507315,Staff,26,0,30,4
1713313014519,EDS 203,A01,507317,Halter; Christopher P.,26,0,30,4
1713313015548,EDS 204R,A01,507319,Halter; Christopher P.,5,0,30,25
1713313015548,EDS 204R,B01,507331,Heinzman; Erica M.,28,0,30,2
1713313016576,EDS 206R,A00,507332,Staff,7,0,30,23
1713313016576,EDS 206R,B00,507343,Staff,27,0,30,3
1713313017603,EDS 250,A00,507344,Hemans; Patricia Ann Benitez,36,0,40,4
1713313018628,EDS 281,A00,507345,Daly; Alan J.,18,0,18,0
1713313019655,EDS 284,A00,507350,Daly; Alan J.,16,0,16,0
1713313020686,EDS 286,A00,507359,Fine; Sarah,18,0,18,0
1713313021714,EDS 289C,A01,507361,Daly; Alan J.,18,0,18,0
1713313022748,EDS 290,A00,507366,Hofstetter; Carolyn,15,0,15,0
1713313023773,LIGM 5A,A00,507421,Fischer-Grunski; Eva K,20,0,20,0
1713313024800,LIGM 5B,A00,507423,Fischer-Grunski; Eva K,20,0,20,0
1713313025825,LIGM 5C,A00,507425,Fischer-Grunski; Eva K,20,0,20,0
1713313026858,LIIT 5AS,A00,507427,Carnelos; Chiara,20,0,20,0
1713313027883,LIIT 5BS,A00,507430,Carnelos; Chiara,20,0,20,0
1713313028906,LIIT 5CS,A00,507432,Carnelos; Chiara,20,0,20,0
1713313029950,LISP 5A,A00,507541,Munoz Sanchez; Alicia,19,0,20,1
1713313030978,LISP 5B,A00,507671,Munoz Sanchez; Alicia,17,0,20,3
1713313032004,LISP 5C,A00,507696,Munoz Sanchez; Alicia,17,0,20,3
1713313033028,MAE 197,001,528363,Boechler; Nicholas Sebastia,9998,0,9999,1
1713313034054,MATH 197,001,523477,Kedlaya; Kiran S.,9999,0,9999,0
1713313034054,MATH 197,002,563811,Zhang; Danna,9999,0,9999,0
1713313035077,MCWP 40R,A00,518780,Staff,20,0,20,0
1713313035077,MCWP 40R,B00,518781,Staff,19,0,20,1
1713313035077,MCWP 40R,C00,518783,Staff,19,0,20,1
1713313036106,MCWP 50R,A00,518791,Staff,20,0,20,0
1713313036106,MCWP 50R,B00,518792,Staff,18,0,20,2
1713313036106,MCWP 50R,C00,518793,Staff,19,0,20,1
1713313036106,MCWP 50R,D00,518794,Staff,18,0,20,2
1713313036106,MCWP 50R,E00,518795,Staff,18,0,20,2
1713313036106,MCWP 50R,F00,518796,Staff,19,0,20,1
1713313036106,MCWP 50R,G00,518797,Staff,19,0,20,1
1713313037132,MMW 12R,A01,514034,Herbst; Matthew,16,0,16,0
1713313037132,MMW 12R,A02,514035,Herbst; Matthew,16,0,16,0
1713313038160,MMW 13R,A01,514037,Staff,13,0,16,3
1713313038160,MMW 13R,A02,514039,Staff,16,0,16,0
1713313040209,SIO 295LS,A00,523233,Staff,19,0,30,11
1713313041233,SIO 295S,A00,523232,Staff,19,0,30,11
1713313042257,SOCI 117,A01,494376,Staff,3,0,5,2
1713313043282,WES 237B,A00,494380,Staff,19,0,20,1
1713313045347,AESE 279B,A00,494370,Wade; Jon P,33,0,33,0
1713313046377,ANAR 135S,A00,494369,Braswell; Geoffrey E.,0,0,0,0
1713313047404,CAT 124RS,A01,519847,Geibel; William,17,0,20,3
1713313048429,CAT 125RS,A01,515971,Geibel; William,17,0,20,3
1713313049456,CLRE 250,A00,511389,Morris; Sheldon,9996,0,9999,3
1713313050484,CLRE 251,A00,507176,Mehta; Ravindra L.,9996,0,9999,3
1713313050484,CLRE 251,B00,511410,Mehta; Ravindra L.,9998,0,9999,1
1713313051513,CLRE 252,A00,507189,Cuomo; Raphael Eduardo,9998,0,9999,1
1713313052538,CLRE 253,A00,507199,Vaida; Florin,9997,0,9999,2
1713313052538,CLRE 253,B00,507202,Vaida; Florin,9999,0,9999,0
1713313053566,CLRE 259,A00,507211,Patel; Hemal,9996,0,9999,3
1713313054592,CLRE 260,A00,507221,Cuomo; Raphael Eduardo,9999,0,9999,0
1713313055617,CLRE 297,001,507242,Cuomo; Raphael Eduardo,9999,0,9999,0
1713313056645,CSE 191,A00,516875,Minnes Kemp; Mor Mia,9999,0,9999,0
1713313057675,CSS 201S,A01,494383,Staff,35,0,35,0
1713313058701,CSS 202S,A01,494387,Staff,35,0,35,0
1713313059726,EAP 100,A00,516065,Staff,9792,0,9999,207
1713313060752,ECE 45,A01,507414,Staff,54,0,60,6
1713313061778,ECE 100,A01,507416,Baghdadchi; Saharnaz,11,0,20,9
1713313061778,ECE 100,A02,507418,Baghdadchi; Saharnaz,20,0,20,0
1713313062804,ECE 111,A01,507420,Staff,40,0,50,10
1713313063830,ECE 197,001,548057,Sievenpiper; Daniel F.,9998,0,9999,1
1713313064855,EDS 115,A00,507243,Choi; Bailey Miyeon,28,0,28,0
1713313065881,EDS 117,A01,494379,Staff,24,0,25,1
1713313066960,EDS 125,A00,507246,Hopkins; Megan Beth,29,0,30,1
1713313067986,EDS 128A,A01,507264,Fargason; Sharon Gayle,26,0,26,0
1713313069012,EDS 128B,A01,507293,Pappas; Elizabeth,30,0,30,0
1713313070036,EDS 139,A00,507294,Fargason; Sharon Gayle,30,0,30,0
1713313070036,EDS 139,B00,507313,Pappas; Elizabeth,30,0,30,0
1713313071061,EDS 201,A00,507315,Staff,26,0,30,4
1713313072089,EDS 203,A01,507317,Halter; Christopher P.,26,0,30,4
1713313073115,EDS 204R,A01,507319,Halter; Christopher P.,5,0,30,25
1713313073115,EDS 204R,B01,507331,Heinzman; Erica M.,28,0,30,2
1713313074146,EDS 206R,A00,507332,Staff,7,0,30,23
1713313074146,EDS 206R,B00,507343,Staff,27,0,30,3
1713313075174,EDS 250,A00,507344,Hemans; Patricia Ann Benitez,36,0,40,4
1713313076200,EDS 281,A00,507345,Daly; Alan J.,18,0,18,0
1713313077224,EDS 284,A00,507350,Daly; Alan J.,16,0,16,0
1713313078253,EDS 286,A00,507359,Fine; Sarah,18,0,18,0
1713313079282,EDS 289C,A01,507361,Daly; Alan J.,18,0,18,0
1713313080312,EDS 290,A00,507366,Hofstetter; Carolyn,15,0,15,0
1713313081338,LIGM 5A,A00,507421,Fischer-Grunski; Eva K,20,0,20,0
1713313082363,LIGM 5B,A00,507423,Fischer-Grunski; Eva K,20,0,20,0
1713313083391,LIGM 5C,A00,507425,Fischer-Grunski; Eva K,20,0,20,0
1713313084416,LIIT 5AS,A00,507427,Carnelos; Chiara,20,0,20,0
1713313085439,LIIT 5BS,A00,507430,Carnelos; Chiara,20,0,20,0
1713313086466,LIIT 5CS,A00,507432,Carnelos; Chiara,20,0,20,0
1713313087491,LISP 5A,A00,507541,Munoz Sanchez; Alicia,19,0,20,1
1713313088516,LISP 5B,A00,507671,Munoz Sanchez; Alicia,17,0,20,3
1713313089542,LISP 5C,A00,507696,Munoz Sanchez; Alicia,17,0,20,3
1713313090570,MAE 197,001,528363,Boechler; Nicholas Sebastia,9998,0,9999,1
1713313091596,MATH 197,001,523477,Kedlaya; Kiran S.,9999,0,9999,0
1713313091596,MATH 197,002,563811,Zhang; Danna,9999,0,9999,0
1713313092621,MCWP 40R,A00,518780,Staff,20,0,20,0
1713313092621,MCWP 40R,B00,518781,Staff,19,0,20,1
1713313092621,MCWP 40R,C00,518783,Staff,19,0,20,1
1713313093651,MCWP 50R,A00,518791,Staff,20,0,20,0
1713313093651,MCWP 50R,B00,518792,Staff,18,0,20,2
1713313093651,MCWP 50R,C00,518793,Staff,19,0,20,1
1713313093651,MCWP 50R,D00,518794,Staff,18,0,20,2
1713313093651,MCWP 50R,E00,518795,Staff,18,0,20,2
1713313093651,MCWP 50R,F00,518796,Staff,19,0,20,1
1713313093651,MCWP 50R,G00,518797,Staff,19,0,20,1
1713313094679,MMW 12R,A01,514034,Herbst; Matthew,16,0,16,0
1713313094679,MMW 12R,A02,514035,Herbst; Matthew,16,0,16,0
1713313095707,MMW 13R,A01,514037,Staff,13,0,16,3
1713313095707,MMW 13R,A02,514039,Staff,16,0,16,0
1713313097760,SIO 295LS,A00,523233,Staff,19,0,30,11
1713313098785,SIO 295S,A00,523232,Staff,19,0,30,11
1713313099810,SOCI 117,A01,494376,Staff,3,0,5,2
1713313100840,WES 237B,A00,494380,Staff,19,0,20,1
1713313102906,AESE 279B,A00,494370,Wade; Jon P,33,0,33,0
1713313103932,ANAR 135S,A00,494369,Braswell; Geoffrey E.,0,0,0,0
1713313104961,CAT 124RS,A01,519847,Geibel; William,17,0,20,3
1713313105989,CAT 125RS,A01,515971,Geibel; William,17,0,20,3
1713313107014,CLRE 250,A00,511389,Morris; Sheldon,9996,0,9999,3
1713313108052,CLRE 251,A00,507176,Mehta; Ravindra L.,9996,0,9999,3
1713313108052,CLRE 251,B00,511410,Mehta; Ravindra L.,9998,0,9999,1
1713313109077,CLRE 252,A00,507189,Cuomo; Raphael Eduardo,9998,0,9999,1
1713313110107,CLRE 253,A00,507199,Vaida; Florin,9997,0,9999,2
1713313110107,CLRE 253,B00,507202,Vaida; Florin,9999,0,9999,0
1713313111133,CLRE 259,A00,507211,Patel; Hemal,9996,0,9999,3
1713313112162,CLRE 260,A00,507221,Cuomo; Raphael Eduardo,9999,0,9999,0
1713313113188,CLRE 297,001,507242,Cuomo; Raphael Eduardo,9999,0,9999,0
1713313114213,CSE 191,A00,516875,Minnes Kemp; Mor Mia,9999,0,9999,0
1713313115239,CSS 201S,A01,494383,Staff,35,0,35,0
1713313116265,CSS 202S,A01,494387,Staff,35,0,35,0
1713313117289,EAP 100,A00,516065,Staff,9792,0,9999,207
1713313118312,ECE 45,A01,507414,Staff,54,0,60,6
1713313119336,ECE 100,A01,507416,Baghdadchi; Saharnaz,11,0,20,9
1713313119336,ECE 100,A02,507418,Baghdadchi; Saharnaz,20,0,20,0
1713313120364,ECE 111,A01,507420,Staff,40,0,50,10
1713313121388,ECE 197,001,548057,Sievenpiper; Daniel F.,9998,0,9999,1
1713313122413,EDS 115,A00,507243,Choi; Bailey Miyeon,28,0,28,0
1713313123437,EDS 117,A01,494379,Staff,24,0,25,1
1713313124464,EDS 125,A00,507246,Hopkins; Megan Beth,29,0,30,1
1713313125488,EDS 128A,A01,507264,Fargason; Sharon Gayle,26,0,26,0
1713313126518,EDS 128B,A01,507293,Pappas; Elizabeth,30,0,30,0
1713313127545,EDS 139,A00,507294,Fargason; Sharon Gayle,30,0,30,0
1713313127545,EDS 139,B00,507313,Pappas; Elizabeth,30,0,30,0
1713313128569,EDS 201,A00,507315,Staff,26,0,30,4
1713313129600,EDS 203,A01,507317,Halter; Christopher P.,26,0,30,4
1713313130630,EDS 204R,A01,507319,Halter; Christopher P.,5,0,30,25
1713313130630,EDS 204R,B01,507331,Heinzman; Erica M.,28,0,30,2
1713313131656,EDS 206R,A00,507332,Staff,7,0,30,23
1713313131656,EDS 206R,B00,507343,Staff,27,0,30,3
1713313132680,EDS 250,A00,507344,Hemans; Patricia Ann Benitez,36,0,40,4
1713313133705,EDS 281,A00,507345,Daly; Alan J.,18,0,18,0
1713313134735,EDS 284,A00,507350,Daly; Alan J.,16,0,16,0
1713313135766,EDS 286,A00,507359,Fine; Sarah,18,0,18,0
1713313136794,EDS 289C,A01,507361,Daly; Alan J.,18,0,18,0
1713313137823,EDS 290,A00,507366,Hofstetter; Carolyn,15,0,15,0
1713313138848,LIGM 5A,A00,507421,Fischer-Grunski; Eva K,20,0,20,0
1713313139875,LIGM 5B,A00,507423,Fischer-Grunski; Eva K,20,0,20,0
1713313140899,LIGM 5C,A00,507425,Fischer-Grunski; Eva K,20,0,20,0
1713313141925,LIIT 5AS,A00,507427,Carnelos; Chiara,20,0,20,0
1713313142951,LIIT 5BS,A00,507430,Carnelos; Chiara,20,0,20,0
1713313143977,LIIT 5CS,A00,507432,Carnelos; Chiara,20,0,20,0
1713313145003,LISP 5A,A00,507541,Munoz Sanchez; Alicia,19,0,20,1
1713313146033,LISP 5B,A00,507671,Munoz Sanchez; Alicia,17,0,20,3
1713313147058,LISP 5C,A00,507696,Munoz Sanchez; Alicia,17,0,20,3
1713313148085,MAE 197,001,528363,Boechler; Nicholas Sebastia,9998,0,9999,1
1713313149114,MATH 197,001,523477,Kedlaya; Kiran S.,9999,0,9999,0
1713313149114,MATH 197,002,563811,Zhang; Danna,9999,0,9999,0
1713313150144,MCWP 40R,A00,518780,Staff,20,0,20,0
1713313150144,MCWP 40R,B00,518781,Staff,19,0,20,1
1713313150144,MCWP 40R,C00,518783,Staff,19,0,20,1
1713313151171,MCWP 50R,A00,518791,Staff,20,0,20,0
1713313151171,MCWP 50R,B00,518792,Staff,18,0,20,2
1713313151171,MCWP 50R,C00,518793,Staff,19,0,20,1
1713313151171,MCWP 50R,D00,518794,Staff,18,0,20,2
1713313151171,MCWP 50R,E00,518795,Staff,18,0,20,2
1713313151171,MCWP 50R,F00,518796,Staff,19,0,20,1
1713313151171,MCWP 50R,G00,518797,Staff,19,0,20,1
1713313152200,MMW 12R,A01,514034,Herbst; Matthew,16,0,16,0
1713313152200,MMW 12R,A02,514035,Herbst; Matthew,16,0,16,0
1713313153225,MMW 13R,A01,514037,Staff,13,0,16,3
1713313153225,MMW 13R,A02,514039,Staff,16,0,16,0
1713313155276,SIO 295LS,A00,523233,Staff,19,0,30,11
1713313156302,SIO 295S,A00,523232,Staff,19,0,30,11
1713313157327,SOCI 117,A01,494376,Staff,3,0,5,2
1713313158355,WES 237B,A00,494380,Staff,19,0,20,1
1713313160431,AESE 279B,A00,494370,Wade; Jon P,33,0,33,0
1713313161456,ANAR 135S,A00,494369,Braswell; Geoffrey E.,0,0,0,0
1713313162480,CAT 124RS,A01,519847,Geibel; William,17,0,20,3
1713313163506,CAT 125RS,A01,515971,Geibel; William,17,0,20,3
1713313164529,CLRE 250,A00,511389,Morris; Sheldon,9996,0,9999,3
1713313165556,CLRE 251,A00,507176,Mehta; Ravindra L.,9996,0,9999,3
1713313165556,CLRE 251,B00,511410,Mehta; Ravindra L.,9998,0,9999,1
1713313166580,CLRE 252,A00,507189,Cuomo; Raphael Eduardo,9998,0,9999,1
1713313167606,CLRE 253,A00,507199,Vaida; Florin,9997,0,9999,2
1713313167606,CLRE 253,B00,507202,Vaida; Florin,9999,0,9999,0
1713313168633,CLRE 259,A00,507211,Patel; Hemal,9996,0,9999,3
1713313169657,CLRE 260,A00,507221,Cuomo; Raphael Eduardo,9999,0,9999,0
1713313170739,CLRE 297,001,507242,Cuomo; Raphael Eduardo,9999,0,9999,0
1713313171765,CSE 191,A00,516875,Minnes Kemp; Mor Mia,9999,0,9999,0
1713313172789,CSS 201S,A01,494383,Staff,35,0,35,0
1713313173814,CSS 202S,A01,494387,Staff,35,0,35,0
1713313174841,EAP 100,A00,516065,Staff,9792,0,9999,207
1713313175869,ECE 45,A01,507414,Staff,54,0,60,6
1713313176899,ECE 100,A01,507416,Baghdadchi; Saharnaz,11,0,20,9
1713313176899,ECE 100,A02,507418,Baghdadchi; Saharnaz,20,0,20,0
1713313177923,ECE 111,A01,507420,Staff,40,0,50,10
1713313178949,ECE 197,001,548057,Sievenpiper; Daniel F.,9998,0,9999,1
1713313179974,EDS 115,A00,507243,Choi; Bailey Miyeon,28,0,28,0
1713313180998,EDS 117,A01,494379,Staff,24,0,25,1
1713313182026,EDS 125,A00,507246,Hopkins; Megan Beth,29,0,30,1
1713313183055,EDS 128A,A01,507264,Fargason; Sharon Gayle,26,0,26,0
1713313184080,EDS 128B,A01,507293,Pappas; Elizabeth,30,0,30,0
1713313185103,EDS 139,A00,507294,Fargason; Sharon Gayle,30,0,30,0
1713313185103,EDS 139,B00,507313,Pappas; Elizabeth,30,0,30,0
1713313186127,EDS 201,A00,507315,Staff,26,0,30,4
1713313187154,EDS 203,A01,507317,Halter; Christopher P.,26,0,30,4
1713313188180,EDS 204R,A01,507319,Halter; Christopher P.,5,0,30,25
1713313188180,EDS 204R,B01,507331,Heinzman; Erica M.,28,0,30,2
1713313189207,EDS 206R,A00,507332,Staff,7,0,30,23
1713313189207,EDS 206R,B00,507343,Staff,27,0,30,3
1713313190234,EDS 250,A00,507344,Hemans; Patricia Ann Benitez,36,0,40,4
1713313191262,EDS 281,A00,507345,Daly; Alan J.,18,0,18,0
1713313192286,EDS 284,A00,507350,Daly; Alan J.,16,0,16,0
1713313193317,EDS 286,A00,507359,Fine; Sarah,18,0,18,0
1713313194342,EDS 289C,A01,507361,Daly; Alan J.,18,0,18,0
1713313195368,EDS 290,A00,507366,Hofstetter; Carolyn,15,0,15,0
1713313196395,LIGM 5A,A00,507421,Fischer-Grunski; Eva K,20,0,20,0
1713313197423,LIGM 5B,A00,507423,Fischer-Grunski; Eva K,20,0,20,0
1713313198451,LIGM 5C,A00,507425,Fischer-Grunski; Eva K,20,0,20,0
1713313199480,LIIT 5AS,A00,507427,Carnelos; Chiara,20,0,20,0
1713313200506,LIIT 5BS,A00,507430,Carnelos; Chiara,20,0,20,0
1713313201534,LIIT 5CS,A00,507432,Carnelos; Chiara,20,0,20,0
1713313202709,LISP 5A,A00,507541,Munoz Sanchez; Alicia,19,0,20,1
1713313203734,LISP 5B,A00,507671,Munoz Sanchez; Alicia,17,0,20,3
1713313204759,LISP 5C,A00,507696,Munoz Sanchez; Alicia,17,0,20,3
1713313205792,MAE 197,001,528363,Boechler; Nicholas Sebastia,9998,0,9999,1
1713313206824,MATH 197,001,523477,Kedlaya; Kiran S.,9999,0,9999,0
1713313206824,MATH 197,002,563811,Zhang; Danna,9999,0,9999,0
1713313207853,MCWP 40R,A00,518780,Staff,20,0,20,0
1713313207853,MCWP 40R,B00,518781,Staff,19,0,20,1
1713313207853,MCWP 40R,C00,518783,Staff,19,0,20,1
1713313208892,MCWP 50R,A00,518791,Staff,20,0,20,0
1713313208892,MCWP 50R,B00,518792,Staff,18,0,20,2
1713313208892,MCWP 50R,C00,518793,Staff,19,0,20,1
1713313208892,MCWP 50R,D00,518794,Staff,18,0,20,2
1713313208892,MCWP 50R,E00,518795,Staff,18,0,20,2
1713313208892,MCWP 50R,F00,518796,Staff,19,0,20,1
1713313208892,MCWP 50R,G00,518797,Staff,19,0,20,1
1713313209919,MMW 12R,A01,514034,Herbst; Matthew,16,0,16,0
1713313209919,MMW 12R,A02,514035,Herbst; Matthew,16,0,16,0
1713313210945,MMW 13R,A01,514037,Staff,12,0,16,4
1713313210945,MMW 13R,A02,514039,Staff,16,0,16,0
1713313213001,SIO 295LS,A00,523233,Staff,19,0,30,11
1713313214029,SIO 295S,A00,523232,Staff,19,0,30,11
1713313215058,SOCI 117,A01,494376,Staff,3,0,5,2
1713313216084,WES 237B,A00,494380,Staff,19,0,20,1
1713313218161,AESE 279B,A00,494370,Wade; Jon P,33,0,33,0
1713313219189,ANAR 135S,A00,494369,Braswell; Geoffrey E.,0,0,0,0
1713313220214,CAT 124RS,A01,519847,Geibel; William,17,0,20,3
1713313221240,CAT 125RS,A01,515971,Geibel; William,17,0,20,3
1713313222265,CLRE 250,A00,511389,Morris; Sheldon,9996,0,9999,3
1713313223291,CLRE 251,A00,507176,Mehta; Ravindra L.,9996,0,9999,3
1713313223291,CLRE 251,B00,511410,Mehta; Ravindra L.,9998,0,9999,1
1713313224317,CLRE 252,A00,507189,Cuomo; Raphael Eduardo,9998,0,9999,1
1713313225342,CLRE 253,A00,507199,Vaida; Florin,9997,0,9999,2
1713313225342,CLRE 253,B00,507202,Vaida; Florin,9999,0,9999,0
1713313226365,CLRE 259,A00,507211,Patel; Hemal,9996,0,9999,3
1713313227389,CLRE 260,A00,507221,Cuomo; Raphael Eduardo,9999,0,9999,0
1713313228415,CLRE 297,001,507242,Cuomo; Raphael Eduardo,9999,0,9999,0
1713313229442,CSE 191,A00,516875,Minnes Kemp; Mor Mia,9999,0,9999,0
1713313230467,CSS 201S,A01,494383,Staff,35,0,35,0
1713313231492,CSS 202S,A01,494387,Staff,35,0,35,0
1713313232519,EAP 100,A00,516065,Staff,9792,0,9999,207
1713313233543,ECE 45,A01,507414,Staff,54,0,60,6
1713313234568,ECE 100,A01,507416,Baghdadchi; Saharnaz,11,0,20,9
1713313234568,ECE 100,A02,507418,Baghdadchi; Saharnaz,20,0,20,0
1713313235597,ECE 111,A01,507420,Staff,40,0,50,10
1713313236624,ECE 197,001,548057,Sievenpiper; Daniel F.,9998,0,9999,1
1713313237651,EDS 115,A00,507243,Choi; Bailey Miyeon,28,0,28,0
1713313238676,EDS 117,A01,494379,Staff,24,0,25,1
1713313239702,EDS 125,A00,507246,Hopkins; Megan Beth,29,0,30,1
1713313240732,EDS 128A,A01,507264,Fargason; Sharon Gayle,26,0,26,0
1713313241760,EDS 128B,A01,507293,Pappas; Elizabeth,30,0,30,0
1713313242787,EDS 139,A00,507294,Fargason; Sharon Gayle,30,0,30,0
1713313242787,EDS 139,B00,507313,Pappas; Elizabeth,30,0,30,0
1713313243812,EDS 201,A00,507315,Staff,26,0,30,4
1713313244840,EDS 203,A01,507317,Halter; Christopher P.,26,0,30,4
1713313245871,EDS 204R,A01,507319,Halter; Christopher P.,5,0,30,25
1713313245871,EDS 204R,B01,507331,Heinzman; Erica M.,28,0,30,2
1713313246900,EDS 206R,A00,507332,Staff,7,0,30,23
1713313246900,EDS 206R,B00,507343,Staff,27,0,30,3
1713313247926,EDS 250,A00,507344,Hemans; Patricia Ann Benitez,36,0,40,4
1713313249017,EDS 281,A00,507345,Daly; Alan J.,18,0,18,0
1713313250069,EDS 284,A00,507350,Daly; Alan J.,16,0,16,0
1713313251098,EDS 286,A00,507359,Fine; Sarah,18,0,18,0
1713313252126,EDS 289C,A01,507361,Daly; Alan J.,18,0,18,0
1713313253155,EDS 290,A00,507366,Hofstetter; Carolyn,15,0,15,0
1713313254181,LIGM 5A,A00,507421,Fischer-Grunski; Eva K,20,0,20,0
1713313255206,LIGM 5B,A00,507423,Fischer-Grunski; Eva K,20,0,20,0
1713313256237,LIGM 5C,A00,507425,Fischer-Grunski; Eva K,20,0,20,0
1713313257262,LIIT 5AS,A00,507427,Carnelos; Chiara,20,0,20,0
1713313258293,LIIT 5BS,A00,507430,Carnelos; Chiara,20,0,20,0
1713313259320,LIIT 5CS,A00,507432,Carnelos; Chiara,20,0,20,0
1713313260346,LISP 5A,A00,507541,Munoz Sanchez; Alicia,19,0,20,1
1713313261371,LISP 5B,A00,507671,Munoz Sanchez; Alicia,17,0,20,3
1713313262394,LISP 5C,A00,507696,Munoz Sanchez; Alicia,17,0,20,3
1713313263426,MAE 197,001,528363,Boechler; Nicholas Sebastia,9998,0,9999,1
1713313264457,MATH 197,001,523477,Kedlaya; Kiran S.,9999,0,9999,0
1713313264457,MATH 197,002,563811,Zhang; Danna,9999,0,9999,0
1713313265488,MCWP 40R,A00,518780,Staff,20,0,20,0
1713313265488,MCWP 40R,B00,518781,Staff,19,0,20,1
1713313265488,MCWP 40R,C00,518783,Staff,19,0,20,1
1713313266518,MCWP 50R,A00,518791,Staff,20,0,20,0
1713313266518,MCWP 50R,B00,518792,Staff,18,0,20,2
1713313266518,MCWP 50R,C00,518793,Staff,19,0,20,1
1713313266518,MCWP 50R,D00,518794,Staff,18,0,20,2
1713313266518,MCWP 50R,E00,518795,Staff,18,0,20,2
1713313266518,MCWP 50R,F00,518796,Staff,19,0,20,1
1713313266518,MCWP 50R,G00,518797,Staff,19,0,20,1
1713313267543,MMW 12R,A01,514034,Herbst; Matthew,16,0,16,0
1713313267543,MMW 12R,A02,514035,Herbst; Matthew,16,0,16,0
1713313268571,MMW 13R,A01,514037,Staff,12,0,16,4
1713313268571,MMW 13R,A02,514039,Staff,16,0,16,0
1713313270627,SIO 295LS,A00,523233,Staff,19,0,30,11
1713313271652,SIO 295S,A00,523232,Staff,19,0,30,11
1713313272677,SOCI 117,A01,494376,Staff,3,0,5,2
1713313273702,WES 237B,A00,494380,Staff,19,0,20,1
1713313275835,AESE 279B,A00,494370,Wade; Jon P,33,0,33,0
1713313276864,ANAR 135S,A00,494369,Braswell; Geoffrey E.,0,0,0,0
1713313277889,CAT 124RS,A01,519847,Geibel; William,17,0,20,3
1713313278914,CAT 125RS,A01,515971,Geibel; William,17,0,20,3
1713313279945,CLRE 250,A00,511389,Morris; Sheldon,9996,0,9999,3
1713313280972,CLRE 251,A00,507176,Mehta; Ravindra L.,9996,0,9999,3
1713313280972,CLRE 251,B00,511410,Mehta; Ravindra L.,9998,0,9999,1
1713313281999,CLRE 252,A00,507189,Cuomo; Raphael Eduardo,9998,0,9999,1
1713313283028,CLRE 253,A00,507199,Vaida; Florin,9997,0,9999,2
1713313283028,CLRE 253,B00,507202,Vaida; Florin,9999,0,9999,0
1713313284057,CLRE 259,A00,507211,Patel; Hemal,9996,0,9999,3
1713313285086,CLRE 260,A00,507221,Cuomo; Raphael Eduardo,9999,0,9999,0
1713313286110,CLRE 297,001,507242,Cuomo; Raphael Eduardo,9999,0,9999,0
1713313287139,CSE 191,A00,516875,Minnes Kemp; Mor Mia,9999,0,9999,0
1713313288168,CSS 201S,A01,494383,Staff,35,0,35,0
1713313289198,CSS 202S,A01,494387,Staff,35,0,35,0
1713313290226,EAP 100,A00,516065,Staff,9792,0,9999,207
1713313291253,ECE 45,A01,507414,Staff,54,0,60,6
1713313292280,ECE 100,A01,507416,Baghdadchi; Saharnaz,11,0,20,9
1713313292280,ECE 100,A02,507418,Baghdadchi; Saharnaz,20,0,20,0
1713313293305,ECE 111,A01,507420,Staff,40,0,50,10
1713313294332,ECE 197,001,548057,Sievenpiper; Daniel F.,9998,0,9999,1
1713313295362,EDS 115,A00,507243,Choi; Bailey Miyeon,28,0,28,0
1713313296386,EDS 117,A01,494379,Staff,24,0,25,1
1713313297411,EDS 125,A00,507246,Hopkins; Megan Beth,29,0,30,1
1713313298440,EDS 128A,A01,507264,Fargason; Sharon Gayle,26,0,26,0
1713313299465,EDS 128B,A01,507293,Pappas; Elizabeth,30,0,30,0
1713313300490,EDS 139,A00,507294,Fargason; Sharon Gayle,30,0,30,0
1713313300490,EDS 139,B00,507313,Pappas; Elizabeth,30,0,30,0
1713313301514,EDS 201,A00,507315,Staff,26,0,30,4
1713313302540,EDS 203,A01,507317,Halter; Christopher P.,26,0,30,4
1713313303571,EDS 204R,A01,507319,Halter; Christopher P.,5,0,30,25
1713313303571,EDS 204R,B01,507331,Heinzman; Erica M.,28,0,30,2
1713313304598,EDS 206R,A00,507332,Staff,7,0,30,23
1713313304598,EDS 206R,B00,507343,Staff,27,0,30,3
1713313305627,EDS 250,A00,507344,Hemans; Patricia Ann Benitez,36,0,40,4
1713313306655,EDS 281,A00,507345,Daly; Alan J.,18,0,18,0
1713313307679,EDS 284,A00,507350,Daly; Alan J.,16,0,16,0
1713313308702,EDS 286,A00,507359,Fine; Sarah,18,0,18,0
1713313309728,EDS 289C,A01,507361,Daly; Alan J.,18,0,18,0
1713313310756,EDS 290,A00,507366,Hofstetter; Carolyn,15,0,15,0
1713313311781,LIGM 5A,A00,507421,Fischer-Grunski; Eva K,20,0,20,0
1713313312807,LIGM 5B,A00,507423,Fischer-Grunski; Eva K,20,0,20,0
1713313313832,LIGM 5C,A00,507425,Fischer-Grunski; Eva K,20,0,20,0
1713313314870,LIIT 5AS,A00,507427,Carnelos; Chiara,20,0,20,0
1713313315894,LIIT 5BS,A00,507430,Carnelos; Chiara,20,0,20,0
1713313316923,LIIT 5CS,A00,507432,Carnelos; Chiara,20,0,20,0
1713313317950,LISP 5A,A00,507541,Munoz Sanchez; Alicia,19,0,20,1
1713313318977,LISP 5B,A00,507671,Munoz Sanchez; Alicia,17,0,20,3
1713313320002,LISP 5C,A00,507696,Munoz Sanchez; Alicia,17,0,20,3
1713313321028,MAE 197,001,528363,Boechler; Nicholas Sebastia,9998,0,9999,1
1713313322057,MATH 197,001,523477,Kedlaya; Kiran S.,9999,0,9999,0
1713313322057,MATH 197,002,563811,Zhang; Danna,9999,0,9999,0
1713313323083,MCWP 40R,A00,518780,Staff,20,0,20,0
1713313323083,MCWP 40R,B00,518781,Staff,19,0,20,1
1713313323083,MCWP 40R,C00,518783,Staff,19,0,20,1
1713313324114,MCWP 50R,A00,518791,Staff,20,0,20,0
1713313324114,MCWP 50R,B00,518792,Staff,18,0,20,2
1713313324114,MCWP 50R,C00,518793,Staff,19,0,20,1
1713313324114,MCWP 50R,D00,518794,Staff,18,0,20,2
1713313324114,MCWP 50R,E00,518795,Staff,18,0,20,2
1713313324114,MCWP 50R,F00,518796,Staff,19,0,20,1
1713313324114,MCWP 50R,G00,518797,Staff,19,0,20,1
1713313325142,MMW 12R,A01,514034,Herbst; Matthew,16,0,16,0
1713313325142,MMW 12R,A02,514035,Herbst; Matthew,16,0,16,0
1713313326168,MMW 13R,A01,514037,Staff,12,0,16,4
1713313326168,MMW 13R,A02,514039,Staff,16,0,16,0
1713313328339,SIO 295LS,A00,523233,Staff,19,0,30,11
1713313329366,SIO 295S,A00,523232,Staff,19,0,30,11
1713313330395,SOCI 117,A01,494376,Staff,3,0,5,2
1713313331423,WES 237B,A00,494380,Staff,19,0,20,1
1713313333496,AESE 279B,A00,494370,Wade; Jon P,33,0,33,0
1713313334524,ANAR 135S,A00,494369,Braswell; Geoffrey E.,0,0,0,0
1713313335554,CAT 124RS,A01,519847,Geibel; William,17,0,20,3
1713313336580,CAT 125RS,A01,515971,Geibel; William,17,0,20,3
1713313337605,CLRE 250,A00,511389,Morris; Sheldon,9996,0,9999,3
1713313338634,CLRE 251,A00,507176,Mehta; Ravindra L.,9996,0,9999,3
1713313338634,CLRE 251,B00,511410,Mehta; Ravindra L.,9998,0,9999,1
1713313339660,CLRE 252,A00,507189,Cuomo; Raphael Eduardo,9998,0,9999,1
1713313340686,CLRE 253,A00,507199,Vaida; Florin,9997,0,9999,2
1713313340686,CLRE 253,B00,507202,Vaida; Florin,9999,0,9999,0
1713313341712,CLRE 259,A00,507211,Patel; Hemal,9996,0,9999,3
1713313342736,CLRE 260,A00,507221,Cuomo; Raphael Eduardo,9999,0,9999,0
1713313343763,CLRE 297,001,507242,Cuomo; Raphael Eduardo,9999,0,9999,0
1713313344793,CSE 191,A00,516875,Minnes Kemp; Mor Mia,9999,0,9999,0
1713313345822,CSS 201S,A01,494383,Staff,35,0,35,0
1713313346852,CSS 202S,A01,494387,Staff,35,0,35,0
1713313347879,EAP 100,A00,516065,Staff,9792,0,9999,207
1713313348908,ECE 45,A01,507414,Staff,54,0,60,6
1713313349938,ECE 100,A01,507416,Baghdadchi; Saharnaz,11,0,20,9
1713313349938,ECE 100,A02,507418,Baghdadchi; Saharnaz,20,0,20,0
1713313350963,ECE 111,A01,507420,Staff,40,0,50,10
1713313351992,ECE 197,001,548057,Sievenpiper; Daniel F.,9998,0,9999,1
1713313353129,EDS 115,A00,507243,Choi; Bailey Miyeon,28,0,28,0
1713313354153,EDS 117,A01,494379,Staff,24,0,25,1
1713313355179,EDS 125,A00,507246,Hopkins; Megan Beth,29,0,30,1
1713313356205,EDS 128A,A01,507264,Fargason; Sharon Gayle,26,0,26,0
1713313357230,EDS 128B,A01,507293,Pappas; Elizabeth,30,0,30,0
1713313358258,EDS 139,A00,507294,Fargason; Sharon Gayle,30,0,30,0
1713313358258,EDS 139,B00,507313,Pappas; Elizabeth,30,0,30,0
1713313359281,EDS 201,A00,507315,Staff,26,0,30,4
1713313360306,EDS 203,A01,507317,Halter; Christopher P.,26,0,30,4
1713313361332,EDS 204R,A01,507319,Halter; Christopher P.,5,0,30,25
1713313361332,EDS 204R,B01,507331,Heinzman; Erica M.,28,0,30,2
1713313362361,EDS 206R,A00,507332,Staff,7,0,30,23
1713313362361,EDS 206R,B00,507343,Staff,27,0,30,3
1713313363390,EDS 250,A00,507344,Hemans; Patricia Ann Benitez,36,0,40,4
1713313364419,EDS 281,A00,507345,Daly; Alan J.,18,0,18,0
1713313365442,EDS 284,A00,507350,Daly; Alan J.,16,0,16,0
1713313366467,EDS 286,A00,507359,Fine; Sarah,18,0,18,0
1713313367493,EDS 289C,A01,507361,Daly; Alan J.,18,0,18,0
1713313368520,EDS 290,A00,507366,Hofstetter; Carolyn,15,0,15,0
1713313369551,LIGM 5A,A00,507421,Fischer-Grunski; Eva K,20,0,20,0
1713313370578,LIGM 5B,A00,507423,Fischer-Grunski; Eva K,20,0,20,0
1713313371604,LIGM 5C,A00,507425,Fischer-Grunski; Eva K,20,0,20,0
1713313372794,LIIT 5AS,A00,507427,Carnelos; Chiara,20,0,20,0
1713313373820,LIIT 5BS,A00,507430,Carnelos; Chiara,20,0,20,0
1713313374849,LIIT 5CS,A00,507432,Carnelos; Chiara,20,0,20,0
1713313375880,LISP 5A,A00,507541,Munoz Sanchez; Alicia,19,0,20,1
1713313376910,LISP 5B,A00,507671,Munoz Sanchez; Alicia,17,0,20,3
1713313377939,LISP 5C,A00,507696,Munoz Sanchez; Alicia,17,0,20,3
1713313379017,MAE 197,001,528363,Boechler; Nicholas Sebastia,9998,0,9999,1
1713313380043,MATH 197,001,523477,Kedlaya; Kiran S.,9999,0,9999,0
1713313380043,MATH 197,002,563811,Zhang; Danna,9999,0,9999,0
1713313381072,MCWP 40R,A00,518780,Staff,20,0,20,0
1713313381072,MCWP 40R,B00,518781,Staff,19,0,20,1
1713313381072,MCWP 40R,C00,518783,Staff,19,0,20,1
1713313382098,MCWP 50R,A00,518791,Staff,20,0,20,0
1713313382098,MCWP 50R,B00,518792,Staff,18,0,20,2
1713313382098,MCWP 50R,C00,518793,Staff,19,0,20,1
1713313382098,MCWP 50R,D00,518794,Staff,18,0,20,2
1713313382098,MCWP 50R,E00,518795,Staff,18,0,20,2
1713313382098,MCWP 50R,F00,518796,Staff,19,0,20,1
1713313382098,MCWP 50R,G00,518797,Staff,19,0,20,1
1713313383124,MMW 12R,A01,514034,Herbst; Matthew,16,0,16,0
1713313383124,MMW 12R,A02,514035,Herbst; Matthew,16,0,16,0
1713313384152,MMW 13R,A01,514037,Staff,12,0,16,4
1713313384152,MMW 13R,A02,514039,Staff,16,0,16,0
1713313386200,SIO 295LS,A00,523233,Staff,19,0,30,11
1713313387226,SIO 295S,A00,523232,Staff,19,0,30,11
1713313388252,SOCI 117,A01,494376,Staff,3,0,5,2
1713313389279,WES 237B,A00,494380,Staff,19,0,20,1
1713313391352,AESE 279B,A00,494370,Wade; Jon P,33,0,33,0
1713313392375,ANAR 135S,A00,494369,Braswell; Geoffrey E.,0,0,0,0
1713313393400,CAT 124RS,A01,519847,Geibel; William,17,0,20,3
1713313394425,CAT 125RS,A01,515971,Geibel; William,17,0,20,3
1713313395459,CLRE 250,A00,511389,Morris; Sheldon,9996,0,9999,3
1713313396487,CLRE 251,A00,507176,Mehta; Ravindra L.,9996,0,9999,3
1713313396487,CLRE 251,B00,511410,Mehta; Ravindra L.,9998,0,9999,1
1713313397513,CLRE 252,A00,507189,Cuomo; Raphael Eduardo,9998,0,9999,1
1713313398541,CLRE 253,A00,507199,Vaida; Florin,9997,0,9999,2
1713313398541,CLRE 253,B00,507202,Vaida; Florin,9999,0,9999,0
1713313399567,CLRE 259,A00,507211,Patel; Hemal,9996,0,9999,3
1713313400594,CLRE 260,A00,507221,Cuomo; Raphael Eduardo,9999,0,9999,0
1713313401619,CLRE 297,001,507242,Cuomo; Raphael Eduardo,9999,0,9999,0
1713313402644,CSE 191,A00,516875,Minnes Kemp; Mor Mia,9999,0,9999,0
1713313403669,CSS 201S,A01,494383,Staff,35,0,35,0
1713313404694,CSS 202S,A01,494387,Staff,35,0,35,0
1713313405720,EAP 100,A00,516065,Staff,9792,0,9999,207
1713313406744,ECE 45,A01,507414,Staff,54,0,60,6
1713313407773,ECE 100,A01,507416,Baghdadchi; Saharnaz,11,0,20,9
1713313407773,ECE 100,A02,507418,Baghdadchi; Saharnaz,20,0,20,0
1713313408798,ECE 111,A01,507420,Staff,40,0,50,10
1713313409829,ECE 197,001,548057,Sievenpiper; Daniel F.,9998,0,9999,1
1713313410858,EDS 115,A00,507243,Choi; Bailey Miyeon,28,0,28,0
1713313411885,EDS 117,A01,494379,Staff,24,0,25,1
1713313412913,EDS 125,A00,507246,Hopkins; Megan Beth,29,0,30,1
1713313413941,EDS 128A,A01,507264,Fargason; Sharon Gayle,26,0,26,0
1713313414972,EDS 128B,A01,507293,Pappas; Elizabeth,30,0,30,0
1713313415997,EDS 139,A00,507294,Fargason; Sharon Gayle,30,0,30,0
1713313415997,EDS 139,B00,507313,Pappas; Elizabeth,30,0,30,0
1713313417022,EDS 201,A00,507315,Staff,26,0,30,4
1713313418048,EDS 203,A01,507317,Halter; Christopher P.,26,0,30,4
1713313419075,EDS 204R,A01,507319,Halter; Christopher P.,5,0,30,25
1713313419075,EDS 204R,B01,507331,Heinzman; Erica M.,28,0,30,2
1713313420102,EDS 206R,A00,507332,Staff,7,0,30,23
1713313420102,EDS 206R,B00,507343,Staff,27,0,30,3
1713313421127,EDS 250,A00,507344,Hemans; Patricia Ann Benitez,36,0,40,4
1713313422151,EDS 281,A00,507345,Daly; Alan J.,18,0,18,0
1713313423181,EDS 284,A00,507350,Daly; Alan J.,16,0,16,0
1713313424211,EDS 286,A00,507359,Fine; Sarah,18,0,18,0
1713313425238,EDS 289C,A01,507361,Daly; Alan J.,18,0,18,0
1713313426261,EDS 290,A00,507366,Hofstetter; Carolyn,15,0,15,0
1713313427289,LIGM 5A,A00,507421,Fischer-Grunski; Eva K,20,0,20,0
1713313428314,LIGM 5B,A00,507423,Fischer-Grunski; Eva K,20,0,20,0
1713313429342,LIGM 5C,A00,507425,Fischer-Grunski; Eva K,20,0,20,0
1713313430367,LIIT 5AS,A00,507427,Carnelos; Chiara,20,0,20,0
1713313431392,LIIT 5BS,A00,507430,Carnelos; Chiara,20,0,20,0
1713313432416,LIIT 5CS,A00,507432,Carnelos; Chiara,20,0,20,0
1713313433439,LISP 5A,A00,507541,Munoz Sanchez; Alicia,19,0,20,1
1713313434464,LISP 5B,A00,507671,Munoz Sanchez; Alicia,17,0,20,3
1713313435496,LISP 5C,A00,507696,Munoz Sanchez; Alicia,17,0,20,3
1713313436524,MAE 197,001,528363,Boechler; Nicholas Sebastia,9998,0,9999,1
1713313437549,MATH 197,001,523477,Kedlaya; Kiran S.,9999,0,9999,0
1713313437549,MATH 197,002,563811,Zhang; Danna,9999,0,9999,0
1713313438582,MCWP 40R,A00,518780,Staff,20,0,20,0
1713313438582,MCWP 40R,B00,518781,Staff,19,0,20,1
1713313438582,MCWP 40R,C00,518783,Staff,19,0,20,1
1713313439610,MCWP 50R,A00,518791,Staff,20,0,20,0
1713313439610,MCWP 50R,B00,518792,Staff,18,0,20,2
1713313439610,MCWP 50R,C00,518793,Staff,19,0,20,1
1713313439610,MCWP 50R,D00,518794,Staff,18,0,20,2
1713313439610,MCWP 50R,E00,518795,Staff,18,0,20,2
1713313439610,MCWP 50R,F00,518796,Staff,19,0,20,1
1713313439610,MCWP 50R,G00,518797,Staff,19,0,20,1
1713313440637,MMW 12R,A01,514034,Herbst; Matthew,16,0,16,0
1713313440637,MMW 12R,A02,514035,Herbst; Matthew,16,0,16,0
1713313441664,MMW 13R,A01,514037,Staff,12,0,16,4
1713313441664,MMW 13R,A02,514039,Staff,16,0,16,0
1713313443719,SIO 295LS,A00,523233,Staff,19,0,30,11
1713313444746,SIO 295S,A00,523232,Staff,19,0,30,11
1713313445771,SOCI 117,A01,494376,Staff,3,0,5,2
1713313446798,WES 237B,A00,494380,Staff,19,0,20,1
1713313448883,AESE 279B,A00,494370,Wade; Jon P,33,0,33,0
1713313449910,ANAR 135S,A00,494369,Braswell; Geoffrey E.,0,0,0,0
1713313450934,CAT 124RS,A01,519847,Geibel; William,17,0,20,3
1713313451963,CAT 125RS,A01,515971,Geibel; William,17,0,20,3
1713313452993,CLRE 250,A00,511389,Morris; Sheldon,9996,0,9999,3
1713313454020,CLRE 251,A00,507176,Mehta; Ravindra L.,9996,0,9999,3
1713313454020,CLRE 251,B00,511410,Mehta; Ravindra L.,9998,0,9999,1
1713313455046,CLRE 252,A00,507189,Cuomo; Raphael Eduardo,9998,0,9999,1
1713313456071,CLRE 253,A00,507199,Vaida; Florin,9997,0,9999,2
1713313456071,CLRE 253,B00,507202,Vaida; Florin,9999,0,9999,0
1713313457096,CLRE 259,A00,507211,Patel; Hemal,9996,0,9999,3
1713313458121,CLRE 260,A00,507221,Cuomo; Raphael Eduardo,9999,0,9999,0
1713313459144,CLRE 297,001,507242,Cuomo; Raphael Eduardo,9999,0,9999,0
1713313460170,CSE 191,A00,516875,Minnes Kemp; Mor Mia,9999,0,9999,0
1713313461200,CSS 201S,A01,494383,Staff,35,0,35,0
1713313462232,CSS 202S,A01,494387,Staff,35,0,35,0
1713313463256,EAP 100,A00,516065,Staff,9792,0,9999,207
1713313464297,ECE 45,A01,507414,Staff,54,0,60,6
1713313465324,ECE 100,A01,507416,Baghdadchi; Saharnaz,11,0,20,9
1713313465324,ECE 100,A02,507418,Baghdadchi; Saharnaz,20,0,20,0
1713313466349,ECE 111,A01,507420,Staff,40,0,50,10
1713313467373,ECE 197,001,548057,Sievenpiper; Daniel F.,9998,0,9999,1
1713313468404,EDS 115,A00,507243,Choi; Bailey Miyeon,28,0,28,0
1713313469428,EDS 117,A01,494379,Staff,24,0,25,1
1713313470457,EDS 125,A00,507246,Hopkins; Megan Beth,29,0,30,1
1713313471483,EDS 128A,A01,507264,Fargason; Sharon Gayle,26,0,26,0
1713313472511,EDS 128B,A01,507293,Pappas; Elizabeth,30,0,30,0
1713313473539,EDS 139,A00,507294,Fargason; Sharon Gayle,30,0,30,0
1713313473539,EDS 139,B00,507313,Pappas; Elizabeth,30,0,30,0
1713313474566,EDS 201,A00,507315,Staff,26,0,30,4
1713313475595,EDS 203,A01,507317,Halter; Christopher P.,26,0,30,4
1713313476621,EDS 204R,A01,507319,Halter; Christopher P.,5,0,30,25
1713313476621,EDS 204R,B01,507331,Heinzman; Erica M.,28,0,30,2
1713313477649,EDS 206R,A00,507332,Staff,7,0,30,23
1713313477649,EDS 206R,B00,507343,Staff,27,0,30,3
1713313478678,EDS 250,A00,507344,Hemans; Patricia Ann Benitez,36,0,40,4
1713313479707,EDS 281,A00,507345,Daly; Alan J.,18,0,18,0
1713313480732,EDS 284,A00,507350,Daly; Alan J.,16,0,16,0
1713313481758,EDS 286,A00,507359,Fine; Sarah,18,0,18,0
1713313482838,EDS 289C,A01,507361,Daly; Alan J.,18,0,18,0
1713313483873,EDS 290,A00,507366,Hofstetter; Carolyn,15,0,15,0
1713313484902,LIGM 5A,A00,507421,Fischer-Grunski; Eva K,20,0,20,0
1713313485928,LIGM 5B,A00,507423,Fischer-Grunski; Eva K,20,0,20,0
1713313486958,LIGM 5C,A00,507425,Fischer-Grunski; Eva K,20,0,20,0
1713313487987,LIIT 5AS,A00,507427,Carnelos; Chiara,20,0,20,0
1713313489012,LIIT 5BS,A00,507430,Carnelos; Chiara,20,0,20,0
1713313490039,LIIT 5CS,A00,507432,Carnelos; Chiara,20,0,20,0
1713313491065,LISP 5A,A00,507541,Munoz Sanchez; Alicia,19,0,20,1
1713313492090,LISP 5B,A00,507671,Munoz Sanchez; Alicia,17,0,20,3
1713313493119,LISP 5C,A00,507696,Munoz Sanchez; Alicia,17,0,20,3
1713313494142,MAE 197,001,528363,Boechler; Nicholas Sebastia,9998,0,9999,1
1713313495167,MATH 197,001,523477,Kedlaya; Kiran S.,9999,0,9999,0
1713313495167,MATH 197,002,563811,Zhang; Danna,9999,0,9999,0
1713313496195,MCWP 40R,A00,518780,Staff,20,0,20,0
1713313496195,MCWP 40R,B00,518781,Staff,19,0,20,1
1713313496195,MCWP 40R,C00,518783,Staff,19,0,20,1
1713313497219,MCWP 50R,A00,518791,Staff,20,0,20,0
1713313497219,MCWP 50R,B00,518792,Staff,18,0,20,2
1713313497219,MCWP 50R,C00,518793,Staff,19,0,20,1
1713313497219,MCWP 50R,D00,518794,Staff,18,0,20,2
1713313497219,MCWP 50R,E00,518795,Staff,18,0,20,2
1713313497219,MCWP 50R,F00,518796,Staff,19,0,20,1
1713313497219,MCWP 50R,G00,518797,Staff,19,0,20,1
1713313498249,MMW 12R,A01,514034,Herbst; Matthew,16,0,16,0
1713313498249,MMW 12R,A02,514035,Herbst; Matthew,16,0,16,0
1713313499274,MMW 13R,A01,514037,Staff,12,0,16,4
1713313499274,MMW 13R,A02,514039,Staff,16,0,16,0
1713313501324,SIO 295LS,A00,523233,Staff,19,0,30,11
1713313502349,SIO 295S,A00,523232,Staff,19,0,30,11
1713313503374,SOCI 117,A01,494376,Staff,3,0,5,2
1713313504398,WES 237B,A00,494380,Staff,19,0,20,1
1713313506457,AESE 279B,A00,494370,Wade; Jon P,33,0,33,0
1713313507485,ANAR 135S,A00,494369,Braswell; Geoffrey E.,0,0,0,0
1713313508510,CAT 124RS,A01,519847,Geibel; William,17,0,20,3
1713313509537,CAT 125RS,A01,515971,Geibel; William,17,0,20,3
1713313510562,CLRE 250,A00,511389,Morris; Sheldon,9996,0,9999,3
1713313511596,CLRE 251,A00,507176,Mehta; Ravindra L.,9996,0,9999,3
1713313511596,CLRE 251,B00,511410,Mehta; Ravindra L.,9998,0,9999,1
1713313512621,CLRE 252,A00,507189,Cuomo; Raphael Eduardo,9998,0,9999,1
1713313513647,CLRE 253,A00,507199,Vaida; Florin,9997,0,9999,2
1713313513647,CLRE 253,B00,507202,Vaida; Florin,9999,0,9999,0
1713313514674,CLRE 259,A00,507211,Patel; Hemal,9996,0,9999,3
1713313515710,CLRE 260,A00,507221,Cuomo; Raphael Eduardo,9999,0,9999,0
1713313516738,CLRE 297,001,507242,Cuomo; Raphael Eduardo,9999,0,9999,0
1713313517764,CSE 191,A00,516875,Minnes Kemp; Mor Mia,9999,0,9999,0
1713313518797,CSS 201S,A01,494383,Staff,35,0,35,0
1713313519824,CSS 202S,A01,494387,Staff,35,0,35,0
1713313520850,EAP 100,A00,516065,Staff,9792,0,9999,207
1713313521875,ECE 45,A01,507414,Staff,54,0,60,6
1713313522907,ECE 100,A01,507416,Baghdadchi; Saharnaz,11,0,20,9
1713313522907,ECE 100,A02,507418,Baghdadchi; Saharnaz,20,0,20,0
1713313523936,ECE 111,A01,507420,Staff,40,0,50,10
1713313524962,ECE 197,001,548057,Sievenpiper; Daniel F.,9998,0,9999,1
1713313525990,EDS 115,A00,507243,Choi; Bailey Miyeon,28,0,28,0
1713313527016,EDS 117,A01,494379,Staff,24,0,25,1
1713313528046,EDS 125,A00,507246,Hopkins; Megan Beth,29,0,30,1
1713313529071,EDS 128A,A01,507264,Fargason; Sharon Gayle,26,0,26,0
1713313530101,EDS 128B,A01,507293,Pappas; Elizabeth,30,0,30,0
1713313531124,EDS 139,A00,507294,Fargason; Sharon Gayle,30,0,30,0
1713313531124,EDS 139,B00,507313,Pappas; Elizabeth,30,0,30,0
1713313532149,EDS 201,A00,507315,Staff,26,0,30,4
1713313533176,EDS 203,A01,507317,Halter; Christopher P.,26,0,30,4
1713313534202,EDS 204R,A01,507319,Halter; Christopher P.,5,0,30,25
1713313534202,EDS 204R,B01,507331,Heinzman; Erica M.,28,0,30,2
1713313535228,EDS 206R,A00,507332,Staff,7,0,30,23
1713313535228,EDS 206R,B00,507343,Staff,27,0,30,3
1713313536257,EDS 250,A00,507344,Hemans; Patricia Ann Benitez,36,0,40,4
1713313537283,EDS 281,A00,507345,Daly; Alan J.,18,0,18,0
1713313538308,EDS 284,A00,507350,Daly; Alan J.,16,0,16,0
1713313539334,EDS 286,A00,507359,Fine; Sarah,18,0,18,0
1713313540360,EDS 289C,A01,507361,Daly; Alan J.,18,0,18,0
1713313541392,EDS 290,A00,507366,Hofstetter; Carolyn,15,0,15,0
1713313542419,LIGM 5A,A00,507421,Fischer-Grunski; Eva K,20,0,20,0
1713313543445,LIGM 5B,A00,507423,Fischer-Grunski; Eva K,20,0,20,0
1713313544475,LIGM 5C,A00,507425,Fischer-Grunski; Eva K,20,0,20,0
1713313545502,LIIT 5AS,A00,507427,Carnelos; Chiara,20,0,20,0
1713313546531,LIIT 5BS,A00,507430,Carnelos; Chiara,20,0,20,0
1713313547559,LIIT 5CS,A00,507432,Carnelos; Chiara,20,0,20,0
1713313548587,LISP 5A,A00,507541,Munoz Sanchez; Alicia,19,0,20,1
1713313549611,LISP 5B,A00,507671,Munoz Sanchez; Alicia,17,0,20,3
1713313550641,LISP 5C,A00,507696,Munoz Sanchez; Alicia,17,0,20,3
1713313551666,MAE 197,001,528363,Boechler; Nicholas Sebastia,9998,0,9999,1
1713313552697,MATH 197,001,523477,Kedlaya; Kiran S.,9999,0,9999,0
1713313552697,MATH 197,002,563811,Zhang; Danna,9999,0,9999,0
1713313553723,MCWP 40R,A00,518780,Staff,20,0,20,0
1713313553723,MCWP 40R,B00,518781,Staff,19,0,20,1
1713313553723,MCWP 40R,C00,518783,Staff,19,0,20,1
1713313554751,MCWP 50R,A00,518791,Staff,20,0,20,0
1713313554751,MCWP 50R,B00,518792,Staff,18,0,20,2
1713313554751,MCWP 50R,C00,518793,Staff,19,0,20,1
1713313554751,MCWP 50R,D00,518794,Staff,18,0,20,2
1713313554751,MCWP 50R,E00,518795,Staff,18,0,20,2
1713313554751,MCWP 50R,F00,518796,Staff,19,0,20,1
1713313554751,MCWP 50R,G00,518797,Staff,19,0,20,1
1713313555777,MMW 12R,A01,514034,Herbst; Matthew,16,0,16,0
1713313555777,MMW 12R,A02,514035,Herbst; Matthew,16,0,16,0
1713313556807,MMW 13R,A01,514037,Staff,12,0,16,4
1713313556807,MMW 13R,A02,514039,Staff,16,0,16,0
1713313558859,SIO 295LS,A00,523233,Staff,19,0,30,11
1713313559889,SIO 295S,A00,523232,Staff,19,0,30,11
1713313560915,SOCI 117,A01,494376,Staff,3,0,5,2
1713313561940,WES 237B,A00,494380,Staff,19,0,20,1
1713313564018,AESE 279B,A00,494370,Wade; Jon P,33,0,33,0
1713313565047,ANAR 135S,A00,494369,Braswell; Geoffrey E.,0,0,0,0
1713313566077,CAT 124RS,A01,519847,Geibel; William,17,0,20,3
1713313567102,CAT 125RS,A01,515971,Geibel; William,17,0,20,3
1713313568128,CLRE 250,A00,511389,Morris; Sheldon,9996,0,9999,3
1713313569156,CLRE 251,A00,507176,Mehta; Ravindra L.,9996,0,9999,3
1713313569156,CLRE 251,B00,511410,Mehta; Ravindra L.,9998,0,9999,1
1713313570183,CLRE 252,A00,507189,Cuomo; Raphael Eduardo,9998,0,9999,1
1713313571211,CLRE 253,A00,507199,Vaida; Florin,9997,0,9999,2
1713313571211,CLRE 253,B00,507202,Vaida; Florin,9999,0,9999,0
1713313572235,CLRE 259,A00,507211,Patel; Hemal,9996,0,9999,3
1713313573261,CLRE 260,A00,507221,Cuomo; Raphael Eduardo,9999,0,9999,0
1713313574286,CLRE 297,001,507242,Cuomo; Raphael Eduardo,9999,0,9999,0
1713313575316,CSE 191,A00,516875,Minnes Kemp; Mor Mia,9999,0,9999,0
1713313576346,CSS 201S,A01,494383,Staff,35,0,35,0
1713313577372,CSS 202S,A01,494387,Staff,35,0,35,0
1713313578398,EAP 100,A00,516065,Staff,9792,0,9999,207
1713313579426,ECE 45,A01,507414,Staff,54,0,60,6
1713313580452,ECE 100,A01,507416,Baghdadchi; Saharnaz,11,0,20,9
1713313580452,ECE 100,A02,507418,Baghdadchi; Saharnaz,20,0,20,0
1713313581477,ECE 111,A01,507420,Staff,40,0,50,10
1713313582506,ECE 197,001,548057,Sievenpiper; Daniel F.,9998,0,9999,1
1713313583532,EDS 115,A00,507243,Choi; Bailey Miyeon,28,0,28,0
1713313584556,EDS 117,A01,494379,Staff,24,0,25,1
1713313585585,EDS 125,A00,507246,Hopkins; Megan Beth,29,0,30,1
1713313586666,EDS 128A,A01,507264,Fargason; Sharon Gayle,26,0,26,0
1713313587695,EDS 128B,A01,507293,Pappas; Elizabeth,30,0,30,0
1713313588722,EDS 139,A00,507294,Fargason; Sharon Gayle,30,0,30,0
1713313588722,EDS 139,B00,507313,Pappas; Elizabeth,30,0,30,0
1713313589748,EDS 201,A00,507315,Staff,26,0,30,4
1713313590776,EDS 203,A01,507317,Halter; Christopher P.,26,0,30,4
1713313591801,EDS 204R,A01,507319,Halter; Christopher P.,5,0,30,25
1713313591801,EDS 204R,B01,507331,Heinzman; Erica M.,28,0,30,2
1713313592829,EDS 206R,A00,507332,Staff,7,0,30,23
1713313592829,EDS 206R,B00,507343,Staff,27,0,30,3
1713313593862,EDS 250,A00,507344,Hemans; Patricia Ann Benitez,36,0,40,4
1713313594893,EDS 281,A00,507345,Daly; Alan J.,18,0,18,0
1713313595918,EDS 284,A00,507350,Daly; Alan J.,16,0,16,0
1713313596943,EDS 286,A00,507359,Fine; Sarah,18,0,18,0
1713313597968,EDS 289C,A01,507361,Daly; Alan J.,18,0,18,0
1713313599000,EDS 290,A00,507366,Hofstetter; Carolyn,15,0,15,0
1713313600027,LIGM 5A,A00,507421,Fischer-Grunski; Eva K,20,0,20,0
1713313601055,LIGM 5B,A00,507423,Fischer-Grunski; Eva K,20,0,20,0
1713313602080,LIGM 5C,A00,507425,Fischer-Grunski; Eva K,20,0,20,0
1713313603107,LIIT 5AS,A00,507427,Carnelos; Chiara,20,0,20,0
1713313604132,LIIT 5BS,A00,507430,Carnelos; Chiara,20,0,20,0
1713313605159,LIIT 5CS,A00,507432,Carnelos; Chiara,20,0,20,0
1713313606189,LISP 5A,A00,507541,Munoz Sanchez; Alicia,19,0,20,1
1713313607215,LISP 5B,A00,507671,Munoz Sanchez; Alicia,17,0,20,3
1713313608240,LISP 5C,A00,507696,Munoz Sanchez; Alicia,17,0,20,3
1713313609268,MAE 197,001,528363,Boechler; Nicholas Sebastia,9998,0,9999,1
1713313610296,MATH 197,001,523477,Kedlaya; Kiran S.,9999,0,9999,0
1713313610296,MATH 197,002,563811,Zhang; Danna,9999,0,9999,0
1713313611321,MCWP 40R,A00,518780,Staff,20,0,20,0
1713313611321,MCWP 40R,B00,518781,Staff,19,0,20,1
1713313611321,MCWP 40R,C00,518783,Staff,19,0,20,1
1713313612352,MCWP 50R,A00,518791,Staff,20,0,20,0
1713313612352,MCWP 50R,B00,518792,Staff,18,0,20,2
1713313612352,MCWP 50R,C00,518793,Staff,19,0,20,1
1713313612352,MCWP 50R,D00,518794,Staff,18,0,20,2
1713313612352,MCWP 50R,E00,518795,Staff,18,0,20,2
1713313612352,MCWP 50R,F00,518796,Staff,19,0,20,1
1713313612352,MCWP 50R,G00,518797,Staff,19,0,20,1
1713313613378,MMW 12R,A01,514034,Herbst; Matthew,16,0,16,0
1713313613378,MMW 12R,A02,514035,Herbst; Matthew,16,0,16,0
1713313614401,MMW 13R,A01,514037,Staff,12,0,16,4
1713313614401,MMW 13R,A02,514039,Staff,16,0,16,0
1713313616454,SIO 295LS,A00,523233,Staff,19,0,30,11
1713313617478,SIO 295S,A00,523232,Staff,19,0,30,11
1713313618509,SOCI 117,A01,494376,Staff,3,0,5,2
1713313619535,WES 237B,A00,494380,Staff,19,0,20,1
1713313621613,AESE 279B,A00,494370,Wade; Jon P,33,0,33,0
1713313622642,ANAR 135S,A00,494369,Braswell; Geoffrey E.,0,0,0,0
1713313623667,CAT 124RS,A01,519847,Geibel; William,17,0,20,3
1713313624691,CAT 125RS,A01,515971,Geibel; William,17,0,20,3
1713313625720,CLRE 250,A00,511389,Morris; Sheldon,9996,0,9999,3
1713313626746,CLRE 251,A00,507176,Mehta; Ravindra L.,9996,0,9999,3
1713313626746,CLRE 251,B00,511410,Mehta; Ravindra L.,9998,0,9999,1
1713313627776,CLRE 252,A00,507189,Cuomo; Raphael Eduardo,9998,0,9999,1
1713313628802,CLRE 253,A00,507199,Vaida; Florin,9997,0,9999,2
1713313628802,CLRE 253,B00,507202,Vaida; Florin,9999,0,9999,0
1713313629832,CLRE 259,A00,507211,Patel; Hemal,9996,0,9999,3
1713313630859,CLRE 260,A00,507221,Cuomo; Raphael Eduardo,9999,0,9999,0
1713313631881,CLRE 297,001,507242,Cuomo; Raphael Eduardo,9999,0,9999,0
1713313632910,CSE 191,A00,516875,Minnes Kemp; Mor Mia,9999,0,9999,0
1713313633937,CSS 201S,A01,494383,Staff,35,0,35,0
1713313634966,CSS 202S,A01,494387,Staff,35,0,35,0
1713313635993,EAP 100,A00,516065,Staff,9792,0,9999,207
1713313637019,ECE 45,A01,507414,Staff,54,0,60,6
1713313638044,ECE 100,A01,507416,Baghdadchi; Saharnaz,11,0,20,9
1713313638044,ECE 100,A02,507418,Baghdadchi; Saharnaz,20,0,20,0
1713313639069,ECE 111,A01,507420,Staff,40,0,50,10
1713313640095,ECE 197,001,548057,Sievenpiper; Daniel F.,9998,0,9999,1
1713313641121,EDS 115,A00,507243,Choi; Bailey Miyeon,28,0,28,0
1713313642149,EDS 117,A01,494379,Staff,24,0,25,1
1713313643176,EDS 125,A00,507246,Hopkins; Megan Beth,29,0,30,1
1713313644201,EDS 128A,A01,507264,Fargason; Sharon Gayle,26,0,26,0
1713313645228,EDS 128B,A01,507293,Pappas; Elizabeth,30,0,30,0
1713313646255,EDS 139,A00,507294,Fargason; Sharon Gayle,30,0,30,0
1713313646255,EDS 139,B00,507313,Pappas; Elizabeth,30,0,30,0
1713313647284,EDS 201,A00,507315,Staff,26,0,30,4
1713313648313,EDS 203,A01,507317,Halter; Christopher P.,26,0,30,4
1713313649339,EDS 204R,A01,507319,Halter; Christopher P.,5,0,30,25
1713313649339,EDS 204R,B01,507331,Heinzman; Erica M.,28,0,30,2
1713313650368,EDS 206R,A00,507332,Staff,7,0,30,23
1713313650368,EDS 206R,B00,507343,Staff,27,0,30,3
1713313651396,EDS 250,A00,507344,Hemans; Patricia Ann Benitez,36,0,40,4
1713313652425,EDS 281,A00,507345,Daly; Alan J.,18,0,18,0
1713313653451,EDS 284,A00,507350,Daly; Alan J.,16,0,16,0
1713313654476,EDS 286,A00,507359,Fine; Sarah,18,0,18,0
1713313655501,EDS 289C,A01,507361,Daly; Alan J.,18,0,18,0
1713313656531,EDS 290,A00,507366,Hofstetter; Carolyn,15,0,15,0
1713313657559,LIGM 5A,A00,507421,Fischer-Grunski; Eva K,20,0,20,0
1713313658584,LIGM 5B,A00,507423,Fischer-Grunski; Eva K,20,0,20,0
1713313659610,LIGM 5C,A00,507425,Fischer-Grunski; Eva K,20,0,20,0
1713313660636,LIIT 5AS,A00,507427,Carnelos; Chiara,20,0,20,0
1713313661666,LIIT 5BS,A00,507430,Carnelos; Chiara,20,0,20,0
1713313662695,LIIT 5CS,A00,507432,Carnelos; Chiara,20,0,20,0
1713313663721,LISP 5A,A00,507541,Munoz Sanchez; Alicia,19,0,20,1
1713313664750,LISP 5B,A00,507671,Munoz Sanchez; Alicia,17,0,20,3
1713313665779,LISP 5C,A00,507696,Munoz Sanchez; Alicia,17,0,20,3
1713313666805,MAE 197,001,528363,Boechler; Nicholas Sebastia,9998,0,9999,1
1713313667831,MATH 197,001,523477,Kedlaya; Kiran S.,9999,0,9999,0
1713313667831,MATH 197,002,563811,Zhang; Danna,9999,0,9999,0
1713313668860,MCWP 40R,A00,518780,Staff,20,0,20,0
1713313668860,MCWP 40R,B00,518781,Staff,19,0,20,1
1713313668860,MCWP 40R,C00,518783,Staff,19,0,20,1
1713313669885,MCWP 50R,A00,518791,Staff,20,0,20,0
1713313669885,MCWP 50R,B00,518792,Staff,18,0,20,2
1713313669885,MCWP 50R,C00,518793,Staff,19,0,20,1
1713313669885,MCWP 50R,D00,518794,Staff,18,0,20,2
1713313669885,MCWP 50R,E00,518795,Staff,18,0,20,2
1713313669885,MCWP 50R,F00,518796,Staff,19,0,20,1
1713313669885,MCWP 50R,G00,518797,Staff,19,0,20,1
1713313670908,MMW 12R,A01,514034,Herbst; Matthew,16,0,16,0
1713313670908,MMW 12R,A02,514035,Herbst; Matthew,16,0,16,0
1713313671937,MMW 13R,A01,514037,Staff,12,0,16,4
1713313671937,MMW 13R,A02,514039,Staff,16,0,16,0
1713313673988,SIO 295LS,A00,523233,Staff,19,0,30,11
1713313675020,SIO 295S,A00,523232,Staff,19,0,30,11
1713313676044,SOCI 117,A01,494376,Staff,3,0,5,2
1713313677070,WES 237B,A00,494380,Staff,19,0,20,1
1713313679150,AESE 279B,A00,494370,Wade; Jon P,33,0,33,0
1713313680176,ANAR 135S,A00,494369,Braswell; Geoffrey E.,0,0,0,0
1713313681204,CAT 124RS,A01,519847,Geibel; William,17,0,20,3
1713313682229,CAT 125RS,A01,515971,Geibel; William,17,0,20,3
1713313683253,CLRE 250,A00,511389,Morris; Sheldon,9996,0,9999,3
1713313684283,CLRE 251,A00,507176,Mehta; Ravindra L.,9996,0,9999,3
1713313684283,CLRE 251,B00,511410,Mehta; Ravindra L.,9998,0,9999,1
1713313685310,CLRE 252,A00,507189,Cuomo; Raphael Eduardo,9998,0,9999,1
1713313686336,CLRE 253,A00,507199,Vaida; Florin,9997,0,9999,2
1713313686336,CLRE 253,B00,507202,Vaida; Florin,9999,0,9999,0
1713313687365,CLRE 259,A00,507211,Patel; Hemal,9996,0,9999,3
1713313688391,CLRE 260,A00,507221,Cuomo; Raphael Eduardo,9999,0,9999,0
1713313689418,CLRE 297,001,507242,Cuomo; Raphael Eduardo,9999,0,9999,0
1713313690500,CSE 191,A00,516875,Minnes Kemp; Mor Mia,9999,0,9999,0
1713313691525,CSS 201S,A01,494383,Staff,35,0,35,0
1713313692554,CSS 202S,A01,494387,Staff,35,0,35,0
1713313693578,EAP 100,A00,516065,Staff,9792,0,9999,207
1713313694602,ECE 45,A01,507414,Staff,54,0,60,6
1713313695627,ECE 100,A01,507416,Baghdadchi; Saharnaz,11,0,20,9
1713313695627,ECE 100,A02,507418,Baghdadchi; Saharnaz,20,0,20,0
1713313696654,ECE 111,A01,507420,Staff,40,0,50,10
1713313697679,ECE 197,001,548057,Sievenpiper; Daniel F.,9998,0,9999,1
1713313698707,EDS 115,A00,507243,Choi; Bailey Miyeon,28,0,28,0
1713313699735,EDS 117,A01,494379,Staff,24,0,25,1
1713313700760,EDS 125,A00,507246,Hopkins; Megan Beth,29,0,30,1
1713313701784,EDS 128A,A01,507264,Fargason; Sharon Gayle,26,0,26,0
1713313702809,EDS 128B,A01,507293,Pappas; Elizabeth,30,0,30,0
1713313703837,EDS 139,A00,507294,Fargason; Sharon Gayle,30,0,30,0
1713313703837,EDS 139,B00,507313,Pappas; Elizabeth,30,0,30,0
1713313704862,EDS 201,A00,507315,Staff,26,0,30,4
1713313705889,EDS 203,A01,507317,Halter; Christopher P.,26,0,30,4
1713313706920,EDS 204R,A01,507319,Halter; Christopher P.,5,0,30,25
1713313706920,EDS 204R,B01,507331,Heinzman; Erica M.,28,0,30,2
1713313707949,EDS 206R,A00,507332,Staff,7,0,30,23
1713313707949,EDS 206R,B00,507343,Staff,27,0,30,3
1713313708977,EDS 250,A00,507344,Hemans; Patricia Ann Benitez,36,0,40,4
1713313710002,EDS 281,A00,507345,Daly; Alan J.,18,0,18,0
1713313711029,EDS 284,A00,507350,Daly; Alan J.,16,0,16,0
1713313712054,EDS 286,A00,507359,Fine; Sarah,18,0,18,0
1713313713082,EDS 289C,A01,507361,Daly; Alan J.,18,0,18,0
1713313714112,EDS 290,A00,507366,Hofstetter; Carolyn,15,0,15,0
1713313715143,LIGM 5A,A00,507421,Fischer-Grunski; Eva K,20,0,20,0
1713313716171,LIGM 5B,A00,507423,Fischer-Grunski; Eva K,20,0,20,0
1713313717200,LIGM 5C,A00,507425,Fischer-Grunski; Eva K,20,0,20,0
1713313718227,LIIT 5AS,A00,507427,Carnelos; Chiara,20,0,20,0
1713313719254,LIIT 5BS,A00,507430,Carnelos; Chiara,20,0,20,0
1713313720281,LIIT 5CS,A00,507432,Carnelos; Chiara,20,0,20,0
1713313721311,LISP 5A,A00,507541,Munoz Sanchez; Alicia,19,0,20,1
1713313722339,LISP 5B,A00,507671,Munoz Sanchez; Alicia,17,0,20,3
1713313723365,LISP 5C,A00,507696,Munoz Sanchez; Alicia,17,0,20,3
1713313724396,MAE 197,001,528363,Boechler; Nicholas Sebastia,9998,0,9999,1
1713313725423,MATH 197,001,523477,Kedlaya; Kiran S.,9999,0,9999,0
1713313725423,MATH 197,002,563811,Zhang; Danna,9999,0,9999,0
1713313726451,MCWP 40R,A00,518780,Staff,20,0,20,0
1713313726451,MCWP 40R,B00,518781,Staff,19,0,20,1
1713313726451,MCWP 40R,C00,518783,Staff,19,0,20,1
1713313727480,MCWP 50R,A00,518791,Staff,20,0,20,0
1713313727480,MCWP 50R,B00,518792,Staff,18,0,20,2
1713313727480,MCWP 50R,C00,518793,Staff,19,0,20,1
1713313727480,MCWP 50R,D00,518794,Staff,18,0,20,2
1713313727480,MCWP 50R,E00,518795,Staff,18,0,20,2
1713313727480,MCWP 50R,F00,518796,Staff,19,0,20,1
1713313727480,MCWP 50R,G00,518797,Staff,19,0,20,1
1713313728505,MMW 12R,A01,514034,Herbst; Matthew,16,0,16,0
1713313728505,MMW 12R,A02,514035,Herbst; Matthew,16,0,16,0
1713313729530,MMW 13R,A01,514037,Staff,12,0,16,4
1713313729530,MMW 13R,A02,514039,Staff,16,0,16,0
1713313731585,SIO 295LS,A00,523233,Staff,19,0,30,11
1713313732609,SIO 295S,A00,523232,Staff,19,0,30,11
1713313733640,SOCI 117,A01,494376,Staff,3,0,5,2
1713313734665,WES 237B,A00,494380,Staff,19,0,20,1
1713313736741,AESE 279B,A00,494370,Wade; Jon P,33,0,33,0
1713313737768,ANAR 135S,A00,494369,Braswell; Geoffrey E.,0,0,0,0
1713313738798,CAT 124RS,A01,519847,Geibel; William,17,0,20,3
1713313739820,CAT 125RS,A01,515971,Geibel; William,17,0,20,3
1713313740845,CLRE 250,A00,511389,Morris; Sheldon,9996,0,9999,3
1713313741873,CLRE 251,A00,507176,Mehta; Ravindra L.,9996,0,9999,3
1713313741873,CLRE 251,B00,511410,Mehta; Ravindra L.,9998,0,9999,1
1713313742897,CLRE 252,A00,507189,Cuomo; Raphael Eduardo,9998,0,9999,1
1713313743925,CLRE 253,A00,507199,Vaida; Florin,9997,0,9999,2
1713313743925,CLRE 253,B00,507202,Vaida; Florin,9999,0,9999,0
1713313744953,CLRE 259,A00,507211,Patel; Hemal,9996,0,9999,3
1713313745978,CLRE 260,A00,507221,Cuomo; Raphael Eduardo,9999,0,9999,0
1713313747003,CLRE 297,001,507242,Cuomo; Raphael Eduardo,9999,0,9999,0
1713313748032,CSE 191,A00,516875,Minnes Kemp; Mor Mia,9999,0,9999,0
1713313749057,CSS 201S,A01,494383,Staff,35,0,35,0
1713313750082,CSS 202S,A01,494387,Staff,35,0,35,0
1713313751109,EAP 100,A00,516065,Staff,9792,0,9999,207
1713313752135,ECE 45,A01,507414,Staff,54,0,60,6
1713313753165,ECE 100,A01,507416,Baghdadchi; Saharnaz,11,0,20,9
1713313753165,ECE 100,A02,507418,Baghdadchi; Saharnaz,20,0,20,0
1713313754190,ECE 111,A01,507420,Staff,40,0,50,10
1713313755213,ECE 197,001,548057,Sievenpiper; Daniel F.,9998,0,9999,1
1713313756243,EDS 115,A00,507243,Choi; Bailey Miyeon,28,0,28,0
1713313757271,EDS 117,A01,494379,Staff,24,0,25,1
1713313758296,EDS 125,A00,507246,Hopkins; Megan Beth,29,0,30,1
1713313759320,EDS 128A,A01,507264,Fargason; Sharon Gayle,26,0,26,0
1713313760349,EDS 128B,A01,507293,Pappas; Elizabeth,30,0,30,0
1713313761379,EDS 139,A00,507294,Fargason; Sharon Gayle,30,0,30,0
1713313761379,EDS 139,B00,507313,Pappas; Elizabeth,30,0,30,0
1713313762406,EDS 201,A00,507315,Staff,26,0,30,4
1713313763438,EDS 203,A01,507317,Halter; Christopher P.,26,0,30,4
1713313764462,EDS 204R,A01,507319,Halter; Christopher P.,5,0,30,25
1713313764462,EDS 204R,B01,507331,Heinzman; Erica M.,28,0,30,2
1713313765487,EDS 206R,A00,507332,Staff,7,0,30,23
1713313765487,EDS 206R,B00,507343,Staff,27,0,30,3
1713313766519,EDS 250,A00,507344,Hemans; Patricia Ann Benitez,36,0,40,4
1713313767544,EDS 281,A00,507345,Daly; Alan J.,18,0,18,0
1713313768568,EDS 284,A00,507350,Daly; Alan J.,16,0,16,0
1713313769597,EDS 286,A00,507359,Fine; Sarah,18,0,18,0
1713313770625,EDS 289C,A01,507361,Daly; Alan J.,18,0,18,0
1713313771651,EDS 290,A00,507366,Hofstetter; Carolyn,15,0,15,0
1713313772680,LIGM 5A,A00,507421,Fischer-Grunski; Eva K,20,0,20,0
1713313773705,LIGM 5B,A00,507423,Fischer-Grunski; Eva K,20,0,20,0
1713313774733,LIGM 5C,A00,507425,Fischer-Grunski; Eva K,20,0,20,0
1713313775763,LIIT 5AS,A00,507427,Carnelos; Chiara,20,0,20,0
1713313776787,LIIT 5BS,A00,507430,Carnelos; Chiara,20,0,20,0
1713313777812,LIIT 5CS,A00,507432,Carnelos; Chiara,20,0,20,0
1713313778838,LISP 5A,A00,507541,Munoz Sanchez; Alicia,19,0,20,1
1713313779864,LISP 5B,A00,507671,Munoz Sanchez; Alicia,17,0,20,3
1713313780889,LISP 5C,A00,507696,Munoz Sanchez; Alicia,17,0,20,3
1713313781915,MAE 197,001,528363,Boechler; Nicholas Sebastia,9998,0,9999,1
1713313782941,MATH 197,001,523477,Kedlaya; Kiran S.,9999,0,9999,0
1713313782941,MATH 197,002,563811,Zhang; Danna,9999,0,9999,0
1713313783968,MCWP 40R,A00,518780,Staff,20,0,20,0
1713313783968,MCWP 40R,B00,518781,Staff,19,0,20,1
1713313783968,MCWP 40R,C00,518783,Staff,19,0,20,1
1713313784997,MCWP 50R,A00,518791,Staff,20,0,20,0
1713313784997,MCWP 50R,B00,518792,Staff,18,0,20,2
1713313784997,MCWP 50R,C00,518793,Staff,19,0,20,1
1713313784997,MCWP 50R,D00,518794,Staff,18,0,20,2
1713313784997,MCWP 50R,E00,518795,Staff,18,0,20,2
1713313784997,MCWP 50R,F00,518796,Staff,19,0,20,1
1713313784997,MCWP 50R,G00,518797,Staff,19,0,20,1
1713313786026,MMW 12R,A01,514034,Herbst; Matthew,16,0,16,0
1713313786026,MMW 12R,A02,514035,Herbst; Matthew,16,0,16,0
1713313787051,MMW 13R,A01,514037,Staff,12,0,16,4
1713313787051,MMW 13R,A02,514039,Staff,16,0,16,0
1713313789104,SIO 295LS,A00,523233,Staff,19,0,30,11
1713313790129,SIO 295S,A00,523232,Staff,19,0,30,11
1713313791158,SOCI 117,A01,494376,Staff,3,0,5,2
1713313792186,WES 237B,A00,494380,Staff,19,0,20,1
1713313794305,AESE 279B,A00,494370,Wade; Jon P,33,0,33,0
1713313795328,ANAR 135S,A00,494369,Braswell; Geoffrey E.,0,0,0,0
1713313796357,CAT 124RS,A01,519847,Geibel; William,17,0,20,3
1713313797384,CAT 125RS,A01,515971,Geibel; William,17,0,20,3
1713313798412,CLRE 250,A00,511389,Morris; Sheldon,9996,0,9999,3
1713313799439,CLRE 251,A00,507176,Mehta; Ravindra L.,9996,0,9999,3
1713313799439,CLRE 251,B00,511410,Mehta; Ravindra L.,9998,0,9999,1
1713313800463,CLRE 252,A00,507189,Cuomo; Raphael Eduardo,9998,0,9999,1
1713313801488,CLRE 253,A00,507199,Vaida; Florin,9997,0,9999,2
1713313801488,CLRE 253,B00,507202,Vaida; Florin,9999,0,9999,0
1713313802513,CLRE 259,A00,507211,Patel; Hemal,9996,0,9999,3
1713313803538,CLRE 260,A00,507221,Cuomo; Raphael Eduardo,9999,0,9999,0
1713313804564,CLRE 297,001,507242,Cuomo; Raphael Eduardo,9999,0,9999,0
1713313805593,CSE 191,A00,516875,Minnes Kemp; Mor Mia,9999,0,9999,0
1713313806618,CSS 201S,A01,494383,Staff,35,0,35,0
1713313807644,CSS 202S,A01,494387,Staff,35,0,35,0
1713313808672,EAP 100,A00,516065,Staff,9792,0,9999,207
1713313809698,ECE 45,A01,507414,Staff,54,0,60,6
1713313810728,ECE 100,A01,507416,Baghdadchi; Saharnaz,11,0,20,9
1713313810728,ECE 100,A02,507418,Baghdadchi; Saharnaz,20,0,20,0
1713313811753,ECE 111,A01,507420,Staff,40,0,50,10
1713313812781,ECE 197,001,548057,Sievenpiper; Daniel F.,9998,0,9999,1
1713313813812,EDS 115,A00,507243,Choi; Bailey Miyeon,28,0,28,0
1713313814838,EDS 117,A01,494379,Staff,24,0,25,1
1713313815867,EDS 125,A00,507246,Hopkins; Megan Beth,29,0,30,1
1713313816893,EDS 128A,A01,507264,Fargason; Sharon Gayle,26,0,26,0
1713313817923,EDS 128B,A01,507293,Pappas; Elizabeth,30,0,30,0
1713313818957,EDS 139,A00,507294,Fargason; Sharon Gayle,30,0,30,0
1713313818957,EDS 139,B00,507313,Pappas; Elizabeth,30,0,30,0
1713313819985,EDS 201,A00,507315,Staff,26,0,30,4
1713313821010,EDS 203,A01,507317,Halter; Christopher P.,26,0,30,4
1713313822033,EDS 204R,A01,507319,Halter; Christopher P.,4,0,30,26
1713313822033,EDS 204R,B01,507331,Heinzman; Erica M.,28,0,30,2
1713313823061,EDS 206R,A00,507332,Staff,7,0,30,23
1713313823061,EDS 206R,B00,507343,Staff,27,0,30,3
1713313824084,EDS 250,A00,507344,Hemans; Patricia Ann Benitez,36,0,40,4
1713313825113,EDS 281,A00,507345,Daly; Alan J.,18,0,18,0
1713313826136,EDS 284,A00,507350,Daly; Alan J.,16,0,16,0
1713313827160,EDS 286,A00,507359,Fine; Sarah,18,0,18,0
1713313828184,EDS 289C,A01,507361,Daly; Alan J.,18,0,18,0
1713313829214,EDS 290,A00,507366,Hofstetter; Carolyn,15,0,15,0
1713313830242,LIGM 5A,A00,507421,Fischer-Grunski; Eva K,20,0,20,0
1713313831272,LIGM 5B,A00,507423,Fischer-Grunski; Eva K,20,0,20,0
1713313832303,LIGM 5C,A00,507425,Fischer-Grunski; Eva K,20,0,20,0
1713313833328,LIIT 5AS,A00,507427,Carnelos; Chiara,20,0,20,0
1713313834354,LIIT 5BS,A00,507430,Carnelos; Chiara,20,0,20,0
1713313835380,LIIT 5CS,A00,507432,Carnelos; Chiara,20,0,20,0
1713313836409,LISP 5A,A00,507541,Munoz Sanchez; Alicia,19,0,20,1
1713313837435,LISP 5B,A00,507671,Munoz Sanchez; Alicia,17,0,20,3
1713313838459,LISP 5C,A00,507696,Munoz Sanchez; Alicia,17,0,20,3
1713313839487,MAE 197,001,528363,Boechler; Nicholas Sebastia,9998,0,9999,1
1713313840517,MATH 197,001,523477,Kedlaya; Kiran S.,9999,0,9999,0
1713313840517,MATH 197,002,563811,Zhang; Danna,9999,0,9999,0
1713313841547,MCWP 40R,A00,518780,Staff,20,0,20,0
1713313841547,MCWP 40R,B00,518781,Staff,19,0,20,1
1713313841547,MCWP 40R,C00,518783,Staff,19,0,20,1
1713313842572,MCWP 50R,A00,518791,Staff,20,0,20,0
1713313842572,MCWP 50R,B00,518792,Staff,18,0,20,2
1713313842572,MCWP 50R,C00,518793,Staff,19,0,20,1
1713313842572,MCWP 50R,D00,518794,Staff,18,0,20,2
1713313842572,MCWP 50R,E00,518795,Staff,18,0,20,2
1713313842572,MCWP 50R,F00,518796,Staff,19,0,20,1
1713313842572,MCWP 50R,G00,518797,Staff,19,0,20,1
1713313843596,MMW 12R,A01,514034,Herbst; Matthew,16,0,16,0
1713313843596,MMW 12R,A02,514035,Herbst; Matthew,16,0,16,0
1713313844620,MMW 13R,A01,514037,Staff,12,0,16,4
1713313844620,MMW 13R,A02,514039,Staff,16,0,16,0
1713313846671,SIO 295LS,A00,523233,Staff,19,0,30,11
1713313847696,SIO 295S,A00,523232,Staff,19,0,30,11
1713313848721,SOCI 117,A01,494376,Staff,3,0,5,2
1713313849747,WES 237B,A00,494380,Staff,19,0,20,1
1713313851815,AESE 279B,A00,494370,Wade; Jon P,33,0,33,0
1713313852840,ANAR 135S,A00,494369,Braswell; Geoffrey E.,0,0,0,0
1713313853877,CAT 124RS,A01,519847,Geibel; William,17,0,20,3
1713313854903,CAT 125RS,A01,515971,Geibel; William,17,0,20,3
1713313855928,CLRE 250,A00,511389,Morris; Sheldon,9996,0,9999,3
1713313856957,CLRE 251,A00,507176,Mehta; Ravindra L.,9996,0,9999,3
1713313856957,CLRE 251,B00,511410,Mehta; Ravindra L.,9998,0,9999,1
1713313857982,CLRE 252,A00,507189,Cuomo; Raphael Eduardo,9998,0,9999,1
1713313859011,CLRE 253,A00,507199,Vaida; Florin,9997,0,9999,2
1713313859011,CLRE 253,B00,507202,Vaida; Florin,9999,0,9999,0
1713313860040,CLRE 259,A00,507211,Patel; Hemal,9996,0,9999,3
1713313861068,CLRE 260,A00,507221,Cuomo; Raphael Eduardo,9999,0,9999,0
1713313862093,CLRE 297,001,507242,Cuomo; Raphael Eduardo,9999,0,9999,0
1713313863120,CSE 191,A00,516875,Minnes Kemp; Mor Mia,9999,0,9999,0
1713313864205,CSS 201S,A01,494383,Staff,35,0,35,0
1713313865230,CSS 202S,A01,494387,Staff,35,0,35,0
1713313866253,EAP 100,A00,516065,Staff,9792,0,9999,207
1713313867279,ECE 45,A01,507414,Staff,54,0,60,6
1713313868308,ECE 100,A01,507416,Baghdadchi; Saharnaz,11,0,20,9
1713313868308,ECE 100,A02,507418,Baghdadchi; Saharnaz,20,0,20,0
1713313869336,ECE 111,A01,507420,Staff,40,0,50,10
1713313870362,ECE 197,001,548057,Sievenpiper; Daniel F.,9998,0,9999,1
1713313871388,EDS 115,A00,507243,Choi; Bailey Miyeon,28,0,28,0
1713313872419,EDS 117,A01,494379,Staff,24,0,25,1
1713313873446,EDS 125,A00,507246,Hopkins; Megan Beth,29,0,30,1
1713313874474,EDS 128A,A01,507264,Fargason; Sharon Gayle,26,0,26,0
1713313875498,EDS 128B,A01,507293,Pappas; Elizabeth,30,0,30,0
1713313876527,EDS 139,A00,507294,Fargason; Sharon Gayle,30,0,30,0
1713313876527,EDS 139,B00,507313,Pappas; Elizabeth,30,0,30,0
1713313877611,EDS 201,A00,507315,Staff,26,0,30,4
1713313878637,EDS 203,A01,507317,Halter; Christopher P.,26,0,30,4
1713313879663,EDS 204R,A01,507319,Halter; Christopher P.,4,0,30,26
1713313879663,EDS 204R,B01,507331,Heinzman; Erica M.,28,0,30,2
1713313880693,EDS 206R,A00,507332,Staff,6,0,30,24
1713313880693,EDS 206R,B00,507343,Staff,27,0,30,3
1713313881718,EDS 250,A00,507344,Hemans; Patricia Ann Benitez,36,0,40,4
1713313882741,EDS 281,A00,507345,Daly; Alan J.,18,0,18,0
1713313883768,EDS 284,A00,507350,Daly; Alan J.,16,0,16,0
1713313884793,EDS 286,A00,507359,Fine; Sarah,18,0,18,0
1713313885820,EDS 289C,A01,507361,Daly; Alan J.,18,0,18,0
1713313886846,EDS 290,A00,507366,Hofstetter; Carolyn,15,0,15,0
1713313887876,LIGM 5A,A00,507421,Fischer-Grunski; Eva K,20,0,20,0
1713313888900,LIGM 5B,A00,507423,Fischer-Grunski; Eva K,20,0,20,0
1713313889926,LIGM 5C,A00,507425,Fischer-Grunski; Eva K,20,0,20,0
1713313890951,LIIT 5AS,A00,507427,Carnelos; Chiara,20,0,20,0
1713313891976,LIIT 5BS,A00,507430,Carnelos; Chiara,20,0,20,0
1713313893002,LIIT 5CS,A00,507432,Carnelos; Chiara,20,0,20,0
1713313894031,LISP 5A,A00,507541,Munoz Sanchez; Alicia,19,0,20,1
1713313895058,LISP 5B,A00,507671,Munoz Sanchez; Alicia,17,0,20,3
1713313896083,LISP 5C,A00,507696,Munoz Sanchez; Alicia,17,0,20,3
1713313897110,MAE 197,001,528363,Boechler; Nicholas Sebastia,9998,0,9999,1
1713313898191,MATH 197,001,523477,Kedlaya; Kiran S.,9999,0,9999,0
1713313898191,MATH 197,002,563811,Zhang; Danna,9999,0,9999,0
1713313899215,MCWP 40R,A00,518780,Staff,20,0,20,0
1713313899215,MCWP 40R,B00,518781,Staff,19,0,20,1
1713313899215,MCWP 40R,C00,518783,Staff,19,0,20,1
1713313900242,MCWP 50R,A00,518791,Staff,20,0,20,0
1713313900242,MCWP 50R,B00,518792,Staff,18,0,20,2
1713313900242,MCWP 50R,C00,518793,Staff,19,0,20,1
1713313900242,MCWP 50R,D00,518794,Staff,18,0,20,2
1713313900242,MCWP 50R,E00,518795,Staff,18,0,20,2
1713313900242,MCWP 50R,F00,518796,Staff,19,0,20,1
1713313900242,MCWP 50R,G00,518797,Staff,19,0,20,1
1713313901270,MMW 12R,A01,514034,Herbst; Matthew,16,0,16,0
1713313901270,MMW 12R,A02,514035,Herbst; Matthew,16,0,16,0
1713313902299,MMW 13R,A01,514037,Staff,12,0,16,4
1713313902299,MMW 13R,A02,514039,Staff,16,0,16,0
1713313904346,SIO 295LS,A00,523233,Staff,19,0,30,11
1713313905375,SIO 295S,A00,523232,Staff,19,0,30,11
1713313906401,SOCI 117,A01,494376,Staff,3,0,5,2
1713313907425,WES 237B,A00,494380,Staff,19,0,20,1
1713313909487,AESE 279B,A00,494370,Wade; Jon P,33,0,33,0
1713313910514,ANAR 135S,A00,494369,Braswell; Geoffrey E.,0,0,0,0
1713313911539,CAT 124RS,A01,519847,Geibel; William,17,0,20,3
1713313912567,CAT 125RS,A01,515971,Geibel; William,17,0,20,3
1713313913593,CLRE 250,A00,511389,Morris; Sheldon,9996,0,9999,3
1713313914618,CLRE 251,A00,507176,Mehta; Ravindra L.,9996,0,9999,3
1713313914618,CLRE 251,B00,511410,Mehta; Ravindra L.,9998,0,9999,1
1713313915646,CLRE 252,A00,507189,Cuomo; Raphael Eduardo,9998,0,9999,1
1713313916675,CLRE 253,A00,507199,Vaida; Florin,9997,0,9999,2
1713313916675,CLRE 253,B00,507202,Vaida; Florin,9999,0,9999,0
1713313917699,CLRE 259,A00,507211,Patel; Hemal,9996,0,9999,3
1713313918724,CLRE 260,A00,507221,Cuomo; Raphael Eduardo,9999,0,9999,0
1713313919751,CLRE 297,001,507242,Cuomo; Raphael Eduardo,9999,0,9999,0
1713313920776,CSE 191,A00,516875,Minnes Kemp; Mor Mia,9999,0,9999,0
1713313921802,CSS 201S,A01,494383,Staff,35,0,35,0
1713313922827,CSS 202S,A01,494387,Staff,35,0,35,0
1713313923863,EAP 100,A00,516065,Staff,9792,0,9999,207
1713313924889,ECE 45,A01,507414,Staff,54,0,60,6
1713313925915,ECE 100,A01,507416,Baghdadchi; Saharnaz,11,0,20,9
1713313925915,ECE 100,A02,507418,Baghdadchi; Saharnaz,20,0,20,0
1713313926943,ECE 111,A01,507420,Staff,40,0,50,10
1713313927969,ECE 197,001,548057,Sievenpiper; Daniel F.,9998,0,9999,1
1713313928996,EDS 115,A00,507243,Choi; Bailey Miyeon,28,0,28,0
1713313930022,EDS 117,A01,494379,Staff,24,0,25,1
1713313931055,EDS 125,A00,507246,Hopkins; Megan Beth,29,0,30,1
1713313932087,EDS 128A,A01,507264,Fargason; Sharon Gayle,26,0,26,0
1713313933117,EDS 128B,A01,507293,Pappas; Elizabeth,30,0,30,0
1713313934146,EDS 139,A00,507294,Fargason; Sharon Gayle,30,0,30,0
1713313934146,EDS 139,B00,507313,Pappas; Elizabeth,30,0,30,0
1713313935172,EDS 201,A00,507315,Staff,26,0,30,4
1713313936199,EDS 203,A01,507317,Halter; Christopher P.,26,0,30,4
1713313937225,EDS 204R,A01,507319,Halter; Christopher P.,4,0,30,26
1713313937225,EDS 204R,B01,507331,Heinzman; Erica M.,28,0,30,2
1713313938250,EDS 206R,A00,507332,Staff,6,0,30,24
1713313938250,EDS 206R,B00,507343,Staff,27,0,30,3
1713313939279,EDS 250,A00,507344,Hemans; Patricia Ann Benitez,36,0,40,4
1713313940305,EDS 281,A00,507345,Daly; Alan J.,18,0,18,0
1713313941334,EDS 284,A00,507350,Daly; Alan J.,16,0,16,0
1713313942359,EDS 286,A00,507359,Fine; Sarah,18,0,18,0
1713313943389,EDS 289C,A01,507361,Daly; Alan J.,18,0,18,0
1713313944413,EDS 290,A00,507366,Hofstetter; Carolyn,15,0,15,0
1713313945445,LIGM 5A,A00,507421,Fischer-Grunski; Eva K,20,0,20,0
1713313946469,LIGM 5B,A00,507423,Fischer-Grunski; Eva K,20,0,20,0
1713313947494,LIGM 5C,A00,507425,Fischer-Grunski; Eva K,20,0,20,0
1713313948520,LIIT 5AS,A00,507427,Carnelos; Chiara,20,0,20,0
1713313949549,LIIT 5BS,A00,507430,Carnelos; Chiara,20,0,20,0
1713313950577,LIIT 5CS,A00,507432,Carnelos; Chiara,20,0,20,0
1713313951603,LISP 5A,A00,507541,Munoz Sanchez; Alicia,19,0,20,1
1713313952627,LISP 5B,A00,507671,Munoz Sanchez; Alicia,17,0,20,3
1713313953652,LISP 5C,A00,507696,Munoz Sanchez; Alicia,17,0,20,3
1713313954681,MAE 197,001,528363,Boechler; Nicholas Sebastia,9998,0,9999,1
1713313955707,MATH 197,001,523477,Kedlaya; Kiran S.,9999,0,9999,0
1713313955707,MATH 197,002,563811,Zhang; Danna,9999,0,9999,0
1713313956736,MCWP 40R,A00,518780,Staff,20,0,20,0
1713313956736,MCWP 40R,B00,518781,Staff,19,0,20,1
1713313956736,MCWP 40R,C00,518783,Staff,19,0,20,1
1713313957762,MCWP 50R,A00,518791,Staff,20,0,20,0
1713313957762,MCWP 50R,B00,518792,Staff,18,0,20,2
1713313957762,MCWP 50R,C00,518793,Staff,19,0,20,1
1713313957762,MCWP 50R,D00,518794,Staff,18,0,20,2
1713313957762,MCWP 50R,E00,518795,Staff,18,0,20,2
1713313957762,MCWP 50R,F00,518796,Staff,19,0,20,1
1713313957762,MCWP 50R,G00,518797,Staff,19,0,20,1
1713313958786,MMW 12R,A01,514034,Herbst; Matthew,16,0,16,0
1713313958786,MMW 12R,A02,514035,Herbst; Matthew,16,0,16,0
1713313959813,MMW 13R,A01,514037,Staff,12,0,16,4
1713313959813,MMW 13R,A02,514039,Staff,16,0,16,0
1713313961864,SIO 295LS,A00,523233,Staff,19,0,30,11
1713313962893,SIO 295S,A00,523232,Staff,19,0,30,11
1713313963920,SOCI 117,A01,494376,Staff,3,0,5,2
1713313964945,WES 237B,A00,494380,Staff,19,0,20,1
1713313967019,AESE 279B,A00,494370,Wade; Jon P,33,0,33,0
1713313968048,ANAR 135S,A00,494369,Braswell; Geoffrey E.,0,0,0,0
1713313969074,CAT 124RS,A01,519847,Geibel; William,17,0,20,3
1713313970099,CAT 125RS,A01,515971,Geibel; William,17,0,20,3
1713313971126,CLRE 250,A00,511389,Morris; Sheldon,9996,0,9999,3
1713313972153,CLRE 251,A00,507176,Mehta; Ravindra L.,9996,0,9999,3
1713313972153,CLRE 251,B00,511410,Mehta; Ravindra L.,9998,0,9999,1
1713313973183,CLRE 252,A00,507189,Cuomo; Raphael Eduardo,9998,0,9999,1
1713313974208,CLRE 253,A00,507199,Vaida; Florin,9997,0,9999,2
1713313974208,CLRE 253,B00,507202,Vaida; Florin,9999,0,9999,0
1713313975238,CLRE 259,A00,507211,Patel; Hemal,9996,0,9999,3
1713313976266,CLRE 260,A00,507221,Cuomo; Raphael Eduardo,9999,0,9999,0
1713313977296,CLRE 297,001,507242,Cuomo; Raphael Eduardo,9999,0,9999,0
1713313978321,CSE 191,A00,516875,Minnes Kemp; Mor Mia,9999,0,9999,0
1713313979347,CSS 201S,A01,494383,Staff,35,0,35,0
1713313980377,CSS 202S,A01,494387,Staff,35,0,35,0
1713313981401,EAP 100,A00,516065,Staff,9792,0,9999,207
1713313982430,ECE 45,A01,507414,Staff,54,0,60,6
1713313983459,ECE 100,A01,507416,Baghdadchi; Saharnaz,11,0,20,9
1713313983459,ECE 100,A02,507418,Baghdadchi; Saharnaz,20,0,20,0
1713313984484,ECE 111,A01,507420,Staff,40,0,50,10
1713313985513,ECE 197,001,548057,Sievenpiper; Daniel F.,9998,0,9999,1
1713313986538,EDS 115,A00,507243,Choi; Bailey Miyeon,28,0,28,0
1713313987567,EDS 117,A01,494379,Staff,24,0,25,1
1713313988592,EDS 125,A00,507246,Hopkins; Megan Beth,29,0,30,1
1713313989621,EDS 128A,A01,507264,Fargason; Sharon Gayle,26,0,26,0
1713313990646,EDS 128B,A01,507293,Pappas; Elizabeth,30,0,30,0
1713313991674,EDS 139,A00,507294,Fargason; Sharon Gayle,30,0,30,0
1713313991674,EDS 139,B00,507313,Pappas; Elizabeth,30,0,30,0
1713313992702,EDS 201,A00,507315,Staff,26,0,30,4
1713313993730,EDS 203,A01,507317,Halter; Christopher P.,26,0,30,4
1713313994760,EDS 204R,A01,507319,Halter; Christopher P.,4,0,30,26
1713313994760,EDS 204R,B01,507331,Heinzman; Erica M.,28,0,30,2
1713313995788,EDS 206R,A00,507332,Staff,6,0,30,24
1713313995788,EDS 206R,B00,507343,Staff,27,0,30,3
1713313996814,EDS 250,A00,507344,Hemans; Patricia Ann Benitez,36,0,40,4
1713313997839,EDS 281,A00,507345,Daly; Alan J.,18,0,18,0
1713313998868,EDS 284,A00,507350,Daly; Alan J.,16,0,16,0
1713313999897,EDS 286,A00,507359,Fine; Sarah,18,0,18,0
1713314000923,EDS 289C,A01,507361,Daly; Alan J.,18,0,18,0
1713314002004,EDS 290,A00,507366,Hofstetter; Carolyn,15,0,15,0
1713314003034,LIGM 5A,A00,507421,Fischer-Grunski; Eva K,20,0,20,0
1713314004061,LIGM 5B,A00,507423,Fischer-Grunski; Eva K,20,0,20,0
1713314005085,LIGM 5C,A00,507425,Fischer-Grunski; Eva K,20,0,20,0
1713314006115,LIIT 5AS,A00,507427,Carnelos; Chiara,20,0,20,0
1713314007177,LIIT 5BS,A00,507430,Carnelos; Chiara,20,0,20,0
1713314008203,LIIT 5CS,A00,507432,Carnelos; Chiara,20,0,20,0
1713314009230,LISP 5A,A00,507541,Munoz Sanchez; Alicia,19,0,20,1
1713314010259,LISP 5B,A00,507671,Munoz Sanchez; Alicia,17,0,20,3
1713314011308,LISP 5C,A00,507696,Munoz Sanchez; Alicia,17,0,20,3
1713314012335,MAE 197,001,528363,Boechler; Nicholas Sebastia,9998,0,9999,1
1713314013361,MATH 197,001,523477,Kedlaya; Kiran S.,9999,0,9999,0
1713314013361,MATH 197,002,563811,Zhang; Danna,9999,0,9999,0
1713314014386,MCWP 40R,A00,518780,Staff,20,0,20,0
1713314014386,MCWP 40R,B00,518781,Staff,19,0,20,1
1713314014386,MCWP 40R,C00,518783,Staff,19,0,20,1
1713314015416,MCWP 50R,A00,518791,Staff,20,0,20,0
1713314015416,MCWP 50R,B00,518792,Staff,18,0,20,2
1713314015416,MCWP 50R,C00,518793,Staff,19,0,20,1
1713314015416,MCWP 50R,D00,518794,Staff,18,0,20,2
1713314015416,MCWP 50R,E00,518795,Staff,18,0,20,2
1713314015416,MCWP 50R,F00,518796,Staff,19,0,20,1
1713314015416,MCWP 50R,G00,518797,Staff,19,0,20,1
1713314016440,MMW 12R,A01,514034,Herbst; Matthew,16,0,16,0
1713314016440,MMW 12R,A02,514035,Herbst; Matthew,16,0,16,0
1713314017465,MMW 13R,A01,514037,Staff,12,0,16,4
1713314017465,MMW 13R,A02,514039,Staff,16,0,16,0
1713314019518,SIO 295LS,A00,523233,Staff,19,0,30,11
1713314020544,SIO 295S,A00,523232,Staff,19,0,30,11
1713314021569,SOCI 117,A01,494376,Staff,3,0,5,2
1713314022594,WES 237B,A00,494380,Staff,19,0,20,1
1713314024656,AESE 279B,A00,494370,Wade; Jon P,33,0,33,0
1713314025684,ANAR 135S,A00,494369,Braswell; Geoffrey E.,0,0,0,0
1713314026710,CAT 124RS,A01,519847,Geibel; William,17,0,20,3
1713314027733,CAT 125RS,A01,515971,Geibel; William,17,0,20,3
1713314028759,CLRE 250,A00,511389,Morris; Sheldon,9996,0,9999,3
1713314029786,CLRE 251,A00,507176,Mehta; Ravindra L.,9996,0,9999,3
1713314029786,CLRE 251,B00,511410,Mehta; Ravindra L.,9998,0,9999,1
1713314030812,CLRE 252,A00,507189,Cuomo; Raphael Eduardo,9998,0,9999,1
1713314031837,CLRE 253,A00,507199,Vaida; Florin,9997,0,9999,2
1713314031837,CLRE 253,B00,507202,Vaida; Florin,9999,0,9999,0
1713314032866,CLRE 259,A00,507211,Patel; Hemal,9996,0,9999,3
1713314033905,CLRE 260,A00,507221,Cuomo; Raphael Eduardo,9999,0,9999,0
1713314034929,CLRE 297,001,507242,Cuomo; Raphael Eduardo,9999,0,9999,0
1713314035958,CSE 191,A00,516875,Minnes Kemp; Mor Mia,9999,0,9999,0
1713314036987,CSS 201S,A01,494383,Staff,35,0,35,0
1713314038011,CSS 202S,A01,494387,Staff,35,0,35,0
1713314039036,EAP 100,A00,516065,Staff,9792,0,9999,207
1713314040065,ECE 45,A01,507414,Staff,54,0,60,6
1713314041093,ECE 100,A01,507416,Baghdadchi; Saharnaz,11,0,20,9
1713314041093,ECE 100,A02,507418,Baghdadchi; Saharnaz,20,0,20,0
1713314042120,ECE 111,A01,507420,Staff,40,0,50,10
1713314043147,ECE 197,001,548057,Sievenpiper; Daniel F.,9998,0,9999,1
1713314044173,EDS 115,A00,507243,Choi; Bailey Miyeon,28,0,28,0
1713314045198,EDS 117,A01,494379,Staff,24,0,25,1
1713314046225,EDS 125,A00,507246,Hopkins; Megan Beth,29,0,30,1
1713314047254,EDS 128A,A01,507264,Fargason; Sharon Gayle,26,0,26,0
1713314048279,EDS 128B,A01,507293,Pappas; Elizabeth,30,0,30,0
1713314049304,EDS 139,A00,507294,Fargason; Sharon Gayle,30,0,30,0
1713314049304,EDS 139,B00,507313,Pappas; Elizabeth,30,0,30,0
1713314050330,EDS 201,A00,507315,Staff,26,0,30,4
1713314051358,EDS 203,A01,507317,Halter; Christopher P.,26,0,30,4
1713314052385,EDS 204R,A01,507319,Halter; Christopher P.,4,0,30,26
1713314052385,EDS 204R,B01,507331,Heinzman; Erica M.,28,0,30,2
1713314053414,EDS 206R,A00,507332,Staff,5,0,30,25
1713314053414,EDS 206R,B00,507343,Staff,28,0,30,2
1713314054439,EDS 250,A00,507344,Hemans; Patricia Ann Benitez,36,0,40,4
1713314055468,EDS 281,A00,507345,Daly; Alan J.,18,0,18,0
1713314056497,EDS 284,A00,507350,Daly; Alan J.,16,0,16,0
1713314057526,EDS 286,A00,507359,Fine; Sarah,18,0,18,0
1713314058550,EDS 289C,A01,507361,Daly; Alan J.,18,0,18,0
1713314059575,EDS 290,A00,507366,Hofstetter; Carolyn,15,0,15,0
1713314060605,LIGM 5A,A00,507421,Fischer-Grunski; Eva K,20,0,20,0
1713314061635,LIGM 5B,A00,507423,Fischer-Grunski; Eva K,20,0,20,0
1713314062659,LIGM 5C,A00,507425,Fischer-Grunski; Eva K,20,0,20,0
1713314063688,LIIT 5AS,A00,507427,Carnelos; Chiara,20,0,20,0
1713314064712,LIIT 5BS,A00,507430,Carnelos; Chiara,20,0,20,0
1713314065741,LIIT 5CS,A00,507432,Carnelos; Chiara,20,0,20,0
1713314066773,LISP 5A,A00,507541,Munoz Sanchez; Alicia,19,0,20,1
1713314067803,LISP 5B,A00,507671,Munoz Sanchez; Alicia,17,0,20,3
1713314068829,LISP 5C,A00,507696,Munoz Sanchez; Alicia,17,0,20,3
1713314069856,MAE 197,001,528363,Boechler; Nicholas Sebastia,9998,0,9999,1
1713314070880,MATH 197,001,523477,Kedlaya; Kiran S.,9999,0,9999,0
1713314070880,MATH 197,002,563811,Zhang; Danna,9999,0,9999,0
1713314071911,MCWP 40R,A00,518780,Staff,20,0,20,0
1713314071911,MCWP 40R,B00,518781,Staff,19,0,20,1
1713314071911,MCWP 40R,C00,518783,Staff,19,0,20,1
1713314072938,MCWP 50R,A00,518791,Staff,20,0,20,0
1713314072938,MCWP 50R,B00,518792,Staff,18,0,20,2
1713314072938,MCWP 50R,C00,518793,Staff,19,0,20,1
1713314072938,MCWP 50R,D00,518794,Staff,18,0,20,2
1713314072938,MCWP 50R,E00,518795,Staff,18,0,20,2
1713314072938,MCWP 50R,F00,518796,Staff,19,0,20,1
1713314072938,MCWP 50R,G00,518797,Staff,19,0,20,1
1713314073965,MMW 12R,A01,514034,Herbst; Matthew,16,0,16,0
1713314073965,MMW 12R,A02,514035,Herbst; Matthew,16,0,16,0
1713314074993,MMW 13R,A01,514037,Staff,12,0,16,4
1713314074993,MMW 13R,A02,514039,Staff,16,0,16,0
1713314077045,SIO 295LS,A00,523233,Staff,19,0,30,11
1713314078073,SIO 295S,A00,523232,Staff,19,0,30,11
1713314079098,SOCI 117,A01,494376,Staff,3,0,5,2
1713314080123,WES 237B,A00,494380,Staff,19,0,20,1
1713314082192,AESE 279B,A00,494370,Wade; Jon P,33,0,33,0
1713314083216,ANAR 135S,A00,494369,Braswell; Geoffrey E.,0,0,0,0
1713314084246,CAT 124RS,A01,519847,Geibel; William,17,0,20,3
1713314085269,CAT 125RS,A01,515971,Geibel; William,17,0,20,3
1713314086294,CLRE 250,A00,511389,Morris; Sheldon,9996,0,9999,3
1713314087321,CLRE 251,A00,507176,Mehta; Ravindra L.,9996,0,9999,3
1713314087321,CLRE 251,B00,511410,Mehta; Ravindra L.,9998,0,9999,1
1713314088350,CLRE 252,A00,507189,Cuomo; Raphael Eduardo,9998,0,9999,1
1713314089380,CLRE 253,A00,507199,Vaida; Florin,9997,0,9999,2
1713314089380,CLRE 253,B00,507202,Vaida; Florin,9999,0,9999,0
1713314090410,CLRE 259,A00,507211,Patel; Hemal,9996,0,9999,3
1713314091436,CLRE 260,A00,507221,Cuomo; Raphael Eduardo,9999,0,9999,0
1713314092464,CLRE 297,001,507242,Cuomo; Raphael Eduardo,9999,0,9999,0
1713314093489,CSE 191,A00,516875,Minnes Kemp; Mor Mia,9999,0,9999,0
1713314094519,CSS 201S,A01,494383,Staff,35,0,35,0
1713314095544,CSS 202S,A01,494387,Staff,35,0,35,0
1713314096571,EAP 100,A00,516065,Staff,9792,0,9999,207
1713314097600,ECE 45,A01,507414,Staff,54,0,60,6
1713314098628,ECE 100,A01,507416,Baghdadchi; Saharnaz,11,0,20,9
1713314098628,ECE 100,A02,507418,Baghdadchi; Saharnaz,20,0,20,0
1713314099652,ECE 111,A01,507420,Staff,40,0,50,10
1713314100675,ECE 197,001,548057,Sievenpiper; Daniel F.,9998,0,9999,1
1713314101703,EDS 115,A00,507243,Choi; Bailey Miyeon,28,0,28,0
1713314102730,EDS 117,A01,494379,Staff,24,0,25,1
1713314103756,EDS 125,A00,507246,Hopkins; Megan Beth,29,0,30,1
1713314104781,EDS 128A,A01,507264,Fargason; Sharon Gayle,26,0,26,0
1713314105866,EDS 128B,A01,507293,Pappas; Elizabeth,30,0,30,0
1713314106893,EDS 139,A00,507294,Fargason; Sharon Gayle,30,0,30,0
1713314106893,EDS 139,B00,507313,Pappas; Elizabeth,30,0,30,0
1713314107918,EDS 201,A00,507315,Staff,26,0,30,4
1713314108945,EDS 203,A01,507317,Halter; Christopher P.,26,0,30,4
1713314109969,EDS 204R,A01,507319,Halter; Christopher P.,4,0,30,26
1713314109969,EDS 204R,B01,507331,Heinzman; Erica M.,28,0,30,2
1713314110995,EDS 206R,A00,507332,Staff,5,0,30,25
1713314110995,EDS 206R,B00,507343,Staff,28,0,30,2
1713314112020,EDS 250,A00,507344,Hemans; Patricia Ann Benitez,36,0,40,4
1713314113046,EDS 281,A00,507345,Daly; Alan J.,18,0,18,0
1713314114075,EDS 284,A00,507350,Daly; Alan J.,16,0,16,0
1713314115102,EDS 286,A00,507359,Fine; Sarah,18,0,18,0
1713314116131,EDS 289C,A01,507361,Daly; Alan J.,18,0,18,0
1713314117157,EDS 290,A00,507366,Hofstetter; Carolyn,15,0,15,0
1713314118183,LIGM 5A,A00,507421,Fischer-Grunski; Eva K,20,0,20,0
1713314119208,LIGM 5B,A00,507423,Fischer-Grunski; Eva K,20,0,20,0
1713314120232,LIGM 5C,A00,507425,Fischer-Grunski; Eva K,20,0,20,0
1713314121263,LIIT 5AS,A00,507427,Carnelos; Chiara,20,0,20,0
1713314122293,LIIT 5BS,A00,507430,Carnelos; Chiara,20,0,20,0
1713314123319,LIIT 5CS,A00,507432,Carnelos; Chiara,20,0,20,0
1713314124348,LISP 5A,A00,507541,Munoz Sanchez; Alicia,19,0,20,1
1713314125373,LISP 5B,A00,507671,Munoz Sanchez; Alicia,17,0,20,3
1713314126403,LISP 5C,A00,507696,Munoz Sanchez; Alicia,17,0,20,3
1713314127427,MAE 197,001,528363,Boechler; Nicholas Sebastia,9998,0,9999,1
1713314128456,MATH 197,001,523477,Kedlaya; Kiran S.,9999,0,9999,0
1713314128456,MATH 197,002,563811,Zhang; Danna,9999,0,9999,0
1713314129483,MCWP 40R,A00,518780,Staff,20,0,20,0
1713314129483,MCWP 40R,B00,518781,Staff,19,0,20,1
1713314129483,MCWP 40R,C00,518783,Staff,19,0,20,1
1713314130508,MCWP 50R,A00,518791,Staff,20,0,20,0
1713314130508,MCWP 50R,B00,518792,Staff,18,0,20,2
1713314130508,MCWP 50R,C00,518793,Staff,19,0,20,1
1713314130508,MCWP 50R,D00,518794,Staff,18,0,20,2
1713314130508,MCWP 50R,E00,518795,Staff,18,0,20,2
1713314130508,MCWP 50R,F00,518796,Staff,19,0,20,1
1713314130508,MCWP 50R,G00,518797,Staff,19,0,20,1
1713314131538,MMW 12R,A01,514034,Herbst; Matthew,16,0,16,0
1713314131538,MMW 12R,A02,514035,Herbst; Matthew,16,0,16,0
1713314132564,MMW 13R,A01,514037,Staff,12,0,16,4
1713314132564,MMW 13R,A02,514039,Staff,16,0,16,0
1713314134621,SIO 295LS,A00,523233,Staff,19,0,30,11
1713314135648,SIO 295S,A00,523232,Staff,19,0,30,11
1713314136674,SOCI 117,A01,494376,Staff,3,0,5,2
1713314137700,WES 237B,A00,494380,Staff,19,0,20,1
1713314139775,AESE 279B,A00,494370,Wade; Jon P,33,0,33,0
1713314140803,ANAR 135S,A00,494369,Braswell; Geoffrey E.,0,0,0,0
1713314141832,CAT 124RS,A01,519847,Geibel; William,17,0,20,3
1713314142858,CAT 125RS,A01,515971,Geibel; William,17,0,20,3
1713314143887,CLRE 250,A00,511389,Morris; Sheldon,9996,0,9999,3
1713314144915,CLRE 251,A00,507176,Mehta; Ravindra L.,9996,0,9999,3
1713314144915,CLRE 251,B00,511410,Mehta; Ravindra L.,9998,0,9999,1
1713314145943,CLRE 252,A00,507189,Cuomo; Raphael Eduardo,9998,0,9999,1
1713314146974,CLRE 253,A00,507199,Vaida; Florin,9997,0,9999,2
1713314146974,CLRE 253,B00,507202,Vaida; Florin,9999,0,9999,0
1713314147999,CLRE 259,A00,507211,Patel; Hemal,9996,0,9999,3
1713314149024,CLRE 260,A00,507221,Cuomo; Raphael Eduardo,9999,0,9999,0
1713314150051,CLRE 297,001,507242,Cuomo; Raphael Eduardo,9999,0,9999,0
1713314151075,CSE 191,A00,516875,Minnes Kemp; Mor Mia,9999,0,9999,0
1713314152101,CSS 201S,A01,494383,Staff,35,0,35,0
1713314153126,CSS 202S,A01,494387,Staff,35,0,35,0
1713314154152,EAP 100,A00,516065,Staff,9792,0,9999,207
1713314155176,ECE 45,A01,507414,Staff,54,0,60,6
1713314156201,ECE 100,A01,507416,Baghdadchi; Saharnaz,11,0,20,9
1713314156201,ECE 100,A02,507418,Baghdadchi; Saharnaz,20,0,20,0
1713314157230,ECE 111,A01,507420,Staff,40,0,50,10
1713314158254,ECE 197,001,548057,Sievenpiper; Daniel F.,9998,0,9999,1
1713314159283,EDS 115,A00,507243,Choi; Bailey Miyeon,28,0,28,0
1713314160312,EDS 117,A01,494379,Staff,24,0,25,1
1713314161338,EDS 125,A00,507246,Hopkins; Megan Beth,29,0,30,1
1713314162365,EDS 128A,A01,507264,Fargason; Sharon Gayle,26,0,26,0
1713314163390,EDS 128B,A01,507293,Pappas; Elizabeth,30,0,30,0
1713314164414,EDS 139,A00,507294,Fargason; Sharon Gayle,30,0,30,0
1713314164414,EDS 139,B00,507313,Pappas; Elizabeth,30,0,30,0
1713314165439,EDS 201,A00,507315,Staff,26,0,30,4
1713314166469,EDS 203,A01,507317,Halter; Christopher P.,26,0,30,4
1713314167493,EDS 204R,A01,507319,Halter; Christopher P.,4,0,30,26
1713314167493,EDS 204R,B01,507331,Heinzman; Erica M.,28,0,30,2
1713314168522,EDS 206R,A00,507332,Staff,5,0,30,25
1713314168522,EDS 206R,B00,507343,Staff,28,0,30,2
1713314169545,EDS 250,A00,507344,Hemans; Patricia Ann Benitez,36,0,40,4
1713314170572,EDS 281,A00,507345,Daly; Alan J.,18,0,18,0
1713314171597,EDS 284,A00,507350,Daly; Alan J.,16,0,16,0
1713314172625,EDS 286,A00,507359,Fine; Sarah,18,0,18,0
1713314173653,EDS 289C,A01,507361,Daly; Alan J.,18,0,18,0
1713314174680,EDS 290,A00,507366,Hofstetter; Carolyn,15,0,15,0
1713314175709,LIGM 5A,A00,507421,Fischer-Grunski; Eva K,20,0,20,0
1713314176735,LIGM 5B,A00,507423,Fischer-Grunski; Eva K,20,0,20,0
1713314177759,LIGM 5C,A00,507425,Fischer-Grunski; Eva K,20,0,20,0
1713314178788,LIIT 5AS,A00,507427,Carnelos; Chiara,20,0,20,0
1713314179821,LIIT 5BS,A00,507430,Carnelos; Chiara,20,0,20,0
1713314180850,LIIT 5CS,A00,507432,Carnelos; Chiara,20,0,20,0
1713314181875,LISP 5A,A00,507541,Munoz Sanchez; Alicia,19,0,20,1
1713314182903,LISP 5B,A00,507671,Munoz Sanchez; Alicia,17,0,20,3
1713314183934,LISP 5C,A00,507696,Munoz Sanchez; Alicia,17,0,20,3
1713314184960,MAE 197,001,528363,Boechler; Nicholas Sebastia,9998,0,9999,1
1713314185986,MATH 197,001,523477,Kedlaya; Kiran S.,9999,0,9999,0
1713314185986,MATH 197,002,563811,Zhang; Danna,9999,0,9999,0
1713314187015,MCWP 40R,A00,518780,Staff,20,0,20,0
1713314187015,MCWP 40R,B00,518781,Staff,19,0,20,1
1713314187015,MCWP 40R,C00,518783,Staff,19,0,20,1
1713314188041,MCWP 50R,A00,518791,Staff,20,0,20,0
1713314188041,MCWP 50R,B00,518792,Staff,18,0,20,2
1713314188041,MCWP 50R,C00,518793,Staff,19,0,20,1
1713314188041,MCWP 50R,D00,518794,Staff,18,0,20,2
1713314188041,MCWP 50R,E00,518795,Staff,18,0,20,2
1713314188041,MCWP 50R,F00,518796,Staff,19,0,20,1
1713314188041,MCWP 50R,G00,518797,Staff,19,0,20,1
1713314189065,MMW 12R,A01,514034,Herbst; Matthew,16,0,16,0
1713314189065,MMW 12R,A02,514035,Herbst; Matthew,16,0,16,0
1713314190090,MMW 13R,A01,514037,Staff,12,0,16,4
1713314190090,MMW 13R,A02,514039,Staff,16,0,16,0
1713314192142,SIO 295LS,A00,523233,Staff,19,0,30,11
1713314193166,SIO 295S,A00,523232,Staff,19,0,30,11
1713314194194,SOCI 117,A01,494376,Staff,3,0,5,2
1713314195222,WES 237B,A00,494380,Staff,19,0,20,1
1713314197285,AESE 279B,A00,494370,Wade; Jon P,33,0,33,0
1713314198311,ANAR 135S,A00,494369,Braswell; Geoffrey E.,0,0,0,0
1713314199339,CAT 124RS,A01,519847,Geibel; William,17,0,20,3
1713314200367,CAT 125RS,A01,515971,Geibel; William,17,0,20,3
1713314201391,CLRE 250,A00,511389,Morris; Sheldon,9996,0,9999,3
1713314202421,CLRE 251,A00,507176,Mehta; Ravindra L.,9996,0,9999,3
1713314202421,CLRE 251,B00,511410,Mehta; Ravindra L.,9998,0,9999,1
1713314203451,CLRE 252,A00,507189,Cuomo; Raphael Eduardo,9998,0,9999,1
1713314204476,CLRE 253,A00,507199,Vaida; Florin,9997,0,9999,2
1713314204476,CLRE 253,B00,507202,Vaida; Florin,9999,0,9999,0
1713314205504,CLRE 259,A00,507211,Patel; Hemal,9996,0,9999,3
1713314206530,CLRE 260,A00,507221,Cuomo; Raphael Eduardo,9999,0,9999,0
1713314207556,CLRE 297,001,507242,Cuomo; Raphael Eduardo,9999,0,9999,0
1713314208581,CSE 191,A00,516875,Minnes Kemp; Mor Mia,9999,0,9999,0
1713314209662,CSS 201S,A01,494383,Staff,35,0,35,0
1713314210688,CSS 202S,A01,494387,Staff,35,0,35,0
1713314211713,EAP 100,A00,516065,Staff,9792,0,9999,207
1713314212738,ECE 45,A01,507414,Staff,54,0,60,6
1713314213763,ECE 100,A01,507416,Baghdadchi; Saharnaz,11,0,20,9
1713314213763,ECE 100,A02,507418,Baghdadchi; Saharnaz,20,0,20,0
1713314214787,ECE 111,A01,507420,Staff,40,0,50,10
1713314215812,ECE 197,001,548057,Sievenpiper; Daniel F.,9998,0,9999,1
1713314216838,EDS 115,A00,507243,Choi; Bailey Miyeon,28,0,28,0
1713314217866,EDS 117,A01,494379,Staff,24,0,25,1
1713314218890,EDS 125,A00,507246,Hopkins; Megan Beth,29,0,30,1
1713314219914,EDS 128A,A01,507264,Fargason; Sharon Gayle,26,0,26,0
1713314220946,EDS 128B,A01,507293,Pappas; Elizabeth,30,0,30,0
1713314221971,EDS 139,A00,507294,Fargason; Sharon Gayle,30,0,30,0
1713314221971,EDS 139,B00,507313,Pappas; Elizabeth,30,0,30,0
1713314222997,EDS 201,A00,507315,Staff,26,0,30,4
1713314224022,EDS 203,A01,507317,Halter; Christopher P.,26,0,30,4
1713314225048,EDS 204R,A01,507319,Halter; Christopher P.,4,0,30,26
1713314225048,EDS 204R,B01,507331,Heinzman; Erica M.,28,0,30,2
1713314226076,EDS 206R,A00,507332,Staff,5,0,30,25
1713314226076,EDS 206R,B00,507343,Staff,28,0,30,2
1713314227102,EDS 250,A00,507344,Hemans; Patricia Ann Benitez,36,0,40,4
1713314228131,EDS 281,A00,507345,Daly; Alan J.,18,0,18,0
1713314229160,EDS 284,A00,507350,Daly; Alan J.,16,0,16,0
1713314230185,EDS 286,A00,507359,Fine; Sarah,18,0,18,0
1713314231210,EDS 289C,A01,507361,Daly; Alan J.,18,0,18,0
1713314232239,EDS 290,A00,507366,Hofstetter; Carolyn,15,0,15,0
1713314233270,LIGM 5A,A00,507421,Fischer-Grunski; Eva K,20,0,20,0
1713314234301,LIGM 5B,A00,507423,Fischer-Grunski; Eva K,20,0,20,0
1713314235329,LIGM 5C,A00,507425,Fischer-Grunski; Eva K,20,0,20,0
1713314236355,LIIT 5AS,A00,507427,Carnelos; Chiara,20,0,20,0
1713314237381,LIIT 5BS,A00,507430,Carnelos; Chiara,20,0,20,0
1713314238411,LIIT 5CS,A00,507432,Carnelos; Chiara,20,0,20,0
1713314239436,LISP 5A,A00,507541,Munoz Sanchez; Alicia,19,0,20,1
1713314240461,LISP 5B,A00,507671,Munoz Sanchez; Alicia,17,0,20,3
1713314241485,LISP 5C,A00,507696,Munoz Sanchez; Alicia,17,0,20,3
1713314242512,MAE 197,001,528363,Boechler; Nicholas Sebastia,9998,0,9999,1
1713314243543,MATH 197,001,523477,Kedlaya; Kiran S.,9999,0,9999,0
1713314243543,MATH 197,002,563811,Zhang; Danna,9999,0,9999,0
1713314244568,MCWP 40R,A00,518780,Staff,20,0,20,0
1713314244568,MCWP 40R,B00,518781,Staff,19,0,20,1
1713314244568,MCWP 40R,C00,518783,Staff,19,0,20,1
1713314245592,MCWP 50R,A00,518791,Staff,20,0,20,0
1713314245592,MCWP 50R,B00,518792,Staff,18,0,20,2
1713314245592,MCWP 50R,C00,518793,Staff,19,0,20,1
1713314245592,MCWP 50R,D00,518794,Staff,18,0,20,2
1713314245592,MCWP 50R,E00,518795,Staff,18,0,20,2
1713314245592,MCWP 50R,F00,518796,Staff,19,0,20,1
1713314245592,MCWP 50R,G00,518797,Staff,19,0,20,1
1713314246619,MMW 12R,A01,514034,Herbst; Matthew,16,0,16,0
1713314246619,MMW 12R,A02,514035,Herbst; Matthew,16,0,16,0
1713314247648,MMW 13R,A01,514037,Staff,12,0,16,4
1713314247648,MMW 13R,A02,514039,Staff,16,0,16,0
1713314249702,SIO 295LS,A00,523233,Staff,19,0,30,11
1713314250728,SIO 295S,A00,523232,Staff,19,0,30,11
1713314251756,SOCI 117,A01,494376,Staff,3,0,5,2
1713314252782,WES 237B,A00,494380,Staff,19,0,20,1
1713314254847,AESE 279B,A00,494370,Wade; Jon P,33,0,33,0
1713314255872,ANAR 135S,A00,494369,Braswell; Geoffrey E.,0,0,0,0
1713314256896,CAT 124RS,A01,519847,Geibel; William,17,0,20,3
1713314257920,CAT 125RS,A01,515971,Geibel; William,17,0,20,3
1713314258950,CLRE 250,A00,511389,Morris; Sheldon,9996,0,9999,3
1713314259982,CLRE 251,A00,507176,Mehta; Ravindra L.,9996,0,9999,3
1713314259982,CLRE 251,B00,511410,Mehta; Ravindra L.,9998,0,9999,1
1713314261006,CLRE 252,A00,507189,Cuomo; Raphael Eduardo,9998,0,9999,1
1713314262032,CLRE 253,A00,507199,Vaida; Florin,9997,0,9999,2
1713314262032,CLRE 253,B00,507202,Vaida; Florin,9999,0,9999,0
1713314263060,CLRE 259,A00,507211,Patel; Hemal,9996,0,9999,3
1713314264087,CLRE 260,A00,507221,Cuomo; Raphael Eduardo,9999,0,9999,0
1713314265116,CLRE 297,001,507242,Cuomo; Raphael Eduardo,9999,0,9999,0
1713314266142,CSE 191,A00,516875,Minnes Kemp; Mor Mia,9999,0,9999,0
1713314267166,CSS 201S,A01,494383,Staff,35,0,35,0
1713314268190,CSS 202S,A01,494387,Staff,35,0,35,0
1713314269215,EAP 100,A00,516065,Staff,9792,0,9999,207
1713314270243,ECE 45,A01,507414,Staff,54,0,60,6
1713314271270,ECE 100,A01,507416,Baghdadchi; Saharnaz,11,0,20,9
1713314271270,ECE 100,A02,507418,Baghdadchi; Saharnaz,20,0,20,0
1713314272299,ECE 111,A01,507420,Staff,40,0,50,10
1713314273324,ECE 197,001,548057,Sievenpiper; Daniel F.,9998,0,9999,1
1713314274352,EDS 115,A00,507243,Choi; Bailey Miyeon,28,0,28,0
1713314275378,EDS 117,A01,494379,Staff,24,0,25,1
1713314276407,EDS 125,A00,507246,Hopkins; Megan Beth,29,0,30,1
1713314277436,EDS 128A,A01,507264,Fargason; Sharon Gayle,26,0,26,0
1713314278463,EDS 128B,A01,507293,Pappas; Elizabeth,30,0,30,0
1713314279492,EDS 139,A00,507294,Fargason; Sharon Gayle,30,0,30,0
1713314279492,EDS 139,B00,507313,Pappas; Elizabeth,30,0,30,0
1713314280521,EDS 201,A00,507315,Staff,26,0,30,4
1713314281549,EDS 203,A01,507317,Halter; Christopher P.,26,0,30,4
1713314282577,EDS 204R,A01,507319,Halter; Christopher P.,4,0,30,26
1713314282577,EDS 204R,B01,507331,Heinzman; Erica M.,28,0,30,2
1713314283604,EDS 206R,A00,507332,Staff,5,0,30,25
1713314283604,EDS 206R,B00,507343,Staff,28,0,30,2
1713314284634,EDS 250,A00,507344,Hemans; Patricia Ann Benitez,36,0,40,4
1713314285660,EDS 281,A00,507345,Daly; Alan J.,18,0,18,0
1713314286685,EDS 284,A00,507350,Daly; Alan J.,16,0,16,0
1713314287711,EDS 286,A00,507359,Fine; Sarah,18,0,18,0
1713314288735,EDS 289C,A01,507361,Daly; Alan J.,18,0,18,0
1713314289762,EDS 290,A00,507366,Hofstetter; Carolyn,15,0,15,0
1713314290787,LIGM 5A,A00,507421,Fischer-Grunski; Eva K,20,0,20,0
1713314291813,LIGM 5B,A00,507423,Fischer-Grunski; Eva K,20,0,20,0
1713314292839,LIGM 5C,A00,507425,Fischer-Grunski; Eva K,20,0,20,0
1713314293876,LIIT 5AS,A00,507427,Carnelos; Chiara,20,0,20,0
1713314294901,LIIT 5BS,A00,507430,Carnelos; Chiara,20,0,20,0
1713314295926,LIIT 5CS,A00,507432,Carnelos; Chiara,20,0,20,0
1713314296957,LISP 5A,A00,507541,Munoz Sanchez; Alicia,19,0,20,1
1713314297985,LISP 5B,A00,507671,Munoz Sanchez; Alicia,17,0,20,3
1713314299013,LISP 5C,A00,507696,Munoz Sanchez; Alicia,17,0,20,3
1713314300041,MAE 197,001,528363,Boechler; Nicholas Sebastia,9998,0,9999,1
1713314301070,MATH 197,001,523477,Kedlaya; Kiran S.,9999,0,9999,0
1713314301070,MATH 197,002,563811,Zhang; Danna,9999,0,9999,0
1713314302100,MCWP 40R,A00,518780,Staff,20,0,20,0
1713314302100,MCWP 40R,B00,518781,Staff,19,0,20,1
1713314302100,MCWP 40R,C00,518783,Staff,19,0,20,1
1713314303125,MCWP 50R,A00,518791,Staff,20,0,20,0
1713314303125,MCWP 50R,B00,518792,Staff,18,0,20,2
1713314303125,MCWP 50R,C00,518793,Staff,19,0,20,1
1713314303125,MCWP 50R,D00,518794,Staff,18,0,20,2
1713314303125,MCWP 50R,E00,518795,Staff,18,0,20,2
1713314303125,MCWP 50R,F00,518796,Staff,19,0,20,1
1713314303125,MCWP 50R,G00,518797,Staff,19,0,20,1
1713314304149,MMW 12R,A01,514034,Herbst; Matthew,16,0,16,0
1713314304149,MMW 12R,A02,514035,Herbst; Matthew,16,0,16,0
1713314305176,MMW 13R,A01,514037,Staff,12,0,16,4
1713314305176,MMW 13R,A02,514039,Staff,16,0,16,0
1713314307228,SIO 295LS,A00,523233,Staff,19,0,30,11
1713314308253,SIO 295S,A00,523232,Staff,19,0,30,11
1713314309284,SOCI 117,A01,494376,Staff,3,0,5,2
1713314310312,WES 237B,A00,494380,Staff,19,0,20,1
1713314312380,AESE 279B,A00,494370,Wade; Jon P,33,0,33,0
1713314313461,ANAR 135S,A00,494369,Braswell; Geoffrey E.,0,0,0,0
1713314314494,CAT 124RS,A01,519847,Geibel; William,17,0,20,3
1713314315522,CAT 125RS,A01,515971,Geibel; William,17,0,20,3
1713314316546,CLRE 250,A00,511389,Morris; Sheldon,9996,0,9999,3
1713314317578,CLRE 251,A00,507176,Mehta; Ravindra L.,9996,0,9999,3
1713314317578,CLRE 251,B00,511410,Mehta; Ravindra L.,9998,0,9999,1
1713314318607,CLRE 252,A00,507189,Cuomo; Raphael Eduardo,9998,0,9999,1
1713314319635,CLRE 253,A00,507199,Vaida; Florin,9997,0,9999,2
1713314319635,CLRE 253,B00,507202,Vaida; Florin,9999,0,9999,0
1713314320664,CLRE 259,A00,507211,Patel; Hemal,9996,0,9999,3
1713314321690,CLRE 260,A00,507221,Cuomo; Raphael Eduardo,9999,0,9999,0
1713314322715,CLRE 297,001,507242,Cuomo; Raphael Eduardo,9999,0,9999,0
1713314323740,CSE 191,A00,516875,Minnes Kemp; Mor Mia,9999,0,9999,0
1713314324766,CSS 201S,A01,494383,Staff,35,0,35,0
1713314325792,CSS 202S,A01,494387,Staff,35,0,35,0
1713314326822,EAP 100,A00,516065,Staff,9792,0,9999,207
1713314327852,ECE 45,A01,507414,Staff,54,0,60,6
1713314328878,ECE 100,A01,507416,Baghdadchi; Saharnaz,11,0,20,9
1713314328878,ECE 100,A02,507418,Baghdadchi; Saharnaz,20,0,20,0
1713314329907,ECE 111,A01,507420,Staff,40,0,50,10
1713314330932,ECE 197,001,548057,Sievenpiper; Daniel F.,9998,0,9999,1
1713314331959,EDS 115,A00,507243,Choi; Bailey Miyeon,28,0,28,0
1713314332988,EDS 117,A01,494379,Staff,24,0,25,1
1713314334017,EDS 125,A00,507246,Hopkins; Megan Beth,29,0,30,1
1713314335049,EDS 128A,A01,507264,Fargason; Sharon Gayle,26,0,26,0
1713314336075,EDS 128B,A01,507293,Pappas; Elizabeth,30,0,30,0
1713314337102,EDS 139,A00,507294,Fargason; Sharon Gayle,30,0,30,0
1713314337102,EDS 139,B00,507313,Pappas; Elizabeth,30,0,30,0
1713314338130,EDS 201,A00,507315,Staff,26,0,30,4
1713314339155,EDS 203,A01,507317,Halter; Christopher P.,26,0,30,4
1713314340185,EDS 204R,A01,507319,Halter; Christopher P.,4,0,30,26
1713314340185,EDS 204R,B01,507331,Heinzman; Erica M.,28,0,30,2
1713314341215,EDS 206R,A00,507332,Staff,5,0,30,25
1713314341215,EDS 206R,B00,507343,Staff,28,0,30,2
1713314342241,EDS 250,A00,507344,Hemans; Patricia Ann Benitez,36,0,40,4
1713314343272,EDS 281,A00,507345,Daly; Alan J.,18,0,18,0
1713314344301,EDS 284,A00,507350,Daly; Alan J.,16,0,16,0
1713314345326,EDS 286,A00,507359,Fine; Sarah,18,0,18,0
1713314346351,EDS 289C,A01,507361,Daly; Alan J.,18,0,18,0
1713314347382,EDS 290,A00,507366,Hofstetter; Carolyn,15,0,15,0
1713314348408,LIGM 5A,A00,507421,Fischer-Grunski; Eva K,20,0,20,0
1713314349433,LIGM 5B,A00,507423,Fischer-Grunski; Eva K,20,0,20,0
1713314350459,LIGM 5C,A00,507425,Fischer-Grunski; Eva K,20,0,20,0
1713314351486,LIIT 5AS,A00,507427,Carnelos; Chiara,20,0,20,0
1713314352509,LIIT 5BS,A00,507430,Carnelos; Chiara,20,0,20,0
1713314353538,LIIT 5CS,A00,507432,Carnelos; Chiara,20,0,20,0
1713314354568,LISP 5A,A00,507541,Munoz Sanchez; Alicia,19,0,20,1
1713314355594,LISP 5B,A00,507671,Munoz Sanchez; Alicia,17,0,20,3
1713314356619,LISP 5C,A00,507696,Munoz Sanchez; Alicia,17,0,20,3
1713314357649,MAE 197,001,528363,Boechler; Nicholas Sebastia,9998,0,9999,1
1713314358677,MATH 197,001,523477,Kedlaya; Kiran S.,9999,0,9999,0
1713314358677,MATH 197,002,563811,Zhang; Danna,9999,0,9999,0
1713314359701,MCWP 40R,A00,518780,Staff,20,0,20,0
1713314359701,MCWP 40R,B00,518781,Staff,19,0,20,1
1713314359701,MCWP 40R,C00,518783,Staff,19,0,20,1
1713314360725,MCWP 50R,A00,518791,Staff,20,0,20,0
1713314360725,MCWP 50R,B00,518792,Staff,18,0,20,2
1713314360725,MCWP 50R,C00,518793,Staff,19,0,20,1
1713314360725,MCWP 50R,D00,518794,Staff,18,0,20,2
1713314360725,MCWP 50R,E00,518795,Staff,18,0,20,2
1713314360725,MCWP 50R,F00,518796,Staff,19,0,20,1
1713314360725,MCWP 50R,G00,518797,Staff,19,0,20,1
1713314361755,MMW 12R,A01,514034,Herbst; Matthew,16,0,16,0
1713314361755,MMW 12R,A02,514035,Herbst; Matthew,16,0,16,0
1713314362783,MMW 13R,A01,514037,Staff,12,0,16,4
1713314362783,MMW 13R,A02,514039,Staff,16,0,16,0
1713314364834,SIO 295LS,A00,523233,Staff,19,0,30,11
1713314365860,SIO 295S,A00,523232,Staff,19,0,30,11
1713314366889,SOCI 117,A01,494376,Staff,3,0,5,2
1713314367913,WES 237B,A00,494380,Staff,19,0,20,1
1713314369979,AESE 279B,A00,494370,Wade; Jon P,33,0,33,0
1713314371008,ANAR 135S,A00,494369,Braswell; Geoffrey E.,0,0,0,0
1713314372035,CAT 124RS,A01,519847,Geibel; William,17,0,20,3
1713314373060,CAT 125RS,A01,515971,Geibel; William,17,0,20,3
1713314374087,CLRE 250,A00,511389,Morris; Sheldon,9996,0,9999,3
1713314375113,CLRE 251,A00,507176,Mehta; Ravindra L.,9996,0,9999,3
1713314375113,CLRE 251,B00,511410,Mehta; Ravindra L.,9998,0,9999,1
1713314376144,CLRE 252,A00,507189,Cuomo; Raphael Eduardo,9998,0,9999,1
1713314377172,CLRE 253,A00,507199,Vaida; Florin,9997,0,9999,2
1713314377172,CLRE 253,B00,507202,Vaida; Florin,9999,0,9999,0
1713314378200,CLRE 259,A00,507211,Patel; Hemal,9996,0,9999,3
1713314379228,CLRE 260,A00,507221,Cuomo; Raphael Eduardo,9999,0,9999,0
1713314380254,CLRE 297,001,507242,Cuomo; Raphael Eduardo,9999,0,9999,0
1713314381280,CSE 191,A00,516875,Minnes Kemp; Mor Mia,9999,0,9999,0
1713314382309,CSS 201S,A01,494383,Staff,35,0,35,0
1713314383338,CSS 202S,A01,494387,Staff,35,0,35,0
1713314384362,EAP 100,A00,516065,Staff,9792,0,9999,207
1713314385387,ECE 45,A01,507414,Staff,54,0,60,6
1713314386413,ECE 100,A01,507416,Baghdadchi; Saharnaz,11,0,20,9
1713314386413,ECE 100,A02,507418,Baghdadchi; Saharnaz,20,0,20,0
1713314387438,ECE 111,A01,507420,Staff,40,0,50,10
1713314388463,ECE 197,001,548057,Sievenpiper; Daniel F.,9998,0,9999,1
1713314389490,EDS 115,A00,507243,Choi; Bailey Miyeon,28,0,28,0
1713314390519,EDS 117,A01,494379,Staff,24,0,25,1
1713314391546,EDS 125,A00,507246,Hopkins; Megan Beth,29,0,30,1
1713314392570,EDS 128A,A01,507264,Fargason; Sharon Gayle,26,0,26,0
1713314393596,EDS 128B,A01,507293,Pappas; Elizabeth,30,0,30,0
1713314394624,EDS 139,A00,507294,Fargason; Sharon Gayle,30,0,30,0
1713314394624,EDS 139,B00,507313,Pappas; Elizabeth,30,0,30,0
1713314395649,EDS 201,A00,507315,Staff,26,0,30,4
1713314396679,EDS 203,A01,507317,Halter; Christopher P.,26,0,30,4
1713314397706,EDS 204R,A01,507319,Halter; Christopher P.,4,0,30,26
1713314397706,EDS 204R,B01,507331,Heinzman; Erica M.,28,0,30,2
1713314398736,EDS 206R,A00,507332,Staff,5,0,30,25
1713314398736,EDS 206R,B00,507343,Staff,28,0,30,2
1713314399762,EDS 250,A00,507344,Hemans; Patricia Ann Benitez,36,0,40,4
1713314400788,EDS 281,A00,507345,Daly; Alan J.,18,0,18,0
1713314401815,EDS 284,A00,507350,Daly; Alan J.,16,0,16,0
1713314402841,EDS 286,A00,507359,Fine; Sarah,18,0,18,0
1713314403878,EDS 289C,A01,507361,Daly; Alan J.,18,0,18,0
1713314404908,EDS 290,A00,507366,Hofstetter; Carolyn,15,0,15,0
1713314405937,LIGM 5A,A00,507421,Fischer-Grunski; Eva K,20,0,20,0
1713314406961,LIGM 5B,A00,507423,Fischer-Grunski; Eva K,20,0,20,0
1713314407986,LIGM 5C,A00,507425,Fischer-Grunski; Eva K,20,0,20,0
1713314409014,LIIT 5AS,A00,507427,Carnelos; Chiara,20,0,20,0
1713314410045,LIIT 5BS,A00,507430,Carnelos; Chiara,20,0,20,0
1713314411073,LIIT 5CS,A00,507432,Carnelos; Chiara,20,0,20,0
1713314412104,LISP 5A,A00,507541,Munoz Sanchez; Alicia,19,0,20,1
1713314413133,LISP 5B,A00,507671,Munoz Sanchez; Alicia,17,0,20,3
1713314414159,LISP 5C,A00,507696,Munoz Sanchez; Alicia,17,0,20,3
1713314415184,MAE 197,001,528363,Boechler; Nicholas Sebastia,9998,0,9999,1
1713314416214,MATH 197,001,523477,Kedlaya; Kiran S.,9999,0,9999,0
1713314416214,MATH 197,002,563811,Zhang; Danna,9999,0,9999,0
1713314417295,MCWP 40R,A00,518780,Staff,20,0,20,0
1713314417295,MCWP 40R,B00,518781,Staff,19,0,20,1
1713314417295,MCWP 40R,C00,518783,Staff,19,0,20,1
1713314418321,MCWP 50R,A00,518791,Staff,20,0,20,0
1713314418321,MCWP 50R,B00,518792,Staff,18,0,20,2
1713314418321,MCWP 50R,C00,518793,Staff,19,0,20,1
1713314418321,MCWP 50R,D00,518794,Staff,18,0,20,2
1713314418321,MCWP 50R,E00,518795,Staff,18,0,20,2
1713314418321,MCWP 50R,F00,518796,Staff,19,0,20,1
1713314418321,MCWP 50R,G00,518797,Staff,19,0,20,1
1713314419347,MMW 12R,A01,514034,Herbst; Matthew,16,0,16,0
1713314419347,MMW 12R,A02,514035,Herbst; Matthew,16,0,16,0
1713314420372,MMW 13R,A01,514037,Staff,12,0,16,4
1713314420372,MMW 13R,A02,514039,Staff,16,0,16,0
1713314422427,SIO 295LS,A00,523233,Staff,19,0,30,11
1713314423456,SIO 295S,A00,523232,Staff,19,0,30,11
1713314424480,SOCI 117,A01,494376,Staff,3,0,5,2
1713314425505,WES 237B,A00,494380,Staff,19,0,20,1
1713314427574,AESE 279B,A00,494370,Wade; Jon P,33,0,33,0
1713314428603,ANAR 135S,A00,494369,Braswell; Geoffrey E.,0,0,0,0
1713314429632,CAT 124RS,A01,519847,Geibel; William,17,0,20,3
1713314430659,CAT 125RS,A01,515971,Geibel; William,17,0,20,3
1713314431684,CLRE 250,A00,511389,Morris; Sheldon,9996,0,9999,3
1713314432711,CLRE 251,A00,507176,Mehta; Ravindra L.,9996,0,9999,3
1713314432711,CLRE 251,B00,511410,Mehta; Ravindra L.,9998,0,9999,1
1713314433737,CLRE 252,A00,507189,Cuomo; Raphael Eduardo,9998,0,9999,1
1713314434763,CLRE 253,A00,507199,Vaida; Florin,9997,0,9999,2
1713314434763,CLRE 253,B00,507202,Vaida; Florin,9999,0,9999,0
1713314435791,CLRE 259,A00,507211,Patel; Hemal,9996,0,9999,3
1713314436814,CLRE 260,A00,507221,Cuomo; Raphael Eduardo,9999,0,9999,0
1713314437839,CLRE 297,001,507242,Cuomo; Raphael Eduardo,9999,0,9999,0
1713314438866,CSE 191,A00,516875,Minnes Kemp; Mor Mia,9999,0,9999,0
1713314439893,CSS 201S,A01,494383,Staff,35,0,35,0
1713314440923,CSS 202S,A01,494387,Staff,35,0,35,0
1713314441950,EAP 100,A00,516065,Staff,9792,0,9999,207
1713314442980,ECE 45,A01,507414,Staff,54,0,60,6
1713314444006,ECE 100,A01,507416,Baghdadchi; Saharnaz,11,0,20,9
1713314444006,ECE 100,A02,507418,Baghdadchi; Saharnaz,20,0,20,0
1713314445035,ECE 111,A01,507420,Staff,40,0,50,10
1713314446060,ECE 197,001,548057,Sievenpiper; Daniel F.,9998,0,9999,1
1713314447087,EDS 115,A00,507243,Choi; Bailey Miyeon,28,0,28,0
1713314448121,EDS 117,A01,494379,Staff,24,0,25,1
1713314449145,EDS 125,A00,507246,Hopkins; Megan Beth,29,0,30,1
1713314450175,EDS 128A,A01,507264,Fargason; Sharon Gayle,26,0,26,0
1713314451204,EDS 128B,A01,507293,Pappas; Elizabeth,30,0,30,0
1713314452232,EDS 139,A00,507294,Fargason; Sharon Gayle,30,0,30,0
1713314452232,EDS 139,B00,507313,Pappas; Elizabeth,30,0,30,0
1713314453257,EDS 201,A00,507315,Staff,26,0,30,4
1713314454282,EDS 203,A01,507317,Halter; Christopher P.,26,0,30,4
1713314455307,EDS 204R,A01,507319,Halter; Christopher P.,4,0,30,26
1713314455307,EDS 204R,B01,507331,Heinzman; Erica M.,28,0,30,2
1713314456330,EDS 206R,A00,507332,Staff,5,0,30,25
1713314456330,EDS 206R,B00,507343,Staff,28,0,30,2
1713314457354,EDS 250,A00,507344,Hemans; Patricia Ann Benitez,36,0,40,4
1713314458384,EDS 281,A00,507345,Daly; Alan J.,18,0,18,0
1713314459409,EDS 284,A00,507350,Daly; Alan J.,16,0,16,0
1713314460445,EDS 286,A00,507359,Fine; Sarah,18,0,18,0
1713314461471,EDS 289C,A01,507361,Daly; Alan J.,18,0,18,0
1713314462498,EDS 290,A00,507366,Hofstetter; Carolyn,15,0,15,0
1713314463522,LIGM 5A,A00,507421,Fischer-Grunski; Eva K,20,0,20,0
1713314464552,LIGM 5B,A00,507423,Fischer-Grunski; Eva K,20,0,20,0
1713314465580,LIGM 5C,A00,507425,Fischer-Grunski; Eva K,20,0,20,0
1713314466604,LIIT 5AS,A00,507427,Carnelos; Chiara,20,0,20,0
1713314467632,LIIT 5BS,A00,507430,Carnelos; Chiara,20,0,20,0
1713314468657,LIIT 5CS,A00,507432,Carnelos; Chiara,20,0,20,0
1713314469682,LISP 5A,A00,507541,Munoz Sanchez; Alicia,19,0,20,1
1713314470710,LISP 5B,A00,507671,Munoz Sanchez; Alicia,17,0,20,3
1713314471739,LISP 5C,A00,507696,Munoz Sanchez; Alicia,17,0,20,3
1713314472771,MAE 197,001,528363,Boechler; Nicholas Sebastia,9998,0,9999,1
1713314473797,MATH 197,001,523477,Kedlaya; Kiran S.,9999,0,9999,0
1713314473797,MATH 197,002,563811,Zhang; Danna,9999,0,9999,0
1713314474823,MCWP 40R,A00,518780,Staff,20,0,20,0
1713314474823,MCWP 40R,B00,518781,Staff,19,0,20,1
1713314474823,MCWP 40R,C00,518783,Staff,19,0,20,1
1713314475850,MCWP 50R,A00,518791,Staff,20,0,20,0
1713314475850,MCWP 50R,B00,518792,Staff,18,0,20,2
1713314475850,MCWP 50R,C00,518793,Staff,19,0,20,1
1713314475850,MCWP 50R,D00,518794,Staff,18,0,20,2
1713314475850,MCWP 50R,E00,518795,Staff,18,0,20,2
1713314475850,MCWP 50R,F00,518796,Staff,19,0,20,1
1713314475850,MCWP 50R,G00,518797,Staff,19,0,20,1
1713314476880,MMW 12R,A01,514034,Herbst; Matthew,16,0,16,0
1713314476880,MMW 12R,A02,514035,Herbst; Matthew,16,0,16,0
1713314477906,MMW 13R,A01,514037,Staff,12,0,16,4
1713314477906,MMW 13R,A02,514039,Staff,16,0,16,0
1713314479956,SIO 295LS,A00,523233,Staff,19,0,30,11
1713314481117,SIO 295S,A00,523232,Staff,19,0,30,11
1713314482145,SOCI 117,A01,494376,Staff,3,0,5,2
1713314483171,WES 237B,A00,494380,Staff,19,0,20,1
1713314485248,AESE 279B,A00,494370,Wade; Jon P,33,0,33,0
1713314486278,ANAR 135S,A00,494369,Braswell; Geoffrey E.,0,0,0,0
1713314487304,CAT 124RS,A01,519847,Geibel; William,17,0,20,3
1713314488333,CAT 125RS,A01,515971,Geibel; William,17,0,20,3
1713314489363,CLRE 250,A00,511389,Morris; Sheldon,9996,0,9999,3
1713314490394,CLRE 251,A00,507176,Mehta; Ravindra L.,9996,0,9999,3
1713314490394,CLRE 251,B00,511410,Mehta; Ravindra L.,9998,0,9999,1
1713314491421,CLRE 252,A00,507189,Cuomo; Raphael Eduardo,9998,0,9999,1
1713314492453,CLRE 253,A00,507199,Vaida; Florin,9997,0,9999,2
1713314492453,CLRE 253,B00,507202,Vaida; Florin,9999,0,9999,0
1713314493482,CLRE 259,A00,507211,Patel; Hemal,9996,0,9999,3
1713314494510,CLRE 260,A00,507221,Cuomo; Raphael Eduardo,9999,0,9999,0
1713314495534,CLRE 297,001,507242,Cuomo; Raphael Eduardo,9999,0,9999,0
1713314496558,CSE 191,A00,516875,Minnes Kemp; Mor Mia,9999,0,9999,0
1713314497585,CSS 201S,A01,494383,Staff,35,0,35,0
1713314498614,CSS 202S,A01,494387,Staff,35,0,35,0
1713314499640,EAP 100,A00,516065,Staff,9792,0,9999,207
1713314500665,ECE 45,A01,507414,Staff,54,0,60,6
1713314501691,ECE 100,A01,507416,Baghdadchi; Saharnaz,11,0,20,9
1713314501691,ECE 100,A02,507418,Baghdadchi; Saharnaz,20,0,20,0
1713314502716,ECE 111,A01,507420,Staff,40,0,50,10
1713314503742,ECE 197,001,548057,Sievenpiper; Daniel F.,9998,0,9999,1
1713314504771,EDS 115,A00,507243,Choi; Bailey Miyeon,28,0,28,0
1713314505800,EDS 117,A01,494379,Staff,24,0,25,1
1713314506827,EDS 125,A00,507246,Hopkins; Megan Beth,29,0,30,1
1713314507852,EDS 128A,A01,507264,Fargason; Sharon Gayle,26,0,26,0
1713314508882,EDS 128B,A01,507293,Pappas; Elizabeth,30,0,30,0
1713314509906,EDS 139,A00,507294,Fargason; Sharon Gayle,30,0,30,0
1713314509906,EDS 139,B00,507313,Pappas; Elizabeth,30,0,30,0
1713314510935,EDS 201,A00,507315,Staff,26,0,30,4
1713314511961,EDS 203,A01,507317,Halter; Christopher P.,26,0,30,4
1713314512986,EDS 204R,A01,507319,Halter; Christopher P.,4,0,30,26
1713314512986,EDS 204R,B01,507331,Heinzman; Erica M.,28,0,30,2
1713314514011,EDS 206R,A00,507332,Staff,5,0,30,25
1713314514011,EDS 206R,B00,507343,Staff,28,0,30,2
1713314515035,EDS 250,A00,507344,Hemans; Patricia Ann Benitez,36,0,40,4
1713314516060,EDS 281,A00,507345,Daly; Alan J.,18,0,18,0
1713314517090,EDS 284,A00,507350,Daly; Alan J.,16,0,16,0
1713314518123,EDS 286,A00,507359,Fine; Sarah,18,0,18,0
1713314519154,EDS 289C,A01,507361,Daly; Alan J.,18,0,18,0
1713314520178,EDS 290,A00,507366,Hofstetter; Carolyn,15,0,15,0
1713314521259,LIGM 5A,A00,507421,Fischer-Grunski; Eva K,20,0,20,0
1713314522290,LIGM 5B,A00,507423,Fischer-Grunski; Eva K,20,0,20,0
1713314523320,LIGM 5C,A00,507425,Fischer-Grunski; Eva K,20,0,20,0
1713314524349,LIIT 5AS,A00,507427,Carnelos; Chiara,20,0,20,0
1713314525375,LIIT 5BS,A00,507430,Carnelos; Chiara,20,0,20,0
1713314526400,LIIT 5CS,A00,507432,Carnelos; Chiara,20,0,20,0
1713314527437,LISP 5A,A00,507541,Munoz Sanchez; Alicia,19,0,20,1
1713314528466,LISP 5B,A00,507671,Munoz Sanchez; Alicia,17,0,20,3
1713314529492,LISP 5C,A00,507696,Munoz Sanchez; Alicia,17,0,20,3
1713314530522,MAE 197,001,528363,Boechler; Nicholas Sebastia,9998,0,9999,1
1713314531549,MATH 197,001,523477,Kedlaya; Kiran S.,9999,0,9999,0
1713314531549,MATH 197,002,563811,Zhang; Danna,9999,0,9999,0
1713314532578,MCWP 40R,A00,518780,Staff,20,0,20,0
1713314532578,MCWP 40R,B00,518781,Staff,19,0,20,1
1713314532578,MCWP 40R,C00,518783,Staff,19,0,20,1
1713314533603,MCWP 50R,A00,518791,Staff,20,0,20,0
1713314533603,MCWP 50R,B00,518792,Staff,18,0,20,2
1713314533603,MCWP 50R,C00,518793,Staff,19,0,20,1
1713314533603,MCWP 50R,D00,518794,Staff,18,0,20,2
1713314533603,MCWP 50R,E00,518795,Staff,18,0,20,2
1713314533603,MCWP 50R,F00,518796,Staff,19,0,20,1
1713314533603,MCWP 50R,G00,518797,Staff,19,0,20,1
1713314534630,MMW 12R,A01,514034,Herbst; Matthew,16,0,16,0
1713314534630,MMW 12R,A02,514035,Herbst; Matthew,16,0,16,0
1713314535657,MMW 13R,A01,514037,Staff,12,0,16,4
1713314535657,MMW 13R,A02,514039,Staff,16,0,16,0
1713314537710,SIO 295LS,A00,523233,Staff,19,0,30,11
1713314538735,SIO 295S,A00,523232,Staff,19,0,30,11
1713314539761,SOCI 117,A01,494376,Staff,3,0,5,2
1713314540786,WES 237B,A00,494380,Staff,19,0,20,1
1713314542858,AESE 279B,A00,494370,Wade; Jon P,33,0,33,0
1713314543895,ANAR 135S,A00,494369,Braswell; Geoffrey E.,0,0,0,0
1713314544924,CAT 124RS,A01,519847,Geibel; William,17,0,20,3
1713314545950,CAT 125RS,A01,515971,Geibel; William,17,0,20,3
1713314546975,CLRE 250,A00,511389,Morris; Sheldon,9996,0,9999,3
1713314548002,CLRE 251,A00,507176,Mehta; Ravindra L.,9996,0,9999,3
1713314548002,CLRE 251,B00,511410,Mehta; Ravindra L.,9998,0,9999,1
1713314549032,CLRE 252,A00,507189,Cuomo; Raphael Eduardo,9998,0,9999,1
1713314550092,CLRE 253,A00,507199,Vaida; Florin,9997,0,9999,2
1713314550092,CLRE 253,B00,507202,Vaida; Florin,9999,0,9999,0
1713314551119,CLRE 259,A00,507211,Patel; Hemal,9996,0,9999,3
1713314552144,CLRE 260,A00,507221,Cuomo; Raphael Eduardo,9999,0,9999,0
1713314553173,CLRE 297,001,507242,Cuomo; Raphael Eduardo,9999,0,9999,0
1713314554199,CSE 191,A00,516875,Minnes Kemp; Mor Mia,9999,0,9999,0
1713314555228,CSS 201S,A01,494383,Staff,35,0,35,0
1713314556253,CSS 202S,A01,494387,Staff,35,0,35,0
1713314557281,EAP 100,A00,516065,Staff,9792,0,9999,207
1713314558307,ECE 45,A01,507414,Staff,54,0,60,6
1713314559331,ECE 100,A01,507416,Baghdadchi; Saharnaz,11,0,20,9
1713314559331,ECE 100,A02,507418,Baghdadchi; Saharnaz,20,0,20,0
1713314560359,ECE 111,A01,507420,Staff,40,0,50,10
1713314561385,ECE 197,001,548057,Sievenpiper; Daniel F.,9998,0,9999,1
1713314562414,EDS 115,A00,507243,Choi; Bailey Miyeon,28,0,28,0
1713314563439,EDS 117,A01,494379,Staff,24,0,25,1
1713314564469,EDS 125,A00,507246,Hopkins; Megan Beth,29,0,30,1
1713314565498,EDS 128A,A01,507264,Fargason; Sharon Gayle,26,0,26,0
1713314566521,EDS 128B,A01,507293,Pappas; Elizabeth,30,0,30,0
1713314567548,EDS 139,A00,507294,Fargason; Sharon Gayle,30,0,30,0
1713314567548,EDS 139,B00,507313,Pappas; Elizabeth,30,0,30,0
1713314568576,EDS 201,A00,507315,Staff,26,0,30,4
1713314569606,EDS 203,A01,507317,Halter; Christopher P.,26,0,30,4
1713314570630,EDS 204R,A01,507319,Halter; Christopher P.,4,0,30,26
1713314570630,EDS 204R,B01,507331,Heinzman; Erica M.,28,0,30,2
1713314571654,EDS 206R,A00,507332,Staff,5,0,30,25
1713314571654,EDS 206R,B00,507343,Staff,28,0,30,2
1713314572679,EDS 250,A00,507344,Hemans; Patricia Ann Benitez,36,0,40,4
1713314573709,EDS 281,A00,507345,Daly; Alan J.,18,0,18,0
1713314574733,EDS 284,A00,507350,Daly; Alan J.,16,0,16,0
1713314575763,EDS 286,A00,507359,Fine; Sarah,18,0,18,0
1713314576787,EDS 289C,A01,507361,Daly; Alan J.,18,0,18,0
1713314577812,EDS 290,A00,507366,Hofstetter; Carolyn,15,0,15,0
1713314578838,LIGM 5A,A00,507421,Fischer-Grunski; Eva K,20,0,20,0
1713314579868,LIGM 5B,A00,507423,Fischer-Grunski; Eva K,20,0,20,0
1713314580894,LIGM 5C,A00,507425,Fischer-Grunski; Eva K,20,0,20,0
1713314581923,LIIT 5AS,A00,507427,Carnelos; Chiara,20,0,20,0
1713314582953,LIIT 5BS,A00,507430,Carnelos; Chiara,20,0,20,0
1713314583977,LIIT 5CS,A00,507432,Carnelos; Chiara,20,0,20,0
1713314585002,LISP 5A,A00,507541,Munoz Sanchez; Alicia,19,0,20,1
1713314586028,LISP 5B,A00,507671,Munoz Sanchez; Alicia,17,0,20,3
1713314587052,LISP 5C,A00,507696,Munoz Sanchez; Alicia,17,0,20,3
1713314588078,MAE 197,001,528363,Boechler; Nicholas Sebastia,9998,0,9999,1
1713314589103,MATH 197,001,523477,Kedlaya; Kiran S.,9999,0,9999,0
1713314589103,MATH 197,002,563811,Zhang; Danna,9999,0,9999,0
1713314590131,MCWP 40R,A00,518780,Staff,20,0,20,0
1713314590131,MCWP 40R,B00,518781,Staff,19,0,20,1
1713314590131,MCWP 40R,C00,518783,Staff,19,0,20,1
1713314591157,MCWP 50R,A00,518791,Staff,20,0,20,0
1713314591157,MCWP 50R,B00,518792,Staff,18,0,20,2
1713314591157,MCWP 50R,C00,518793,Staff,19,0,20,1
1713314591157,MCWP 50R,D00,518794,Staff,18,0,20,2
1713314591157,MCWP 50R,E00,518795,Staff,18,0,20,2
1713314591157,MCWP 50R,F00,518796,Staff,19,0,20,1
1713314591157,MCWP 50R,G00,518797,Staff,19,0,20,1
1713314592186,MMW 12R,A01,514034,Herbst; Matthew,16,0,16,0
1713314592186,MMW 12R,A02,514035,Herbst; Matthew,16,0,16,0
1713314593211,MMW 13R,A01,514037,Staff,12,0,16,4
1713314593211,MMW 13R,A02,514039,Staff,16,0,16,0
1713314595262,SIO 295LS,A00,523233,Staff,19,0,30,11
1713314596288,SIO 295S,A00,523232,Staff,19,0,30,11
1713314597421,SOCI 117,A01,494376,Staff,3,0,5,2
1713314598446,WES 237B,A00,494380,Staff,19,0,20,1
1713314600518,AESE 279B,A00,494370,Wade; Jon P,33,0,33,0
1713314601542,ANAR 135S,A00,494369,Braswell; Geoffrey E.,0,0,0,0
1713314602572,CAT 124RS,A01,519847,Geibel; William,17,0,20,3
1713314603596,CAT 125RS,A01,515971,Geibel; William,17,0,20,3
1713314604626,CLRE 250,A00,511389,Morris; Sheldon,9996,0,9999,3
1713314605658,CLRE 251,A00,507176,Mehta; Ravindra L.,9996,0,9999,3
1713314605658,CLRE 251,B00,511410,Mehta; Ravindra L.,9998,0,9999,1
1713314606685,CLRE 252,A00,507189,Cuomo; Raphael Eduardo,9998,0,9999,1
1713314607714,CLRE 253,A00,507199,Vaida; Florin,9997,0,9999,2
1713314607714,CLRE 253,B00,507202,Vaida; Florin,9999,0,9999,0
1713314608741,CLRE 259,A00,507211,Patel; Hemal,9996,0,9999,3
1713314609769,CLRE 260,A00,507221,Cuomo; Raphael Eduardo,9999,0,9999,0
1713314610795,CLRE 297,001,507242,Cuomo; Raphael Eduardo,9999,0,9999,0
1713314611824,CSE 191,A00,516875,Minnes Kemp; Mor Mia,9999,0,9999,0
1713314612850,CSS 201S,A01,494383,Staff,35,0,35,0
1713314613875,CSS 202S,A01,494387,Staff,35,0,35,0
1713314614898,EAP 100,A00,516065,Staff,9792,0,9999,207
1713314615924,ECE 45,A01,507414,Staff,54,0,60,6
1713314616955,ECE 100,A01,507416,Baghdadchi; Saharnaz,11,0,20,9
1713314616955,ECE 100,A02,507418,Baghdadchi; Saharnaz,20,0,20,0
1713314617980,ECE 111,A01,507420,Staff,40,0,50,10
1713314619010,ECE 197,001,548057,Sievenpiper; Daniel F.,9998,0,9999,1
1713314620036,EDS 115,A00,507243,Choi; Bailey Miyeon,28,0,28,0
1713314621065,EDS 117,A01,494379,Staff,24,0,25,1
1713314622089,EDS 125,A00,507246,Hopkins; Megan Beth,29,0,30,1
1713314623115,EDS 128A,A01,507264,Fargason; Sharon Gayle,26,0,26,0
1713314624141,EDS 128B,A01,507293,Pappas; Elizabeth,30,0,30,0
1713314625222,EDS 139,A00,507294,Fargason; Sharon Gayle,30,0,30,0
1713314625222,EDS 139,B00,507313,Pappas; Elizabeth,30,0,30,0
1713314626250,EDS 201,A00,507315,Staff,26,0,30,4
1713314627274,EDS 203,A01,507317,Halter; Christopher P.,26,0,30,4
1713314628304,EDS 204R,A01,507319,Halter; Christopher P.,4,0,30,26
1713314628304,EDS 204R,B01,507331,Heinzman; Erica M.,28,0,30,2
1713314629333,EDS 206R,A00,507332,Staff,5,0,30,25
1713314629333,EDS 206R,B00,507343,Staff,28,0,30,2
1713314630357,EDS 250,A00,507344,Hemans; Patricia Ann Benitez,36,0,40,4
1713314631386,EDS 281,A00,507345,Daly; Alan J.,18,0,18,0
1713314632413,EDS 284,A00,507350,Daly; Alan J.,16,0,16,0
1713314633443,EDS 286,A00,507359,Fine; Sarah,18,0,18,0
1713314634467,EDS 289C,A01,507361,Daly; Alan J.,18,0,18,0
1713314635493,EDS 290,A00,507366,Hofstetter; Carolyn,15,0,15,0
1713314636520,LIGM 5A,A00,507421,Fischer-Grunski; Eva K,20,0,20,0
1713314637545,LIGM 5B,A00,507423,Fischer-Grunski; Eva K,20,0,20,0
1713314638573,LIGM 5C,A00,507425,Fischer-Grunski; Eva K,20,0,20,0
1713314639603,LIIT 5AS,A00,507427,Carnelos; Chiara,20,0,20,0
1713314640633,LIIT 5BS,A00,507430,Carnelos; Chiara,20,0,20,0
1713314641659,LIIT 5CS,A00,507432,Carnelos; Chiara,20,0,20,0
1713314642685,LISP 5A,A00,507541,Munoz Sanchez; Alicia,19,0,20,1
1713314643715,LISP 5B,A00,507671,Munoz Sanchez; Alicia,17,0,20,3
1713314644740,LISP 5C,A00,507696,Munoz Sanchez; Alicia,17,0,20,3
1713314645765,MAE 197,001,528363,Boechler; Nicholas Sebastia,9998,0,9999,1
1713314646790,MATH 197,001,523477,Kedlaya; Kiran S.,9999,0,9999,0
1713314646790,MATH 197,002,563811,Zhang; Danna,9999,0,9999,0
1713314647815,MCWP 40R,A00,518780,Staff,20,0,20,0
1713314647815,MCWP 40R,B00,518781,Staff,19,0,20,1
1713314647815,MCWP 40R,C00,518783,Staff,19,0,20,1
1713314648847,MCWP 50R,A00,518791,Staff,20,0,20,0
1713314648847,MCWP 50R,B00,518792,Staff,18,0,20,2
1713314648847,MCWP 50R,C00,518793,Staff,19,0,20,1
1713314648847,MCWP 50R,D00,518794,Staff,18,0,20,2
1713314648847,MCWP 50R,E00,518795,Staff,18,0,20,2
1713314648847,MCWP 50R,F00,518796,Staff,19,0,20,1
1713314648847,MCWP 50R,G00,518797,Staff,19,0,20,1
1713314649880,MMW 12R,A01,514034,Herbst; Matthew,16,0,16,0
1713314649880,MMW 12R,A02,514035,Herbst; Matthew,16,0,16,0
1713314650904,MMW 13R,A01,514037,Staff,12,0,16,4
1713314650904,MMW 13R,A02,514039,Staff,16,0,16,0
1713314652953,SIO 295LS,A00,523233,Staff,19,0,30,11
1713314653979,SIO 295S,A00,523232,Staff,19,0,30,11
1713314655004,SOCI 117,A01,494376,Staff,3,0,5,2
1713314656029,WES 237B,A00,494380,Staff,19,0,20,1
1713314658103,AESE 279B,A00,494370,Wade; Jon P,33,0,33,0
1713314659128,ANAR 135S,A00,494369,Braswell; Geoffrey E.,0,0,0,0
1713314660157,CAT 124RS,A01,519847,Geibel; William,17,0,20,3
1713314661182,CAT 125RS,A01,515971,Geibel; William,17,0,20,3
1713314662210,CLRE 250,A00,511389,Morris; Sheldon,9996,0,9999,3
1713314663235,CLRE 251,A00,507176,Mehta; Ravindra L.,9996,0,9999,3
1713314663235,CLRE 251,B00,511410,Mehta; Ravindra L.,9998,0,9999,1
1713314664260,CLRE 252,A00,507189,Cuomo; Raphael Eduardo,9998,0,9999,1
1713314665286,CLRE 253,A00,507199,Vaida; Florin,9997,0,9999,2
1713314665286,CLRE 253,B00,507202,Vaida; Florin,9999,0,9999,0
1713314666313,CLRE 259,A00,507211,Patel; Hemal,9996,0,9999,3
1713314667338,CLRE 260,A00,507221,Cuomo; Raphael Eduardo,9999,0,9999,0
1713314668361,CLRE 297,001,507242,Cuomo; Raphael Eduardo,9999,0,9999,0
1713314669388,CSE 191,A00,516875,Minnes Kemp; Mor Mia,9999,0,9999,0
1713314670420,CSS 201S,A01,494383,Staff,35,0,35,0
1713314671450,CSS 202S,A01,494387,Staff,35,0,35,0
1713314672475,EAP 100,A00,516065,Staff,9792,0,9999,207
1713314673500,ECE 45,A01,507414,Staff,54,0,60,6
1713314674526,ECE 100,A01,507416,Baghdadchi; Saharnaz,11,0,20,9
1713314674526,ECE 100,A02,507418,Baghdadchi; Saharnaz,20,0,20,0
1713314675551,ECE 111,A01,507420,Staff,40,0,50,10
1713314676576,ECE 197,001,548057,Sievenpiper; Daniel F.,9998,0,9999,1
1713314677603,EDS 115,A00,507243,Choi; Bailey Miyeon,28,0,28,0
1713314678630,EDS 117,A01,494379,Staff,24,0,25,1
1713314679655,EDS 125,A00,507246,Hopkins; Megan Beth,29,0,30,1
1713314680678,EDS 128A,A01,507264,Fargason; Sharon Gayle,26,0,26,0
1713314681704,EDS 128B,A01,507293,Pappas; Elizabeth,30,0,30,0
1713314682728,EDS 139,A00,507294,Fargason; Sharon Gayle,30,0,30,0
1713314682728,EDS 139,B00,507313,Pappas; Elizabeth,30,0,30,0
1713314683753,EDS 201,A00,507315,Staff,26,0,30,4
1713314684779,EDS 203,A01,507317,Halter; Christopher P.,26,0,30,4
1713314685804,EDS 204R,A01,507319,Halter; Christopher P.,4,0,30,26
1713314685804,EDS 204R,B01,507331,Heinzman; Erica M.,28,0,30,2
1713314686829,EDS 206R,A00,507332,Staff,5,0,30,25
1713314686829,EDS 206R,B00,507343,Staff,28,0,30,2
1713314687854,EDS 250,A00,507344,Hemans; Patricia Ann Benitez,36,0,40,4
1713314688883,EDS 281,A00,507345,Daly; Alan J.,18,0,18,0
1713314689907,EDS 284,A00,507350,Daly; Alan J.,16,0,16,0
1713314690936,EDS 286,A00,507359,Fine; Sarah,18,0,18,0
1713314691960,EDS 289C,A01,507361,Daly; Alan J.,18,0,18,0
1713314692985,EDS 290,A00,507366,Hofstetter; Carolyn,15,0,15,0
1713314694016,LIGM 5A,A00,507421,Fischer-Grunski; Eva K,20,0,20,0
1713314695042,LIGM 5B,A00,507423,Fischer-Grunski; Eva K,20,0,20,0
1713314696070,LIGM 5C,A00,507425,Fischer-Grunski; Eva K,20,0,20,0
1713314697113,LIIT 5AS,A00,507427,Carnelos; Chiara,20,0,20,0
1713314698137,LIIT 5BS,A00,507430,Carnelos; Chiara,20,0,20,0
1713314699166,LIIT 5CS,A00,507432,Carnelos; Chiara,20,0,20,0
1713314700193,LISP 5A,A00,507541,Munoz Sanchez; Alicia,19,0,20,1
1713314701219,LISP 5B,A00,507671,Munoz Sanchez; Alicia,17,0,20,3
1713314702246,LISP 5C,A00,507696,Munoz Sanchez; Alicia,17,0,20,3
1713314703275,MAE 197,001,528363,Boechler; Nicholas Sebastia,9998,0,9999,1
1713314704301,MATH 197,001,523477,Kedlaya; Kiran S.,9999,0,9999,0
1713314704301,MATH 197,002,563811,Zhang; Danna,9999,0,9999,0
1713314705329,MCWP 40R,A00,518780,Staff,20,0,20,0
1713314705329,MCWP 40R,B00,518781,Staff,19,0,20,1
1713314705329,MCWP 40R,C00,518783,Staff,19,0,20,1
1713314706357,MCWP 50R,A00,518791,Staff,20,0,20,0
1713314706357,MCWP 50R,B00,518792,Staff,18,0,20,2
1713314706357,MCWP 50R,C00,518793,Staff,19,0,20,1
1713314706357,MCWP 50R,D00,518794,Staff,18,0,20,2
1713314706357,MCWP 50R,E00,518795,Staff,18,0,20,2
1713314706357,MCWP 50R,F00,518796,Staff,19,0,20,1
1713314706357,MCWP 50R,G00,518797,Staff,19,0,20,1
1713314707382,MMW 12R,A01,514034,Herbst; Matthew,16,0,16,0
1713314707382,MMW 12R,A02,514035,Herbst; Matthew,16,0,16,0
1713314708407,MMW 13R,A01,514037,Staff,12,0,16,4
1713314708407,MMW 13R,A02,514039,Staff,16,0,16,0
1713314710456,SIO 295LS,A00,523233,Staff,19,0,30,11
1713314711482,SIO 295S,A00,523232,Staff,19,0,30,11
1713314712506,SOCI 117,A01,494376,Staff,3,0,5,2
1713314713531,WES 237B,A00,494380,Staff,19,0,20,1
1713314715597,AESE 279B,A00,494370,Wade; Jon P,33,0,33,0
1713314716625,ANAR 135S,A00,494369,Braswell; Geoffrey E.,0,0,0,0
1713314717651,CAT 124RS,A01,519847,Geibel; William,17,0,20,3
1713314718677,CAT 125RS,A01,515971,Geibel; William,17,0,20,3
1713314719702,CLRE 250,A00,511389,Morris; Sheldon,9996,0,9999,3
1713314720735,CLRE 251,A00,507176,Mehta; Ravindra L.,9996,0,9999,3
1713314720735,CLRE 251,B00,511410,Mehta; Ravindra L.,9998,0,9999,1
1713314721760,CLRE 252,A00,507189,Cuomo; Raphael Eduardo,9998,0,9999,1
1713314722786,CLRE 253,A00,507199,Vaida; Florin,9997,0,9999,2
1713314722786,CLRE 253,B00,507202,Vaida; Florin,9999,0,9999,0
1713314723811,CLRE 259,A00,507211,Patel; Hemal,9996,0,9999,3
1713314724840,CLRE 260,A00,507221,Cuomo; Raphael Eduardo,9999,0,9999,0
1713314725866,CLRE 297,001,507242,Cuomo; Raphael Eduardo,9999,0,9999,0
1713314726894,CSE 191,A00,516875,Minnes Kemp; Mor Mia,9999,0,9999,0
1713314727919,CSS 201S,A01,494383,Staff,35,0,35,0
1713314729001,CSS 202S,A01,494387,Staff,35,0,35,0
1713314730030,EAP 100,A00,516065,Staff,9792,0,9999,207
1713314731055,ECE 45,A01,507414,Staff,54,0,60,6
1713314732084,ECE 100,A01,507416,Baghdadchi; Saharnaz,11,0,20,9
1713314732084,ECE 100,A02,507418,Baghdadchi; Saharnaz,20,0,20,0
1713314733109,ECE 111,A01,507420,Staff,40,0,50,10
1713314734134,ECE 197,001,548057,Sievenpiper; Daniel F.,9998,0,9999,1
1713314735161,EDS 115,A00,507243,Choi; Bailey Miyeon,28,0,28,0
1713314736293,EDS 117,A01,494379,Staff,24,0,25,1
1713314737319,EDS 125,A00,507246,Hopkins; Megan Beth,29,0,30,1
1713314738345,EDS 128A,A01,507264,Fargason; Sharon Gayle,26,0,26,0
1713314739374,EDS 128B,A01,507293,Pappas; Elizabeth,30,0,30,0
1713314740402,EDS 139,A00,507294,Fargason; Sharon Gayle,30,0,30,0
1713314740402,EDS 139,B00,507313,Pappas; Elizabeth,30,0,30,0
1713314741426,EDS 201,A00,507315,Staff,26,0,30,4
1713314742450,EDS 203,A01,507317,Halter; Christopher P.,26,0,30,4
1713314743477,EDS 204R,A01,507319,Halter; Christopher P.,4,0,30,26
1713314743477,EDS 204R,B01,507331,Heinzman; Erica M.,28,0,30,2
1713314744502,EDS 206R,A00,507332,Staff,5,0,30,25
1713314744502,EDS 206R,B00,507343,Staff,28,0,30,2
1713314745528,EDS 250,A00,507344,Hemans; Patricia Ann Benitez,36,0,40,4
1713314746554,EDS 281,A00,507345,Daly; Alan J.,18,0,18,0
1713314747580,EDS 284,A00,507350,Daly; Alan J.,16,0,16,0
1713314748606,EDS 286,A00,507359,Fine; Sarah,18,0,18,0
1713314749636,EDS 289C,A01,507361,Daly; Alan J.,18,0,18,0
1713314750662,EDS 290,A00,507366,Hofstetter; Carolyn,15,0,15,0
1713314751687,LIGM 5A,A00,507421,Fischer-Grunski; Eva K,20,0,20,0
1713314752720,LIGM 5B,A00,507423,Fischer-Grunski; Eva K,20,0,20,0
1713314753746,LIGM 5C,A00,507425,Fischer-Grunski; Eva K,20,0,20,0
1713314754771,LIIT 5AS,A00,507427,Carnelos; Chiara,20,0,20,0
1713314755796,LIIT 5BS,A00,507430,Carnelos; Chiara,20,0,20,0
1713314756821,LIIT 5CS,A00,507432,Carnelos; Chiara,20,0,20,0
1713314757851,LISP 5A,A00,507541,Munoz Sanchez; Alicia,19,0,20,1
1713314758880,LISP 5B,A00,507671,Munoz Sanchez; Alicia,17,0,20,3
1713314759907,LISP 5C,A00,507696,Munoz Sanchez; Alicia,17,0,20,3
1713314760933,MAE 197,001,528363,Boechler; Nicholas Sebastia,9998,0,9999,1
1713314761960,MATH 197,001,523477,Kedlaya; Kiran S.,9999,0,9999,0
1713314761960,MATH 197,002,563811,Zhang; Danna,9999,0,9999,0
1713314762989,MCWP 40R,A00,518780,Staff,20,0,20,0
1713314762989,MCWP 40R,B00,518781,Staff,19,0,20,1
1713314762989,MCWP 40R,C00,518783,Staff,19,0,20,1
1713314764021,MCWP 50R,A00,518791,Staff,20,0,20,0
1713314764021,MCWP 50R,B00,518792,Staff,18,0,20,2
1713314764021,MCWP 50R,C00,518793,Staff,19,0,20,1
1713314764021,MCWP 50R,D00,518794,Staff,18,0,20,2
1713314764021,MCWP 50R,E00,518795,Staff,18,0,20,2
1713314764021,MCWP 50R,F00,518796,Staff,19,0,20,1
1713314764021,MCWP 50R,G00,518797,Staff,19,0,20,1
1713314765045,MMW 12R,A01,514034,Herbst; Matthew,16,0,16,0
1713314765045,MMW 12R,A02,514035,Herbst; Matthew,16,0,16,0
1713314766081,MMW 13R,A01,514037,Staff,12,0,16,4
1713314766081,MMW 13R,A02,514039,Staff,16,0,16,0
1713314768146,SIO 295LS,A00,523233,Staff,19,0,30,11
1713314769171,SIO 295S,A00,523232,Staff,19,0,30,11
1713314770203,SOCI 117,A01,494376,Staff,3,0,5,2
1713314771234,WES 237B,A00,494380,Staff,19,0,20,1
1713314773311,AESE 279B,A00,494370,Wade; Jon P,33,0,33,0
1713314774335,ANAR 135S,A00,494369,Braswell; Geoffrey E.,0,0,0,0
1713314775362,CAT 124RS,A01,519847,Geibel; William,17,0,20,3
1713314776386,CAT 125RS,A01,515971,Geibel; William,17,0,20,3
1713314777412,CLRE 250,A00,511389,Morris; Sheldon,9996,0,9999,3
1713314778438,CLRE 251,A00,507176,Mehta; Ravindra L.,9996,0,9999,3
1713314778438,CLRE 251,B00,511410,Mehta; Ravindra L.,9998,0,9999,1
1713314779465,CLRE 252,A00,507189,Cuomo; Raphael Eduardo,9998,0,9999,1
1713314780490,CLRE 253,A00,507199,Vaida; Florin,9997,0,9999,2
1713314780490,CLRE 253,B00,507202,Vaida; Florin,9999,0,9999,0
1713314781518,CLRE 259,A00,507211,Patel; Hemal,9996,0,9999,3
1713314782547,CLRE 260,A00,507221,Cuomo; Raphael Eduardo,9999,0,9999,0
1713314783570,CLRE 297,001,507242,Cuomo; Raphael Eduardo,9999,0,9999,0
1713314784596,CSE 191,A00,516875,Minnes Kemp; Mor Mia,9999,0,9999,0
1713314785621,CSS 201S,A01,494383,Staff,35,0,35,0
1713314786651,CSS 202S,A01,494387,Staff,35,0,35,0
1713314787675,EAP 100,A00,516065,Staff,9792,0,9999,207
1713314788701,ECE 45,A01,507414,Staff,54,0,60,6
1713314789727,ECE 100,A01,507416,Baghdadchi; Saharnaz,11,0,20,9
1713314789727,ECE 100,A02,507418,Baghdadchi; Saharnaz,20,0,20,0
1713314790750,ECE 111,A01,507420,Staff,40,0,50,10
1713314791777,ECE 197,001,548057,Sievenpiper; Daniel F.,9998,0,9999,1
1713314792804,EDS 115,A00,507243,Choi; Bailey Miyeon,28,0,28,0
1713314793829,EDS 117,A01,494379,Staff,24,0,25,1
1713314794856,EDS 125,A00,507246,Hopkins; Megan Beth,29,0,30,1
1713314795887,EDS 128A,A01,507264,Fargason; Sharon Gayle,26,0,26,0
1713314796913,EDS 128B,A01,507293,Pappas; Elizabeth,30,0,30,0
1713314797942,EDS 139,A00,507294,Fargason; Sharon Gayle,30,0,30,0
1713314797942,EDS 139,B00,507313,Pappas; Elizabeth,30,0,30,0
1713314798968,EDS 201,A00,507315,Staff,26,0,30,4
1713314799998,EDS 203,A01,507317,Halter; Christopher P.,26,0,30,4
1713314801024,EDS 204R,A01,507319,Halter; Christopher P.,4,0,30,26
1713314801024,EDS 204R,B01,507331,Heinzman; Erica M.,28,0,30,2
1713314802049,EDS 206R,A00,507332,Staff,5,0,30,25
1713314802049,EDS 206R,B00,507343,Staff,28,0,30,2
1713314803076,EDS 250,A00,507344,Hemans; Patricia Ann Benitez,36,0,40,4
1713314804105,EDS 281,A00,507345,Daly; Alan J.,18,0,18,0
1713314805130,EDS 284,A00,507350,Daly; Alan J.,16,0,16,0
1713314806156,EDS 286,A00,507359,Fine; Sarah,18,0,18,0
1713314807185,EDS 289C,A01,507361,Daly; Alan J.,18,0,18,0
1713314808212,EDS 290,A00,507366,Hofstetter; Carolyn,15,0,15,0
1713314809242,LIGM 5A,A00,507421,Fischer-Grunski; Eva K,20,0,20,0
1713314810273,LIGM 5B,A00,507423,Fischer-Grunski; Eva K,20,0,20,0
1713314811301,LIGM 5C,A00,507425,Fischer-Grunski; Eva K,20,0,20,0
1713314812328,LIIT 5AS,A00,507427,Carnelos; Chiara,20,0,20,0
1713314813354,LIIT 5BS,A00,507430,Carnelos; Chiara,20,0,20,0
1713314814379,LIIT 5CS,A00,507432,Carnelos; Chiara,20,0,20,0
1713314815410,LISP 5A,A00,507541,Munoz Sanchez; Alicia,19,0,20,1
1713314816441,LISP 5B,A00,507671,Munoz Sanchez; Alicia,17,0,20,3
1713314817468,LISP 5C,A00,507696,Munoz Sanchez; Alicia,17,0,20,3
1713314818497,MAE 197,001,528363,Boechler; Nicholas Sebastia,9998,0,9999,1
1713314819523,MATH 197,001,523477,Kedlaya; Kiran S.,9999,0,9999,0
1713314819523,MATH 197,002,563811,Zhang; Danna,9999,0,9999,0
1713314820549,MCWP 40R,A00,518780,Staff,20,0,20,0
1713314820549,MCWP 40R,B00,518781,Staff,19,0,20,1
1713314820549,MCWP 40R,C00,518783,Staff,19,0,20,1
1713314821580,MCWP 50R,A00,518791,Staff,20,0,20,0
1713314821580,MCWP 50R,B00,518792,Staff,18,0,20,2
1713314821580,MCWP 50R,C00,518793,Staff,19,0,20,1
1713314821580,MCWP 50R,D00,518794,Staff,18,0,20,2
1713314821580,MCWP 50R,E00,518795,Staff,18,0,20,2
1713314821580,MCWP 50R,F00,518796,Staff,19,0,20,1
1713314821580,MCWP 50R,G00,518797,Staff,19,0,20,1
1713314822607,MMW 12R,A01,514034,Herbst; Matthew,15,0,16,1
1713314822607,MMW 12R,A02,514035,Herbst; Matthew,16,0,16,0
1713314823632,MMW 13R,A01,514037,Staff,12,0,16,4
1713314823632,MMW 13R,A02,514039,Staff,16,0,16,0
1713314825686,SIO 295LS,A00,523233,Staff,19,0,30,11
1713314826713,SIO 295S,A00,523232,Staff,19,0,30,11
1713314827740,SOCI 117,A01,494376,Staff,3,0,5,2
1713314828765,WES 237B,A00,494380,Staff,19,0,20,1
1713314830830,AESE 279B,A00,494370,Wade; Jon P,33,0,33,0
1713314831856,ANAR 135S,A00,494369,Braswell; Geoffrey E.,0,0,0,0
1713314832936,CAT 124RS,A01,519847,Geibel; William,17,0,20,3
1713314833962,CAT 125RS,A01,515971,Geibel; William,17,0,20,3
1713314834987,CLRE 250,A00,511389,Morris; Sheldon,9996,0,9999,3
1713314836015,CLRE 251,A00,507176,Mehta; Ravindra L.,9996,0,9999,3
1713314836015,CLRE 251,B00,511410,Mehta; Ravindra L.,9998,0,9999,1
1713314837045,CLRE 252,A00,507189,Cuomo; Raphael Eduardo,9998,0,9999,1
1713314838077,CLRE 253,A00,507199,Vaida; Florin,9997,0,9999,2
1713314838077,CLRE 253,B00,507202,Vaida; Florin,9999,0,9999,0
1713314839107,CLRE 259,A00,507211,Patel; Hemal,9996,0,9999,3
1713314840132,CLRE 260,A00,507221,Cuomo; Raphael Eduardo,9999,0,9999,0
1713314841160,CLRE 297,001,507242,Cuomo; Raphael Eduardo,9999,0,9999,0
1713314842188,CSE 191,A00,516875,Minnes Kemp; Mor Mia,9999,0,9999,0
1713314843217,CSS 201S,A01,494383,Staff,35,0,35,0
1713314844248,CSS 202S,A01,494387,Staff,35,0,35,0
1713314845276,EAP 100,A00,516065,Staff,9792,0,9999,207
1713314846304,ECE 45,A01,507414,Staff,54,0,60,6
1713314847330,ECE 100,A01,507416,Baghdadchi; Saharnaz,11,0,20,9
1713314847330,ECE 100,A02,507418,Baghdadchi; Saharnaz,20,0,20,0
1713314848355,ECE 111,A01,507420,Staff,40,0,50,10
1713314849384,ECE 197,001,548057,Sievenpiper; Daniel F.,9998,0,9999,1
1713314850409,EDS 115,A00,507243,Choi; Bailey Miyeon,28,0,28,0
1713314851437,EDS 117,A01,494379,Staff,24,0,25,1
1713314852463,EDS 125,A00,507246,Hopkins; Megan Beth,29,0,30,1
1713314853494,EDS 128A,A01,507264,Fargason; Sharon Gayle,26,0,26,0
1713314854519,EDS 128B,A01,507293,Pappas; Elizabeth,30,0,30,0
1713314855549,EDS 139,A00,507294,Fargason; Sharon Gayle,30,0,30,0
1713314855549,EDS 139,B00,507313,Pappas; Elizabeth,30,0,30,0
1713314856576,EDS 201,A00,507315,Staff,26,0,30,4
1713314857602,EDS 203,A01,507317,Halter; Christopher P.,26,0,30,4
1713314858628,EDS 204R,A01,507319,Halter; Christopher P.,4,0,30,26
1713314858628,EDS 204R,B01,507331,Heinzman; Erica M.,28,0,30,2
1713314859656,EDS 206R,A00,507332,Staff,5,0,30,25
1713314859656,EDS 206R,B00,507343,Staff,28,0,30,2
1713314860681,EDS 250,A00,507344,Hemans; Patricia Ann Benitez,36,0,40,4
1713314861707,EDS 281,A00,507345,Daly; Alan J.,18,0,18,0
1713314862731,EDS 284,A00,507350,Daly; Alan J.,16,0,16,0
1713314863756,EDS 286,A00,507359,Fine; Sarah,18,0,18,0
1713314864783,EDS 289C,A01,507361,Daly; Alan J.,18,0,18,0
1713314865810,EDS 290,A00,507366,Hofstetter; Carolyn,15,0,15,0
1713314866835,LIGM 5A,A00,507421,Fischer-Grunski; Eva K,20,0,20,0
1713314867860,LIGM 5B,A00,507423,Fischer-Grunski; Eva K,20,0,20,0
1713314868889,LIGM 5C,A00,507425,Fischer-Grunski; Eva K,20,0,20,0
1713314869920,LIIT 5AS,A00,507427,Carnelos; Chiara,20,0,20,0
1713314870944,LIIT 5BS,A00,507430,Carnelos; Chiara,20,0,20,0
1713314871969,LIIT 5CS,A00,507432,Carnelos; Chiara,20,0,20,0
1713314872995,LISP 5A,A00,507541,Munoz Sanchez; Alicia,19,0,20,1
1713314874019,LISP 5B,A00,507671,Munoz Sanchez; Alicia,17,0,20,3
1713314875049,LISP 5C,A00,507696,Munoz Sanchez; Alicia,17,0,20,3
1713314876072,MAE 197,001,528363,Boechler; Nicholas Sebastia,9998,0,9999,1
1713314877102,MATH 197,001,523477,Kedlaya; Kiran S.,9999,0,9999,0
1713314877102,MATH 197,002,563811,Zhang; Danna,9999,0,9999,0
1713314878127,MCWP 40R,A00,518780,Staff,20,0,20,0
1713314878127,MCWP 40R,B00,518781,Staff,19,0,20,1
1713314878127,MCWP 40R,C00,518783,Staff,19,0,20,1
1713314879153,MCWP 50R,A00,518791,Staff,20,0,20,0
1713314879153,MCWP 50R,B00,518792,Staff,18,0,20,2
1713314879153,MCWP 50R,C00,518793,Staff,19,0,20,1
1713314879153,MCWP 50R,D00,518794,Staff,18,0,20,2
1713314879153,MCWP 50R,E00,518795,Staff,18,0,20,2
1713314879153,MCWP 50R,F00,518796,Staff,19,0,20,1
1713314879153,MCWP 50R,G00,518797,Staff,19,0,20,1
1713314880179,MMW 12R,A01,514034,Herbst; Matthew,15,0,16,1
1713314880179,MMW 12R,A02,514035,Herbst; Matthew,16,0,16,0
1713314881203,MMW 13R,A01,514037,Staff,12,0,16,4
1713314881203,MMW 13R,A02,514039,Staff,16,0,16,0
1713314883260,SIO 295LS,A00,523233,Staff,19,0,30,11
1713314884285,SIO 295S,A00,523232,Staff,19,0,30,11
1713314885314,SOCI 117,A01,494376,Staff,3,0,5,2
1713314886338,WES 237B,A00,494380,Staff,19,0,20,1
1713314888410,AESE 279B,A00,494370,Wade; Jon P,33,0,33,0
1713314889437,ANAR 135S,A00,494369,Braswell; Geoffrey E.,0,0,0,0
1713314890465,CAT 124RS,A01,519847,Geibel; William,17,0,20,3
1713314891494,CAT 125RS,A01,515971,Geibel; William,17,0,20,3
1713314892519,CLRE 250,A00,511389,Morris; Sheldon,9996,0,9999,3
1713314893546,CLRE 251,A00,507176,Mehta; Ravindra L.,9996,0,9999,3
1713314893546,CLRE 251,B00,511410,Mehta; Ravindra L.,9998,0,9999,1
1713314894571,CLRE 252,A00,507189,Cuomo; Raphael Eduardo,9998,0,9999,1
1713314895596,CLRE 253,A00,507199,Vaida; Florin,9997,0,9999,2
1713314895596,CLRE 253,B00,507202,Vaida; Florin,9999,0,9999,0
1713314896622,CLRE 259,A00,507211,Patel; Hemal,9996,0,9999,3
1713314897648,CLRE 260,A00,507221,Cuomo; Raphael Eduardo,9999,0,9999,0
1713314898673,CLRE 297,001,507242,Cuomo; Raphael Eduardo,9999,0,9999,0
1713314899699,CSE 191,A00,516875,Minnes Kemp; Mor Mia,9999,0,9999,0
1713314900725,CSS 201S,A01,494383,Staff,35,0,35,0
1713314901754,CSS 202S,A01,494387,Staff,35,0,35,0
1713314902781,EAP 100,A00,516065,Staff,9792,0,9999,207
1713314903807,ECE 45,A01,507414,Staff,54,0,60,6
1713314904835,ECE 100,A01,507416,Baghdadchi; Saharnaz,11,0,20,9
1713314904835,ECE 100,A02,507418,Baghdadchi; Saharnaz,20,0,20,0
1713314905863,ECE 111,A01,507420,Staff,40,0,50,10
1713314906893,ECE 197,001,548057,Sievenpiper; Daniel F.,9998,0,9999,1
1713314907919,EDS 115,A00,507243,Choi; Bailey Miyeon,28,0,28,0
1713314908946,EDS 117,A01,494379,Staff,24,0,25,1
1713314909975,EDS 125,A00,507246,Hopkins; Megan Beth,29,0,30,1
1713314911000,EDS 128A,A01,507264,Fargason; Sharon Gayle,26,0,26,0
1713314912026,EDS 128B,A01,507293,Pappas; Elizabeth,30,0,30,0
1713314913057,EDS 139,A00,507294,Fargason; Sharon Gayle,30,0,30,0
1713314913057,EDS 139,B00,507313,Pappas; Elizabeth,30,0,30,0
1713314914085,EDS 201,A00,507315,Staff,26,0,30,4
1713314915111,EDS 203,A01,507317,Halter; Christopher P.,26,0,30,4
1713314916137,EDS 204R,A01,507319,Halter; Christopher P.,4,0,30,26
1713314916137,EDS 204R,B01,507331,Heinzman; Erica M.,28,0,30,2
1713314917165,EDS 206R,A00,507332,Staff,5,0,30,25
1713314917165,EDS 206R,B00,507343,Staff,28,0,30,2
1713314918191,EDS 250,A00,507344,Hemans; Patricia Ann Benitez,36,0,40,4
1713314919215,EDS 281,A00,507345,Daly; Alan J.,18,0,18,0
1713314920240,EDS 284,A00,507350,Daly; Alan J.,16,0,16,0
1713314921266,EDS 286,A00,507359,Fine; Sarah,18,0,18,0
1713314922289,EDS 289C,A01,507361,Daly; Alan J.,18,0,18,0
1713314923321,EDS 290,A00,507366,Hofstetter; Carolyn,15,0,15,0
1713314924348,LIGM 5A,A00,507421,Fischer-Grunski; Eva K,20,0,20,0
1713314925374,LIGM 5B,A00,507423,Fischer-Grunski; Eva K,20,0,20,0
1713314926402,LIGM 5C,A00,507425,Fischer-Grunski; Eva K,20,0,20,0
1713314927433,LIIT 5AS,A00,507427,Carnelos; Chiara,20,0,20,0
1713314928461,LIIT 5BS,A00,507430,Carnelos; Chiara,20,0,20,0
1713314929489,LIIT 5CS,A00,507432,Carnelos; Chiara,20,0,20,0
1713314930518,LISP 5A,A00,507541,Munoz Sanchez; Alicia,19,0,20,1
1713314931545,LISP 5B,A00,507671,Munoz Sanchez; Alicia,17,0,20,3
1713314932574,LISP 5C,A00,507696,Munoz Sanchez; Alicia,17,0,20,3
1713314933604,MAE 197,001,528363,Boechler; Nicholas Sebastia,9998,0,9999,1
1713314934629,MATH 197,001,523477,Kedlaya; Kiran S.,9999,0,9999,0
1713314934629,MATH 197,002,563811,Zhang; Danna,9999,0,9999,0
1713314935659,MCWP 40R,A00,518780,Staff,20,0,20,0
1713314935659,MCWP 40R,B00,518781,Staff,19,0,20,1
1713314935659,MCWP 40R,C00,518783,Staff,19,0,20,1
1713314936738,MCWP 50R,A00,518791,Staff,20,0,20,0
1713314936738,MCWP 50R,B00,518792,Staff,18,0,20,2
1713314936738,MCWP 50R,C00,518793,Staff,19,0,20,1
1713314936738,MCWP 50R,D00,518794,Staff,18,0,20,2
1713314936738,MCWP 50R,E00,518795,Staff,18,0,20,2
1713314936738,MCWP 50R,F00,518796,Staff,19,0,20,1
1713314936738,MCWP 50R,G00,518797,Staff,19,0,20,1
1713314937768,MMW 12R,A01,514034,Herbst; Matthew,15,0,16,1
1713314937768,MMW 12R,A02,514035,Herbst; Matthew,16,0,16,0
1713314938794,MMW 13R,A01,514037,Staff,12,0,16,4
1713314938794,MMW 13R,A02,514039,Staff,16,0,16,0
1713314940844,SIO 295LS,A00,523233,Staff,19,0,30,11
1713314941872,SIO 295S,A00,523232,Staff,19,0,30,11
1713314942897,SOCI 117,A01,494376,Staff,3,0,5,2
1713314943926,WES 237B,A00,494380,Staff,19,0,20,1
1713314945992,AESE 279B,A00,494370,Wade; Jon P,33,0,33,0
1713314947018,ANAR 135S,A00,494369,Braswell; Geoffrey E.,0,0,0,0
1713314948047,CAT 124RS,A01,519847,Geibel; William,17,0,20,3
1713314949072,CAT 125RS,A01,515971,Geibel; William,17,0,20,3
1713314950102,CLRE 250,A00,511389,Morris; Sheldon,9996,0,9999,3
1713314951127,CLRE 251,A00,507176,Mehta; Ravindra L.,9996,0,9999,3
1713314951127,CLRE 251,B00,511410,Mehta; Ravindra L.,9998,0,9999,1
1713314952157,CLRE 252,A00,507189,Cuomo; Raphael Eduardo,9998,0,9999,1
1713314953182,CLRE 253,A00,507199,Vaida; Florin,9997,0,9999,2
1713314953182,CLRE 253,B00,507202,Vaida; Florin,9999,0,9999,0
1713314954207,CLRE 259,A00,507211,Patel; Hemal,9996,0,9999,3
1713314955238,CLRE 260,A00,507221,Cuomo; Raphael Eduardo,9999,0,9999,0
1713314956263,CLRE 297,001,507242,Cuomo; Raphael Eduardo,9999,0,9999,0
1713314957291,CSE 191,A00,516875,Minnes Kemp; Mor Mia,9999,0,9999,0
1713314958316,CSS 201S,A01,494383,Staff,35,0,35,0
1713314959342,CSS 202S,A01,494387,Staff,35,0,35,0
1713314960367,EAP 100,A00,516065,Staff,9792,0,9999,207
1713314961392,ECE 45,A01,507414,Staff,54,0,60,6
1713314962418,ECE 100,A01,507416,Baghdadchi; Saharnaz,11,0,20,9
1713314962418,ECE 100,A02,507418,Baghdadchi; Saharnaz,20,0,20,0
1713314963445,ECE 111,A01,507420,Staff,40,0,50,10
1713314964470,ECE 197,001,548057,Sievenpiper; Daniel F.,9998,0,9999,1
1713314965499,EDS 115,A00,507243,Choi; Bailey Miyeon,28,0,28,0
1713314966529,EDS 117,A01,494379,Staff,24,0,25,1
1713314967555,EDS 125,A00,507246,Hopkins; Megan Beth,29,0,30,1
1713314968585,EDS 128A,A01,507264,Fargason; Sharon Gayle,26,0,26,0
1713314969611,EDS 128B,A01,507293,Pappas; Elizabeth,30,0,30,0
1713314970635,EDS 139,A00,507294,Fargason; Sharon Gayle,30,0,30,0
1713314970635,EDS 139,B00,507313,Pappas; Elizabeth,30,0,30,0
1713314971660,EDS 201,A00,507315,Staff,26,0,30,4
1713314972685,EDS 203,A01,507317,Halter; Christopher P.,26,0,30,4
1713314973709,EDS 204R,A01,507319,Halter; Christopher P.,4,0,30,26
1713314973709,EDS 204R,B01,507331,Heinzman; Erica M.,28,0,30,2
1713314974735,EDS 206R,A00,507332,Staff,5,0,30,25
1713314974735,EDS 206R,B00,507343,Staff,28,0,30,2
1713314975761,EDS 250,A00,507344,Hemans; Patricia Ann Benitez,36,0,40,4
1713314976786,EDS 281,A00,507345,Daly; Alan J.,18,0,18,0
1713314977812,EDS 284,A00,507350,Daly; Alan J.,16,0,16,0
1713314978838,EDS 286,A00,507359,Fine; Sarah,18,0,18,0
1713314979866,EDS 289C,A01,507361,Daly; Alan J.,18,0,18,0
1713314980891,EDS 290,A00,507366,Hofstetter; Carolyn,15,0,15,0
1713314981921,LIGM 5A,A00,507421,Fischer-Grunski; Eva K,20,0,20,0
1713314982956,LIGM 5B,A00,507423,Fischer-Grunski; Eva K,20,0,20,0
1713314983980,LIGM 5C,A00,507425,Fischer-Grunski; Eva K,20,0,20,0
1713314985005,LIIT 5AS,A00,507427,Carnelos; Chiara,20,0,20,0
1713314986031,LIIT 5BS,A00,507430,Carnelos; Chiara,20,0,20,0
1713314987057,LIIT 5CS,A00,507432,Carnelos; Chiara,20,0,20,0
1713314988085,LISP 5A,A00,507541,Munoz Sanchez; Alicia,19,0,20,1
1713314989111,LISP 5B,A00,507671,Munoz Sanchez; Alicia,17,0,20,3
1713314990141,LISP 5C,A00,507696,Munoz Sanchez; Alicia,17,0,20,3
1713314991168,MAE 197,001,528363,Boechler; Nicholas Sebastia,9998,0,9999,1
1713314992193,MATH 197,001,523477,Kedlaya; Kiran S.,9999,0,9999,0
1713314992193,MATH 197,002,563811,Zhang; Danna,9999,0,9999,0
1713314993217,MCWP 40R,A00,518780,Staff,20,0,20,0
1713314993217,MCWP 40R,B00,518781,Staff,19,0,20,1
1713314993217,MCWP 40R,C00,518783,Staff,19,0,20,1
1713314994242,MCWP 50R,A00,518791,Staff,20,0,20,0
1713314994242,MCWP 50R,B00,518792,Staff,18,0,20,2
1713314994242,MCWP 50R,C00,518793,Staff,19,0,20,1
1713314994242,MCWP 50R,D00,518794,Staff,18,0,20,2
1713314994242,MCWP 50R,E00,518795,Staff,18,0,20,2
1713314994242,MCWP 50R,F00,518796,Staff,19,0,20,1
1713314994242,MCWP 50R,G00,518797,Staff,19,0,20,1
1713314995266,MMW 12R,A01,514034,Herbst; Matthew,15,0,16,1
1713314995266,MMW 12R,A02,514035,Herbst; Matthew,16,0,16,0
1713314996291,MMW 13R,A01,514037,Staff,12,0,16,4
1713314996291,MMW 13R,A02,514039,Staff,16,0,16,0
1713314998343,SIO 295LS,A00,523233,Staff,19,0,30,11
1713314999368,SIO 295S,A00,523232,Staff,19,0,30,11
1713315000393,SOCI 117,A01,494376,Staff,3,0,5,2
1713315001423,WES 237B,A00,494380,Staff,19,0,20,1
1713315003493,AESE 279B,A00,494370,Wade; Jon P,33,0,33,0
1713315004519,ANAR 135S,A00,494369,Braswell; Geoffrey E.,0,0,0,0
1713315005546,CAT 124RS,A01,519847,Geibel; William,17,0,20,3
1713315006573,CAT 125RS,A01,515971,Geibel; William,17,0,20,3
1713315007599,CLRE 250,A00,511389,Morris; Sheldon,9996,0,9999,3
1713315008625,CLRE 251,A00,507176,Mehta; Ravindra L.,9996,0,9999,3
1713315008625,CLRE 251,B00,511410,Mehta; Ravindra L.,9998,0,9999,1
1713315009655,CLRE 252,A00,507189,Cuomo; Raphael Eduardo,9998,0,9999,1
1713315010685,CLRE 253,A00,507199,Vaida; Florin,9997,0,9999,2
1713315010685,CLRE 253,B00,507202,Vaida; Florin,9999,0,9999,0
1713315011717,CLRE 259,A00,507211,Patel; Hemal,9996,0,9999,3
1713315012744,CLRE 260,A00,507221,Cuomo; Raphael Eduardo,9999,0,9999,0
1713315013769,CLRE 297,001,507242,Cuomo; Raphael Eduardo,9999,0,9999,0
1713315014797,CSE 191,A00,516875,Minnes Kemp; Mor Mia,9999,0,9999,0
1713315015821,CSS 201S,A01,494383,Staff,35,0,35,0
1713315016850,CSS 202S,A01,494387,Staff,35,0,35,0
1713315017876,EAP 100,A00,516065,Staff,9792,0,9999,207
1713315018901,ECE 45,A01,507414,Staff,54,0,60,6
1713315019934,ECE 100,A01,507416,Baghdadchi; Saharnaz,11,0,20,9
1713315019934,ECE 100,A02,507418,Baghdadchi; Saharnaz,20,0,20,0
1713315020960,ECE 111,A01,507420,Staff,40,0,50,10
1713315021986,ECE 197,001,548057,Sievenpiper; Daniel F.,9998,0,9999,1
1713315023019,EDS 115,A00,507243,Choi; Bailey Miyeon,28,0,28,0
1713315024043,EDS 117,A01,494379,Staff,24,0,25,1
1713315025073,EDS 125,A00,507246,Hopkins; Megan Beth,29,0,30,1
1713315026100,EDS 128A,A01,507264,Fargason; Sharon Gayle,26,0,26,0
1713315027126,EDS 128B,A01,507293,Pappas; Elizabeth,30,0,30,0
1713315028155,EDS 139,A00,507294,Fargason; Sharon Gayle,30,0,30,0
1713315028155,EDS 139,B00,507313,Pappas; Elizabeth,30,0,30,0
1713315029182,EDS 201,A00,507315,Staff,26,0,30,4
1713315030206,EDS 203,A01,507317,Halter; Christopher P.,26,0,30,4
1713315031235,EDS 204R,A01,507319,Halter; Christopher P.,4,0,30,26
1713315031235,EDS 204R,B01,507331,Heinzman; Erica M.,28,0,30,2
1713315032267,EDS 206R,A00,507332,Staff,5,0,30,25
1713315032267,EDS 206R,B00,507343,Staff,28,0,30,2
1713315033298,EDS 250,A00,507344,Hemans; Patricia Ann Benitez,36,0,40,4
1713315034324,EDS 281,A00,507345,Daly; Alan J.,18,0,18,0
1713315035349,EDS 284,A00,507350,Daly; Alan J.,16,0,16,0
1713315036373,EDS 286,A00,507359,Fine; Sarah,18,0,18,0
1713315037397,EDS 289C,A01,507361,Daly; Alan J.,18,0,18,0
1713315038426,EDS 290,A00,507366,Hofstetter; Carolyn,15,0,15,0
1713315039456,LIGM 5A,A00,507421,Fischer-Grunski; Eva K,20,0,20,0
1713315040535,LIGM 5B,A00,507423,Fischer-Grunski; Eva K,20,0,20,0
1713315041561,LIGM 5C,A00,507425,Fischer-Grunski; Eva K,20,0,20,0
1713315042587,LIIT 5AS,A00,507427,Carnelos; Chiara,20,0,20,0
1713315043612,LIIT 5BS,A00,507430,Carnelos; Chiara,20,0,20,0
1713315044636,LIIT 5CS,A00,507432,Carnelos; Chiara,20,0,20,0
1713315045662,LISP 5A,A00,507541,Munoz Sanchez; Alicia,19,0,20,1
1713315046687,LISP 5B,A00,507671,Munoz Sanchez; Alicia,17,0,20,3
1713315047712,LISP 5C,A00,507696,Munoz Sanchez; Alicia,17,0,20,3
1713315048736,MAE 197,001,528363,Boechler; Nicholas Sebastia,9998,0,9999,1
1713315049762,MATH 197,001,523477,Kedlaya; Kiran S.,9999,0,9999,0
1713315049762,MATH 197,002,563811,Zhang; Danna,9999,0,9999,0
1713315050787,MCWP 40R,A00,518780,Staff,20,0,20,0
1713315050787,MCWP 40R,B00,518781,Staff,19,0,20,1
1713315050787,MCWP 40R,C00,518783,Staff,19,0,20,1
1713315051812,MCWP 50R,A00,518791,Staff,20,0,20,0
1713315051812,MCWP 50R,B00,518792,Staff,18,0,20,2
1713315051812,MCWP 50R,C00,518793,Staff,19,0,20,1
1713315051812,MCWP 50R,D00,518794,Staff,18,0,20,2
1713315051812,MCWP 50R,E00,518795,Staff,18,0,20,2
1713315051812,MCWP 50R,F00,518796,Staff,19,0,20,1
1713315051812,MCWP 50R,G00,518797,Staff,19,0,20,1
1713315052838,MMW 12R,A01,514034,Herbst; Matthew,15,0,16,1
1713315052838,MMW 12R,A02,514035,Herbst; Matthew,16,0,16,0
1713315053863,MMW 13R,A01,514037,Staff,12,0,16,4
1713315053863,MMW 13R,A02,514039,Staff,16,0,16,0
1713315055917,SIO 295LS,A00,523233,Staff,19,0,30,11
1713315056941,SIO 295S,A00,523232,Staff,19,0,30,11
1713315057971,SOCI 117,A01,494376,Staff,3,0,5,2
1713315058995,WES 237B,A00,494380,Staff,19,0,20,1
1713315061072,AESE 279B,A00,494370,Wade; Jon P,33,0,33,0
1713315062102,ANAR 135S,A00,494369,Braswell; Geoffrey E.,0,0,0,0
1713315063129,CAT 124RS,A01,519847,Geibel; William,17,0,20,3
1713315064158,CAT 125RS,A01,515971,Geibel; William,17,0,20,3
1713315065185,CLRE 250,A00,511389,Morris; Sheldon,9996,0,9999,3
1713315066213,CLRE 251,A00,507176,Mehta; Ravindra L.,9996,0,9999,3
1713315066213,CLRE 251,B00,511410,Mehta; Ravindra L.,9998,0,9999,1
1713315067336,CLRE 252,A00,507189,Cuomo; Raphael Eduardo,9998,0,9999,1
1713315068362,CLRE 253,A00,507199,Vaida; Florin,9997,0,9999,2
1713315068362,CLRE 253,B00,507202,Vaida; Florin,9999,0,9999,0
1713315069387,CLRE 259,A00,507211,Patel; Hemal,9996,0,9999,3
1713315070412,CLRE 260,A00,507221,Cuomo; Raphael Eduardo,9999,0,9999,0
1713315071439,CLRE 297,001,507242,Cuomo; Raphael Eduardo,9999,0,9999,0
1713315072469,CSE 191,A00,516875,Minnes Kemp; Mor Mia,9999,0,9999,0
1713315073501,CSS 201S,A01,494383,Staff,35,0,35,0
1713315074527,CSS 202S,A01,494387,Staff,35,0,35,0
1713315075552,EAP 100,A00,516065,Staff,9792,0,9999,207
1713315076580,ECE 45,A01,507414,Staff,54,0,60,6
1713315077605,ECE 100,A01,507416,Baghdadchi; Saharnaz,11,0,20,9
1713315077605,ECE 100,A02,507418,Baghdadchi; Saharnaz,20,0,20,0
1713315078630,ECE 111,A01,507420,Staff,40,0,50,10
1713315079654,ECE 197,001,548057,Sievenpiper; Daniel F.,9998,0,9999,1
1713315080680,EDS 115,A00,507243,Choi; Bailey Miyeon,28,0,28,0
1713315081704,EDS 117,A01,494379,Staff,24,0,25,1
1713315082736,EDS 125,A00,507246,Hopkins; Megan Beth,29,0,30,1
1713315083766,EDS 128A,A01,507264,Fargason; Sharon Gayle,26,0,26,0
1713315084793,EDS 128B,A01,507293,Pappas; Elizabeth,30,0,30,0
1713315085821,EDS 139,A00,507294,Fargason; Sharon Gayle,30,0,30,0
1713315085821,EDS 139,B00,507313,Pappas; Elizabeth,30,0,30,0
1713315086845,EDS 201,A00,507315,Staff,26,0,30,4
1713315087869,EDS 203,A01,507317,Halter; Christopher P.,26,0,30,4
1713315088899,EDS 204R,A01,507319,Halter; Christopher P.,4,0,30,26
1713315088899,EDS 204R,B01,507331,Heinzman; Erica M.,28,0,30,2
1713315089925,EDS 206R,A00,507332,Staff,5,0,30,25
1713315089925,EDS 206R,B00,507343,Staff,28,0,30,2
1713315090950,EDS 250,A00,507344,Hemans; Patricia Ann Benitez,36,0,40,4
1713315091975,EDS 281,A00,507345,Daly; Alan J.,18,0,18,0
1713315093002,EDS 284,A00,507350,Daly; Alan J.,16,0,16,0
1713315094031,EDS 286,A00,507359,Fine; Sarah,18,0,18,0
1713315095059,EDS 289C,A01,507361,Daly; Alan J.,18,0,18,0
1713315096085,EDS 290,A00,507366,Hofstetter; Carolyn,15,0,15,0
1713315097112,LIGM 5A,A00,507421,Fischer-Grunski; Eva K,20,0,20,0
1713315098138,LIGM 5B,A00,507423,Fischer-Grunski; Eva K,20,0,20,0
1713315099165,LIGM 5C,A00,507425,Fischer-Grunski; Eva K,20,0,20,0
1713315100194,LIIT 5AS,A00,507427,Carnelos; Chiara,20,0,20,0
1713315101219,LIIT 5BS,A00,507430,Carnelos; Chiara,20,0,20,0
1713315102246,LIIT 5CS,A00,507432,Carnelos; Chiara,20,0,20,0
1713315103276,LISP 5A,A00,507541,Munoz Sanchez; Alicia,19,0,20,1
1713315104301,LISP 5B,A00,507671,Munoz Sanchez; Alicia,17,0,20,3
1713315105331,LISP 5C,A00,507696,Munoz Sanchez; Alicia,17,0,20,3
1713315106361,MAE 197,001,528363,Boechler; Nicholas Sebastia,9998,0,9999,1
1713315107388,MATH 197,001,523477,Kedlaya; Kiran S.,9999,0,9999,0
1713315107388,MATH 197,002,563811,Zhang; Danna,9999,0,9999,0
1713315108418,MCWP 40R,A00,518780,Staff,20,0,20,0
1713315108418,MCWP 40R,B00,518781,Staff,19,0,20,1
1713315108418,MCWP 40R,C00,518783,Staff,19,0,20,1
1713315109443,MCWP 50R,A00,518791,Staff,20,0,20,0
1713315109443,MCWP 50R,B00,518792,Staff,17,0,20,3
1713315109443,MCWP 50R,C00,518793,Staff,19,0,20,1
1713315109443,MCWP 50R,D00,518794,Staff,18,0,20,2
1713315109443,MCWP 50R,E00,518795,Staff,18,0,20,2
1713315109443,MCWP 50R,F00,518796,Staff,19,0,20,1
1713315109443,MCWP 50R,G00,518797,Staff,19,0,20,1
1713315110471,MMW 12R,A01,514034,Herbst; Matthew,15,0,16,1
1713315110471,MMW 12R,A02,514035,Herbst; Matthew,16,0,16,0
1713315111495,MMW 13R,A01,514037,Staff,12,0,16,4
1713315111495,MMW 13R,A02,514039,Staff,16,0,16,0
1713315113549,SIO 295LS,A00,523233,Staff,19,0,30,11
1713315114579,SIO 295S,A00,523232,Staff,19,0,30,11
1713315115605,SOCI 117,A01,494376,Staff,3,0,5,2
1713315116630,WES 237B,A00,494380,Staff,19,0,20,1
1713315118694,AESE 279B,A00,494370,Wade; Jon P,33,0,33,0
1713315119720,ANAR 135S,A00,494369,Braswell; Geoffrey E.,0,0,0,0
1713315120745,CAT 124RS,A01,519847,Geibel; William,17,0,20,3
1713315121769,CAT 125RS,A01,515971,Geibel; William,17,0,20,3
1713315122795,CLRE 250,A00,511389,Morris; Sheldon,9996,0,9999,3
1713315123827,CLRE 251,A00,507176,Mehta; Ravindra L.,9996,0,9999,3
1713315123827,CLRE 251,B00,511410,Mehta; Ravindra L.,9998,0,9999,1
1713315124855,CLRE 252,A00,507189,Cuomo; Raphael Eduardo,9998,0,9999,1
1713315125881,CLRE 253,A00,507199,Vaida; Florin,9997,0,9999,2
1713315125881,CLRE 253,B00,507202,Vaida; Florin,9999,0,9999,0
1713315126907,CLRE 259,A00,507211,Patel; Hemal,9996,0,9999,3
1713315127934,CLRE 260,A00,507221,Cuomo; Raphael Eduardo,9999,0,9999,0
1713315128961,CLRE 297,001,507242,Cuomo; Raphael Eduardo,9999,0,9999,0
1713315129988,CSE 191,A00,516875,Minnes Kemp; Mor Mia,9999,0,9999,0
1713315131016,CSS 201S,A01,494383,Staff,35,0,35,0
1713315132046,CSS 202S,A01,494387,Staff,35,0,35,0
1713315133071,EAP 100,A00,516065,Staff,9792,0,9999,207
1713315134098,ECE 45,A01,507414,Staff,54,0,60,6
1713315135124,ECE 100,A01,507416,Baghdadchi; Saharnaz,11,0,20,9
1713315135124,ECE 100,A02,507418,Baghdadchi; Saharnaz,20,0,20,0
1713315136153,ECE 111,A01,507420,Staff,40,0,50,10
1713315137180,ECE 197,001,548057,Sievenpiper; Daniel F.,9998,0,9999,1
1713315138208,EDS 115,A00,507243,Choi; Bailey Miyeon,28,0,28,0
1713315139239,EDS 117,A01,494379,Staff,24,0,25,1
1713315140270,EDS 125,A00,507246,Hopkins; Megan Beth,29,0,30,1
1713315141299,EDS 128A,A01,507264,Fargason; Sharon Gayle,26,0,26,0
1713315142323,EDS 128B,A01,507293,Pappas; Elizabeth,30,0,30,0
1713315143353,EDS 139,A00,507294,Fargason; Sharon Gayle,30,0,30,0
1713315143353,EDS 139,B00,507313,Pappas; Elizabeth,30,0,30,0
1713315144436,EDS 201,A00,507315,Staff,26,0,30,4
1713315145466,EDS 203,A01,507317,Halter; Christopher P.,26,0,30,4
1713315146491,EDS 204R,A01,507319,Halter; Christopher P.,4,0,30,26
1713315146491,EDS 204R,B01,507331,Heinzman; Erica M.,28,0,30,2
1713315147517,EDS 206R,A00,507332,Staff,5,0,30,25
1713315147517,EDS 206R,B00,507343,Staff,28,0,30,2
1713315148542,EDS 250,A00,507344,Hemans; Patricia Ann Benitez,36,0,40,4
1713315149565,EDS 281,A00,507345,Daly; Alan J.,18,0,18,0
1713315150591,EDS 284,A00,507350,Daly; Alan J.,16,0,16,0
1713315151618,EDS 286,A00,507359,Fine; Sarah,18,0,18,0
1713315152646,EDS 289C,A01,507361,Daly; Alan J.,18,0,18,0
1713315153676,EDS 290,A00,507366,Hofstetter; Carolyn,15,0,15,0
1713315154702,LIGM 5A,A00,507421,Fischer-Grunski; Eva K,20,0,20,0
1713315155730,LIGM 5B,A00,507423,Fischer-Grunski; Eva K,20,0,20,0
1713315156758,LIGM 5C,A00,507425,Fischer-Grunski; Eva K,20,0,20,0
1713315157786,LIIT 5AS,A00,507427,Carnelos; Chiara,20,0,20,0
1713315158816,LIIT 5BS,A00,507430,Carnelos; Chiara,20,0,20,0
1713315159843,LIIT 5CS,A00,507432,Carnelos; Chiara,20,0,20,0
1713315160874,LISP 5A,A00,507541,Munoz Sanchez; Alicia,19,0,20,1
1713315161903,LISP 5B,A00,507671,Munoz Sanchez; Alicia,17,0,20,3
1713315162929,LISP 5C,A00,507696,Munoz Sanchez; Alicia,17,0,20,3
1713315163958,MAE 197,001,528363,Boechler; Nicholas Sebastia,9998,0,9999,1
1713315164991,MATH 197,001,523477,Kedlaya; Kiran S.,9999,0,9999,0
1713315164991,MATH 197,002,563811,Zhang; Danna,9999,0,9999,0
1713315166016,MCWP 40R,A00,518780,Staff,20,0,20,0
1713315166016,MCWP 40R,B00,518781,Staff,19,0,20,1
1713315166016,MCWP 40R,C00,518783,Staff,19,0,20,1
1713315167043,MCWP 50R,A00,518791,Staff,20,0,20,0
1713315167043,MCWP 50R,B00,518792,Staff,17,0,20,3
1713315167043,MCWP 50R,C00,518793,Staff,19,0,20,1
1713315167043,MCWP 50R,D00,518794,Staff,18,0,20,2
1713315167043,MCWP 50R,E00,518795,Staff,18,0,20,2
1713315167043,MCWP 50R,F00,518796,Staff,19,0,20,1
1713315167043,MCWP 50R,G00,518797,Staff,19,0,20,1
1713315168076,MMW 12R,A01,514034,Herbst; Matthew,15,0,16,1
1713315168076,MMW 12R,A02,514035,Herbst; Matthew,16,0,16,0
1713315169105,MMW 13R,A01,514037,Staff,12,0,16,4
1713315169105,MMW 13R,A02,514039,Staff,16,0,16,0
1713315171159,SIO 295LS,A00,523233,Staff,19,0,30,11
1713315172184,SIO 295S,A00,523232,Staff,19,0,30,11
1713315173213,SOCI 117,A01,494376,Staff,3,0,5,2
1713315174238,WES 237B,A00,494380,Staff,19,0,20,1
1713315176308,AESE 279B,A00,494370,Wade; Jon P,33,0,33,0
1713315177333,ANAR 135S,A00,494369,Braswell; Geoffrey E.,0,0,0,0
1713315178358,CAT 124RS,A01,519847,Geibel; William,17,0,20,3
1713315179381,CAT 125RS,A01,515971,Geibel; William,17,0,20,3
1713315180410,CLRE 250,A00,511389,Morris; Sheldon,9996,0,9999,3
1713315181436,CLRE 251,A00,507176,Mehta; Ravindra L.,9996,0,9999,3
1713315181436,CLRE 251,B00,511410,Mehta; Ravindra L.,9998,0,9999,1
1713315182461,CLRE 252,A00,507189,Cuomo; Raphael Eduardo,9998,0,9999,1
1713315183491,CLRE 253,A00,507199,Vaida; Florin,9997,0,9999,2
1713315183491,CLRE 253,B00,507202,Vaida; Florin,9999,0,9999,0
1713315184520,CLRE 259,A00,507211,Patel; Hemal,9996,0,9999,3
1713315185549,CLRE 260,A00,507221,Cuomo; Raphael Eduardo,9999,0,9999,0
1713315186577,CLRE 297,001,507242,Cuomo; Raphael Eduardo,9999,0,9999,0
1713315187600,CSE 191,A00,516875,Minnes Kemp; Mor Mia,9999,0,9999,0
1713315188628,CSS 201S,A01,494383,Staff,35,0,35,0
1713315189653,CSS 202S,A01,494387,Staff,35,0,35,0
1713315190679,EAP 100,A00,516065,Staff,9792,0,9999,207
1713315191703,ECE 45,A01,507414,Staff,54,0,60,6
1713315192727,ECE 100,A01,507416,Baghdadchi; Saharnaz,11,0,20,9
1713315192727,ECE 100,A02,507418,Baghdadchi; Saharnaz,20,0,20,0
1713315193752,ECE 111,A01,507420,Staff,40,0,50,10
1713315194777,ECE 197,001,548057,Sievenpiper; Daniel F.,9998,0,9999,1
1713315195804,EDS 115,A00,507243,Choi; Bailey Miyeon,28,0,28,0
1713315196829,EDS 117,A01,494379,Staff,24,0,25,1
1713315197855,EDS 125,A00,507246,Hopkins; Megan Beth,29,0,30,1
1713315198883,EDS 128A,A01,507264,Fargason; Sharon Gayle,26,0,26,0
1713315199908,EDS 128B,A01,507293,Pappas; Elizabeth,30,0,30,0
1713315200933,EDS 139,A00,507294,Fargason; Sharon Gayle,30,0,30,0
1713315200933,EDS 139,B00,507313,Pappas; Elizabeth,30,0,30,0
1713315201958,EDS 201,A00,507315,Staff,26,0,30,4
1713315202987,EDS 203,A01,507317,Halter; Christopher P.,26,0,30,4
1713315204017,EDS 204R,A01,507319,Halter; Christopher P.,4,0,30,26
1713315204017,EDS 204R,B01,507331,Heinzman; Erica M.,28,0,30,2
1713315205041,EDS 206R,A00,507332,Staff,5,0,30,25
1713315205041,EDS 206R,B00,507343,Staff,28,0,30,2
1713315206068,EDS 250,A00,507344,Hemans; Patricia Ann Benitez,36,0,40,4
1713315207095,EDS 281,A00,507345,Daly; Alan J.,18,0,18,0
1713315208121,EDS 284,A00,507350,Daly; Alan J.,16,0,16,0
1713315209149,EDS 286,A00,507359,Fine; Sarah,18,0,18,0
1713315210174,EDS 289C,A01,507361,Daly; Alan J.,18,0,18,0
1713315211203,EDS 290,A00,507366,Hofstetter; Carolyn,15,0,15,0
1713315212230,LIGM 5A,A00,507421,Fischer-Grunski; Eva K,20,0,20,0
1713315213257,LIGM 5B,A00,507423,Fischer-Grunski; Eva K,20,0,20,0
1713315214284,LIGM 5C,A00,507425,Fischer-Grunski; Eva K,20,0,20,0
1713315215311,LIIT 5AS,A00,507427,Carnelos; Chiara,20,0,20,0
1713315216336,LIIT 5BS,A00,507430,Carnelos; Chiara,20,0,20,0
1713315217362,LIIT 5CS,A00,507432,Carnelos; Chiara,20,0,20,0
1713315218393,LISP 5A,A00,507541,Munoz Sanchez; Alicia,19,0,20,1
1713315219417,LISP 5B,A00,507671,Munoz Sanchez; Alicia,17,0,20,3
1713315220446,LISP 5C,A00,507696,Munoz Sanchez; Alicia,17,0,20,3
1713315221476,MAE 197,001,528363,Boechler; Nicholas Sebastia,9998,0,9999,1
1713315222500,MATH 197,001,523477,Kedlaya; Kiran S.,9999,0,9999,0
1713315222500,MATH 197,002,563811,Zhang; Danna,9999,0,9999,0
1713315223526,MCWP 40R,A00,518780,Staff,20,0,20,0
1713315223526,MCWP 40R,B00,518781,Staff,19,0,20,1
1713315223526,MCWP 40R,C00,518783,Staff,19,0,20,1
1713315224552,MCWP 50R,A00,518791,Staff,20,0,20,0
1713315224552,MCWP 50R,B00,518792,Staff,17,0,20,3
1713315224552,MCWP 50R,C00,518793,Staff,19,0,20,1
1713315224552,MCWP 50R,D00,518794,Staff,18,0,20,2
1713315224552,MCWP 50R,E00,518795,Staff,18,0,20,2
1713315224552,MCWP 50R,F00,518796,Staff,19,0,20,1
1713315224552,MCWP 50R,G00,518797,Staff,19,0,20,1
1713315225578,MMW 12R,A01,514034,Herbst; Matthew,15,0,16,1
1713315225578,MMW 12R,A02,514035,Herbst; Matthew,16,0,16,0
1713315226602,MMW 13R,A01,514037,Staff,12,0,16,4
1713315226602,MMW 13R,A02,514039,Staff,16,0,16,0
1713315228658,SIO 295LS,A00,523233,Staff,19,0,30,11
1713315229687,SIO 295S,A00,523232,Staff,19,0,30,11
1713315230716,SOCI 117,A01,494376,Staff,3,0,5,2
1713315231744,WES 237B,A00,494380,Staff,19,0,20,1
1713315233818,AESE 279B,A00,494370,Wade; Jon P,33,0,33,0
1713315234844,ANAR 135S,A00,494369,Braswell; Geoffrey E.,0,0,0,0
1713315235868,CAT 124RS,A01,519847,Geibel; William,17,0,20,3
1713315236896,CAT 125RS,A01,515971,Geibel; William,17,0,20,3
1713315237924,CLRE 250,A00,511389,Morris; Sheldon,9996,0,9999,3
1713315238951,CLRE 251,A00,507176,Mehta; Ravindra L.,9996,0,9999,3
1713315238951,CLRE 251,B00,511410,Mehta; Ravindra L.,9998,0,9999,1
1713315239979,CLRE 252,A00,507189,Cuomo; Raphael Eduardo,9998,0,9999,1
1713315241006,CLRE 253,A00,507199,Vaida; Florin,9997,0,9999,2
1713315241006,CLRE 253,B00,507202,Vaida; Florin,9999,0,9999,0
1713315242032,CLRE 259,A00,507211,Patel; Hemal,9996,0,9999,3
1713315243057,CLRE 260,A00,507221,Cuomo; Raphael Eduardo,9999,0,9999,0
1713315244086,CLRE 297,001,507242,Cuomo; Raphael Eduardo,9999,0,9999,0
1713315245111,CSE 191,A00,516875,Minnes Kemp; Mor Mia,9999,0,9999,0
1713315246136,CSS 201S,A01,494383,Staff,35,0,35,0
1713315247161,CSS 202S,A01,494387,Staff,35,0,35,0
1713315248240,EAP 100,A00,516065,Staff,9792,0,9999,207
1713315249264,ECE 45,A01,507414,Staff,54,0,60,6
1713315250295,ECE 100,A01,507416,Baghdadchi; Saharnaz,11,0,20,9
1713315250295,ECE 100,A02,507418,Baghdadchi; Saharnaz,20,0,20,0
1713315251326,ECE 111,A01,507420,Staff,40,0,50,10
1713315252351,ECE 197,001,548057,Sievenpiper; Daniel F.,9998,0,9999,1
1713315253381,EDS 115,A00,507243,Choi; Bailey Miyeon,28,0,28,0
1713315254413,EDS 117,A01,494379,Staff,24,0,25,1
1713315255443,EDS 125,A00,507246,Hopkins; Megan Beth,29,0,30,1
1713315256472,EDS 128A,A01,507264,Fargason; Sharon Gayle,26,0,26,0
1713315257502,EDS 128B,A01,507293,Pappas; Elizabeth,30,0,30,0
1713315258530,EDS 139,A00,507294,Fargason; Sharon Gayle,30,0,30,0
1713315258530,EDS 139,B00,507313,Pappas; Elizabeth,30,0,30,0
1713315259557,EDS 201,A00,507315,Staff,26,0,30,4
1713315260583,EDS 203,A01,507317,Halter; Christopher P.,26,0,30,4
1713315261614,EDS 204R,A01,507319,Halter; Christopher P.,4,0,30,26
1713315261614,EDS 204R,B01,507331,Heinzman; Erica M.,28,0,30,2
1713315262643,EDS 206R,A00,507332,Staff,5,0,30,25
1713315262643,EDS 206R,B00,507343,Staff,28,0,30,2
1713315263667,EDS 250,A00,507344,Hemans; Patricia Ann Benitez,36,0,40,4
1713315264693,EDS 281,A00,507345,Daly; Alan J.,18,0,18,0
1713315265721,EDS 284,A00,507350,Daly; Alan J.,16,0,16,0
1713315266748,EDS 286,A00,507359,Fine; Sarah,18,0,18,0
1713315267773,EDS 289C,A01,507361,Daly; Alan J.,18,0,18,0
1713315268799,EDS 290,A00,507366,Hofstetter; Carolyn,15,0,15,0
1713315269824,LIGM 5A,A00,507421,Fischer-Grunski; Eva K,20,0,20,0
1713315270852,LIGM 5B,A00,507423,Fischer-Grunski; Eva K,20,0,20,0
1713315271881,LIGM 5C,A00,507425,Fischer-Grunski; Eva K,20,0,20,0
1713315272907,LIIT 5AS,A00,507427,Carnelos; Chiara,20,0,20,0
1713315273935,LIIT 5BS,A00,507430,Carnelos; Chiara,20,0,20,0
1713315274965,LIIT 5CS,A00,507432,Carnelos; Chiara,20,0,20,0
1713315275990,LISP 5A,A00,507541,Munoz Sanchez; Alicia,19,0,20,1
1713315277016,LISP 5B,A00,507671,Munoz Sanchez; Alicia,17,0,20,3
1713315278041,LISP 5C,A00,507696,Munoz Sanchez; Alicia,17,0,20,3
1713315279067,MAE 197,001,528363,Boechler; Nicholas Sebastia,9998,0,9999,1
1713315280092,MATH 197,001,523477,Kedlaya; Kiran S.,9999,0,9999,0
1713315280092,MATH 197,002,563811,Zhang; Danna,9999,0,9999,0
1713315281197,MCWP 40R,A00,518780,Staff,20,0,20,0
1713315281197,MCWP 40R,B00,518781,Staff,19,0,20,1
1713315281197,MCWP 40R,C00,518783,Staff,19,0,20,1
1713315282227,MCWP 50R,A00,518791,Staff,20,0,20,0
1713315282227,MCWP 50R,B00,518792,Staff,17,0,20,3
1713315282227,MCWP 50R,C00,518793,Staff,19,0,20,1
1713315282227,MCWP 50R,D00,518794,Staff,18,0,20,2
1713315282227,MCWP 50R,E00,518795,Staff,18,0,20,2
1713315282227,MCWP 50R,F00,518796,Staff,19,0,20,1
1713315282227,MCWP 50R,G00,518797,Staff,19,0,20,1
1713315283253,MMW 12R,A01,514034,Herbst; Matthew,15,0,16,1
1713315283253,MMW 12R,A02,514035,Herbst; Matthew,16,0,16,0
1713315284279,MMW 13R,A01,514037,Staff,12,0,16,4
1713315284279,MMW 13R,A02,514039,Staff,16,0,16,0
1713315286331,SIO 295LS,A00,523233,Staff,19,0,30,11
1713315287359,SIO 295S,A00,523232,Staff,19,0,30,11
1713315288389,SOCI 117,A01,494376,Staff,3,0,5,2
1713315289418,WES 237B,A00,494380,Staff,19,0,20,1
1713315291484,AESE 279B,A00,494370,Wade; Jon P,33,0,33,0
1713315292512,ANAR 135S,A00,494369,Braswell; Geoffrey E.,0,0,0,0
1713315293536,CAT 124RS,A01,519847,Geibel; William,17,0,20,3
1713315294561,CAT 125RS,A01,515971,Geibel; William,17,0,20,3
1713315295702,CLRE 250,A00,511389,Morris; Sheldon,9996,0,9999,3
1713315296728,CLRE 251,A00,507176,Mehta; Ravindra L.,9996,0,9999,3
1713315296728,CLRE 251,B00,511410,Mehta; Ravindra L.,9998,0,9999,1
1713315297760,CLRE 252,A00,507189,Cuomo; Raphael Eduardo,9998,0,9999,1
1713315298785,CLRE 253,A00,507199,Vaida; Florin,9997,0,9999,2
1713315298785,CLRE 253,B00,507202,Vaida; Florin,9999,0,9999,0
1713315299814,CLRE 259,A00,507211,Patel; Hemal,9996,0,9999,3
1713315300847,CLRE 260,A00,507221,Cuomo; Raphael Eduardo,9999,0,9999,0
1713315301876,CLRE 297,001,507242,Cuomo; Raphael Eduardo,9999,0,9999,0
1713315302900,CSE 191,A00,516875,Minnes Kemp; Mor Mia,9999,0,9999,0
1713315303929,CSS 201S,A01,494383,Staff,35,0,35,0
1713315304955,CSS 202S,A01,494387,Staff,35,0,35,0
1713315305984,EAP 100,A00,516065,Staff,9792,0,9999,207
1713315307008,ECE 45,A01,507414,Staff,54,0,60,6
1713315308035,ECE 100,A01,507416,Baghdadchi; Saharnaz,11,0,20,9
1713315308035,ECE 100,A02,507418,Baghdadchi; Saharnaz,20,0,20,0
1713315309059,ECE 111,A01,507420,Staff,40,0,50,10
1713315310083,ECE 197,001,548057,Sievenpiper; Daniel F.,9998,0,9999,1
1713315311109,EDS 115,A00,507243,Choi; Bailey Miyeon,28,0,28,0
1713315312134,EDS 117,A01,494379,Staff,24,0,25,1
1713315313160,EDS 125,A00,507246,Hopkins; Megan Beth,29,0,30,1
1713315314186,EDS 128A,A01,507264,Fargason; Sharon Gayle,26,0,26,0
1713315315211,EDS 128B,A01,507293,Pappas; Elizabeth,30,0,30,0
1713315316239,EDS 139,A00,507294,Fargason; Sharon Gayle,30,0,30,0
1713315316239,EDS 139,B00,507313,Pappas; Elizabeth,30,0,30,0
1713315317264,EDS 201,A00,507315,Staff,26,0,30,4
1713315318290,EDS 203,A01,507317,Halter; Christopher P.,26,0,30,4
1713315319320,EDS 204R,A01,507319,Halter; Christopher P.,4,0,30,26
1713315319320,EDS 204R,B01,507331,Heinzman; Erica M.,28,0,30,2
1713315320348,EDS 206R,A00,507332,Staff,5,0,30,25
1713315320348,EDS 206R,B00,507343,Staff,28,0,30,2
1713315321374,EDS 250,A00,507344,Hemans; Patricia Ann Benitez,36,0,40,4
1713315322400,EDS 281,A00,507345,Daly; Alan J.,18,0,18,0
1713315323425,EDS 284,A00,507350,Daly; Alan J.,16,0,16,0
1713315324454,EDS 286,A00,507359,Fine; Sarah,18,0,18,0
1713315325479,EDS 289C,A01,507361,Daly; Alan J.,18,0,18,0
1713315326504,EDS 290,A00,507366,Hofstetter; Carolyn,15,0,15,0
1713315327529,LIGM 5A,A00,507421,Fischer-Grunski; Eva K,20,0,20,0
1713315328553,LIGM 5B,A00,507423,Fischer-Grunski; Eva K,20,0,20,0
1713315329581,LIGM 5C,A00,507425,Fischer-Grunski; Eva K,20,0,20,0
1713315330612,LIIT 5AS,A00,507427,Carnelos; Chiara,20,0,20,0
1713315331637,LIIT 5BS,A00,507430,Carnelos; Chiara,20,0,20,0
1713315332665,LIIT 5CS,A00,507432,Carnelos; Chiara,20,0,20,0
1713315333694,LISP 5A,A00,507541,Munoz Sanchez; Alicia,19,0,20,1
1713315334722,LISP 5B,A00,507671,Munoz Sanchez; Alicia,17,0,20,3
1713315335752,LISP 5C,A00,507696,Munoz Sanchez; Alicia,17,0,20,3
1713315336777,MAE 197,001,528363,Boechler; Nicholas Sebastia,9998,0,9999,1
1713315337802,MATH 197,001,523477,Kedlaya; Kiran S.,9999,0,9999,0
1713315337802,MATH 197,002,563811,Zhang; Danna,9999,0,9999,0
1713315338827,MCWP 40R,A00,518780,Staff,20,0,20,0
1713315338827,MCWP 40R,B00,518781,Staff,19,0,20,1
1713315338827,MCWP 40R,C00,518783,Staff,19,0,20,1
1713315339853,MCWP 50R,A00,518791,Staff,20,0,20,0
1713315339853,MCWP 50R,B00,518792,Staff,17,0,20,3
1713315339853,MCWP 50R,C00,518793,Staff,19,0,20,1
1713315339853,MCWP 50R,D00,518794,Staff,18,0,20,2
1713315339853,MCWP 50R,E00,518795,Staff,18,0,20,2
1713315339853,MCWP 50R,F00,518796,Staff,19,0,20,1
1713315339853,MCWP 50R,G00,518797,Staff,19,0,20,1
1713315340882,MMW 12R,A01,514034,Herbst; Matthew,15,0,16,1
1713315340882,MMW 12R,A02,514035,Herbst; Matthew,16,0,16,0
1713315341908,MMW 13R,A01,514037,Staff,12,0,16,4
1713315341908,MMW 13R,A02,514039,Staff,16,0,16,0
1713315343964,SIO 295LS,A00,523233,Staff,19,0,30,11
1713315344992,SIO 295S,A00,523232,Staff,19,0,30,11
1713315346022,SOCI 117,A01,494376,Staff,3,0,5,2
1713315347049,WES 237B,A00,494380,Staff,19,0,20,1
1713315349121,AESE 279B,A00,494370,Wade; Jon P,33,0,33,0
1713315350146,ANAR 135S,A00,494369,Braswell; Geoffrey E.,0,0,0,0
1713315351173,CAT 124RS,A01,519847,Geibel; William,17,0,20,3
1713315352256,CAT 125RS,A01,515971,Geibel; William,17,0,20,3
1713315353286,CLRE 250,A00,511389,Morris; Sheldon,9996,0,9999,3
1713315354311,CLRE 251,A00,507176,Mehta; Ravindra L.,9996,0,9999,3
1713315354311,CLRE 251,B00,511410,Mehta; Ravindra L.,9998,0,9999,1
1713315355340,CLRE 252,A00,507189,Cuomo; Raphael Eduardo,9998,0,9999,1
1713315356366,CLRE 253,A00,507199,Vaida; Florin,9997,0,9999,2
1713315356366,CLRE 253,B00,507202,Vaida; Florin,9999,0,9999,0
1713315357393,CLRE 259,A00,507211,Patel; Hemal,9996,0,9999,3
1713315358418,CLRE 260,A00,507221,Cuomo; Raphael Eduardo,9999,0,9999,0
1713315359443,CLRE 297,001,507242,Cuomo; Raphael Eduardo,9999,0,9999,0
1713315360471,CSE 191,A00,516875,Minnes Kemp; Mor Mia,9999,0,9999,0
1713315361498,CSS 201S,A01,494383,Staff,35,0,35,0
1713315362523,CSS 202S,A01,494387,Staff,35,0,35,0
1713315363547,EAP 100,A00,516065,Staff,9792,0,9999,207
1713315364573,ECE 45,A01,507414,Staff,54,0,60,6
1713315365604,ECE 100,A01,507416,Baghdadchi; Saharnaz,11,0,20,9
1713315365604,ECE 100,A02,507418,Baghdadchi; Saharnaz,20,0,20,0
1713315366633,ECE 111,A01,507420,Staff,40,0,50,10
1713315367658,ECE 197,001,548057,Sievenpiper; Daniel F.,9998,0,9999,1
1713315368684,EDS 115,A00,507243,Choi; Bailey Miyeon,28,0,28,0
1713315369714,EDS 117,A01,494379,Staff,24,0,25,1
1713315370743,EDS 125,A00,507246,Hopkins; Megan Beth,29,0,30,1
1713315371769,EDS 128A,A01,507264,Fargason; Sharon Gayle,26,0,26,0
1713315372794,EDS 128B,A01,507293,Pappas; Elizabeth,30,0,30,0
1713315373820,EDS 139,A00,507294,Fargason; Sharon Gayle,30,0,30,0
1713315373820,EDS 139,B00,507313,Pappas; Elizabeth,30,0,30,0
1713315374844,EDS 201,A00,507315,Staff,26,0,30,4
1713315375874,EDS 203,A01,507317,Halter; Christopher P.,26,0,30,4
1713315376899,EDS 204R,A01,507319,Halter; Christopher P.,4,0,30,26
1713315376899,EDS 204R,B01,507331,Heinzman; Erica M.,28,0,30,2
1713315377941,EDS 206R,A00,507332,Staff,5,0,30,25
1713315377941,EDS 206R,B00,507343,Staff,28,0,30,2
1713315378966,EDS 250,A00,507344,Hemans; Patricia Ann Benitez,36,0,40,4
1713315379993,EDS 281,A00,507345,Daly; Alan J.,18,0,18,0
1713315381020,EDS 284,A00,507350,Daly; Alan J.,16,0,16,0
1713315382046,EDS 286,A00,507359,Fine; Sarah,18,0,18,0
1713315383071,EDS 289C,A01,507361,Daly; Alan J.,18,0,18,0
1713315384099,EDS 290,A00,507366,Hofstetter; Carolyn,15,0,15,0
1713315385129,LIGM 5A,A00,507421,Fischer-Grunski; Eva K,20,0,20,0
1713315386157,LIGM 5B,A00,507423,Fischer-Grunski; Eva K,20,0,20,0
1713315387183,LIGM 5C,A00,507425,Fischer-Grunski; Eva K,20,0,20,0
1713315388208,LIIT 5AS,A00,507427,Carnelos; Chiara,20,0,20,0
1713315389237,LIIT 5BS,A00,507430,Carnelos; Chiara,20,0,20,0
1713315390262,LIIT 5CS,A00,507432,Carnelos; Chiara,20,0,20,0
1713315391287,LISP 5A,A00,507541,Munoz Sanchez; Alicia,19,0,20,1
1713315392317,LISP 5B,A00,507671,Munoz Sanchez; Alicia,17,0,20,3
1713315393347,LISP 5C,A00,507696,Munoz Sanchez; Alicia,17,0,20,3
1713315394376,MAE 197,001,528363,Boechler; Nicholas Sebastia,9998,0,9999,1
1713315395405,MATH 197,001,523477,Kedlaya; Kiran S.,9999,0,9999,0
1713315395405,MATH 197,002,563811,Zhang; Danna,9999,0,9999,0
1713315396431,MCWP 40R,A00,518780,Staff,20,0,20,0
1713315396431,MCWP 40R,B00,518781,Staff,19,0,20,1
1713315396431,MCWP 40R,C00,518783,Staff,19,0,20,1
1713315397459,MCWP 50R,A00,518791,Staff,20,0,20,0
1713315397459,MCWP 50R,B00,518792,Staff,17,0,20,3
1713315397459,MCWP 50R,C00,518793,Staff,19,0,20,1
1713315397459,MCWP 50R,D00,518794,Staff,18,0,20,2
1713315397459,MCWP 50R,E00,518795,Staff,18,0,20,2
1713315397459,MCWP 50R,F00,518796,Staff,19,0,20,1
1713315397459,MCWP 50R,G00,518797,Staff,19,0,20,1
1713315398487,MMW 12R,A01,514034,Herbst; Matthew,15,0,16,1
1713315398487,MMW 12R,A02,514035,Herbst; Matthew,16,0,16,0
1713315399514,MMW 13R,A01,514037,Staff,12,0,16,4
1713315399514,MMW 13R,A02,514039,Staff,16,0,16,0
1713315401573,SIO 295LS,A00,523233,Staff,19,0,30,11
1713315402601,SIO 295S,A00,523232,Staff,19,0,30,11
1713315403630,SOCI 117,A01,494376,Staff,3,0,5,2
1713315404657,WES 237B,A00,494380,Staff,19,0,20,1
1713315406728,AESE 279B,A00,494370,Wade; Jon P,33,0,33,0
1713315407754,ANAR 135S,A00,494369,Braswell; Geoffrey E.,0,0,0,0
1713315408781,CAT 124RS,A01,519847,Geibel; William,17,0,20,3
1713315409807,CAT 125RS,A01,515971,Geibel; William,17,0,20,3
1713315410837,CLRE 250,A00,511389,Morris; Sheldon,9996,0,9999,3
1713315411867,CLRE 251,A00,507176,Mehta; Ravindra L.,9996,0,9999,3
1713315411867,CLRE 251,B00,511410,Mehta; Ravindra L.,9998,0,9999,1
1713315412893,CLRE 252,A00,507189,Cuomo; Raphael Eduardo,9998,0,9999,1
1713315413919,CLRE 253,A00,507199,Vaida; Florin,9997,0,9999,2
1713315413919,CLRE 253,B00,507202,Vaida; Florin,9999,0,9999,0
1713315414947,CLRE 259,A00,507211,Patel; Hemal,9996,0,9999,3
1713315415975,CLRE 260,A00,507221,Cuomo; Raphael Eduardo,9999,0,9999,0
1713315417000,CLRE 297,001,507242,Cuomo; Raphael Eduardo,9999,0,9999,0
1713315418030,CSE 191,A00,516875,Minnes Kemp; Mor Mia,9999,0,9999,0
1713315419054,CSS 201S,A01,494383,Staff,35,0,35,0
1713315420080,CSS 202S,A01,494387,Staff,35,0,35,0
1713315421109,EAP 100,A00,516065,Staff,9792,0,9999,207
1713315422137,ECE 45,A01,507414,Staff,54,0,60,6
1713315423169,ECE 100,A01,507416,Baghdadchi; Saharnaz,11,0,20,9
1713315423169,ECE 100,A02,507418,Baghdadchi; Saharnaz,20,0,20,0
1713315424197,ECE 111,A01,507420,Staff,40,0,50,10
1713315425223,ECE 197,001,548057,Sievenpiper; Daniel F.,9998,0,9999,1
1713315426252,EDS 115,A00,507243,Choi; Bailey Miyeon,28,0,28,0
1713315427280,EDS 117,A01,494379,Staff,24,0,25,1
1713315428310,EDS 125,A00,507246,Hopkins; Megan Beth,29,0,30,1
1713315429335,EDS 128A,A01,507264,Fargason; Sharon Gayle,26,0,26,0
1713315430360,EDS 128B,A01,507293,Pappas; Elizabeth,30,0,30,0
1713315431385,EDS 139,A00,507294,Fargason; Sharon Gayle,30,0,30,0
1713315431385,EDS 139,B00,507313,Pappas; Elizabeth,30,0,30,0
1713315432410,EDS 201,A00,507315,Staff,26,0,30,4
1713315433439,EDS 203,A01,507317,Halter; Christopher P.,26,0,30,4
1713315434466,EDS 204R,A01,507319,Halter; Christopher P.,4,0,30,26
1713315434466,EDS 204R,B01,507331,Heinzman; Erica M.,28,0,30,2
1713315435492,EDS 206R,A00,507332,Staff,5,0,30,25
1713315435492,EDS 206R,B00,507343,Staff,28,0,30,2
1713315436519,EDS 250,A00,507344,Hemans; Patricia Ann Benitez,36,0,40,4
1713315437550,EDS 281,A00,507345,Daly; Alan J.,18,0,18,0
1713315438574,EDS 284,A00,507350,Daly; Alan J.,16,0,16,0
1713315439603,EDS 286,A00,507359,Fine; Sarah,18,0,18,0
1713315440632,EDS 289C,A01,507361,Daly; Alan J.,18,0,18,0
1713315441662,EDS 290,A00,507366,Hofstetter; Carolyn,15,0,15,0
1713315442689,LIGM 5A,A00,507421,Fischer-Grunski; Eva K,20,0,20,0
1713315443714,LIGM 5B,A00,507423,Fischer-Grunski; Eva K,20,0,20,0
1713315444739,LIGM 5C,A00,507425,Fischer-Grunski; Eva K,20,0,20,0
1713315445764,LIIT 5AS,A00,507427,Carnelos; Chiara,20,0,20,0
1713315446789,LIIT 5BS,A00,507430,Carnelos; Chiara,20,0,20,0
1713315447813,LIIT 5CS,A00,507432,Carnelos; Chiara,20,0,20,0
1713315448844,LISP 5A,A00,507541,Munoz Sanchez; Alicia,19,0,20,1
1713315449872,LISP 5B,A00,507671,Munoz Sanchez; Alicia,17,0,20,3
1713315450898,LISP 5C,A00,507696,Munoz Sanchez; Alicia,17,0,20,3
1713315451927,MAE 197,001,528363,Boechler; Nicholas Sebastia,9998,0,9999,1
1713315452954,MATH 197,001,523477,Kedlaya; Kiran S.,9999,0,9999,0
1713315452954,MATH 197,002,563811,Zhang; Danna,9999,0,9999,0
1713315453986,MCWP 40R,A00,518780,Staff,20,0,20,0
1713315453986,MCWP 40R,B00,518781,Staff,19,0,20,1
1713315453986,MCWP 40R,C00,518783,Staff,19,0,20,1
1713315455015,MCWP 50R,A00,518791,Staff,20,0,20,0
1713315455015,MCWP 50R,B00,518792,Staff,17,0,20,3
1713315455015,MCWP 50R,C00,518793,Staff,19,0,20,1
1713315455015,MCWP 50R,D00,518794,Staff,18,0,20,2
1713315455015,MCWP 50R,E00,518795,Staff,18,0,20,2
1713315455015,MCWP 50R,F00,518796,Staff,19,0,20,1
1713315455015,MCWP 50R,G00,518797,Staff,19,0,20,1
1713315456097,MMW 12R,A01,514034,Herbst; Matthew,15,0,16,1
1713315456097,MMW 12R,A02,514035,Herbst; Matthew,16,0,16,0
1713315457124,MMW 13R,A01,514037,Staff,12,0,16,4
1713315457124,MMW 13R,A02,514039,Staff,16,0,16,0
1713315459178,SIO 295LS,A00,523233,Staff,19,0,30,11
1713315460202,SIO 295S,A00,523232,Staff,19,0,30,11
1713315461233,SOCI 117,A01,494376,Staff,3,0,5,2
1713315462258,WES 237B,A00,494380,Staff,19,0,20,1
1713315464327,AESE 279B,A00,494370,Wade; Jon P,33,0,33,0
1713315465353,ANAR 135S,A00,494369,Braswell; Geoffrey E.,0,0,0,0
1713315466378,CAT 124RS,A01,519847,Geibel; William,17,0,20,3
1713315467403,CAT 125RS,A01,515971,Geibel; William,17,0,20,3
1713315468429,CLRE 250,A00,511389,Morris; Sheldon,9996,0,9999,3
1713315469455,CLRE 251,A00,507176,Mehta; Ravindra L.,9996,0,9999,3
1713315469455,CLRE 251,B00,511410,Mehta; Ravindra L.,9998,0,9999,1
1713315470484,CLRE 252,A00,507189,Cuomo; Raphael Eduardo,9998,0,9999,1
1713315471512,CLRE 253,A00,507199,Vaida; Florin,9997,0,9999,2
1713315471512,CLRE 253,B00,507202,Vaida; Florin,9999,0,9999,0
1713315472537,CLRE 259,A00,507211,Patel; Hemal,9996,0,9999,3
1713315473565,CLRE 260,A00,507221,Cuomo; Raphael Eduardo,9999,0,9999,0
1713315474595,CLRE 297,001,507242,Cuomo; Raphael Eduardo,9999,0,9999,0
1713315475620,CSE 191,A00,516875,Minnes Kemp; Mor Mia,9999,0,9999,0
1713315476647,CSS 201S,A01,494383,Staff,35,0,35,0
1713315477673,CSS 202S,A01,494387,Staff,35,0,35,0
1713315478698,EAP 100,A00,516065,Staff,9792,0,9999,207
1713315479727,ECE 45,A01,507414,Staff,54,0,60,6
1713315480753,ECE 100,A01,507416,Baghdadchi; Saharnaz,11,0,20,9
1713315480753,ECE 100,A02,507418,Baghdadchi; Saharnaz,20,0,20,0
1713315481782,ECE 111,A01,507420,Staff,40,0,50,10
1713315482809,ECE 197,001,548057,Sievenpiper; Daniel F.,9998,0,9999,1
1713315483835,EDS 115,A00,507243,Choi; Bailey Miyeon,28,0,28,0
1713315484860,EDS 117,A01,494379,Staff,24,0,25,1
1713315485885,EDS 125,A00,507246,Hopkins; Megan Beth,29,0,30,1
1713315486911,EDS 128A,A01,507264,Fargason; Sharon Gayle,26,0,26,0
1713315487941,EDS 128B,A01,507293,Pappas; Elizabeth,30,0,30,0
1713315488966,EDS 139,A00,507294,Fargason; Sharon Gayle,30,0,30,0
1713315488966,EDS 139,B00,507313,Pappas; Elizabeth,30,0,30,0
1713315489991,EDS 201,A00,507315,Staff,26,0,30,4
1713315491017,EDS 203,A01,507317,Halter; Christopher P.,26,0,30,4
1713315492055,EDS 204R,A01,507319,Halter; Christopher P.,4,0,30,26
1713315492055,EDS 204R,B01,507331,Heinzman; Erica M.,28,0,30,2
1713315493080,EDS 206R,A00,507332,Staff,5,0,30,25
1713315493080,EDS 206R,B00,507343,Staff,28,0,30,2
1713315494107,EDS 250,A00,507344,Hemans; Patricia Ann Benitez,36,0,40,4
1713315495134,EDS 281,A00,507345,Daly; Alan J.,18,0,18,0
1713315496159,EDS 284,A00,507350,Daly; Alan J.,16,0,16,0
1713315497188,EDS 286,A00,507359,Fine; Sarah,18,0,18,0
1713315498211,EDS 289C,A01,507361,Daly; Alan J.,18,0,18,0
1713315499240,EDS 290,A00,507366,Hofstetter; Carolyn,15,0,15,0
1713315500266,LIGM 5A,A00,507421,Fischer-Grunski; Eva K,20,0,20,0
1713315501293,LIGM 5B,A00,507423,Fischer-Grunski; Eva K,20,0,20,0
1713315502322,LIGM 5C,A00,507425,Fischer-Grunski; Eva K,20,0,20,0
1713315503353,LIIT 5AS,A00,507427,Carnelos; Chiara,20,0,20,0
1713315504378,LIIT 5BS,A00,507430,Carnelos; Chiara,20,0,20,0
1713315505408,LIIT 5CS,A00,507432,Carnelos; Chiara,20,0,20,0
1713315506434,LISP 5A,A00,507541,Munoz Sanchez; Alicia,19,0,20,1
1713315507463,LISP 5B,A00,507671,Munoz Sanchez; Alicia,17,0,20,3
1713315508493,LISP 5C,A00,507696,Munoz Sanchez; Alicia,17,0,20,3
1713315509520,MAE 197,001,528363,Boechler; Nicholas Sebastia,9998,0,9999,1
1713315510545,MATH 197,001,523477,Kedlaya; Kiran S.,9999,0,9999,0
1713315510545,MATH 197,002,563811,Zhang; Danna,9999,0,9999,0
1713315511571,MCWP 40R,A00,518780,Staff,20,0,20,0
1713315511571,MCWP 40R,B00,518781,Staff,19,0,20,1
1713315511571,MCWP 40R,C00,518783,Staff,19,0,20,1
1713315512597,MCWP 50R,A00,518791,Staff,20,0,20,0
1713315512597,MCWP 50R,B00,518792,Staff,17,0,20,3
1713315512597,MCWP 50R,C00,518793,Staff,19,0,20,1
1713315512597,MCWP 50R,D00,518794,Staff,18,0,20,2
1713315512597,MCWP 50R,E00,518795,Staff,18,0,20,2
1713315512597,MCWP 50R,F00,518796,Staff,19,0,20,1
1713315512597,MCWP 50R,G00,518797,Staff,19,0,20,1
1713315513625,MMW 12R,A01,514034,Herbst; Matthew,15,0,16,1
1713315513625,MMW 12R,A02,514035,Herbst; Matthew,16,0,16,0
1713315514650,MMW 13R,A01,514037,Staff,12,0,16,4
1713315514650,MMW 13R,A02,514039,Staff,16,0,16,0
1713315516701,SIO 295LS,A00,523233,Staff,19,0,30,11
1713315517734,SIO 295S,A00,523232,Staff,19,0,30,11
1713315518760,SOCI 117,A01,494376,Staff,3,0,5,2
1713315519788,WES 237B,A00,494380,Staff,19,0,20,1
1713315521855,AESE 279B,A00,494370,Wade; Jon P,33,0,33,0
1713315522885,ANAR 135S,A00,494369,Braswell; Geoffrey E.,0,0,0,0
1713315523911,CAT 124RS,A01,519847,Geibel; William,17,0,20,3
1713315524936,CAT 125RS,A01,515971,Geibel; William,17,0,20,3
1713315525962,CLRE 250,A00,511389,Morris; Sheldon,9996,0,9999,3
1713315526988,CLRE 251,A00,507176,Mehta; Ravindra L.,9996,0,9999,3
1713315526988,CLRE 251,B00,511410,Mehta; Ravindra L.,9998,0,9999,1
1713315528013,CLRE 252,A00,507189,Cuomo; Raphael Eduardo,9998,0,9999,1
1713315529039,CLRE 253,A00,507199,Vaida; Florin,9997,0,9999,2
1713315529039,CLRE 253,B00,507202,Vaida; Florin,9999,0,9999,0
1713315530069,CLRE 259,A00,507211,Patel; Hemal,9996,0,9999,3
1713315531096,CLRE 260,A00,507221,Cuomo; Raphael Eduardo,9999,0,9999,0
1713315532123,CLRE 297,001,507242,Cuomo; Raphael Eduardo,9999,0,9999,0
1713315533148,CSE 191,A00,516875,Minnes Kemp; Mor Mia,9999,0,9999,0
1713315534174,CSS 201S,A01,494383,Staff,35,0,35,0
1713315535199,CSS 202S,A01,494387,Staff,35,0,35,0
1713315536225,EAP 100,A00,516065,Staff,9792,0,9999,207
1713315537254,ECE 45,A01,507414,Staff,54,0,60,6
1713315538280,ECE 100,A01,507416,Baghdadchi; Saharnaz,11,0,20,9
1713315538280,ECE 100,A02,507418,Baghdadchi; Saharnaz,20,0,20,0
1713315539306,ECE 111,A01,507420,Staff,40,0,50,10
1713315540331,ECE 197,001,548057,Sievenpiper; Daniel F.,9998,0,9999,1
1713315541361,EDS 115,A00,507243,Choi; Bailey Miyeon,28,0,28,0
1713315542387,EDS 117,A01,494379,Staff,24,0,25,1
1713315543413,EDS 125,A00,507246,Hopkins; Megan Beth,29,0,30,1
1713315544444,EDS 128A,A01,507264,Fargason; Sharon Gayle,26,0,26,0
1713315545474,EDS 128B,A01,507293,Pappas; Elizabeth,30,0,30,0
1713315546500,EDS 139,A00,507294,Fargason; Sharon Gayle,30,0,30,0
1713315546500,EDS 139,B00,507313,Pappas; Elizabeth,30,0,30,0
1713315547529,EDS 201,A00,507315,Staff,26,0,30,4
1713315548555,EDS 203,A01,507317,Halter; Christopher P.,26,0,30,4
1713315549581,EDS 204R,A01,507319,Halter; Christopher P.,4,0,30,26
1713315549581,EDS 204R,B01,507331,Heinzman; Erica M.,28,0,30,2
1713315550607,EDS 206R,A00,507332,Staff,5,0,30,25
1713315550607,EDS 206R,B00,507343,Staff,28,0,30,2
1713315551634,EDS 250,A00,507344,Hemans; Patricia Ann Benitez,36,0,40,4
1713315552663,EDS 281,A00,507345,Daly; Alan J.,18,0,18,0
1713315553691,EDS 284,A00,507350,Daly; Alan J.,16,0,16,0
1713315554721,EDS 286,A00,507359,Fine; Sarah,18,0,18,0
1713315555750,EDS 289C,A01,507361,Daly; Alan J.,18,0,18,0
1713315556774,EDS 290,A00,507366,Hofstetter; Carolyn,15,0,15,0
1713315557800,LIGM 5A,A00,507421,Fischer-Grunski; Eva K,20,0,20,0
1713315558827,LIGM 5B,A00,507423,Fischer-Grunski; Eva K,20,0,20,0
1713315559913,LIGM 5C,A00,507425,Fischer-Grunski; Eva K,20,0,20,0
1713315560942,LIIT 5AS,A00,507427,Carnelos; Chiara,20,0,20,0
1713315561970,LIIT 5BS,A00,507430,Carnelos; Chiara,20,0,20,0
1713315562998,LIIT 5CS,A00,507432,Carnelos; Chiara,20,0,20,0
1713315564027,LISP 5A,A00,507541,Munoz Sanchez; Alicia,19,0,20,1
1713315565063,LISP 5B,A00,507671,Munoz Sanchez; Alicia,17,0,20,3
1713315566088,LISP 5C,A00,507696,Munoz Sanchez; Alicia,17,0,20,3
1713315567113,MAE 197,001,528363,Boechler; Nicholas Sebastia,9998,0,9999,1
1713315568150,MATH 197,001,523477,Kedlaya; Kiran S.,9999,0,9999,0
1713315568150,MATH 197,002,563811,Zhang; Danna,9999,0,9999,0
1713315569176,MCWP 40R,A00,518780,Staff,20,0,20,0
1713315569176,MCWP 40R,B00,518781,Staff,19,0,20,1
1713315569176,MCWP 40R,C00,518783,Staff,19,0,20,1
1713315570202,MCWP 50R,A00,518791,Staff,20,0,20,0
1713315570202,MCWP 50R,B00,518792,Staff,17,0,20,3
1713315570202,MCWP 50R,C00,518793,Staff,19,0,20,1
1713315570202,MCWP 50R,D00,518794,Staff,18,0,20,2
1713315570202,MCWP 50R,E00,518795,Staff,18,0,20,2
1713315570202,MCWP 50R,F00,518796,Staff,19,0,20,1
1713315570202,MCWP 50R,G00,518797,Staff,19,0,20,1
1713315571231,MMW 12R,A01,514034,Herbst; Matthew,15,0,16,1
1713315571231,MMW 12R,A02,514035,Herbst; Matthew,16,0,16,0
1713315572259,MMW 13R,A01,514037,Staff,12,0,16,4
1713315572259,MMW 13R,A02,514039,Staff,16,0,16,0
1713315574311,SIO 295LS,A00,523233,Staff,19,0,30,11
1713315575339,SIO 295S,A00,523232,Staff,19,0,30,11
1713315576367,SOCI 117,A01,494376,Staff,3,0,5,2
1713315577391,WES 237B,A00,494380,Staff,19,0,20,1
1713315579456,AESE 279B,A00,494370,Wade; Jon P,33,0,33,0
1713315580497,ANAR 135S,A00,494369,Braswell; Geoffrey E.,0,0,0,0
1713315581525,CAT 124RS,A01,519847,Geibel; William,17,0,20,3
1713315582549,CAT 125RS,A01,515971,Geibel; William,17,0,20,3
1713315583574,CLRE 250,A00,511389,Morris; Sheldon,9996,0,9999,3
1713315584604,CLRE 251,A00,507176,Mehta; Ravindra L.,9996,0,9999,3
1713315584604,CLRE 251,B00,511410,Mehta; Ravindra L.,9998,0,9999,1
1713315585632,CLRE 252,A00,507189,Cuomo; Raphael Eduardo,9998,0,9999,1
1713315586660,CLRE 253,A00,507199,Vaida; Florin,9997,0,9999,2
1713315586660,CLRE 253,B00,507202,Vaida; Florin,9999,0,9999,0
1713315587687,CLRE 259,A00,507211,Patel; Hemal,9996,0,9999,3
1713315588712,CLRE 260,A00,507221,Cuomo; Raphael Eduardo,9999,0,9999,0
1713315589737,CLRE 297,001,507242,Cuomo; Raphael Eduardo,9999,0,9999,0
1713315590762,CSE 191,A00,516875,Minnes Kemp; Mor Mia,9999,0,9999,0
1713315591787,CSS 201S,A01,494383,Staff,35,0,35,0
1713315592813,CSS 202S,A01,494387,Staff,35,0,35,0
1713315593838,EAP 100,A00,516065,Staff,9792,0,9999,207
1713315594864,ECE 45,A01,507414,Staff,54,0,60,6
1713315595890,ECE 100,A01,507416,Baghdadchi; Saharnaz,11,0,20,9
1713315595890,ECE 100,A02,507418,Baghdadchi; Saharnaz,20,0,20,0
1713315596915,ECE 111,A01,507420,Staff,40,0,50,10
1713315597944,ECE 197,001,548057,Sievenpiper; Daniel F.,9998,0,9999,1
1713315598970,EDS 115,A00,507243,Choi; Bailey Miyeon,28,0,28,0
1713315600000,EDS 117,A01,494379,Staff,24,0,25,1
1713315601026,EDS 125,A00,507246,Hopkins; Megan Beth,29,0,30,1
1713315602072,EDS 128A,A01,507264,Fargason; Sharon Gayle,26,0,26,0
1713315603107,EDS 128B,A01,507293,Pappas; Elizabeth,30,0,30,0
1713315604136,EDS 139,A00,507294,Fargason; Sharon Gayle,30,0,30,0
1713315604136,EDS 139,B00,507313,Pappas; Elizabeth,30,0,30,0
1713315605162,EDS 201,A00,507315,Staff,26,0,30,4
1713315606188,EDS 203,A01,507317,Halter; Christopher P.,26,0,30,4
1713315607292,EDS 204R,A01,507319,Halter; Christopher P.,4,0,30,26
1713315607292,EDS 204R,B01,507331,Heinzman; Erica M.,28,0,30,2
1713315608322,EDS 206R,A00,507332,Staff,5,0,30,25
1713315608322,EDS 206R,B00,507343,Staff,28,0,30,2
1713315609349,EDS 250,A00,507344,Hemans; Patricia Ann Benitez,36,0,40,4
1713315610375,EDS 281,A00,507345,Daly; Alan J.,18,0,18,0
1713315611400,EDS 284,A00,507350,Daly; Alan J.,16,0,16,0
1713315612425,EDS 286,A00,507359,Fine; Sarah,18,0,18,0
1713315613450,EDS 289C,A01,507361,Daly; Alan J.,18,0,18,0
1713315614476,EDS 290,A00,507366,Hofstetter; Carolyn,15,0,15,0
1713315615504,LIGM 5A,A00,507421,Fischer-Grunski; Eva K,20,0,20,0
1713315616529,LIGM 5B,A00,507423,Fischer-Grunski; Eva K,20,0,20,0
1713315617556,LIGM 5C,A00,507425,Fischer-Grunski; Eva K,20,0,20,0
1713315618589,LIIT 5AS,A00,507427,Carnelos; Chiara,20,0,20,0
1713315619615,LIIT 5BS,A00,507430,Carnelos; Chiara,20,0,20,0
1713315620640,LIIT 5CS,A00,507432,Carnelos; Chiara,20,0,20,0
1713315621666,LISP 5A,A00,507541,Munoz Sanchez; Alicia,19,0,20,1
1713315622692,LISP 5B,A00,507671,Munoz Sanchez; Alicia,17,0,20,3
1713315623719,LISP 5C,A00,507696,Munoz Sanchez; Alicia,17,0,20,3
1713315624746,MAE 197,001,528363,Boechler; Nicholas Sebastia,9998,0,9999,1
1713315625776,MATH 197,001,523477,Kedlaya; Kiran S.,9999,0,9999,0
1713315625776,MATH 197,002,563811,Zhang; Danna,9999,0,9999,0
1713315626805,MCWP 40R,A00,518780,Staff,20,0,20,0
1713315626805,MCWP 40R,B00,518781,Staff,19,0,20,1
1713315626805,MCWP 40R,C00,518783,Staff,19,0,20,1
1713315627830,MCWP 50R,A00,518791,Staff,20,0,20,0
1713315627830,MCWP 50R,B00,518792,Staff,17,0,20,3
1713315627830,MCWP 50R,C00,518793,Staff,19,0,20,1
1713315627830,MCWP 50R,D00,518794,Staff,18,0,20,2
1713315627830,MCWP 50R,E00,518795,Staff,18,0,20,2
1713315627830,MCWP 50R,F00,518796,Staff,19,0,20,1
1713315627830,MCWP 50R,G00,518797,Staff,19,0,20,1
1713315628858,MMW 12R,A01,514034,Herbst; Matthew,15,0,16,1
1713315628858,MMW 12R,A02,514035,Herbst; Matthew,16,0,16,0
1713315629883,MMW 13R,A01,514037,Staff,12,0,16,4
1713315629883,MMW 13R,A02,514039,Staff,16,0,16,0
1713315631940,SIO 295LS,A00,523233,Staff,19,0,30,11
1713315632970,SIO 295S,A00,523232,Staff,19,0,30,11
1713315633996,SOCI 117,A01,494376,Staff,3,0,5,2
1713315635026,WES 237B,A00,494380,Staff,19,0,20,1
1713315637095,AESE 279B,A00,494370,Wade; Jon P,33,0,33,0
1713315638126,ANAR 135S,A00,494369,Braswell; Geoffrey E.,0,0,0,0
1713315639153,CAT 124RS,A01,519847,Geibel; William,17,0,20,3
1713315640180,CAT 125RS,A01,515971,Geibel; William,17,0,20,3
1713315641206,CLRE 250,A00,511389,Morris; Sheldon,9996,0,9999,3
1713315642237,CLRE 251,A00,507176,Mehta; Ravindra L.,9996,0,9999,3
1713315642237,CLRE 251,B00,511410,Mehta; Ravindra L.,9998,0,9999,1
1713315643265,CLRE 252,A00,507189,Cuomo; Raphael Eduardo,9998,0,9999,1
1713315644293,CLRE 253,A00,507199,Vaida; Florin,9997,0,9999,2
1713315644293,CLRE 253,B00,507202,Vaida; Florin,9999,0,9999,0
1713315645323,CLRE 259,A00,507211,Patel; Hemal,9996,0,9999,3
1713315646349,CLRE 260,A00,507221,Cuomo; Raphael Eduardo,9999,0,9999,0
1713315647376,CLRE 297,001,507242,Cuomo; Raphael Eduardo,9999,0,9999,0
1713315648402,CSE 191,A00,516875,Minnes Kemp; Mor Mia,9999,0,9999,0
1713315649428,CSS 201S,A01,494383,Staff,35,0,35,0
1713315650453,CSS 202S,A01,494387,Staff,35,0,35,0
1713315651480,EAP 100,A00,516065,Staff,9792,0,9999,207
1713315652509,ECE 45,A01,507414,Staff,54,0,60,6
1713315653538,ECE 100,A01,507416,Baghdadchi; Saharnaz,11,0,20,9
1713315653538,ECE 100,A02,507418,Baghdadchi; Saharnaz,20,0,20,0
1713315654567,ECE 111,A01,507420,Staff,40,0,50,10
1713315655596,ECE 197,001,548057,Sievenpiper; Daniel F.,9998,0,9999,1
1713315656626,EDS 115,A00,507243,Choi; Bailey Miyeon,28,0,28,0
1713315657656,EDS 117,A01,494379,Staff,24,0,25,1
1713315658686,EDS 125,A00,507246,Hopkins; Megan Beth,29,0,30,1
1713315659711,EDS 128A,A01,507264,Fargason; Sharon Gayle,26,0,26,0
1713315660736,EDS 128B,A01,507293,Pappas; Elizabeth,30,0,30,0
1713315661762,EDS 139,A00,507294,Fargason; Sharon Gayle,30,0,30,0
1713315661762,EDS 139,B00,507313,Pappas; Elizabeth,30,0,30,0
1713315662788,EDS 201,A00,507315,Staff,26,0,30,4
1713315663877,EDS 203,A01,507317,Halter; Christopher P.,26,0,30,4
1713315664904,EDS 204R,A01,507319,Halter; Christopher P.,4,0,30,26
1713315664904,EDS 204R,B01,507331,Heinzman; Erica M.,28,0,30,2
1713315665930,EDS 206R,A00,507332,Staff,5,0,30,25
1713315665930,EDS 206R,B00,507343,Staff,28,0,30,2
1713315666960,EDS 250,A00,507344,Hemans; Patricia Ann Benitez,36,0,40,4
1713315667987,EDS 281,A00,507345,Daly; Alan J.,18,0,18,0
1713315669011,EDS 284,A00,507350,Daly; Alan J.,16,0,16,0
1713315670041,EDS 286,A00,507359,Fine; Sarah,18,0,18,0
1713315671069,EDS 289C,A01,507361,Daly; Alan J.,18,0,18,0
1713315672098,EDS 290,A00,507366,Hofstetter; Carolyn,15,0,15,0
1713315673125,LIGM 5A,A00,507421,Fischer-Grunski; Eva K,20,0,20,0
1713315674151,LIGM 5B,A00,507423,Fischer-Grunski; Eva K,20,0,20,0
1713315675178,LIGM 5C,A00,507425,Fischer-Grunski; Eva K,20,0,20,0
1713315676203,LIIT 5AS,A00,507427,Carnelos; Chiara,20,0,20,0
1713315677227,LIIT 5BS,A00,507430,Carnelos; Chiara,20,0,20,0
1713315678257,LIIT 5CS,A00,507432,Carnelos; Chiara,20,0,20,0
1713315679287,LISP 5A,A00,507541,Munoz Sanchez; Alicia,19,0,20,1
1713315680311,LISP 5B,A00,507671,Munoz Sanchez; Alicia,17,0,20,3
1713315681341,LISP 5C,A00,507696,Munoz Sanchez; Alicia,17,0,20,3
1713315682367,MAE 197,001,528363,Boechler; Nicholas Sebastia,9998,0,9999,1
1713315683393,MATH 197,001,523477,Kedlaya; Kiran S.,9999,0,9999,0
1713315683393,MATH 197,002,563811,Zhang; Danna,9999,0,9999,0
1713315684418,MCWP 40R,A00,518780,Staff,20,0,20,0
1713315684418,MCWP 40R,B00,518781,Staff,19,0,20,1
1713315684418,MCWP 40R,C00,518783,Staff,19,0,20,1
1713315685449,MCWP 50R,A00,518791,Staff,20,0,20,0
1713315685449,MCWP 50R,B00,518792,Staff,17,0,20,3
1713315685449,MCWP 50R,C00,518793,Staff,19,0,20,1
1713315685449,MCWP 50R,D00,518794,Staff,18,0,20,2
1713315685449,MCWP 50R,E00,518795,Staff,18,0,20,2
1713315685449,MCWP 50R,F00,518796,Staff,19,0,20,1
1713315685449,MCWP 50R,G00,518797,Staff,19,0,20,1
1713315686472,MMW 12R,A01,514034,Herbst; Matthew,15,0,16,1
1713315686472,MMW 12R,A02,514035,Herbst; Matthew,16,0,16,0
1713315687497,MMW 13R,A01,514037,Staff,12,0,16,4
1713315687497,MMW 13R,A02,514039,Staff,16,0,16,0
1713315689550,SIO 295LS,A00,523233,Staff,19,0,30,11
1713315690584,SIO 295S,A00,523232,Staff,19,0,30,11
1713315691614,SOCI 117,A01,494376,Staff,3,0,5,2
1713315692643,WES 237B,A00,494380,Staff,19,0,20,1
1713315694709,AESE 279B,A00,494370,Wade; Jon P,33,0,33,0
1713315695736,ANAR 135S,A00,494369,Braswell; Geoffrey E.,0,0,0,0
1713315696761,CAT 124RS,A01,519847,Geibel; William,17,0,20,3
1713315697787,CAT 125RS,A01,515971,Geibel; William,17,0,20,3
1713315698813,CLRE 250,A00,511389,Morris; Sheldon,9996,0,9999,3
1713315699839,CLRE 251,A00,507176,Mehta; Ravindra L.,9996,0,9999,3
1713315699839,CLRE 251,B00,511410,Mehta; Ravindra L.,9998,0,9999,1
1713315700865,CLRE 252,A00,507189,Cuomo; Raphael Eduardo,9998,0,9999,1
1713315701892,CLRE 253,A00,507199,Vaida; Florin,9997,0,9999,2
1713315701892,CLRE 253,B00,507202,Vaida; Florin,9999,0,9999,0
1713315702923,CLRE 259,A00,507211,Patel; Hemal,9996,0,9999,3
1713315703951,CLRE 260,A00,507221,Cuomo; Raphael Eduardo,9999,0,9999,0
1713315704976,CLRE 297,001,507242,Cuomo; Raphael Eduardo,9999,0,9999,0
1713315706000,CSE 191,A00,516875,Minnes Kemp; Mor Mia,9999,0,9999,0
1713315707035,CSS 201S,A01,494383,Staff,35,0,35,0
1713315708066,CSS 202S,A01,494387,Staff,35,0,35,0
1713315709090,EAP 100,A00,516065,Staff,9792,0,9999,207
1713315710116,ECE 45,A01,507414,Staff,54,0,60,6
1713315711141,ECE 100,A01,507416,Baghdadchi; Saharnaz,11,0,20,9
1713315711141,ECE 100,A02,507418,Baghdadchi; Saharnaz,20,0,20,0
1713315712170,ECE 111,A01,507420,Staff,40,0,50,10
1713315713199,ECE 197,001,548057,Sievenpiper; Daniel F.,9998,0,9999,1
1713315714228,EDS 115,A00,507243,Choi; Bailey Miyeon,28,0,28,0
1713315715257,EDS 117,A01,494379,Staff,24,0,25,1
1713315716288,EDS 125,A00,507246,Hopkins; Megan Beth,29,0,30,1
1713315717313,EDS 128A,A01,507264,Fargason; Sharon Gayle,26,0,26,0
1713315718338,EDS 128B,A01,507293,Pappas; Elizabeth,30,0,30,0
1713315719367,EDS 139,A00,507294,Fargason; Sharon Gayle,30,0,30,0
1713315719367,EDS 139,B00,507313,Pappas; Elizabeth,30,0,30,0
1713315720395,EDS 201,A00,507315,Staff,26,0,30,4
1713315721423,EDS 203,A01,507317,Halter; Christopher P.,26,0,30,4
1713315722446,EDS 204R,A01,507319,Halter; Christopher P.,4,0,30,26
1713315722446,EDS 204R,B01,507331,Heinzman; Erica M.,28,0,30,2
1713315723472,EDS 206R,A00,507332,Staff,5,0,30,25
1713315723472,EDS 206R,B00,507343,Staff,28,0,30,2
1713315724501,EDS 250,A00,507344,Hemans; Patricia Ann Benitez,36,0,40,4
1713315725525,EDS 281,A00,507345,Daly; Alan J.,18,0,18,0
1713315726552,EDS 284,A00,507350,Daly; Alan J.,16,0,16,0
1713315727582,EDS 286,A00,507359,Fine; Sarah,18,0,18,0
1713315728607,EDS 289C,A01,507361,Daly; Alan J.,18,0,18,0
1713315729635,EDS 290,A00,507366,Hofstetter; Carolyn,15,0,15,0
1713315730660,LIGM 5A,A00,507421,Fischer-Grunski; Eva K,20,0,20,0
1713315731688,LIGM 5B,A00,507423,Fischer-Grunski; Eva K,20,0,20,0
1713315732712,LIGM 5C,A00,507425,Fischer-Grunski; Eva K,20,0,20,0
1713315733738,LIIT 5AS,A00,507427,Carnelos; Chiara,20,0,20,0
1713315734765,LIIT 5BS,A00,507430,Carnelos; Chiara,20,0,20,0
1713315735794,LIIT 5CS,A00,507432,Carnelos; Chiara,20,0,20,0
1713315736825,LISP 5A,A00,507541,Munoz Sanchez; Alicia,19,0,20,1
1713315737851,LISP 5B,A00,507671,Munoz Sanchez; Alicia,17,0,20,3
1713315738882,LISP 5C,A00,507696,Munoz Sanchez; Alicia,17,0,20,3
1713315739906,MAE 197,001,528363,Boechler; Nicholas Sebastia,9998,0,9999,1
1713315740931,MATH 197,001,523477,Kedlaya; Kiran S.,9999,0,9999,0
1713315740931,MATH 197,002,563811,Zhang; Danna,9999,0,9999,0
1713315741957,MCWP 40R,A00,518780,Staff,20,0,20,0
1713315741957,MCWP 40R,B00,518781,Staff,19,0,20,1
1713315741957,MCWP 40R,C00,518783,Staff,19,0,20,1
1713315742983,MCWP 50R,A00,518791,Staff,20,0,20,0
1713315742983,MCWP 50R,B00,518792,Staff,17,0,20,3
1713315742983,MCWP 50R,C00,518793,Staff,19,0,20,1
1713315742983,MCWP 50R,D00,518794,Staff,18,0,20,2
1713315742983,MCWP 50R,E00,518795,Staff,18,0,20,2
1713315742983,MCWP 50R,F00,518796,Staff,19,0,20,1
1713315742983,MCWP 50R,G00,518797,Staff,19,0,20,1
1713315744008,MMW 12R,A01,514034,Herbst; Matthew,15,0,16,1
1713315744008,MMW 12R,A02,514035,Herbst; Matthew,16,0,16,0
1713315745035,MMW 13R,A01,514037,Staff,12,0,16,4
1713315745035,MMW 13R,A02,514039,Staff,16,0,16,0
1713315747090,SIO 295LS,A00,523233,Staff,19,0,30,11
1713315748115,SIO 295S,A00,523232,Staff,19,0,30,11
1713315749143,SOCI 117,A01,494376,Staff,3,0,5,2
1713315750167,WES 237B,A00,494380,Staff,19,0,20,1
1713315752232,AESE 279B,A00,494370,Wade; Jon P,33,0,33,0
1713315753257,ANAR 135S,A00,494369,Braswell; Geoffrey E.,0,0,0,0
1713315754287,CAT 124RS,A01,519847,Geibel; William,17,0,20,3
1713315755312,CAT 125RS,A01,515971,Geibel; William,17,0,20,3
1713315756341,CLRE 250,A00,511389,Morris; Sheldon,9996,0,9999,3
1713315757370,CLRE 251,A00,507176,Mehta; Ravindra L.,9996,0,9999,3
1713315757370,CLRE 251,B00,511410,Mehta; Ravindra L.,9998,0,9999,1
1713315758398,CLRE 252,A00,507189,Cuomo; Raphael Eduardo,9998,0,9999,1
1713315759424,CLRE 253,A00,507199,Vaida; Florin,9997,0,9999,2
1713315759424,CLRE 253,B00,507202,Vaida; Florin,9999,0,9999,0
1713315760453,CLRE 259,A00,507211,Patel; Hemal,9996,0,9999,3
1713315761479,CLRE 260,A00,507221,Cuomo; Raphael Eduardo,9999,0,9999,0
1713315762506,CLRE 297,001,507242,Cuomo; Raphael Eduardo,9999,0,9999,0
1713315763532,CSE 191,A00,516875,Minnes Kemp; Mor Mia,9999,0,9999,0
1713315764559,CSS 201S,A01,494383,Staff,35,0,35,0
1713315765587,CSS 202S,A01,494387,Staff,35,0,35,0
1713315766617,EAP 100,A00,516065,Staff,9792,0,9999,207
1713315767697,ECE 45,A01,507414,Staff,54,0,60,6
1713315768723,ECE 100,A01,507416,Baghdadchi; Saharnaz,11,0,20,9
1713315768723,ECE 100,A02,507418,Baghdadchi; Saharnaz,20,0,20,0
1713315769746,ECE 111,A01,507420,Staff,40,0,50,10
1713315770772,ECE 197,001,548057,Sievenpiper; Daniel F.,9998,0,9999,1
1713315771797,EDS 115,A00,507243,Choi; Bailey Miyeon,28,0,28,0
1713315772822,EDS 117,A01,494379,Staff,24,0,25,1
1713315773850,EDS 125,A00,507246,Hopkins; Megan Beth,29,0,30,1
1713315774881,EDS 128A,A01,507264,Fargason; Sharon Gayle,26,0,26,0
1713315775907,EDS 128B,A01,507293,Pappas; Elizabeth,30,0,30,0
1713315776935,EDS 139,A00,507294,Fargason; Sharon Gayle,30,0,30,0
1713315776935,EDS 139,B00,507313,Pappas; Elizabeth,30,0,30,0
1713315777959,EDS 201,A00,507315,Staff,26,0,30,4
1713315778989,EDS 203,A01,507317,Halter; Christopher P.,26,0,30,4
1713315780015,EDS 204R,A01,507319,Halter; Christopher P.,4,0,30,26
1713315780015,EDS 204R,B01,507331,Heinzman; Erica M.,28,0,30,2
1713315781041,EDS 206R,A00,507332,Staff,5,0,30,25
1713315781041,EDS 206R,B00,507343,Staff,28,0,30,2
1713315782069,EDS 250,A00,507344,Hemans; Patricia Ann Benitez,36,0,40,4
1713315783094,EDS 281,A00,507345,Daly; Alan J.,18,0,18,0
1713315784118,EDS 284,A00,507350,Daly; Alan J.,16,0,16,0
1713315785148,EDS 286,A00,507359,Fine; Sarah,18,0,18,0
1713315786175,EDS 289C,A01,507361,Daly; Alan J.,18,0,18,0
1713315787202,EDS 290,A00,507366,Hofstetter; Carolyn,15,0,15,0
1713315788231,LIGM 5A,A00,507421,Fischer-Grunski; Eva K,20,0,20,0
1713315789256,LIGM 5B,A00,507423,Fischer-Grunski; Eva K,20,0,20,0
1713315790286,LIGM 5C,A00,507425,Fischer-Grunski; Eva K,20,0,20,0
1713315791311,LIIT 5AS,A00,507427,Carnelos; Chiara,20,0,20,0
1713315792336,LIIT 5BS,A00,507430,Carnelos; Chiara,20,0,20,0
1713315793360,LIIT 5CS,A00,507432,Carnelos; Chiara,20,0,20,0
1713315794387,LISP 5A,A00,507541,Munoz Sanchez; Alicia,19,0,20,1
1713315795416,LISP 5B,A00,507671,Munoz Sanchez; Alicia,17,0,20,3
1713315796441,LISP 5C,A00,507696,Munoz Sanchez; Alicia,17,0,20,3
1713315797468,MAE 197,001,528363,Boechler; Nicholas Sebastia,9998,0,9999,1
1713315798493,MATH 197,001,523477,Kedlaya; Kiran S.,9999,0,9999,0
1713315798493,MATH 197,002,563811,Zhang; Danna,9999,0,9999,0
1713315799518,MCWP 40R,A00,518780,Staff,20,0,20,0
1713315799518,MCWP 40R,B00,518781,Staff,19,0,20,1
1713315799518,MCWP 40R,C00,518783,Staff,19,0,20,1
1713315800550,MCWP 50R,A00,518791,Staff,20,0,20,0
1713315800550,MCWP 50R,B00,518792,Staff,17,0,20,3
1713315800550,MCWP 50R,C00,518793,Staff,19,0,20,1
1713315800550,MCWP 50R,D00,518794,Staff,18,0,20,2
1713315800550,MCWP 50R,E00,518795,Staff,18,0,20,2
1713315800550,MCWP 50R,F00,518796,Staff,19,0,20,1
1713315800550,MCWP 50R,G00,518797,Staff,19,0,20,1
1713315801579,MMW 12R,A01,514034,Herbst; Matthew,15,0,16,1
1713315801579,MMW 12R,A02,514035,Herbst; Matthew,16,0,16,0
1713315802605,MMW 13R,A01,514037,Staff,12,0,16,4
1713315802605,MMW 13R,A02,514039,Staff,16,0,16,0
1713315804656,SIO 295LS,A00,523233,Staff,19,0,30,11
1713315805682,SIO 295S,A00,523232,Staff,19,0,30,11
1713315806707,SOCI 117,A01,494376,Staff,3,0,5,2
1713315807733,WES 237B,A00,494380,Staff,19,0,20,1
1713315809801,AESE 279B,A00,494370,Wade; Jon P,33,0,33,0
1713315810830,ANAR 135S,A00,494369,Braswell; Geoffrey E.,0,0,0,0
1713315811859,CAT 124RS,A01,519847,Geibel; William,17,0,20,3
1713315812885,CAT 125RS,A01,515971,Geibel; William,17,0,20,3
1713315813910,CLRE 250,A00,511389,Morris; Sheldon,9996,0,9999,3
1713315814938,CLRE 251,A00,507176,Mehta; Ravindra L.,9996,0,9999,3
1713315814938,CLRE 251,B00,511410,Mehta; Ravindra L.,9998,0,9999,1
1713315815963,CLRE 252,A00,507189,Cuomo; Raphael Eduardo,9998,0,9999,1
1713315816987,CLRE 253,A00,507199,Vaida; Florin,9997,0,9999,2
1713315816987,CLRE 253,B00,507202,Vaida; Florin,9999,0,9999,0
1713315818013,CLRE 259,A00,507211,Patel; Hemal,9996,0,9999,3
1713315819038,CLRE 260,A00,507221,Cuomo; Raphael Eduardo,9999,0,9999,0
1713315820065,CLRE 297,001,507242,Cuomo; Raphael Eduardo,9999,0,9999,0
1713315821090,CSE 191,A00,516875,Minnes Kemp; Mor Mia,9999,0,9999,0
1713315822120,CSS 201S,A01,494383,Staff,35,0,35,0
1713315823146,CSS 202S,A01,494387,Staff,35,0,35,0
1713315824175,EAP 100,A00,516065,Staff,9792,0,9999,207
1713315825202,ECE 45,A01,507414,Staff,54,0,60,6
1713315826231,ECE 100,A01,507416,Baghdadchi; Saharnaz,11,0,20,9
1713315826231,ECE 100,A02,507418,Baghdadchi; Saharnaz,20,0,20,0
1713315827257,ECE 111,A01,507420,Staff,40,0,50,10
1713315828282,ECE 197,001,548057,Sievenpiper; Daniel F.,9998,0,9999,1
1713315829312,EDS 115,A00,507243,Choi; Bailey Miyeon,28,0,28,0
1713315830339,EDS 117,A01,494379,Staff,24,0,25,1
1713315831365,EDS 125,A00,507246,Hopkins; Megan Beth,29,0,30,1
1713315832392,EDS 128A,A01,507264,Fargason; Sharon Gayle,26,0,26,0
1713315833417,EDS 128B,A01,507293,Pappas; Elizabeth,30,0,30,0
1713315834442,EDS 139,A00,507294,Fargason; Sharon Gayle,30,0,30,0
1713315834442,EDS 139,B00,507313,Pappas; Elizabeth,30,0,30,0
1713315835468,EDS 201,A00,507315,Staff,26,0,30,4
1713315836494,EDS 203,A01,507317,Halter; Christopher P.,26,0,30,4
1713315837518,EDS 204R,A01,507319,Halter; Christopher P.,4,0,30,26
1713315837518,EDS 204R,B01,507331,Heinzman; Erica M.,28,0,30,2
1713315838543,EDS 206R,A00,507332,Staff,5,0,30,25
1713315838543,EDS 206R,B00,507343,Staff,28,0,30,2
1713315839572,EDS 250,A00,507344,Hemans; Patricia Ann Benitez,36,0,40,4
1713315840598,EDS 281,A00,507345,Daly; Alan J.,18,0,18,0
1713315841625,EDS 284,A00,507350,Daly; Alan J.,16,0,16,0
1713315842655,EDS 286,A00,507359,Fine; Sarah,18,0,18,0
1713315843680,EDS 289C,A01,507361,Daly; Alan J.,18,0,18,0
1713315844705,EDS 290,A00,507366,Hofstetter; Carolyn,15,0,15,0
1713315845734,LIGM 5A,A00,507421,Fischer-Grunski; Eva K,20,0,20,0
1713315846757,LIGM 5B,A00,507423,Fischer-Grunski; Eva K,20,0,20,0
1713315847783,LIGM 5C,A00,507425,Fischer-Grunski; Eva K,20,0,20,0
1713315848808,LIIT 5AS,A00,507427,Carnelos; Chiara,20,0,20,0
1713315849833,LIIT 5BS,A00,507430,Carnelos; Chiara,20,0,20,0
1713315850864,LIIT 5CS,A00,507432,Carnelos; Chiara,20,0,20,0
1713315851894,LISP 5A,A00,507541,Munoz Sanchez; Alicia,19,0,20,1
1713315852924,LISP 5B,A00,507671,Munoz Sanchez; Alicia,17,0,20,3
1713315853951,LISP 5C,A00,507696,Munoz Sanchez; Alicia,17,0,20,3
1713315854980,MAE 197,001,528363,Boechler; Nicholas Sebastia,9998,0,9999,1
1713315856007,MATH 197,001,523477,Kedlaya; Kiran S.,9999,0,9999,0
1713315856007,MATH 197,002,563811,Zhang; Danna,9999,0,9999,0
1713315857038,MCWP 40R,A00,518780,Staff,20,0,20,0
1713315857038,MCWP 40R,B00,518781,Staff,19,0,20,1
1713315857038,MCWP 40R,C00,518783,Staff,19,0,20,1
1713315858069,MCWP 50R,A00,518791,Staff,20,0,20,0
1713315858069,MCWP 50R,B00,518792,Staff,17,0,20,3
1713315858069,MCWP 50R,C00,518793,Staff,19,0,20,1
1713315858069,MCWP 50R,D00,518794,Staff,18,0,20,2
1713315858069,MCWP 50R,E00,518795,Staff,18,0,20,2
1713315858069,MCWP 50R,F00,518796,Staff,19,0,20,1
1713315858069,MCWP 50R,G00,518797,Staff,19,0,20,1
1713315859094,MMW 12R,A01,514034,Herbst; Matthew,15,0,16,1
1713315859094,MMW 12R,A02,514035,Herbst; Matthew,16,0,16,0
1713315860122,MMW 13R,A01,514037,Staff,12,0,16,4
1713315860122,MMW 13R,A02,514039,Staff,16,0,16,0
1713315862176,SIO 295LS,A00,523233,Staff,19,0,30,11
1713315863201,SIO 295S,A00,523232,Staff,19,0,30,11
1713315864226,SOCI 117,A01,494376,Staff,3,0,5,2
1713315865254,WES 237B,A00,494380,Staff,19,0,20,1
1713315867313,AESE 279B,A00,494370,Wade; Jon P,33,0,33,0
1713315868353,ANAR 135S,A00,494369,Braswell; Geoffrey E.,0,0,0,0
1713315869378,CAT 124RS,A01,519847,Geibel; William,17,0,20,3
1713315870407,CAT 125RS,A01,515971,Geibel; William,17,0,20,3
1713315871486,CLRE 250,A00,511389,Morris; Sheldon,9996,0,9999,3
1713315872510,CLRE 251,A00,507176,Mehta; Ravindra L.,9996,0,9999,3
1713315872510,CLRE 251,B00,511410,Mehta; Ravindra L.,9998,0,9999,1
1713315873534,CLRE 252,A00,507189,Cuomo; Raphael Eduardo,9998,0,9999,1
1713315874560,CLRE 253,A00,507199,Vaida; Florin,9997,0,9999,2
1713315874560,CLRE 253,B00,507202,Vaida; Florin,9999,0,9999,0
1713315875584,CLRE 259,A00,507211,Patel; Hemal,9996,0,9999,3
1713315876608,CLRE 260,A00,507221,Cuomo; Raphael Eduardo,9999,0,9999,0
1713315877635,CLRE 297,001,507242,Cuomo; Raphael Eduardo,9999,0,9999,0
1713315878664,CSE 191,A00,516875,Minnes Kemp; Mor Mia,9999,0,9999,0
1713315879690,CSS 201S,A01,494383,Staff,35,0,35,0
1713315880716,CSS 202S,A01,494387,Staff,35,0,35,0
1713315881748,EAP 100,A00,516065,Staff,9792,0,9999,207
1713315882777,ECE 45,A01,507414,Staff,54,0,60,6
1713315883808,ECE 100,A01,507416,Baghdadchi; Saharnaz,11,0,20,9
1713315883808,ECE 100,A02,507418,Baghdadchi; Saharnaz,20,0,20,0
1713315884835,ECE 111,A01,507420,Staff,40,0,50,10
1713315885861,ECE 197,001,548057,Sievenpiper; Daniel F.,9998,0,9999,1
1713315886895,EDS 115,A00,507243,Choi; Bailey Miyeon,28,0,28,0
1713315887925,EDS 117,A01,494379,Staff,24,0,25,1
1713315888950,EDS 125,A00,507246,Hopkins; Megan Beth,29,0,30,1
1713315889976,EDS 128A,A01,507264,Fargason; Sharon Gayle,26,0,26,0
1713315891001,EDS 128B,A01,507293,Pappas; Elizabeth,30,0,30,0
1713315892026,EDS 139,A00,507294,Fargason; Sharon Gayle,30,0,30,0
1713315892026,EDS 139,B00,507313,Pappas; Elizabeth,30,0,30,0
1713315893053,EDS 201,A00,507315,Staff,26,0,30,4
1713315894083,EDS 203,A01,507317,Halter; Christopher P.,26,0,30,4
1713315895111,EDS 204R,A01,507319,Halter; Christopher P.,4,0,30,26
1713315895111,EDS 204R,B01,507331,Heinzman; Erica M.,28,0,30,2
1713315896138,EDS 206R,A00,507332,Staff,5,0,30,25
1713315896138,EDS 206R,B00,507343,Staff,28,0,30,2
1713315897164,EDS 250,A00,507344,Hemans; Patricia Ann Benitez,36,0,40,4
1713315898191,EDS 281,A00,507345,Daly; Alan J.,18,0,18,0
1713315899216,EDS 284,A00,507350,Daly; Alan J.,16,0,16,0
1713315900246,EDS 286,A00,507359,Fine; Sarah,18,0,18,0
1713315901272,EDS 289C,A01,507361,Daly; Alan J.,18,0,18,0
1713315902298,EDS 290,A00,507366,Hofstetter; Carolyn,15,0,15,0
1713315903325,LIGM 5A,A00,507421,Fischer-Grunski; Eva K,20,0,20,0
1713315904359,LIGM 5B,A00,507423,Fischer-Grunski; Eva K,20,0,20,0
1713315905384,LIGM 5C,A00,507425,Fischer-Grunski; Eva K,20,0,20,0
1713315906410,LIIT 5AS,A00,507427,Carnelos; Chiara,20,0,20,0
1713315907437,LIIT 5BS,A00,507430,Carnelos; Chiara,20,0,20,0
1713315908467,LIIT 5CS,A00,507432,Carnelos; Chiara,20,0,20,0
1713315909495,LISP 5A,A00,507541,Munoz Sanchez; Alicia,19,0,20,1
1713315910521,LISP 5B,A00,507671,Munoz Sanchez; Alicia,17,0,20,3
1713315911552,LISP 5C,A00,507696,Munoz Sanchez; Alicia,17,0,20,3
1713315912581,MAE 197,001,528363,Boechler; Nicholas Sebastia,9998,0,9999,1
1713315913607,MATH 197,001,523477,Kedlaya; Kiran S.,9999,0,9999,0
1713315913607,MATH 197,002,563811,Zhang; Danna,9999,0,9999,0
1713315914635,MCWP 40R,A00,518780,Staff,20,0,20,0
1713315914635,MCWP 40R,B00,518781,Staff,19,0,20,1
1713315914635,MCWP 40R,C00,518783,Staff,19,0,20,1
1713315915665,MCWP 50R,A00,518791,Staff,20,0,20,0
1713315915665,MCWP 50R,B00,518792,Staff,17,0,20,3
1713315915665,MCWP 50R,C00,518793,Staff,19,0,20,1
1713315915665,MCWP 50R,D00,518794,Staff,18,0,20,2
1713315915665,MCWP 50R,E00,518795,Staff,18,0,20,2
1713315915665,MCWP 50R,F00,518796,Staff,19,0,20,1
1713315915665,MCWP 50R,G00,518797,Staff,19,0,20,1
1713315916694,MMW 12R,A01,514034,Herbst; Matthew,15,0,16,1
1713315916694,MMW 12R,A02,514035,Herbst; Matthew,16,0,16,0
1713315917719,MMW 13R,A01,514037,Staff,12,0,16,4
1713315917719,MMW 13R,A02,514039,Staff,16,0,16,0
1713315919775,SIO 295LS,A00,523233,Staff,19,0,30,11
1713315920801,SIO 295S,A00,523232,Staff,19,0,30,11
1713315921827,SOCI 117,A01,494376,Staff,3,0,5,2
1713315922852,WES 237B,A00,494380,Staff,19,0,20,1
1713315924920,AESE 279B,A00,494370,Wade; Jon P,33,0,33,0
1713315925946,ANAR 135S,A00,494369,Braswell; Geoffrey E.,0,0,0,0
1713315926972,CAT 124RS,A01,519847,Geibel; William,17,0,20,3
1713315927996,CAT 125RS,A01,515971,Geibel; William,17,0,20,3
1713315929022,CLRE 250,A00,511389,Morris; Sheldon,9996,0,9999,3
1713315930057,CLRE 251,A00,507176,Mehta; Ravindra L.,9996,0,9999,3
1713315930057,CLRE 251,B00,511410,Mehta; Ravindra L.,9998,0,9999,1
1713315931087,CLRE 252,A00,507189,Cuomo; Raphael Eduardo,9998,0,9999,1
1713315932111,CLRE 253,A00,507199,Vaida; Florin,9997,0,9999,2
1713315932111,CLRE 253,B00,507202,Vaida; Florin,9999,0,9999,0
1713315933140,CLRE 259,A00,507211,Patel; Hemal,9996,0,9999,3
1713315934165,CLRE 260,A00,507221,Cuomo; Raphael Eduardo,9999,0,9999,0
1713315935191,CLRE 297,001,507242,Cuomo; Raphael Eduardo,9999,0,9999,0
1713315936221,CSE 191,A00,516875,Minnes Kemp; Mor Mia,9999,0,9999,0
1713315937246,CSS 201S,A01,494383,Staff,35,0,35,0
1713315938275,CSS 202S,A01,494387,Staff,35,0,35,0
1713315939304,EAP 100,A00,516065,Staff,9792,0,9999,207
1713315940330,ECE 45,A01,507414,Staff,54,0,60,6
1713315941357,ECE 100,A01,507416,Baghdadchi; Saharnaz,11,0,20,9
1713315941357,ECE 100,A02,507418,Baghdadchi; Saharnaz,20,0,20,0
1713315942381,ECE 111,A01,507420,Staff,40,0,50,10
1713315943408,ECE 197,001,548057,Sievenpiper; Daniel F.,9998,0,9999,1
1713315944438,EDS 115,A00,507243,Choi; Bailey Miyeon,28,0,28,0
1713315945465,EDS 117,A01,494379,Staff,24,0,25,1
1713315946496,EDS 125,A00,507246,Hopkins; Megan Beth,29,0,30,1
1713315947531,EDS 128A,A01,507264,Fargason; Sharon Gayle,26,0,26,0
1713315948563,EDS 128B,A01,507293,Pappas; Elizabeth,30,0,30,0
1713315949588,EDS 139,A00,507294,Fargason; Sharon Gayle,30,0,30,0
1713315949588,EDS 139,B00,507313,Pappas; Elizabeth,30,0,30,0
1713315950614,EDS 201,A00,507315,Staff,26,0,30,4
1713315951639,EDS 203,A01,507317,Halter; Christopher P.,26,0,30,4
1713315952665,EDS 204R,A01,507319,Halter; Christopher P.,4,0,30,26
1713315952665,EDS 204R,B01,507331,Heinzman; Erica M.,28,0,30,2
1713315953690,EDS 206R,A00,507332,Staff,5,0,30,25
1713315953690,EDS 206R,B00,507343,Staff,28,0,30,2
1713315954719,EDS 250,A00,507344,Hemans; Patricia Ann Benitez,36,0,40,4
1713315955744,EDS 281,A00,507345,Daly; Alan J.,18,0,18,0
1713315956775,EDS 284,A00,507350,Daly; Alan J.,16,0,16,0
1713315957802,EDS 286,A00,507359,Fine; Sarah,18,0,18,0
1713315958831,EDS 289C,A01,507361,Daly; Alan J.,18,0,18,0
1713315959867,EDS 290,A00,507366,Hofstetter; Carolyn,15,0,15,0
1713315960893,LIGM 5A,A00,507421,Fischer-Grunski; Eva K,20,0,20,0
1713315961923,LIGM 5B,A00,507423,Fischer-Grunski; Eva K,20,0,20,0
1713315962951,LIGM 5C,A00,507425,Fischer-Grunski; Eva K,20,0,20,0
1713315963977,LIIT 5AS,A00,507427,Carnelos; Chiara,20,0,20,0
1713315965008,LIIT 5BS,A00,507430,Carnelos; Chiara,20,0,20,0
1713315966040,LIIT 5CS,A00,507432,Carnelos; Chiara,20,0,20,0
1713315967068,LISP 5A,A00,507541,Munoz Sanchez; Alicia,19,0,20,1
1713315968097,LISP 5B,A00,507671,Munoz Sanchez; Alicia,17,0,20,3
1713315969128,LISP 5C,A00,507696,Munoz Sanchez; Alicia,17,0,20,3
1713315970154,MAE 197,001,528363,Boechler; Nicholas Sebastia,9998,0,9999,1
1713315971180,MATH 197,001,523477,Kedlaya; Kiran S.,9999,0,9999,0
1713315971180,MATH 197,002,563811,Zhang; Danna,9999,0,9999,0
1713315972206,MCWP 40R,A00,518780,Staff,20,0,20,0
1713315972206,MCWP 40R,B00,518781,Staff,19,0,20,1
1713315972206,MCWP 40R,C00,518783,Staff,19,0,20,1
1713315973230,MCWP 50R,A00,518791,Staff,20,0,20,0
1713315973230,MCWP 50R,B00,518792,Staff,17,0,20,3
1713315973230,MCWP 50R,C00,518793,Staff,19,0,20,1
1713315973230,MCWP 50R,D00,518794,Staff,18,0,20,2
1713315973230,MCWP 50R,E00,518795,Staff,18,0,20,2
1713315973230,MCWP 50R,F00,518796,Staff,19,0,20,1
1713315973230,MCWP 50R,G00,518797,Staff,19,0,20,1
1713315974261,MMW 12R,A01,514034,Herbst; Matthew,15,0,16,1
1713315974261,MMW 12R,A02,514035,Herbst; Matthew,16,0,16,0
1713315975344,MMW 13R,A01,514037,Staff,12,0,16,4
1713315975344,MMW 13R,A02,514039,Staff,16,0,16,0
1713315977396,SIO 295LS,A00,523233,Staff,19,0,30,11
1713315978422,SIO 295S,A00,523232,Staff,19,0,30,11
1713315979447,SOCI 117,A01,494376,Staff,3,0,5,2
1713315980479,WES 237B,A00,494380,Staff,19,0,20,1
1713315982539,AESE 279B,A00,494370,Wade; Jon P,33,0,33,0
1713315983573,ANAR 135S,A00,494369,Braswell; Geoffrey E.,0,0,0,0
1713315984602,CAT 124RS,A01,519847,Geibel; William,17,0,20,3
1713315985628,CAT 125RS,A01,515971,Geibel; William,17,0,20,3
1713315986660,CLRE 250,A00,511389,Morris; Sheldon,9996,0,9999,3
1713315987686,CLRE 251,A00,507176,Mehta; Ravindra L.,9996,0,9999,3
1713315987686,CLRE 251,B00,511410,Mehta; Ravindra L.,9998,0,9999,1
1713315988713,CLRE 252,A00,507189,Cuomo; Raphael Eduardo,9998,0,9999,1
1713315989743,CLRE 253,A00,507199,Vaida; Florin,9997,0,9999,2
1713315989743,CLRE 253,B00,507202,Vaida; Florin,9999,0,9999,0
1713315990771,CLRE 259,A00,507211,Patel; Hemal,9996,0,9999,3
1713315991801,CLRE 260,A00,507221,Cuomo; Raphael Eduardo,9999,0,9999,0
1713315992828,CLRE 297,001,507242,Cuomo; Raphael Eduardo,9999,0,9999,0
1713315993855,CSE 191,A00,516875,Minnes Kemp; Mor Mia,9999,0,9999,0
1713315994887,CSS 201S,A01,494383,Staff,35,0,35,0
1713316005741,CSS 202S,A01,494387,Staff,35,0,35,0
1713316006778,EAP 100,A00,516065,Staff,9792,0,9999,207
1713316007812,ECE 45,A01,507414,Staff,54,0,60,6
1713316008843,ECE 100,A01,507416,Baghdadchi; Saharnaz,11,0,20,9
1713316008843,ECE 100,A02,507418,Baghdadchi; Saharnaz,20,0,20,0
1713316009869,ECE 111,A01,507420,Staff,40,0,50,10
1713316010896,ECE 197,001,548057,Sievenpiper; Daniel F.,9998,0,9999,1
1713316011923,EDS 115,A00,507243,Choi; Bailey Miyeon,28,0,28,0
1713316012949,EDS 117,A01,494379,Staff,24,0,25,1
1713316013982,EDS 125,A00,507246,Hopkins; Megan Beth,29,0,30,1
1713316015013,EDS 128A,A01,507264,Fargason; Sharon Gayle,26,0,26,0
1713316016042,EDS 128B,A01,507293,Pappas; Elizabeth,30,0,30,0
1713316017073,EDS 139,A00,507294,Fargason; Sharon Gayle,30,0,30,0
1713316017073,EDS 139,B00,507313,Pappas; Elizabeth,30,0,30,0
1713316018098,EDS 201,A00,507315,Staff,26,0,30,4
1713316019125,EDS 203,A01,507317,Halter; Christopher P.,26,0,30,4
1713316020154,EDS 204R,A01,507319,Halter; Christopher P.,4,0,30,26
1713316020154,EDS 204R,B01,507331,Heinzman; Erica M.,28,0,30,2
1713316021187,EDS 206R,A00,507332,Staff,5,0,30,25
1713316021187,EDS 206R,B00,507343,Staff,28,0,30,2
1713316022210,EDS 250,A00,507344,Hemans; Patricia Ann Benitez,36,0,40,4
1713316023241,EDS 281,A00,507345,Daly; Alan J.,18,0,18,0
1713316024269,EDS 284,A00,507350,Daly; Alan J.,16,0,16,0
1713316025298,EDS 286,A00,507359,Fine; Sarah,18,0,18,0
1713316026326,EDS 289C,A01,507361,Daly; Alan J.,18,0,18,0
1713316027352,EDS 290,A00,507366,Hofstetter; Carolyn,15,0,15,0
1713316028385,LIGM 5A,A00,507421,Fischer-Grunski; Eva K,20,0,20,0
1713316029409,LIGM 5B,A00,507423,Fischer-Grunski; Eva K,20,0,20,0
1713316030434,LIGM 5C,A00,507425,Fischer-Grunski; Eva K,20,0,20,0
1713316031463,LIIT 5AS,A00,507427,Carnelos; Chiara,20,0,20,0
1713316032494,LIIT 5BS,A00,507430,Carnelos; Chiara,20,0,20,0
1713316033518,LIIT 5CS,A00,507432,Carnelos; Chiara,20,0,20,0
1713316034545,LISP 5A,A00,507541,Munoz Sanchez; Alicia,19,0,20,1
1713316035571,LISP 5B,A00,507671,Munoz Sanchez; Alicia,17,0,20,3
1713316036602,LISP 5C,A00,507696,Munoz Sanchez; Alicia,17,0,20,3
1713316037628,MAE 197,001,528363,Boechler; Nicholas Sebastia,9998,0,9999,1
1713316038659,MATH 197,001,523477,Kedlaya; Kiran S.,9999,0,9999,0
1713316038659,MATH 197,002,563811,Zhang; Danna,9999,0,9999,0
1713316039689,MCWP 40R,A00,518780,Staff,20,0,20,0
1713316039689,MCWP 40R,B00,518781,Staff,19,0,20,1
1713316039689,MCWP 40R,C00,518783,Staff,19,0,20,1
1713316040715,MCWP 50R,A00,518791,Staff,20,0,20,0
1713316040715,MCWP 50R,B00,518792,Staff,17,0,20,3
1713316040715,MCWP 50R,C00,518793,Staff,19,0,20,1
1713316040715,MCWP 50R,D00,518794,Staff,18,0,20,2
1713316040715,MCWP 50R,E00,518795,Staff,18,0,20,2
1713316040715,MCWP 50R,F00,518796,Staff,19,0,20,1
1713316040715,MCWP 50R,G00,518797,Staff,19,0,20,1
1713316041744,MMW 12R,A01,514034,Herbst; Matthew,15,0,16,1
1713316041744,MMW 12R,A02,514035,Herbst; Matthew,16,0,16,0
1713316042767,MMW 13R,A01,514037,Staff,12,0,16,4
1713316042767,MMW 13R,A02,514039,Staff,16,0,16,0
1713316044823,SIO 295LS,A00,523233,Staff,19,0,30,11
1713316045852,SIO 295S,A00,523232,Staff,19,0,30,11
1713316046877,SOCI 117,A01,494376,Staff,3,0,5,2
1713316047904,WES 237B,A00,494380,Staff,19,0,20,1
1713316049974,AESE 279B,A00,494370,Wade; Jon P,33,0,33,0
1713316051003,ANAR 135S,A00,494369,Braswell; Geoffrey E.,0,0,0,0
1713316052026,CAT 124RS,A01,519847,Geibel; William,17,0,20,3
1713316053053,CAT 125RS,A01,515971,Geibel; William,17,0,20,3
1713316054081,CLRE 250,A00,511389,Morris; Sheldon,9996,0,9999,3
1713316055106,CLRE 251,A00,507176,Mehta; Ravindra L.,9996,0,9999,3
1713316055106,CLRE 251,B00,511410,Mehta; Ravindra L.,9998,0,9999,1
1713316056129,CLRE 252,A00,507189,Cuomo; Raphael Eduardo,9998,0,9999,1
1713316057157,CLRE 253,A00,507199,Vaida; Florin,9997,0,9999,2
1713316057157,CLRE 253,B00,507202,Vaida; Florin,9999,0,9999,0
1713316058186,CLRE 259,A00,507211,Patel; Hemal,9996,0,9999,3
1713316059208,CLRE 260,A00,507221,Cuomo; Raphael Eduardo,9999,0,9999,0
1713316060233,CLRE 297,001,507242,Cuomo; Raphael Eduardo,9999,0,9999,0
1713316061261,CSE 191,A00,516875,Minnes Kemp; Mor Mia,9999,0,9999,0
1713316062287,CSS 201S,A01,494383,Staff,35,0,35,0
1713316063312,CSS 202S,A01,494387,Staff,35,0,35,0
1713316064340,EAP 100,A00,516065,Staff,9792,0,9999,207
1713316065365,ECE 45,A01,507414,Staff,54,0,60,6
1713316066395,ECE 100,A01,507416,Baghdadchi; Saharnaz,11,0,20,9
1713316066395,ECE 100,A02,507418,Baghdadchi; Saharnaz,20,0,20,0
1713316067420,ECE 111,A01,507420,Staff,40,0,50,10
1713316068445,ECE 197,001,548057,Sievenpiper; Daniel F.,9998,0,9999,1
1713316069470,EDS 115,A00,507243,Choi; Bailey Miyeon,28,0,28,0
1713316070496,EDS 117,A01,494379,Staff,24,0,25,1
1713316071520,EDS 125,A00,507246,Hopkins; Megan Beth,29,0,30,1
1713316072545,EDS 128A,A01,507264,Fargason; Sharon Gayle,26,0,26,0
1713316073569,EDS 128B,A01,507293,Pappas; Elizabeth,30,0,30,0
1713316074594,EDS 139,A00,507294,Fargason; Sharon Gayle,30,0,30,0
1713316074594,EDS 139,B00,507313,Pappas; Elizabeth,30,0,30,0
1713316075620,EDS 201,A00,507315,Staff,26,0,30,4
1713316076646,EDS 203,A01,507317,Halter; Christopher P.,26,0,30,4
1713316077675,EDS 204R,A01,507319,Halter; Christopher P.,4,0,30,26
1713316077675,EDS 204R,B01,507331,Heinzman; Erica M.,28,0,30,2
1713316078701,EDS 206R,A00,507332,Staff,5,0,30,25
1713316078701,EDS 206R,B00,507343,Staff,28,0,30,2
1713316079730,EDS 250,A00,507344,Hemans; Patricia Ann Benitez,36,0,40,4
1713316080759,EDS 281,A00,507345,Daly; Alan J.,18,0,18,0
1713316081784,EDS 284,A00,507350,Daly; Alan J.,16,0,16,0
1713316082811,EDS 286,A00,507359,Fine; Sarah,18,0,18,0
1713316083840,EDS 289C,A01,507361,Daly; Alan J.,18,0,18,0
1713316084865,EDS 290,A00,507366,Hofstetter; Carolyn,15,0,15,0
1713316085892,LIGM 5A,A00,507421,Fischer-Grunski; Eva K,20,0,20,0
1713316086917,LIGM 5B,A00,507423,Fischer-Grunski; Eva K,20,0,20,0
1713316087942,LIGM 5C,A00,507425,Fischer-Grunski; Eva K,20,0,20,0
1713316089039,LIIT 5AS,A00,507427,Carnelos; Chiara,20,0,20,0
1713316090067,LIIT 5BS,A00,507430,Carnelos; Chiara,20,0,20,0
1713316091103,LIIT 5CS,A00,507432,Carnelos; Chiara,20,0,20,0
1713316092130,LISP 5A,A00,507541,Munoz Sanchez; Alicia,19,0,20,1
1713316093153,LISP 5B,A00,507671,Munoz Sanchez; Alicia,17,0,20,3
1713316094178,LISP 5C,A00,507696,Munoz Sanchez; Alicia,17,0,20,3
1713316095204,MAE 197,001,528363,Boechler; Nicholas Sebastia,9998,0,9999,1
1713316096230,MATH 197,001,523477,Kedlaya; Kiran S.,9999,0,9999,0
1713316096230,MATH 197,002,563811,Zhang; Danna,9999,0,9999,0
1713316097259,MCWP 40R,A00,518780,Staff,20,0,20,0
1713316097259,MCWP 40R,B00,518781,Staff,19,0,20,1
1713316097259,MCWP 40R,C00,518783,Staff,19,0,20,1
1713316098286,MCWP 50R,A00,518791,Staff,20,0,20,0
1713316098286,MCWP 50R,B00,518792,Staff,17,0,20,3
1713316098286,MCWP 50R,C00,518793,Staff,19,0,20,1
1713316098286,MCWP 50R,D00,518794,Staff,18,0,20,2
1713316098286,MCWP 50R,E00,518795,Staff,18,0,20,2
1713316098286,MCWP 50R,F00,518796,Staff,19,0,20,1
1713316098286,MCWP 50R,G00,518797,Staff,19,0,20,1
1713316099314,MMW 12R,A01,514034,Herbst; Matthew,15,0,16,1
1713316099314,MMW 12R,A02,514035,Herbst; Matthew,16,0,16,0
1713316100338,MMW 13R,A01,514037,Staff,12,0,16,4
1713316100338,MMW 13R,A02,514039,Staff,16,0,16,0
1713316102393,SIO 295LS,A00,523233,Staff,19,0,30,11
1713316103417,SIO 295S,A00,523232,Staff,19,0,30,11
1713316104446,SOCI 117,A01,494376,Staff,3,0,5,2
1713316105474,WES 237B,A00,494380,Staff,19,0,20,1
1713316107541,AESE 279B,A00,494370,Wade; Jon P,33,0,33,0
1713316108566,ANAR 135S,A00,494369,Braswell; Geoffrey E.,0,0,0,0
1713316109594,CAT 124RS,A01,519847,Geibel; William,17,0,20,3
1713316110618,CAT 125RS,A01,515971,Geibel; William,17,0,20,3
1713316111646,CLRE 250,A00,511389,Morris; Sheldon,9996,0,9999,3
1713316112672,CLRE 251,A00,507176,Mehta; Ravindra L.,9996,0,9999,3
1713316112672,CLRE 251,B00,511410,Mehta; Ravindra L.,9998,0,9999,1
1713316113701,CLRE 252,A00,507189,Cuomo; Raphael Eduardo,9998,0,9999,1
1713316114728,CLRE 253,A00,507199,Vaida; Florin,9997,0,9999,2
1713316114728,CLRE 253,B00,507202,Vaida; Florin,9999,0,9999,0
1713316115757,CLRE 259,A00,507211,Patel; Hemal,9996,0,9999,3
1713316116784,CLRE 260,A00,507221,Cuomo; Raphael Eduardo,9999,0,9999,0
1713316117810,CLRE 297,001,507242,Cuomo; Raphael Eduardo,9999,0,9999,0
1713316118838,CSE 191,A00,516875,Minnes Kemp; Mor Mia,9999,0,9999,0
1713316119864,CSS 201S,A01,494383,Staff,35,0,35,0
1713316120892,CSS 202S,A01,494387,Staff,35,0,35,0
1713316121917,EAP 100,A00,516065,Staff,9792,0,9999,207
1713316122945,ECE 45,A01,507414,Staff,54,0,60,6
1713316123971,ECE 100,A01,507416,Baghdadchi; Saharnaz,11,0,20,9
1713316123971,ECE 100,A02,507418,Baghdadchi; Saharnaz,20,0,20,0
1713316124998,ECE 111,A01,507420,Staff,40,0,50,10
1713316126026,ECE 197,001,548057,Sievenpiper; Daniel F.,9998,0,9999,1
1713316127052,EDS 115,A00,507243,Choi; Bailey Miyeon,28,0,28,0
1713316128079,EDS 117,A01,494379,Staff,24,0,25,1
1713316129106,EDS 125,A00,507246,Hopkins; Megan Beth,29,0,30,1
1713316130131,EDS 128A,A01,507264,Fargason; Sharon Gayle,26,0,26,0
1713316131161,EDS 128B,A01,507293,Pappas; Elizabeth,30,0,30,0
1713316132186,EDS 139,A00,507294,Fargason; Sharon Gayle,30,0,30,0
1713316132186,EDS 139,B00,507313,Pappas; Elizabeth,30,0,30,0
1713316133215,EDS 201,A00,507315,Staff,26,0,30,4
1713316134243,EDS 203,A01,507317,Halter; Christopher P.,26,0,30,4
1713316135272,EDS 204R,A01,507319,Halter; Christopher P.,4,0,30,26
1713316135272,EDS 204R,B01,507331,Heinzman; Erica M.,28,0,30,2
1713316136297,EDS 206R,A00,507332,Staff,5,0,30,25
1713316136297,EDS 206R,B00,507343,Staff,28,0,30,2
1713316137323,EDS 250,A00,507344,Hemans; Patricia Ann Benitez,36,0,40,4
1713316138351,EDS 281,A00,507345,Daly; Alan J.,18,0,18,0
1713316139378,EDS 284,A00,507350,Daly; Alan J.,16,0,16,0
1713316140404,EDS 286,A00,507359,Fine; Sarah,18,0,18,0
1713316141431,EDS 289C,A01,507361,Daly; Alan J.,18,0,18,0
1713316142456,EDS 290,A00,507366,Hofstetter; Carolyn,15,0,15,0
1713316143482,LIGM 5A,A00,507421,Fischer-Grunski; Eva K,20,0,20,0
1713316144508,LIGM 5B,A00,507423,Fischer-Grunski; Eva K,20,0,20,0
1713316145533,LIGM 5C,A00,507425,Fischer-Grunski; Eva K,20,0,20,0
1713316146562,LIIT 5AS,A00,507427,Carnelos; Chiara,20,0,20,0
1713316147591,LIIT 5BS,A00,507430,Carnelos; Chiara,20,0,20,0
1713316148617,LIIT 5CS,A00,507432,Carnelos; Chiara,20,0,20,0
1713316149642,LISP 5A,A00,507541,Munoz Sanchez; Alicia,19,0,20,1
1713316150668,LISP 5B,A00,507671,Munoz Sanchez; Alicia,17,0,20,3
1713316151695,LISP 5C,A00,507696,Munoz Sanchez; Alicia,17,0,20,3
1713316152718,MAE 197,001,528363,Boechler; Nicholas Sebastia,9998,0,9999,1
1713316153744,MATH 197,001,523477,Kedlaya; Kiran S.,9999,0,9999,0
1713316153744,MATH 197,002,563811,Zhang; Danna,9999,0,9999,0
1713316154774,MCWP 40R,A00,518780,Staff,20,0,20,0
1713316154774,MCWP 40R,B00,518781,Staff,19,0,20,1
1713316154774,MCWP 40R,C00,518783,Staff,19,0,20,1
1713316155804,MCWP 50R,A00,518791,Staff,20,0,20,0
1713316155804,MCWP 50R,B00,518792,Staff,17,0,20,3
1713316155804,MCWP 50R,C00,518793,Staff,19,0,20,1
1713316155804,MCWP 50R,D00,518794,Staff,18,0,20,2
1713316155804,MCWP 50R,E00,518795,Staff,18,0,20,2
1713316155804,MCWP 50R,F00,518796,Staff,19,0,20,1
1713316155804,MCWP 50R,G00,518797,Staff,19,0,20,1
1713316156830,MMW 12R,A01,514034,Herbst; Matthew,15,0,16,1
1713316156830,MMW 12R,A02,514035,Herbst; Matthew,16,0,16,0
1713316157855,MMW 13R,A01,514037,Staff,12,0,16,4
1713316157855,MMW 13R,A02,514039,Staff,16,0,16,0
1713316159903,SIO 295LS,A00,523233,Staff,19,0,30,11
1713316160929,SIO 295S,A00,523232,Staff,19,0,30,11
1713316161954,SOCI 117,A01,494376,Staff,3,0,5,2
1713316162985,WES 237B,A00,494380,Staff,19,0,20,1
1713316165062,AESE 279B,A00,494370,Wade; Jon P,33,0,33,0
1713316166087,ANAR 135S,A00,494369,Braswell; Geoffrey E.,0,0,0,0
1713316167113,CAT 124RS,A01,519847,Geibel; William,17,0,20,3
1713316168139,CAT 125RS,A01,515971,Geibel; William,17,0,20,3
1713316169166,CLRE 250,A00,511389,Morris; Sheldon,9996,0,9999,3
1713316170193,CLRE 251,A00,507176,Mehta; Ravindra L.,9996,0,9999,3
1713316170193,CLRE 251,B00,511410,Mehta; Ravindra L.,9998,0,9999,1
1713316171223,CLRE 252,A00,507189,Cuomo; Raphael Eduardo,9998,0,9999,1
1713316172254,CLRE 253,A00,507199,Vaida; Florin,9997,0,9999,2
1713316172254,CLRE 253,B00,507202,Vaida; Florin,9999,0,9999,0
1713316173282,CLRE 259,A00,507211,Patel; Hemal,9996,0,9999,3
1713316174307,CLRE 260,A00,507221,Cuomo; Raphael Eduardo,9999,0,9999,0
1713316175336,CLRE 297,001,507242,Cuomo; Raphael Eduardo,9999,0,9999,0
1713316176366,CSE 191,A00,516875,Minnes Kemp; Mor Mia,9999,0,9999,0
1713316177392,CSS 201S,A01,494383,Staff,35,0,35,0
1713316178417,CSS 202S,A01,494387,Staff,35,0,35,0
1713316179441,EAP 100,A00,516065,Staff,9792,0,9999,207
1713316180466,ECE 45,A01,507414,Staff,54,0,60,6
1713316181494,ECE 100,A01,507416,Baghdadchi; Saharnaz,11,0,20,9
1713316181494,ECE 100,A02,507418,Baghdadchi; Saharnaz,20,0,20,0
1713316182517,ECE 111,A01,507420,Staff,40,0,50,10
1713316183541,ECE 197,001,548057,Sievenpiper; Daniel F.,9998,0,9999,1
1713316184567,EDS 115,A00,507243,Choi; Bailey Miyeon,28,0,28,0
1713316185593,EDS 117,A01,494379,Staff,24,0,25,1
1713316186616,EDS 125,A00,507246,Hopkins; Megan Beth,29,0,30,1
1713316187644,EDS 128A,A01,507264,Fargason; Sharon Gayle,26,0,26,0
1713316188670,EDS 128B,A01,507293,Pappas; Elizabeth,30,0,30,0
1713316189694,EDS 139,A00,507294,Fargason; Sharon Gayle,30,0,30,0
1713316189694,EDS 139,B00,507313,Pappas; Elizabeth,30,0,30,0
1713316190722,EDS 201,A00,507315,Staff,26,0,30,4
1713316191748,EDS 203,A01,507317,Halter; Christopher P.,26,0,30,4
1713316192829,EDS 204R,A01,507319,Halter; Christopher P.,4,0,30,26
1713316192829,EDS 204R,B01,507331,Heinzman; Erica M.,28,0,30,2
1713316193868,EDS 206R,A00,507332,Staff,5,0,30,25
1713316193868,EDS 206R,B00,507343,Staff,28,0,30,2
1713316194895,EDS 250,A00,507344,Hemans; Patricia Ann Benitez,36,0,40,4
1713316195921,EDS 281,A00,507345,Daly; Alan J.,18,0,18,0
1713316196948,EDS 284,A00,507350,Daly; Alan J.,16,0,16,0
1713316197978,EDS 286,A00,507359,Fine; Sarah,18,0,18,0
1713316199002,EDS 289C,A01,507361,Daly; Alan J.,18,0,18,0
1713316200033,EDS 290,A00,507366,Hofstetter; Carolyn,15,0,15,0
1713316201065,LIGM 5A,A00,507421,Fischer-Grunski; Eva K,20,0,20,0
1713316202092,LIGM 5B,A00,507423,Fischer-Grunski; Eva K,20,0,20,0
1713316203116,LIGM 5C,A00,507425,Fischer-Grunski; Eva K,20,0,20,0
1713316204148,LIIT 5AS,A00,507427,Carnelos; Chiara,20,0,20,0
1713316205173,LIIT 5BS,A00,507430,Carnelos; Chiara,20,0,20,0
1713316206196,LIIT 5CS,A00,507432,Carnelos; Chiara,20,0,20,0
1713316207221,LISP 5A,A00,507541,Munoz Sanchez; Alicia,19,0,20,1
1713316208246,LISP 5B,A00,507671,Munoz Sanchez; Alicia,17,0,20,3
1713316209272,LISP 5C,A00,507696,Munoz Sanchez; Alicia,17,0,20,3
1713316210302,MAE 197,001,528363,Boechler; Nicholas Sebastia,9998,0,9999,1
1713316211333,MATH 197,001,523477,Kedlaya; Kiran S.,9999,0,9999,0
1713316211333,MATH 197,002,563811,Zhang; Danna,9999,0,9999,0
1713316212361,MCWP 40R,A00,518780,Staff,20,0,20,0
1713316212361,MCWP 40R,B00,518781,Staff,19,0,20,1
1713316212361,MCWP 40R,C00,518783,Staff,19,0,20,1
1713316213385,MCWP 50R,A00,518791,Staff,20,0,20,0
1713316213385,MCWP 50R,B00,518792,Staff,17,0,20,3
1713316213385,MCWP 50R,C00,518793,Staff,19,0,20,1
1713316213385,MCWP 50R,D00,518794,Staff,18,0,20,2
1713316213385,MCWP 50R,E00,518795,Staff,18,0,20,2
1713316213385,MCWP 50R,F00,518796,Staff,19,0,20,1
1713316213385,MCWP 50R,G00,518797,Staff,19,0,20,1
1713316214412,MMW 12R,A01,514034,Herbst; Matthew,15,0,16,1
1713316214412,MMW 12R,A02,514035,Herbst; Matthew,16,0,16,0
1713316215440,MMW 13R,A01,514037,Staff,12,0,16,4
1713316215440,MMW 13R,A02,514039,Staff,16,0,16,0
1713316217496,SIO 295LS,A00,523233,Staff,19,0,30,11
1713316218523,SIO 295S,A00,523232,Staff,19,0,30,11
1713316219551,SOCI 117,A01,494376,Staff,3,0,5,2
1713316220576,WES 237B,A00,494380,Staff,19,0,20,1
1713316222660,AESE 279B,A00,494370,Wade; Jon P,33,0,33,0
1713316223688,ANAR 135S,A00,494369,Braswell; Geoffrey E.,0,0,0,0
1713316224715,CAT 124RS,A01,519847,Geibel; William,17,0,20,3
1713316225739,CAT 125RS,A01,515971,Geibel; William,17,0,20,3
1713316226764,CLRE 250,A00,511389,Morris; Sheldon,9996,0,9999,3
1713316227790,CLRE 251,A00,507176,Mehta; Ravindra L.,9996,0,9999,3
1713316227790,CLRE 251,B00,511410,Mehta; Ravindra L.,9998,0,9999,1
1713316228818,CLRE 252,A00,507189,Cuomo; Raphael Eduardo,9998,0,9999,1
1713316229848,CLRE 253,A00,507199,Vaida; Florin,9997,0,9999,2
1713316229848,CLRE 253,B00,507202,Vaida; Florin,9999,0,9999,0
1713316230873,CLRE 259,A00,507211,Patel; Hemal,9996,0,9999,3
1713316231899,CLRE 260,A00,507221,Cuomo; Raphael Eduardo,9999,0,9999,0
1713316232922,CLRE 297,001,507242,Cuomo; Raphael Eduardo,9999,0,9999,0
1713316233950,CSE 191,A00,516875,Minnes Kemp; Mor Mia,9999,0,9999,0
1713316234979,CSS 201S,A01,494383,Staff,35,0,35,0
1713316236004,CSS 202S,A01,494387,Staff,35,0,35,0
1713316237028,EAP 100,A00,516065,Staff,9792,0,9999,207
1713316238053,ECE 45,A01,507414,Staff,54,0,60,6
1713316239082,ECE 100,A01,507416,Baghdadchi; Saharnaz,11,0,20,9
1713316239082,ECE 100,A02,507418,Baghdadchi; Saharnaz,20,0,20,0
1713316240108,ECE 111,A01,507420,Staff,40,0,50,10
1713316241133,ECE 197,001,548057,Sievenpiper; Daniel F.,9998,0,9999,1
1713316242158,EDS 115,A00,507243,Choi; Bailey Miyeon,28,0,28,0
1713316243188,EDS 117,A01,494379,Staff,24,0,25,1
1713316244214,EDS 125,A00,507246,Hopkins; Megan Beth,29,0,30,1
1713316245239,EDS 128A,A01,507264,Fargason; Sharon Gayle,26,0,26,0
1713316246266,EDS 128B,A01,507293,Pappas; Elizabeth,30,0,30,0
1713316247291,EDS 139,A00,507294,Fargason; Sharon Gayle,30,0,30,0
1713316247291,EDS 139,B00,507313,Pappas; Elizabeth,30,0,30,0
1713316248315,EDS 201,A00,507315,Staff,26,0,30,4
1713316249340,EDS 203,A01,507317,Halter; Christopher P.,26,0,30,4
1713316250366,EDS 204R,A01,507319,Halter; Christopher P.,4,0,30,26
1713316250366,EDS 204R,B01,507331,Heinzman; Erica M.,28,0,30,2
1713316251389,EDS 206R,A00,507332,Staff,5,0,30,25
1713316251389,EDS 206R,B00,507343,Staff,28,0,30,2
1713316252419,EDS 250,A00,507344,Hemans; Patricia Ann Benitez,36,0,40,4
1713316253447,EDS 281,A00,507345,Daly; Alan J.,18,0,18,0
1713316254474,EDS 284,A00,507350,Daly; Alan J.,16,0,16,0
1713316255499,EDS 286,A00,507359,Fine; Sarah,18,0,18,0
1713316256527,EDS 289C,A01,507361,Daly; Alan J.,18,0,18,0
1713316257552,EDS 290,A00,507366,Hofstetter; Carolyn,15,0,15,0
1713316258579,LIGM 5A,A00,507421,Fischer-Grunski; Eva K,20,0,20,0
1713316259604,LIGM 5B,A00,507423,Fischer-Grunski; Eva K,20,0,20,0
1713316260628,LIGM 5C,A00,507425,Fischer-Grunski; Eva K,20,0,20,0
1713316261658,LIIT 5AS,A00,507427,Carnelos; Chiara,20,0,20,0
1713316262683,LIIT 5BS,A00,507430,Carnelos; Chiara,20,0,20,0
1713316263714,LIIT 5CS,A00,507432,Carnelos; Chiara,20,0,20,0
1713316264743,LISP 5A,A00,507541,Munoz Sanchez; Alicia,19,0,20,1
1713316265768,LISP 5B,A00,507671,Munoz Sanchez; Alicia,17,0,20,3
1713316266796,LISP 5C,A00,507696,Munoz Sanchez; Alicia,17,0,20,3
1713316267820,MAE 197,001,528363,Boechler; Nicholas Sebastia,9998,0,9999,1
1713316268847,MATH 197,001,523477,Kedlaya; Kiran S.,9999,0,9999,0
1713316268847,MATH 197,002,563811,Zhang; Danna,9999,0,9999,0
1713316269878,MCWP 40R,A00,518780,Staff,20,0,20,0
1713316269878,MCWP 40R,B00,518781,Staff,19,0,20,1
1713316269878,MCWP 40R,C00,518783,Staff,19,0,20,1
1713316270902,MCWP 50R,A00,518791,Staff,20,0,20,0
1713316270902,MCWP 50R,B00,518792,Staff,17,0,20,3
1713316270902,MCWP 50R,C00,518793,Staff,19,0,20,1
1713316270902,MCWP 50R,D00,518794,Staff,18,0,20,2
1713316270902,MCWP 50R,E00,518795,Staff,18,0,20,2
1713316270902,MCWP 50R,F00,518796,Staff,19,0,20,1
1713316270902,MCWP 50R,G00,518797,Staff,19,0,20,1
1713316271929,MMW 12R,A01,514034,Herbst; Matthew,15,0,16,1
1713316271929,MMW 12R,A02,514035,Herbst; Matthew,16,0,16,0
1713316272952,MMW 13R,A01,514037,Staff,12,0,16,4
1713316272952,MMW 13R,A02,514039,Staff,16,0,16,0
1713316275002,SIO 295LS,A00,523233,Staff,19,0,30,11
1713316276032,SIO 295S,A00,523232,Staff,19,0,30,11
1713316277061,SOCI 117,A01,494376,Staff,3,0,5,2
1713316278086,WES 237B,A00,494380,Staff,19,0,20,1
1713316280146,AESE 279B,A00,494370,Wade; Jon P,33,0,33,0
1713316281171,ANAR 135S,A00,494369,Braswell; Geoffrey E.,0,0,0,0
1713316282202,CAT 124RS,A01,519847,Geibel; William,17,0,20,3
1713316283231,CAT 125RS,A01,515971,Geibel; William,17,0,20,3
1713316284260,CLRE 250,A00,511389,Morris; Sheldon,9996,0,9999,3
1713316285288,CLRE 251,A00,507176,Mehta; Ravindra L.,9996,0,9999,3
1713316285288,CLRE 251,B00,511410,Mehta; Ravindra L.,9998,0,9999,1
1713316286314,CLRE 252,A00,507189,Cuomo; Raphael Eduardo,9998,0,9999,1
1713316287340,CLRE 253,A00,507199,Vaida; Florin,9997,0,9999,2
1713316287340,CLRE 253,B00,507202,Vaida; Florin,9999,0,9999,0
1713316288369,CLRE 259,A00,507211,Patel; Hemal,9996,0,9999,3
1713316289393,CLRE 260,A00,507221,Cuomo; Raphael Eduardo,9999,0,9999,0
1713316290421,CLRE 297,001,507242,Cuomo; Raphael Eduardo,9999,0,9999,0
1713316291445,CSE 191,A00,516875,Minnes Kemp; Mor Mia,9999,0,9999,0
1713316292476,CSS 201S,A01,494383,Staff,35,0,35,0
1713316293515,CSS 202S,A01,494387,Staff,35,0,35,0
1713316294544,EAP 100,A00,516065,Staff,9792,0,9999,207
1713316295568,ECE 45,A01,507414,Staff,54,0,60,6
1713316296651,ECE 100,A01,507416,Baghdadchi; Saharnaz,11,0,20,9
1713316296651,ECE 100,A02,507418,Baghdadchi; Saharnaz,20,0,20,0
1713316297676,ECE 111,A01,507420,Staff,40,0,50,10
1713316298702,ECE 197,001,548057,Sievenpiper; Daniel F.,9998,0,9999,1
1713316299729,EDS 115,A00,507243,Choi; Bailey Miyeon,28,0,28,0
1713316300755,EDS 117,A01,494379,Staff,24,0,25,1
1713316301783,EDS 125,A00,507246,Hopkins; Megan Beth,29,0,30,1
1713316302808,EDS 128A,A01,507264,Fargason; Sharon Gayle,26,0,26,0
1713316303834,EDS 128B,A01,507293,Pappas; Elizabeth,30,0,30,0
1713316304861,EDS 139,A00,507294,Fargason; Sharon Gayle,30,0,30,0
1713316304861,EDS 139,B00,507313,Pappas; Elizabeth,30,0,30,0
1713316305905,EDS 201,A00,507315,Staff,26,0,30,4
1713316306934,EDS 203,A01,507317,Halter; Christopher P.,26,0,30,4
1713316307958,EDS 204R,A01,507319,Halter; Christopher P.,4,0,30,26
1713316307958,EDS 204R,B01,507331,Heinzman; Erica M.,28,0,30,2
1713316308983,EDS 206R,A00,507332,Staff,5,0,30,25
1713316308983,EDS 206R,B00,507343,Staff,28,0,30,2
1713316310012,EDS 250,A00,507344,Hemans; Patricia Ann Benitez,36,0,40,4
1713316311039,EDS 281,A00,507345,Daly; Alan J.,18,0,18,0
1713316312064,EDS 284,A00,507350,Daly; Alan J.,16,0,16,0
1713316313089,EDS 286,A00,507359,Fine; Sarah,18,0,18,0
1713316314117,EDS 289C,A01,507361,Daly; Alan J.,18,0,18,0
1713316315144,EDS 290,A00,507366,Hofstetter; Carolyn,15,0,15,0
1713316316399,LIGM 5A,A00,507421,Fischer-Grunski; Eva K,20,0,20,0
1713316317424,LIGM 5B,A00,507423,Fischer-Grunski; Eva K,20,0,20,0
1713316318459,LIGM 5C,A00,507425,Fischer-Grunski; Eva K,20,0,20,0
1713316319490,LIIT 5AS,A00,507427,Carnelos; Chiara,20,0,20,0
1713316320519,LIIT 5BS,A00,507430,Carnelos; Chiara,20,0,20,0
1713316321549,LIIT 5CS,A00,507432,Carnelos; Chiara,20,0,20,0
1713316322575,LISP 5A,A00,507541,Munoz Sanchez; Alicia,19,0,20,1
1713316323601,LISP 5B,A00,507671,Munoz Sanchez; Alicia,17,0,20,3
1713316324626,LISP 5C,A00,507696,Munoz Sanchez; Alicia,17,0,20,3
1713316325653,MAE 197,001,528363,Boechler; Nicholas Sebastia,9998,0,9999,1
1713316326680,MATH 197,001,523477,Kedlaya; Kiran S.,9999,0,9999,0
1713316326680,MATH 197,002,563811,Zhang; Danna,9999,0,9999,0
1713316327709,MCWP 40R,A00,518780,Staff,20,0,20,0
1713316327709,MCWP 40R,B00,518781,Staff,19,0,20,1
1713316327709,MCWP 40R,C00,518783,Staff,19,0,20,1
1713316328739,MCWP 50R,A00,518791,Staff,20,0,20,0
1713316328739,MCWP 50R,B00,518792,Staff,17,0,20,3
1713316328739,MCWP 50R,C00,518793,Staff,19,0,20,1
1713316328739,MCWP 50R,D00,518794,Staff,18,0,20,2
1713316328739,MCWP 50R,E00,518795,Staff,18,0,20,2
1713316328739,MCWP 50R,F00,518796,Staff,19,0,20,1
1713316328739,MCWP 50R,G00,518797,Staff,19,0,20,1
1713316329764,MMW 12R,A01,514034,Herbst; Matthew,15,0,16,1
1713316329764,MMW 12R,A02,514035,Herbst; Matthew,16,0,16,0
1713316330794,MMW 13R,A01,514037,Staff,12,0,16,4
1713316330794,MMW 13R,A02,514039,Staff,16,0,16,0
1713316332846,SIO 295LS,A00,523233,Staff,19,0,30,11
1713316333870,SIO 295S,A00,523232,Staff,19,0,30,11
1713316334899,SOCI 117,A01,494376,Staff,3,0,5,2
1713316335923,WES 237B,A00,494380,Staff,19,0,20,1
1713316337995,AESE 279B,A00,494370,Wade; Jon P,33,0,33,0
1713316339021,ANAR 135S,A00,494369,Braswell; Geoffrey E.,0,0,0,0
1713316340047,CAT 124RS,A01,519847,Geibel; William,17,0,20,3
1713316341072,CAT 125RS,A01,515971,Geibel; William,17,0,20,3
1713316342097,CLRE 250,A00,511389,Morris; Sheldon,9996,0,9999,3
1713316343129,CLRE 251,A00,507176,Mehta; Ravindra L.,9996,0,9999,3
1713316343129,CLRE 251,B00,511410,Mehta; Ravindra L.,9998,0,9999,1
1713316344158,CLRE 252,A00,507189,Cuomo; Raphael Eduardo,9998,0,9999,1
1713316345190,CLRE 253,A00,507199,Vaida; Florin,9997,0,9999,2
1713316345190,CLRE 253,B00,507202,Vaida; Florin,9999,0,9999,0
1713316346217,CLRE 259,A00,507211,Patel; Hemal,9996,0,9999,3
1713316347243,CLRE 260,A00,507221,Cuomo; Raphael Eduardo,9999,0,9999,0
1713316348272,CLRE 297,001,507242,Cuomo; Raphael Eduardo,9999,0,9999,0
1713316349302,CSE 191,A00,516875,Minnes Kemp; Mor Mia,9999,0,9999,0
1713316350324,CSS 201S,A01,494383,Staff,35,0,35,0
1713316351351,CSS 202S,A01,494387,Staff,35,0,35,0
1713316352375,EAP 100,A00,516065,Staff,9792,0,9999,207
1713316353404,ECE 45,A01,507414,Staff,54,0,60,6
1713316354430,ECE 100,A01,507416,Baghdadchi; Saharnaz,11,0,20,9
1713316354430,ECE 100,A02,507418,Baghdadchi; Saharnaz,20,0,20,0
1713316355456,ECE 111,A01,507420,Staff,40,0,50,10
1713316356484,ECE 197,001,548057,Sievenpiper; Daniel F.,9998,0,9999,1
1713316357512,EDS 115,A00,507243,Choi; Bailey Miyeon,28,0,28,0
1713316358540,EDS 117,A01,494379,Staff,24,0,25,1
1713316359563,EDS 125,A00,507246,Hopkins; Megan Beth,29,0,30,1
1713316360589,EDS 128A,A01,507264,Fargason; Sharon Gayle,26,0,26,0
1713316361614,EDS 128B,A01,507293,Pappas; Elizabeth,30,0,30,0
1713316362639,EDS 139,A00,507294,Fargason; Sharon Gayle,30,0,30,0
1713316362639,EDS 139,B00,507313,Pappas; Elizabeth,30,0,30,0
1713316363668,EDS 201,A00,507315,Staff,26,0,30,4
1713316364692,EDS 203,A01,507317,Halter; Christopher P.,26,0,30,4
1713316365717,EDS 204R,A01,507319,Halter; Christopher P.,4,0,30,26
1713316365717,EDS 204R,B01,507331,Heinzman; Erica M.,28,0,30,2
1713316366743,EDS 206R,A00,507332,Staff,5,0,30,25
1713316366743,EDS 206R,B00,507343,Staff,28,0,30,2
1713316367768,EDS 250,A00,507344,Hemans; Patricia Ann Benitez,36,0,40,4
1713316368796,EDS 281,A00,507345,Daly; Alan J.,18,0,18,0
1713316369824,EDS 284,A00,507350,Daly; Alan J.,16,0,16,0
1713316370849,EDS 286,A00,507359,Fine; Sarah,18,0,18,0
1713316371873,EDS 289C,A01,507361,Daly; Alan J.,18,0,18,0
1713316372902,EDS 290,A00,507366,Hofstetter; Carolyn,15,0,15,0
1713316373930,LIGM 5A,A00,507421,Fischer-Grunski; Eva K,20,0,20,0
1713316374960,LIGM 5B,A00,507423,Fischer-Grunski; Eva K,20,0,20,0
1713316375986,LIGM 5C,A00,507425,Fischer-Grunski; Eva K,20,0,20,0
1713316377012,LIIT 5AS,A00,507427,Carnelos; Chiara,20,0,20,0
1713316378038,LIIT 5BS,A00,507430,Carnelos; Chiara,20,0,20,0
1713316379067,LIIT 5CS,A00,507432,Carnelos; Chiara,20,0,20,0
1713316380094,LISP 5A,A00,507541,Munoz Sanchez; Alicia,19,0,20,1
1713316381124,LISP 5B,A00,507671,Munoz Sanchez; Alicia,17,0,20,3
1713316382150,LISP 5C,A00,507696,Munoz Sanchez; Alicia,17,0,20,3
1713316383174,MAE 197,001,528363,Boechler; Nicholas Sebastia,9998,0,9999,1
1713316384202,MATH 197,001,523477,Kedlaya; Kiran S.,9999,0,9999,0
1713316384202,MATH 197,002,563811,Zhang; Danna,9999,0,9999,0
1713316385230,MCWP 40R,A00,518780,Staff,20,0,20,0
1713316385230,MCWP 40R,B00,518781,Staff,19,0,20,1
1713316385230,MCWP 40R,C00,518783,Staff,19,0,20,1
1713316386255,MCWP 50R,A00,518791,Staff,20,0,20,0
1713316386255,MCWP 50R,B00,518792,Staff,17,0,20,3
1713316386255,MCWP 50R,C00,518793,Staff,19,0,20,1
1713316386255,MCWP 50R,D00,518794,Staff,18,0,20,2
1713316386255,MCWP 50R,E00,518795,Staff,18,0,20,2
1713316386255,MCWP 50R,F00,518796,Staff,19,0,20,1
1713316386255,MCWP 50R,G00,518797,Staff,19,0,20,1
1713316387287,MMW 12R,A01,514034,Herbst; Matthew,15,0,16,1
1713316387287,MMW 12R,A02,514035,Herbst; Matthew,16,0,16,0
1713316388315,MMW 13R,A01,514037,Staff,12,0,16,4
1713316388315,MMW 13R,A02,514039,Staff,16,0,16,0
1713316390364,SIO 295LS,A00,523233,Staff,19,0,30,11
1713316391392,SIO 295S,A00,523232,Staff,19,0,30,11
1713316392416,SOCI 117,A01,494376,Staff,3,0,5,2
1713316393441,WES 237B,A00,494380,Staff,19,0,20,1
1713316395510,AESE 279B,A00,494370,Wade; Jon P,33,0,33,0
1713316396536,ANAR 135S,A00,494369,Braswell; Geoffrey E.,0,0,0,0
1713316397561,CAT 124RS,A01,519847,Geibel; William,17,0,20,3
1713316398589,CAT 125RS,A01,515971,Geibel; William,17,0,20,3
1713316399615,CLRE 250,A00,511389,Morris; Sheldon,9996,0,9999,3
1713316400701,CLRE 251,A00,507176,Mehta; Ravindra L.,9996,0,9999,3
1713316400701,CLRE 251,B00,511410,Mehta; Ravindra L.,9998,0,9999,1
1713316401731,CLRE 252,A00,507189,Cuomo; Raphael Eduardo,9998,0,9999,1
1713316402756,CLRE 253,A00,507199,Vaida; Florin,9997,0,9999,2
1713316402756,CLRE 253,B00,507202,Vaida; Florin,9999,0,9999,0
1713316403781,CLRE 259,A00,507211,Patel; Hemal,9996,0,9999,3
1713316404806,CLRE 260,A00,507221,Cuomo; Raphael Eduardo,9999,0,9999,0
1713316405830,CLRE 297,001,507242,Cuomo; Raphael Eduardo,9999,0,9999,0
1713316406859,CSE 191,A00,516875,Minnes Kemp; Mor Mia,9999,0,9999,0
1713316407889,CSS 201S,A01,494383,Staff,35,0,35,0
1713316408915,CSS 202S,A01,494387,Staff,35,0,35,0
1713316409940,EAP 100,A00,516065,Staff,9792,0,9999,207
1713316410970,ECE 45,A01,507414,Staff,54,0,60,6
1713316411995,ECE 100,A01,507416,Baghdadchi; Saharnaz,11,0,20,9
1713316411995,ECE 100,A02,507418,Baghdadchi; Saharnaz,20,0,20,0
1713316413023,ECE 111,A01,507420,Staff,40,0,50,10
1713316414051,ECE 197,001,548057,Sievenpiper; Daniel F.,9998,0,9999,1
1713316415081,EDS 115,A00,507243,Choi; Bailey Miyeon,28,0,28,0
1713316416110,EDS 117,A01,494379,Staff,24,0,25,1
1713316417135,EDS 125,A00,507246,Hopkins; Megan Beth,29,0,30,1
1713316418166,EDS 128A,A01,507264,Fargason; Sharon Gayle,26,0,26,0
1713316419191,EDS 128B,A01,507293,Pappas; Elizabeth,30,0,30,0
1713316420215,EDS 139,A00,507294,Fargason; Sharon Gayle,30,0,30,0
1713316420215,EDS 139,B00,507313,Pappas; Elizabeth,30,0,30,0
1713316421244,EDS 201,A00,507315,Staff,26,0,30,4
1713316422274,EDS 203,A01,507317,Halter; Christopher P.,26,0,30,4
1713316423300,EDS 204R,A01,507319,Halter; Christopher P.,4,0,30,26
1713316423300,EDS 204R,B01,507331,Heinzman; Erica M.,28,0,30,2
1713316424326,EDS 206R,A00,507332,Staff,5,0,30,25
1713316424326,EDS 206R,B00,507343,Staff,28,0,30,2
1713316425352,EDS 250,A00,507344,Hemans; Patricia Ann Benitez,36,0,40,4
1713316426379,EDS 281,A00,507345,Daly; Alan J.,18,0,18,0
1713316427406,EDS 284,A00,507350,Daly; Alan J.,16,0,16,0
1713316428434,EDS 286,A00,507359,Fine; Sarah,18,0,18,0
1713316429459,EDS 289C,A01,507361,Daly; Alan J.,18,0,18,0
1713316430485,EDS 290,A00,507366,Hofstetter; Carolyn,15,0,15,0
1713316431515,LIGM 5A,A00,507421,Fischer-Grunski; Eva K,20,0,20,0
1713316432545,LIGM 5B,A00,507423,Fischer-Grunski; Eva K,20,0,20,0
1713316433572,LIGM 5C,A00,507425,Fischer-Grunski; Eva K,20,0,20,0
1713316434603,LIIT 5AS,A00,507427,Carnelos; Chiara,20,0,20,0
1713316435628,LIIT 5BS,A00,507430,Carnelos; Chiara,20,0,20,0
1713316436659,LIIT 5CS,A00,507432,Carnelos; Chiara,20,0,20,0
1713316437685,LISP 5A,A00,507541,Munoz Sanchez; Alicia,19,0,20,1
1713316438715,LISP 5B,A00,507671,Munoz Sanchez; Alicia,17,0,20,3
1713316439743,LISP 5C,A00,507696,Munoz Sanchez; Alicia,17,0,20,3
1713316440769,MAE 197,001,528363,Boechler; Nicholas Sebastia,9998,0,9999,1
1713316441800,MATH 197,001,523477,Kedlaya; Kiran S.,9999,0,9999,0
1713316441800,MATH 197,002,563811,Zhang; Danna,9999,0,9999,0
1713316442832,MCWP 40R,A00,518780,Staff,20,0,20,0
1713316442832,MCWP 40R,B00,518781,Staff,19,0,20,1
1713316442832,MCWP 40R,C00,518783,Staff,19,0,20,1
1713316443863,MCWP 50R,A00,518791,Staff,20,0,20,0
1713316443863,MCWP 50R,B00,518792,Staff,17,0,20,3
1713316443863,MCWP 50R,C00,518793,Staff,19,0,20,1
1713316443863,MCWP 50R,D00,518794,Staff,18,0,20,2
1713316443863,MCWP 50R,E00,518795,Staff,18,0,20,2
1713316443863,MCWP 50R,F00,518796,Staff,19,0,20,1
1713316443863,MCWP 50R,G00,518797,Staff,19,0,20,1
1713316444889,MMW 12R,A01,514034,Herbst; Matthew,15,0,16,1
1713316444889,MMW 12R,A02,514035,Herbst; Matthew,16,0,16,0
1713316445918,MMW 13R,A01,514037,Staff,12,0,16,4
1713316445918,MMW 13R,A02,514039,Staff,16,0,16,0
1713316447973,SIO 295LS,A00,523233,Staff,19,0,30,11
1713316449003,SIO 295S,A00,523232,Staff,19,0,30,11
1713316450028,SOCI 117,A01,494376,Staff,3,0,5,2
1713316451053,WES 237B,A00,494380,Staff,19,0,20,1
1713316453131,AESE 279B,A00,494370,Wade; Jon P,33,0,33,0
1713316454159,ANAR 135S,A00,494369,Braswell; Geoffrey E.,0,0,0,0
1713316455188,CAT 124RS,A01,519847,Geibel; William,17,0,20,3
1713316456212,CAT 125RS,A01,515971,Geibel; William,17,0,20,3
1713316457238,CLRE 250,A00,511389,Morris; Sheldon,9996,0,9999,3
1713316458265,CLRE 251,A00,507176,Mehta; Ravindra L.,9996,0,9999,3
1713316458265,CLRE 251,B00,511410,Mehta; Ravindra L.,9998,0,9999,1
1713316459291,CLRE 252,A00,507189,Cuomo; Raphael Eduardo,9998,0,9999,1
1713316460318,CLRE 253,A00,507199,Vaida; Florin,9997,0,9999,2
1713316460318,CLRE 253,B00,507202,Vaida; Florin,9999,0,9999,0
1713316461343,CLRE 259,A00,507211,Patel; Hemal,9996,0,9999,3
1713316462371,CLRE 260,A00,507221,Cuomo; Raphael Eduardo,9999,0,9999,0
1713316463399,CLRE 297,001,507242,Cuomo; Raphael Eduardo,9999,0,9999,0
1713316464424,CSE 191,A00,516875,Minnes Kemp; Mor Mia,9999,0,9999,0
1713316465449,CSS 201S,A01,494383,Staff,35,0,35,0
1713316466475,CSS 202S,A01,494387,Staff,35,0,35,0
1713316467504,EAP 100,A00,516065,Staff,9792,0,9999,207
1713316468534,ECE 45,A01,507414,Staff,54,0,60,6
1713316469559,ECE 100,A01,507416,Baghdadchi; Saharnaz,11,0,20,9
1713316469559,ECE 100,A02,507418,Baghdadchi; Saharnaz,20,0,20,0
1713316470583,ECE 111,A01,507420,Staff,40,0,50,10
1713316471612,ECE 197,001,548057,Sievenpiper; Daniel F.,9998,0,9999,1
1713316472642,EDS 115,A00,507243,Choi; Bailey Miyeon,28,0,28,0
1713316473669,EDS 117,A01,494379,Staff,24,0,25,1
1713316474696,EDS 125,A00,507246,Hopkins; Megan Beth,29,0,30,1
1713316475720,EDS 128A,A01,507264,Fargason; Sharon Gayle,26,0,26,0
1713316476745,EDS 128B,A01,507293,Pappas; Elizabeth,30,0,30,0
1713316477769,EDS 139,A00,507294,Fargason; Sharon Gayle,30,0,30,0
1713316477769,EDS 139,B00,507313,Pappas; Elizabeth,30,0,30,0
1713316478798,EDS 201,A00,507315,Staff,26,0,30,4
1713316479824,EDS 203,A01,507317,Halter; Christopher P.,26,0,30,4
1713316480850,EDS 204R,A01,507319,Halter; Christopher P.,4,0,30,26
1713316480850,EDS 204R,B01,507331,Heinzman; Erica M.,28,0,30,2
1713316481876,EDS 206R,A00,507332,Staff,5,0,30,25
1713316481876,EDS 206R,B00,507343,Staff,28,0,30,2
1713316482901,EDS 250,A00,507344,Hemans; Patricia Ann Benitez,36,0,40,4
1713316483926,EDS 281,A00,507345,Daly; Alan J.,18,0,18,0
1713316484952,EDS 284,A00,507350,Daly; Alan J.,16,0,16,0
1713316485977,EDS 286,A00,507359,Fine; Sarah,18,0,18,0
1713316487002,EDS 289C,A01,507361,Daly; Alan J.,18,0,18,0
1713316488030,EDS 290,A00,507366,Hofstetter; Carolyn,15,0,15,0
1713316489057,LIGM 5A,A00,507421,Fischer-Grunski; Eva K,20,0,20,0
1713316490082,LIGM 5B,A00,507423,Fischer-Grunski; Eva K,20,0,20,0
1713316491111,LIGM 5C,A00,507425,Fischer-Grunski; Eva K,20,0,20,0
1713316492142,LIIT 5AS,A00,507427,Carnelos; Chiara,20,0,20,0
1713316493168,LIIT 5BS,A00,507430,Carnelos; Chiara,20,0,20,0
1713316494197,LIIT 5CS,A00,507432,Carnelos; Chiara,20,0,20,0
1713316495226,LISP 5A,A00,507541,Munoz Sanchez; Alicia,19,0,20,1
1713316496253,LISP 5B,A00,507671,Munoz Sanchez; Alicia,17,0,20,3
1713316497284,LISP 5C,A00,507696,Munoz Sanchez; Alicia,17,0,20,3
1713316498310,MAE 197,001,528363,Boechler; Nicholas Sebastia,9998,0,9999,1
1713316499336,MATH 197,001,523477,Kedlaya; Kiran S.,9999,0,9999,0
1713316499336,MATH 197,002,563811,Zhang; Danna,9999,0,9999,0
1713316500365,MCWP 40R,A00,518780,Staff,20,0,20,0
1713316500365,MCWP 40R,B00,518781,Staff,19,0,20,1
1713316500365,MCWP 40R,C00,518783,Staff,19,0,20,1
1713316501390,MCWP 50R,A00,518791,Staff,20,0,20,0
1713316501390,MCWP 50R,B00,518792,Staff,17,0,20,3
1713316501390,MCWP 50R,C00,518793,Staff,19,0,20,1
1713316501390,MCWP 50R,D00,518794,Staff,18,0,20,2
1713316501390,MCWP 50R,E00,518795,Staff,18,0,20,2
1713316501390,MCWP 50R,F00,518796,Staff,19,0,20,1
1713316501390,MCWP 50R,G00,518797,Staff,19,0,20,1
1713316502419,MMW 12R,A01,514034,Herbst; Matthew,15,0,16,1
1713316502419,MMW 12R,A02,514035,Herbst; Matthew,16,0,16,0
1713316503444,MMW 13R,A01,514037,Staff,12,0,16,4
1713316503444,MMW 13R,A02,514039,Staff,16,0,16,0
1713316505554,SIO 295LS,A00,523233,Staff,19,0,30,11
1713316506579,SIO 295S,A00,523232,Staff,19,0,30,11
1713316507604,SOCI 117,A01,494376,Staff,3,0,5,2
1713316508629,WES 237B,A00,494380,Staff,19,0,20,1
1713316510693,AESE 279B,A00,494370,Wade; Jon P,33,0,33,0
1713316511720,ANAR 135S,A00,494369,Braswell; Geoffrey E.,0,0,0,0
1713316512749,CAT 124RS,A01,519847,Geibel; William,17,0,20,3
1713316513773,CAT 125RS,A01,515971,Geibel; William,17,0,20,3
1713316514799,CLRE 250,A00,511389,Morris; Sheldon,9996,0,9999,3
1713316515827,CLRE 251,A00,507176,Mehta; Ravindra L.,9996,0,9999,3
1713316515827,CLRE 251,B00,511410,Mehta; Ravindra L.,9998,0,9999,1
1713316516853,CLRE 252,A00,507189,Cuomo; Raphael Eduardo,9998,0,9999,1
1713316517879,CLRE 253,A00,507199,Vaida; Florin,9997,0,9999,2
1713316517879,CLRE 253,B00,507202,Vaida; Florin,9999,0,9999,0
1713316518903,CLRE 259,A00,507211,Patel; Hemal,9996,0,9999,3
1713316519933,CLRE 260,A00,507221,Cuomo; Raphael Eduardo,9999,0,9999,0
1713316520960,CLRE 297,001,507242,Cuomo; Raphael Eduardo,9999,0,9999,0
1713316521987,CSE 191,A00,516875,Minnes Kemp; Mor Mia,9999,0,9999,0
1713316523013,CSS 201S,A01,494383,Staff,35,0,35,0
1713316524039,CSS 202S,A01,494387,Staff,35,0,35,0
1713316525064,EAP 100,A00,516065,Staff,9792,0,9999,207
1713316526089,ECE 45,A01,507414,Staff,54,0,60,6
1713316527114,ECE 100,A01,507416,Baghdadchi; Saharnaz,11,0,20,9
1713316527114,ECE 100,A02,507418,Baghdadchi; Saharnaz,20,0,20,0
1713316528139,ECE 111,A01,507420,Staff,40,0,50,10
1713316529166,ECE 197,001,548057,Sievenpiper; Daniel F.,9998,0,9999,1
1713316530196,EDS 115,A00,507243,Choi; Bailey Miyeon,28,0,28,0
1713316531222,EDS 117,A01,494379,Staff,24,0,25,1
1713316532247,EDS 125,A00,507246,Hopkins; Megan Beth,29,0,30,1
1713316533272,EDS 128A,A01,507264,Fargason; Sharon Gayle,26,0,26,0
1713316534297,EDS 128B,A01,507293,Pappas; Elizabeth,30,0,30,0
1713316535320,EDS 139,A00,507294,Fargason; Sharon Gayle,30,0,30,0
1713316535320,EDS 139,B00,507313,Pappas; Elizabeth,30,0,30,0
1713316536344,EDS 201,A00,507315,Staff,26,0,30,4
1713316537372,EDS 203,A01,507317,Halter; Christopher P.,26,0,30,4
1713316538398,EDS 204R,A01,507319,Halter; Christopher P.,4,0,30,26
1713316538398,EDS 204R,B01,507331,Heinzman; Erica M.,28,0,30,2
1713316539421,EDS 206R,A00,507332,Staff,5,0,30,25
1713316539421,EDS 206R,B00,507343,Staff,28,0,30,2
1713316540448,EDS 250,A00,507344,Hemans; Patricia Ann Benitez,36,0,40,4
1713316541476,EDS 281,A00,507345,Daly; Alan J.,18,0,18,0
1713316542501,EDS 284,A00,507350,Daly; Alan J.,16,0,16,0
1713316543527,EDS 286,A00,507359,Fine; Sarah,18,0,18,0
1713316544553,EDS 289C,A01,507361,Daly; Alan J.,18,0,18,0
1713316545578,EDS 290,A00,507366,Hofstetter; Carolyn,15,0,15,0
1713316546603,LIGM 5A,A00,507421,Fischer-Grunski; Eva K,20,0,20,0
1713316547634,LIGM 5B,A00,507423,Fischer-Grunski; Eva K,20,0,20,0
1713316548664,LIGM 5C,A00,507425,Fischer-Grunski; Eva K,20,0,20,0
1713316549690,LIIT 5AS,A00,507427,Carnelos; Chiara,20,0,20,0
1713316550714,LIIT 5BS,A00,507430,Carnelos; Chiara,20,0,20,0
1713316551742,LIIT 5CS,A00,507432,Carnelos; Chiara,20,0,20,0
1713316552767,LISP 5A,A00,507541,Munoz Sanchez; Alicia,19,0,20,1
1713316553820,LISP 5B,A00,507671,Munoz Sanchez; Alicia,17,0,20,3
1713316554844,LISP 5C,A00,507696,Munoz Sanchez; Alicia,17,0,20,3
1713316555869,MAE 197,001,528363,Boechler; Nicholas Sebastia,9998,0,9999,1
1713316556897,MATH 197,001,523477,Kedlaya; Kiran S.,9999,0,9999,0
1713316556897,MATH 197,002,563811,Zhang; Danna,9999,0,9999,0
1713316557923,MCWP 40R,A00,518780,Staff,20,0,20,0
1713316557923,MCWP 40R,B00,518781,Staff,19,0,20,1
1713316557923,MCWP 40R,C00,518783,Staff,19,0,20,1
1713316558953,MCWP 50R,A00,518791,Staff,20,0,20,0
1713316558953,MCWP 50R,B00,518792,Staff,17,0,20,3
1713316558953,MCWP 50R,C00,518793,Staff,19,0,20,1
1713316558953,MCWP 50R,D00,518794,Staff,18,0,20,2
1713316558953,MCWP 50R,E00,518795,Staff,18,0,20,2
1713316558953,MCWP 50R,F00,518796,Staff,19,0,20,1
1713316558953,MCWP 50R,G00,518797,Staff,19,0,20,1
1713316559979,MMW 12R,A01,514034,Herbst; Matthew,15,0,16,1
1713316559979,MMW 12R,A02,514035,Herbst; Matthew,16,0,16,0
1713316561008,MMW 13R,A01,514037,Staff,12,0,16,4
1713316561008,MMW 13R,A02,514039,Staff,16,0,16,0
1713316563057,SIO 295LS,A00,523233,Staff,19,0,30,11
1713316564082,SIO 295S,A00,523232,Staff,19,0,30,11
1713316565109,SOCI 117,A01,494376,Staff,3,0,5,2
1713316566136,WES 237B,A00,494380,Staff,19,0,20,1
1713316568192,AESE 279B,A00,494370,Wade; Jon P,33,0,33,0
1713316569217,ANAR 135S,A00,494369,Braswell; Geoffrey E.,0,0,0,0
1713316570247,CAT 124RS,A01,519847,Geibel; William,17,0,20,3
1713316571273,CAT 125RS,A01,515971,Geibel; William,17,0,20,3
1713316572301,CLRE 250,A00,511389,Morris; Sheldon,9996,0,9999,3
1713316573327,CLRE 251,A00,507176,Mehta; Ravindra L.,9996,0,9999,3
1713316573327,CLRE 251,B00,511410,Mehta; Ravindra L.,9998,0,9999,1
1713316574357,CLRE 252,A00,507189,Cuomo; Raphael Eduardo,9998,0,9999,1
1713316575381,CLRE 253,A00,507199,Vaida; Florin,9997,0,9999,2
1713316575381,CLRE 253,B00,507202,Vaida; Florin,9999,0,9999,0
1713316576404,CLRE 259,A00,507211,Patel; Hemal,9996,0,9999,3
1713316577428,CLRE 260,A00,507221,Cuomo; Raphael Eduardo,9999,0,9999,0
1713316578452,CLRE 297,001,507242,Cuomo; Raphael Eduardo,9999,0,9999,0
1713316579480,CSE 191,A00,516875,Minnes Kemp; Mor Mia,9999,0,9999,0
1713316580504,CSS 201S,A01,494383,Staff,35,0,35,0
1713316581528,CSS 202S,A01,494387,Staff,35,0,35,0
1713316582553,EAP 100,A00,516065,Staff,9792,0,9999,207
1713316583579,ECE 45,A01,507414,Staff,54,0,60,6
1713316584603,ECE 100,A01,507416,Baghdadchi; Saharnaz,11,0,20,9
1713316584603,ECE 100,A02,507418,Baghdadchi; Saharnaz,20,0,20,0
1713316585631,ECE 111,A01,507420,Staff,40,0,50,10
1713316586658,ECE 197,001,548057,Sievenpiper; Daniel F.,9998,0,9999,1
1713316587682,EDS 115,A00,507243,Choi; Bailey Miyeon,28,0,28,0
1713316588707,EDS 117,A01,494379,Staff,24,0,25,1
1713316589735,EDS 125,A00,507246,Hopkins; Megan Beth,29,0,30,1
1713316590764,EDS 128A,A01,507264,Fargason; Sharon Gayle,26,0,26,0
1713316591788,EDS 128B,A01,507293,Pappas; Elizabeth,30,0,30,0
1713316592812,EDS 139,A00,507294,Fargason; Sharon Gayle,30,0,30,0
1713316592812,EDS 139,B00,507313,Pappas; Elizabeth,30,0,30,0
1713316593840,EDS 201,A00,507315,Staff,26,0,30,4
1713316594864,EDS 203,A01,507317,Halter; Christopher P.,26,0,30,4
1713316595891,EDS 204R,A01,507319,Halter; Christopher P.,4,0,30,26
1713316595891,EDS 204R,B01,507331,Heinzman; Erica M.,28,0,30,2
1713316596919,EDS 206R,A00,507332,Staff,5,0,30,25
1713316596919,EDS 206R,B00,507343,Staff,28,0,30,2
1713316597945,EDS 250,A00,507344,Hemans; Patricia Ann Benitez,36,0,40,4
1713316598970,EDS 281,A00,507345,Daly; Alan J.,18,0,18,0
1713316599994,EDS 284,A00,507350,Daly; Alan J.,16,0,16,0
1713316601019,EDS 286,A00,507359,Fine; Sarah,18,0,18,0
1713316602046,EDS 289C,A01,507361,Daly; Alan J.,18,0,18,0
1713316603072,EDS 290,A00,507366,Hofstetter; Carolyn,15,0,15,0
1713316604099,LIGM 5A,A00,507421,Fischer-Grunski; Eva K,20,0,20,0
1713316605124,LIGM 5B,A00,507423,Fischer-Grunski; Eva K,20,0,20,0
1713316606153,LIGM 5C,A00,507425,Fischer-Grunski; Eva K,20,0,20,0
1713316607183,LIIT 5AS,A00,507427,Carnelos; Chiara,20,0,20,0
1713316608273,LIIT 5BS,A00,507430,Carnelos; Chiara,20,0,20,0
1713316609302,LIIT 5CS,A00,507432,Carnelos; Chiara,20,0,20,0
1713316610329,LISP 5A,A00,507541,Munoz Sanchez; Alicia,19,0,20,1
1713316611357,LISP 5B,A00,507671,Munoz Sanchez; Alicia,17,0,20,3
1713316612382,LISP 5C,A00,507696,Munoz Sanchez; Alicia,17,0,20,3
1713316613411,MAE 197,001,528363,Boechler; Nicholas Sebastia,9998,0,9999,1
1713316614438,MATH 197,001,523477,Kedlaya; Kiran S.,9999,0,9999,0
1713316614438,MATH 197,002,563811,Zhang; Danna,9999,0,9999,0
1713316615467,MCWP 40R,A00,518780,Staff,20,0,20,0
1713316615467,MCWP 40R,B00,518781,Staff,19,0,20,1
1713316615467,MCWP 40R,C00,518783,Staff,19,0,20,1
1713316616492,MCWP 50R,A00,518791,Staff,20,0,20,0
1713316616492,MCWP 50R,B00,518792,Staff,17,0,20,3
1713316616492,MCWP 50R,C00,518793,Staff,19,0,20,1
1713316616492,MCWP 50R,D00,518794,Staff,18,0,20,2
1713316616492,MCWP 50R,E00,518795,Staff,18,0,20,2
1713316616492,MCWP 50R,F00,518796,Staff,19,0,20,1
1713316616492,MCWP 50R,G00,518797,Staff,19,0,20,1
1713316617517,MMW 12R,A01,514034,Herbst; Matthew,15,0,16,1
1713316617517,MMW 12R,A02,514035,Herbst; Matthew,16,0,16,0
1713316618547,MMW 13R,A01,514037,Staff,12,0,16,4
1713316618547,MMW 13R,A02,514039,Staff,16,0,16,0
1713316620595,SIO 295LS,A00,523233,Staff,19,0,30,11
1713316621624,SIO 295S,A00,523232,Staff,19,0,30,11
1713316622649,SOCI 117,A01,494376,Staff,3,0,5,2
1713316623675,WES 237B,A00,494380,Staff,19,0,20,1
1713316625740,AESE 279B,A00,494370,Wade; Jon P,33,0,33,0
1713316626765,ANAR 135S,A00,494369,Braswell; Geoffrey E.,0,0,0,0
1713316627791,CAT 124RS,A01,519847,Geibel; William,17,0,20,3
1713316628820,CAT 125RS,A01,515971,Geibel; William,17,0,20,3
1713316629845,CLRE 250,A00,511389,Morris; Sheldon,9996,0,9999,3
1713316630873,CLRE 251,A00,507176,Mehta; Ravindra L.,9996,0,9999,3
1713316630873,CLRE 251,B00,511410,Mehta; Ravindra L.,9998,0,9999,1
1713316631898,CLRE 252,A00,507189,Cuomo; Raphael Eduardo,9998,0,9999,1
1713316632924,CLRE 253,A00,507199,Vaida; Florin,9997,0,9999,2
1713316632924,CLRE 253,B00,507202,Vaida; Florin,9999,0,9999,0
1713316633950,CLRE 259,A00,507211,Patel; Hemal,9996,0,9999,3
1713316634976,CLRE 260,A00,507221,Cuomo; Raphael Eduardo,9999,0,9999,0
1713316636001,CLRE 297,001,507242,Cuomo; Raphael Eduardo,9999,0,9999,0
1713316637029,CSE 191,A00,516875,Minnes Kemp; Mor Mia,9999,0,9999,0
1713316638060,CSS 201S,A01,494383,Staff,35,0,35,0
1713316639085,CSS 202S,A01,494387,Staff,35,0,35,0
1713316640110,EAP 100,A00,516065,Staff,9792,0,9999,207
1713316641135,ECE 45,A01,507414,Staff,54,0,60,6
1713316642165,ECE 100,A01,507416,Baghdadchi; Saharnaz,11,0,20,9
1713316642165,ECE 100,A02,507418,Baghdadchi; Saharnaz,20,0,20,0
1713316643193,ECE 111,A01,507420,Staff,40,0,50,10
1713316644220,ECE 197,001,548057,Sievenpiper; Daniel F.,9998,0,9999,1
1713316645250,EDS 115,A00,507243,Choi; Bailey Miyeon,28,0,28,0
1713316646274,EDS 117,A01,494379,Staff,24,0,25,1
1713316647300,EDS 125,A00,507246,Hopkins; Megan Beth,29,0,30,1
1713316648327,EDS 128A,A01,507264,Fargason; Sharon Gayle,26,0,26,0
1713316649352,EDS 128B,A01,507293,Pappas; Elizabeth,30,0,30,0
1713316650376,EDS 139,A00,507294,Fargason; Sharon Gayle,30,0,30,0
1713316650376,EDS 139,B00,507313,Pappas; Elizabeth,30,0,30,0
1713316651401,EDS 201,A00,507315,Staff,26,0,30,4
1713316652427,EDS 203,A01,507317,Halter; Christopher P.,26,0,30,4
1713316653456,EDS 204R,A01,507319,Halter; Christopher P.,4,0,30,26
1713316653456,EDS 204R,B01,507331,Heinzman; Erica M.,28,0,30,2
1713316654484,EDS 206R,A00,507332,Staff,5,0,30,25
1713316654484,EDS 206R,B00,507343,Staff,28,0,30,2
1713316655510,EDS 250,A00,507344,Hemans; Patricia Ann Benitez,36,0,40,4
1713316656534,EDS 281,A00,507345,Daly; Alan J.,18,0,18,0
1713316657564,EDS 284,A00,507350,Daly; Alan J.,16,0,16,0
1713316658590,EDS 286,A00,507359,Fine; Sarah,18,0,18,0
1713316659615,EDS 289C,A01,507361,Daly; Alan J.,18,0,18,0
1713316660639,EDS 290,A00,507366,Hofstetter; Carolyn,15,0,15,0
1713316661664,LIGM 5A,A00,507421,Fischer-Grunski; Eva K,20,0,20,0
1713316662688,LIGM 5B,A00,507423,Fischer-Grunski; Eva K,20,0,20,0
1713316663714,LIGM 5C,A00,507425,Fischer-Grunski; Eva K,20,0,20,0
1713316664738,LIIT 5AS,A00,507427,Carnelos; Chiara,20,0,20,0
1713316665765,LIIT 5BS,A00,507430,Carnelos; Chiara,20,0,20,0
1713316666795,LIIT 5CS,A00,507432,Carnelos; Chiara,20,0,20,0
1713316667825,LISP 5A,A00,507541,Munoz Sanchez; Alicia,19,0,20,1
1713316668851,LISP 5B,A00,507671,Munoz Sanchez; Alicia,17,0,20,3
1713316669875,LISP 5C,A00,507696,Munoz Sanchez; Alicia,17,0,20,3
1713316670903,MAE 197,001,528363,Boechler; Nicholas Sebastia,9998,0,9999,1
1713316671928,MATH 197,001,523477,Kedlaya; Kiran S.,9999,0,9999,0
1713316671928,MATH 197,002,563811,Zhang; Danna,9999,0,9999,0
1713316672954,MCWP 40R,A00,518780,Staff,20,0,20,0
1713316672954,MCWP 40R,B00,518781,Staff,19,0,20,1
1713316672954,MCWP 40R,C00,518783,Staff,19,0,20,1
1713316673984,MCWP 50R,A00,518791,Staff,20,0,20,0
1713316673984,MCWP 50R,B00,518792,Staff,17,0,20,3
1713316673984,MCWP 50R,C00,518793,Staff,19,0,20,1
1713316673984,MCWP 50R,D00,518794,Staff,18,0,20,2
1713316673984,MCWP 50R,E00,518795,Staff,18,0,20,2
1713316673984,MCWP 50R,F00,518796,Staff,19,0,20,1
1713316673984,MCWP 50R,G00,518797,Staff,19,0,20,1
1713316675009,MMW 12R,A01,514034,Herbst; Matthew,15,0,16,1
1713316675009,MMW 12R,A02,514035,Herbst; Matthew,16,0,16,0
1713316676037,MMW 13R,A01,514037,Staff,12,0,16,4
1713316676037,MMW 13R,A02,514039,Staff,16,0,16,0
1713316678087,SIO 295LS,A00,523233,Staff,19,0,30,11
1713316679116,SIO 295S,A00,523232,Staff,19,0,30,11
1713316680148,SOCI 117,A01,494376,Staff,3,0,5,2
1713316681173,WES 237B,A00,494380,Staff,19,0,20,1
1713316683246,AESE 279B,A00,494370,Wade; Jon P,33,0,33,0
1713316684271,ANAR 135S,A00,494369,Braswell; Geoffrey E.,0,0,0,0
1713316685304,CAT 124RS,A01,519847,Geibel; William,17,0,20,3
1713316686329,CAT 125RS,A01,515971,Geibel; William,17,0,20,3
1713316687360,CLRE 250,A00,511389,Morris; Sheldon,9996,0,9999,3
1713316688389,CLRE 251,A00,507176,Mehta; Ravindra L.,9996,0,9999,3
1713316688389,CLRE 251,B00,511410,Mehta; Ravindra L.,9998,0,9999,1
1713316689416,CLRE 252,A00,507189,Cuomo; Raphael Eduardo,9998,0,9999,1
1713316690443,CLRE 253,A00,507199,Vaida; Florin,9997,0,9999,2
1713316690443,CLRE 253,B00,507202,Vaida; Florin,9999,0,9999,0
1713316691472,CLRE 259,A00,507211,Patel; Hemal,9996,0,9999,3
1713316692498,CLRE 260,A00,507221,Cuomo; Raphael Eduardo,9999,0,9999,0
1713316693526,CLRE 297,001,507242,Cuomo; Raphael Eduardo,9999,0,9999,0
1713316694550,CSE 191,A00,516875,Minnes Kemp; Mor Mia,9999,0,9999,0
1713316695581,CSS 201S,A01,494383,Staff,35,0,35,0
1713316696607,CSS 202S,A01,494387,Staff,35,0,35,0
1713316697632,EAP 100,A00,516065,Staff,9792,0,9999,207
1713316698658,ECE 45,A01,507414,Staff,54,0,60,6
1713316699685,ECE 100,A01,507416,Baghdadchi; Saharnaz,11,0,20,9
1713316699685,ECE 100,A02,507418,Baghdadchi; Saharnaz,20,0,20,0
1713316700713,ECE 111,A01,507420,Staff,40,0,50,10
1713316701737,ECE 197,001,548057,Sievenpiper; Daniel F.,9998,0,9999,1
1713316702763,EDS 115,A00,507243,Choi; Bailey Miyeon,28,0,28,0
1713316703788,EDS 117,A01,494379,Staff,24,0,25,1
1713316704814,EDS 125,A00,507246,Hopkins; Megan Beth,29,0,30,1
1713316705841,EDS 128A,A01,507264,Fargason; Sharon Gayle,26,0,26,0
1713316706867,EDS 128B,A01,507293,Pappas; Elizabeth,30,0,30,0
1713316707893,EDS 139,A00,507294,Fargason; Sharon Gayle,30,0,30,0
1713316707893,EDS 139,B00,507313,Pappas; Elizabeth,30,0,30,0
1713316708922,EDS 201,A00,507315,Staff,26,0,30,4
1713316709946,EDS 203,A01,507317,Halter; Christopher P.,26,0,30,4
1713316710971,EDS 204R,A01,507319,Halter; Christopher P.,4,0,30,26
1713316710971,EDS 204R,B01,507331,Heinzman; Erica M.,28,0,30,2
1713316712052,EDS 206R,A00,507332,Staff,5,0,30,25
1713316712052,EDS 206R,B00,507343,Staff,28,0,30,2
1713316713080,EDS 250,A00,507344,Hemans; Patricia Ann Benitez,36,0,40,4
1713316714105,EDS 281,A00,507345,Daly; Alan J.,18,0,18,0
1713316715129,EDS 284,A00,507350,Daly; Alan J.,16,0,16,0
1713316716155,EDS 286,A00,507359,Fine; Sarah,18,0,18,0
1713316717179,EDS 289C,A01,507361,Daly; Alan J.,18,0,18,0
1713316718206,EDS 290,A00,507366,Hofstetter; Carolyn,15,0,15,0
1713316719233,LIGM 5A,A00,507421,Fischer-Grunski; Eva K,20,0,20,0
1713316720259,LIGM 5B,A00,507423,Fischer-Grunski; Eva K,20,0,20,0
1713316721286,LIGM 5C,A00,507425,Fischer-Grunski; Eva K,20,0,20,0
1713316722311,LIIT 5AS,A00,507427,Carnelos; Chiara,20,0,20,0
1713316723336,LIIT 5BS,A00,507430,Carnelos; Chiara,20,0,20,0
1713316724362,LIIT 5CS,A00,507432,Carnelos; Chiara,20,0,20,0
1713316725388,LISP 5A,A00,507541,Munoz Sanchez; Alicia,19,0,20,1
1713316726413,LISP 5B,A00,507671,Munoz Sanchez; Alicia,17,0,20,3
1713316727439,LISP 5C,A00,507696,Munoz Sanchez; Alicia,17,0,20,3
1713316728466,MAE 197,001,528363,Boechler; Nicholas Sebastia,9998,0,9999,1
1713316729492,MATH 197,001,523477,Kedlaya; Kiran S.,9999,0,9999,0
1713316729492,MATH 197,002,563811,Zhang; Danna,9999,0,9999,0
1713316730518,MCWP 40R,A00,518780,Staff,20,0,20,0
1713316730518,MCWP 40R,B00,518781,Staff,19,0,20,1
1713316730518,MCWP 40R,C00,518783,Staff,19,0,20,1
1713316731543,MCWP 50R,A00,518791,Staff,20,0,20,0
1713316731543,MCWP 50R,B00,518792,Staff,17,0,20,3
1713316731543,MCWP 50R,C00,518793,Staff,19,0,20,1
1713316731543,MCWP 50R,D00,518794,Staff,18,0,20,2
1713316731543,MCWP 50R,E00,518795,Staff,18,0,20,2
1713316731543,MCWP 50R,F00,518796,Staff,19,0,20,1
1713316731543,MCWP 50R,G00,518797,Staff,19,0,20,1
1713316732571,MMW 12R,A01,514034,Herbst; Matthew,15,0,16,1
1713316732571,MMW 12R,A02,514035,Herbst; Matthew,16,0,16,0
1713316733595,MMW 13R,A01,514037,Staff,12,0,16,4
1713316733595,MMW 13R,A02,514039,Staff,16,0,16,0
1713316735649,SIO 295LS,A00,523233,Staff,19,0,30,11
1713316736676,SIO 295S,A00,523232,Staff,19,0,30,11
1713316737703,SOCI 117,A01,494376,Staff,3,0,5,2
1713316738729,WES 237B,A00,494380,Staff,19,0,20,1
1713316740799,AESE 279B,A00,494370,Wade; Jon P,33,0,33,0
1713316741824,ANAR 135S,A00,494369,Braswell; Geoffrey E.,0,0,0,0
1713316742851,CAT 124RS,A01,519847,Geibel; William,17,0,20,3
1713316743878,CAT 125RS,A01,515971,Geibel; William,17,0,20,3
1713316744903,CLRE 250,A00,511389,Morris; Sheldon,9996,0,9999,3
1713316745929,CLRE 251,A00,507176,Mehta; Ravindra L.,9996,0,9999,3
1713316745929,CLRE 251,B00,511410,Mehta; Ravindra L.,9998,0,9999,1
1713316746958,CLRE 252,A00,507189,Cuomo; Raphael Eduardo,9998,0,9999,1
1713316747988,CLRE 253,A00,507199,Vaida; Florin,9997,0,9999,2
1713316747988,CLRE 253,B00,507202,Vaida; Florin,9999,0,9999,0
1713316749016,CLRE 259,A00,507211,Patel; Hemal,9996,0,9999,3
1713316750041,CLRE 260,A00,507221,Cuomo; Raphael Eduardo,9999,0,9999,0
1713316751071,CLRE 297,001,507242,Cuomo; Raphael Eduardo,9999,0,9999,0
1713316752096,CSE 191,A00,516875,Minnes Kemp; Mor Mia,9999,0,9999,0
1713316753122,CSS 201S,A01,494383,Staff,35,0,35,0
1713316754148,CSS 202S,A01,494387,Staff,35,0,35,0
1713316755173,EAP 100,A00,516065,Staff,9792,0,9999,207
1713316756199,ECE 45,A01,507414,Staff,54,0,60,6
1713316757227,ECE 100,A01,507416,Baghdadchi; Saharnaz,11,0,20,9
1713316757227,ECE 100,A02,507418,Baghdadchi; Saharnaz,20,0,20,0
1713316758253,ECE 111,A01,507420,Staff,40,0,50,10
1713316759279,ECE 197,001,548057,Sievenpiper; Daniel F.,9998,0,9999,1
1713316760306,EDS 115,A00,507243,Choi; Bailey Miyeon,28,0,28,0
1713316761337,EDS 117,A01,494379,Staff,24,0,25,1
1713316762367,EDS 125,A00,507246,Hopkins; Megan Beth,29,0,30,1
1713316763399,EDS 128A,A01,507264,Fargason; Sharon Gayle,26,0,26,0
1713316764424,EDS 128B,A01,507293,Pappas; Elizabeth,30,0,30,0
1713316765450,EDS 139,A00,507294,Fargason; Sharon Gayle,30,0,30,0
1713316765450,EDS 139,B00,507313,Pappas; Elizabeth,30,0,30,0
1713316766473,EDS 201,A00,507315,Staff,26,0,30,4
1713316767498,EDS 203,A01,507317,Halter; Christopher P.,26,0,30,4
1713316768528,EDS 204R,A01,507319,Halter; Christopher P.,4,0,30,26
1713316768528,EDS 204R,B01,507331,Heinzman; Erica M.,28,0,30,2
1713316769553,EDS 206R,A00,507332,Staff,5,0,30,25
1713316769553,EDS 206R,B00,507343,Staff,28,0,30,2
1713316770581,EDS 250,A00,507344,Hemans; Patricia Ann Benitez,36,0,40,4
1713316771610,EDS 281,A00,507345,Daly; Alan J.,18,0,18,0
1713316772636,EDS 284,A00,507350,Daly; Alan J.,16,0,16,0
1713316773662,EDS 286,A00,507359,Fine; Sarah,18,0,18,0
1713316774687,EDS 289C,A01,507361,Daly; Alan J.,18,0,18,0
1713316775713,EDS 290,A00,507366,Hofstetter; Carolyn,15,0,15,0
1713316776740,LIGM 5A,A00,507421,Fischer-Grunski; Eva K,20,0,20,0
1713316777770,LIGM 5B,A00,507423,Fischer-Grunski; Eva K,20,0,20,0
1713316778796,LIGM 5C,A00,507425,Fischer-Grunski; Eva K,20,0,20,0
1713316779825,LIIT 5AS,A00,507427,Carnelos; Chiara,20,0,20,0
1713316780856,LIIT 5BS,A00,507430,Carnelos; Chiara,20,0,20,0
1713316781882,LIIT 5CS,A00,507432,Carnelos; Chiara,20,0,20,0
1713316782916,LISP 5A,A00,507541,Munoz Sanchez; Alicia,19,0,20,1
1713316783941,LISP 5B,A00,507671,Munoz Sanchez; Alicia,17,0,20,3
1713316784966,LISP 5C,A00,507696,Munoz Sanchez; Alicia,17,0,20,3
1713316785996,MAE 197,001,528363,Boechler; Nicholas Sebastia,9998,0,9999,1
1713316787026,MATH 197,001,523477,Kedlaya; Kiran S.,9999,0,9999,0
1713316787026,MATH 197,002,563811,Zhang; Danna,9999,0,9999,0
1713316788053,MCWP 40R,A00,518780,Staff,20,0,20,0
1713316788053,MCWP 40R,B00,518781,Staff,19,0,20,1
1713316788053,MCWP 40R,C00,518783,Staff,19,0,20,1
1713316789093,MCWP 50R,A00,518791,Staff,20,0,20,0
1713316789093,MCWP 50R,B00,518792,Staff,17,0,20,3
1713316789093,MCWP 50R,C00,518793,Staff,19,0,20,1
1713316789093,MCWP 50R,D00,518794,Staff,18,0,20,2
1713316789093,MCWP 50R,E00,518795,Staff,18,0,20,2
1713316789093,MCWP 50R,F00,518796,Staff,19,0,20,1
1713316789093,MCWP 50R,G00,518797,Staff,19,0,20,1
1713316790125,MMW 12R,A01,514034,Herbst; Matthew,15,0,16,1
1713316790125,MMW 12R,A02,514035,Herbst; Matthew,16,0,16,0
1713316791150,MMW 13R,A01,514037,Staff,12,0,16,4
1713316791150,MMW 13R,A02,514039,Staff,16,0,16,0
1713316793208,SIO 295LS,A00,523233,Staff,19,0,30,11
1713316794236,SIO 295S,A00,523232,Staff,19,0,30,11
1713316795262,SOCI 117,A01,494376,Staff,3,0,5,2
1713316796287,WES 237B,A00,494380,Staff,19,0,20,1
1713316798372,AESE 279B,A00,494370,Wade; Jon P,33,0,33,0
1713316799403,ANAR 135S,A00,494369,Braswell; Geoffrey E.,0,0,0,0
1713316800432,CAT 124RS,A01,519847,Geibel; William,17,0,20,3
1713316801458,CAT 125RS,A01,515971,Geibel; William,17,0,20,3
1713316802489,CLRE 250,A00,511389,Morris; Sheldon,9996,0,9999,3
1713316803514,CLRE 251,A00,507176,Mehta; Ravindra L.,9996,0,9999,3
1713316803514,CLRE 251,B00,511410,Mehta; Ravindra L.,9998,0,9999,1
1713316804541,CLRE 252,A00,507189,Cuomo; Raphael Eduardo,9998,0,9999,1
1713316805571,CLRE 253,A00,507199,Vaida; Florin,9997,0,9999,2
1713316805571,CLRE 253,B00,507202,Vaida; Florin,9999,0,9999,0
1713316806601,CLRE 259,A00,507211,Patel; Hemal,9996,0,9999,3
1713316807625,CLRE 260,A00,507221,Cuomo; Raphael Eduardo,9999,0,9999,0
1713316808650,CLRE 297,001,507242,Cuomo; Raphael Eduardo,9999,0,9999,0
1713316809675,CSE 191,A00,516875,Minnes Kemp; Mor Mia,9999,0,9999,0
1713316810706,CSS 201S,A01,494383,Staff,35,0,35,0
1713316811731,CSS 202S,A01,494387,Staff,35,0,35,0
1713316812756,EAP 100,A00,516065,Staff,9792,0,9999,207
1713316813781,ECE 45,A01,507414,Staff,54,0,60,6
1713316814806,ECE 100,A01,507416,Baghdadchi; Saharnaz,11,0,20,9
1713316814806,ECE 100,A02,507418,Baghdadchi; Saharnaz,20,0,20,0
1713316815886,ECE 111,A01,507420,Staff,40,0,50,10
1713316816915,ECE 197,001,548057,Sievenpiper; Daniel F.,9998,0,9999,1
1713316817941,EDS 115,A00,507243,Choi; Bailey Miyeon,28,0,28,0
1713316818965,EDS 117,A01,494379,Staff,24,0,25,1
1713316819996,EDS 125,A00,507246,Hopkins; Megan Beth,29,0,30,1
1713316821026,EDS 128A,A01,507264,Fargason; Sharon Gayle,26,0,26,0
1713316822048,EDS 128B,A01,507293,Pappas; Elizabeth,30,0,30,0
1713316823074,EDS 139,A00,507294,Fargason; Sharon Gayle,30,0,30,0
1713316823074,EDS 139,B00,507313,Pappas; Elizabeth,30,0,30,0
1713316824100,EDS 201,A00,507315,Staff,26,0,30,4
1713316825128,EDS 203,A01,507317,Halter; Christopher P.,26,0,30,4
1713316826154,EDS 204R,A01,507319,Halter; Christopher P.,4,0,30,26
1713316826154,EDS 204R,B01,507331,Heinzman; Erica M.,28,0,30,2
1713316827179,EDS 206R,A00,507332,Staff,5,0,30,25
1713316827179,EDS 206R,B00,507343,Staff,28,0,30,2
1713316828205,EDS 250,A00,507344,Hemans; Patricia Ann Benitez,36,0,40,4
1713316829231,EDS 281,A00,507345,Daly; Alan J.,18,0,18,0
1713316830260,EDS 284,A00,507350,Daly; Alan J.,16,0,16,0
1713316831284,EDS 286,A00,507359,Fine; Sarah,18,0,18,0
1713316832313,EDS 289C,A01,507361,Daly; Alan J.,18,0,18,0
1713316833340,EDS 290,A00,507366,Hofstetter; Carolyn,15,0,15,0
1713316834368,LIGM 5A,A00,507421,Fischer-Grunski; Eva K,20,0,20,0
1713316835395,LIGM 5B,A00,507423,Fischer-Grunski; Eva K,20,0,20,0
1713316836420,LIGM 5C,A00,507425,Fischer-Grunski; Eva K,20,0,20,0
1713316837449,LIIT 5AS,A00,507427,Carnelos; Chiara,20,0,20,0
1713316838476,LIIT 5BS,A00,507430,Carnelos; Chiara,20,0,20,0
1713316839503,LIIT 5CS,A00,507432,Carnelos; Chiara,20,0,20,0
1713316840535,LISP 5A,A00,507541,Munoz Sanchez; Alicia,19,0,20,1
1713316841561,LISP 5B,A00,507671,Munoz Sanchez; Alicia,17,0,20,3
1713316842586,LISP 5C,A00,507696,Munoz Sanchez; Alicia,17,0,20,3
1713316843612,MAE 197,001,528363,Boechler; Nicholas Sebastia,9998,0,9999,1
1713316844639,MATH 197,001,523477,Kedlaya; Kiran S.,9999,0,9999,0
1713316844639,MATH 197,002,563811,Zhang; Danna,9999,0,9999,0
1713316845670,MCWP 40R,A00,518780,Staff,20,0,20,0
1713316845670,MCWP 40R,B00,518781,Staff,19,0,20,1
1713316845670,MCWP 40R,C00,518783,Staff,19,0,20,1
1713316846696,MCWP 50R,A00,518791,Staff,20,0,20,0
1713316846696,MCWP 50R,B00,518792,Staff,17,0,20,3
1713316846696,MCWP 50R,C00,518793,Staff,19,0,20,1
1713316846696,MCWP 50R,D00,518794,Staff,18,0,20,2
1713316846696,MCWP 50R,E00,518795,Staff,18,0,20,2
1713316846696,MCWP 50R,F00,518796,Staff,19,0,20,1
1713316846696,MCWP 50R,G00,518797,Staff,19,0,20,1
1713316847722,MMW 12R,A01,514034,Herbst; Matthew,15,0,16,1
1713316847722,MMW 12R,A02,514035,Herbst; Matthew,16,0,16,0
1713316848747,MMW 13R,A01,514037,Staff,12,0,16,4
1713316848747,MMW 13R,A02,514039,Staff,16,0,16,0
1713316850797,SIO 295LS,A00,523233,Staff,19,0,30,11
1713316851823,SIO 295S,A00,523232,Staff,19,0,30,11
1713316852849,SOCI 117,A01,494376,Staff,3,0,5,2
1713316853877,WES 237B,A00,494380,Staff,19,0,20,1
1713316855944,AESE 279B,A00,494370,Wade; Jon P,33,0,33,0
1713316856973,ANAR 135S,A00,494369,Braswell; Geoffrey E.,0,0,0,0
1713316858002,CAT 124RS,A01,519847,Geibel; William,17,0,20,3
1713316859028,CAT 125RS,A01,515971,Geibel; William,17,0,20,3
1713316860053,CLRE 250,A00,511389,Morris; Sheldon,9996,0,9999,3
1713316861088,CLRE 251,A00,507176,Mehta; Ravindra L.,9996,0,9999,3
1713316861088,CLRE 251,B00,511410,Mehta; Ravindra L.,9998,0,9999,1
1713316862114,CLRE 252,A00,507189,Cuomo; Raphael Eduardo,9998,0,9999,1
1713316863138,CLRE 253,A00,507199,Vaida; Florin,9997,0,9999,2
1713316863138,CLRE 253,B00,507202,Vaida; Florin,9999,0,9999,0
1713316864163,CLRE 259,A00,507211,Patel; Hemal,9996,0,9999,3
1713316865190,CLRE 260,A00,507221,Cuomo; Raphael Eduardo,9999,0,9999,0
1713316866218,CLRE 297,001,507242,Cuomo; Raphael Eduardo,9999,0,9999,0
1713316867247,CSE 191,A00,516875,Minnes Kemp; Mor Mia,9999,0,9999,0
1713316868281,CSS 201S,A01,494383,Staff,35,0,35,0
1713316869305,CSS 202S,A01,494387,Staff,35,0,35,0
1713316870328,EAP 100,A00,516065,Staff,9792,0,9999,207
1713316871355,ECE 45,A01,507414,Staff,54,0,60,6
1713316872380,ECE 100,A01,507416,Baghdadchi; Saharnaz,11,0,20,9
1713316872380,ECE 100,A02,507418,Baghdadchi; Saharnaz,20,0,20,0
1713316873410,ECE 111,A01,507420,Staff,40,0,50,10
1713316874439,ECE 197,001,548057,Sievenpiper; Daniel F.,9998,0,9999,1
1713316875464,EDS 115,A00,507243,Choi; Bailey Miyeon,28,0,28,0
1713316876494,EDS 117,A01,494379,Staff,24,0,25,1
1713316877519,EDS 125,A00,507246,Hopkins; Megan Beth,29,0,30,1
1713316878545,EDS 128A,A01,507264,Fargason; Sharon Gayle,26,0,26,0
1713316879571,EDS 128B,A01,507293,Pappas; Elizabeth,30,0,30,0
1713316880596,EDS 139,A00,507294,Fargason; Sharon Gayle,30,0,30,0
1713316880596,EDS 139,B00,507313,Pappas; Elizabeth,30,0,30,0
1713316881621,EDS 201,A00,507315,Staff,26,0,30,4
1713316882652,EDS 203,A01,507317,Halter; Christopher P.,26,0,30,4
1713316883678,EDS 204R,A01,507319,Halter; Christopher P.,4,0,30,26
1713316883678,EDS 204R,B01,507331,Heinzman; Erica M.,28,0,30,2
1713316884703,EDS 206R,A00,507332,Staff,5,0,30,25
1713316884703,EDS 206R,B00,507343,Staff,28,0,30,2
1713316885736,EDS 250,A00,507344,Hemans; Patricia Ann Benitez,36,0,40,4
1713316886761,EDS 281,A00,507345,Daly; Alan J.,18,0,18,0
1713316887790,EDS 284,A00,507350,Daly; Alan J.,16,0,16,0
1713316888819,EDS 286,A00,507359,Fine; Sarah,18,0,18,0
1713316889844,EDS 289C,A01,507361,Daly; Alan J.,18,0,18,0
1713316890868,EDS 290,A00,507366,Hofstetter; Carolyn,15,0,15,0
1713316891894,LIGM 5A,A00,507421,Fischer-Grunski; Eva K,20,0,20,0
1713316892925,LIGM 5B,A00,507423,Fischer-Grunski; Eva K,20,0,20,0
1713316893955,LIGM 5C,A00,507425,Fischer-Grunski; Eva K,20,0,20,0
1713316894981,LIIT 5AS,A00,507427,Carnelos; Chiara,20,0,20,0
1713316896007,LIIT 5BS,A00,507430,Carnelos; Chiara,20,0,20,0
1713316897034,LIIT 5CS,A00,507432,Carnelos; Chiara,20,0,20,0
1713316898065,LISP 5A,A00,507541,Munoz Sanchez; Alicia,19,0,20,1
1713316899092,LISP 5B,A00,507671,Munoz Sanchez; Alicia,17,0,20,3
1713316900119,LISP 5C,A00,507696,Munoz Sanchez; Alicia,17,0,20,3
1713316901144,MAE 197,001,528363,Boechler; Nicholas Sebastia,9998,0,9999,1
1713316902175,MATH 197,001,523477,Kedlaya; Kiran S.,9999,0,9999,0
1713316902175,MATH 197,002,563811,Zhang; Danna,9999,0,9999,0
1713316903205,MCWP 40R,A00,518780,Staff,20,0,20,0
1713316903205,MCWP 40R,B00,518781,Staff,19,0,20,1
1713316903205,MCWP 40R,C00,518783,Staff,19,0,20,1
1713316904230,MCWP 50R,A00,518791,Staff,20,0,20,0
1713316904230,MCWP 50R,B00,518792,Staff,17,0,20,3
1713316904230,MCWP 50R,C00,518793,Staff,19,0,20,1
1713316904230,MCWP 50R,D00,518794,Staff,18,0,20,2
1713316904230,MCWP 50R,E00,518795,Staff,17,0,20,3
1713316904230,MCWP 50R,F00,518796,Staff,19,0,20,1
1713316904230,MCWP 50R,G00,518797,Staff,19,0,20,1
1713316905261,MMW 12R,A01,514034,Herbst; Matthew,15,0,16,1
1713316905261,MMW 12R,A02,514035,Herbst; Matthew,16,0,16,0
1713316906288,MMW 13R,A01,514037,Staff,12,0,16,4
1713316906288,MMW 13R,A02,514039,Staff,16,0,16,0
1713316908341,SIO 295LS,A00,523233,Staff,19,0,30,11
1713316909371,SIO 295S,A00,523232,Staff,19,0,30,11
1713316910397,SOCI 117,A01,494376,Staff,3,0,5,2
1713316911427,WES 237B,A00,494380,Staff,19,0,20,1
1713316913500,AESE 279B,A00,494370,Wade; Jon P,33,0,33,0
1713316914525,ANAR 135S,A00,494369,Braswell; Geoffrey E.,0,0,0,0
1713316915557,CAT 124RS,A01,519847,Geibel; William,17,0,20,3
1713316916586,CAT 125RS,A01,515971,Geibel; William,17,0,20,3
1713316917616,CLRE 250,A00,511389,Morris; Sheldon,9996,0,9999,3
1713316918643,CLRE 251,A00,507176,Mehta; Ravindra L.,9996,0,9999,3
1713316918643,CLRE 251,B00,511410,Mehta; Ravindra L.,9998,0,9999,1
1713316919724,CLRE 252,A00,507189,Cuomo; Raphael Eduardo,9998,0,9999,1
1713316920751,CLRE 253,A00,507199,Vaida; Florin,9997,0,9999,2
1713316920751,CLRE 253,B00,507202,Vaida; Florin,9999,0,9999,0
1713316921778,CLRE 259,A00,507211,Patel; Hemal,9996,0,9999,3
1713316922806,CLRE 260,A00,507221,Cuomo; Raphael Eduardo,9999,0,9999,0
1713316923830,CLRE 297,001,507242,Cuomo; Raphael Eduardo,9999,0,9999,0
1713316924856,CSE 191,A00,516875,Minnes Kemp; Mor Mia,9999,0,9999,0
1713316925883,CSS 201S,A01,494383,Staff,35,0,35,0
1713316926909,CSS 202S,A01,494387,Staff,35,0,35,0
1713316927936,EAP 100,A00,516065,Staff,9792,0,9999,207
1713316928963,ECE 45,A01,507414,Staff,54,0,60,6
1713316929996,ECE 100,A01,507416,Baghdadchi; Saharnaz,11,0,20,9
1713316929996,ECE 100,A02,507418,Baghdadchi; Saharnaz,20,0,20,0
1713316931022,ECE 111,A01,507420,Staff,40,0,50,10
1713316932051,ECE 197,001,548057,Sievenpiper; Daniel F.,9998,0,9999,1
1713316933080,EDS 115,A00,507243,Choi; Bailey Miyeon,28,0,28,0
1713316934107,EDS 117,A01,494379,Staff,24,0,25,1
1713316935131,EDS 125,A00,507246,Hopkins; Megan Beth,29,0,30,1
1713316936163,EDS 128A,A01,507264,Fargason; Sharon Gayle,26,0,26,0
1713316937189,EDS 128B,A01,507293,Pappas; Elizabeth,30,0,30,0
1713316938217,EDS 139,A00,507294,Fargason; Sharon Gayle,30,0,30,0
1713316938217,EDS 139,B00,507313,Pappas; Elizabeth,30,0,30,0
1713316939244,EDS 201,A00,507315,Staff,26,0,30,4
1713316940273,EDS 203,A01,507317,Halter; Christopher P.,26,0,30,4
1713316941298,EDS 204R,A01,507319,Halter; Christopher P.,4,0,30,26
1713316941298,EDS 204R,B01,507331,Heinzman; Erica M.,28,0,30,2
1713316942327,EDS 206R,A00,507332,Staff,5,0,30,25
1713316942327,EDS 206R,B00,507343,Staff,28,0,30,2
1713316943358,EDS 250,A00,507344,Hemans; Patricia Ann Benitez,36,0,40,4
1713316944385,EDS 281,A00,507345,Daly; Alan J.,18,0,18,0
1713316945414,EDS 284,A00,507350,Daly; Alan J.,16,0,16,0
1713316946440,EDS 286,A00,507359,Fine; Sarah,18,0,18,0
1713316947465,EDS 289C,A01,507361,Daly; Alan J.,18,0,18,0
1713316948491,EDS 290,A00,507366,Hofstetter; Carolyn,15,0,15,0
1713316949519,LIGM 5A,A00,507421,Fischer-Grunski; Eva K,20,0,20,0
1713316950551,LIGM 5B,A00,507423,Fischer-Grunski; Eva K,20,0,20,0
1713316951577,LIGM 5C,A00,507425,Fischer-Grunski; Eva K,20,0,20,0
1713316952602,LIIT 5AS,A00,507427,Carnelos; Chiara,20,0,20,0
1713316953631,LIIT 5BS,A00,507430,Carnelos; Chiara,20,0,20,0
1713316954657,LIIT 5CS,A00,507432,Carnelos; Chiara,20,0,20,0
1713316955680,LISP 5A,A00,507541,Munoz Sanchez; Alicia,19,0,20,1
1713316956705,LISP 5B,A00,507671,Munoz Sanchez; Alicia,17,0,20,3
1713316957731,LISP 5C,A00,507696,Munoz Sanchez; Alicia,17,0,20,3
1713316958759,MAE 197,001,528363,Boechler; Nicholas Sebastia,9998,0,9999,1
1713316959791,MATH 197,001,523477,Kedlaya; Kiran S.,9999,0,9999,0
1713316959791,MATH 197,002,563811,Zhang; Danna,9999,0,9999,0
1713316960819,MCWP 40R,A00,518780,Staff,20,0,20,0
1713316960819,MCWP 40R,B00,518781,Staff,19,0,20,1
1713316960819,MCWP 40R,C00,518783,Staff,19,0,20,1
1713316961847,MCWP 50R,A00,518791,Staff,20,0,20,0
1713316961847,MCWP 50R,B00,518792,Staff,17,0,20,3
1713316961847,MCWP 50R,C00,518793,Staff,19,0,20,1
1713316961847,MCWP 50R,D00,518794,Staff,18,0,20,2
1713316961847,MCWP 50R,E00,518795,Staff,17,0,20,3
1713316961847,MCWP 50R,F00,518796,Staff,19,0,20,1
1713316961847,MCWP 50R,G00,518797,Staff,19,0,20,1
1713316962871,MMW 12R,A01,514034,Herbst; Matthew,15,0,16,1
1713316962871,MMW 12R,A02,514035,Herbst; Matthew,16,0,16,0
1713316963899,MMW 13R,A01,514037,Staff,12,0,16,4
1713316963899,MMW 13R,A02,514039,Staff,16,0,16,0
1713316965954,SIO 295LS,A00,523233,Staff,19,0,30,11
1713316966979,SIO 295S,A00,523232,Staff,19,0,30,11
1713316968005,SOCI 117,A01,494376,Staff,3,0,5,2
1713316969033,WES 237B,A00,494380,Staff,19,0,20,1
1713316971102,AESE 279B,A00,494370,Wade; Jon P,33,0,33,0
1713316972133,ANAR 135S,A00,494369,Braswell; Geoffrey E.,0,0,0,0
1713316973161,CAT 124RS,A01,519847,Geibel; William,17,0,20,3
1713316974187,CAT 125RS,A01,515971,Geibel; William,17,0,20,3
1713316975214,CLRE 250,A00,511389,Morris; Sheldon,9996,0,9999,3
1713316976240,CLRE 251,A00,507176,Mehta; Ravindra L.,9996,0,9999,3
1713316976240,CLRE 251,B00,511410,Mehta; Ravindra L.,9998,0,9999,1
1713316977269,CLRE 252,A00,507189,Cuomo; Raphael Eduardo,9998,0,9999,1
1713316978300,CLRE 253,A00,507199,Vaida; Florin,9997,0,9999,2
1713316978300,CLRE 253,B00,507202,Vaida; Florin,9999,0,9999,0
1713316979329,CLRE 259,A00,507211,Patel; Hemal,9996,0,9999,3
1713316980353,CLRE 260,A00,507221,Cuomo; Raphael Eduardo,9999,0,9999,0
1713316981383,CLRE 297,001,507242,Cuomo; Raphael Eduardo,9999,0,9999,0
1713316982408,CSE 191,A00,516875,Minnes Kemp; Mor Mia,9999,0,9999,0
1713316983432,CSS 201S,A01,494383,Staff,35,0,35,0
1713316984456,CSS 202S,A01,494387,Staff,35,0,35,0
1713316985481,EAP 100,A00,516065,Staff,9792,0,9999,207
1713316986506,ECE 45,A01,507414,Staff,54,0,60,6
1713316987535,ECE 100,A01,507416,Baghdadchi; Saharnaz,11,0,20,9
1713316987535,ECE 100,A02,507418,Baghdadchi; Saharnaz,20,0,20,0
1713316988562,ECE 111,A01,507420,Staff,40,0,50,10
1713316989590,ECE 197,001,548057,Sievenpiper; Daniel F.,9998,0,9999,1
1713316990616,EDS 115,A00,507243,Choi; Bailey Miyeon,28,0,28,0
1713316991645,EDS 117,A01,494379,Staff,24,0,25,1
1713316992674,EDS 125,A00,507246,Hopkins; Megan Beth,29,0,30,1
1713316993705,EDS 128A,A01,507264,Fargason; Sharon Gayle,26,0,26,0
1713316994730,EDS 128B,A01,507293,Pappas; Elizabeth,30,0,30,0
1713316995762,EDS 139,A00,507294,Fargason; Sharon Gayle,30,0,30,0
1713316995762,EDS 139,B00,507313,Pappas; Elizabeth,30,0,30,0
1713316996787,EDS 201,A00,507315,Staff,26,0,30,4
1713316997817,EDS 203,A01,507317,Halter; Christopher P.,26,0,30,4
1713316998848,EDS 204R,A01,507319,Halter; Christopher P.,4,0,30,26
1713316998848,EDS 204R,B01,507331,Heinzman; Erica M.,28,0,30,2
1713316999873,EDS 206R,A00,507332,Staff,5,0,30,25
1713316999873,EDS 206R,B00,507343,Staff,28,0,30,2
1713317000899,EDS 250,A00,507344,Hemans; Patricia Ann Benitez,36,0,40,4
1713317001923,EDS 281,A00,507345,Daly; Alan J.,18,0,18,0
1713317002948,EDS 284,A00,507350,Daly; Alan J.,16,0,16,0
1713317003972,EDS 286,A00,507359,Fine; Sarah,18,0,18,0
1713317004998,EDS 289C,A01,507361,Daly; Alan J.,18,0,18,0
1713317006023,EDS 290,A00,507366,Hofstetter; Carolyn,15,0,15,0
1713317007054,LIGM 5A,A00,507421,Fischer-Grunski; Eva K,20,0,20,0
1713317008078,LIGM 5B,A00,507423,Fischer-Grunski; Eva K,20,0,20,0
1713317009103,LIGM 5C,A00,507425,Fischer-Grunski; Eva K,20,0,20,0
1713317010130,LIIT 5AS,A00,507427,Carnelos; Chiara,20,0,20,0
1713317011161,LIIT 5BS,A00,507430,Carnelos; Chiara,20,0,20,0
1713317012189,LIIT 5CS,A00,507432,Carnelos; Chiara,20,0,20,0
1713317013220,LISP 5A,A00,507541,Munoz Sanchez; Alicia,19,0,20,1
1713317014245,LISP 5B,A00,507671,Munoz Sanchez; Alicia,17,0,20,3
1713317015273,LISP 5C,A00,507696,Munoz Sanchez; Alicia,17,0,20,3
1713317016300,MAE 197,001,528363,Boechler; Nicholas Sebastia,9998,0,9999,1
1713317017326,MATH 197,001,523477,Kedlaya; Kiran S.,9999,0,9999,0
1713317017326,MATH 197,002,563811,Zhang; Danna,9999,0,9999,0
1713317018353,MCWP 40R,A00,518780,Staff,20,0,20,0
1713317018353,MCWP 40R,B00,518781,Staff,19,0,20,1
1713317018353,MCWP 40R,C00,518783,Staff,19,0,20,1
1713317019383,MCWP 50R,A00,518791,Staff,20,0,20,0
1713317019383,MCWP 50R,B00,518792,Staff,17,0,20,3
1713317019383,MCWP 50R,C00,518793,Staff,19,0,20,1
1713317019383,MCWP 50R,D00,518794,Staff,18,0,20,2
1713317019383,MCWP 50R,E00,518795,Staff,17,0,20,3
1713317019383,MCWP 50R,F00,518796,Staff,19,0,20,1
1713317019383,MCWP 50R,G00,518797,Staff,19,0,20,1
1713317020410,MMW 12R,A01,514034,Herbst; Matthew,15,0,16,1
1713317020410,MMW 12R,A02,514035,Herbst; Matthew,16,0,16,0
1713317021437,MMW 13R,A01,514037,Staff,12,0,16,4
1713317021437,MMW 13R,A02,514039,Staff,16,0,16,0
1713317023541,SIO 295LS,A00,523233,Staff,19,0,30,11
1713317024567,SIO 295S,A00,523232,Staff,19,0,30,11
1713317025593,SOCI 117,A01,494376,Staff,3,0,5,2
1713317026622,WES 237B,A00,494380,Staff,19,0,20,1
1713317028686,AESE 279B,A00,494370,Wade; Jon P,33,0,33,0
1713317029717,ANAR 135S,A00,494369,Braswell; Geoffrey E.,0,0,0,0
1713317030750,CAT 124RS,A01,519847,Geibel; William,17,0,20,3
1713317031775,CAT 125RS,A01,515971,Geibel; William,17,0,20,3
1713317032803,CLRE 250,A00,511389,Morris; Sheldon,9996,0,9999,3
1713317033829,CLRE 251,A00,507176,Mehta; Ravindra L.,9996,0,9999,3
1713317033829,CLRE 251,B00,511410,Mehta; Ravindra L.,9998,0,9999,1
1713317034855,CLRE 252,A00,507189,Cuomo; Raphael Eduardo,9998,0,9999,1
1713317035878,CLRE 253,A00,507199,Vaida; Florin,9997,0,9999,2
1713317035878,CLRE 253,B00,507202,Vaida; Florin,9999,0,9999,0
1713317036905,CLRE 259,A00,507211,Patel; Hemal,9996,0,9999,3
1713317037929,CLRE 260,A00,507221,Cuomo; Raphael Eduardo,9999,0,9999,0
1713317038953,CLRE 297,001,507242,Cuomo; Raphael Eduardo,9999,0,9999,0
1713317039979,CSE 191,A00,516875,Minnes Kemp; Mor Mia,9999,0,9999,0
1713317041010,CSS 201S,A01,494383,Staff,35,0,35,0
1713317042035,CSS 202S,A01,494387,Staff,35,0,35,0
1713317043060,EAP 100,A00,516065,Staff,9792,0,9999,207
1713317044085,ECE 45,A01,507414,Staff,54,0,60,6
1713317045110,ECE 100,A01,507416,Baghdadchi; Saharnaz,11,0,20,9
1713317045110,ECE 100,A02,507418,Baghdadchi; Saharnaz,20,0,20,0
1713317046138,ECE 111,A01,507420,Staff,40,0,50,10
1713317047163,ECE 197,001,548057,Sievenpiper; Daniel F.,9998,0,9999,1
1713317048192,EDS 115,A00,507243,Choi; Bailey Miyeon,28,0,28,0
1713317049219,EDS 117,A01,494379,Staff,24,0,25,1
1713317050243,EDS 125,A00,507246,Hopkins; Megan Beth,29,0,30,1
1713317051268,EDS 128A,A01,507264,Fargason; Sharon Gayle,26,0,26,0
1713317052295,EDS 128B,A01,507293,Pappas; Elizabeth,30,0,30,0
1713317053326,EDS 139,A00,507294,Fargason; Sharon Gayle,30,0,30,0
1713317053326,EDS 139,B00,507313,Pappas; Elizabeth,30,0,30,0
1713317054352,EDS 201,A00,507315,Staff,26,0,30,4
1713317055378,EDS 203,A01,507317,Halter; Christopher P.,26,0,30,4
1713317056404,EDS 204R,A01,507319,Halter; Christopher P.,4,0,30,26
1713317056404,EDS 204R,B01,507331,Heinzman; Erica M.,28,0,30,2
1713317057433,EDS 206R,A00,507332,Staff,5,0,30,25
1713317057433,EDS 206R,B00,507343,Staff,28,0,30,2
1713317058461,EDS 250,A00,507344,Hemans; Patricia Ann Benitez,36,0,40,4
1713317059487,EDS 281,A00,507345,Daly; Alan J.,18,0,18,0
1713317060513,EDS 284,A00,507350,Daly; Alan J.,16,0,16,0
1713317061538,EDS 286,A00,507359,Fine; Sarah,18,0,18,0
1713317062563,EDS 289C,A01,507361,Daly; Alan J.,18,0,18,0
1713317063588,EDS 290,A00,507366,Hofstetter; Carolyn,15,0,15,0
1713317064618,LIGM 5A,A00,507421,Fischer-Grunski; Eva K,20,0,20,0
1713317065647,LIGM 5B,A00,507423,Fischer-Grunski; Eva K,20,0,20,0
1713317066676,LIGM 5C,A00,507425,Fischer-Grunski; Eva K,20,0,20,0
1713317067705,LIIT 5AS,A00,507427,Carnelos; Chiara,20,0,20,0
1713317068735,LIIT 5BS,A00,507430,Carnelos; Chiara,20,0,20,0
1713317069765,LIIT 5CS,A00,507432,Carnelos; Chiara,20,0,20,0
1713317070796,LISP 5A,A00,507541,Munoz Sanchez; Alicia,19,0,20,1
1713317071825,LISP 5B,A00,507671,Munoz Sanchez; Alicia,17,0,20,3
1713317072850,LISP 5C,A00,507696,Munoz Sanchez; Alicia,17,0,20,3
1713317073875,MAE 197,001,528363,Boechler; Nicholas Sebastia,9998,0,9999,1
1713317074900,MATH 197,001,523477,Kedlaya; Kiran S.,9999,0,9999,0
1713317074900,MATH 197,002,563811,Zhang; Danna,9999,0,9999,0
1713317075925,MCWP 40R,A00,518780,Staff,20,0,20,0
1713317075925,MCWP 40R,B00,518781,Staff,19,0,20,1
1713317075925,MCWP 40R,C00,518783,Staff,19,0,20,1
1713317076954,MCWP 50R,A00,518791,Staff,20,0,20,0
1713317076954,MCWP 50R,B00,518792,Staff,17,0,20,3
1713317076954,MCWP 50R,C00,518793,Staff,19,0,20,1
1713317076954,MCWP 50R,D00,518794,Staff,18,0,20,2
1713317076954,MCWP 50R,E00,518795,Staff,17,0,20,3
1713317076954,MCWP 50R,F00,518796,Staff,19,0,20,1
1713317076954,MCWP 50R,G00,518797,Staff,19,0,20,1
1713317077984,MMW 12R,A01,514034,Herbst; Matthew,15,0,16,1
1713317077984,MMW 12R,A02,514035,Herbst; Matthew,16,0,16,0
1713317079008,MMW 13R,A01,514037,Staff,12,0,16,4
1713317079008,MMW 13R,A02,514039,Staff,16,0,16,0
1713317081065,SIO 295LS,A00,523233,Staff,19,0,30,11
1713317082094,SIO 295S,A00,523232,Staff,19,0,30,11
1713317083120,SOCI 117,A01,494376,Staff,3,0,5,2
1713317084149,WES 237B,A00,494380,Staff,19,0,20,1
1713317086214,AESE 279B,A00,494370,Wade; Jon P,33,0,33,0
1713317087239,ANAR 135S,A00,494369,Braswell; Geoffrey E.,0,0,0,0
1713317088266,CAT 124RS,A01,519847,Geibel; William,17,0,20,3
1713317089292,CAT 125RS,A01,515971,Geibel; William,17,0,20,3
1713317090317,CLRE 250,A00,511389,Morris; Sheldon,9996,0,9999,3
1713317091347,CLRE 251,A00,507176,Mehta; Ravindra L.,9996,0,9999,3
1713317091347,CLRE 251,B00,511410,Mehta; Ravindra L.,9998,0,9999,1
1713317092377,CLRE 252,A00,507189,Cuomo; Raphael Eduardo,9998,0,9999,1
1713317093406,CLRE 253,A00,507199,Vaida; Florin,9997,0,9999,2
1713317093406,CLRE 253,B00,507202,Vaida; Florin,9999,0,9999,0
1713317094430,CLRE 259,A00,507211,Patel; Hemal,9996,0,9999,3
1713317095459,CLRE 260,A00,507221,Cuomo; Raphael Eduardo,9999,0,9999,0
1713317096487,CLRE 297,001,507242,Cuomo; Raphael Eduardo,9999,0,9999,0
1713317097512,CSE 191,A00,516875,Minnes Kemp; Mor Mia,9999,0,9999,0
1713317098543,CSS 201S,A01,494383,Staff,35,0,35,0
1713317099569,CSS 202S,A01,494387,Staff,35,0,35,0
1713317100594,EAP 100,A00,516065,Staff,9792,0,9999,207
1713317101622,ECE 45,A01,507414,Staff,54,0,60,6
1713317102650,ECE 100,A01,507416,Baghdadchi; Saharnaz,11,0,20,9
1713317102650,ECE 100,A02,507418,Baghdadchi; Saharnaz,20,0,20,0
1713317103675,ECE 111,A01,507420,Staff,40,0,50,10
1713317104700,ECE 197,001,548057,Sievenpiper; Daniel F.,9998,0,9999,1
1713317105725,EDS 115,A00,507243,Choi; Bailey Miyeon,28,0,28,0
1713317106754,EDS 117,A01,494379,Staff,24,0,25,1
1713317107781,EDS 125,A00,507246,Hopkins; Megan Beth,29,0,30,1
1713317108812,EDS 128A,A01,507264,Fargason; Sharon Gayle,26,0,26,0
1713317109839,EDS 128B,A01,507293,Pappas; Elizabeth,30,0,30,0
1713317110863,EDS 139,A00,507294,Fargason; Sharon Gayle,30,0,30,0
1713317110863,EDS 139,B00,507313,Pappas; Elizabeth,30,0,30,0
1713317111892,EDS 201,A00,507315,Staff,26,0,30,4
1713317112918,EDS 203,A01,507317,Halter; Christopher P.,26,0,30,4
1713317113944,EDS 204R,A01,507319,Halter; Christopher P.,4,0,30,26
1713317113944,EDS 204R,B01,507331,Heinzman; Erica M.,28,0,30,2
1713317114976,EDS 206R,A00,507332,Staff,5,0,30,25
1713317114976,EDS 206R,B00,507343,Staff,28,0,30,2
1713317116003,EDS 250,A00,507344,Hemans; Patricia Ann Benitez,36,0,40,4
1713317117027,EDS 281,A00,507345,Daly; Alan J.,18,0,18,0
1713317118055,EDS 284,A00,507350,Daly; Alan J.,16,0,16,0
1713317119085,EDS 286,A00,507359,Fine; Sarah,18,0,18,0
1713317120110,EDS 289C,A01,507361,Daly; Alan J.,18,0,18,0
1713317121137,EDS 290,A00,507366,Hofstetter; Carolyn,15,0,15,0
1713317122241,LIGM 5A,A00,507421,Fischer-Grunski; Eva K,20,0,20,0
1713317123272,LIGM 5B,A00,507423,Fischer-Grunski; Eva K,20,0,20,0
1713317124301,LIGM 5C,A00,507425,Fischer-Grunski; Eva K,20,0,20,0
1713317125325,LIIT 5AS,A00,507427,Carnelos; Chiara,20,0,20,0
1713317126353,LIIT 5BS,A00,507430,Carnelos; Chiara,20,0,20,0
1713317127432,LIIT 5CS,A00,507432,Carnelos; Chiara,20,0,20,0
1713317128467,LISP 5A,A00,507541,Munoz Sanchez; Alicia,19,0,20,1
1713317129495,LISP 5B,A00,507671,Munoz Sanchez; Alicia,17,0,20,3
1713317130523,LISP 5C,A00,507696,Munoz Sanchez; Alicia,17,0,20,3
1713317131553,MAE 197,001,528363,Boechler; Nicholas Sebastia,9998,0,9999,1
1713317132579,MATH 197,001,523477,Kedlaya; Kiran S.,9999,0,9999,0
1713317132579,MATH 197,002,563811,Zhang; Danna,9999,0,9999,0
1713317133605,MCWP 40R,A00,518780,Staff,20,0,20,0
1713317133605,MCWP 40R,B00,518781,Staff,19,0,20,1
1713317133605,MCWP 40R,C00,518783,Staff,19,0,20,1
1713317134631,MCWP 50R,A00,518791,Staff,20,0,20,0
1713317134631,MCWP 50R,B00,518792,Staff,17,0,20,3
1713317134631,MCWP 50R,C00,518793,Staff,19,0,20,1
1713317134631,MCWP 50R,D00,518794,Staff,18,0,20,2
1713317134631,MCWP 50R,E00,518795,Staff,17,0,20,3
1713317134631,MCWP 50R,F00,518796,Staff,19,0,20,1
1713317134631,MCWP 50R,G00,518797,Staff,19,0,20,1
1713317135661,MMW 12R,A01,514034,Herbst; Matthew,15,0,16,1
1713317135661,MMW 12R,A02,514035,Herbst; Matthew,16,0,16,0
1713317136688,MMW 13R,A01,514037,Staff,12,0,16,4
1713317136688,MMW 13R,A02,514039,Staff,16,0,16,0
1713317138741,SIO 295LS,A00,523233,Staff,19,0,30,11
1713317139765,SIO 295S,A00,523232,Staff,19,0,30,11
1713317140791,SOCI 117,A01,494376,Staff,3,0,5,2
1713317141820,WES 237B,A00,494380,Staff,19,0,20,1
1713317143901,AESE 279B,A00,494370,Wade; Jon P,33,0,33,0
1713317144929,ANAR 135S,A00,494369,Braswell; Geoffrey E.,0,0,0,0
1713317145957,CAT 124RS,A01,519847,Geibel; William,17,0,20,3
1713317146985,CAT 125RS,A01,515971,Geibel; William,17,0,20,3
1713317148017,CLRE 250,A00,511389,Morris; Sheldon,9996,0,9999,3
1713317149053,CLRE 251,A00,507176,Mehta; Ravindra L.,9996,0,9999,3
1713317149053,CLRE 251,B00,511410,Mehta; Ravindra L.,9998,0,9999,1
1713317150079,CLRE 252,A00,507189,Cuomo; Raphael Eduardo,9998,0,9999,1
1713317151104,CLRE 253,A00,507199,Vaida; Florin,9997,0,9999,2
1713317151104,CLRE 253,B00,507202,Vaida; Florin,9999,0,9999,0
1713317152129,CLRE 259,A00,507211,Patel; Hemal,9996,0,9999,3
1713317153157,CLRE 260,A00,507221,Cuomo; Raphael Eduardo,9999,0,9999,0
1713317154186,CLRE 297,001,507242,Cuomo; Raphael Eduardo,9999,0,9999,0
1713317155210,CSE 191,A00,516875,Minnes Kemp; Mor Mia,9999,0,9999,0
1713317156237,CSS 201S,A01,494383,Staff,35,0,35,0
1713317157263,CSS 202S,A01,494387,Staff,35,0,35,0
1713317158290,EAP 100,A00,516065,Staff,9792,0,9999,207
1713317159315,ECE 45,A01,507414,Staff,54,0,60,6
1713317160341,ECE 100,A01,507416,Baghdadchi; Saharnaz,11,0,20,9
1713317160341,ECE 100,A02,507418,Baghdadchi; Saharnaz,20,0,20,0
1713317161371,ECE 111,A01,507420,Staff,40,0,50,10
1713317162395,ECE 197,001,548057,Sievenpiper; Daniel F.,9998,0,9999,1
1713317163428,EDS 115,A00,507243,Choi; Bailey Miyeon,28,0,28,0
1713317164457,EDS 117,A01,494379,Staff,24,0,25,1
1713317165487,EDS 125,A00,507246,Hopkins; Megan Beth,29,0,30,1
1713317166513,EDS 128A,A01,507264,Fargason; Sharon Gayle,26,0,26,0
1713317167539,EDS 128B,A01,507293,Pappas; Elizabeth,30,0,30,0
1713317168570,EDS 139,A00,507294,Fargason; Sharon Gayle,30,0,30,0
1713317168570,EDS 139,B00,507313,Pappas; Elizabeth,30,0,30,0
1713317169599,EDS 201,A00,507315,Staff,26,0,30,4
1713317170628,EDS 203,A01,507317,Halter; Christopher P.,26,0,30,4
1713317171657,EDS 204R,A01,507319,Halter; Christopher P.,4,0,30,26
1713317171657,EDS 204R,B01,507331,Heinzman; Erica M.,28,0,30,2
1713317172682,EDS 206R,A00,507332,Staff,5,0,30,25
1713317172682,EDS 206R,B00,507343,Staff,28,0,30,2
1713317173711,EDS 250,A00,507344,Hemans; Patricia Ann Benitez,36,0,40,4
1713317174740,EDS 281,A00,507345,Daly; Alan J.,18,0,18,0
1713317175764,EDS 284,A00,507350,Daly; Alan J.,16,0,16,0
1713317176790,EDS 286,A00,507359,Fine; Sarah,18,0,18,0
1713317177815,EDS 289C,A01,507361,Daly; Alan J.,18,0,18,0
1713317178843,EDS 290,A00,507366,Hofstetter; Carolyn,15,0,15,0
1713317179874,LIGM 5A,A00,507421,Fischer-Grunski; Eva K,20,0,20,0
1713317180903,LIGM 5B,A00,507423,Fischer-Grunski; Eva K,20,0,20,0
1713317181928,LIGM 5C,A00,507425,Fischer-Grunski; Eva K,20,0,20,0
1713317182959,LIIT 5AS,A00,507427,Carnelos; Chiara,20,0,20,0
1713317183991,LIIT 5BS,A00,507430,Carnelos; Chiara,20,0,20,0
1713317185019,LIIT 5CS,A00,507432,Carnelos; Chiara,20,0,20,0
1713317186045,LISP 5A,A00,507541,Munoz Sanchez; Alicia,19,0,20,1
1713317187071,LISP 5B,A00,507671,Munoz Sanchez; Alicia,17,0,20,3
1713317188095,LISP 5C,A00,507696,Munoz Sanchez; Alicia,17,0,20,3
1713317189122,MAE 197,001,528363,Boechler; Nicholas Sebastia,9998,0,9999,1
1713317190148,MATH 197,001,523477,Kedlaya; Kiran S.,9999,0,9999,0
1713317190148,MATH 197,002,563811,Zhang; Danna,9999,0,9999,0
1713317191173,MCWP 40R,A00,518780,Staff,20,0,20,0
1713317191173,MCWP 40R,B00,518781,Staff,19,0,20,1
1713317191173,MCWP 40R,C00,518783,Staff,19,0,20,1
1713317192198,MCWP 50R,A00,518791,Staff,20,0,20,0
1713317192198,MCWP 50R,B00,518792,Staff,17,0,20,3
1713317192198,MCWP 50R,C00,518793,Staff,19,0,20,1
1713317192198,MCWP 50R,D00,518794,Staff,18,0,20,2
1713317192198,MCWP 50R,E00,518795,Staff,17,0,20,3
1713317192198,MCWP 50R,F00,518796,Staff,19,0,20,1
1713317192198,MCWP 50R,G00,518797,Staff,19,0,20,1
1713317193226,MMW 12R,A01,514034,Herbst; Matthew,15,0,16,1
1713317193226,MMW 12R,A02,514035,Herbst; Matthew,16,0,16,0
1713317194254,MMW 13R,A01,514037,Staff,12,0,16,4
1713317194254,MMW 13R,A02,514039,Staff,16,0,16,0
1713317196306,SIO 295LS,A00,523233,Staff,19,0,30,11
1713317197334,SIO 295S,A00,523232,Staff,19,0,30,11
1713317198359,SOCI 117,A01,494376,Staff,3,0,5,2
1713317199383,WES 237B,A00,494380,Staff,19,0,20,1
1713317201463,AESE 279B,A00,494370,Wade; Jon P,33,0,33,0
1713317202488,ANAR 135S,A00,494369,Braswell; Geoffrey E.,0,0,0,0
1713317203516,CAT 124RS,A01,519847,Geibel; William,17,0,20,3
1713317204542,CAT 125RS,A01,515971,Geibel; William,17,0,20,3
1713317205566,CLRE 250,A00,511389,Morris; Sheldon,9996,0,9999,3
1713317206594,CLRE 251,A00,507176,Mehta; Ravindra L.,9996,0,9999,3
1713317206594,CLRE 251,B00,511410,Mehta; Ravindra L.,9998,0,9999,1
1713317207623,CLRE 252,A00,507189,Cuomo; Raphael Eduardo,9998,0,9999,1
1713317208650,CLRE 253,A00,507199,Vaida; Florin,9997,0,9999,2
1713317208650,CLRE 253,B00,507202,Vaida; Florin,9999,0,9999,0
1713317209676,CLRE 259,A00,507211,Patel; Hemal,9996,0,9999,3
1713317210704,CLRE 260,A00,507221,Cuomo; Raphael Eduardo,9999,0,9999,0
1713317211729,CLRE 297,001,507242,Cuomo; Raphael Eduardo,9999,0,9999,0
1713317212755,CSE 191,A00,516875,Minnes Kemp; Mor Mia,9999,0,9999,0
1713317213782,CSS 201S,A01,494383,Staff,35,0,35,0
1713317214811,CSS 202S,A01,494387,Staff,35,0,35,0
1713317215839,EAP 100,A00,516065,Staff,9792,0,9999,207
1713317216865,ECE 45,A01,507414,Staff,54,0,60,6
1713317217891,ECE 100,A01,507416,Baghdadchi; Saharnaz,11,0,20,9
1713317217891,ECE 100,A02,507418,Baghdadchi; Saharnaz,20,0,20,0
1713317218920,ECE 111,A01,507420,Staff,40,0,50,10
1713317219945,ECE 197,001,548057,Sievenpiper; Daniel F.,9998,0,9999,1
1713317220975,EDS 115,A00,507243,Choi; Bailey Miyeon,28,0,28,0
1713317222005,EDS 117,A01,494379,Staff,24,0,25,1
1713317223032,EDS 125,A00,507246,Hopkins; Megan Beth,29,0,30,1
1713317224066,EDS 128A,A01,507264,Fargason; Sharon Gayle,26,0,26,0
1713317225100,EDS 128B,A01,507293,Pappas; Elizabeth,30,0,30,0
1713317226139,EDS 139,A00,507294,Fargason; Sharon Gayle,30,0,30,0
1713317226139,EDS 139,B00,507313,Pappas; Elizabeth,30,0,30,0
1713317227167,EDS 201,A00,507315,Staff,26,0,30,4
1713317228194,EDS 203,A01,507317,Halter; Christopher P.,26,0,30,4
1713317229219,EDS 204R,A01,507319,Halter; Christopher P.,4,0,30,26
1713317229219,EDS 204R,B01,507331,Heinzman; Erica M.,28,0,30,2
1713317230247,EDS 206R,A00,507332,Staff,5,0,30,25
1713317230247,EDS 206R,B00,507343,Staff,28,0,30,2
1713317231334,EDS 250,A00,507344,Hemans; Patricia Ann Benitez,36,0,40,4
1713317232358,EDS 281,A00,507345,Daly; Alan J.,18,0,18,0
1713317233387,EDS 284,A00,507350,Daly; Alan J.,16,0,16,0
1713317234413,EDS 286,A00,507359,Fine; Sarah,18,0,18,0
1713317235438,EDS 289C,A01,507361,Daly; Alan J.,18,0,18,0
1713317236464,EDS 290,A00,507366,Hofstetter; Carolyn,15,0,15,0
1713317237495,LIGM 5A,A00,507421,Fischer-Grunski; Eva K,20,0,20,0
1713317238521,LIGM 5B,A00,507423,Fischer-Grunski; Eva K,20,0,20,0
1713317239553,LIGM 5C,A00,507425,Fischer-Grunski; Eva K,20,0,20,0
1713317240579,LIIT 5AS,A00,507427,Carnelos; Chiara,20,0,20,0
1713317241604,LIIT 5BS,A00,507430,Carnelos; Chiara,20,0,20,0
1713317242630,LIIT 5CS,A00,507432,Carnelos; Chiara,20,0,20,0
1713317243656,LISP 5A,A00,507541,Munoz Sanchez; Alicia,19,0,20,1
1713317244682,LISP 5B,A00,507671,Munoz Sanchez; Alicia,17,0,20,3
1713317245708,LISP 5C,A00,507696,Munoz Sanchez; Alicia,17,0,20,3
1713317246734,MAE 197,001,528363,Boechler; Nicholas Sebastia,9998,0,9999,1
1713317247763,MATH 197,001,523477,Kedlaya; Kiran S.,9999,0,9999,0
1713317247763,MATH 197,002,563811,Zhang; Danna,9999,0,9999,0
1713317248791,MCWP 40R,A00,518780,Staff,20,0,20,0
1713317248791,MCWP 40R,B00,518781,Staff,19,0,20,1
1713317248791,MCWP 40R,C00,518783,Staff,19,0,20,1
1713317249816,MCWP 50R,A00,518791,Staff,20,0,20,0
1713317249816,MCWP 50R,B00,518792,Staff,17,0,20,3
1713317249816,MCWP 50R,C00,518793,Staff,19,0,20,1
1713317249816,MCWP 50R,D00,518794,Staff,18,0,20,2
1713317249816,MCWP 50R,E00,518795,Staff,17,0,20,3
1713317249816,MCWP 50R,F00,518796,Staff,19,0,20,1
1713317249816,MCWP 50R,G00,518797,Staff,19,0,20,1
1713317250842,MMW 12R,A01,514034,Herbst; Matthew,15,0,16,1
1713317250842,MMW 12R,A02,514035,Herbst; Matthew,16,0,16,0
1713317251867,MMW 13R,A01,514037,Staff,12,0,16,4
1713317251867,MMW 13R,A02,514039,Staff,16,0,16,0
1713317253921,SIO 295LS,A00,523233,Staff,19,0,30,11
1713317254949,SIO 295S,A00,523232,Staff,19,0,30,11
1713317255980,SOCI 117,A01,494376,Staff,3,0,5,2
1713317257004,WES 237B,A00,494380,Staff,19,0,20,1
1713317259082,AESE 279B,A00,494370,Wade; Jon P,33,0,33,0
1713317260108,ANAR 135S,A00,494369,Braswell; Geoffrey E.,0,0,0,0
1713317261136,CAT 124RS,A01,519847,Geibel; William,17,0,20,3
1713317262161,CAT 125RS,A01,515971,Geibel; William,17,0,20,3
1713317263188,CLRE 250,A00,511389,Morris; Sheldon,9996,0,9999,3
1713317264215,CLRE 251,A00,507176,Mehta; Ravindra L.,9996,0,9999,3
1713317264215,CLRE 251,B00,511410,Mehta; Ravindra L.,9998,0,9999,1
1713317265243,CLRE 252,A00,507189,Cuomo; Raphael Eduardo,9998,0,9999,1
1713317266272,CLRE 253,A00,507199,Vaida; Florin,9997,0,9999,2
1713317266272,CLRE 253,B00,507202,Vaida; Florin,9999,0,9999,0
1713317267299,CLRE 259,A00,507211,Patel; Hemal,9996,0,9999,3
1713317268326,CLRE 260,A00,507221,Cuomo; Raphael Eduardo,9999,0,9999,0
1713317269355,CLRE 297,001,507242,Cuomo; Raphael Eduardo,9999,0,9999,0
1713317270382,CSE 191,A00,516875,Minnes Kemp; Mor Mia,9999,0,9999,0
1713317271413,CSS 201S,A01,494383,Staff,35,0,35,0
1713317272439,CSS 202S,A01,494387,Staff,35,0,35,0
1713317273464,EAP 100,A00,516065,Staff,9792,0,9999,207
1713317274490,ECE 45,A01,507414,Staff,54,0,60,6
1713317275521,ECE 100,A01,507416,Baghdadchi; Saharnaz,11,0,20,9
1713317275521,ECE 100,A02,507418,Baghdadchi; Saharnaz,20,0,20,0
1713317276548,ECE 111,A01,507420,Staff,40,0,50,10
1713317277574,ECE 197,001,548057,Sievenpiper; Daniel F.,9998,0,9999,1
1713317278600,EDS 115,A00,507243,Choi; Bailey Miyeon,28,0,28,0
1713317279632,EDS 117,A01,494379,Staff,24,0,25,1
1713317280663,EDS 125,A00,507246,Hopkins; Megan Beth,29,0,30,1
1713317281703,EDS 128A,A01,507264,Fargason; Sharon Gayle,26,0,26,0
1713317282729,EDS 128B,A01,507293,Pappas; Elizabeth,30,0,30,0
1713317283753,EDS 139,A00,507294,Fargason; Sharon Gayle,30,0,30,0
1713317283753,EDS 139,B00,507313,Pappas; Elizabeth,30,0,30,0
1713317284779,EDS 201,A00,507315,Staff,26,0,30,4
1713317285804,EDS 203,A01,507317,Halter; Christopher P.,26,0,30,4
1713317286833,EDS 204R,A01,507319,Halter; Christopher P.,4,0,30,26
1713317286833,EDS 204R,B01,507331,Heinzman; Erica M.,28,0,30,2
1713317287859,EDS 206R,A00,507332,Staff,5,0,30,25
1713317287859,EDS 206R,B00,507343,Staff,28,0,30,2
1713317288889,EDS 250,A00,507344,Hemans; Patricia Ann Benitez,36,0,40,4
1713317289915,EDS 281,A00,507345,Daly; Alan J.,18,0,18,0
1713317290943,EDS 284,A00,507350,Daly; Alan J.,16,0,16,0
1713317291968,EDS 286,A00,507359,Fine; Sarah,18,0,18,0
1713317292995,EDS 289C,A01,507361,Daly; Alan J.,18,0,18,0
1713317294020,EDS 290,A00,507366,Hofstetter; Carolyn,15,0,15,0
1713317295049,LIGM 5A,A00,507421,Fischer-Grunski; Eva K,20,0,20,0
1713317296078,LIGM 5B,A00,507423,Fischer-Grunski; Eva K,20,0,20,0
1713317297103,LIGM 5C,A00,507425,Fischer-Grunski; Eva K,20,0,20,0
1713317298129,LIIT 5AS,A00,507427,Carnelos; Chiara,20,0,20,0
1713317299160,LIIT 5BS,A00,507430,Carnelos; Chiara,20,0,20,0
1713317300184,LIIT 5CS,A00,507432,Carnelos; Chiara,20,0,20,0
1713317301210,LISP 5A,A00,507541,Munoz Sanchez; Alicia,19,0,20,1
1713317302239,LISP 5B,A00,507671,Munoz Sanchez; Alicia,17,0,20,3
1713317303265,LISP 5C,A00,507696,Munoz Sanchez; Alicia,17,0,20,3
1713317304295,MAE 197,001,528363,Boechler; Nicholas Sebastia,9998,0,9999,1
1713317305323,MATH 197,001,523477,Kedlaya; Kiran S.,9999,0,9999,0
1713317305323,MATH 197,002,563811,Zhang; Danna,9999,0,9999,0
1713317306347,MCWP 40R,A00,518780,Staff,20,0,20,0
1713317306347,MCWP 40R,B00,518781,Staff,19,0,20,1
1713317306347,MCWP 40R,C00,518783,Staff,19,0,20,1
1713317307375,MCWP 50R,A00,518791,Staff,20,0,20,0
1713317307375,MCWP 50R,B00,518792,Staff,17,0,20,3
1713317307375,MCWP 50R,C00,518793,Staff,19,0,20,1
1713317307375,MCWP 50R,D00,518794,Staff,18,0,20,2
1713317307375,MCWP 50R,E00,518795,Staff,17,0,20,3
1713317307375,MCWP 50R,F00,518796,Staff,19,0,20,1
1713317307375,MCWP 50R,G00,518797,Staff,19,0,20,1
1713317308404,MMW 12R,A01,514034,Herbst; Matthew,15,0,16,1
1713317308404,MMW 12R,A02,514035,Herbst; Matthew,16,0,16,0
1713317309428,MMW 13R,A01,514037,Staff,12,0,16,4
1713317309428,MMW 13R,A02,514039,Staff,16,0,16,0
1713317311479,SIO 295LS,A00,523233,Staff,19,0,30,11
1713317312504,SIO 295S,A00,523232,Staff,19,0,30,11
1713317313529,SOCI 117,A01,494376,Staff,3,0,5,2
1713317314561,WES 237B,A00,494380,Staff,19,0,20,1
1713317316643,AESE 279B,A00,494370,Wade; Jon P,33,0,33,0
1713317317669,ANAR 135S,A00,494369,Braswell; Geoffrey E.,0,0,0,0
1713317318700,CAT 124RS,A01,519847,Geibel; William,17,0,20,3
1713317319726,CAT 125RS,A01,515971,Geibel; William,17,0,20,3
1713317320752,CLRE 250,A00,511389,Morris; Sheldon,9996,0,9999,3
1713317321778,CLRE 251,A00,507176,Mehta; Ravindra L.,9996,0,9999,3
1713317321778,CLRE 251,B00,511410,Mehta; Ravindra L.,9998,0,9999,1
1713317322803,CLRE 252,A00,507189,Cuomo; Raphael Eduardo,9998,0,9999,1
1713317323828,CLRE 253,A00,507199,Vaida; Florin,9997,0,9999,2
1713317323828,CLRE 253,B00,507202,Vaida; Florin,9999,0,9999,0
1713317324852,CLRE 259,A00,507211,Patel; Hemal,9996,0,9999,3
1713317325879,CLRE 260,A00,507221,Cuomo; Raphael Eduardo,9999,0,9999,0
1713317326904,CLRE 297,001,507242,Cuomo; Raphael Eduardo,9999,0,9999,0
1713317327927,CSE 191,A00,516875,Minnes Kemp; Mor Mia,9999,0,9999,0
1713317328953,CSS 201S,A01,494383,Staff,35,0,35,0
1713317329979,CSS 202S,A01,494387,Staff,35,0,35,0
1713317331006,EAP 100,A00,516065,Staff,9792,0,9999,207
1713317332033,ECE 45,A01,507414,Staff,54,0,60,6
1713317333062,ECE 100,A01,507416,Baghdadchi; Saharnaz,11,0,20,9
1713317333062,ECE 100,A02,507418,Baghdadchi; Saharnaz,20,0,20,0
1713317334090,ECE 111,A01,507420,Staff,40,0,50,10
1713317335172,ECE 197,001,548057,Sievenpiper; Daniel F.,9998,0,9999,1
1713317336199,EDS 115,A00,507243,Choi; Bailey Miyeon,28,0,28,0
1713317337225,EDS 117,A01,494379,Staff,24,0,25,1
1713317338252,EDS 125,A00,507246,Hopkins; Megan Beth,29,0,30,1
1713317339278,EDS 128A,A01,507264,Fargason; Sharon Gayle,26,0,26,0
1713317340303,EDS 128B,A01,507293,Pappas; Elizabeth,30,0,30,0
1713317341331,EDS 139,A00,507294,Fargason; Sharon Gayle,30,0,30,0
1713317341331,EDS 139,B00,507313,Pappas; Elizabeth,30,0,30,0
1713317342357,EDS 201,A00,507315,Staff,26,0,30,4
1713317343383,EDS 203,A01,507317,Halter; Christopher P.,26,0,30,4
1713317344411,EDS 204R,A01,507319,Halter; Christopher P.,4,0,30,26
1713317344411,EDS 204R,B01,507331,Heinzman; Erica M.,28,0,30,2
1713317345440,EDS 206R,A00,507332,Staff,5,0,30,25
1713317345440,EDS 206R,B00,507343,Staff,28,0,30,2
1713317346469,EDS 250,A00,507344,Hemans; Patricia Ann Benitez,36,0,40,4
1713317347495,EDS 281,A00,507345,Daly; Alan J.,18,0,18,0
1713317348520,EDS 284,A00,507350,Daly; Alan J.,16,0,16,0
1713317349543,EDS 286,A00,507359,Fine; Sarah,18,0,18,0
1713317350568,EDS 289C,A01,507361,Daly; Alan J.,18,0,18,0
1713317351592,EDS 290,A00,507366,Hofstetter; Carolyn,15,0,15,0
1713317352620,LIGM 5A,A00,507421,Fischer-Grunski; Eva K,20,0,20,0
1713317353647,LIGM 5B,A00,507423,Fischer-Grunski; Eva K,20,0,20,0
1713317354673,LIGM 5C,A00,507425,Fischer-Grunski; Eva K,20,0,20,0
1713317355698,LIIT 5AS,A00,507427,Carnelos; Chiara,20,0,20,0
1713317356724,LIIT 5BS,A00,507430,Carnelos; Chiara,20,0,20,0
1713317357754,LIIT 5CS,A00,507432,Carnelos; Chiara,20,0,20,0
1713317358787,LISP 5A,A00,507541,Munoz Sanchez; Alicia,19,0,20,1
1713317359816,LISP 5B,A00,507671,Munoz Sanchez; Alicia,17,0,20,3
1713317360847,LISP 5C,A00,507696,Munoz Sanchez; Alicia,17,0,20,3
1713317361872,MAE 197,001,528363,Boechler; Nicholas Sebastia,9998,0,9999,1
1713317362903,MATH 197,001,523477,Kedlaya; Kiran S.,9999,0,9999,0
1713317362903,MATH 197,002,563811,Zhang; Danna,9999,0,9999,0
1713317363933,MCWP 40R,A00,518780,Staff,20,0,20,0
1713317363933,MCWP 40R,B00,518781,Staff,19,0,20,1
1713317363933,MCWP 40R,C00,518783,Staff,19,0,20,1
1713317364959,MCWP 50R,A00,518791,Staff,20,0,20,0
1713317364959,MCWP 50R,B00,518792,Staff,17,0,20,3
1713317364959,MCWP 50R,C00,518793,Staff,19,0,20,1
1713317364959,MCWP 50R,D00,518794,Staff,18,0,20,2
1713317364959,MCWP 50R,E00,518795,Staff,17,0,20,3
1713317364959,MCWP 50R,F00,518796,Staff,19,0,20,1
1713317364959,MCWP 50R,G00,518797,Staff,19,0,20,1
1713317365985,MMW 12R,A01,514034,Herbst; Matthew,15,0,16,1
1713317365985,MMW 12R,A02,514035,Herbst; Matthew,16,0,16,0
1713317367014,MMW 13R,A01,514037,Staff,12,0,16,4
1713317367014,MMW 13R,A02,514039,Staff,16,0,16,0
1713317369068,SIO 295LS,A00,523233,Staff,19,0,30,11
1713317370096,SIO 295S,A00,523232,Staff,19,0,30,11
1713317371120,SOCI 117,A01,494376,Staff,3,0,5,2
1713317372150,WES 237B,A00,494380,Staff,19,0,20,1
1713317374218,AESE 279B,A00,494370,Wade; Jon P,33,0,33,0
1713317375245,ANAR 135S,A00,494369,Braswell; Geoffrey E.,0,0,0,0
1713317376271,CAT 124RS,A01,519847,Geibel; William,17,0,20,3
1713317377296,CAT 125RS,A01,515971,Geibel; William,17,0,20,3
1713317378328,CLRE 250,A00,511389,Morris; Sheldon,9996,0,9999,3
1713317379359,CLRE 251,A00,507176,Mehta; Ravindra L.,9996,0,9999,3
1713317379359,CLRE 251,B00,511410,Mehta; Ravindra L.,9998,0,9999,1
1713317380383,CLRE 252,A00,507189,Cuomo; Raphael Eduardo,9998,0,9999,1
1713317381409,CLRE 253,A00,507199,Vaida; Florin,9997,0,9999,2
1713317381409,CLRE 253,B00,507202,Vaida; Florin,9999,0,9999,0
1713317382436,CLRE 259,A00,507211,Patel; Hemal,9996,0,9999,3
1713317383461,CLRE 260,A00,507221,Cuomo; Raphael Eduardo,9999,0,9999,0
1713317384491,CLRE 297,001,507242,Cuomo; Raphael Eduardo,9999,0,9999,0
1713317385516,CSE 191,A00,516875,Minnes Kemp; Mor Mia,9999,0,9999,0
1713317386545,CSS 201S,A01,494383,Staff,35,0,35,0
1713317387572,CSS 202S,A01,494387,Staff,35,0,35,0
1713317388599,EAP 100,A00,516065,Staff,9792,0,9999,207
1713317389623,ECE 45,A01,507414,Staff,54,0,60,6
1713317390650,ECE 100,A01,507416,Baghdadchi; Saharnaz,11,0,20,9
1713317390650,ECE 100,A02,507418,Baghdadchi; Saharnaz,20,0,20,0
1713317391675,ECE 111,A01,507420,Staff,40,0,50,10
1713317392700,ECE 197,001,548057,Sievenpiper; Daniel F.,9998,0,9999,1
1713317393725,EDS 115,A00,507243,Choi; Bailey Miyeon,28,0,28,0
1713317394752,EDS 117,A01,494379,Staff,24,0,25,1
1713317395779,EDS 125,A00,507246,Hopkins; Megan Beth,29,0,30,1
1713317396805,EDS 128A,A01,507264,Fargason; Sharon Gayle,26,0,26,0
1713317397831,EDS 128B,A01,507293,Pappas; Elizabeth,30,0,30,0
1713317398857,EDS 139,A00,507294,Fargason; Sharon Gayle,30,0,30,0
1713317398857,EDS 139,B00,507313,Pappas; Elizabeth,30,0,30,0
1713317399885,EDS 201,A00,507315,Staff,26,0,30,4
1713317400912,EDS 203,A01,507317,Halter; Christopher P.,26,0,30,4
1713317401937,EDS 204R,A01,507319,Halter; Christopher P.,4,0,30,26
1713317401937,EDS 204R,B01,507331,Heinzman; Erica M.,28,0,30,2
1713317402962,EDS 206R,A00,507332,Staff,5,0,30,25
1713317402962,EDS 206R,B00,507343,Staff,28,0,30,2
1713317403991,EDS 250,A00,507344,Hemans; Patricia Ann Benitez,36,0,40,4
1713317405018,EDS 281,A00,507345,Daly; Alan J.,18,0,18,0
1713317406044,EDS 284,A00,507350,Daly; Alan J.,16,0,16,0
1713317407070,EDS 286,A00,507359,Fine; Sarah,18,0,18,0
1713317408096,EDS 289C,A01,507361,Daly; Alan J.,18,0,18,0
1713317409120,EDS 290,A00,507366,Hofstetter; Carolyn,15,0,15,0
1713317410147,LIGM 5A,A00,507421,Fischer-Grunski; Eva K,20,0,20,0
1713317411171,LIGM 5B,A00,507423,Fischer-Grunski; Eva K,20,0,20,0
1713317412197,LIGM 5C,A00,507425,Fischer-Grunski; Eva K,20,0,20,0
1713317413227,LIIT 5AS,A00,507427,Carnelos; Chiara,20,0,20,0
1713317414258,LIIT 5BS,A00,507430,Carnelos; Chiara,20,0,20,0
1713317415283,LIIT 5CS,A00,507432,Carnelos; Chiara,20,0,20,0
1713317416308,LISP 5A,A00,507541,Munoz Sanchez; Alicia,19,0,20,1
1713317417336,LISP 5B,A00,507671,Munoz Sanchez; Alicia,17,0,20,3
1713317418366,LISP 5C,A00,507696,Munoz Sanchez; Alicia,17,0,20,3
1713317419395,MAE 197,001,528363,Boechler; Nicholas Sebastia,9998,0,9999,1
1713317420424,MATH 197,001,523477,Kedlaya; Kiran S.,9999,0,9999,0
1713317420424,MATH 197,002,563811,Zhang; Danna,9999,0,9999,0
1713317421453,MCWP 40R,A00,518780,Staff,20,0,20,0
1713317421453,MCWP 40R,B00,518781,Staff,19,0,20,1
1713317421453,MCWP 40R,C00,518783,Staff,19,0,20,1
1713317422482,MCWP 50R,A00,518791,Staff,20,0,20,0
1713317422482,MCWP 50R,B00,518792,Staff,17,0,20,3
1713317422482,MCWP 50R,C00,518793,Staff,19,0,20,1
1713317422482,MCWP 50R,D00,518794,Staff,18,0,20,2
1713317422482,MCWP 50R,E00,518795,Staff,17,0,20,3
1713317422482,MCWP 50R,F00,518796,Staff,19,0,20,1
1713317422482,MCWP 50R,G00,518797,Staff,19,0,20,1
1713317423507,MMW 12R,A01,514034,Herbst; Matthew,15,0,16,1
1713317423507,MMW 12R,A02,514035,Herbst; Matthew,16,0,16,0
1713317424529,MMW 13R,A01,514037,Staff,12,0,16,4
1713317424529,MMW 13R,A02,514039,Staff,16,0,16,0
1713317426582,SIO 295LS,A00,523233,Staff,19,0,30,11
1713317427612,SIO 295S,A00,523232,Staff,19,0,30,11
1713317428639,SOCI 117,A01,494376,Staff,3,0,5,2
1713317429669,WES 237B,A00,494380,Staff,19,0,20,1
1713317431747,AESE 279B,A00,494370,Wade; Jon P,33,0,33,0
1713317432772,ANAR 135S,A00,494369,Braswell; Geoffrey E.,0,0,0,0
1713317433798,CAT 124RS,A01,519847,Geibel; William,17,0,20,3
1713317434820,CAT 125RS,A01,515971,Geibel; William,17,0,20,3
1713317435848,CLRE 250,A00,511389,Morris; Sheldon,9996,0,9999,3
1713317436874,CLRE 251,A00,507176,Mehta; Ravindra L.,9996,0,9999,3
1713317436874,CLRE 251,B00,511410,Mehta; Ravindra L.,9998,0,9999,1
1713317437905,CLRE 252,A00,507189,Cuomo; Raphael Eduardo,9998,0,9999,1
1713317438987,CLRE 253,A00,507199,Vaida; Florin,9997,0,9999,2
1713317438987,CLRE 253,B00,507202,Vaida; Florin,9999,0,9999,0
1713317440017,CLRE 259,A00,507211,Patel; Hemal,9996,0,9999,3
1713317441046,CLRE 260,A00,507221,Cuomo; Raphael Eduardo,9999,0,9999,0
1713317442074,CLRE 297,001,507242,Cuomo; Raphael Eduardo,9999,0,9999,0
1713317443098,CSE 191,A00,516875,Minnes Kemp; Mor Mia,9999,0,9999,0
1713317444126,CSS 201S,A01,494383,Staff,35,0,35,0
1713317445152,CSS 202S,A01,494387,Staff,35,0,35,0
1713317446181,EAP 100,A00,516065,Staff,9792,0,9999,207
1713317447210,ECE 45,A01,507414,Staff,54,0,60,6
1713317448236,ECE 100,A01,507416,Baghdadchi; Saharnaz,11,0,20,9
1713317448236,ECE 100,A02,507418,Baghdadchi; Saharnaz,20,0,20,0
1713317449265,ECE 111,A01,507420,Staff,40,0,50,10
1713317450291,ECE 197,001,548057,Sievenpiper; Daniel F.,9998,0,9999,1
1713317451319,EDS 115,A00,507243,Choi; Bailey Miyeon,28,0,28,0
1713317452351,EDS 117,A01,494379,Staff,24,0,25,1
1713317453380,EDS 125,A00,507246,Hopkins; Megan Beth,29,0,30,1
1713317454405,EDS 128A,A01,507264,Fargason; Sharon Gayle,26,0,26,0
1713317455432,EDS 128B,A01,507293,Pappas; Elizabeth,30,0,30,0
1713317456457,EDS 139,A00,507294,Fargason; Sharon Gayle,30,0,30,0
1713317456457,EDS 139,B00,507313,Pappas; Elizabeth,30,0,30,0
1713317457487,EDS 201,A00,507315,Staff,26,0,30,4
1713317458515,EDS 203,A01,507317,Halter; Christopher P.,26,0,30,4
1713317459544,EDS 204R,A01,507319,Halter; Christopher P.,4,0,30,26
1713317459544,EDS 204R,B01,507331,Heinzman; Erica M.,28,0,30,2
1713317460591,EDS 206R,A00,507332,Staff,5,0,30,25
1713317460591,EDS 206R,B00,507343,Staff,28,0,30,2
1713317461620,EDS 250,A00,507344,Hemans; Patricia Ann Benitez,36,0,40,4
1713317462646,EDS 281,A00,507345,Daly; Alan J.,18,0,18,0
1713317463670,EDS 284,A00,507350,Daly; Alan J.,16,0,16,0
1713317464697,EDS 286,A00,507359,Fine; Sarah,18,0,18,0
1713317465726,EDS 289C,A01,507361,Daly; Alan J.,18,0,18,0
1713317466752,EDS 290,A00,507366,Hofstetter; Carolyn,15,0,15,0
1713317467778,LIGM 5A,A00,507421,Fischer-Grunski; Eva K,20,0,20,0
1713317468806,LIGM 5B,A00,507423,Fischer-Grunski; Eva K,20,0,20,0
1713317469836,LIGM 5C,A00,507425,Fischer-Grunski; Eva K,20,0,20,0
1713317470862,LIIT 5AS,A00,507427,Carnelos; Chiara,20,0,20,0
1713317471891,LIIT 5BS,A00,507430,Carnelos; Chiara,20,0,20,0
1713317472919,LIIT 5CS,A00,507432,Carnelos; Chiara,20,0,20,0
1713317473949,LISP 5A,A00,507541,Munoz Sanchez; Alicia,19,0,20,1
1713317474974,LISP 5B,A00,507671,Munoz Sanchez; Alicia,17,0,20,3
1713317475999,LISP 5C,A00,507696,Munoz Sanchez; Alicia,17,0,20,3
1713317477027,MAE 197,001,528363,Boechler; Nicholas Sebastia,9998,0,9999,1
1713317478053,MATH 197,001,523477,Kedlaya; Kiran S.,9999,0,9999,0
1713317478053,MATH 197,002,563811,Zhang; Danna,9999,0,9999,0
1713317479082,MCWP 40R,A00,518780,Staff,20,0,20,0
1713317479082,MCWP 40R,B00,518781,Staff,19,0,20,1
1713317479082,MCWP 40R,C00,518783,Staff,19,0,20,1
1713317480107,MCWP 50R,A00,518791,Staff,20,0,20,0
1713317480107,MCWP 50R,B00,518792,Staff,17,0,20,3
1713317480107,MCWP 50R,C00,518793,Staff,19,0,20,1
1713317480107,MCWP 50R,D00,518794,Staff,18,0,20,2
1713317480107,MCWP 50R,E00,518795,Staff,17,0,20,3
1713317480107,MCWP 50R,F00,518796,Staff,19,0,20,1
1713317480107,MCWP 50R,G00,518797,Staff,19,0,20,1
1713317481132,MMW 12R,A01,514034,Herbst; Matthew,15,0,16,1
1713317481132,MMW 12R,A02,514035,Herbst; Matthew,16,0,16,0
1713317482157,MMW 13R,A01,514037,Staff,12,0,16,4
1713317482157,MMW 13R,A02,514039,Staff,16,0,16,0
1713317484211,SIO 295LS,A00,523233,Staff,19,0,30,11
1713317485240,SIO 295S,A00,523232,Staff,19,0,30,11
1713317486267,SOCI 117,A01,494376,Staff,3,0,5,2
1713317487294,WES 237B,A00,494380,Staff,19,0,20,1
1713317489369,AESE 279B,A00,494370,Wade; Jon P,33,0,33,0
1713317490394,ANAR 135S,A00,494369,Braswell; Geoffrey E.,0,0,0,0
1713317491420,CAT 124RS,A01,519847,Geibel; William,17,0,20,3
1713317492446,CAT 125RS,A01,515971,Geibel; William,17,0,20,3
1713317493470,CLRE 250,A00,511389,Morris; Sheldon,9996,0,9999,3
1713317494497,CLRE 251,A00,507176,Mehta; Ravindra L.,9996,0,9999,3
1713317494497,CLRE 251,B00,511410,Mehta; Ravindra L.,9998,0,9999,1
1713317495521,CLRE 252,A00,507189,Cuomo; Raphael Eduardo,9998,0,9999,1
1713317496547,CLRE 253,A00,507199,Vaida; Florin,9997,0,9999,2
1713317496547,CLRE 253,B00,507202,Vaida; Florin,9999,0,9999,0
1713317497577,CLRE 259,A00,507211,Patel; Hemal,9996,0,9999,3
1713317498601,CLRE 260,A00,507221,Cuomo; Raphael Eduardo,9999,0,9999,0
1713317499624,CLRE 297,001,507242,Cuomo; Raphael Eduardo,9999,0,9999,0
1713317500650,CSE 191,A00,516875,Minnes Kemp; Mor Mia,9999,0,9999,0
1713317501676,CSS 201S,A01,494383,Staff,35,0,35,0
1713317502705,CSS 202S,A01,494387,Staff,35,0,35,0
1713317503729,EAP 100,A00,516065,Staff,9792,0,9999,207
1713317504759,ECE 45,A01,507414,Staff,54,0,60,6
1713317505783,ECE 100,A01,507416,Baghdadchi; Saharnaz,11,0,20,9
1713317505783,ECE 100,A02,507418,Baghdadchi; Saharnaz,20,0,20,0
1713317506807,ECE 111,A01,507420,Staff,40,0,50,10
1713317507833,ECE 197,001,548057,Sievenpiper; Daniel F.,9998,0,9999,1
1713317508860,EDS 115,A00,507243,Choi; Bailey Miyeon,28,0,28,0
1713317509886,EDS 117,A01,494379,Staff,24,0,25,1
1713317510911,EDS 125,A00,507246,Hopkins; Megan Beth,29,0,30,1
1713317511946,EDS 128A,A01,507264,Fargason; Sharon Gayle,26,0,26,0
1713317512971,EDS 128B,A01,507293,Pappas; Elizabeth,30,0,30,0
1713317514000,EDS 139,A00,507294,Fargason; Sharon Gayle,30,0,30,0
1713317514000,EDS 139,B00,507313,Pappas; Elizabeth,30,0,30,0
1713317515027,EDS 201,A00,507315,Staff,26,0,30,4
1713317516052,EDS 203,A01,507317,Halter; Christopher P.,26,0,30,4
1713317517079,EDS 204R,A01,507319,Halter; Christopher P.,4,0,30,26
1713317517079,EDS 204R,B01,507331,Heinzman; Erica M.,28,0,30,2
1713317518104,EDS 206R,A00,507332,Staff,5,0,30,25
1713317518104,EDS 206R,B00,507343,Staff,28,0,30,2
1713317519128,EDS 250,A00,507344,Hemans; Patricia Ann Benitez,36,0,40,4
1713317520155,EDS 281,A00,507345,Daly; Alan J.,18,0,18,0
1713317521180,EDS 284,A00,507350,Daly; Alan J.,16,0,16,0
1713317522206,EDS 286,A00,507359,Fine; Sarah,18,0,18,0
1713317523235,EDS 289C,A01,507361,Daly; Alan J.,18,0,18,0
1713317524263,EDS 290,A00,507366,Hofstetter; Carolyn,15,0,15,0
1713317525291,LIGM 5A,A00,507421,Fischer-Grunski; Eva K,20,0,20,0
1713317526316,LIGM 5B,A00,507423,Fischer-Grunski; Eva K,20,0,20,0
1713317527342,LIGM 5C,A00,507425,Fischer-Grunski; Eva K,20,0,20,0
1713317528372,LIIT 5AS,A00,507427,Carnelos; Chiara,20,0,20,0
1713317529401,LIIT 5BS,A00,507430,Carnelos; Chiara,20,0,20,0
1713317530432,LIIT 5CS,A00,507432,Carnelos; Chiara,20,0,20,0
1713317531459,LISP 5A,A00,507541,Munoz Sanchez; Alicia,19,0,20,1
1713317532485,LISP 5B,A00,507671,Munoz Sanchez; Alicia,17,0,20,3
1713317533515,LISP 5C,A00,507696,Munoz Sanchez; Alicia,17,0,20,3
1713317534545,MAE 197,001,528363,Boechler; Nicholas Sebastia,9998,0,9999,1
1713317535570,MATH 197,001,523477,Kedlaya; Kiran S.,9999,0,9999,0
1713317535570,MATH 197,002,563811,Zhang; Danna,9999,0,9999,0
1713317536593,MCWP 40R,A00,518780,Staff,20,0,20,0
1713317536593,MCWP 40R,B00,518781,Staff,19,0,20,1
1713317536593,MCWP 40R,C00,518783,Staff,19,0,20,1
1713317537625,MCWP 50R,A00,518791,Staff,20,0,20,0
1713317537625,MCWP 50R,B00,518792,Staff,17,0,20,3
1713317537625,MCWP 50R,C00,518793,Staff,19,0,20,1
1713317537625,MCWP 50R,D00,518794,Staff,18,0,20,2
1713317537625,MCWP 50R,E00,518795,Staff,17,0,20,3
1713317537625,MCWP 50R,F00,518796,Staff,19,0,20,1
1713317537625,MCWP 50R,G00,518797,Staff,19,0,20,1
1713317538651,MMW 12R,A01,514034,Herbst; Matthew,15,0,16,1
1713317538651,MMW 12R,A02,514035,Herbst; Matthew,16,0,16,0
1713317539679,MMW 13R,A01,514037,Staff,12,0,16,4
1713317539679,MMW 13R,A02,514039,Staff,16,0,16,0
1713317541730,SIO 295LS,A00,523233,Staff,19,0,30,11
1713317542812,SIO 295S,A00,523232,Staff,19,0,30,11
1713317543838,SOCI 117,A01,494376,Staff,3,0,5,2
1713317544863,WES 237B,A00,494380,Staff,19,0,20,1
1713317546924,AESE 279B,A00,494370,Wade; Jon P,33,0,33,0
1713317547950,ANAR 135S,A00,494369,Braswell; Geoffrey E.,0,0,0,0
1713317548977,CAT 124RS,A01,519847,Geibel; William,17,0,20,3
1713317550003,CAT 125RS,A01,515971,Geibel; William,17,0,20,3
1713317551032,CLRE 250,A00,511389,Morris; Sheldon,9996,0,9999,3
1713317552063,CLRE 251,A00,507176,Mehta; Ravindra L.,9996,0,9999,3
1713317552063,CLRE 251,B00,511410,Mehta; Ravindra L.,9998,0,9999,1
1713317553089,CLRE 252,A00,507189,Cuomo; Raphael Eduardo,9998,0,9999,1
1713317554121,CLRE 253,A00,507199,Vaida; Florin,9997,0,9999,2
1713317554121,CLRE 253,B00,507202,Vaida; Florin,9999,0,9999,0
1713317555150,CLRE 259,A00,507211,Patel; Hemal,9996,0,9999,3
1713317556176,CLRE 260,A00,507221,Cuomo; Raphael Eduardo,9999,0,9999,0
1713317557203,CLRE 297,001,507242,Cuomo; Raphael Eduardo,9999,0,9999,0
1713317558233,CSE 191,A00,516875,Minnes Kemp; Mor Mia,9999,0,9999,0
1713317559257,CSS 201S,A01,494383,Staff,35,0,35,0
1713317560283,CSS 202S,A01,494387,Staff,35,0,35,0
1713317561309,EAP 100,A00,516065,Staff,9792,0,9999,207
1713317562334,ECE 45,A01,507414,Staff,54,0,60,6
1713317563363,ECE 100,A01,507416,Baghdadchi; Saharnaz,11,0,20,9
1713317563363,ECE 100,A02,507418,Baghdadchi; Saharnaz,20,0,20,0
1713317564388,ECE 111,A01,507420,Staff,40,0,50,10
1713317565416,ECE 197,001,548057,Sievenpiper; Daniel F.,9998,0,9999,1
1713317566442,EDS 115,A00,507243,Choi; Bailey Miyeon,28,0,28,0
1713317567467,EDS 117,A01,494379,Staff,24,0,25,1
1713317568494,EDS 125,A00,507246,Hopkins; Megan Beth,29,0,30,1
1713317569519,EDS 128A,A01,507264,Fargason; Sharon Gayle,26,0,26,0
1713317570550,EDS 128B,A01,507293,Pappas; Elizabeth,30,0,30,0
1713317571577,EDS 139,A00,507294,Fargason; Sharon Gayle,30,0,30,0
1713317571577,EDS 139,B00,507313,Pappas; Elizabeth,30,0,30,0
1713317572602,EDS 201,A00,507315,Staff,26,0,30,4
1713317573628,EDS 203,A01,507317,Halter; Christopher P.,26,0,30,4
1713317574658,EDS 204R,A01,507319,Halter; Christopher P.,4,0,30,26
1713317574658,EDS 204R,B01,507331,Heinzman; Erica M.,28,0,30,2
1713317575688,EDS 206R,A00,507332,Staff,5,0,30,25
1713317575688,EDS 206R,B00,507343,Staff,28,0,30,2
1713317576713,EDS 250,A00,507344,Hemans; Patricia Ann Benitez,36,0,40,4
1713317577739,EDS 281,A00,507345,Daly; Alan J.,18,0,18,0
1713317578765,EDS 284,A00,507350,Daly; Alan J.,16,0,16,0
1713317579795,EDS 286,A00,507359,Fine; Sarah,18,0,18,0
1713317580820,EDS 289C,A01,507361,Daly; Alan J.,18,0,18,0
1713317581851,EDS 290,A00,507366,Hofstetter; Carolyn,15,0,15,0
1713317582876,LIGM 5A,A00,507421,Fischer-Grunski; Eva K,20,0,20,0
1713317583905,LIGM 5B,A00,507423,Fischer-Grunski; Eva K,20,0,20,0
1713317584935,LIGM 5C,A00,507425,Fischer-Grunski; Eva K,20,0,20,0
1713317585963,LIIT 5AS,A00,507427,Carnelos; Chiara,20,0,20,0
1713317586992,LIIT 5BS,A00,507430,Carnelos; Chiara,20,0,20,0
1713317588018,LIIT 5CS,A00,507432,Carnelos; Chiara,20,0,20,0
1713317589050,LISP 5A,A00,507541,Munoz Sanchez; Alicia,19,0,20,1
1713317590076,LISP 5B,A00,507671,Munoz Sanchez; Alicia,17,0,20,3
1713317591105,LISP 5C,A00,507696,Munoz Sanchez; Alicia,17,0,20,3
1713317592132,MAE 197,001,528363,Boechler; Nicholas Sebastia,9998,0,9999,1
1713317593157,MATH 197,001,523477,Kedlaya; Kiran S.,9999,0,9999,0
1713317593157,MATH 197,002,563811,Zhang; Danna,9999,0,9999,0
1713317594183,MCWP 40R,A00,518780,Staff,20,0,20,0
1713317594183,MCWP 40R,B00,518781,Staff,19,0,20,1
1713317594183,MCWP 40R,C00,518783,Staff,19,0,20,1
1713317595206,MCWP 50R,A00,518791,Staff,20,0,20,0
1713317595206,MCWP 50R,B00,518792,Staff,17,0,20,3
1713317595206,MCWP 50R,C00,518793,Staff,19,0,20,1
1713317595206,MCWP 50R,D00,518794,Staff,18,0,20,2
1713317595206,MCWP 50R,E00,518795,Staff,17,0,20,3
1713317595206,MCWP 50R,F00,518796,Staff,19,0,20,1
1713317595206,MCWP 50R,G00,518797,Staff,19,0,20,1
1713317596233,MMW 12R,A01,514034,Herbst; Matthew,15,0,16,1
1713317596233,MMW 12R,A02,514035,Herbst; Matthew,16,0,16,0
1713317597258,MMW 13R,A01,514037,Staff,12,0,16,4
1713317597258,MMW 13R,A02,514039,Staff,16,0,16,0
1713317599311,SIO 295LS,A00,523233,Staff,19,0,30,11
1713317600341,SIO 295S,A00,523232,Staff,19,0,30,11
1713317601367,SOCI 117,A01,494376,Staff,3,0,5,2
1713317602394,WES 237B,A00,494380,Staff,19,0,20,1
1713317604454,AESE 279B,A00,494370,Wade; Jon P,33,0,33,0
1713317605480,ANAR 135S,A00,494369,Braswell; Geoffrey E.,0,0,0,0
1713317606507,CAT 124RS,A01,519847,Geibel; William,17,0,20,3
1713317607534,CAT 125RS,A01,515971,Geibel; William,17,0,20,3
1713317608560,CLRE 250,A00,511389,Morris; Sheldon,9996,0,9999,3
1713317609587,CLRE 251,A00,507176,Mehta; Ravindra L.,9996,0,9999,3
1713317609587,CLRE 251,B00,511410,Mehta; Ravindra L.,9998,0,9999,1
1713317610612,CLRE 252,A00,507189,Cuomo; Raphael Eduardo,9998,0,9999,1
1713317611638,CLRE 253,A00,507199,Vaida; Florin,9997,0,9999,2
1713317611638,CLRE 253,B00,507202,Vaida; Florin,9999,0,9999,0
1713317612665,CLRE 259,A00,507211,Patel; Hemal,9996,0,9999,3
1713317613693,CLRE 260,A00,507221,Cuomo; Raphael Eduardo,9999,0,9999,0
1713317614722,CLRE 297,001,507242,Cuomo; Raphael Eduardo,9999,0,9999,0
1713317615750,CSE 191,A00,516875,Minnes Kemp; Mor Mia,9999,0,9999,0
1713317616782,CSS 201S,A01,494383,Staff,35,0,35,0
1713317617807,CSS 202S,A01,494387,Staff,35,0,35,0
1713317618831,EAP 100,A00,516065,Staff,9792,0,9999,207
1713317619859,ECE 45,A01,507414,Staff,54,0,60,6
1713317620890,ECE 100,A01,507416,Baghdadchi; Saharnaz,11,0,20,9
1713317620890,ECE 100,A02,507418,Baghdadchi; Saharnaz,20,0,20,0
1713317621915,ECE 111,A01,507420,Staff,40,0,50,10
1713317622939,ECE 197,001,548057,Sievenpiper; Daniel F.,9998,0,9999,1
1713317623964,EDS 115,A00,507243,Choi; Bailey Miyeon,28,0,28,0
1713317624994,EDS 117,A01,494379,Staff,24,0,25,1
1713317626019,EDS 125,A00,507246,Hopkins; Megan Beth,29,0,30,1
1713317627046,EDS 128A,A01,507264,Fargason; Sharon Gayle,26,0,26,0
1713317628071,EDS 128B,A01,507293,Pappas; Elizabeth,30,0,30,0
1713317629096,EDS 139,A00,507294,Fargason; Sharon Gayle,30,0,30,0
1713317629096,EDS 139,B00,507313,Pappas; Elizabeth,30,0,30,0
1713317630121,EDS 201,A00,507315,Staff,26,0,30,4
1713317631146,EDS 203,A01,507317,Halter; Christopher P.,26,0,30,4
1713317632174,EDS 204R,A01,507319,Halter; Christopher P.,4,0,30,26
1713317632174,EDS 204R,B01,507331,Heinzman; Erica M.,28,0,30,2
1713317633202,EDS 206R,A00,507332,Staff,5,0,30,25
1713317633202,EDS 206R,B00,507343,Staff,28,0,30,2
1713317634227,EDS 250,A00,507344,Hemans; Patricia Ann Benitez,36,0,40,4
1713317635256,EDS 281,A00,507345,Daly; Alan J.,18,0,18,0
1713317636284,EDS 284,A00,507350,Daly; Alan J.,16,0,16,0
1713317637308,EDS 286,A00,507359,Fine; Sarah,18,0,18,0
1713317638343,EDS 289C,A01,507361,Daly; Alan J.,18,0,18,0
1713317639367,EDS 290,A00,507366,Hofstetter; Carolyn,15,0,15,0
1713317640400,LIGM 5A,A00,507421,Fischer-Grunski; Eva K,20,0,20,0
1713317641428,LIGM 5B,A00,507423,Fischer-Grunski; Eva K,20,0,20,0
1713317642458,LIGM 5C,A00,507425,Fischer-Grunski; Eva K,20,0,20,0
1713317643485,LIIT 5AS,A00,507427,Carnelos; Chiara,20,0,20,0
1713317644508,LIIT 5BS,A00,507430,Carnelos; Chiara,20,0,20,0
1713317645540,LIIT 5CS,A00,507432,Carnelos; Chiara,20,0,20,0
1713317646623,LISP 5A,A00,507541,Munoz Sanchez; Alicia,19,0,20,1
1713317647649,LISP 5B,A00,507671,Munoz Sanchez; Alicia,17,0,20,3
1713317648676,LISP 5C,A00,507696,Munoz Sanchez; Alicia,17,0,20,3
1713317649702,MAE 197,001,528363,Boechler; Nicholas Sebastia,9998,0,9999,1
1713317650729,MATH 197,001,523477,Kedlaya; Kiran S.,9999,0,9999,0
1713317650729,MATH 197,002,563811,Zhang; Danna,9999,0,9999,0
1713317651758,MCWP 40R,A00,518780,Staff,20,0,20,0
1713317651758,MCWP 40R,B00,518781,Staff,19,0,20,1
1713317651758,MCWP 40R,C00,518783,Staff,19,0,20,1
1713317652784,MCWP 50R,A00,518791,Staff,20,0,20,0
1713317652784,MCWP 50R,B00,518792,Staff,17,0,20,3
1713317652784,MCWP 50R,C00,518793,Staff,19,0,20,1
1713317652784,MCWP 50R,D00,518794,Staff,18,0,20,2
1713317652784,MCWP 50R,E00,518795,Staff,17,0,20,3
1713317652784,MCWP 50R,F00,518796,Staff,19,0,20,1
1713317652784,MCWP 50R,G00,518797,Staff,19,0,20,1
1713317653811,MMW 12R,A01,514034,Herbst; Matthew,15,0,16,1
1713317653811,MMW 12R,A02,514035,Herbst; Matthew,16,0,16,0
1713317654967,MMW 13R,A01,514037,Staff,12,0,16,4
1713317654967,MMW 13R,A02,514039,Staff,16,0,16,0
1713317657027,SIO 295LS,A00,523233,Staff,19,0,30,11
1713317658052,SIO 295S,A00,523232,Staff,19,0,30,11
1713317659076,SOCI 117,A01,494376,Staff,3,0,5,2
1713317660103,WES 237B,A00,494380,Staff,19,0,20,1
1713317662173,AESE 279B,A00,494370,Wade; Jon P,33,0,33,0
1713317663198,ANAR 135S,A00,494369,Braswell; Geoffrey E.,0,0,0,0
1713317664222,CAT 124RS,A01,519847,Geibel; William,17,0,20,3
1713317665246,CAT 125RS,A01,515971,Geibel; William,17,0,20,3
1713317666275,CLRE 250,A00,511389,Morris; Sheldon,9996,0,9999,3
1713317667302,CLRE 251,A00,507176,Mehta; Ravindra L.,9996,0,9999,3
1713317667302,CLRE 251,B00,511410,Mehta; Ravindra L.,9998,0,9999,1
1713317668329,CLRE 252,A00,507189,Cuomo; Raphael Eduardo,9998,0,9999,1
1713317669359,CLRE 253,A00,507199,Vaida; Florin,9997,0,9999,2
1713317669359,CLRE 253,B00,507202,Vaida; Florin,9999,0,9999,0
1713317670389,CLRE 259,A00,507211,Patel; Hemal,9996,0,9999,3
1713317671416,CLRE 260,A00,507221,Cuomo; Raphael Eduardo,9999,0,9999,0
1713317672443,CLRE 297,001,507242,Cuomo; Raphael Eduardo,9999,0,9999,0
1713317673466,CSE 191,A00,516875,Minnes Kemp; Mor Mia,9999,0,9999,0
1713317674495,CSS 201S,A01,494383,Staff,35,0,35,0
1713317675519,CSS 202S,A01,494387,Staff,35,0,35,0
1713317676546,EAP 100,A00,516065,Staff,9792,0,9999,207
1713317677572,ECE 45,A01,507414,Staff,54,0,60,6
1713317678597,ECE 100,A01,507416,Baghdadchi; Saharnaz,11,0,20,9
1713317678597,ECE 100,A02,507418,Baghdadchi; Saharnaz,20,0,20,0
1713317679622,ECE 111,A01,507420,Staff,40,0,50,10
1713317680647,ECE 197,001,548057,Sievenpiper; Daniel F.,9998,0,9999,1
1713317681675,EDS 115,A00,507243,Choi; Bailey Miyeon,28,0,28,0
1713317682702,EDS 117,A01,494379,Staff,24,0,25,1
1713317683727,EDS 125,A00,507246,Hopkins; Megan Beth,29,0,30,1
1713317684757,EDS 128A,A01,507264,Fargason; Sharon Gayle,26,0,26,0
1713317685781,EDS 128B,A01,507293,Pappas; Elizabeth,30,0,30,0
1713317686806,EDS 139,A00,507294,Fargason; Sharon Gayle,30,0,30,0
1713317686806,EDS 139,B00,507313,Pappas; Elizabeth,30,0,30,0
1713317687830,EDS 201,A00,507315,Staff,26,0,30,4
1713317688859,EDS 203,A01,507317,Halter; Christopher P.,26,0,30,4
1713317689884,EDS 204R,A01,507319,Halter; Christopher P.,4,0,30,26
1713317689884,EDS 204R,B01,507331,Heinzman; Erica M.,28,0,30,2
1713317690909,EDS 206R,A00,507332,Staff,5,0,30,25
1713317690909,EDS 206R,B00,507343,Staff,28,0,30,2
1713317691935,EDS 250,A00,507344,Hemans; Patricia Ann Benitez,36,0,40,4
1713317692959,EDS 281,A00,507345,Daly; Alan J.,18,0,18,0
1713317693985,EDS 284,A00,507350,Daly; Alan J.,16,0,16,0
1713317695014,EDS 286,A00,507359,Fine; Sarah,18,0,18,0
1713317696039,EDS 289C,A01,507361,Daly; Alan J.,18,0,18,0
1713317697065,EDS 290,A00,507366,Hofstetter; Carolyn,15,0,15,0
1713317698095,LIGM 5A,A00,507421,Fischer-Grunski; Eva K,20,0,20,0
1713317699121,LIGM 5B,A00,507423,Fischer-Grunski; Eva K,20,0,20,0
1713317700154,LIGM 5C,A00,507425,Fischer-Grunski; Eva K,20,0,20,0
1713317701181,LIIT 5AS,A00,507427,Carnelos; Chiara,20,0,20,0
1713317702210,LIIT 5BS,A00,507430,Carnelos; Chiara,20,0,20,0
1713317703235,LIIT 5CS,A00,507432,Carnelos; Chiara,20,0,20,0
1713317704260,LISP 5A,A00,507541,Munoz Sanchez; Alicia,19,0,20,1
1713317705288,LISP 5B,A00,507671,Munoz Sanchez; Alicia,17,0,20,3
1713317706319,LISP 5C,A00,507696,Munoz Sanchez; Alicia,17,0,20,3
1713317707348,MAE 197,001,528363,Boechler; Nicholas Sebastia,9998,0,9999,1
1713317708378,MATH 197,001,523477,Kedlaya; Kiran S.,9999,0,9999,0
1713317708378,MATH 197,002,563811,Zhang; Danna,9999,0,9999,0
1713317709402,MCWP 40R,A00,518780,Staff,20,0,20,0
1713317709402,MCWP 40R,B00,518781,Staff,19,0,20,1
1713317709402,MCWP 40R,C00,518783,Staff,19,0,20,1
1713317710429,MCWP 50R,A00,518791,Staff,20,0,20,0
1713317710429,MCWP 50R,B00,518792,Staff,17,0,20,3
1713317710429,MCWP 50R,C00,518793,Staff,19,0,20,1
1713317710429,MCWP 50R,D00,518794,Staff,18,0,20,2
1713317710429,MCWP 50R,E00,518795,Staff,17,0,20,3
1713317710429,MCWP 50R,F00,518796,Staff,19,0,20,1
1713317710429,MCWP 50R,G00,518797,Staff,19,0,20,1
1713317711455,MMW 12R,A01,514034,Herbst; Matthew,15,0,16,1
1713317711455,MMW 12R,A02,514035,Herbst; Matthew,16,0,16,0
1713317712480,MMW 13R,A01,514037,Staff,12,0,16,4
1713317712480,MMW 13R,A02,514039,Staff,16,0,16,0
1713317714537,SIO 295LS,A00,523233,Staff,19,0,30,11
1713317715563,SIO 295S,A00,523232,Staff,19,0,30,11
1713317716589,SOCI 117,A01,494376,Staff,3,0,5,2
1713317717615,WES 237B,A00,494380,Staff,19,0,20,1
1713317719682,AESE 279B,A00,494370,Wade; Jon P,33,0,33,0
1713317720710,ANAR 135S,A00,494369,Braswell; Geoffrey E.,0,0,0,0
1713317721735,CAT 124RS,A01,519847,Geibel; William,17,0,20,3
1713317722762,CAT 125RS,A01,515971,Geibel; William,17,0,20,3
1713317723788,CLRE 250,A00,511389,Morris; Sheldon,9996,0,9999,3
1713317724815,CLRE 251,A00,507176,Mehta; Ravindra L.,9996,0,9999,3
1713317724815,CLRE 251,B00,511410,Mehta; Ravindra L.,9998,0,9999,1
1713317725843,CLRE 252,A00,507189,Cuomo; Raphael Eduardo,9998,0,9999,1
1713317726868,CLRE 253,A00,507199,Vaida; Florin,9997,0,9999,2
1713317726868,CLRE 253,B00,507202,Vaida; Florin,9999,0,9999,0
1713317727895,CLRE 259,A00,507211,Patel; Hemal,9996,0,9999,3
1713317728919,CLRE 260,A00,507221,Cuomo; Raphael Eduardo,9999,0,9999,0
1713317729944,CLRE 297,001,507242,Cuomo; Raphael Eduardo,9999,0,9999,0
1713317730971,CSE 191,A00,516875,Minnes Kemp; Mor Mia,9999,0,9999,0
1713317731995,CSS 201S,A01,494383,Staff,35,0,35,0
1713317733022,CSS 202S,A01,494387,Staff,35,0,35,0
1713317734048,EAP 100,A00,516065,Staff,9792,0,9999,207
1713317735078,ECE 45,A01,507414,Staff,54,0,60,6
1713317736109,ECE 100,A01,507416,Baghdadchi; Saharnaz,11,0,20,9
1713317736109,ECE 100,A02,507418,Baghdadchi; Saharnaz,20,0,20,0
1713317737133,ECE 111,A01,507420,Staff,40,0,50,10
1713317738163,ECE 197,001,548057,Sievenpiper; Daniel F.,9998,0,9999,1
1713317739188,EDS 115,A00,507243,Choi; Bailey Miyeon,28,0,28,0
1713317740220,EDS 117,A01,494379,Staff,24,0,25,1
1713317741248,EDS 125,A00,507246,Hopkins; Megan Beth,29,0,30,1
1713317742274,EDS 128A,A01,507264,Fargason; Sharon Gayle,26,0,26,0
1713317743303,EDS 128B,A01,507293,Pappas; Elizabeth,30,0,30,0
1713317744327,EDS 139,A00,507294,Fargason; Sharon Gayle,30,0,30,0
1713317744327,EDS 139,B00,507313,Pappas; Elizabeth,30,0,30,0
1713317745351,EDS 201,A00,507315,Staff,26,0,30,4
1713317746376,EDS 203,A01,507317,Halter; Christopher P.,26,0,30,4
1713317747402,EDS 204R,A01,507319,Halter; Christopher P.,4,0,30,26
1713317747402,EDS 204R,B01,507331,Heinzman; Erica M.,28,0,30,2
1713317748428,EDS 206R,A00,507332,Staff,5,0,30,25
1713317748428,EDS 206R,B00,507343,Staff,28,0,30,2
1713317749458,EDS 250,A00,507344,Hemans; Patricia Ann Benitez,36,0,40,4
1713317750537,EDS 281,A00,507345,Daly; Alan J.,18,0,18,0
1713317751564,EDS 284,A00,507350,Daly; Alan J.,16,0,16,0
1713317752590,EDS 286,A00,507359,Fine; Sarah,18,0,18,0
1713317753614,EDS 289C,A01,507361,Daly; Alan J.,18,0,18,0
1713317754639,EDS 290,A00,507366,Hofstetter; Carolyn,15,0,15,0
1713317755669,LIGM 5A,A00,507421,Fischer-Grunski; Eva K,20,0,20,0
1713317756695,LIGM 5B,A00,507423,Fischer-Grunski; Eva K,20,0,20,0
1713317757721,LIGM 5C,A00,507425,Fischer-Grunski; Eva K,20,0,20,0
1713317758750,LIIT 5AS,A00,507427,Carnelos; Chiara,20,0,20,0
1713317759786,LIIT 5BS,A00,507430,Carnelos; Chiara,20,0,20,0
1713317760812,LIIT 5CS,A00,507432,Carnelos; Chiara,20,0,20,0
1713317761838,LISP 5A,A00,507541,Munoz Sanchez; Alicia,19,0,20,1
1713317762863,LISP 5B,A00,507671,Munoz Sanchez; Alicia,17,0,20,3
1713317763891,LISP 5C,A00,507696,Munoz Sanchez; Alicia,17,0,20,3
1713317764916,MAE 197,001,528363,Boechler; Nicholas Sebastia,9998,0,9999,1
1713317765943,MATH 197,001,523477,Kedlaya; Kiran S.,9999,0,9999,0
1713317765943,MATH 197,002,563811,Zhang; Danna,9999,0,9999,0
1713317766968,MCWP 40R,A00,518780,Staff,20,0,20,0
1713317766968,MCWP 40R,B00,518781,Staff,19,0,20,1
1713317766968,MCWP 40R,C00,518783,Staff,19,0,20,1
1713317767994,MCWP 50R,A00,518791,Staff,20,0,20,0
1713317767994,MCWP 50R,B00,518792,Staff,17,0,20,3
1713317767994,MCWP 50R,C00,518793,Staff,19,0,20,1
1713317767994,MCWP 50R,D00,518794,Staff,18,0,20,2
1713317767994,MCWP 50R,E00,518795,Staff,17,0,20,3
1713317767994,MCWP 50R,F00,518796,Staff,19,0,20,1
1713317767994,MCWP 50R,G00,518797,Staff,19,0,20,1
1713317769019,MMW 12R,A01,514034,Herbst; Matthew,15,0,16,1
1713317769019,MMW 12R,A02,514035,Herbst; Matthew,16,0,16,0
1713317770043,MMW 13R,A01,514037,Staff,12,0,16,4
1713317770043,MMW 13R,A02,514039,Staff,16,0,16,0
1713317772095,SIO 295LS,A00,523233,Staff,19,0,30,11
1713317773128,SIO 295S,A00,523232,Staff,19,0,30,11
1713317774152,SOCI 117,A01,494376,Staff,3,0,5,2
1713317775178,WES 237B,A00,494380,Staff,19,0,20,1
1713317777240,AESE 279B,A00,494370,Wade; Jon P,33,0,33,0
1713317778265,ANAR 135S,A00,494369,Braswell; Geoffrey E.,0,0,0,0
1713317779295,CAT 124RS,A01,519847,Geibel; William,17,0,20,3
1713317780323,CAT 125RS,A01,515971,Geibel; William,17,0,20,3
1713317781347,CLRE 250,A00,511389,Morris; Sheldon,9996,0,9999,3
1713317782373,CLRE 251,A00,507176,Mehta; Ravindra L.,9996,0,9999,3
1713317782373,CLRE 251,B00,511410,Mehta; Ravindra L.,9998,0,9999,1
1713317783399,CLRE 252,A00,507189,Cuomo; Raphael Eduardo,9998,0,9999,1
1713317784423,CLRE 253,A00,507199,Vaida; Florin,9997,0,9999,2
1713317784423,CLRE 253,B00,507202,Vaida; Florin,9999,0,9999,0
1713317785451,CLRE 259,A00,507211,Patel; Hemal,9996,0,9999,3
1713317786476,CLRE 260,A00,507221,Cuomo; Raphael Eduardo,9999,0,9999,0
1713317787500,CLRE 297,001,507242,Cuomo; Raphael Eduardo,9999,0,9999,0
1713317788525,CSE 191,A00,516875,Minnes Kemp; Mor Mia,9999,0,9999,0
1713317789550,CSS 201S,A01,494383,Staff,35,0,35,0
1713317790576,CSS 202S,A01,494387,Staff,35,0,35,0
1713317791600,EAP 100,A00,516065,Staff,9792,0,9999,207
1713317792625,ECE 45,A01,507414,Staff,54,0,60,6
1713317793650,ECE 100,A01,507416,Baghdadchi; Saharnaz,11,0,20,9
1713317793650,ECE 100,A02,507418,Baghdadchi; Saharnaz,20,0,20,0
1713317794675,ECE 111,A01,507420,Staff,40,0,50,10
1713317795704,ECE 197,001,548057,Sievenpiper; Daniel F.,9998,0,9999,1
1713317796734,EDS 115,A00,507243,Choi; Bailey Miyeon,28,0,28,0
1713317797765,EDS 117,A01,494379,Staff,24,0,25,1
1713317798795,EDS 125,A00,507246,Hopkins; Megan Beth,29,0,30,1
1713317799826,EDS 128A,A01,507264,Fargason; Sharon Gayle,26,0,26,0
1713317800852,EDS 128B,A01,507293,Pappas; Elizabeth,30,0,30,0
1713317801880,EDS 139,A00,507294,Fargason; Sharon Gayle,30,0,30,0
1713317801880,EDS 139,B00,507313,Pappas; Elizabeth,30,0,30,0
1713317802908,EDS 201,A00,507315,Staff,26,0,30,4
1713317803934,EDS 203,A01,507317,Halter; Christopher P.,26,0,30,4
1713317804961,EDS 204R,A01,507319,Halter; Christopher P.,4,0,30,26
1713317804961,EDS 204R,B01,507331,Heinzman; Erica M.,28,0,30,2
1713317805989,EDS 206R,A00,507332,Staff,5,0,30,25
1713317805989,EDS 206R,B00,507343,Staff,28,0,30,2
1713317807018,EDS 250,A00,507344,Hemans; Patricia Ann Benitez,36,0,40,4
1713317808046,EDS 281,A00,507345,Daly; Alan J.,18,0,18,0
1713317809071,EDS 284,A00,507350,Daly; Alan J.,16,0,16,0
1713317810095,EDS 286,A00,507359,Fine; Sarah,18,0,18,0
1713317811120,EDS 289C,A01,507361,Daly; Alan J.,18,0,18,0
1713317812150,EDS 290,A00,507366,Hofstetter; Carolyn,15,0,15,0
1713317813176,LIGM 5A,A00,507421,Fischer-Grunski; Eva K,20,0,20,0
1713317814203,LIGM 5B,A00,507423,Fischer-Grunski; Eva K,20,0,20,0
1713317815232,LIGM 5C,A00,507425,Fischer-Grunski; Eva K,20,0,20,0
1713317816266,LIIT 5AS,A00,507427,Carnelos; Chiara,20,0,20,0
1713317817291,LIIT 5BS,A00,507430,Carnelos; Chiara,20,0,20,0
1713317818317,LIIT 5CS,A00,507432,Carnelos; Chiara,20,0,20,0
1713317819348,LISP 5A,A00,507541,Munoz Sanchez; Alicia,19,0,20,1
1713317820373,LISP 5B,A00,507671,Munoz Sanchez; Alicia,17,0,20,3
1713317821398,LISP 5C,A00,507696,Munoz Sanchez; Alicia,17,0,20,3
1713317822424,MAE 197,001,528363,Boechler; Nicholas Sebastia,9998,0,9999,1
1713317823454,MATH 197,001,523477,Kedlaya; Kiran S.,9999,0,9999,0
1713317823454,MATH 197,002,563811,Zhang; Danna,9999,0,9999,0
1713317824482,MCWP 40R,A00,518780,Staff,20,0,20,0
1713317824482,MCWP 40R,B00,518781,Staff,19,0,20,1
1713317824482,MCWP 40R,C00,518783,Staff,19,0,20,1
1713317825510,MCWP 50R,A00,518791,Staff,20,0,20,0
1713317825510,MCWP 50R,B00,518792,Staff,17,0,20,3
1713317825510,MCWP 50R,C00,518793,Staff,19,0,20,1
1713317825510,MCWP 50R,D00,518794,Staff,18,0,20,2
1713317825510,MCWP 50R,E00,518795,Staff,17,0,20,3
1713317825510,MCWP 50R,F00,518796,Staff,19,0,20,1
1713317825510,MCWP 50R,G00,518797,Staff,19,0,20,1
1713317826539,MMW 12R,A01,514034,Herbst; Matthew,15,0,16,1
1713317826539,MMW 12R,A02,514035,Herbst; Matthew,16,0,16,0
1713317827566,MMW 13R,A01,514037,Staff,12,0,16,4
1713317827566,MMW 13R,A02,514039,Staff,16,0,16,0
1713317829623,SIO 295LS,A00,523233,Staff,19,0,30,11
1713317830652,SIO 295S,A00,523232,Staff,19,0,30,11
1713317831677,SOCI 117,A01,494376,Staff,3,0,5,2
1713317832706,WES 237B,A00,494380,Staff,19,0,20,1
1713317834773,AESE 279B,A00,494370,Wade; Jon P,33,0,33,0
1713317835800,ANAR 135S,A00,494369,Braswell; Geoffrey E.,0,0,0,0
1713317836826,CAT 124RS,A01,519847,Geibel; William,17,0,20,3
1713317837853,CAT 125RS,A01,515971,Geibel; William,17,0,20,3
1713317838878,CLRE 250,A00,511389,Morris; Sheldon,9996,0,9999,3
1713317839904,CLRE 251,A00,507176,Mehta; Ravindra L.,9996,0,9999,3
1713317839904,CLRE 251,B00,511410,Mehta; Ravindra L.,9998,0,9999,1
1713317840932,CLRE 252,A00,507189,Cuomo; Raphael Eduardo,9998,0,9999,1
1713317841958,CLRE 253,A00,507199,Vaida; Florin,9997,0,9999,2
1713317841958,CLRE 253,B00,507202,Vaida; Florin,9999,0,9999,0
1713317842984,CLRE 259,A00,507211,Patel; Hemal,9996,0,9999,3
1713317844013,CLRE 260,A00,507221,Cuomo; Raphael Eduardo,9999,0,9999,0
1713317845038,CLRE 297,001,507242,Cuomo; Raphael Eduardo,9999,0,9999,0
1713317846064,CSE 191,A00,516875,Minnes Kemp; Mor Mia,9999,0,9999,0
1713317847097,CSS 201S,A01,494383,Staff,35,0,35,0
1713317848125,CSS 202S,A01,494387,Staff,35,0,35,0
1713317849149,EAP 100,A00,516065,Staff,9792,0,9999,207
1713317850173,ECE 45,A01,507414,Staff,54,0,60,6
1713317851204,ECE 100,A01,507416,Baghdadchi; Saharnaz,11,0,20,9
1713317851204,ECE 100,A02,507418,Baghdadchi; Saharnaz,20,0,20,0
1713317852231,ECE 111,A01,507420,Staff,40,0,50,10
1713317853256,ECE 197,001,548057,Sievenpiper; Daniel F.,9998,0,9999,1
1713317854339,EDS 115,A00,507243,Choi; Bailey Miyeon,28,0,28,0
1713317855367,EDS 117,A01,494379,Staff,24,0,25,1
1713317856394,EDS 125,A00,507246,Hopkins; Megan Beth,29,0,30,1
1713317857421,EDS 128A,A01,507264,Fargason; Sharon Gayle,26,0,26,0
1713317858446,EDS 128B,A01,507293,Pappas; Elizabeth,30,0,30,0
1713317859473,EDS 139,A00,507294,Fargason; Sharon Gayle,30,0,30,0
1713317859473,EDS 139,B00,507313,Pappas; Elizabeth,30,0,30,0
1713317860499,EDS 201,A00,507315,Staff,26,0,30,4
1713317861525,EDS 203,A01,507317,Halter; Christopher P.,26,0,30,4
1713317862553,EDS 204R,A01,507319,Halter; Christopher P.,4,0,30,26
1713317862553,EDS 204R,B01,507331,Heinzman; Erica M.,28,0,30,2
1713317863577,EDS 206R,A00,507332,Staff,5,0,30,25
1713317863577,EDS 206R,B00,507343,Staff,28,0,30,2
1713317864601,EDS 250,A00,507344,Hemans; Patricia Ann Benitez,36,0,40,4
1713317865630,EDS 281,A00,507345,Daly; Alan J.,18,0,18,0
1713317866657,EDS 284,A00,507350,Daly; Alan J.,16,0,16,0
1713317867688,EDS 286,A00,507359,Fine; Sarah,18,0,18,0
1713317868713,EDS 289C,A01,507361,Daly; Alan J.,18,0,18,0
1713317869741,EDS 290,A00,507366,Hofstetter; Carolyn,15,0,15,0
1713317870768,LIGM 5A,A00,507421,Fischer-Grunski; Eva K,20,0,20,0
1713317871794,LIGM 5B,A00,507423,Fischer-Grunski; Eva K,20,0,20,0
1713317872817,LIGM 5C,A00,507425,Fischer-Grunski; Eva K,20,0,20,0
1713317873843,LIIT 5AS,A00,507427,Carnelos; Chiara,20,0,20,0
1713317874872,LIIT 5BS,A00,507430,Carnelos; Chiara,20,0,20,0
1713317875896,LIIT 5CS,A00,507432,Carnelos; Chiara,20,0,20,0
1713317876925,LISP 5A,A00,507541,Munoz Sanchez; Alicia,19,0,20,1
1713317877954,LISP 5B,A00,507671,Munoz Sanchez; Alicia,17,0,20,3
1713317878979,LISP 5C,A00,507696,Munoz Sanchez; Alicia,17,0,20,3
1713317880005,MAE 197,001,528363,Boechler; Nicholas Sebastia,9998,0,9999,1
1713317881030,MATH 197,001,523477,Kedlaya; Kiran S.,9999,0,9999,0
1713317881030,MATH 197,002,563811,Zhang; Danna,9999,0,9999,0
1713317882055,MCWP 40R,A00,518780,Staff,20,0,20,0
1713317882055,MCWP 40R,B00,518781,Staff,19,0,20,1
1713317882055,MCWP 40R,C00,518783,Staff,19,0,20,1
1713317883086,MCWP 50R,A00,518791,Staff,20,0,20,0
1713317883086,MCWP 50R,B00,518792,Staff,17,0,20,3
1713317883086,MCWP 50R,C00,518793,Staff,19,0,20,1
1713317883086,MCWP 50R,D00,518794,Staff,18,0,20,2
1713317883086,MCWP 50R,E00,518795,Staff,17,0,20,3
1713317883086,MCWP 50R,F00,518796,Staff,19,0,20,1
1713317883086,MCWP 50R,G00,518797,Staff,19,0,20,1
1713317884115,MMW 12R,A01,514034,Herbst; Matthew,15,0,16,1
1713317884115,MMW 12R,A02,514035,Herbst; Matthew,16,0,16,0
1713317885144,MMW 13R,A01,514037,Staff,12,0,16,4
1713317885144,MMW 13R,A02,514039,Staff,16,0,16,0
1713317887199,SIO 295LS,A00,523233,Staff,19,0,30,11
1713317888226,SIO 295S,A00,523232,Staff,19,0,30,11
1713317889252,SOCI 117,A01,494376,Staff,3,0,5,2
1713317890277,WES 237B,A00,494380,Staff,19,0,20,1
1713317892340,AESE 279B,A00,494370,Wade; Jon P,33,0,33,0
1713317893368,ANAR 135S,A00,494369,Braswell; Geoffrey E.,0,0,0,0
1713317894392,CAT 124RS,A01,519847,Geibel; William,17,0,20,3
1713317895418,CAT 125RS,A01,515971,Geibel; William,17,0,20,3
1713317896446,CLRE 250,A00,511389,Morris; Sheldon,9996,0,9999,3
1713317897472,CLRE 251,A00,507176,Mehta; Ravindra L.,9996,0,9999,3
1713317897472,CLRE 251,B00,511410,Mehta; Ravindra L.,9998,0,9999,1
1713317898496,CLRE 252,A00,507189,Cuomo; Raphael Eduardo,9998,0,9999,1
1713317899524,CLRE 253,A00,507199,Vaida; Florin,9997,0,9999,2
1713317899524,CLRE 253,B00,507202,Vaida; Florin,9999,0,9999,0
1713317900550,CLRE 259,A00,507211,Patel; Hemal,9996,0,9999,3
1713317901575,CLRE 260,A00,507221,Cuomo; Raphael Eduardo,9999,0,9999,0
1713317902597,CLRE 297,001,507242,Cuomo; Raphael Eduardo,9999,0,9999,0
1713317903622,CSE 191,A00,516875,Minnes Kemp; Mor Mia,9999,0,9999,0
1713317904646,CSS 201S,A01,494383,Staff,35,0,35,0
1713317905674,CSS 202S,A01,494387,Staff,35,0,35,0
1713317906702,EAP 100,A00,516065,Staff,9792,0,9999,207
1713317907729,ECE 45,A01,507414,Staff,54,0,60,6
1713317908756,ECE 100,A01,507416,Baghdadchi; Saharnaz,11,0,20,9
1713317908756,ECE 100,A02,507418,Baghdadchi; Saharnaz,20,0,20,0
1713317909782,ECE 111,A01,507420,Staff,40,0,50,10
1713317910812,ECE 197,001,548057,Sievenpiper; Daniel F.,9998,0,9999,1
1713317911838,EDS 115,A00,507243,Choi; Bailey Miyeon,28,0,28,0
1713317912865,EDS 117,A01,494379,Staff,24,0,25,1
1713317913889,EDS 125,A00,507246,Hopkins; Megan Beth,29,0,30,1
1713317914916,EDS 128A,A01,507264,Fargason; Sharon Gayle,26,0,26,0
1713317915941,EDS 128B,A01,507293,Pappas; Elizabeth,30,0,30,0
1713317916966,EDS 139,A00,507294,Fargason; Sharon Gayle,30,0,30,0
1713317916966,EDS 139,B00,507313,Pappas; Elizabeth,30,0,30,0
1713317917991,EDS 201,A00,507315,Staff,26,0,30,4
1713317919017,EDS 203,A01,507317,Halter; Christopher P.,26,0,30,4
1713317920044,EDS 204R,A01,507319,Halter; Christopher P.,4,0,30,26
1713317920044,EDS 204R,B01,507331,Heinzman; Erica M.,28,0,30,2
1713317921071,EDS 206R,A00,507332,Staff,5,0,30,25
1713317921071,EDS 206R,B00,507343,Staff,28,0,30,2
1713317922098,EDS 250,A00,507344,Hemans; Patricia Ann Benitez,36,0,40,4
1713317923124,EDS 281,A00,507345,Daly; Alan J.,18,0,18,0
1713317924149,EDS 284,A00,507350,Daly; Alan J.,16,0,16,0
1713317925178,EDS 286,A00,507359,Fine; Sarah,18,0,18,0
1713317926202,EDS 289C,A01,507361,Daly; Alan J.,18,0,18,0
1713317927228,EDS 290,A00,507366,Hofstetter; Carolyn,15,0,15,0
1713317928259,LIGM 5A,A00,507421,Fischer-Grunski; Eva K,20,0,20,0
1713317929287,LIGM 5B,A00,507423,Fischer-Grunski; Eva K,20,0,20,0
1713317930316,LIGM 5C,A00,507425,Fischer-Grunski; Eva K,20,0,20,0
1713317931344,LIIT 5AS,A00,507427,Carnelos; Chiara,20,0,20,0
1713317932374,LIIT 5BS,A00,507430,Carnelos; Chiara,20,0,20,0
1713317933405,LIIT 5CS,A00,507432,Carnelos; Chiara,20,0,20,0
1713317934430,LISP 5A,A00,507541,Munoz Sanchez; Alicia,19,0,20,1
1713317935456,LISP 5B,A00,507671,Munoz Sanchez; Alicia,17,0,20,3
1713317936480,LISP 5C,A00,507696,Munoz Sanchez; Alicia,17,0,20,3
1713317937505,MAE 197,001,528363,Boechler; Nicholas Sebastia,9998,0,9999,1
1713317938533,MATH 197,001,523477,Kedlaya; Kiran S.,9999,0,9999,0
1713317938533,MATH 197,002,563811,Zhang; Danna,9999,0,9999,0
1713317939557,MCWP 40R,A00,518780,Staff,20,0,20,0
1713317939557,MCWP 40R,B00,518781,Staff,19,0,20,1
1713317939557,MCWP 40R,C00,518783,Staff,19,0,20,1
1713317940587,MCWP 50R,A00,518791,Staff,20,0,20,0
1713317940587,MCWP 50R,B00,518792,Staff,17,0,20,3
1713317940587,MCWP 50R,C00,518793,Staff,19,0,20,1
1713317940587,MCWP 50R,D00,518794,Staff,18,0,20,2
1713317940587,MCWP 50R,E00,518795,Staff,17,0,20,3
1713317940587,MCWP 50R,F00,518796,Staff,19,0,20,1
1713317940587,MCWP 50R,G00,518797,Staff,19,0,20,1
1713317941617,MMW 12R,A01,514034,Herbst; Matthew,15,0,16,1
1713317941617,MMW 12R,A02,514035,Herbst; Matthew,16,0,16,0
1713317942641,MMW 13R,A01,514037,Staff,12,0,16,4
1713317942641,MMW 13R,A02,514039,Staff,16,0,16,0
1713317944695,SIO 295LS,A00,523233,Staff,19,0,30,11
1713317945724,SIO 295S,A00,523232,Staff,19,0,30,11
1713317946750,SOCI 117,A01,494376,Staff,3,0,5,2
1713317947774,WES 237B,A00,494380,Staff,19,0,20,1
1713317949843,AESE 279B,A00,494370,Wade; Jon P,33,0,33,0
1713317950872,ANAR 135S,A00,494369,Braswell; Geoffrey E.,0,0,0,0
1713317951896,CAT 124RS,A01,519847,Geibel; William,17,0,20,3
1713317952921,CAT 125RS,A01,515971,Geibel; William,17,0,20,3
1713317953946,CLRE 250,A00,511389,Morris; Sheldon,9996,0,9999,3
1713317954972,CLRE 251,A00,507176,Mehta; Ravindra L.,9996,0,9999,3
1713317954972,CLRE 251,B00,511410,Mehta; Ravindra L.,9998,0,9999,1
1713317956000,CLRE 252,A00,507189,Cuomo; Raphael Eduardo,9998,0,9999,1
1713317957026,CLRE 253,A00,507199,Vaida; Florin,9997,0,9999,2
1713317957026,CLRE 253,B00,507202,Vaida; Florin,9999,0,9999,0
1713317958114,CLRE 259,A00,507211,Patel; Hemal,9996,0,9999,3
1713317959138,CLRE 260,A00,507221,Cuomo; Raphael Eduardo,9999,0,9999,0
1713317960165,CLRE 297,001,507242,Cuomo; Raphael Eduardo,9999,0,9999,0
1713317961190,CSE 191,A00,516875,Minnes Kemp; Mor Mia,9999,0,9999,0
1713317962217,CSS 201S,A01,494383,Staff,35,0,35,0
1713317963242,CSS 202S,A01,494387,Staff,35,0,35,0
1713317964267,EAP 100,A00,516065,Staff,9792,0,9999,207
1713317965293,ECE 45,A01,507414,Staff,54,0,60,6
1713317966323,ECE 100,A01,507416,Baghdadchi; Saharnaz,11,0,20,9
1713317966323,ECE 100,A02,507418,Baghdadchi; Saharnaz,20,0,20,0
1713317967348,ECE 111,A01,507420,Staff,40,0,50,10
1713317968377,ECE 197,001,548057,Sievenpiper; Daniel F.,9998,0,9999,1
1713317969406,EDS 115,A00,507243,Choi; Bailey Miyeon,28,0,28,0
1713317970432,EDS 117,A01,494379,Staff,24,0,25,1
1713317971458,EDS 125,A00,507246,Hopkins; Megan Beth,29,0,30,1
1713317972489,EDS 128A,A01,507264,Fargason; Sharon Gayle,26,0,26,0
1713317973514,EDS 128B,A01,507293,Pappas; Elizabeth,30,0,30,0
1713317974539,EDS 139,A00,507294,Fargason; Sharon Gayle,30,0,30,0
1713317974539,EDS 139,B00,507313,Pappas; Elizabeth,30,0,30,0
1713317975566,EDS 201,A00,507315,Staff,26,0,30,4
1713317976592,EDS 203,A01,507317,Halter; Christopher P.,26,0,30,4
1713317977617,EDS 204R,A01,507319,Halter; Christopher P.,4,0,30,26
1713317977617,EDS 204R,B01,507331,Heinzman; Erica M.,28,0,30,2
1713317978645,EDS 206R,A00,507332,Staff,5,0,30,25
1713317978645,EDS 206R,B00,507343,Staff,28,0,30,2
1713317979676,EDS 250,A00,507344,Hemans; Patricia Ann Benitez,36,0,40,4
1713317980704,EDS 281,A00,507345,Daly; Alan J.,18,0,18,0
1713317981733,EDS 284,A00,507350,Daly; Alan J.,16,0,16,0
1713317982758,EDS 286,A00,507359,Fine; Sarah,18,0,18,0
1713317983782,EDS 289C,A01,507361,Daly; Alan J.,18,0,18,0
1713317984811,EDS 290,A00,507366,Hofstetter; Carolyn,15,0,15,0
1713317985839,LIGM 5A,A00,507421,Fischer-Grunski; Eva K,20,0,20,0
1713317986868,LIGM 5B,A00,507423,Fischer-Grunski; Eva K,20,0,20,0
1713317987898,LIGM 5C,A00,507425,Fischer-Grunski; Eva K,20,0,20,0
1713317988927,LIIT 5AS,A00,507427,Carnelos; Chiara,20,0,20,0
1713317989955,LIIT 5BS,A00,507430,Carnelos; Chiara,20,0,20,0
1713317990982,LIIT 5CS,A00,507432,Carnelos; Chiara,20,0,20,0
1713317992007,LISP 5A,A00,507541,Munoz Sanchez; Alicia,19,0,20,1
1713317993032,LISP 5B,A00,507671,Munoz Sanchez; Alicia,17,0,20,3
1713317994057,LISP 5C,A00,507696,Munoz Sanchez; Alicia,17,0,20,3
1713317995085,MAE 197,001,528363,Boechler; Nicholas Sebastia,9998,0,9999,1
1713317996111,MATH 197,001,523477,Kedlaya; Kiran S.,9999,0,9999,0
1713317996111,MATH 197,002,563811,Zhang; Danna,9999,0,9999,0
1713317997141,MCWP 40R,A00,518780,Staff,20,0,20,0
1713317997141,MCWP 40R,B00,518781,Staff,19,0,20,1
1713317997141,MCWP 40R,C00,518783,Staff,19,0,20,1
1713317998168,MCWP 50R,A00,518791,Staff,20,0,20,0
1713317998168,MCWP 50R,B00,518792,Staff,17,0,20,3
1713317998168,MCWP 50R,C00,518793,Staff,19,0,20,1
1713317998168,MCWP 50R,D00,518794,Staff,18,0,20,2
1713317998168,MCWP 50R,E00,518795,Staff,17,0,20,3
1713317998168,MCWP 50R,F00,518796,Staff,19,0,20,1
1713317998168,MCWP 50R,G00,518797,Staff,19,0,20,1
1713317999194,MMW 12R,A01,514034,Herbst; Matthew,15,0,16,1
1713317999194,MMW 12R,A02,514035,Herbst; Matthew,16,0,16,0
1713318000220,MMW 13R,A01,514037,Staff,12,0,16,4
1713318000220,MMW 13R,A02,514039,Staff,16,0,16,0
1713318002275,SIO 295LS,A00,523233,Staff,19,0,30,11
1713318003303,SIO 295S,A00,523232,Staff,19,0,30,11
1713318004330,SOCI 117,A01,494376,Staff,3,0,5,2
1713318005356,WES 237B,A00,494380,Staff,19,0,20,1
1713318007415,AESE 279B,A00,494370,Wade; Jon P,33,0,33,0
1713318008443,ANAR 135S,A00,494369,Braswell; Geoffrey E.,0,0,0,0
1713318009469,CAT 124RS,A01,519847,Geibel; William,17,0,20,3
1713318010500,CAT 125RS,A01,515971,Geibel; William,17,0,20,3
1713318011525,CLRE 250,A00,511389,Morris; Sheldon,9996,0,9999,3
1713318012550,CLRE 251,A00,507176,Mehta; Ravindra L.,9996,0,9999,3
1713318012550,CLRE 251,B00,511410,Mehta; Ravindra L.,9998,0,9999,1
1713318013580,CLRE 252,A00,507189,Cuomo; Raphael Eduardo,9998,0,9999,1
1713318014608,CLRE 253,A00,507199,Vaida; Florin,9997,0,9999,2
1713318014608,CLRE 253,B00,507202,Vaida; Florin,9999,0,9999,0
1713318015637,CLRE 259,A00,507211,Patel; Hemal,9996,0,9999,3
1713318016664,CLRE 260,A00,507221,Cuomo; Raphael Eduardo,9999,0,9999,0
1713318017688,CLRE 297,001,507242,Cuomo; Raphael Eduardo,9999,0,9999,0
1713318018713,CSE 191,A00,516875,Minnes Kemp; Mor Mia,9999,0,9999,0
1713318019738,CSS 201S,A01,494383,Staff,35,0,35,0
1713318020762,CSS 202S,A01,494387,Staff,35,0,35,0
1713318021788,EAP 100,A00,516065,Staff,9792,0,9999,207
1713318022818,ECE 45,A01,507414,Staff,54,0,60,6
1713318023859,ECE 100,A01,507416,Baghdadchi; Saharnaz,11,0,20,9
1713318023859,ECE 100,A02,507418,Baghdadchi; Saharnaz,20,0,20,0
1713318024884,ECE 111,A01,507420,Staff,40,0,50,10
1713318025910,ECE 197,001,548057,Sievenpiper; Daniel F.,9998,0,9999,1
1713318026935,EDS 115,A00,507243,Choi; Bailey Miyeon,28,0,28,0
1713318027961,EDS 117,A01,494379,Staff,24,0,25,1
1713318028985,EDS 125,A00,507246,Hopkins; Megan Beth,29,0,30,1
1713318030010,EDS 128A,A01,507264,Fargason; Sharon Gayle,26,0,26,0
1713318031035,EDS 128B,A01,507293,Pappas; Elizabeth,30,0,30,0
1713318032059,EDS 139,A00,507294,Fargason; Sharon Gayle,30,0,30,0
1713318032059,EDS 139,B00,507313,Pappas; Elizabeth,30,0,30,0
1713318033084,EDS 201,A00,507315,Staff,26,0,30,4
1713318034110,EDS 203,A01,507317,Halter; Christopher P.,26,0,30,4
1713318035136,EDS 204R,A01,507319,Halter; Christopher P.,4,0,30,26
1713318035136,EDS 204R,B01,507331,Heinzman; Erica M.,28,0,30,2
1713318036161,EDS 206R,A00,507332,Staff,5,0,30,25
1713318036161,EDS 206R,B00,507343,Staff,28,0,30,2
1713318037189,EDS 250,A00,507344,Hemans; Patricia Ann Benitez,36,0,40,4
1713318038216,EDS 281,A00,507345,Daly; Alan J.,18,0,18,0
1713318039244,EDS 284,A00,507350,Daly; Alan J.,16,0,16,0
1713318040272,EDS 286,A00,507359,Fine; Sarah,18,0,18,0
1713318041296,EDS 289C,A01,507361,Daly; Alan J.,18,0,18,0
1713318042320,EDS 290,A00,507366,Hofstetter; Carolyn,15,0,15,0
1713318043346,LIGM 5A,A00,507421,Fischer-Grunski; Eva K,20,0,20,0
1713318044371,LIGM 5B,A00,507423,Fischer-Grunski; Eva K,20,0,20,0
1713318045400,LIGM 5C,A00,507425,Fischer-Grunski; Eva K,20,0,20,0
1713318046429,LIIT 5AS,A00,507427,Carnelos; Chiara,20,0,20,0
1713318047459,LIIT 5BS,A00,507430,Carnelos; Chiara,20,0,20,0
1713318048484,LIIT 5CS,A00,507432,Carnelos; Chiara,20,0,20,0
1713318049509,LISP 5A,A00,507541,Munoz Sanchez; Alicia,19,0,20,1
1713318050535,LISP 5B,A00,507671,Munoz Sanchez; Alicia,17,0,20,3
1713318051566,LISP 5C,A00,507696,Munoz Sanchez; Alicia,17,0,20,3
1713318052599,MAE 197,001,528363,Boechler; Nicholas Sebastia,9998,0,9999,1
1713318053626,MATH 197,001,523477,Kedlaya; Kiran S.,9999,0,9999,0
1713318053626,MATH 197,002,563811,Zhang; Danna,9999,0,9999,0
1713318054651,MCWP 40R,A00,518780,Staff,20,0,20,0
1713318054651,MCWP 40R,B00,518781,Staff,19,0,20,1
1713318054651,MCWP 40R,C00,518783,Staff,19,0,20,1
1713318055681,MCWP 50R,A00,518791,Staff,20,0,20,0
1713318055681,MCWP 50R,B00,518792,Staff,17,0,20,3
1713318055681,MCWP 50R,C00,518793,Staff,19,0,20,1
1713318055681,MCWP 50R,D00,518794,Staff,18,0,20,2
1713318055681,MCWP 50R,E00,518795,Staff,17,0,20,3
1713318055681,MCWP 50R,F00,518796,Staff,19,0,20,1
1713318055681,MCWP 50R,G00,518797,Staff,19,0,20,1
1713318056707,MMW 12R,A01,514034,Herbst; Matthew,15,0,16,1
1713318056707,MMW 12R,A02,514035,Herbst; Matthew,16,0,16,0
1713318057731,MMW 13R,A01,514037,Staff,12,0,16,4
1713318057731,MMW 13R,A02,514039,Staff,16,0,16,0
1713318059785,SIO 295LS,A00,523233,Staff,19,0,30,11
1713318060816,SIO 295S,A00,523232,Staff,19,0,30,11
1713318061894,SOCI 117,A01,494376,Staff,3,0,5,2
1713318062921,WES 237B,A00,494380,Staff,19,0,20,1
1713318064998,AESE 279B,A00,494370,Wade; Jon P,33,0,33,0
1713318066027,ANAR 135S,A00,494369,Braswell; Geoffrey E.,0,0,0,0
1713318067060,CAT 124RS,A01,519847,Geibel; William,17,0,20,3
1713318068090,CAT 125RS,A01,515971,Geibel; William,17,0,20,3
1713318069115,CLRE 250,A00,511389,Morris; Sheldon,9996,0,9999,3
1713318070150,CLRE 251,A00,507176,Mehta; Ravindra L.,9996,0,9999,3
1713318070150,CLRE 251,B00,511410,Mehta; Ravindra L.,9998,0,9999,1
1713318071175,CLRE 252,A00,507189,Cuomo; Raphael Eduardo,9998,0,9999,1
1713318072199,CLRE 253,A00,507199,Vaida; Florin,9997,0,9999,2
1713318072199,CLRE 253,B00,507202,Vaida; Florin,9999,0,9999,0
1713318073225,CLRE 259,A00,507211,Patel; Hemal,9996,0,9999,3
1713318074250,CLRE 260,A00,507221,Cuomo; Raphael Eduardo,9999,0,9999,0
1713318075275,CLRE 297,001,507242,Cuomo; Raphael Eduardo,9999,0,9999,0
1713318076306,CSE 191,A00,516875,Minnes Kemp; Mor Mia,9999,0,9999,0
1713318077339,CSS 201S,A01,494383,Staff,35,0,35,0
1713318078364,CSS 202S,A01,494387,Staff,35,0,35,0
1713318079391,EAP 100,A00,516065,Staff,9792,0,9999,207
1713318080421,ECE 45,A01,507414,Staff,54,0,60,6
1713318081450,ECE 100,A01,507416,Baghdadchi; Saharnaz,11,0,20,9
1713318081450,ECE 100,A02,507418,Baghdadchi; Saharnaz,20,0,20,0
1713318082474,ECE 111,A01,507420,Staff,40,0,50,10
1713318083500,ECE 197,001,548057,Sievenpiper; Daniel F.,9998,0,9999,1
1713318084527,EDS 115,A00,507243,Choi; Bailey Miyeon,28,0,28,0
1713318085553,EDS 117,A01,494379,Staff,24,0,25,1
1713318086584,EDS 125,A00,507246,Hopkins; Megan Beth,29,0,30,1
1713318087616,EDS 128A,A01,507264,Fargason; Sharon Gayle,26,0,26,0
1713318088642,EDS 128B,A01,507293,Pappas; Elizabeth,30,0,30,0
1713318089670,EDS 139,A00,507294,Fargason; Sharon Gayle,30,0,30,0
1713318089670,EDS 139,B00,507313,Pappas; Elizabeth,30,0,30,0
1713318090695,EDS 201,A00,507315,Staff,26,0,30,4
1713318091722,EDS 203,A01,507317,Halter; Christopher P.,26,0,30,4
1713318092747,EDS 204R,A01,507319,Halter; Christopher P.,4,0,30,26
1713318092747,EDS 204R,B01,507331,Heinzman; Erica M.,28,0,30,2
1713318093772,EDS 206R,A00,507332,Staff,5,0,30,25
1713318093772,EDS 206R,B00,507343,Staff,28,0,30,2
1713318094801,EDS 250,A00,507344,Hemans; Patricia Ann Benitez,36,0,40,4
1713318095826,EDS 281,A00,507345,Daly; Alan J.,18,0,18,0
1713318096849,EDS 284,A00,507350,Daly; Alan J.,16,0,16,0
1713318097893,EDS 286,A00,507359,Fine; Sarah,18,0,18,0
1713318098918,EDS 289C,A01,507361,Daly; Alan J.,18,0,18,0
1713318099945,EDS 290,A00,507366,Hofstetter; Carolyn,15,0,15,0
1713318100970,LIGM 5A,A00,507421,Fischer-Grunski; Eva K,20,0,20,0
1713318101999,LIGM 5B,A00,507423,Fischer-Grunski; Eva K,20,0,20,0
1713318103026,LIGM 5C,A00,507425,Fischer-Grunski; Eva K,20,0,20,0
1713318104056,LIIT 5AS,A00,507427,Carnelos; Chiara,20,0,20,0
1713318105084,LIIT 5BS,A00,507430,Carnelos; Chiara,20,0,20,0
1713318106111,LIIT 5CS,A00,507432,Carnelos; Chiara,20,0,20,0
1713318107142,LISP 5A,A00,507541,Munoz Sanchez; Alicia,19,0,20,1
1713318108168,LISP 5B,A00,507671,Munoz Sanchez; Alicia,17,0,20,3
1713318109195,LISP 5C,A00,507696,Munoz Sanchez; Alicia,17,0,20,3
1713318110227,MAE 197,001,528363,Boechler; Nicholas Sebastia,9998,0,9999,1
1713318111251,MATH 197,001,523477,Kedlaya; Kiran S.,9999,0,9999,0
1713318111251,MATH 197,002,563811,Zhang; Danna,9999,0,9999,0
1713318112284,MCWP 40R,A00,518780,Staff,20,0,20,0
1713318112284,MCWP 40R,B00,518781,Staff,19,0,20,1
1713318112284,MCWP 40R,C00,518783,Staff,19,0,20,1
1713318113310,MCWP 50R,A00,518791,Staff,20,0,20,0
1713318113310,MCWP 50R,B00,518792,Staff,17,0,20,3
1713318113310,MCWP 50R,C00,518793,Staff,19,0,20,1
1713318113310,MCWP 50R,D00,518794,Staff,18,0,20,2
1713318113310,MCWP 50R,E00,518795,Staff,17,0,20,3
1713318113310,MCWP 50R,F00,518796,Staff,19,0,20,1
1713318113310,MCWP 50R,G00,518797,Staff,19,0,20,1
1713318114338,MMW 12R,A01,514034,Herbst; Matthew,15,0,16,1
1713318114338,MMW 12R,A02,514035,Herbst; Matthew,16,0,16,0
1713318115363,MMW 13R,A01,514037,Staff,12,0,16,4
1713318115363,MMW 13R,A02,514039,Staff,16,0,16,0
1713318117419,SIO 295LS,A00,523233,Staff,19,0,30,11
1713318118449,SIO 295S,A00,523232,Staff,19,0,30,11
1713318119475,SOCI 117,A01,494376,Staff,3,0,5,2
1713318120502,WES 237B,A00,494380,Staff,19,0,20,1
1713318122577,AESE 279B,A00,494370,Wade; Jon P,33,0,33,0
1713318123604,ANAR 135S,A00,494369,Braswell; Geoffrey E.,0,0,0,0
1713318124629,CAT 124RS,A01,519847,Geibel; William,17,0,20,3
1713318125654,CAT 125RS,A01,515971,Geibel; William,17,0,20,3
1713318126681,CLRE 250,A00,511389,Morris; Sheldon,9996,0,9999,3
1713318127708,CLRE 251,A00,507176,Mehta; Ravindra L.,9996,0,9999,3
1713318127708,CLRE 251,B00,511410,Mehta; Ravindra L.,9998,0,9999,1
1713318128735,CLRE 252,A00,507189,Cuomo; Raphael Eduardo,9998,0,9999,1
1713318129765,CLRE 253,A00,507199,Vaida; Florin,9997,0,9999,2
1713318129765,CLRE 253,B00,507202,Vaida; Florin,9999,0,9999,0
1713318130788,CLRE 259,A00,507211,Patel; Hemal,9996,0,9999,3
1713318131815,CLRE 260,A00,507221,Cuomo; Raphael Eduardo,9999,0,9999,0
1713318132840,CLRE 297,001,507242,Cuomo; Raphael Eduardo,9999,0,9999,0
1713318133867,CSE 191,A00,516875,Minnes Kemp; Mor Mia,9999,0,9999,0
1713318134898,CSS 201S,A01,494383,Staff,35,0,35,0
1713318135924,CSS 202S,A01,494387,Staff,35,0,35,0
1713318136952,EAP 100,A00,516065,Staff,9792,0,9999,207
1713318137980,ECE 45,A01,507414,Staff,54,0,60,6
1713318139005,ECE 100,A01,507416,Baghdadchi; Saharnaz,11,0,20,9
1713318139005,ECE 100,A02,507418,Baghdadchi; Saharnaz,20,0,20,0
1713318140035,ECE 111,A01,507420,Staff,40,0,50,10
1713318141060,ECE 197,001,548057,Sievenpiper; Daniel F.,9998,0,9999,1
1713318142088,EDS 115,A00,507243,Choi; Bailey Miyeon,28,0,28,0
1713318143117,EDS 117,A01,494379,Staff,24,0,25,1
1713318144145,EDS 125,A00,507246,Hopkins; Megan Beth,29,0,30,1
1713318145172,EDS 128A,A01,507264,Fargason; Sharon Gayle,26,0,26,0
1713318146200,EDS 128B,A01,507293,Pappas; Elizabeth,30,0,30,0
1713318147226,EDS 139,A00,507294,Fargason; Sharon Gayle,30,0,30,0
1713318147226,EDS 139,B00,507313,Pappas; Elizabeth,30,0,30,0
1713318148256,EDS 201,A00,507315,Staff,26,0,30,4
1713318149292,EDS 203,A01,507317,Halter; Christopher P.,26,0,30,4
1713318150323,EDS 204R,A01,507319,Halter; Christopher P.,4,0,30,26
1713318150323,EDS 204R,B01,507331,Heinzman; Erica M.,28,0,30,2
1713318151348,EDS 206R,A00,507332,Staff,5,0,30,25
1713318151348,EDS 206R,B00,507343,Staff,28,0,30,2
1713318152379,EDS 250,A00,507344,Hemans; Patricia Ann Benitez,36,0,40,4
1713318153406,EDS 281,A00,507345,Daly; Alan J.,18,0,18,0
1713318154431,EDS 284,A00,507350,Daly; Alan J.,16,0,16,0
1713318155457,EDS 286,A00,507359,Fine; Sarah,18,0,18,0
1713318156486,EDS 289C,A01,507361,Daly; Alan J.,18,0,18,0
1713318157512,EDS 290,A00,507366,Hofstetter; Carolyn,15,0,15,0
1713318158536,LIGM 5A,A00,507421,Fischer-Grunski; Eva K,20,0,20,0
1713318159565,LIGM 5B,A00,507423,Fischer-Grunski; Eva K,20,0,20,0
1713318160590,LIGM 5C,A00,507425,Fischer-Grunski; Eva K,20,0,20,0
1713318161620,LIIT 5AS,A00,507427,Carnelos; Chiara,20,0,20,0
1713318162646,LIIT 5BS,A00,507430,Carnelos; Chiara,20,0,20,0
1713318163674,LIIT 5CS,A00,507432,Carnelos; Chiara,20,0,20,0
1713318164706,LISP 5A,A00,507541,Munoz Sanchez; Alicia,19,0,20,1
1713318165790,LISP 5B,A00,507671,Munoz Sanchez; Alicia,17,0,20,3
1713318166816,LISP 5C,A00,507696,Munoz Sanchez; Alicia,17,0,20,3
1713318167841,MAE 197,001,528363,Boechler; Nicholas Sebastia,9998,0,9999,1
1713318168866,MATH 197,001,523477,Kedlaya; Kiran S.,9999,0,9999,0
1713318168866,MATH 197,002,563811,Zhang; Danna,9999,0,9999,0
1713318169892,MCWP 40R,A00,518780,Staff,20,0,20,0
1713318169892,MCWP 40R,B00,518781,Staff,19,0,20,1
1713318169892,MCWP 40R,C00,518783,Staff,19,0,20,1
1713318170919,MCWP 50R,A00,518791,Staff,20,0,20,0
1713318170919,MCWP 50R,B00,518792,Staff,17,0,20,3
1713318170919,MCWP 50R,C00,518793,Staff,19,0,20,1
1713318170919,MCWP 50R,D00,518794,Staff,18,0,20,2
1713318170919,MCWP 50R,E00,518795,Staff,17,0,20,3
1713318170919,MCWP 50R,F00,518796,Staff,19,0,20,1
1713318170919,MCWP 50R,G00,518797,Staff,19,0,20,1
1713318171944,MMW 12R,A01,514034,Herbst; Matthew,15,0,16,1
1713318171944,MMW 12R,A02,514035,Herbst; Matthew,16,0,16,0
1713318172974,MMW 13R,A01,514037,Staff,12,0,16,4
1713318172974,MMW 13R,A02,514039,Staff,16,0,16,0
1713318175024,SIO 295LS,A00,523233,Staff,19,0,30,11
1713318176051,SIO 295S,A00,523232,Staff,19,0,30,11
1713318177074,SOCI 117,A01,494376,Staff,3,0,5,2
1713318178100,WES 237B,A00,494380,Staff,19,0,20,1
1713318180303,AESE 279B,A00,494370,Wade; Jon P,33,0,33,0
1713318181330,ANAR 135S,A00,494369,Braswell; Geoffrey E.,0,0,0,0
1713318182356,CAT 124RS,A01,519847,Geibel; William,17,0,20,3
1713318183383,CAT 125RS,A01,515971,Geibel; William,17,0,20,3
1713318184409,CLRE 250,A00,511389,Morris; Sheldon,9996,0,9999,3
1713318185436,CLRE 251,A00,507176,Mehta; Ravindra L.,9996,0,9999,3
1713318185436,CLRE 251,B00,511410,Mehta; Ravindra L.,9998,0,9999,1
1713318186459,CLRE 252,A00,507189,Cuomo; Raphael Eduardo,9998,0,9999,1
1713318187485,CLRE 253,A00,507199,Vaida; Florin,9997,0,9999,2
1713318187485,CLRE 253,B00,507202,Vaida; Florin,9999,0,9999,0
1713318188515,CLRE 259,A00,507211,Patel; Hemal,9996,0,9999,3
1713318189538,CLRE 260,A00,507221,Cuomo; Raphael Eduardo,9999,0,9999,0
1713318190563,CLRE 297,001,507242,Cuomo; Raphael Eduardo,9999,0,9999,0
1713318191591,CSE 191,A00,516875,Minnes Kemp; Mor Mia,9999,0,9999,0
1713318192619,CSS 201S,A01,494383,Staff,35,0,35,0
1713318193644,CSS 202S,A01,494387,Staff,35,0,35,0
1713318194669,EAP 100,A00,516065,Staff,9792,0,9999,207
1713318195696,ECE 45,A01,507414,Staff,54,0,60,6
1713318196720,ECE 100,A01,507416,Baghdadchi; Saharnaz,11,0,20,9
1713318196720,ECE 100,A02,507418,Baghdadchi; Saharnaz,20,0,20,0
1713318197745,ECE 111,A01,507420,Staff,40,0,50,10
1713318198772,ECE 197,001,548057,Sievenpiper; Daniel F.,9998,0,9999,1
1713318199798,EDS 115,A00,507243,Choi; Bailey Miyeon,28,0,28,0
1713318200823,EDS 117,A01,494379,Staff,24,0,25,1
1713318201851,EDS 125,A00,507246,Hopkins; Megan Beth,29,0,30,1
1713318202875,EDS 128A,A01,507264,Fargason; Sharon Gayle,26,0,26,0
1713318203908,EDS 128B,A01,507293,Pappas; Elizabeth,30,0,30,0
1713318204932,EDS 139,A00,507294,Fargason; Sharon Gayle,30,0,30,0
1713318204932,EDS 139,B00,507313,Pappas; Elizabeth,30,0,30,0
1713318205959,EDS 201,A00,507315,Staff,26,0,30,4
1713318206983,EDS 203,A01,507317,Halter; Christopher P.,26,0,30,4
1713318208013,EDS 204R,A01,507319,Halter; Christopher P.,4,0,30,26
1713318208013,EDS 204R,B01,507331,Heinzman; Erica M.,28,0,30,2
1713318209040,EDS 206R,A00,507332,Staff,5,0,30,25
1713318209040,EDS 206R,B00,507343,Staff,28,0,30,2
1713318210071,EDS 250,A00,507344,Hemans; Patricia Ann Benitez,36,0,40,4
1713318211099,EDS 281,A00,507345,Daly; Alan J.,18,0,18,0
1713318212123,EDS 284,A00,507350,Daly; Alan J.,16,0,16,0
1713318213156,EDS 286,A00,507359,Fine; Sarah,18,0,18,0
1713318214181,EDS 289C,A01,507361,Daly; Alan J.,18,0,18,0
1713318215207,EDS 290,A00,507366,Hofstetter; Carolyn,15,0,15,0
1713318216231,LIGM 5A,A00,507421,Fischer-Grunski; Eva K,20,0,20,0
1713318217258,LIGM 5B,A00,507423,Fischer-Grunski; Eva K,20,0,20,0
1713318218282,LIGM 5C,A00,507425,Fischer-Grunski; Eva K,20,0,20,0
1713318219308,LIIT 5AS,A00,507427,Carnelos; Chiara,20,0,20,0
1713318220333,LIIT 5BS,A00,507430,Carnelos; Chiara,20,0,20,0
1713318221359,LIIT 5CS,A00,507432,Carnelos; Chiara,20,0,20,0
1713318222384,LISP 5A,A00,507541,Munoz Sanchez; Alicia,19,0,20,1
1713318223408,LISP 5B,A00,507671,Munoz Sanchez; Alicia,17,0,20,3
1713318224435,LISP 5C,A00,507696,Munoz Sanchez; Alicia,17,0,20,3
1713318225460,MAE 197,001,528363,Boechler; Nicholas Sebastia,9998,0,9999,1
1713318226487,MATH 197,001,523477,Kedlaya; Kiran S.,9999,0,9999,0
1713318226487,MATH 197,002,563811,Zhang; Danna,9999,0,9999,0
1713318227513,MCWP 40R,A00,518780,Staff,20,0,20,0
1713318227513,MCWP 40R,B00,518781,Staff,19,0,20,1
1713318227513,MCWP 40R,C00,518783,Staff,19,0,20,1
1713318228540,MCWP 50R,A00,518791,Staff,20,0,20,0
1713318228540,MCWP 50R,B00,518792,Staff,17,0,20,3
1713318228540,MCWP 50R,C00,518793,Staff,19,0,20,1
1713318228540,MCWP 50R,D00,518794,Staff,18,0,20,2
1713318228540,MCWP 50R,E00,518795,Staff,17,0,20,3
1713318228540,MCWP 50R,F00,518796,Staff,19,0,20,1
1713318228540,MCWP 50R,G00,518797,Staff,19,0,20,1
1713318229570,MMW 12R,A01,514034,Herbst; Matthew,15,0,16,1
1713318229570,MMW 12R,A02,514035,Herbst; Matthew,16,0,16,0
1713318230598,MMW 13R,A01,514037,Staff,12,0,16,4
1713318230598,MMW 13R,A02,514039,Staff,16,0,16,0
1713318232647,SIO 295LS,A00,523233,Staff,19,0,30,11
1713318233672,SIO 295S,A00,523232,Staff,19,0,30,11
1713318234698,SOCI 117,A01,494376,Staff,3,0,5,2
1713318235724,WES 237B,A00,494380,Staff,19,0,20,1
1713318237795,AESE 279B,A00,494370,Wade; Jon P,33,0,33,0
1713318238821,ANAR 135S,A00,494369,Braswell; Geoffrey E.,0,0,0,0
1713318239848,CAT 124RS,A01,519847,Geibel; William,17,0,20,3
1713318240874,CAT 125RS,A01,515971,Geibel; William,17,0,20,3
1713318241902,CLRE 250,A00,511389,Morris; Sheldon,9996,0,9999,3
1713318242932,CLRE 251,A00,507176,Mehta; Ravindra L.,9996,0,9999,3
1713318242932,CLRE 251,B00,511410,Mehta; Ravindra L.,9998,0,9999,1
1713318243962,CLRE 252,A00,507189,Cuomo; Raphael Eduardo,9998,0,9999,1
1713318244989,CLRE 253,A00,507199,Vaida; Florin,9997,0,9999,2
1713318244989,CLRE 253,B00,507202,Vaida; Florin,9999,0,9999,0
1713318246016,CLRE 259,A00,507211,Patel; Hemal,9996,0,9999,3
1713318247043,CLRE 260,A00,507221,Cuomo; Raphael Eduardo,9999,0,9999,0
1713318248069,CLRE 297,001,507242,Cuomo; Raphael Eduardo,9999,0,9999,0
1713318249094,CSE 191,A00,516875,Minnes Kemp; Mor Mia,9999,0,9999,0
1713318250125,CSS 201S,A01,494383,Staff,35,0,35,0
1713318251151,CSS 202S,A01,494387,Staff,35,0,35,0
1713318252176,EAP 100,A00,516065,Staff,9792,0,9999,207
1713318253202,ECE 45,A01,507414,Staff,54,0,60,6
1713318254228,ECE 100,A01,507416,Baghdadchi; Saharnaz,11,0,20,9
1713318254228,ECE 100,A02,507418,Baghdadchi; Saharnaz,20,0,20,0
1713318255254,ECE 111,A01,507420,Staff,40,0,50,10
1713318256283,ECE 197,001,548057,Sievenpiper; Daniel F.,9998,0,9999,1
1713318257310,EDS 115,A00,507243,Choi; Bailey Miyeon,28,0,28,0
1713318258338,EDS 117,A01,494379,Staff,24,0,25,1
1713318259363,EDS 125,A00,507246,Hopkins; Megan Beth,29,0,30,1
1713318260392,EDS 128A,A01,507264,Fargason; Sharon Gayle,26,0,26,0
1713318261423,EDS 128B,A01,507293,Pappas; Elizabeth,30,0,30,0
1713318262453,EDS 139,A00,507294,Fargason; Sharon Gayle,30,0,30,0
1713318262453,EDS 139,B00,507313,Pappas; Elizabeth,30,0,30,0
1713318263479,EDS 201,A00,507315,Staff,26,0,30,4
1713318264508,EDS 203,A01,507317,Halter; Christopher P.,26,0,30,4
1713318265534,EDS 204R,A01,507319,Halter; Christopher P.,4,0,30,26
1713318265534,EDS 204R,B01,507331,Heinzman; Erica M.,28,0,30,2
1713318266562,EDS 206R,A00,507332,Staff,5,0,30,25
1713318266562,EDS 206R,B00,507343,Staff,28,0,30,2
1713318267588,EDS 250,A00,507344,Hemans; Patricia Ann Benitez,36,0,40,4
1713318268615,EDS 281,A00,507345,Daly; Alan J.,18,0,18,0
1713318269694,EDS 284,A00,507350,Daly; Alan J.,16,0,16,0
1713318270719,EDS 286,A00,507359,Fine; Sarah,18,0,18,0
1713318271742,EDS 289C,A01,507361,Daly; Alan J.,18,0,18,0
1713318272772,EDS 290,A00,507366,Hofstetter; Carolyn,15,0,15,0
1713318273799,LIGM 5A,A00,507421,Fischer-Grunski; Eva K,20,0,20,0
1713318274828,LIGM 5B,A00,507423,Fischer-Grunski; Eva K,20,0,20,0
1713318275854,LIGM 5C,A00,507425,Fischer-Grunski; Eva K,20,0,20,0
1713318276883,LIIT 5AS,A00,507427,Carnelos; Chiara,20,0,20,0
1713318277911,LIIT 5BS,A00,507430,Carnelos; Chiara,20,0,20,0
1713318278935,LIIT 5CS,A00,507432,Carnelos; Chiara,20,0,20,0
1713318279961,LISP 5A,A00,507541,Munoz Sanchez; Alicia,19,0,20,1
1713318280986,LISP 5B,A00,507671,Munoz Sanchez; Alicia,17,0,20,3
1713318282016,LISP 5C,A00,507696,Munoz Sanchez; Alicia,17,0,20,3
1713318283040,MAE 197,001,528363,Boechler; Nicholas Sebastia,9998,0,9999,1
1713318284065,MATH 197,001,523477,Kedlaya; Kiran S.,9999,0,9999,0
1713318284065,MATH 197,002,563811,Zhang; Danna,9999,0,9999,0
1713318285094,MCWP 40R,A00,518780,Staff,20,0,20,0
1713318285094,MCWP 40R,B00,518781,Staff,19,0,20,1
1713318285094,MCWP 40R,C00,518783,Staff,19,0,20,1
1713318286122,MCWP 50R,A00,518791,Staff,20,0,20,0
1713318286122,MCWP 50R,B00,518792,Staff,17,0,20,3
1713318286122,MCWP 50R,C00,518793,Staff,19,0,20,1
1713318286122,MCWP 50R,D00,518794,Staff,18,0,20,2
1713318286122,MCWP 50R,E00,518795,Staff,17,0,20,3
1713318286122,MCWP 50R,F00,518796,Staff,19,0,20,1
1713318286122,MCWP 50R,G00,518797,Staff,19,0,20,1
1713318287148,MMW 12R,A01,514034,Herbst; Matthew,15,0,16,1
1713318287148,MMW 12R,A02,514035,Herbst; Matthew,16,0,16,0
1713318288173,MMW 13R,A01,514037,Staff,12,0,16,4
1713318288173,MMW 13R,A02,514039,Staff,16,0,16,0
1713318290227,SIO 295LS,A00,523233,Staff,19,0,30,11
1713318291253,SIO 295S,A00,523232,Staff,19,0,30,11
1713318292280,SOCI 117,A01,494376,Staff,3,0,5,2
1713318293309,WES 237B,A00,494380,Staff,19,0,20,1
1713318295419,AESE 279B,A00,494370,Wade; Jon P,33,0,33,0
1713318296445,ANAR 135S,A00,494369,Braswell; Geoffrey E.,0,0,0,0
1713318297469,CAT 124RS,A01,519847,Geibel; William,17,0,20,3
1713318298498,CAT 125RS,A01,515971,Geibel; William,17,0,20,3
1713318299523,CLRE 250,A00,511389,Morris; Sheldon,9996,0,9999,3
1713318300550,CLRE 251,A00,507176,Mehta; Ravindra L.,9996,0,9999,3
1713318300550,CLRE 251,B00,511410,Mehta; Ravindra L.,9998,0,9999,1
1713318301574,CLRE 252,A00,507189,Cuomo; Raphael Eduardo,9998,0,9999,1
1713318302598,CLRE 253,A00,507199,Vaida; Florin,9997,0,9999,2
1713318302598,CLRE 253,B00,507202,Vaida; Florin,9999,0,9999,0
1713318303628,CLRE 259,A00,507211,Patel; Hemal,9996,0,9999,3
1713318304654,CLRE 260,A00,507221,Cuomo; Raphael Eduardo,9999,0,9999,0
1713318305681,CLRE 297,001,507242,Cuomo; Raphael Eduardo,9999,0,9999,0
1713318306704,CSE 191,A00,516875,Minnes Kemp; Mor Mia,9999,0,9999,0
1713318307730,CSS 201S,A01,494383,Staff,35,0,35,0
1713318308756,CSS 202S,A01,494387,Staff,35,0,35,0
1713318309781,EAP 100,A00,516065,Staff,9792,0,9999,207
1713318310816,ECE 45,A01,507414,Staff,54,0,60,6
1713318311841,ECE 100,A01,507416,Baghdadchi; Saharnaz,11,0,20,9
1713318311841,ECE 100,A02,507418,Baghdadchi; Saharnaz,20,0,20,0
1713318312871,ECE 111,A01,507420,Staff,40,0,50,10
1713318313903,ECE 197,001,548057,Sievenpiper; Daniel F.,9998,0,9999,1
1713318314931,EDS 115,A00,507243,Choi; Bailey Miyeon,28,0,28,0
1713318315956,EDS 117,A01,494379,Staff,24,0,25,1
1713318316982,EDS 125,A00,507246,Hopkins; Megan Beth,29,0,30,1
1713318318008,EDS 128A,A01,507264,Fargason; Sharon Gayle,26,0,26,0
1713318319038,EDS 128B,A01,507293,Pappas; Elizabeth,30,0,30,0
1713318320067,EDS 139,A00,507294,Fargason; Sharon Gayle,30,0,30,0
1713318320067,EDS 139,B00,507313,Pappas; Elizabeth,30,0,30,0
1713318321093,EDS 201,A00,507315,Staff,26,0,30,4
1713318322120,EDS 203,A01,507317,Halter; Christopher P.,26,0,30,4
1713318323145,EDS 204R,A01,507319,Halter; Christopher P.,4,0,30,26
1713318323145,EDS 204R,B01,507331,Heinzman; Erica M.,28,0,30,2
1713318324170,EDS 206R,A00,507332,Staff,5,0,30,25
1713318324170,EDS 206R,B00,507343,Staff,28,0,30,2
1713318325196,EDS 250,A00,507344,Hemans; Patricia Ann Benitez,36,0,40,4
1713318326226,EDS 281,A00,507345,Daly; Alan J.,18,0,18,0
1713318327250,EDS 284,A00,507350,Daly; Alan J.,16,0,16,0
1713318328393,EDS 286,A00,507359,Fine; Sarah,18,0,18,0
1713318329422,EDS 289C,A01,507361,Daly; Alan J.,18,0,18,0
1713318330447,EDS 290,A00,507366,Hofstetter; Carolyn,15,0,15,0
1713318331478,LIGM 5A,A00,507421,Fischer-Grunski; Eva K,20,0,20,0
1713318332508,LIGM 5B,A00,507423,Fischer-Grunski; Eva K,20,0,20,0
1713318333536,LIGM 5C,A00,507425,Fischer-Grunski; Eva K,20,0,20,0
1713318334565,LIIT 5AS,A00,507427,Carnelos; Chiara,20,0,20,0
1713318335590,LIIT 5BS,A00,507430,Carnelos; Chiara,20,0,20,0
1713318336615,LIIT 5CS,A00,507432,Carnelos; Chiara,20,0,20,0
1713318337646,LISP 5A,A00,507541,Munoz Sanchez; Alicia,19,0,20,1
1713318338674,LISP 5B,A00,507671,Munoz Sanchez; Alicia,17,0,20,3
1713318339699,LISP 5C,A00,507696,Munoz Sanchez; Alicia,17,0,20,3
1713318340726,MAE 197,001,528363,Boechler; Nicholas Sebastia,9998,0,9999,1
1713318341757,MATH 197,001,523477,Kedlaya; Kiran S.,9999,0,9999,0
1713318341757,MATH 197,002,563811,Zhang; Danna,9999,0,9999,0
1713318342784,MCWP 40R,A00,518780,Staff,20,0,20,0
1713318342784,MCWP 40R,B00,518781,Staff,19,0,20,1
1713318342784,MCWP 40R,C00,518783,Staff,19,0,20,1
1713318343814,MCWP 50R,A00,518791,Staff,20,0,20,0
1713318343814,MCWP 50R,B00,518792,Staff,17,0,20,3
1713318343814,MCWP 50R,C00,518793,Staff,19,0,20,1
1713318343814,MCWP 50R,D00,518794,Staff,18,0,20,2
1713318343814,MCWP 50R,E00,518795,Staff,17,0,20,3
1713318343814,MCWP 50R,F00,518796,Staff,19,0,20,1
1713318343814,MCWP 50R,G00,518797,Staff,19,0,20,1
1713318344843,MMW 12R,A01,514034,Herbst; Matthew,15,0,16,1
1713318344843,MMW 12R,A02,514035,Herbst; Matthew,16,0,16,0
1713318345869,MMW 13R,A01,514037,Staff,12,0,16,4
1713318345869,MMW 13R,A02,514039,Staff,16,0,16,0
1713318347922,SIO 295LS,A00,523233,Staff,19,0,30,11
1713318348950,SIO 295S,A00,523232,Staff,19,0,30,11
1713318349976,SOCI 117,A01,494376,Staff,3,0,5,2
1713318351001,WES 237B,A00,494380,Staff,19,0,20,1
1713318353067,AESE 279B,A00,494370,Wade; Jon P,33,0,33,0
1713318354091,ANAR 135S,A00,494369,Braswell; Geoffrey E.,0,0,0,0
1713318355118,CAT 124RS,A01,519847,Geibel; William,17,0,20,3
1713318356146,CAT 125RS,A01,515971,Geibel; William,17,0,20,3
1713318357172,CLRE 250,A00,511389,Morris; Sheldon,9996,0,9999,3
1713318358200,CLRE 251,A00,507176,Mehta; Ravindra L.,9996,0,9999,3
1713318358200,CLRE 251,B00,511410,Mehta; Ravindra L.,9998,0,9999,1
1713318359225,CLRE 252,A00,507189,Cuomo; Raphael Eduardo,9998,0,9999,1
1713318360250,CLRE 253,A00,507199,Vaida; Florin,9997,0,9999,2
1713318360250,CLRE 253,B00,507202,Vaida; Florin,9999,0,9999,0
1713318361276,CLRE 259,A00,507211,Patel; Hemal,9996,0,9999,3
1713318362301,CLRE 260,A00,507221,Cuomo; Raphael Eduardo,9999,0,9999,0
1713318363326,CLRE 297,001,507242,Cuomo; Raphael Eduardo,9999,0,9999,0
1713318364354,CSE 191,A00,516875,Minnes Kemp; Mor Mia,9999,0,9999,0
1713318365380,CSS 201S,A01,494383,Staff,35,0,35,0
1713318366405,CSS 202S,A01,494387,Staff,35,0,35,0
1713318367433,EAP 100,A00,516065,Staff,9792,0,9999,207
1713318368459,ECE 45,A01,507414,Staff,54,0,60,6
1713318369490,ECE 100,A01,507416,Baghdadchi; Saharnaz,11,0,20,9
1713318369490,ECE 100,A02,507418,Baghdadchi; Saharnaz,20,0,20,0
1713318370518,ECE 111,A01,507420,Staff,40,0,50,10
1713318371544,ECE 197,001,548057,Sievenpiper; Daniel F.,9998,0,9999,1
1713318372572,EDS 115,A00,507243,Choi; Bailey Miyeon,28,0,28,0
1713318373651,EDS 117,A01,494379,Staff,24,0,25,1
1713318374680,EDS 125,A00,507246,Hopkins; Megan Beth,29,0,30,1
1713318375706,EDS 128A,A01,507264,Fargason; Sharon Gayle,26,0,26,0
1713318376731,EDS 128B,A01,507293,Pappas; Elizabeth,30,0,30,0
1713318377755,EDS 139,A00,507294,Fargason; Sharon Gayle,30,0,30,0
1713318377755,EDS 139,B00,507313,Pappas; Elizabeth,30,0,30,0
1713318378779,EDS 201,A00,507315,Staff,26,0,30,4
1713318379805,EDS 203,A01,507317,Halter; Christopher P.,26,0,30,4
1713318380882,EDS 204R,A01,507319,Halter; Christopher P.,4,0,30,26
1713318380882,EDS 204R,B01,507331,Heinzman; Erica M.,28,0,30,2
1713318381906,EDS 206R,A00,507332,Staff,5,0,30,25
1713318381906,EDS 206R,B00,507343,Staff,28,0,30,2
1713318382936,EDS 250,A00,507344,Hemans; Patricia Ann Benitez,36,0,40,4
1713318383962,EDS 281,A00,507345,Daly; Alan J.,18,0,18,0
1713318384989,EDS 284,A00,507350,Daly; Alan J.,16,0,16,0
1713318386019,EDS 286,A00,507359,Fine; Sarah,18,0,18,0
1713318387047,EDS 289C,A01,507361,Daly; Alan J.,18,0,18,0
1713318388074,EDS 290,A00,507366,Hofstetter; Carolyn,15,0,15,0
1713318389109,LIGM 5A,A00,507421,Fischer-Grunski; Eva K,20,0,20,0
1713318390135,LIGM 5B,A00,507423,Fischer-Grunski; Eva K,20,0,20,0
1713318391160,LIGM 5C,A00,507425,Fischer-Grunski; Eva K,20,0,20,0
1713318392188,LIIT 5AS,A00,507427,Carnelos; Chiara,20,0,20,0
1713318393216,LIIT 5BS,A00,507430,Carnelos; Chiara,20,0,20,0
1713318394242,LIIT 5CS,A00,507432,Carnelos; Chiara,20,0,20,0
1713318395270,LISP 5A,A00,507541,Munoz Sanchez; Alicia,19,0,20,1
1713318396301,LISP 5B,A00,507671,Munoz Sanchez; Alicia,17,0,20,3
1713318397326,LISP 5C,A00,507696,Munoz Sanchez; Alicia,17,0,20,3
1713318398351,MAE 197,001,528363,Boechler; Nicholas Sebastia,9998,0,9999,1
1713318399375,MATH 197,001,523477,Kedlaya; Kiran S.,9999,0,9999,0
1713318399375,MATH 197,002,563811,Zhang; Danna,9999,0,9999,0
1713318400401,MCWP 40R,A00,518780,Staff,20,0,20,0
1713318400401,MCWP 40R,B00,518781,Staff,19,0,20,1
1713318400401,MCWP 40R,C00,518783,Staff,19,0,20,1
1713318401431,MCWP 50R,A00,518791,Staff,20,0,20,0
1713318401431,MCWP 50R,B00,518792,Staff,17,0,20,3
1713318401431,MCWP 50R,C00,518793,Staff,19,0,20,1
1713318401431,MCWP 50R,D00,518794,Staff,18,0,20,2
1713318401431,MCWP 50R,E00,518795,Staff,17,0,20,3
1713318401431,MCWP 50R,F00,518796,Staff,19,0,20,1
1713318401431,MCWP 50R,G00,518797,Staff,19,0,20,1
1713318402458,MMW 12R,A01,514034,Herbst; Matthew,15,0,16,1
1713318402458,MMW 12R,A02,514035,Herbst; Matthew,16,0,16,0
1713318403483,MMW 13R,A01,514037,Staff,12,0,16,4
1713318403483,MMW 13R,A02,514039,Staff,16,0,16,0
1713318405536,SIO 295LS,A00,523233,Staff,19,0,30,11
1713318406561,SIO 295S,A00,523232,Staff,19,0,30,11
1713318407586,SOCI 117,A01,494376,Staff,3,0,5,2
1713318408612,WES 237B,A00,494380,Staff,19,0,20,1
1713318410679,AESE 279B,A00,494370,Wade; Jon P,33,0,33,0
1713318411704,ANAR 135S,A00,494369,Braswell; Geoffrey E.,0,0,0,0
1713318412731,CAT 124RS,A01,519847,Geibel; William,17,0,20,3
1713318413758,CAT 125RS,A01,515971,Geibel; William,17,0,20,3
1713318414784,CLRE 250,A00,511389,Morris; Sheldon,9996,0,9999,3
1713318415811,CLRE 251,A00,507176,Mehta; Ravindra L.,9996,0,9999,3
1713318415811,CLRE 251,B00,511410,Mehta; Ravindra L.,9998,0,9999,1
1713318416837,CLRE 252,A00,507189,Cuomo; Raphael Eduardo,9998,0,9999,1
1713318417866,CLRE 253,A00,507199,Vaida; Florin,9997,0,9999,2
1713318417866,CLRE 253,B00,507202,Vaida; Florin,9999,0,9999,0
1713318418894,CLRE 259,A00,507211,Patel; Hemal,9996,0,9999,3
1713318419919,CLRE 260,A00,507221,Cuomo; Raphael Eduardo,9999,0,9999,0
1713318420947,CLRE 297,001,507242,Cuomo; Raphael Eduardo,9999,0,9999,0
1713318421973,CSE 191,A00,516875,Minnes Kemp; Mor Mia,9999,0,9999,0
1713318423004,CSS 201S,A01,494383,Staff,35,0,35,0
1713318424032,CSS 202S,A01,494387,Staff,35,0,35,0
1713318425057,EAP 100,A00,516065,Staff,9792,0,9999,207
1713318426086,ECE 45,A01,507414,Staff,54,0,60,6
1713318427112,ECE 100,A01,507416,Baghdadchi; Saharnaz,11,0,20,9
1713318427112,ECE 100,A02,507418,Baghdadchi; Saharnaz,20,0,20,0
1713318428139,ECE 111,A01,507420,Staff,40,0,50,10
1713318429168,ECE 197,001,548057,Sievenpiper; Daniel F.,9998,0,9999,1
1713318430194,EDS 115,A00,507243,Choi; Bailey Miyeon,28,0,28,0
1713318431219,EDS 117,A01,494379,Staff,24,0,25,1
1713318432246,EDS 125,A00,507246,Hopkins; Megan Beth,29,0,30,1
1713318433273,EDS 128A,A01,507264,Fargason; Sharon Gayle,26,0,26,0
1713318434305,EDS 128B,A01,507293,Pappas; Elizabeth,30,0,30,0
1713318435330,EDS 139,A00,507294,Fargason; Sharon Gayle,30,0,30,0
1713318435330,EDS 139,B00,507313,Pappas; Elizabeth,30,0,30,0
1713318436356,EDS 201,A00,507315,Staff,26,0,30,4
1713318437382,EDS 203,A01,507317,Halter; Christopher P.,26,0,30,4
1713318438410,EDS 204R,A01,507319,Halter; Christopher P.,4,0,30,26
1713318438410,EDS 204R,B01,507331,Heinzman; Erica M.,28,0,30,2
1713318439436,EDS 206R,A00,507332,Staff,5,0,30,25
1713318439436,EDS 206R,B00,507343,Staff,28,0,30,2
1713318440461,EDS 250,A00,507344,Hemans; Patricia Ann Benitez,36,0,40,4
1713318441484,EDS 281,A00,507345,Daly; Alan J.,18,0,18,0
1713318442511,EDS 284,A00,507350,Daly; Alan J.,16,0,16,0
1713318443537,EDS 286,A00,507359,Fine; Sarah,18,0,18,0
1713318444560,EDS 289C,A01,507361,Daly; Alan J.,18,0,18,0
1713318445590,EDS 290,A00,507366,Hofstetter; Carolyn,15,0,15,0
1713318446620,LIGM 5A,A00,507421,Fischer-Grunski; Eva K,20,0,20,0
1713318447645,LIGM 5B,A00,507423,Fischer-Grunski; Eva K,20,0,20,0
1713318448670,LIGM 5C,A00,507425,Fischer-Grunski; Eva K,20,0,20,0
1713318449697,LIIT 5AS,A00,507427,Carnelos; Chiara,20,0,20,0
1713318450726,LIIT 5BS,A00,507430,Carnelos; Chiara,20,0,20,0
1713318451751,LIIT 5CS,A00,507432,Carnelos; Chiara,20,0,20,0
1713318452778,LISP 5A,A00,507541,Munoz Sanchez; Alicia,19,0,20,1
1713318453804,LISP 5B,A00,507671,Munoz Sanchez; Alicia,17,0,20,3
1713318454830,LISP 5C,A00,507696,Munoz Sanchez; Alicia,17,0,20,3
1713318455857,MAE 197,001,528363,Boechler; Nicholas Sebastia,9998,0,9999,1
1713318456883,MATH 197,001,523477,Kedlaya; Kiran S.,9999,0,9999,0
1713318456883,MATH 197,002,563811,Zhang; Danna,9999,0,9999,0
1713318457908,MCWP 40R,A00,518780,Staff,20,0,20,0
1713318457908,MCWP 40R,B00,518781,Staff,19,0,20,1
1713318457908,MCWP 40R,C00,518783,Staff,19,0,20,1
1713318458935,MCWP 50R,A00,518791,Staff,20,0,20,0
1713318458935,MCWP 50R,B00,518792,Staff,17,0,20,3
1713318458935,MCWP 50R,C00,518793,Staff,19,0,20,1
1713318458935,MCWP 50R,D00,518794,Staff,18,0,20,2
1713318458935,MCWP 50R,E00,518795,Staff,17,0,20,3
1713318458935,MCWP 50R,F00,518796,Staff,19,0,20,1
1713318458935,MCWP 50R,G00,518797,Staff,19,0,20,1
1713318459961,MMW 12R,A01,514034,Herbst; Matthew,15,0,16,1
1713318459961,MMW 12R,A02,514035,Herbst; Matthew,16,0,16,0
1713318460988,MMW 13R,A01,514037,Staff,12,0,16,4
1713318460988,MMW 13R,A02,514039,Staff,16,0,16,0
1713318463041,SIO 295LS,A00,523233,Staff,19,0,30,11
1713318464065,SIO 295S,A00,523232,Staff,19,0,30,11
1713318465091,SOCI 117,A01,494376,Staff,3,0,5,2
1713318466116,WES 237B,A00,494380,Staff,19,0,20,1
1713318468181,AESE 279B,A00,494370,Wade; Jon P,33,0,33,0
1713318469206,ANAR 135S,A00,494369,Braswell; Geoffrey E.,0,0,0,0
1713318470269,CAT 124RS,A01,519847,Geibel; William,17,0,20,3
1713318471295,CAT 125RS,A01,515971,Geibel; William,17,0,20,3
1713318472326,CLRE 250,A00,511389,Morris; Sheldon,9996,0,9999,3
1713318473356,CLRE 251,A00,507176,Mehta; Ravindra L.,9996,0,9999,3
1713318473356,CLRE 251,B00,511410,Mehta; Ravindra L.,9998,0,9999,1
1713318474385,CLRE 252,A00,507189,Cuomo; Raphael Eduardo,9998,0,9999,1
1713318475412,CLRE 253,A00,507199,Vaida; Florin,9997,0,9999,2
1713318475412,CLRE 253,B00,507202,Vaida; Florin,9999,0,9999,0
1713318476436,CLRE 259,A00,507211,Patel; Hemal,9996,0,9999,3
1713318477531,CLRE 260,A00,507221,Cuomo; Raphael Eduardo,9999,0,9999,0
1713318478557,CLRE 297,001,507242,Cuomo; Raphael Eduardo,9999,0,9999,0
1713318479583,CSE 191,A00,516875,Minnes Kemp; Mor Mia,9999,0,9999,0
1713318480609,CSS 201S,A01,494383,Staff,35,0,35,0
1713318481636,CSS 202S,A01,494387,Staff,35,0,35,0
1713318482661,EAP 100,A00,516065,Staff,9792,0,9999,207
1713318483686,ECE 45,A01,507414,Staff,54,0,60,6
1713318484715,ECE 100,A01,507416,Baghdadchi; Saharnaz,11,0,20,9
1713318484715,ECE 100,A02,507418,Baghdadchi; Saharnaz,20,0,20,0
1713318485746,ECE 111,A01,507420,Staff,40,0,50,10
1713318486770,ECE 197,001,548057,Sievenpiper; Daniel F.,9998,0,9999,1
1713318487796,EDS 115,A00,507243,Choi; Bailey Miyeon,28,0,28,0
1713318488821,EDS 117,A01,494379,Staff,24,0,25,1
1713318489850,EDS 125,A00,507246,Hopkins; Megan Beth,29,0,30,1
1713318490874,EDS 128A,A01,507264,Fargason; Sharon Gayle,26,0,26,0
1713318491903,EDS 128B,A01,507293,Pappas; Elizabeth,30,0,30,0
1713318492929,EDS 139,A00,507294,Fargason; Sharon Gayle,30,0,30,0
1713318492929,EDS 139,B00,507313,Pappas; Elizabeth,30,0,30,0
1713318493957,EDS 201,A00,507315,Staff,26,0,30,4
1713318494982,EDS 203,A01,507317,Halter; Christopher P.,26,0,30,4
1713318496006,EDS 204R,A01,507319,Halter; Christopher P.,4,0,30,26
1713318496006,EDS 204R,B01,507331,Heinzman; Erica M.,28,0,30,2
1713318497029,EDS 206R,A00,507332,Staff,5,0,30,25
1713318497029,EDS 206R,B00,507343,Staff,28,0,30,2
1713318498261,EDS 250,A00,507344,Hemans; Patricia Ann Benitez,36,0,40,4
1713318499289,EDS 281,A00,507345,Daly; Alan J.,18,0,18,0
1713318500324,EDS 284,A00,507350,Daly; Alan J.,16,0,16,0
1713318501349,EDS 286,A00,507359,Fine; Sarah,18,0,18,0
1713318502377,EDS 289C,A01,507361,Daly; Alan J.,18,0,18,0
1713318503406,EDS 290,A00,507366,Hofstetter; Carolyn,15,0,15,0
1713318504436,LIGM 5A,A00,507421,Fischer-Grunski; Eva K,20,0,20,0
1713318505462,LIGM 5B,A00,507423,Fischer-Grunski; Eva K,20,0,20,0
1713318506487,LIGM 5C,A00,507425,Fischer-Grunski; Eva K,20,0,20,0
1713318507516,LIIT 5AS,A00,507427,Carnelos; Chiara,20,0,20,0
1713318508541,LIIT 5BS,A00,507430,Carnelos; Chiara,20,0,20,0
1713318509571,LIIT 5CS,A00,507432,Carnelos; Chiara,20,0,20,0
1713318510597,LISP 5A,A00,507541,Munoz Sanchez; Alicia,19,0,20,1
1713318511626,LISP 5B,A00,507671,Munoz Sanchez; Alicia,17,0,20,3
1713318512650,LISP 5C,A00,507696,Munoz Sanchez; Alicia,17,0,20,3
1713318513676,MAE 197,001,528363,Boechler; Nicholas Sebastia,9998,0,9999,1
1713318514703,MATH 197,001,523477,Kedlaya; Kiran S.,9999,0,9999,0
1713318514703,MATH 197,002,563811,Zhang; Danna,9999,0,9999,0
1713318515727,MCWP 40R,A00,518780,Staff,20,0,20,0
1713318515727,MCWP 40R,B00,518781,Staff,19,0,20,1
1713318515727,MCWP 40R,C00,518783,Staff,19,0,20,1
1713318516758,MCWP 50R,A00,518791,Staff,20,0,20,0
1713318516758,MCWP 50R,B00,518792,Staff,17,0,20,3
1713318516758,MCWP 50R,C00,518793,Staff,19,0,20,1
1713318516758,MCWP 50R,D00,518794,Staff,18,0,20,2
1713318516758,MCWP 50R,E00,518795,Staff,17,0,20,3
1713318516758,MCWP 50R,F00,518796,Staff,19,0,20,1
1713318516758,MCWP 50R,G00,518797,Staff,19,0,20,1
1713318517783,MMW 12R,A01,514034,Herbst; Matthew,15,0,16,1
1713318517783,MMW 12R,A02,514035,Herbst; Matthew,16,0,16,0
1713318518812,MMW 13R,A01,514037,Staff,12,0,16,4
1713318518812,MMW 13R,A02,514039,Staff,16,0,16,0
1713318520867,SIO 295LS,A00,523233,Staff,19,0,30,11
1713318521894,SIO 295S,A00,523232,Staff,19,0,30,11
1713318522925,SOCI 117,A01,494376,Staff,3,0,5,2
1713318523952,WES 237B,A00,494380,Staff,19,0,20,1
1713318526034,AESE 279B,A00,494370,Wade; Jon P,33,0,33,0
1713318527063,ANAR 135S,A00,494369,Braswell; Geoffrey E.,0,0,0,0
1713318528090,CAT 124RS,A01,519847,Geibel; William,17,0,20,3
1713318529120,CAT 125RS,A01,515971,Geibel; William,17,0,20,3
1713318530146,CLRE 250,A00,511389,Morris; Sheldon,9996,0,9999,3
1713318531170,CLRE 251,A00,507176,Mehta; Ravindra L.,9996,0,9999,3
1713318531170,CLRE 251,B00,511410,Mehta; Ravindra L.,9998,0,9999,1
1713318532196,CLRE 252,A00,507189,Cuomo; Raphael Eduardo,9998,0,9999,1
1713318533221,CLRE 253,A00,507199,Vaida; Florin,9997,0,9999,2
1713318533221,CLRE 253,B00,507202,Vaida; Florin,9999,0,9999,0
1713318534250,CLRE 259,A00,507211,Patel; Hemal,9996,0,9999,3
1713318535276,CLRE 260,A00,507221,Cuomo; Raphael Eduardo,9999,0,9999,0
1713318536304,CLRE 297,001,507242,Cuomo; Raphael Eduardo,9999,0,9999,0
1713318537329,CSE 191,A00,516875,Minnes Kemp; Mor Mia,9999,0,9999,0
1713318538354,CSS 201S,A01,494383,Staff,35,0,35,0
1713318539380,CSS 202S,A01,494387,Staff,35,0,35,0
1713318540405,EAP 100,A00,516065,Staff,9792,0,9999,207
1713318541434,ECE 45,A01,507414,Staff,54,0,60,6
1713318542460,ECE 100,A01,507416,Baghdadchi; Saharnaz,11,0,20,9
1713318542460,ECE 100,A02,507418,Baghdadchi; Saharnaz,20,0,20,0
1713318543487,ECE 111,A01,507420,Staff,40,0,50,10
1713318544513,ECE 197,001,548057,Sievenpiper; Daniel F.,9998,0,9999,1
1713318545540,EDS 115,A00,507243,Choi; Bailey Miyeon,28,0,28,0
1713318546571,EDS 117,A01,494379,Staff,24,0,25,1
1713318547600,EDS 125,A00,507246,Hopkins; Megan Beth,29,0,30,1
1713318548627,EDS 128A,A01,507264,Fargason; Sharon Gayle,26,0,26,0
1713318549655,EDS 128B,A01,507293,Pappas; Elizabeth,30,0,30,0
1713318550680,EDS 139,A00,507294,Fargason; Sharon Gayle,30,0,30,0
1713318550680,EDS 139,B00,507313,Pappas; Elizabeth,30,0,30,0
1713318551704,EDS 201,A00,507315,Staff,26,0,30,4
1713318552732,EDS 203,A01,507317,Halter; Christopher P.,26,0,30,4
1713318553763,EDS 204R,A01,507319,Halter; Christopher P.,4,0,30,26
1713318553763,EDS 204R,B01,507331,Heinzman; Erica M.,28,0,30,2
1713318554793,EDS 206R,A00,507332,Staff,5,0,30,25
1713318554793,EDS 206R,B00,507343,Staff,28,0,30,2
1713318555818,EDS 250,A00,507344,Hemans; Patricia Ann Benitez,36,0,40,4
1713318556844,EDS 281,A00,507345,Daly; Alan J.,18,0,18,0
1713318557870,EDS 284,A00,507350,Daly; Alan J.,16,0,16,0
1713318558895,EDS 286,A00,507359,Fine; Sarah,18,0,18,0
1713318559927,EDS 289C,A01,507361,Daly; Alan J.,18,0,18,0
1713318560952,EDS 290,A00,507366,Hofstetter; Carolyn,15,0,15,0
1713318561976,LIGM 5A,A00,507421,Fischer-Grunski; Eva K,20,0,20,0
1713318563003,LIGM 5B,A00,507423,Fischer-Grunski; Eva K,20,0,20,0
1713318564036,LIGM 5C,A00,507425,Fischer-Grunski; Eva K,20,0,20,0
1713318565065,LIIT 5AS,A00,507427,Carnelos; Chiara,20,0,20,0
1713318566094,LIIT 5BS,A00,507430,Carnelos; Chiara,20,0,20,0
1713318567123,LIIT 5CS,A00,507432,Carnelos; Chiara,20,0,20,0
1713318568152,LISP 5A,A00,507541,Munoz Sanchez; Alicia,19,0,20,1
1713318569180,LISP 5B,A00,507671,Munoz Sanchez; Alicia,17,0,20,3
1713318570209,LISP 5C,A00,507696,Munoz Sanchez; Alicia,17,0,20,3
1713318571240,MAE 197,001,528363,Boechler; Nicholas Sebastia,9998,0,9999,1
1713318572271,MATH 197,001,523477,Kedlaya; Kiran S.,9999,0,9999,0
1713318572271,MATH 197,002,563811,Zhang; Danna,9999,0,9999,0
1713318573298,MCWP 40R,A00,518780,Staff,20,0,20,0
1713318573298,MCWP 40R,B00,518781,Staff,19,0,20,1
1713318573298,MCWP 40R,C00,518783,Staff,19,0,20,1
1713318574328,MCWP 50R,A00,518791,Staff,20,0,20,0
1713318574328,MCWP 50R,B00,518792,Staff,17,0,20,3
1713318574328,MCWP 50R,C00,518793,Staff,19,0,20,1
1713318574328,MCWP 50R,D00,518794,Staff,18,0,20,2
1713318574328,MCWP 50R,E00,518795,Staff,17,0,20,3
1713318574328,MCWP 50R,F00,518796,Staff,19,0,20,1
1713318574328,MCWP 50R,G00,518797,Staff,19,0,20,1
1713318575353,MMW 12R,A01,514034,Herbst; Matthew,15,0,16,1
1713318575353,MMW 12R,A02,514035,Herbst; Matthew,16,0,16,0
1713318576378,MMW 13R,A01,514037,Staff,12,0,16,4
1713318576378,MMW 13R,A02,514039,Staff,16,0,16,0
1713318578429,SIO 295LS,A00,523233,Staff,19,0,30,11
1713318579456,SIO 295S,A00,523232,Staff,19,0,30,11
1713318580482,SOCI 117,A01,494376,Staff,3,0,5,2
1713318581565,WES 237B,A00,494380,Staff,19,0,20,1
1713318583639,AESE 279B,A00,494370,Wade; Jon P,33,0,33,0
1713318584668,ANAR 135S,A00,494369,Braswell; Geoffrey E.,0,0,0,0
1713318585691,CAT 124RS,A01,519847,Geibel; William,17,0,20,3
1713318586716,CAT 125RS,A01,515971,Geibel; William,17,0,20,3
1713318587743,CLRE 250,A00,511389,Morris; Sheldon,9996,0,9999,3
1713318588772,CLRE 251,A00,507176,Mehta; Ravindra L.,9996,0,9999,3
1713318588772,CLRE 251,B00,511410,Mehta; Ravindra L.,9998,0,9999,1
1713318589801,CLRE 252,A00,507189,Cuomo; Raphael Eduardo,9998,0,9999,1
1713318590827,CLRE 253,A00,507199,Vaida; Florin,9997,0,9999,2
1713318590827,CLRE 253,B00,507202,Vaida; Florin,9999,0,9999,0
1713318591855,CLRE 259,A00,507211,Patel; Hemal,9996,0,9999,3
1713318592885,CLRE 260,A00,507221,Cuomo; Raphael Eduardo,9999,0,9999,0
1713318593911,CLRE 297,001,507242,Cuomo; Raphael Eduardo,9999,0,9999,0
1713318594938,CSE 191,A00,516875,Minnes Kemp; Mor Mia,9999,0,9999,0
1713318595968,CSS 201S,A01,494383,Staff,35,0,35,0
1713318596993,CSS 202S,A01,494387,Staff,35,0,35,0
1713318598022,EAP 100,A00,516065,Staff,9792,0,9999,207
1713318599051,ECE 45,A01,507414,Staff,54,0,60,6
1713318600084,ECE 100,A01,507416,Baghdadchi; Saharnaz,11,0,20,9
1713318600084,ECE 100,A02,507418,Baghdadchi; Saharnaz,20,0,20,0
1713318601109,ECE 111,A01,507420,Staff,40,0,50,10
1713318602137,ECE 197,001,548057,Sievenpiper; Daniel F.,9998,0,9999,1
1713318603161,EDS 115,A00,507243,Choi; Bailey Miyeon,28,0,28,0
1713318604189,EDS 117,A01,494379,Staff,24,0,25,1
1713318605213,EDS 125,A00,507246,Hopkins; Megan Beth,29,0,30,1
1713318606242,EDS 128A,A01,507264,Fargason; Sharon Gayle,26,0,26,0
1713318607268,EDS 128B,A01,507293,Pappas; Elizabeth,30,0,30,0
1713318608297,EDS 139,A00,507294,Fargason; Sharon Gayle,30,0,30,0
1713318608297,EDS 139,B00,507313,Pappas; Elizabeth,30,0,30,0
1713318609320,EDS 201,A00,507315,Staff,26,0,30,4
1713318610345,EDS 203,A01,507317,Halter; Christopher P.,26,0,30,4
1713318611373,EDS 204R,A01,507319,Halter; Christopher P.,4,0,30,26
1713318611373,EDS 204R,B01,507331,Heinzman; Erica M.,28,0,30,2
1713318612400,EDS 206R,A00,507332,Staff,5,0,30,25
1713318612400,EDS 206R,B00,507343,Staff,28,0,30,2
1713318613425,EDS 250,A00,507344,Hemans; Patricia Ann Benitez,36,0,40,4
1713318614450,EDS 281,A00,507345,Daly; Alan J.,18,0,18,0
1713318615475,EDS 284,A00,507350,Daly; Alan J.,16,0,16,0
1713318616502,EDS 286,A00,507359,Fine; Sarah,18,0,18,0
1713318617527,EDS 289C,A01,507361,Daly; Alan J.,18,0,18,0
1713318618550,EDS 290,A00,507366,Hofstetter; Carolyn,15,0,15,0
1713318619577,LIGM 5A,A00,507421,Fischer-Grunski; Eva K,20,0,20,0
1713318620602,LIGM 5B,A00,507423,Fischer-Grunski; Eva K,20,0,20,0
1713318621631,LIGM 5C,A00,507425,Fischer-Grunski; Eva K,20,0,20,0
1713318622659,LIIT 5AS,A00,507427,Carnelos; Chiara,20,0,20,0
1713318623687,LIIT 5BS,A00,507430,Carnelos; Chiara,20,0,20,0
1713318624713,LIIT 5CS,A00,507432,Carnelos; Chiara,20,0,20,0
1713318625740,LISP 5A,A00,507541,Munoz Sanchez; Alicia,19,0,20,1
1713318626765,LISP 5B,A00,507671,Munoz Sanchez; Alicia,17,0,20,3
1713318627797,LISP 5C,A00,507696,Munoz Sanchez; Alicia,17,0,20,3
1713318628822,MAE 197,001,528363,Boechler; Nicholas Sebastia,9998,0,9999,1
1713318629848,MATH 197,001,523477,Kedlaya; Kiran S.,9999,0,9999,0
1713318629848,MATH 197,002,563811,Zhang; Danna,9999,0,9999,0
1713318630874,MCWP 40R,A00,518780,Staff,20,0,20,0
1713318630874,MCWP 40R,B00,518781,Staff,19,0,20,1
1713318630874,MCWP 40R,C00,518783,Staff,19,0,20,1
1713318631903,MCWP 50R,A00,518791,Staff,20,0,20,0
1713318631903,MCWP 50R,B00,518792,Staff,17,0,20,3
1713318631903,MCWP 50R,C00,518793,Staff,19,0,20,1
1713318631903,MCWP 50R,D00,518794,Staff,18,0,20,2
1713318631903,MCWP 50R,E00,518795,Staff,17,0,20,3
1713318631903,MCWP 50R,F00,518796,Staff,19,0,20,1
1713318631903,MCWP 50R,G00,518797,Staff,19,0,20,1
1713318632928,MMW 12R,A01,514034,Herbst; Matthew,15,0,16,1
1713318632928,MMW 12R,A02,514035,Herbst; Matthew,16,0,16,0
1713318633953,MMW 13R,A01,514037,Staff,12,0,16,4
1713318633953,MMW 13R,A02,514039,Staff,16,0,16,0
1713318636006,SIO 295LS,A00,523233,Staff,19,0,30,11
1713318637034,SIO 295S,A00,523232,Staff,19,0,30,11
1713318638059,SOCI 117,A01,494376,Staff,3,0,5,2
1713318639088,WES 237B,A00,494380,Staff,19,0,20,1
1713318641169,AESE 279B,A00,494370,Wade; Jon P,33,0,33,0
1713318642193,ANAR 135S,A00,494369,Braswell; Geoffrey E.,0,0,0,0
1713318643219,CAT 124RS,A01,519847,Geibel; William,17,0,20,3
1713318644248,CAT 125RS,A01,515971,Geibel; William,17,0,20,3
1713318645277,CLRE 250,A00,511389,Morris; Sheldon,9996,0,9999,3
1713318646304,CLRE 251,A00,507176,Mehta; Ravindra L.,9996,0,9999,3
1713318646304,CLRE 251,B00,511410,Mehta; Ravindra L.,9998,0,9999,1
1713318647329,CLRE 252,A00,507189,Cuomo; Raphael Eduardo,9998,0,9999,1
1713318648360,CLRE 253,A00,507199,Vaida; Florin,9997,0,9999,2
1713318648360,CLRE 253,B00,507202,Vaida; Florin,9999,0,9999,0
1713318649388,CLRE 259,A00,507211,Patel; Hemal,9996,0,9999,3
1713318650416,CLRE 260,A00,507221,Cuomo; Raphael Eduardo,9999,0,9999,0
1713318651443,CLRE 297,001,507242,Cuomo; Raphael Eduardo,9999,0,9999,0
1713318652469,CSE 191,A00,516875,Minnes Kemp; Mor Mia,9999,0,9999,0
1713318653499,CSS 201S,A01,494383,Staff,35,0,35,0
1713318654523,CSS 202S,A01,494387,Staff,35,0,35,0
1713318655550,EAP 100,A00,516065,Staff,9792,0,9999,207
1713318656574,ECE 45,A01,507414,Staff,54,0,60,6
1713318657599,ECE 100,A01,507416,Baghdadchi; Saharnaz,11,0,20,9
1713318657599,ECE 100,A02,507418,Baghdadchi; Saharnaz,20,0,20,0
1713318658627,ECE 111,A01,507420,Staff,40,0,50,10
1713318659653,ECE 197,001,548057,Sievenpiper; Daniel F.,9998,0,9999,1
1713318660679,EDS 115,A00,507243,Choi; Bailey Miyeon,28,0,28,0
1713318661703,EDS 117,A01,494379,Staff,24,0,25,1
1713318662728,EDS 125,A00,507246,Hopkins; Megan Beth,29,0,30,1
1713318663758,EDS 128A,A01,507264,Fargason; Sharon Gayle,26,0,26,0
1713318664784,EDS 128B,A01,507293,Pappas; Elizabeth,30,0,30,0
1713318665813,EDS 139,A00,507294,Fargason; Sharon Gayle,30,0,30,0
1713318665813,EDS 139,B00,507313,Pappas; Elizabeth,30,0,30,0
1713318666838,EDS 201,A00,507315,Staff,26,0,30,4
1713318667865,EDS 203,A01,507317,Halter; Christopher P.,26,0,30,4
1713318668895,EDS 204R,A01,507319,Halter; Christopher P.,4,0,30,26
1713318668895,EDS 204R,B01,507331,Heinzman; Erica M.,28,0,30,2
1713318669924,EDS 206R,A00,507332,Staff,5,0,30,25
1713318669924,EDS 206R,B00,507343,Staff,28,0,30,2
1713318670949,EDS 250,A00,507344,Hemans; Patricia Ann Benitez,36,0,40,4
1713318671975,EDS 281,A00,507345,Daly; Alan J.,18,0,18,0
1713318673001,EDS 284,A00,507350,Daly; Alan J.,16,0,16,0
1713318674025,EDS 286,A00,507359,Fine; Sarah,18,0,18,0
1713318675054,EDS 289C,A01,507361,Daly; Alan J.,18,0,18,0
1713318676083,EDS 290,A00,507366,Hofstetter; Carolyn,15,0,15,0
1713318677115,LIGM 5A,A00,507421,Fischer-Grunski; Eva K,20,0,20,0
1713318678139,LIGM 5B,A00,507423,Fischer-Grunski; Eva K,20,0,20,0
1713318679166,LIGM 5C,A00,507425,Fischer-Grunski; Eva K,20,0,20,0
1713318680193,LIIT 5AS,A00,507427,Carnelos; Chiara,20,0,20,0
1713318681219,LIIT 5BS,A00,507430,Carnelos; Chiara,20,0,20,0
1713318682249,LIIT 5CS,A00,507432,Carnelos; Chiara,20,0,20,0
1713318683273,LISP 5A,A00,507541,Munoz Sanchez; Alicia,19,0,20,1
1713318684302,LISP 5B,A00,507671,Munoz Sanchez; Alicia,17,0,20,3
1713318685385,LISP 5C,A00,507696,Munoz Sanchez; Alicia,17,0,20,3
1713318686410,MAE 197,001,528363,Boechler; Nicholas Sebastia,9998,0,9999,1
1713318687440,MATH 197,001,523477,Kedlaya; Kiran S.,9999,0,9999,0
1713318687440,MATH 197,002,563811,Zhang; Danna,9999,0,9999,0
1713318688466,MCWP 40R,A00,518780,Staff,20,0,20,0
1713318688466,MCWP 40R,B00,518781,Staff,19,0,20,1
1713318688466,MCWP 40R,C00,518783,Staff,19,0,20,1
1713318689492,MCWP 50R,A00,518791,Staff,20,0,20,0
1713318689492,MCWP 50R,B00,518792,Staff,17,0,20,3
1713318689492,MCWP 50R,C00,518793,Staff,19,0,20,1
1713318689492,MCWP 50R,D00,518794,Staff,18,0,20,2
1713318689492,MCWP 50R,E00,518795,Staff,17,0,20,3
1713318689492,MCWP 50R,F00,518796,Staff,19,0,20,1
1713318689492,MCWP 50R,G00,518797,Staff,19,0,20,1
1713318690518,MMW 12R,A01,514034,Herbst; Matthew,15,0,16,1
1713318690518,MMW 12R,A02,514035,Herbst; Matthew,16,0,16,0
1713318691548,MMW 13R,A01,514037,Staff,12,0,16,4
1713318691548,MMW 13R,A02,514039,Staff,16,0,16,0
1713318693598,SIO 295LS,A00,523233,Staff,19,0,30,11
1713318694626,SIO 295S,A00,523232,Staff,19,0,30,11
1713318695651,SOCI 117,A01,494376,Staff,3,0,5,2
1713318696680,WES 237B,A00,494380,Staff,19,0,20,1
1713318698747,AESE 279B,A00,494370,Wade; Jon P,33,0,33,0
1713318699773,ANAR 135S,A00,494369,Braswell; Geoffrey E.,0,0,0,0
1713318700805,CAT 124RS,A01,519847,Geibel; William,17,0,20,3
1713318701831,CAT 125RS,A01,515971,Geibel; William,17,0,20,3
1713318702860,CLRE 250,A00,511389,Morris; Sheldon,9996,0,9999,3
1713318703886,CLRE 251,A00,507176,Mehta; Ravindra L.,9996,0,9999,3
1713318703886,CLRE 251,B00,511410,Mehta; Ravindra L.,9998,0,9999,1
1713318704914,CLRE 252,A00,507189,Cuomo; Raphael Eduardo,9998,0,9999,1
1713318705944,CLRE 253,A00,507199,Vaida; Florin,9997,0,9999,2
1713318705944,CLRE 253,B00,507202,Vaida; Florin,9999,0,9999,0
1713318706970,CLRE 259,A00,507211,Patel; Hemal,9996,0,9999,3
1713318707995,CLRE 260,A00,507221,Cuomo; Raphael Eduardo,9999,0,9999,0
1713318709020,CLRE 297,001,507242,Cuomo; Raphael Eduardo,9999,0,9999,0
1713318710046,CSE 191,A00,516875,Minnes Kemp; Mor Mia,9999,0,9999,0
1713318711072,CSS 201S,A01,494383,Staff,35,0,35,0
1713318712101,CSS 202S,A01,494387,Staff,35,0,35,0
1713318713126,EAP 100,A00,516065,Staff,9792,0,9999,207
1713318714156,ECE 45,A01,507414,Staff,54,0,60,6
1713318715186,ECE 100,A01,507416,Baghdadchi; Saharnaz,11,0,20,9
1713318715186,ECE 100,A02,507418,Baghdadchi; Saharnaz,20,0,20,0
1713318716212,ECE 111,A01,507420,Staff,40,0,50,10
1713318717239,ECE 197,001,548057,Sievenpiper; Daniel F.,9998,0,9999,1
1713318718264,EDS 115,A00,507243,Choi; Bailey Miyeon,28,0,28,0
1713318719291,EDS 117,A01,494379,Staff,24,0,25,1
1713318720316,EDS 125,A00,507246,Hopkins; Megan Beth,29,0,30,1
1713318721341,EDS 128A,A01,507264,Fargason; Sharon Gayle,26,0,26,0
1713318722367,EDS 128B,A01,507293,Pappas; Elizabeth,30,0,30,0
1713318723396,EDS 139,A00,507294,Fargason; Sharon Gayle,30,0,30,0
1713318723396,EDS 139,B00,507313,Pappas; Elizabeth,30,0,30,0
1713318724422,EDS 201,A00,507315,Staff,26,0,30,4
1713318725450,EDS 203,A01,507317,Halter; Christopher P.,26,0,30,4
1713318726473,EDS 204R,A01,507319,Halter; Christopher P.,4,0,30,26
1713318726473,EDS 204R,B01,507331,Heinzman; Erica M.,28,0,30,2
1713318727497,EDS 206R,A00,507332,Staff,5,0,30,25
1713318727497,EDS 206R,B00,507343,Staff,28,0,30,2
1713318728523,EDS 250,A00,507344,Hemans; Patricia Ann Benitez,36,0,40,4
1713318729548,EDS 281,A00,507345,Daly; Alan J.,18,0,18,0
1713318730573,EDS 284,A00,507350,Daly; Alan J.,16,0,16,0
1713318731597,EDS 286,A00,507359,Fine; Sarah,18,0,18,0
1713318732622,EDS 289C,A01,507361,Daly; Alan J.,18,0,18,0
1713318733651,EDS 290,A00,507366,Hofstetter; Carolyn,15,0,15,0
1713318734686,LIGM 5A,A00,507421,Fischer-Grunski; Eva K,20,0,20,0
1713318735712,LIGM 5B,A00,507423,Fischer-Grunski; Eva K,20,0,20,0
1713318736737,LIGM 5C,A00,507425,Fischer-Grunski; Eva K,20,0,20,0
1713318737765,LIIT 5AS,A00,507427,Carnelos; Chiara,20,0,20,0
1713318738791,LIIT 5BS,A00,507430,Carnelos; Chiara,20,0,20,0
1713318739815,LIIT 5CS,A00,507432,Carnelos; Chiara,20,0,20,0
1713318740842,LISP 5A,A00,507541,Munoz Sanchez; Alicia,19,0,20,1
1713318741869,LISP 5B,A00,507671,Munoz Sanchez; Alicia,17,0,20,3
1713318742895,LISP 5C,A00,507696,Munoz Sanchez; Alicia,17,0,20,3
1713318743928,MAE 197,001,528363,Boechler; Nicholas Sebastia,9998,0,9999,1
1713318744954,MATH 197,001,523477,Kedlaya; Kiran S.,9999,0,9999,0
1713318744954,MATH 197,002,563811,Zhang; Danna,9999,0,9999,0
1713318745982,MCWP 40R,A00,518780,Staff,20,0,20,0
1713318745982,MCWP 40R,B00,518781,Staff,19,0,20,1
1713318745982,MCWP 40R,C00,518783,Staff,19,0,20,1
1713318747013,MCWP 50R,A00,518791,Staff,20,0,20,0
1713318747013,MCWP 50R,B00,518792,Staff,17,0,20,3
1713318747013,MCWP 50R,C00,518793,Staff,19,0,20,1
1713318747013,MCWP 50R,D00,518794,Staff,18,0,20,2
1713318747013,MCWP 50R,E00,518795,Staff,17,0,20,3
1713318747013,MCWP 50R,F00,518796,Staff,19,0,20,1
1713318747013,MCWP 50R,G00,518797,Staff,19,0,20,1
1713318748038,MMW 12R,A01,514034,Herbst; Matthew,15,0,16,1
1713318748038,MMW 12R,A02,514035,Herbst; Matthew,16,0,16,0
1713318749066,MMW 13R,A01,514037,Staff,12,0,16,4
1713318749066,MMW 13R,A02,514039,Staff,16,0,16,0
1713318751124,SIO 295LS,A00,523233,Staff,19,0,30,11
1713318752149,SIO 295S,A00,523232,Staff,19,0,30,11
1713318753174,SOCI 117,A01,494376,Staff,3,0,5,2
1713318754203,WES 237B,A00,494380,Staff,19,0,20,1
1713318756267,AESE 279B,A00,494370,Wade; Jon P,33,0,33,0
1713318757299,ANAR 135S,A00,494369,Braswell; Geoffrey E.,0,0,0,0
1713318758325,CAT 124RS,A01,519847,Geibel; William,17,0,20,3
1713318759352,CAT 125RS,A01,515971,Geibel; William,17,0,20,3
1713318760378,CLRE 250,A00,511389,Morris; Sheldon,9996,0,9999,3
1713318761405,CLRE 251,A00,507176,Mehta; Ravindra L.,9996,0,9999,3
1713318761405,CLRE 251,B00,511410,Mehta; Ravindra L.,9998,0,9999,1
1713318762432,CLRE 252,A00,507189,Cuomo; Raphael Eduardo,9998,0,9999,1
1713318763460,CLRE 253,A00,507199,Vaida; Florin,9997,0,9999,2
1713318763460,CLRE 253,B00,507202,Vaida; Florin,9999,0,9999,0
1713318764488,CLRE 259,A00,507211,Patel; Hemal,9996,0,9999,3
1713318765516,CLRE 260,A00,507221,Cuomo; Raphael Eduardo,9999,0,9999,0
1713318766541,CLRE 297,001,507242,Cuomo; Raphael Eduardo,9999,0,9999,0
1713318767571,CSE 191,A00,516875,Minnes Kemp; Mor Mia,9999,0,9999,0
1713318768598,CSS 201S,A01,494383,Staff,35,0,35,0
1713318769628,CSS 202S,A01,494387,Staff,35,0,35,0
1713318770657,EAP 100,A00,516065,Staff,9792,0,9999,207
1713318771682,ECE 45,A01,507414,Staff,54,0,60,6
1713318772712,ECE 100,A01,507416,Baghdadchi; Saharnaz,11,0,20,9
1713318772712,ECE 100,A02,507418,Baghdadchi; Saharnaz,20,0,20,0
1713318773735,ECE 111,A01,507420,Staff,40,0,50,10
1713318774761,ECE 197,001,548057,Sievenpiper; Daniel F.,9998,0,9999,1
1713318775786,EDS 115,A00,507243,Choi; Bailey Miyeon,28,0,28,0
1713318776812,EDS 117,A01,494379,Staff,24,0,25,1
1713318777838,EDS 125,A00,507246,Hopkins; Megan Beth,29,0,30,1
1713318778863,EDS 128A,A01,507264,Fargason; Sharon Gayle,26,0,26,0
1713318779888,EDS 128B,A01,507293,Pappas; Elizabeth,30,0,30,0
1713318780916,EDS 139,A00,507294,Fargason; Sharon Gayle,30,0,30,0
1713318780916,EDS 139,B00,507313,Pappas; Elizabeth,30,0,30,0
1713318781941,EDS 201,A00,507315,Staff,26,0,30,4
1713318782966,EDS 203,A01,507317,Halter; Christopher P.,26,0,30,4
1713318783996,EDS 204R,A01,507319,Halter; Christopher P.,4,0,30,26
1713318783996,EDS 204R,B01,507331,Heinzman; Erica M.,28,0,30,2
1713318785024,EDS 206R,A00,507332,Staff,5,0,30,25
1713318785024,EDS 206R,B00,507343,Staff,28,0,30,2
1713318786049,EDS 250,A00,507344,Hemans; Patricia Ann Benitez,36,0,40,4
1713318787077,EDS 281,A00,507345,Daly; Alan J.,18,0,18,0
1713318788104,EDS 284,A00,507350,Daly; Alan J.,16,0,16,0
1713318789182,EDS 286,A00,507359,Fine; Sarah,18,0,18,0
1713318790211,EDS 289C,A01,507361,Daly; Alan J.,18,0,18,0
1713318791236,EDS 290,A00,507366,Hofstetter; Carolyn,15,0,15,0
1713318792268,LIGM 5A,A00,507421,Fischer-Grunski; Eva K,20,0,20,0
1713318793293,LIGM 5B,A00,507423,Fischer-Grunski; Eva K,20,0,20,0
1713318794317,LIGM 5C,A00,507425,Fischer-Grunski; Eva K,20,0,20,0
1713318795342,LIIT 5AS,A00,507427,Carnelos; Chiara,20,0,20,0
1713318796370,LIIT 5BS,A00,507430,Carnelos; Chiara,20,0,20,0
1713318797397,LIIT 5CS,A00,507432,Carnelos; Chiara,20,0,20,0
1713318798426,LISP 5A,A00,507541,Munoz Sanchez; Alicia,19,0,20,1
1713318799451,LISP 5B,A00,507671,Munoz Sanchez; Alicia,17,0,20,3
1713318800476,LISP 5C,A00,507696,Munoz Sanchez; Alicia,17,0,20,3
1713318801501,MAE 197,001,528363,Boechler; Nicholas Sebastia,9998,0,9999,1
1713318802528,MATH 197,001,523477,Kedlaya; Kiran S.,9999,0,9999,0
1713318802528,MATH 197,002,563811,Zhang; Danna,9999,0,9999,0
1713318803553,MCWP 40R,A00,518780,Staff,20,0,20,0
1713318803553,MCWP 40R,B00,518781,Staff,19,0,20,1
1713318803553,MCWP 40R,C00,518783,Staff,19,0,20,1
1713318804580,MCWP 50R,A00,518791,Staff,20,0,20,0
1713318804580,MCWP 50R,B00,518792,Staff,17,0,20,3
1713318804580,MCWP 50R,C00,518793,Staff,19,0,20,1
1713318804580,MCWP 50R,D00,518794,Staff,18,0,20,2
1713318804580,MCWP 50R,E00,518795,Staff,17,0,20,3
1713318804580,MCWP 50R,F00,518796,Staff,19,0,20,1
1713318804580,MCWP 50R,G00,518797,Staff,19,0,20,1
1713318805605,MMW 12R,A01,514034,Herbst; Matthew,15,0,16,1
1713318805605,MMW 12R,A02,514035,Herbst; Matthew,16,0,16,0
1713318806643,MMW 13R,A01,514037,Staff,12,0,16,4
1713318806643,MMW 13R,A02,514039,Staff,16,0,16,0
1713318808692,SIO 295LS,A00,523233,Staff,19,0,30,11
1713318809718,SIO 295S,A00,523232,Staff,19,0,30,11
1713318810742,SOCI 117,A01,494376,Staff,3,0,5,2
1713318811770,WES 237B,A00,494380,Staff,19,0,20,1
1713318813841,AESE 279B,A00,494370,Wade; Jon P,33,0,33,0
1713318814865,ANAR 135S,A00,494369,Braswell; Geoffrey E.,0,0,0,0
1713318815895,CAT 124RS,A01,519847,Geibel; William,17,0,20,3
1713318816919,CAT 125RS,A01,515971,Geibel; William,17,0,20,3
1713318817945,CLRE 250,A00,511389,Morris; Sheldon,9996,0,9999,3
1713318818971,CLRE 251,A00,507176,Mehta; Ravindra L.,9996,0,9999,3
1713318818971,CLRE 251,B00,511410,Mehta; Ravindra L.,9998,0,9999,1
1713318819999,CLRE 252,A00,507189,Cuomo; Raphael Eduardo,9998,0,9999,1
1713318821029,CLRE 253,A00,507199,Vaida; Florin,9997,0,9999,2
1713318821029,CLRE 253,B00,507202,Vaida; Florin,9999,0,9999,0
1713318822057,CLRE 259,A00,507211,Patel; Hemal,9996,0,9999,3
1713318823083,CLRE 260,A00,507221,Cuomo; Raphael Eduardo,9999,0,9999,0
1713318824111,CLRE 297,001,507242,Cuomo; Raphael Eduardo,9999,0,9999,0
1713318825138,CSE 191,A00,516875,Minnes Kemp; Mor Mia,9999,0,9999,0
1713318826168,CSS 201S,A01,494383,Staff,35,0,35,0
1713318827197,CSS 202S,A01,494387,Staff,35,0,35,0
1713318828221,EAP 100,A00,516065,Staff,9792,0,9999,207
1713318829247,ECE 45,A01,507414,Staff,54,0,60,6
1713318830273,ECE 100,A01,507416,Baghdadchi; Saharnaz,11,0,20,9
1713318830273,ECE 100,A02,507418,Baghdadchi; Saharnaz,20,0,20,0
1713318831302,ECE 111,A01,507420,Staff,40,0,50,10
1713318832328,ECE 197,001,548057,Sievenpiper; Daniel F.,9998,0,9999,1
1713318833357,EDS 115,A00,507243,Choi; Bailey Miyeon,28,0,28,0
1713318834383,EDS 117,A01,494379,Staff,24,0,25,1
1713318835408,EDS 125,A00,507246,Hopkins; Megan Beth,29,0,30,1
1713318836434,EDS 128A,A01,507264,Fargason; Sharon Gayle,26,0,26,0
1713318837464,EDS 128B,A01,507293,Pappas; Elizabeth,30,0,30,0
1713318838488,EDS 139,A00,507294,Fargason; Sharon Gayle,30,0,30,0
1713318838488,EDS 139,B00,507313,Pappas; Elizabeth,30,0,30,0
1713318839513,EDS 201,A00,507315,Staff,26,0,30,4
1713318840542,EDS 203,A01,507317,Halter; Christopher P.,26,0,30,4
1713318841571,EDS 204R,A01,507319,Halter; Christopher P.,4,0,30,26
1713318841571,EDS 204R,B01,507331,Heinzman; Erica M.,28,0,30,2
1713318842595,EDS 206R,A00,507332,Staff,5,0,30,25
1713318842595,EDS 206R,B00,507343,Staff,28,0,30,2
1713318843621,EDS 250,A00,507344,Hemans; Patricia Ann Benitez,36,0,40,4
1713318844648,EDS 281,A00,507345,Daly; Alan J.,18,0,18,0
1713318845674,EDS 284,A00,507350,Daly; Alan J.,16,0,16,0
1713318846699,EDS 286,A00,507359,Fine; Sarah,18,0,18,0
1713318847724,EDS 289C,A01,507361,Daly; Alan J.,18,0,18,0
1713318848751,EDS 290,A00,507366,Hofstetter; Carolyn,15,0,15,0
1713318849776,LIGM 5A,A00,507421,Fischer-Grunski; Eva K,20,0,20,0
1713318850802,LIGM 5B,A00,507423,Fischer-Grunski; Eva K,20,0,20,0
1713318851833,LIGM 5C,A00,507425,Fischer-Grunski; Eva K,20,0,20,0
1713318852861,LIIT 5AS,A00,507427,Carnelos; Chiara,20,0,20,0
1713318853897,LIIT 5BS,A00,507430,Carnelos; Chiara,20,0,20,0
1713318854923,LIIT 5CS,A00,507432,Carnelos; Chiara,20,0,20,0
1713318855952,LISP 5A,A00,507541,Munoz Sanchez; Alicia,19,0,20,1
1713318856978,LISP 5B,A00,507671,Munoz Sanchez; Alicia,17,0,20,3
1713318858008,LISP 5C,A00,507696,Munoz Sanchez; Alicia,17,0,20,3
1713318859036,MAE 197,001,528363,Boechler; Nicholas Sebastia,9998,0,9999,1
1713318860062,MATH 197,001,523477,Kedlaya; Kiran S.,9999,0,9999,0
1713318860062,MATH 197,002,563811,Zhang; Danna,9999,0,9999,0
1713318861091,MCWP 40R,A00,518780,Staff,20,0,20,0
1713318861091,MCWP 40R,B00,518781,Staff,19,0,20,1
1713318861091,MCWP 40R,C00,518783,Staff,19,0,20,1
1713318862121,MCWP 50R,A00,518791,Staff,20,0,20,0
1713318862121,MCWP 50R,B00,518792,Staff,17,0,20,3
1713318862121,MCWP 50R,C00,518793,Staff,19,0,20,1
1713318862121,MCWP 50R,D00,518794,Staff,18,0,20,2
1713318862121,MCWP 50R,E00,518795,Staff,17,0,20,3
1713318862121,MCWP 50R,F00,518796,Staff,19,0,20,1
1713318862121,MCWP 50R,G00,518797,Staff,19,0,20,1
1713318863145,MMW 12R,A01,514034,Herbst; Matthew,15,0,16,1
1713318863145,MMW 12R,A02,514035,Herbst; Matthew,16,0,16,0
1713318864171,MMW 13R,A01,514037,Staff,12,0,16,4
1713318864171,MMW 13R,A02,514039,Staff,16,0,16,0
1713318866227,SIO 295LS,A00,523233,Staff,19,0,30,11
1713318867251,SIO 295S,A00,523232,Staff,19,0,30,11
1713318868280,SOCI 117,A01,494376,Staff,3,0,5,2
1713318869306,WES 237B,A00,494380,Staff,19,0,20,1
1713318871370,AESE 279B,A00,494370,Wade; Jon P,33,0,33,0
1713318872399,ANAR 135S,A00,494369,Braswell; Geoffrey E.,0,0,0,0
1713318873424,CAT 124RS,A01,519847,Geibel; William,17,0,20,3
1713318874452,CAT 125RS,A01,515971,Geibel; William,17,0,20,3
1713318875481,CLRE 250,A00,511389,Morris; Sheldon,9996,0,9999,3
1713318876506,CLRE 251,A00,507176,Mehta; Ravindra L.,9996,0,9999,3
1713318876506,CLRE 251,B00,511410,Mehta; Ravindra L.,9998,0,9999,1
1713318877532,CLRE 252,A00,507189,Cuomo; Raphael Eduardo,9998,0,9999,1
1713318878561,CLRE 253,A00,507199,Vaida; Florin,9997,0,9999,2
1713318878561,CLRE 253,B00,507202,Vaida; Florin,9999,0,9999,0
1713318879592,CLRE 259,A00,507211,Patel; Hemal,9996,0,9999,3
1713318880617,CLRE 260,A00,507221,Cuomo; Raphael Eduardo,9999,0,9999,0
1713318881642,CLRE 297,001,507242,Cuomo; Raphael Eduardo,9999,0,9999,0
1713318882668,CSE 191,A00,516875,Minnes Kemp; Mor Mia,9999,0,9999,0
1713318883698,CSS 201S,A01,494383,Staff,35,0,35,0
1713318884724,CSS 202S,A01,494387,Staff,35,0,35,0
1713318885749,EAP 100,A00,516065,Staff,9792,0,9999,207
1713318886776,ECE 45,A01,507414,Staff,54,0,60,6
1713318887802,ECE 100,A01,507416,Baghdadchi; Saharnaz,11,0,20,9
1713318887802,ECE 100,A02,507418,Baghdadchi; Saharnaz,20,0,20,0
1713318888829,ECE 111,A01,507420,Staff,40,0,50,10
1713318889854,ECE 197,001,548057,Sievenpiper; Daniel F.,9998,0,9999,1
1713318890880,EDS 115,A00,507243,Choi; Bailey Miyeon,28,0,28,0
1713318891910,EDS 117,A01,494379,Staff,24,0,25,1
1713318892995,EDS 125,A00,507246,Hopkins; Megan Beth,29,0,30,1
1713318894026,EDS 128A,A01,507264,Fargason; Sharon Gayle,26,0,26,0
1713318895053,EDS 128B,A01,507293,Pappas; Elizabeth,30,0,30,0
1713318896078,EDS 139,A00,507294,Fargason; Sharon Gayle,30,0,30,0
1713318896078,EDS 139,B00,507313,Pappas; Elizabeth,30,0,30,0
1713318897104,EDS 201,A00,507315,Staff,26,0,30,4
1713318898130,EDS 203,A01,507317,Halter; Christopher P.,26,0,30,4
1713318899159,EDS 204R,A01,507319,Halter; Christopher P.,4,0,30,26
1713318899159,EDS 204R,B01,507331,Heinzman; Erica M.,28,0,30,2
1713318900184,EDS 206R,A00,507332,Staff,5,0,30,25
1713318900184,EDS 206R,B00,507343,Staff,28,0,30,2
1713318901213,EDS 250,A00,507344,Hemans; Patricia Ann Benitez,36,0,40,4
1713318902238,EDS 281,A00,507345,Daly; Alan J.,18,0,18,0
1713318903263,EDS 284,A00,507350,Daly; Alan J.,16,0,16,0
1713318904288,EDS 286,A00,507359,Fine; Sarah,18,0,18,0
1713318905313,EDS 289C,A01,507361,Daly; Alan J.,18,0,18,0
1713318906340,EDS 290,A00,507366,Hofstetter; Carolyn,15,0,15,0
1713318907367,LIGM 5A,A00,507421,Fischer-Grunski; Eva K,20,0,20,0
1713318908393,LIGM 5B,A00,507423,Fischer-Grunski; Eva K,20,0,20,0
1713318909417,LIGM 5C,A00,507425,Fischer-Grunski; Eva K,20,0,20,0
1713318910441,LIIT 5AS,A00,507427,Carnelos; Chiara,20,0,20,0
1713318911465,LIIT 5BS,A00,507430,Carnelos; Chiara,20,0,20,0
1713318912493,LIIT 5CS,A00,507432,Carnelos; Chiara,20,0,20,0
1713318913524,LISP 5A,A00,507541,Munoz Sanchez; Alicia,19,0,20,1
1713318914554,LISP 5B,A00,507671,Munoz Sanchez; Alicia,17,0,20,3
1713318915583,LISP 5C,A00,507696,Munoz Sanchez; Alicia,17,0,20,3
1713318916611,MAE 197,001,528363,Boechler; Nicholas Sebastia,9998,0,9999,1
1713318917640,MATH 197,001,523477,Kedlaya; Kiran S.,9999,0,9999,0
1713318917640,MATH 197,002,563811,Zhang; Danna,9999,0,9999,0
1713318918669,MCWP 40R,A00,518780,Staff,20,0,20,0
1713318918669,MCWP 40R,B00,518781,Staff,19,0,20,1
1713318918669,MCWP 40R,C00,518783,Staff,19,0,20,1
1713318919697,MCWP 50R,A00,518791,Staff,20,0,20,0
1713318919697,MCWP 50R,B00,518792,Staff,17,0,20,3
1713318919697,MCWP 50R,C00,518793,Staff,19,0,20,1
1713318919697,MCWP 50R,D00,518794,Staff,18,0,20,2
1713318919697,MCWP 50R,E00,518795,Staff,17,0,20,3
1713318919697,MCWP 50R,F00,518796,Staff,19,0,20,1
1713318919697,MCWP 50R,G00,518797,Staff,19,0,20,1
1713318920723,MMW 12R,A01,514034,Herbst; Matthew,15,0,16,1
1713318920723,MMW 12R,A02,514035,Herbst; Matthew,16,0,16,0
1713318921747,MMW 13R,A01,514037,Staff,12,0,16,4
1713318921747,MMW 13R,A02,514039,Staff,16,0,16,0
1713318923800,SIO 295LS,A00,523233,Staff,19,0,30,11
1713318924828,SIO 295S,A00,523232,Staff,19,0,30,11
1713318925854,SOCI 117,A01,494376,Staff,3,0,5,2
1713318926882,WES 237B,A00,494380,Staff,19,0,20,1
1713318928948,AESE 279B,A00,494370,Wade; Jon P,33,0,33,0
1713318929976,ANAR 135S,A00,494369,Braswell; Geoffrey E.,0,0,0,0
1713318931002,CAT 124RS,A01,519847,Geibel; William,17,0,20,3
1713318932026,CAT 125RS,A01,515971,Geibel; William,17,0,20,3
1713318933052,CLRE 250,A00,511389,Morris; Sheldon,9996,0,9999,3
1713318934084,CLRE 251,A00,507176,Mehta; Ravindra L.,9996,0,9999,3
1713318934084,CLRE 251,B00,511410,Mehta; Ravindra L.,9998,0,9999,1
1713318935112,CLRE 252,A00,507189,Cuomo; Raphael Eduardo,9998,0,9999,1
1713318936140,CLRE 253,A00,507199,Vaida; Florin,9997,0,9999,2
1713318936140,CLRE 253,B00,507202,Vaida; Florin,9999,0,9999,0
1713318937165,CLRE 259,A00,507211,Patel; Hemal,9996,0,9999,3
1713318938191,CLRE 260,A00,507221,Cuomo; Raphael Eduardo,9999,0,9999,0
1713318939218,CLRE 297,001,507242,Cuomo; Raphael Eduardo,9999,0,9999,0
1713318940245,CSE 191,A00,516875,Minnes Kemp; Mor Mia,9999,0,9999,0
1713318941275,CSS 201S,A01,494383,Staff,35,0,35,0
1713318942300,CSS 202S,A01,494387,Staff,35,0,35,0
1713318943325,EAP 100,A00,516065,Staff,9792,0,9999,207
1713318944352,ECE 45,A01,507414,Staff,54,0,60,6
1713318945381,ECE 100,A01,507416,Baghdadchi; Saharnaz,11,0,20,9
1713318945381,ECE 100,A02,507418,Baghdadchi; Saharnaz,20,0,20,0
1713318946410,ECE 111,A01,507420,Staff,40,0,50,10
1713318947434,ECE 197,001,548057,Sievenpiper; Daniel F.,9998,0,9999,1
1713318948461,EDS 115,A00,507243,Choi; Bailey Miyeon,28,0,28,0
1713318949486,EDS 117,A01,494379,Staff,24,0,25,1
1713318950529,EDS 125,A00,507246,Hopkins; Megan Beth,29,0,30,1
1713318951554,EDS 128A,A01,507264,Fargason; Sharon Gayle,26,0,26,0
1713318952581,EDS 128B,A01,507293,Pappas; Elizabeth,30,0,30,0
1713318953608,EDS 139,A00,507294,Fargason; Sharon Gayle,30,0,30,0
1713318953608,EDS 139,B00,507313,Pappas; Elizabeth,30,0,30,0
1713318954632,EDS 201,A00,507315,Staff,26,0,30,4
1713318955659,EDS 203,A01,507317,Halter; Christopher P.,26,0,30,4
1713318956688,EDS 204R,A01,507319,Halter; Christopher P.,4,0,30,26
1713318956688,EDS 204R,B01,507331,Heinzman; Erica M.,28,0,30,2
1713318957716,EDS 206R,A00,507332,Staff,5,0,30,25
1713318957716,EDS 206R,B00,507343,Staff,28,0,30,2
1713318958740,EDS 250,A00,507344,Hemans; Patricia Ann Benitez,36,0,40,4
1713318959765,EDS 281,A00,507345,Daly; Alan J.,18,0,18,0
1713318960788,EDS 284,A00,507350,Daly; Alan J.,16,0,16,0
1713318961814,EDS 286,A00,507359,Fine; Sarah,18,0,18,0
1713318962841,EDS 289C,A01,507361,Daly; Alan J.,18,0,18,0
1713318963867,EDS 290,A00,507366,Hofstetter; Carolyn,15,0,15,0
1713318964892,LIGM 5A,A00,507421,Fischer-Grunski; Eva K,20,0,20,0
1713318965916,LIGM 5B,A00,507423,Fischer-Grunski; Eva K,20,0,20,0
1713318966945,LIGM 5C,A00,507425,Fischer-Grunski; Eva K,20,0,20,0
1713318967976,LIIT 5AS,A00,507427,Carnelos; Chiara,20,0,20,0
1713318969004,LIIT 5BS,A00,507430,Carnelos; Chiara,20,0,20,0
1713318970029,LIIT 5CS,A00,507432,Carnelos; Chiara,20,0,20,0
1713318971056,LISP 5A,A00,507541,Munoz Sanchez; Alicia,19,0,20,1
1713318972081,LISP 5B,A00,507671,Munoz Sanchez; Alicia,17,0,20,3
1713318973110,LISP 5C,A00,507696,Munoz Sanchez; Alicia,17,0,20,3
1713318974140,MAE 197,001,528363,Boechler; Nicholas Sebastia,9998,0,9999,1
1713318975168,MATH 197,001,523477,Kedlaya; Kiran S.,9999,0,9999,0
1713318975168,MATH 197,002,563811,Zhang; Danna,9999,0,9999,0
1713318976193,MCWP 40R,A00,518780,Staff,20,0,20,0
1713318976193,MCWP 40R,B00,518781,Staff,19,0,20,1
1713318976193,MCWP 40R,C00,518783,Staff,19,0,20,1
1713318977220,MCWP 50R,A00,518791,Staff,20,0,20,0
1713318977220,MCWP 50R,B00,518792,Staff,17,0,20,3
1713318977220,MCWP 50R,C00,518793,Staff,19,0,20,1
1713318977220,MCWP 50R,D00,518794,Staff,18,0,20,2
1713318977220,MCWP 50R,E00,518795,Staff,17,0,20,3
1713318977220,MCWP 50R,F00,518796,Staff,19,0,20,1
1713318977220,MCWP 50R,G00,518797,Staff,19,0,20,1
1713318978248,MMW 12R,A01,514034,Herbst; Matthew,15,0,16,1
1713318978248,MMW 12R,A02,514035,Herbst; Matthew,16,0,16,0
1713318979274,MMW 13R,A01,514037,Staff,12,0,16,4
1713318979274,MMW 13R,A02,514039,Staff,16,0,16,0
1713318981324,SIO 295LS,A00,523233,Staff,19,0,30,11
1713318982349,SIO 295S,A00,523232,Staff,19,0,30,11
1713318983374,SOCI 117,A01,494376,Staff,3,0,5,2
1713318984404,WES 237B,A00,494380,Staff,19,0,20,1
1713318986486,AESE 279B,A00,494370,Wade; Jon P,33,0,33,0
1713318987514,ANAR 135S,A00,494369,Braswell; Geoffrey E.,0,0,0,0
1713318988540,CAT 124RS,A01,519847,Geibel; William,17,0,20,3
1713318989568,CAT 125RS,A01,515971,Geibel; William,17,0,20,3
1713318990599,CLRE 250,A00,511389,Morris; Sheldon,9996,0,9999,3
1713318991622,CLRE 251,A00,507176,Mehta; Ravindra L.,9996,0,9999,3
1713318991622,CLRE 251,B00,511410,Mehta; Ravindra L.,9998,0,9999,1
1713318992647,CLRE 252,A00,507189,Cuomo; Raphael Eduardo,9998,0,9999,1
1713318993672,CLRE 253,A00,507199,Vaida; Florin,9997,0,9999,2
1713318993672,CLRE 253,B00,507202,Vaida; Florin,9999,0,9999,0
1713318994702,CLRE 259,A00,507211,Patel; Hemal,9996,0,9999,3
1713318995728,CLRE 260,A00,507221,Cuomo; Raphael Eduardo,9999,0,9999,0
1713318996807,CLRE 297,001,507242,Cuomo; Raphael Eduardo,9999,0,9999,0
1713318997837,CSE 191,A00,516875,Minnes Kemp; Mor Mia,9999,0,9999,0
1713318998867,CSS 201S,A01,494383,Staff,35,0,35,0
1713318999893,CSS 202S,A01,494387,Staff,35,0,35,0
1713319000920,EAP 100,A00,516065,Staff,9792,0,9999,207
1713319001945,ECE 45,A01,507414,Staff,54,0,60,6
1713319002973,ECE 100,A01,507416,Baghdadchi; Saharnaz,11,0,20,9
1713319002973,ECE 100,A02,507418,Baghdadchi; Saharnaz,20,0,20,0
1713319003998,ECE 111,A01,507420,Staff,40,0,50,10
1713319005026,ECE 197,001,548057,Sievenpiper; Daniel F.,9998,0,9999,1
1713319006052,EDS 115,A00,507243,Choi; Bailey Miyeon,28,0,28,0
1713319007079,EDS 117,A01,494379,Staff,24,0,25,1
1713319008108,EDS 125,A00,507246,Hopkins; Megan Beth,29,0,30,1
1713319009138,EDS 128A,A01,507264,Fargason; Sharon Gayle,26,0,26,0
1713319010165,EDS 128B,A01,507293,Pappas; Elizabeth,30,0,30,0
1713319011189,EDS 139,A00,507294,Fargason; Sharon Gayle,30,0,30,0
1713319011189,EDS 139,B00,507313,Pappas; Elizabeth,30,0,30,0
1713319012213,EDS 201,A00,507315,Staff,26,0,30,4
1713319013238,EDS 203,A01,507317,Halter; Christopher P.,26,0,30,4
1713319014266,EDS 204R,A01,507319,Halter; Christopher P.,4,0,30,26
1713319014266,EDS 204R,B01,507331,Heinzman; Erica M.,28,0,30,2
1713319015292,EDS 206R,A00,507332,Staff,5,0,30,25
1713319015292,EDS 206R,B00,507343,Staff,28,0,30,2
1713319016321,EDS 250,A00,507344,Hemans; Patricia Ann Benitez,36,0,40,4
1713319017350,EDS 281,A00,507345,Daly; Alan J.,18,0,18,0
1713319018380,EDS 284,A00,507350,Daly; Alan J.,16,0,16,0
1713319019404,EDS 286,A00,507359,Fine; Sarah,18,0,18,0
1713319020430,EDS 289C,A01,507361,Daly; Alan J.,18,0,18,0
1713319021459,EDS 290,A00,507366,Hofstetter; Carolyn,15,0,15,0
1713319022489,LIGM 5A,A00,507421,Fischer-Grunski; Eva K,20,0,20,0
1713319023519,LIGM 5B,A00,507423,Fischer-Grunski; Eva K,20,0,20,0
1713319024546,LIGM 5C,A00,507425,Fischer-Grunski; Eva K,20,0,20,0
1713319025572,LIIT 5AS,A00,507427,Carnelos; Chiara,20,0,20,0
1713319026596,LIIT 5BS,A00,507430,Carnelos; Chiara,20,0,20,0
1713319027622,LIIT 5CS,A00,507432,Carnelos; Chiara,20,0,20,0
1713319028652,LISP 5A,A00,507541,Munoz Sanchez; Alicia,19,0,20,1
1713319029680,LISP 5B,A00,507671,Munoz Sanchez; Alicia,17,0,20,3
1713319030710,LISP 5C,A00,507696,Munoz Sanchez; Alicia,17,0,20,3
1713319031736,MAE 197,001,528363,Boechler; Nicholas Sebastia,9998,0,9999,1
1713319032767,MATH 197,001,523477,Kedlaya; Kiran S.,9999,0,9999,0
1713319032767,MATH 197,002,563811,Zhang; Danna,9999,0,9999,0
1713319033794,MCWP 40R,A00,518780,Staff,20,0,20,0
1713319033794,MCWP 40R,B00,518781,Staff,19,0,20,1
1713319033794,MCWP 40R,C00,518783,Staff,19,0,20,1
1713319034823,MCWP 50R,A00,518791,Staff,20,0,20,0
1713319034823,MCWP 50R,B00,518792,Staff,17,0,20,3
1713319034823,MCWP 50R,C00,518793,Staff,19,0,20,1
1713319034823,MCWP 50R,D00,518794,Staff,18,0,20,2
1713319034823,MCWP 50R,E00,518795,Staff,17,0,20,3
1713319034823,MCWP 50R,F00,518796,Staff,19,0,20,1
1713319034823,MCWP 50R,G00,518797,Staff,19,0,20,1
1713319035848,MMW 12R,A01,514034,Herbst; Matthew,15,0,16,1
1713319035848,MMW 12R,A02,514035,Herbst; Matthew,16,0,16,0
1713319036879,MMW 13R,A01,514037,Staff,12,0,16,4
1713319036879,MMW 13R,A02,514039,Staff,16,0,16,0
1713319038931,SIO 295LS,A00,523233,Staff,19,0,30,11
1713319039955,SIO 295S,A00,523232,Staff,19,0,30,11
1713319040985,SOCI 117,A01,494376,Staff,3,0,5,2
1713319042015,WES 237B,A00,494380,Staff,19,0,20,1
1713319044080,AESE 279B,A00,494370,Wade; Jon P,33,0,33,0
1713319045108,ANAR 135S,A00,494369,Braswell; Geoffrey E.,0,0,0,0
1713319046142,CAT 124RS,A01,519847,Geibel; William,17,0,20,3
1713319047168,CAT 125RS,A01,515971,Geibel; William,17,0,20,3
1713319048200,CLRE 250,A00,511389,Morris; Sheldon,9996,0,9999,3
1713319049227,CLRE 251,A00,507176,Mehta; Ravindra L.,9996,0,9999,3
1713319049227,CLRE 251,B00,511410,Mehta; Ravindra L.,9998,0,9999,1
1713319050251,CLRE 252,A00,507189,Cuomo; Raphael Eduardo,9998,0,9999,1
1713319051276,CLRE 253,A00,507199,Vaida; Florin,9997,0,9999,2
1713319051276,CLRE 253,B00,507202,Vaida; Florin,9999,0,9999,0
1713319052302,CLRE 259,A00,507211,Patel; Hemal,9996,0,9999,3
1713319053326,CLRE 260,A00,507221,Cuomo; Raphael Eduardo,9999,0,9999,0
1713319054350,CLRE 297,001,507242,Cuomo; Raphael Eduardo,9999,0,9999,0
1713319055379,CSE 191,A00,516875,Minnes Kemp; Mor Mia,9999,0,9999,0
1713319056408,CSS 201S,A01,494383,Staff,35,0,35,0
1713319057438,CSS 202S,A01,494387,Staff,35,0,35,0
1713319058465,EAP 100,A00,516065,Staff,9792,0,9999,207
1713319059490,ECE 45,A01,507414,Staff,54,0,60,6
1713319060516,ECE 100,A01,507416,Baghdadchi; Saharnaz,11,0,20,9
1713319060516,ECE 100,A02,507418,Baghdadchi; Saharnaz,20,0,20,0
1713319061542,ECE 111,A01,507420,Staff,40,0,50,10
1713319062569,ECE 197,001,548057,Sievenpiper; Daniel F.,9998,0,9999,1
1713319063593,EDS 115,A00,507243,Choi; Bailey Miyeon,28,0,28,0
1713319064619,EDS 117,A01,494379,Staff,24,0,25,1
1713319065645,EDS 125,A00,507246,Hopkins; Megan Beth,29,0,30,1
1713319066670,EDS 128A,A01,507264,Fargason; Sharon Gayle,26,0,26,0
1713319067694,EDS 128B,A01,507293,Pappas; Elizabeth,30,0,30,0
1713319068720,EDS 139,A00,507294,Fargason; Sharon Gayle,30,0,30,0
1713319068720,EDS 139,B00,507313,Pappas; Elizabeth,30,0,30,0
1713319069745,EDS 201,A00,507315,Staff,26,0,30,4
1713319070774,EDS 203,A01,507317,Halter; Christopher P.,26,0,30,4
1713319071807,EDS 204R,A01,507319,Halter; Christopher P.,4,0,30,26
1713319071807,EDS 204R,B01,507331,Heinzman; Erica M.,28,0,30,2
1713319072832,EDS 206R,A00,507332,Staff,5,0,30,25
1713319072832,EDS 206R,B00,507343,Staff,28,0,30,2
1713319073859,EDS 250,A00,507344,Hemans; Patricia Ann Benitez,36,0,40,4
1713319074888,EDS 281,A00,507345,Daly; Alan J.,18,0,18,0
1713319075913,EDS 284,A00,507350,Daly; Alan J.,16,0,16,0
1713319076938,EDS 286,A00,507359,Fine; Sarah,18,0,18,0
1713319077967,EDS 289C,A01,507361,Daly; Alan J.,18,0,18,0
1713319078994,EDS 290,A00,507366,Hofstetter; Carolyn,15,0,15,0
1713319080019,LIGM 5A,A00,507421,Fischer-Grunski; Eva K,20,0,20,0
1713319081046,LIGM 5B,A00,507423,Fischer-Grunski; Eva K,20,0,20,0
1713319082075,LIGM 5C,A00,507425,Fischer-Grunski; Eva K,20,0,20,0
1713319083099,LIIT 5AS,A00,507427,Carnelos; Chiara,20,0,20,0
1713319084129,LIIT 5BS,A00,507430,Carnelos; Chiara,20,0,20,0
1713319085156,LIIT 5CS,A00,507432,Carnelos; Chiara,20,0,20,0
1713319086185,LISP 5A,A00,507541,Munoz Sanchez; Alicia,19,0,20,1
1713319087210,LISP 5B,A00,507671,Munoz Sanchez; Alicia,17,0,20,3
1713319088240,LISP 5C,A00,507696,Munoz Sanchez; Alicia,17,0,20,3
1713319089265,MAE 197,001,528363,Boechler; Nicholas Sebastia,9998,0,9999,1
1713319090297,MATH 197,001,523477,Kedlaya; Kiran S.,9999,0,9999,0
1713319090297,MATH 197,002,563811,Zhang; Danna,9999,0,9999,0
1713319091325,MCWP 40R,A00,518780,Staff,20,0,20,0
1713319091325,MCWP 40R,B00,518781,Staff,19,0,20,1
1713319091325,MCWP 40R,C00,518783,Staff,19,0,20,1
1713319092351,MCWP 50R,A00,518791,Staff,20,0,20,0
1713319092351,MCWP 50R,B00,518792,Staff,17,0,20,3
1713319092351,MCWP 50R,C00,518793,Staff,19,0,20,1
1713319092351,MCWP 50R,D00,518794,Staff,18,0,20,2
1713319092351,MCWP 50R,E00,518795,Staff,17,0,20,3
1713319092351,MCWP 50R,F00,518796,Staff,19,0,20,1
1713319092351,MCWP 50R,G00,518797,Staff,19,0,20,1
1713319093377,MMW 12R,A01,514034,Herbst; Matthew,15,0,16,1
1713319093377,MMW 12R,A02,514035,Herbst; Matthew,16,0,16,0
1713319094402,MMW 13R,A01,514037,Staff,12,0,16,4
1713319094402,MMW 13R,A02,514039,Staff,16,0,16,0
1713319096456,SIO 295LS,A00,523233,Staff,19,0,30,11
1713319097486,SIO 295S,A00,523232,Staff,19,0,30,11
1713319098514,SOCI 117,A01,494376,Staff,3,0,5,2
1713319099540,WES 237B,A00,494380,Staff,19,0,20,1
1713319101663,AESE 279B,A00,494370,Wade; Jon P,33,0,33,0
1713319102688,ANAR 135S,A00,494369,Braswell; Geoffrey E.,0,0,0,0
1713319103715,CAT 124RS,A01,519847,Geibel; William,17,0,20,3
1713319104740,CAT 125RS,A01,515971,Geibel; William,17,0,20,3
1713319105769,CLRE 250,A00,511389,Morris; Sheldon,9996,0,9999,3
1713319106796,CLRE 251,A00,507176,Mehta; Ravindra L.,9996,0,9999,3
1713319106796,CLRE 251,B00,511410,Mehta; Ravindra L.,9998,0,9999,1
1713319107825,CLRE 252,A00,507189,Cuomo; Raphael Eduardo,9998,0,9999,1
1713319108852,CLRE 253,A00,507199,Vaida; Florin,9997,0,9999,2
1713319108852,CLRE 253,B00,507202,Vaida; Florin,9999,0,9999,0
1713319109879,CLRE 259,A00,507211,Patel; Hemal,9996,0,9999,3
1713319110906,CLRE 260,A00,507221,Cuomo; Raphael Eduardo,9999,0,9999,0
1713319111932,CLRE 297,001,507242,Cuomo; Raphael Eduardo,9999,0,9999,0
1713319112959,CSE 191,A00,516875,Minnes Kemp; Mor Mia,9999,0,9999,0
1713319113986,CSS 201S,A01,494383,Staff,35,0,35,0
1713319115011,CSS 202S,A01,494387,Staff,35,0,35,0
1713319116038,EAP 100,A00,516065,Staff,9792,0,9999,207
1713319117063,ECE 45,A01,507414,Staff,54,0,60,6
1713319118092,ECE 100,A01,507416,Baghdadchi; Saharnaz,11,0,20,9
1713319118092,ECE 100,A02,507418,Baghdadchi; Saharnaz,20,0,20,0
1713319119120,ECE 111,A01,507420,Staff,40,0,50,10
1713319120156,ECE 197,001,548057,Sievenpiper; Daniel F.,9998,0,9999,1
1713319121183,EDS 115,A00,507243,Choi; Bailey Miyeon,28,0,28,0
1713319122210,EDS 117,A01,494379,Staff,24,0,25,1
1713319123236,EDS 125,A00,507246,Hopkins; Megan Beth,29,0,30,1
1713319124262,EDS 128A,A01,507264,Fargason; Sharon Gayle,26,0,26,0
1713319125287,EDS 128B,A01,507293,Pappas; Elizabeth,30,0,30,0
1713319126312,EDS 139,A00,507294,Fargason; Sharon Gayle,30,0,30,0
1713319126312,EDS 139,B00,507313,Pappas; Elizabeth,30,0,30,0
1713319127341,EDS 201,A00,507315,Staff,26,0,30,4
1713319128367,EDS 203,A01,507317,Halter; Christopher P.,26,0,30,4
1713319129393,EDS 204R,A01,507319,Halter; Christopher P.,4,0,30,26
1713319129393,EDS 204R,B01,507331,Heinzman; Erica M.,28,0,30,2
1713319130419,EDS 206R,A00,507332,Staff,5,0,30,25
1713319130419,EDS 206R,B00,507343,Staff,28,0,30,2
1713319131444,EDS 250,A00,507344,Hemans; Patricia Ann Benitez,36,0,40,4
1713319132473,EDS 281,A00,507345,Daly; Alan J.,18,0,18,0
1713319133498,EDS 284,A00,507350,Daly; Alan J.,16,0,16,0
1713319134523,EDS 286,A00,507359,Fine; Sarah,18,0,18,0
1713319135548,EDS 289C,A01,507361,Daly; Alan J.,18,0,18,0
1713319136576,EDS 290,A00,507366,Hofstetter; Carolyn,15,0,15,0
1713319137602,LIGM 5A,A00,507421,Fischer-Grunski; Eva K,20,0,20,0
1713319138629,LIGM 5B,A00,507423,Fischer-Grunski; Eva K,20,0,20,0
1713319139659,LIGM 5C,A00,507425,Fischer-Grunski; Eva K,20,0,20,0
1713319140685,LIIT 5AS,A00,507427,Carnelos; Chiara,20,0,20,0
1713319141713,LIIT 5BS,A00,507430,Carnelos; Chiara,20,0,20,0
1713319142739,LIIT 5CS,A00,507432,Carnelos; Chiara,20,0,20,0
1713319143765,LISP 5A,A00,507541,Munoz Sanchez; Alicia,19,0,20,1
1713319144788,LISP 5B,A00,507671,Munoz Sanchez; Alicia,17,0,20,3
1713319145814,LISP 5C,A00,507696,Munoz Sanchez; Alicia,17,0,20,3
1713319146839,MAE 197,001,528363,Boechler; Nicholas Sebastia,9998,0,9999,1
1713319147865,MATH 197,001,523477,Kedlaya; Kiran S.,9999,0,9999,0
1713319147865,MATH 197,002,563811,Zhang; Danna,9999,0,9999,0
1713319148893,MCWP 40R,A00,518780,Staff,20,0,20,0
1713319148893,MCWP 40R,B00,518781,Staff,19,0,20,1
1713319148893,MCWP 40R,C00,518783,Staff,19,0,20,1
1713319149918,MCWP 50R,A00,518791,Staff,20,0,20,0
1713319149918,MCWP 50R,B00,518792,Staff,17,0,20,3
1713319149918,MCWP 50R,C00,518793,Staff,19,0,20,1
1713319149918,MCWP 50R,D00,518794,Staff,18,0,20,2
1713319149918,MCWP 50R,E00,518795,Staff,17,0,20,3
1713319149918,MCWP 50R,F00,518796,Staff,19,0,20,1
1713319149918,MCWP 50R,G00,518797,Staff,19,0,20,1
1713319150944,MMW 12R,A01,514034,Herbst; Matthew,15,0,16,1
1713319150944,MMW 12R,A02,514035,Herbst; Matthew,16,0,16,0
1713319151969,MMW 13R,A01,514037,Staff,12,0,16,4
1713319151969,MMW 13R,A02,514039,Staff,16,0,16,0
1713319154023,SIO 295LS,A00,523233,Staff,19,0,30,11
1713319155051,SIO 295S,A00,523232,Staff,19,0,30,11
1713319156080,SOCI 117,A01,494376,Staff,3,0,5,2
1713319157107,WES 237B,A00,494380,Staff,19,0,20,1
1713319159182,AESE 279B,A00,494370,Wade; Jon P,33,0,33,0
1713319160211,ANAR 135S,A00,494369,Braswell; Geoffrey E.,0,0,0,0
1713319161236,CAT 124RS,A01,519847,Geibel; William,17,0,20,3
1713319162264,CAT 125RS,A01,515971,Geibel; William,17,0,20,3
1713319163289,CLRE 250,A00,511389,Morris; Sheldon,9996,0,9999,3
1713319164316,CLRE 251,A00,507176,Mehta; Ravindra L.,9996,0,9999,3
1713319164316,CLRE 251,B00,511410,Mehta; Ravindra L.,9998,0,9999,1
1713319165348,CLRE 252,A00,507189,Cuomo; Raphael Eduardo,9998,0,9999,1
1713319166378,CLRE 253,A00,507199,Vaida; Florin,9997,0,9999,2
1713319166378,CLRE 253,B00,507202,Vaida; Florin,9999,0,9999,0
1713319167406,CLRE 259,A00,507211,Patel; Hemal,9996,0,9999,3
1713319168435,CLRE 260,A00,507221,Cuomo; Raphael Eduardo,9999,0,9999,0
1713319169460,CLRE 297,001,507242,Cuomo; Raphael Eduardo,9999,0,9999,0
1713319170488,CSE 191,A00,516875,Minnes Kemp; Mor Mia,9999,0,9999,0
1713319171515,CSS 201S,A01,494383,Staff,35,0,35,0
1713319172540,CSS 202S,A01,494387,Staff,35,0,35,0
1713319173568,EAP 100,A00,516065,Staff,9792,0,9999,207
1713319174594,ECE 45,A01,507414,Staff,54,0,60,6
1713319175623,ECE 100,A01,507416,Baghdadchi; Saharnaz,11,0,20,9
1713319175623,ECE 100,A02,507418,Baghdadchi; Saharnaz,20,0,20,0
1713319176650,ECE 111,A01,507420,Staff,40,0,50,10
1713319177674,ECE 197,001,548057,Sievenpiper; Daniel F.,9998,0,9999,1
1713319178704,EDS 115,A00,507243,Choi; Bailey Miyeon,28,0,28,0
1713319179729,EDS 117,A01,494379,Staff,24,0,25,1
1713319180756,EDS 125,A00,507246,Hopkins; Megan Beth,29,0,30,1
1713319181782,EDS 128A,A01,507264,Fargason; Sharon Gayle,26,0,26,0
1713319182806,EDS 128B,A01,507293,Pappas; Elizabeth,30,0,30,0
1713319183831,EDS 139,A00,507294,Fargason; Sharon Gayle,30,0,30,0
1713319183831,EDS 139,B00,507313,Pappas; Elizabeth,30,0,30,0
1713319184857,EDS 201,A00,507315,Staff,26,0,30,4
1713319185889,EDS 203,A01,507317,Halter; Christopher P.,26,0,30,4
1713319186915,EDS 204R,A01,507319,Halter; Christopher P.,4,0,30,26
1713319186915,EDS 204R,B01,507331,Heinzman; Erica M.,28,0,30,2
1713319187940,EDS 206R,A00,507332,Staff,5,0,30,25
1713319187940,EDS 206R,B00,507343,Staff,28,0,30,2
1713319188970,EDS 250,A00,507344,Hemans; Patricia Ann Benitez,36,0,40,4
1713319189995,EDS 281,A00,507345,Daly; Alan J.,18,0,18,0
1713319191020,EDS 284,A00,507350,Daly; Alan J.,16,0,16,0
1713319192047,EDS 286,A00,507359,Fine; Sarah,18,0,18,0
1713319193074,EDS 289C,A01,507361,Daly; Alan J.,18,0,18,0
1713319194099,EDS 290,A00,507366,Hofstetter; Carolyn,15,0,15,0
1713319195129,LIGM 5A,A00,507421,Fischer-Grunski; Eva K,20,0,20,0
1713319196157,LIGM 5B,A00,507423,Fischer-Grunski; Eva K,20,0,20,0
1713319197181,LIGM 5C,A00,507425,Fischer-Grunski; Eva K,20,0,20,0
1713319198207,LIIT 5AS,A00,507427,Carnelos; Chiara,20,0,20,0
1713319199240,LIIT 5BS,A00,507430,Carnelos; Chiara,20,0,20,0
1713319200287,LIIT 5CS,A00,507432,Carnelos; Chiara,20,0,20,0
1713319201311,LISP 5A,A00,507541,Munoz Sanchez; Alicia,19,0,20,1
1713319202337,LISP 5B,A00,507671,Munoz Sanchez; Alicia,17,0,20,3
1713319203365,LISP 5C,A00,507696,Munoz Sanchez; Alicia,17,0,20,3
1713319204445,MAE 197,001,528363,Boechler; Nicholas Sebastia,9998,0,9999,1
1713319205475,MATH 197,001,523477,Kedlaya; Kiran S.,9999,0,9999,0
1713319205475,MATH 197,002,563811,Zhang; Danna,9999,0,9999,0
1713319206501,MCWP 40R,A00,518780,Staff,20,0,20,0
1713319206501,MCWP 40R,B00,518781,Staff,19,0,20,1
1713319206501,MCWP 40R,C00,518783,Staff,19,0,20,1
1713319207532,MCWP 50R,A00,518791,Staff,20,0,20,0
1713319207532,MCWP 50R,B00,518792,Staff,17,0,20,3
1713319207532,MCWP 50R,C00,518793,Staff,19,0,20,1
1713319207532,MCWP 50R,D00,518794,Staff,18,0,20,2
1713319207532,MCWP 50R,E00,518795,Staff,17,0,20,3
1713319207532,MCWP 50R,F00,518796,Staff,19,0,20,1
1713319207532,MCWP 50R,G00,518797,Staff,19,0,20,1
1713319208564,MMW 12R,A01,514034,Herbst; Matthew,15,0,16,1
1713319208564,MMW 12R,A02,514035,Herbst; Matthew,16,0,16,0
1713319209589,MMW 13R,A01,514037,Staff,12,0,16,4
1713319209589,MMW 13R,A02,514039,Staff,16,0,16,0
1713319211642,SIO 295LS,A00,523233,Staff,19,0,30,11
1713319212666,SIO 295S,A00,523232,Staff,19,0,30,11
1713319213694,SOCI 117,A01,494376,Staff,3,0,5,2
1713319214723,WES 237B,A00,494380,Staff,19,0,20,1
1713319216796,AESE 279B,A00,494370,Wade; Jon P,33,0,33,0
1713319217822,ANAR 135S,A00,494369,Braswell; Geoffrey E.,0,0,0,0
1713319218848,CAT 124RS,A01,519847,Geibel; William,17,0,20,3
1713319219872,CAT 125RS,A01,515971,Geibel; William,17,0,20,3
1713319220900,CLRE 250,A00,511389,Morris; Sheldon,9996,0,9999,3
1713319221933,CLRE 251,A00,507176,Mehta; Ravindra L.,9996,0,9999,3
1713319221933,CLRE 251,B00,511410,Mehta; Ravindra L.,9998,0,9999,1
1713319222962,CLRE 252,A00,507189,Cuomo; Raphael Eduardo,9998,0,9999,1
1713319223988,CLRE 253,A00,507199,Vaida; Florin,9997,0,9999,2
1713319223988,CLRE 253,B00,507202,Vaida; Florin,9999,0,9999,0
1713319225017,CLRE 259,A00,507211,Patel; Hemal,9996,0,9999,3
1713319226043,CLRE 260,A00,507221,Cuomo; Raphael Eduardo,9999,0,9999,0
1713319227071,CLRE 297,001,507242,Cuomo; Raphael Eduardo,9999,0,9999,0
1713319228098,CSE 191,A00,516875,Minnes Kemp; Mor Mia,9999,0,9999,0
1713319229126,CSS 201S,A01,494383,Staff,35,0,35,0
1713319230154,CSS 202S,A01,494387,Staff,35,0,35,0
1713319231179,EAP 100,A00,516065,Staff,9792,0,9999,207
1713319232204,ECE 45,A01,507414,Staff,54,0,60,6
1713319233229,ECE 100,A01,507416,Baghdadchi; Saharnaz,11,0,20,9
1713319233229,ECE 100,A02,507418,Baghdadchi; Saharnaz,20,0,20,0
1713319234254,ECE 111,A01,507420,Staff,40,0,50,10
1713319235286,ECE 197,001,548057,Sievenpiper; Daniel F.,9998,0,9999,1
1713319236316,EDS 115,A00,507243,Choi; Bailey Miyeon,28,0,28,0
1713319237341,EDS 117,A01,494379,Staff,24,0,25,1
1713319238368,EDS 125,A00,507246,Hopkins; Megan Beth,29,0,30,1
1713319239393,EDS 128A,A01,507264,Fargason; Sharon Gayle,26,0,26,0
1713319240423,EDS 128B,A01,507293,Pappas; Elizabeth,30,0,30,0
1713319241553,EDS 139,A00,507294,Fargason; Sharon Gayle,30,0,30,0
1713319241553,EDS 139,B00,507313,Pappas; Elizabeth,30,0,30,0
1713319242577,EDS 201,A00,507315,Staff,26,0,30,4
1713319243602,EDS 203,A01,507317,Halter; Christopher P.,26,0,30,4
1713319244633,EDS 204R,A01,507319,Halter; Christopher P.,4,0,30,26
1713319244633,EDS 204R,B01,507331,Heinzman; Erica M.,28,0,30,2
1713319245660,EDS 206R,A00,507332,Staff,5,0,30,25
1713319245660,EDS 206R,B00,507343,Staff,28,0,30,2
1713319246687,EDS 250,A00,507344,Hemans; Patricia Ann Benitez,36,0,40,4
1713319247712,EDS 281,A00,507345,Daly; Alan J.,18,0,18,0
1713319248736,EDS 284,A00,507350,Daly; Alan J.,16,0,16,0
1713319249761,EDS 286,A00,507359,Fine; Sarah,18,0,18,0
1713319250786,EDS 289C,A01,507361,Daly; Alan J.,18,0,18,0
1713319251811,EDS 290,A00,507366,Hofstetter; Carolyn,15,0,15,0
1713319252837,LIGM 5A,A00,507421,Fischer-Grunski; Eva K,20,0,20,0
1713319253865,LIGM 5B,A00,507423,Fischer-Grunski; Eva K,20,0,20,0
1713319254892,LIGM 5C,A00,507425,Fischer-Grunski; Eva K,20,0,20,0
1713319255919,LIIT 5AS,A00,507427,Carnelos; Chiara,20,0,20,0
1713319256945,LIIT 5BS,A00,507430,Carnelos; Chiara,20,0,20,0
1713319257974,LIIT 5CS,A00,507432,Carnelos; Chiara,20,0,20,0
1713319259006,LISP 5A,A00,507541,Munoz Sanchez; Alicia,19,0,20,1
1713319260033,LISP 5B,A00,507671,Munoz Sanchez; Alicia,17,0,20,3
1713319261058,LISP 5C,A00,507696,Munoz Sanchez; Alicia,17,0,20,3
1713319262087,MAE 197,001,528363,Boechler; Nicholas Sebastia,9998,0,9999,1
1713319263111,MATH 197,001,523477,Kedlaya; Kiran S.,9999,0,9999,0
1713319263111,MATH 197,002,563811,Zhang; Danna,9999,0,9999,0
1713319264139,MCWP 40R,A00,518780,Staff,20,0,20,0
1713319264139,MCWP 40R,B00,518781,Staff,19,0,20,1
1713319264139,MCWP 40R,C00,518783,Staff,19,0,20,1
1713319265166,MCWP 50R,A00,518791,Staff,20,0,20,0
1713319265166,MCWP 50R,B00,518792,Staff,17,0,20,3
1713319265166,MCWP 50R,C00,518793,Staff,19,0,20,1
1713319265166,MCWP 50R,D00,518794,Staff,18,0,20,2
1713319265166,MCWP 50R,E00,518795,Staff,17,0,20,3
1713319265166,MCWP 50R,F00,518796,Staff,19,0,20,1
1713319265166,MCWP 50R,G00,518797,Staff,19,0,20,1
1713319266198,MMW 12R,A01,514034,Herbst; Matthew,15,0,16,1
1713319266198,MMW 12R,A02,514035,Herbst; Matthew,16,0,16,0
1713319267226,MMW 13R,A01,514037,Staff,12,0,16,4
1713319267226,MMW 13R,A02,514039,Staff,16,0,16,0
1713319269283,SIO 295LS,A00,523233,Staff,19,0,30,11
1713319270309,SIO 295S,A00,523232,Staff,19,0,30,11
1713319271333,SOCI 117,A01,494376,Staff,3,0,5,2
1713319272359,WES 237B,A00,494380,Staff,19,0,20,1
1713319274440,AESE 279B,A00,494370,Wade; Jon P,33,0,33,0
1713319275466,ANAR 135S,A00,494369,Braswell; Geoffrey E.,0,0,0,0
1713319276494,CAT 124RS,A01,519847,Geibel; William,17,0,20,3
1713319277520,CAT 125RS,A01,515971,Geibel; William,17,0,20,3
1713319278546,CLRE 250,A00,511389,Morris; Sheldon,9996,0,9999,3
1713319279575,CLRE 251,A00,507176,Mehta; Ravindra L.,9996,0,9999,3
1713319279575,CLRE 251,B00,511410,Mehta; Ravindra L.,9998,0,9999,1
1713319280604,CLRE 252,A00,507189,Cuomo; Raphael Eduardo,9998,0,9999,1
1713319281634,CLRE 253,A00,507199,Vaida; Florin,9997,0,9999,2
1713319281634,CLRE 253,B00,507202,Vaida; Florin,9999,0,9999,0
1713319282665,CLRE 259,A00,507211,Patel; Hemal,9996,0,9999,3
1713319283692,CLRE 260,A00,507221,Cuomo; Raphael Eduardo,9999,0,9999,0
1713319284717,CLRE 297,001,507242,Cuomo; Raphael Eduardo,9999,0,9999,0
1713319285742,CSE 191,A00,516875,Minnes Kemp; Mor Mia,9999,0,9999,0
1713319286767,CSS 201S,A01,494383,Staff,35,0,35,0
1713319287794,CSS 202S,A01,494387,Staff,35,0,35,0
1713319288821,EAP 100,A00,516065,Staff,9792,0,9999,207
1713319289845,ECE 45,A01,507414,Staff,54,0,60,6
1713319290869,ECE 100,A01,507416,Baghdadchi; Saharnaz,11,0,20,9
1713319290869,ECE 100,A02,507418,Baghdadchi; Saharnaz,20,0,20,0
1713319291899,ECE 111,A01,507420,Staff,40,0,50,10
1713319292926,ECE 197,001,548057,Sievenpiper; Daniel F.,9998,0,9999,1
1713319293956,EDS 115,A00,507243,Choi; Bailey Miyeon,28,0,28,0
1713319294984,EDS 117,A01,494379,Staff,24,0,25,1
1713319296010,EDS 125,A00,507246,Hopkins; Megan Beth,29,0,30,1
1713319297040,EDS 128A,A01,507264,Fargason; Sharon Gayle,26,0,26,0
1713319298067,EDS 128B,A01,507293,Pappas; Elizabeth,30,0,30,0
1713319299092,EDS 139,A00,507294,Fargason; Sharon Gayle,30,0,30,0
1713319299092,EDS 139,B00,507313,Pappas; Elizabeth,30,0,30,0
1713319300119,EDS 201,A00,507315,Staff,26,0,30,4
1713319301144,EDS 203,A01,507317,Halter; Christopher P.,26,0,30,4
1713319302170,EDS 204R,A01,507319,Halter; Christopher P.,4,0,30,26
1713319302170,EDS 204R,B01,507331,Heinzman; Erica M.,28,0,30,2
1713319303200,EDS 206R,A00,507332,Staff,5,0,30,25
1713319303200,EDS 206R,B00,507343,Staff,28,0,30,2
1713319304225,EDS 250,A00,507344,Hemans; Patricia Ann Benitez,36,0,40,4
1713319305251,EDS 281,A00,507345,Daly; Alan J.,18,0,18,0
1713319306277,EDS 284,A00,507350,Daly; Alan J.,16,0,16,0
1713319307302,EDS 286,A00,507359,Fine; Sarah,18,0,18,0
1713319308386,EDS 289C,A01,507361,Daly; Alan J.,18,0,18,0
1713319309411,EDS 290,A00,507366,Hofstetter; Carolyn,15,0,15,0
1713319310437,LIGM 5A,A00,507421,Fischer-Grunski; Eva K,20,0,20,0
1713319311461,LIGM 5B,A00,507423,Fischer-Grunski; Eva K,20,0,20,0
1713319312490,LIGM 5C,A00,507425,Fischer-Grunski; Eva K,20,0,20,0
1713319313520,LIIT 5AS,A00,507427,Carnelos; Chiara,20,0,20,0
1713319314551,LIIT 5BS,A00,507430,Carnelos; Chiara,20,0,20,0
1713319315582,LIIT 5CS,A00,507432,Carnelos; Chiara,20,0,20,0
1713319316611,LISP 5A,A00,507541,Munoz Sanchez; Alicia,19,0,20,1
1713319317640,LISP 5B,A00,507671,Munoz Sanchez; Alicia,17,0,20,3
1713319318669,LISP 5C,A00,507696,Munoz Sanchez; Alicia,17,0,20,3
1713319319694,MAE 197,001,528363,Boechler; Nicholas Sebastia,9998,0,9999,1
1713319320723,MATH 197,001,523477,Kedlaya; Kiran S.,9999,0,9999,0
1713319320723,MATH 197,002,563811,Zhang; Danna,9999,0,9999,0
1713319321749,MCWP 40R,A00,518780,Staff,20,0,20,0
1713319321749,MCWP 40R,B00,518781,Staff,19,0,20,1
1713319321749,MCWP 40R,C00,518783,Staff,19,0,20,1
1713319322773,MCWP 50R,A00,518791,Staff,20,0,20,0
1713319322773,MCWP 50R,B00,518792,Staff,17,0,20,3
1713319322773,MCWP 50R,C00,518793,Staff,19,0,20,1
1713319322773,MCWP 50R,D00,518794,Staff,18,0,20,2
1713319322773,MCWP 50R,E00,518795,Staff,17,0,20,3
1713319322773,MCWP 50R,F00,518796,Staff,19,0,20,1
1713319322773,MCWP 50R,G00,518797,Staff,19,0,20,1
1713319323798,MMW 12R,A01,514034,Herbst; Matthew,15,0,16,1
1713319323798,MMW 12R,A02,514035,Herbst; Matthew,16,0,16,0
1713319324827,MMW 13R,A01,514037,Staff,12,0,16,4
1713319324827,MMW 13R,A02,514039,Staff,16,0,16,0
1713319326879,SIO 295LS,A00,523233,Staff,19,0,30,11
1713319327905,SIO 295S,A00,523232,Staff,19,0,30,11
1713319328931,SOCI 117,A01,494376,Staff,3,0,5,2
1713319329955,WES 237B,A00,494380,Staff,19,0,20,1
1713319332016,AESE 279B,A00,494370,Wade; Jon P,33,0,33,0
1713319333044,ANAR 135S,A00,494369,Braswell; Geoffrey E.,0,0,0,0
1713319334072,CAT 124RS,A01,519847,Geibel; William,17,0,20,3
1713319335099,CAT 125RS,A01,515971,Geibel; William,17,0,20,3
1713319336124,CLRE 250,A00,511389,Morris; Sheldon,9996,0,9999,3
1713319337149,CLRE 251,A00,507176,Mehta; Ravindra L.,9996,0,9999,3
1713319337149,CLRE 251,B00,511410,Mehta; Ravindra L.,9998,0,9999,1
1713319338177,CLRE 252,A00,507189,Cuomo; Raphael Eduardo,9998,0,9999,1
1713319339202,CLRE 253,A00,507199,Vaida; Florin,9997,0,9999,2
1713319339202,CLRE 253,B00,507202,Vaida; Florin,9999,0,9999,0
1713319340230,CLRE 259,A00,507211,Patel; Hemal,9996,0,9999,3
1713319341256,CLRE 260,A00,507221,Cuomo; Raphael Eduardo,9999,0,9999,0
1713319342280,CLRE 297,001,507242,Cuomo; Raphael Eduardo,9999,0,9999,0
1713319343305,CSE 191,A00,516875,Minnes Kemp; Mor Mia,9999,0,9999,0
1713319344332,CSS 201S,A01,494383,Staff,35,0,35,0
1713319345363,CSS 202S,A01,494387,Staff,35,0,35,0
1713319346393,EAP 100,A00,516065,Staff,9792,0,9999,207
1713319347423,ECE 45,A01,507414,Staff,54,0,60,6
1713319348452,ECE 100,A01,507416,Baghdadchi; Saharnaz,11,0,20,9
1713319348452,ECE 100,A02,507418,Baghdadchi; Saharnaz,20,0,20,0
1713319349478,ECE 111,A01,507420,Staff,40,0,50,10
1713319350507,ECE 197,001,548057,Sievenpiper; Daniel F.,9998,0,9999,1
1713319351538,EDS 115,A00,507243,Choi; Bailey Miyeon,28,0,28,0
1713319352565,EDS 117,A01,494379,Staff,24,0,25,1
1713319353589,EDS 125,A00,507246,Hopkins; Megan Beth,29,0,30,1
1713319354620,EDS 128A,A01,507264,Fargason; Sharon Gayle,26,0,26,0
1713319355647,EDS 128B,A01,507293,Pappas; Elizabeth,30,0,30,0
1713319356672,EDS 139,A00,507294,Fargason; Sharon Gayle,30,0,30,0
1713319356672,EDS 139,B00,507313,Pappas; Elizabeth,30,0,30,0
1713319357696,EDS 201,A00,507315,Staff,26,0,30,4
1713319358722,EDS 203,A01,507317,Halter; Christopher P.,26,0,30,4
1713319359750,EDS 204R,A01,507319,Halter; Christopher P.,4,0,30,26
1713319359750,EDS 204R,B01,507331,Heinzman; Erica M.,28,0,30,2
1713319360780,EDS 206R,A00,507332,Staff,5,0,30,25
1713319360780,EDS 206R,B00,507343,Staff,28,0,30,2
1713319361809,EDS 250,A00,507344,Hemans; Patricia Ann Benitez,36,0,40,4
1713319362837,EDS 281,A00,507345,Daly; Alan J.,18,0,18,0
1713319363866,EDS 284,A00,507350,Daly; Alan J.,16,0,16,0
1713319364895,EDS 286,A00,507359,Fine; Sarah,18,0,18,0
1713319365925,EDS 289C,A01,507361,Daly; Alan J.,18,0,18,0
1713319366950,EDS 290,A00,507366,Hofstetter; Carolyn,15,0,15,0
1713319367982,LIGM 5A,A00,507421,Fischer-Grunski; Eva K,20,0,20,0
1713319369010,LIGM 5B,A00,507423,Fischer-Grunski; Eva K,20,0,20,0
1713319370036,LIGM 5C,A00,507425,Fischer-Grunski; Eva K,20,0,20,0
1713319371061,LIIT 5AS,A00,507427,Carnelos; Chiara,20,0,20,0
1713319372087,LIIT 5BS,A00,507430,Carnelos; Chiara,20,0,20,0
1713319373113,LIIT 5CS,A00,507432,Carnelos; Chiara,20,0,20,0
1713319374144,LISP 5A,A00,507541,Munoz Sanchez; Alicia,19,0,20,1
1713319375174,LISP 5B,A00,507671,Munoz Sanchez; Alicia,17,0,20,3
1713319376205,LISP 5C,A00,507696,Munoz Sanchez; Alicia,17,0,20,3
1713319377230,MAE 197,001,528363,Boechler; Nicholas Sebastia,9998,0,9999,1
1713319378257,MATH 197,001,523477,Kedlaya; Kiran S.,9999,0,9999,0
1713319378257,MATH 197,002,563811,Zhang; Danna,9999,0,9999,0
1713319379282,MCWP 40R,A00,518780,Staff,20,0,20,0
1713319379282,MCWP 40R,B00,518781,Staff,19,0,20,1
1713319379282,MCWP 40R,C00,518783,Staff,19,0,20,1
1713319380309,MCWP 50R,A00,518791,Staff,20,0,20,0
1713319380309,MCWP 50R,B00,518792,Staff,17,0,20,3
1713319380309,MCWP 50R,C00,518793,Staff,19,0,20,1
1713319380309,MCWP 50R,D00,518794,Staff,18,0,20,2
1713319380309,MCWP 50R,E00,518795,Staff,17,0,20,3
1713319380309,MCWP 50R,F00,518796,Staff,19,0,20,1
1713319380309,MCWP 50R,G00,518797,Staff,19,0,20,1
1713319381336,MMW 12R,A01,514034,Herbst; Matthew,15,0,16,1
1713319381336,MMW 12R,A02,514035,Herbst; Matthew,16,0,16,0
1713319382366,MMW 13R,A01,514037,Staff,12,0,16,4
1713319382366,MMW 13R,A02,514039,Staff,16,0,16,0
1713319384420,SIO 295LS,A00,523233,Staff,19,0,30,11
1713319385445,SIO 295S,A00,523232,Staff,19,0,30,11
1713319386469,SOCI 117,A01,494376,Staff,3,0,5,2
1713319387500,WES 237B,A00,494380,Staff,19,0,20,1
1713319389567,AESE 279B,A00,494370,Wade; Jon P,33,0,33,0
1713319390591,ANAR 135S,A00,494369,Braswell; Geoffrey E.,0,0,0,0
1713319391616,CAT 124RS,A01,519847,Geibel; William,17,0,20,3
1713319392643,CAT 125RS,A01,515971,Geibel; William,17,0,20,3
1713319393670,CLRE 250,A00,511389,Morris; Sheldon,9996,0,9999,3
1713319394696,CLRE 251,A00,507176,Mehta; Ravindra L.,9996,0,9999,3
1713319394696,CLRE 251,B00,511410,Mehta; Ravindra L.,9998,0,9999,1
1713319395721,CLRE 252,A00,507189,Cuomo; Raphael Eduardo,9998,0,9999,1
1713319396746,CLRE 253,A00,507199,Vaida; Florin,9997,0,9999,2
1713319396746,CLRE 253,B00,507202,Vaida; Florin,9999,0,9999,0
1713319397771,CLRE 259,A00,507211,Patel; Hemal,9996,0,9999,3
1713319398800,CLRE 260,A00,507221,Cuomo; Raphael Eduardo,9999,0,9999,0
1713319399824,CLRE 297,001,507242,Cuomo; Raphael Eduardo,9999,0,9999,0
1713319400853,CSE 191,A00,516875,Minnes Kemp; Mor Mia,9999,0,9999,0
1713319401880,CSS 201S,A01,494383,Staff,35,0,35,0
1713319402904,CSS 202S,A01,494387,Staff,35,0,35,0
1713319403930,EAP 100,A00,516065,Staff,9792,0,9999,207
1713319404959,ECE 45,A01,507414,Staff,54,0,60,6
1713319405989,ECE 100,A01,507416,Baghdadchi; Saharnaz,11,0,20,9
1713319405989,ECE 100,A02,507418,Baghdadchi; Saharnaz,20,0,20,0
1713319407013,ECE 111,A01,507420,Staff,40,0,50,10
1713319408044,ECE 197,001,548057,Sievenpiper; Daniel F.,9998,0,9999,1
1713319409072,EDS 115,A00,507243,Choi; Bailey Miyeon,28,0,28,0
1713319410098,EDS 117,A01,494379,Staff,24,0,25,1
1713319411125,EDS 125,A00,507246,Hopkins; Megan Beth,29,0,30,1
1713319412206,EDS 128A,A01,507264,Fargason; Sharon Gayle,26,0,26,0
1713319413234,EDS 128B,A01,507293,Pappas; Elizabeth,30,0,30,0
1713319414259,EDS 139,A00,507294,Fargason; Sharon Gayle,30,0,30,0
1713319414259,EDS 139,B00,507313,Pappas; Elizabeth,30,0,30,0
1713319415284,EDS 201,A00,507315,Staff,26,0,30,4
1713319416317,EDS 203,A01,507317,Halter; Christopher P.,26,0,30,4
1713319417345,EDS 204R,A01,507319,Halter; Christopher P.,4,0,30,26
1713319417345,EDS 204R,B01,507331,Heinzman; Erica M.,28,0,30,2
1713319418369,EDS 206R,A00,507332,Staff,5,0,30,25
1713319418369,EDS 206R,B00,507343,Staff,28,0,30,2
1713319419398,EDS 250,A00,507344,Hemans; Patricia Ann Benitez,36,0,40,4
1713319420426,EDS 281,A00,507345,Daly; Alan J.,18,0,18,0
1713319421450,EDS 284,A00,507350,Daly; Alan J.,16,0,16,0
1713319422479,EDS 286,A00,507359,Fine; Sarah,18,0,18,0
1713319423508,EDS 289C,A01,507361,Daly; Alan J.,18,0,18,0
1713319424534,EDS 290,A00,507366,Hofstetter; Carolyn,15,0,15,0
1713319425564,LIGM 5A,A00,507421,Fischer-Grunski; Eva K,20,0,20,0
1713319426592,LIGM 5B,A00,507423,Fischer-Grunski; Eva K,20,0,20,0
1713319427616,LIGM 5C,A00,507425,Fischer-Grunski; Eva K,20,0,20,0
1713319428641,LIIT 5AS,A00,507427,Carnelos; Chiara,20,0,20,0
1713319429666,LIIT 5BS,A00,507430,Carnelos; Chiara,20,0,20,0
1713319430691,LIIT 5CS,A00,507432,Carnelos; Chiara,20,0,20,0
1713319431717,LISP 5A,A00,507541,Munoz Sanchez; Alicia,19,0,20,1
1713319432747,LISP 5B,A00,507671,Munoz Sanchez; Alicia,17,0,20,3
1713319433775,LISP 5C,A00,507696,Munoz Sanchez; Alicia,17,0,20,3
1713319434802,MAE 197,001,528363,Boechler; Nicholas Sebastia,9998,0,9999,1
1713319435831,MATH 197,001,523477,Kedlaya; Kiran S.,9999,0,9999,0
1713319435831,MATH 197,002,563811,Zhang; Danna,9999,0,9999,0
1713319436856,MCWP 40R,A00,518780,Staff,20,0,20,0
1713319436856,MCWP 40R,B00,518781,Staff,19,0,20,1
1713319436856,MCWP 40R,C00,518783,Staff,19,0,20,1
1713319437885,MCWP 50R,A00,518791,Staff,20,0,20,0
1713319437885,MCWP 50R,B00,518792,Staff,17,0,20,3
1713319437885,MCWP 50R,C00,518793,Staff,19,0,20,1
1713319437885,MCWP 50R,D00,518794,Staff,18,0,20,2
1713319437885,MCWP 50R,E00,518795,Staff,17,0,20,3
1713319437885,MCWP 50R,F00,518796,Staff,19,0,20,1
1713319437885,MCWP 50R,G00,518797,Staff,19,0,20,1
1713319438913,MMW 12R,A01,514034,Herbst; Matthew,15,0,16,1
1713319438913,MMW 12R,A02,514035,Herbst; Matthew,16,0,16,0
1713319439939,MMW 13R,A01,514037,Staff,12,0,16,4
1713319439939,MMW 13R,A02,514039,Staff,16,0,16,0
1713319441994,SIO 295LS,A00,523233,Staff,19,0,30,11
1713319443018,SIO 295S,A00,523232,Staff,19,0,30,11
1713319444048,SOCI 117,A01,494376,Staff,3,0,5,2
1713319445077,WES 237B,A00,494380,Staff,19,0,20,1
1713319447141,AESE 279B,A00,494370,Wade; Jon P,33,0,33,0
1713319448166,ANAR 135S,A00,494369,Braswell; Geoffrey E.,0,0,0,0
1713319449195,CAT 124RS,A01,519847,Geibel; William,17,0,20,3
1713319450221,CAT 125RS,A01,515971,Geibel; William,17,0,20,3
1713319451244,CLRE 250,A00,511389,Morris; Sheldon,9996,0,9999,3
1713319452273,CLRE 251,A00,507176,Mehta; Ravindra L.,9996,0,9999,3
1713319452273,CLRE 251,B00,511410,Mehta; Ravindra L.,9998,0,9999,1
1713319453298,CLRE 252,A00,507189,Cuomo; Raphael Eduardo,9998,0,9999,1
1713319454327,CLRE 253,A00,507199,Vaida; Florin,9997,0,9999,2
1713319454327,CLRE 253,B00,507202,Vaida; Florin,9999,0,9999,0
1713319455356,CLRE 259,A00,507211,Patel; Hemal,9996,0,9999,3
1713319456384,CLRE 260,A00,507221,Cuomo; Raphael Eduardo,9999,0,9999,0
1713319457410,CLRE 297,001,507242,Cuomo; Raphael Eduardo,9999,0,9999,0
1713319458438,CSE 191,A00,516875,Minnes Kemp; Mor Mia,9999,0,9999,0
1713319459464,CSS 201S,A01,494383,Staff,35,0,35,0
1713319460491,CSS 202S,A01,494387,Staff,35,0,35,0
1713319461518,EAP 100,A00,516065,Staff,9792,0,9999,207
1713319462547,ECE 45,A01,507414,Staff,54,0,60,6
1713319463573,ECE 100,A01,507416,Baghdadchi; Saharnaz,11,0,20,9
1713319463573,ECE 100,A02,507418,Baghdadchi; Saharnaz,20,0,20,0
1713319464601,ECE 111,A01,507420,Staff,40,0,50,10
1713319465632,ECE 197,001,548057,Sievenpiper; Daniel F.,9998,0,9999,1
1713319466658,EDS 115,A00,507243,Choi; Bailey Miyeon,28,0,28,0
1713319467683,EDS 117,A01,494379,Staff,24,0,25,1
1713319468708,EDS 125,A00,507246,Hopkins; Megan Beth,29,0,30,1
1713319469732,EDS 128A,A01,507264,Fargason; Sharon Gayle,26,0,26,0
1713319470768,EDS 128B,A01,507293,Pappas; Elizabeth,30,0,30,0
1713319471796,EDS 139,A00,507294,Fargason; Sharon Gayle,30,0,30,0
1713319471796,EDS 139,B00,507313,Pappas; Elizabeth,30,0,30,0
1713319472821,EDS 201,A00,507315,Staff,26,0,30,4
1713319473850,EDS 203,A01,507317,Halter; Christopher P.,26,0,30,4
1713319474876,EDS 204R,A01,507319,Halter; Christopher P.,4,0,30,26
1713319474876,EDS 204R,B01,507331,Heinzman; Erica M.,28,0,30,2
1713319475907,EDS 206R,A00,507332,Staff,5,0,30,25
1713319475907,EDS 206R,B00,507343,Staff,28,0,30,2
1713319476941,EDS 250,A00,507344,Hemans; Patricia Ann Benitez,36,0,40,4
1713319477969,EDS 281,A00,507345,Daly; Alan J.,18,0,18,0
1713319478997,EDS 284,A00,507350,Daly; Alan J.,16,0,16,0
1713319480024,EDS 286,A00,507359,Fine; Sarah,18,0,18,0
1713319481053,EDS 289C,A01,507361,Daly; Alan J.,18,0,18,0
1713319482077,EDS 290,A00,507366,Hofstetter; Carolyn,15,0,15,0
1713319483108,LIGM 5A,A00,507421,Fischer-Grunski; Eva K,20,0,20,0
1713319484133,LIGM 5B,A00,507423,Fischer-Grunski; Eva K,20,0,20,0
1713319485158,LIGM 5C,A00,507425,Fischer-Grunski; Eva K,20,0,20,0
1713319486184,LIIT 5AS,A00,507427,Carnelos; Chiara,20,0,20,0
1713319487209,LIIT 5BS,A00,507430,Carnelos; Chiara,20,0,20,0
1713319488236,LIIT 5CS,A00,507432,Carnelos; Chiara,20,0,20,0
1713319489262,LISP 5A,A00,507541,Munoz Sanchez; Alicia,19,0,20,1
1713319490287,LISP 5B,A00,507671,Munoz Sanchez; Alicia,17,0,20,3
1713319491315,LISP 5C,A00,507696,Munoz Sanchez; Alicia,17,0,20,3
1713319492341,MAE 197,001,528363,Boechler; Nicholas Sebastia,9998,0,9999,1
1713319493372,MATH 197,001,523477,Kedlaya; Kiran S.,9999,0,9999,0
1713319493372,MATH 197,002,563811,Zhang; Danna,9999,0,9999,0
1713319494398,MCWP 40R,A00,518780,Staff,20,0,20,0
1713319494398,MCWP 40R,B00,518781,Staff,19,0,20,1
1713319494398,MCWP 40R,C00,518783,Staff,19,0,20,1
1713319495422,MCWP 50R,A00,518791,Staff,20,0,20,0
1713319495422,MCWP 50R,B00,518792,Staff,17,0,20,3
1713319495422,MCWP 50R,C00,518793,Staff,19,0,20,1
1713319495422,MCWP 50R,D00,518794,Staff,18,0,20,2
1713319495422,MCWP 50R,E00,518795,Staff,17,0,20,3
1713319495422,MCWP 50R,F00,518796,Staff,19,0,20,1
1713319495422,MCWP 50R,G00,518797,Staff,19,0,20,1
1713319496450,MMW 12R,A01,514034,Herbst; Matthew,15,0,16,1
1713319496450,MMW 12R,A02,514035,Herbst; Matthew,16,0,16,0
1713319497474,MMW 13R,A01,514037,Staff,12,0,16,4
1713319497474,MMW 13R,A02,514039,Staff,16,0,16,0
1713319499530,SIO 295LS,A00,523233,Staff,19,0,30,11
1713319500554,SIO 295S,A00,523232,Staff,19,0,30,11
1713319501578,SOCI 117,A01,494376,Staff,3,0,5,2
1713319502604,WES 237B,A00,494380,Staff,19,0,20,1
1713319504673,AESE 279B,A00,494370,Wade; Jon P,33,0,33,0
1713319505699,ANAR 135S,A00,494369,Braswell; Geoffrey E.,0,0,0,0
1713319506726,CAT 124RS,A01,519847,Geibel; William,17,0,20,3
1713319507755,CAT 125RS,A01,515971,Geibel; William,17,0,20,3
1713319508780,CLRE 250,A00,511389,Morris; Sheldon,9996,0,9999,3
1713319509807,CLRE 251,A00,507176,Mehta; Ravindra L.,9996,0,9999,3
1713319509807,CLRE 251,B00,511410,Mehta; Ravindra L.,9998,0,9999,1
1713319510833,CLRE 252,A00,507189,Cuomo; Raphael Eduardo,9998,0,9999,1
1713319511862,CLRE 253,A00,507199,Vaida; Florin,9997,0,9999,2
1713319511862,CLRE 253,B00,507202,Vaida; Florin,9999,0,9999,0
1713319512888,CLRE 259,A00,507211,Patel; Hemal,9996,0,9999,3
1713319513912,CLRE 260,A00,507221,Cuomo; Raphael Eduardo,9999,0,9999,0
1713319514939,CLRE 297,001,507242,Cuomo; Raphael Eduardo,9999,0,9999,0
1713319516036,CSE 191,A00,516875,Minnes Kemp; Mor Mia,9999,0,9999,0
1713319517062,CSS 201S,A01,494383,Staff,35,0,35,0
1713319518094,CSS 202S,A01,494387,Staff,35,0,35,0
1713319519120,EAP 100,A00,516065,Staff,9792,0,9999,207
1713319520145,ECE 45,A01,507414,Staff,54,0,60,6
1713319521170,ECE 100,A01,507416,Baghdadchi; Saharnaz,11,0,20,9
1713319521170,ECE 100,A02,507418,Baghdadchi; Saharnaz,20,0,20,0
1713319522198,ECE 111,A01,507420,Staff,40,0,50,10
1713319523224,ECE 197,001,548057,Sievenpiper; Daniel F.,9998,0,9999,1
1713319524249,EDS 115,A00,507243,Choi; Bailey Miyeon,28,0,28,0
1713319525274,EDS 117,A01,494379,Staff,24,0,25,1
1713319526301,EDS 125,A00,507246,Hopkins; Megan Beth,29,0,30,1
1713319527329,EDS 128A,A01,507264,Fargason; Sharon Gayle,26,0,26,0
1713319528358,EDS 128B,A01,507293,Pappas; Elizabeth,30,0,30,0
1713319529383,EDS 139,A00,507294,Fargason; Sharon Gayle,30,0,30,0
1713319529383,EDS 139,B00,507313,Pappas; Elizabeth,30,0,30,0
1713319530411,EDS 201,A00,507315,Staff,26,0,30,4
1713319531435,EDS 203,A01,507317,Halter; Christopher P.,26,0,30,4
1713319532461,EDS 204R,A01,507319,Halter; Christopher P.,4,0,30,26
1713319532461,EDS 204R,B01,507331,Heinzman; Erica M.,28,0,30,2
1713319533484,EDS 206R,A00,507332,Staff,5,0,30,25
1713319533484,EDS 206R,B00,507343,Staff,28,0,30,2
1713319534510,EDS 250,A00,507344,Hemans; Patricia Ann Benitez,36,0,40,4
1713319535538,EDS 281,A00,507345,Daly; Alan J.,18,0,18,0
1713319536566,EDS 284,A00,507350,Daly; Alan J.,16,0,16,0
1713319537590,EDS 286,A00,507359,Fine; Sarah,18,0,18,0
1713319538614,EDS 289C,A01,507361,Daly; Alan J.,18,0,18,0
1713319539644,EDS 290,A00,507366,Hofstetter; Carolyn,15,0,15,0
1713319540671,LIGM 5A,A00,507421,Fischer-Grunski; Eva K,20,0,20,0
1713319541700,LIGM 5B,A00,507423,Fischer-Grunski; Eva K,20,0,20,0
1713319542729,LIGM 5C,A00,507425,Fischer-Grunski; Eva K,20,0,20,0
1713319543757,LIIT 5AS,A00,507427,Carnelos; Chiara,20,0,20,0
1713319544785,LIIT 5BS,A00,507430,Carnelos; Chiara,20,0,20,0
1713319545815,LIIT 5CS,A00,507432,Carnelos; Chiara,20,0,20,0
1713319546840,LISP 5A,A00,507541,Munoz Sanchez; Alicia,19,0,20,1
1713319547865,LISP 5B,A00,507671,Munoz Sanchez; Alicia,17,0,20,3
1713319548894,LISP 5C,A00,507696,Munoz Sanchez; Alicia,17,0,20,3
1713319549919,MAE 197,001,528363,Boechler; Nicholas Sebastia,9998,0,9999,1
1713319550949,MATH 197,001,523477,Kedlaya; Kiran S.,9999,0,9999,0
1713319550949,MATH 197,002,563811,Zhang; Danna,9999,0,9999,0
1713319551974,MCWP 40R,A00,518780,Staff,20,0,20,0
1713319551974,MCWP 40R,B00,518781,Staff,19,0,20,1
1713319551974,MCWP 40R,C00,518783,Staff,19,0,20,1
1713319553002,MCWP 50R,A00,518791,Staff,20,0,20,0
1713319553002,MCWP 50R,B00,518792,Staff,17,0,20,3
1713319553002,MCWP 50R,C00,518793,Staff,19,0,20,1
1713319553002,MCWP 50R,D00,518794,Staff,18,0,20,2
1713319553002,MCWP 50R,E00,518795,Staff,17,0,20,3
1713319553002,MCWP 50R,F00,518796,Staff,19,0,20,1
1713319553002,MCWP 50R,G00,518797,Staff,19,0,20,1
1713319554027,MMW 12R,A01,514034,Herbst; Matthew,15,0,16,1
1713319554027,MMW 12R,A02,514035,Herbst; Matthew,16,0,16,0
1713319555053,MMW 13R,A01,514037,Staff,12,0,16,4
1713319555053,MMW 13R,A02,514039,Staff,16,0,16,0
1713319557107,SIO 295LS,A00,523233,Staff,19,0,30,11
1713319558131,SIO 295S,A00,523232,Staff,19,0,30,11
1713319559156,SOCI 117,A01,494376,Staff,3,0,5,2
1713319560186,WES 237B,A00,494380,Staff,19,0,20,1
1713319562248,AESE 279B,A00,494370,Wade; Jon P,33,0,33,0
1713319563273,ANAR 135S,A00,494369,Braswell; Geoffrey E.,0,0,0,0
1713319564299,CAT 124RS,A01,519847,Geibel; William,17,0,20,3
1713319565323,CAT 125RS,A01,515971,Geibel; William,17,0,20,3
1713319566351,CLRE 250,A00,511389,Morris; Sheldon,9996,0,9999,3
1713319567388,CLRE 251,A00,507176,Mehta; Ravindra L.,9996,0,9999,3
1713319567388,CLRE 251,B00,511410,Mehta; Ravindra L.,9998,0,9999,1
1713319568412,CLRE 252,A00,507189,Cuomo; Raphael Eduardo,9998,0,9999,1
1713319569437,CLRE 253,A00,507199,Vaida; Florin,9997,0,9999,2
1713319569437,CLRE 253,B00,507202,Vaida; Florin,9999,0,9999,0
1713319570465,CLRE 259,A00,507211,Patel; Hemal,9996,0,9999,3
1713319571494,CLRE 260,A00,507221,Cuomo; Raphael Eduardo,9999,0,9999,0
1713319572522,CLRE 297,001,507242,Cuomo; Raphael Eduardo,9999,0,9999,0
1713319573548,CSE 191,A00,516875,Minnes Kemp; Mor Mia,9999,0,9999,0
1713319574572,CSS 201S,A01,494383,Staff,35,0,35,0
1713319575602,CSS 202S,A01,494387,Staff,35,0,35,0
1713319576630,EAP 100,A00,516065,Staff,9792,0,9999,207
1713319577655,ECE 45,A01,507414,Staff,54,0,60,6
1713319578680,ECE 100,A01,507416,Baghdadchi; Saharnaz,11,0,20,9
1713319578680,ECE 100,A02,507418,Baghdadchi; Saharnaz,20,0,20,0
1713319579709,ECE 111,A01,507420,Staff,40,0,50,10
1713319580738,ECE 197,001,548057,Sievenpiper; Daniel F.,9998,0,9999,1
1713319581773,EDS 115,A00,507243,Choi; Bailey Miyeon,28,0,28,0
1713319582804,EDS 117,A01,494379,Staff,24,0,25,1
1713319583830,EDS 125,A00,507246,Hopkins; Megan Beth,29,0,30,1
1713319584856,EDS 128A,A01,507264,Fargason; Sharon Gayle,26,0,26,0
1713319585888,EDS 128B,A01,507293,Pappas; Elizabeth,30,0,30,0
1713319586916,EDS 139,A00,507294,Fargason; Sharon Gayle,30,0,30,0
1713319586916,EDS 139,B00,507313,Pappas; Elizabeth,30,0,30,0
1713319587942,EDS 201,A00,507315,Staff,26,0,30,4
1713319588969,EDS 203,A01,507317,Halter; Christopher P.,26,0,30,4
1713319590000,EDS 204R,A01,507319,Halter; Christopher P.,4,0,30,26
1713319590000,EDS 204R,B01,507331,Heinzman; Erica M.,28,0,30,2
1713319591025,EDS 206R,A00,507332,Staff,5,0,30,25
1713319591025,EDS 206R,B00,507343,Staff,28,0,30,2
1713319592049,EDS 250,A00,507344,Hemans; Patricia Ann Benitez,36,0,40,4
1713319593079,EDS 281,A00,507345,Daly; Alan J.,18,0,18,0
1713319594107,EDS 284,A00,507350,Daly; Alan J.,16,0,16,0
1713319595138,EDS 286,A00,507359,Fine; Sarah,18,0,18,0
1713319596162,EDS 289C,A01,507361,Daly; Alan J.,18,0,18,0
1713319597340,EDS 290,A00,507366,Hofstetter; Carolyn,15,0,15,0
1713319598367,LIGM 5A,A00,507421,Fischer-Grunski; Eva K,20,0,20,0
1713319599394,LIGM 5B,A00,507423,Fischer-Grunski; Eva K,20,0,20,0
1713319600422,LIGM 5C,A00,507425,Fischer-Grunski; Eva K,20,0,20,0
1713319601453,LIIT 5AS,A00,507427,Carnelos; Chiara,20,0,20,0
1713319602482,LIIT 5BS,A00,507430,Carnelos; Chiara,20,0,20,0
1713319603510,LIIT 5CS,A00,507432,Carnelos; Chiara,20,0,20,0
1713319604539,LISP 5A,A00,507541,Munoz Sanchez; Alicia,19,0,20,1
1713319605566,LISP 5B,A00,507671,Munoz Sanchez; Alicia,17,0,20,3
1713319606592,LISP 5C,A00,507696,Munoz Sanchez; Alicia,17,0,20,3
1713319607617,MAE 197,001,528363,Boechler; Nicholas Sebastia,9998,0,9999,1
1713319608650,MATH 197,001,523477,Kedlaya; Kiran S.,9999,0,9999,0
1713319608650,MATH 197,002,563811,Zhang; Danna,9999,0,9999,0
1713319609681,MCWP 40R,A00,518780,Staff,20,0,20,0
1713319609681,MCWP 40R,B00,518781,Staff,19,0,20,1
1713319609681,MCWP 40R,C00,518783,Staff,19,0,20,1
1713319610709,MCWP 50R,A00,518791,Staff,20,0,20,0
1713319610709,MCWP 50R,B00,518792,Staff,17,0,20,3
1713319610709,MCWP 50R,C00,518793,Staff,19,0,20,1
1713319610709,MCWP 50R,D00,518794,Staff,18,0,20,2
1713319610709,MCWP 50R,E00,518795,Staff,17,0,20,3
1713319610709,MCWP 50R,F00,518796,Staff,19,0,20,1
1713319610709,MCWP 50R,G00,518797,Staff,19,0,20,1
1713319611736,MMW 12R,A01,514034,Herbst; Matthew,15,0,16,1
1713319611736,MMW 12R,A02,514035,Herbst; Matthew,16,0,16,0
1713319612762,MMW 13R,A01,514037,Staff,12,0,16,4
1713319612762,MMW 13R,A02,514039,Staff,16,0,16,0
1713319614818,SIO 295LS,A00,523233,Staff,19,0,30,11
1713319615842,SIO 295S,A00,523232,Staff,19,0,30,11
1713319616867,SOCI 117,A01,494376,Staff,3,0,5,2
1713319617892,WES 237B,A00,494380,Staff,19,0,20,1
1713319620008,AESE 279B,A00,494370,Wade; Jon P,33,0,33,0
1713319621032,ANAR 135S,A00,494369,Braswell; Geoffrey E.,0,0,0,0
1713319622059,CAT 124RS,A01,519847,Geibel; William,17,0,20,3
1713319623084,CAT 125RS,A01,515971,Geibel; William,17,0,20,3
1713319624109,CLRE 250,A00,511389,Morris; Sheldon,9996,0,9999,3
1713319625137,CLRE 251,A00,507176,Mehta; Ravindra L.,9996,0,9999,3
1713319625137,CLRE 251,B00,511410,Mehta; Ravindra L.,9998,0,9999,1
1713319626169,CLRE 252,A00,507189,Cuomo; Raphael Eduardo,9998,0,9999,1
1713319627201,CLRE 253,A00,507199,Vaida; Florin,9997,0,9999,2
1713319627201,CLRE 253,B00,507202,Vaida; Florin,9999,0,9999,0
1713319628230,CLRE 259,A00,507211,Patel; Hemal,9996,0,9999,3
1713319629253,CLRE 260,A00,507221,Cuomo; Raphael Eduardo,9999,0,9999,0
1713319630277,CLRE 297,001,507242,Cuomo; Raphael Eduardo,9999,0,9999,0
1713319631308,CSE 191,A00,516875,Minnes Kemp; Mor Mia,9999,0,9999,0
1713319632340,CSS 201S,A01,494383,Staff,35,0,35,0
1713319633369,CSS 202S,A01,494387,Staff,35,0,35,0
1713319634396,EAP 100,A00,516065,Staff,9792,0,9999,207
1713319635421,ECE 45,A01,507414,Staff,54,0,60,6
1713319636447,ECE 100,A01,507416,Baghdadchi; Saharnaz,11,0,20,9
1713319636447,ECE 100,A02,507418,Baghdadchi; Saharnaz,20,0,20,0
1713319637477,ECE 111,A01,507420,Staff,40,0,50,10
1713319638505,ECE 197,001,548057,Sievenpiper; Daniel F.,9998,0,9999,1
1713319639538,EDS 115,A00,507243,Choi; Bailey Miyeon,28,0,28,0
1713319640562,EDS 117,A01,494379,Staff,24,0,25,1
1713319641593,EDS 125,A00,507246,Hopkins; Megan Beth,29,0,30,1
1713319642623,EDS 128A,A01,507264,Fargason; Sharon Gayle,26,0,26,0
1713319643654,EDS 128B,A01,507293,Pappas; Elizabeth,30,0,30,0
1713319644680,EDS 139,A00,507294,Fargason; Sharon Gayle,30,0,30,0
1713319644680,EDS 139,B00,507313,Pappas; Elizabeth,30,0,30,0
1713319645709,EDS 201,A00,507315,Staff,26,0,30,4
1713319646735,EDS 203,A01,507317,Halter; Christopher P.,26,0,30,4
1713319647762,EDS 204R,A01,507319,Halter; Christopher P.,4,0,30,26
1713319647762,EDS 204R,B01,507331,Heinzman; Erica M.,28,0,30,2
1713319648787,EDS 206R,A00,507332,Staff,5,0,30,25
1713319648787,EDS 206R,B00,507343,Staff,28,0,30,2
1713319649816,EDS 250,A00,507344,Hemans; Patricia Ann Benitez,36,0,40,4
1713319650841,EDS 281,A00,507345,Daly; Alan J.,18,0,18,0
1713319651869,EDS 284,A00,507350,Daly; Alan J.,16,0,16,0
1713319652894,EDS 286,A00,507359,Fine; Sarah,18,0,18,0
1713319653920,EDS 289C,A01,507361,Daly; Alan J.,18,0,18,0
1713319654948,EDS 290,A00,507366,Hofstetter; Carolyn,15,0,15,0
1713319655981,LIGM 5A,A00,507421,Fischer-Grunski; Eva K,20,0,20,0
1713319657012,LIGM 5B,A00,507423,Fischer-Grunski; Eva K,20,0,20,0
1713319658072,LIGM 5C,A00,507425,Fischer-Grunski; Eva K,20,0,20,0
1713319659098,LIIT 5AS,A00,507427,Carnelos; Chiara,20,0,20,0
1713319660125,LIIT 5BS,A00,507430,Carnelos; Chiara,20,0,20,0
1713319661151,LIIT 5CS,A00,507432,Carnelos; Chiara,20,0,20,0
1713319662176,LISP 5A,A00,507541,Munoz Sanchez; Alicia,19,0,20,1
1713319663201,LISP 5B,A00,507671,Munoz Sanchez; Alicia,17,0,20,3
1713319664231,LISP 5C,A00,507696,Munoz Sanchez; Alicia,17,0,20,3
1713319665256,MAE 197,001,528363,Boechler; Nicholas Sebastia,9998,0,9999,1
1713319666283,MATH 197,001,523477,Kedlaya; Kiran S.,9999,0,9999,0
1713319666283,MATH 197,002,563811,Zhang; Danna,9999,0,9999,0
1713319667309,MCWP 40R,A00,518780,Staff,20,0,20,0
1713319667309,MCWP 40R,B00,518781,Staff,19,0,20,1
1713319667309,MCWP 40R,C00,518783,Staff,19,0,20,1
1713319668338,MCWP 50R,A00,518791,Staff,20,0,20,0
1713319668338,MCWP 50R,B00,518792,Staff,17,0,20,3
1713319668338,MCWP 50R,C00,518793,Staff,19,0,20,1
1713319668338,MCWP 50R,D00,518794,Staff,18,0,20,2
1713319668338,MCWP 50R,E00,518795,Staff,17,0,20,3
1713319668338,MCWP 50R,F00,518796,Staff,19,0,20,1
1713319668338,MCWP 50R,G00,518797,Staff,19,0,20,1
1713319669362,MMW 12R,A01,514034,Herbst; Matthew,15,0,16,1
1713319669362,MMW 12R,A02,514035,Herbst; Matthew,16,0,16,0
1713319670392,MMW 13R,A01,514037,Staff,12,0,16,4
1713319670392,MMW 13R,A02,514039,Staff,16,0,16,0
1713319672442,SIO 295LS,A00,523233,Staff,19,0,30,11
1713319673469,SIO 295S,A00,523232,Staff,19,0,30,11
1713319674493,SOCI 117,A01,494376,Staff,3,0,5,2
1713319675522,WES 237B,A00,494380,Staff,19,0,20,1
1713319677584,AESE 279B,A00,494370,Wade; Jon P,33,0,33,0
1713319678612,ANAR 135S,A00,494369,Braswell; Geoffrey E.,0,0,0,0
1713319679636,CAT 124RS,A01,519847,Geibel; William,17,0,20,3
1713319680663,CAT 125RS,A01,515971,Geibel; William,17,0,20,3
1713319681691,CLRE 250,A00,511389,Morris; Sheldon,9996,0,9999,3
1713319682720,CLRE 251,A00,507176,Mehta; Ravindra L.,9996,0,9999,3
1713319682720,CLRE 251,B00,511410,Mehta; Ravindra L.,9998,0,9999,1
1713319683745,CLRE 252,A00,507189,Cuomo; Raphael Eduardo,9998,0,9999,1
1713319684769,CLRE 253,A00,507199,Vaida; Florin,9997,0,9999,2
1713319684769,CLRE 253,B00,507202,Vaida; Florin,9999,0,9999,0
1713319685795,CLRE 259,A00,507211,Patel; Hemal,9996,0,9999,3
1713319686822,CLRE 260,A00,507221,Cuomo; Raphael Eduardo,9999,0,9999,0
1713319687849,CLRE 297,001,507242,Cuomo; Raphael Eduardo,9999,0,9999,0
1713319688874,CSE 191,A00,516875,Minnes Kemp; Mor Mia,9999,0,9999,0
1713319689899,CSS 201S,A01,494383,Staff,35,0,35,0
1713319690923,CSS 202S,A01,494387,Staff,35,0,35,0
1713319691949,EAP 100,A00,516065,Staff,9792,0,9999,207
1713319692973,ECE 45,A01,507414,Staff,54,0,60,6
1713319694002,ECE 100,A01,507416,Baghdadchi; Saharnaz,11,0,20,9
1713319694002,ECE 100,A02,507418,Baghdadchi; Saharnaz,20,0,20,0
1713319695028,ECE 111,A01,507420,Staff,39,0,50,11
1713319696058,ECE 197,001,548057,Sievenpiper; Daniel F.,9998,0,9999,1
1713319697084,EDS 115,A00,507243,Choi; Bailey Miyeon,28,0,28,0
1713319698111,EDS 117,A01,494379,Staff,24,0,25,1
1713319699136,EDS 125,A00,507246,Hopkins; Megan Beth,29,0,30,1
1713319700162,EDS 128A,A01,507264,Fargason; Sharon Gayle,26,0,26,0
1713319701189,EDS 128B,A01,507293,Pappas; Elizabeth,30,0,30,0
1713319702213,EDS 139,A00,507294,Fargason; Sharon Gayle,30,0,30,0
1713319702213,EDS 139,B00,507313,Pappas; Elizabeth,30,0,30,0
1713319703238,EDS 201,A00,507315,Staff,26,0,30,4
1713319704264,EDS 203,A01,507317,Halter; Christopher P.,26,0,30,4
1713319705291,EDS 204R,A01,507319,Halter; Christopher P.,4,0,30,26
1713319705291,EDS 204R,B01,507331,Heinzman; Erica M.,28,0,30,2
1713319706317,EDS 206R,A00,507332,Staff,5,0,30,25
1713319706317,EDS 206R,B00,507343,Staff,28,0,30,2
1713319707345,EDS 250,A00,507344,Hemans; Patricia Ann Benitez,36,0,40,4
1713319708374,EDS 281,A00,507345,Daly; Alan J.,18,0,18,0
1713319709400,EDS 284,A00,507350,Daly; Alan J.,16,0,16,0
1713319710427,EDS 286,A00,507359,Fine; Sarah,18,0,18,0
1713319711454,EDS 289C,A01,507361,Daly; Alan J.,18,0,18,0
1713319712481,EDS 290,A00,507366,Hofstetter; Carolyn,15,0,15,0
1713319713506,LIGM 5A,A00,507421,Fischer-Grunski; Eva K,20,0,20,0
1713319714534,LIGM 5B,A00,507423,Fischer-Grunski; Eva K,20,0,20,0
1713319715562,LIGM 5C,A00,507425,Fischer-Grunski; Eva K,20,0,20,0
1713319716586,LIIT 5AS,A00,507427,Carnelos; Chiara,20,0,20,0
1713319717611,LIIT 5BS,A00,507430,Carnelos; Chiara,20,0,20,0
1713319718636,LIIT 5CS,A00,507432,Carnelos; Chiara,20,0,20,0
1713319719662,LISP 5A,A00,507541,Munoz Sanchez; Alicia,19,0,20,1
1713319720688,LISP 5B,A00,507671,Munoz Sanchez; Alicia,17,0,20,3
1713319721719,LISP 5C,A00,507696,Munoz Sanchez; Alicia,17,0,20,3
1713319722745,MAE 197,001,528363,Boechler; Nicholas Sebastia,9998,0,9999,1
1713319723824,MATH 197,001,523477,Kedlaya; Kiran S.,9999,0,9999,0
1713319723824,MATH 197,002,563811,Zhang; Danna,9999,0,9999,0
1713319724853,MCWP 40R,A00,518780,Staff,20,0,20,0
1713319724853,MCWP 40R,B00,518781,Staff,19,0,20,1
1713319724853,MCWP 40R,C00,518783,Staff,19,0,20,1
1713319725885,MCWP 50R,A00,518791,Staff,20,0,20,0
1713319725885,MCWP 50R,B00,518792,Staff,17,0,20,3
1713319725885,MCWP 50R,C00,518793,Staff,19,0,20,1
1713319725885,MCWP 50R,D00,518794,Staff,18,0,20,2
1713319725885,MCWP 50R,E00,518795,Staff,17,0,20,3
1713319725885,MCWP 50R,F00,518796,Staff,19,0,20,1
1713319725885,MCWP 50R,G00,518797,Staff,19,0,20,1
1713319726913,MMW 12R,A01,514034,Herbst; Matthew,15,0,16,1
1713319726913,MMW 12R,A02,514035,Herbst; Matthew,16,0,16,0
1713319727938,MMW 13R,A01,514037,Staff,12,0,16,4
1713319727938,MMW 13R,A02,514039,Staff,16,0,16,0
1713319729993,SIO 295LS,A00,523233,Staff,19,0,30,11
1713319731023,SIO 295S,A00,523232,Staff,19,0,30,11
1713319732049,SOCI 117,A01,494376,Staff,3,0,5,2
1713319733077,WES 237B,A00,494380,Staff,19,0,20,1
1713319735141,AESE 279B,A00,494370,Wade; Jon P,33,0,33,0
1713319736167,ANAR 135S,A00,494369,Braswell; Geoffrey E.,0,0,0,0
1713319737192,CAT 124RS,A01,519847,Geibel; William,17,0,20,3
1713319738221,CAT 125RS,A01,515971,Geibel; William,17,0,20,3
1713319739247,CLRE 250,A00,511389,Morris; Sheldon,9996,0,9999,3
1713319740279,CLRE 251,A00,507176,Mehta; Ravindra L.,9996,0,9999,3
1713319740279,CLRE 251,B00,511410,Mehta; Ravindra L.,9998,0,9999,1
1713319741313,CLRE 252,A00,507189,Cuomo; Raphael Eduardo,9998,0,9999,1
1713319742341,CLRE 253,A00,507199,Vaida; Florin,9997,0,9999,2
1713319742341,CLRE 253,B00,507202,Vaida; Florin,9999,0,9999,0
1713319743366,CLRE 259,A00,507211,Patel; Hemal,9996,0,9999,3
1713319744395,CLRE 260,A00,507221,Cuomo; Raphael Eduardo,9999,0,9999,0
1713319745422,CLRE 297,001,507242,Cuomo; Raphael Eduardo,9999,0,9999,0
1713319746448,CSE 191,A00,516875,Minnes Kemp; Mor Mia,9999,0,9999,0
1713319747478,CSS 201S,A01,494383,Staff,35,0,35,0
1713319748502,CSS 202S,A01,494387,Staff,35,0,35,0
1713319749530,EAP 100,A00,516065,Staff,9792,0,9999,207
1713319750555,ECE 45,A01,507414,Staff,54,0,60,6
1713319751579,ECE 100,A01,507416,Baghdadchi; Saharnaz,11,0,20,9
1713319751579,ECE 100,A02,507418,Baghdadchi; Saharnaz,20,0,20,0
1713319752604,ECE 111,A01,507420,Staff,39,0,50,11
1713319753631,ECE 197,001,548057,Sievenpiper; Daniel F.,9998,0,9999,1
1713319754661,EDS 115,A00,507243,Choi; Bailey Miyeon,28,0,28,0
1713319755688,EDS 117,A01,494379,Staff,24,0,25,1
1713319756714,EDS 125,A00,507246,Hopkins; Megan Beth,29,0,30,1
1713319757741,EDS 128A,A01,507264,Fargason; Sharon Gayle,26,0,26,0
1713319758767,EDS 128B,A01,507293,Pappas; Elizabeth,30,0,30,0
1713319759797,EDS 139,A00,507294,Fargason; Sharon Gayle,30,0,30,0
1713319759797,EDS 139,B00,507313,Pappas; Elizabeth,30,0,30,0
1713319760825,EDS 201,A00,507315,Staff,26,0,30,4
1713319761852,EDS 203,A01,507317,Halter; Christopher P.,26,0,30,4
1713319762882,EDS 204R,A01,507319,Halter; Christopher P.,4,0,30,26
1713319762882,EDS 204R,B01,507331,Heinzman; Erica M.,28,0,30,2
1713319763906,EDS 206R,A00,507332,Staff,5,0,30,25
1713319763906,EDS 206R,B00,507343,Staff,28,0,30,2
1713319764934,EDS 250,A00,507344,Hemans; Patricia Ann Benitez,36,0,40,4
1713319765963,EDS 281,A00,507345,Daly; Alan J.,18,0,18,0
1713319766986,EDS 284,A00,507350,Daly; Alan J.,16,0,16,0
1713319768012,EDS 286,A00,507359,Fine; Sarah,18,0,18,0
1713319769038,EDS 289C,A01,507361,Daly; Alan J.,18,0,18,0
1713319770065,EDS 290,A00,507366,Hofstetter; Carolyn,15,0,15,0
1713319771097,LIGM 5A,A00,507421,Fischer-Grunski; Eva K,20,0,20,0
1713319772129,LIGM 5B,A00,507423,Fischer-Grunski; Eva K,20,0,20,0
1713319773152,LIGM 5C,A00,507425,Fischer-Grunski; Eva K,20,0,20,0
1713319774178,LIIT 5AS,A00,507427,Carnelos; Chiara,20,0,20,0
1713319775205,LIIT 5BS,A00,507430,Carnelos; Chiara,20,0,20,0
1713319776233,LIIT 5CS,A00,507432,Carnelos; Chiara,20,0,20,0
1713319777264,LISP 5A,A00,507541,Munoz Sanchez; Alicia,19,0,20,1
1713319778294,LISP 5B,A00,507671,Munoz Sanchez; Alicia,17,0,20,3
1713319779317,LISP 5C,A00,507696,Munoz Sanchez; Alicia,17,0,20,3
1713319780342,MAE 197,001,528363,Boechler; Nicholas Sebastia,9998,0,9999,1
1713319781370,MATH 197,001,523477,Kedlaya; Kiran S.,9999,0,9999,0
1713319781370,MATH 197,002,563811,Zhang; Danna,9999,0,9999,0
1713319782394,MCWP 40R,A00,518780,Staff,20,0,20,0
1713319782394,MCWP 40R,B00,518781,Staff,19,0,20,1
1713319782394,MCWP 40R,C00,518783,Staff,19,0,20,1
1713319783420,MCWP 50R,A00,518791,Staff,20,0,20,0
1713319783420,MCWP 50R,B00,518792,Staff,17,0,20,3
1713319783420,MCWP 50R,C00,518793,Staff,19,0,20,1
1713319783420,MCWP 50R,D00,518794,Staff,18,0,20,2
1713319783420,MCWP 50R,E00,518795,Staff,17,0,20,3
1713319783420,MCWP 50R,F00,518796,Staff,19,0,20,1
1713319783420,MCWP 50R,G00,518797,Staff,19,0,20,1
1713319784452,MMW 12R,A01,514034,Herbst; Matthew,15,0,16,1
1713319784452,MMW 12R,A02,514035,Herbst; Matthew,16,0,16,0
1713319785480,MMW 13R,A01,514037,Staff,12,0,16,4
1713319785480,MMW 13R,A02,514039,Staff,16,0,16,0
1713319787533,SIO 295LS,A00,523233,Staff,19,0,30,11
1713319788562,SIO 295S,A00,523232,Staff,19,0,30,11
1713319789587,SOCI 117,A01,494376,Staff,3,0,5,2
1713319790614,WES 237B,A00,494380,Staff,19,0,20,1
1713319792667,AESE 279B,A00,494370,Wade; Jon P,33,0,33,0
1713319793692,ANAR 135S,A00,494369,Braswell; Geoffrey E.,0,0,0,0
1713319794718,CAT 124RS,A01,519847,Geibel; William,17,0,20,3
1713319795743,CAT 125RS,A01,515971,Geibel; William,17,0,20,3
1713319796768,CLRE 250,A00,511389,Morris; Sheldon,9996,0,9999,3
1713319797798,CLRE 251,A00,507176,Mehta; Ravindra L.,9996,0,9999,3
1713319797798,CLRE 251,B00,511410,Mehta; Ravindra L.,9998,0,9999,1
1713319798824,CLRE 252,A00,507189,Cuomo; Raphael Eduardo,9998,0,9999,1
1713319799849,CLRE 253,A00,507199,Vaida; Florin,9997,0,9999,2
1713319799849,CLRE 253,B00,507202,Vaida; Florin,9999,0,9999,0
1713319800879,CLRE 259,A00,507211,Patel; Hemal,9996,0,9999,3
1713319801902,CLRE 260,A00,507221,Cuomo; Raphael Eduardo,9999,0,9999,0
1713319802929,CLRE 297,001,507242,Cuomo; Raphael Eduardo,9999,0,9999,0
1713319803957,CSE 191,A00,516875,Minnes Kemp; Mor Mia,9999,0,9999,0
1713319804983,CSS 201S,A01,494383,Staff,35,0,35,0
1713319806007,CSS 202S,A01,494387,Staff,35,0,35,0
1713319807034,EAP 100,A00,516065,Staff,9792,0,9999,207
1713319808063,ECE 45,A01,507414,Staff,54,0,60,6
1713319809089,ECE 100,A01,507416,Baghdadchi; Saharnaz,11,0,20,9
1713319809089,ECE 100,A02,507418,Baghdadchi; Saharnaz,20,0,20,0
1713319810115,ECE 111,A01,507420,Staff,39,0,50,11
1713319811140,ECE 197,001,548057,Sievenpiper; Daniel F.,9998,0,9999,1
1713319812171,EDS 115,A00,507243,Choi; Bailey Miyeon,28,0,28,0
1713319813196,EDS 117,A01,494379,Staff,24,0,25,1
1713319814225,EDS 125,A00,507246,Hopkins; Megan Beth,29,0,30,1
1713319815250,EDS 128A,A01,507264,Fargason; Sharon Gayle,26,0,26,0
1713319816277,EDS 128B,A01,507293,Pappas; Elizabeth,30,0,30,0
1713319817304,EDS 139,A00,507294,Fargason; Sharon Gayle,30,0,30,0
1713319817304,EDS 139,B00,507313,Pappas; Elizabeth,30,0,30,0
1713319818328,EDS 201,A00,507315,Staff,26,0,30,4
1713319819352,EDS 203,A01,507317,Halter; Christopher P.,26,0,30,4
1713319820381,EDS 204R,A01,507319,Halter; Christopher P.,3,0,30,27
1713319820381,EDS 204R,B01,507331,Heinzman; Erica M.,28,0,30,2
1713319821404,EDS 206R,A00,507332,Staff,5,0,30,25
1713319821404,EDS 206R,B00,507343,Staff,28,0,30,2
1713319822431,EDS 250,A00,507344,Hemans; Patricia Ann Benitez,36,0,40,4
1713319823456,EDS 281,A00,507345,Daly; Alan J.,18,0,18,0
1713319824482,EDS 284,A00,507350,Daly; Alan J.,16,0,16,0
1713319825509,EDS 286,A00,507359,Fine; Sarah,18,0,18,0
1713319826533,EDS 289C,A01,507361,Daly; Alan J.,18,0,18,0
1713319827618,EDS 290,A00,507366,Hofstetter; Carolyn,15,0,15,0
1713319828647,LIGM 5A,A00,507421,Fischer-Grunski; Eva K,20,0,20,0
1713319829671,LIGM 5B,A00,507423,Fischer-Grunski; Eva K,20,0,20,0
1713319830697,LIGM 5C,A00,507425,Fischer-Grunski; Eva K,20,0,20,0
1713319831722,LIIT 5AS,A00,507427,Carnelos; Chiara,20,0,20,0
1713319832748,LIIT 5BS,A00,507430,Carnelos; Chiara,20,0,20,0
1713319833777,LIIT 5CS,A00,507432,Carnelos; Chiara,20,0,20,0
1713319834804,LISP 5A,A00,507541,Munoz Sanchez; Alicia,19,0,20,1
1713319835829,LISP 5B,A00,507671,Munoz Sanchez; Alicia,17,0,20,3
1713319836855,LISP 5C,A00,507696,Munoz Sanchez; Alicia,17,0,20,3
1713319837887,MAE 197,001,528363,Boechler; Nicholas Sebastia,9998,0,9999,1
1713319838912,MATH 197,001,523477,Kedlaya; Kiran S.,9999,0,9999,0
1713319838912,MATH 197,002,563811,Zhang; Danna,9999,0,9999,0
1713319839940,MCWP 40R,A00,518780,Staff,20,0,20,0
1713319839940,MCWP 40R,B00,518781,Staff,19,0,20,1
1713319839940,MCWP 40R,C00,518783,Staff,19,0,20,1
1713319840971,MCWP 50R,A00,518791,Staff,20,0,20,0
1713319840971,MCWP 50R,B00,518792,Staff,17,0,20,3
1713319840971,MCWP 50R,C00,518793,Staff,19,0,20,1
1713319840971,MCWP 50R,D00,518794,Staff,18,0,20,2
1713319840971,MCWP 50R,E00,518795,Staff,17,0,20,3
1713319840971,MCWP 50R,F00,518796,Staff,19,0,20,1
1713319840971,MCWP 50R,G00,518797,Staff,19,0,20,1
1713319842000,MMW 12R,A01,514034,Herbst; Matthew,15,0,16,1
1713319842000,MMW 12R,A02,514035,Herbst; Matthew,16,0,16,0
1713319843023,MMW 13R,A01,514037,Staff,12,0,16,4
1713319843023,MMW 13R,A02,514039,Staff,16,0,16,0
1713319845077,SIO 295LS,A00,523233,Staff,19,0,30,11
1713319846102,SIO 295S,A00,523232,Staff,19,0,30,11
1713319847130,SOCI 117,A01,494376,Staff,3,0,5,2
1713319848156,WES 237B,A00,494380,Staff,19,0,20,1
1713319850213,AESE 279B,A00,494370,Wade; Jon P,33,0,33,0
1713319851242,ANAR 135S,A00,494369,Braswell; Geoffrey E.,0,0,0,0
1713319852269,CAT 124RS,A01,519847,Geibel; William,17,0,20,3
1713319853296,CAT 125RS,A01,515971,Geibel; William,17,0,20,3
1713319854325,CLRE 250,A00,511389,Morris; Sheldon,9996,0,9999,3
1713319855350,CLRE 251,A00,507176,Mehta; Ravindra L.,9996,0,9999,3
1713319855350,CLRE 251,B00,511410,Mehta; Ravindra L.,9998,0,9999,1
1713319856377,CLRE 252,A00,507189,Cuomo; Raphael Eduardo,9998,0,9999,1
1713319857405,CLRE 253,A00,507199,Vaida; Florin,9997,0,9999,2
1713319857405,CLRE 253,B00,507202,Vaida; Florin,9999,0,9999,0
1713319858430,CLRE 259,A00,507211,Patel; Hemal,9996,0,9999,3
1713319859456,CLRE 260,A00,507221,Cuomo; Raphael Eduardo,9999,0,9999,0
1713319860480,CLRE 297,001,507242,Cuomo; Raphael Eduardo,9999,0,9999,0
1713319861504,CSE 191,A00,516875,Minnes Kemp; Mor Mia,9999,0,9999,0
1713319862529,CSS 201S,A01,494383,Staff,35,0,35,0
1713319863555,CSS 202S,A01,494387,Staff,35,0,35,0
1713319864579,EAP 100,A00,516065,Staff,9792,0,9999,207
1713319865603,ECE 45,A01,507414,Staff,54,0,60,6
1713319866631,ECE 100,A01,507416,Baghdadchi; Saharnaz,11,0,20,9
1713319866631,ECE 100,A02,507418,Baghdadchi; Saharnaz,20,0,20,0
1713319867655,ECE 111,A01,507420,Staff,39,0,50,11
1713319868683,ECE 197,001,548057,Sievenpiper; Daniel F.,9998,0,9999,1
1713319869709,EDS 115,A00,507243,Choi; Bailey Miyeon,28,0,28,0
1713319870734,EDS 117,A01,494379,Staff,24,0,25,1
1713319871759,EDS 125,A00,507246,Hopkins; Megan Beth,29,0,30,1
1713319872786,EDS 128A,A01,507264,Fargason; Sharon Gayle,26,0,26,0
1713319873812,EDS 128B,A01,507293,Pappas; Elizabeth,30,0,30,0
1713319874837,EDS 139,A00,507294,Fargason; Sharon Gayle,30,0,30,0
1713319874837,EDS 139,B00,507313,Pappas; Elizabeth,30,0,30,0
1713319875862,EDS 201,A00,507315,Staff,26,0,30,4
1713319876889,EDS 203,A01,507317,Halter; Christopher P.,26,0,30,4
1713319877913,EDS 204R,A01,507319,Halter; Christopher P.,3,0,30,27
1713319877913,EDS 204R,B01,507331,Heinzman; Erica M.,28,0,30,2
1713319878938,EDS 206R,A00,507332,Staff,4,0,30,26
1713319878938,EDS 206R,B00,507343,Staff,28,0,30,2
1713319879966,EDS 250,A00,507344,Hemans; Patricia Ann Benitez,36,0,40,4
1713319880991,EDS 281,A00,507345,Daly; Alan J.,18,0,18,0
1713319882018,EDS 284,A00,507350,Daly; Alan J.,16,0,16,0
1713319883067,EDS 286,A00,507359,Fine; Sarah,18,0,18,0
1713319884091,EDS 289C,A01,507361,Daly; Alan J.,18,0,18,0
1713319885117,EDS 290,A00,507366,Hofstetter; Carolyn,15,0,15,0
1713319886144,LIGM 5A,A00,507421,Fischer-Grunski; Eva K,20,0,20,0
1713319887168,LIGM 5B,A00,507423,Fischer-Grunski; Eva K,20,0,20,0
1713319888197,LIGM 5C,A00,507425,Fischer-Grunski; Eva K,20,0,20,0
1713319889226,LIIT 5AS,A00,507427,Carnelos; Chiara,20,0,20,0
1713319890255,LIIT 5BS,A00,507430,Carnelos; Chiara,20,0,20,0
1713319891279,LIIT 5CS,A00,507432,Carnelos; Chiara,20,0,20,0
1713319892303,LISP 5A,A00,507541,Munoz Sanchez; Alicia,19,0,20,1
1713319893328,LISP 5B,A00,507671,Munoz Sanchez; Alicia,17,0,20,3
1713319894353,LISP 5C,A00,507696,Munoz Sanchez; Alicia,17,0,20,3
1713319895379,MAE 197,001,528363,Boechler; Nicholas Sebastia,9998,0,9999,1
1713319896403,MATH 197,001,523477,Kedlaya; Kiran S.,9999,0,9999,0
1713319896403,MATH 197,002,563811,Zhang; Danna,9999,0,9999,0
1713319897428,MCWP 40R,A00,518780,Staff,20,0,20,0
1713319897428,MCWP 40R,B00,518781,Staff,19,0,20,1
1713319897428,MCWP 40R,C00,518783,Staff,19,0,20,1
1713319898451,MCWP 50R,A00,518791,Staff,20,0,20,0
1713319898451,MCWP 50R,B00,518792,Staff,17,0,20,3
1713319898451,MCWP 50R,C00,518793,Staff,19,0,20,1
1713319898451,MCWP 50R,D00,518794,Staff,18,0,20,2
1713319898451,MCWP 50R,E00,518795,Staff,17,0,20,3
1713319898451,MCWP 50R,F00,518796,Staff,19,0,20,1
1713319898451,MCWP 50R,G00,518797,Staff,19,0,20,1
1713319899475,MMW 12R,A01,514034,Herbst; Matthew,15,0,16,1
1713319899475,MMW 12R,A02,514035,Herbst; Matthew,16,0,16,0
1713319900503,MMW 13R,A01,514037,Staff,12,0,16,4
1713319900503,MMW 13R,A02,514039,Staff,16,0,16,0
1713319902557,SIO 295LS,A00,523233,Staff,19,0,30,11
1713319903582,SIO 295S,A00,523232,Staff,19,0,30,11
1713319904609,SOCI 117,A01,494376,Staff,3,0,5,2
1713319905633,WES 237B,A00,494380,Staff,19,0,20,1
1713319907691,AESE 279B,A00,494370,Wade; Jon P,33,0,33,0
1713319908716,ANAR 135S,A00,494369,Braswell; Geoffrey E.,0,0,0,0
1713319909744,CAT 124RS,A01,519847,Geibel; William,17,0,20,3
1713319910773,CAT 125RS,A01,515971,Geibel; William,17,0,20,3
1713319911801,CLRE 250,A00,511389,Morris; Sheldon,9996,0,9999,3
1713319912828,CLRE 251,A00,507176,Mehta; Ravindra L.,9996,0,9999,3
1713319912828,CLRE 251,B00,511410,Mehta; Ravindra L.,9998,0,9999,1
1713319913853,CLRE 252,A00,507189,Cuomo; Raphael Eduardo,9998,0,9999,1
1713319914877,CLRE 253,A00,507199,Vaida; Florin,9997,0,9999,2
1713319914877,CLRE 253,B00,507202,Vaida; Florin,9999,0,9999,0
1713319915903,CLRE 259,A00,507211,Patel; Hemal,9996,0,9999,3
1713319916928,CLRE 260,A00,507221,Cuomo; Raphael Eduardo,9999,0,9999,0
1713319917952,CLRE 297,001,507242,Cuomo; Raphael Eduardo,9999,0,9999,0
1713319918978,CSE 191,A00,516875,Minnes Kemp; Mor Mia,9999,0,9999,0
1713319920002,CSS 201S,A01,494383,Staff,35,0,35,0
1713319921031,CSS 202S,A01,494387,Staff,35,0,35,0
1713319922061,EAP 100,A00,516065,Staff,9792,0,9999,207
1713319923086,ECE 45,A01,507414,Staff,54,0,60,6
1713319924116,ECE 100,A01,507416,Baghdadchi; Saharnaz,11,0,20,9
1713319924116,ECE 100,A02,507418,Baghdadchi; Saharnaz,20,0,20,0
1713319925142,ECE 111,A01,507420,Staff,39,0,50,11
1713319926167,ECE 197,001,548057,Sievenpiper; Daniel F.,9998,0,9999,1
1713319927193,EDS 115,A00,507243,Choi; Bailey Miyeon,28,0,28,0
1713319928219,EDS 117,A01,494379,Staff,24,0,25,1
1713319929245,EDS 125,A00,507246,Hopkins; Megan Beth,29,0,30,1
1713319930270,EDS 128A,A01,507264,Fargason; Sharon Gayle,26,0,26,0
1713319931350,EDS 128B,A01,507293,Pappas; Elizabeth,30,0,30,0
1713319932378,EDS 139,A00,507294,Fargason; Sharon Gayle,30,0,30,0
1713319932378,EDS 139,B00,507313,Pappas; Elizabeth,30,0,30,0
1713319933404,EDS 201,A00,507315,Staff,26,0,30,4
1713319934430,EDS 203,A01,507317,Halter; Christopher P.,26,0,30,4
1713319935456,EDS 204R,A01,507319,Halter; Christopher P.,3,0,30,27
1713319935456,EDS 204R,B01,507331,Heinzman; Erica M.,28,0,30,2
1713319936480,EDS 206R,A00,507332,Staff,4,0,30,26
1713319936480,EDS 206R,B00,507343,Staff,28,0,30,2
1713319937507,EDS 250,A00,507344,Hemans; Patricia Ann Benitez,36,0,40,4
1713319938533,EDS 281,A00,507345,Daly; Alan J.,18,0,18,0
1713319939558,EDS 284,A00,507350,Daly; Alan J.,16,0,16,0
1713319940586,EDS 286,A00,507359,Fine; Sarah,18,0,18,0
1713319941617,EDS 289C,A01,507361,Daly; Alan J.,18,0,18,0
1713319942641,EDS 290,A00,507366,Hofstetter; Carolyn,15,0,15,0
1713319943671,LIGM 5A,A00,507421,Fischer-Grunski; Eva K,20,0,20,0
1713319944699,LIGM 5B,A00,507423,Fischer-Grunski; Eva K,20,0,20,0
1713319945727,LIGM 5C,A00,507425,Fischer-Grunski; Eva K,20,0,20,0
1713319946754,LIIT 5AS,A00,507427,Carnelos; Chiara,20,0,20,0
1713319947782,LIIT 5BS,A00,507430,Carnelos; Chiara,20,0,20,0
1713319948806,LIIT 5CS,A00,507432,Carnelos; Chiara,20,0,20,0
1713319949831,LISP 5A,A00,507541,Munoz Sanchez; Alicia,19,0,20,1
1713319950857,LISP 5B,A00,507671,Munoz Sanchez; Alicia,17,0,20,3
1713319951885,LISP 5C,A00,507696,Munoz Sanchez; Alicia,17,0,20,3
1713319952914,MAE 197,001,528363,Boechler; Nicholas Sebastia,9998,0,9999,1
1713319953940,MATH 197,001,523477,Kedlaya; Kiran S.,9999,0,9999,0
1713319953940,MATH 197,002,563811,Zhang; Danna,9999,0,9999,0
1713319954965,MCWP 40R,A00,518780,Staff,20,0,20,0
1713319954965,MCWP 40R,B00,518781,Staff,19,0,20,1
1713319954965,MCWP 40R,C00,518783,Staff,19,0,20,1
1713319955993,MCWP 50R,A00,518791,Staff,20,0,20,0
1713319955993,MCWP 50R,B00,518792,Staff,17,0,20,3
1713319955993,MCWP 50R,C00,518793,Staff,19,0,20,1
1713319955993,MCWP 50R,D00,518794,Staff,18,0,20,2
1713319955993,MCWP 50R,E00,518795,Staff,17,0,20,3
1713319955993,MCWP 50R,F00,518796,Staff,19,0,20,1
1713319955993,MCWP 50R,G00,518797,Staff,19,0,20,1
1713319957017,MMW 12R,A01,514034,Herbst; Matthew,15,0,16,1
1713319957017,MMW 12R,A02,514035,Herbst; Matthew,16,0,16,0
1713319958043,MMW 13R,A01,514037,Staff,12,0,16,4
1713319958043,MMW 13R,A02,514039,Staff,16,0,16,0
1713319960096,SIO 295LS,A00,523233,Staff,19,0,30,11
1713319961124,SIO 295S,A00,523232,Staff,19,0,30,11
1713319962151,SOCI 117,A01,494376,Staff,3,0,5,2
1713319963175,WES 237B,A00,494380,Staff,19,0,20,1
1713319965228,AESE 279B,A00,494370,Wade; Jon P,33,0,33,0
1713319966252,ANAR 135S,A00,494369,Braswell; Geoffrey E.,0,0,0,0
1713319967277,CAT 124RS,A01,519847,Geibel; William,17,0,20,3
1713319968307,CAT 125RS,A01,515971,Geibel; William,17,0,20,3
1713319969336,CLRE 250,A00,511389,Morris; Sheldon,9996,0,9999,3
1713319970362,CLRE 251,A00,507176,Mehta; Ravindra L.,9996,0,9999,3
1713319970362,CLRE 251,B00,511410,Mehta; Ravindra L.,9998,0,9999,1
1713319971388,CLRE 252,A00,507189,Cuomo; Raphael Eduardo,9998,0,9999,1
1713319972412,CLRE 253,A00,507199,Vaida; Florin,9997,0,9999,2
1713319972412,CLRE 253,B00,507202,Vaida; Florin,9999,0,9999,0
1713319973438,CLRE 259,A00,507211,Patel; Hemal,9996,0,9999,3
1713319974464,CLRE 260,A00,507221,Cuomo; Raphael Eduardo,9999,0,9999,0
1713319975488,CLRE 297,001,507242,Cuomo; Raphael Eduardo,9999,0,9999,0
1713319976512,CSE 191,A00,516875,Minnes Kemp; Mor Mia,9999,0,9999,0
1713319977539,CSS 201S,A01,494383,Staff,35,0,35,0
1713319978564,CSS 202S,A01,494387,Staff,35,0,35,0
1713319979588,EAP 100,A00,516065,Staff,9792,0,9999,207
1713319980611,ECE 45,A01,507414,Staff,54,0,60,6
1713319981641,ECE 100,A01,507416,Baghdadchi; Saharnaz,11,0,20,9
1713319981641,ECE 100,A02,507418,Baghdadchi; Saharnaz,20,0,20,0
1713319982670,ECE 111,A01,507420,Staff,39,0,50,11
1713319983828,ECE 197,001,548057,Sievenpiper; Daniel F.,9998,0,9999,1
1713319984855,EDS 115,A00,507243,Choi; Bailey Miyeon,28,0,28,0
1713319985879,EDS 117,A01,494379,Staff,23,0,25,2
1713319986904,EDS 125,A00,507246,Hopkins; Megan Beth,29,0,30,1
1713319987928,EDS 128A,A01,507264,Fargason; Sharon Gayle,26,0,26,0
1713319988953,EDS 128B,A01,507293,Pappas; Elizabeth,30,0,30,0
1713319989979,EDS 139,A00,507294,Fargason; Sharon Gayle,30,0,30,0
1713319989979,EDS 139,B00,507313,Pappas; Elizabeth,30,0,30,0
1713319991007,EDS 201,A00,507315,Staff,26,0,30,4
1713319992035,EDS 203,A01,507317,Halter; Christopher P.,26,0,30,4
1713319993061,EDS 204R,A01,507319,Halter; Christopher P.,3,0,30,27
1713319993061,EDS 204R,B01,507331,Heinzman; Erica M.,28,0,30,2
1713319994089,EDS 206R,A00,507332,Staff,4,0,30,26
1713319994089,EDS 206R,B00,507343,Staff,28,0,30,2
1713319995114,EDS 250,A00,507344,Hemans; Patricia Ann Benitez,36,0,40,4
1713319996139,EDS 281,A00,507345,Daly; Alan J.,18,0,18,0
1713319997162,EDS 284,A00,507350,Daly; Alan J.,16,0,16,0
1713319998190,EDS 286,A00,507359,Fine; Sarah,18,0,18,0
1713319999215,EDS 289C,A01,507361,Daly; Alan J.,18,0,18,0
1713320000240,EDS 290,A00,507366,Hofstetter; Carolyn,15,0,15,0
1713320001269,LIGM 5A,A00,507421,Fischer-Grunski; Eva K,20,0,20,0
1713320002299,LIGM 5B,A00,507423,Fischer-Grunski; Eva K,20,0,20,0
1713320003328,LIGM 5C,A00,507425,Fischer-Grunski; Eva K,20,0,20,0
1713320004352,LIIT 5AS,A00,507427,Carnelos; Chiara,20,0,20,0
1713320005379,LIIT 5BS,A00,507430,Carnelos; Chiara,20,0,20,0
1713320006406,LIIT 5CS,A00,507432,Carnelos; Chiara,20,0,20,0
1713320007429,LISP 5A,A00,507541,Munoz Sanchez; Alicia,19,0,20,1
1713320008454,LISP 5B,A00,507671,Munoz Sanchez; Alicia,17,0,20,3
1713320009478,LISP 5C,A00,507696,Munoz Sanchez; Alicia,17,0,20,3
1713320010506,MAE 197,001,528363,Boechler; Nicholas Sebastia,9998,0,9999,1
1713320011533,MATH 197,001,523477,Kedlaya; Kiran S.,9999,0,9999,0
1713320011533,MATH 197,002,563811,Zhang; Danna,9999,0,9999,0
1713320012562,MCWP 40R,A00,518780,Staff,20,0,20,0
1713320012562,MCWP 40R,B00,518781,Staff,19,0,20,1
1713320012562,MCWP 40R,C00,518783,Staff,19,0,20,1
1713320013588,MCWP 50R,A00,518791,Staff,20,0,20,0
1713320013588,MCWP 50R,B00,518792,Staff,17,0,20,3
1713320013588,MCWP 50R,C00,518793,Staff,19,0,20,1
1713320013588,MCWP 50R,D00,518794,Staff,18,0,20,2
1713320013588,MCWP 50R,E00,518795,Staff,17,0,20,3
1713320013588,MCWP 50R,F00,518796,Staff,19,0,20,1
1713320013588,MCWP 50R,G00,518797,Staff,19,0,20,1
1713320014615,MMW 12R,A01,514034,Herbst; Matthew,15,0,16,1
1713320014615,MMW 12R,A02,514035,Herbst; Matthew,16,0,16,0
1713320015642,MMW 13R,A01,514037,Staff,12,0,16,4
1713320015642,MMW 13R,A02,514039,Staff,16,0,16,0
1713320017693,SIO 295LS,A00,523233,Staff,19,0,30,11
1713320018717,SIO 295S,A00,523232,Staff,19,0,30,11
1713320019742,SOCI 117,A01,494376,Staff,3,0,5,2
1713320020770,WES 237B,A00,494380,Staff,19,0,20,1
1713320022830,AESE 279B,A00,494370,Wade; Jon P,33,0,33,0
1713320023857,ANAR 135S,A00,494369,Braswell; Geoffrey E.,0,0,0,0
1713320024884,CAT 124RS,A01,519847,Geibel; William,17,0,20,3
1713320025911,CAT 125RS,A01,515971,Geibel; William,17,0,20,3
1713320026940,CLRE 250,A00,511389,Morris; Sheldon,9996,0,9999,3
1713320027967,CLRE 251,A00,507176,Mehta; Ravindra L.,9996,0,9999,3
1713320027967,CLRE 251,B00,511410,Mehta; Ravindra L.,9998,0,9999,1
1713320028995,CLRE 252,A00,507189,Cuomo; Raphael Eduardo,9998,0,9999,1
1713320030020,CLRE 253,A00,507199,Vaida; Florin,9997,0,9999,2
1713320030020,CLRE 253,B00,507202,Vaida; Florin,9999,0,9999,0
1713320031046,CLRE 259,A00,507211,Patel; Hemal,9996,0,9999,3
1713320032071,CLRE 260,A00,507221,Cuomo; Raphael Eduardo,9999,0,9999,0
1713320033097,CLRE 297,001,507242,Cuomo; Raphael Eduardo,9999,0,9999,0
1713320034120,CSE 191,A00,516875,Minnes Kemp; Mor Mia,9999,0,9999,0
1713320035206,CSS 201S,A01,494383,Staff,35,0,35,0
1713320036233,CSS 202S,A01,494387,Staff,35,0,35,0
1713320037256,EAP 100,A00,516065,Staff,9792,0,9999,207
1713320038285,ECE 45,A01,507414,Staff,54,0,60,6
1713320039314,ECE 100,A01,507416,Baghdadchi; Saharnaz,11,0,20,9
1713320039314,ECE 100,A02,507418,Baghdadchi; Saharnaz,20,0,20,0
1713320040341,ECE 111,A01,507420,Staff,39,0,50,11
1713320041367,ECE 197,001,548057,Sievenpiper; Daniel F.,9998,0,9999,1
1713320042396,EDS 115,A00,507243,Choi; Bailey Miyeon,28,0,28,0
1713320043424,EDS 117,A01,494379,Staff,23,0,25,2
1713320044453,EDS 125,A00,507246,Hopkins; Megan Beth,29,0,30,1
1713320045478,EDS 128A,A01,507264,Fargason; Sharon Gayle,26,0,26,0
1713320046506,EDS 128B,A01,507293,Pappas; Elizabeth,30,0,30,0
1713320047534,EDS 139,A00,507294,Fargason; Sharon Gayle,30,0,30,0
1713320047534,EDS 139,B00,507313,Pappas; Elizabeth,30,0,30,0
1713320048560,EDS 201,A00,507315,Staff,26,0,30,4
1713320049585,EDS 203,A01,507317,Halter; Christopher P.,26,0,30,4
1713320050610,EDS 204R,A01,507319,Halter; Christopher P.,3,0,30,27
1713320050610,EDS 204R,B01,507331,Heinzman; Erica M.,28,0,30,2
1713320051635,EDS 206R,A00,507332,Staff,4,0,30,26
1713320051635,EDS 206R,B00,507343,Staff,28,0,30,2
1713320052661,EDS 250,A00,507344,Hemans; Patricia Ann Benitez,36,0,40,4
1713320053685,EDS 281,A00,507345,Daly; Alan J.,18,0,18,0
1713320054712,EDS 284,A00,507350,Daly; Alan J.,16,0,16,0
1713320055740,EDS 286,A00,507359,Fine; Sarah,18,0,18,0
1713320056763,EDS 289C,A01,507361,Daly; Alan J.,18,0,18,0
1713320057789,EDS 290,A00,507366,Hofstetter; Carolyn,15,0,15,0
1713320058817,LIGM 5A,A00,507421,Fischer-Grunski; Eva K,20,0,20,0
1713320059843,LIGM 5B,A00,507423,Fischer-Grunski; Eva K,20,0,20,0
1713320060867,LIGM 5C,A00,507425,Fischer-Grunski; Eva K,20,0,20,0
1713320061895,LIIT 5AS,A00,507427,Carnelos; Chiara,20,0,20,0
1713320062920,LIIT 5BS,A00,507430,Carnelos; Chiara,20,0,20,0
1713320063946,LIIT 5CS,A00,507432,Carnelos; Chiara,20,0,20,0
1713320064972,LISP 5A,A00,507541,Munoz Sanchez; Alicia,19,0,20,1
1713320066002,LISP 5B,A00,507671,Munoz Sanchez; Alicia,17,0,20,3
1713320067026,LISP 5C,A00,507696,Munoz Sanchez; Alicia,17,0,20,3
1713320068051,MAE 197,001,528363,Boechler; Nicholas Sebastia,9998,0,9999,1
1713320069077,MATH 197,001,523477,Kedlaya; Kiran S.,9999,0,9999,0
1713320069077,MATH 197,002,563811,Zhang; Danna,9999,0,9999,0
1713320070105,MCWP 40R,A00,518780,Staff,20,0,20,0
1713320070105,MCWP 40R,B00,518781,Staff,19,0,20,1
1713320070105,MCWP 40R,C00,518783,Staff,19,0,20,1
1713320071133,MCWP 50R,A00,518791,Staff,20,0,20,0
1713320071133,MCWP 50R,B00,518792,Staff,17,0,20,3
1713320071133,MCWP 50R,C00,518793,Staff,19,0,20,1
1713320071133,MCWP 50R,D00,518794,Staff,18,0,20,2
1713320071133,MCWP 50R,E00,518795,Staff,17,0,20,3
1713320071133,MCWP 50R,F00,518796,Staff,19,0,20,1
1713320071133,MCWP 50R,G00,518797,Staff,19,0,20,1
1713320072157,MMW 12R,A01,514034,Herbst; Matthew,15,0,16,1
1713320072157,MMW 12R,A02,514035,Herbst; Matthew,16,0,16,0
1713320073181,MMW 13R,A01,514037,Staff,12,0,16,4
1713320073181,MMW 13R,A02,514039,Staff,16,0,16,0
1713320075236,SIO 295LS,A00,523233,Staff,19,0,30,11
1713320076259,SIO 295S,A00,523232,Staff,19,0,30,11
1713320077286,SOCI 117,A01,494376,Staff,3,0,5,2
1713320078313,WES 237B,A00,494380,Staff,19,0,20,1
1713320080369,AESE 279B,A00,494370,Wade; Jon P,33,0,33,0
1713320081396,ANAR 135S,A00,494369,Braswell; Geoffrey E.,0,0,0,0
1713320082419,CAT 124RS,A01,519847,Geibel; William,17,0,20,3
1713320083447,CAT 125RS,A01,515971,Geibel; William,17,0,20,3
1713320084472,CLRE 250,A00,511389,Morris; Sheldon,9996,0,9999,3
1713320085498,CLRE 251,A00,507176,Mehta; Ravindra L.,9996,0,9999,3
1713320085498,CLRE 251,B00,511410,Mehta; Ravindra L.,9998,0,9999,1
1713320086526,CLRE 252,A00,507189,Cuomo; Raphael Eduardo,9998,0,9999,1
1713320087554,CLRE 253,A00,507199,Vaida; Florin,9997,0,9999,2
1713320087554,CLRE 253,B00,507202,Vaida; Florin,9999,0,9999,0
1713320088578,CLRE 259,A00,507211,Patel; Hemal,9996,0,9999,3
1713320089603,CLRE 260,A00,507221,Cuomo; Raphael Eduardo,9999,0,9999,0
1713320090630,CLRE 297,001,507242,Cuomo; Raphael Eduardo,9999,0,9999,0
1713320091657,CSE 191,A00,516875,Minnes Kemp; Mor Mia,9999,0,9999,0
1713320092679,CSS 201S,A01,494383,Staff,35,0,35,0
1713320093709,CSS 202S,A01,494387,Staff,35,0,35,0
1713320094733,EAP 100,A00,516065,Staff,9792,0,9999,207
1713320095760,ECE 45,A01,507414,Staff,54,0,60,6
1713320096786,ECE 100,A01,507416,Baghdadchi; Saharnaz,11,0,20,9
1713320096786,ECE 100,A02,507418,Baghdadchi; Saharnaz,20,0,20,0
1713320097809,ECE 111,A01,507420,Staff,39,0,50,11
1713320098833,ECE 197,001,548057,Sievenpiper; Daniel F.,9998,0,9999,1
1713320099862,EDS 115,A00,507243,Choi; Bailey Miyeon,28,0,28,0
1713320100890,EDS 117,A01,494379,Staff,23,0,25,2
1713320101914,EDS 125,A00,507246,Hopkins; Megan Beth,29,0,30,1
1713320102942,EDS 128A,A01,507264,Fargason; Sharon Gayle,26,0,26,0
1713320103970,EDS 128B,A01,507293,Pappas; Elizabeth,30,0,30,0
1713320104995,EDS 139,A00,507294,Fargason; Sharon Gayle,30,0,30,0
1713320104995,EDS 139,B00,507313,Pappas; Elizabeth,30,0,30,0
1713320106019,EDS 201,A00,507315,Staff,26,0,30,4
1713320107044,EDS 203,A01,507317,Halter; Christopher P.,26,0,30,4
1713320108070,EDS 204R,A01,507319,Halter; Christopher P.,3,0,30,27
1713320108070,EDS 204R,B01,507331,Heinzman; Erica M.,28,0,30,2
1713320109100,EDS 206R,A00,507332,Staff,4,0,30,26
1713320109100,EDS 206R,B00,507343,Staff,28,0,30,2
1713320110125,EDS 250,A00,507344,Hemans; Patricia Ann Benitez,36,0,40,4
1713320111151,EDS 281,A00,507345,Daly; Alan J.,18,0,18,0
1713320112175,EDS 284,A00,507350,Daly; Alan J.,16,0,16,0
1713320113203,EDS 286,A00,507359,Fine; Sarah,18,0,18,0
1713320114227,EDS 289C,A01,507361,Daly; Alan J.,18,0,18,0
1713320115251,EDS 290,A00,507366,Hofstetter; Carolyn,15,0,15,0
1713320116279,LIGM 5A,A00,507421,Fischer-Grunski; Eva K,20,0,20,0
1713320117308,LIGM 5B,A00,507423,Fischer-Grunski; Eva K,20,0,20,0
1713320118338,LIGM 5C,A00,507425,Fischer-Grunski; Eva K,20,0,20,0
1713320119368,LIIT 5AS,A00,507427,Carnelos; Chiara,20,0,20,0
1713320120395,LIIT 5BS,A00,507430,Carnelos; Chiara,20,0,20,0
1713320121425,LIIT 5CS,A00,507432,Carnelos; Chiara,20,0,20,0
1713320122449,LISP 5A,A00,507541,Munoz Sanchez; Alicia,19,0,20,1
1713320123475,LISP 5B,A00,507671,Munoz Sanchez; Alicia,17,0,20,3
1713320124499,LISP 5C,A00,507696,Munoz Sanchez; Alicia,17,0,20,3
1713320125525,MAE 197,001,528363,Boechler; Nicholas Sebastia,9998,0,9999,1
1713320126550,MATH 197,001,523477,Kedlaya; Kiran S.,9999,0,9999,0
1713320126550,MATH 197,002,563811,Zhang; Danna,9999,0,9999,0
1713320127577,MCWP 40R,A00,518780,Staff,20,0,20,0
1713320127577,MCWP 40R,B00,518781,Staff,19,0,20,1
1713320127577,MCWP 40R,C00,518783,Staff,19,0,20,1
1713320128606,MCWP 50R,A00,518791,Staff,20,0,20,0
1713320128606,MCWP 50R,B00,518792,Staff,17,0,20,3
1713320128606,MCWP 50R,C00,518793,Staff,19,0,20,1
1713320128606,MCWP 50R,D00,518794,Staff,18,0,20,2
1713320128606,MCWP 50R,E00,518795,Staff,17,0,20,3
1713320128606,MCWP 50R,F00,518796,Staff,19,0,20,1
1713320128606,MCWP 50R,G00,518797,Staff,19,0,20,1
1713320129633,MMW 12R,A01,514034,Herbst; Matthew,15,0,16,1
1713320129633,MMW 12R,A02,514035,Herbst; Matthew,16,0,16,0
1713320130657,MMW 13R,A01,514037,Staff,12,0,16,4
1713320130657,MMW 13R,A02,514039,Staff,16,0,16,0
1713320132710,SIO 295LS,A00,523233,Staff,19,0,30,11
1713320133734,SIO 295S,A00,523232,Staff,19,0,30,11
1713320134764,SOCI 117,A01,494376,Staff,3,0,5,2
1713320135789,WES 237B,A00,494380,Staff,19,0,20,1
1713320137864,AESE 279B,A00,494370,Wade; Jon P,33,0,33,0
1713320138944,ANAR 135S,A00,494369,Braswell; Geoffrey E.,0,0,0,0
1713320139969,CAT 124RS,A01,519847,Geibel; William,17,0,20,3
1713320140997,CAT 125RS,A01,515971,Geibel; William,17,0,20,3
1713320142026,CLRE 250,A00,511389,Morris; Sheldon,9996,0,9999,3
1713320143055,CLRE 251,A00,507176,Mehta; Ravindra L.,9996,0,9999,3
1713320143055,CLRE 251,B00,511410,Mehta; Ravindra L.,9998,0,9999,1
1713320144079,CLRE 252,A00,507189,Cuomo; Raphael Eduardo,9998,0,9999,1
1713320145105,CLRE 253,A00,507199,Vaida; Florin,9997,0,9999,2
1713320145105,CLRE 253,B00,507202,Vaida; Florin,9999,0,9999,0
1713320146129,CLRE 259,A00,507211,Patel; Hemal,9996,0,9999,3
1713320147158,CLRE 260,A00,507221,Cuomo; Raphael Eduardo,9999,0,9999,0
1713320148182,CLRE 297,001,507242,Cuomo; Raphael Eduardo,9999,0,9999,0
1713320149208,CSE 191,A00,516875,Minnes Kemp; Mor Mia,9999,0,9999,0
1713320150233,CSS 201S,A01,494383,Staff,35,0,35,0
1713320151262,CSS 202S,A01,494387,Staff,35,0,35,0
1713320152286,EAP 100,A00,516065,Staff,9792,0,9999,207
1713320153316,ECE 45,A01,507414,Staff,54,0,60,6
1713320154340,ECE 100,A01,507416,Baghdadchi; Saharnaz,11,0,20,9
1713320154340,ECE 100,A02,507418,Baghdadchi; Saharnaz,20,0,20,0
1713320155367,ECE 111,A01,507420,Staff,39,0,50,11
1713320156395,ECE 197,001,548057,Sievenpiper; Daniel F.,9998,0,9999,1
1713320157421,EDS 115,A00,507243,Choi; Bailey Miyeon,28,0,28,0
1713320158448,EDS 117,A01,494379,Staff,23,0,25,2
1713320159477,EDS 125,A00,507246,Hopkins; Megan Beth,29,0,30,1
1713320160505,EDS 128A,A01,507264,Fargason; Sharon Gayle,26,0,26,0
1713320161531,EDS 128B,A01,507293,Pappas; Elizabeth,30,0,30,0
1713320162554,EDS 139,A00,507294,Fargason; Sharon Gayle,30,0,30,0
1713320162554,EDS 139,B00,507313,Pappas; Elizabeth,30,0,30,0
1713320163582,EDS 201,A00,507315,Staff,26,0,30,4
1713320164607,EDS 203,A01,507317,Halter; Christopher P.,26,0,30,4
1713320165633,EDS 204R,A01,507319,Halter; Christopher P.,3,0,30,27
1713320165633,EDS 204R,B01,507331,Heinzman; Erica M.,28,0,30,2
1713320166658,EDS 206R,A00,507332,Staff,4,0,30,26
1713320166658,EDS 206R,B00,507343,Staff,28,0,30,2
1713320167686,EDS 250,A00,507344,Hemans; Patricia Ann Benitez,36,0,40,4
1713320168711,EDS 281,A00,507345,Daly; Alan J.,18,0,18,0
1713320169736,EDS 284,A00,507350,Daly; Alan J.,16,0,16,0
1713320170762,EDS 286,A00,507359,Fine; Sarah,18,0,18,0
1713320171787,EDS 289C,A01,507361,Daly; Alan J.,18,0,18,0
1713320172814,EDS 290,A00,507366,Hofstetter; Carolyn,15,0,15,0
1713320173844,LIGM 5A,A00,507421,Fischer-Grunski; Eva K,20,0,20,0
1713320174869,LIGM 5B,A00,507423,Fischer-Grunski; Eva K,20,0,20,0
1713320175898,LIGM 5C,A00,507425,Fischer-Grunski; Eva K,20,0,20,0
1713320176923,LIIT 5AS,A00,507427,Carnelos; Chiara,20,0,20,0
1713320177952,LIIT 5BS,A00,507430,Carnelos; Chiara,20,0,20,0
1713320178977,LIIT 5CS,A00,507432,Carnelos; Chiara,20,0,20,0
1713320180003,LISP 5A,A00,507541,Munoz Sanchez; Alicia,19,0,20,1
1713320181029,LISP 5B,A00,507671,Munoz Sanchez; Alicia,17,0,20,3
1713320182058,LISP 5C,A00,507696,Munoz Sanchez; Alicia,16,0,20,4
1713320183085,MAE 197,001,528363,Boechler; Nicholas Sebastia,9998,0,9999,1
1713320184110,MATH 197,001,523477,Kedlaya; Kiran S.,9999,0,9999,0
1713320184110,MATH 197,002,563811,Zhang; Danna,9999,0,9999,0
1713320185137,MCWP 40R,A00,518780,Staff,20,0,20,0
1713320185137,MCWP 40R,B00,518781,Staff,19,0,20,1
1713320185137,MCWP 40R,C00,518783,Staff,19,0,20,1
1713320186161,MCWP 50R,A00,518791,Staff,20,0,20,0
1713320186161,MCWP 50R,B00,518792,Staff,17,0,20,3
1713320186161,MCWP 50R,C00,518793,Staff,19,0,20,1
1713320186161,MCWP 50R,D00,518794,Staff,18,0,20,2
1713320186161,MCWP 50R,E00,518795,Staff,17,0,20,3
1713320186161,MCWP 50R,F00,518796,Staff,19,0,20,1
1713320186161,MCWP 50R,G00,518797,Staff,19,0,20,1
1713320187186,MMW 12R,A01,514034,Herbst; Matthew,15,0,16,1
1713320187186,MMW 12R,A02,514035,Herbst; Matthew,16,0,16,0
1713320188213,MMW 13R,A01,514037,Staff,12,0,16,4
1713320188213,MMW 13R,A02,514039,Staff,16,0,16,0
1713320190269,SIO 295LS,A00,523233,Staff,19,0,30,11
1713320191294,SIO 295S,A00,523232,Staff,19,0,30,11
1713320192319,SOCI 117,A01,494376,Staff,3,0,5,2
1713320193346,WES 237B,A00,494380,Staff,19,0,20,1
1713320195402,AESE 279B,A00,494370,Wade; Jon P,33,0,33,0
1713320196426,ANAR 135S,A00,494369,Braswell; Geoffrey E.,0,0,0,0
1713320197451,CAT 124RS,A01,519847,Geibel; William,17,0,20,3
1713320198477,CAT 125RS,A01,515971,Geibel; William,17,0,20,3
1713320199500,CLRE 250,A00,511389,Morris; Sheldon,9996,0,9999,3
1713320200526,CLRE 251,A00,507176,Mehta; Ravindra L.,9996,0,9999,3
1713320200526,CLRE 251,B00,511410,Mehta; Ravindra L.,9998,0,9999,1
1713320201549,CLRE 252,A00,507189,Cuomo; Raphael Eduardo,9998,0,9999,1
1713320202575,CLRE 253,A00,507199,Vaida; Florin,9997,0,9999,2
1713320202575,CLRE 253,B00,507202,Vaida; Florin,9999,0,9999,0
1713320203604,CLRE 259,A00,507211,Patel; Hemal,9996,0,9999,3
1713320204629,CLRE 260,A00,507221,Cuomo; Raphael Eduardo,9999,0,9999,0
1713320205654,CLRE 297,001,507242,Cuomo; Raphael Eduardo,9999,0,9999,0
1713320206679,CSE 191,A00,516875,Minnes Kemp; Mor Mia,9999,0,9999,0
1713320207705,CSS 201S,A01,494383,Staff,35,0,35,0
1713320208730,CSS 202S,A01,494387,Staff,35,0,35,0
1713320209755,EAP 100,A00,516065,Staff,9792,0,9999,207
1713320210780,ECE 45,A01,507414,Staff,54,0,60,6
1713320211806,ECE 100,A01,507416,Baghdadchi; Saharnaz,11,0,20,9
1713320211806,ECE 100,A02,507418,Baghdadchi; Saharnaz,20,0,20,0
1713320212829,ECE 111,A01,507420,Staff,39,0,50,11
1713320213871,ECE 197,001,548057,Sievenpiper; Daniel F.,9998,0,9999,1
1713320214897,EDS 115,A00,507243,Choi; Bailey Miyeon,28,0,28,0
1713320215921,EDS 117,A01,494379,Staff,23,0,25,2
1713320216950,EDS 125,A00,507246,Hopkins; Megan Beth,29,0,30,1
1713320217975,EDS 128A,A01,507264,Fargason; Sharon Gayle,26,0,26,0
1713320219002,EDS 128B,A01,507293,Pappas; Elizabeth,30,0,30,0
1713320220029,EDS 139,A00,507294,Fargason; Sharon Gayle,30,0,30,0
1713320220029,EDS 139,B00,507313,Pappas; Elizabeth,30,0,30,0
1713320221056,EDS 201,A00,507315,Staff,26,0,30,4
1713320222082,EDS 203,A01,507317,Halter; Christopher P.,26,0,30,4
1713320223117,EDS 204R,A01,507319,Halter; Christopher P.,3,0,30,27
1713320223117,EDS 204R,B01,507331,Heinzman; Erica M.,28,0,30,2
1713320224143,EDS 206R,A00,507332,Staff,4,0,30,26
1713320224143,EDS 206R,B00,507343,Staff,28,0,30,2
1713320225168,EDS 250,A00,507344,Hemans; Patricia Ann Benitez,36,0,40,4
1713320226193,EDS 281,A00,507345,Daly; Alan J.,18,0,18,0
1713320227217,EDS 284,A00,507350,Daly; Alan J.,16,0,16,0
1713320228242,EDS 286,A00,507359,Fine; Sarah,18,0,18,0
1713320229266,EDS 289C,A01,507361,Daly; Alan J.,18,0,18,0
1713320230291,EDS 290,A00,507366,Hofstetter; Carolyn,15,0,15,0
1713320231317,LIGM 5A,A00,507421,Fischer-Grunski; Eva K,20,0,20,0
1713320232342,LIGM 5B,A00,507423,Fischer-Grunski; Eva K,20,0,20,0
1713320233366,LIGM 5C,A00,507425,Fischer-Grunski; Eva K,20,0,20,0
1713320234395,LIIT 5AS,A00,507427,Carnelos; Chiara,20,0,20,0
1713320235419,LIIT 5BS,A00,507430,Carnelos; Chiara,20,0,20,0
1713320236443,LIIT 5CS,A00,507432,Carnelos; Chiara,20,0,20,0
1713320237467,LISP 5A,A00,507541,Munoz Sanchez; Alicia,18,0,20,2
1713320238492,LISP 5B,A00,507671,Munoz Sanchez; Alicia,16,0,20,4
1713320239521,LISP 5C,A00,507696,Munoz Sanchez; Alicia,16,0,20,4
1713320240548,MAE 197,001,528363,Boechler; Nicholas Sebastia,9998,0,9999,1
1713320241572,MATH 197,001,523477,Kedlaya; Kiran S.,9999,0,9999,0
1713320241572,MATH 197,002,563811,Zhang; Danna,9999,0,9999,0
1713320242667,MCWP 40R,A00,518780,Staff,20,0,20,0
1713320242667,MCWP 40R,B00,518781,Staff,19,0,20,1
1713320242667,MCWP 40R,C00,518783,Staff,19,0,20,1
1713320243693,MCWP 50R,A00,518791,Staff,20,0,20,0
1713320243693,MCWP 50R,B00,518792,Staff,17,0,20,3
1713320243693,MCWP 50R,C00,518793,Staff,19,0,20,1
1713320243693,MCWP 50R,D00,518794,Staff,18,0,20,2
1713320243693,MCWP 50R,E00,518795,Staff,17,0,20,3
1713320243693,MCWP 50R,F00,518796,Staff,19,0,20,1
1713320243693,MCWP 50R,G00,518797,Staff,19,0,20,1
1713320244719,MMW 12R,A01,514034,Herbst; Matthew,15,0,16,1
1713320244719,MMW 12R,A02,514035,Herbst; Matthew,16,0,16,0
1713320245744,MMW 13R,A01,514037,Staff,12,0,16,4
1713320245744,MMW 13R,A02,514039,Staff,16,0,16,0
1713320247800,SIO 295LS,A00,523233,Staff,19,0,30,11
1713320248828,SIO 295S,A00,523232,Staff,19,0,30,11
1713320249853,SOCI 117,A01,494376,Staff,3,0,5,2
1713320250880,WES 237B,A00,494380,Staff,19,0,20,1
1713320252938,AESE 279B,A00,494370,Wade; Jon P,33,0,33,0
1713320253966,ANAR 135S,A00,494369,Braswell; Geoffrey E.,0,0,0,0
1713320254993,CAT 124RS,A01,519847,Geibel; William,17,0,20,3
1713320256016,CAT 125RS,A01,515971,Geibel; William,17,0,20,3
1713320257045,CLRE 250,A00,511389,Morris; Sheldon,9996,0,9999,3
1713320258069,CLRE 251,A00,507176,Mehta; Ravindra L.,9996,0,9999,3
1713320258069,CLRE 251,B00,511410,Mehta; Ravindra L.,9998,0,9999,1
1713320259098,CLRE 252,A00,507189,Cuomo; Raphael Eduardo,9998,0,9999,1
1713320260128,CLRE 253,A00,507199,Vaida; Florin,9997,0,9999,2
1713320260128,CLRE 253,B00,507202,Vaida; Florin,9999,0,9999,0
1713320261151,CLRE 259,A00,507211,Patel; Hemal,9996,0,9999,3
1713320262181,CLRE 260,A00,507221,Cuomo; Raphael Eduardo,9999,0,9999,0
1713320263206,CLRE 297,001,507242,Cuomo; Raphael Eduardo,9999,0,9999,0
1713320264234,CSE 191,A00,516875,Minnes Kemp; Mor Mia,9999,0,9999,0
1713320265258,CSS 201S,A01,494383,Staff,35,0,35,0
1713320266285,CSS 202S,A01,494387,Staff,35,0,35,0
1713320267311,EAP 100,A00,516065,Staff,9792,0,9999,207
1713320268335,ECE 45,A01,507414,Staff,54,0,60,6
1713320269363,ECE 100,A01,507416,Baghdadchi; Saharnaz,11,0,20,9
1713320269363,ECE 100,A02,507418,Baghdadchi; Saharnaz,20,0,20,0
1713320270386,ECE 111,A01,507420,Staff,39,0,50,11
1713320271415,ECE 197,001,548057,Sievenpiper; Daniel F.,9998,0,9999,1
1713320272443,EDS 115,A00,507243,Choi; Bailey Miyeon,28,0,28,0
1713320273469,EDS 117,A01,494379,Staff,23,0,25,2
1713320274496,EDS 125,A00,507246,Hopkins; Megan Beth,29,0,30,1
1713320275522,EDS 128A,A01,507264,Fargason; Sharon Gayle,26,0,26,0
1713320276552,EDS 128B,A01,507293,Pappas; Elizabeth,30,0,30,0
1713320277583,EDS 139,A00,507294,Fargason; Sharon Gayle,30,0,30,0
1713320277583,EDS 139,B00,507313,Pappas; Elizabeth,30,0,30,0
1713320278610,EDS 201,A00,507315,Staff,26,0,30,4
1713320279640,EDS 203,A01,507317,Halter; Christopher P.,26,0,30,4
1713320280665,EDS 204R,A01,507319,Halter; Christopher P.,3,0,30,27
1713320280665,EDS 204R,B01,507331,Heinzman; Erica M.,28,0,30,2
1713320281688,EDS 206R,A00,507332,Staff,4,0,30,26
1713320281688,EDS 206R,B00,507343,Staff,28,0,30,2
1713320282713,EDS 250,A00,507344,Hemans; Patricia Ann Benitez,36,0,40,4
1713320283738,EDS 281,A00,507345,Daly; Alan J.,18,0,18,0
1713320284763,EDS 284,A00,507350,Daly; Alan J.,16,0,16,0
1713320285792,EDS 286,A00,507359,Fine; Sarah,18,0,18,0
1713320286819,EDS 289C,A01,507361,Daly; Alan J.,18,0,18,0
1713320287844,EDS 290,A00,507366,Hofstetter; Carolyn,15,0,15,0
1713320288873,LIGM 5A,A00,507421,Fischer-Grunski; Eva K,20,0,20,0
1713320289899,LIGM 5B,A00,507423,Fischer-Grunski; Eva K,20,0,20,0
1713320290926,LIGM 5C,A00,507425,Fischer-Grunski; Eva K,20,0,20,0
1713320291953,LIIT 5AS,A00,507427,Carnelos; Chiara,20,0,20,0
1713320292980,LIIT 5BS,A00,507430,Carnelos; Chiara,20,0,20,0
1713320294005,LIIT 5CS,A00,507432,Carnelos; Chiara,20,0,20,0
1713320295031,LISP 5A,A00,507541,Munoz Sanchez; Alicia,18,0,20,2
1713320296055,LISP 5B,A00,507671,Munoz Sanchez; Alicia,16,0,20,4
1713320297081,LISP 5C,A00,507696,Munoz Sanchez; Alicia,16,0,20,4
1713320298107,MAE 197,001,528363,Boechler; Nicholas Sebastia,9998,0,9999,1
1713320299131,MATH 197,001,523477,Kedlaya; Kiran S.,9999,0,9999,0
1713320299131,MATH 197,002,563811,Zhang; Danna,9999,0,9999,0
1713320300156,MCWP 40R,A00,518780,Staff,20,0,20,0
1713320300156,MCWP 40R,B00,518781,Staff,19,0,20,1
1713320300156,MCWP 40R,C00,518783,Staff,19,0,20,1
1713320301180,MCWP 50R,A00,518791,Staff,20,0,20,0
1713320301180,MCWP 50R,B00,518792,Staff,17,0,20,3
1713320301180,MCWP 50R,C00,518793,Staff,19,0,20,1
1713320301180,MCWP 50R,D00,518794,Staff,18,0,20,2
1713320301180,MCWP 50R,E00,518795,Staff,17,0,20,3
1713320301180,MCWP 50R,F00,518796,Staff,19,0,20,1
1713320301180,MCWP 50R,G00,518797,Staff,19,0,20,1
1713320302208,MMW 12R,A01,514034,Herbst; Matthew,15,0,16,1
1713320302208,MMW 12R,A02,514035,Herbst; Matthew,16,0,16,0
1713320303236,MMW 13R,A01,514037,Staff,12,0,16,4
1713320303236,MMW 13R,A02,514039,Staff,16,0,16,0
1713320305293,SIO 295LS,A00,523233,Staff,19,0,30,11
1713320306318,SIO 295S,A00,523232,Staff,19,0,30,11
1713320307342,SOCI 117,A01,494376,Staff,3,0,5,2
1713320308369,WES 237B,A00,494380,Staff,19,0,20,1
1713320310432,AESE 279B,A00,494370,Wade; Jon P,33,0,33,0
1713320311463,ANAR 135S,A00,494369,Braswell; Geoffrey E.,0,0,0,0
1713320312488,CAT 124RS,A01,519847,Geibel; William,17,0,20,3
1713320313511,CAT 125RS,A01,515971,Geibel; William,17,0,20,3
1713320314536,CLRE 250,A00,511389,Morris; Sheldon,9996,0,9999,3
1713320315562,CLRE 251,A00,507176,Mehta; Ravindra L.,9996,0,9999,3
1713320315562,CLRE 251,B00,511410,Mehta; Ravindra L.,9998,0,9999,1
1713320316592,CLRE 252,A00,507189,Cuomo; Raphael Eduardo,9998,0,9999,1
1713320317616,CLRE 253,A00,507199,Vaida; Florin,9997,0,9999,2
1713320317616,CLRE 253,B00,507202,Vaida; Florin,9999,0,9999,0
1713320318639,CLRE 259,A00,507211,Patel; Hemal,9996,0,9999,3
1713320319667,CLRE 260,A00,507221,Cuomo; Raphael Eduardo,9999,0,9999,0
1713320320691,CLRE 297,001,507242,Cuomo; Raphael Eduardo,9999,0,9999,0
1713320321719,CSE 191,A00,516875,Minnes Kemp; Mor Mia,9999,0,9999,0
1713320322748,CSS 201S,A01,494383,Staff,35,0,35,0
1713320323772,CSS 202S,A01,494387,Staff,35,0,35,0
1713320324797,EAP 100,A00,516065,Staff,9792,0,9999,207
1713320325823,ECE 45,A01,507414,Staff,54,0,60,6
1713320326847,ECE 100,A01,507416,Baghdadchi; Saharnaz,11,0,20,9
1713320326847,ECE 100,A02,507418,Baghdadchi; Saharnaz,20,0,20,0
1713320327871,ECE 111,A01,507420,Staff,39,0,50,11
1713320328896,ECE 197,001,548057,Sievenpiper; Daniel F.,9998,0,9999,1
1713320329922,EDS 115,A00,507243,Choi; Bailey Miyeon,28,0,28,0
1713320330944,EDS 117,A01,494379,Staff,23,0,25,2
1713320331969,EDS 125,A00,507246,Hopkins; Megan Beth,29,0,30,1
1713320332995,EDS 128A,A01,507264,Fargason; Sharon Gayle,26,0,26,0
1713320334019,EDS 128B,A01,507293,Pappas; Elizabeth,30,0,30,0
1713320335045,EDS 139,A00,507294,Fargason; Sharon Gayle,30,0,30,0
1713320335045,EDS 139,B00,507313,Pappas; Elizabeth,30,0,30,0
1713320336072,EDS 201,A00,507315,Staff,26,0,30,4
1713320337099,EDS 203,A01,507317,Halter; Christopher P.,26,0,30,4
1713320338130,EDS 204R,A01,507319,Halter; Christopher P.,3,0,30,27
1713320338130,EDS 204R,B01,507331,Heinzman; Erica M.,28,0,30,2
1713320339154,EDS 206R,A00,507332,Staff,4,0,30,26
1713320339154,EDS 206R,B00,507343,Staff,28,0,30,2
1713320340182,EDS 250,A00,507344,Hemans; Patricia Ann Benitez,36,0,40,4
1713320341207,EDS 281,A00,507345,Daly; Alan J.,18,0,18,0
1713320342232,EDS 284,A00,507350,Daly; Alan J.,16,0,16,0
1713320343257,EDS 286,A00,507359,Fine; Sarah,18,0,18,0
1713320344282,EDS 289C,A01,507361,Daly; Alan J.,18,0,18,0
1713320345311,EDS 290,A00,507366,Hofstetter; Carolyn,15,0,15,0
1713320346394,LIGM 5A,A00,507421,Fischer-Grunski; Eva K,20,0,20,0
1713320347419,LIGM 5B,A00,507423,Fischer-Grunski; Eva K,20,0,20,0
1713320348444,LIGM 5C,A00,507425,Fischer-Grunski; Eva K,20,0,20,0
1713320349471,LIIT 5AS,A00,507427,Carnelos; Chiara,20,0,20,0
1713320350502,LIIT 5BS,A00,507430,Carnelos; Chiara,20,0,20,0
1713320351531,LIIT 5CS,A00,507432,Carnelos; Chiara,20,0,20,0
1713320352555,LISP 5A,A00,507541,Munoz Sanchez; Alicia,18,0,20,2
1713320353585,LISP 5B,A00,507671,Munoz Sanchez; Alicia,16,0,20,4
1713320354615,LISP 5C,A00,507696,Munoz Sanchez; Alicia,16,0,20,4
1713320355640,MAE 197,001,528363,Boechler; Nicholas Sebastia,9998,0,9999,1
1713320356665,MATH 197,001,523477,Kedlaya; Kiran S.,9999,0,9999,0
1713320356665,MATH 197,002,563811,Zhang; Danna,9999,0,9999,0
1713320357694,MCWP 40R,A00,518780,Staff,20,0,20,0
1713320357694,MCWP 40R,B00,518781,Staff,19,0,20,1
1713320357694,MCWP 40R,C00,518783,Staff,19,0,20,1
1713320358724,MCWP 50R,A00,518791,Staff,20,0,20,0
1713320358724,MCWP 50R,B00,518792,Staff,17,0,20,3
1713320358724,MCWP 50R,C00,518793,Staff,19,0,20,1
1713320358724,MCWP 50R,D00,518794,Staff,18,0,20,2
1713320358724,MCWP 50R,E00,518795,Staff,17,0,20,3
1713320358724,MCWP 50R,F00,518796,Staff,19,0,20,1
1713320358724,MCWP 50R,G00,518797,Staff,19,0,20,1
1713320359748,MMW 12R,A01,514034,Herbst; Matthew,15,0,16,1
1713320359748,MMW 12R,A02,514035,Herbst; Matthew,16,0,16,0
1713320360779,MMW 13R,A01,514037,Staff,12,0,16,4
1713320360779,MMW 13R,A02,514039,Staff,16,0,16,0
1713320362829,SIO 295LS,A00,523233,Staff,19,0,30,11
1713320363870,SIO 295S,A00,523232,Staff,19,0,30,11
1713320364894,SOCI 117,A01,494376,Staff,3,0,5,2
1713320365922,WES 237B,A00,494380,Staff,19,0,20,1
1713320367994,AESE 279B,A00,494370,Wade; Jon P,33,0,33,0
1713320369018,ANAR 135S,A00,494369,Braswell; Geoffrey E.,0,0,0,0
1713320370044,CAT 124RS,A01,519847,Geibel; William,17,0,20,3
1713320371069,CAT 125RS,A01,515971,Geibel; William,17,0,20,3
1713320372094,CLRE 250,A00,511389,Morris; Sheldon,9996,0,9999,3
1713320373124,CLRE 251,A00,507176,Mehta; Ravindra L.,9996,0,9999,3
1713320373124,CLRE 251,B00,511410,Mehta; Ravindra L.,9998,0,9999,1
1713320374151,CLRE 252,A00,507189,Cuomo; Raphael Eduardo,9998,0,9999,1
1713320375180,CLRE 253,A00,507199,Vaida; Florin,9997,0,9999,2
1713320375180,CLRE 253,B00,507202,Vaida; Florin,9999,0,9999,0
1713320376208,CLRE 259,A00,507211,Patel; Hemal,9996,0,9999,3
1713320377236,CLRE 260,A00,507221,Cuomo; Raphael Eduardo,9999,0,9999,0
1713320378263,CLRE 297,001,507242,Cuomo; Raphael Eduardo,9999,0,9999,0
1713320379290,CSE 191,A00,516875,Minnes Kemp; Mor Mia,9999,0,9999,0
1713320380315,CSS 201S,A01,494383,Staff,35,0,35,0
1713320381340,CSS 202S,A01,494387,Staff,35,0,35,0
1713320382364,EAP 100,A00,516065,Staff,9792,0,9999,207
1713320383391,ECE 45,A01,507414,Staff,54,0,60,6
1713320384418,ECE 100,A01,507416,Baghdadchi; Saharnaz,11,0,20,9
1713320384418,ECE 100,A02,507418,Baghdadchi; Saharnaz,20,0,20,0
1713320385441,ECE 111,A01,507420,Staff,39,0,50,11
1713320386466,ECE 197,001,548057,Sievenpiper; Daniel F.,9998,0,9999,1
1713320387491,EDS 115,A00,507243,Choi; Bailey Miyeon,28,0,28,0
1713320388514,EDS 117,A01,494379,Staff,23,0,25,2
1713320389538,EDS 125,A00,507246,Hopkins; Megan Beth,29,0,30,1
1713320390567,EDS 128A,A01,507264,Fargason; Sharon Gayle,26,0,26,0
1713320391593,EDS 128B,A01,507293,Pappas; Elizabeth,30,0,30,0
1713320392620,EDS 139,A00,507294,Fargason; Sharon Gayle,30,0,30,0
1713320392620,EDS 139,B00,507313,Pappas; Elizabeth,30,0,30,0
1713320393646,EDS 201,A00,507315,Staff,26,0,30,4
1713320394673,EDS 203,A01,507317,Halter; Christopher P.,26,0,30,4
1713320395698,EDS 204R,A01,507319,Halter; Christopher P.,3,0,30,27
1713320395698,EDS 204R,B01,507331,Heinzman; Erica M.,28,0,30,2
1713320396722,EDS 206R,A00,507332,Staff,4,0,30,26
1713320396722,EDS 206R,B00,507343,Staff,28,0,30,2
1713320397751,EDS 250,A00,507344,Hemans; Patricia Ann Benitez,36,0,40,4
1713320398776,EDS 281,A00,507345,Daly; Alan J.,18,0,18,0
1713320399803,EDS 284,A00,507350,Daly; Alan J.,16,0,16,0
1713320400828,EDS 286,A00,507359,Fine; Sarah,18,0,18,0
1713320401853,EDS 289C,A01,507361,Daly; Alan J.,18,0,18,0
1713320402877,EDS 290,A00,507366,Hofstetter; Carolyn,15,0,15,0
1713320403909,LIGM 5A,A00,507421,Fischer-Grunski; Eva K,20,0,20,0
1713320404934,LIGM 5B,A00,507423,Fischer-Grunski; Eva K,20,0,20,0
1713320405958,LIGM 5C,A00,507425,Fischer-Grunski; Eva K,20,0,20,0
1713320406986,LIIT 5AS,A00,507427,Carnelos; Chiara,20,0,20,0
1713320408011,LIIT 5BS,A00,507430,Carnelos; Chiara,20,0,20,0
1713320409038,LIIT 5CS,A00,507432,Carnelos; Chiara,20,0,20,0
1713320410066,LISP 5A,A00,507541,Munoz Sanchez; Alicia,18,0,20,2
1713320411090,LISP 5B,A00,507671,Munoz Sanchez; Alicia,16,0,20,4
1713320412114,LISP 5C,A00,507696,Munoz Sanchez; Alicia,16,0,20,4
1713320413141,MAE 197,001,528363,Boechler; Nicholas Sebastia,9998,0,9999,1
1713320414165,MATH 197,001,523477,Kedlaya; Kiran S.,9999,0,9999,0
1713320414165,MATH 197,002,563811,Zhang; Danna,9999,0,9999,0
1713320415190,MCWP 40R,A00,518780,Staff,20,0,20,0
1713320415190,MCWP 40R,B00,518781,Staff,19,0,20,1
1713320415190,MCWP 40R,C00,518783,Staff,19,0,20,1
1713320416215,MCWP 50R,A00,518791,Staff,20,0,20,0
1713320416215,MCWP 50R,B00,518792,Staff,17,0,20,3
1713320416215,MCWP 50R,C00,518793,Staff,19,0,20,1
1713320416215,MCWP 50R,D00,518794,Staff,18,0,20,2
1713320416215,MCWP 50R,E00,518795,Staff,16,0,20,4
1713320416215,MCWP 50R,F00,518796,Staff,19,0,20,1
1713320416215,MCWP 50R,G00,518797,Staff,19,0,20,1
1713320417241,MMW 12R,A01,514034,Herbst; Matthew,15,0,16,1
1713320417241,MMW 12R,A02,514035,Herbst; Matthew,16,0,16,0
1713320418269,MMW 13R,A01,514037,Staff,12,0,16,4
1713320418269,MMW 13R,A02,514039,Staff,16,0,16,0
1713320420321,SIO 295LS,A00,523233,Staff,19,0,30,11
1713320421358,SIO 295S,A00,523232,Staff,19,0,30,11
1713320422384,SOCI 117,A01,494376,Staff,3,0,5,2
1713320423412,WES 237B,A00,494380,Staff,19,0,20,1
1713320425472,AESE 279B,A00,494370,Wade; Jon P,33,0,33,0
1713320426500,ANAR 135S,A00,494369,Braswell; Geoffrey E.,0,0,0,0
1713320427528,CAT 124RS,A01,519847,Geibel; William,17,0,20,3
1713320428553,CAT 125RS,A01,515971,Geibel; William,17,0,20,3
1713320429576,CLRE 250,A00,511389,Morris; Sheldon,9996,0,9999,3
1713320430602,CLRE 251,A00,507176,Mehta; Ravindra L.,9996,0,9999,3
1713320430602,CLRE 251,B00,511410,Mehta; Ravindra L.,9998,0,9999,1
1713320431629,CLRE 252,A00,507189,Cuomo; Raphael Eduardo,9998,0,9999,1
1713320432654,CLRE 253,A00,507199,Vaida; Florin,9997,0,9999,2
1713320432654,CLRE 253,B00,507202,Vaida; Florin,9999,0,9999,0
1713320433678,CLRE 259,A00,507211,Patel; Hemal,9996,0,9999,3
1713320434702,CLRE 260,A00,507221,Cuomo; Raphael Eduardo,9999,0,9999,0
1713320435727,CLRE 297,001,507242,Cuomo; Raphael Eduardo,9999,0,9999,0
1713320436753,CSE 191,A00,516875,Minnes Kemp; Mor Mia,9999,0,9999,0
1713320437781,CSS 201S,A01,494383,Staff,35,0,35,0
1713320438810,CSS 202S,A01,494387,Staff,35,0,35,0
1713320439833,EAP 100,A00,516065,Staff,9792,0,9999,207
1713320440859,ECE 45,A01,507414,Staff,54,0,60,6
1713320441882,ECE 100,A01,507416,Baghdadchi; Saharnaz,11,0,20,9
1713320441882,ECE 100,A02,507418,Baghdadchi; Saharnaz,20,0,20,0
1713320442907,ECE 111,A01,507420,Staff,39,0,50,11
1713320443932,ECE 197,001,548057,Sievenpiper; Daniel F.,9998,0,9999,1
1713320444960,EDS 115,A00,507243,Choi; Bailey Miyeon,28,0,28,0
1713320445984,EDS 117,A01,494379,Staff,23,0,25,2
1713320447013,EDS 125,A00,507246,Hopkins; Megan Beth,29,0,30,1
1713320448038,EDS 128A,A01,507264,Fargason; Sharon Gayle,26,0,26,0
1713320449063,EDS 128B,A01,507293,Pappas; Elizabeth,30,0,30,0
1713320450147,EDS 139,A00,507294,Fargason; Sharon Gayle,30,0,30,0
1713320450147,EDS 139,B00,507313,Pappas; Elizabeth,30,0,30,0
1713320451175,EDS 201,A00,507315,Staff,26,0,30,4
1713320452203,EDS 203,A01,507317,Halter; Christopher P.,26,0,30,4
1713320453229,EDS 204R,A01,507319,Halter; Christopher P.,3,0,30,27
1713320453229,EDS 204R,B01,507331,Heinzman; Erica M.,28,0,30,2
1713320454253,EDS 206R,A00,507332,Staff,4,0,30,26
1713320454253,EDS 206R,B00,507343,Staff,28,0,30,2
1713320455281,EDS 250,A00,507344,Hemans; Patricia Ann Benitez,36,0,40,4
1713320456306,EDS 281,A00,507345,Daly; Alan J.,18,0,18,0
1713320457329,EDS 284,A00,507350,Daly; Alan J.,16,0,16,0
1713320458356,EDS 286,A00,507359,Fine; Sarah,18,0,18,0
1713320459383,EDS 289C,A01,507361,Daly; Alan J.,18,0,18,0
1713320460411,EDS 290,A00,507366,Hofstetter; Carolyn,15,0,15,0
1713320461435,LIGM 5A,A00,507421,Fischer-Grunski; Eva K,20,0,20,0
1713320462464,LIGM 5B,A00,507423,Fischer-Grunski; Eva K,20,0,20,0
1713320463488,LIGM 5C,A00,507425,Fischer-Grunski; Eva K,20,0,20,0
1713320464513,LIIT 5AS,A00,507427,Carnelos; Chiara,20,0,20,0
1713320465537,LIIT 5BS,A00,507430,Carnelos; Chiara,20,0,20,0
1713320466561,LIIT 5CS,A00,507432,Carnelos; Chiara,20,0,20,0
1713320467584,LISP 5A,A00,507541,Munoz Sanchez; Alicia,18,0,20,2
1713320468607,LISP 5B,A00,507671,Munoz Sanchez; Alicia,16,0,20,4
1713320469636,LISP 5C,A00,507696,Munoz Sanchez; Alicia,16,0,20,4
1713320470660,MAE 197,001,528363,Boechler; Nicholas Sebastia,9998,0,9999,1
1713320471685,MATH 197,001,523477,Kedlaya; Kiran S.,9999,0,9999,0
1713320471685,MATH 197,002,563811,Zhang; Danna,9999,0,9999,0
1713320472714,MCWP 40R,A00,518780,Staff,20,0,20,0
1713320472714,MCWP 40R,B00,518781,Staff,19,0,20,1
1713320472714,MCWP 40R,C00,518783,Staff,19,0,20,1
1713320473743,MCWP 50R,A00,518791,Staff,20,0,20,0
1713320473743,MCWP 50R,B00,518792,Staff,17,0,20,3
1713320473743,MCWP 50R,C00,518793,Staff,19,0,20,1
1713320473743,MCWP 50R,D00,518794,Staff,18,0,20,2
1713320473743,MCWP 50R,E00,518795,Staff,16,0,20,4
1713320473743,MCWP 50R,F00,518796,Staff,19,0,20,1
1713320473743,MCWP 50R,G00,518797,Staff,19,0,20,1
1713320474770,MMW 12R,A01,514034,Herbst; Matthew,15,0,16,1
1713320474770,MMW 12R,A02,514035,Herbst; Matthew,16,0,16,0
1713320475799,MMW 13R,A01,514037,Staff,12,0,16,4
1713320475799,MMW 13R,A02,514039,Staff,16,0,16,0
1713320477853,SIO 295LS,A00,523233,Staff,19,0,30,11
1713320478882,SIO 295S,A00,523232,Staff,19,0,30,11
1713320479908,SOCI 117,A01,494376,Staff,3,0,5,2
1713320480934,WES 237B,A00,494380,Staff,19,0,20,1
1713320482991,AESE 279B,A00,494370,Wade; Jon P,33,0,33,0
1713320484016,ANAR 135S,A00,494369,Braswell; Geoffrey E.,0,0,0,0
1713320485041,CAT 124RS,A01,519847,Geibel; William,17,0,20,3
1713320486066,CAT 125RS,A01,515971,Geibel; William,17,0,20,3
1713320487093,CLRE 250,A00,511389,Morris; Sheldon,9996,0,9999,3
1713320488118,CLRE 251,A00,507176,Mehta; Ravindra L.,9996,0,9999,3
1713320488118,CLRE 251,B00,511410,Mehta; Ravindra L.,9998,0,9999,1
1713320489146,CLRE 252,A00,507189,Cuomo; Raphael Eduardo,9998,0,9999,1
1713320490173,CLRE 253,A00,507199,Vaida; Florin,9997,0,9999,2
1713320490173,CLRE 253,B00,507202,Vaida; Florin,9999,0,9999,0
1713320491198,CLRE 259,A00,507211,Patel; Hemal,9996,0,9999,3
1713320492222,CLRE 260,A00,507221,Cuomo; Raphael Eduardo,9999,0,9999,0
1713320493252,CLRE 297,001,507242,Cuomo; Raphael Eduardo,9999,0,9999,0
1713320494276,CSE 191,A00,516875,Minnes Kemp; Mor Mia,9999,0,9999,0
1713320495303,CSS 201S,A01,494383,Staff,35,0,35,0
1713320496330,CSS 202S,A01,494387,Staff,35,0,35,0
1713320497354,EAP 100,A00,516065,Staff,9792,0,9999,207
1713320498381,ECE 45,A01,507414,Staff,54,0,60,6
1713320499403,ECE 100,A01,507416,Baghdadchi; Saharnaz,11,0,20,9
1713320499403,ECE 100,A02,507418,Baghdadchi; Saharnaz,20,0,20,0
1713320500431,ECE 111,A01,507420,Staff,39,0,50,11
1713320501458,ECE 197,001,548057,Sievenpiper; Daniel F.,9998,0,9999,1
1713320502481,EDS 115,A00,507243,Choi; Bailey Miyeon,28,0,28,0
1713320503509,EDS 117,A01,494379,Staff,23,0,25,2
1713320504535,EDS 125,A00,507246,Hopkins; Megan Beth,29,0,30,1
1713320505561,EDS 128A,A01,507264,Fargason; Sharon Gayle,26,0,26,0
1713320506591,EDS 128B,A01,507293,Pappas; Elizabeth,30,0,30,0
1713320507617,EDS 139,A00,507294,Fargason; Sharon Gayle,30,0,30,0
1713320507617,EDS 139,B00,507313,Pappas; Elizabeth,30,0,30,0
1713320508642,EDS 201,A00,507315,Staff,26,0,30,4
1713320509666,EDS 203,A01,507317,Halter; Christopher P.,26,0,30,4
1713320510693,EDS 204R,A01,507319,Halter; Christopher P.,3,0,30,27
1713320510693,EDS 204R,B01,507331,Heinzman; Erica M.,28,0,30,2
1713320511718,EDS 206R,A00,507332,Staff,4,0,30,26
1713320511718,EDS 206R,B00,507343,Staff,28,0,30,2
1713320512746,EDS 250,A00,507344,Hemans; Patricia Ann Benitez,36,0,40,4
1713320513771,EDS 281,A00,507345,Daly; Alan J.,18,0,18,0
1713320514797,EDS 284,A00,507350,Daly; Alan J.,16,0,16,0
1713320515820,EDS 286,A00,507359,Fine; Sarah,18,0,18,0
1713320516845,EDS 289C,A01,507361,Daly; Alan J.,18,0,18,0
1713320517873,EDS 290,A00,507366,Hofstetter; Carolyn,15,0,15,0
1713320518903,LIGM 5A,A00,507421,Fischer-Grunski; Eva K,20,0,20,0
1713320519929,LIGM 5B,A00,507423,Fischer-Grunski; Eva K,20,0,20,0
1713320520957,LIGM 5C,A00,507425,Fischer-Grunski; Eva K,20,0,20,0
1713320521983,LIIT 5AS,A00,507427,Carnelos; Chiara,20,0,20,0
1713320523010,LIIT 5BS,A00,507430,Carnelos; Chiara,20,0,20,0
1713320524034,LIIT 5CS,A00,507432,Carnelos; Chiara,20,0,20,0
1713320525060,LISP 5A,A00,507541,Munoz Sanchez; Alicia,18,0,20,2
1713320526084,LISP 5B,A00,507671,Munoz Sanchez; Alicia,16,0,20,4
1713320527109,LISP 5C,A00,507696,Munoz Sanchez; Alicia,16,0,20,4
1713320528134,MAE 197,001,528363,Boechler; Nicholas Sebastia,9998,0,9999,1
1713320529162,MATH 197,001,523477,Kedlaya; Kiran S.,9999,0,9999,0
1713320529162,MATH 197,002,563811,Zhang; Danna,9999,0,9999,0
1713320530186,MCWP 40R,A00,518780,Staff,20,0,20,0
1713320530186,MCWP 40R,B00,518781,Staff,19,0,20,1
1713320530186,MCWP 40R,C00,518783,Staff,19,0,20,1
1713320531212,MCWP 50R,A00,518791,Staff,20,0,20,0
1713320531212,MCWP 50R,B00,518792,Staff,17,0,20,3
1713320531212,MCWP 50R,C00,518793,Staff,19,0,20,1
1713320531212,MCWP 50R,D00,518794,Staff,18,0,20,2
1713320531212,MCWP 50R,E00,518795,Staff,16,0,20,4
1713320531212,MCWP 50R,F00,518796,Staff,19,0,20,1
1713320531212,MCWP 50R,G00,518797,Staff,19,0,20,1
1713320532238,MMW 12R,A01,514034,Herbst; Matthew,15,0,16,1
1713320532238,MMW 12R,A02,514035,Herbst; Matthew,16,0,16,0
1713320533265,MMW 13R,A01,514037,Staff,12,0,16,4
1713320533265,MMW 13R,A02,514039,Staff,16,0,16,0
1713320535321,SIO 295LS,A00,523233,Staff,19,0,30,11
1713320536347,SIO 295S,A00,523232,Staff,19,0,30,11
1713320537372,SOCI 117,A01,494376,Staff,3,0,5,2
1713320538396,WES 237B,A00,494380,Staff,19,0,20,1
1713320540461,AESE 279B,A00,494370,Wade; Jon P,33,0,33,0
1713320541488,ANAR 135S,A00,494369,Braswell; Geoffrey E.,0,0,0,0
1713320542515,CAT 124RS,A01,519847,Geibel; William,17,0,20,3
1713320543543,CAT 125RS,A01,515971,Geibel; William,17,0,20,3
1713320544568,CLRE 250,A00,511389,Morris; Sheldon,9996,0,9999,3
1713320545597,CLRE 251,A00,507176,Mehta; Ravindra L.,9996,0,9999,3
1713320545597,CLRE 251,B00,511410,Mehta; Ravindra L.,9998,0,9999,1
1713320546625,CLRE 252,A00,507189,Cuomo; Raphael Eduardo,9998,0,9999,1
1713320547653,CLRE 253,A00,507199,Vaida; Florin,9997,0,9999,2
1713320547653,CLRE 253,B00,507202,Vaida; Florin,9999,0,9999,0
1713320548682,CLRE 259,A00,507211,Patel; Hemal,9996,0,9999,3
1713320549708,CLRE 260,A00,507221,Cuomo; Raphael Eduardo,9999,0,9999,0
1713320550736,CLRE 297,001,507242,Cuomo; Raphael Eduardo,9999,0,9999,0
1713320551763,CSE 191,A00,516875,Minnes Kemp; Mor Mia,9999,0,9999,0
1713320552793,CSS 201S,A01,494383,Staff,35,0,35,0
1713320553873,CSS 202S,A01,494387,Staff,35,0,35,0
1713320554900,EAP 100,A00,516065,Staff,9792,0,9999,207
1713320555925,ECE 45,A01,507414,Staff,54,0,60,6
1713320556950,ECE 100,A01,507416,Baghdadchi; Saharnaz,11,0,20,9
1713320556950,ECE 100,A02,507418,Baghdadchi; Saharnaz,20,0,20,0
1713320557975,ECE 111,A01,507420,Staff,39,0,50,11
1713320559000,ECE 197,001,548057,Sievenpiper; Daniel F.,9998,0,9999,1
1713320560026,EDS 115,A00,507243,Choi; Bailey Miyeon,28,0,28,0
1713320561054,EDS 117,A01,494379,Staff,23,0,25,2
1713320562079,EDS 125,A00,507246,Hopkins; Megan Beth,29,0,30,1
1713320563107,EDS 128A,A01,507264,Fargason; Sharon Gayle,26,0,26,0
1713320564130,EDS 128B,A01,507293,Pappas; Elizabeth,30,0,30,0
1713320565155,EDS 139,A00,507294,Fargason; Sharon Gayle,30,0,30,0
1713320565155,EDS 139,B00,507313,Pappas; Elizabeth,30,0,30,0
1713320566178,EDS 201,A00,507315,Staff,26,0,30,4
1713320567204,EDS 203,A01,507317,Halter; Christopher P.,26,0,30,4
1713320568230,EDS 204R,A01,507319,Halter; Christopher P.,3,0,30,27
1713320568230,EDS 204R,B01,507331,Heinzman; Erica M.,28,0,30,2
1713320569255,EDS 206R,A00,507332,Staff,4,0,30,26
1713320569255,EDS 206R,B00,507343,Staff,28,0,30,2
1713320570283,EDS 250,A00,507344,Hemans; Patricia Ann Benitez,36,0,40,4
1713320571308,EDS 281,A00,507345,Daly; Alan J.,18,0,18,0
1713320572332,EDS 284,A00,507350,Daly; Alan J.,16,0,16,0
1713320573361,EDS 286,A00,507359,Fine; Sarah,18,0,18,0
1713320574385,EDS 289C,A01,507361,Daly; Alan J.,18,0,18,0
1713320575408,EDS 290,A00,507366,Hofstetter; Carolyn,15,0,15,0
1713320576563,LIGM 5A,A00,507421,Fischer-Grunski; Eva K,20,0,20,0
1713320577591,LIGM 5B,A00,507423,Fischer-Grunski; Eva K,20,0,20,0
1713320578619,LIGM 5C,A00,507425,Fischer-Grunski; Eva K,20,0,20,0
1713320579646,LIIT 5AS,A00,507427,Carnelos; Chiara,20,0,20,0
1713320580670,LIIT 5BS,A00,507430,Carnelos; Chiara,20,0,20,0
1713320581694,LIIT 5CS,A00,507432,Carnelos; Chiara,20,0,20,0
1713320582724,LISP 5A,A00,507541,Munoz Sanchez; Alicia,18,0,20,2
1713320583754,LISP 5B,A00,507671,Munoz Sanchez; Alicia,16,0,20,4
1713320584778,LISP 5C,A00,507696,Munoz Sanchez; Alicia,16,0,20,4
1713320585804,MAE 197,001,528363,Boechler; Nicholas Sebastia,9998,0,9999,1
1713320586833,MATH 197,001,523477,Kedlaya; Kiran S.,9999,0,9999,0
1713320586833,MATH 197,002,563811,Zhang; Danna,9999,0,9999,0
1713320587859,MCWP 40R,A00,518780,Staff,20,0,20,0
1713320587859,MCWP 40R,B00,518781,Staff,19,0,20,1
1713320587859,MCWP 40R,C00,518783,Staff,19,0,20,1
1713320588886,MCWP 50R,A00,518791,Staff,20,0,20,0
1713320588886,MCWP 50R,B00,518792,Staff,17,0,20,3
1713320588886,MCWP 50R,C00,518793,Staff,19,0,20,1
1713320588886,MCWP 50R,D00,518794,Staff,18,0,20,2
1713320588886,MCWP 50R,E00,518795,Staff,16,0,20,4
1713320588886,MCWP 50R,F00,518796,Staff,19,0,20,1
1713320588886,MCWP 50R,G00,518797,Staff,19,0,20,1
1713320589912,MMW 12R,A01,514034,Herbst; Matthew,15,0,16,1
1713320589912,MMW 12R,A02,514035,Herbst; Matthew,16,0,16,0
1713320590937,MMW 13R,A01,514037,Staff,12,0,16,4
1713320590937,MMW 13R,A02,514039,Staff,16,0,16,0
1713320592986,SIO 295LS,A00,523233,Staff,19,0,30,11
1713320594013,SIO 295S,A00,523232,Staff,19,0,30,11
1713320595039,SOCI 117,A01,494376,Staff,3,0,5,2
1713320596064,WES 237B,A00,494380,Staff,19,0,20,1
1713320598121,AESE 279B,A00,494370,Wade; Jon P,33,0,33,0
1713320599146,ANAR 135S,A00,494369,Braswell; Geoffrey E.,0,0,0,0
1713320600171,CAT 124RS,A01,519847,Geibel; William,17,0,20,3
1713320601197,CAT 125RS,A01,515971,Geibel; William,17,0,20,3
1713320602225,CLRE 250,A00,511389,Morris; Sheldon,9996,0,9999,3
1713320603255,CLRE 251,A00,507176,Mehta; Ravindra L.,9996,0,9999,3
1713320603255,CLRE 251,B00,511410,Mehta; Ravindra L.,9998,0,9999,1
1713320604282,CLRE 252,A00,507189,Cuomo; Raphael Eduardo,9998,0,9999,1
1713320605310,CLRE 253,A00,507199,Vaida; Florin,9997,0,9999,2
1713320605310,CLRE 253,B00,507202,Vaida; Florin,9999,0,9999,0
1713320606338,CLRE 259,A00,507211,Patel; Hemal,9996,0,9999,3
1713320607364,CLRE 260,A00,507221,Cuomo; Raphael Eduardo,9999,0,9999,0
1713320608388,CLRE 297,001,507242,Cuomo; Raphael Eduardo,9999,0,9999,0
1713320609412,CSE 191,A00,516875,Minnes Kemp; Mor Mia,9999,0,9999,0
1713320610439,CSS 201S,A01,494383,Staff,35,0,35,0
1713320611462,CSS 202S,A01,494387,Staff,35,0,35,0
1713320612488,EAP 100,A00,516065,Staff,9792,0,9999,207
1713320613515,ECE 45,A01,507414,Staff,54,0,60,6
1713320614541,ECE 100,A01,507416,Baghdadchi; Saharnaz,11,0,20,9
1713320614541,ECE 100,A02,507418,Baghdadchi; Saharnaz,20,0,20,0
1713320615569,ECE 111,A01,507420,Staff,39,0,50,11
1713320616592,ECE 197,001,548057,Sievenpiper; Daniel F.,9998,0,9999,1
1713320617617,EDS 115,A00,507243,Choi; Bailey Miyeon,28,0,28,0
1713320618641,EDS 117,A01,494379,Staff,23,0,25,2
1713320619668,EDS 125,A00,507246,Hopkins; Megan Beth,29,0,30,1
1713320620693,EDS 128A,A01,507264,Fargason; Sharon Gayle,26,0,26,0
1713320621716,EDS 128B,A01,507293,Pappas; Elizabeth,30,0,30,0
1713320622744,EDS 139,A00,507294,Fargason; Sharon Gayle,30,0,30,0
1713320622744,EDS 139,B00,507313,Pappas; Elizabeth,30,0,30,0
1713320623769,EDS 201,A00,507315,Staff,26,0,30,4
1713320624797,EDS 203,A01,507317,Halter; Christopher P.,26,0,30,4
1713320625822,EDS 204R,A01,507319,Halter; Christopher P.,3,0,30,27
1713320625822,EDS 204R,B01,507331,Heinzman; Erica M.,28,0,30,2
1713320626851,EDS 206R,A00,507332,Staff,4,0,30,26
1713320626851,EDS 206R,B00,507343,Staff,28,0,30,2
1713320627879,EDS 250,A00,507344,Hemans; Patricia Ann Benitez,36,0,40,4
1713320628903,EDS 281,A00,507345,Daly; Alan J.,18,0,18,0
1713320629928,EDS 284,A00,507350,Daly; Alan J.,16,0,16,0
1713320630952,EDS 286,A00,507359,Fine; Sarah,18,0,18,0
1713320631977,EDS 289C,A01,507361,Daly; Alan J.,18,0,18,0
1713320633004,EDS 290,A00,507366,Hofstetter; Carolyn,15,0,15,0
1713320634029,LIGM 5A,A00,507421,Fischer-Grunski; Eva K,20,0,20,0
1713320635058,LIGM 5B,A00,507423,Fischer-Grunski; Eva K,20,0,20,0
1713320636083,LIGM 5C,A00,507425,Fischer-Grunski; Eva K,20,0,20,0
1713320637112,LIIT 5AS,A00,507427,Carnelos; Chiara,20,0,20,0
1713320638138,LIIT 5BS,A00,507430,Carnelos; Chiara,20,0,20,0
1713320639168,LIIT 5CS,A00,507432,Carnelos; Chiara,20,0,20,0
1713320640192,LISP 5A,A00,507541,Munoz Sanchez; Alicia,18,0,20,2
1713320641218,LISP 5B,A00,507671,Munoz Sanchez; Alicia,16,0,20,4
1713320642243,LISP 5C,A00,507696,Munoz Sanchez; Alicia,16,0,20,4
1713320643268,MAE 197,001,528363,Boechler; Nicholas Sebastia,9998,0,9999,1
1713320644293,MATH 197,001,523477,Kedlaya; Kiran S.,9999,0,9999,0
1713320644293,MATH 197,002,563811,Zhang; Danna,9999,0,9999,0
1713320645320,MCWP 40R,A00,518780,Staff,20,0,20,0
1713320645320,MCWP 40R,B00,518781,Staff,19,0,20,1
1713320645320,MCWP 40R,C00,518783,Staff,19,0,20,1
1713320646344,MCWP 50R,A00,518791,Staff,20,0,20,0
1713320646344,MCWP 50R,B00,518792,Staff,17,0,20,3
1713320646344,MCWP 50R,C00,518793,Staff,19,0,20,1
1713320646344,MCWP 50R,D00,518794,Staff,18,0,20,2
1713320646344,MCWP 50R,E00,518795,Staff,16,0,20,4
1713320646344,MCWP 50R,F00,518796,Staff,19,0,20,1
1713320646344,MCWP 50R,G00,518797,Staff,19,0,20,1
1713320647367,MMW 12R,A01,514034,Herbst; Matthew,15,0,16,1
1713320647367,MMW 12R,A02,514035,Herbst; Matthew,16,0,16,0
1713320648392,MMW 13R,A01,514037,Staff,12,0,16,4
1713320648392,MMW 13R,A02,514039,Staff,16,0,16,0
1713320650442,SIO 295LS,A00,523233,Staff,19,0,30,11
1713320651468,SIO 295S,A00,523232,Staff,19,0,30,11
1713320652496,SOCI 117,A01,494376,Staff,2,0,5,3
1713320653520,WES 237B,A00,494380,Staff,19,0,20,1
1713320655578,AESE 279B,A00,494370,Wade; Jon P,33,0,33,0
1713320656606,ANAR 135S,A00,494369,Braswell; Geoffrey E.,0,0,0,0
1713320657702,CAT 124RS,A01,519847,Geibel; William,17,0,20,3
1713320658729,CAT 125RS,A01,515971,Geibel; William,17,0,20,3
1713320659755,CLRE 250,A00,511389,Morris; Sheldon,9996,0,9999,3
1713320660781,CLRE 251,A00,507176,Mehta; Ravindra L.,9996,0,9999,3
1713320660781,CLRE 251,B00,511410,Mehta; Ravindra L.,9998,0,9999,1
1713320661808,CLRE 252,A00,507189,Cuomo; Raphael Eduardo,9998,0,9999,1
1713320662835,CLRE 253,A00,507199,Vaida; Florin,9997,0,9999,2
1713320662835,CLRE 253,B00,507202,Vaida; Florin,9999,0,9999,0
1713320663871,CLRE 259,A00,507211,Patel; Hemal,9996,0,9999,3
1713320664894,CLRE 260,A00,507221,Cuomo; Raphael Eduardo,9999,0,9999,0
1713320665920,CLRE 297,001,507242,Cuomo; Raphael Eduardo,9999,0,9999,0
1713320666946,CSE 191,A00,516875,Minnes Kemp; Mor Mia,9999,0,9999,0
1713320667971,CSS 201S,A01,494383,Staff,35,0,35,0
1713320668996,CSS 202S,A01,494387,Staff,35,0,35,0
1713320670021,EAP 100,A00,516065,Staff,9792,0,9999,207
1713320671046,ECE 45,A01,507414,Staff,54,0,60,6
1713320672071,ECE 100,A01,507416,Baghdadchi; Saharnaz,11,0,20,9
1713320672071,ECE 100,A02,507418,Baghdadchi; Saharnaz,20,0,20,0
1713320673095,ECE 111,A01,507420,Staff,39,0,50,11
1713320674124,ECE 197,001,548057,Sievenpiper; Daniel F.,9998,0,9999,1
1713320675153,EDS 115,A00,507243,Choi; Bailey Miyeon,28,0,28,0
1713320676181,EDS 117,A01,494379,Staff,23,0,25,2
1713320677205,EDS 125,A00,507246,Hopkins; Megan Beth,29,0,30,1
1713320678230,EDS 128A,A01,507264,Fargason; Sharon Gayle,26,0,26,0
1713320679254,EDS 128B,A01,507293,Pappas; Elizabeth,30,0,30,0
1713320680279,EDS 139,A00,507294,Fargason; Sharon Gayle,30,0,30,0
1713320680279,EDS 139,B00,507313,Pappas; Elizabeth,30,0,30,0
1713320681305,EDS 201,A00,507315,Staff,26,0,30,4
1713320682334,EDS 203,A01,507317,Halter; Christopher P.,26,0,30,4
1713320683362,EDS 204R,A01,507319,Halter; Christopher P.,3,0,30,27
1713320683362,EDS 204R,B01,507331,Heinzman; Erica M.,28,0,30,2
1713320684392,EDS 206R,A00,507332,Staff,4,0,30,26
1713320684392,EDS 206R,B00,507343,Staff,28,0,30,2
1713320685415,EDS 250,A00,507344,Hemans; Patricia Ann Benitez,36,0,40,4
1713320686442,EDS 281,A00,507345,Daly; Alan J.,18,0,18,0
1713320687466,EDS 284,A00,507350,Daly; Alan J.,16,0,16,0
1713320688494,EDS 286,A00,507359,Fine; Sarah,18,0,18,0
1713320689519,EDS 289C,A01,507361,Daly; Alan J.,18,0,18,0
1713320690546,EDS 290,A00,507366,Hofstetter; Carolyn,15,0,15,0
1713320691576,LIGM 5A,A00,507421,Fischer-Grunski; Eva K,20,0,20,0
1713320692603,LIGM 5B,A00,507423,Fischer-Grunski; Eva K,20,0,20,0
1713320693631,LIGM 5C,A00,507425,Fischer-Grunski; Eva K,20,0,20,0
1713320694656,LIIT 5AS,A00,507427,Carnelos; Chiara,20,0,20,0
1713320695684,LIIT 5BS,A00,507430,Carnelos; Chiara,20,0,20,0
1713320696715,LIIT 5CS,A00,507432,Carnelos; Chiara,20,0,20,0
1713320697744,LISP 5A,A00,507541,Munoz Sanchez; Alicia,18,0,20,2
1713320698772,LISP 5B,A00,507671,Munoz Sanchez; Alicia,16,0,20,4
1713320699800,LISP 5C,A00,507696,Munoz Sanchez; Alicia,16,0,20,4
1713320700824,MAE 197,001,528363,Boechler; Nicholas Sebastia,9998,0,9999,1
1713320701851,MATH 197,001,523477,Kedlaya; Kiran S.,9999,0,9999,0
1713320701851,MATH 197,002,563811,Zhang; Danna,9999,0,9999,0
1713320702878,MCWP 40R,A00,518780,Staff,20,0,20,0
1713320702878,MCWP 40R,B00,518781,Staff,19,0,20,1
1713320702878,MCWP 40R,C00,518783,Staff,19,0,20,1
1713320703904,MCWP 50R,A00,518791,Staff,20,0,20,0
1713320703904,MCWP 50R,B00,518792,Staff,17,0,20,3
1713320703904,MCWP 50R,C00,518793,Staff,19,0,20,1
1713320703904,MCWP 50R,D00,518794,Staff,18,0,20,2
1713320703904,MCWP 50R,E00,518795,Staff,16,0,20,4
1713320703904,MCWP 50R,F00,518796,Staff,19,0,20,1
1713320703904,MCWP 50R,G00,518797,Staff,19,0,20,1
1713320704930,MMW 12R,A01,514034,Herbst; Matthew,15,0,16,1
1713320704930,MMW 12R,A02,514035,Herbst; Matthew,16,0,16,0
1713320705954,MMW 13R,A01,514037,Staff,12,0,16,4
1713320705954,MMW 13R,A02,514039,Staff,16,0,16,0
1713320708010,SIO 295LS,A00,523233,Staff,19,0,30,11
1713320709036,SIO 295S,A00,523232,Staff,19,0,30,11
1713320710062,SOCI 117,A01,494376,Staff,2,0,5,3
1713320711090,WES 237B,A00,494380,Staff,19,0,20,1
1713320713145,AESE 279B,A00,494370,Wade; Jon P,33,0,33,0
1713320714169,ANAR 135S,A00,494369,Braswell; Geoffrey E.,0,0,0,0
1713320715194,CAT 124RS,A01,519847,Geibel; William,17,0,20,3
1713320716219,CAT 125RS,A01,515971,Geibel; William,17,0,20,3
1713320717246,CLRE 250,A00,511389,Morris; Sheldon,9996,0,9999,3
1713320718275,CLRE 251,A00,507176,Mehta; Ravindra L.,9996,0,9999,3
1713320718275,CLRE 251,B00,511410,Mehta; Ravindra L.,9998,0,9999,1
1713320719299,CLRE 252,A00,507189,Cuomo; Raphael Eduardo,9998,0,9999,1
1713320720323,CLRE 253,A00,507199,Vaida; Florin,9997,0,9999,2
1713320720323,CLRE 253,B00,507202,Vaida; Florin,9999,0,9999,0
1713320721349,CLRE 259,A00,507211,Patel; Hemal,9996,0,9999,3
1713320722372,CLRE 260,A00,507221,Cuomo; Raphael Eduardo,9999,0,9999,0
1713320723399,CLRE 297,001,507242,Cuomo; Raphael Eduardo,9999,0,9999,0
1713320724423,CSE 191,A00,516875,Minnes Kemp; Mor Mia,9999,0,9999,0
1713320725449,CSS 201S,A01,494383,Staff,35,0,35,0
1713320726473,CSS 202S,A01,494387,Staff,35,0,35,0
1713320727496,EAP 100,A00,516065,Staff,9792,0,9999,207
1713320728524,ECE 45,A01,507414,Staff,54,0,60,6
1713320729552,ECE 100,A01,507416,Baghdadchi; Saharnaz,11,0,20,9
1713320729552,ECE 100,A02,507418,Baghdadchi; Saharnaz,20,0,20,0
1713320730581,ECE 111,A01,507420,Staff,39,0,50,11
1713320731606,ECE 197,001,548057,Sievenpiper; Daniel F.,9998,0,9999,1
1713320732629,EDS 115,A00,507243,Choi; Bailey Miyeon,28,0,28,0
1713320733654,EDS 117,A01,494379,Staff,23,0,25,2
1713320734678,EDS 125,A00,507246,Hopkins; Megan Beth,29,0,30,1
1713320735703,EDS 128A,A01,507264,Fargason; Sharon Gayle,26,0,26,0
1713320736727,EDS 128B,A01,507293,Pappas; Elizabeth,30,0,30,0
1713320737754,EDS 139,A00,507294,Fargason; Sharon Gayle,30,0,30,0
1713320737754,EDS 139,B00,507313,Pappas; Elizabeth,30,0,30,0
1713320738864,EDS 201,A00,507315,Staff,26,0,30,4
1713320739891,EDS 203,A01,507317,Halter; Christopher P.,26,0,30,4
1713320740919,EDS 204R,A01,507319,Halter; Christopher P.,3,0,30,27
1713320740919,EDS 204R,B01,507331,Heinzman; Erica M.,28,0,30,2
1713320741946,EDS 206R,A00,507332,Staff,4,0,30,26
1713320741946,EDS 206R,B00,507343,Staff,28,0,30,2
1713320742970,EDS 250,A00,507344,Hemans; Patricia Ann Benitez,36,0,40,4
1713320744000,EDS 281,A00,507345,Daly; Alan J.,18,0,18,0
1713320745030,EDS 284,A00,507350,Daly; Alan J.,16,0,16,0
1713320746055,EDS 286,A00,507359,Fine; Sarah,18,0,18,0
1713320747082,EDS 289C,A01,507361,Daly; Alan J.,18,0,18,0
1713320748110,EDS 290,A00,507366,Hofstetter; Carolyn,15,0,15,0
1713320749134,LIGM 5A,A00,507421,Fischer-Grunski; Eva K,20,0,20,0
1713320750164,LIGM 5B,A00,507423,Fischer-Grunski; Eva K,20,0,20,0
1713320751188,LIGM 5C,A00,507425,Fischer-Grunski; Eva K,20,0,20,0
1713320752216,LIIT 5AS,A00,507427,Carnelos; Chiara,20,0,20,0
1713320753241,LIIT 5BS,A00,507430,Carnelos; Chiara,20,0,20,0
1713320754267,LIIT 5CS,A00,507432,Carnelos; Chiara,20,0,20,0
1713320755293,LISP 5A,A00,507541,Munoz Sanchez; Alicia,18,0,20,2
1713320756318,LISP 5B,A00,507671,Munoz Sanchez; Alicia,16,0,20,4
1713320757343,LISP 5C,A00,507696,Munoz Sanchez; Alicia,16,0,20,4
1713320758371,MAE 197,001,528363,Boechler; Nicholas Sebastia,9998,0,9999,1
1713320759396,MATH 197,001,523477,Kedlaya; Kiran S.,9999,0,9999,0
1713320759396,MATH 197,002,563811,Zhang; Danna,9999,0,9999,0
1713320760422,MCWP 40R,A00,518780,Staff,20,0,20,0
1713320760422,MCWP 40R,B00,518781,Staff,19,0,20,1
1713320760422,MCWP 40R,C00,518783,Staff,19,0,20,1
1713320761509,MCWP 50R,A00,518791,Staff,20,0,20,0
1713320761509,MCWP 50R,B00,518792,Staff,17,0,20,3
1713320761509,MCWP 50R,C00,518793,Staff,19,0,20,1
1713320761509,MCWP 50R,D00,518794,Staff,18,0,20,2
1713320761509,MCWP 50R,E00,518795,Staff,16,0,20,4
1713320761509,MCWP 50R,F00,518796,Staff,19,0,20,1
1713320761509,MCWP 50R,G00,518797,Staff,19,0,20,1
1713320762537,MMW 12R,A01,514034,Herbst; Matthew,15,0,16,1
1713320762537,MMW 12R,A02,514035,Herbst; Matthew,16,0,16,0
1713320763564,MMW 13R,A01,514037,Staff,12,0,16,4
1713320763564,MMW 13R,A02,514039,Staff,16,0,16,0
1713320765613,SIO 295LS,A00,523233,Staff,19,0,30,11
1713320766637,SIO 295S,A00,523232,Staff,19,0,30,11
1713320767660,SOCI 117,A01,494376,Staff,2,0,5,3
1713320768684,WES 237B,A00,494380,Staff,19,0,20,1
1713320770742,AESE 279B,A00,494370,Wade; Jon P,33,0,33,0
1713320771768,ANAR 135S,A00,494369,Braswell; Geoffrey E.,0,0,0,0
1713320772792,CAT 124RS,A01,519847,Geibel; William,17,0,20,3
1713320773816,CAT 125RS,A01,515971,Geibel; William,17,0,20,3
1713320774843,CLRE 250,A00,511389,Morris; Sheldon,9996,0,9999,3
1713320775867,CLRE 251,A00,507176,Mehta; Ravindra L.,9996,0,9999,3
1713320775867,CLRE 251,B00,511410,Mehta; Ravindra L.,9998,0,9999,1
1713320776896,CLRE 252,A00,507189,Cuomo; Raphael Eduardo,9998,0,9999,1
1713320777921,CLRE 253,A00,507199,Vaida; Florin,9997,0,9999,2
1713320777921,CLRE 253,B00,507202,Vaida; Florin,9999,0,9999,0
1713320778949,CLRE 259,A00,507211,Patel; Hemal,9996,0,9999,3
1713320779975,CLRE 260,A00,507221,Cuomo; Raphael Eduardo,9999,0,9999,0
1713320781000,CLRE 297,001,507242,Cuomo; Raphael Eduardo,9999,0,9999,0
1713320782027,CSE 191,A00,516875,Minnes Kemp; Mor Mia,9999,0,9999,0
1713320783050,CSS 201S,A01,494383,Staff,35,0,35,0
1713320784078,CSS 202S,A01,494387,Staff,35,0,35,0
1713320785106,EAP 100,A00,516065,Staff,9792,0,9999,207
1713320786129,ECE 45,A01,507414,Staff,54,0,60,6
1713320787155,ECE 100,A01,507416,Baghdadchi; Saharnaz,11,0,20,9
1713320787155,ECE 100,A02,507418,Baghdadchi; Saharnaz,20,0,20,0
1713320788180,ECE 111,A01,507420,Staff,39,0,50,11
1713320789204,ECE 197,001,548057,Sievenpiper; Daniel F.,9998,0,9999,1
1713320790229,EDS 115,A00,507243,Choi; Bailey Miyeon,28,0,28,0
1713320791256,EDS 117,A01,494379,Staff,23,0,25,2
1713320792281,EDS 125,A00,507246,Hopkins; Megan Beth,29,0,30,1
1713320793304,EDS 128A,A01,507264,Fargason; Sharon Gayle,26,0,26,0
1713320794330,EDS 128B,A01,507293,Pappas; Elizabeth,30,0,30,0
1713320795357,EDS 139,A00,507294,Fargason; Sharon Gayle,30,0,30,0
1713320795357,EDS 139,B00,507313,Pappas; Elizabeth,30,0,30,0
1713320796383,EDS 201,A00,507315,Staff,26,0,30,4
1713320797411,EDS 203,A01,507317,Halter; Christopher P.,26,0,30,4
1713320798439,EDS 204R,A01,507319,Halter; Christopher P.,3,0,30,27
1713320798439,EDS 204R,B01,507331,Heinzman; Erica M.,28,0,30,2
1713320799463,EDS 206R,A00,507332,Staff,4,0,30,26
1713320799463,EDS 206R,B00,507343,Staff,28,0,30,2
1713320800488,EDS 250,A00,507344,Hemans; Patricia Ann Benitez,36,0,40,4
1713320801513,EDS 281,A00,507345,Daly; Alan J.,18,0,18,0
1713320802542,EDS 284,A00,507350,Daly; Alan J.,16,0,16,0
1713320803572,EDS 286,A00,507359,Fine; Sarah,18,0,18,0
1713320804597,EDS 289C,A01,507361,Daly; Alan J.,18,0,18,0
1713320805624,EDS 290,A00,507366,Hofstetter; Carolyn,15,0,15,0
1713320806649,LIGM 5A,A00,507421,Fischer-Grunski; Eva K,20,0,20,0
1713320807674,LIGM 5B,A00,507423,Fischer-Grunski; Eva K,20,0,20,0
1713320808702,LIGM 5C,A00,507425,Fischer-Grunski; Eva K,20,0,20,0
1713320809727,LIIT 5AS,A00,507427,Carnelos; Chiara,20,0,20,0
1713320810756,LIIT 5BS,A00,507430,Carnelos; Chiara,20,0,20,0
1713320811781,LIIT 5CS,A00,507432,Carnelos; Chiara,20,0,20,0
1713320812806,LISP 5A,A00,507541,Munoz Sanchez; Alicia,18,0,20,2
1713320813831,LISP 5B,A00,507671,Munoz Sanchez; Alicia,16,0,20,4
1713320814854,LISP 5C,A00,507696,Munoz Sanchez; Alicia,16,0,20,4
1713320815882,MAE 197,001,528363,Boechler; Nicholas Sebastia,9998,0,9999,1
1713320816911,MATH 197,001,523477,Kedlaya; Kiran S.,9999,0,9999,0
1713320816911,MATH 197,002,563811,Zhang; Danna,9999,0,9999,0
1713320817938,MCWP 40R,A00,518780,Staff,20,0,20,0
1713320817938,MCWP 40R,B00,518781,Staff,19,0,20,1
1713320817938,MCWP 40R,C00,518783,Staff,19,0,20,1
1713320818964,MCWP 50R,A00,518791,Staff,20,0,20,0
1713320818964,MCWP 50R,B00,518792,Staff,17,0,20,3
1713320818964,MCWP 50R,C00,518793,Staff,19,0,20,1
1713320818964,MCWP 50R,D00,518794,Staff,18,0,20,2
1713320818964,MCWP 50R,E00,518795,Staff,16,0,20,4
1713320818964,MCWP 50R,F00,518796,Staff,19,0,20,1
1713320818964,MCWP 50R,G00,518797,Staff,19,0,20,1
1713320819989,MMW 12R,A01,514034,Herbst; Matthew,15,0,16,1
1713320819989,MMW 12R,A02,514035,Herbst; Matthew,16,0,16,0
1713320821017,MMW 13R,A01,514037,Staff,12,0,16,4
1713320821017,MMW 13R,A02,514039,Staff,16,0,16,0
1713320823071,SIO 295LS,A00,523233,Staff,19,0,30,11
1713320824095,SIO 295S,A00,523232,Staff,19,0,30,11
1713320825125,SOCI 117,A01,494376,Staff,2,0,5,3
1713320826151,WES 237B,A00,494380,Staff,19,0,20,1
1713320828217,AESE 279B,A00,494370,Wade; Jon P,33,0,33,0
1713320829243,ANAR 135S,A00,494369,Braswell; Geoffrey E.,0,0,0,0
1713320830268,CAT 124RS,A01,519847,Geibel; William,17,0,20,3
1713320831292,CAT 125RS,A01,515971,Geibel; William,17,0,20,3
1713320832319,CLRE 250,A00,511389,Morris; Sheldon,9996,0,9999,3
1713320833344,CLRE 251,A00,507176,Mehta; Ravindra L.,9996,0,9999,3
1713320833344,CLRE 251,B00,511410,Mehta; Ravindra L.,9998,0,9999,1
1713320834369,CLRE 252,A00,507189,Cuomo; Raphael Eduardo,9998,0,9999,1
1713320835394,CLRE 253,A00,507199,Vaida; Florin,9997,0,9999,2
1713320835394,CLRE 253,B00,507202,Vaida; Florin,9999,0,9999,0
1713320836421,CLRE 259,A00,507211,Patel; Hemal,9996,0,9999,3
1713320837448,CLRE 260,A00,507221,Cuomo; Raphael Eduardo,9999,0,9999,0
1713320838475,CLRE 297,001,507242,Cuomo; Raphael Eduardo,9999,0,9999,0
1713320839499,CSE 191,A00,516875,Minnes Kemp; Mor Mia,9999,0,9999,0
1713320840525,CSS 201S,A01,494383,Staff,35,0,35,0
1713320841552,CSS 202S,A01,494387,Staff,35,0,35,0
1713320842576,EAP 100,A00,516065,Staff,9792,0,9999,207
1713320843600,ECE 45,A01,507414,Staff,54,0,60,6
1713320844628,ECE 100,A01,507416,Baghdadchi; Saharnaz,11,0,20,9
1713320844628,ECE 100,A02,507418,Baghdadchi; Saharnaz,20,0,20,0
1713320845655,ECE 111,A01,507420,Staff,39,0,50,11
1713320846681,ECE 197,001,548057,Sievenpiper; Daniel F.,9998,0,9999,1
1713320847705,EDS 115,A00,507243,Choi; Bailey Miyeon,28,0,28,0
1713320848728,EDS 117,A01,494379,Staff,23,0,25,2
1713320849753,EDS 125,A00,507246,Hopkins; Megan Beth,29,0,30,1
1713320850779,EDS 128A,A01,507264,Fargason; Sharon Gayle,26,0,26,0
1713320851803,EDS 128B,A01,507293,Pappas; Elizabeth,30,0,30,0
1713320852827,EDS 139,A00,507294,Fargason; Sharon Gayle,30,0,30,0
1713320852827,EDS 139,B00,507313,Pappas; Elizabeth,30,0,30,0
1713320853861,EDS 201,A00,507315,Staff,26,0,30,4
1713320854885,EDS 203,A01,507317,Halter; Christopher P.,26,0,30,4
1713320855910,EDS 204R,A01,507319,Halter; Christopher P.,3,0,30,27
1713320855910,EDS 204R,B01,507331,Heinzman; Erica M.,28,0,30,2
1713320856935,EDS 206R,A00,507332,Staff,4,0,30,26
1713320856935,EDS 206R,B00,507343,Staff,28,0,30,2
1713320857959,EDS 250,A00,507344,Hemans; Patricia Ann Benitez,36,0,40,4
1713320858987,EDS 281,A00,507345,Daly; Alan J.,18,0,18,0
1713320860011,EDS 284,A00,507350,Daly; Alan J.,16,0,16,0
1713320861039,EDS 286,A00,507359,Fine; Sarah,18,0,18,0
1713320862070,EDS 289C,A01,507361,Daly; Alan J.,18,0,18,0
1713320863099,EDS 290,A00,507366,Hofstetter; Carolyn,15,0,15,0
1713320864124,LIGM 5A,A00,507421,Fischer-Grunski; Eva K,20,0,20,0
1713320865206,LIGM 5B,A00,507423,Fischer-Grunski; Eva K,20,0,20,0
1713320866231,LIGM 5C,A00,507425,Fischer-Grunski; Eva K,20,0,20,0
1713320867256,LIIT 5AS,A00,507427,Carnelos; Chiara,20,0,20,0
1713320868280,LIIT 5BS,A00,507430,Carnelos; Chiara,20,0,20,0
1713320869305,LIIT 5CS,A00,507432,Carnelos; Chiara,20,0,20,0
1713320870333,LISP 5A,A00,507541,Munoz Sanchez; Alicia,18,0,20,2
1713320871361,LISP 5B,A00,507671,Munoz Sanchez; Alicia,16,0,20,4
1713320872390,LISP 5C,A00,507696,Munoz Sanchez; Alicia,16,0,20,4
1713320873417,MAE 197,001,528363,Boechler; Nicholas Sebastia,9998,0,9999,1
1713320874445,MATH 197,001,523477,Kedlaya; Kiran S.,9999,0,9999,0
1713320874445,MATH 197,002,563811,Zhang; Danna,9999,0,9999,0
1713320875470,MCWP 40R,A00,518780,Staff,20,0,20,0
1713320875470,MCWP 40R,B00,518781,Staff,19,0,20,1
1713320875470,MCWP 40R,C00,518783,Staff,19,0,20,1
1713320876499,MCWP 50R,A00,518791,Staff,20,0,20,0
1713320876499,MCWP 50R,B00,518792,Staff,17,0,20,3
1713320876499,MCWP 50R,C00,518793,Staff,19,0,20,1
1713320876499,MCWP 50R,D00,518794,Staff,18,0,20,2
1713320876499,MCWP 50R,E00,518795,Staff,16,0,20,4
1713320876499,MCWP 50R,F00,518796,Staff,19,0,20,1
1713320876499,MCWP 50R,G00,518797,Staff,19,0,20,1
1713320877523,MMW 12R,A01,514034,Herbst; Matthew,15,0,16,1
1713320877523,MMW 12R,A02,514035,Herbst; Matthew,16,0,16,0
1713320878548,MMW 13R,A01,514037,Staff,12,0,16,4
1713320878548,MMW 13R,A02,514039,Staff,16,0,16,0
1713320880600,SIO 295LS,A00,523233,Staff,19,0,30,11
1713320881628,SIO 295S,A00,523232,Staff,19,0,30,11
1713320882652,SOCI 117,A01,494376,Staff,2,0,5,3
1713320883676,WES 237B,A00,494380,Staff,19,0,20,1
1713320885741,AESE 279B,A00,494370,Wade; Jon P,33,0,33,0
1713320886767,ANAR 135S,A00,494369,Braswell; Geoffrey E.,0,0,0,0
1713320887791,CAT 124RS,A01,519847,Geibel; William,17,0,20,3
1713320888817,CAT 125RS,A01,515971,Geibel; William,17,0,20,3
1713320889840,CLRE 250,A00,511389,Morris; Sheldon,9996,0,9999,3
1713320890865,CLRE 251,A00,507176,Mehta; Ravindra L.,9996,0,9999,3
1713320890865,CLRE 251,B00,511410,Mehta; Ravindra L.,9998,0,9999,1
1713320891894,CLRE 252,A00,507189,Cuomo; Raphael Eduardo,9998,0,9999,1
1713320892922,CLRE 253,A00,507199,Vaida; Florin,9997,0,9999,2
1713320892922,CLRE 253,B00,507202,Vaida; Florin,9999,0,9999,0
1713320893947,CLRE 259,A00,507211,Patel; Hemal,9996,0,9999,3
1713320894976,CLRE 260,A00,507221,Cuomo; Raphael Eduardo,9999,0,9999,0
1713320896001,CLRE 297,001,507242,Cuomo; Raphael Eduardo,9999,0,9999,0
1713320897030,CSE 191,A00,516875,Minnes Kemp; Mor Mia,9999,0,9999,0
1713320898056,CSS 201S,A01,494383,Staff,35,0,35,0
1713320899081,CSS 202S,A01,494387,Staff,35,0,35,0
1713320900106,EAP 100,A00,516065,Staff,9792,0,9999,207
1713320901129,ECE 45,A01,507414,Staff,54,0,60,6
1713320902153,ECE 100,A01,507416,Baghdadchi; Saharnaz,11,0,20,9
1713320902153,ECE 100,A02,507418,Baghdadchi; Saharnaz,20,0,20,0
1713320903178,ECE 111,A01,507420,Staff,39,0,50,11
1713320904201,ECE 197,001,548057,Sievenpiper; Daniel F.,9998,0,9999,1
1713320905230,EDS 115,A00,507243,Choi; Bailey Miyeon,28,0,28,0
1713320906257,EDS 117,A01,494379,Staff,23,0,25,2
1713320907284,EDS 125,A00,507246,Hopkins; Megan Beth,29,0,30,1
1713320908311,EDS 128A,A01,507264,Fargason; Sharon Gayle,26,0,26,0
1713320909336,EDS 128B,A01,507293,Pappas; Elizabeth,30,0,30,0
1713320910360,EDS 139,A00,507294,Fargason; Sharon Gayle,30,0,30,0
1713320910360,EDS 139,B00,507313,Pappas; Elizabeth,30,0,30,0
1713320911388,EDS 201,A00,507315,Staff,26,0,30,4
1713320912415,EDS 203,A01,507317,Halter; Christopher P.,26,0,30,4
1713320913441,EDS 204R,A01,507319,Halter; Christopher P.,3,0,30,27
1713320913441,EDS 204R,B01,507331,Heinzman; Erica M.,28,0,30,2
1713320914468,EDS 206R,A00,507332,Staff,4,0,30,26
1713320914468,EDS 206R,B00,507343,Staff,28,0,30,2
1713320915496,EDS 250,A00,507344,Hemans; Patricia Ann Benitez,36,0,40,4
1713320916522,EDS 281,A00,507345,Daly; Alan J.,18,0,18,0
1713320917548,EDS 284,A00,507350,Daly; Alan J.,16,0,16,0
1713320918572,EDS 286,A00,507359,Fine; Sarah,18,0,18,0
1713320919599,EDS 289C,A01,507361,Daly; Alan J.,18,0,18,0
1713320920625,EDS 290,A00,507366,Hofstetter; Carolyn,15,0,15,0
1713320921652,LIGM 5A,A00,507421,Fischer-Grunski; Eva K,20,0,20,0
1713320922677,LIGM 5B,A00,507423,Fischer-Grunski; Eva K,20,0,20,0
1713320923702,LIGM 5C,A00,507425,Fischer-Grunski; Eva K,20,0,20,0
1713320924732,LIIT 5AS,A00,507427,Carnelos; Chiara,20,0,20,0
1713320925756,LIIT 5BS,A00,507430,Carnelos; Chiara,20,0,20,0
1713320926779,LIIT 5CS,A00,507432,Carnelos; Chiara,20,0,20,0
1713320927808,LISP 5A,A00,507541,Munoz Sanchez; Alicia,18,0,20,2
1713320928833,LISP 5B,A00,507671,Munoz Sanchez; Alicia,16,0,20,4
1713320929861,LISP 5C,A00,507696,Munoz Sanchez; Alicia,16,0,20,4
1713320930891,MAE 197,001,528363,Boechler; Nicholas Sebastia,9998,0,9999,1
1713320931918,MATH 197,001,523477,Kedlaya; Kiran S.,9999,0,9999,0
1713320931918,MATH 197,002,563811,Zhang; Danna,9999,0,9999,0
1713320932945,MCWP 40R,A00,518780,Staff,20,0,20,0
1713320932945,MCWP 40R,B00,518781,Staff,19,0,20,1
1713320932945,MCWP 40R,C00,518783,Staff,19,0,20,1
1713320933969,MCWP 50R,A00,518791,Staff,20,0,20,0
1713320933969,MCWP 50R,B00,518792,Staff,17,0,20,3
1713320933969,MCWP 50R,C00,518793,Staff,19,0,20,1
1713320933969,MCWP 50R,D00,518794,Staff,18,0,20,2
1713320933969,MCWP 50R,E00,518795,Staff,16,0,20,4
1713320933969,MCWP 50R,F00,518796,Staff,19,0,20,1
1713320933969,MCWP 50R,G00,518797,Staff,19,0,20,1
1713320934995,MMW 12R,A01,514034,Herbst; Matthew,15,0,16,1
1713320934995,MMW 12R,A02,514035,Herbst; Matthew,16,0,16,0
1713320936020,MMW 13R,A01,514037,Staff,12,0,16,4
1713320936020,MMW 13R,A02,514039,Staff,16,0,16,0
1713320938075,SIO 295LS,A00,523233,Staff,19,0,30,11
1713320939106,SIO 295S,A00,523232,Staff,19,0,30,11
1713320940130,SOCI 117,A01,494376,Staff,2,0,5,3
1713320941157,WES 237B,A00,494380,Staff,19,0,20,1
1713320943226,AESE 279B,A00,494370,Wade; Jon P,33,0,33,0
1713320944250,ANAR 135S,A00,494369,Braswell; Geoffrey E.,0,0,0,0
1713320945275,CAT 124RS,A01,519847,Geibel; William,17,0,20,3
1713320946299,CAT 125RS,A01,515971,Geibel; William,17,0,20,3
1713320947327,CLRE 250,A00,511389,Morris; Sheldon,9996,0,9999,3
1713320948353,CLRE 251,A00,507176,Mehta; Ravindra L.,9996,0,9999,3
1713320948353,CLRE 251,B00,511410,Mehta; Ravindra L.,9998,0,9999,1
1713320949376,CLRE 252,A00,507189,Cuomo; Raphael Eduardo,9998,0,9999,1
1713320950401,CLRE 253,A00,507199,Vaida; Florin,9997,0,9999,2
1713320950401,CLRE 253,B00,507202,Vaida; Florin,9999,0,9999,0
1713320951426,CLRE 259,A00,507211,Patel; Hemal,9996,0,9999,3
1713320952450,CLRE 260,A00,507221,Cuomo; Raphael Eduardo,9999,0,9999,0
1713320953474,CLRE 297,001,507242,Cuomo; Raphael Eduardo,9999,0,9999,0
1713320954502,CSE 191,A00,516875,Minnes Kemp; Mor Mia,9999,0,9999,0
1713320955529,CSS 201S,A01,494383,Staff,35,0,35,0
1713320956553,CSS 202S,A01,494387,Staff,35,0,35,0
1713320957580,EAP 100,A00,516065,Staff,9792,0,9999,207
1713320958606,ECE 45,A01,507414,Staff,54,0,60,6
1713320959631,ECE 100,A01,507416,Baghdadchi; Saharnaz,11,0,20,9
1713320959631,ECE 100,A02,507418,Baghdadchi; Saharnaz,20,0,20,0
1713320960660,ECE 111,A01,507420,Staff,39,0,50,11
1713320961685,ECE 197,001,548057,Sievenpiper; Daniel F.,9998,0,9999,1
1713320962710,EDS 115,A00,507243,Choi; Bailey Miyeon,28,0,28,0
1713320963736,EDS 117,A01,494379,Staff,23,0,25,2
1713320964765,EDS 125,A00,507246,Hopkins; Megan Beth,29,0,30,1
1713320965793,EDS 128A,A01,507264,Fargason; Sharon Gayle,26,0,26,0
1713320966820,EDS 128B,A01,507293,Pappas; Elizabeth,30,0,30,0
1713320967845,EDS 139,A00,507294,Fargason; Sharon Gayle,30,0,30,0
1713320967845,EDS 139,B00,507313,Pappas; Elizabeth,30,0,30,0
1713320968928,EDS 201,A00,507315,Staff,26,0,30,4
1713320969952,EDS 203,A01,507317,Halter; Christopher P.,26,0,30,4
1713320970979,EDS 204R,A01,507319,Halter; Christopher P.,3,0,30,27
1713320970979,EDS 204R,B01,507331,Heinzman; Erica M.,28,0,30,2
1713320972004,EDS 206R,A00,507332,Staff,4,0,30,26
1713320972004,EDS 206R,B00,507343,Staff,28,0,30,2
1713320973029,EDS 250,A00,507344,Hemans; Patricia Ann Benitez,36,0,40,4
1713320974053,EDS 281,A00,507345,Daly; Alan J.,18,0,18,0
1713320975077,EDS 284,A00,507350,Daly; Alan J.,16,0,16,0
1713320976102,EDS 286,A00,507359,Fine; Sarah,18,0,18,0
1713320977126,EDS 289C,A01,507361,Daly; Alan J.,18,0,18,0
1713320978154,EDS 290,A00,507366,Hofstetter; Carolyn,15,0,15,0
1713320979182,LIGM 5A,A00,507421,Fischer-Grunski; Eva K,20,0,20,0
1713320980207,LIGM 5B,A00,507423,Fischer-Grunski; Eva K,20,0,20,0
1713320981237,LIGM 5C,A00,507425,Fischer-Grunski; Eva K,20,0,20,0
1713320982263,LIIT 5AS,A00,507427,Carnelos; Chiara,20,0,20,0
1713320983291,LIIT 5BS,A00,507430,Carnelos; Chiara,20,0,20,0
1713320984320,LIIT 5CS,A00,507432,Carnelos; Chiara,20,0,20,0
1713320985346,LISP 5A,A00,507541,Munoz Sanchez; Alicia,18,0,20,2
1713320986372,LISP 5B,A00,507671,Munoz Sanchez; Alicia,16,0,20,4
1713320987397,LISP 5C,A00,507696,Munoz Sanchez; Alicia,16,0,20,4
1713320988420,MAE 197,001,528363,Boechler; Nicholas Sebastia,9998,0,9999,1
1713320989446,MATH 197,001,523477,Kedlaya; Kiran S.,9999,0,9999,0
1713320989446,MATH 197,002,563811,Zhang; Danna,9999,0,9999,0
1713320990472,MCWP 40R,A00,518780,Staff,20,0,20,0
1713320990472,MCWP 40R,B00,518781,Staff,19,0,20,1
1713320990472,MCWP 40R,C00,518783,Staff,19,0,20,1
1713320991498,MCWP 50R,A00,518791,Staff,20,0,20,0
1713320991498,MCWP 50R,B00,518792,Staff,17,0,20,3
1713320991498,MCWP 50R,C00,518793,Staff,19,0,20,1
1713320991498,MCWP 50R,D00,518794,Staff,18,0,20,2
1713320991498,MCWP 50R,E00,518795,Staff,16,0,20,4
1713320991498,MCWP 50R,F00,518796,Staff,19,0,20,1
1713320991498,MCWP 50R,G00,518797,Staff,19,0,20,1
1713320992523,MMW 12R,A01,514034,Herbst; Matthew,15,0,16,1
1713320992523,MMW 12R,A02,514035,Herbst; Matthew,16,0,16,0
1713320993547,MMW 13R,A01,514037,Staff,12,0,16,4
1713320993547,MMW 13R,A02,514039,Staff,16,0,16,0
1713320995598,SIO 295LS,A00,523233,Staff,19,0,30,11
1713320996621,SIO 295S,A00,523232,Staff,19,0,30,11
1713320997650,SOCI 117,A01,494376,Staff,2,0,5,3
1713320998674,WES 237B,A00,494380,Staff,19,0,20,1
1713321000730,AESE 279B,A00,494370,Wade; Jon P,33,0,33,0
1713321001757,ANAR 135S,A00,494369,Braswell; Geoffrey E.,0,0,0,0
1713321002782,CAT 124RS,A01,519847,Geibel; William,17,0,20,3
1713321003805,CAT 125RS,A01,515971,Geibel; William,17,0,20,3
1713321004831,CLRE 250,A00,511389,Morris; Sheldon,9996,0,9999,3
1713321005858,CLRE 251,A00,507176,Mehta; Ravindra L.,9996,0,9999,3
1713321005858,CLRE 251,B00,511410,Mehta; Ravindra L.,9998,0,9999,1
1713321006887,CLRE 252,A00,507189,Cuomo; Raphael Eduardo,9998,0,9999,1
1713321007911,CLRE 253,A00,507199,Vaida; Florin,9997,0,9999,2
1713321007911,CLRE 253,B00,507202,Vaida; Florin,9999,0,9999,0
1713321008938,CLRE 259,A00,507211,Patel; Hemal,9996,0,9999,3
1713321009962,CLRE 260,A00,507221,Cuomo; Raphael Eduardo,9999,0,9999,0
1713321010990,CLRE 297,001,507242,Cuomo; Raphael Eduardo,9999,0,9999,0
1713321012014,CSE 191,A00,516875,Minnes Kemp; Mor Mia,9999,0,9999,0
1713321013038,CSS 201S,A01,494383,Staff,35,0,35,0
1713321014064,CSS 202S,A01,494387,Staff,35,0,35,0
1713321015088,EAP 100,A00,516065,Staff,9792,0,9999,207
1713321016114,ECE 45,A01,507414,Staff,54,0,60,6
1713321017143,ECE 100,A01,507416,Baghdadchi; Saharnaz,11,0,20,9
1713321017143,ECE 100,A02,507418,Baghdadchi; Saharnaz,20,0,20,0
1713321018170,ECE 111,A01,507420,Staff,39,0,50,11
1713321019194,ECE 197,001,548057,Sievenpiper; Daniel F.,9998,0,9999,1
1713321020218,EDS 115,A00,507243,Choi; Bailey Miyeon,28,0,28,0
1713321021242,EDS 117,A01,494379,Staff,23,0,25,2
1713321022267,EDS 125,A00,507246,Hopkins; Megan Beth,29,0,30,1
1713321023291,EDS 128A,A01,507264,Fargason; Sharon Gayle,26,0,26,0
1713321024316,EDS 128B,A01,507293,Pappas; Elizabeth,30,0,30,0
1713321025342,EDS 139,A00,507294,Fargason; Sharon Gayle,30,0,30,0
1713321025342,EDS 139,B00,507313,Pappas; Elizabeth,30,0,30,0
1713321026366,EDS 201,A00,507315,Staff,26,0,30,4
1713321027391,EDS 203,A01,507317,Halter; Christopher P.,26,0,30,4
1713321028421,EDS 204R,A01,507319,Halter; Christopher P.,3,0,30,27
1713321028421,EDS 204R,B01,507331,Heinzman; Erica M.,28,0,30,2
1713321029445,EDS 206R,A00,507332,Staff,4,0,30,26
1713321029445,EDS 206R,B00,507343,Staff,28,0,30,2
1713321030472,EDS 250,A00,507344,Hemans; Patricia Ann Benitez,36,0,40,4
1713321031500,EDS 281,A00,507345,Daly; Alan J.,18,0,18,0
1713321032528,EDS 284,A00,507350,Daly; Alan J.,16,0,16,0
1713321033556,EDS 286,A00,507359,Fine; Sarah,18,0,18,0
1713321034583,EDS 289C,A01,507361,Daly; Alan J.,18,0,18,0
1713321035610,EDS 290,A00,507366,Hofstetter; Carolyn,15,0,15,0
1713321036639,LIGM 5A,A00,507421,Fischer-Grunski; Eva K,20,0,20,0
1713321037663,LIGM 5B,A00,507423,Fischer-Grunski; Eva K,20,0,20,0
1713321038689,LIGM 5C,A00,507425,Fischer-Grunski; Eva K,20,0,20,0
1713321039714,LIIT 5AS,A00,507427,Carnelos; Chiara,20,0,20,0
1713321040743,LIIT 5BS,A00,507430,Carnelos; Chiara,20,0,20,0
1713321041771,LIIT 5CS,A00,507432,Carnelos; Chiara,20,0,20,0
1713321042799,LISP 5A,A00,507541,Munoz Sanchez; Alicia,18,0,20,2
1713321043828,LISP 5B,A00,507671,Munoz Sanchez; Alicia,16,0,20,4
1713321044854,LISP 5C,A00,507696,Munoz Sanchez; Alicia,16,0,20,4
1713321045881,MAE 197,001,528363,Boechler; Nicholas Sebastia,9998,0,9999,1
1713321046906,MATH 197,001,523477,Kedlaya; Kiran S.,9999,0,9999,0
1713321046906,MATH 197,002,563811,Zhang; Danna,9999,0,9999,0
1713321047934,MCWP 40R,A00,518780,Staff,20,0,20,0
1713321047934,MCWP 40R,B00,518781,Staff,19,0,20,1
1713321047934,MCWP 40R,C00,518783,Staff,19,0,20,1
1713321048962,MCWP 50R,A00,518791,Staff,20,0,20,0
1713321048962,MCWP 50R,B00,518792,Staff,17,0,20,3
1713321048962,MCWP 50R,C00,518793,Staff,19,0,20,1
1713321048962,MCWP 50R,D00,518794,Staff,18,0,20,2
1713321048962,MCWP 50R,E00,518795,Staff,16,0,20,4
1713321048962,MCWP 50R,F00,518796,Staff,19,0,20,1
1713321048962,MCWP 50R,G00,518797,Staff,19,0,20,1
1713321049990,MMW 12R,A01,514034,Herbst; Matthew,15,0,16,1
1713321049990,MMW 12R,A02,514035,Herbst; Matthew,16,0,16,0
1713321051018,MMW 13R,A01,514037,Staff,12,0,16,4
1713321051018,MMW 13R,A02,514039,Staff,16,0,16,0
1713321053070,SIO 295LS,A00,523233,Staff,19,0,30,11
1713321054095,SIO 295S,A00,523232,Staff,19,0,30,11
1713321055119,SOCI 117,A01,494376,Staff,2,0,5,3
1713321056148,WES 237B,A00,494380,Staff,19,0,20,1
1713321058206,AESE 279B,A00,494370,Wade; Jon P,33,0,33,0
1713321059230,ANAR 135S,A00,494369,Braswell; Geoffrey E.,0,0,0,0
1713321060255,CAT 124RS,A01,519847,Geibel; William,17,0,20,3
1713321061288,CAT 125RS,A01,515971,Geibel; William,17,0,20,3
1713321062316,CLRE 250,A00,511389,Morris; Sheldon,9996,0,9999,3
1713321063340,CLRE 251,A00,507176,Mehta; Ravindra L.,9996,0,9999,3
1713321063340,CLRE 251,B00,511410,Mehta; Ravindra L.,9998,0,9999,1
1713321064370,CLRE 252,A00,507189,Cuomo; Raphael Eduardo,9998,0,9999,1
1713321065393,CLRE 253,A00,507199,Vaida; Florin,9997,0,9999,2
1713321065393,CLRE 253,B00,507202,Vaida; Florin,9999,0,9999,0
1713321066419,CLRE 259,A00,507211,Patel; Hemal,9996,0,9999,3
1713321067443,CLRE 260,A00,507221,Cuomo; Raphael Eduardo,9999,0,9999,0
1713321068468,CLRE 297,001,507242,Cuomo; Raphael Eduardo,9999,0,9999,0
1713321069492,CSE 191,A00,516875,Minnes Kemp; Mor Mia,9999,0,9999,0
1713321070519,CSS 201S,A01,494383,Staff,35,0,35,0
1713321071550,CSS 202S,A01,494387,Staff,35,0,35,0
1713321072626,EAP 100,A00,516065,Staff,9792,0,9999,207
1713321073655,ECE 45,A01,507414,Staff,54,0,60,6
1713321074682,ECE 100,A01,507416,Baghdadchi; Saharnaz,11,0,20,9
1713321074682,ECE 100,A02,507418,Baghdadchi; Saharnaz,20,0,20,0
1713321075710,ECE 111,A01,507420,Staff,39,0,50,11
1713321076736,ECE 197,001,548057,Sievenpiper; Daniel F.,9998,0,9999,1
1713321077762,EDS 115,A00,507243,Choi; Bailey Miyeon,28,0,28,0
1713321078786,EDS 117,A01,494379,Staff,23,0,25,2
1713321079810,EDS 125,A00,507246,Hopkins; Megan Beth,29,0,30,1
1713321080835,EDS 128A,A01,507264,Fargason; Sharon Gayle,26,0,26,0
1713321081859,EDS 128B,A01,507293,Pappas; Elizabeth,30,0,30,0
1713321082884,EDS 139,A00,507294,Fargason; Sharon Gayle,30,0,30,0
1713321082884,EDS 139,B00,507313,Pappas; Elizabeth,30,0,30,0
1713321083909,EDS 201,A00,507315,Staff,26,0,30,4
1713321084938,EDS 203,A01,507317,Halter; Christopher P.,26,0,30,4
1713321085964,EDS 204R,A01,507319,Halter; Christopher P.,3,0,30,27
1713321085964,EDS 204R,B01,507331,Heinzman; Erica M.,28,0,30,2
1713321086991,EDS 206R,A00,507332,Staff,4,0,30,26
1713321086991,EDS 206R,B00,507343,Staff,28,0,30,2
1713321088020,EDS 250,A00,507344,Hemans; Patricia Ann Benitez,36,0,40,4
1713321089048,EDS 281,A00,507345,Daly; Alan J.,18,0,18,0
1713321090071,EDS 284,A00,507350,Daly; Alan J.,16,0,16,0
1713321091097,EDS 286,A00,507359,Fine; Sarah,18,0,18,0
1713321092122,EDS 289C,A01,507361,Daly; Alan J.,18,0,18,0
1713321093147,EDS 290,A00,507366,Hofstetter; Carolyn,15,0,15,0
1713321094173,LIGM 5A,A00,507421,Fischer-Grunski; Eva K,20,0,20,0
1713321095200,LIGM 5B,A00,507423,Fischer-Grunski; Eva K,20,0,20,0
1713321096226,LIGM 5C,A00,507425,Fischer-Grunski; Eva K,20,0,20,0
1713321097251,LIIT 5AS,A00,507427,Carnelos; Chiara,20,0,20,0
1713321098280,LIIT 5BS,A00,507430,Carnelos; Chiara,20,0,20,0
1713321099308,LIIT 5CS,A00,507432,Carnelos; Chiara,20,0,20,0
1713321100332,LISP 5A,A00,507541,Munoz Sanchez; Alicia,18,0,20,2
1713321101356,LISP 5B,A00,507671,Munoz Sanchez; Alicia,16,0,20,4
1713321102383,LISP 5C,A00,507696,Munoz Sanchez; Alicia,16,0,20,4
1713321103407,MAE 197,001,528363,Boechler; Nicholas Sebastia,9998,0,9999,1
1713321104432,MATH 197,001,523477,Kedlaya; Kiran S.,9999,0,9999,0
1713321104432,MATH 197,002,563811,Zhang; Danna,9999,0,9999,0
1713321105460,MCWP 40R,A00,518780,Staff,20,0,20,0
1713321105460,MCWP 40R,B00,518781,Staff,19,0,20,1
1713321105460,MCWP 40R,C00,518783,Staff,19,0,20,1
1713321106487,MCWP 50R,A00,518791,Staff,20,0,20,0
1713321106487,MCWP 50R,B00,518792,Staff,17,0,20,3
1713321106487,MCWP 50R,C00,518793,Staff,19,0,20,1
1713321106487,MCWP 50R,D00,518794,Staff,18,0,20,2
1713321106487,MCWP 50R,E00,518795,Staff,16,0,20,4
1713321106487,MCWP 50R,F00,518796,Staff,19,0,20,1
1713321106487,MCWP 50R,G00,518797,Staff,19,0,20,1
1713321107512,MMW 12R,A01,514034,Herbst; Matthew,15,0,16,1
1713321107512,MMW 12R,A02,514035,Herbst; Matthew,16,0,16,0
1713321108537,MMW 13R,A01,514037,Staff,12,0,16,4
1713321108537,MMW 13R,A02,514039,Staff,16,0,16,0
1713321110589,SIO 295LS,A00,523233,Staff,19,0,30,11
1713321111614,SIO 295S,A00,523232,Staff,19,0,30,11
1713321112636,SOCI 117,A01,494376,Staff,2,0,5,3
1713321113660,WES 237B,A00,494380,Staff,19,0,20,1
1713321115714,AESE 279B,A00,494370,Wade; Jon P,33,0,33,0
1713321116738,ANAR 135S,A00,494369,Braswell; Geoffrey E.,0,0,0,0
1713321117762,CAT 124RS,A01,519847,Geibel; William,17,0,20,3
1713321118790,CAT 125RS,A01,515971,Geibel; William,17,0,20,3
1713321119818,CLRE 250,A00,511389,Morris; Sheldon,9996,0,9999,3
1713321120843,CLRE 251,A00,507176,Mehta; Ravindra L.,9996,0,9999,3
1713321120843,CLRE 251,B00,511410,Mehta; Ravindra L.,9998,0,9999,1
1713321121869,CLRE 252,A00,507189,Cuomo; Raphael Eduardo,9998,0,9999,1
1713321122894,CLRE 253,A00,507199,Vaida; Florin,9997,0,9999,2
1713321122894,CLRE 253,B00,507202,Vaida; Florin,9999,0,9999,0
1713321123918,CLRE 259,A00,507211,Patel; Hemal,9996,0,9999,3
1713321124943,CLRE 260,A00,507221,Cuomo; Raphael Eduardo,9999,0,9999,0
1713321125971,CLRE 297,001,507242,Cuomo; Raphael Eduardo,9999,0,9999,0
1713321126998,CSE 191,A00,516875,Minnes Kemp; Mor Mia,9999,0,9999,0
1713321128025,CSS 201S,A01,494383,Staff,35,0,35,0
1713321129053,CSS 202S,A01,494387,Staff,35,0,35,0
1713321130078,EAP 100,A00,516065,Staff,9792,0,9999,207
1713321131104,ECE 45,A01,507414,Staff,54,0,60,6
1713321132128,ECE 100,A01,507416,Baghdadchi; Saharnaz,11,0,20,9
1713321132128,ECE 100,A02,507418,Baghdadchi; Saharnaz,20,0,20,0
1713321133153,ECE 111,A01,507420,Staff,39,0,50,11
1713321134180,ECE 197,001,548057,Sievenpiper; Daniel F.,9998,0,9999,1
1713321135205,EDS 115,A00,507243,Choi; Bailey Miyeon,28,0,28,0
1713321136229,EDS 117,A01,494379,Staff,23,0,25,2
1713321137254,EDS 125,A00,507246,Hopkins; Megan Beth,29,0,30,1
1713321138277,EDS 128A,A01,507264,Fargason; Sharon Gayle,26,0,26,0
1713321139302,EDS 128B,A01,507293,Pappas; Elizabeth,30,0,30,0
1713321140327,EDS 139,A00,507294,Fargason; Sharon Gayle,30,0,30,0
1713321140327,EDS 139,B00,507313,Pappas; Elizabeth,30,0,30,0
1713321141351,EDS 201,A00,507315,Staff,26,0,30,4
1713321142400,EDS 203,A01,507317,Halter; Christopher P.,26,0,30,4
1713321143425,EDS 204R,A01,507319,Halter; Christopher P.,3,0,30,27
1713321143425,EDS 204R,B01,507331,Heinzman; Erica M.,28,0,30,2
1713321144448,EDS 206R,A00,507332,Staff,4,0,30,26
1713321144448,EDS 206R,B00,507343,Staff,28,0,30,2
1713321145473,EDS 250,A00,507344,Hemans; Patricia Ann Benitez,36,0,40,4
1713321146498,EDS 281,A00,507345,Daly; Alan J.,18,0,18,0
1713321147524,EDS 284,A00,507350,Daly; Alan J.,16,0,16,0
1713321148549,EDS 286,A00,507359,Fine; Sarah,18,0,18,0
1713321149576,EDS 289C,A01,507361,Daly; Alan J.,18,0,18,0
1713321150601,EDS 290,A00,507366,Hofstetter; Carolyn,15,0,15,0
1713321151624,LIGM 5A,A00,507421,Fischer-Grunski; Eva K,20,0,20,0
1713321152656,LIGM 5B,A00,507423,Fischer-Grunski; Eva K,20,0,20,0
1713321153682,LIGM 5C,A00,507425,Fischer-Grunski; Eva K,20,0,20,0
1713321154711,LIIT 5AS,A00,507427,Carnelos; Chiara,20,0,20,0
1713321155736,LIIT 5BS,A00,507430,Carnelos; Chiara,20,0,20,0
1713321156766,LIIT 5CS,A00,507432,Carnelos; Chiara,20,0,20,0
1713321157791,LISP 5A,A00,507541,Munoz Sanchez; Alicia,18,0,20,2
1713321158815,LISP 5B,A00,507671,Munoz Sanchez; Alicia,16,0,20,4
1713321159838,LISP 5C,A00,507696,Munoz Sanchez; Alicia,16,0,20,4
1713321160866,MAE 197,001,528363,Boechler; Nicholas Sebastia,9998,0,9999,1
1713321161890,MATH 197,001,523477,Kedlaya; Kiran S.,9999,0,9999,0
1713321161890,MATH 197,002,563811,Zhang; Danna,9999,0,9999,0
1713321162915,MCWP 40R,A00,518780,Staff,20,0,20,0
1713321162915,MCWP 40R,B00,518781,Staff,19,0,20,1
1713321162915,MCWP 40R,C00,518783,Staff,19,0,20,1
1713321163939,MCWP 50R,A00,518791,Staff,20,0,20,0
1713321163939,MCWP 50R,B00,518792,Staff,17,0,20,3
1713321163939,MCWP 50R,C00,518793,Staff,19,0,20,1
1713321163939,MCWP 50R,D00,518794,Staff,18,0,20,2
1713321163939,MCWP 50R,E00,518795,Staff,16,0,20,4
1713321163939,MCWP 50R,F00,518796,Staff,19,0,20,1
1713321163939,MCWP 50R,G00,518797,Staff,19,0,20,1
1713321164964,MMW 12R,A01,514034,Herbst; Matthew,15,0,16,1
1713321164964,MMW 12R,A02,514035,Herbst; Matthew,16,0,16,0
1713321165989,MMW 13R,A01,514037,Staff,12,0,16,4
1713321165989,MMW 13R,A02,514039,Staff,16,0,16,0
1713321168044,SIO 295LS,A00,523233,Staff,19,0,30,11
1713321169068,SIO 295S,A00,523232,Staff,19,0,30,11
1713321170095,SOCI 117,A01,494376,Staff,2,0,5,3
1713321171118,WES 237B,A00,494380,Staff,19,0,20,1
1713321173172,AESE 279B,A00,494370,Wade; Jon P,33,0,33,0
1713321174197,ANAR 135S,A00,494369,Braswell; Geoffrey E.,0,0,0,0
1713321175224,CAT 124RS,A01,519847,Geibel; William,17,0,20,3
1713321176307,CAT 125RS,A01,515971,Geibel; William,17,0,20,3
1713321177329,CLRE 250,A00,511389,Morris; Sheldon,9996,0,9999,3
1713321178354,CLRE 251,A00,507176,Mehta; Ravindra L.,9996,0,9999,3
1713321178354,CLRE 251,B00,511410,Mehta; Ravindra L.,9998,0,9999,1
1713321179382,CLRE 252,A00,507189,Cuomo; Raphael Eduardo,9998,0,9999,1
1713321180404,CLRE 253,A00,507199,Vaida; Florin,9997,0,9999,2
1713321180404,CLRE 253,B00,507202,Vaida; Florin,9999,0,9999,0
1713321181430,CLRE 259,A00,507211,Patel; Hemal,9996,0,9999,3
1713321182460,CLRE 260,A00,507221,Cuomo; Raphael Eduardo,9999,0,9999,0
1713321183487,CLRE 297,001,507242,Cuomo; Raphael Eduardo,9999,0,9999,0
1713321184512,CSE 191,A00,516875,Minnes Kemp; Mor Mia,9999,0,9999,0
1713321185537,CSS 201S,A01,494383,Staff,35,0,35,0
1713321186562,CSS 202S,A01,494387,Staff,35,0,35,0
1713321187590,EAP 100,A00,516065,Staff,9792,0,9999,207
1713321188617,ECE 45,A01,507414,Staff,54,0,60,6
1713321189642,ECE 100,A01,507416,Baghdadchi; Saharnaz,11,0,20,9
1713321189642,ECE 100,A02,507418,Baghdadchi; Saharnaz,20,0,20,0
1713321190668,ECE 111,A01,507420,Staff,39,0,50,11
1713321191697,ECE 197,001,548057,Sievenpiper; Daniel F.,9998,0,9999,1
1713321192725,EDS 115,A00,507243,Choi; Bailey Miyeon,28,0,28,0
1713321193753,EDS 117,A01,494379,Staff,23,0,25,2
1713321194779,EDS 125,A00,507246,Hopkins; Megan Beth,29,0,30,1
1713321195803,EDS 128A,A01,507264,Fargason; Sharon Gayle,26,0,26,0
1713321196834,EDS 128B,A01,507293,Pappas; Elizabeth,30,0,30,0
1713321197859,EDS 139,A00,507294,Fargason; Sharon Gayle,30,0,30,0
1713321197859,EDS 139,B00,507313,Pappas; Elizabeth,30,0,30,0
1713321198884,EDS 201,A00,507315,Staff,26,0,30,4
1713321199907,EDS 203,A01,507317,Halter; Christopher P.,26,0,30,4
1713321200933,EDS 204R,A01,507319,Halter; Christopher P.,3,0,30,27
1713321200933,EDS 204R,B01,507331,Heinzman; Erica M.,28,0,30,2
1713321201960,EDS 206R,A00,507332,Staff,4,0,30,26
1713321201960,EDS 206R,B00,507343,Staff,28,0,30,2
1713321202985,EDS 250,A00,507344,Hemans; Patricia Ann Benitez,36,0,40,4
1713321204012,EDS 281,A00,507345,Daly; Alan J.,18,0,18,0
1713321205038,EDS 284,A00,507350,Daly; Alan J.,16,0,16,0
1713321206064,EDS 286,A00,507359,Fine; Sarah,18,0,18,0
1713321207090,EDS 289C,A01,507361,Daly; Alan J.,18,0,18,0
1713321208115,EDS 290,A00,507366,Hofstetter; Carolyn,15,0,15,0
1713321209140,LIGM 5A,A00,507421,Fischer-Grunski; Eva K,20,0,20,0
1713321210169,LIGM 5B,A00,507423,Fischer-Grunski; Eva K,20,0,20,0
1713321211198,LIGM 5C,A00,507425,Fischer-Grunski; Eva K,20,0,20,0
1713321212224,LIIT 5AS,A00,507427,Carnelos; Chiara,20,0,20,0
1713321213250,LIIT 5BS,A00,507430,Carnelos; Chiara,20,0,20,0
1713321214275,LIIT 5CS,A00,507432,Carnelos; Chiara,20,0,20,0
1713321215304,LISP 5A,A00,507541,Munoz Sanchez; Alicia,18,0,20,2
1713321216327,LISP 5B,A00,507671,Munoz Sanchez; Alicia,16,0,20,4
1713321217354,LISP 5C,A00,507696,Munoz Sanchez; Alicia,16,0,20,4
1713321218378,MAE 197,001,528363,Boechler; Nicholas Sebastia,9998,0,9999,1
1713321219403,MATH 197,001,523477,Kedlaya; Kiran S.,9999,0,9999,0
1713321219403,MATH 197,002,563811,Zhang; Danna,9999,0,9999,0
1713321220428,MCWP 40R,A00,518780,Staff,20,0,20,0
1713321220428,MCWP 40R,B00,518781,Staff,19,0,20,1
1713321220428,MCWP 40R,C00,518783,Staff,19,0,20,1
1713321221453,MCWP 50R,A00,518791,Staff,20,0,20,0
1713321221453,MCWP 50R,B00,518792,Staff,17,0,20,3
1713321221453,MCWP 50R,C00,518793,Staff,19,0,20,1
1713321221453,MCWP 50R,D00,518794,Staff,18,0,20,2
1713321221453,MCWP 50R,E00,518795,Staff,16,0,20,4
1713321221453,MCWP 50R,F00,518796,Staff,19,0,20,1
1713321221453,MCWP 50R,G00,518797,Staff,19,0,20,1
1713321222479,MMW 12R,A01,514034,Herbst; Matthew,15,0,16,1
1713321222479,MMW 12R,A02,514035,Herbst; Matthew,16,0,16,0
1713321223504,MMW 13R,A01,514037,Staff,12,0,16,4
1713321223504,MMW 13R,A02,514039,Staff,16,0,16,0
1713321225554,SIO 295LS,A00,523233,Staff,19,0,30,11
1713321226579,SIO 295S,A00,523232,Staff,19,0,30,11
1713321227603,SOCI 117,A01,494376,Staff,2,0,5,3
1713321228630,WES 237B,A00,494380,Staff,19,0,20,1
1713321230687,AESE 279B,A00,494370,Wade; Jon P,33,0,33,0
1713321231711,ANAR 135S,A00,494369,Braswell; Geoffrey E.,0,0,0,0
1713321232736,CAT 124RS,A01,519847,Geibel; William,17,0,20,3
1713321233761,CAT 125RS,A01,515971,Geibel; William,17,0,20,3
1713321234790,CLRE 250,A00,511389,Morris; Sheldon,9996,0,9999,3
1713321235817,CLRE 251,A00,507176,Mehta; Ravindra L.,9996,0,9999,3
1713321235817,CLRE 251,B00,511410,Mehta; Ravindra L.,9998,0,9999,1
1713321236845,CLRE 252,A00,507189,Cuomo; Raphael Eduardo,9998,0,9999,1
1713321237868,CLRE 253,A00,507199,Vaida; Florin,9997,0,9999,2
1713321237868,CLRE 253,B00,507202,Vaida; Florin,9999,0,9999,0
1713321238893,CLRE 259,A00,507211,Patel; Hemal,9996,0,9999,3
1713321240032,CLRE 260,A00,507221,Cuomo; Raphael Eduardo,9999,0,9999,0
1713321241060,CLRE 297,001,507242,Cuomo; Raphael Eduardo,9999,0,9999,0
1713321242083,CSE 191,A00,516875,Minnes Kemp; Mor Mia,9999,0,9999,0
1713321243108,CSS 201S,A01,494383,Staff,35,0,35,0
1713321244137,CSS 202S,A01,494387,Staff,35,0,35,0
1713321245163,EAP 100,A00,516065,Staff,9792,0,9999,207
1713321246191,ECE 45,A01,507414,Staff,54,0,60,6
1713321247215,ECE 100,A01,507416,Baghdadchi; Saharnaz,11,0,20,9
1713321247215,ECE 100,A02,507418,Baghdadchi; Saharnaz,20,0,20,0
1713321248243,ECE 111,A01,507420,Staff,39,0,50,11
1713321249266,ECE 197,001,548057,Sievenpiper; Daniel F.,9998,0,9999,1
1713321250291,EDS 115,A00,507243,Choi; Bailey Miyeon,28,0,28,0
1713321251316,EDS 117,A01,494379,Staff,23,0,25,2
1713321252342,EDS 125,A00,507246,Hopkins; Megan Beth,29,0,30,1
1713321253368,EDS 128A,A01,507264,Fargason; Sharon Gayle,26,0,26,0
1713321254392,EDS 128B,A01,507293,Pappas; Elizabeth,30,0,30,0
1713321255418,EDS 139,A00,507294,Fargason; Sharon Gayle,30,0,30,0
1713321255418,EDS 139,B00,507313,Pappas; Elizabeth,30,0,30,0
1713321256442,EDS 201,A00,507315,Staff,26,0,30,4
1713321257472,EDS 203,A01,507317,Halter; Christopher P.,26,0,30,4
1713321258497,EDS 204R,A01,507319,Halter; Christopher P.,3,0,30,27
1713321258497,EDS 204R,B01,507331,Heinzman; Erica M.,28,0,30,2
1713321259522,EDS 206R,A00,507332,Staff,4,0,30,26
1713321259522,EDS 206R,B00,507343,Staff,28,0,30,2
1713321260551,EDS 250,A00,507344,Hemans; Patricia Ann Benitez,36,0,40,4
1713321261576,EDS 281,A00,507345,Daly; Alan J.,18,0,18,0
1713321262602,EDS 284,A00,507350,Daly; Alan J.,16,0,16,0
1713321263630,EDS 286,A00,507359,Fine; Sarah,18,0,18,0
1713321264659,EDS 289C,A01,507361,Daly; Alan J.,18,0,18,0
1713321265681,EDS 290,A00,507366,Hofstetter; Carolyn,15,0,15,0
1713321266710,LIGM 5A,A00,507421,Fischer-Grunski; Eva K,20,0,20,0
1713321267735,LIGM 5B,A00,507423,Fischer-Grunski; Eva K,20,0,20,0
1713321268759,LIGM 5C,A00,507425,Fischer-Grunski; Eva K,20,0,20,0
1713321269788,LIIT 5AS,A00,507427,Carnelos; Chiara,20,0,20,0
1713321270813,LIIT 5BS,A00,507430,Carnelos; Chiara,20,0,20,0
1713321271842,LIIT 5CS,A00,507432,Carnelos; Chiara,20,0,20,0
1713321272867,LISP 5A,A00,507541,Munoz Sanchez; Alicia,18,0,20,2
1713321273899,LISP 5B,A00,507671,Munoz Sanchez; Alicia,16,0,20,4
1713321274924,LISP 5C,A00,507696,Munoz Sanchez; Alicia,16,0,20,4
1713321275953,MAE 197,001,528363,Boechler; Nicholas Sebastia,9998,0,9999,1
1713321276978,MATH 197,001,523477,Kedlaya; Kiran S.,9999,0,9999,0
1713321276978,MATH 197,002,563811,Zhang; Danna,9999,0,9999,0
1713321278003,MCWP 40R,A00,518780,Staff,20,0,20,0
1713321278003,MCWP 40R,B00,518781,Staff,19,0,20,1
1713321278003,MCWP 40R,C00,518783,Staff,19,0,20,1
1713321279029,MCWP 50R,A00,518791,Staff,20,0,20,0
1713321279029,MCWP 50R,B00,518792,Staff,17,0,20,3
1713321279029,MCWP 50R,C00,518793,Staff,19,0,20,1
1713321279029,MCWP 50R,D00,518794,Staff,18,0,20,2
1713321279029,MCWP 50R,E00,518795,Staff,16,0,20,4
1713321279029,MCWP 50R,F00,518796,Staff,19,0,20,1
1713321279029,MCWP 50R,G00,518797,Staff,19,0,20,1
1713321280111,MMW 12R,A01,514034,Herbst; Matthew,15,0,16,1
1713321280111,MMW 12R,A02,514035,Herbst; Matthew,16,0,16,0
1713321281135,MMW 13R,A01,514037,Staff,12,0,16,4
1713321281135,MMW 13R,A02,514039,Staff,16,0,16,0
1713321283190,SIO 295LS,A00,523233,Staff,19,0,30,11
1713321284216,SIO 295S,A00,523232,Staff,19,0,30,11
1713321285240,SOCI 117,A01,494376,Staff,2,0,5,3
1713321286264,WES 237B,A00,494380,Staff,19,0,20,1
1713321288321,AESE 279B,A00,494370,Wade; Jon P,33,0,33,0
1713321289348,ANAR 135S,A00,494369,Braswell; Geoffrey E.,0,0,0,0
1713321290374,CAT 124RS,A01,519847,Geibel; William,17,0,20,3
1713321291400,CAT 125RS,A01,515971,Geibel; William,17,0,20,3
1713321292428,CLRE 250,A00,511389,Morris; Sheldon,9996,0,9999,3
1713321293454,CLRE 251,A00,507176,Mehta; Ravindra L.,9996,0,9999,3
1713321293454,CLRE 251,B00,511410,Mehta; Ravindra L.,9998,0,9999,1
1713321294478,CLRE 252,A00,507189,Cuomo; Raphael Eduardo,9998,0,9999,1
1713321295509,CLRE 253,A00,507199,Vaida; Florin,9997,0,9999,2
1713321295509,CLRE 253,B00,507202,Vaida; Florin,9999,0,9999,0
1713321296537,CLRE 259,A00,507211,Patel; Hemal,9996,0,9999,3
1713321297566,CLRE 260,A00,507221,Cuomo; Raphael Eduardo,9999,0,9999,0
1713321298590,CLRE 297,001,507242,Cuomo; Raphael Eduardo,9999,0,9999,0
1713321299614,CSE 191,A00,516875,Minnes Kemp; Mor Mia,9999,0,9999,0
1713321300639,CSS 201S,A01,494383,Staff,35,0,35,0
1713321301669,CSS 202S,A01,494387,Staff,35,0,35,0
1713321302696,EAP 100,A00,516065,Staff,9792,0,9999,207
1713321303724,ECE 45,A01,507414,Staff,54,0,60,6
1713321304750,ECE 100,A01,507416,Baghdadchi; Saharnaz,11,0,20,9
1713321304750,ECE 100,A02,507418,Baghdadchi; Saharnaz,20,0,20,0
1713321305775,ECE 111,A01,507420,Staff,39,0,50,11
1713321306799,ECE 197,001,548057,Sievenpiper; Daniel F.,9998,0,9999,1
1713321307823,EDS 115,A00,507243,Choi; Bailey Miyeon,28,0,28,0
1713321308850,EDS 117,A01,494379,Staff,23,0,25,2
1713321309880,EDS 125,A00,507246,Hopkins; Megan Beth,29,0,30,1
1713321310908,EDS 128A,A01,507264,Fargason; Sharon Gayle,26,0,26,0
1713321311935,EDS 128B,A01,507293,Pappas; Elizabeth,30,0,30,0
1713321312962,EDS 139,A00,507294,Fargason; Sharon Gayle,30,0,30,0
1713321312962,EDS 139,B00,507313,Pappas; Elizabeth,30,0,30,0
1713321313988,EDS 201,A00,507315,Staff,26,0,30,4
1713321315015,EDS 203,A01,507317,Halter; Christopher P.,26,0,30,4
1713321316044,EDS 204R,A01,507319,Halter; Christopher P.,3,0,30,27
1713321316044,EDS 204R,B01,507331,Heinzman; Erica M.,28,0,30,2
1713321317071,EDS 206R,A00,507332,Staff,4,0,30,26
1713321317071,EDS 206R,B00,507343,Staff,28,0,30,2
1713321318099,EDS 250,A00,507344,Hemans; Patricia Ann Benitez,36,0,40,4
1713321319126,EDS 281,A00,507345,Daly; Alan J.,18,0,18,0
1713321320153,EDS 284,A00,507350,Daly; Alan J.,16,0,16,0
1713321321183,EDS 286,A00,507359,Fine; Sarah,18,0,18,0
1713321322207,EDS 289C,A01,507361,Daly; Alan J.,18,0,18,0
1713321323232,EDS 290,A00,507366,Hofstetter; Carolyn,15,0,15,0
1713321324257,LIGM 5A,A00,507421,Fischer-Grunski; Eva K,20,0,20,0
1713321325283,LIGM 5B,A00,507423,Fischer-Grunski; Eva K,20,0,20,0
1713321326313,LIGM 5C,A00,507425,Fischer-Grunski; Eva K,20,0,20,0
1713321327336,LIIT 5AS,A00,507427,Carnelos; Chiara,20,0,20,0
1713321328361,LIIT 5BS,A00,507430,Carnelos; Chiara,20,0,20,0
1713321329386,LIIT 5CS,A00,507432,Carnelos; Chiara,20,0,20,0
1713321330415,LISP 5A,A00,507541,Munoz Sanchez; Alicia,18,0,20,2
1713321331444,LISP 5B,A00,507671,Munoz Sanchez; Alicia,16,0,20,4
1713321332471,LISP 5C,A00,507696,Munoz Sanchez; Alicia,16,0,20,4
1713321333500,MAE 197,001,528363,Boechler; Nicholas Sebastia,9998,0,9999,1
1713321334530,MATH 197,001,523477,Kedlaya; Kiran S.,9999,0,9999,0
1713321334530,MATH 197,002,563811,Zhang; Danna,9999,0,9999,0
1713321335555,MCWP 40R,A00,518780,Staff,20,0,20,0
1713321335555,MCWP 40R,B00,518781,Staff,19,0,20,1
1713321335555,MCWP 40R,C00,518783,Staff,19,0,20,1
1713321336582,MCWP 50R,A00,518791,Staff,20,0,20,0
1713321336582,MCWP 50R,B00,518792,Staff,17,0,20,3
1713321336582,MCWP 50R,C00,518793,Staff,19,0,20,1
1713321336582,MCWP 50R,D00,518794,Staff,18,0,20,2
1713321336582,MCWP 50R,E00,518795,Staff,16,0,20,4
1713321336582,MCWP 50R,F00,518796,Staff,19,0,20,1
1713321336582,MCWP 50R,G00,518797,Staff,19,0,20,1
1713321337608,MMW 12R,A01,514034,Herbst; Matthew,15,0,16,1
1713321337608,MMW 12R,A02,514035,Herbst; Matthew,16,0,16,0
1713321338634,MMW 13R,A01,514037,Staff,12,0,16,4
1713321338634,MMW 13R,A02,514039,Staff,16,0,16,0
1713321340693,SIO 295LS,A00,523233,Staff,19,0,30,11
1713321341722,SIO 295S,A00,523232,Staff,19,0,30,11
1713321342860,SOCI 117,A01,494376,Staff,2,0,5,3
1713321343896,WES 237B,A00,494380,Staff,19,0,20,1
1713321345960,AESE 279B,A00,494370,Wade; Jon P,33,0,33,0
1713321346987,ANAR 135S,A00,494369,Braswell; Geoffrey E.,0,0,0,0
1713321348015,CAT 124RS,A01,519847,Geibel; William,17,0,20,3
1713321349041,CAT 125RS,A01,515971,Geibel; William,17,0,20,3
1713321350067,CLRE 250,A00,511389,Morris; Sheldon,9996,0,9999,3
1713321351095,CLRE 251,A00,507176,Mehta; Ravindra L.,9996,0,9999,3
1713321351095,CLRE 251,B00,511410,Mehta; Ravindra L.,9998,0,9999,1
1713321352122,CLRE 252,A00,507189,Cuomo; Raphael Eduardo,9998,0,9999,1
1713321353147,CLRE 253,A00,507199,Vaida; Florin,9997,0,9999,2
1713321353147,CLRE 253,B00,507202,Vaida; Florin,9999,0,9999,0
1713321354172,CLRE 259,A00,507211,Patel; Hemal,9996,0,9999,3
1713321355199,CLRE 260,A00,507221,Cuomo; Raphael Eduardo,9999,0,9999,0
1713321356224,CLRE 297,001,507242,Cuomo; Raphael Eduardo,9999,0,9999,0
1713321357247,CSE 191,A00,516875,Minnes Kemp; Mor Mia,9999,0,9999,0
1713321358279,CSS 201S,A01,494383,Staff,35,0,35,0
1713321359308,CSS 202S,A01,494387,Staff,35,0,35,0
1713321360332,EAP 100,A00,516065,Staff,9792,0,9999,207
1713321361356,ECE 45,A01,507414,Staff,54,0,60,6
1713321362382,ECE 100,A01,507416,Baghdadchi; Saharnaz,11,0,20,9
1713321362382,ECE 100,A02,507418,Baghdadchi; Saharnaz,20,0,20,0
1713321363412,ECE 111,A01,507420,Staff,39,0,50,11
1713321364436,ECE 197,001,548057,Sievenpiper; Daniel F.,9998,0,9999,1
1713321365465,EDS 115,A00,507243,Choi; Bailey Miyeon,28,0,28,0
1713321366491,EDS 117,A01,494379,Staff,23,0,25,2
1713321367520,EDS 125,A00,507246,Hopkins; Megan Beth,29,0,30,1
1713321368549,EDS 128A,A01,507264,Fargason; Sharon Gayle,26,0,26,0
1713321369573,EDS 128B,A01,507293,Pappas; Elizabeth,30,0,30,0
1713321370603,EDS 139,A00,507294,Fargason; Sharon Gayle,30,0,30,0
1713321370603,EDS 139,B00,507313,Pappas; Elizabeth,30,0,30,0
1713321371630,EDS 201,A00,507315,Staff,26,0,30,4
1713321372654,EDS 203,A01,507317,Halter; Christopher P.,26,0,30,4
1713321373679,EDS 204R,A01,507319,Halter; Christopher P.,3,0,30,27
1713321373679,EDS 204R,B01,507331,Heinzman; Erica M.,28,0,30,2
1713321374705,EDS 206R,A00,507332,Staff,4,0,30,26
1713321374705,EDS 206R,B00,507343,Staff,28,0,30,2
1713321375730,EDS 250,A00,507344,Hemans; Patricia Ann Benitez,36,0,40,4
1713321376757,EDS 281,A00,507345,Daly; Alan J.,18,0,18,0
1713321377780,EDS 284,A00,507350,Daly; Alan J.,16,0,16,0
1713321378809,EDS 286,A00,507359,Fine; Sarah,18,0,18,0
1713321379836,EDS 289C,A01,507361,Daly; Alan J.,18,0,18,0
1713321380863,EDS 290,A00,507366,Hofstetter; Carolyn,15,0,15,0
1713321381892,LIGM 5A,A00,507421,Fischer-Grunski; Eva K,20,0,20,0
1713321382916,LIGM 5B,A00,507423,Fischer-Grunski; Eva K,20,0,20,0
1713321383995,LIGM 5C,A00,507425,Fischer-Grunski; Eva K,20,0,20,0
1713321385025,LIIT 5AS,A00,507427,Carnelos; Chiara,20,0,20,0
1713321386054,LIIT 5BS,A00,507430,Carnelos; Chiara,20,0,20,0
1713321387079,LIIT 5CS,A00,507432,Carnelos; Chiara,20,0,20,0
1713321388109,LISP 5A,A00,507541,Munoz Sanchez; Alicia,18,0,20,2
1713321389134,LISP 5B,A00,507671,Munoz Sanchez; Alicia,16,0,20,4
1713321390163,LISP 5C,A00,507696,Munoz Sanchez; Alicia,16,0,20,4
1713321391190,MAE 197,001,528363,Boechler; Nicholas Sebastia,9998,0,9999,1
1713321392214,MATH 197,001,523477,Kedlaya; Kiran S.,9999,0,9999,0
1713321392214,MATH 197,002,563811,Zhang; Danna,9999,0,9999,0
1713321393242,MCWP 40R,A00,518780,Staff,20,0,20,0
1713321393242,MCWP 40R,B00,518781,Staff,19,0,20,1
1713321393242,MCWP 40R,C00,518783,Staff,19,0,20,1
1713321394266,MCWP 50R,A00,518791,Staff,20,0,20,0
1713321394266,MCWP 50R,B00,518792,Staff,17,0,20,3
1713321394266,MCWP 50R,C00,518793,Staff,19,0,20,1
1713321394266,MCWP 50R,D00,518794,Staff,18,0,20,2
1713321394266,MCWP 50R,E00,518795,Staff,16,0,20,4
1713321394266,MCWP 50R,F00,518796,Staff,19,0,20,1
1713321394266,MCWP 50R,G00,518797,Staff,19,0,20,1
1713321395293,MMW 12R,A01,514034,Herbst; Matthew,15,0,16,1
1713321395293,MMW 12R,A02,514035,Herbst; Matthew,16,0,16,0
1713321396320,MMW 13R,A01,514037,Staff,12,0,16,4
1713321396320,MMW 13R,A02,514039,Staff,16,0,16,0
1713321398372,SIO 295LS,A00,523233,Staff,19,0,30,11
1713321399394,SIO 295S,A00,523232,Staff,19,0,30,11
1713321400422,SOCI 117,A01,494376,Staff,2,0,5,3
1713321401449,WES 237B,A00,494380,Staff,19,0,20,1
1713321403511,AESE 279B,A00,494370,Wade; Jon P,33,0,33,0
1713321404536,ANAR 135S,A00,494369,Braswell; Geoffrey E.,0,0,0,0
1713321405560,CAT 124RS,A01,519847,Geibel; William,17,0,20,3
1713321406585,CAT 125RS,A01,515971,Geibel; William,17,0,20,3
1713321407612,CLRE 250,A00,511389,Morris; Sheldon,9996,0,9999,3
1713321408638,CLRE 251,A00,507176,Mehta; Ravindra L.,9996,0,9999,3
1713321408638,CLRE 251,B00,511410,Mehta; Ravindra L.,9998,0,9999,1
1713321409667,CLRE 252,A00,507189,Cuomo; Raphael Eduardo,9998,0,9999,1
1713321410691,CLRE 253,A00,507199,Vaida; Florin,9997,0,9999,2
1713321410691,CLRE 253,B00,507202,Vaida; Florin,9999,0,9999,0
1713321411715,CLRE 259,A00,507211,Patel; Hemal,9996,0,9999,3
1713321412743,CLRE 260,A00,507221,Cuomo; Raphael Eduardo,9999,0,9999,0
1713321413770,CLRE 297,001,507242,Cuomo; Raphael Eduardo,9999,0,9999,0
1713321414797,CSE 191,A00,516875,Minnes Kemp; Mor Mia,9999,0,9999,0
1713321415823,CSS 201S,A01,494383,Staff,35,0,35,0
1713321416849,CSS 202S,A01,494387,Staff,35,0,35,0
1713321417872,EAP 100,A00,516065,Staff,9792,0,9999,207
1713321418897,ECE 45,A01,507414,Staff,54,0,60,6
1713321419921,ECE 100,A01,507416,Baghdadchi; Saharnaz,11,0,20,9
1713321419921,ECE 100,A02,507418,Baghdadchi; Saharnaz,20,0,20,0
1713321420945,ECE 111,A01,507420,Staff,39,0,50,11
1713321421970,ECE 197,001,548057,Sievenpiper; Daniel F.,9998,0,9999,1
1713321422998,EDS 115,A00,507243,Choi; Bailey Miyeon,28,0,28,0
1713321424025,EDS 117,A01,494379,Staff,23,0,25,2
1713321425050,EDS 125,A00,507246,Hopkins; Megan Beth,29,0,30,1
1713321426077,EDS 128A,A01,507264,Fargason; Sharon Gayle,26,0,26,0
1713321427104,EDS 128B,A01,507293,Pappas; Elizabeth,30,0,30,0
1713321428128,EDS 139,A00,507294,Fargason; Sharon Gayle,30,0,30,0
1713321428128,EDS 139,B00,507313,Pappas; Elizabeth,30,0,30,0
1713321429152,EDS 201,A00,507315,Staff,26,0,30,4
1713321430177,EDS 203,A01,507317,Halter; Christopher P.,26,0,30,4
1713321431206,EDS 204R,A01,507319,Halter; Christopher P.,3,0,30,27
1713321431206,EDS 204R,B01,507331,Heinzman; Erica M.,28,0,30,2
1713321432230,EDS 206R,A00,507332,Staff,4,0,30,26
1713321432230,EDS 206R,B00,507343,Staff,28,0,30,2
1713321433258,EDS 250,A00,507344,Hemans; Patricia Ann Benitez,36,0,40,4
1713321434281,EDS 281,A00,507345,Daly; Alan J.,18,0,18,0
1713321435308,EDS 284,A00,507350,Daly; Alan J.,16,0,16,0
1713321436333,EDS 286,A00,507359,Fine; Sarah,18,0,18,0
1713321437360,EDS 289C,A01,507361,Daly; Alan J.,18,0,18,0
1713321438385,EDS 290,A00,507366,Hofstetter; Carolyn,15,0,15,0
1713321439410,LIGM 5A,A00,507421,Fischer-Grunski; Eva K,20,0,20,0
1713321440434,LIGM 5B,A00,507423,Fischer-Grunski; Eva K,20,0,20,0
1713321441463,LIGM 5C,A00,507425,Fischer-Grunski; Eva K,20,0,20,0
1713321442489,LIIT 5AS,A00,507427,Carnelos; Chiara,20,0,20,0
1713321443514,LIIT 5BS,A00,507430,Carnelos; Chiara,20,0,20,0
1713321444542,LIIT 5CS,A00,507432,Carnelos; Chiara,20,0,20,0
1713321445566,LISP 5A,A00,507541,Munoz Sanchez; Alicia,18,0,20,2
1713321446592,LISP 5B,A00,507671,Munoz Sanchez; Alicia,16,0,20,4
1713321447621,LISP 5C,A00,507696,Munoz Sanchez; Alicia,16,0,20,4
1713321448649,MAE 197,001,528363,Boechler; Nicholas Sebastia,9998,0,9999,1
1713321449676,MATH 197,001,523477,Kedlaya; Kiran S.,9999,0,9999,0
1713321449676,MATH 197,002,563811,Zhang; Danna,9999,0,9999,0
1713321450700,MCWP 40R,A00,518780,Staff,20,0,20,0
1713321450700,MCWP 40R,B00,518781,Staff,19,0,20,1
1713321450700,MCWP 40R,C00,518783,Staff,19,0,20,1
1713321451724,MCWP 50R,A00,518791,Staff,20,0,20,0
1713321451724,MCWP 50R,B00,518792,Staff,17,0,20,3
1713321451724,MCWP 50R,C00,518793,Staff,19,0,20,1
1713321451724,MCWP 50R,D00,518794,Staff,18,0,20,2
1713321451724,MCWP 50R,E00,518795,Staff,16,0,20,4
1713321451724,MCWP 50R,F00,518796,Staff,19,0,20,1
1713321451724,MCWP 50R,G00,518797,Staff,19,0,20,1
1713321452752,MMW 12R,A01,514034,Herbst; Matthew,15,0,16,1
1713321452752,MMW 12R,A02,514035,Herbst; Matthew,16,0,16,0
1713321453776,MMW 13R,A01,514037,Staff,12,0,16,4
1713321453776,MMW 13R,A02,514039,Staff,16,0,16,0
1713321455830,SIO 295LS,A00,523233,Staff,19,0,30,11
1713321456854,SIO 295S,A00,523232,Staff,19,0,30,11
1713321457881,SOCI 117,A01,494376,Staff,2,0,5,3
1713321458906,WES 237B,A00,494380,Staff,19,0,20,1
1713321460963,AESE 279B,A00,494370,Wade; Jon P,33,0,33,0
1713321461990,ANAR 135S,A00,494369,Braswell; Geoffrey E.,0,0,0,0
1713321463015,CAT 124RS,A01,519847,Geibel; William,17,0,20,3
1713321464041,CAT 125RS,A01,515971,Geibel; William,17,0,20,3
1713321465064,CLRE 250,A00,511389,Morris; Sheldon,9996,0,9999,3
1713321466089,CLRE 251,A00,507176,Mehta; Ravindra L.,9996,0,9999,3
1713321466089,CLRE 251,B00,511410,Mehta; Ravindra L.,9998,0,9999,1
1713321467115,CLRE 252,A00,507189,Cuomo; Raphael Eduardo,9998,0,9999,1
1713321468142,CLRE 253,A00,507199,Vaida; Florin,9997,0,9999,2
1713321468142,CLRE 253,B00,507202,Vaida; Florin,9999,0,9999,0
1713321469166,CLRE 259,A00,507211,Patel; Hemal,9996,0,9999,3
1713321470190,CLRE 260,A00,507221,Cuomo; Raphael Eduardo,9999,0,9999,0
1713321471215,CLRE 297,001,507242,Cuomo; Raphael Eduardo,9999,0,9999,0
1713321472241,CSE 191,A00,516875,Minnes Kemp; Mor Mia,9999,0,9999,0
1713321473267,CSS 201S,A01,494383,Staff,35,0,35,0
1713321474290,CSS 202S,A01,494387,Staff,35,0,35,0
1713321475314,EAP 100,A00,516065,Staff,9792,0,9999,207
1713321476339,ECE 45,A01,507414,Staff,54,0,60,6
1713321477366,ECE 100,A01,507416,Baghdadchi; Saharnaz,11,0,20,9
1713321477366,ECE 100,A02,507418,Baghdadchi; Saharnaz,20,0,20,0
1713321478389,ECE 111,A01,507420,Staff,39,0,50,11
1713321479415,ECE 197,001,548057,Sievenpiper; Daniel F.,9998,0,9999,1
1713321480443,EDS 115,A00,507243,Choi; Bailey Miyeon,28,0,28,0
1713321481471,EDS 117,A01,494379,Staff,23,0,25,2
1713321482498,EDS 125,A00,507246,Hopkins; Megan Beth,29,0,30,1
1713321483522,EDS 128A,A01,507264,Fargason; Sharon Gayle,26,0,26,0
1713321484546,EDS 128B,A01,507293,Pappas; Elizabeth,30,0,30,0
1713321485571,EDS 139,A00,507294,Fargason; Sharon Gayle,30,0,30,0
1713321485571,EDS 139,B00,507313,Pappas; Elizabeth,30,0,30,0
1713321486594,EDS 201,A00,507315,Staff,26,0,30,4
1713321487674,EDS 203,A01,507317,Halter; Christopher P.,26,0,30,4
1713321488698,EDS 204R,A01,507319,Halter; Christopher P.,3,0,30,27
1713321488698,EDS 204R,B01,507331,Heinzman; Erica M.,28,0,30,2
1713321489722,EDS 206R,A00,507332,Staff,4,0,30,26
1713321489722,EDS 206R,B00,507343,Staff,28,0,30,2
1713321490750,EDS 250,A00,507344,Hemans; Patricia Ann Benitez,36,0,40,4
1713321491787,EDS 281,A00,507345,Daly; Alan J.,18,0,18,0
1713321492809,EDS 284,A00,507350,Daly; Alan J.,16,0,16,0
1713321493834,EDS 286,A00,507359,Fine; Sarah,18,0,18,0
1713321494861,EDS 289C,A01,507361,Daly; Alan J.,18,0,18,0
1713321495884,EDS 290,A00,507366,Hofstetter; Carolyn,15,0,15,0
1713321496908,LIGM 5A,A00,507421,Fischer-Grunski; Eva K,20,0,20,0
1713321497939,LIGM 5B,A00,507423,Fischer-Grunski; Eva K,20,0,20,0
1713321498963,LIGM 5C,A00,507425,Fischer-Grunski; Eva K,20,0,20,0
1713321499989,LIIT 5AS,A00,507427,Carnelos; Chiara,20,0,20,0
1713321501014,LIIT 5BS,A00,507430,Carnelos; Chiara,20,0,20,0
1713321502044,LIIT 5CS,A00,507432,Carnelos; Chiara,20,0,20,0
1713321503069,LISP 5A,A00,507541,Munoz Sanchez; Alicia,18,0,20,2
1713321504094,LISP 5B,A00,507671,Munoz Sanchez; Alicia,16,0,20,4
1713321505122,LISP 5C,A00,507696,Munoz Sanchez; Alicia,16,0,20,4
1713321506149,MAE 197,001,528363,Boechler; Nicholas Sebastia,9998,0,9999,1
1713321507174,MATH 197,001,523477,Kedlaya; Kiran S.,9999,0,9999,0
1713321507174,MATH 197,002,563811,Zhang; Danna,9999,0,9999,0
1713321508198,MCWP 40R,A00,518780,Staff,20,0,20,0
1713321508198,MCWP 40R,B00,518781,Staff,19,0,20,1
1713321508198,MCWP 40R,C00,518783,Staff,19,0,20,1
1713321509224,MCWP 50R,A00,518791,Staff,20,0,20,0
1713321509224,MCWP 50R,B00,518792,Staff,17,0,20,3
1713321509224,MCWP 50R,C00,518793,Staff,19,0,20,1
1713321509224,MCWP 50R,D00,518794,Staff,18,0,20,2
1713321509224,MCWP 50R,E00,518795,Staff,16,0,20,4
1713321509224,MCWP 50R,F00,518796,Staff,19,0,20,1
1713321509224,MCWP 50R,G00,518797,Staff,19,0,20,1
1713321510251,MMW 12R,A01,514034,Herbst; Matthew,15,0,16,1
1713321510251,MMW 12R,A02,514035,Herbst; Matthew,16,0,16,0
1713321511279,MMW 13R,A01,514037,Staff,12,0,16,4
1713321511279,MMW 13R,A02,514039,Staff,16,0,16,0
1713321513331,SIO 295LS,A00,523233,Staff,19,0,30,11
1713321514356,SIO 295S,A00,523232,Staff,19,0,30,11
1713321515382,SOCI 117,A01,494376,Staff,2,0,5,3
1713321516406,WES 237B,A00,494380,Staff,19,0,20,1
1713321518458,AESE 279B,A00,494370,Wade; Jon P,33,0,33,0
1713321519481,ANAR 135S,A00,494369,Braswell; Geoffrey E.,0,0,0,0
1713321520506,CAT 124RS,A01,519847,Geibel; William,17,0,20,3
1713321521533,CAT 125RS,A01,515971,Geibel; William,17,0,20,3
1713321522557,CLRE 250,A00,511389,Morris; Sheldon,9996,0,9999,3
1713321523586,CLRE 251,A00,507176,Mehta; Ravindra L.,9996,0,9999,3
1713321523586,CLRE 251,B00,511410,Mehta; Ravindra L.,9998,0,9999,1
1713321524618,CLRE 252,A00,507189,Cuomo; Raphael Eduardo,9998,0,9999,1
1713321525646,CLRE 253,A00,507199,Vaida; Florin,9997,0,9999,2
1713321525646,CLRE 253,B00,507202,Vaida; Florin,9999,0,9999,0
1713321526673,CLRE 259,A00,507211,Patel; Hemal,9996,0,9999,3
1713321527698,CLRE 260,A00,507221,Cuomo; Raphael Eduardo,9999,0,9999,0
1713321528724,CLRE 297,001,507242,Cuomo; Raphael Eduardo,9999,0,9999,0
1713321529749,CSE 191,A00,516875,Minnes Kemp; Mor Mia,9999,0,9999,0
1713321530773,CSS 201S,A01,494383,Staff,35,0,35,0
1713321531799,CSS 202S,A01,494387,Staff,35,0,35,0
1713321532824,EAP 100,A00,516065,Staff,9792,0,9999,207
1713321533850,ECE 45,A01,507414,Staff,54,0,60,6
1713321534878,ECE 100,A01,507416,Baghdadchi; Saharnaz,11,0,20,9
1713321534878,ECE 100,A02,507418,Baghdadchi; Saharnaz,20,0,20,0
1713321535903,ECE 111,A01,507420,Staff,39,0,50,11
1713321536930,ECE 197,001,548057,Sievenpiper; Daniel F.,9998,0,9999,1
1713321537954,EDS 115,A00,507243,Choi; Bailey Miyeon,28,0,28,0
1713321538980,EDS 117,A01,494379,Staff,23,0,25,2
1713321540005,EDS 125,A00,507246,Hopkins; Megan Beth,29,0,30,1
1713321541028,EDS 128A,A01,507264,Fargason; Sharon Gayle,26,0,26,0
1713321542053,EDS 128B,A01,507293,Pappas; Elizabeth,30,0,30,0
1713321543081,EDS 139,A00,507294,Fargason; Sharon Gayle,30,0,30,0
1713321543081,EDS 139,B00,507313,Pappas; Elizabeth,30,0,30,0
1713321544105,EDS 201,A00,507315,Staff,26,0,30,4
1713321545128,EDS 203,A01,507317,Halter; Christopher P.,26,0,30,4
1713321546153,EDS 204R,A01,507319,Halter; Christopher P.,3,0,30,27
1713321546153,EDS 204R,B01,507331,Heinzman; Erica M.,28,0,30,2
1713321547181,EDS 206R,A00,507332,Staff,4,0,30,26
1713321547181,EDS 206R,B00,507343,Staff,28,0,30,2
1713321548207,EDS 250,A00,507344,Hemans; Patricia Ann Benitez,36,0,40,4
1713321549230,EDS 281,A00,507345,Daly; Alan J.,18,0,18,0
1713321550257,EDS 284,A00,507350,Daly; Alan J.,16,0,16,0
1713321551281,EDS 286,A00,507359,Fine; Sarah,18,0,18,0
1713321552306,EDS 289C,A01,507361,Daly; Alan J.,18,0,18,0
1713321553330,EDS 290,A00,507366,Hofstetter; Carolyn,15,0,15,0
1713321554359,LIGM 5A,A00,507421,Fischer-Grunski; Eva K,20,0,20,0
1713321555383,LIGM 5B,A00,507423,Fischer-Grunski; Eva K,20,0,20,0
1713321556411,LIGM 5C,A00,507425,Fischer-Grunski; Eva K,20,0,20,0
1713321557435,LIIT 5AS,A00,507427,Carnelos; Chiara,20,0,20,0
1713321558460,LIIT 5BS,A00,507430,Carnelos; Chiara,20,0,20,0
1713321559488,LIIT 5CS,A00,507432,Carnelos; Chiara,20,0,20,0
1713321560513,LISP 5A,A00,507541,Munoz Sanchez; Alicia,18,0,20,2
1713321561538,LISP 5B,A00,507671,Munoz Sanchez; Alicia,16,0,20,4
1713321562561,LISP 5C,A00,507696,Munoz Sanchez; Alicia,16,0,20,4
1713321563589,MAE 197,001,528363,Boechler; Nicholas Sebastia,9998,0,9999,1
1713321564615,MATH 197,001,523477,Kedlaya; Kiran S.,9999,0,9999,0
1713321564615,MATH 197,002,563811,Zhang; Danna,9999,0,9999,0
1713321565639,MCWP 40R,A00,518780,Staff,20,0,20,0
1713321565639,MCWP 40R,B00,518781,Staff,19,0,20,1
1713321565639,MCWP 40R,C00,518783,Staff,19,0,20,1
1713321566664,MCWP 50R,A00,518791,Staff,20,0,20,0
1713321566664,MCWP 50R,B00,518792,Staff,17,0,20,3
1713321566664,MCWP 50R,C00,518793,Staff,19,0,20,1
1713321566664,MCWP 50R,D00,518794,Staff,18,0,20,2
1713321566664,MCWP 50R,E00,518795,Staff,16,0,20,4
1713321566664,MCWP 50R,F00,518796,Staff,19,0,20,1
1713321566664,MCWP 50R,G00,518797,Staff,19,0,20,1
1713321567691,MMW 12R,A01,514034,Herbst; Matthew,15,0,16,1
1713321567691,MMW 12R,A02,514035,Herbst; Matthew,16,0,16,0
1713321568716,MMW 13R,A01,514037,Staff,12,0,16,4
1713321568716,MMW 13R,A02,514039,Staff,16,0,16,0
1713321570768,SIO 295LS,A00,523233,Staff,19,0,30,11
1713321571797,SIO 295S,A00,523232,Staff,19,0,30,11
1713321572822,SOCI 117,A01,494376,Staff,2,0,5,3
1713321573845,WES 237B,A00,494380,Staff,19,0,20,1
1713321575905,AESE 279B,A00,494370,Wade; Jon P,33,0,33,0
1713321576929,ANAR 135S,A00,494369,Braswell; Geoffrey E.,0,0,0,0
1713321577953,CAT 124RS,A01,519847,Geibel; William,17,0,20,3
1713321578977,CAT 125RS,A01,515971,Geibel; William,17,0,20,3
1713321580000,CLRE 250,A00,511389,Morris; Sheldon,9996,0,9999,3
1713321581025,CLRE 251,A00,507176,Mehta; Ravindra L.,9996,0,9999,3
1713321581025,CLRE 251,B00,511410,Mehta; Ravindra L.,9998,0,9999,1
1713321582052,CLRE 252,A00,507189,Cuomo; Raphael Eduardo,9998,0,9999,1
1713321583081,CLRE 253,A00,507199,Vaida; Florin,9997,0,9999,2
1713321583081,CLRE 253,B00,507202,Vaida; Florin,9999,0,9999,0
1713321584105,CLRE 259,A00,507211,Patel; Hemal,9996,0,9999,3
1713321585131,CLRE 260,A00,507221,Cuomo; Raphael Eduardo,9999,0,9999,0
1713321586155,CLRE 297,001,507242,Cuomo; Raphael Eduardo,9999,0,9999,0
1713321587179,CSE 191,A00,516875,Minnes Kemp; Mor Mia,9999,0,9999,0
1713321588205,CSS 201S,A01,494383,Staff,35,0,35,0
1713321589230,CSS 202S,A01,494387,Staff,35,0,35,0
1713321590255,EAP 100,A00,516065,Staff,9792,0,9999,207
1713321591337,ECE 45,A01,507414,Staff,54,0,60,6
1713321592361,ECE 100,A01,507416,Baghdadchi; Saharnaz,11,0,20,9
1713321592361,ECE 100,A02,507418,Baghdadchi; Saharnaz,20,0,20,0
1713321593386,ECE 111,A01,507420,Staff,39,0,50,11
1713321594411,ECE 197,001,548057,Sievenpiper; Daniel F.,9998,0,9999,1
1713321595436,EDS 115,A00,507243,Choi; Bailey Miyeon,28,0,28,0
1713321596460,EDS 117,A01,494379,Staff,23,0,25,2
1713321597484,EDS 125,A00,507246,Hopkins; Megan Beth,29,0,30,1
1713321598508,EDS 128A,A01,507264,Fargason; Sharon Gayle,26,0,26,0
1713321599537,EDS 128B,A01,507293,Pappas; Elizabeth,30,0,30,0
1713321600565,EDS 139,A00,507294,Fargason; Sharon Gayle,30,0,30,0
1713321600565,EDS 139,B00,507313,Pappas; Elizabeth,30,0,30,0
1713321601592,EDS 201,A00,507315,Staff,26,0,30,4
1713321602620,EDS 203,A01,507317,Halter; Christopher P.,26,0,30,4
1713321603648,EDS 204R,A01,507319,Halter; Christopher P.,3,0,30,27
1713321603648,EDS 204R,B01,507331,Heinzman; Erica M.,28,0,30,2
1713321604672,EDS 206R,A00,507332,Staff,4,0,30,26
1713321604672,EDS 206R,B00,507343,Staff,28,0,30,2
1713321605696,EDS 250,A00,507344,Hemans; Patricia Ann Benitez,36,0,40,4
1713321606721,EDS 281,A00,507345,Daly; Alan J.,18,0,18,0
1713321607747,EDS 284,A00,507350,Daly; Alan J.,16,0,16,0
1713321608775,EDS 286,A00,507359,Fine; Sarah,18,0,18,0
1713321609799,EDS 289C,A01,507361,Daly; Alan J.,18,0,18,0
1713321610823,EDS 290,A00,507366,Hofstetter; Carolyn,15,0,15,0
1713321611849,LIGM 5A,A00,507421,Fischer-Grunski; Eva K,20,0,20,0
1713321612877,LIGM 5B,A00,507423,Fischer-Grunski; Eva K,20,0,20,0
1713321613901,LIGM 5C,A00,507425,Fischer-Grunski; Eva K,20,0,20,0
1713321614926,LIIT 5AS,A00,507427,Carnelos; Chiara,20,0,20,0
1713321615952,LIIT 5BS,A00,507430,Carnelos; Chiara,20,0,20,0
1713321616976,LIIT 5CS,A00,507432,Carnelos; Chiara,20,0,20,0
1713321618004,LISP 5A,A00,507541,Munoz Sanchez; Alicia,18,0,20,2
1713321619032,LISP 5B,A00,507671,Munoz Sanchez; Alicia,16,0,20,4
1713321620059,LISP 5C,A00,507696,Munoz Sanchez; Alicia,16,0,20,4
1713321621085,MAE 197,001,528363,Boechler; Nicholas Sebastia,9998,0,9999,1
1713321622111,MATH 197,001,523477,Kedlaya; Kiran S.,9999,0,9999,0
1713321622111,MATH 197,002,563811,Zhang; Danna,9999,0,9999,0
1713321623134,MCWP 40R,A00,518780,Staff,20,0,20,0
1713321623134,MCWP 40R,B00,518781,Staff,19,0,20,1
1713321623134,MCWP 40R,C00,518783,Staff,19,0,20,1
1713321624157,MCWP 50R,A00,518791,Staff,20,0,20,0
1713321624157,MCWP 50R,B00,518792,Staff,17,0,20,3
1713321624157,MCWP 50R,C00,518793,Staff,19,0,20,1
1713321624157,MCWP 50R,D00,518794,Staff,18,0,20,2
1713321624157,MCWP 50R,E00,518795,Staff,16,0,20,4
1713321624157,MCWP 50R,F00,518796,Staff,19,0,20,1
1713321624157,MCWP 50R,G00,518797,Staff,19,0,20,1
1713321625185,MMW 12R,A01,514034,Herbst; Matthew,15,0,16,1
1713321625185,MMW 12R,A02,514035,Herbst; Matthew,16,0,16,0
1713321626209,MMW 13R,A01,514037,Staff,12,0,16,4
1713321626209,MMW 13R,A02,514039,Staff,16,0,16,0
1713321628263,SIO 295LS,A00,523233,Staff,19,0,30,11
1713321629287,SIO 295S,A00,523232,Staff,19,0,30,11
1713321630314,SOCI 117,A01,494376,Staff,2,0,5,3
1713321631339,WES 237B,A00,494380,Staff,19,0,20,1
1713321633395,AESE 279B,A00,494370,Wade; Jon P,33,0,33,0
1713321634422,ANAR 135S,A00,494369,Braswell; Geoffrey E.,0,0,0,0
1713321635447,CAT 124RS,A01,519847,Geibel; William,17,0,20,3
1713321636474,CAT 125RS,A01,515971,Geibel; William,17,0,20,3
1713321637498,CLRE 250,A00,511389,Morris; Sheldon,9996,0,9999,3
1713321638524,CLRE 251,A00,507176,Mehta; Ravindra L.,9996,0,9999,3
1713321638524,CLRE 251,B00,511410,Mehta; Ravindra L.,9998,0,9999,1
1713321639547,CLRE 252,A00,507189,Cuomo; Raphael Eduardo,9998,0,9999,1
1713321640573,CLRE 253,A00,507199,Vaida; Florin,9997,0,9999,2
1713321640573,CLRE 253,B00,507202,Vaida; Florin,9999,0,9999,0
1713321641598,CLRE 259,A00,507211,Patel; Hemal,9996,0,9999,3
1713321642626,CLRE 260,A00,507221,Cuomo; Raphael Eduardo,9999,0,9999,0
1713321643651,CLRE 297,001,507242,Cuomo; Raphael Eduardo,9999,0,9999,0
1713321644675,CSE 191,A00,516875,Minnes Kemp; Mor Mia,9999,0,9999,0
1713321645700,CSS 201S,A01,494383,Staff,35,0,35,0
1713321646725,CSS 202S,A01,494387,Staff,35,0,35,0
1713321647751,EAP 100,A00,516065,Staff,9792,0,9999,207
1713321648778,ECE 45,A01,507414,Staff,54,0,60,6
1713321649806,ECE 100,A01,507416,Baghdadchi; Saharnaz,11,0,20,9
1713321649806,ECE 100,A02,507418,Baghdadchi; Saharnaz,20,0,20,0
1713321650831,ECE 111,A01,507420,Staff,39,0,50,11
1713321651856,ECE 197,001,548057,Sievenpiper; Daniel F.,9998,0,9999,1
1713321652884,EDS 115,A00,507243,Choi; Bailey Miyeon,28,0,28,0
1713321653908,EDS 117,A01,494379,Staff,23,0,25,2
1713321654937,EDS 125,A00,507246,Hopkins; Megan Beth,29,0,30,1
1713321655964,EDS 128A,A01,507264,Fargason; Sharon Gayle,26,0,26,0
1713321656991,EDS 128B,A01,507293,Pappas; Elizabeth,30,0,30,0
1713321658018,EDS 139,A00,507294,Fargason; Sharon Gayle,30,0,30,0
1713321658018,EDS 139,B00,507313,Pappas; Elizabeth,30,0,30,0
1713321659043,EDS 201,A00,507315,Staff,26,0,30,4
1713321660066,EDS 203,A01,507317,Halter; Christopher P.,26,0,30,4
1713321661094,EDS 204R,A01,507319,Halter; Christopher P.,3,0,30,27
1713321661094,EDS 204R,B01,507331,Heinzman; Erica M.,28,0,30,2
1713321662119,EDS 206R,A00,507332,Staff,4,0,30,26
1713321662119,EDS 206R,B00,507343,Staff,28,0,30,2
1713321663145,EDS 250,A00,507344,Hemans; Patricia Ann Benitez,36,0,40,4
1713321664172,EDS 281,A00,507345,Daly; Alan J.,18,0,18,0
1713321665197,EDS 284,A00,507350,Daly; Alan J.,16,0,16,0
1713321666222,EDS 286,A00,507359,Fine; Sarah,18,0,18,0
1713321667246,EDS 289C,A01,507361,Daly; Alan J.,18,0,18,0
1713321668270,EDS 290,A00,507366,Hofstetter; Carolyn,15,0,15,0
1713321669297,LIGM 5A,A00,507421,Fischer-Grunski; Eva K,20,0,20,0
1713321670322,LIGM 5B,A00,507423,Fischer-Grunski; Eva K,20,0,20,0
1713321671350,LIGM 5C,A00,507425,Fischer-Grunski; Eva K,20,0,20,0
1713321672374,LIIT 5AS,A00,507427,Carnelos; Chiara,20,0,20,0
1713321673399,LIIT 5BS,A00,507430,Carnelos; Chiara,20,0,20,0
1713321674424,LIIT 5CS,A00,507432,Carnelos; Chiara,20,0,20,0
1713321675449,LISP 5A,A00,507541,Munoz Sanchez; Alicia,18,0,20,2
1713321676476,LISP 5B,A00,507671,Munoz Sanchez; Alicia,16,0,20,4
1713321677502,LISP 5C,A00,507696,Munoz Sanchez; Alicia,16,0,20,4
1713321678529,MAE 197,001,528363,Boechler; Nicholas Sebastia,9998,0,9999,1
1713321679556,MATH 197,001,523477,Kedlaya; Kiran S.,9999,0,9999,0
1713321679556,MATH 197,002,563811,Zhang; Danna,9999,0,9999,0
1713321680591,MCWP 40R,A00,518780,Staff,20,0,20,0
1713321680591,MCWP 40R,B00,518781,Staff,19,0,20,1
1713321680591,MCWP 40R,C00,518783,Staff,19,0,20,1
1713321681617,MCWP 50R,A00,518791,Staff,20,0,20,0
1713321681617,MCWP 50R,B00,518792,Staff,17,0,20,3
1713321681617,MCWP 50R,C00,518793,Staff,19,0,20,1
1713321681617,MCWP 50R,D00,518794,Staff,18,0,20,2
1713321681617,MCWP 50R,E00,518795,Staff,16,0,20,4
1713321681617,MCWP 50R,F00,518796,Staff,19,0,20,1
1713321681617,MCWP 50R,G00,518797,Staff,19,0,20,1
1713321682641,MMW 12R,A01,514034,Herbst; Matthew,15,0,16,1
1713321682641,MMW 12R,A02,514035,Herbst; Matthew,16,0,16,0
1713321683669,MMW 13R,A01,514037,Staff,12,0,16,4
1713321683669,MMW 13R,A02,514039,Staff,16,0,16,0
1713321685718,SIO 295LS,A00,523233,Staff,19,0,30,11
1713321686746,SIO 295S,A00,523232,Staff,19,0,30,11
1713321687772,SOCI 117,A01,494376,Staff,2,0,5,3
1713321688801,WES 237B,A00,494380,Staff,19,0,20,1
1713321690865,AESE 279B,A00,494370,Wade; Jon P,33,0,33,0
1713321691889,ANAR 135S,A00,494369,Braswell; Geoffrey E.,0,0,0,0
1713321692918,CAT 124RS,A01,519847,Geibel; William,17,0,20,3
1713321693943,CAT 125RS,A01,515971,Geibel; William,17,0,20,3
1713321695019,CLRE 250,A00,511389,Morris; Sheldon,9996,0,9999,3
1713321696044,CLRE 251,A00,507176,Mehta; Ravindra L.,9996,0,9999,3
1713321696044,CLRE 251,B00,511410,Mehta; Ravindra L.,9998,0,9999,1
1713321697071,CLRE 252,A00,507189,Cuomo; Raphael Eduardo,9998,0,9999,1
1713321698100,CLRE 253,A00,507199,Vaida; Florin,9997,0,9999,2
1713321698100,CLRE 253,B00,507202,Vaida; Florin,9999,0,9999,0
1713321699123,CLRE 259,A00,507211,Patel; Hemal,9996,0,9999,3
1713321700149,CLRE 260,A00,507221,Cuomo; Raphael Eduardo,9999,0,9999,0
1713321701177,CLRE 297,001,507242,Cuomo; Raphael Eduardo,9999,0,9999,0
1713321702203,CSE 191,A00,516875,Minnes Kemp; Mor Mia,9999,0,9999,0
1713321703227,CSS 201S,A01,494383,Staff,35,0,35,0
1713321704251,CSS 202S,A01,494387,Staff,35,0,35,0
1713321705277,EAP 100,A00,516065,Staff,9792,0,9999,207
1713321706303,ECE 45,A01,507414,Staff,54,0,60,6
1713321707331,ECE 100,A01,507416,Baghdadchi; Saharnaz,11,0,20,9
1713321707331,ECE 100,A02,507418,Baghdadchi; Saharnaz,20,0,20,0
1713321708357,ECE 111,A01,507420,Staff,39,0,50,11
1713321709385,ECE 197,001,548057,Sievenpiper; Daniel F.,9998,0,9999,1
1713321710410,EDS 115,A00,507243,Choi; Bailey Miyeon,28,0,28,0
1713321711439,EDS 117,A01,494379,Staff,23,0,25,2
1713321712464,EDS 125,A00,507246,Hopkins; Megan Beth,29,0,30,1
1713321713488,EDS 128A,A01,507264,Fargason; Sharon Gayle,26,0,26,0
1713321714517,EDS 128B,A01,507293,Pappas; Elizabeth,30,0,30,0
1713321715542,EDS 139,A00,507294,Fargason; Sharon Gayle,30,0,30,0
1713321715542,EDS 139,B00,507313,Pappas; Elizabeth,30,0,30,0
1713321716567,EDS 201,A00,507315,Staff,26,0,30,4
1713321717593,EDS 203,A01,507317,Halter; Christopher P.,26,0,30,4
1713321718618,EDS 204R,A01,507319,Halter; Christopher P.,3,0,30,27
1713321718618,EDS 204R,B01,507331,Heinzman; Erica M.,28,0,30,2
1713321719642,EDS 206R,A00,507332,Staff,4,0,30,26
1713321719642,EDS 206R,B00,507343,Staff,28,0,30,2
1713321720670,EDS 250,A00,507344,Hemans; Patricia Ann Benitez,36,0,40,4
1713321721695,EDS 281,A00,507345,Daly; Alan J.,18,0,18,0
1713321722729,EDS 284,A00,507350,Daly; Alan J.,16,0,16,0
1713321723758,EDS 286,A00,507359,Fine; Sarah,18,0,18,0
1713321724783,EDS 289C,A01,507361,Daly; Alan J.,18,0,18,0
1713321725810,EDS 290,A00,507366,Hofstetter; Carolyn,15,0,15,0
1713321726839,LIGM 5A,A00,507421,Fischer-Grunski; Eva K,20,0,20,0
1713321727867,LIGM 5B,A00,507423,Fischer-Grunski; Eva K,20,0,20,0
1713321728896,LIGM 5C,A00,507425,Fischer-Grunski; Eva K,20,0,20,0
1713321729921,LIIT 5AS,A00,507427,Carnelos; Chiara,20,0,20,0
1713321730945,LIIT 5BS,A00,507430,Carnelos; Chiara,20,0,20,0
1713321731973,LIIT 5CS,A00,507432,Carnelos; Chiara,20,0,20,0
1713321732997,LISP 5A,A00,507541,Munoz Sanchez; Alicia,18,0,20,2
1713321734025,LISP 5B,A00,507671,Munoz Sanchez; Alicia,16,0,20,4
1713321735051,LISP 5C,A00,507696,Munoz Sanchez; Alicia,16,0,20,4
1713321736076,MAE 197,001,528363,Boechler; Nicholas Sebastia,9998,0,9999,1
1713321737101,MATH 197,001,523477,Kedlaya; Kiran S.,9999,0,9999,0
1713321737101,MATH 197,002,563811,Zhang; Danna,9999,0,9999,0
1713321738128,MCWP 40R,A00,518780,Staff,20,0,20,0
1713321738128,MCWP 40R,B00,518781,Staff,19,0,20,1
1713321738128,MCWP 40R,C00,518783,Staff,19,0,20,1
1713321739156,MCWP 50R,A00,518791,Staff,20,0,20,0
1713321739156,MCWP 50R,B00,518792,Staff,17,0,20,3
1713321739156,MCWP 50R,C00,518793,Staff,19,0,20,1
1713321739156,MCWP 50R,D00,518794,Staff,18,0,20,2
1713321739156,MCWP 50R,E00,518795,Staff,16,0,20,4
1713321739156,MCWP 50R,F00,518796,Staff,19,0,20,1
1713321739156,MCWP 50R,G00,518797,Staff,19,0,20,1
1713321740180,MMW 12R,A01,514034,Herbst; Matthew,15,0,16,1
1713321740180,MMW 12R,A02,514035,Herbst; Matthew,16,0,16,0
1713321741203,MMW 13R,A01,514037,Staff,12,0,16,4
1713321741203,MMW 13R,A02,514039,Staff,16,0,16,0
1713321743259,SIO 295LS,A00,523233,Staff,19,0,30,11
1713321744287,SIO 295S,A00,523232,Staff,19,0,30,11
1713321745315,SOCI 117,A01,494376,Staff,2,0,5,3
1713321746339,WES 237B,A00,494380,Staff,19,0,20,1
1713321748411,AESE 279B,A00,494370,Wade; Jon P,33,0,33,0
1713321749434,ANAR 135S,A00,494369,Braswell; Geoffrey E.,0,0,0,0
1713321750458,CAT 124RS,A01,519847,Geibel; William,17,0,20,3
1713321751483,CAT 125RS,A01,515971,Geibel; William,17,0,20,3
1713321752511,CLRE 250,A00,511389,Morris; Sheldon,9996,0,9999,3
1713321753535,CLRE 251,A00,507176,Mehta; Ravindra L.,9996,0,9999,3
1713321753535,CLRE 251,B00,511410,Mehta; Ravindra L.,9998,0,9999,1
1713321754564,CLRE 252,A00,507189,Cuomo; Raphael Eduardo,9998,0,9999,1
1713321755591,CLRE 253,A00,507199,Vaida; Florin,9997,0,9999,2
1713321755591,CLRE 253,B00,507202,Vaida; Florin,9999,0,9999,0
1713321756619,CLRE 259,A00,507211,Patel; Hemal,9996,0,9999,3
1713321757644,CLRE 260,A00,507221,Cuomo; Raphael Eduardo,9999,0,9999,0
1713321758672,CLRE 297,001,507242,Cuomo; Raphael Eduardo,9999,0,9999,0
1713321759698,CSE 191,A00,516875,Minnes Kemp; Mor Mia,9999,0,9999,0
1713321760727,CSS 201S,A01,494383,Staff,35,0,35,0
1713321761752,CSS 202S,A01,494387,Staff,35,0,35,0
1713321762775,EAP 100,A00,516065,Staff,9792,0,9999,207
1713321763800,ECE 45,A01,507414,Staff,53,0,60,7
1713321764829,ECE 100,A01,507416,Baghdadchi; Saharnaz,11,0,20,9
1713321764829,ECE 100,A02,507418,Baghdadchi; Saharnaz,20,0,20,0
1713321765853,ECE 111,A01,507420,Staff,39,0,50,11
1713321766881,ECE 197,001,548057,Sievenpiper; Daniel F.,9998,0,9999,1
1713321767927,EDS 115,A00,507243,Choi; Bailey Miyeon,28,0,28,0
1713321768951,EDS 117,A01,494379,Staff,23,0,25,2
1713321769977,EDS 125,A00,507246,Hopkins; Megan Beth,29,0,30,1
1713321771003,EDS 128A,A01,507264,Fargason; Sharon Gayle,26,0,26,0
1713321772027,EDS 128B,A01,507293,Pappas; Elizabeth,30,0,30,0
1713321773052,EDS 139,A00,507294,Fargason; Sharon Gayle,30,0,30,0
1713321773052,EDS 139,B00,507313,Pappas; Elizabeth,30,0,30,0
1713321774080,EDS 201,A00,507315,Staff,26,0,30,4
1713321775108,EDS 203,A01,507317,Halter; Christopher P.,26,0,30,4
1713321776133,EDS 204R,A01,507319,Halter; Christopher P.,3,0,30,27
1713321776133,EDS 204R,B01,507331,Heinzman; Erica M.,28,0,30,2
1713321777158,EDS 206R,A00,507332,Staff,4,0,30,26
1713321777158,EDS 206R,B00,507343,Staff,28,0,30,2
1713321778186,EDS 250,A00,507344,Hemans; Patricia Ann Benitez,36,0,40,4
1713321779209,EDS 281,A00,507345,Daly; Alan J.,18,0,18,0
1713321780233,EDS 284,A00,507350,Daly; Alan J.,16,0,16,0
1713321781261,EDS 286,A00,507359,Fine; Sarah,18,0,18,0
1713321782285,EDS 289C,A01,507361,Daly; Alan J.,18,0,18,0
1713321783309,EDS 290,A00,507366,Hofstetter; Carolyn,15,0,15,0
1713321784336,LIGM 5A,A00,507421,Fischer-Grunski; Eva K,20,0,20,0
1713321785360,LIGM 5B,A00,507423,Fischer-Grunski; Eva K,20,0,20,0
1713321786389,LIGM 5C,A00,507425,Fischer-Grunski; Eva K,20,0,20,0
1713321787415,LIIT 5AS,A00,507427,Carnelos; Chiara,20,0,20,0
1713321788580,LIIT 5BS,A00,507430,Carnelos; Chiara,20,0,20,0
1713321789610,LIIT 5CS,A00,507432,Carnelos; Chiara,20,0,20,0
1713321790637,LISP 5A,A00,507541,Munoz Sanchez; Alicia,18,0,20,2
1713321791663,LISP 5B,A00,507671,Munoz Sanchez; Alicia,16,0,20,4
1713321792690,LISP 5C,A00,507696,Munoz Sanchez; Alicia,16,0,20,4
1713321793714,MAE 197,001,528363,Boechler; Nicholas Sebastia,9998,0,9999,1
1713321794743,MATH 197,001,523477,Kedlaya; Kiran S.,9999,0,9999,0
1713321794743,MATH 197,002,563811,Zhang; Danna,9999,0,9999,0
1713321795766,MCWP 40R,A00,518780,Staff,20,0,20,0
1713321795766,MCWP 40R,B00,518781,Staff,19,0,20,1
1713321795766,MCWP 40R,C00,518783,Staff,19,0,20,1
1713321796797,MCWP 50R,A00,518791,Staff,20,0,20,0
1713321796797,MCWP 50R,B00,518792,Staff,17,0,20,3
1713321796797,MCWP 50R,C00,518793,Staff,19,0,20,1
1713321796797,MCWP 50R,D00,518794,Staff,18,0,20,2
1713321796797,MCWP 50R,E00,518795,Staff,16,0,20,4
1713321796797,MCWP 50R,F00,518796,Staff,19,0,20,1
1713321796797,MCWP 50R,G00,518797,Staff,19,0,20,1
1713321797823,MMW 12R,A01,514034,Herbst; Matthew,15,0,16,1
1713321797823,MMW 12R,A02,514035,Herbst; Matthew,16,0,16,0
1713321798902,MMW 13R,A01,514037,Staff,12,0,16,4
1713321798902,MMW 13R,A02,514039,Staff,16,0,16,0
1713321800956,SIO 295LS,A00,523233,Staff,19,0,30,11
1713321801982,SIO 295S,A00,523232,Staff,19,0,30,11
1713321803008,SOCI 117,A01,494376,Staff,2,0,5,3
1713321804031,WES 237B,A00,494380,Staff,19,0,20,1
1713321806095,AESE 279B,A00,494370,Wade; Jon P,33,0,33,0
1713321807120,ANAR 135S,A00,494369,Braswell; Geoffrey E.,0,0,0,0
1713321808147,CAT 124RS,A01,519847,Geibel; William,17,0,20,3
1713321809172,CAT 125RS,A01,515971,Geibel; William,17,0,20,3
1713321810197,CLRE 250,A00,511389,Morris; Sheldon,9996,0,9999,3
1713321811226,CLRE 251,A00,507176,Mehta; Ravindra L.,9996,0,9999,3
1713321811226,CLRE 251,B00,511410,Mehta; Ravindra L.,9998,0,9999,1
1713321812255,CLRE 252,A00,507189,Cuomo; Raphael Eduardo,9998,0,9999,1
1713321813280,CLRE 253,A00,507199,Vaida; Florin,9997,0,9999,2
1713321813280,CLRE 253,B00,507202,Vaida; Florin,9999,0,9999,0
1713321814308,CLRE 259,A00,507211,Patel; Hemal,9996,0,9999,3
1713321815335,CLRE 260,A00,507221,Cuomo; Raphael Eduardo,9999,0,9999,0
1713321816365,CLRE 297,001,507242,Cuomo; Raphael Eduardo,9999,0,9999,0
1713321817389,CSE 191,A00,516875,Minnes Kemp; Mor Mia,9999,0,9999,0
1713321818417,CSS 201S,A01,494383,Staff,35,0,35,0
1713321819444,CSS 202S,A01,494387,Staff,35,0,35,0
1713321820469,EAP 100,A00,516065,Staff,9792,0,9999,207
1713321821497,ECE 45,A01,507414,Staff,53,0,60,7
1713321822522,ECE 100,A01,507416,Baghdadchi; Saharnaz,11,0,20,9
1713321822522,ECE 100,A02,507418,Baghdadchi; Saharnaz,20,0,20,0
1713321823549,ECE 111,A01,507420,Staff,39,0,50,11
1713321824573,ECE 197,001,548057,Sievenpiper; Daniel F.,9998,0,9999,1
1713321825601,EDS 115,A00,507243,Choi; Bailey Miyeon,28,0,28,0
1713321826625,EDS 117,A01,494379,Staff,23,0,25,2
1713321827651,EDS 125,A00,507246,Hopkins; Megan Beth,29,0,30,1
1713321828679,EDS 128A,A01,507264,Fargason; Sharon Gayle,26,0,26,0
1713321829708,EDS 128B,A01,507293,Pappas; Elizabeth,30,0,30,0
1713321830738,EDS 139,A00,507294,Fargason; Sharon Gayle,30,0,30,0
1713321830738,EDS 139,B00,507313,Pappas; Elizabeth,30,0,30,0
1713321831763,EDS 201,A00,507315,Staff,26,0,30,4
1713321832790,EDS 203,A01,507317,Halter; Christopher P.,26,0,30,4
1713321833817,EDS 204R,A01,507319,Halter; Christopher P.,3,0,30,27
1713321833817,EDS 204R,B01,507331,Heinzman; Erica M.,28,0,30,2
1713321834844,EDS 206R,A00,507332,Staff,4,0,30,26
1713321834844,EDS 206R,B00,507343,Staff,28,0,30,2
1713321835869,EDS 250,A00,507344,Hemans; Patricia Ann Benitez,36,0,40,4
1713321836895,EDS 281,A00,507345,Daly; Alan J.,18,0,18,0
1713321837920,EDS 284,A00,507350,Daly; Alan J.,16,0,16,0
1713321838945,EDS 286,A00,507359,Fine; Sarah,18,0,18,0
1713321839970,EDS 289C,A01,507361,Daly; Alan J.,18,0,18,0
1713321840994,EDS 290,A00,507366,Hofstetter; Carolyn,15,0,15,0
1713321842021,LIGM 5A,A00,507421,Fischer-Grunski; Eva K,20,0,20,0
1713321843047,LIGM 5B,A00,507423,Fischer-Grunski; Eva K,20,0,20,0
1713321844075,LIGM 5C,A00,507425,Fischer-Grunski; Eva K,20,0,20,0
1713321845099,LIIT 5AS,A00,507427,Carnelos; Chiara,20,0,20,0
1713321846123,LIIT 5BS,A00,507430,Carnelos; Chiara,20,0,20,0
1713321847148,LIIT 5CS,A00,507432,Carnelos; Chiara,20,0,20,0
1713321848173,LISP 5A,A00,507541,Munoz Sanchez; Alicia,18,0,20,2
1713321849197,LISP 5B,A00,507671,Munoz Sanchez; Alicia,16,0,20,4
1713321850223,LISP 5C,A00,507696,Munoz Sanchez; Alicia,16,0,20,4
1713321851248,MAE 197,001,528363,Boechler; Nicholas Sebastia,9998,0,9999,1
1713321852272,MATH 197,001,523477,Kedlaya; Kiran S.,9999,0,9999,0
1713321852272,MATH 197,002,563811,Zhang; Danna,9999,0,9999,0
1713321853297,MCWP 40R,A00,518780,Staff,20,0,20,0
1713321853297,MCWP 40R,B00,518781,Staff,19,0,20,1
1713321853297,MCWP 40R,C00,518783,Staff,19,0,20,1
1713321854321,MCWP 50R,A00,518791,Staff,20,0,20,0
1713321854321,MCWP 50R,B00,518792,Staff,17,0,20,3
1713321854321,MCWP 50R,C00,518793,Staff,19,0,20,1
1713321854321,MCWP 50R,D00,518794,Staff,18,0,20,2
1713321854321,MCWP 50R,E00,518795,Staff,16,0,20,4
1713321854321,MCWP 50R,F00,518796,Staff,19,0,20,1
1713321854321,MCWP 50R,G00,518797,Staff,19,0,20,1
1713321855346,MMW 12R,A01,514034,Herbst; Matthew,15,0,16,1
1713321855346,MMW 12R,A02,514035,Herbst; Matthew,16,0,16,0
1713321856374,MMW 13R,A01,514037,Staff,12,0,16,4
1713321856374,MMW 13R,A02,514039,Staff,16,0,16,0
1713321858426,SIO 295LS,A00,523233,Staff,19,0,30,11
1713321859453,SIO 295S,A00,523232,Staff,19,0,30,11
1713321860477,SOCI 117,A01,494376,Staff,2,0,5,3
1713321861501,WES 237B,A00,494380,Staff,19,0,20,1
1713321863571,AESE 279B,A00,494370,Wade; Jon P,33,0,33,0
1713321864596,ANAR 135S,A00,494369,Braswell; Geoffrey E.,0,0,0,0
1713321865624,CAT 124RS,A01,519847,Geibel; William,17,0,20,3
1713321866652,CAT 125RS,A01,515971,Geibel; William,17,0,20,3
1713321867677,CLRE 250,A00,511389,Morris; Sheldon,9996,0,9999,3
1713321868700,CLRE 251,A00,507176,Mehta; Ravindra L.,9996,0,9999,3
1713321868700,CLRE 251,B00,511410,Mehta; Ravindra L.,9998,0,9999,1
1713321869727,CLRE 252,A00,507189,Cuomo; Raphael Eduardo,9998,0,9999,1
1713321870752,CLRE 253,A00,507199,Vaida; Florin,9997,0,9999,2
1713321870752,CLRE 253,B00,507202,Vaida; Florin,9999,0,9999,0
1713321871776,CLRE 259,A00,507211,Patel; Hemal,9996,0,9999,3
1713321872799,CLRE 260,A00,507221,Cuomo; Raphael Eduardo,9999,0,9999,0
1713321873822,CLRE 297,001,507242,Cuomo; Raphael Eduardo,9999,0,9999,0
1713321874849,CSE 191,A00,516875,Minnes Kemp; Mor Mia,9999,0,9999,0
1713321875872,CSS 201S,A01,494383,Staff,35,0,35,0
1713321876896,CSS 202S,A01,494387,Staff,35,0,35,0
1713321877920,EAP 100,A00,516065,Staff,9792,0,9999,207
1713321878945,ECE 45,A01,507414,Staff,53,0,60,7
1713321879969,ECE 100,A01,507416,Baghdadchi; Saharnaz,11,0,20,9
1713321879969,ECE 100,A02,507418,Baghdadchi; Saharnaz,20,0,20,0
1713321880993,ECE 111,A01,507420,Staff,39,0,50,11
1713321882017,ECE 197,001,548057,Sievenpiper; Daniel F.,9998,0,9999,1
1713321883042,EDS 115,A00,507243,Choi; Bailey Miyeon,28,0,28,0
1713321884066,EDS 117,A01,494379,Staff,23,0,25,2
1713321885091,EDS 125,A00,507246,Hopkins; Megan Beth,29,0,30,1
1713321886118,EDS 128A,A01,507264,Fargason; Sharon Gayle,26,0,26,0
1713321887143,EDS 128B,A01,507293,Pappas; Elizabeth,30,0,30,0
1713321888169,EDS 139,A00,507294,Fargason; Sharon Gayle,30,0,30,0
1713321888169,EDS 139,B00,507313,Pappas; Elizabeth,30,0,30,0
1713321889197,EDS 201,A00,507315,Staff,26,0,30,4
1713321890222,EDS 203,A01,507317,Halter; Christopher P.,26,0,30,4
1713321891245,EDS 204R,A01,507319,Halter; Christopher P.,3,0,30,27
1713321891245,EDS 204R,B01,507331,Heinzman; Erica M.,28,0,30,2
1713321892274,EDS 206R,A00,507332,Staff,4,0,30,26
1713321892274,EDS 206R,B00,507343,Staff,28,0,30,2
1713321893299,EDS 250,A00,507344,Hemans; Patricia Ann Benitez,36,0,40,4
1713321894326,EDS 281,A00,507345,Daly; Alan J.,18,0,18,0
1713321895351,EDS 284,A00,507350,Daly; Alan J.,16,0,16,0
1713321896377,EDS 286,A00,507359,Fine; Sarah,18,0,18,0
1713321897401,EDS 289C,A01,507361,Daly; Alan J.,18,0,18,0
1713321898425,EDS 290,A00,507366,Hofstetter; Carolyn,15,0,15,0
1713321899450,LIGM 5A,A00,507421,Fischer-Grunski; Eva K,20,0,20,0
1713321900473,LIGM 5B,A00,507423,Fischer-Grunski; Eva K,20,0,20,0
1713321901500,LIGM 5C,A00,507425,Fischer-Grunski; Eva K,20,0,20,0
1713321902580,LIIT 5AS,A00,507427,Carnelos; Chiara,20,0,20,0
1713321903608,LIIT 5BS,A00,507430,Carnelos; Chiara,20,0,20,0
1713321904632,LIIT 5CS,A00,507432,Carnelos; Chiara,20,0,20,0
1713321905659,LISP 5A,A00,507541,Munoz Sanchez; Alicia,18,0,20,2
1713321906683,LISP 5B,A00,507671,Munoz Sanchez; Alicia,16,0,20,4
1713321907708,LISP 5C,A00,507696,Munoz Sanchez; Alicia,16,0,20,4
1713321908733,MAE 197,001,528363,Boechler; Nicholas Sebastia,9998,0,9999,1
1713321909756,MATH 197,001,523477,Kedlaya; Kiran S.,9999,0,9999,0
1713321909756,MATH 197,002,563811,Zhang; Danna,9999,0,9999,0
1713321910783,MCWP 40R,A00,518780,Staff,20,0,20,0
1713321910783,MCWP 40R,B00,518781,Staff,19,0,20,1
1713321910783,MCWP 40R,C00,518783,Staff,19,0,20,1
1713321911814,MCWP 50R,A00,518791,Staff,20,0,20,0
1713321911814,MCWP 50R,B00,518792,Staff,17,0,20,3
1713321911814,MCWP 50R,C00,518793,Staff,19,0,20,1
1713321911814,MCWP 50R,D00,518794,Staff,18,0,20,2
1713321911814,MCWP 50R,E00,518795,Staff,16,0,20,4
1713321911814,MCWP 50R,F00,518796,Staff,19,0,20,1
1713321911814,MCWP 50R,G00,518797,Staff,19,0,20,1
1713321912838,MMW 12R,A01,514034,Herbst; Matthew,15,0,16,1
1713321912838,MMW 12R,A02,514035,Herbst; Matthew,16,0,16,0
1713321913863,MMW 13R,A01,514037,Staff,12,0,16,4
1713321913863,MMW 13R,A02,514039,Staff,16,0,16,0
1713321915914,SIO 295LS,A00,523233,Staff,19,0,30,11
1713321916941,SIO 295S,A00,523232,Staff,19,0,30,11
1713321917972,SOCI 117,A01,494376,Staff,2,0,5,3
1713321918997,WES 237B,A00,494380,Staff,19,0,20,1
1713321921057,AESE 279B,A00,494370,Wade; Jon P,33,0,33,0
1713321922080,ANAR 135S,A00,494369,Braswell; Geoffrey E.,0,0,0,0
1713321923107,CAT 124RS,A01,519847,Geibel; William,17,0,20,3
1713321924132,CAT 125RS,A01,515971,Geibel; William,17,0,20,3
1713321925155,CLRE 250,A00,511389,Morris; Sheldon,9996,0,9999,3
1713321926180,CLRE 251,A00,507176,Mehta; Ravindra L.,9996,0,9999,3
1713321926180,CLRE 251,B00,511410,Mehta; Ravindra L.,9998,0,9999,1
1713321927203,CLRE 252,A00,507189,Cuomo; Raphael Eduardo,9998,0,9999,1
1713321928231,CLRE 253,A00,507199,Vaida; Florin,9997,0,9999,2
1713321928231,CLRE 253,B00,507202,Vaida; Florin,9999,0,9999,0
1713321929255,CLRE 259,A00,507211,Patel; Hemal,9996,0,9999,3
1713321930277,CLRE 260,A00,507221,Cuomo; Raphael Eduardo,9999,0,9999,0
1713321931303,CLRE 297,001,507242,Cuomo; Raphael Eduardo,9999,0,9999,0
1713321932328,CSE 191,A00,516875,Minnes Kemp; Mor Mia,9999,0,9999,0
1713321933352,CSS 201S,A01,494383,Staff,35,0,35,0
1713321934376,CSS 202S,A01,494387,Staff,35,0,35,0
1713321935404,EAP 100,A00,516065,Staff,9792,0,9999,207
1713321936430,ECE 45,A01,507414,Staff,53,0,60,7
1713321937453,ECE 100,A01,507416,Baghdadchi; Saharnaz,11,0,20,9
1713321937453,ECE 100,A02,507418,Baghdadchi; Saharnaz,20,0,20,0
1713321938480,ECE 111,A01,507420,Staff,39,0,50,11
1713321939507,ECE 197,001,548057,Sievenpiper; Daniel F.,9998,0,9999,1
1713321940533,EDS 115,A00,507243,Choi; Bailey Miyeon,28,0,28,0
1713321941559,EDS 117,A01,494379,Staff,23,0,25,2
1713321942584,EDS 125,A00,507246,Hopkins; Megan Beth,29,0,30,1
1713321943616,EDS 128A,A01,507264,Fargason; Sharon Gayle,26,0,26,0
1713321944641,EDS 128B,A01,507293,Pappas; Elizabeth,30,0,30,0
1713321945667,EDS 139,A00,507294,Fargason; Sharon Gayle,30,0,30,0
1713321945667,EDS 139,B00,507313,Pappas; Elizabeth,30,0,30,0
1713321946697,EDS 201,A00,507315,Staff,26,0,30,4
1713321947726,EDS 203,A01,507317,Halter; Christopher P.,26,0,30,4
1713321948753,EDS 204R,A01,507319,Halter; Christopher P.,3,0,30,27
1713321948753,EDS 204R,B01,507331,Heinzman; Erica M.,28,0,30,2
1713321949781,EDS 206R,A00,507332,Staff,4,0,30,26
1713321949781,EDS 206R,B00,507343,Staff,28,0,30,2
1713321950805,EDS 250,A00,507344,Hemans; Patricia Ann Benitez,36,0,40,4
1713321951832,EDS 281,A00,507345,Daly; Alan J.,18,0,18,0
1713321952855,EDS 284,A00,507350,Daly; Alan J.,16,0,16,0
1713321953878,EDS 286,A00,507359,Fine; Sarah,18,0,18,0
1713321954903,EDS 289C,A01,507361,Daly; Alan J.,18,0,18,0
1713321955930,EDS 290,A00,507366,Hofstetter; Carolyn,15,0,15,0
1713321956955,LIGM 5A,A00,507421,Fischer-Grunski; Eva K,20,0,20,0
1713321957980,LIGM 5B,A00,507423,Fischer-Grunski; Eva K,20,0,20,0
1713321959006,LIGM 5C,A00,507425,Fischer-Grunski; Eva K,20,0,20,0
1713321960031,LIIT 5AS,A00,507427,Carnelos; Chiara,20,0,20,0
1713321961059,LIIT 5BS,A00,507430,Carnelos; Chiara,20,0,20,0
1713321962088,LIIT 5CS,A00,507432,Carnelos; Chiara,20,0,20,0
1713321963113,LISP 5A,A00,507541,Munoz Sanchez; Alicia,18,0,20,2
1713321964143,LISP 5B,A00,507671,Munoz Sanchez; Alicia,16,0,20,4
1713321965168,LISP 5C,A00,507696,Munoz Sanchez; Alicia,16,0,20,4
1713321966192,MAE 197,001,528363,Boechler; Nicholas Sebastia,9998,0,9999,1
1713321967217,MATH 197,001,523477,Kedlaya; Kiran S.,9999,0,9999,0
1713321967217,MATH 197,002,563811,Zhang; Danna,9999,0,9999,0
1713321968241,MCWP 40R,A00,518780,Staff,20,0,20,0
1713321968241,MCWP 40R,B00,518781,Staff,19,0,20,1
1713321968241,MCWP 40R,C00,518783,Staff,19,0,20,1
1713321969267,MCWP 50R,A00,518791,Staff,20,0,20,0
1713321969267,MCWP 50R,B00,518792,Staff,17,0,20,3
1713321969267,MCWP 50R,C00,518793,Staff,19,0,20,1
1713321969267,MCWP 50R,D00,518794,Staff,18,0,20,2
1713321969267,MCWP 50R,E00,518795,Staff,16,0,20,4
1713321969267,MCWP 50R,F00,518796,Staff,19,0,20,1
1713321969267,MCWP 50R,G00,518797,Staff,19,0,20,1
1713321970293,MMW 12R,A01,514034,Herbst; Matthew,15,0,16,1
1713321970293,MMW 12R,A02,514035,Herbst; Matthew,16,0,16,0
1713321971318,MMW 13R,A01,514037,Staff,12,0,16,4
1713321971318,MMW 13R,A02,514039,Staff,16,0,16,0
1713321973376,SIO 295LS,A00,523233,Staff,19,0,30,11
1713321974404,SIO 295S,A00,523232,Staff,19,0,30,11
1713321975428,SOCI 117,A01,494376,Staff,2,0,5,3
1713321976453,WES 237B,A00,494380,Staff,19,0,20,1
1713321978514,AESE 279B,A00,494370,Wade; Jon P,33,0,33,0
1713321979538,ANAR 135S,A00,494369,Braswell; Geoffrey E.,0,0,0,0
1713321980563,CAT 124RS,A01,519847,Geibel; William,17,0,20,3
1713321981590,CAT 125RS,A01,515971,Geibel; William,17,0,20,3
1713321982614,CLRE 250,A00,511389,Morris; Sheldon,9996,0,9999,3
1713321983642,CLRE 251,A00,507176,Mehta; Ravindra L.,9996,0,9999,3
1713321983642,CLRE 251,B00,511410,Mehta; Ravindra L.,9998,0,9999,1
1713321984671,CLRE 252,A00,507189,Cuomo; Raphael Eduardo,9998,0,9999,1
1713321985697,CLRE 253,A00,507199,Vaida; Florin,9997,0,9999,2
1713321985697,CLRE 253,B00,507202,Vaida; Florin,9999,0,9999,0
1713321986721,CLRE 259,A00,507211,Patel; Hemal,9996,0,9999,3
1713321987748,CLRE 260,A00,507221,Cuomo; Raphael Eduardo,9999,0,9999,0
1713321988776,CLRE 297,001,507242,Cuomo; Raphael Eduardo,9999,0,9999,0
1713321989803,CSE 191,A00,516875,Minnes Kemp; Mor Mia,9999,0,9999,0
1713321990831,CSS 201S,A01,494383,Staff,35,0,35,0
1713321991855,CSS 202S,A01,494387,Staff,35,0,35,0
1713321992879,EAP 100,A00,516065,Staff,9792,0,9999,207
1713321993905,ECE 45,A01,507414,Staff,52,0,60,8
1713321994933,ECE 100,A01,507416,Baghdadchi; Saharnaz,11,0,20,9
1713321994933,ECE 100,A02,507418,Baghdadchi; Saharnaz,20,0,20,0
1713321995958,ECE 111,A01,507420,Staff,39,0,50,11
1713321996984,ECE 197,001,548057,Sievenpiper; Daniel F.,9998,0,9999,1
1713321998013,EDS 115,A00,507243,Choi; Bailey Miyeon,28,0,28,0
1713321999038,EDS 117,A01,494379,Staff,23,0,25,2
1713322000067,EDS 125,A00,507246,Hopkins; Megan Beth,29,0,30,1
1713322001092,EDS 128A,A01,507264,Fargason; Sharon Gayle,26,0,26,0
1713322002121,EDS 128B,A01,507293,Pappas; Elizabeth,30,0,30,0
1713322003146,EDS 139,A00,507294,Fargason; Sharon Gayle,30,0,30,0
1713322003146,EDS 139,B00,507313,Pappas; Elizabeth,30,0,30,0
1713322004174,EDS 201,A00,507315,Staff,26,0,30,4
1713322005198,EDS 203,A01,507317,Halter; Christopher P.,26,0,30,4
1713322006277,EDS 204R,A01,507319,Halter; Christopher P.,3,0,30,27
1713322006277,EDS 204R,B01,507331,Heinzman; Erica M.,28,0,30,2
1713322007304,EDS 206R,A00,507332,Staff,4,0,30,26
1713322007304,EDS 206R,B00,507343,Staff,28,0,30,2
1713322008331,EDS 250,A00,507344,Hemans; Patricia Ann Benitez,36,0,40,4
1713322009359,EDS 281,A00,507345,Daly; Alan J.,18,0,18,0
1713322010384,EDS 284,A00,507350,Daly; Alan J.,16,0,16,0
1713322011410,EDS 286,A00,507359,Fine; Sarah,18,0,18,0
1713322012435,EDS 289C,A01,507361,Daly; Alan J.,18,0,18,0
1713322013461,EDS 290,A00,507366,Hofstetter; Carolyn,15,0,15,0
1713322014486,LIGM 5A,A00,507421,Fischer-Grunski; Eva K,20,0,20,0
1713322015514,LIGM 5B,A00,507423,Fischer-Grunski; Eva K,20,0,20,0
1713322016540,LIGM 5C,A00,507425,Fischer-Grunski; Eva K,20,0,20,0
1713322017565,LIIT 5AS,A00,507427,Carnelos; Chiara,20,0,20,0
1713322018590,LIIT 5BS,A00,507430,Carnelos; Chiara,20,0,20,0
1713322019616,LIIT 5CS,A00,507432,Carnelos; Chiara,20,0,20,0
1713322020645,LISP 5A,A00,507541,Munoz Sanchez; Alicia,18,0,20,2
1713322021668,LISP 5B,A00,507671,Munoz Sanchez; Alicia,16,0,20,4
1713322022698,LISP 5C,A00,507696,Munoz Sanchez; Alicia,16,0,20,4
1713322023723,MAE 197,001,528363,Boechler; Nicholas Sebastia,9998,0,9999,1
1713322024749,MATH 197,001,523477,Kedlaya; Kiran S.,9999,0,9999,0
1713322024749,MATH 197,002,563811,Zhang; Danna,9999,0,9999,0
1713322025774,MCWP 40R,A00,518780,Staff,20,0,20,0
1713322025774,MCWP 40R,B00,518781,Staff,19,0,20,1
1713322025774,MCWP 40R,C00,518783,Staff,19,0,20,1
1713322026799,MCWP 50R,A00,518791,Staff,20,0,20,0
1713322026799,MCWP 50R,B00,518792,Staff,17,0,20,3
1713322026799,MCWP 50R,C00,518793,Staff,19,0,20,1
1713322026799,MCWP 50R,D00,518794,Staff,18,0,20,2
1713322026799,MCWP 50R,E00,518795,Staff,16,0,20,4
1713322026799,MCWP 50R,F00,518796,Staff,19,0,20,1
1713322026799,MCWP 50R,G00,518797,Staff,19,0,20,1
1713322027827,MMW 12R,A01,514034,Herbst; Matthew,15,0,16,1
1713322027827,MMW 12R,A02,514035,Herbst; Matthew,16,0,16,0
1713322028854,MMW 13R,A01,514037,Staff,12,0,16,4
1713322028854,MMW 13R,A02,514039,Staff,16,0,16,0
1713322030904,SIO 295LS,A00,523233,Staff,19,0,30,11
1713322031929,SIO 295S,A00,523232,Staff,19,0,30,11
1713322032954,SOCI 117,A01,494376,Staff,2,0,5,3
1713322033978,WES 237B,A00,494380,Staff,19,0,20,1
1713322036035,AESE 279B,A00,494370,Wade; Jon P,33,0,33,0
1713322037062,ANAR 135S,A00,494369,Braswell; Geoffrey E.,0,0,0,0
1713322038087,CAT 124RS,A01,519847,Geibel; William,17,0,20,3
1713322039115,CAT 125RS,A01,515971,Geibel; William,17,0,20,3
1713322040142,CLRE 250,A00,511389,Morris; Sheldon,9996,0,9999,3
1713322041167,CLRE 251,A00,507176,Mehta; Ravindra L.,9996,0,9999,3
1713322041167,CLRE 251,B00,511410,Mehta; Ravindra L.,9998,0,9999,1
1713322042196,CLRE 252,A00,507189,Cuomo; Raphael Eduardo,9998,0,9999,1
1713322043221,CLRE 253,A00,507199,Vaida; Florin,9997,0,9999,2
1713322043221,CLRE 253,B00,507202,Vaida; Florin,9999,0,9999,0
1713322044246,CLRE 259,A00,507211,Patel; Hemal,9996,0,9999,3
1713322045273,CLRE 260,A00,507221,Cuomo; Raphael Eduardo,9999,0,9999,0
1713322046303,CLRE 297,001,507242,Cuomo; Raphael Eduardo,9999,0,9999,0
1713322047327,CSE 191,A00,516875,Minnes Kemp; Mor Mia,9999,0,9999,0
1713322048352,CSS 201S,A01,494383,Staff,35,0,35,0
1713322049382,CSS 202S,A01,494387,Staff,35,0,35,0
1713322050413,EAP 100,A00,516065,Staff,9792,0,9999,207
1713322051440,ECE 45,A01,507414,Staff,52,0,60,8
1713322052466,ECE 100,A01,507416,Baghdadchi; Saharnaz,11,0,20,9
1713322052466,ECE 100,A02,507418,Baghdadchi; Saharnaz,20,0,20,0
1713322053493,ECE 111,A01,507420,Staff,39,0,50,11
1713322054521,ECE 197,001,548057,Sievenpiper; Daniel F.,9998,0,9999,1
1713322055547,EDS 115,A00,507243,Choi; Bailey Miyeon,28,0,28,0
1713322056576,EDS 117,A01,494379,Staff,23,0,25,2
1713322057600,EDS 125,A00,507246,Hopkins; Megan Beth,29,0,30,1
1713322058626,EDS 128A,A01,507264,Fargason; Sharon Gayle,26,0,26,0
1713322059649,EDS 128B,A01,507293,Pappas; Elizabeth,30,0,30,0
1713322060680,EDS 139,A00,507294,Fargason; Sharon Gayle,30,0,30,0
1713322060680,EDS 139,B00,507313,Pappas; Elizabeth,30,0,30,0
1713322061704,EDS 201,A00,507315,Staff,26,0,30,4
1713322062729,EDS 203,A01,507317,Halter; Christopher P.,26,0,30,4
1713322063757,EDS 204R,A01,507319,Halter; Christopher P.,3,0,30,27
1713322063757,EDS 204R,B01,507331,Heinzman; Erica M.,28,0,30,2
1713322064784,EDS 206R,A00,507332,Staff,4,0,30,26
1713322064784,EDS 206R,B00,507343,Staff,28,0,30,2
1713322065809,EDS 250,A00,507344,Hemans; Patricia Ann Benitez,36,0,40,4
1713322066834,EDS 281,A00,507345,Daly; Alan J.,18,0,18,0
1713322067861,EDS 284,A00,507350,Daly; Alan J.,16,0,16,0
1713322068886,EDS 286,A00,507359,Fine; Sarah,18,0,18,0
1713322069911,EDS 289C,A01,507361,Daly; Alan J.,18,0,18,0
1713322070935,EDS 290,A00,507366,Hofstetter; Carolyn,15,0,15,0
1713322071964,LIGM 5A,A00,507421,Fischer-Grunski; Eva K,20,0,20,0
1713322072992,LIGM 5B,A00,507423,Fischer-Grunski; Eva K,20,0,20,0
1713322074017,LIGM 5C,A00,507425,Fischer-Grunski; Eva K,20,0,20,0
1713322075047,LIIT 5AS,A00,507427,Carnelos; Chiara,20,0,20,0
1713322076072,LIIT 5BS,A00,507430,Carnelos; Chiara,20,0,20,0
1713322077096,LIIT 5CS,A00,507432,Carnelos; Chiara,20,0,20,0
1713322078124,LISP 5A,A00,507541,Munoz Sanchez; Alicia,18,0,20,2
1713322079152,LISP 5B,A00,507671,Munoz Sanchez; Alicia,16,0,20,4
1713322080183,LISP 5C,A00,507696,Munoz Sanchez; Alicia,16,0,20,4
1713322081218,MAE 197,001,528363,Boechler; Nicholas Sebastia,9998,0,9999,1
1713322082245,MATH 197,001,523477,Kedlaya; Kiran S.,9999,0,9999,0
1713322082245,MATH 197,002,563811,Zhang; Danna,9999,0,9999,0
1713322083270,MCWP 40R,A00,518780,Staff,20,0,20,0
1713322083270,MCWP 40R,B00,518781,Staff,19,0,20,1
1713322083270,MCWP 40R,C00,518783,Staff,19,0,20,1
1713322084302,MCWP 50R,A00,518791,Staff,20,0,20,0
1713322084302,MCWP 50R,B00,518792,Staff,17,0,20,3
1713322084302,MCWP 50R,C00,518793,Staff,19,0,20,1
1713322084302,MCWP 50R,D00,518794,Staff,18,0,20,2
1713322084302,MCWP 50R,E00,518795,Staff,16,0,20,4
1713322084302,MCWP 50R,F00,518796,Staff,19,0,20,1
1713322084302,MCWP 50R,G00,518797,Staff,19,0,20,1
1713322085326,MMW 12R,A01,514034,Herbst; Matthew,15,0,16,1
1713322085326,MMW 12R,A02,514035,Herbst; Matthew,16,0,16,0
1713322086353,MMW 13R,A01,514037,Staff,12,0,16,4
1713322086353,MMW 13R,A02,514039,Staff,16,0,16,0
1713322088402,SIO 295LS,A00,523233,Staff,19,0,30,11
1713322089428,SIO 295S,A00,523232,Staff,19,0,30,11
1713322090452,SOCI 117,A01,494376,Staff,2,0,5,3
1713322091476,WES 237B,A00,494380,Staff,19,0,20,1
1713322093536,AESE 279B,A00,494370,Wade; Jon P,33,0,33,0
1713322094561,ANAR 135S,A00,494369,Braswell; Geoffrey E.,0,0,0,0
1713322095586,CAT 124RS,A01,519847,Geibel; William,17,0,20,3
1713322096613,CAT 125RS,A01,515971,Geibel; William,17,0,20,3
1713322097639,CLRE 250,A00,511389,Morris; Sheldon,9996,0,9999,3
1713322098664,CLRE 251,A00,507176,Mehta; Ravindra L.,9996,0,9999,3
1713322098664,CLRE 251,B00,511410,Mehta; Ravindra L.,9998,0,9999,1
1713322099691,CLRE 252,A00,507189,Cuomo; Raphael Eduardo,9998,0,9999,1
1713322100719,CLRE 253,A00,507199,Vaida; Florin,9997,0,9999,2
1713322100719,CLRE 253,B00,507202,Vaida; Florin,9999,0,9999,0
1713322101746,CLRE 259,A00,507211,Patel; Hemal,9996,0,9999,3
1713322102770,CLRE 260,A00,507221,Cuomo; Raphael Eduardo,9999,0,9999,0
1713322103797,CLRE 297,001,507242,Cuomo; Raphael Eduardo,9999,0,9999,0
1713322104822,CSE 191,A00,516875,Minnes Kemp; Mor Mia,9999,0,9999,0
1713322105848,CSS 201S,A01,494383,Staff,35,0,35,0
1713322106876,CSS 202S,A01,494387,Staff,35,0,35,0
1713322107902,EAP 100,A00,516065,Staff,9792,0,9999,207
1713322108928,ECE 45,A01,507414,Staff,52,0,60,8
1713322110027,ECE 100,A01,507416,Baghdadchi; Saharnaz,11,0,20,9
1713322110027,ECE 100,A02,507418,Baghdadchi; Saharnaz,20,0,20,0
1713322111051,ECE 111,A01,507420,Staff,39,0,50,11
1713322112080,ECE 197,001,548057,Sievenpiper; Daniel F.,9998,0,9999,1
1713322113104,EDS 115,A00,507243,Choi; Bailey Miyeon,28,0,28,0
1713322114128,EDS 117,A01,494379,Staff,23,0,25,2
1713322115158,EDS 125,A00,507246,Hopkins; Megan Beth,29,0,30,1
1713322116186,EDS 128A,A01,507264,Fargason; Sharon Gayle,26,0,26,0
1713322117212,EDS 128B,A01,507293,Pappas; Elizabeth,30,0,30,0
1713322118240,EDS 139,A00,507294,Fargason; Sharon Gayle,30,0,30,0
1713322118240,EDS 139,B00,507313,Pappas; Elizabeth,30,0,30,0
1713322119264,EDS 201,A00,507315,Staff,26,0,30,4
1713322120289,EDS 203,A01,507317,Halter; Christopher P.,26,0,30,4
1713322121314,EDS 204R,A01,507319,Halter; Christopher P.,3,0,30,27
1713322121314,EDS 204R,B01,507331,Heinzman; Erica M.,28,0,30,2
1713322122339,EDS 206R,A00,507332,Staff,4,0,30,26
1713322122339,EDS 206R,B00,507343,Staff,28,0,30,2
1713322123364,EDS 250,A00,507344,Hemans; Patricia Ann Benitez,36,0,40,4
1713322124392,EDS 281,A00,507345,Daly; Alan J.,18,0,18,0
1713322125415,EDS 284,A00,507350,Daly; Alan J.,16,0,16,0
1713322126443,EDS 286,A00,507359,Fine; Sarah,18,0,18,0
1713322127467,EDS 289C,A01,507361,Daly; Alan J.,18,0,18,0
1713322128492,EDS 290,A00,507366,Hofstetter; Carolyn,15,0,15,0
1713322129518,LIGM 5A,A00,507421,Fischer-Grunski; Eva K,20,0,20,0
1713322130547,LIGM 5B,A00,507423,Fischer-Grunski; Eva K,20,0,20,0
1713322131576,LIGM 5C,A00,507425,Fischer-Grunski; Eva K,20,0,20,0
1713322132602,LIIT 5AS,A00,507427,Carnelos; Chiara,20,0,20,0
1713322133626,LIIT 5BS,A00,507430,Carnelos; Chiara,20,0,20,0
1713322134652,LIIT 5CS,A00,507432,Carnelos; Chiara,20,0,20,0
1713322135678,LISP 5A,A00,507541,Munoz Sanchez; Alicia,18,0,20,2
1713322136707,LISP 5B,A00,507671,Munoz Sanchez; Alicia,16,0,20,4
1713322137731,LISP 5C,A00,507696,Munoz Sanchez; Alicia,16,0,20,4
1713322138755,MAE 197,001,528363,Boechler; Nicholas Sebastia,9998,0,9999,1
1713322139781,MATH 197,001,523477,Kedlaya; Kiran S.,9999,0,9999,0
1713322139781,MATH 197,002,563811,Zhang; Danna,9999,0,9999,0
1713322140808,MCWP 40R,A00,518780,Staff,20,0,20,0
1713322140808,MCWP 40R,B00,518781,Staff,19,0,20,1
1713322140808,MCWP 40R,C00,518783,Staff,19,0,20,1
1713322141834,MCWP 50R,A00,518791,Staff,20,0,20,0
1713322141834,MCWP 50R,B00,518792,Staff,17,0,20,3
1713322141834,MCWP 50R,C00,518793,Staff,19,0,20,1
1713322141834,MCWP 50R,D00,518794,Staff,18,0,20,2
1713322141834,MCWP 50R,E00,518795,Staff,16,0,20,4
1713322141834,MCWP 50R,F00,518796,Staff,19,0,20,1
1713322141834,MCWP 50R,G00,518797,Staff,19,0,20,1
1713322142862,MMW 12R,A01,514034,Herbst; Matthew,15,0,16,1
1713322142862,MMW 12R,A02,514035,Herbst; Matthew,16,0,16,0
1713322143905,MMW 13R,A01,514037,Staff,12,0,16,4
1713322143905,MMW 13R,A02,514039,Staff,16,0,16,0
1713322145954,SIO 295LS,A00,523233,Staff,19,0,30,11
1713322146979,SIO 295S,A00,523232,Staff,19,0,30,11
1713322148003,SOCI 117,A01,494376,Staff,2,0,5,3
1713322149030,WES 237B,A00,494380,Staff,19,0,20,1
1713322151085,AESE 279B,A00,494370,Wade; Jon P,33,0,33,0
1713322152109,ANAR 135S,A00,494369,Braswell; Geoffrey E.,0,0,0,0
1713322153136,CAT 124RS,A01,519847,Geibel; William,17,0,20,3
1713322154161,CAT 125RS,A01,515971,Geibel; William,17,0,20,3
1713322155186,CLRE 250,A00,511389,Morris; Sheldon,9996,0,9999,3
1713322156210,CLRE 251,A00,507176,Mehta; Ravindra L.,9996,0,9999,3
1713322156210,CLRE 251,B00,511410,Mehta; Ravindra L.,9998,0,9999,1
1713322157235,CLRE 252,A00,507189,Cuomo; Raphael Eduardo,9998,0,9999,1
1713322158260,CLRE 253,A00,507199,Vaida; Florin,9997,0,9999,2
1713322158260,CLRE 253,B00,507202,Vaida; Florin,9999,0,9999,0
1713322159287,CLRE 259,A00,507211,Patel; Hemal,9996,0,9999,3
1713322160312,CLRE 260,A00,507221,Cuomo; Raphael Eduardo,9999,0,9999,0
1713322161339,CLRE 297,001,507242,Cuomo; Raphael Eduardo,9999,0,9999,0
1713322162372,CSE 191,A00,516875,Minnes Kemp; Mor Mia,9999,0,9999,0
1713322163401,CSS 201S,A01,494383,Staff,35,0,35,0
1713322164429,CSS 202S,A01,494387,Staff,35,0,35,0
1713322165452,EAP 100,A00,516065,Staff,9792,0,9999,207
1713322166481,ECE 45,A01,507414,Staff,52,0,60,8
1713322167505,ECE 100,A01,507416,Baghdadchi; Saharnaz,11,0,20,9
1713322167505,ECE 100,A02,507418,Baghdadchi; Saharnaz,20,0,20,0
1713322168533,ECE 111,A01,507420,Staff,39,0,50,11
1713322169557,ECE 197,001,548057,Sievenpiper; Daniel F.,9998,0,9999,1
1713322170582,EDS 115,A00,507243,Choi; Bailey Miyeon,28,0,28,0
1713322171606,EDS 117,A01,494379,Staff,23,0,25,2
1713322172631,EDS 125,A00,507246,Hopkins; Megan Beth,29,0,30,1
1713322173654,EDS 128A,A01,507264,Fargason; Sharon Gayle,26,0,26,0
1713322174692,EDS 128B,A01,507293,Pappas; Elizabeth,30,0,30,0
1713322175719,EDS 139,A00,507294,Fargason; Sharon Gayle,30,0,30,0
1713322175719,EDS 139,B00,507313,Pappas; Elizabeth,30,0,30,0
1713322176746,EDS 201,A00,507315,Staff,26,0,30,4
1713322177771,EDS 203,A01,507317,Halter; Christopher P.,26,0,30,4
1713322178797,EDS 204R,A01,507319,Halter; Christopher P.,3,0,30,27
1713322178797,EDS 204R,B01,507331,Heinzman; Erica M.,28,0,30,2
1713322179824,EDS 206R,A00,507332,Staff,4,0,30,26
1713322179824,EDS 206R,B00,507343,Staff,28,0,30,2
1713322180851,EDS 250,A00,507344,Hemans; Patricia Ann Benitez,36,0,40,4
1713322181878,EDS 281,A00,507345,Daly; Alan J.,18,0,18,0
1713322182904,EDS 284,A00,507350,Daly; Alan J.,16,0,16,0
1713322183931,EDS 286,A00,507359,Fine; Sarah,18,0,18,0
1713322184957,EDS 289C,A01,507361,Daly; Alan J.,18,0,18,0
1713322185982,EDS 290,A00,507366,Hofstetter; Carolyn,15,0,15,0
1713322187008,LIGM 5A,A00,507421,Fischer-Grunski; Eva K,20,0,20,0
1713322188035,LIGM 5B,A00,507423,Fischer-Grunski; Eva K,20,0,20,0
1713322189059,LIGM 5C,A00,507425,Fischer-Grunski; Eva K,20,0,20,0
1713322190084,LIIT 5AS,A00,507427,Carnelos; Chiara,20,0,20,0
1713322191109,LIIT 5BS,A00,507430,Carnelos; Chiara,20,0,20,0
1713322192134,LIIT 5CS,A00,507432,Carnelos; Chiara,20,0,20,0
1713322193163,LISP 5A,A00,507541,Munoz Sanchez; Alicia,18,0,20,2
1713322194187,LISP 5B,A00,507671,Munoz Sanchez; Alicia,16,0,20,4
1713322195216,LISP 5C,A00,507696,Munoz Sanchez; Alicia,16,0,20,4
1713322196240,MAE 197,001,528363,Boechler; Nicholas Sebastia,9998,0,9999,1
1713322197267,MATH 197,001,523477,Kedlaya; Kiran S.,9999,0,9999,0
1713322197267,MATH 197,002,563811,Zhang; Danna,9999,0,9999,0
1713322198293,MCWP 40R,A00,518780,Staff,20,0,20,0
1713322198293,MCWP 40R,B00,518781,Staff,19,0,20,1
1713322198293,MCWP 40R,C00,518783,Staff,19,0,20,1
1713322199319,MCWP 50R,A00,518791,Staff,20,0,20,0
1713322199319,MCWP 50R,B00,518792,Staff,17,0,20,3
1713322199319,MCWP 50R,C00,518793,Staff,19,0,20,1
1713322199319,MCWP 50R,D00,518794,Staff,18,0,20,2
1713322199319,MCWP 50R,E00,518795,Staff,16,0,20,4
1713322199319,MCWP 50R,F00,518796,Staff,19,0,20,1
1713322199319,MCWP 50R,G00,518797,Staff,19,0,20,1
1713322200343,MMW 12R,A01,514034,Herbst; Matthew,15,0,16,1
1713322200343,MMW 12R,A02,514035,Herbst; Matthew,16,0,16,0
1713322201368,MMW 13R,A01,514037,Staff,12,0,16,4
1713322201368,MMW 13R,A02,514039,Staff,16,0,16,0
1713322203425,SIO 295LS,A00,523233,Staff,19,0,30,11
1713322204448,SIO 295S,A00,523232,Staff,19,0,30,11
1713322205473,SOCI 117,A01,494376,Staff,2,0,5,3
1713322206496,WES 237B,A00,494380,Staff,19,0,20,1
1713322208555,AESE 279B,A00,494370,Wade; Jon P,33,0,33,0
1713322209584,ANAR 135S,A00,494369,Braswell; Geoffrey E.,0,0,0,0
1713322210609,CAT 124RS,A01,519847,Geibel; William,17,0,20,3
1713322211634,CAT 125RS,A01,515971,Geibel; William,17,0,20,3
1713322212658,CLRE 250,A00,511389,Morris; Sheldon,9996,0,9999,3
1713322213737,CLRE 251,A00,507176,Mehta; Ravindra L.,9996,0,9999,3
1713322213737,CLRE 251,B00,511410,Mehta; Ravindra L.,9998,0,9999,1
1713322214764,CLRE 252,A00,507189,Cuomo; Raphael Eduardo,9998,0,9999,1
1713322215802,CLRE 253,A00,507199,Vaida; Florin,9997,0,9999,2
1713322215802,CLRE 253,B00,507202,Vaida; Florin,9999,0,9999,0
1713322216828,CLRE 259,A00,507211,Patel; Hemal,9996,0,9999,3
1713322217855,CLRE 260,A00,507221,Cuomo; Raphael Eduardo,9999,0,9999,0
1713322218878,CLRE 297,001,507242,Cuomo; Raphael Eduardo,9999,0,9999,0
1713322219901,CSE 191,A00,516875,Minnes Kemp; Mor Mia,9999,0,9999,0
1713322220926,CSS 201S,A01,494383,Staff,35,0,35,0
1713322221950,CSS 202S,A01,494387,Staff,35,0,35,0
1713322222975,EAP 100,A00,516065,Staff,9792,0,9999,207
1713322224001,ECE 45,A01,507414,Staff,52,0,60,8
1713322225029,ECE 100,A01,507416,Baghdadchi; Saharnaz,11,0,20,9
1713322225029,ECE 100,A02,507418,Baghdadchi; Saharnaz,20,0,20,0
1713322226054,ECE 111,A01,507420,Staff,39,0,50,11
1713322227081,ECE 197,001,548057,Sievenpiper; Daniel F.,9998,0,9999,1
1713322228105,EDS 115,A00,507243,Choi; Bailey Miyeon,28,0,28,0
1713322229132,EDS 117,A01,494379,Staff,23,0,25,2
1713322230157,EDS 125,A00,507246,Hopkins; Megan Beth,29,0,30,1
1713322231182,EDS 128A,A01,507264,Fargason; Sharon Gayle,26,0,26,0
1713322232212,EDS 128B,A01,507293,Pappas; Elizabeth,30,0,30,0
1713322233235,EDS 139,A00,507294,Fargason; Sharon Gayle,30,0,30,0
1713322233235,EDS 139,B00,507313,Pappas; Elizabeth,30,0,30,0
1713322234262,EDS 201,A00,507315,Staff,26,0,30,4
1713322235290,EDS 203,A01,507317,Halter; Christopher P.,26,0,30,4
1713322236320,EDS 204R,A01,507319,Halter; Christopher P.,3,0,30,27
1713322236320,EDS 204R,B01,507331,Heinzman; Erica M.,28,0,30,2
1713322237344,EDS 206R,A00,507332,Staff,4,0,30,26
1713322237344,EDS 206R,B00,507343,Staff,28,0,30,2
1713322238372,EDS 250,A00,507344,Hemans; Patricia Ann Benitez,36,0,40,4
1713322239396,EDS 281,A00,507345,Daly; Alan J.,18,0,18,0
1713322240423,EDS 284,A00,507350,Daly; Alan J.,16,0,16,0
1713322241453,EDS 286,A00,507359,Fine; Sarah,18,0,18,0
1713322242477,EDS 289C,A01,507361,Daly; Alan J.,18,0,18,0
1713322243504,EDS 290,A00,507366,Hofstetter; Carolyn,15,0,15,0
1713322244533,LIGM 5A,A00,507421,Fischer-Grunski; Eva K,20,0,20,0
1713322245560,LIGM 5B,A00,507423,Fischer-Grunski; Eva K,20,0,20,0
1713322246589,LIGM 5C,A00,507425,Fischer-Grunski; Eva K,20,0,20,0
1713322247614,LIIT 5AS,A00,507427,Carnelos; Chiara,20,0,20,0
1713322248643,LIIT 5BS,A00,507430,Carnelos; Chiara,20,0,20,0
1713322249667,LIIT 5CS,A00,507432,Carnelos; Chiara,20,0,20,0
1713322250695,LISP 5A,A00,507541,Munoz Sanchez; Alicia,18,0,20,2
1713322251720,LISP 5B,A00,507671,Munoz Sanchez; Alicia,16,0,20,4
1713322252744,LISP 5C,A00,507696,Munoz Sanchez; Alicia,16,0,20,4
1713322253771,MAE 197,001,528363,Boechler; Nicholas Sebastia,9998,0,9999,1
1713322254799,MATH 197,001,523477,Kedlaya; Kiran S.,9999,0,9999,0
1713322254799,MATH 197,002,563811,Zhang; Danna,9999,0,9999,0
1713322255826,MCWP 40R,A00,518780,Staff,20,0,20,0
1713322255826,MCWP 40R,B00,518781,Staff,19,0,20,1
1713322255826,MCWP 40R,C00,518783,Staff,19,0,20,1
1713322256852,MCWP 50R,A00,518791,Staff,20,0,20,0
1713322256852,MCWP 50R,B00,518792,Staff,17,0,20,3
1713322256852,MCWP 50R,C00,518793,Staff,19,0,20,1
1713322256852,MCWP 50R,D00,518794,Staff,18,0,20,2
1713322256852,MCWP 50R,E00,518795,Staff,16,0,20,4
1713322256852,MCWP 50R,F00,518796,Staff,19,0,20,1
1713322256852,MCWP 50R,G00,518797,Staff,19,0,20,1
1713322257877,MMW 12R,A01,514034,Herbst; Matthew,15,0,16,1
1713322257877,MMW 12R,A02,514035,Herbst; Matthew,16,0,16,0
1713322258905,MMW 13R,A01,514037,Staff,12,0,16,4
1713322258905,MMW 13R,A02,514039,Staff,16,0,16,0
1713322260954,SIO 295LS,A00,523233,Staff,19,0,30,11
1713322261983,SIO 295S,A00,523232,Staff,19,0,30,11
1713322263009,SOCI 117,A01,494376,Staff,2,0,5,3
1713322264032,WES 237B,A00,494380,Staff,19,0,20,1
1713322266090,AESE 279B,A00,494370,Wade; Jon P,33,0,33,0
1713322267115,ANAR 135S,A00,494369,Braswell; Geoffrey E.,0,0,0,0
1713322268143,CAT 124RS,A01,519847,Geibel; William,17,0,20,3
1713322269171,CAT 125RS,A01,515971,Geibel; William,17,0,20,3
1713322270194,CLRE 250,A00,511389,Morris; Sheldon,9996,0,9999,3
1713322271219,CLRE 251,A00,507176,Mehta; Ravindra L.,9996,0,9999,3
1713322271219,CLRE 251,B00,511410,Mehta; Ravindra L.,9998,0,9999,1
1713322272249,CLRE 252,A00,507189,Cuomo; Raphael Eduardo,9998,0,9999,1
1713322273273,CLRE 253,A00,507199,Vaida; Florin,9997,0,9999,2
1713322273273,CLRE 253,B00,507202,Vaida; Florin,9999,0,9999,0
1713322274300,CLRE 259,A00,507211,Patel; Hemal,9996,0,9999,3
1713322275328,CLRE 260,A00,507221,Cuomo; Raphael Eduardo,9999,0,9999,0
1713322276356,CLRE 297,001,507242,Cuomo; Raphael Eduardo,9999,0,9999,0
1713322277384,CSE 191,A00,516875,Minnes Kemp; Mor Mia,9999,0,9999,0
1713322278414,CSS 201S,A01,494383,Staff,35,0,35,0
1713322279439,CSS 202S,A01,494387,Staff,35,0,35,0
1713322280462,EAP 100,A00,516065,Staff,9792,0,9999,207
1713322281491,ECE 45,A01,507414,Staff,52,0,60,8
1713322282517,ECE 100,A01,507416,Baghdadchi; Saharnaz,11,0,20,9
1713322282517,ECE 100,A02,507418,Baghdadchi; Saharnaz,20,0,20,0
1713322283541,ECE 111,A01,507420,Staff,39,0,50,11
1713322284565,ECE 197,001,548057,Sievenpiper; Daniel F.,9998,0,9999,1
1713322285590,EDS 115,A00,507243,Choi; Bailey Miyeon,28,0,28,0
1713322286618,EDS 117,A01,494379,Staff,23,0,25,2
1713322287646,EDS 125,A00,507246,Hopkins; Megan Beth,29,0,30,1
1713322288671,EDS 128A,A01,507264,Fargason; Sharon Gayle,26,0,26,0
1713322289697,EDS 128B,A01,507293,Pappas; Elizabeth,30,0,30,0
1713322290725,EDS 139,A00,507294,Fargason; Sharon Gayle,30,0,30,0
1713322290725,EDS 139,B00,507313,Pappas; Elizabeth,30,0,30,0
1713322291751,EDS 201,A00,507315,Staff,26,0,30,4
1713322292776,EDS 203,A01,507317,Halter; Christopher P.,26,0,30,4
1713322293806,EDS 204R,A01,507319,Halter; Christopher P.,3,0,30,27
1713322293806,EDS 204R,B01,507331,Heinzman; Erica M.,28,0,30,2
1713322294835,EDS 206R,A00,507332,Staff,4,0,30,26
1713322294835,EDS 206R,B00,507343,Staff,28,0,30,2
1713322295860,EDS 250,A00,507344,Hemans; Patricia Ann Benitez,36,0,40,4
1713322296886,EDS 281,A00,507345,Daly; Alan J.,18,0,18,0
1713322297912,EDS 284,A00,507350,Daly; Alan J.,16,0,16,0
1713322298940,EDS 286,A00,507359,Fine; Sarah,18,0,18,0
1713322299964,EDS 289C,A01,507361,Daly; Alan J.,18,0,18,0
1713322300989,EDS 290,A00,507366,Hofstetter; Carolyn,15,0,15,0
1713322302016,LIGM 5A,A00,507421,Fischer-Grunski; Eva K,20,0,20,0
1713322303042,LIGM 5B,A00,507423,Fischer-Grunski; Eva K,20,0,20,0
1713322304071,LIGM 5C,A00,507425,Fischer-Grunski; Eva K,20,0,20,0
1713322305099,LIIT 5AS,A00,507427,Carnelos; Chiara,20,0,20,0
1713322306124,LIIT 5BS,A00,507430,Carnelos; Chiara,20,0,20,0
1713322307149,LIIT 5CS,A00,507432,Carnelos; Chiara,20,0,20,0
1713322308173,LISP 5A,A00,507541,Munoz Sanchez; Alicia,18,0,20,2
1713322309202,LISP 5B,A00,507671,Munoz Sanchez; Alicia,16,0,20,4
1713322310227,LISP 5C,A00,507696,Munoz Sanchez; Alicia,16,0,20,4
1713322311253,MAE 197,001,528363,Boechler; Nicholas Sebastia,9998,0,9999,1
1713322312279,MATH 197,001,523477,Kedlaya; Kiran S.,9999,0,9999,0
1713322312279,MATH 197,002,563811,Zhang; Danna,9999,0,9999,0
1713322313306,MCWP 40R,A00,518780,Staff,20,0,20,0
1713322313306,MCWP 40R,B00,518781,Staff,19,0,20,1
1713322313306,MCWP 40R,C00,518783,Staff,19,0,20,1
1713322314336,MCWP 50R,A00,518791,Staff,20,0,20,0
1713322314336,MCWP 50R,B00,518792,Staff,17,0,20,3
1713322314336,MCWP 50R,C00,518793,Staff,19,0,20,1
1713322314336,MCWP 50R,D00,518794,Staff,18,0,20,2
1713322314336,MCWP 50R,E00,518795,Staff,16,0,20,4
1713322314336,MCWP 50R,F00,518796,Staff,19,0,20,1
1713322314336,MCWP 50R,G00,518797,Staff,19,0,20,1
1713322315360,MMW 12R,A01,514034,Herbst; Matthew,15,0,16,1
1713322315360,MMW 12R,A02,514035,Herbst; Matthew,16,0,16,0
1713322316385,MMW 13R,A01,514037,Staff,12,0,16,4
1713322316385,MMW 13R,A02,514039,Staff,16,0,16,0
1713322318492,SIO 295LS,A00,523233,Staff,19,0,30,11
1713322319516,SIO 295S,A00,523232,Staff,19,0,30,11
1713322320542,SOCI 117,A01,494376,Staff,2,0,5,3
1713322321569,WES 237B,A00,494380,Staff,19,0,20,1
1713322323630,AESE 279B,A00,494370,Wade; Jon P,33,0,33,0
1713322324658,ANAR 135S,A00,494369,Braswell; Geoffrey E.,0,0,0,0
1713322325683,CAT 124RS,A01,519847,Geibel; William,17,0,20,3
1713322326710,CAT 125RS,A01,515971,Geibel; William,17,0,20,3
1713322327735,CLRE 250,A00,511389,Morris; Sheldon,9996,0,9999,3
1713322328764,CLRE 251,A00,507176,Mehta; Ravindra L.,9996,0,9999,3
1713322328764,CLRE 251,B00,511410,Mehta; Ravindra L.,9998,0,9999,1
1713322329792,CLRE 252,A00,507189,Cuomo; Raphael Eduardo,9998,0,9999,1
1713322330821,CLRE 253,A00,507199,Vaida; Florin,9997,0,9999,2
1713322330821,CLRE 253,B00,507202,Vaida; Florin,9999,0,9999,0
1713322331848,CLRE 259,A00,507211,Patel; Hemal,9996,0,9999,3
1713322332876,CLRE 260,A00,507221,Cuomo; Raphael Eduardo,9999,0,9999,0
1713322333901,CLRE 297,001,507242,Cuomo; Raphael Eduardo,9999,0,9999,0
1713322334927,CSE 191,A00,516875,Minnes Kemp; Mor Mia,9999,0,9999,0
1713322335953,CSS 201S,A01,494383,Staff,35,0,35,0
1713322336977,CSS 202S,A01,494387,Staff,35,0,35,0
1713322338003,EAP 100,A00,516065,Staff,9792,0,9999,207
1713322339032,ECE 45,A01,507414,Staff,52,0,60,8
1713322340058,ECE 100,A01,507416,Baghdadchi; Saharnaz,11,0,20,9
1713322340058,ECE 100,A02,507418,Baghdadchi; Saharnaz,20,0,20,0
1713322341084,ECE 111,A01,507420,Staff,39,0,50,11
1713322342109,ECE 197,001,548057,Sievenpiper; Daniel F.,9998,0,9999,1
1713322343135,EDS 115,A00,507243,Choi; Bailey Miyeon,28,0,28,0
1713322344161,EDS 117,A01,494379,Staff,23,0,25,2
1713322345185,EDS 125,A00,507246,Hopkins; Megan Beth,29,0,30,1
1713322346216,EDS 128A,A01,507264,Fargason; Sharon Gayle,26,0,26,0
1713322347239,EDS 128B,A01,507293,Pappas; Elizabeth,30,0,30,0
1713322348266,EDS 139,A00,507294,Fargason; Sharon Gayle,30,0,30,0
1713322348266,EDS 139,B00,507313,Pappas; Elizabeth,30,0,30,0
1713322349290,EDS 201,A00,507315,Staff,26,0,30,4
1713322350318,EDS 203,A01,507317,Halter; Christopher P.,26,0,30,4
1713322351342,EDS 204R,A01,507319,Halter; Christopher P.,3,0,30,27
1713322351342,EDS 204R,B01,507331,Heinzman; Erica M.,28,0,30,2
1713322352367,EDS 206R,A00,507332,Staff,4,0,30,26
1713322352367,EDS 206R,B00,507343,Staff,28,0,30,2
1713322353392,EDS 250,A00,507344,Hemans; Patricia Ann Benitez,36,0,40,4
1713322354418,EDS 281,A00,507345,Daly; Alan J.,18,0,18,0
1713322355442,EDS 284,A00,507350,Daly; Alan J.,16,0,16,0
1713322356468,EDS 286,A00,507359,Fine; Sarah,18,0,18,0
1713322357494,EDS 289C,A01,507361,Daly; Alan J.,18,0,18,0
1713322358521,EDS 290,A00,507366,Hofstetter; Carolyn,15,0,15,0
1713322359546,LIGM 5A,A00,507421,Fischer-Grunski; Eva K,20,0,20,0
1713322360570,LIGM 5B,A00,507423,Fischer-Grunski; Eva K,20,0,20,0
1713322361595,LIGM 5C,A00,507425,Fischer-Grunski; Eva K,20,0,20,0
1713322362622,LIIT 5AS,A00,507427,Carnelos; Chiara,20,0,20,0
1713322363647,LIIT 5BS,A00,507430,Carnelos; Chiara,20,0,20,0
1713322364673,LIIT 5CS,A00,507432,Carnelos; Chiara,20,0,20,0
1713322365697,LISP 5A,A00,507541,Munoz Sanchez; Alicia,18,0,20,2
1713322366724,LISP 5B,A00,507671,Munoz Sanchez; Alicia,16,0,20,4
1713322367748,LISP 5C,A00,507696,Munoz Sanchez; Alicia,16,0,20,4
1713322368773,MAE 197,001,528363,Boechler; Nicholas Sebastia,9998,0,9999,1
1713322369801,MATH 197,001,523477,Kedlaya; Kiran S.,9999,0,9999,0
1713322369801,MATH 197,002,563811,Zhang; Danna,9999,0,9999,0
1713322370826,MCWP 40R,A00,518780,Staff,20,0,20,0
1713322370826,MCWP 40R,B00,518781,Staff,19,0,20,1
1713322370826,MCWP 40R,C00,518783,Staff,19,0,20,1
1713322371852,MCWP 50R,A00,518791,Staff,20,0,20,0
1713322371852,MCWP 50R,B00,518792,Staff,17,0,20,3
1713322371852,MCWP 50R,C00,518793,Staff,19,0,20,1
1713322371852,MCWP 50R,D00,518794,Staff,17,0,20,3
1713322371852,MCWP 50R,E00,518795,Staff,16,0,20,4
1713322371852,MCWP 50R,F00,518796,Staff,19,0,20,1
1713322371852,MCWP 50R,G00,518797,Staff,19,0,20,1
1713322372878,MMW 12R,A01,514034,Herbst; Matthew,15,0,16,1
1713322372878,MMW 12R,A02,514035,Herbst; Matthew,16,0,16,0
1713322373903,MMW 13R,A01,514037,Staff,12,0,16,4
1713322373903,MMW 13R,A02,514039,Staff,16,0,16,0
1713322375961,SIO 295LS,A00,523233,Staff,19,0,30,11
1713322376984,SIO 295S,A00,523232,Staff,19,0,30,11
1713322378011,SOCI 117,A01,494376,Staff,2,0,5,3
1713322379036,WES 237B,A00,494380,Staff,19,0,20,1
1713322381100,AESE 279B,A00,494370,Wade; Jon P,33,0,33,0
1713322382125,ANAR 135S,A00,494369,Braswell; Geoffrey E.,0,0,0,0
1713322383153,CAT 124RS,A01,519847,Geibel; William,17,0,20,3
1713322384191,CAT 125RS,A01,515971,Geibel; William,17,0,20,3
1713322385215,CLRE 250,A00,511389,Morris; Sheldon,9996,0,9999,3
1713322386242,CLRE 251,A00,507176,Mehta; Ravindra L.,9996,0,9999,3
1713322386242,CLRE 251,B00,511410,Mehta; Ravindra L.,9998,0,9999,1
1713322387268,CLRE 252,A00,507189,Cuomo; Raphael Eduardo,9998,0,9999,1
1713322388293,CLRE 253,A00,507199,Vaida; Florin,9997,0,9999,2
1713322388293,CLRE 253,B00,507202,Vaida; Florin,9999,0,9999,0
1713322389317,CLRE 259,A00,507211,Patel; Hemal,9996,0,9999,3
1713322390340,CLRE 260,A00,507221,Cuomo; Raphael Eduardo,9999,0,9999,0
1713322391363,CLRE 297,001,507242,Cuomo; Raphael Eduardo,9999,0,9999,0
1713322392390,CSE 191,A00,516875,Minnes Kemp; Mor Mia,9999,0,9999,0
1713322393418,CSS 201S,A01,494383,Staff,35,0,35,0
1713322394442,CSS 202S,A01,494387,Staff,35,0,35,0
1713322395466,EAP 100,A00,516065,Staff,9792,0,9999,207
1713322396492,ECE 45,A01,507414,Staff,52,0,60,8
1713322397521,ECE 100,A01,507416,Baghdadchi; Saharnaz,11,0,20,9
1713322397521,ECE 100,A02,507418,Baghdadchi; Saharnaz,20,0,20,0
1713322398545,ECE 111,A01,507420,Staff,39,0,50,11
1713322399570,ECE 197,001,548057,Sievenpiper; Daniel F.,9998,0,9999,1
1713322400593,EDS 115,A00,507243,Choi; Bailey Miyeon,28,0,28,0
1713322401621,EDS 117,A01,494379,Staff,23,0,25,2
1713322402649,EDS 125,A00,507246,Hopkins; Megan Beth,29,0,30,1
1713322403673,EDS 128A,A01,507264,Fargason; Sharon Gayle,26,0,26,0
1713322404702,EDS 128B,A01,507293,Pappas; Elizabeth,30,0,30,0
1713322405727,EDS 139,A00,507294,Fargason; Sharon Gayle,30,0,30,0
1713322405727,EDS 139,B00,507313,Pappas; Elizabeth,30,0,30,0
1713322406752,EDS 201,A00,507315,Staff,26,0,30,4
1713322407777,EDS 203,A01,507317,Halter; Christopher P.,26,0,30,4
1713322408806,EDS 204R,A01,507319,Halter; Christopher P.,3,0,30,27
1713322408806,EDS 204R,B01,507331,Heinzman; Erica M.,28,0,30,2
1713322409833,EDS 206R,A00,507332,Staff,4,0,30,26
1713322409833,EDS 206R,B00,507343,Staff,28,0,30,2
1713322410862,EDS 250,A00,507344,Hemans; Patricia Ann Benitez,36,0,40,4
1713322411892,EDS 281,A00,507345,Daly; Alan J.,18,0,18,0
1713322412920,EDS 284,A00,507350,Daly; Alan J.,16,0,16,0
1713322413948,EDS 286,A00,507359,Fine; Sarah,18,0,18,0
1713322414973,EDS 289C,A01,507361,Daly; Alan J.,18,0,18,0
1713322416001,EDS 290,A00,507366,Hofstetter; Carolyn,15,0,15,0
1713322417026,LIGM 5A,A00,507421,Fischer-Grunski; Eva K,20,0,20,0
1713322418049,LIGM 5B,A00,507423,Fischer-Grunski; Eva K,20,0,20,0
1713322419073,LIGM 5C,A00,507425,Fischer-Grunski; Eva K,20,0,20,0
1713322420098,LIIT 5AS,A00,507427,Carnelos; Chiara,20,0,20,0
1713322421178,LIIT 5BS,A00,507430,Carnelos; Chiara,20,0,20,0
1713322422202,LIIT 5CS,A00,507432,Carnelos; Chiara,20,0,20,0
1713322423226,LISP 5A,A00,507541,Munoz Sanchez; Alicia,18,0,20,2
1713322424253,LISP 5B,A00,507671,Munoz Sanchez; Alicia,16,0,20,4
1713322425280,LISP 5C,A00,507696,Munoz Sanchez; Alicia,16,0,20,4
1713322426306,MAE 197,001,528363,Boechler; Nicholas Sebastia,9998,0,9999,1
1713322427333,MATH 197,001,523477,Kedlaya; Kiran S.,9999,0,9999,0
1713322427333,MATH 197,002,563811,Zhang; Danna,9999,0,9999,0
1713322428360,MCWP 40R,A00,518780,Staff,20,0,20,0
1713322428360,MCWP 40R,B00,518781,Staff,19,0,20,1
1713322428360,MCWP 40R,C00,518783,Staff,19,0,20,1
1713322429388,MCWP 50R,A00,518791,Staff,20,0,20,0
1713322429388,MCWP 50R,B00,518792,Staff,17,0,20,3
1713322429388,MCWP 50R,C00,518793,Staff,19,0,20,1
1713322429388,MCWP 50R,D00,518794,Staff,17,0,20,3
1713322429388,MCWP 50R,E00,518795,Staff,16,0,20,4
1713322429388,MCWP 50R,F00,518796,Staff,19,0,20,1
1713322429388,MCWP 50R,G00,518797,Staff,19,0,20,1
1713322430415,MMW 12R,A01,514034,Herbst; Matthew,15,0,16,1
1713322430415,MMW 12R,A02,514035,Herbst; Matthew,16,0,16,0
1713322431440,MMW 13R,A01,514037,Staff,12,0,16,4
1713322431440,MMW 13R,A02,514039,Staff,16,0,16,0
1713322433491,SIO 295LS,A00,523233,Staff,19,0,30,11
1713322434515,SIO 295S,A00,523232,Staff,19,0,30,11
1713322435541,SOCI 117,A01,494376,Staff,2,0,5,3
1713322436568,WES 237B,A00,494380,Staff,19,0,20,1
1713322438626,AESE 279B,A00,494370,Wade; Jon P,33,0,33,0
1713322439651,ANAR 135S,A00,494369,Braswell; Geoffrey E.,0,0,0,0
1713322440678,CAT 124RS,A01,519847,Geibel; William,17,0,20,3
1713322441704,CAT 125RS,A01,515971,Geibel; William,17,0,20,3
1713322442728,CLRE 250,A00,511389,Morris; Sheldon,9996,0,9999,3
1713322443754,CLRE 251,A00,507176,Mehta; Ravindra L.,9996,0,9999,3
1713322443754,CLRE 251,B00,511410,Mehta; Ravindra L.,9998,0,9999,1
1713322444778,CLRE 252,A00,507189,Cuomo; Raphael Eduardo,9998,0,9999,1
1713322445807,CLRE 253,A00,507199,Vaida; Florin,9997,0,9999,2
1713322445807,CLRE 253,B00,507202,Vaida; Florin,9999,0,9999,0
1713322446832,CLRE 259,A00,507211,Patel; Hemal,9996,0,9999,3
1713322447856,CLRE 260,A00,507221,Cuomo; Raphael Eduardo,9999,0,9999,0
1713322448880,CLRE 297,001,507242,Cuomo; Raphael Eduardo,9999,0,9999,0
1713322449910,CSE 191,A00,516875,Minnes Kemp; Mor Mia,9999,0,9999,0
1713322450936,CSS 201S,A01,494383,Staff,35,0,35,0
1713322451961,CSS 202S,A01,494387,Staff,35,0,35,0
1713322452991,EAP 100,A00,516065,Staff,9792,0,9999,207
1713322454016,ECE 45,A01,507414,Staff,52,0,60,8
1713322455044,ECE 100,A01,507416,Baghdadchi; Saharnaz,11,0,20,9
1713322455044,ECE 100,A02,507418,Baghdadchi; Saharnaz,20,0,20,0
1713322456067,ECE 111,A01,507420,Staff,39,0,50,11
1713322457095,ECE 197,001,548057,Sievenpiper; Daniel F.,9998,0,9999,1
1713322458123,EDS 115,A00,507243,Choi; Bailey Miyeon,28,0,28,0
1713322459148,EDS 117,A01,494379,Staff,23,0,25,2
1713322460175,EDS 125,A00,507246,Hopkins; Megan Beth,29,0,30,1
1713322461201,EDS 128A,A01,507264,Fargason; Sharon Gayle,26,0,26,0
1713322462230,EDS 128B,A01,507293,Pappas; Elizabeth,30,0,30,0
1713322463257,EDS 139,A00,507294,Fargason; Sharon Gayle,30,0,30,0
1713322463257,EDS 139,B00,507313,Pappas; Elizabeth,30,0,30,0
1713322464281,EDS 201,A00,507315,Staff,26,0,30,4
1713322465307,EDS 203,A01,507317,Halter; Christopher P.,26,0,30,4
1713322466337,EDS 204R,A01,507319,Halter; Christopher P.,3,0,30,27
1713322466337,EDS 204R,B01,507331,Heinzman; Erica M.,28,0,30,2
1713322467361,EDS 206R,A00,507332,Staff,4,0,30,26
1713322467361,EDS 206R,B00,507343,Staff,28,0,30,2
1713322468385,EDS 250,A00,507344,Hemans; Patricia Ann Benitez,36,0,40,4
1713322469410,EDS 281,A00,507345,Daly; Alan J.,18,0,18,0
1713322470435,EDS 284,A00,507350,Daly; Alan J.,16,0,16,0
1713322471462,EDS 286,A00,507359,Fine; Sarah,18,0,18,0
1713322472489,EDS 289C,A01,507361,Daly; Alan J.,18,0,18,0
1713322473513,EDS 290,A00,507366,Hofstetter; Carolyn,15,0,15,0
1713322474662,LIGM 5A,A00,507421,Fischer-Grunski; Eva K,20,0,20,0
1713322475687,LIGM 5B,A00,507423,Fischer-Grunski; Eva K,20,0,20,0
1713322476713,LIGM 5C,A00,507425,Fischer-Grunski; Eva K,20,0,20,0
1713322477741,LIIT 5AS,A00,507427,Carnelos; Chiara,20,0,20,0
1713322478767,LIIT 5BS,A00,507430,Carnelos; Chiara,20,0,20,0
1713322479797,LIIT 5CS,A00,507432,Carnelos; Chiara,20,0,20,0
1713322480824,LISP 5A,A00,507541,Munoz Sanchez; Alicia,18,0,20,2
1713322481853,LISP 5B,A00,507671,Munoz Sanchez; Alicia,16,0,20,4
1713322482878,LISP 5C,A00,507696,Munoz Sanchez; Alicia,16,0,20,4
1713322483907,MAE 197,001,528363,Boechler; Nicholas Sebastia,9998,0,9999,1
1713322484935,MATH 197,001,523477,Kedlaya; Kiran S.,9999,0,9999,0
1713322484935,MATH 197,002,563811,Zhang; Danna,9999,0,9999,0
1713322485960,MCWP 40R,A00,518780,Staff,20,0,20,0
1713322485960,MCWP 40R,B00,518781,Staff,19,0,20,1
1713322485960,MCWP 40R,C00,518783,Staff,19,0,20,1
1713322486985,MCWP 50R,A00,518791,Staff,20,0,20,0
1713322486985,MCWP 50R,B00,518792,Staff,17,0,20,3
1713322486985,MCWP 50R,C00,518793,Staff,19,0,20,1
1713322486985,MCWP 50R,D00,518794,Staff,17,0,20,3
1713322486985,MCWP 50R,E00,518795,Staff,16,0,20,4
1713322486985,MCWP 50R,F00,518796,Staff,19,0,20,1
1713322486985,MCWP 50R,G00,518797,Staff,19,0,20,1
1713322488013,MMW 12R,A01,514034,Herbst; Matthew,15,0,16,1
1713322488013,MMW 12R,A02,514035,Herbst; Matthew,16,0,16,0
1713322489037,MMW 13R,A01,514037,Staff,12,0,16,4
1713322489037,MMW 13R,A02,514039,Staff,16,0,16,0
1713322491091,SIO 295LS,A00,523233,Staff,19,0,30,11
1713322492117,SIO 295S,A00,523232,Staff,19,0,30,11
1713322493143,SOCI 117,A01,494376,Staff,2,0,5,3
1713322494169,WES 237B,A00,494380,Staff,19,0,20,1
1713322496235,AESE 279B,A00,494370,Wade; Jon P,33,0,33,0
1713322497259,ANAR 135S,A00,494369,Braswell; Geoffrey E.,0,0,0,0
1713322498287,CAT 124RS,A01,519847,Geibel; William,17,0,20,3
1713322499312,CAT 125RS,A01,515971,Geibel; William,17,0,20,3
1713322500336,CLRE 250,A00,511389,Morris; Sheldon,9996,0,9999,3
1713322501360,CLRE 251,A00,507176,Mehta; Ravindra L.,9996,0,9999,3
1713322501360,CLRE 251,B00,511410,Mehta; Ravindra L.,9998,0,9999,1
1713322502391,CLRE 252,A00,507189,Cuomo; Raphael Eduardo,9998,0,9999,1
1713322503414,CLRE 253,A00,507199,Vaida; Florin,9997,0,9999,2
1713322503414,CLRE 253,B00,507202,Vaida; Florin,9999,0,9999,0
1713322504439,CLRE 259,A00,507211,Patel; Hemal,9996,0,9999,3
1713322505465,CLRE 260,A00,507221,Cuomo; Raphael Eduardo,9999,0,9999,0
1713322506490,CLRE 297,001,507242,Cuomo; Raphael Eduardo,9999,0,9999,0
1713322507518,CSE 191,A00,516875,Minnes Kemp; Mor Mia,9999,0,9999,0
1713322508548,CSS 201S,A01,494383,Staff,35,0,35,0
1713322509572,CSS 202S,A01,494387,Staff,35,0,35,0
1713322510600,EAP 100,A00,516065,Staff,9792,0,9999,207
1713322511624,ECE 45,A01,507414,Staff,52,0,60,8
1713322512648,ECE 100,A01,507416,Baghdadchi; Saharnaz,11,0,20,9
1713322512648,ECE 100,A02,507418,Baghdadchi; Saharnaz,20,0,20,0
1713322513674,ECE 111,A01,507420,Staff,39,0,50,11
1713322514698,ECE 197,001,548057,Sievenpiper; Daniel F.,9998,0,9999,1
1713322515726,EDS 115,A00,507243,Choi; Bailey Miyeon,28,0,28,0
1713322516755,EDS 117,A01,494379,Staff,23,0,25,2
1713322517784,EDS 125,A00,507246,Hopkins; Megan Beth,29,0,30,1
1713322518813,EDS 128A,A01,507264,Fargason; Sharon Gayle,26,0,26,0
1713322519841,EDS 128B,A01,507293,Pappas; Elizabeth,30,0,30,0
1713322520866,EDS 139,A00,507294,Fargason; Sharon Gayle,30,0,30,0
1713322520866,EDS 139,B00,507313,Pappas; Elizabeth,30,0,30,0
1713322521890,EDS 201,A00,507315,Staff,26,0,30,4
1713322522916,EDS 203,A01,507317,Halter; Christopher P.,26,0,30,4
1713322523942,EDS 204R,A01,507319,Halter; Christopher P.,3,0,30,27
1713322523942,EDS 204R,B01,507331,Heinzman; Erica M.,28,0,30,2
1713322525022,EDS 206R,A00,507332,Staff,4,0,30,26
1713322525022,EDS 206R,B00,507343,Staff,28,0,30,2
1713322526047,EDS 250,A00,507344,Hemans; Patricia Ann Benitez,36,0,40,4
1713322527072,EDS 281,A00,507345,Daly; Alan J.,18,0,18,0
1713322528097,EDS 284,A00,507350,Daly; Alan J.,16,0,16,0
1713322529121,EDS 286,A00,507359,Fine; Sarah,18,0,18,0
1713322530150,EDS 289C,A01,507361,Daly; Alan J.,18,0,18,0
1713322531175,EDS 290,A00,507366,Hofstetter; Carolyn,15,0,15,0
1713322532200,LIGM 5A,A00,507421,Fischer-Grunski; Eva K,20,0,20,0
1713322533226,LIGM 5B,A00,507423,Fischer-Grunski; Eva K,20,0,20,0
1713322534252,LIGM 5C,A00,507425,Fischer-Grunski; Eva K,20,0,20,0
1713322535278,LIIT 5AS,A00,507427,Carnelos; Chiara,20,0,20,0
1713322536304,LIIT 5BS,A00,507430,Carnelos; Chiara,20,0,20,0
1713322537332,LIIT 5CS,A00,507432,Carnelos; Chiara,20,0,20,0
1713322538358,LISP 5A,A00,507541,Munoz Sanchez; Alicia,18,0,20,2
1713322539385,LISP 5B,A00,507671,Munoz Sanchez; Alicia,16,0,20,4
1713322540414,LISP 5C,A00,507696,Munoz Sanchez; Alicia,16,0,20,4
1713322541440,MAE 197,001,528363,Boechler; Nicholas Sebastia,9998,0,9999,1
1713322542465,MATH 197,001,523477,Kedlaya; Kiran S.,9999,0,9999,0
1713322542465,MATH 197,002,563811,Zhang; Danna,9999,0,9999,0
1713322543491,MCWP 40R,A00,518780,Staff,20,0,20,0
1713322543491,MCWP 40R,B00,518781,Staff,19,0,20,1
1713322543491,MCWP 40R,C00,518783,Staff,19,0,20,1
1713322544520,MCWP 50R,A00,518791,Staff,20,0,20,0
1713322544520,MCWP 50R,B00,518792,Staff,17,0,20,3
1713322544520,MCWP 50R,C00,518793,Staff,19,0,20,1
1713322544520,MCWP 50R,D00,518794,Staff,17,0,20,3
1713322544520,MCWP 50R,E00,518795,Staff,16,0,20,4
1713322544520,MCWP 50R,F00,518796,Staff,19,0,20,1
1713322544520,MCWP 50R,G00,518797,Staff,19,0,20,1
1713322545544,MMW 12R,A01,514034,Herbst; Matthew,15,0,16,1
1713322545544,MMW 12R,A02,514035,Herbst; Matthew,16,0,16,0
1713322546572,MMW 13R,A01,514037,Staff,12,0,16,4
1713322546572,MMW 13R,A02,514039,Staff,16,0,16,0
1713322548626,SIO 295LS,A00,523233,Staff,19,0,30,11
1713322549654,SIO 295S,A00,523232,Staff,19,0,30,11
1713322550682,SOCI 117,A01,494376,Staff,2,0,5,3
1713322551707,WES 237B,A00,494380,Staff,19,0,20,1
1713322553768,AESE 279B,A00,494370,Wade; Jon P,33,0,33,0
1713322554793,ANAR 135S,A00,494369,Braswell; Geoffrey E.,0,0,0,0
1713322555816,CAT 124RS,A01,519847,Geibel; William,17,0,20,3
1713322556841,CAT 125RS,A01,515971,Geibel; William,17,0,20,3
1713322557869,CLRE 250,A00,511389,Morris; Sheldon,9996,0,9999,3
1713322558898,CLRE 251,A00,507176,Mehta; Ravindra L.,9996,0,9999,3
1713322558898,CLRE 251,B00,511410,Mehta; Ravindra L.,9998,0,9999,1
1713322559925,CLRE 252,A00,507189,Cuomo; Raphael Eduardo,9998,0,9999,1
1713322560953,CLRE 253,A00,507199,Vaida; Florin,9997,0,9999,2
1713322560953,CLRE 253,B00,507202,Vaida; Florin,9999,0,9999,0
1713322561976,CLRE 259,A00,507211,Patel; Hemal,9996,0,9999,3
1713322563006,CLRE 260,A00,507221,Cuomo; Raphael Eduardo,9999,0,9999,0
1713322564034,CLRE 297,001,507242,Cuomo; Raphael Eduardo,9999,0,9999,0
1713322565063,CSE 191,A00,516875,Minnes Kemp; Mor Mia,9999,0,9999,0
1713322566087,CSS 201S,A01,494383,Staff,35,0,35,0
1713322567115,CSS 202S,A01,494387,Staff,35,0,35,0
1713322568140,EAP 100,A00,516065,Staff,9792,0,9999,207
1713322569164,ECE 45,A01,507414,Staff,52,0,60,8
1713322570191,ECE 100,A01,507416,Baghdadchi; Saharnaz,11,0,20,9
1713322570191,ECE 100,A02,507418,Baghdadchi; Saharnaz,20,0,20,0
1713322571216,ECE 111,A01,507420,Staff,39,0,50,11
1713322572240,ECE 197,001,548057,Sievenpiper; Daniel F.,9998,0,9999,1
1713322573264,EDS 115,A00,507243,Choi; Bailey Miyeon,28,0,28,0
1713322574288,EDS 117,A01,494379,Staff,23,0,25,2
1713322575310,EDS 125,A00,507246,Hopkins; Megan Beth,29,0,30,1
1713322576339,EDS 128A,A01,507264,Fargason; Sharon Gayle,26,0,26,0
1713322577365,EDS 128B,A01,507293,Pappas; Elizabeth,30,0,30,0
1713322578392,EDS 139,A00,507294,Fargason; Sharon Gayle,30,0,30,0
1713322578392,EDS 139,B00,507313,Pappas; Elizabeth,30,0,30,0
1713322579416,EDS 201,A00,507315,Staff,26,0,30,4
1713322580442,EDS 203,A01,507317,Halter; Christopher P.,26,0,30,4
1713322581467,EDS 204R,A01,507319,Halter; Christopher P.,3,0,30,27
1713322581467,EDS 204R,B01,507331,Heinzman; Erica M.,28,0,30,2
1713322582493,EDS 206R,A00,507332,Staff,4,0,30,26
1713322582493,EDS 206R,B00,507343,Staff,28,0,30,2
1713322583520,EDS 250,A00,507344,Hemans; Patricia Ann Benitez,36,0,40,4
1713322584544,EDS 281,A00,507345,Daly; Alan J.,18,0,18,0
1713322585570,EDS 284,A00,507350,Daly; Alan J.,16,0,16,0
1713322586596,EDS 286,A00,507359,Fine; Sarah,18,0,18,0
1713322587619,EDS 289C,A01,507361,Daly; Alan J.,18,0,18,0
1713322588644,EDS 290,A00,507366,Hofstetter; Carolyn,15,0,15,0
1713322589667,LIGM 5A,A00,507421,Fischer-Grunski; Eva K,20,0,20,0
1713322590694,LIGM 5B,A00,507423,Fischer-Grunski; Eva K,20,0,20,0
1713322591718,LIGM 5C,A00,507425,Fischer-Grunski; Eva K,20,0,20,0
1713322592746,LIIT 5AS,A00,507427,Carnelos; Chiara,20,0,20,0
1713322593771,LIIT 5BS,A00,507430,Carnelos; Chiara,20,0,20,0
1713322594798,LIIT 5CS,A00,507432,Carnelos; Chiara,20,0,20,0
1713322595826,LISP 5A,A00,507541,Munoz Sanchez; Alicia,18,0,20,2
1713322596852,LISP 5B,A00,507671,Munoz Sanchez; Alicia,16,0,20,4
1713322597876,LISP 5C,A00,507696,Munoz Sanchez; Alicia,16,0,20,4
1713322598902,MAE 197,001,528363,Boechler; Nicholas Sebastia,9998,0,9999,1
1713322599927,MATH 197,001,523477,Kedlaya; Kiran S.,9999,0,9999,0
1713322599927,MATH 197,002,563811,Zhang; Danna,9999,0,9999,0
1713322600954,MCWP 40R,A00,518780,Staff,20,0,20,0
1713322600954,MCWP 40R,B00,518781,Staff,19,0,20,1
1713322600954,MCWP 40R,C00,518783,Staff,19,0,20,1
1713322601980,MCWP 50R,A00,518791,Staff,20,0,20,0
1713322601980,MCWP 50R,B00,518792,Staff,17,0,20,3
1713322601980,MCWP 50R,C00,518793,Staff,19,0,20,1
1713322601980,MCWP 50R,D00,518794,Staff,17,0,20,3
1713322601980,MCWP 50R,E00,518795,Staff,16,0,20,4
1713322601980,MCWP 50R,F00,518796,Staff,19,0,20,1
1713322601980,MCWP 50R,G00,518797,Staff,19,0,20,1
1713322603004,MMW 12R,A01,514034,Herbst; Matthew,15,0,16,1
1713322603004,MMW 12R,A02,514035,Herbst; Matthew,16,0,16,0
1713322604028,MMW 13R,A01,514037,Staff,12,0,16,4
1713322604028,MMW 13R,A02,514039,Staff,16,0,16,0
1713322606079,SIO 295LS,A00,523233,Staff,19,0,30,11
1713322607105,SIO 295S,A00,523232,Staff,19,0,30,11
1713322608130,SOCI 117,A01,494376,Staff,2,0,5,3
1713322609154,WES 237B,A00,494380,Staff,19,0,20,1
1713322611211,AESE 279B,A00,494370,Wade; Jon P,33,0,33,0
1713322612236,ANAR 135S,A00,494369,Braswell; Geoffrey E.,0,0,0,0
1713322613259,CAT 124RS,A01,519847,Geibel; William,17,0,20,3
1713322614285,CAT 125RS,A01,515971,Geibel; William,17,0,20,3
1713322615312,CLRE 250,A00,511389,Morris; Sheldon,9996,0,9999,3
1713322616337,CLRE 251,A00,507176,Mehta; Ravindra L.,9996,0,9999,3
1713322616337,CLRE 251,B00,511410,Mehta; Ravindra L.,9998,0,9999,1
1713322617364,CLRE 252,A00,507189,Cuomo; Raphael Eduardo,9998,0,9999,1
1713322618391,CLRE 253,A00,507199,Vaida; Florin,9997,0,9999,2
1713322618391,CLRE 253,B00,507202,Vaida; Florin,9999,0,9999,0
1713322619419,CLRE 259,A00,507211,Patel; Hemal,9996,0,9999,3
1713322620443,CLRE 260,A00,507221,Cuomo; Raphael Eduardo,9999,0,9999,0
1713322621468,CLRE 297,001,507242,Cuomo; Raphael Eduardo,9999,0,9999,0
1713322622492,CSE 191,A00,516875,Minnes Kemp; Mor Mia,9999,0,9999,0
1713322623521,CSS 201S,A01,494383,Staff,35,0,35,0
1713322624549,CSS 202S,A01,494387,Staff,35,0,35,0
1713322625574,EAP 100,A00,516065,Staff,9792,0,9999,207
1713322626599,ECE 45,A01,507414,Staff,52,0,60,8
1713322627624,ECE 100,A01,507416,Baghdadchi; Saharnaz,11,0,20,9
1713322627624,ECE 100,A02,507418,Baghdadchi; Saharnaz,20,0,20,0
1713322628705,ECE 111,A01,507420,Staff,39,0,50,11
1713322629729,ECE 197,001,548057,Sievenpiper; Daniel F.,9998,0,9999,1
1713322630756,EDS 115,A00,507243,Choi; Bailey Miyeon,28,0,28,0
1713322631781,EDS 117,A01,494379,Staff,23,0,25,2
1713322632806,EDS 125,A00,507246,Hopkins; Megan Beth,29,0,30,1
1713322633831,EDS 128A,A01,507264,Fargason; Sharon Gayle,26,0,26,0
1713322634858,EDS 128B,A01,507293,Pappas; Elizabeth,30,0,30,0
1713322635883,EDS 139,A00,507294,Fargason; Sharon Gayle,30,0,30,0
1713322635883,EDS 139,B00,507313,Pappas; Elizabeth,30,0,30,0
1713322636908,EDS 201,A00,507315,Staff,26,0,30,4
1713322637936,EDS 203,A01,507317,Halter; Christopher P.,26,0,30,4
1713322638964,EDS 204R,A01,507319,Halter; Christopher P.,3,0,30,27
1713322638964,EDS 204R,B01,507331,Heinzman; Erica M.,28,0,30,2
1713322639992,EDS 206R,A00,507332,Staff,4,0,30,26
1713322639992,EDS 206R,B00,507343,Staff,28,0,30,2
1713322641015,EDS 250,A00,507344,Hemans; Patricia Ann Benitez,36,0,40,4
1713322642039,EDS 281,A00,507345,Daly; Alan J.,18,0,18,0
1713322643063,EDS 284,A00,507350,Daly; Alan J.,16,0,16,0
1713322644090,EDS 286,A00,507359,Fine; Sarah,18,0,18,0
1713322645114,EDS 289C,A01,507361,Daly; Alan J.,18,0,18,0
1713322646139,EDS 290,A00,507366,Hofstetter; Carolyn,15,0,15,0
1713322647163,LIGM 5A,A00,507421,Fischer-Grunski; Eva K,20,0,20,0
1713322648187,LIGM 5B,A00,507423,Fischer-Grunski; Eva K,20,0,20,0
1713322649212,LIGM 5C,A00,507425,Fischer-Grunski; Eva K,20,0,20,0
1713322650242,LIIT 5AS,A00,507427,Carnelos; Chiara,20,0,20,0
1713322651266,LIIT 5BS,A00,507430,Carnelos; Chiara,20,0,20,0
1713322652291,LIIT 5CS,A00,507432,Carnelos; Chiara,20,0,20,0
1713322653315,LISP 5A,A00,507541,Munoz Sanchez; Alicia,18,0,20,2
1713322654344,LISP 5B,A00,507671,Munoz Sanchez; Alicia,16,0,20,4
1713322655369,LISP 5C,A00,507696,Munoz Sanchez; Alicia,16,0,20,4
1713322656395,MAE 197,001,528363,Boechler; Nicholas Sebastia,9998,0,9999,1
1713322657422,MATH 197,001,523477,Kedlaya; Kiran S.,9999,0,9999,0
1713322657422,MATH 197,002,563811,Zhang; Danna,9999,0,9999,0
1713322658448,MCWP 40R,A00,518780,Staff,20,0,20,0
1713322658448,MCWP 40R,B00,518781,Staff,19,0,20,1
1713322658448,MCWP 40R,C00,518783,Staff,19,0,20,1
1713322659473,MCWP 50R,A00,518791,Staff,20,0,20,0
1713322659473,MCWP 50R,B00,518792,Staff,17,0,20,3
1713322659473,MCWP 50R,C00,518793,Staff,19,0,20,1
1713322659473,MCWP 50R,D00,518794,Staff,17,0,20,3
1713322659473,MCWP 50R,E00,518795,Staff,16,0,20,4
1713322659473,MCWP 50R,F00,518796,Staff,19,0,20,1
1713322659473,MCWP 50R,G00,518797,Staff,19,0,20,1
1713322660500,MMW 12R,A01,514034,Herbst; Matthew,15,0,16,1
1713322660500,MMW 12R,A02,514035,Herbst; Matthew,16,0,16,0
1713322661525,MMW 13R,A01,514037,Staff,12,0,16,4
1713322661525,MMW 13R,A02,514039,Staff,16,0,16,0
1713322663580,SIO 295LS,A00,523233,Staff,19,0,30,11
1713322664607,SIO 295S,A00,523232,Staff,19,0,30,11
1713322665631,SOCI 117,A01,494376,Staff,2,0,5,3
1713322666656,WES 237B,A00,494380,Staff,19,0,20,1
1713322668713,AESE 279B,A00,494370,Wade; Jon P,33,0,33,0
1713322669737,ANAR 135S,A00,494369,Braswell; Geoffrey E.,0,0,0,0
1713322670765,CAT 124RS,A01,519847,Geibel; William,17,0,20,3
1713322671792,CAT 125RS,A01,515971,Geibel; William,17,0,20,3
1713322672817,CLRE 250,A00,511389,Morris; Sheldon,9996,0,9999,3
1713322673841,CLRE 251,A00,507176,Mehta; Ravindra L.,9996,0,9999,3
1713322673841,CLRE 251,B00,511410,Mehta; Ravindra L.,9998,0,9999,1
1713322674866,CLRE 252,A00,507189,Cuomo; Raphael Eduardo,9998,0,9999,1
1713322675895,CLRE 253,A00,507199,Vaida; Florin,9997,0,9999,2
1713322675895,CLRE 253,B00,507202,Vaida; Florin,9999,0,9999,0
1713322676920,CLRE 259,A00,507211,Patel; Hemal,9996,0,9999,3
1713322677946,CLRE 260,A00,507221,Cuomo; Raphael Eduardo,9999,0,9999,0
1713322678974,CLRE 297,001,507242,Cuomo; Raphael Eduardo,9999,0,9999,0
1713322680000,CSE 191,A00,516875,Minnes Kemp; Mor Mia,9999,0,9999,0
1713322681025,CSS 201S,A01,494383,Staff,35,0,35,0
1713322682050,CSS 202S,A01,494387,Staff,35,0,35,0
1713322683074,EAP 100,A00,516065,Staff,9792,0,9999,207
1713322684100,ECE 45,A01,507414,Staff,52,0,60,8
1713322685129,ECE 100,A01,507416,Baghdadchi; Saharnaz,11,0,20,9
1713322685129,ECE 100,A02,507418,Baghdadchi; Saharnaz,20,0,20,0
1713322686154,ECE 111,A01,507420,Staff,39,0,50,11
1713322687178,ECE 197,001,548057,Sievenpiper; Daniel F.,9998,0,9999,1
1713322688202,EDS 115,A00,507243,Choi; Bailey Miyeon,28,0,28,0
1713322689228,EDS 117,A01,494379,Staff,23,0,25,2
1713322690252,EDS 125,A00,507246,Hopkins; Megan Beth,29,0,30,1
1713322691277,EDS 128A,A01,507264,Fargason; Sharon Gayle,26,0,26,0
1713322692300,EDS 128B,A01,507293,Pappas; Elizabeth,30,0,30,0
1713322693325,EDS 139,A00,507294,Fargason; Sharon Gayle,30,0,30,0
1713322693325,EDS 139,B00,507313,Pappas; Elizabeth,30,0,30,0
1713322694350,EDS 201,A00,507315,Staff,26,0,30,4
1713322695374,EDS 203,A01,507317,Halter; Christopher P.,26,0,30,4
1713322696399,EDS 204R,A01,507319,Halter; Christopher P.,3,0,30,27
1713322696399,EDS 204R,B01,507331,Heinzman; Erica M.,28,0,30,2
1713322697423,EDS 206R,A00,507332,Staff,4,0,30,26
1713322697423,EDS 206R,B00,507343,Staff,28,0,30,2
1713322698446,EDS 250,A00,507344,Hemans; Patricia Ann Benitez,36,0,40,4
1713322699470,EDS 281,A00,507345,Daly; Alan J.,18,0,18,0
1713322700494,EDS 284,A00,507350,Daly; Alan J.,16,0,16,0
1713322701523,EDS 286,A00,507359,Fine; Sarah,18,0,18,0
1713322702548,EDS 289C,A01,507361,Daly; Alan J.,18,0,18,0
1713322703576,EDS 290,A00,507366,Hofstetter; Carolyn,15,0,15,0
1713322704604,LIGM 5A,A00,507421,Fischer-Grunski; Eva K,20,0,20,0
1713322705634,LIGM 5B,A00,507423,Fischer-Grunski; Eva K,20,0,20,0
1713322706661,LIGM 5C,A00,507425,Fischer-Grunski; Eva K,20,0,20,0
1713322707692,LIIT 5AS,A00,507427,Carnelos; Chiara,20,0,20,0
1713322708717,LIIT 5BS,A00,507430,Carnelos; Chiara,20,0,20,0
1713322709746,LIIT 5CS,A00,507432,Carnelos; Chiara,20,0,20,0
1713322710774,LISP 5A,A00,507541,Munoz Sanchez; Alicia,18,0,20,2
1713322711801,LISP 5B,A00,507671,Munoz Sanchez; Alicia,16,0,20,4
1713322712827,LISP 5C,A00,507696,Munoz Sanchez; Alicia,16,0,20,4
1713322713863,MAE 197,001,528363,Boechler; Nicholas Sebastia,9998,0,9999,1
1713322714887,MATH 197,001,523477,Kedlaya; Kiran S.,9999,0,9999,0
1713322714887,MATH 197,002,563811,Zhang; Danna,9999,0,9999,0
1713322715915,MCWP 40R,A00,518780,Staff,20,0,20,0
1713322715915,MCWP 40R,B00,518781,Staff,19,0,20,1
1713322715915,MCWP 40R,C00,518783,Staff,19,0,20,1
1713322716944,MCWP 50R,A00,518791,Staff,20,0,20,0
1713322716944,MCWP 50R,B00,518792,Staff,17,0,20,3
1713322716944,MCWP 50R,C00,518793,Staff,19,0,20,1
1713322716944,MCWP 50R,D00,518794,Staff,17,0,20,3
1713322716944,MCWP 50R,E00,518795,Staff,16,0,20,4
1713322716944,MCWP 50R,F00,518796,Staff,19,0,20,1
1713322716944,MCWP 50R,G00,518797,Staff,19,0,20,1
1713322717969,MMW 12R,A01,514034,Herbst; Matthew,15,0,16,1
1713322717969,MMW 12R,A02,514035,Herbst; Matthew,16,0,16,0
1713322718995,MMW 13R,A01,514037,Staff,12,0,16,4
1713322718995,MMW 13R,A02,514039,Staff,16,0,16,0
1713322721047,SIO 295LS,A00,523233,Staff,19,0,30,11
1713322722072,SIO 295S,A00,523232,Staff,19,0,30,11
1713322723099,SOCI 117,A01,494376,Staff,2,0,5,3
1713322724125,WES 237B,A00,494380,Staff,19,0,20,1
1713322726193,AESE 279B,A00,494370,Wade; Jon P,33,0,33,0
1713322727220,ANAR 135S,A00,494369,Braswell; Geoffrey E.,0,0,0,0
1713322739062,CAT 124RS,A01,519847,Geibel; William,17,0,20,3
1713322740092,CAT 125RS,A01,515971,Geibel; William,17,0,20,3
1713322741117,CLRE 250,A00,511389,Morris; Sheldon,9996,0,9999,3
1713322742141,CLRE 251,A00,507176,Mehta; Ravindra L.,9996,0,9999,3
1713322742141,CLRE 251,B00,511410,Mehta; Ravindra L.,9998,0,9999,1
1713322743226,CLRE 252,A00,507189,Cuomo; Raphael Eduardo,9998,0,9999,1
1713322744252,CLRE 253,A00,507199,Vaida; Florin,9997,0,9999,2
1713322744252,CLRE 253,B00,507202,Vaida; Florin,9999,0,9999,0
1713322745276,CLRE 259,A00,507211,Patel; Hemal,9996,0,9999,3
1713322746300,CLRE 260,A00,507221,Cuomo; Raphael Eduardo,9999,0,9999,0
1713322747325,CLRE 297,001,507242,Cuomo; Raphael Eduardo,9999,0,9999,0
1713322748349,CSE 191,A00,516875,Minnes Kemp; Mor Mia,9999,0,9999,0
1713322749374,CSS 201S,A01,494383,Staff,35,0,35,0
1713322750398,CSS 202S,A01,494387,Staff,35,0,35,0
1713322751427,EAP 100,A00,516065,Staff,9792,0,9999,207
1713322752450,ECE 45,A01,507414,Staff,52,0,60,8
1713322753473,ECE 100,A01,507416,Baghdadchi; Saharnaz,11,0,20,9
1713322753473,ECE 100,A02,507418,Baghdadchi; Saharnaz,20,0,20,0
1713322754496,ECE 111,A01,507420,Staff,39,0,50,11
1713322755523,ECE 197,001,548057,Sievenpiper; Daniel F.,9998,0,9999,1
1713322756547,EDS 115,A00,507243,Choi; Bailey Miyeon,28,0,28,0
1713322757573,EDS 117,A01,494379,Staff,23,0,25,2
1713322758596,EDS 125,A00,507246,Hopkins; Megan Beth,29,0,30,1
1713322759624,EDS 128A,A01,507264,Fargason; Sharon Gayle,26,0,26,0
1713322760648,EDS 128B,A01,507293,Pappas; Elizabeth,30,0,30,0
1713322761674,EDS 139,A00,507294,Fargason; Sharon Gayle,30,0,30,0
1713322761674,EDS 139,B00,507313,Pappas; Elizabeth,30,0,30,0
1713322762698,EDS 201,A00,507315,Staff,26,0,30,4
1713322763726,EDS 203,A01,507317,Halter; Christopher P.,26,0,30,4
1713322764754,EDS 204R,A01,507319,Halter; Christopher P.,3,0,30,27
1713322764754,EDS 204R,B01,507331,Heinzman; Erica M.,28,0,30,2
1713322765778,EDS 206R,A00,507332,Staff,4,0,30,26
1713322765778,EDS 206R,B00,507343,Staff,28,0,30,2
1713322766803,EDS 250,A00,507344,Hemans; Patricia Ann Benitez,36,0,40,4
1713322767829,EDS 281,A00,507345,Daly; Alan J.,18,0,18,0
1713322768852,EDS 284,A00,507350,Daly; Alan J.,16,0,16,0
1713322769875,EDS 286,A00,507359,Fine; Sarah,18,0,18,0
1713322770900,EDS 289C,A01,507361,Daly; Alan J.,18,0,18,0
1713322771926,EDS 290,A00,507366,Hofstetter; Carolyn,15,0,15,0
1713322772952,LIGM 5A,A00,507421,Fischer-Grunski; Eva K,20,0,20,0
1713322773983,LIGM 5B,A00,507423,Fischer-Grunski; Eva K,20,0,20,0
1713322775009,LIGM 5C,A00,507425,Fischer-Grunski; Eva K,20,0,20,0
1713322776038,LIIT 5AS,A00,507427,Carnelos; Chiara,20,0,20,0
1713322777067,LIIT 5BS,A00,507430,Carnelos; Chiara,20,0,20,0
1713322778092,LIIT 5CS,A00,507432,Carnelos; Chiara,20,0,20,0
1713322779122,LISP 5A,A00,507541,Munoz Sanchez; Alicia,18,0,20,2
1713322780146,LISP 5B,A00,507671,Munoz Sanchez; Alicia,16,0,20,4
1713322781171,LISP 5C,A00,507696,Munoz Sanchez; Alicia,16,0,20,4
1713322782195,MAE 197,001,528363,Boechler; Nicholas Sebastia,9998,0,9999,1
1713322783221,MATH 197,001,523477,Kedlaya; Kiran S.,9999,0,9999,0
1713322783221,MATH 197,002,563811,Zhang; Danna,9999,0,9999,0
1713322784247,MCWP 40R,A00,518780,Staff,20,0,20,0
1713322784247,MCWP 40R,B00,518781,Staff,19,0,20,1
1713322784247,MCWP 40R,C00,518783,Staff,19,0,20,1
1713322785276,MCWP 50R,A00,518791,Staff,20,0,20,0
1713322785276,MCWP 50R,B00,518792,Staff,17,0,20,3
1713322785276,MCWP 50R,C00,518793,Staff,19,0,20,1
1713322785276,MCWP 50R,D00,518794,Staff,17,0,20,3
1713322785276,MCWP 50R,E00,518795,Staff,16,0,20,4
1713322785276,MCWP 50R,F00,518796,Staff,19,0,20,1
1713322785276,MCWP 50R,G00,518797,Staff,19,0,20,1
1713322786301,MMW 12R,A01,514034,Herbst; Matthew,15,0,16,1
1713322786301,MMW 12R,A02,514035,Herbst; Matthew,16,0,16,0
1713322787326,MMW 13R,A01,514037,Staff,12,0,16,4
1713322787326,MMW 13R,A02,514039,Staff,16,0,16,0
1713322789379,SIO 295LS,A00,523233,Staff,19,0,30,11
1713322790408,SIO 295S,A00,523232,Staff,19,0,30,11
1713322791435,SOCI 117,A01,494376,Staff,2,0,5,3
1713322792462,WES 237B,A00,494380,Staff,19,0,20,1
1713322794516,AESE 279B,A00,494370,Wade; Jon P,33,0,33,0
1713322795541,ANAR 135S,A00,494369,Braswell; Geoffrey E.,0,0,0,0
1713322796566,CAT 124RS,A01,519847,Geibel; William,17,0,20,3
1713322797593,CAT 125RS,A01,515971,Geibel; William,17,0,20,3
1713322798632,CLRE 250,A00,511389,Morris; Sheldon,9996,0,9999,3
1713322799662,CLRE 251,A00,507176,Mehta; Ravindra L.,9996,0,9999,3
1713322799662,CLRE 251,B00,511410,Mehta; Ravindra L.,9998,0,9999,1
1713322800688,CLRE 252,A00,507189,Cuomo; Raphael Eduardo,9998,0,9999,1
1713322801715,CLRE 253,A00,507199,Vaida; Florin,9997,0,9999,2
1713322801715,CLRE 253,B00,507202,Vaida; Florin,9999,0,9999,0
1713322802738,CLRE 259,A00,507211,Patel; Hemal,9996,0,9999,3
1713322803766,CLRE 260,A00,507221,Cuomo; Raphael Eduardo,9999,0,9999,0
1713322804790,CLRE 297,001,507242,Cuomo; Raphael Eduardo,9999,0,9999,0
1713322805818,CSE 191,A00,516875,Minnes Kemp; Mor Mia,9999,0,9999,0
1713322806845,CSS 201S,A01,494383,Staff,35,0,35,0
1713322807877,CSS 202S,A01,494387,Staff,35,0,35,0
1713322808905,EAP 100,A00,516065,Staff,9792,0,9999,207
1713322809933,ECE 45,A01,507414,Staff,52,0,60,8
1713322810960,ECE 100,A01,507416,Baghdadchi; Saharnaz,11,0,20,9
1713322810960,ECE 100,A02,507418,Baghdadchi; Saharnaz,20,0,20,0
1713322811988,ECE 111,A01,507420,Staff,39,0,50,11
1713322813018,ECE 197,001,548057,Sievenpiper; Daniel F.,9998,0,9999,1
1713322814047,EDS 115,A00,507243,Choi; Bailey Miyeon,28,0,28,0
1713322815072,EDS 117,A01,494379,Staff,23,0,25,2
1713322816098,EDS 125,A00,507246,Hopkins; Megan Beth,29,0,30,1
1713322817125,EDS 128A,A01,507264,Fargason; Sharon Gayle,26,0,26,0
1713322818155,EDS 128B,A01,507293,Pappas; Elizabeth,30,0,30,0
1713322819183,EDS 139,A00,507294,Fargason; Sharon Gayle,30,0,30,0
1713322819183,EDS 139,B00,507313,Pappas; Elizabeth,30,0,30,0
1713322820208,EDS 201,A00,507315,Staff,26,0,30,4
1713322821237,EDS 203,A01,507317,Halter; Christopher P.,26,0,30,4
1713322822266,EDS 204R,A01,507319,Halter; Christopher P.,3,0,30,27
1713322822266,EDS 204R,B01,507331,Heinzman; Erica M.,28,0,30,2
1713322823289,EDS 206R,A00,507332,Staff,4,0,30,26
1713322823289,EDS 206R,B00,507343,Staff,28,0,30,2
1713322824316,EDS 250,A00,507344,Hemans; Patricia Ann Benitez,36,0,40,4
1713322825341,EDS 281,A00,507345,Daly; Alan J.,18,0,18,0
1713322826365,EDS 284,A00,507350,Daly; Alan J.,16,0,16,0
1713322827393,EDS 286,A00,507359,Fine; Sarah,18,0,18,0
1713322828422,EDS 289C,A01,507361,Daly; Alan J.,18,0,18,0
1713322829447,EDS 290,A00,507366,Hofstetter; Carolyn,15,0,15,0
1713322830469,LIGM 5A,A00,507421,Fischer-Grunski; Eva K,20,0,20,0
1713322831495,LIGM 5B,A00,507423,Fischer-Grunski; Eva K,20,0,20,0
1713322832520,LIGM 5C,A00,507425,Fischer-Grunski; Eva K,20,0,20,0
1713322833549,LIIT 5AS,A00,507427,Carnelos; Chiara,20,0,20,0
1713322834572,LIIT 5BS,A00,507430,Carnelos; Chiara,20,0,20,0
1713322835596,LIIT 5CS,A00,507432,Carnelos; Chiara,20,0,20,0
1713322836624,LISP 5A,A00,507541,Munoz Sanchez; Alicia,18,0,20,2
1713322837651,LISP 5B,A00,507671,Munoz Sanchez; Alicia,16,0,20,4
1713322838676,LISP 5C,A00,507696,Munoz Sanchez; Alicia,16,0,20,4
1713322839704,MAE 197,001,528363,Boechler; Nicholas Sebastia,9998,0,9999,1
1713322840732,MATH 197,001,523477,Kedlaya; Kiran S.,9999,0,9999,0
1713322840732,MATH 197,002,563811,Zhang; Danna,9999,0,9999,0
1713322841756,MCWP 40R,A00,518780,Staff,20,0,20,0
1713322841756,MCWP 40R,B00,518781,Staff,19,0,20,1
1713322841756,MCWP 40R,C00,518783,Staff,19,0,20,1
1713322842781,MCWP 50R,A00,518791,Staff,20,0,20,0
1713322842781,MCWP 50R,B00,518792,Staff,17,0,20,3
1713322842781,MCWP 50R,C00,518793,Staff,19,0,20,1
1713322842781,MCWP 50R,D00,518794,Staff,17,0,20,3
1713322842781,MCWP 50R,E00,518795,Staff,16,0,20,4
1713322842781,MCWP 50R,F00,518796,Staff,19,0,20,1
1713322842781,MCWP 50R,G00,518797,Staff,19,0,20,1
1713322843808,MMW 12R,A01,514034,Herbst; Matthew,15,0,16,1
1713322843808,MMW 12R,A02,514035,Herbst; Matthew,16,0,16,0
1713322844834,MMW 13R,A01,514037,Staff,12,0,16,4
1713322844834,MMW 13R,A02,514039,Staff,16,0,16,0
1713322846941,SIO 295LS,A00,523233,Staff,19,0,30,11
1713322847968,SIO 295S,A00,523232,Staff,19,0,30,11
1713322848995,SOCI 117,A01,494376,Staff,2,0,5,3
1713322850021,WES 237B,A00,494380,Staff,19,0,20,1
1713322852085,AESE 279B,A00,494370,Wade; Jon P,33,0,33,0
1713322853112,ANAR 135S,A00,494369,Braswell; Geoffrey E.,0,0,0,0
1713322854136,CAT 124RS,A01,519847,Geibel; William,17,0,20,3
1713322855164,CAT 125RS,A01,515971,Geibel; William,17,0,20,3
1713322856191,CLRE 250,A00,511389,Morris; Sheldon,9996,0,9999,3
1713322857219,CLRE 251,A00,507176,Mehta; Ravindra L.,9996,0,9999,3
1713322857219,CLRE 251,B00,511410,Mehta; Ravindra L.,9998,0,9999,1
1713322858243,CLRE 252,A00,507189,Cuomo; Raphael Eduardo,9998,0,9999,1
1713322859271,CLRE 253,A00,507199,Vaida; Florin,9997,0,9999,2
1713322859271,CLRE 253,B00,507202,Vaida; Florin,9999,0,9999,0
1713322860299,CLRE 259,A00,507211,Patel; Hemal,9996,0,9999,3
1713322861323,CLRE 260,A00,507221,Cuomo; Raphael Eduardo,9999,0,9999,0
1713322862347,CLRE 297,001,507242,Cuomo; Raphael Eduardo,9999,0,9999,0
1713322863377,CSE 191,A00,516875,Minnes Kemp; Mor Mia,9999,0,9999,0
1713322864405,CSS 201S,A01,494383,Staff,35,0,35,0
1713322865442,CSS 202S,A01,494387,Staff,35,0,35,0
1713322866465,EAP 100,A00,516065,Staff,9792,0,9999,207
1713322867489,ECE 45,A01,507414,Staff,52,0,60,8
1713322868514,ECE 100,A01,507416,Baghdadchi; Saharnaz,11,0,20,9
1713322868514,ECE 100,A02,507418,Baghdadchi; Saharnaz,20,0,20,0
1713322869537,ECE 111,A01,507420,Staff,39,0,50,11
1713322870563,ECE 197,001,548057,Sievenpiper; Daniel F.,9998,0,9999,1
1713322871587,EDS 115,A00,507243,Choi; Bailey Miyeon,28,0,28,0
1713322872614,EDS 117,A01,494379,Staff,23,0,25,2
1713322873638,EDS 125,A00,507246,Hopkins; Megan Beth,29,0,30,1
1713322874662,EDS 128A,A01,507264,Fargason; Sharon Gayle,26,0,26,0
1713322875691,EDS 128B,A01,507293,Pappas; Elizabeth,30,0,30,0
1713322876719,EDS 139,A00,507294,Fargason; Sharon Gayle,30,0,30,0
1713322876719,EDS 139,B00,507313,Pappas; Elizabeth,30,0,30,0
1713322877745,EDS 201,A00,507315,Staff,26,0,30,4
1713322878773,EDS 203,A01,507317,Halter; Christopher P.,26,0,30,4
1713322879798,EDS 204R,A01,507319,Halter; Christopher P.,3,0,30,27
1713322879798,EDS 204R,B01,507331,Heinzman; Erica M.,28,0,30,2
1713322880825,EDS 206R,A00,507332,Staff,4,0,30,26
1713322880825,EDS 206R,B00,507343,Staff,28,0,30,2
1713322881849,EDS 250,A00,507344,Hemans; Patricia Ann Benitez,36,0,40,4
1713322882872,EDS 281,A00,507345,Daly; Alan J.,18,0,18,0
1713322883899,EDS 284,A00,507350,Daly; Alan J.,16,0,16,0
1713322884922,EDS 286,A00,507359,Fine; Sarah,18,0,18,0
1713322885954,EDS 289C,A01,507361,Daly; Alan J.,18,0,18,0
1713322886978,EDS 290,A00,507366,Hofstetter; Carolyn,15,0,15,0
1713322888007,LIGM 5A,A00,507421,Fischer-Grunski; Eva K,20,0,20,0
1713322889034,LIGM 5B,A00,507423,Fischer-Grunski; Eva K,20,0,20,0
1713322890064,LIGM 5C,A00,507425,Fischer-Grunski; Eva K,20,0,20,0
1713322891092,LIIT 5AS,A00,507427,Carnelos; Chiara,20,0,20,0
1713322892120,LIIT 5BS,A00,507430,Carnelos; Chiara,20,0,20,0
1713322893145,LIIT 5CS,A00,507432,Carnelos; Chiara,20,0,20,0
1713322894168,LISP 5A,A00,507541,Munoz Sanchez; Alicia,18,0,20,2
1713322895192,LISP 5B,A00,507671,Munoz Sanchez; Alicia,16,0,20,4
1713322896215,LISP 5C,A00,507696,Munoz Sanchez; Alicia,16,0,20,4
1713322897242,MAE 197,001,528363,Boechler; Nicholas Sebastia,9998,0,9999,1
1713322898271,MATH 197,001,523477,Kedlaya; Kiran S.,9999,0,9999,0
1713322898271,MATH 197,002,563811,Zhang; Danna,9999,0,9999,0
1713322899294,MCWP 40R,A00,518780,Staff,20,0,20,0
1713322899294,MCWP 40R,B00,518781,Staff,19,0,20,1
1713322899294,MCWP 40R,C00,518783,Staff,19,0,20,1
1713322900320,MCWP 50R,A00,518791,Staff,20,0,20,0
1713322900320,MCWP 50R,B00,518792,Staff,17,0,20,3
1713322900320,MCWP 50R,C00,518793,Staff,19,0,20,1
1713322900320,MCWP 50R,D00,518794,Staff,17,0,20,3
1713322900320,MCWP 50R,E00,518795,Staff,16,0,20,4
1713322900320,MCWP 50R,F00,518796,Staff,19,0,20,1
1713322900320,MCWP 50R,G00,518797,Staff,19,0,20,1
1713322901348,MMW 12R,A01,514034,Herbst; Matthew,15,0,16,1
1713322901348,MMW 12R,A02,514035,Herbst; Matthew,16,0,16,0
1713322902374,MMW 13R,A01,514037,Staff,12,0,16,4
1713322902374,MMW 13R,A02,514039,Staff,16,0,16,0
1713322904432,SIO 295LS,A00,523233,Staff,19,0,30,11
1713322905456,SIO 295S,A00,523232,Staff,19,0,30,11
1713322906479,SOCI 117,A01,494376,Staff,2,0,5,3
1713322907505,WES 237B,A00,494380,Staff,19,0,20,1
1713322909559,AESE 279B,A00,494370,Wade; Jon P,33,0,33,0
1713322910584,ANAR 135S,A00,494369,Braswell; Geoffrey E.,0,0,0,0
1713322911609,CAT 124RS,A01,519847,Geibel; William,17,0,20,3
1713322912638,CAT 125RS,A01,515971,Geibel; William,17,0,20,3
1713322913663,CLRE 250,A00,511389,Morris; Sheldon,9996,0,9999,3
1713322914688,CLRE 251,A00,507176,Mehta; Ravindra L.,9996,0,9999,3
1713322914688,CLRE 251,B00,511410,Mehta; Ravindra L.,9998,0,9999,1
1713322915712,CLRE 252,A00,507189,Cuomo; Raphael Eduardo,9998,0,9999,1
1713322916738,CLRE 253,A00,507199,Vaida; Florin,9997,0,9999,2
1713322916738,CLRE 253,B00,507202,Vaida; Florin,9999,0,9999,0
1713322917761,CLRE 259,A00,507211,Patel; Hemal,9996,0,9999,3
1713322918786,CLRE 260,A00,507221,Cuomo; Raphael Eduardo,9999,0,9999,0
1713322919809,CLRE 297,001,507242,Cuomo; Raphael Eduardo,9999,0,9999,0
1713322920834,CSE 191,A00,516875,Minnes Kemp; Mor Mia,9999,0,9999,0
1713322921859,CSS 201S,A01,494383,Staff,35,0,35,0
1713322922888,CSS 202S,A01,494387,Staff,35,0,35,0
1713322923912,EAP 100,A00,516065,Staff,9792,0,9999,207
1713322924941,ECE 45,A01,507414,Staff,52,0,60,8
1713322925968,ECE 100,A01,507416,Baghdadchi; Saharnaz,11,0,20,9
1713322925968,ECE 100,A02,507418,Baghdadchi; Saharnaz,20,0,20,0
1713322926993,ECE 111,A01,507420,Staff,39,0,50,11
1713322928018,ECE 197,001,548057,Sievenpiper; Daniel F.,9998,0,9999,1
1713322929043,EDS 115,A00,507243,Choi; Bailey Miyeon,28,0,28,0
1713322930069,EDS 117,A01,494379,Staff,23,0,25,2
1713322931094,EDS 125,A00,507246,Hopkins; Megan Beth,29,0,30,1
1713322932117,EDS 128A,A01,507264,Fargason; Sharon Gayle,26,0,26,0
1713322933147,EDS 128B,A01,507293,Pappas; Elizabeth,30,0,30,0
1713322934173,EDS 139,A00,507294,Fargason; Sharon Gayle,30,0,30,0
1713322934173,EDS 139,B00,507313,Pappas; Elizabeth,30,0,30,0
1713322935200,EDS 201,A00,507315,Staff,26,0,30,4
1713322936225,EDS 203,A01,507317,Halter; Christopher P.,26,0,30,4
1713322937250,EDS 204R,A01,507319,Halter; Christopher P.,3,0,30,27
1713322937250,EDS 204R,B01,507331,Heinzman; Erica M.,28,0,30,2
1713322938279,EDS 206R,A00,507332,Staff,4,0,30,26
1713322938279,EDS 206R,B00,507343,Staff,28,0,30,2
1713322939303,EDS 250,A00,507344,Hemans; Patricia Ann Benitez,36,0,40,4
1713322940330,EDS 281,A00,507345,Daly; Alan J.,18,0,18,0
1713322941353,EDS 284,A00,507350,Daly; Alan J.,16,0,16,0
1713322942378,EDS 286,A00,507359,Fine; Sarah,18,0,18,0
1713322943406,EDS 289C,A01,507361,Daly; Alan J.,18,0,18,0
1713322944433,EDS 290,A00,507366,Hofstetter; Carolyn,15,0,15,0
1713322945458,LIGM 5A,A00,507421,Fischer-Grunski; Eva K,20,0,20,0
1713322946483,LIGM 5B,A00,507423,Fischer-Grunski; Eva K,20,0,20,0
1713322947512,LIGM 5C,A00,507425,Fischer-Grunski; Eva K,20,0,20,0
1713322948543,LIIT 5AS,A00,507427,Carnelos; Chiara,20,0,20,0
1713322949569,LIIT 5BS,A00,507430,Carnelos; Chiara,20,0,20,0
1713322950652,LIIT 5CS,A00,507432,Carnelos; Chiara,20,0,20,0
1713322951676,LISP 5A,A00,507541,Munoz Sanchez; Alicia,18,0,20,2
1713322952705,LISP 5B,A00,507671,Munoz Sanchez; Alicia,16,0,20,4
1713322953730,LISP 5C,A00,507696,Munoz Sanchez; Alicia,16,0,20,4
1713322954757,MAE 197,001,528363,Boechler; Nicholas Sebastia,9998,0,9999,1
1713322955785,MATH 197,001,523477,Kedlaya; Kiran S.,9999,0,9999,0
1713322955785,MATH 197,002,563811,Zhang; Danna,9999,0,9999,0
1713322956809,MCWP 40R,A00,518780,Staff,20,0,20,0
1713322956809,MCWP 40R,B00,518781,Staff,19,0,20,1
1713322956809,MCWP 40R,C00,518783,Staff,19,0,20,1
1713322957835,MCWP 50R,A00,518791,Staff,20,0,20,0
1713322957835,MCWP 50R,B00,518792,Staff,17,0,20,3
1713322957835,MCWP 50R,C00,518793,Staff,19,0,20,1
1713322957835,MCWP 50R,D00,518794,Staff,17,0,20,3
1713322957835,MCWP 50R,E00,518795,Staff,16,0,20,4
1713322957835,MCWP 50R,F00,518796,Staff,19,0,20,1
1713322957835,MCWP 50R,G00,518797,Staff,19,0,20,1
1713322958864,MMW 12R,A01,514034,Herbst; Matthew,15,0,16,1
1713322958864,MMW 12R,A02,514035,Herbst; Matthew,16,0,16,0
1713322959893,MMW 13R,A01,514037,Staff,12,0,16,4
1713322959893,MMW 13R,A02,514039,Staff,16,0,16,0
1713322961943,SIO 295LS,A00,523233,Staff,19,0,30,11
1713322962967,SIO 295S,A00,523232,Staff,19,0,30,11
1713322963992,SOCI 117,A01,494376,Staff,2,0,5,3
1713322965018,WES 237B,A00,494380,Staff,19,0,20,1
1713322967082,AESE 279B,A00,494370,Wade; Jon P,33,0,33,0
1713322968112,ANAR 135S,A00,494369,Braswell; Geoffrey E.,0,0,0,0
1713322969138,CAT 124RS,A01,519847,Geibel; William,17,0,20,3
1713322970163,CAT 125RS,A01,515971,Geibel; William,17,0,20,3
1713322971192,CLRE 250,A00,511389,Morris; Sheldon,9996,0,9999,3
1713322972217,CLRE 251,A00,507176,Mehta; Ravindra L.,9996,0,9999,3
1713322972217,CLRE 251,B00,511410,Mehta; Ravindra L.,9998,0,9999,1
1713322973241,CLRE 252,A00,507189,Cuomo; Raphael Eduardo,9998,0,9999,1
1713322974267,CLRE 253,A00,507199,Vaida; Florin,9997,0,9999,2
1713322974267,CLRE 253,B00,507202,Vaida; Florin,9999,0,9999,0
1713322975295,CLRE 259,A00,507211,Patel; Hemal,9996,0,9999,3
1713322976320,CLRE 260,A00,507221,Cuomo; Raphael Eduardo,9999,0,9999,0
1713322977348,CLRE 297,001,507242,Cuomo; Raphael Eduardo,9999,0,9999,0
1713322978373,CSE 191,A00,516875,Minnes Kemp; Mor Mia,9999,0,9999,0
1713322979397,CSS 201S,A01,494383,Staff,35,0,35,0
1713322980429,CSS 202S,A01,494387,Staff,35,0,35,0
1713322981456,EAP 100,A00,516065,Staff,9792,0,9999,207
1713322982480,ECE 45,A01,507414,Staff,52,0,60,8
1713322983506,ECE 100,A01,507416,Baghdadchi; Saharnaz,11,0,20,9
1713322983506,ECE 100,A02,507418,Baghdadchi; Saharnaz,20,0,20,0
1713322984534,ECE 111,A01,507420,Staff,39,0,50,11
1713322985561,ECE 197,001,548057,Sievenpiper; Daniel F.,9998,0,9999,1
1713322986588,EDS 115,A00,507243,Choi; Bailey Miyeon,28,0,28,0
1713322987612,EDS 117,A01,494379,Staff,23,0,25,2
1713322988646,EDS 125,A00,507246,Hopkins; Megan Beth,29,0,30,1
1713322989670,EDS 128A,A01,507264,Fargason; Sharon Gayle,26,0,26,0
1713322990699,EDS 128B,A01,507293,Pappas; Elizabeth,30,0,30,0
1713322991724,EDS 139,A00,507294,Fargason; Sharon Gayle,30,0,30,0
1713322991724,EDS 139,B00,507313,Pappas; Elizabeth,30,0,30,0
1713322992753,EDS 201,A00,507315,Staff,26,0,30,4
1713322993777,EDS 203,A01,507317,Halter; Christopher P.,26,0,30,4
1713322994802,EDS 204R,A01,507319,Halter; Christopher P.,3,0,30,27
1713322994802,EDS 204R,B01,507331,Heinzman; Erica M.,28,0,30,2
1713322995826,EDS 206R,A00,507332,Staff,4,0,30,26
1713322995826,EDS 206R,B00,507343,Staff,28,0,30,2
1713322996853,EDS 250,A00,507344,Hemans; Patricia Ann Benitez,36,0,40,4
1713322997877,EDS 281,A00,507345,Daly; Alan J.,18,0,18,0
1713322998903,EDS 284,A00,507350,Daly; Alan J.,16,0,16,0
1713322999928,EDS 286,A00,507359,Fine; Sarah,18,0,18,0
1713323000952,EDS 289C,A01,507361,Daly; Alan J.,18,0,18,0
1713323001979,EDS 290,A00,507366,Hofstetter; Carolyn,15,0,15,0
1713323003007,LIGM 5A,A00,507421,Fischer-Grunski; Eva K,20,0,20,0
1713323004049,LIGM 5B,A00,507423,Fischer-Grunski; Eva K,20,0,20,0
1713323005075,LIGM 5C,A00,507425,Fischer-Grunski; Eva K,20,0,20,0
1713323006100,LIIT 5AS,A00,507427,Carnelos; Chiara,20,0,20,0
1713323007124,LIIT 5BS,A00,507430,Carnelos; Chiara,20,0,20,0
1713323008148,LIIT 5CS,A00,507432,Carnelos; Chiara,20,0,20,0
1713323009172,LISP 5A,A00,507541,Munoz Sanchez; Alicia,18,0,20,2
1713323010198,LISP 5B,A00,507671,Munoz Sanchez; Alicia,16,0,20,4
1713323011226,LISP 5C,A00,507696,Munoz Sanchez; Alicia,16,0,20,4
1713323012252,MAE 197,001,528363,Boechler; Nicholas Sebastia,9998,0,9999,1
1713323013280,MATH 197,001,523477,Kedlaya; Kiran S.,9999,0,9999,0
1713323013280,MATH 197,002,563811,Zhang; Danna,9999,0,9999,0
1713323014304,MCWP 40R,A00,518780,Staff,20,0,20,0
1713323014304,MCWP 40R,B00,518781,Staff,19,0,20,1
1713323014304,MCWP 40R,C00,518783,Staff,19,0,20,1
1713323015329,MCWP 50R,A00,518791,Staff,20,0,20,0
1713323015329,MCWP 50R,B00,518792,Staff,17,0,20,3
1713323015329,MCWP 50R,C00,518793,Staff,19,0,20,1
1713323015329,MCWP 50R,D00,518794,Staff,16,0,20,4
1713323015329,MCWP 50R,E00,518795,Staff,16,0,20,4
1713323015329,MCWP 50R,F00,518796,Staff,19,0,20,1
1713323015329,MCWP 50R,G00,518797,Staff,19,0,20,1
1713323016357,MMW 12R,A01,514034,Herbst; Matthew,15,0,16,1
1713323016357,MMW 12R,A02,514035,Herbst; Matthew,16,0,16,0
1713323017384,MMW 13R,A01,514037,Staff,12,0,16,4
1713323017384,MMW 13R,A02,514039,Staff,16,0,16,0
1713323019435,SIO 295LS,A00,523233,Staff,19,0,30,11
1713323020462,SIO 295S,A00,523232,Staff,19,0,30,11
1713323021489,SOCI 117,A01,494376,Staff,2,0,5,3
1713323022513,WES 237B,A00,494380,Staff,19,0,20,1
1713323024568,AESE 279B,A00,494370,Wade; Jon P,33,0,33,0
1713323025593,ANAR 135S,A00,494369,Braswell; Geoffrey E.,0,0,0,0
1713323026618,CAT 124RS,A01,519847,Geibel; William,17,0,20,3
1713323027643,CAT 125RS,A01,515971,Geibel; William,17,0,20,3
1713323028669,CLRE 250,A00,511389,Morris; Sheldon,9996,0,9999,3
1713323029695,CLRE 251,A00,507176,Mehta; Ravindra L.,9996,0,9999,3
1713323029695,CLRE 251,B00,511410,Mehta; Ravindra L.,9998,0,9999,1
1713323030722,CLRE 252,A00,507189,Cuomo; Raphael Eduardo,9998,0,9999,1
1713323031751,CLRE 253,A00,507199,Vaida; Florin,9997,0,9999,2
1713323031751,CLRE 253,B00,507202,Vaida; Florin,9999,0,9999,0
1713323032777,CLRE 259,A00,507211,Patel; Hemal,9996,0,9999,3
1713323033801,CLRE 260,A00,507221,Cuomo; Raphael Eduardo,9999,0,9999,0
1713323034828,CLRE 297,001,507242,Cuomo; Raphael Eduardo,9999,0,9999,0
1713323035857,CSE 191,A00,516875,Minnes Kemp; Mor Mia,9999,0,9999,0
1713323036887,CSS 201S,A01,494383,Staff,35,0,35,0
1713323037912,CSS 202S,A01,494387,Staff,35,0,35,0
1713323038938,EAP 100,A00,516065,Staff,9792,0,9999,207
1713323039963,ECE 45,A01,507414,Staff,52,0,60,8
1713323040997,ECE 100,A01,507416,Baghdadchi; Saharnaz,11,0,20,9
1713323040997,ECE 100,A02,507418,Baghdadchi; Saharnaz,20,0,20,0
1713323042023,ECE 111,A01,507420,Staff,39,0,50,11
1713323043048,ECE 197,001,548057,Sievenpiper; Daniel F.,9998,0,9999,1
1713323044074,EDS 115,A00,507243,Choi; Bailey Miyeon,28,0,28,0
1713323045100,EDS 117,A01,494379,Staff,23,0,25,2
1713323046128,EDS 125,A00,507246,Hopkins; Megan Beth,29,0,30,1
1713323047157,EDS 128A,A01,507264,Fargason; Sharon Gayle,26,0,26,0
1713323048185,EDS 128B,A01,507293,Pappas; Elizabeth,30,0,30,0
1713323049207,EDS 139,A00,507294,Fargason; Sharon Gayle,30,0,30,0
1713323049207,EDS 139,B00,507313,Pappas; Elizabeth,30,0,30,0
1713323050233,EDS 201,A00,507315,Staff,26,0,30,4
1713323051257,EDS 203,A01,507317,Halter; Christopher P.,26,0,30,4
1713323052287,EDS 204R,A01,507319,Halter; Christopher P.,3,0,30,27
1713323052287,EDS 204R,B01,507331,Heinzman; Erica M.,28,0,30,2
1713323053313,EDS 206R,A00,507332,Staff,4,0,30,26
1713323053313,EDS 206R,B00,507343,Staff,28,0,30,2
1713323054411,EDS 250,A00,507344,Hemans; Patricia Ann Benitez,36,0,40,4
1713323055436,EDS 281,A00,507345,Daly; Alan J.,18,0,18,0
1713323056464,EDS 284,A00,507350,Daly; Alan J.,16,0,16,0
1713323057488,EDS 286,A00,507359,Fine; Sarah,18,0,18,0
1713323058515,EDS 289C,A01,507361,Daly; Alan J.,18,0,18,0
1713323059544,EDS 290,A00,507366,Hofstetter; Carolyn,15,0,15,0
1713323060569,LIGM 5A,A00,507421,Fischer-Grunski; Eva K,20,0,20,0
1713323061593,LIGM 5B,A00,507423,Fischer-Grunski; Eva K,20,0,20,0
1713323062619,LIGM 5C,A00,507425,Fischer-Grunski; Eva K,20,0,20,0
1713323063645,LIIT 5AS,A00,507427,Carnelos; Chiara,20,0,20,0
1713323064670,LIIT 5BS,A00,507430,Carnelos; Chiara,20,0,20,0
1713323065695,LIIT 5CS,A00,507432,Carnelos; Chiara,20,0,20,0
1713323066726,LISP 5A,A00,507541,Munoz Sanchez; Alicia,18,0,20,2
1713323067754,LISP 5B,A00,507671,Munoz Sanchez; Alicia,16,0,20,4
1713323068778,LISP 5C,A00,507696,Munoz Sanchez; Alicia,16,0,20,4
1713323069803,MAE 197,001,528363,Boechler; Nicholas Sebastia,9998,0,9999,1
1713323070827,MATH 197,001,523477,Kedlaya; Kiran S.,9999,0,9999,0
1713323070827,MATH 197,002,563811,Zhang; Danna,9999,0,9999,0
1713323071852,MCWP 40R,A00,518780,Staff,20,0,20,0
1713323071852,MCWP 40R,B00,518781,Staff,19,0,20,1
1713323071852,MCWP 40R,C00,518783,Staff,19,0,20,1
1713323072879,MCWP 50R,A00,518791,Staff,20,0,20,0
1713323072879,MCWP 50R,B00,518792,Staff,17,0,20,3
1713323072879,MCWP 50R,C00,518793,Staff,19,0,20,1
1713323072879,MCWP 50R,D00,518794,Staff,16,0,20,4
1713323072879,MCWP 50R,E00,518795,Staff,16,0,20,4
1713323072879,MCWP 50R,F00,518796,Staff,19,0,20,1
1713323072879,MCWP 50R,G00,518797,Staff,19,0,20,1
1713323073907,MMW 12R,A01,514034,Herbst; Matthew,15,0,16,1
1713323073907,MMW 12R,A02,514035,Herbst; Matthew,16,0,16,0
1713323074934,MMW 13R,A01,514037,Staff,12,0,16,4
1713323074934,MMW 13R,A02,514039,Staff,16,0,16,0
1713323076986,SIO 295LS,A00,523233,Staff,19,0,30,11
1713323078015,SIO 295S,A00,523232,Staff,19,0,30,11
1713323079040,SOCI 117,A01,494376,Staff,2,0,5,3
1713323080067,WES 237B,A00,494380,Staff,19,0,20,1
1713323082121,AESE 279B,A00,494370,Wade; Jon P,33,0,33,0
1713323083146,ANAR 135S,A00,494369,Braswell; Geoffrey E.,0,0,0,0
1713323084175,CAT 124RS,A01,519847,Geibel; William,17,0,20,3
1713323085199,CAT 125RS,A01,515971,Geibel; William,17,0,20,3
1713323086224,CLRE 250,A00,511389,Morris; Sheldon,9996,0,9999,3
1713323087265,CLRE 251,A00,507176,Mehta; Ravindra L.,9996,0,9999,3
1713323087265,CLRE 251,B00,511410,Mehta; Ravindra L.,9998,0,9999,1
1713323088290,CLRE 252,A00,507189,Cuomo; Raphael Eduardo,9998,0,9999,1
1713323089316,CLRE 253,A00,507199,Vaida; Florin,9997,0,9999,2
1713323089316,CLRE 253,B00,507202,Vaida; Florin,9999,0,9999,0
1713323090343,CLRE 259,A00,507211,Patel; Hemal,9996,0,9999,3
1713323091372,CLRE 260,A00,507221,Cuomo; Raphael Eduardo,9999,0,9999,0
1713323092400,CLRE 297,001,507242,Cuomo; Raphael Eduardo,9999,0,9999,0
1713323093426,CSE 191,A00,516875,Minnes Kemp; Mor Mia,9999,0,9999,0
1713323094455,CSS 201S,A01,494383,Staff,35,0,35,0
1713323095482,CSS 202S,A01,494387,Staff,35,0,35,0
1713323096537,EAP 100,A00,516065,Staff,9792,0,9999,207
1713323097568,ECE 45,A01,507414,Staff,52,0,60,8
1713323098594,ECE 100,A01,507416,Baghdadchi; Saharnaz,11,0,20,9
1713323098594,ECE 100,A02,507418,Baghdadchi; Saharnaz,20,0,20,0
1713323099620,ECE 111,A01,507420,Staff,39,0,50,11
1713323100645,ECE 197,001,548057,Sievenpiper; Daniel F.,9998,0,9999,1
1713323101672,EDS 115,A00,507243,Choi; Bailey Miyeon,28,0,28,0
1713323102697,EDS 117,A01,494379,Staff,23,0,25,2
1713323103723,EDS 125,A00,507246,Hopkins; Megan Beth,29,0,30,1
1713323104748,EDS 128A,A01,507264,Fargason; Sharon Gayle,26,0,26,0
1713323105779,EDS 128B,A01,507293,Pappas; Elizabeth,30,0,30,0
1713323106804,EDS 139,A00,507294,Fargason; Sharon Gayle,30,0,30,0
1713323106804,EDS 139,B00,507313,Pappas; Elizabeth,30,0,30,0
1713323107949,EDS 201,A00,507315,Staff,26,0,30,4
1713323108976,EDS 203,A01,507317,Halter; Christopher P.,26,0,30,4
1713323110003,EDS 204R,A01,507319,Halter; Christopher P.,3,0,30,27
1713323110003,EDS 204R,B01,507331,Heinzman; Erica M.,28,0,30,2
1713323111028,EDS 206R,A00,507332,Staff,4,0,30,26
1713323111028,EDS 206R,B00,507343,Staff,28,0,30,2
1713323112056,EDS 250,A00,507344,Hemans; Patricia Ann Benitez,36,0,40,4
1713323113081,EDS 281,A00,507345,Daly; Alan J.,18,0,18,0
1713323114108,EDS 284,A00,507350,Daly; Alan J.,16,0,16,0
1713323115133,EDS 286,A00,507359,Fine; Sarah,18,0,18,0
1713323116159,EDS 289C,A01,507361,Daly; Alan J.,18,0,18,0
1713323117186,EDS 290,A00,507366,Hofstetter; Carolyn,15,0,15,0
1713323118214,LIGM 5A,A00,507421,Fischer-Grunski; Eva K,20,0,20,0
1713323119243,LIGM 5B,A00,507423,Fischer-Grunski; Eva K,20,0,20,0
1713323120269,LIGM 5C,A00,507425,Fischer-Grunski; Eva K,20,0,20,0
1713323121293,LIIT 5AS,A00,507427,Carnelos; Chiara,20,0,20,0
1713323122318,LIIT 5BS,A00,507430,Carnelos; Chiara,20,0,20,0
1713323123343,LIIT 5CS,A00,507432,Carnelos; Chiara,20,0,20,0
1713323124371,LISP 5A,A00,507541,Munoz Sanchez; Alicia,18,0,20,2
1713323125397,LISP 5B,A00,507671,Munoz Sanchez; Alicia,16,0,20,4
1713323126423,LISP 5C,A00,507696,Munoz Sanchez; Alicia,16,0,20,4
1713323127449,MAE 197,001,528363,Boechler; Nicholas Sebastia,9998,0,9999,1
1713323128473,MATH 197,001,523477,Kedlaya; Kiran S.,9999,0,9999,0
1713323128473,MATH 197,002,563811,Zhang; Danna,9999,0,9999,0
1713323129497,MCWP 40R,A00,518780,Staff,20,0,20,0
1713323129497,MCWP 40R,B00,518781,Staff,19,0,20,1
1713323129497,MCWP 40R,C00,518783,Staff,19,0,20,1
1713323130526,MCWP 50R,A00,518791,Staff,20,0,20,0
1713323130526,MCWP 50R,B00,518792,Staff,17,0,20,3
1713323130526,MCWP 50R,C00,518793,Staff,19,0,20,1
1713323130526,MCWP 50R,D00,518794,Staff,16,0,20,4
1713323130526,MCWP 50R,E00,518795,Staff,16,0,20,4
1713323130526,MCWP 50R,F00,518796,Staff,19,0,20,1
1713323130526,MCWP 50R,G00,518797,Staff,19,0,20,1
1713323131554,MMW 12R,A01,514034,Herbst; Matthew,15,0,16,1
1713323131554,MMW 12R,A02,514035,Herbst; Matthew,16,0,16,0
1713323132583,MMW 13R,A01,514037,Staff,12,0,16,4
1713323132583,MMW 13R,A02,514039,Staff,16,0,16,0
1713323134636,SIO 295LS,A00,523233,Staff,19,0,30,11
1713323135661,SIO 295S,A00,523232,Staff,19,0,30,11
1713323136686,SOCI 117,A01,494376,Staff,2,0,5,3
1713323137718,WES 237B,A00,494380,Staff,19,0,20,1
1713323139783,AESE 279B,A00,494370,Wade; Jon P,33,0,33,0
1713323140807,ANAR 135S,A00,494369,Braswell; Geoffrey E.,0,0,0,0
1713323141831,CAT 124RS,A01,519847,Geibel; William,17,0,20,3
1713323142857,CAT 125RS,A01,515971,Geibel; William,17,0,20,3
1713323143886,CLRE 250,A00,511389,Morris; Sheldon,9996,0,9999,3
1713323144911,CLRE 251,A00,507176,Mehta; Ravindra L.,9996,0,9999,3
1713323144911,CLRE 251,B00,511410,Mehta; Ravindra L.,9998,0,9999,1
1713323145935,CLRE 252,A00,507189,Cuomo; Raphael Eduardo,9998,0,9999,1
1713323146970,CLRE 253,A00,507199,Vaida; Florin,9997,0,9999,2
1713323146970,CLRE 253,B00,507202,Vaida; Florin,9999,0,9999,0
1713323147998,CLRE 259,A00,507211,Patel; Hemal,9996,0,9999,3
1713323149024,CLRE 260,A00,507221,Cuomo; Raphael Eduardo,9999,0,9999,0
1713323150062,CLRE 297,001,507242,Cuomo; Raphael Eduardo,9999,0,9999,0
1713323151086,CSE 191,A00,516875,Minnes Kemp; Mor Mia,9999,0,9999,0
1713323152114,CSS 201S,A01,494383,Staff,35,0,35,0
1713323153144,CSS 202S,A01,494387,Staff,35,0,35,0
1713323154169,EAP 100,A00,516065,Staff,9792,0,9999,207
1713323155194,ECE 45,A01,507414,Staff,52,0,60,8
1713323156222,ECE 100,A01,507416,Baghdadchi; Saharnaz,11,0,20,9
1713323156222,ECE 100,A02,507418,Baghdadchi; Saharnaz,20,0,20,0
1713323157248,ECE 111,A01,507420,Staff,39,0,50,11
1713323158327,ECE 197,001,548057,Sievenpiper; Daniel F.,9998,0,9999,1
1713323159350,EDS 115,A00,507243,Choi; Bailey Miyeon,28,0,28,0
1713323160375,EDS 117,A01,494379,Staff,23,0,25,2
1713323161402,EDS 125,A00,507246,Hopkins; Megan Beth,29,0,30,1
1713323162430,EDS 128A,A01,507264,Fargason; Sharon Gayle,26,0,26,0
1713323163457,EDS 128B,A01,507293,Pappas; Elizabeth,30,0,30,0
1713323164481,EDS 139,A00,507294,Fargason; Sharon Gayle,30,0,30,0
1713323164481,EDS 139,B00,507313,Pappas; Elizabeth,30,0,30,0
1713323165628,EDS 201,A00,507315,Staff,26,0,30,4
1713323166658,EDS 203,A01,507317,Halter; Christopher P.,26,0,30,4
1713323167683,EDS 204R,A01,507319,Halter; Christopher P.,3,0,30,27
1713323167683,EDS 204R,B01,507331,Heinzman; Erica M.,28,0,30,2
1713323168708,EDS 206R,A00,507332,Staff,4,0,30,26
1713323168708,EDS 206R,B00,507343,Staff,28,0,30,2
1713323169737,EDS 250,A00,507344,Hemans; Patricia Ann Benitez,36,0,40,4
1713323170762,EDS 281,A00,507345,Daly; Alan J.,18,0,18,0
1713323171790,EDS 284,A00,507350,Daly; Alan J.,16,0,16,0
1713323172817,EDS 286,A00,507359,Fine; Sarah,18,0,18,0
1713323173840,EDS 289C,A01,507361,Daly; Alan J.,18,0,18,0
1713323174868,EDS 290,A00,507366,Hofstetter; Carolyn,15,0,15,0
1713323175897,LIGM 5A,A00,507421,Fischer-Grunski; Eva K,20,0,20,0
1713323176922,LIGM 5B,A00,507423,Fischer-Grunski; Eva K,20,0,20,0
1713323177947,LIGM 5C,A00,507425,Fischer-Grunski; Eva K,20,0,20,0
1713323178973,LIIT 5AS,A00,507427,Carnelos; Chiara,20,0,20,0
1713323179999,LIIT 5BS,A00,507430,Carnelos; Chiara,20,0,20,0
1713323181026,LIIT 5CS,A00,507432,Carnelos; Chiara,20,0,20,0
1713323182053,LISP 5A,A00,507541,Munoz Sanchez; Alicia,18,0,20,2
1713323183080,LISP 5B,A00,507671,Munoz Sanchez; Alicia,16,0,20,4
1713323184105,LISP 5C,A00,507696,Munoz Sanchez; Alicia,16,0,20,4
1713323185130,MAE 197,001,528363,Boechler; Nicholas Sebastia,9998,0,9999,1
1713323186158,MATH 197,001,523477,Kedlaya; Kiran S.,9999,0,9999,0
1713323186158,MATH 197,002,563811,Zhang; Danna,9999,0,9999,0
1713323187183,MCWP 40R,A00,518780,Staff,20,0,20,0
1713323187183,MCWP 40R,B00,518781,Staff,19,0,20,1
1713323187183,MCWP 40R,C00,518783,Staff,19,0,20,1
1713323188210,MCWP 50R,A00,518791,Staff,20,0,20,0
1713323188210,MCWP 50R,B00,518792,Staff,17,0,20,3
1713323188210,MCWP 50R,C00,518793,Staff,19,0,20,1
1713323188210,MCWP 50R,D00,518794,Staff,16,0,20,4
1713323188210,MCWP 50R,E00,518795,Staff,16,0,20,4
1713323188210,MCWP 50R,F00,518796,Staff,19,0,20,1
1713323188210,MCWP 50R,G00,518797,Staff,19,0,20,1
1713323189236,MMW 12R,A01,514034,Herbst; Matthew,15,0,16,1
1713323189236,MMW 12R,A02,514035,Herbst; Matthew,16,0,16,0
1713323190262,MMW 13R,A01,514037,Staff,12,0,16,4
1713323190262,MMW 13R,A02,514039,Staff,16,0,16,0
1713323192312,SIO 295LS,A00,523233,Staff,19,0,30,11
1713323193337,SIO 295S,A00,523232,Staff,19,0,30,11
1713323194363,SOCI 117,A01,494376,Staff,2,0,5,3
1713323195389,WES 237B,A00,494380,Staff,19,0,20,1
1713323197455,AESE 279B,A00,494370,Wade; Jon P,33,0,33,0
1713323198482,ANAR 135S,A00,494369,Braswell; Geoffrey E.,0,0,0,0
1713323199508,CAT 124RS,A01,519847,Geibel; William,17,0,20,3
1713323200533,CAT 125RS,A01,515971,Geibel; William,17,0,20,3
1713323201560,CLRE 250,A00,511389,Morris; Sheldon,9996,0,9999,3
1713323202587,CLRE 251,A00,507176,Mehta; Ravindra L.,9996,0,9999,3
1713323202587,CLRE 251,B00,511410,Mehta; Ravindra L.,9998,0,9999,1
1713323203610,CLRE 252,A00,507189,Cuomo; Raphael Eduardo,9998,0,9999,1
1713323204634,CLRE 253,A00,507199,Vaida; Florin,9997,0,9999,2
1713323204634,CLRE 253,B00,507202,Vaida; Florin,9999,0,9999,0
1713323205658,CLRE 259,A00,507211,Patel; Hemal,9996,0,9999,3
1713323206685,CLRE 260,A00,507221,Cuomo; Raphael Eduardo,9999,0,9999,0
1713323207714,CLRE 297,001,507242,Cuomo; Raphael Eduardo,9999,0,9999,0
1713323208738,CSE 191,A00,516875,Minnes Kemp; Mor Mia,9999,0,9999,0
1713323209761,CSS 201S,A01,494383,Staff,35,0,35,0
1713323210789,CSS 202S,A01,494387,Staff,35,0,35,0
1713323211815,EAP 100,A00,516065,Staff,9792,0,9999,207
1713323212840,ECE 45,A01,507414,Staff,52,0,60,8
1713323213864,ECE 100,A01,507416,Baghdadchi; Saharnaz,11,0,20,9
1713323213864,ECE 100,A02,507418,Baghdadchi; Saharnaz,20,0,20,0
1713323214893,ECE 111,A01,507420,Staff,39,0,50,11
1713323215917,ECE 197,001,548057,Sievenpiper; Daniel F.,9998,0,9999,1
1713323216943,EDS 115,A00,507243,Choi; Bailey Miyeon,28,0,28,0
1713323217971,EDS 117,A01,494379,Staff,23,0,25,2
1713323218996,EDS 125,A00,507246,Hopkins; Megan Beth,29,0,30,1
1713323220029,EDS 128A,A01,507264,Fargason; Sharon Gayle,26,0,26,0
1713323221059,EDS 128B,A01,507293,Pappas; Elizabeth,30,0,30,0
1713323222086,EDS 139,A00,507294,Fargason; Sharon Gayle,30,0,30,0
1713323222086,EDS 139,B00,507313,Pappas; Elizabeth,30,0,30,0
1713323223112,EDS 201,A00,507315,Staff,26,0,30,4
1713323224141,EDS 203,A01,507317,Halter; Christopher P.,26,0,30,4
1713323225168,EDS 204R,A01,507319,Halter; Christopher P.,3,0,30,27
1713323225168,EDS 204R,B01,507331,Heinzman; Erica M.,28,0,30,2
1713323226197,EDS 206R,A00,507332,Staff,4,0,30,26
1713323226197,EDS 206R,B00,507343,Staff,28,0,30,2
1713323227222,EDS 250,A00,507344,Hemans; Patricia Ann Benitez,36,0,40,4
1713323228251,EDS 281,A00,507345,Daly; Alan J.,18,0,18,0
1713323229278,EDS 284,A00,507350,Daly; Alan J.,16,0,16,0
1713323230305,EDS 286,A00,507359,Fine; Sarah,18,0,18,0
1713323231329,EDS 289C,A01,507361,Daly; Alan J.,18,0,18,0
1713323232352,EDS 290,A00,507366,Hofstetter; Carolyn,15,0,15,0
1713323233378,LIGM 5A,A00,507421,Fischer-Grunski; Eva K,20,0,20,0
1713323234403,LIGM 5B,A00,507423,Fischer-Grunski; Eva K,20,0,20,0
1713323235427,LIGM 5C,A00,507425,Fischer-Grunski; Eva K,20,0,20,0
1713323236455,LIIT 5AS,A00,507427,Carnelos; Chiara,20,0,20,0
1713323237480,LIIT 5BS,A00,507430,Carnelos; Chiara,20,0,20,0
1713323238508,LIIT 5CS,A00,507432,Carnelos; Chiara,20,0,20,0
1713323239531,LISP 5A,A00,507541,Munoz Sanchez; Alicia,18,0,20,2
1713323240557,LISP 5B,A00,507671,Munoz Sanchez; Alicia,16,0,20,4
1713323241581,LISP 5C,A00,507696,Munoz Sanchez; Alicia,16,0,20,4
1713323242611,MAE 197,001,528363,Boechler; Nicholas Sebastia,9998,0,9999,1
1713323243635,MATH 197,001,523477,Kedlaya; Kiran S.,9999,0,9999,0
1713323243635,MATH 197,002,563811,Zhang; Danna,9999,0,9999,0
1713323244661,MCWP 40R,A00,518780,Staff,20,0,20,0
1713323244661,MCWP 40R,B00,518781,Staff,19,0,20,1
1713323244661,MCWP 40R,C00,518783,Staff,19,0,20,1
1713323245689,MCWP 50R,A00,518791,Staff,20,0,20,0
1713323245689,MCWP 50R,B00,518792,Staff,17,0,20,3
1713323245689,MCWP 50R,C00,518793,Staff,19,0,20,1
1713323245689,MCWP 50R,D00,518794,Staff,16,0,20,4
1713323245689,MCWP 50R,E00,518795,Staff,16,0,20,4
1713323245689,MCWP 50R,F00,518796,Staff,19,0,20,1
1713323245689,MCWP 50R,G00,518797,Staff,19,0,20,1
1713323246717,MMW 12R,A01,514034,Herbst; Matthew,15,0,16,1
1713323246717,MMW 12R,A02,514035,Herbst; Matthew,16,0,16,0
1713323247742,MMW 13R,A01,514037,Staff,12,0,16,4
1713323247742,MMW 13R,A02,514039,Staff,16,0,16,0
1713323249795,SIO 295LS,A00,523233,Staff,19,0,30,11
1713323250821,SIO 295S,A00,523232,Staff,19,0,30,11
1713323251847,SOCI 117,A01,494376,Staff,2,0,5,3
1713323252871,WES 237B,A00,494380,Staff,19,0,20,1
1713323254939,AESE 279B,A00,494370,Wade; Jon P,33,0,33,0
1713323255964,ANAR 135S,A00,494369,Braswell; Geoffrey E.,0,0,0,0
1713323256989,CAT 124RS,A01,519847,Geibel; William,17,0,20,3
1713323258016,CAT 125RS,A01,515971,Geibel; William,17,0,20,3
1713323259045,CLRE 250,A00,511389,Morris; Sheldon,9996,0,9999,3
1713323260072,CLRE 251,A00,507176,Mehta; Ravindra L.,9996,0,9999,3
1713323260072,CLRE 251,B00,511410,Mehta; Ravindra L.,9998,0,9999,1
1713323261099,CLRE 252,A00,507189,Cuomo; Raphael Eduardo,9998,0,9999,1
1713323262176,CLRE 253,A00,507199,Vaida; Florin,9997,0,9999,2
1713323262176,CLRE 253,B00,507202,Vaida; Florin,9999,0,9999,0
1713323263201,CLRE 259,A00,507211,Patel; Hemal,9996,0,9999,3
1713323264227,CLRE 260,A00,507221,Cuomo; Raphael Eduardo,9999,0,9999,0
1713323265357,CLRE 297,001,507242,Cuomo; Raphael Eduardo,9999,0,9999,0
1713323266381,CSE 191,A00,516875,Minnes Kemp; Mor Mia,9999,0,9999,0
1713323267407,CSS 201S,A01,494383,Staff,35,0,35,0
1713323268435,CSS 202S,A01,494387,Staff,35,0,35,0
1713323269460,EAP 100,A00,516065,Staff,9792,0,9999,207
1713323270488,ECE 45,A01,507414,Staff,52,0,60,8
1713323271513,ECE 100,A01,507416,Baghdadchi; Saharnaz,11,0,20,9
1713323271513,ECE 100,A02,507418,Baghdadchi; Saharnaz,20,0,20,0
1713323272537,ECE 111,A01,507420,Staff,39,0,50,11
1713323273565,ECE 197,001,548057,Sievenpiper; Daniel F.,9998,0,9999,1
1713323274594,EDS 115,A00,507243,Choi; Bailey Miyeon,28,0,28,0
1713323275619,EDS 117,A01,494379,Staff,23,0,25,2
1713323276643,EDS 125,A00,507246,Hopkins; Megan Beth,29,0,30,1
1713323277670,EDS 128A,A01,507264,Fargason; Sharon Gayle,26,0,26,0
1713323278695,EDS 128B,A01,507293,Pappas; Elizabeth,30,0,30,0
1713323279720,EDS 139,A00,507294,Fargason; Sharon Gayle,30,0,30,0
1713323279720,EDS 139,B00,507313,Pappas; Elizabeth,30,0,30,0
1713323280744,EDS 201,A00,507315,Staff,26,0,30,4
1713323281772,EDS 203,A01,507317,Halter; Christopher P.,26,0,30,4
1713323282797,EDS 204R,A01,507319,Halter; Christopher P.,3,0,30,27
1713323282797,EDS 204R,B01,507331,Heinzman; Erica M.,28,0,30,2
1713323283821,EDS 206R,A00,507332,Staff,4,0,30,26
1713323283821,EDS 206R,B00,507343,Staff,28,0,30,2
1713323284849,EDS 250,A00,507344,Hemans; Patricia Ann Benitez,36,0,40,4
1713323285872,EDS 281,A00,507345,Daly; Alan J.,18,0,18,0
1713323286897,EDS 284,A00,507350,Daly; Alan J.,16,0,16,0
1713323287923,EDS 286,A00,507359,Fine; Sarah,18,0,18,0
1713323288948,EDS 289C,A01,507361,Daly; Alan J.,18,0,18,0
1713323289976,EDS 290,A00,507366,Hofstetter; Carolyn,15,0,15,0
1713323291006,LIGM 5A,A00,507421,Fischer-Grunski; Eva K,20,0,20,0
1713323292037,LIGM 5B,A00,507423,Fischer-Grunski; Eva K,20,0,20,0
1713323293063,LIGM 5C,A00,507425,Fischer-Grunski; Eva K,20,0,20,0
1713323294089,LIIT 5AS,A00,507427,Carnelos; Chiara,20,0,20,0
1713323295114,LIIT 5BS,A00,507430,Carnelos; Chiara,20,0,20,0
1713323296140,LIIT 5CS,A00,507432,Carnelos; Chiara,20,0,20,0
1713323297169,LISP 5A,A00,507541,Munoz Sanchez; Alicia,18,0,20,2
1713323298198,LISP 5B,A00,507671,Munoz Sanchez; Alicia,16,0,20,4
1713323299222,LISP 5C,A00,507696,Munoz Sanchez; Alicia,16,0,20,4
1713323300246,MAE 197,001,528363,Boechler; Nicholas Sebastia,9998,0,9999,1
1713323301272,MATH 197,001,523477,Kedlaya; Kiran S.,9999,0,9999,0
1713323301272,MATH 197,002,563811,Zhang; Danna,9999,0,9999,0
1713323302297,MCWP 40R,A00,518780,Staff,20,0,20,0
1713323302297,MCWP 40R,B00,518781,Staff,19,0,20,1
1713323302297,MCWP 40R,C00,518783,Staff,19,0,20,1
1713323303324,MCWP 50R,A00,518791,Staff,20,0,20,0
1713323303324,MCWP 50R,B00,518792,Staff,17,0,20,3
1713323303324,MCWP 50R,C00,518793,Staff,19,0,20,1
1713323303324,MCWP 50R,D00,518794,Staff,16,0,20,4
1713323303324,MCWP 50R,E00,518795,Staff,16,0,20,4
1713323303324,MCWP 50R,F00,518796,Staff,19,0,20,1
1713323303324,MCWP 50R,G00,518797,Staff,19,0,20,1
1713323304352,MMW 12R,A01,514034,Herbst; Matthew,15,0,16,1
1713323304352,MMW 12R,A02,514035,Herbst; Matthew,16,0,16,0
1713323305378,MMW 13R,A01,514037,Staff,12,0,16,4
1713323305378,MMW 13R,A02,514039,Staff,16,0,16,0
1713323307427,SIO 295LS,A00,523233,Staff,19,0,30,11
1713323308451,SIO 295S,A00,523232,Staff,19,0,30,11
1713323309476,SOCI 117,A01,494376,Staff,2,0,5,3
1713323310501,WES 237B,A00,494380,Staff,19,0,20,1
1713323312566,AESE 279B,A00,494370,Wade; Jon P,33,0,33,0
1713323313590,ANAR 135S,A00,494369,Braswell; Geoffrey E.,0,0,0,0
1713323314618,CAT 124RS,A01,519847,Geibel; William,17,0,20,3
1713323315643,CAT 125RS,A01,515971,Geibel; William,17,0,20,3
1713323316667,CLRE 250,A00,511389,Morris; Sheldon,9996,0,9999,3
1713323317694,CLRE 251,A00,507176,Mehta; Ravindra L.,9996,0,9999,3
1713323317694,CLRE 251,B00,511410,Mehta; Ravindra L.,9998,0,9999,1
1713323318722,CLRE 252,A00,507189,Cuomo; Raphael Eduardo,9998,0,9999,1
1713323319746,CLRE 253,A00,507199,Vaida; Florin,9997,0,9999,2
1713323319746,CLRE 253,B00,507202,Vaida; Florin,9999,0,9999,0
1713323320771,CLRE 259,A00,507211,Patel; Hemal,9996,0,9999,3
1713323321800,CLRE 260,A00,507221,Cuomo; Raphael Eduardo,9999,0,9999,0
1713323322831,CLRE 297,001,507242,Cuomo; Raphael Eduardo,9999,0,9999,0
1713323323869,CSE 191,A00,516875,Minnes Kemp; Mor Mia,9999,0,9999,0
1713323324900,CSS 201S,A01,494383,Staff,35,0,35,0
1713323325925,CSS 202S,A01,494387,Staff,35,0,35,0
1713323326949,EAP 100,A00,516065,Staff,9792,0,9999,207
1713323327975,ECE 45,A01,507414,Staff,52,0,60,8
1713323329005,ECE 100,A01,507416,Baghdadchi; Saharnaz,11,0,20,9
1713323329005,ECE 100,A02,507418,Baghdadchi; Saharnaz,20,0,20,0
1713323330033,ECE 111,A01,507420,Staff,39,0,50,11
1713323331061,ECE 197,001,548057,Sievenpiper; Daniel F.,9998,0,9999,1
1713323332086,EDS 115,A00,507243,Choi; Bailey Miyeon,28,0,28,0
1713323333113,EDS 117,A01,494379,Staff,23,0,25,2
1713323334141,EDS 125,A00,507246,Hopkins; Megan Beth,29,0,30,1
1713323335168,EDS 128A,A01,507264,Fargason; Sharon Gayle,26,0,26,0
1713323336194,EDS 128B,A01,507293,Pappas; Elizabeth,30,0,30,0
1713323337219,EDS 139,A00,507294,Fargason; Sharon Gayle,30,0,30,0
1713323337219,EDS 139,B00,507313,Pappas; Elizabeth,30,0,30,0
1713323338247,EDS 201,A00,507315,Staff,26,0,30,4
1713323339273,EDS 203,A01,507317,Halter; Christopher P.,26,0,30,4
1713323340299,EDS 204R,A01,507319,Halter; Christopher P.,3,0,30,27
1713323340299,EDS 204R,B01,507331,Heinzman; Erica M.,28,0,30,2
1713323341325,EDS 206R,A00,507332,Staff,4,0,30,26
1713323341325,EDS 206R,B00,507343,Staff,28,0,30,2
1713323342350,EDS 250,A00,507344,Hemans; Patricia Ann Benitez,36,0,40,4
1713323343375,EDS 281,A00,507345,Daly; Alan J.,18,0,18,0
1713323344406,EDS 284,A00,507350,Daly; Alan J.,16,0,16,0
1713323345435,EDS 286,A00,507359,Fine; Sarah,18,0,18,0
1713323346460,EDS 289C,A01,507361,Daly; Alan J.,18,0,18,0
1713323347488,EDS 290,A00,507366,Hofstetter; Carolyn,15,0,15,0
1713323348515,LIGM 5A,A00,507421,Fischer-Grunski; Eva K,20,0,20,0
1713323349539,LIGM 5B,A00,507423,Fischer-Grunski; Eva K,20,0,20,0
1713323350569,LIGM 5C,A00,507425,Fischer-Grunski; Eva K,20,0,20,0
1713323351593,LIIT 5AS,A00,507427,Carnelos; Chiara,20,0,20,0
1713323352622,LIIT 5BS,A00,507430,Carnelos; Chiara,20,0,20,0
1713323353653,LIIT 5CS,A00,507432,Carnelos; Chiara,20,0,20,0
1713323354679,LISP 5A,A00,507541,Munoz Sanchez; Alicia,18,0,20,2
1713323355707,LISP 5B,A00,507671,Munoz Sanchez; Alicia,16,0,20,4
1713323356734,LISP 5C,A00,507696,Munoz Sanchez; Alicia,16,0,20,4
1713323357759,MAE 197,001,528363,Boechler; Nicholas Sebastia,9998,0,9999,1
1713323358785,MATH 197,001,523477,Kedlaya; Kiran S.,9999,0,9999,0
1713323358785,MATH 197,002,563811,Zhang; Danna,9999,0,9999,0
1713323359812,MCWP 40R,A00,518780,Staff,20,0,20,0
1713323359812,MCWP 40R,B00,518781,Staff,19,0,20,1
1713323359812,MCWP 40R,C00,518783,Staff,19,0,20,1
1713323360838,MCWP 50R,A00,518791,Staff,20,0,20,0
1713323360838,MCWP 50R,B00,518792,Staff,17,0,20,3
1713323360838,MCWP 50R,C00,518793,Staff,19,0,20,1
1713323360838,MCWP 50R,D00,518794,Staff,16,0,20,4
1713323360838,MCWP 50R,E00,518795,Staff,16,0,20,4
1713323360838,MCWP 50R,F00,518796,Staff,19,0,20,1
1713323360838,MCWP 50R,G00,518797,Staff,19,0,20,1
1713323361865,MMW 12R,A01,514034,Herbst; Matthew,15,0,16,1
1713323361865,MMW 12R,A02,514035,Herbst; Matthew,16,0,16,0
1713323362892,MMW 13R,A01,514037,Staff,12,0,16,4
1713323362892,MMW 13R,A02,514039,Staff,16,0,16,0
1713323364949,SIO 295LS,A00,523233,Staff,19,0,30,11
1713323366031,SIO 295S,A00,523232,Staff,19,0,30,11
1713323367056,SOCI 117,A01,494376,Staff,2,0,5,3
1713323368083,WES 237B,A00,494380,Staff,19,0,20,1
1713323370148,AESE 279B,A00,494370,Wade; Jon P,33,0,33,0
1713323371175,ANAR 135S,A00,494369,Braswell; Geoffrey E.,0,0,0,0
1713323372203,CAT 124RS,A01,519847,Geibel; William,17,0,20,3
1713323373231,CAT 125RS,A01,515971,Geibel; William,17,0,20,3
1713323374258,CLRE 250,A00,511389,Morris; Sheldon,9996,0,9999,3
1713323375288,CLRE 251,A00,507176,Mehta; Ravindra L.,9996,0,9999,3
1713323375288,CLRE 251,B00,511410,Mehta; Ravindra L.,9998,0,9999,1
1713323376318,CLRE 252,A00,507189,Cuomo; Raphael Eduardo,9998,0,9999,1
1713323377345,CLRE 253,A00,507199,Vaida; Florin,9997,0,9999,2
1713323377345,CLRE 253,B00,507202,Vaida; Florin,9999,0,9999,0
1713323378370,CLRE 259,A00,507211,Patel; Hemal,9996,0,9999,3
1713323379393,CLRE 260,A00,507221,Cuomo; Raphael Eduardo,9999,0,9999,0
1713323380422,CLRE 297,001,507242,Cuomo; Raphael Eduardo,9999,0,9999,0
1713323381447,CSE 191,A00,516875,Minnes Kemp; Mor Mia,9999,0,9999,0
1713323382473,CSS 201S,A01,494383,Staff,35,0,35,0
1713323383561,CSS 202S,A01,494387,Staff,35,0,35,0
1713323384586,EAP 100,A00,516065,Staff,9792,0,9999,207
1713323385613,ECE 45,A01,507414,Staff,52,0,60,8
1713323386643,ECE 100,A01,507416,Baghdadchi; Saharnaz,11,0,20,9
1713323386643,ECE 100,A02,507418,Baghdadchi; Saharnaz,20,0,20,0
1713323387668,ECE 111,A01,507420,Staff,39,0,50,11
1713323388693,ECE 197,001,548057,Sievenpiper; Daniel F.,9998,0,9999,1
1713323389718,EDS 115,A00,507243,Choi; Bailey Miyeon,28,0,28,0
1713323390744,EDS 117,A01,494379,Staff,23,0,25,2
1713323391772,EDS 125,A00,507246,Hopkins; Megan Beth,29,0,30,1
1713323392802,EDS 128A,A01,507264,Fargason; Sharon Gayle,26,0,26,0
1713323393831,EDS 128B,A01,507293,Pappas; Elizabeth,30,0,30,0
1713323394857,EDS 139,A00,507294,Fargason; Sharon Gayle,30,0,30,0
1713323394857,EDS 139,B00,507313,Pappas; Elizabeth,30,0,30,0
1713323395883,EDS 201,A00,507315,Staff,26,0,30,4
1713323396907,EDS 203,A01,507317,Halter; Christopher P.,26,0,30,4
1713323397932,EDS 204R,A01,507319,Halter; Christopher P.,3,0,30,27
1713323397932,EDS 204R,B01,507331,Heinzman; Erica M.,28,0,30,2
1713323398957,EDS 206R,A00,507332,Staff,4,0,30,26
1713323398957,EDS 206R,B00,507343,Staff,28,0,30,2
1713323399980,EDS 250,A00,507344,Hemans; Patricia Ann Benitez,36,0,40,4
1713323401010,EDS 281,A00,507345,Daly; Alan J.,18,0,18,0
1713323402039,EDS 284,A00,507350,Daly; Alan J.,16,0,16,0
1713323403074,EDS 286,A00,507359,Fine; Sarah,18,0,18,0
1713323404101,EDS 289C,A01,507361,Daly; Alan J.,18,0,18,0
1713323405125,EDS 290,A00,507366,Hofstetter; Carolyn,15,0,15,0
1713323406149,LIGM 5A,A00,507421,Fischer-Grunski; Eva K,20,0,20,0
1713323407175,LIGM 5B,A00,507423,Fischer-Grunski; Eva K,20,0,20,0
1713323408204,LIGM 5C,A00,507425,Fischer-Grunski; Eva K,20,0,20,0
1713323409230,LIIT 5AS,A00,507427,Carnelos; Chiara,20,0,20,0
1713323410257,LIIT 5BS,A00,507430,Carnelos; Chiara,20,0,20,0
1713323411284,LIIT 5CS,A00,507432,Carnelos; Chiara,20,0,20,0
1713323412309,LISP 5A,A00,507541,Munoz Sanchez; Alicia,18,0,20,2
1713323413334,LISP 5B,A00,507671,Munoz Sanchez; Alicia,16,0,20,4
1713323414362,LISP 5C,A00,507696,Munoz Sanchez; Alicia,16,0,20,4
1713323415392,MAE 197,001,528363,Boechler; Nicholas Sebastia,9998,0,9999,1
1713323416420,MATH 197,001,523477,Kedlaya; Kiran S.,9999,0,9999,0
1713323416420,MATH 197,002,563811,Zhang; Danna,9999,0,9999,0
1713323417445,MCWP 40R,A00,518780,Staff,20,0,20,0
1713323417445,MCWP 40R,B00,518781,Staff,19,0,20,1
1713323417445,MCWP 40R,C00,518783,Staff,19,0,20,1
1713323418469,MCWP 50R,A00,518791,Staff,20,0,20,0
1713323418469,MCWP 50R,B00,518792,Staff,17,0,20,3
1713323418469,MCWP 50R,C00,518793,Staff,19,0,20,1
1713323418469,MCWP 50R,D00,518794,Staff,16,0,20,4
1713323418469,MCWP 50R,E00,518795,Staff,16,0,20,4
1713323418469,MCWP 50R,F00,518796,Staff,19,0,20,1
1713323418469,MCWP 50R,G00,518797,Staff,19,0,20,1
1713323419493,MMW 12R,A01,514034,Herbst; Matthew,15,0,16,1
1713323419493,MMW 12R,A02,514035,Herbst; Matthew,16,0,16,0
1713323420518,MMW 13R,A01,514037,Staff,12,0,16,4
1713323420518,MMW 13R,A02,514039,Staff,16,0,16,0
1713323422571,SIO 295LS,A00,523233,Staff,19,0,30,11
1713323423613,SIO 295S,A00,523232,Staff,19,0,30,11
1713323424639,SOCI 117,A01,494376,Staff,2,0,5,3
1713323425666,WES 237B,A00,494380,Staff,19,0,20,1
1713323427731,AESE 279B,A00,494370,Wade; Jon P,33,0,33,0
1713323428756,ANAR 135S,A00,494369,Braswell; Geoffrey E.,0,0,0,0
1713323429779,CAT 124RS,A01,519847,Geibel; William,17,0,20,3
1713323430802,CAT 125RS,A01,515971,Geibel; William,17,0,20,3
1713323431825,CLRE 250,A00,511389,Morris; Sheldon,9996,0,9999,3
1713323432850,CLRE 251,A00,507176,Mehta; Ravindra L.,9996,0,9999,3
1713323432850,CLRE 251,B00,511410,Mehta; Ravindra L.,9998,0,9999,1
1713323433872,CLRE 252,A00,507189,Cuomo; Raphael Eduardo,9998,0,9999,1
1713323434898,CLRE 253,A00,507199,Vaida; Florin,9997,0,9999,2
1713323434898,CLRE 253,B00,507202,Vaida; Florin,9999,0,9999,0
1713323435926,CLRE 259,A00,507211,Patel; Hemal,9996,0,9999,3
1713323437113,CLRE 260,A00,507221,Cuomo; Raphael Eduardo,9999,0,9999,0
1713323438143,CLRE 297,001,507242,Cuomo; Raphael Eduardo,9999,0,9999,0
1713323439175,CSE 191,A00,516875,Minnes Kemp; Mor Mia,9999,0,9999,0
1713323440201,CSS 201S,A01,494383,Staff,35,0,35,0
1713323441229,CSS 202S,A01,494387,Staff,35,0,35,0
1713323442254,EAP 100,A00,516065,Staff,9792,0,9999,207
1713323443280,ECE 45,A01,507414,Staff,52,0,60,8
1713323444305,ECE 100,A01,507416,Baghdadchi; Saharnaz,11,0,20,9
1713323444305,ECE 100,A02,507418,Baghdadchi; Saharnaz,20,0,20,0
1713323445329,ECE 111,A01,507420,Staff,39,0,50,11
1713323446356,ECE 197,001,548057,Sievenpiper; Daniel F.,9998,0,9999,1
1713323447381,EDS 115,A00,507243,Choi; Bailey Miyeon,28,0,28,0
1713323448408,EDS 117,A01,494379,Staff,23,0,25,2
1713323449437,EDS 125,A00,507246,Hopkins; Megan Beth,29,0,30,1
1713323450461,EDS 128A,A01,507264,Fargason; Sharon Gayle,26,0,26,0
1713323451490,EDS 128B,A01,507293,Pappas; Elizabeth,30,0,30,0
1713323452514,EDS 139,A00,507294,Fargason; Sharon Gayle,30,0,30,0
1713323452514,EDS 139,B00,507313,Pappas; Elizabeth,30,0,30,0
1713323453539,EDS 201,A00,507315,Staff,26,0,30,4
1713323454564,EDS 203,A01,507317,Halter; Christopher P.,26,0,30,4
1713323455587,EDS 204R,A01,507319,Halter; Christopher P.,3,0,30,27
1713323455587,EDS 204R,B01,507331,Heinzman; Erica M.,28,0,30,2
1713323456613,EDS 206R,A00,507332,Staff,4,0,30,26
1713323456613,EDS 206R,B00,507343,Staff,28,0,30,2
1713323457638,EDS 250,A00,507344,Hemans; Patricia Ann Benitez,36,0,40,4
1713323458664,EDS 281,A00,507345,Daly; Alan J.,18,0,18,0
1713323459689,EDS 284,A00,507350,Daly; Alan J.,16,0,16,0
1713323460718,EDS 286,A00,507359,Fine; Sarah,18,0,18,0
1713323461745,EDS 289C,A01,507361,Daly; Alan J.,18,0,18,0
1713323462771,EDS 290,A00,507366,Hofstetter; Carolyn,15,0,15,0
1713323463799,LIGM 5A,A00,507421,Fischer-Grunski; Eva K,20,0,20,0
1713323464824,LIGM 5B,A00,507423,Fischer-Grunski; Eva K,20,0,20,0
1713323465851,LIGM 5C,A00,507425,Fischer-Grunski; Eva K,20,0,20,0
1713323466880,LIIT 5AS,A00,507427,Carnelos; Chiara,20,0,20,0
1713323467907,LIIT 5BS,A00,507430,Carnelos; Chiara,20,0,20,0
1713323468936,LIIT 5CS,A00,507432,Carnelos; Chiara,20,0,20,0
1713323470013,LISP 5A,A00,507541,Munoz Sanchez; Alicia,18,0,20,2
1713323471039,LISP 5B,A00,507671,Munoz Sanchez; Alicia,16,0,20,4
1713323472065,LISP 5C,A00,507696,Munoz Sanchez; Alicia,16,0,20,4
1713323473093,MAE 197,001,528363,Boechler; Nicholas Sebastia,9998,0,9999,1
1713323474119,MATH 197,001,523477,Kedlaya; Kiran S.,9999,0,9999,0
1713323474119,MATH 197,002,563811,Zhang; Danna,9999,0,9999,0
1713323475149,MCWP 40R,A00,518780,Staff,20,0,20,0
1713323475149,MCWP 40R,B00,518781,Staff,19,0,20,1
1713323475149,MCWP 40R,C00,518783,Staff,19,0,20,1
1713323476178,MCWP 50R,A00,518791,Staff,20,0,20,0
1713323476178,MCWP 50R,B00,518792,Staff,17,0,20,3
1713323476178,MCWP 50R,C00,518793,Staff,19,0,20,1
1713323476178,MCWP 50R,D00,518794,Staff,16,0,20,4
1713323476178,MCWP 50R,E00,518795,Staff,16,0,20,4
1713323476178,MCWP 50R,F00,518796,Staff,19,0,20,1
1713323476178,MCWP 50R,G00,518797,Staff,19,0,20,1
1713323477206,MMW 12R,A01,514034,Herbst; Matthew,15,0,16,1
1713323477206,MMW 12R,A02,514035,Herbst; Matthew,16,0,16,0
1713323478235,MMW 13R,A01,514037,Staff,12,0,16,4
1713323478235,MMW 13R,A02,514039,Staff,16,0,16,0
1713323480288,SIO 295LS,A00,523233,Staff,19,0,30,11
1713323481312,SIO 295S,A00,523232,Staff,19,0,30,11
1713323482337,SOCI 117,A01,494376,Staff,2,0,5,3
1713323483361,WES 237B,A00,494380,Staff,19,0,20,1
1713323485417,AESE 279B,A00,494370,Wade; Jon P,33,0,33,0
1713323486442,ANAR 135S,A00,494369,Braswell; Geoffrey E.,0,0,0,0
1713323487466,CAT 124RS,A01,519847,Geibel; William,17,0,20,3
1713323488492,CAT 125RS,A01,515971,Geibel; William,17,0,20,3
1713323489518,CLRE 250,A00,511389,Morris; Sheldon,9996,0,9999,3
1713323490542,CLRE 251,A00,507176,Mehta; Ravindra L.,9996,0,9999,3
1713323490542,CLRE 251,B00,511410,Mehta; Ravindra L.,9998,0,9999,1
1713323491567,CLRE 252,A00,507189,Cuomo; Raphael Eduardo,9998,0,9999,1
1713323492591,CLRE 253,A00,507199,Vaida; Florin,9997,0,9999,2
1713323492591,CLRE 253,B00,507202,Vaida; Florin,9999,0,9999,0
1713323493619,CLRE 259,A00,507211,Patel; Hemal,9996,0,9999,3
1713323494644,CLRE 260,A00,507221,Cuomo; Raphael Eduardo,9999,0,9999,0
1713323495669,CLRE 297,001,507242,Cuomo; Raphael Eduardo,9999,0,9999,0
1713323496695,CSE 191,A00,516875,Minnes Kemp; Mor Mia,9999,0,9999,0
1713323497720,CSS 201S,A01,494383,Staff,35,0,35,0
1713323498749,CSS 202S,A01,494387,Staff,35,0,35,0
1713323499773,EAP 100,A00,516065,Staff,9792,0,9999,207
1713323500798,ECE 45,A01,507414,Staff,52,0,60,8
1713323501826,ECE 100,A01,507416,Baghdadchi; Saharnaz,11,0,20,9
1713323501826,ECE 100,A02,507418,Baghdadchi; Saharnaz,20,0,20,0
1713323502853,ECE 111,A01,507420,Staff,39,0,50,11
1713323503880,ECE 197,001,548057,Sievenpiper; Daniel F.,9998,0,9999,1
1713323504905,EDS 115,A00,507243,Choi; Bailey Miyeon,28,0,28,0
1713323505933,EDS 117,A01,494379,Staff,23,0,25,2
1713323506960,EDS 125,A00,507246,Hopkins; Megan Beth,29,0,30,1
1713323507988,EDS 128A,A01,507264,Fargason; Sharon Gayle,26,0,26,0
1713323509014,EDS 128B,A01,507293,Pappas; Elizabeth,30,0,30,0
1713323510041,EDS 139,A00,507294,Fargason; Sharon Gayle,30,0,30,0
1713323510041,EDS 139,B00,507313,Pappas; Elizabeth,30,0,30,0
1713323511065,EDS 201,A00,507315,Staff,26,0,30,4
1713323512092,EDS 203,A01,507317,Halter; Christopher P.,26,0,30,4
1713323513118,EDS 204R,A01,507319,Halter; Christopher P.,3,0,30,27
1713323513118,EDS 204R,B01,507331,Heinzman; Erica M.,28,0,30,2
1713323514146,EDS 206R,A00,507332,Staff,4,0,30,26
1713323514146,EDS 206R,B00,507343,Staff,28,0,30,2
1713323515199,EDS 250,A00,507344,Hemans; Patricia Ann Benitez,36,0,40,4
1713323516223,EDS 281,A00,507345,Daly; Alan J.,18,0,18,0
1713323517246,EDS 284,A00,507350,Daly; Alan J.,16,0,16,0
1713323518272,EDS 286,A00,507359,Fine; Sarah,18,0,18,0
1713323519302,EDS 289C,A01,507361,Daly; Alan J.,18,0,18,0
1713323520326,EDS 290,A00,507366,Hofstetter; Carolyn,15,0,15,0
1713323521354,LIGM 5A,A00,507421,Fischer-Grunski; Eva K,20,0,20,0
1713323522384,LIGM 5B,A00,507423,Fischer-Grunski; Eva K,20,0,20,0
1713323523411,LIGM 5C,A00,507425,Fischer-Grunski; Eva K,20,0,20,0
1713323524436,LIIT 5AS,A00,507427,Carnelos; Chiara,20,0,20,0
1713323525460,LIIT 5BS,A00,507430,Carnelos; Chiara,20,0,20,0
1713323526482,LIIT 5CS,A00,507432,Carnelos; Chiara,20,0,20,0
1713323527510,LISP 5A,A00,507541,Munoz Sanchez; Alicia,18,0,20,2
1713323528540,LISP 5B,A00,507671,Munoz Sanchez; Alicia,16,0,20,4
1713323529565,LISP 5C,A00,507696,Munoz Sanchez; Alicia,16,0,20,4
1713323530589,MAE 197,001,528363,Boechler; Nicholas Sebastia,9998,0,9999,1
1713323531612,MATH 197,001,523477,Kedlaya; Kiran S.,9999,0,9999,0
1713323531612,MATH 197,002,563811,Zhang; Danna,9999,0,9999,0
1713323532640,MCWP 40R,A00,518780,Staff,20,0,20,0
1713323532640,MCWP 40R,B00,518781,Staff,19,0,20,1
1713323532640,MCWP 40R,C00,518783,Staff,19,0,20,1
1713323533664,MCWP 50R,A00,518791,Staff,20,0,20,0
1713323533664,MCWP 50R,B00,518792,Staff,17,0,20,3
1713323533664,MCWP 50R,C00,518793,Staff,19,0,20,1
1713323533664,MCWP 50R,D00,518794,Staff,16,0,20,4
1713323533664,MCWP 50R,E00,518795,Staff,16,0,20,4
1713323533664,MCWP 50R,F00,518796,Staff,19,0,20,1
1713323533664,MCWP 50R,G00,518797,Staff,19,0,20,1
1713323534689,MMW 12R,A01,514034,Herbst; Matthew,15,0,16,1
1713323534689,MMW 12R,A02,514035,Herbst; Matthew,16,0,16,0
1713323535716,MMW 13R,A01,514037,Staff,12,0,16,4
1713323535716,MMW 13R,A02,514039,Staff,16,0,16,0
1713323537769,SIO 295LS,A00,523233,Staff,19,0,30,11
1713323538798,SIO 295S,A00,523232,Staff,19,0,30,11
1713323539823,SOCI 117,A01,494376,Staff,2,0,5,3
1713323540847,WES 237B,A00,494380,Staff,19,0,20,1
1713323542908,AESE 279B,A00,494370,Wade; Jon P,33,0,33,0
1713323543935,ANAR 135S,A00,494369,Braswell; Geoffrey E.,0,0,0,0
1713323544962,CAT 124RS,A01,519847,Geibel; William,17,0,20,3
1713323545992,CAT 125RS,A01,515971,Geibel; William,17,0,20,3
1713323547020,CLRE 250,A00,511389,Morris; Sheldon,9996,0,9999,3
1713323548051,CLRE 251,A00,507176,Mehta; Ravindra L.,9996,0,9999,3
1713323548051,CLRE 251,B00,511410,Mehta; Ravindra L.,9998,0,9999,1
1713323549076,CLRE 252,A00,507189,Cuomo; Raphael Eduardo,9998,0,9999,1
1713323550106,CLRE 253,A00,507199,Vaida; Florin,9997,0,9999,2
1713323550106,CLRE 253,B00,507202,Vaida; Florin,9999,0,9999,0
1713323551130,CLRE 259,A00,507211,Patel; Hemal,9996,0,9999,3
1713323552160,CLRE 260,A00,507221,Cuomo; Raphael Eduardo,9999,0,9999,0
1713323553188,CLRE 297,001,507242,Cuomo; Raphael Eduardo,9999,0,9999,0
1713323554215,CSE 191,A00,516875,Minnes Kemp; Mor Mia,9999,0,9999,0
1713323555240,CSS 201S,A01,494383,Staff,35,0,35,0
1713323556266,CSS 202S,A01,494387,Staff,35,0,35,0
1713323557292,EAP 100,A00,516065,Staff,9792,0,9999,207
1713323558318,ECE 45,A01,507414,Staff,52,0,60,8
1713323559346,ECE 100,A01,507416,Baghdadchi; Saharnaz,11,0,20,9
1713323559346,ECE 100,A02,507418,Baghdadchi; Saharnaz,20,0,20,0
1713323560373,ECE 111,A01,507420,Staff,39,0,50,11
1713323561399,ECE 197,001,548057,Sievenpiper; Daniel F.,9998,0,9999,1
1713323562426,EDS 115,A00,507243,Choi; Bailey Miyeon,28,0,28,0
1713323563455,EDS 117,A01,494379,Staff,23,0,25,2
1713323564480,EDS 125,A00,507246,Hopkins; Megan Beth,29,0,30,1
1713323565505,EDS 128A,A01,507264,Fargason; Sharon Gayle,26,0,26,0
1713323566534,EDS 128B,A01,507293,Pappas; Elizabeth,30,0,30,0
1713323567559,EDS 139,A00,507294,Fargason; Sharon Gayle,30,0,30,0
1713323567559,EDS 139,B00,507313,Pappas; Elizabeth,30,0,30,0
1713323568584,EDS 201,A00,507315,Staff,26,0,30,4
1713323569609,EDS 203,A01,507317,Halter; Christopher P.,26,0,30,4
1713323570639,EDS 204R,A01,507319,Halter; Christopher P.,3,0,30,27
1713323570639,EDS 204R,B01,507331,Heinzman; Erica M.,28,0,30,2
1713323571669,EDS 206R,A00,507332,Staff,4,0,30,26
1713323571669,EDS 206R,B00,507343,Staff,28,0,30,2
1713323572694,EDS 250,A00,507344,Hemans; Patricia Ann Benitez,36,0,40,4
1713323573771,EDS 281,A00,507345,Daly; Alan J.,18,0,18,0
1713323574797,EDS 284,A00,507350,Daly; Alan J.,16,0,16,0
1713323575822,EDS 286,A00,507359,Fine; Sarah,18,0,18,0
1713323576847,EDS 289C,A01,507361,Daly; Alan J.,18,0,18,0
1713323577875,EDS 290,A00,507366,Hofstetter; Carolyn,15,0,15,0
1713323578900,LIGM 5A,A00,507421,Fischer-Grunski; Eva K,20,0,20,0
1713323579929,LIGM 5B,A00,507423,Fischer-Grunski; Eva K,20,0,20,0
1713323580954,LIGM 5C,A00,507425,Fischer-Grunski; Eva K,20,0,20,0
1713323581983,LIIT 5AS,A00,507427,Carnelos; Chiara,20,0,20,0
1713323583010,LIIT 5BS,A00,507430,Carnelos; Chiara,20,0,20,0
1713323584040,LIIT 5CS,A00,507432,Carnelos; Chiara,20,0,20,0
1713323585069,LISP 5A,A00,507541,Munoz Sanchez; Alicia,18,0,20,2
1713323586092,LISP 5B,A00,507671,Munoz Sanchez; Alicia,16,0,20,4
1713323587117,LISP 5C,A00,507696,Munoz Sanchez; Alicia,16,0,20,4
1713323588142,MAE 197,001,528363,Boechler; Nicholas Sebastia,9998,0,9999,1
1713323589167,MATH 197,001,523477,Kedlaya; Kiran S.,9999,0,9999,0
1713323589167,MATH 197,002,563811,Zhang; Danna,9999,0,9999,0
1713323590195,MCWP 40R,A00,518780,Staff,20,0,20,0
1713323590195,MCWP 40R,B00,518781,Staff,19,0,20,1
1713323590195,MCWP 40R,C00,518783,Staff,19,0,20,1
1713323591223,MCWP 50R,A00,518791,Staff,20,0,20,0
1713323591223,MCWP 50R,B00,518792,Staff,17,0,20,3
1713323591223,MCWP 50R,C00,518793,Staff,19,0,20,1
1713323591223,MCWP 50R,D00,518794,Staff,16,0,20,4
1713323591223,MCWP 50R,E00,518795,Staff,16,0,20,4
1713323591223,MCWP 50R,F00,518796,Staff,19,0,20,1
1713323591223,MCWP 50R,G00,518797,Staff,19,0,20,1
1713323592249,MMW 12R,A01,514034,Herbst; Matthew,15,0,16,1
1713323592249,MMW 12R,A02,514035,Herbst; Matthew,16,0,16,0
1713323593273,MMW 13R,A01,514037,Staff,12,0,16,4
1713323593273,MMW 13R,A02,514039,Staff,16,0,16,0
1713323595326,SIO 295LS,A00,523233,Staff,19,0,30,11
1713323596355,SIO 295S,A00,523232,Staff,19,0,30,11
1713323597379,SOCI 117,A01,494376,Staff,2,0,5,3
1713323598404,WES 237B,A00,494380,Staff,19,0,20,1
1713323600475,AESE 279B,A00,494370,Wade; Jon P,33,0,33,0
1713323601500,ANAR 135S,A00,494369,Braswell; Geoffrey E.,0,0,0,0
1713323602528,CAT 124RS,A01,519847,Geibel; William,17,0,20,3
1713323603556,CAT 125RS,A01,515971,Geibel; William,17,0,20,3
1713323604580,CLRE 250,A00,511389,Morris; Sheldon,9996,0,9999,3
1713323605605,CLRE 251,A00,507176,Mehta; Ravindra L.,9996,0,9999,3
1713323605605,CLRE 251,B00,511410,Mehta; Ravindra L.,9998,0,9999,1
1713323606630,CLRE 252,A00,507189,Cuomo; Raphael Eduardo,9998,0,9999,1
1713323607655,CLRE 253,A00,507199,Vaida; Florin,9997,0,9999,2
1713323607655,CLRE 253,B00,507202,Vaida; Florin,9999,0,9999,0
1713323608682,CLRE 259,A00,507211,Patel; Hemal,9996,0,9999,3
1713323609706,CLRE 260,A00,507221,Cuomo; Raphael Eduardo,9999,0,9999,0
1713323610734,CLRE 297,001,507242,Cuomo; Raphael Eduardo,9999,0,9999,0
1713323611764,CSE 191,A00,516875,Minnes Kemp; Mor Mia,9999,0,9999,0
1713323612793,CSS 201S,A01,494383,Staff,35,0,35,0
1713323613820,CSS 202S,A01,494387,Staff,35,0,35,0
1713323614847,EAP 100,A00,516065,Staff,9792,0,9999,207
1713323615872,ECE 45,A01,507414,Staff,52,0,60,8
1713323616897,ECE 100,A01,507416,Baghdadchi; Saharnaz,11,0,20,9
1713323616897,ECE 100,A02,507418,Baghdadchi; Saharnaz,20,0,20,0
1713323617923,ECE 111,A01,507420,Staff,39,0,50,11
1713323618951,ECE 197,001,548057,Sievenpiper; Daniel F.,9998,0,9999,1
1713323619976,EDS 115,A00,507243,Choi; Bailey Miyeon,28,0,28,0
1713323621005,EDS 117,A01,494379,Staff,23,0,25,2
1713323622032,EDS 125,A00,507246,Hopkins; Megan Beth,29,0,30,1
1713323623061,EDS 128A,A01,507264,Fargason; Sharon Gayle,26,0,26,0
1713323624086,EDS 128B,A01,507293,Pappas; Elizabeth,30,0,30,0
1713323625111,EDS 139,A00,507294,Fargason; Sharon Gayle,30,0,30,0
1713323625111,EDS 139,B00,507313,Pappas; Elizabeth,30,0,30,0
1713323626140,EDS 201,A00,507315,Staff,26,0,30,4
1713323627166,EDS 203,A01,507317,Halter; Christopher P.,26,0,30,4
1713323628194,EDS 204R,A01,507319,Halter; Christopher P.,3,0,30,27
1713323628194,EDS 204R,B01,507331,Heinzman; Erica M.,28,0,30,2
1713323629221,EDS 206R,A00,507332,Staff,4,0,30,26
1713323629221,EDS 206R,B00,507343,Staff,28,0,30,2
1713323630251,EDS 250,A00,507344,Hemans; Patricia Ann Benitez,36,0,40,4
1713323631276,EDS 281,A00,507345,Daly; Alan J.,18,0,18,0
1713323632302,EDS 284,A00,507350,Daly; Alan J.,16,0,16,0
1713323633329,EDS 286,A00,507359,Fine; Sarah,18,0,18,0
1713323634355,EDS 289C,A01,507361,Daly; Alan J.,18,0,18,0
1713323635380,EDS 290,A00,507366,Hofstetter; Carolyn,15,0,15,0
1713323636405,LIGM 5A,A00,507421,Fischer-Grunski; Eva K,20,0,20,0
1713323637430,LIGM 5B,A00,507423,Fischer-Grunski; Eva K,20,0,20,0
1713323638460,LIGM 5C,A00,507425,Fischer-Grunski; Eva K,20,0,20,0
1713323639488,LIIT 5AS,A00,507427,Carnelos; Chiara,20,0,20,0
1713323640518,LIIT 5BS,A00,507430,Carnelos; Chiara,20,0,20,0
1713323641542,LIIT 5CS,A00,507432,Carnelos; Chiara,20,0,20,0
1713323642568,LISP 5A,A00,507541,Munoz Sanchez; Alicia,18,0,20,2
1713323643597,LISP 5B,A00,507671,Munoz Sanchez; Alicia,16,0,20,4
1713323644625,LISP 5C,A00,507696,Munoz Sanchez; Alicia,16,0,20,4
1713323645654,MAE 197,001,528363,Boechler; Nicholas Sebastia,9998,0,9999,1
1713323646679,MATH 197,001,523477,Kedlaya; Kiran S.,9999,0,9999,0
1713323646679,MATH 197,002,563811,Zhang; Danna,9999,0,9999,0
1713323647706,MCWP 40R,A00,518780,Staff,20,0,20,0
1713323647706,MCWP 40R,B00,518781,Staff,19,0,20,1
1713323647706,MCWP 40R,C00,518783,Staff,19,0,20,1
1713323648732,MCWP 50R,A00,518791,Staff,20,0,20,0
1713323648732,MCWP 50R,B00,518792,Staff,17,0,20,3
1713323648732,MCWP 50R,C00,518793,Staff,19,0,20,1
1713323648732,MCWP 50R,D00,518794,Staff,16,0,20,4
1713323648732,MCWP 50R,E00,518795,Staff,16,0,20,4
1713323648732,MCWP 50R,F00,518796,Staff,19,0,20,1
1713323648732,MCWP 50R,G00,518797,Staff,19,0,20,1
1713323649760,MMW 12R,A01,514034,Herbst; Matthew,15,0,16,1
1713323649760,MMW 12R,A02,514035,Herbst; Matthew,16,0,16,0
1713323650788,MMW 13R,A01,514037,Staff,12,0,16,4
1713323650788,MMW 13R,A02,514039,Staff,16,0,16,0
1713323652836,SIO 295LS,A00,523233,Staff,19,0,30,11
1713323653860,SIO 295S,A00,523232,Staff,19,0,30,11
1713323654886,SOCI 117,A01,494376,Staff,2,0,5,3
1713323655913,WES 237B,A00,494380,Staff,19,0,20,1
1713323657985,AESE 279B,A00,494370,Wade; Jon P,33,0,33,0
1713323659010,ANAR 135S,A00,494369,Braswell; Geoffrey E.,0,0,0,0
1713323660036,CAT 124RS,A01,519847,Geibel; William,17,0,20,3
1713323661064,CAT 125RS,A01,515971,Geibel; William,17,0,20,3
1713323662089,CLRE 250,A00,511389,Morris; Sheldon,9996,0,9999,3
1713323663115,CLRE 251,A00,507176,Mehta; Ravindra L.,9996,0,9999,3
1713323663115,CLRE 251,B00,511410,Mehta; Ravindra L.,9998,0,9999,1
1713323664143,CLRE 252,A00,507189,Cuomo; Raphael Eduardo,9998,0,9999,1
1713323665172,CLRE 253,A00,507199,Vaida; Florin,9997,0,9999,2
1713323665172,CLRE 253,B00,507202,Vaida; Florin,9999,0,9999,0
1713323666198,CLRE 259,A00,507211,Patel; Hemal,9996,0,9999,3
1713323667222,CLRE 260,A00,507221,Cuomo; Raphael Eduardo,9999,0,9999,0
1713323668249,CLRE 297,001,507242,Cuomo; Raphael Eduardo,9999,0,9999,0
1713323669274,CSE 191,A00,516875,Minnes Kemp; Mor Mia,9999,0,9999,0
1713323670301,CSS 201S,A01,494383,Staff,35,0,35,0
1713323671328,CSS 202S,A01,494387,Staff,35,0,35,0
1713323672355,EAP 100,A00,516065,Staff,9792,0,9999,207
1713323673378,ECE 45,A01,507414,Staff,52,0,60,8
1713323674403,ECE 100,A01,507416,Baghdadchi; Saharnaz,11,0,20,9
1713323674403,ECE 100,A02,507418,Baghdadchi; Saharnaz,20,0,20,0
1713323675434,ECE 111,A01,507420,Staff,39,0,50,11
1713323676457,ECE 197,001,548057,Sievenpiper; Daniel F.,9998,0,9999,1
1713323677536,EDS 115,A00,507243,Choi; Bailey Miyeon,28,0,28,0
1713323678564,EDS 117,A01,494379,Staff,23,0,25,2
1713323679588,EDS 125,A00,507246,Hopkins; Megan Beth,29,0,30,1
1713323680617,EDS 128A,A01,507264,Fargason; Sharon Gayle,26,0,26,0
1713323681642,EDS 128B,A01,507293,Pappas; Elizabeth,30,0,30,0
1713323682668,EDS 139,A00,507294,Fargason; Sharon Gayle,30,0,30,0
1713323682668,EDS 139,B00,507313,Pappas; Elizabeth,30,0,30,0
1713323683695,EDS 201,A00,507315,Staff,26,0,30,4
1713323684725,EDS 203,A01,507317,Halter; Christopher P.,26,0,30,4
1713323685754,EDS 204R,A01,507319,Halter; Christopher P.,3,0,30,27
1713323685754,EDS 204R,B01,507331,Heinzman; Erica M.,28,0,30,2
1713323686778,EDS 206R,A00,507332,Staff,4,0,30,26
1713323686778,EDS 206R,B00,507343,Staff,28,0,30,2
1713323687804,EDS 250,A00,507344,Hemans; Patricia Ann Benitez,36,0,40,4
1713323688828,EDS 281,A00,507345,Daly; Alan J.,18,0,18,0
1713323689856,EDS 284,A00,507350,Daly; Alan J.,16,0,16,0
1713323690881,EDS 286,A00,507359,Fine; Sarah,18,0,18,0
1713323691910,EDS 289C,A01,507361,Daly; Alan J.,18,0,18,0
1713323692936,EDS 290,A00,507366,Hofstetter; Carolyn,15,0,15,0
1713323693960,LIGM 5A,A00,507421,Fischer-Grunski; Eva K,20,0,20,0
1713323694985,LIGM 5B,A00,507423,Fischer-Grunski; Eva K,20,0,20,0
1713323696012,LIGM 5C,A00,507425,Fischer-Grunski; Eva K,20,0,20,0
1713323697041,LIIT 5AS,A00,507427,Carnelos; Chiara,20,0,20,0
1713323698067,LIIT 5BS,A00,507430,Carnelos; Chiara,20,0,20,0
1713323699092,LIIT 5CS,A00,507432,Carnelos; Chiara,20,0,20,0
1713323700121,LISP 5A,A00,507541,Munoz Sanchez; Alicia,18,0,20,2
1713323701150,LISP 5B,A00,507671,Munoz Sanchez; Alicia,16,0,20,4
1713323702176,LISP 5C,A00,507696,Munoz Sanchez; Alicia,16,0,20,4
1713323703200,MAE 197,001,528363,Boechler; Nicholas Sebastia,9998,0,9999,1
1713323704225,MATH 197,001,523477,Kedlaya; Kiran S.,9999,0,9999,0
1713323704225,MATH 197,002,563811,Zhang; Danna,9999,0,9999,0
1713323705255,MCWP 40R,A00,518780,Staff,20,0,20,0
1713323705255,MCWP 40R,B00,518781,Staff,19,0,20,1
1713323705255,MCWP 40R,C00,518783,Staff,19,0,20,1
1713323706279,MCWP 50R,A00,518791,Staff,20,0,20,0
1713323706279,MCWP 50R,B00,518792,Staff,17,0,20,3
1713323706279,MCWP 50R,C00,518793,Staff,19,0,20,1
1713323706279,MCWP 50R,D00,518794,Staff,16,0,20,4
1713323706279,MCWP 50R,E00,518795,Staff,16,0,20,4
1713323706279,MCWP 50R,F00,518796,Staff,19,0,20,1
1713323706279,MCWP 50R,G00,518797,Staff,19,0,20,1
1713323707306,MMW 12R,A01,514034,Herbst; Matthew,15,0,16,1
1713323707306,MMW 12R,A02,514035,Herbst; Matthew,16,0,16,0
1713323708332,MMW 13R,A01,514037,Staff,12,0,16,4
1713323708332,MMW 13R,A02,514039,Staff,16,0,16,0
1713323710388,SIO 295LS,A00,523233,Staff,19,0,30,11
1713323711414,SIO 295S,A00,523232,Staff,19,0,30,11
1713323712441,SOCI 117,A01,494376,Staff,2,0,5,3
1713323713490,WES 237B,A00,494380,Staff,19,0,20,1
1713323715548,AESE 279B,A00,494370,Wade; Jon P,33,0,33,0
1713323716572,ANAR 135S,A00,494369,Braswell; Geoffrey E.,0,0,0,0
1713323717599,CAT 124RS,A01,519847,Geibel; William,17,0,20,3
1713323718626,CAT 125RS,A01,515971,Geibel; William,17,0,20,3
1713323719651,CLRE 250,A00,511389,Morris; Sheldon,9996,0,9999,3
1713323720682,CLRE 251,A00,507176,Mehta; Ravindra L.,9996,0,9999,3
1713323720682,CLRE 251,B00,511410,Mehta; Ravindra L.,9998,0,9999,1
1713323721709,CLRE 252,A00,507189,Cuomo; Raphael Eduardo,9998,0,9999,1
1713323722737,CLRE 253,A00,507199,Vaida; Florin,9997,0,9999,2
1713323722737,CLRE 253,B00,507202,Vaida; Florin,9999,0,9999,0
1713323723761,CLRE 259,A00,507211,Patel; Hemal,9996,0,9999,3
1713323724791,CLRE 260,A00,507221,Cuomo; Raphael Eduardo,9999,0,9999,0
1713323725815,CLRE 297,001,507242,Cuomo; Raphael Eduardo,9999,0,9999,0
1713323726839,CSE 191,A00,516875,Minnes Kemp; Mor Mia,9999,0,9999,0
1713323727864,CSS 201S,A01,494383,Staff,35,0,35,0
1713323728890,CSS 202S,A01,494387,Staff,35,0,35,0
1713323729916,EAP 100,A00,516065,Staff,9792,0,9999,207
1713323730942,ECE 45,A01,507414,Staff,52,0,60,8
1713323731972,ECE 100,A01,507416,Baghdadchi; Saharnaz,11,0,20,9
1713323731972,ECE 100,A02,507418,Baghdadchi; Saharnaz,20,0,20,0
1713323732999,ECE 111,A01,507420,Staff,39,0,50,11
1713323734024,ECE 197,001,548057,Sievenpiper; Daniel F.,9998,0,9999,1
1713323735050,EDS 115,A00,507243,Choi; Bailey Miyeon,28,0,28,0
1713323736075,EDS 117,A01,494379,Staff,23,0,25,2
1713323737105,EDS 125,A00,507246,Hopkins; Megan Beth,29,0,30,1
1713323738134,EDS 128A,A01,507264,Fargason; Sharon Gayle,26,0,26,0
1713323739159,EDS 128B,A01,507293,Pappas; Elizabeth,30,0,30,0
1713323740184,EDS 139,A00,507294,Fargason; Sharon Gayle,30,0,30,0
1713323740184,EDS 139,B00,507313,Pappas; Elizabeth,30,0,30,0
1713323741212,EDS 201,A00,507315,Staff,26,0,30,4
1713323742235,EDS 203,A01,507317,Halter; Christopher P.,26,0,30,4
1713323743260,EDS 204R,A01,507319,Halter; Christopher P.,3,0,30,27
1713323743260,EDS 204R,B01,507331,Heinzman; Erica M.,28,0,30,2
1713323744286,EDS 206R,A00,507332,Staff,4,0,30,26
1713323744286,EDS 206R,B00,507343,Staff,28,0,30,2
1713323745311,EDS 250,A00,507344,Hemans; Patricia Ann Benitez,36,0,40,4
1713323746335,EDS 281,A00,507345,Daly; Alan J.,18,0,18,0
1713323747360,EDS 284,A00,507350,Daly; Alan J.,16,0,16,0
1713323748384,EDS 286,A00,507359,Fine; Sarah,18,0,18,0
1713323749408,EDS 289C,A01,507361,Daly; Alan J.,18,0,18,0
1713323750431,EDS 290,A00,507366,Hofstetter; Carolyn,15,0,15,0
1713323751461,LIGM 5A,A00,507421,Fischer-Grunski; Eva K,20,0,20,0
1713323752486,LIGM 5B,A00,507423,Fischer-Grunski; Eva K,20,0,20,0
1713323753512,LIGM 5C,A00,507425,Fischer-Grunski; Eva K,20,0,20,0
1713323754538,LIIT 5AS,A00,507427,Carnelos; Chiara,20,0,20,0
1713323755567,LIIT 5BS,A00,507430,Carnelos; Chiara,20,0,20,0
1713323756593,LIIT 5CS,A00,507432,Carnelos; Chiara,20,0,20,0
1713323757620,LISP 5A,A00,507541,Munoz Sanchez; Alicia,18,0,20,2
1713323758645,LISP 5B,A00,507671,Munoz Sanchez; Alicia,16,0,20,4
1713323759669,LISP 5C,A00,507696,Munoz Sanchez; Alicia,16,0,20,4
1713323760693,MAE 197,001,528363,Boechler; Nicholas Sebastia,9998,0,9999,1
1713323761722,MATH 197,001,523477,Kedlaya; Kiran S.,9999,0,9999,0
1713323761722,MATH 197,002,563811,Zhang; Danna,9999,0,9999,0
1713323762752,MCWP 40R,A00,518780,Staff,20,0,20,0
1713323762752,MCWP 40R,B00,518781,Staff,19,0,20,1
1713323762752,MCWP 40R,C00,518783,Staff,19,0,20,1
1713323763776,MCWP 50R,A00,518791,Staff,20,0,20,0
1713323763776,MCWP 50R,B00,518792,Staff,17,0,20,3
1713323763776,MCWP 50R,C00,518793,Staff,19,0,20,1
1713323763776,MCWP 50R,D00,518794,Staff,16,0,20,4
1713323763776,MCWP 50R,E00,518795,Staff,16,0,20,4
1713323763776,MCWP 50R,F00,518796,Staff,19,0,20,1
1713323763776,MCWP 50R,G00,518797,Staff,19,0,20,1
1713323764805,MMW 12R,A01,514034,Herbst; Matthew,15,0,16,1
1713323764805,MMW 12R,A02,514035,Herbst; Matthew,16,0,16,0
1713323765834,MMW 13R,A01,514037,Staff,12,0,16,4
1713323765834,MMW 13R,A02,514039,Staff,16,0,16,0
1713323767891,SIO 295LS,A00,523233,Staff,19,0,30,11
1713323768920,SIO 295S,A00,523232,Staff,19,0,30,11
1713323769945,SOCI 117,A01,494376,Staff,2,0,5,3
1713323770970,WES 237B,A00,494380,Staff,19,0,20,1
1713323773023,AESE 279B,A00,494370,Wade; Jon P,33,0,33,0
1713323774052,ANAR 135S,A00,494369,Braswell; Geoffrey E.,0,0,0,0
1713323775075,CAT 124RS,A01,519847,Geibel; William,17,0,20,3
1713323776103,CAT 125RS,A01,515971,Geibel; William,17,0,20,3
1713323777128,CLRE 250,A00,511389,Morris; Sheldon,9996,0,9999,3
1713323778153,CLRE 251,A00,507176,Mehta; Ravindra L.,9996,0,9999,3
1713323778153,CLRE 251,B00,511410,Mehta; Ravindra L.,9998,0,9999,1
1713323779182,CLRE 252,A00,507189,Cuomo; Raphael Eduardo,9998,0,9999,1
1713323780330,CLRE 253,A00,507199,Vaida; Florin,9997,0,9999,2
1713323780330,CLRE 253,B00,507202,Vaida; Florin,9999,0,9999,0
1713323781412,CLRE 259,A00,507211,Patel; Hemal,9996,0,9999,3
1713323782440,CLRE 260,A00,507221,Cuomo; Raphael Eduardo,9999,0,9999,0
1713323783473,CLRE 297,001,507242,Cuomo; Raphael Eduardo,9999,0,9999,0
1713323784497,CSE 191,A00,516875,Minnes Kemp; Mor Mia,9999,0,9999,0
1713323785521,CSS 201S,A01,494383,Staff,35,0,35,0
1713323786547,CSS 202S,A01,494387,Staff,35,0,35,0
1713323787576,EAP 100,A00,516065,Staff,9792,0,9999,207
1713323788603,ECE 45,A01,507414,Staff,52,0,60,8
1713323789627,ECE 100,A01,507416,Baghdadchi; Saharnaz,11,0,20,9
1713323789627,ECE 100,A02,507418,Baghdadchi; Saharnaz,20,0,20,0
1713323790652,ECE 111,A01,507420,Staff,39,0,50,11
1713323791676,ECE 197,001,548057,Sievenpiper; Daniel F.,9998,0,9999,1
1713323792705,EDS 115,A00,507243,Choi; Bailey Miyeon,28,0,28,0
1713323793731,EDS 117,A01,494379,Staff,23,0,25,2
1713323794757,EDS 125,A00,507246,Hopkins; Megan Beth,29,0,30,1
1713323795782,EDS 128A,A01,507264,Fargason; Sharon Gayle,26,0,26,0
1713323796809,EDS 128B,A01,507293,Pappas; Elizabeth,30,0,30,0
1713323797837,EDS 139,A00,507294,Fargason; Sharon Gayle,30,0,30,0
1713323797837,EDS 139,B00,507313,Pappas; Elizabeth,30,0,30,0
1713323798862,EDS 201,A00,507315,Staff,26,0,30,4
1713323799890,EDS 203,A01,507317,Halter; Christopher P.,26,0,30,4
1713323800916,EDS 204R,A01,507319,Halter; Christopher P.,3,0,30,27
1713323800916,EDS 204R,B01,507331,Heinzman; Erica M.,28,0,30,2
1713323801940,EDS 206R,A00,507332,Staff,4,0,30,26
1713323801940,EDS 206R,B00,507343,Staff,28,0,30,2
1713323802967,EDS 250,A00,507344,Hemans; Patricia Ann Benitez,36,0,40,4
1713323803991,EDS 281,A00,507345,Daly; Alan J.,18,0,18,0
1713323805018,EDS 284,A00,507350,Daly; Alan J.,16,0,16,0
1713323806048,EDS 286,A00,507359,Fine; Sarah,18,0,18,0
1713323807074,EDS 289C,A01,507361,Daly; Alan J.,18,0,18,0
1713323808097,EDS 290,A00,507366,Hofstetter; Carolyn,15,0,15,0
1713323809123,LIGM 5A,A00,507421,Fischer-Grunski; Eva K,20,0,20,0
1713323810150,LIGM 5B,A00,507423,Fischer-Grunski; Eva K,20,0,20,0
1713323811178,LIGM 5C,A00,507425,Fischer-Grunski; Eva K,20,0,20,0
1713323812204,LIIT 5AS,A00,507427,Carnelos; Chiara,20,0,20,0
1713323813232,LIIT 5BS,A00,507430,Carnelos; Chiara,20,0,20,0
1713323814255,LIIT 5CS,A00,507432,Carnelos; Chiara,20,0,20,0
1713323815280,LISP 5A,A00,507541,Munoz Sanchez; Alicia,18,0,20,2
1713323816311,LISP 5B,A00,507671,Munoz Sanchez; Alicia,16,0,20,4
1713323817335,LISP 5C,A00,507696,Munoz Sanchez; Alicia,16,0,20,4
1713323818359,MAE 197,001,528363,Boechler; Nicholas Sebastia,9998,0,9999,1
1713323819383,MATH 197,001,523477,Kedlaya; Kiran S.,9999,0,9999,0
1713323819383,MATH 197,002,563811,Zhang; Danna,9999,0,9999,0
1713323820408,MCWP 40R,A00,518780,Staff,20,0,20,0
1713323820408,MCWP 40R,B00,518781,Staff,19,0,20,1
1713323820408,MCWP 40R,C00,518783,Staff,19,0,20,1
1713323821436,MCWP 50R,A00,518791,Staff,20,0,20,0
1713323821436,MCWP 50R,B00,518792,Staff,17,0,20,3
1713323821436,MCWP 50R,C00,518793,Staff,19,0,20,1
1713323821436,MCWP 50R,D00,518794,Staff,16,0,20,4
1713323821436,MCWP 50R,E00,518795,Staff,16,0,20,4
1713323821436,MCWP 50R,F00,518796,Staff,19,0,20,1
1713323821436,MCWP 50R,G00,518797,Staff,19,0,20,1
1713323822463,MMW 12R,A01,514034,Herbst; Matthew,15,0,16,1
1713323822463,MMW 12R,A02,514035,Herbst; Matthew,16,0,16,0
1713323823500,MMW 13R,A01,514037,Staff,12,0,16,4
1713323823500,MMW 13R,A02,514039,Staff,16,0,16,0
1713323825552,SIO 295LS,A00,523233,Staff,19,0,30,11
1713323826576,SIO 295S,A00,523232,Staff,19,0,30,11
1713323827600,SOCI 117,A01,494376,Staff,2,0,5,3
1713323828624,WES 237B,A00,494380,Staff,19,0,20,1
1713323830692,AESE 279B,A00,494370,Wade; Jon P,33,0,33,0
1713323831720,ANAR 135S,A00,494369,Braswell; Geoffrey E.,0,0,0,0
1713323832748,CAT 124RS,A01,519847,Geibel; William,17,0,20,3
1713323833775,CAT 125RS,A01,515971,Geibel; William,17,0,20,3
1713323834803,CLRE 250,A00,511389,Morris; Sheldon,9996,0,9999,3
1713323835832,CLRE 251,A00,507176,Mehta; Ravindra L.,9996,0,9999,3
1713323835832,CLRE 251,B00,511410,Mehta; Ravindra L.,9998,0,9999,1
1713323836859,CLRE 252,A00,507189,Cuomo; Raphael Eduardo,9998,0,9999,1
1713323837883,CLRE 253,A00,507199,Vaida; Florin,9997,0,9999,2
1713323837883,CLRE 253,B00,507202,Vaida; Florin,9999,0,9999,0
1713323838909,CLRE 259,A00,507211,Patel; Hemal,9996,0,9999,3
1713323839939,CLRE 260,A00,507221,Cuomo; Raphael Eduardo,9999,0,9999,0
1713323840967,CLRE 297,001,507242,Cuomo; Raphael Eduardo,9999,0,9999,0
1713323841991,CSE 191,A00,516875,Minnes Kemp; Mor Mia,9999,0,9999,0
1713323843020,CSS 201S,A01,494383,Staff,35,0,35,0
1713323844049,CSS 202S,A01,494387,Staff,35,0,35,0
1713323845075,EAP 100,A00,516065,Staff,9792,0,9999,207
1713323846099,ECE 45,A01,507414,Staff,52,0,60,8
1713323847127,ECE 100,A01,507416,Baghdadchi; Saharnaz,11,0,20,9
1713323847127,ECE 100,A02,507418,Baghdadchi; Saharnaz,20,0,20,0
1713323848152,ECE 111,A01,507420,Staff,39,0,50,11
1713323849179,ECE 197,001,548057,Sievenpiper; Daniel F.,9998,0,9999,1
1713323850207,EDS 115,A00,507243,Choi; Bailey Miyeon,28,0,28,0
1713323851236,EDS 117,A01,494379,Staff,23,0,25,2
1713323852261,EDS 125,A00,507246,Hopkins; Megan Beth,29,0,30,1
1713323853286,EDS 128A,A01,507264,Fargason; Sharon Gayle,26,0,26,0
1713323854311,EDS 128B,A01,507293,Pappas; Elizabeth,30,0,30,0
1713323855336,EDS 139,A00,507294,Fargason; Sharon Gayle,30,0,30,0
1713323855336,EDS 139,B00,507313,Pappas; Elizabeth,30,0,30,0
1713323856363,EDS 201,A00,507315,Staff,26,0,30,4
1713323857388,EDS 203,A01,507317,Halter; Christopher P.,26,0,30,4
1713323858414,EDS 204R,A01,507319,Halter; Christopher P.,3,0,30,27
1713323858414,EDS 204R,B01,507331,Heinzman; Erica M.,28,0,30,2
1713323859436,EDS 206R,A00,507332,Staff,4,0,30,26
1713323859436,EDS 206R,B00,507343,Staff,28,0,30,2
1713323860461,EDS 250,A00,507344,Hemans; Patricia Ann Benitez,36,0,40,4
1713323861490,EDS 281,A00,507345,Daly; Alan J.,18,0,18,0
1713323862521,EDS 284,A00,507350,Daly; Alan J.,16,0,16,0
1713323863550,EDS 286,A00,507359,Fine; Sarah,18,0,18,0
1713323864579,EDS 289C,A01,507361,Daly; Alan J.,18,0,18,0
1713323865604,EDS 290,A00,507366,Hofstetter; Carolyn,15,0,15,0
1713323866628,LIGM 5A,A00,507421,Fischer-Grunski; Eva K,20,0,20,0
1713323867654,LIGM 5B,A00,507423,Fischer-Grunski; Eva K,20,0,20,0
1713323868683,LIGM 5C,A00,507425,Fischer-Grunski; Eva K,20,0,20,0
1713323869711,LIIT 5AS,A00,507427,Carnelos; Chiara,20,0,20,0
1713323870736,LIIT 5BS,A00,507430,Carnelos; Chiara,20,0,20,0
1713323871764,LIIT 5CS,A00,507432,Carnelos; Chiara,20,0,20,0
1713323872788,LISP 5A,A00,507541,Munoz Sanchez; Alicia,18,0,20,2
1713323873817,LISP 5B,A00,507671,Munoz Sanchez; Alicia,16,0,20,4
1713323874842,LISP 5C,A00,507696,Munoz Sanchez; Alicia,16,0,20,4
1713323875866,MAE 197,001,528363,Boechler; Nicholas Sebastia,9998,0,9999,1
1713323876893,MATH 197,001,523477,Kedlaya; Kiran S.,9999,0,9999,0
1713323876893,MATH 197,002,563811,Zhang; Danna,9999,0,9999,0
1713323877919,MCWP 40R,A00,518780,Staff,20,0,20,0
1713323877919,MCWP 40R,B00,518781,Staff,19,0,20,1
1713323877919,MCWP 40R,C00,518783,Staff,19,0,20,1
1713323878948,MCWP 50R,A00,518791,Staff,20,0,20,0
1713323878948,MCWP 50R,B00,518792,Staff,17,0,20,3
1713323878948,MCWP 50R,C00,518793,Staff,19,0,20,1
1713323878948,MCWP 50R,D00,518794,Staff,16,0,20,4
1713323878948,MCWP 50R,E00,518795,Staff,16,0,20,4
1713323878948,MCWP 50R,F00,518796,Staff,19,0,20,1
1713323878948,MCWP 50R,G00,518797,Staff,19,0,20,1
1713323879973,MMW 12R,A01,514034,Herbst; Matthew,15,0,16,1
1713323879973,MMW 12R,A02,514035,Herbst; Matthew,16,0,16,0
1713323880997,MMW 13R,A01,514037,Staff,12,0,16,4
1713323880997,MMW 13R,A02,514039,Staff,16,0,16,0
1713323883052,SIO 295LS,A00,523233,Staff,19,0,30,11
1713323884077,SIO 295S,A00,523232,Staff,19,0,30,11
1713323885157,SOCI 117,A01,494376,Staff,2,0,5,3
1713323886183,WES 237B,A00,494380,Staff,19,0,20,1
1713323888245,AESE 279B,A00,494370,Wade; Jon P,33,0,33,0
1713323889272,ANAR 135S,A00,494369,Braswell; Geoffrey E.,0,0,0,0
1713323890297,CAT 124RS,A01,519847,Geibel; William,17,0,20,3
1713323891323,CAT 125RS,A01,515971,Geibel; William,17,0,20,3
1713323892347,CLRE 250,A00,511389,Morris; Sheldon,9996,0,9999,3
1713323893372,CLRE 251,A00,507176,Mehta; Ravindra L.,9996,0,9999,3
1713323893372,CLRE 251,B00,511410,Mehta; Ravindra L.,9998,0,9999,1
1713323894397,CLRE 252,A00,507189,Cuomo; Raphael Eduardo,9998,0,9999,1
1713323895422,CLRE 253,A00,507199,Vaida; Florin,9997,0,9999,2
1713323895422,CLRE 253,B00,507202,Vaida; Florin,9999,0,9999,0
1713323896445,CLRE 259,A00,507211,Patel; Hemal,9996,0,9999,3
1713323897470,CLRE 260,A00,507221,Cuomo; Raphael Eduardo,9999,0,9999,0
1713323898493,CLRE 297,001,507242,Cuomo; Raphael Eduardo,9999,0,9999,0
1713323899520,CSE 191,A00,516875,Minnes Kemp; Mor Mia,9999,0,9999,0
1713323900544,CSS 201S,A01,494383,Staff,35,0,35,0
1713323901568,CSS 202S,A01,494387,Staff,35,0,35,0
1713323902593,EAP 100,A00,516065,Staff,9792,0,9999,207
1713323903618,ECE 45,A01,507414,Staff,52,0,60,8
1713323904643,ECE 100,A01,507416,Baghdadchi; Saharnaz,11,0,20,9
1713323904643,ECE 100,A02,507418,Baghdadchi; Saharnaz,20,0,20,0
1713323905667,ECE 111,A01,507420,Staff,39,0,50,11
1713323906691,ECE 197,001,548057,Sievenpiper; Daniel F.,9998,0,9999,1
1713323907717,EDS 115,A00,507243,Choi; Bailey Miyeon,28,0,28,0
1713323908742,EDS 117,A01,494379,Staff,23,0,25,2
1713323909772,EDS 125,A00,507246,Hopkins; Megan Beth,29,0,30,1
1713323910797,EDS 128A,A01,507264,Fargason; Sharon Gayle,26,0,26,0
1713323911822,EDS 128B,A01,507293,Pappas; Elizabeth,30,0,30,0
1713323912849,EDS 139,A00,507294,Fargason; Sharon Gayle,30,0,30,0
1713323912849,EDS 139,B00,507313,Pappas; Elizabeth,30,0,30,0
1713323913877,EDS 201,A00,507315,Staff,26,0,30,4
1713323914902,EDS 203,A01,507317,Halter; Christopher P.,26,0,30,4
1713323915930,EDS 204R,A01,507319,Halter; Christopher P.,3,0,30,27
1713323915930,EDS 204R,B01,507331,Heinzman; Erica M.,28,0,30,2
1713323916958,EDS 206R,A00,507332,Staff,4,0,30,26
1713323916958,EDS 206R,B00,507343,Staff,28,0,30,2
1713323917983,EDS 250,A00,507344,Hemans; Patricia Ann Benitez,36,0,40,4
1713323919007,EDS 281,A00,507345,Daly; Alan J.,18,0,18,0
1713323920031,EDS 284,A00,507350,Daly; Alan J.,16,0,16,0
1713323921054,EDS 286,A00,507359,Fine; Sarah,18,0,18,0
1713323922081,EDS 289C,A01,507361,Daly; Alan J.,18,0,18,0
1713323923105,EDS 290,A00,507366,Hofstetter; Carolyn,15,0,15,0
1713323924133,LIGM 5A,A00,507421,Fischer-Grunski; Eva K,20,0,20,0
1713323925158,LIGM 5B,A00,507423,Fischer-Grunski; Eva K,20,0,20,0
1713323926183,LIGM 5C,A00,507425,Fischer-Grunski; Eva K,20,0,20,0
1713323927210,LIIT 5AS,A00,507427,Carnelos; Chiara,20,0,20,0
1713323928240,LIIT 5BS,A00,507430,Carnelos; Chiara,20,0,20,0
1713323929268,LIIT 5CS,A00,507432,Carnelos; Chiara,20,0,20,0
1713323930292,LISP 5A,A00,507541,Munoz Sanchez; Alicia,18,0,20,2
1713323931317,LISP 5B,A00,507671,Munoz Sanchez; Alicia,16,0,20,4
1713323932342,LISP 5C,A00,507696,Munoz Sanchez; Alicia,16,0,20,4
1713323933368,MAE 197,001,528363,Boechler; Nicholas Sebastia,9998,0,9999,1
1713323934393,MATH 197,001,523477,Kedlaya; Kiran S.,9999,0,9999,0
1713323934393,MATH 197,002,563811,Zhang; Danna,9999,0,9999,0
1713323935416,MCWP 40R,A00,518780,Staff,20,0,20,0
1713323935416,MCWP 40R,B00,518781,Staff,19,0,20,1
1713323935416,MCWP 40R,C00,518783,Staff,19,0,20,1
1713323936442,MCWP 50R,A00,518791,Staff,20,0,20,0
1713323936442,MCWP 50R,B00,518792,Staff,17,0,20,3
1713323936442,MCWP 50R,C00,518793,Staff,19,0,20,1
1713323936442,MCWP 50R,D00,518794,Staff,16,0,20,4
1713323936442,MCWP 50R,E00,518795,Staff,16,0,20,4
1713323936442,MCWP 50R,F00,518796,Staff,19,0,20,1
1713323936442,MCWP 50R,G00,518797,Staff,19,0,20,1
1713323937465,MMW 12R,A01,514034,Herbst; Matthew,15,0,16,1
1713323937465,MMW 12R,A02,514035,Herbst; Matthew,16,0,16,0
1713323938491,MMW 13R,A01,514037,Staff,12,0,16,4
1713323938491,MMW 13R,A02,514039,Staff,16,0,16,0
1713323940540,SIO 295LS,A00,523233,Staff,19,0,30,11
1713323941570,SIO 295S,A00,523232,Staff,19,0,30,11
1713323942595,SOCI 117,A01,494376,Staff,2,0,5,3
1713323943623,WES 237B,A00,494380,Staff,19,0,20,1
1713323945679,AESE 279B,A00,494370,Wade; Jon P,33,0,33,0
1713323946707,ANAR 135S,A00,494369,Braswell; Geoffrey E.,0,0,0,0
1713323947734,CAT 124RS,A01,519847,Geibel; William,17,0,20,3
1713323948761,CAT 125RS,A01,515971,Geibel; William,17,0,20,3
1713323949788,CLRE 250,A00,511389,Morris; Sheldon,9996,0,9999,3
1713323950811,CLRE 251,A00,507176,Mehta; Ravindra L.,9996,0,9999,3
1713323950811,CLRE 251,B00,511410,Mehta; Ravindra L.,9998,0,9999,1
1713323951836,CLRE 252,A00,507189,Cuomo; Raphael Eduardo,9998,0,9999,1
1713323952862,CLRE 253,A00,507199,Vaida; Florin,9997,0,9999,2
1713323952862,CLRE 253,B00,507202,Vaida; Florin,9999,0,9999,0
1713323953887,CLRE 259,A00,507211,Patel; Hemal,9996,0,9999,3
1713323954916,CLRE 260,A00,507221,Cuomo; Raphael Eduardo,9999,0,9999,0
1713323955943,CLRE 297,001,507242,Cuomo; Raphael Eduardo,9999,0,9999,0
1713323956969,CSE 191,A00,516875,Minnes Kemp; Mor Mia,9999,0,9999,0
1713323957998,CSS 201S,A01,494383,Staff,35,0,35,0
1713323959033,CSS 202S,A01,494387,Staff,35,0,35,0
1713323960056,EAP 100,A00,516065,Staff,9792,0,9999,207
1713323961082,ECE 45,A01,507414,Staff,52,0,60,8
1713323962108,ECE 100,A01,507416,Baghdadchi; Saharnaz,11,0,20,9
1713323962108,ECE 100,A02,507418,Baghdadchi; Saharnaz,20,0,20,0
1713323963133,ECE 111,A01,507420,Staff,39,0,50,11
1713323964159,ECE 197,001,548057,Sievenpiper; Daniel F.,9998,0,9999,1
1713323965182,EDS 115,A00,507243,Choi; Bailey Miyeon,28,0,28,0
1713323966207,EDS 117,A01,494379,Staff,23,0,25,2
1713323967232,EDS 125,A00,507246,Hopkins; Megan Beth,29,0,30,1
1713323968258,EDS 128A,A01,507264,Fargason; Sharon Gayle,26,0,26,0
1713323969282,EDS 128B,A01,507293,Pappas; Elizabeth,30,0,30,0
1713323970307,EDS 139,A00,507294,Fargason; Sharon Gayle,30,0,30,0
1713323970307,EDS 139,B00,507313,Pappas; Elizabeth,30,0,30,0
1713323971333,EDS 201,A00,507315,Staff,26,0,30,4
1713323972358,EDS 203,A01,507317,Halter; Christopher P.,26,0,30,4
1713323973383,EDS 204R,A01,507319,Halter; Christopher P.,3,0,30,27
1713323973383,EDS 204R,B01,507331,Heinzman; Erica M.,28,0,30,2
1713323974411,EDS 206R,A00,507332,Staff,4,0,30,26
1713323974411,EDS 206R,B00,507343,Staff,28,0,30,2
1713323975436,EDS 250,A00,507344,Hemans; Patricia Ann Benitez,36,0,40,4
1713323976459,EDS 281,A00,507345,Daly; Alan J.,18,0,18,0
1713323977483,EDS 284,A00,507350,Daly; Alan J.,16,0,16,0
1713323978508,EDS 286,A00,507359,Fine; Sarah,18,0,18,0
1713323979533,EDS 289C,A01,507361,Daly; Alan J.,18,0,18,0
1713323980556,EDS 290,A00,507366,Hofstetter; Carolyn,15,0,15,0
1713323981583,LIGM 5A,A00,507421,Fischer-Grunski; Eva K,20,0,20,0
1713323982608,LIGM 5B,A00,507423,Fischer-Grunski; Eva K,20,0,20,0
1713323983635,LIGM 5C,A00,507425,Fischer-Grunski; Eva K,20,0,20,0
1713323984657,LIIT 5AS,A00,507427,Carnelos; Chiara,20,0,20,0
1713323985681,LIIT 5BS,A00,507430,Carnelos; Chiara,20,0,20,0
1713323986709,LIIT 5CS,A00,507432,Carnelos; Chiara,20,0,20,0
1713323987736,LISP 5A,A00,507541,Munoz Sanchez; Alicia,18,0,20,2
1713323988819,LISP 5B,A00,507671,Munoz Sanchez; Alicia,16,0,20,4
1713323989844,LISP 5C,A00,507696,Munoz Sanchez; Alicia,16,0,20,4
1713323990868,MAE 197,001,528363,Boechler; Nicholas Sebastia,9998,0,9999,1
1713323991895,MATH 197,001,523477,Kedlaya; Kiran S.,9999,0,9999,0
1713323991895,MATH 197,002,563811,Zhang; Danna,9999,0,9999,0
1713323992920,MCWP 40R,A00,518780,Staff,20,0,20,0
1713323992920,MCWP 40R,B00,518781,Staff,19,0,20,1
1713323992920,MCWP 40R,C00,518783,Staff,19,0,20,1
1713323993950,MCWP 50R,A00,518791,Staff,20,0,20,0
1713323993950,MCWP 50R,B00,518792,Staff,17,0,20,3
1713323993950,MCWP 50R,C00,518793,Staff,19,0,20,1
1713323993950,MCWP 50R,D00,518794,Staff,16,0,20,4
1713323993950,MCWP 50R,E00,518795,Staff,16,0,20,4
1713323993950,MCWP 50R,F00,518796,Staff,19,0,20,1
1713323993950,MCWP 50R,G00,518797,Staff,19,0,20,1
1713323994976,MMW 12R,A01,514034,Herbst; Matthew,15,0,16,1
1713323994976,MMW 12R,A02,514035,Herbst; Matthew,16,0,16,0
1713323996001,MMW 13R,A01,514037,Staff,12,0,16,4
1713323996001,MMW 13R,A02,514039,Staff,16,0,16,0
1713323998052,SIO 295LS,A00,523233,Staff,19,0,30,11
1713323999078,SIO 295S,A00,523232,Staff,19,0,30,11
1713324000162,SOCI 117,A01,494376,Staff,2,0,5,3
1713324001187,WES 237B,A00,494380,Staff,19,0,20,1
1713324003252,AESE 279B,A00,494370,Wade; Jon P,33,0,33,0
1713324004280,ANAR 135S,A00,494369,Braswell; Geoffrey E.,0,0,0,0
1713324005310,CAT 124RS,A01,519847,Geibel; William,17,0,20,3
1713324006335,CAT 125RS,A01,515971,Geibel; William,17,0,20,3
1713324007359,CLRE 250,A00,511389,Morris; Sheldon,9996,0,9999,3
1713324008385,CLRE 251,A00,507176,Mehta; Ravindra L.,9996,0,9999,3
1713324008385,CLRE 251,B00,511410,Mehta; Ravindra L.,9998,0,9999,1
1713324009411,CLRE 252,A00,507189,Cuomo; Raphael Eduardo,9998,0,9999,1
1713324010436,CLRE 253,A00,507199,Vaida; Florin,9997,0,9999,2
1713324010436,CLRE 253,B00,507202,Vaida; Florin,9999,0,9999,0
1713324011459,CLRE 259,A00,507211,Patel; Hemal,9996,0,9999,3
1713324012483,CLRE 260,A00,507221,Cuomo; Raphael Eduardo,9999,0,9999,0
1713324013510,CLRE 297,001,507242,Cuomo; Raphael Eduardo,9999,0,9999,0
1713324014537,CSE 191,A00,516875,Minnes Kemp; Mor Mia,9999,0,9999,0
1713324015565,CSS 201S,A01,494383,Staff,35,0,35,0
1713324016594,CSS 202S,A01,494387,Staff,35,0,35,0
1713324017620,EAP 100,A00,516065,Staff,9792,0,9999,207
1713324018645,ECE 45,A01,507414,Staff,52,0,60,8
1713324019670,ECE 100,A01,507416,Baghdadchi; Saharnaz,11,0,20,9
1713324019670,ECE 100,A02,507418,Baghdadchi; Saharnaz,20,0,20,0
1713324020698,ECE 111,A01,507420,Staff,39,0,50,11
1713324021724,ECE 197,001,548057,Sievenpiper; Daniel F.,9998,0,9999,1
1713324022751,EDS 115,A00,507243,Choi; Bailey Miyeon,28,0,28,0
1713324023779,EDS 117,A01,494379,Staff,23,0,25,2
1713324024808,EDS 125,A00,507246,Hopkins; Megan Beth,29,0,30,1
1713324025836,EDS 128A,A01,507264,Fargason; Sharon Gayle,26,0,26,0
1713324026863,EDS 128B,A01,507293,Pappas; Elizabeth,30,0,30,0
1713324027889,EDS 139,A00,507294,Fargason; Sharon Gayle,30,0,30,0
1713324027889,EDS 139,B00,507313,Pappas; Elizabeth,30,0,30,0
1713324028912,EDS 201,A00,507315,Staff,26,0,30,4
1713324029938,EDS 203,A01,507317,Halter; Christopher P.,26,0,30,4
1713324030963,EDS 204R,A01,507319,Halter; Christopher P.,3,0,30,27
1713324030963,EDS 204R,B01,507331,Heinzman; Erica M.,28,0,30,2
1713324031987,EDS 206R,A00,507332,Staff,4,0,30,26
1713324031987,EDS 206R,B00,507343,Staff,28,0,30,2
1713324033015,EDS 250,A00,507344,Hemans; Patricia Ann Benitez,36,0,40,4
1713324034039,EDS 281,A00,507345,Daly; Alan J.,18,0,18,0
1713324035062,EDS 284,A00,507350,Daly; Alan J.,16,0,16,0
1713324036086,EDS 286,A00,507359,Fine; Sarah,18,0,18,0
1713324037114,EDS 289C,A01,507361,Daly; Alan J.,18,0,18,0
1713324038139,EDS 290,A00,507366,Hofstetter; Carolyn,15,0,15,0
1713324039168,LIGM 5A,A00,507421,Fischer-Grunski; Eva K,20,0,20,0
1713324040193,LIGM 5B,A00,507423,Fischer-Grunski; Eva K,20,0,20,0
1713324041221,LIGM 5C,A00,507425,Fischer-Grunski; Eva K,20,0,20,0
1713324042246,LIIT 5AS,A00,507427,Carnelos; Chiara,20,0,20,0
1713324043272,LIIT 5BS,A00,507430,Carnelos; Chiara,20,0,20,0
1713324044297,LIIT 5CS,A00,507432,Carnelos; Chiara,20,0,20,0
1713324045326,LISP 5A,A00,507541,Munoz Sanchez; Alicia,18,0,20,2
1713324046354,LISP 5B,A00,507671,Munoz Sanchez; Alicia,16,0,20,4
1713324047379,LISP 5C,A00,507696,Munoz Sanchez; Alicia,16,0,20,4
1713324048405,MAE 197,001,528363,Boechler; Nicholas Sebastia,9998,0,9999,1
1713324049429,MATH 197,001,523477,Kedlaya; Kiran S.,9999,0,9999,0
1713324049429,MATH 197,002,563811,Zhang; Danna,9999,0,9999,0
1713324050457,MCWP 40R,A00,518780,Staff,20,0,20,0
1713324050457,MCWP 40R,B00,518781,Staff,19,0,20,1
1713324050457,MCWP 40R,C00,518783,Staff,19,0,20,1
1713324051484,MCWP 50R,A00,518791,Staff,20,0,20,0
1713324051484,MCWP 50R,B00,518792,Staff,17,0,20,3
1713324051484,MCWP 50R,C00,518793,Staff,19,0,20,1
1713324051484,MCWP 50R,D00,518794,Staff,16,0,20,4
1713324051484,MCWP 50R,E00,518795,Staff,16,0,20,4
1713324051484,MCWP 50R,F00,518796,Staff,19,0,20,1
1713324051484,MCWP 50R,G00,518797,Staff,19,0,20,1
1713324052513,MMW 12R,A01,514034,Herbst; Matthew,15,0,16,1
1713324052513,MMW 12R,A02,514035,Herbst; Matthew,16,0,16,0
1713324053546,MMW 13R,A01,514037,Staff,12,0,16,4
1713324053546,MMW 13R,A02,514039,Staff,16,0,16,0
1713324055598,SIO 295LS,A00,523233,Staff,19,0,30,11
1713324056626,SIO 295S,A00,523232,Staff,19,0,30,11
1713324057654,SOCI 117,A01,494376,Staff,2,0,5,3
1713324058680,WES 237B,A00,494380,Staff,19,0,20,1
1713324060746,AESE 279B,A00,494370,Wade; Jon P,33,0,33,0
1713324061771,ANAR 135S,A00,494369,Braswell; Geoffrey E.,0,0,0,0
1713324062795,CAT 124RS,A01,519847,Geibel; William,17,0,20,3
1713324063823,CAT 125RS,A01,515971,Geibel; William,17,0,20,3
1713324064848,CLRE 250,A00,511389,Morris; Sheldon,9996,0,9999,3
1713324065875,CLRE 251,A00,507176,Mehta; Ravindra L.,9996,0,9999,3
1713324065875,CLRE 251,B00,511410,Mehta; Ravindra L.,9998,0,9999,1
1713324066900,CLRE 252,A00,507189,Cuomo; Raphael Eduardo,9998,0,9999,1
1713324067926,CLRE 253,A00,507199,Vaida; Florin,9997,0,9999,2
1713324067926,CLRE 253,B00,507202,Vaida; Florin,9999,0,9999,0
1713324068951,CLRE 259,A00,507211,Patel; Hemal,9996,0,9999,3
1713324069975,CLRE 260,A00,507221,Cuomo; Raphael Eduardo,9999,0,9999,0
1713324071003,CLRE 297,001,507242,Cuomo; Raphael Eduardo,9999,0,9999,0
1713324072027,CSE 191,A00,516875,Minnes Kemp; Mor Mia,9999,0,9999,0
1713324073056,CSS 201S,A01,494383,Staff,35,0,35,0
1713324074081,CSS 202S,A01,494387,Staff,35,0,35,0
1713324075108,EAP 100,A00,516065,Staff,9792,0,9999,207
1713324076134,ECE 45,A01,507414,Staff,52,0,60,8
1713324077161,ECE 100,A01,507416,Baghdadchi; Saharnaz,11,0,20,9
1713324077161,ECE 100,A02,507418,Baghdadchi; Saharnaz,20,0,20,0
1713324078189,ECE 111,A01,507420,Staff,39,0,50,11
1713324079217,ECE 197,001,548057,Sievenpiper; Daniel F.,9998,0,9999,1
1713324080242,EDS 115,A00,507243,Choi; Bailey Miyeon,28,0,28,0
1713324081271,EDS 117,A01,494379,Staff,23,0,25,2
1713324082295,EDS 125,A00,507246,Hopkins; Megan Beth,29,0,30,1
1713324083321,EDS 128A,A01,507264,Fargason; Sharon Gayle,26,0,26,0
1713324084354,EDS 128B,A01,507293,Pappas; Elizabeth,30,0,30,0
1713324085380,EDS 139,A00,507294,Fargason; Sharon Gayle,30,0,30,0
1713324085380,EDS 139,B00,507313,Pappas; Elizabeth,30,0,30,0
1713324086406,EDS 201,A00,507315,Staff,26,0,30,4
1713324087432,EDS 203,A01,507317,Halter; Christopher P.,26,0,30,4
1713324088456,EDS 204R,A01,507319,Halter; Christopher P.,3,0,30,27
1713324088456,EDS 204R,B01,507331,Heinzman; Erica M.,28,0,30,2
1713324089480,EDS 206R,A00,507332,Staff,4,0,30,26
1713324089480,EDS 206R,B00,507343,Staff,28,0,30,2
1713324090507,EDS 250,A00,507344,Hemans; Patricia Ann Benitez,36,0,40,4
1713324091532,EDS 281,A00,507345,Daly; Alan J.,18,0,18,0
1713324092612,EDS 284,A00,507350,Daly; Alan J.,16,0,16,0
1713324093640,EDS 286,A00,507359,Fine; Sarah,18,0,18,0
1713324094670,EDS 289C,A01,507361,Daly; Alan J.,18,0,18,0
1713324095694,EDS 290,A00,507366,Hofstetter; Carolyn,15,0,15,0
1713324096718,LIGM 5A,A00,507421,Fischer-Grunski; Eva K,20,0,20,0
1713324097743,LIGM 5B,A00,507423,Fischer-Grunski; Eva K,20,0,20,0
1713324098766,LIGM 5C,A00,507425,Fischer-Grunski; Eva K,20,0,20,0
1713324099797,LIIT 5AS,A00,507427,Carnelos; Chiara,20,0,20,0
1713324100821,LIIT 5BS,A00,507430,Carnelos; Chiara,20,0,20,0
1713324101847,LIIT 5CS,A00,507432,Carnelos; Chiara,20,0,20,0
1713324102877,LISP 5A,A00,507541,Munoz Sanchez; Alicia,18,0,20,2
1713324103902,LISP 5B,A00,507671,Munoz Sanchez; Alicia,16,0,20,4
1713324104930,LISP 5C,A00,507696,Munoz Sanchez; Alicia,16,0,20,4
1713324105959,MAE 197,001,528363,Boechler; Nicholas Sebastia,9998,0,9999,1
1713324106987,MATH 197,001,523477,Kedlaya; Kiran S.,9999,0,9999,0
1713324106987,MATH 197,002,563811,Zhang; Danna,9999,0,9999,0
1713324108016,MCWP 40R,A00,518780,Staff,20,0,20,0
1713324108016,MCWP 40R,B00,518781,Staff,19,0,20,1
1713324108016,MCWP 40R,C00,518783,Staff,19,0,20,1
1713324109043,MCWP 50R,A00,518791,Staff,20,0,20,0
1713324109043,MCWP 50R,B00,518792,Staff,17,0,20,3
1713324109043,MCWP 50R,C00,518793,Staff,19,0,20,1
1713324109043,MCWP 50R,D00,518794,Staff,16,0,20,4
1713324109043,MCWP 50R,E00,518795,Staff,16,0,20,4
1713324109043,MCWP 50R,F00,518796,Staff,19,0,20,1
1713324109043,MCWP 50R,G00,518797,Staff,19,0,20,1
1713324110067,MMW 12R,A01,514034,Herbst; Matthew,15,0,16,1
1713324110067,MMW 12R,A02,514035,Herbst; Matthew,16,0,16,0
1713324111096,MMW 13R,A01,514037,Staff,12,0,16,4
1713324111096,MMW 13R,A02,514039,Staff,16,0,16,0
1713324113147,SIO 295LS,A00,523233,Staff,19,0,30,11
1713324114171,SIO 295S,A00,523232,Staff,19,0,30,11
1713324115195,SOCI 117,A01,494376,Staff,2,0,5,3
1713324116221,WES 237B,A00,494380,Staff,19,0,20,1
1713324118296,AESE 279B,A00,494370,Wade; Jon P,33,0,33,0
1713324119322,ANAR 135S,A00,494369,Braswell; Geoffrey E.,0,0,0,0
1713324120349,CAT 124RS,A01,519847,Geibel; William,17,0,20,3
1713324121372,CAT 125RS,A01,515971,Geibel; William,17,0,20,3
1713324122397,CLRE 250,A00,511389,Morris; Sheldon,9996,0,9999,3
1713324123422,CLRE 251,A00,507176,Mehta; Ravindra L.,9996,0,9999,3
1713324123422,CLRE 251,B00,511410,Mehta; Ravindra L.,9998,0,9999,1
1713324124447,CLRE 252,A00,507189,Cuomo; Raphael Eduardo,9998,0,9999,1
1713324125476,CLRE 253,A00,507199,Vaida; Florin,9997,0,9999,2
1713324125476,CLRE 253,B00,507202,Vaida; Florin,9999,0,9999,0
1713324126502,CLRE 259,A00,507211,Patel; Hemal,9996,0,9999,3
1713324127527,CLRE 260,A00,507221,Cuomo; Raphael Eduardo,9999,0,9999,0
1713324128551,CLRE 297,001,507242,Cuomo; Raphael Eduardo,9999,0,9999,0
1713324129577,CSE 191,A00,516875,Minnes Kemp; Mor Mia,9999,0,9999,0
1713324130602,CSS 201S,A01,494383,Staff,35,0,35,0
1713324131632,CSS 202S,A01,494387,Staff,35,0,35,0
1713324132660,EAP 100,A00,516065,Staff,9792,0,9999,207
1713324133755,ECE 45,A01,507414,Staff,52,0,60,8
1713324134783,ECE 100,A01,507416,Baghdadchi; Saharnaz,11,0,20,9
1713324134783,ECE 100,A02,507418,Baghdadchi; Saharnaz,20,0,20,0
1713324135810,ECE 111,A01,507420,Staff,39,0,50,11
1713324136835,ECE 197,001,548057,Sievenpiper; Daniel F.,9998,0,9999,1
1713324137859,EDS 115,A00,507243,Choi; Bailey Miyeon,28,0,28,0
1713324138887,EDS 117,A01,494379,Staff,23,0,25,2
1713324139916,EDS 125,A00,507246,Hopkins; Megan Beth,29,0,30,1
1713324140945,EDS 128A,A01,507264,Fargason; Sharon Gayle,26,0,26,0
1713324141971,EDS 128B,A01,507293,Pappas; Elizabeth,30,0,30,0
1713324142994,EDS 139,A00,507294,Fargason; Sharon Gayle,30,0,30,0
1713324142994,EDS 139,B00,507313,Pappas; Elizabeth,30,0,30,0
1713324144019,EDS 201,A00,507315,Staff,26,0,30,4
1713324145045,EDS 203,A01,507317,Halter; Christopher P.,26,0,30,4
1713324146069,EDS 204R,A01,507319,Halter; Christopher P.,3,0,30,27
1713324146069,EDS 204R,B01,507331,Heinzman; Erica M.,28,0,30,2
1713324147094,EDS 206R,A00,507332,Staff,4,0,30,26
1713324147094,EDS 206R,B00,507343,Staff,28,0,30,2
1713324148118,EDS 250,A00,507344,Hemans; Patricia Ann Benitez,36,0,40,4
1713324149142,EDS 281,A00,507345,Daly; Alan J.,18,0,18,0
1713324150167,EDS 284,A00,507350,Daly; Alan J.,16,0,16,0
1713324151191,EDS 286,A00,507359,Fine; Sarah,18,0,18,0
1713324152215,EDS 289C,A01,507361,Daly; Alan J.,18,0,18,0
1713324153239,EDS 290,A00,507366,Hofstetter; Carolyn,15,0,15,0
1713324154269,LIGM 5A,A00,507421,Fischer-Grunski; Eva K,20,0,20,0
1713324155293,LIGM 5B,A00,507423,Fischer-Grunski; Eva K,20,0,20,0
1713324156318,LIGM 5C,A00,507425,Fischer-Grunski; Eva K,20,0,20,0
1713324157343,LIIT 5AS,A00,507427,Carnelos; Chiara,20,0,20,0
1713324158371,LIIT 5BS,A00,507430,Carnelos; Chiara,20,0,20,0
1713324159399,LIIT 5CS,A00,507432,Carnelos; Chiara,20,0,20,0
1713324160426,LISP 5A,A00,507541,Munoz Sanchez; Alicia,18,0,20,2
1713324161451,LISP 5B,A00,507671,Munoz Sanchez; Alicia,16,0,20,4
1713324162482,LISP 5C,A00,507696,Munoz Sanchez; Alicia,16,0,20,4
1713324163506,MAE 197,001,528363,Boechler; Nicholas Sebastia,9998,0,9999,1
1713324164531,MATH 197,001,523477,Kedlaya; Kiran S.,9999,0,9999,0
1713324164531,MATH 197,002,563811,Zhang; Danna,9999,0,9999,0
1713324165557,MCWP 40R,A00,518780,Staff,20,0,20,0
1713324165557,MCWP 40R,B00,518781,Staff,19,0,20,1
1713324165557,MCWP 40R,C00,518783,Staff,19,0,20,1
1713324166585,MCWP 50R,A00,518791,Staff,20,0,20,0
1713324166585,MCWP 50R,B00,518792,Staff,17,0,20,3
1713324166585,MCWP 50R,C00,518793,Staff,19,0,20,1
1713324166585,MCWP 50R,D00,518794,Staff,16,0,20,4
1713324166585,MCWP 50R,E00,518795,Staff,16,0,20,4
1713324166585,MCWP 50R,F00,518796,Staff,19,0,20,1
1713324166585,MCWP 50R,G00,518797,Staff,19,0,20,1
1713324167613,MMW 12R,A01,514034,Herbst; Matthew,15,0,16,1
1713324167613,MMW 12R,A02,514035,Herbst; Matthew,16,0,16,0
1713324168640,MMW 13R,A01,514037,Staff,12,0,16,4
1713324168640,MMW 13R,A02,514039,Staff,16,0,16,0
1713324170689,SIO 295LS,A00,523233,Staff,19,0,30,11
1713324171713,SIO 295S,A00,523232,Staff,19,0,30,11
1713324172738,SOCI 117,A01,494376,Staff,2,0,5,3
1713324173762,WES 237B,A00,494380,Staff,19,0,20,1
1713324175818,AESE 279B,A00,494370,Wade; Jon P,33,0,33,0
1713324176845,ANAR 135S,A00,494369,Braswell; Geoffrey E.,0,0,0,0
1713324177873,CAT 124RS,A01,519847,Geibel; William,17,0,20,3
1713324178902,CAT 125RS,A01,515971,Geibel; William,17,0,20,3
1713324179930,CLRE 250,A00,511389,Morris; Sheldon,9996,0,9999,3
1713324180957,CLRE 251,A00,507176,Mehta; Ravindra L.,9996,0,9999,3
1713324180957,CLRE 251,B00,511410,Mehta; Ravindra L.,9998,0,9999,1
1713324181982,CLRE 252,A00,507189,Cuomo; Raphael Eduardo,9998,0,9999,1
1713324183010,CLRE 253,A00,507199,Vaida; Florin,9997,0,9999,2
1713324183010,CLRE 253,B00,507202,Vaida; Florin,9999,0,9999,0
1713324184037,CLRE 259,A00,507211,Patel; Hemal,9996,0,9999,3
1713324185066,CLRE 260,A00,507221,Cuomo; Raphael Eduardo,9999,0,9999,0
1713324186094,CLRE 297,001,507242,Cuomo; Raphael Eduardo,9999,0,9999,0
1713324187120,CSE 191,A00,516875,Minnes Kemp; Mor Mia,9999,0,9999,0
1713324188146,CSS 201S,A01,494383,Staff,35,0,35,0
1713324189175,CSS 202S,A01,494387,Staff,35,0,35,0
1713324190201,EAP 100,A00,516065,Staff,9792,0,9999,207
1713324191230,ECE 45,A01,507414,Staff,52,0,60,8
1713324192257,ECE 100,A01,507416,Baghdadchi; Saharnaz,11,0,20,9
1713324192257,ECE 100,A02,507418,Baghdadchi; Saharnaz,20,0,20,0
1713324193281,ECE 111,A01,507420,Staff,39,0,50,11
1713324194309,ECE 197,001,548057,Sievenpiper; Daniel F.,9998,0,9999,1
1713324195335,EDS 115,A00,507243,Choi; Bailey Miyeon,28,0,28,0
1713324196416,EDS 117,A01,494379,Staff,23,0,25,2
1713324197442,EDS 125,A00,507246,Hopkins; Megan Beth,29,0,30,1
1713324198469,EDS 128A,A01,507264,Fargason; Sharon Gayle,26,0,26,0
1713324199495,EDS 128B,A01,507293,Pappas; Elizabeth,30,0,30,0
1713324200523,EDS 139,A00,507294,Fargason; Sharon Gayle,30,0,30,0
1713324200523,EDS 139,B00,507313,Pappas; Elizabeth,30,0,30,0
1713324201547,EDS 201,A00,507315,Staff,26,0,30,4
1713324202572,EDS 203,A01,507317,Halter; Christopher P.,26,0,30,4
1713324203600,EDS 204R,A01,507319,Halter; Christopher P.,3,0,30,27
1713324203600,EDS 204R,B01,507331,Heinzman; Erica M.,28,0,30,2
1713324204628,EDS 206R,A00,507332,Staff,4,0,30,26
1713324204628,EDS 206R,B00,507343,Staff,28,0,30,2
1713324205652,EDS 250,A00,507344,Hemans; Patricia Ann Benitez,36,0,40,4
1713324206676,EDS 281,A00,507345,Daly; Alan J.,18,0,18,0
1713324207704,EDS 284,A00,507350,Daly; Alan J.,16,0,16,0
1713324208731,EDS 286,A00,507359,Fine; Sarah,18,0,18,0
1713324209757,EDS 289C,A01,507361,Daly; Alan J.,18,0,18,0
1713324210786,EDS 290,A00,507366,Hofstetter; Carolyn,15,0,15,0
1713324211816,LIGM 5A,A00,507421,Fischer-Grunski; Eva K,20,0,20,0
1713324212846,LIGM 5B,A00,507423,Fischer-Grunski; Eva K,20,0,20,0
1713324213872,LIGM 5C,A00,507425,Fischer-Grunski; Eva K,20,0,20,0
1713324214898,LIIT 5AS,A00,507427,Carnelos; Chiara,20,0,20,0
1713324215922,LIIT 5BS,A00,507430,Carnelos; Chiara,20,0,20,0
1713324216947,LIIT 5CS,A00,507432,Carnelos; Chiara,20,0,20,0
1713324217975,LISP 5A,A00,507541,Munoz Sanchez; Alicia,18,0,20,2
1713324218999,LISP 5B,A00,507671,Munoz Sanchez; Alicia,16,0,20,4
1713324220029,LISP 5C,A00,507696,Munoz Sanchez; Alicia,16,0,20,4
1713324221054,MAE 197,001,528363,Boechler; Nicholas Sebastia,9998,0,9999,1
1713324222081,MATH 197,001,523477,Kedlaya; Kiran S.,9999,0,9999,0
1713324222081,MATH 197,002,563811,Zhang; Danna,9999,0,9999,0
1713324223110,MCWP 40R,A00,518780,Staff,20,0,20,0
1713324223110,MCWP 40R,B00,518781,Staff,19,0,20,1
1713324223110,MCWP 40R,C00,518783,Staff,19,0,20,1
1713324224135,MCWP 50R,A00,518791,Staff,20,0,20,0
1713324224135,MCWP 50R,B00,518792,Staff,17,0,20,3
1713324224135,MCWP 50R,C00,518793,Staff,19,0,20,1
1713324224135,MCWP 50R,D00,518794,Staff,16,0,20,4
1713324224135,MCWP 50R,E00,518795,Staff,16,0,20,4
1713324224135,MCWP 50R,F00,518796,Staff,19,0,20,1
1713324224135,MCWP 50R,G00,518797,Staff,19,0,20,1
1713324225161,MMW 12R,A01,514034,Herbst; Matthew,15,0,16,1
1713324225161,MMW 12R,A02,514035,Herbst; Matthew,16,0,16,0
1713324226188,MMW 13R,A01,514037,Staff,12,0,16,4
1713324226188,MMW 13R,A02,514039,Staff,16,0,16,0
1713324228240,SIO 295LS,A00,523233,Staff,19,0,30,11
1713324229267,SIO 295S,A00,523232,Staff,19,0,30,11
1713324230296,SOCI 117,A01,494376,Staff,2,0,5,3
1713324231319,WES 237B,A00,494380,Staff,19,0,20,1
1713324233378,AESE 279B,A00,494370,Wade; Jon P,33,0,33,0
1713324234403,ANAR 135S,A00,494369,Braswell; Geoffrey E.,0,0,0,0
1713324235431,CAT 124RS,A01,519847,Geibel; William,17,0,20,3
1713324236456,CAT 125RS,A01,515971,Geibel; William,17,0,20,3
1713324237483,CLRE 250,A00,511389,Morris; Sheldon,9996,0,9999,3
1713324238515,CLRE 251,A00,507176,Mehta; Ravindra L.,9996,0,9999,3
1713324238515,CLRE 251,B00,511410,Mehta; Ravindra L.,9998,0,9999,1
1713324239540,CLRE 252,A00,507189,Cuomo; Raphael Eduardo,9998,0,9999,1
1713324240565,CLRE 253,A00,507199,Vaida; Florin,9997,0,9999,2
1713324240565,CLRE 253,B00,507202,Vaida; Florin,9999,0,9999,0
1713324241588,CLRE 259,A00,507211,Patel; Hemal,9996,0,9999,3
1713324242613,CLRE 260,A00,507221,Cuomo; Raphael Eduardo,9999,0,9999,0
1713324243638,CLRE 297,001,507242,Cuomo; Raphael Eduardo,9999,0,9999,0
1713324244664,CSE 191,A00,516875,Minnes Kemp; Mor Mia,9999,0,9999,0
1713324245692,CSS 201S,A01,494383,Staff,35,0,35,0
1713324246717,CSS 202S,A01,494387,Staff,35,0,35,0
1713324247741,EAP 100,A00,516065,Staff,9792,0,9999,207
1713324248766,ECE 45,A01,507414,Staff,52,0,60,8
1713324249795,ECE 100,A01,507416,Baghdadchi; Saharnaz,11,0,20,9
1713324249795,ECE 100,A02,507418,Baghdadchi; Saharnaz,20,0,20,0
1713324250818,ECE 111,A01,507420,Staff,39,0,50,11
1713324251842,ECE 197,001,548057,Sievenpiper; Daniel F.,9998,0,9999,1
1713324252867,EDS 115,A00,507243,Choi; Bailey Miyeon,28,0,28,0
1713324253899,EDS 117,A01,494379,Staff,23,0,25,2
1713324254928,EDS 125,A00,507246,Hopkins; Megan Beth,29,0,30,1
1713324255956,EDS 128A,A01,507264,Fargason; Sharon Gayle,26,0,26,0
1713324256981,EDS 128B,A01,507293,Pappas; Elizabeth,30,0,30,0
1713324258010,EDS 139,A00,507294,Fargason; Sharon Gayle,30,0,30,0
1713324258010,EDS 139,B00,507313,Pappas; Elizabeth,30,0,30,0
1713324259034,EDS 201,A00,507315,Staff,26,0,30,4
1713324260058,EDS 203,A01,507317,Halter; Christopher P.,26,0,30,4
1713324261087,EDS 204R,A01,507319,Halter; Christopher P.,3,0,30,27
1713324261087,EDS 204R,B01,507331,Heinzman; Erica M.,28,0,30,2
1713324262117,EDS 206R,A00,507332,Staff,4,0,30,26
1713324262117,EDS 206R,B00,507343,Staff,28,0,30,2
1713324263146,EDS 250,A00,507344,Hemans; Patricia Ann Benitez,36,0,40,4
1713324264223,EDS 281,A00,507345,Daly; Alan J.,18,0,18,0
1713324265248,EDS 284,A00,507350,Daly; Alan J.,16,0,16,0
1713324266273,EDS 286,A00,507359,Fine; Sarah,18,0,18,0
1713324267298,EDS 289C,A01,507361,Daly; Alan J.,18,0,18,0
1713324268326,EDS 290,A00,507366,Hofstetter; Carolyn,15,0,15,0
1713324269352,LIGM 5A,A00,507421,Fischer-Grunski; Eva K,20,0,20,0
1713324270378,LIGM 5B,A00,507423,Fischer-Grunski; Eva K,20,0,20,0
1713324271403,LIGM 5C,A00,507425,Fischer-Grunski; Eva K,20,0,20,0
1713324272432,LIIT 5AS,A00,507427,Carnelos; Chiara,20,0,20,0
1713324273456,LIIT 5BS,A00,507430,Carnelos; Chiara,20,0,20,0
1713324274482,LIIT 5CS,A00,507432,Carnelos; Chiara,20,0,20,0
1713324275511,LISP 5A,A00,507541,Munoz Sanchez; Alicia,18,0,20,2
1713324276537,LISP 5B,A00,507671,Munoz Sanchez; Alicia,16,0,20,4
1713324277563,LISP 5C,A00,507696,Munoz Sanchez; Alicia,16,0,20,4
1713324278591,MAE 197,001,528363,Boechler; Nicholas Sebastia,9998,0,9999,1
1713324279621,MATH 197,001,523477,Kedlaya; Kiran S.,9999,0,9999,0
1713324279621,MATH 197,002,563811,Zhang; Danna,9999,0,9999,0
1713324280649,MCWP 40R,A00,518780,Staff,20,0,20,0
1713324280649,MCWP 40R,B00,518781,Staff,19,0,20,1
1713324280649,MCWP 40R,C00,518783,Staff,19,0,20,1
1713324281674,MCWP 50R,A00,518791,Staff,20,0,20,0
1713324281674,MCWP 50R,B00,518792,Staff,17,0,20,3
1713324281674,MCWP 50R,C00,518793,Staff,19,0,20,1
1713324281674,MCWP 50R,D00,518794,Staff,16,0,20,4
1713324281674,MCWP 50R,E00,518795,Staff,16,0,20,4
1713324281674,MCWP 50R,F00,518796,Staff,19,0,20,1
1713324281674,MCWP 50R,G00,518797,Staff,19,0,20,1
1713324282699,MMW 12R,A01,514034,Herbst; Matthew,15,0,16,1
1713324282699,MMW 12R,A02,514035,Herbst; Matthew,16,0,16,0
1713324283723,MMW 13R,A01,514037,Staff,12,0,16,4
1713324283723,MMW 13R,A02,514039,Staff,16,0,16,0
1713324285770,SIO 295LS,A00,523233,Staff,19,0,30,11
1713324286919,SIO 295S,A00,523232,Staff,19,0,30,11
1713324287946,SOCI 117,A01,494376,Staff,2,0,5,3
1713324288973,WES 237B,A00,494380,Staff,19,0,20,1
1713324291038,AESE 279B,A00,494370,Wade; Jon P,33,0,33,0
1713324292064,ANAR 135S,A00,494369,Braswell; Geoffrey E.,0,0,0,0
1713324293087,CAT 124RS,A01,519847,Geibel; William,17,0,20,3
1713324294114,CAT 125RS,A01,515971,Geibel; William,17,0,20,3
1713324295140,CLRE 250,A00,511389,Morris; Sheldon,9996,0,9999,3
1713324296165,CLRE 251,A00,507176,Mehta; Ravindra L.,9996,0,9999,3
1713324296165,CLRE 251,B00,511410,Mehta; Ravindra L.,9998,0,9999,1
1713324297188,CLRE 252,A00,507189,Cuomo; Raphael Eduardo,9998,0,9999,1
1713324298214,CLRE 253,A00,507199,Vaida; Florin,9997,0,9999,2
1713324298214,CLRE 253,B00,507202,Vaida; Florin,9999,0,9999,0
1713324299244,CLRE 259,A00,507211,Patel; Hemal,9996,0,9999,3
1713324300324,CLRE 260,A00,507221,Cuomo; Raphael Eduardo,9999,0,9999,0
1713324301350,CLRE 297,001,507242,Cuomo; Raphael Eduardo,9999,0,9999,0
1713324302378,CSE 191,A00,516875,Minnes Kemp; Mor Mia,9999,0,9999,0
1713324303402,CSS 201S,A01,494383,Staff,35,0,35,0
1713324304433,CSS 202S,A01,494387,Staff,35,0,35,0
1713324305456,EAP 100,A00,516065,Staff,9792,0,9999,207
1713324306483,ECE 45,A01,507414,Staff,52,0,60,8
1713324307507,ECE 100,A01,507416,Baghdadchi; Saharnaz,11,0,20,9
1713324307507,ECE 100,A02,507418,Baghdadchi; Saharnaz,20,0,20,0
1713324308532,ECE 111,A01,507420,Staff,39,0,50,11
1713324309556,ECE 197,001,548057,Sievenpiper; Daniel F.,9998,0,9999,1
1713324310579,EDS 115,A00,507243,Choi; Bailey Miyeon,28,0,28,0
1713324311608,EDS 117,A01,494379,Staff,23,0,25,2
1713324312633,EDS 125,A00,507246,Hopkins; Megan Beth,29,0,30,1
1713324313656,EDS 128A,A01,507264,Fargason; Sharon Gayle,26,0,26,0
1713324314680,EDS 128B,A01,507293,Pappas; Elizabeth,30,0,30,0
1713324315704,EDS 139,A00,507294,Fargason; Sharon Gayle,30,0,30,0
1713324315704,EDS 139,B00,507313,Pappas; Elizabeth,30,0,30,0
1713324316730,EDS 201,A00,507315,Staff,26,0,30,4
1713324317755,EDS 203,A01,507317,Halter; Christopher P.,26,0,30,4
1713324318783,EDS 204R,A01,507319,Halter; Christopher P.,3,0,30,27
1713324318783,EDS 204R,B01,507331,Heinzman; Erica M.,28,0,30,2
1713324319811,EDS 206R,A00,507332,Staff,4,0,30,26
1713324319811,EDS 206R,B00,507343,Staff,28,0,30,2
1713324320836,EDS 250,A00,507344,Hemans; Patricia Ann Benitez,36,0,40,4
1713324321864,EDS 281,A00,507345,Daly; Alan J.,18,0,18,0
1713324322890,EDS 284,A00,507350,Daly; Alan J.,16,0,16,0
1713324323915,EDS 286,A00,507359,Fine; Sarah,18,0,18,0
1713324324940,EDS 289C,A01,507361,Daly; Alan J.,18,0,18,0
1713324325965,EDS 290,A00,507366,Hofstetter; Carolyn,15,0,15,0
1713324326990,LIGM 5A,A00,507421,Fischer-Grunski; Eva K,20,0,20,0
1713324328017,LIGM 5B,A00,507423,Fischer-Grunski; Eva K,20,0,20,0
1713324329042,LIGM 5C,A00,507425,Fischer-Grunski; Eva K,20,0,20,0
1713324330068,LIIT 5AS,A00,507427,Carnelos; Chiara,20,0,20,0
1713324331096,LIIT 5BS,A00,507430,Carnelos; Chiara,20,0,20,0
1713324332119,LIIT 5CS,A00,507432,Carnelos; Chiara,20,0,20,0
1713324333144,LISP 5A,A00,507541,Munoz Sanchez; Alicia,18,0,20,2
1713324334172,LISP 5B,A00,507671,Munoz Sanchez; Alicia,16,0,20,4
1713324335197,LISP 5C,A00,507696,Munoz Sanchez; Alicia,16,0,20,4
1713324336222,MAE 197,001,528363,Boechler; Nicholas Sebastia,9998,0,9999,1
1713324337247,MATH 197,001,523477,Kedlaya; Kiran S.,9999,0,9999,0
1713324337247,MATH 197,002,563811,Zhang; Danna,9999,0,9999,0
1713324338272,MCWP 40R,A00,518780,Staff,20,0,20,0
1713324338272,MCWP 40R,B00,518781,Staff,19,0,20,1
1713324338272,MCWP 40R,C00,518783,Staff,19,0,20,1
1713324339298,MCWP 50R,A00,518791,Staff,20,0,20,0
1713324339298,MCWP 50R,B00,518792,Staff,17,0,20,3
1713324339298,MCWP 50R,C00,518793,Staff,19,0,20,1
1713324339298,MCWP 50R,D00,518794,Staff,16,0,20,4
1713324339298,MCWP 50R,E00,518795,Staff,16,0,20,4
1713324339298,MCWP 50R,F00,518796,Staff,19,0,20,1
1713324339298,MCWP 50R,G00,518797,Staff,19,0,20,1
1713324340322,MMW 12R,A01,514034,Herbst; Matthew,15,0,16,1
1713324340322,MMW 12R,A02,514035,Herbst; Matthew,16,0,16,0
1713324341350,MMW 13R,A01,514037,Staff,12,0,16,4
1713324341350,MMW 13R,A02,514039,Staff,16,0,16,0
1713324343405,SIO 295LS,A00,523233,Staff,19,0,30,11
1713324344431,SIO 295S,A00,523232,Staff,19,0,30,11
1713324345455,SOCI 117,A01,494376,Staff,2,0,5,3
1713324346485,WES 237B,A00,494380,Staff,19,0,20,1
1713324348545,AESE 279B,A00,494370,Wade; Jon P,33,0,33,0
1713324349572,ANAR 135S,A00,494369,Braswell; Geoffrey E.,0,0,0,0
1713324350599,CAT 124RS,A01,519847,Geibel; William,17,0,20,3
1713324351624,CAT 125RS,A01,515971,Geibel; William,17,0,20,3
1713324352648,CLRE 250,A00,511389,Morris; Sheldon,9996,0,9999,3
1713324353672,CLRE 251,A00,507176,Mehta; Ravindra L.,9996,0,9999,3
1713324353672,CLRE 251,B00,511410,Mehta; Ravindra L.,9998,0,9999,1
1713324354700,CLRE 252,A00,507189,Cuomo; Raphael Eduardo,9998,0,9999,1
1713324355725,CLRE 253,A00,507199,Vaida; Florin,9997,0,9999,2
1713324355725,CLRE 253,B00,507202,Vaida; Florin,9999,0,9999,0
1713324356751,CLRE 259,A00,507211,Patel; Hemal,9996,0,9999,3
1713324357912,CLRE 260,A00,507221,Cuomo; Raphael Eduardo,9999,0,9999,0
1713324358940,CLRE 297,001,507242,Cuomo; Raphael Eduardo,9999,0,9999,0
1713324359968,CSE 191,A00,516875,Minnes Kemp; Mor Mia,9999,0,9999,0
1713324360992,CSS 201S,A01,494383,Staff,35,0,35,0
1713324362022,CSS 202S,A01,494387,Staff,35,0,35,0
1713324363047,EAP 100,A00,516065,Staff,9792,0,9999,207
1713324364072,ECE 45,A01,507414,Staff,52,0,60,8
1713324365100,ECE 100,A01,507416,Baghdadchi; Saharnaz,11,0,20,9
1713324365100,ECE 100,A02,507418,Baghdadchi; Saharnaz,20,0,20,0
1713324366124,ECE 111,A01,507420,Staff,39,0,50,11
1713324367151,ECE 197,001,548057,Sievenpiper; Daniel F.,9998,0,9999,1
1713324368173,EDS 115,A00,507243,Choi; Bailey Miyeon,28,0,28,0
1713324369197,EDS 117,A01,494379,Staff,23,0,25,2
1713324370226,EDS 125,A00,507246,Hopkins; Megan Beth,29,0,30,1
1713324371254,EDS 128A,A01,507264,Fargason; Sharon Gayle,26,0,26,0
1713324372278,EDS 128B,A01,507293,Pappas; Elizabeth,30,0,30,0
1713324373303,EDS 139,A00,507294,Fargason; Sharon Gayle,30,0,30,0
1713324373303,EDS 139,B00,507313,Pappas; Elizabeth,30,0,30,0
1713324374331,EDS 201,A00,507315,Staff,26,0,30,4
1713324375359,EDS 203,A01,507317,Halter; Christopher P.,26,0,30,4
1713324376387,EDS 204R,A01,507319,Halter; Christopher P.,3,0,30,27
1713324376387,EDS 204R,B01,507331,Heinzman; Erica M.,28,0,30,2
1713324377411,EDS 206R,A00,507332,Staff,4,0,30,26
1713324377411,EDS 206R,B00,507343,Staff,28,0,30,2
1713324378436,EDS 250,A00,507344,Hemans; Patricia Ann Benitez,36,0,40,4
1713324379460,EDS 281,A00,507345,Daly; Alan J.,18,0,18,0
1713324380484,EDS 284,A00,507350,Daly; Alan J.,16,0,16,0
1713324381512,EDS 286,A00,507359,Fine; Sarah,18,0,18,0
1713324382541,EDS 289C,A01,507361,Daly; Alan J.,18,0,18,0
1713324383568,EDS 290,A00,507366,Hofstetter; Carolyn,15,0,15,0
1713324384593,LIGM 5A,A00,507421,Fischer-Grunski; Eva K,20,0,20,0
1713324385618,LIGM 5B,A00,507423,Fischer-Grunski; Eva K,20,0,20,0
1713324386642,LIGM 5C,A00,507425,Fischer-Grunski; Eva K,20,0,20,0
1713324387672,LIIT 5AS,A00,507427,Carnelos; Chiara,20,0,20,0
1713324388701,LIIT 5BS,A00,507430,Carnelos; Chiara,20,0,20,0
1713324389728,LIIT 5CS,A00,507432,Carnelos; Chiara,20,0,20,0
1713324390760,LISP 5A,A00,507541,Munoz Sanchez; Alicia,18,0,20,2
1713324391784,LISP 5B,A00,507671,Munoz Sanchez; Alicia,16,0,20,4
1713324392809,LISP 5C,A00,507696,Munoz Sanchez; Alicia,16,0,20,4
1713324393836,MAE 197,001,528363,Boechler; Nicholas Sebastia,9998,0,9999,1
1713324394860,MATH 197,001,523477,Kedlaya; Kiran S.,9999,0,9999,0
1713324394860,MATH 197,002,563811,Zhang; Danna,9999,0,9999,0
1713324395889,MCWP 40R,A00,518780,Staff,20,0,20,0
1713324395889,MCWP 40R,B00,518781,Staff,19,0,20,1
1713324395889,MCWP 40R,C00,518783,Staff,19,0,20,1
1713324396916,MCWP 50R,A00,518791,Staff,20,0,20,0
1713324396916,MCWP 50R,B00,518792,Staff,17,0,20,3
1713324396916,MCWP 50R,C00,518793,Staff,19,0,20,1
1713324396916,MCWP 50R,D00,518794,Staff,16,0,20,4
1713324396916,MCWP 50R,E00,518795,Staff,16,0,20,4
1713324396916,MCWP 50R,F00,518796,Staff,19,0,20,1
1713324396916,MCWP 50R,G00,518797,Staff,19,0,20,1
1713324397942,MMW 12R,A01,514034,Herbst; Matthew,15,0,16,1
1713324397942,MMW 12R,A02,514035,Herbst; Matthew,16,0,16,0
1713324398969,MMW 13R,A01,514037,Staff,12,0,16,4
1713324398969,MMW 13R,A02,514039,Staff,16,0,16,0
1713324401025,SIO 295LS,A00,523233,Staff,19,0,30,11
1713324402054,SIO 295S,A00,523232,Staff,19,0,30,11
1713324403078,SOCI 117,A01,494376,Staff,2,0,5,3
1713324404158,WES 237B,A00,494380,Staff,19,0,20,1
1713324406208,AESE 279B,A00,494370,Wade; Jon P,33,0,33,0
1713324407233,ANAR 135S,A00,494369,Braswell; Geoffrey E.,0,0,0,0
1713324408259,CAT 124RS,A01,519847,Geibel; William,17,0,20,3
1713324409284,CAT 125RS,A01,515971,Geibel; William,17,0,20,3
1713324410307,CLRE 250,A00,511389,Morris; Sheldon,9996,0,9999,3
1713324411332,CLRE 251,A00,507176,Mehta; Ravindra L.,9996,0,9999,3
1713324411332,CLRE 251,B00,511410,Mehta; Ravindra L.,9998,0,9999,1
1713324412356,CLRE 252,A00,507189,Cuomo; Raphael Eduardo,9998,0,9999,1
1713324413386,CLRE 253,A00,507199,Vaida; Florin,9997,0,9999,2
1713324413386,CLRE 253,B00,507202,Vaida; Florin,9999,0,9999,0
1713324414412,CLRE 259,A00,507211,Patel; Hemal,9996,0,9999,3
1713324415437,CLRE 260,A00,507221,Cuomo; Raphael Eduardo,9999,0,9999,0
1713324416463,CLRE 297,001,507242,Cuomo; Raphael Eduardo,9999,0,9999,0
1713324417486,CSE 191,A00,516875,Minnes Kemp; Mor Mia,9999,0,9999,0
1713324418512,CSS 201S,A01,494383,Staff,35,0,35,0
1713324419536,CSS 202S,A01,494387,Staff,35,0,35,0
1713324420561,EAP 100,A00,516065,Staff,9792,0,9999,207
1713324421590,ECE 45,A01,507414,Staff,52,0,60,8
1713324422619,ECE 100,A01,507416,Baghdadchi; Saharnaz,11,0,20,9
1713324422619,ECE 100,A02,507418,Baghdadchi; Saharnaz,20,0,20,0
1713324423647,ECE 111,A01,507420,Staff,39,0,50,11
1713324424672,ECE 197,001,548057,Sievenpiper; Daniel F.,9998,0,9999,1
1713324425696,EDS 115,A00,507243,Choi; Bailey Miyeon,28,0,28,0
1713324426720,EDS 117,A01,494379,Staff,23,0,25,2
1713324427745,EDS 125,A00,507246,Hopkins; Megan Beth,29,0,30,1
1713324428769,EDS 128A,A01,507264,Fargason; Sharon Gayle,26,0,26,0
1713324429805,EDS 128B,A01,507293,Pappas; Elizabeth,30,0,30,0
1713324430833,EDS 139,A00,507294,Fargason; Sharon Gayle,30,0,30,0
1713324430833,EDS 139,B00,507313,Pappas; Elizabeth,30,0,30,0
1713324431856,EDS 201,A00,507315,Staff,26,0,30,4
1713324432881,EDS 203,A01,507317,Halter; Christopher P.,26,0,30,4
1713324433929,EDS 204R,A01,507319,Halter; Christopher P.,3,0,30,27
1713324433929,EDS 204R,B01,507331,Heinzman; Erica M.,28,0,30,2
1713324434954,EDS 206R,A00,507332,Staff,4,0,30,26
1713324434954,EDS 206R,B00,507343,Staff,28,0,30,2
1713324435982,EDS 250,A00,507344,Hemans; Patricia Ann Benitez,36,0,40,4
1713324437009,EDS 281,A00,507345,Daly; Alan J.,18,0,18,0
1713324438037,EDS 284,A00,507350,Daly; Alan J.,16,0,16,0
1713324439062,EDS 286,A00,507359,Fine; Sarah,18,0,18,0
1713324440086,EDS 289C,A01,507361,Daly; Alan J.,18,0,18,0
1713324441114,EDS 290,A00,507366,Hofstetter; Carolyn,15,0,15,0
1713324442140,LIGM 5A,A00,507421,Fischer-Grunski; Eva K,20,0,20,0
1713324443164,LIGM 5B,A00,507423,Fischer-Grunski; Eva K,20,0,20,0
1713324444192,LIGM 5C,A00,507425,Fischer-Grunski; Eva K,20,0,20,0
1713324445221,LIIT 5AS,A00,507427,Carnelos; Chiara,20,0,20,0
1713324446248,LIIT 5BS,A00,507430,Carnelos; Chiara,20,0,20,0
1713324447273,LIIT 5CS,A00,507432,Carnelos; Chiara,20,0,20,0
1713324448302,LISP 5A,A00,507541,Munoz Sanchez; Alicia,18,0,20,2
1713324449327,LISP 5B,A00,507671,Munoz Sanchez; Alicia,16,0,20,4
1713324450352,LISP 5C,A00,507696,Munoz Sanchez; Alicia,16,0,20,4
1713324451380,MAE 197,001,528363,Boechler; Nicholas Sebastia,9998,0,9999,1
1713324452404,MATH 197,001,523477,Kedlaya; Kiran S.,9999,0,9999,0
1713324452404,MATH 197,002,563811,Zhang; Danna,9999,0,9999,0
1713324453432,MCWP 40R,A00,518780,Staff,20,0,20,0
1713324453432,MCWP 40R,B00,518781,Staff,19,0,20,1
1713324453432,MCWP 40R,C00,518783,Staff,19,0,20,1
1713324454458,MCWP 50R,A00,518791,Staff,20,0,20,0
1713324454458,MCWP 50R,B00,518792,Staff,17,0,20,3
1713324454458,MCWP 50R,C00,518793,Staff,19,0,20,1
1713324454458,MCWP 50R,D00,518794,Staff,16,0,20,4
1713324454458,MCWP 50R,E00,518795,Staff,16,0,20,4
1713324454458,MCWP 50R,F00,518796,Staff,19,0,20,1
1713324454458,MCWP 50R,G00,518797,Staff,19,0,20,1
1713324455483,MMW 12R,A01,514034,Herbst; Matthew,15,0,16,1
1713324455483,MMW 12R,A02,514035,Herbst; Matthew,16,0,16,0
1713324456507,MMW 13R,A01,514037,Staff,12,0,16,4
1713324456507,MMW 13R,A02,514039,Staff,16,0,16,0
1713324458562,SIO 295LS,A00,523233,Staff,19,0,30,11
1713324459589,SIO 295S,A00,523232,Staff,19,0,30,11
1713324460614,SOCI 117,A01,494376,Staff,2,0,5,3
1713324461641,WES 237B,A00,494380,Staff,19,0,20,1
1713324463705,AESE 279B,A00,494370,Wade; Jon P,33,0,33,0
1713324464733,ANAR 135S,A00,494369,Braswell; Geoffrey E.,0,0,0,0
1713324465757,CAT 124RS,A01,519847,Geibel; William,17,0,20,3
1713324466783,CAT 125RS,A01,515971,Geibel; William,17,0,20,3
1713324467808,CLRE 250,A00,511389,Morris; Sheldon,9996,0,9999,3
1713324468836,CLRE 251,A00,507176,Mehta; Ravindra L.,9996,0,9999,3
1713324468836,CLRE 251,B00,511410,Mehta; Ravindra L.,9998,0,9999,1
1713324469866,CLRE 252,A00,507189,Cuomo; Raphael Eduardo,9998,0,9999,1
1713324470894,CLRE 253,A00,507199,Vaida; Florin,9997,0,9999,2
1713324470894,CLRE 253,B00,507202,Vaida; Florin,9999,0,9999,0
1713324471919,CLRE 259,A00,507211,Patel; Hemal,9996,0,9999,3
1713324472948,CLRE 260,A00,507221,Cuomo; Raphael Eduardo,9999,0,9999,0
1713324473972,CLRE 297,001,507242,Cuomo; Raphael Eduardo,9999,0,9999,0
1713324474996,CSE 191,A00,516875,Minnes Kemp; Mor Mia,9999,0,9999,0
1713324476020,CSS 201S,A01,494383,Staff,35,0,35,0
1713324477048,CSS 202S,A01,494387,Staff,35,0,35,0
1713324478073,EAP 100,A00,516065,Staff,9792,0,9999,207
1713324479100,ECE 45,A01,507414,Staff,52,0,60,8
1713324480126,ECE 100,A01,507416,Baghdadchi; Saharnaz,11,0,20,9
1713324480126,ECE 100,A02,507418,Baghdadchi; Saharnaz,20,0,20,0
1713324481152,ECE 111,A01,507420,Staff,39,0,50,11
1713324482177,ECE 197,001,548057,Sievenpiper; Daniel F.,9998,0,9999,1
1713324483204,EDS 115,A00,507243,Choi; Bailey Miyeon,28,0,28,0
1713324484228,EDS 117,A01,494379,Staff,23,0,25,2
1713324485253,EDS 125,A00,507246,Hopkins; Megan Beth,29,0,30,1
1713324486278,EDS 128A,A01,507264,Fargason; Sharon Gayle,26,0,26,0
1713324487303,EDS 128B,A01,507293,Pappas; Elizabeth,30,0,30,0
1713324488326,EDS 139,A00,507294,Fargason; Sharon Gayle,30,0,30,0
1713324488326,EDS 139,B00,507313,Pappas; Elizabeth,30,0,30,0
1713324489350,EDS 201,A00,507315,Staff,26,0,30,4
1713324490374,EDS 203,A01,507317,Halter; Christopher P.,26,0,30,4
1713324491401,EDS 204R,A01,507319,Halter; Christopher P.,3,0,30,27
1713324491401,EDS 204R,B01,507331,Heinzman; Erica M.,28,0,30,2
1713324492428,EDS 206R,A00,507332,Staff,4,0,30,26
1713324492428,EDS 206R,B00,507343,Staff,28,0,30,2
1713324493453,EDS 250,A00,507344,Hemans; Patricia Ann Benitez,36,0,40,4
1713324494477,EDS 281,A00,507345,Daly; Alan J.,18,0,18,0
1713324495505,EDS 284,A00,507350,Daly; Alan J.,16,0,16,0
1713324496530,EDS 286,A00,507359,Fine; Sarah,18,0,18,0
1713324497554,EDS 289C,A01,507361,Daly; Alan J.,18,0,18,0
1713324498579,EDS 290,A00,507366,Hofstetter; Carolyn,15,0,15,0
1713324499603,LIGM 5A,A00,507421,Fischer-Grunski; Eva K,20,0,20,0
1713324500632,LIGM 5B,A00,507423,Fischer-Grunski; Eva K,20,0,20,0
1713324501660,LIGM 5C,A00,507425,Fischer-Grunski; Eva K,20,0,20,0
1713324502686,LIIT 5AS,A00,507427,Carnelos; Chiara,20,0,20,0
1713324503710,LIIT 5BS,A00,507430,Carnelos; Chiara,20,0,20,0
1713324504735,LIIT 5CS,A00,507432,Carnelos; Chiara,20,0,20,0
1713324505761,LISP 5A,A00,507541,Munoz Sanchez; Alicia,18,0,20,2
1713324506785,LISP 5B,A00,507671,Munoz Sanchez; Alicia,16,0,20,4
1713324507869,LISP 5C,A00,507696,Munoz Sanchez; Alicia,16,0,20,4
1713324508895,MAE 197,001,528363,Boechler; Nicholas Sebastia,9998,0,9999,1
1713324509920,MATH 197,001,523477,Kedlaya; Kiran S.,9999,0,9999,0
1713324509920,MATH 197,002,563811,Zhang; Danna,9999,0,9999,0
1713324510948,MCWP 40R,A00,518780,Staff,20,0,20,0
1713324510948,MCWP 40R,B00,518781,Staff,19,0,20,1
1713324510948,MCWP 40R,C00,518783,Staff,19,0,20,1
1713324511974,MCWP 50R,A00,518791,Staff,20,0,20,0
1713324511974,MCWP 50R,B00,518792,Staff,17,0,20,3
1713324511974,MCWP 50R,C00,518793,Staff,19,0,20,1
1713324511974,MCWP 50R,D00,518794,Staff,16,0,20,4
1713324511974,MCWP 50R,E00,518795,Staff,16,0,20,4
1713324511974,MCWP 50R,F00,518796,Staff,19,0,20,1
1713324511974,MCWP 50R,G00,518797,Staff,19,0,20,1
1713324512998,MMW 12R,A01,514034,Herbst; Matthew,15,0,16,1
1713324512998,MMW 12R,A02,514035,Herbst; Matthew,16,0,16,0
1713324514022,MMW 13R,A01,514037,Staff,12,0,16,4
1713324514022,MMW 13R,A02,514039,Staff,16,0,16,0
1713324516077,SIO 295LS,A00,523233,Staff,19,0,30,11
1713324517104,SIO 295S,A00,523232,Staff,19,0,30,11
1713324518132,SOCI 117,A01,494376,Staff,2,0,5,3
1713324519156,WES 237B,A00,494380,Staff,19,0,20,1
1713324521209,AESE 279B,A00,494370,Wade; Jon P,33,0,33,0
1713324522234,ANAR 135S,A00,494369,Braswell; Geoffrey E.,0,0,0,0
1713324523259,CAT 124RS,A01,519847,Geibel; William,17,0,20,3
1713324524285,CAT 125RS,A01,515971,Geibel; William,17,0,20,3
1713324525309,CLRE 250,A00,511389,Morris; Sheldon,9996,0,9999,3
1713324526336,CLRE 251,A00,507176,Mehta; Ravindra L.,9996,0,9999,3
1713324526336,CLRE 251,B00,511410,Mehta; Ravindra L.,9998,0,9999,1
1713324527363,CLRE 252,A00,507189,Cuomo; Raphael Eduardo,9998,0,9999,1
1713324528389,CLRE 253,A00,507199,Vaida; Florin,9997,0,9999,2
1713324528389,CLRE 253,B00,507202,Vaida; Florin,9999,0,9999,0
1713324529417,CLRE 259,A00,507211,Patel; Hemal,9996,0,9999,3
1713324530445,CLRE 260,A00,507221,Cuomo; Raphael Eduardo,9999,0,9999,0
1713324531469,CLRE 297,001,507242,Cuomo; Raphael Eduardo,9999,0,9999,0
1713324532495,CSE 191,A00,516875,Minnes Kemp; Mor Mia,9999,0,9999,0
1713324533523,CSS 201S,A01,494383,Staff,35,0,35,0
1713324534547,CSS 202S,A01,494387,Staff,35,0,35,0
1713324535573,EAP 100,A00,516065,Staff,9792,0,9999,207
1713324536599,ECE 45,A01,507414,Staff,52,0,60,8
1713324537624,ECE 100,A01,507416,Baghdadchi; Saharnaz,11,0,20,9
1713324537624,ECE 100,A02,507418,Baghdadchi; Saharnaz,20,0,20,0
1713324538649,ECE 111,A01,507420,Staff,39,0,50,11
1713324539673,ECE 197,001,548057,Sievenpiper; Daniel F.,9998,0,9999,1
1713324540702,EDS 115,A00,507243,Choi; Bailey Miyeon,28,0,28,0
1713324541726,EDS 117,A01,494379,Staff,23,0,25,2
1713324542752,EDS 125,A00,507246,Hopkins; Megan Beth,29,0,30,1
1713324543777,EDS 128A,A01,507264,Fargason; Sharon Gayle,26,0,26,0
1713324544802,EDS 128B,A01,507293,Pappas; Elizabeth,30,0,30,0
1713324545829,EDS 139,A00,507294,Fargason; Sharon Gayle,30,0,30,0
1713324545829,EDS 139,B00,507313,Pappas; Elizabeth,30,0,30,0
1713324546855,EDS 201,A00,507315,Staff,26,0,30,4
1713324547885,EDS 203,A01,507317,Halter; Christopher P.,26,0,30,4
1713324548909,EDS 204R,A01,507319,Halter; Christopher P.,3,0,30,27
1713324548909,EDS 204R,B01,507331,Heinzman; Erica M.,28,0,30,2
1713324549934,EDS 206R,A00,507332,Staff,4,0,30,26
1713324549934,EDS 206R,B00,507343,Staff,28,0,30,2
1713324550958,EDS 250,A00,507344,Hemans; Patricia Ann Benitez,36,0,40,4
1713324551983,EDS 281,A00,507345,Daly; Alan J.,18,0,18,0
1713324553008,EDS 284,A00,507350,Daly; Alan J.,16,0,16,0
1713324554033,EDS 286,A00,507359,Fine; Sarah,18,0,18,0
1713324555059,EDS 289C,A01,507361,Daly; Alan J.,18,0,18,0
1713324556086,EDS 290,A00,507366,Hofstetter; Carolyn,15,0,15,0
1713324557115,LIGM 5A,A00,507421,Fischer-Grunski; Eva K,20,0,20,0
1713324558143,LIGM 5B,A00,507423,Fischer-Grunski; Eva K,20,0,20,0
1713324559168,LIGM 5C,A00,507425,Fischer-Grunski; Eva K,20,0,20,0
1713324560194,LIIT 5AS,A00,507427,Carnelos; Chiara,20,0,20,0
1713324561222,LIIT 5BS,A00,507430,Carnelos; Chiara,20,0,20,0
1713324562250,LIIT 5CS,A00,507432,Carnelos; Chiara,20,0,20,0
1713324563280,LISP 5A,A00,507541,Munoz Sanchez; Alicia,18,0,20,2
1713324564309,LISP 5B,A00,507671,Munoz Sanchez; Alicia,16,0,20,4
1713324565332,LISP 5C,A00,507696,Munoz Sanchez; Alicia,16,0,20,4
1713324566358,MAE 197,001,528363,Boechler; Nicholas Sebastia,9998,0,9999,1
1713324567384,MATH 197,001,523477,Kedlaya; Kiran S.,9999,0,9999,0
1713324567384,MATH 197,002,563811,Zhang; Danna,9999,0,9999,0
1713324568408,MCWP 40R,A00,518780,Staff,20,0,20,0
1713324568408,MCWP 40R,B00,518781,Staff,19,0,20,1
1713324568408,MCWP 40R,C00,518783,Staff,19,0,20,1
1713324569434,MCWP 50R,A00,518791,Staff,20,0,20,0
1713324569434,MCWP 50R,B00,518792,Staff,17,0,20,3
1713324569434,MCWP 50R,C00,518793,Staff,19,0,20,1
1713324569434,MCWP 50R,D00,518794,Staff,16,0,20,4
1713324569434,MCWP 50R,E00,518795,Staff,16,0,20,4
1713324569434,MCWP 50R,F00,518796,Staff,19,0,20,1
1713324569434,MCWP 50R,G00,518797,Staff,19,0,20,1
1713324570462,MMW 12R,A01,514034,Herbst; Matthew,15,0,16,1
1713324570462,MMW 12R,A02,514035,Herbst; Matthew,16,0,16,0
1713324571487,MMW 13R,A01,514037,Staff,12,0,16,4
1713324571487,MMW 13R,A02,514039,Staff,16,0,16,0
1713324573538,SIO 295LS,A00,523233,Staff,19,0,30,11
1713324574565,SIO 295S,A00,523232,Staff,19,0,30,11
1713324575593,SOCI 117,A01,494376,Staff,2,0,5,3
1713324576617,WES 237B,A00,494380,Staff,19,0,20,1
1713324578686,AESE 279B,A00,494370,Wade; Jon P,33,0,33,0
1713324579709,ANAR 135S,A00,494369,Braswell; Geoffrey E.,0,0,0,0
1713324580734,CAT 124RS,A01,519847,Geibel; William,17,0,20,3
1713324581757,CAT 125RS,A01,515971,Geibel; William,17,0,20,3
1713324582783,CLRE 250,A00,511389,Morris; Sheldon,9996,0,9999,3
1713324583808,CLRE 251,A00,507176,Mehta; Ravindra L.,9996,0,9999,3
1713324583808,CLRE 251,B00,511410,Mehta; Ravindra L.,9998,0,9999,1
1713324584832,CLRE 252,A00,507189,Cuomo; Raphael Eduardo,9998,0,9999,1
1713324585859,CLRE 253,A00,507199,Vaida; Florin,9997,0,9999,2
1713324585859,CLRE 253,B00,507202,Vaida; Florin,9999,0,9999,0
1713324586886,CLRE 259,A00,507211,Patel; Hemal,9996,0,9999,3
1713324587911,CLRE 260,A00,507221,Cuomo; Raphael Eduardo,9999,0,9999,0
1713324588939,CLRE 297,001,507242,Cuomo; Raphael Eduardo,9999,0,9999,0
1713324589964,CSE 191,A00,516875,Minnes Kemp; Mor Mia,9999,0,9999,0
1713324590992,CSS 201S,A01,494383,Staff,35,0,35,0
1713324592018,CSS 202S,A01,494387,Staff,35,0,35,0
1713324593041,EAP 100,A00,516065,Staff,9792,0,9999,207
1713324594067,ECE 45,A01,507414,Staff,52,0,60,8
1713324595096,ECE 100,A01,507416,Baghdadchi; Saharnaz,11,0,20,9
1713324595096,ECE 100,A02,507418,Baghdadchi; Saharnaz,20,0,20,0
1713324596121,ECE 111,A01,507420,Staff,39,0,50,11
1713324597149,ECE 197,001,548057,Sievenpiper; Daniel F.,9998,0,9999,1
1713324598174,EDS 115,A00,507243,Choi; Bailey Miyeon,28,0,28,0
1713324599199,EDS 117,A01,494379,Staff,23,0,25,2
1713324600225,EDS 125,A00,507246,Hopkins; Megan Beth,29,0,30,1
1713324601251,EDS 128A,A01,507264,Fargason; Sharon Gayle,26,0,26,0
1713324602275,EDS 128B,A01,507293,Pappas; Elizabeth,30,0,30,0
1713324603297,EDS 139,A00,507294,Fargason; Sharon Gayle,30,0,30,0
1713324603297,EDS 139,B00,507313,Pappas; Elizabeth,30,0,30,0
1713324604325,EDS 201,A00,507315,Staff,26,0,30,4
1713324605350,EDS 203,A01,507317,Halter; Christopher P.,26,0,30,4
1713324606374,EDS 204R,A01,507319,Halter; Christopher P.,3,0,30,27
1713324606374,EDS 204R,B01,507331,Heinzman; Erica M.,28,0,30,2
1713324607401,EDS 206R,A00,507332,Staff,4,0,30,26
1713324607401,EDS 206R,B00,507343,Staff,28,0,30,2
1713324608426,EDS 250,A00,507344,Hemans; Patricia Ann Benitez,36,0,40,4
1713324609453,EDS 281,A00,507345,Daly; Alan J.,18,0,18,0
1713324610482,EDS 284,A00,507350,Daly; Alan J.,16,0,16,0
1713324611563,EDS 286,A00,507359,Fine; Sarah,18,0,18,0
1713324612590,EDS 289C,A01,507361,Daly; Alan J.,18,0,18,0
1713324613616,EDS 290,A00,507366,Hofstetter; Carolyn,15,0,15,0
1713324614642,LIGM 5A,A00,507421,Fischer-Grunski; Eva K,20,0,20,0
1713324615668,LIGM 5B,A00,507423,Fischer-Grunski; Eva K,20,0,20,0
1713324616696,LIGM 5C,A00,507425,Fischer-Grunski; Eva K,20,0,20,0
1713324617721,LIIT 5AS,A00,507427,Carnelos; Chiara,20,0,20,0
1713324618751,LIIT 5BS,A00,507430,Carnelos; Chiara,20,0,20,0
1713324619781,LIIT 5CS,A00,507432,Carnelos; Chiara,20,0,20,0
1713324620809,LISP 5A,A00,507541,Munoz Sanchez; Alicia,18,0,20,2
1713324621833,LISP 5B,A00,507671,Munoz Sanchez; Alicia,16,0,20,4
1713324622857,LISP 5C,A00,507696,Munoz Sanchez; Alicia,16,0,20,4
1713324623896,MAE 197,001,528363,Boechler; Nicholas Sebastia,9998,0,9999,1
1713324624920,MATH 197,001,523477,Kedlaya; Kiran S.,9999,0,9999,0
1713324624920,MATH 197,002,563811,Zhang; Danna,9999,0,9999,0
1713324625948,MCWP 40R,A00,518780,Staff,20,0,20,0
1713324625948,MCWP 40R,B00,518781,Staff,19,0,20,1
1713324625948,MCWP 40R,C00,518783,Staff,19,0,20,1
1713324626975,MCWP 50R,A00,518791,Staff,20,0,20,0
1713324626975,MCWP 50R,B00,518792,Staff,17,0,20,3
1713324626975,MCWP 50R,C00,518793,Staff,19,0,20,1
1713324626975,MCWP 50R,D00,518794,Staff,16,0,20,4
1713324626975,MCWP 50R,E00,518795,Staff,16,0,20,4
1713324626975,MCWP 50R,F00,518796,Staff,19,0,20,1
1713324626975,MCWP 50R,G00,518797,Staff,19,0,20,1
1713324627998,MMW 12R,A01,514034,Herbst; Matthew,15,0,16,1
1713324627998,MMW 12R,A02,514035,Herbst; Matthew,16,0,16,0
1713324629023,MMW 13R,A01,514037,Staff,12,0,16,4
1713324629023,MMW 13R,A02,514039,Staff,16,0,16,0
1713324631073,SIO 295LS,A00,523233,Staff,19,0,30,11
1713324632098,SIO 295S,A00,523232,Staff,19,0,30,11
1713324633127,SOCI 117,A01,494376,Staff,2,0,5,3
1713324634150,WES 237B,A00,494380,Staff,19,0,20,1
1713324636220,AESE 279B,A00,494370,Wade; Jon P,33,0,33,0
1713324637246,ANAR 135S,A00,494369,Braswell; Geoffrey E.,0,0,0,0
1713324638273,CAT 124RS,A01,519847,Geibel; William,17,0,20,3
1713324639299,CAT 125RS,A01,515971,Geibel; William,17,0,20,3
1713324640327,CLRE 250,A00,511389,Morris; Sheldon,9996,0,9999,3
1713324641352,CLRE 251,A00,507176,Mehta; Ravindra L.,9996,0,9999,3
1713324641352,CLRE 251,B00,511410,Mehta; Ravindra L.,9998,0,9999,1
1713324642377,CLRE 252,A00,507189,Cuomo; Raphael Eduardo,9998,0,9999,1
1713324643403,CLRE 253,A00,507199,Vaida; Florin,9997,0,9999,2
1713324643403,CLRE 253,B00,507202,Vaida; Florin,9999,0,9999,0
1713324644432,CLRE 259,A00,507211,Patel; Hemal,9996,0,9999,3
1713324645456,CLRE 260,A00,507221,Cuomo; Raphael Eduardo,9999,0,9999,0
1713324646482,CLRE 297,001,507242,Cuomo; Raphael Eduardo,9999,0,9999,0
1713324647509,CSE 191,A00,516875,Minnes Kemp; Mor Mia,9999,0,9999,0
1713324648535,CSS 201S,A01,494383,Staff,35,0,35,0
1713324649559,CSS 202S,A01,494387,Staff,35,0,35,0
1713324650584,EAP 100,A00,516065,Staff,9792,0,9999,207
1713324651608,ECE 45,A01,507414,Staff,52,0,60,8
1713324652637,ECE 100,A01,507416,Baghdadchi; Saharnaz,11,0,20,9
1713324652637,ECE 100,A02,507418,Baghdadchi; Saharnaz,20,0,20,0
1713324653664,ECE 111,A01,507420,Staff,39,0,50,11
1713324654690,ECE 197,001,548057,Sievenpiper; Daniel F.,9998,0,9999,1
1713324655714,EDS 115,A00,507243,Choi; Bailey Miyeon,28,0,28,0
1713324656742,EDS 117,A01,494379,Staff,23,0,25,2
1713324657768,EDS 125,A00,507246,Hopkins; Megan Beth,29,0,30,1
1713324658793,EDS 128A,A01,507264,Fargason; Sharon Gayle,26,0,26,0
1713324659817,EDS 128B,A01,507293,Pappas; Elizabeth,30,0,30,0
1713324660845,EDS 139,A00,507294,Fargason; Sharon Gayle,30,0,30,0
1713324660845,EDS 139,B00,507313,Pappas; Elizabeth,30,0,30,0
1713324661870,EDS 201,A00,507315,Staff,26,0,30,4
1713324662894,EDS 203,A01,507317,Halter; Christopher P.,26,0,30,4
1713324663924,EDS 204R,A01,507319,Halter; Christopher P.,3,0,30,27
1713324663924,EDS 204R,B01,507331,Heinzman; Erica M.,28,0,30,2
1713324664950,EDS 206R,A00,507332,Staff,4,0,30,26
1713324664950,EDS 206R,B00,507343,Staff,28,0,30,2
1713324665978,EDS 250,A00,507344,Hemans; Patricia Ann Benitez,36,0,40,4
1713324667001,EDS 281,A00,507345,Daly; Alan J.,18,0,18,0
1713324668025,EDS 284,A00,507350,Daly; Alan J.,16,0,16,0
1713324669053,EDS 286,A00,507359,Fine; Sarah,18,0,18,0
1713324670081,EDS 289C,A01,507361,Daly; Alan J.,18,0,18,0
1713324671107,EDS 290,A00,507366,Hofstetter; Carolyn,15,0,15,0
1713324672135,LIGM 5A,A00,507421,Fischer-Grunski; Eva K,20,0,20,0
1713324673158,LIGM 5B,A00,507423,Fischer-Grunski; Eva K,20,0,20,0
1713324674184,LIGM 5C,A00,507425,Fischer-Grunski; Eva K,20,0,20,0
1713324675208,LIIT 5AS,A00,507427,Carnelos; Chiara,20,0,20,0
1713324676233,LIIT 5BS,A00,507430,Carnelos; Chiara,20,0,20,0
1713324677262,LIIT 5CS,A00,507432,Carnelos; Chiara,20,0,20,0
1713324678287,LISP 5A,A00,507541,Munoz Sanchez; Alicia,18,0,20,2
1713324679315,LISP 5B,A00,507671,Munoz Sanchez; Alicia,16,0,20,4
1713324680340,LISP 5C,A00,507696,Munoz Sanchez; Alicia,16,0,20,4
1713324681365,MAE 197,001,528363,Boechler; Nicholas Sebastia,9998,0,9999,1
1713324682393,MATH 197,001,523477,Kedlaya; Kiran S.,9999,0,9999,0
1713324682393,MATH 197,002,563811,Zhang; Danna,9999,0,9999,0
1713324683419,MCWP 40R,A00,518780,Staff,20,0,20,0
1713324683419,MCWP 40R,B00,518781,Staff,19,0,20,1
1713324683419,MCWP 40R,C00,518783,Staff,19,0,20,1
1713324684448,MCWP 50R,A00,518791,Staff,20,0,20,0
1713324684448,MCWP 50R,B00,518792,Staff,17,0,20,3
1713324684448,MCWP 50R,C00,518793,Staff,19,0,20,1
1713324684448,MCWP 50R,D00,518794,Staff,16,0,20,4
1713324684448,MCWP 50R,E00,518795,Staff,16,0,20,4
1713324684448,MCWP 50R,F00,518796,Staff,19,0,20,1
1713324684448,MCWP 50R,G00,518797,Staff,19,0,20,1
1713324685472,MMW 12R,A01,514034,Herbst; Matthew,15,0,16,1
1713324685472,MMW 12R,A02,514035,Herbst; Matthew,16,0,16,0
1713324686499,MMW 13R,A01,514037,Staff,12,0,16,4
1713324686499,MMW 13R,A02,514039,Staff,16,0,16,0
1713324688548,SIO 295LS,A00,523233,Staff,19,0,30,11
1713324689576,SIO 295S,A00,523232,Staff,19,0,30,11
1713324690603,SOCI 117,A01,494376,Staff,2,0,5,3
1713324691628,WES 237B,A00,494380,Staff,19,0,20,1
1713324693683,AESE 279B,A00,494370,Wade; Jon P,33,0,33,0
1713324694707,ANAR 135S,A00,494369,Braswell; Geoffrey E.,0,0,0,0
1713324695732,CAT 124RS,A01,519847,Geibel; William,17,0,20,3
1713324696758,CAT 125RS,A01,515971,Geibel; William,17,0,20,3
1713324697786,CLRE 250,A00,511389,Morris; Sheldon,9996,0,9999,3
1713324698810,CLRE 251,A00,507176,Mehta; Ravindra L.,9996,0,9999,3
1713324698810,CLRE 251,B00,511410,Mehta; Ravindra L.,9998,0,9999,1
1713324699834,CLRE 252,A00,507189,Cuomo; Raphael Eduardo,9998,0,9999,1
1713324700858,CLRE 253,A00,507199,Vaida; Florin,9997,0,9999,2
1713324700858,CLRE 253,B00,507202,Vaida; Florin,9999,0,9999,0
1713324701885,CLRE 259,A00,507211,Patel; Hemal,9996,0,9999,3
1713324702913,CLRE 260,A00,507221,Cuomo; Raphael Eduardo,9999,0,9999,0
1713324703936,CLRE 297,001,507242,Cuomo; Raphael Eduardo,9999,0,9999,0
1713324704961,CSE 191,A00,516875,Minnes Kemp; Mor Mia,9999,0,9999,0
1713324705986,CSS 201S,A01,494383,Staff,35,0,35,0
1713324707010,CSS 202S,A01,494387,Staff,35,0,35,0
1713324708037,EAP 100,A00,516065,Staff,9792,0,9999,207
1713324709061,ECE 45,A01,507414,Staff,52,0,60,8
1713324710084,ECE 100,A01,507416,Baghdadchi; Saharnaz,11,0,20,9
1713324710084,ECE 100,A02,507418,Baghdadchi; Saharnaz,20,0,20,0
1713324711108,ECE 111,A01,507420,Staff,39,0,50,11
1713324712133,ECE 197,001,548057,Sievenpiper; Daniel F.,9998,0,9999,1
1713324713162,EDS 115,A00,507243,Choi; Bailey Miyeon,28,0,28,0
1713324714187,EDS 117,A01,494379,Staff,23,0,25,2
1713324715266,EDS 125,A00,507246,Hopkins; Megan Beth,29,0,30,1
1713324716290,EDS 128A,A01,507264,Fargason; Sharon Gayle,26,0,26,0
1713324717320,EDS 128B,A01,507293,Pappas; Elizabeth,30,0,30,0
1713324718347,EDS 139,A00,507294,Fargason; Sharon Gayle,30,0,30,0
1713324718347,EDS 139,B00,507313,Pappas; Elizabeth,30,0,30,0
1713324719372,EDS 201,A00,507315,Staff,26,0,30,4
1713324720396,EDS 203,A01,507317,Halter; Christopher P.,26,0,30,4
1713324721441,EDS 204R,A01,507319,Halter; Christopher P.,3,0,30,27
1713324721441,EDS 204R,B01,507331,Heinzman; Erica M.,28,0,30,2
1713324722465,EDS 206R,A00,507332,Staff,4,0,30,26
1713324722465,EDS 206R,B00,507343,Staff,28,0,30,2
1713324723489,EDS 250,A00,507344,Hemans; Patricia Ann Benitez,36,0,40,4
1713324724513,EDS 281,A00,507345,Daly; Alan J.,18,0,18,0
1713324725537,EDS 284,A00,507350,Daly; Alan J.,16,0,16,0
1713324726561,EDS 286,A00,507359,Fine; Sarah,18,0,18,0
1713324727586,EDS 289C,A01,507361,Daly; Alan J.,18,0,18,0
1713324728613,EDS 290,A00,507366,Hofstetter; Carolyn,15,0,15,0
1713324729635,LIGM 5A,A00,507421,Fischer-Grunski; Eva K,20,0,20,0
1713324730660,LIGM 5B,A00,507423,Fischer-Grunski; Eva K,20,0,20,0
1713324731685,LIGM 5C,A00,507425,Fischer-Grunski; Eva K,20,0,20,0
1713324732709,LIIT 5AS,A00,507427,Carnelos; Chiara,20,0,20,0
1713324733736,LIIT 5BS,A00,507430,Carnelos; Chiara,20,0,20,0
1713324734764,LIIT 5CS,A00,507432,Carnelos; Chiara,20,0,20,0
1713324735788,LISP 5A,A00,507541,Munoz Sanchez; Alicia,18,0,20,2
1713324736813,LISP 5B,A00,507671,Munoz Sanchez; Alicia,16,0,20,4
1713324737838,LISP 5C,A00,507696,Munoz Sanchez; Alicia,16,0,20,4
1713324738863,MAE 197,001,528363,Boechler; Nicholas Sebastia,9998,0,9999,1
1713324739892,MATH 197,001,523477,Kedlaya; Kiran S.,9999,0,9999,0
1713324739892,MATH 197,002,563811,Zhang; Danna,9999,0,9999,0
1713324740921,MCWP 40R,A00,518780,Staff,20,0,20,0
1713324740921,MCWP 40R,B00,518781,Staff,19,0,20,1
1713324740921,MCWP 40R,C00,518783,Staff,19,0,20,1
1713324741945,MCWP 50R,A00,518791,Staff,20,0,20,0
1713324741945,MCWP 50R,B00,518792,Staff,17,0,20,3
1713324741945,MCWP 50R,C00,518793,Staff,19,0,20,1
1713324741945,MCWP 50R,D00,518794,Staff,16,0,20,4
1713324741945,MCWP 50R,E00,518795,Staff,16,0,20,4
1713324741945,MCWP 50R,F00,518796,Staff,19,0,20,1
1713324741945,MCWP 50R,G00,518797,Staff,19,0,20,1
1713324742968,MMW 12R,A01,514034,Herbst; Matthew,15,0,16,1
1713324742968,MMW 12R,A02,514035,Herbst; Matthew,16,0,16,0
1713324743994,MMW 13R,A01,514037,Staff,12,0,16,4
1713324743994,MMW 13R,A02,514039,Staff,16,0,16,0
1713324746046,SIO 295LS,A00,523233,Staff,19,0,30,11
1713324747071,SIO 295S,A00,523232,Staff,19,0,30,11
1713324748097,SOCI 117,A01,494376,Staff,2,0,5,3
1713324749122,WES 237B,A00,494380,Staff,19,0,20,1
1713324751192,AESE 279B,A00,494370,Wade; Jon P,33,0,33,0
1713324752217,ANAR 135S,A00,494369,Braswell; Geoffrey E.,0,0,0,0
1713324753244,CAT 124RS,A01,519847,Geibel; William,17,0,20,3
1713324754269,CAT 125RS,A01,515971,Geibel; William,17,0,20,3
1713324755296,CLRE 250,A00,511389,Morris; Sheldon,9996,0,9999,3
1713324756325,CLRE 251,A00,507176,Mehta; Ravindra L.,9996,0,9999,3
1713324756325,CLRE 251,B00,511410,Mehta; Ravindra L.,9998,0,9999,1
1713324757350,CLRE 252,A00,507189,Cuomo; Raphael Eduardo,9998,0,9999,1
1713324758380,CLRE 253,A00,507199,Vaida; Florin,9997,0,9999,2
1713324758380,CLRE 253,B00,507202,Vaida; Florin,9999,0,9999,0
1713324759406,CLRE 259,A00,507211,Patel; Hemal,9996,0,9999,3
1713324760431,CLRE 260,A00,507221,Cuomo; Raphael Eduardo,9999,0,9999,0
1713324761457,CLRE 297,001,507242,Cuomo; Raphael Eduardo,9999,0,9999,0
1713324762481,CSE 191,A00,516875,Minnes Kemp; Mor Mia,9999,0,9999,0
1713324763510,CSS 201S,A01,494383,Staff,35,0,35,0
1713324764535,CSS 202S,A01,494387,Staff,35,0,35,0
1713324765562,EAP 100,A00,516065,Staff,9792,0,9999,207
1713324766587,ECE 45,A01,507414,Staff,52,0,60,8
1713324767611,ECE 100,A01,507416,Baghdadchi; Saharnaz,11,0,20,9
1713324767611,ECE 100,A02,507418,Baghdadchi; Saharnaz,20,0,20,0
1713324768639,ECE 111,A01,507420,Staff,39,0,50,11
1713324769663,ECE 197,001,548057,Sievenpiper; Daniel F.,9998,0,9999,1
1713324770691,EDS 115,A00,507243,Choi; Bailey Miyeon,28,0,28,0
1713324771716,EDS 117,A01,494379,Staff,23,0,25,2
1713324772740,EDS 125,A00,507246,Hopkins; Megan Beth,29,0,30,1
1713324773768,EDS 128A,A01,507264,Fargason; Sharon Gayle,26,0,26,0
1713324774795,EDS 128B,A01,507293,Pappas; Elizabeth,30,0,30,0
1713324775821,EDS 139,A00,507294,Fargason; Sharon Gayle,30,0,30,0
1713324775821,EDS 139,B00,507313,Pappas; Elizabeth,30,0,30,0
1713324776849,EDS 201,A00,507315,Staff,26,0,30,4
1713324777873,EDS 203,A01,507317,Halter; Christopher P.,26,0,30,4
1713324778907,EDS 204R,A01,507319,Halter; Christopher P.,3,0,30,27
1713324778907,EDS 204R,B01,507331,Heinzman; Erica M.,28,0,30,2
1713324779933,EDS 206R,A00,507332,Staff,4,0,30,26
1713324779933,EDS 206R,B00,507343,Staff,28,0,30,2
1713324780961,EDS 250,A00,507344,Hemans; Patricia Ann Benitez,36,0,40,4
1713324781989,EDS 281,A00,507345,Daly; Alan J.,18,0,18,0
1713324783015,EDS 284,A00,507350,Daly; Alan J.,16,0,16,0
1713324784040,EDS 286,A00,507359,Fine; Sarah,18,0,18,0
1713324785067,EDS 289C,A01,507361,Daly; Alan J.,18,0,18,0
1713324786090,EDS 290,A00,507366,Hofstetter; Carolyn,15,0,15,0
1713324787117,LIGM 5A,A00,507421,Fischer-Grunski; Eva K,20,0,20,0
1713324788141,LIGM 5B,A00,507423,Fischer-Grunski; Eva K,20,0,20,0
1713324789165,LIGM 5C,A00,507425,Fischer-Grunski; Eva K,20,0,20,0
1713324790194,LIIT 5AS,A00,507427,Carnelos; Chiara,20,0,20,0
1713324791217,LIIT 5BS,A00,507430,Carnelos; Chiara,20,0,20,0
1713324792247,LIIT 5CS,A00,507432,Carnelos; Chiara,20,0,20,0
1713324793275,LISP 5A,A00,507541,Munoz Sanchez; Alicia,17,0,20,3
1713324794303,LISP 5B,A00,507671,Munoz Sanchez; Alicia,15,0,20,5
1713324795328,LISP 5C,A00,507696,Munoz Sanchez; Alicia,15,0,20,5
1713324796352,MAE 197,001,528363,Boechler; Nicholas Sebastia,9998,0,9999,1
1713324797375,MATH 197,001,523477,Kedlaya; Kiran S.,9999,0,9999,0
1713324797375,MATH 197,002,563811,Zhang; Danna,9999,0,9999,0
1713324798403,MCWP 40R,A00,518780,Staff,20,0,20,0
1713324798403,MCWP 40R,B00,518781,Staff,19,0,20,1
1713324798403,MCWP 40R,C00,518783,Staff,19,0,20,1
1713324799429,MCWP 50R,A00,518791,Staff,20,0,20,0
1713324799429,MCWP 50R,B00,518792,Staff,17,0,20,3
1713324799429,MCWP 50R,C00,518793,Staff,19,0,20,1
1713324799429,MCWP 50R,D00,518794,Staff,16,0,20,4
1713324799429,MCWP 50R,E00,518795,Staff,16,0,20,4
1713324799429,MCWP 50R,F00,518796,Staff,19,0,20,1
1713324799429,MCWP 50R,G00,518797,Staff,19,0,20,1
1713324800457,MMW 12R,A01,514034,Herbst; Matthew,15,0,16,1
1713324800457,MMW 12R,A02,514035,Herbst; Matthew,16,0,16,0
1713324801485,MMW 13R,A01,514037,Staff,12,0,16,4
1713324801485,MMW 13R,A02,514039,Staff,16,0,16,0
1713324803537,SIO 295LS,A00,523233,Staff,19,0,30,11
1713324804561,SIO 295S,A00,523232,Staff,19,0,30,11
1713324805584,SOCI 117,A01,494376,Staff,2,0,5,3
1713324806612,WES 237B,A00,494380,Staff,19,0,20,1
1713324808664,AESE 279B,A00,494370,Wade; Jon P,33,0,33,0
1713324809689,ANAR 135S,A00,494369,Braswell; Geoffrey E.,0,0,0,0
1713324810714,CAT 124RS,A01,519847,Geibel; William,17,0,20,3
1713324811738,CAT 125RS,A01,515971,Geibel; William,17,0,20,3
1713324812761,CLRE 250,A00,511389,Morris; Sheldon,9996,0,9999,3
1713324813788,CLRE 251,A00,507176,Mehta; Ravindra L.,9996,0,9999,3
1713324813788,CLRE 251,B00,511410,Mehta; Ravindra L.,9998,0,9999,1
1713324814812,CLRE 252,A00,507189,Cuomo; Raphael Eduardo,9998,0,9999,1
1713324815839,CLRE 253,A00,507199,Vaida; Florin,9997,0,9999,2
1713324815839,CLRE 253,B00,507202,Vaida; Florin,9999,0,9999,0
1713324816863,CLRE 259,A00,507211,Patel; Hemal,9996,0,9999,3
1713324817890,CLRE 260,A00,507221,Cuomo; Raphael Eduardo,9999,0,9999,0
1713324818968,CLRE 297,001,507242,Cuomo; Raphael Eduardo,9999,0,9999,0
1713324819993,CSE 191,A00,516875,Minnes Kemp; Mor Mia,9999,0,9999,0
1713324821021,CSS 201S,A01,494383,Staff,35,0,35,0
1713324822051,CSS 202S,A01,494387,Staff,35,0,35,0
1713324823076,EAP 100,A00,516065,Staff,9792,0,9999,207
1713324824104,ECE 45,A01,507414,Staff,52,0,60,8
1713324825129,ECE 100,A01,507416,Baghdadchi; Saharnaz,11,0,20,9
1713324825129,ECE 100,A02,507418,Baghdadchi; Saharnaz,20,0,20,0
1713324826154,ECE 111,A01,507420,Staff,39,0,50,11
1713324827179,ECE 197,001,548057,Sievenpiper; Daniel F.,9998,0,9999,1
1713324828203,EDS 115,A00,507243,Choi; Bailey Miyeon,28,0,28,0
1713324829231,EDS 117,A01,494379,Staff,23,0,25,2
1713324830258,EDS 125,A00,507246,Hopkins; Megan Beth,29,0,30,1
1713324831281,EDS 128A,A01,507264,Fargason; Sharon Gayle,26,0,26,0
1713324832306,EDS 128B,A01,507293,Pappas; Elizabeth,30,0,30,0
1713324833331,EDS 139,A00,507294,Fargason; Sharon Gayle,30,0,30,0
1713324833331,EDS 139,B00,507313,Pappas; Elizabeth,30,0,30,0
1713324834359,EDS 201,A00,507315,Staff,26,0,30,4
1713324835385,EDS 203,A01,507317,Halter; Christopher P.,26,0,30,4
1713324836412,EDS 204R,A01,507319,Halter; Christopher P.,3,0,30,27
1713324836412,EDS 204R,B01,507331,Heinzman; Erica M.,28,0,30,2
1713324837438,EDS 206R,A00,507332,Staff,4,0,30,26
1713324837438,EDS 206R,B00,507343,Staff,28,0,30,2
1713324838466,EDS 250,A00,507344,Hemans; Patricia Ann Benitez,36,0,40,4
1713324839493,EDS 281,A00,507345,Daly; Alan J.,18,0,18,0
1713324840518,EDS 284,A00,507350,Daly; Alan J.,16,0,16,0
1713324841545,EDS 286,A00,507359,Fine; Sarah,18,0,18,0
1713324842573,EDS 289C,A01,507361,Daly; Alan J.,18,0,18,0
1713324843596,EDS 290,A00,507366,Hofstetter; Carolyn,15,0,15,0
1713324844621,LIGM 5A,A00,507421,Fischer-Grunski; Eva K,20,0,20,0
1713324845650,LIGM 5B,A00,507423,Fischer-Grunski; Eva K,20,0,20,0
1713324846677,LIGM 5C,A00,507425,Fischer-Grunski; Eva K,20,0,20,0
1713324847701,LIIT 5AS,A00,507427,Carnelos; Chiara,20,0,20,0
1713324848725,LIIT 5BS,A00,507430,Carnelos; Chiara,20,0,20,0
1713324849751,LIIT 5CS,A00,507432,Carnelos; Chiara,20,0,20,0
1713324850775,LISP 5A,A00,507541,Munoz Sanchez; Alicia,17,0,20,3
1713324851800,LISP 5B,A00,507671,Munoz Sanchez; Alicia,15,0,20,5
1713324852823,LISP 5C,A00,507696,Munoz Sanchez; Alicia,15,0,20,5
1713324853846,MAE 197,001,528363,Boechler; Nicholas Sebastia,9998,0,9999,1
1713324854877,MATH 197,001,523477,Kedlaya; Kiran S.,9999,0,9999,0
1713324854877,MATH 197,002,563811,Zhang; Danna,9999,0,9999,0
1713324855905,MCWP 40R,A00,518780,Staff,20,0,20,0
1713324855905,MCWP 40R,B00,518781,Staff,19,0,20,1
1713324855905,MCWP 40R,C00,518783,Staff,19,0,20,1
1713324856934,MCWP 50R,A00,518791,Staff,20,0,20,0
1713324856934,MCWP 50R,B00,518792,Staff,17,0,20,3
1713324856934,MCWP 50R,C00,518793,Staff,19,0,20,1
1713324856934,MCWP 50R,D00,518794,Staff,16,0,20,4
1713324856934,MCWP 50R,E00,518795,Staff,16,0,20,4
1713324856934,MCWP 50R,F00,518796,Staff,19,0,20,1
1713324856934,MCWP 50R,G00,518797,Staff,19,0,20,1
1713324857962,MMW 12R,A01,514034,Herbst; Matthew,15,0,16,1
1713324857962,MMW 12R,A02,514035,Herbst; Matthew,16,0,16,0
1713324858986,MMW 13R,A01,514037,Staff,12,0,16,4
1713324858986,MMW 13R,A02,514039,Staff,16,0,16,0
1713324861038,SIO 295LS,A00,523233,Staff,19,0,30,11
1713324862063,SIO 295S,A00,523232,Staff,19,0,30,11
1713324863090,SOCI 117,A01,494376,Staff,2,0,5,3
1713324864114,WES 237B,A00,494380,Staff,19,0,20,1
1713324866168,AESE 279B,A00,494370,Wade; Jon P,33,0,33,0
1713324867192,ANAR 135S,A00,494369,Braswell; Geoffrey E.,0,0,0,0
1713324868218,CAT 124RS,A01,519847,Geibel; William,17,0,20,3
1713324869242,CAT 125RS,A01,515971,Geibel; William,17,0,20,3
1713324870266,CLRE 250,A00,511389,Morris; Sheldon,9996,0,9999,3
1713324871292,CLRE 251,A00,507176,Mehta; Ravindra L.,9996,0,9999,3
1713324871292,CLRE 251,B00,511410,Mehta; Ravindra L.,9998,0,9999,1
1713324872319,CLRE 252,A00,507189,Cuomo; Raphael Eduardo,9998,0,9999,1
1713324873345,CLRE 253,A00,507199,Vaida; Florin,9997,0,9999,2
1713324873345,CLRE 253,B00,507202,Vaida; Florin,9999,0,9999,0
1713324874371,CLRE 259,A00,507211,Patel; Hemal,9996,0,9999,3
1713324875395,CLRE 260,A00,507221,Cuomo; Raphael Eduardo,9999,0,9999,0
1713324876419,CLRE 297,001,507242,Cuomo; Raphael Eduardo,9999,0,9999,0
1713324877446,CSE 191,A00,516875,Minnes Kemp; Mor Mia,9999,0,9999,0
1713324878470,CSS 201S,A01,494383,Staff,35,0,35,0
1713324879495,CSS 202S,A01,494387,Staff,35,0,35,0
1713324880521,EAP 100,A00,516065,Staff,9792,0,9999,207
1713324881546,ECE 45,A01,507414,Staff,52,0,60,8
1713324882571,ECE 100,A01,507416,Baghdadchi; Saharnaz,11,0,20,9
1713324882571,ECE 100,A02,507418,Baghdadchi; Saharnaz,20,0,20,0
1713324883595,ECE 111,A01,507420,Staff,39,0,50,11
1713324884619,ECE 197,001,548057,Sievenpiper; Daniel F.,9998,0,9999,1
1713324885647,EDS 115,A00,507243,Choi; Bailey Miyeon,28,0,28,0
1713324886674,EDS 117,A01,494379,Staff,23,0,25,2
1713324887702,EDS 125,A00,507246,Hopkins; Megan Beth,29,0,30,1
1713324888731,EDS 128A,A01,507264,Fargason; Sharon Gayle,26,0,26,0
1713324889756,EDS 128B,A01,507293,Pappas; Elizabeth,30,0,30,0
1713324890781,EDS 139,A00,507294,Fargason; Sharon Gayle,30,0,30,0
1713324890781,EDS 139,B00,507313,Pappas; Elizabeth,30,0,30,0
1713324891808,EDS 201,A00,507315,Staff,26,0,30,4
1713324892833,EDS 203,A01,507317,Halter; Christopher P.,26,0,30,4
1713324893862,EDS 204R,A01,507319,Halter; Christopher P.,3,0,30,27
1713324893862,EDS 204R,B01,507331,Heinzman; Erica M.,28,0,30,2
1713324894886,EDS 206R,A00,507332,Staff,4,0,30,26
1713324894886,EDS 206R,B00,507343,Staff,28,0,30,2
1713324895911,EDS 250,A00,507344,Hemans; Patricia Ann Benitez,36,0,40,4
1713324896938,EDS 281,A00,507345,Daly; Alan J.,18,0,18,0
1713324897963,EDS 284,A00,507350,Daly; Alan J.,16,0,16,0
1713324898990,EDS 286,A00,507359,Fine; Sarah,18,0,18,0
1713324900018,EDS 289C,A01,507361,Daly; Alan J.,18,0,18,0
1713324901045,EDS 290,A00,507366,Hofstetter; Carolyn,15,0,15,0
1713324902070,LIGM 5A,A00,507421,Fischer-Grunski; Eva K,20,0,20,0
1713324903095,LIGM 5B,A00,507423,Fischer-Grunski; Eva K,20,0,20,0
1713324904122,LIGM 5C,A00,507425,Fischer-Grunski; Eva K,20,0,20,0
1713324905146,LIIT 5AS,A00,507427,Carnelos; Chiara,20,0,20,0
1713324906173,LIIT 5BS,A00,507430,Carnelos; Chiara,20,0,20,0
1713324907198,LIIT 5CS,A00,507432,Carnelos; Chiara,20,0,20,0
1713324908223,LISP 5A,A00,507541,Munoz Sanchez; Alicia,17,0,20,3
1713324909248,LISP 5B,A00,507671,Munoz Sanchez; Alicia,15,0,20,5
1713324910277,LISP 5C,A00,507696,Munoz Sanchez; Alicia,15,0,20,5
1713324911302,MAE 197,001,528363,Boechler; Nicholas Sebastia,9998,0,9999,1
1713324912326,MATH 197,001,523477,Kedlaya; Kiran S.,9999,0,9999,0
1713324912326,MATH 197,002,563811,Zhang; Danna,9999,0,9999,0
1713324913350,MCWP 40R,A00,518780,Staff,20,0,20,0
1713324913350,MCWP 40R,B00,518781,Staff,19,0,20,1
1713324913350,MCWP 40R,C00,518783,Staff,19,0,20,1
1713324914378,MCWP 50R,A00,518791,Staff,20,0,20,0
1713324914378,MCWP 50R,B00,518792,Staff,17,0,20,3
1713324914378,MCWP 50R,C00,518793,Staff,19,0,20,1
1713324914378,MCWP 50R,D00,518794,Staff,16,0,20,4
1713324914378,MCWP 50R,E00,518795,Staff,16,0,20,4
1713324914378,MCWP 50R,F00,518796,Staff,19,0,20,1
1713324914378,MCWP 50R,G00,518797,Staff,19,0,20,1
1713324915407,MMW 12R,A01,514034,Herbst; Matthew,15,0,16,1
1713324915407,MMW 12R,A02,514035,Herbst; Matthew,16,0,16,0
1713324916433,MMW 13R,A01,514037,Staff,12,0,16,4
1713324916433,MMW 13R,A02,514039,Staff,16,0,16,0
1713324918484,SIO 295LS,A00,523233,Staff,19,0,30,11
1713324919512,SIO 295S,A00,523232,Staff,19,0,30,11
1713324920536,SOCI 117,A01,494376,Staff,2,0,5,3
1713324921560,WES 237B,A00,494380,Staff,19,0,20,1
1713324923681,AESE 279B,A00,494370,Wade; Jon P,33,0,33,0
1713324924704,ANAR 135S,A00,494369,Braswell; Geoffrey E.,0,0,0,0
1713324925729,CAT 124RS,A01,519847,Geibel; William,17,0,20,3
1713324926752,CAT 125RS,A01,515971,Geibel; William,17,0,20,3
1713324927780,CLRE 250,A00,511389,Morris; Sheldon,9996,0,9999,3
1713324928806,CLRE 251,A00,507176,Mehta; Ravindra L.,9996,0,9999,3
1713324928806,CLRE 251,B00,511410,Mehta; Ravindra L.,9998,0,9999,1
1713324929831,CLRE 252,A00,507189,Cuomo; Raphael Eduardo,9998,0,9999,1
1713324930855,CLRE 253,A00,507199,Vaida; Florin,9997,0,9999,2
1713324930855,CLRE 253,B00,507202,Vaida; Florin,9999,0,9999,0
1713324931884,CLRE 259,A00,507211,Patel; Hemal,9996,0,9999,3
1713324932909,CLRE 260,A00,507221,Cuomo; Raphael Eduardo,9999,0,9999,0
1713324933937,CLRE 297,001,507242,Cuomo; Raphael Eduardo,9999,0,9999,0
1713324934963,CSE 191,A00,516875,Minnes Kemp; Mor Mia,9999,0,9999,0
1713324935988,CSS 201S,A01,494383,Staff,35,0,35,0
1713324937015,CSS 202S,A01,494387,Staff,35,0,35,0
1713324938040,EAP 100,A00,516065,Staff,9792,0,9999,207
1713324939064,ECE 45,A01,507414,Staff,52,0,60,8
1713324940088,ECE 100,A01,507416,Baghdadchi; Saharnaz,11,0,20,9
1713324940088,ECE 100,A02,507418,Baghdadchi; Saharnaz,20,0,20,0
1713324941115,ECE 111,A01,507420,Staff,39,0,50,11
1713324942141,ECE 197,001,548057,Sievenpiper; Daniel F.,9998,0,9999,1
1713324943166,EDS 115,A00,507243,Choi; Bailey Miyeon,28,0,28,0
1713324944195,EDS 117,A01,494379,Staff,23,0,25,2
1713324945223,EDS 125,A00,507246,Hopkins; Megan Beth,29,0,30,1
1713324946247,EDS 128A,A01,507264,Fargason; Sharon Gayle,26,0,26,0
1713324947275,EDS 128B,A01,507293,Pappas; Elizabeth,30,0,30,0
1713324948299,EDS 139,A00,507294,Fargason; Sharon Gayle,30,0,30,0
1713324948299,EDS 139,B00,507313,Pappas; Elizabeth,30,0,30,0
1713324949323,EDS 201,A00,507315,Staff,26,0,30,4
1713324950352,EDS 203,A01,507317,Halter; Christopher P.,26,0,30,4
1713324951380,EDS 204R,A01,507319,Halter; Christopher P.,3,0,30,27
1713324951380,EDS 204R,B01,507331,Heinzman; Erica M.,28,0,30,2
1713324952409,EDS 206R,A00,507332,Staff,4,0,30,26
1713324952409,EDS 206R,B00,507343,Staff,28,0,30,2
1713324953434,EDS 250,A00,507344,Hemans; Patricia Ann Benitez,36,0,40,4
1713324954458,EDS 281,A00,507345,Daly; Alan J.,18,0,18,0
1713324955485,EDS 284,A00,507350,Daly; Alan J.,16,0,16,0
1713324956512,EDS 286,A00,507359,Fine; Sarah,18,0,18,0
1713324957536,EDS 289C,A01,507361,Daly; Alan J.,18,0,18,0
1713324958560,EDS 290,A00,507366,Hofstetter; Carolyn,15,0,15,0
1713324959586,LIGM 5A,A00,507421,Fischer-Grunski; Eva K,20,0,20,0
1713324960611,LIGM 5B,A00,507423,Fischer-Grunski; Eva K,20,0,20,0
1713324961636,LIGM 5C,A00,507425,Fischer-Grunski; Eva K,20,0,20,0
1713324962664,LIIT 5AS,A00,507427,Carnelos; Chiara,20,0,20,0
1713324963693,LIIT 5BS,A00,507430,Carnelos; Chiara,20,0,20,0
1713324964721,LIIT 5CS,A00,507432,Carnelos; Chiara,20,0,20,0
1713324965746,LISP 5A,A00,507541,Munoz Sanchez; Alicia,17,0,20,3
1713324966769,LISP 5B,A00,507671,Munoz Sanchez; Alicia,15,0,20,5
1713324967794,LISP 5C,A00,507696,Munoz Sanchez; Alicia,15,0,20,5
1713324968823,MAE 197,001,528363,Boechler; Nicholas Sebastia,9998,0,9999,1
1713324969851,MATH 197,001,523477,Kedlaya; Kiran S.,9999,0,9999,0
1713324969851,MATH 197,002,563811,Zhang; Danna,9999,0,9999,0
1713324970876,MCWP 40R,A00,518780,Staff,20,0,20,0
1713324970876,MCWP 40R,B00,518781,Staff,19,0,20,1
1713324970876,MCWP 40R,C00,518783,Staff,19,0,20,1
1713324971907,MCWP 50R,A00,518791,Staff,20,0,20,0
1713324971907,MCWP 50R,B00,518792,Staff,17,0,20,3
1713324971907,MCWP 50R,C00,518793,Staff,19,0,20,1
1713324971907,MCWP 50R,D00,518794,Staff,16,0,20,4
1713324971907,MCWP 50R,E00,518795,Staff,16,0,20,4
1713324971907,MCWP 50R,F00,518796,Staff,19,0,20,1
1713324971907,MCWP 50R,G00,518797,Staff,19,0,20,1
1713324972933,MMW 12R,A01,514034,Herbst; Matthew,15,0,16,1
1713324972933,MMW 12R,A02,514035,Herbst; Matthew,16,0,16,0
1713324973957,MMW 13R,A01,514037,Staff,12,0,16,4
1713324973957,MMW 13R,A02,514039,Staff,16,0,16,0
1713324976008,SIO 295LS,A00,523233,Staff,19,0,30,11
1713324977033,SIO 295S,A00,523232,Staff,19,0,30,11
1713324978058,SOCI 117,A01,494376,Staff,2,0,5,3
1713324979082,WES 237B,A00,494380,Staff,19,0,20,1
1713324981149,AESE 279B,A00,494370,Wade; Jon P,33,0,33,0
1713324982174,ANAR 135S,A00,494369,Braswell; Geoffrey E.,0,0,0,0
1713324983198,CAT 124RS,A01,519847,Geibel; William,17,0,20,3
1713324984224,CAT 125RS,A01,515971,Geibel; William,17,0,20,3
1713324985249,CLRE 250,A00,511389,Morris; Sheldon,9996,0,9999,3
1713324986278,CLRE 251,A00,507176,Mehta; Ravindra L.,9996,0,9999,3
1713324986278,CLRE 251,B00,511410,Mehta; Ravindra L.,9998,0,9999,1
1713324987303,CLRE 252,A00,507189,Cuomo; Raphael Eduardo,9998,0,9999,1
1713324988328,CLRE 253,A00,507199,Vaida; Florin,9997,0,9999,2
1713324988328,CLRE 253,B00,507202,Vaida; Florin,9999,0,9999,0
1713324989356,CLRE 259,A00,507211,Patel; Hemal,9996,0,9999,3
1713324990380,CLRE 260,A00,507221,Cuomo; Raphael Eduardo,9999,0,9999,0
1713324991410,CLRE 297,001,507242,Cuomo; Raphael Eduardo,9999,0,9999,0
1713324992439,CSE 191,A00,516875,Minnes Kemp; Mor Mia,9999,0,9999,0
1713324993464,CSS 201S,A01,494383,Staff,35,0,35,0
1713324994490,CSS 202S,A01,494387,Staff,35,0,35,0
1713324995516,EAP 100,A00,516065,Staff,9792,0,9999,207
1713324996543,ECE 45,A01,507414,Staff,52,0,60,8
1713324997570,ECE 100,A01,507416,Baghdadchi; Saharnaz,11,0,20,9
1713324997570,ECE 100,A02,507418,Baghdadchi; Saharnaz,20,0,20,0
1713324998597,ECE 111,A01,507420,Staff,39,0,50,11
1713324999624,ECE 197,001,548057,Sievenpiper; Daniel F.,9998,0,9999,1
1713325000650,EDS 115,A00,507243,Choi; Bailey Miyeon,28,0,28,0
1713325001678,EDS 117,A01,494379,Staff,23,0,25,2
1713325002703,EDS 125,A00,507246,Hopkins; Megan Beth,29,0,30,1
1713325003727,EDS 128A,A01,507264,Fargason; Sharon Gayle,26,0,26,0
1713325004751,EDS 128B,A01,507293,Pappas; Elizabeth,30,0,30,0
1713325005779,EDS 139,A00,507294,Fargason; Sharon Gayle,30,0,30,0
1713325005779,EDS 139,B00,507313,Pappas; Elizabeth,30,0,30,0
1713325006804,EDS 201,A00,507315,Staff,26,0,30,4
1713325007832,EDS 203,A01,507317,Halter; Christopher P.,26,0,30,4
1713325008856,EDS 204R,A01,507319,Halter; Christopher P.,3,0,30,27
1713325008856,EDS 204R,B01,507331,Heinzman; Erica M.,28,0,30,2
1713325009883,EDS 206R,A00,507332,Staff,4,0,30,26
1713325009883,EDS 206R,B00,507343,Staff,28,0,30,2
1713325010906,EDS 250,A00,507344,Hemans; Patricia Ann Benitez,36,0,40,4
1713325011933,EDS 281,A00,507345,Daly; Alan J.,18,0,18,0
1713325012956,EDS 284,A00,507350,Daly; Alan J.,16,0,16,0
1713325013985,EDS 286,A00,507359,Fine; Sarah,18,0,18,0
1713325015011,EDS 289C,A01,507361,Daly; Alan J.,18,0,18,0
1713325016034,EDS 290,A00,507366,Hofstetter; Carolyn,15,0,15,0
1713325017064,LIGM 5A,A00,507421,Fischer-Grunski; Eva K,20,0,20,0
1713325018091,LIGM 5B,A00,507423,Fischer-Grunski; Eva K,20,0,20,0
1713325019115,LIGM 5C,A00,507425,Fischer-Grunski; Eva K,20,0,20,0
1713325020141,LIIT 5AS,A00,507427,Carnelos; Chiara,20,0,20,0
1713325021170,LIIT 5BS,A00,507430,Carnelos; Chiara,20,0,20,0
1713325022197,LIIT 5CS,A00,507432,Carnelos; Chiara,20,0,20,0
1713325023225,LISP 5A,A00,507541,Munoz Sanchez; Alicia,17,0,20,3
1713325024253,LISP 5B,A00,507671,Munoz Sanchez; Alicia,15,0,20,5
1713325025281,LISP 5C,A00,507696,Munoz Sanchez; Alicia,15,0,20,5
1713325026379,MAE 197,001,528363,Boechler; Nicholas Sebastia,9998,0,9999,1
1713325027407,MATH 197,001,523477,Kedlaya; Kiran S.,9999,0,9999,0
1713325027407,MATH 197,002,563811,Zhang; Danna,9999,0,9999,0
1713325028434,MCWP 40R,A00,518780,Staff,20,0,20,0
1713325028434,MCWP 40R,B00,518781,Staff,19,0,20,1
1713325028434,MCWP 40R,C00,518783,Staff,19,0,20,1
1713325029462,MCWP 50R,A00,518791,Staff,20,0,20,0
1713325029462,MCWP 50R,B00,518792,Staff,17,0,20,3
1713325029462,MCWP 50R,C00,518793,Staff,19,0,20,1
1713325029462,MCWP 50R,D00,518794,Staff,16,0,20,4
1713325029462,MCWP 50R,E00,518795,Staff,16,0,20,4
1713325029462,MCWP 50R,F00,518796,Staff,19,0,20,1
1713325029462,MCWP 50R,G00,518797,Staff,19,0,20,1
1713325030487,MMW 12R,A01,514034,Herbst; Matthew,15,0,16,1
1713325030487,MMW 12R,A02,514035,Herbst; Matthew,16,0,16,0
1713325031511,MMW 13R,A01,514037,Staff,12,0,16,4
1713325031511,MMW 13R,A02,514039,Staff,16,0,16,0
1713325033568,SIO 295LS,A00,523233,Staff,19,0,30,11
1713325034593,SIO 295S,A00,523232,Staff,19,0,30,11
1713325035621,SOCI 117,A01,494376,Staff,2,0,5,3
1713325036646,WES 237B,A00,494380,Staff,19,0,20,1
1713325038700,AESE 279B,A00,494370,Wade; Jon P,33,0,33,0
1713325039723,ANAR 135S,A00,494369,Braswell; Geoffrey E.,0,0,0,0
1713325040748,CAT 124RS,A01,519847,Geibel; William,17,0,20,3
1713325041772,CAT 125RS,A01,515971,Geibel; William,17,0,20,3
1713325042801,CLRE 250,A00,511389,Morris; Sheldon,9996,0,9999,3
1713325043828,CLRE 251,A00,507176,Mehta; Ravindra L.,9996,0,9999,3
1713325043828,CLRE 251,B00,511410,Mehta; Ravindra L.,9998,0,9999,1
1713325044854,CLRE 252,A00,507189,Cuomo; Raphael Eduardo,9998,0,9999,1
1713325045883,CLRE 253,A00,507199,Vaida; Florin,9997,0,9999,2
1713325045883,CLRE 253,B00,507202,Vaida; Florin,9999,0,9999,0
1713325046908,CLRE 259,A00,507211,Patel; Hemal,9996,0,9999,3
1713325047932,CLRE 260,A00,507221,Cuomo; Raphael Eduardo,9999,0,9999,0
1713325048960,CLRE 297,001,507242,Cuomo; Raphael Eduardo,9999,0,9999,0
1713325049982,CSE 191,A00,516875,Minnes Kemp; Mor Mia,9999,0,9999,0
1713325051007,CSS 201S,A01,494383,Staff,35,0,35,0
1713325052033,CSS 202S,A01,494387,Staff,35,0,35,0
1713325053056,EAP 100,A00,516065,Staff,9792,0,9999,207
1713325054080,ECE 45,A01,507414,Staff,52,0,60,8
1713325055106,ECE 100,A01,507416,Baghdadchi; Saharnaz,11,0,20,9
1713325055106,ECE 100,A02,507418,Baghdadchi; Saharnaz,20,0,20,0
1713325056131,ECE 111,A01,507420,Staff,39,0,50,11
1713325057155,ECE 197,001,548057,Sievenpiper; Daniel F.,9998,0,9999,1
1713325058179,EDS 115,A00,507243,Choi; Bailey Miyeon,28,0,28,0
1713325059206,EDS 117,A01,494379,Staff,23,0,25,2
1713325060231,EDS 125,A00,507246,Hopkins; Megan Beth,29,0,30,1
1713325061255,EDS 128A,A01,507264,Fargason; Sharon Gayle,26,0,26,0
1713325062283,EDS 128B,A01,507293,Pappas; Elizabeth,30,0,30,0
1713325063311,EDS 139,A00,507294,Fargason; Sharon Gayle,30,0,30,0
1713325063311,EDS 139,B00,507313,Pappas; Elizabeth,30,0,30,0
1713325064334,EDS 201,A00,507315,Staff,26,0,30,4
1713325065359,EDS 203,A01,507317,Halter; Christopher P.,26,0,30,4
1713325066383,EDS 204R,A01,507319,Halter; Christopher P.,3,0,30,27
1713325066383,EDS 204R,B01,507331,Heinzman; Erica M.,28,0,30,2
1713325067409,EDS 206R,A00,507332,Staff,4,0,30,26
1713325067409,EDS 206R,B00,507343,Staff,28,0,30,2
1713325068433,EDS 250,A00,507344,Hemans; Patricia Ann Benitez,36,0,40,4
1713325069459,EDS 281,A00,507345,Daly; Alan J.,18,0,18,0
1713325070486,EDS 284,A00,507350,Daly; Alan J.,16,0,16,0
1713325071511,EDS 286,A00,507359,Fine; Sarah,18,0,18,0
1713325072536,EDS 289C,A01,507361,Daly; Alan J.,18,0,18,0
1713325073561,EDS 290,A00,507366,Hofstetter; Carolyn,15,0,15,0
1713325074587,LIGM 5A,A00,507421,Fischer-Grunski; Eva K,20,0,20,0
1713325075612,LIGM 5B,A00,507423,Fischer-Grunski; Eva K,20,0,20,0
1713325076637,LIGM 5C,A00,507425,Fischer-Grunski; Eva K,20,0,20,0
1713325077663,LIIT 5AS,A00,507427,Carnelos; Chiara,20,0,20,0
1713325078687,LIIT 5BS,A00,507430,Carnelos; Chiara,20,0,20,0
1713325079712,LIIT 5CS,A00,507432,Carnelos; Chiara,20,0,20,0
1713325080741,LISP 5A,A00,507541,Munoz Sanchez; Alicia,17,0,20,3
1713325081766,LISP 5B,A00,507671,Munoz Sanchez; Alicia,15,0,20,5
1713325082791,LISP 5C,A00,507696,Munoz Sanchez; Alicia,15,0,20,5
1713325083816,MAE 197,001,528363,Boechler; Nicholas Sebastia,9998,0,9999,1
1713325084841,MATH 197,001,523477,Kedlaya; Kiran S.,9999,0,9999,0
1713325084841,MATH 197,002,563811,Zhang; Danna,9999,0,9999,0
1713325085867,MCWP 40R,A00,518780,Staff,20,0,20,0
1713325085867,MCWP 40R,B00,518781,Staff,19,0,20,1
1713325085867,MCWP 40R,C00,518783,Staff,19,0,20,1
1713325086891,MCWP 50R,A00,518791,Staff,20,0,20,0
1713325086891,MCWP 50R,B00,518792,Staff,17,0,20,3
1713325086891,MCWP 50R,C00,518793,Staff,19,0,20,1
1713325086891,MCWP 50R,D00,518794,Staff,16,0,20,4
1713325086891,MCWP 50R,E00,518795,Staff,16,0,20,4
1713325086891,MCWP 50R,F00,518796,Staff,19,0,20,1
1713325086891,MCWP 50R,G00,518797,Staff,19,0,20,1
1713325087917,MMW 12R,A01,514034,Herbst; Matthew,15,0,16,1
1713325087917,MMW 12R,A02,514035,Herbst; Matthew,16,0,16,0
1713325088943,MMW 13R,A01,514037,Staff,12,0,16,4
1713325088943,MMW 13R,A02,514039,Staff,16,0,16,0
1713325090997,SIO 295LS,A00,523233,Staff,19,0,30,11
1713325092030,SIO 295S,A00,523232,Staff,19,0,30,11
1713325093057,SOCI 117,A01,494376,Staff,2,0,5,3
1713325094084,WES 237B,A00,494380,Staff,19,0,20,1
1713325096148,AESE 279B,A00,494370,Wade; Jon P,33,0,33,0
1713325097174,ANAR 135S,A00,494369,Braswell; Geoffrey E.,0,0,0,0
1713325098198,CAT 124RS,A01,519847,Geibel; William,17,0,20,3
1713325099223,CAT 125RS,A01,515971,Geibel; William,17,0,20,3
1713325100248,CLRE 250,A00,511389,Morris; Sheldon,9996,0,9999,3
1713325101273,CLRE 251,A00,507176,Mehta; Ravindra L.,9996,0,9999,3
1713325101273,CLRE 251,B00,511410,Mehta; Ravindra L.,9998,0,9999,1
1713325102297,CLRE 252,A00,507189,Cuomo; Raphael Eduardo,9998,0,9999,1
1713325103321,CLRE 253,A00,507199,Vaida; Florin,9997,0,9999,2
1713325103321,CLRE 253,B00,507202,Vaida; Florin,9999,0,9999,0
1713325104346,CLRE 259,A00,507211,Patel; Hemal,9996,0,9999,3
1713325105371,CLRE 260,A00,507221,Cuomo; Raphael Eduardo,9999,0,9999,0
1713325106394,CLRE 297,001,507242,Cuomo; Raphael Eduardo,9999,0,9999,0
1713325107417,CSE 191,A00,516875,Minnes Kemp; Mor Mia,9999,0,9999,0
1713325108445,CSS 201S,A01,494383,Staff,35,0,35,0
1713325109471,CSS 202S,A01,494387,Staff,35,0,35,0
1713325110494,EAP 100,A00,516065,Staff,9792,0,9999,207
1713325111519,ECE 45,A01,507414,Staff,52,0,60,8
1713325112544,ECE 100,A01,507416,Baghdadchi; Saharnaz,11,0,20,9
1713325112544,ECE 100,A02,507418,Baghdadchi; Saharnaz,20,0,20,0
1713325113568,ECE 111,A01,507420,Staff,39,0,50,11
1713325114593,ECE 197,001,548057,Sievenpiper; Daniel F.,9998,0,9999,1
1713325115618,EDS 115,A00,507243,Choi; Bailey Miyeon,28,0,28,0
1713325116643,EDS 117,A01,494379,Staff,23,0,25,2
1713325117671,EDS 125,A00,507246,Hopkins; Megan Beth,29,0,30,1
1713325118698,EDS 128A,A01,507264,Fargason; Sharon Gayle,26,0,26,0
1713325119724,EDS 128B,A01,507293,Pappas; Elizabeth,30,0,30,0
1713325120749,EDS 139,A00,507294,Fargason; Sharon Gayle,30,0,30,0
1713325120749,EDS 139,B00,507313,Pappas; Elizabeth,30,0,30,0
1713325121776,EDS 201,A00,507315,Staff,26,0,30,4
1713325122801,EDS 203,A01,507317,Halter; Christopher P.,26,0,30,4
1713325123828,EDS 204R,A01,507319,Halter; Christopher P.,3,0,30,27
1713325123828,EDS 204R,B01,507331,Heinzman; Erica M.,28,0,30,2
1713325124856,EDS 206R,A00,507332,Staff,4,0,30,26
1713325124856,EDS 206R,B00,507343,Staff,28,0,30,2
1713325125881,EDS 250,A00,507344,Hemans; Patricia Ann Benitez,36,0,40,4
1713325126905,EDS 281,A00,507345,Daly; Alan J.,18,0,18,0
1713325127929,EDS 284,A00,507350,Daly; Alan J.,16,0,16,0
1713325128958,EDS 286,A00,507359,Fine; Sarah,18,0,18,0
1713325130036,EDS 289C,A01,507361,Daly; Alan J.,18,0,18,0
1713325131061,EDS 290,A00,507366,Hofstetter; Carolyn,15,0,15,0
1713325132090,LIGM 5A,A00,507421,Fischer-Grunski; Eva K,20,0,20,0
1713325133116,LIGM 5B,A00,507423,Fischer-Grunski; Eva K,20,0,20,0
1713325134140,LIGM 5C,A00,507425,Fischer-Grunski; Eva K,20,0,20,0
1713325135166,LIIT 5AS,A00,507427,Carnelos; Chiara,20,0,20,0
1713325136194,LIIT 5BS,A00,507430,Carnelos; Chiara,20,0,20,0
1713325137219,LIIT 5CS,A00,507432,Carnelos; Chiara,20,0,20,0
1713325138244,LISP 5A,A00,507541,Munoz Sanchez; Alicia,17,0,20,3
1713325139269,LISP 5B,A00,507671,Munoz Sanchez; Alicia,15,0,20,5
1713325140295,LISP 5C,A00,507696,Munoz Sanchez; Alicia,15,0,20,5
1713325141320,MAE 197,001,528363,Boechler; Nicholas Sebastia,9998,0,9999,1
1713325142345,MATH 197,001,523477,Kedlaya; Kiran S.,9999,0,9999,0
1713325142345,MATH 197,002,563811,Zhang; Danna,9999,0,9999,0
1713325143370,MCWP 40R,A00,518780,Staff,20,0,20,0
1713325143370,MCWP 40R,B00,518781,Staff,19,0,20,1
1713325143370,MCWP 40R,C00,518783,Staff,19,0,20,1
1713325144395,MCWP 50R,A00,518791,Staff,20,0,20,0
1713325144395,MCWP 50R,B00,518792,Staff,17,0,20,3
1713325144395,MCWP 50R,C00,518793,Staff,19,0,20,1
1713325144395,MCWP 50R,D00,518794,Staff,16,0,20,4
1713325144395,MCWP 50R,E00,518795,Staff,16,0,20,4
1713325144395,MCWP 50R,F00,518796,Staff,19,0,20,1
1713325144395,MCWP 50R,G00,518797,Staff,19,0,20,1
1713325145422,MMW 12R,A01,514034,Herbst; Matthew,15,0,16,1
1713325145422,MMW 12R,A02,514035,Herbst; Matthew,16,0,16,0
1713325146446,MMW 13R,A01,514037,Staff,12,0,16,4
1713325146446,MMW 13R,A02,514039,Staff,16,0,16,0
1713325148498,SIO 295LS,A00,523233,Staff,19,0,30,11
1713325149522,SIO 295S,A00,523232,Staff,19,0,30,11
1713325150549,SOCI 117,A01,494376,Staff,2,0,5,3
1713325151572,WES 237B,A00,494380,Staff,19,0,20,1
1713325153629,AESE 279B,A00,494370,Wade; Jon P,33,0,33,0
1713325154656,ANAR 135S,A00,494369,Braswell; Geoffrey E.,0,0,0,0
1713325155681,CAT 124RS,A01,519847,Geibel; William,17,0,20,3
1713325156706,CAT 125RS,A01,515971,Geibel; William,17,0,20,3
1713325157730,CLRE 250,A00,511389,Morris; Sheldon,9996,0,9999,3
1713325158755,CLRE 251,A00,507176,Mehta; Ravindra L.,9996,0,9999,3
1713325158755,CLRE 251,B00,511410,Mehta; Ravindra L.,9998,0,9999,1
1713325159780,CLRE 252,A00,507189,Cuomo; Raphael Eduardo,9998,0,9999,1
1713325160805,CLRE 253,A00,507199,Vaida; Florin,9997,0,9999,2
1713325160805,CLRE 253,B00,507202,Vaida; Florin,9999,0,9999,0
1713325161829,CLRE 259,A00,507211,Patel; Hemal,9996,0,9999,3
1713325162853,CLRE 260,A00,507221,Cuomo; Raphael Eduardo,9999,0,9999,0
1713325163877,CLRE 297,001,507242,Cuomo; Raphael Eduardo,9999,0,9999,0
1713325164900,CSE 191,A00,516875,Minnes Kemp; Mor Mia,9999,0,9999,0
1713325165928,CSS 201S,A01,494383,Staff,35,0,35,0
1713325166952,CSS 202S,A01,494387,Staff,35,0,35,0
1713325167976,EAP 100,A00,516065,Staff,9792,0,9999,207
1713325169004,ECE 45,A01,507414,Staff,52,0,60,8
1713325170029,ECE 100,A01,507416,Baghdadchi; Saharnaz,11,0,20,9
1713325170029,ECE 100,A02,507418,Baghdadchi; Saharnaz,20,0,20,0
1713325171055,ECE 111,A01,507420,Staff,39,0,50,11
1713325172081,ECE 197,001,548057,Sievenpiper; Daniel F.,9998,0,9999,1
1713325173108,EDS 115,A00,507243,Choi; Bailey Miyeon,28,0,28,0
1713325174133,EDS 117,A01,494379,Staff,23,0,25,2
1713325175157,EDS 125,A00,507246,Hopkins; Megan Beth,29,0,30,1
1713325176182,EDS 128A,A01,507264,Fargason; Sharon Gayle,26,0,26,0
1713325177206,EDS 128B,A01,507293,Pappas; Elizabeth,30,0,30,0
1713325178233,EDS 139,A00,507294,Fargason; Sharon Gayle,30,0,30,0
1713325178233,EDS 139,B00,507313,Pappas; Elizabeth,30,0,30,0
1713325179260,EDS 201,A00,507315,Staff,26,0,30,4
1713325180288,EDS 203,A01,507317,Halter; Christopher P.,26,0,30,4
1713325181312,EDS 204R,A01,507319,Halter; Christopher P.,3,0,30,27
1713325181312,EDS 204R,B01,507331,Heinzman; Erica M.,28,0,30,2
1713325182336,EDS 206R,A00,507332,Staff,4,0,30,26
1713325182336,EDS 206R,B00,507343,Staff,28,0,30,2
1713325183366,EDS 250,A00,507344,Hemans; Patricia Ann Benitez,36,0,40,4
1713325184390,EDS 281,A00,507345,Daly; Alan J.,18,0,18,0
1713325185414,EDS 284,A00,507350,Daly; Alan J.,16,0,16,0
1713325186438,EDS 286,A00,507359,Fine; Sarah,18,0,18,0
1713325187466,EDS 289C,A01,507361,Daly; Alan J.,18,0,18,0
1713325188491,EDS 290,A00,507366,Hofstetter; Carolyn,15,0,15,0
1713325189516,LIGM 5A,A00,507421,Fischer-Grunski; Eva K,20,0,20,0
1713325190543,LIGM 5B,A00,507423,Fischer-Grunski; Eva K,20,0,20,0
1713325191566,LIGM 5C,A00,507425,Fischer-Grunski; Eva K,20,0,20,0
1713325192595,LIIT 5AS,A00,507427,Carnelos; Chiara,20,0,20,0
1713325193619,LIIT 5BS,A00,507430,Carnelos; Chiara,20,0,20,0
1713325194644,LIIT 5CS,A00,507432,Carnelos; Chiara,20,0,20,0
1713325195669,LISP 5A,A00,507541,Munoz Sanchez; Alicia,17,0,20,3
1713325196694,LISP 5B,A00,507671,Munoz Sanchez; Alicia,15,0,20,5
1713325197721,LISP 5C,A00,507696,Munoz Sanchez; Alicia,15,0,20,5
1713325198748,MAE 197,001,528363,Boechler; Nicholas Sebastia,9998,0,9999,1
1713325199774,MATH 197,001,523477,Kedlaya; Kiran S.,9999,0,9999,0
1713325199774,MATH 197,002,563811,Zhang; Danna,9999,0,9999,0
1713325200801,MCWP 40R,A00,518780,Staff,20,0,20,0
1713325200801,MCWP 40R,B00,518781,Staff,19,0,20,1
1713325200801,MCWP 40R,C00,518783,Staff,19,0,20,1
1713325201831,MCWP 50R,A00,518791,Staff,20,0,20,0
1713325201831,MCWP 50R,B00,518792,Staff,17,0,20,3
1713325201831,MCWP 50R,C00,518793,Staff,19,0,20,1
1713325201831,MCWP 50R,D00,518794,Staff,16,0,20,4
1713325201831,MCWP 50R,E00,518795,Staff,16,0,20,4
1713325201831,MCWP 50R,F00,518796,Staff,19,0,20,1
1713325201831,MCWP 50R,G00,518797,Staff,19,0,20,1
1713325202859,MMW 12R,A01,514034,Herbst; Matthew,15,0,16,1
1713325202859,MMW 12R,A02,514035,Herbst; Matthew,16,0,16,0
1713325203898,MMW 13R,A01,514037,Staff,12,0,16,4
1713325203898,MMW 13R,A02,514039,Staff,16,0,16,0
1713325205947,SIO 295LS,A00,523233,Staff,19,0,30,11
1713325206976,SIO 295S,A00,523232,Staff,19,0,30,11
1713325208003,SOCI 117,A01,494376,Staff,2,0,5,3
1713325209028,WES 237B,A00,494380,Staff,19,0,20,1
1713325211090,AESE 279B,A00,494370,Wade; Jon P,33,0,33,0
1713325212114,ANAR 135S,A00,494369,Braswell; Geoffrey E.,0,0,0,0
1713325213139,CAT 124RS,A01,519847,Geibel; William,17,0,20,3
1713325214167,CAT 125RS,A01,515971,Geibel; William,17,0,20,3
1713325215195,CLRE 250,A00,511389,Morris; Sheldon,9996,0,9999,3
1713325216224,CLRE 251,A00,507176,Mehta; Ravindra L.,9996,0,9999,3
1713325216224,CLRE 251,B00,511410,Mehta; Ravindra L.,9998,0,9999,1
1713325217253,CLRE 252,A00,507189,Cuomo; Raphael Eduardo,9998,0,9999,1
1713325218281,CLRE 253,A00,507199,Vaida; Florin,9997,0,9999,2
1713325218281,CLRE 253,B00,507202,Vaida; Florin,9999,0,9999,0
1713325219306,CLRE 259,A00,507211,Patel; Hemal,9996,0,9999,3
1713325220330,CLRE 260,A00,507221,Cuomo; Raphael Eduardo,9999,0,9999,0
1713325221358,CLRE 297,001,507242,Cuomo; Raphael Eduardo,9999,0,9999,0
1713325222385,CSE 191,A00,516875,Minnes Kemp; Mor Mia,9999,0,9999,0
1713325223409,CSS 201S,A01,494383,Staff,35,0,35,0
1713325224435,CSS 202S,A01,494387,Staff,35,0,35,0
1713325225459,EAP 100,A00,516065,Staff,9792,0,9999,207
1713325226484,ECE 45,A01,507414,Staff,52,0,60,8
1713325227513,ECE 100,A01,507416,Baghdadchi; Saharnaz,11,0,20,9
1713325227513,ECE 100,A02,507418,Baghdadchi; Saharnaz,20,0,20,0
1713325228540,ECE 111,A01,507420,Staff,39,0,50,11
1713325229566,ECE 197,001,548057,Sievenpiper; Daniel F.,9998,0,9999,1
1713325230592,EDS 115,A00,507243,Choi; Bailey Miyeon,28,0,28,0
1713325231620,EDS 117,A01,494379,Staff,23,0,25,2
1713325232650,EDS 125,A00,507246,Hopkins; Megan Beth,29,0,30,1
1713325233733,EDS 128A,A01,507264,Fargason; Sharon Gayle,26,0,26,0
1713325234761,EDS 128B,A01,507293,Pappas; Elizabeth,30,0,30,0
1713325235786,EDS 139,A00,507294,Fargason; Sharon Gayle,30,0,30,0
1713325235786,EDS 139,B00,507313,Pappas; Elizabeth,30,0,30,0
1713325236809,EDS 201,A00,507315,Staff,26,0,30,4
1713325237833,EDS 203,A01,507317,Halter; Christopher P.,26,0,30,4
1713325238859,EDS 204R,A01,507319,Halter; Christopher P.,3,0,30,27
1713325238859,EDS 204R,B01,507331,Heinzman; Erica M.,28,0,30,2
1713325239886,EDS 206R,A00,507332,Staff,4,0,30,26
1713325239886,EDS 206R,B00,507343,Staff,28,0,30,2
1713325240910,EDS 250,A00,507344,Hemans; Patricia Ann Benitez,36,0,40,4
1713325241938,EDS 281,A00,507345,Daly; Alan J.,18,0,18,0
1713325242962,EDS 284,A00,507350,Daly; Alan J.,16,0,16,0
1713325243987,EDS 286,A00,507359,Fine; Sarah,18,0,18,0
1713325245011,EDS 289C,A01,507361,Daly; Alan J.,18,0,18,0
1713325246039,EDS 290,A00,507366,Hofstetter; Carolyn,15,0,15,0
1713325247066,LIGM 5A,A00,507421,Fischer-Grunski; Eva K,20,0,20,0
1713325248094,LIGM 5B,A00,507423,Fischer-Grunski; Eva K,20,0,20,0
1713325249122,LIGM 5C,A00,507425,Fischer-Grunski; Eva K,20,0,20,0
1713325250147,LIIT 5AS,A00,507427,Carnelos; Chiara,20,0,20,0
1713325251175,LIIT 5BS,A00,507430,Carnelos; Chiara,20,0,20,0
1713325252204,LIIT 5CS,A00,507432,Carnelos; Chiara,20,0,20,0
1713325253232,LISP 5A,A00,507541,Munoz Sanchez; Alicia,17,0,20,3
1713325254260,LISP 5B,A00,507671,Munoz Sanchez; Alicia,15,0,20,5
1713325255285,LISP 5C,A00,507696,Munoz Sanchez; Alicia,15,0,20,5
1713325256308,MAE 197,001,528363,Boechler; Nicholas Sebastia,9998,0,9999,1
1713325257332,MATH 197,001,523477,Kedlaya; Kiran S.,9999,0,9999,0
1713325257332,MATH 197,002,563811,Zhang; Danna,9999,0,9999,0
1713325258359,MCWP 40R,A00,518780,Staff,20,0,20,0
1713325258359,MCWP 40R,B00,518781,Staff,19,0,20,1
1713325258359,MCWP 40R,C00,518783,Staff,19,0,20,1
1713325259385,MCWP 50R,A00,518791,Staff,20,0,20,0
1713325259385,MCWP 50R,B00,518792,Staff,17,0,20,3
1713325259385,MCWP 50R,C00,518793,Staff,19,0,20,1
1713325259385,MCWP 50R,D00,518794,Staff,16,0,20,4
1713325259385,MCWP 50R,E00,518795,Staff,16,0,20,4
1713325259385,MCWP 50R,F00,518796,Staff,19,0,20,1
1713325259385,MCWP 50R,G00,518797,Staff,19,0,20,1
1713325260413,MMW 12R,A01,514034,Herbst; Matthew,15,0,16,1
1713325260413,MMW 12R,A02,514035,Herbst; Matthew,16,0,16,0
1713325261438,MMW 13R,A01,514037,Staff,12,0,16,4
1713325261438,MMW 13R,A02,514039,Staff,16,0,16,0
1713325263491,SIO 295LS,A00,523233,Staff,19,0,30,11
1713325264515,SIO 295S,A00,523232,Staff,19,0,30,11
1713325265540,SOCI 117,A01,494376,Staff,2,0,5,3
1713325266566,WES 237B,A00,494380,Staff,19,0,20,1
1713325268631,AESE 279B,A00,494370,Wade; Jon P,33,0,33,0
1713325269670,ANAR 135S,A00,494369,Braswell; Geoffrey E.,0,0,0,0
1713325270695,CAT 124RS,A01,519847,Geibel; William,17,0,20,3
1713325271720,CAT 125RS,A01,515971,Geibel; William,17,0,20,3
1713325272745,CLRE 250,A00,511389,Morris; Sheldon,9996,0,9999,3
1713325273771,CLRE 251,A00,507176,Mehta; Ravindra L.,9996,0,9999,3
1713325273771,CLRE 251,B00,511410,Mehta; Ravindra L.,9998,0,9999,1
1713325274799,CLRE 252,A00,507189,Cuomo; Raphael Eduardo,9998,0,9999,1
1713325275825,CLRE 253,A00,507199,Vaida; Florin,9997,0,9999,2
1713325275825,CLRE 253,B00,507202,Vaida; Florin,9999,0,9999,0
1713325276849,CLRE 259,A00,507211,Patel; Hemal,9996,0,9999,3
1713325277877,CLRE 260,A00,507221,Cuomo; Raphael Eduardo,9999,0,9999,0
1713325278902,CLRE 297,001,507242,Cuomo; Raphael Eduardo,9999,0,9999,0
1713325279927,CSE 191,A00,516875,Minnes Kemp; Mor Mia,9999,0,9999,0
1713325280953,CSS 201S,A01,494383,Staff,35,0,35,0
1713325281981,CSS 202S,A01,494387,Staff,35,0,35,0
1713325283005,EAP 100,A00,516065,Staff,9792,0,9999,207
1713325284031,ECE 45,A01,507414,Staff,52,0,60,8
1713325285060,ECE 100,A01,507416,Baghdadchi; Saharnaz,11,0,20,9
1713325285060,ECE 100,A02,507418,Baghdadchi; Saharnaz,20,0,20,0
1713325286087,ECE 111,A01,507420,Staff,39,0,50,11
1713325287113,ECE 197,001,548057,Sievenpiper; Daniel F.,9998,0,9999,1
1713325288138,EDS 115,A00,507243,Choi; Bailey Miyeon,28,0,28,0
1713325289164,EDS 117,A01,494379,Staff,23,0,25,2
1713325290188,EDS 125,A00,507246,Hopkins; Megan Beth,29,0,30,1
1713325291213,EDS 128A,A01,507264,Fargason; Sharon Gayle,26,0,26,0
1713325292243,EDS 128B,A01,507293,Pappas; Elizabeth,30,0,30,0
1713325293269,EDS 139,A00,507294,Fargason; Sharon Gayle,30,0,30,0
1713325293269,EDS 139,B00,507313,Pappas; Elizabeth,30,0,30,0
1713325294298,EDS 201,A00,507315,Staff,26,0,30,4
1713325295326,EDS 203,A01,507317,Halter; Christopher P.,26,0,30,4
1713325296352,EDS 204R,A01,507319,Halter; Christopher P.,3,0,30,27
1713325296352,EDS 204R,B01,507331,Heinzman; Erica M.,28,0,30,2
1713325297378,EDS 206R,A00,507332,Staff,4,0,30,26
1713325297378,EDS 206R,B00,507343,Staff,28,0,30,2
1713325298404,EDS 250,A00,507344,Hemans; Patricia Ann Benitez,36,0,40,4
1713325299431,EDS 281,A00,507345,Daly; Alan J.,18,0,18,0
1713325300462,EDS 284,A00,507350,Daly; Alan J.,16,0,16,0
1713325301490,EDS 286,A00,507359,Fine; Sarah,18,0,18,0
1713325302517,EDS 289C,A01,507361,Daly; Alan J.,18,0,18,0
1713325303548,EDS 290,A00,507366,Hofstetter; Carolyn,15,0,15,0
1713325304576,LIGM 5A,A00,507421,Fischer-Grunski; Eva K,20,0,20,0
1713325305600,LIGM 5B,A00,507423,Fischer-Grunski; Eva K,20,0,20,0
1713325306625,LIGM 5C,A00,507425,Fischer-Grunski; Eva K,20,0,20,0
1713325307650,LIIT 5AS,A00,507427,Carnelos; Chiara,20,0,20,0
1713325308681,LIIT 5BS,A00,507430,Carnelos; Chiara,20,0,20,0
1713325309708,LIIT 5CS,A00,507432,Carnelos; Chiara,20,0,20,0
1713325310735,LISP 5A,A00,507541,Munoz Sanchez; Alicia,17,0,20,3
1713325311760,LISP 5B,A00,507671,Munoz Sanchez; Alicia,15,0,20,5
1713325312788,LISP 5C,A00,507696,Munoz Sanchez; Alicia,15,0,20,5
1713325313812,MAE 197,001,528363,Boechler; Nicholas Sebastia,9998,0,9999,1
1713325314839,MATH 197,001,523477,Kedlaya; Kiran S.,9999,0,9999,0
1713325314839,MATH 197,002,563811,Zhang; Danna,9999,0,9999,0
1713325315864,MCWP 40R,A00,518780,Staff,20,0,20,0
1713325315864,MCWP 40R,B00,518781,Staff,19,0,20,1
1713325315864,MCWP 40R,C00,518783,Staff,19,0,20,1
1713325316887,MCWP 50R,A00,518791,Staff,20,0,20,0
1713325316887,MCWP 50R,B00,518792,Staff,17,0,20,3
1713325316887,MCWP 50R,C00,518793,Staff,19,0,20,1
1713325316887,MCWP 50R,D00,518794,Staff,16,0,20,4
1713325316887,MCWP 50R,E00,518795,Staff,16,0,20,4
1713325316887,MCWP 50R,F00,518796,Staff,19,0,20,1
1713325316887,MCWP 50R,G00,518797,Staff,19,0,20,1
1713325317912,MMW 12R,A01,514034,Herbst; Matthew,15,0,16,1
1713325317912,MMW 12R,A02,514035,Herbst; Matthew,16,0,16,0
1713325318940,MMW 13R,A01,514037,Staff,12,0,16,4
1713325318940,MMW 13R,A02,514039,Staff,16,0,16,0
1713325320994,SIO 295LS,A00,523233,Staff,19,0,30,11
1713325322021,SIO 295S,A00,523232,Staff,19,0,30,11
1713325323047,SOCI 117,A01,494376,Staff,2,0,5,3
1713325324073,WES 237B,A00,494380,Staff,19,0,20,1
1713325326135,AESE 279B,A00,494370,Wade; Jon P,33,0,33,0
1713325327160,ANAR 135S,A00,494369,Braswell; Geoffrey E.,0,0,0,0
1713325328184,CAT 124RS,A01,519847,Geibel; William,17,0,20,3
1713325329213,CAT 125RS,A01,515971,Geibel; William,17,0,20,3
1713325330241,CLRE 250,A00,511389,Morris; Sheldon,9996,0,9999,3
1713325331265,CLRE 251,A00,507176,Mehta; Ravindra L.,9996,0,9999,3
1713325331265,CLRE 251,B00,511410,Mehta; Ravindra L.,9998,0,9999,1
1713325332295,CLRE 252,A00,507189,Cuomo; Raphael Eduardo,9998,0,9999,1
1713325333323,CLRE 253,A00,507199,Vaida; Florin,9997,0,9999,2
1713325333323,CLRE 253,B00,507202,Vaida; Florin,9999,0,9999,0
1713325334347,CLRE 259,A00,507211,Patel; Hemal,9996,0,9999,3
1713325335373,CLRE 260,A00,507221,Cuomo; Raphael Eduardo,9999,0,9999,0
1713325336400,CLRE 297,001,507242,Cuomo; Raphael Eduardo,9999,0,9999,0
1713325337489,CSE 191,A00,516875,Minnes Kemp; Mor Mia,9999,0,9999,0
1713325338514,CSS 201S,A01,494383,Staff,35,0,35,0
1713325339540,CSS 202S,A01,494387,Staff,35,0,35,0
1713325340565,EAP 100,A00,516065,Staff,9792,0,9999,207
1713325341591,ECE 45,A01,507414,Staff,52,0,60,8
1713325342618,ECE 100,A01,507416,Baghdadchi; Saharnaz,11,0,20,9
1713325342618,ECE 100,A02,507418,Baghdadchi; Saharnaz,20,0,20,0
1713325343644,ECE 111,A01,507420,Staff,39,0,50,11
1713325344671,ECE 197,001,548057,Sievenpiper; Daniel F.,9998,0,9999,1
1713325345699,EDS 115,A00,507243,Choi; Bailey Miyeon,28,0,28,0
1713325346726,EDS 117,A01,494379,Staff,23,0,25,2
1713325347753,EDS 125,A00,507246,Hopkins; Megan Beth,29,0,30,1
1713325348780,EDS 128A,A01,507264,Fargason; Sharon Gayle,26,0,26,0
1713325349804,EDS 128B,A01,507293,Pappas; Elizabeth,30,0,30,0
1713325350830,EDS 139,A00,507294,Fargason; Sharon Gayle,30,0,30,0
1713325350830,EDS 139,B00,507313,Pappas; Elizabeth,30,0,30,0
1713325351854,EDS 201,A00,507315,Staff,26,0,30,4
1713325352878,EDS 203,A01,507317,Halter; Christopher P.,26,0,30,4
1713325353906,EDS 204R,A01,507319,Halter; Christopher P.,3,0,30,27
1713325353906,EDS 204R,B01,507331,Heinzman; Erica M.,28,0,30,2
1713325354935,EDS 206R,A00,507332,Staff,4,0,30,26
1713325354935,EDS 206R,B00,507343,Staff,28,0,30,2
1713325355963,EDS 250,A00,507344,Hemans; Patricia Ann Benitez,36,0,40,4
1713325356986,EDS 281,A00,507345,Daly; Alan J.,18,0,18,0
1713325358011,EDS 284,A00,507350,Daly; Alan J.,16,0,16,0
1713325359043,EDS 286,A00,507359,Fine; Sarah,18,0,18,0
1713325360067,EDS 289C,A01,507361,Daly; Alan J.,18,0,18,0
1713325361095,EDS 290,A00,507366,Hofstetter; Carolyn,15,0,15,0
1713325362123,LIGM 5A,A00,507421,Fischer-Grunski; Eva K,20,0,20,0
1713325363151,LIGM 5B,A00,507423,Fischer-Grunski; Eva K,20,0,20,0
1713325364177,LIGM 5C,A00,507425,Fischer-Grunski; Eva K,20,0,20,0
1713325365203,LIIT 5AS,A00,507427,Carnelos; Chiara,20,0,20,0
1713325366227,LIIT 5BS,A00,507430,Carnelos; Chiara,20,0,20,0
1713325367255,LIIT 5CS,A00,507432,Carnelos; Chiara,20,0,20,0
1713325368281,LISP 5A,A00,507541,Munoz Sanchez; Alicia,17,0,20,3
1713325369304,LISP 5B,A00,507671,Munoz Sanchez; Alicia,15,0,20,5
1713325370332,LISP 5C,A00,507696,Munoz Sanchez; Alicia,15,0,20,5
1713325371361,MAE 197,001,528363,Boechler; Nicholas Sebastia,9998,0,9999,1
1713325372385,MATH 197,001,523477,Kedlaya; Kiran S.,9999,0,9999,0
1713325372385,MATH 197,002,563811,Zhang; Danna,9999,0,9999,0
1713325373412,MCWP 40R,A00,518780,Staff,20,0,20,0
1713325373412,MCWP 40R,B00,518781,Staff,19,0,20,1
1713325373412,MCWP 40R,C00,518783,Staff,19,0,20,1
1713325374440,MCWP 50R,A00,518791,Staff,20,0,20,0
1713325374440,MCWP 50R,B00,518792,Staff,17,0,20,3
1713325374440,MCWP 50R,C00,518793,Staff,19,0,20,1
1713325374440,MCWP 50R,D00,518794,Staff,16,0,20,4
1713325374440,MCWP 50R,E00,518795,Staff,16,0,20,4
1713325374440,MCWP 50R,F00,518796,Staff,19,0,20,1
1713325374440,MCWP 50R,G00,518797,Staff,19,0,20,1
1713325375466,MMW 12R,A01,514034,Herbst; Matthew,15,0,16,1
1713325375466,MMW 12R,A02,514035,Herbst; Matthew,16,0,16,0
1713325376491,MMW 13R,A01,514037,Staff,12,0,16,4
1713325376491,MMW 13R,A02,514039,Staff,16,0,16,0
1713325378541,SIO 295LS,A00,523233,Staff,19,0,30,11
1713325379569,SIO 295S,A00,523232,Staff,19,0,30,11
1713325380596,SOCI 117,A01,494376,Staff,2,0,5,3
1713325381623,WES 237B,A00,494380,Staff,19,0,20,1
1713325383680,AESE 279B,A00,494370,Wade; Jon P,33,0,33,0
1713325384708,ANAR 135S,A00,494369,Braswell; Geoffrey E.,0,0,0,0
1713325385732,CAT 124RS,A01,519847,Geibel; William,17,0,20,3
1713325386760,CAT 125RS,A01,515971,Geibel; William,17,0,20,3
1713325387786,CLRE 250,A00,511389,Morris; Sheldon,9996,0,9999,3
1713325388814,CLRE 251,A00,507176,Mehta; Ravindra L.,9996,0,9999,3
1713325388814,CLRE 251,B00,511410,Mehta; Ravindra L.,9998,0,9999,1
1713325389841,CLRE 252,A00,507189,Cuomo; Raphael Eduardo,9998,0,9999,1
1713325390867,CLRE 253,A00,507199,Vaida; Florin,9997,0,9999,2
1713325390867,CLRE 253,B00,507202,Vaida; Florin,9999,0,9999,0
1713325391894,CLRE 259,A00,507211,Patel; Hemal,9996,0,9999,3
1713325392922,CLRE 260,A00,507221,Cuomo; Raphael Eduardo,9999,0,9999,0
1713325393952,CLRE 297,001,507242,Cuomo; Raphael Eduardo,9999,0,9999,0
1713325394976,CSE 191,A00,516875,Minnes Kemp; Mor Mia,9999,0,9999,0
1713325396006,CSS 201S,A01,494383,Staff,35,0,35,0
1713325397032,CSS 202S,A01,494387,Staff,35,0,35,0
1713325398060,EAP 100,A00,516065,Staff,9792,0,9999,207
1713325399087,ECE 45,A01,507414,Staff,52,0,60,8
1713325400113,ECE 100,A01,507416,Baghdadchi; Saharnaz,11,0,20,9
1713325400113,ECE 100,A02,507418,Baghdadchi; Saharnaz,20,0,20,0
1713325401141,ECE 111,A01,507420,Staff,39,0,50,11
1713325402165,ECE 197,001,548057,Sievenpiper; Daniel F.,9998,0,9999,1
1713325403189,EDS 115,A00,507243,Choi; Bailey Miyeon,28,0,28,0
1713325404214,EDS 117,A01,494379,Staff,23,0,25,2
1713325405336,EDS 125,A00,507246,Hopkins; Megan Beth,29,0,30,1
1713325406361,EDS 128A,A01,507264,Fargason; Sharon Gayle,26,0,26,0
1713325407388,EDS 128B,A01,507293,Pappas; Elizabeth,30,0,30,0
1713325408413,EDS 139,A00,507294,Fargason; Sharon Gayle,30,0,30,0
1713325408413,EDS 139,B00,507313,Pappas; Elizabeth,30,0,30,0
1713325409442,EDS 201,A00,507315,Staff,26,0,30,4
1713325410469,EDS 203,A01,507317,Halter; Christopher P.,26,0,30,4
1713325411495,EDS 204R,A01,507319,Halter; Christopher P.,3,0,30,27
1713325411495,EDS 204R,B01,507331,Heinzman; Erica M.,28,0,30,2
1713325412524,EDS 206R,A00,507332,Staff,4,0,30,26
1713325412524,EDS 206R,B00,507343,Staff,28,0,30,2
1713325413547,EDS 250,A00,507344,Hemans; Patricia Ann Benitez,36,0,40,4
1713325414573,EDS 281,A00,507345,Daly; Alan J.,18,0,18,0
1713325415600,EDS 284,A00,507350,Daly; Alan J.,16,0,16,0
1713325416628,EDS 286,A00,507359,Fine; Sarah,18,0,18,0
1713325417657,EDS 289C,A01,507361,Daly; Alan J.,18,0,18,0
1713325418683,EDS 290,A00,507366,Hofstetter; Carolyn,15,0,15,0
1713325419708,LIGM 5A,A00,507421,Fischer-Grunski; Eva K,20,0,20,0
1713325420733,LIGM 5B,A00,507423,Fischer-Grunski; Eva K,20,0,20,0
1713325421761,LIGM 5C,A00,507425,Fischer-Grunski; Eva K,20,0,20,0
1713325422786,LIIT 5AS,A00,507427,Carnelos; Chiara,20,0,20,0
1713325423812,LIIT 5BS,A00,507430,Carnelos; Chiara,20,0,20,0
1713325424838,LIIT 5CS,A00,507432,Carnelos; Chiara,20,0,20,0
1713325425866,LISP 5A,A00,507541,Munoz Sanchez; Alicia,17,0,20,3
1713325426894,LISP 5B,A00,507671,Munoz Sanchez; Alicia,15,0,20,5
1713325427940,LISP 5C,A00,507696,Munoz Sanchez; Alicia,15,0,20,5
1713325428964,MAE 197,001,528363,Boechler; Nicholas Sebastia,9998,0,9999,1
1713325429989,MATH 197,001,523477,Kedlaya; Kiran S.,9999,0,9999,0
1713325429989,MATH 197,002,563811,Zhang; Danna,9999,0,9999,0
1713325431014,MCWP 40R,A00,518780,Staff,20,0,20,0
1713325431014,MCWP 40R,B00,518781,Staff,19,0,20,1
1713325431014,MCWP 40R,C00,518783,Staff,19,0,20,1
1713325432039,MCWP 50R,A00,518791,Staff,20,0,20,0
1713325432039,MCWP 50R,B00,518792,Staff,17,0,20,3
1713325432039,MCWP 50R,C00,518793,Staff,19,0,20,1
1713325432039,MCWP 50R,D00,518794,Staff,16,0,20,4
1713325432039,MCWP 50R,E00,518795,Staff,16,0,20,4
1713325432039,MCWP 50R,F00,518796,Staff,19,0,20,1
1713325432039,MCWP 50R,G00,518797,Staff,19,0,20,1
1713325433064,MMW 12R,A01,514034,Herbst; Matthew,15,0,16,1
1713325433064,MMW 12R,A02,514035,Herbst; Matthew,16,0,16,0
1713325434091,MMW 13R,A01,514037,Staff,12,0,16,4
1713325434091,MMW 13R,A02,514039,Staff,16,0,16,0
1713325436144,SIO 295LS,A00,523233,Staff,19,0,30,11
1713325437171,SIO 295S,A00,523232,Staff,19,0,30,11
1713325438197,SOCI 117,A01,494376,Staff,2,0,5,3
1713325439224,WES 237B,A00,494380,Staff,19,0,20,1
1713325441343,AESE 279B,A00,494370,Wade; Jon P,33,0,33,0
1713325442369,ANAR 135S,A00,494369,Braswell; Geoffrey E.,0,0,0,0
1713325443396,CAT 124RS,A01,519847,Geibel; William,17,0,20,3
1713325444422,CAT 125RS,A01,515971,Geibel; William,17,0,20,3
1713325445446,CLRE 250,A00,511389,Morris; Sheldon,9996,0,9999,3
1713325446472,CLRE 251,A00,507176,Mehta; Ravindra L.,9996,0,9999,3
1713325446472,CLRE 251,B00,511410,Mehta; Ravindra L.,9998,0,9999,1
1713325447499,CLRE 252,A00,507189,Cuomo; Raphael Eduardo,9998,0,9999,1
1713325448525,CLRE 253,A00,507199,Vaida; Florin,9997,0,9999,2
1713325448525,CLRE 253,B00,507202,Vaida; Florin,9999,0,9999,0
1713325449552,CLRE 259,A00,507211,Patel; Hemal,9996,0,9999,3
1713325450579,CLRE 260,A00,507221,Cuomo; Raphael Eduardo,9999,0,9999,0
1713325451606,CLRE 297,001,507242,Cuomo; Raphael Eduardo,9999,0,9999,0
1713325452630,CSE 191,A00,516875,Minnes Kemp; Mor Mia,9999,0,9999,0
1713325453655,CSS 201S,A01,494383,Staff,35,0,35,0
1713325454682,CSS 202S,A01,494387,Staff,35,0,35,0
1713325455710,EAP 100,A00,516065,Staff,9792,0,9999,207
1713325456736,ECE 45,A01,507414,Staff,52,0,60,8
1713325457761,ECE 100,A01,507416,Baghdadchi; Saharnaz,11,0,20,9
1713325457761,ECE 100,A02,507418,Baghdadchi; Saharnaz,20,0,20,0
1713325458786,ECE 111,A01,507420,Staff,39,0,50,11
1713325459812,ECE 197,001,548057,Sievenpiper; Daniel F.,9998,0,9999,1
1713325460837,EDS 115,A00,507243,Choi; Bailey Miyeon,28,0,28,0
1713325461862,EDS 117,A01,494379,Staff,23,0,25,2
1713325462886,EDS 125,A00,507246,Hopkins; Megan Beth,29,0,30,1
1713325463912,EDS 128A,A01,507264,Fargason; Sharon Gayle,26,0,26,0
1713325464940,EDS 128B,A01,507293,Pappas; Elizabeth,30,0,30,0
1713325465970,EDS 139,A00,507294,Fargason; Sharon Gayle,30,0,30,0
1713325465970,EDS 139,B00,507313,Pappas; Elizabeth,30,0,30,0
1713325466994,EDS 201,A00,507315,Staff,26,0,30,4
1713325468023,EDS 203,A01,507317,Halter; Christopher P.,26,0,30,4
1713325469052,EDS 204R,A01,507319,Halter; Christopher P.,3,0,30,27
1713325469052,EDS 204R,B01,507331,Heinzman; Erica M.,28,0,30,2
1713325470076,EDS 206R,A00,507332,Staff,4,0,30,26
1713325470076,EDS 206R,B00,507343,Staff,28,0,30,2
1713325471104,EDS 250,A00,507344,Hemans; Patricia Ann Benitez,36,0,40,4
1713325472129,EDS 281,A00,507345,Daly; Alan J.,18,0,18,0
1713325473153,EDS 284,A00,507350,Daly; Alan J.,16,0,16,0
1713325474178,EDS 286,A00,507359,Fine; Sarah,18,0,18,0
1713325475208,EDS 289C,A01,507361,Daly; Alan J.,18,0,18,0
1713325476234,EDS 290,A00,507366,Hofstetter; Carolyn,15,0,15,0
1713325477262,LIGM 5A,A00,507421,Fischer-Grunski; Eva K,20,0,20,0
1713325478290,LIGM 5B,A00,507423,Fischer-Grunski; Eva K,20,0,20,0
1713325479317,LIGM 5C,A00,507425,Fischer-Grunski; Eva K,20,0,20,0
1713325480346,LIIT 5AS,A00,507427,Carnelos; Chiara,20,0,20,0
1713325481370,LIIT 5BS,A00,507430,Carnelos; Chiara,20,0,20,0
1713325482395,LIIT 5CS,A00,507432,Carnelos; Chiara,20,0,20,0
1713325483421,LISP 5A,A00,507541,Munoz Sanchez; Alicia,17,0,20,3
1713325484449,LISP 5B,A00,507671,Munoz Sanchez; Alicia,15,0,20,5
1713325485473,LISP 5C,A00,507696,Munoz Sanchez; Alicia,15,0,20,5
1713325486498,MAE 197,001,528363,Boechler; Nicholas Sebastia,9998,0,9999,1
1713325487524,MATH 197,001,523477,Kedlaya; Kiran S.,9999,0,9999,0
1713325487524,MATH 197,002,563811,Zhang; Danna,9999,0,9999,0
1713325488552,MCWP 40R,A00,518780,Staff,20,0,20,0
1713325488552,MCWP 40R,B00,518781,Staff,19,0,20,1
1713325488552,MCWP 40R,C00,518783,Staff,19,0,20,1
1713325489578,MCWP 50R,A00,518791,Staff,20,0,20,0
1713325489578,MCWP 50R,B00,518792,Staff,17,0,20,3
1713325489578,MCWP 50R,C00,518793,Staff,19,0,20,1
1713325489578,MCWP 50R,D00,518794,Staff,16,0,20,4
1713325489578,MCWP 50R,E00,518795,Staff,16,0,20,4
1713325489578,MCWP 50R,F00,518796,Staff,19,0,20,1
1713325489578,MCWP 50R,G00,518797,Staff,19,0,20,1
1713325490603,MMW 12R,A01,514034,Herbst; Matthew,15,0,16,1
1713325490603,MMW 12R,A02,514035,Herbst; Matthew,16,0,16,0
1713325491627,MMW 13R,A01,514037,Staff,12,0,16,4
1713325491627,MMW 13R,A02,514039,Staff,16,0,16,0
1713325493679,SIO 295LS,A00,523233,Staff,19,0,30,11
1713325494707,SIO 295S,A00,523232,Staff,19,0,30,11
1713325495732,SOCI 117,A01,494376,Staff,2,0,5,3
1713325496757,WES 237B,A00,494380,Staff,19,0,20,1
1713325498810,AESE 279B,A00,494370,Wade; Jon P,33,0,33,0
1713325499833,ANAR 135S,A00,494369,Braswell; Geoffrey E.,0,0,0,0
1713325500859,CAT 124RS,A01,519847,Geibel; William,17,0,20,3
1713325501882,CAT 125RS,A01,515971,Geibel; William,17,0,20,3
1713325502908,CLRE 250,A00,511389,Morris; Sheldon,9996,0,9999,3
1713325503938,CLRE 251,A00,507176,Mehta; Ravindra L.,9996,0,9999,3
1713325503938,CLRE 251,B00,511410,Mehta; Ravindra L.,9998,0,9999,1
1713325504963,CLRE 252,A00,507189,Cuomo; Raphael Eduardo,9998,0,9999,1
1713325505992,CLRE 253,A00,507199,Vaida; Florin,9997,0,9999,2
1713325505992,CLRE 253,B00,507202,Vaida; Florin,9999,0,9999,0
1713325507017,CLRE 259,A00,507211,Patel; Hemal,9996,0,9999,3
1713325508045,CLRE 260,A00,507221,Cuomo; Raphael Eduardo,9999,0,9999,0
1713325509076,CLRE 297,001,507242,Cuomo; Raphael Eduardo,9999,0,9999,0
1713325510104,CSE 191,A00,516875,Minnes Kemp; Mor Mia,9999,0,9999,0
1713325511131,CSS 201S,A01,494383,Staff,35,0,35,0
1713325512156,CSS 202S,A01,494387,Staff,35,0,35,0
1713325513182,EAP 100,A00,516065,Staff,9792,0,9999,207
1713325514207,ECE 45,A01,507414,Staff,52,0,60,8
1713325515231,ECE 100,A01,507416,Baghdadchi; Saharnaz,11,0,20,9
1713325515231,ECE 100,A02,507418,Baghdadchi; Saharnaz,20,0,20,0
1713325516257,ECE 111,A01,507420,Staff,39,0,50,11
1713325517283,ECE 197,001,548057,Sievenpiper; Daniel F.,9998,0,9999,1
1713325518310,EDS 115,A00,507243,Choi; Bailey Miyeon,28,0,28,0
1713325519335,EDS 117,A01,494379,Staff,23,0,25,2
1713325520360,EDS 125,A00,507246,Hopkins; Megan Beth,29,0,30,1
1713325521387,EDS 128A,A01,507264,Fargason; Sharon Gayle,26,0,26,0
1713325522412,EDS 128B,A01,507293,Pappas; Elizabeth,30,0,30,0
1713325523436,EDS 139,A00,507294,Fargason; Sharon Gayle,30,0,30,0
1713325523436,EDS 139,B00,507313,Pappas; Elizabeth,30,0,30,0
1713325524461,EDS 201,A00,507315,Staff,26,0,30,4
1713325525487,EDS 203,A01,507317,Halter; Christopher P.,26,0,30,4
1713325526510,EDS 204R,A01,507319,Halter; Christopher P.,3,0,30,27
1713325526510,EDS 204R,B01,507331,Heinzman; Erica M.,28,0,30,2
1713325527535,EDS 206R,A00,507332,Staff,4,0,30,26
1713325527535,EDS 206R,B00,507343,Staff,28,0,30,2
1713325528560,EDS 250,A00,507344,Hemans; Patricia Ann Benitez,36,0,40,4
1713325529585,EDS 281,A00,507345,Daly; Alan J.,18,0,18,0
1713325530613,EDS 284,A00,507350,Daly; Alan J.,16,0,16,0
1713325531640,EDS 286,A00,507359,Fine; Sarah,18,0,18,0
1713325532664,EDS 289C,A01,507361,Daly; Alan J.,18,0,18,0
1713325533693,EDS 290,A00,507366,Hofstetter; Carolyn,15,0,15,0
1713325534721,LIGM 5A,A00,507421,Fischer-Grunski; Eva K,20,0,20,0
1713325535744,LIGM 5B,A00,507423,Fischer-Grunski; Eva K,20,0,20,0
1713325536769,LIGM 5C,A00,507425,Fischer-Grunski; Eva K,20,0,20,0
1713325537797,LIIT 5AS,A00,507427,Carnelos; Chiara,20,0,20,0
1713325538824,LIIT 5BS,A00,507430,Carnelos; Chiara,20,0,20,0
1713325539853,LIIT 5CS,A00,507432,Carnelos; Chiara,20,0,20,0
1713325540877,LISP 5A,A00,507541,Munoz Sanchez; Alicia,17,0,20,3
1713325541905,LISP 5B,A00,507671,Munoz Sanchez; Alicia,15,0,20,5
1713325542930,LISP 5C,A00,507696,Munoz Sanchez; Alicia,15,0,20,5
1713325543958,MAE 197,001,528363,Boechler; Nicholas Sebastia,9998,0,9999,1
1713325545033,MATH 197,001,523477,Kedlaya; Kiran S.,9999,0,9999,0
1713325545033,MATH 197,002,563811,Zhang; Danna,9999,0,9999,0
1713325546062,MCWP 40R,A00,518780,Staff,20,0,20,0
1713325546062,MCWP 40R,B00,518781,Staff,19,0,20,1
1713325546062,MCWP 40R,C00,518783,Staff,19,0,20,1
1713325547087,MCWP 50R,A00,518791,Staff,20,0,20,0
1713325547087,MCWP 50R,B00,518792,Staff,17,0,20,3
1713325547087,MCWP 50R,C00,518793,Staff,19,0,20,1
1713325547087,MCWP 50R,D00,518794,Staff,16,0,20,4
1713325547087,MCWP 50R,E00,518795,Staff,16,0,20,4
1713325547087,MCWP 50R,F00,518796,Staff,19,0,20,1
1713325547087,MCWP 50R,G00,518797,Staff,19,0,20,1
1713325548115,MMW 12R,A01,514034,Herbst; Matthew,15,0,16,1
1713325548115,MMW 12R,A02,514035,Herbst; Matthew,16,0,16,0
1713325549143,MMW 13R,A01,514037,Staff,12,0,16,4
1713325549143,MMW 13R,A02,514039,Staff,16,0,16,0
1713325551192,SIO 295LS,A00,523233,Staff,19,0,30,11
1713325552219,SIO 295S,A00,523232,Staff,19,0,30,11
1713325553246,SOCI 117,A01,494376,Staff,2,0,5,3
1713325554270,WES 237B,A00,494380,Staff,19,0,20,1
1713325556325,AESE 279B,A00,494370,Wade; Jon P,33,0,33,0
1713325557349,ANAR 135S,A00,494369,Braswell; Geoffrey E.,0,0,0,0
1713325558405,CAT 124RS,A01,519847,Geibel; William,17,0,20,3
1713325559433,CAT 125RS,A01,515971,Geibel; William,17,0,20,3
1713325560460,CLRE 250,A00,511389,Morris; Sheldon,9996,0,9999,3
1713325561489,CLRE 251,A00,507176,Mehta; Ravindra L.,9996,0,9999,3
1713325561489,CLRE 251,B00,511410,Mehta; Ravindra L.,9998,0,9999,1
1713325562518,CLRE 252,A00,507189,Cuomo; Raphael Eduardo,9998,0,9999,1
1713325563544,CLRE 253,A00,507199,Vaida; Florin,9997,0,9999,2
1713325563544,CLRE 253,B00,507202,Vaida; Florin,9999,0,9999,0
1713325564576,CLRE 259,A00,507211,Patel; Hemal,9996,0,9999,3
1713325565603,CLRE 260,A00,507221,Cuomo; Raphael Eduardo,9999,0,9999,0
1713325566629,CLRE 297,001,507242,Cuomo; Raphael Eduardo,9999,0,9999,0
1713325567654,CSE 191,A00,516875,Minnes Kemp; Mor Mia,9999,0,9999,0
1713325568683,CSS 201S,A01,494383,Staff,35,0,35,0
1713325569711,CSS 202S,A01,494387,Staff,35,0,35,0
1713325570736,EAP 100,A00,516065,Staff,9792,0,9999,207
1713325571761,ECE 45,A01,507414,Staff,51,0,60,9
1713325572786,ECE 100,A01,507416,Baghdadchi; Saharnaz,11,0,20,9
1713325572786,ECE 100,A02,507418,Baghdadchi; Saharnaz,20,0,20,0
1713325573813,ECE 111,A01,507420,Staff,39,0,50,11
1713325574838,ECE 197,001,548057,Sievenpiper; Daniel F.,9998,0,9999,1
1713325575863,EDS 115,A00,507243,Choi; Bailey Miyeon,28,0,28,0
1713325576889,EDS 117,A01,494379,Staff,23,0,25,2
1713325577913,EDS 125,A00,507246,Hopkins; Megan Beth,29,0,30,1
1713325578944,EDS 128A,A01,507264,Fargason; Sharon Gayle,26,0,26,0
1713325579971,EDS 128B,A01,507293,Pappas; Elizabeth,30,0,30,0
1713325580998,EDS 139,A00,507294,Fargason; Sharon Gayle,30,0,30,0
1713325580998,EDS 139,B00,507313,Pappas; Elizabeth,30,0,30,0
1713325582028,EDS 201,A00,507315,Staff,26,0,30,4
1713325583054,EDS 203,A01,507317,Halter; Christopher P.,26,0,30,4
1713325584080,EDS 204R,A01,507319,Halter; Christopher P.,3,0,30,27
1713325584080,EDS 204R,B01,507331,Heinzman; Erica M.,28,0,30,2
1713325585104,EDS 206R,A00,507332,Staff,4,0,30,26
1713325585104,EDS 206R,B00,507343,Staff,28,0,30,2
1713325586129,EDS 250,A00,507344,Hemans; Patricia Ann Benitez,36,0,40,4
1713325587157,EDS 281,A00,507345,Daly; Alan J.,18,0,18,0
1713325588181,EDS 284,A00,507350,Daly; Alan J.,16,0,16,0
1713325589206,EDS 286,A00,507359,Fine; Sarah,18,0,18,0
1713325590234,EDS 289C,A01,507361,Daly; Alan J.,18,0,18,0
1713325591258,EDS 290,A00,507366,Hofstetter; Carolyn,15,0,15,0
1713325592283,LIGM 5A,A00,507421,Fischer-Grunski; Eva K,20,0,20,0
1713325593313,LIGM 5B,A00,507423,Fischer-Grunski; Eva K,20,0,20,0
1713325594338,LIGM 5C,A00,507425,Fischer-Grunski; Eva K,20,0,20,0
1713325595362,LIIT 5AS,A00,507427,Carnelos; Chiara,20,0,20,0
1713325596390,LIIT 5BS,A00,507430,Carnelos; Chiara,20,0,20,0
1713325597416,LIIT 5CS,A00,507432,Carnelos; Chiara,20,0,20,0
1713325598439,LISP 5A,A00,507541,Munoz Sanchez; Alicia,17,0,20,3
1713325599467,LISP 5B,A00,507671,Munoz Sanchez; Alicia,15,0,20,5
1713325600492,LISP 5C,A00,507696,Munoz Sanchez; Alicia,15,0,20,5
1713325601518,MAE 197,001,528363,Boechler; Nicholas Sebastia,9998,0,9999,1
1713325602542,MATH 197,001,523477,Kedlaya; Kiran S.,9999,0,9999,0
1713325602542,MATH 197,002,563811,Zhang; Danna,9999,0,9999,0
1713325603569,MCWP 40R,A00,518780,Staff,20,0,20,0
1713325603569,MCWP 40R,B00,518781,Staff,19,0,20,1
1713325603569,MCWP 40R,C00,518783,Staff,19,0,20,1
1713325604601,MCWP 50R,A00,518791,Staff,20,0,20,0
1713325604601,MCWP 50R,B00,518792,Staff,17,0,20,3
1713325604601,MCWP 50R,C00,518793,Staff,19,0,20,1
1713325604601,MCWP 50R,D00,518794,Staff,16,0,20,4
1713325604601,MCWP 50R,E00,518795,Staff,16,0,20,4
1713325604601,MCWP 50R,F00,518796,Staff,19,0,20,1
1713325604601,MCWP 50R,G00,518797,Staff,19,0,20,1
1713325605625,MMW 12R,A01,514034,Herbst; Matthew,15,0,16,1
1713325605625,MMW 12R,A02,514035,Herbst; Matthew,16,0,16,0
1713325606653,MMW 13R,A01,514037,Staff,12,0,16,4
1713325606653,MMW 13R,A02,514039,Staff,16,0,16,0
1713325608707,SIO 295LS,A00,523233,Staff,19,0,30,11
1713325609731,SIO 295S,A00,523232,Staff,19,0,30,11
1713325610757,SOCI 117,A01,494376,Staff,2,0,5,3
1713325611780,WES 237B,A00,494380,Staff,19,0,20,1
1713325613850,AESE 279B,A00,494370,Wade; Jon P,33,0,33,0
1713325614874,ANAR 135S,A00,494369,Braswell; Geoffrey E.,0,0,0,0
1713325615903,CAT 124RS,A01,519847,Geibel; William,17,0,20,3
1713325616932,CAT 125RS,A01,515971,Geibel; William,17,0,20,3
1713325617956,CLRE 250,A00,511389,Morris; Sheldon,9996,0,9999,3
1713325618988,CLRE 251,A00,507176,Mehta; Ravindra L.,9996,0,9999,3
1713325618988,CLRE 251,B00,511410,Mehta; Ravindra L.,9998,0,9999,1
1713325620013,CLRE 252,A00,507189,Cuomo; Raphael Eduardo,9998,0,9999,1
1713325621040,CLRE 253,A00,507199,Vaida; Florin,9997,0,9999,2
1713325621040,CLRE 253,B00,507202,Vaida; Florin,9999,0,9999,0
1713325622068,CLRE 259,A00,507211,Patel; Hemal,9996,0,9999,3
1713325623092,CLRE 260,A00,507221,Cuomo; Raphael Eduardo,9999,0,9999,0
1713325624116,CLRE 297,001,507242,Cuomo; Raphael Eduardo,9999,0,9999,0
1713325625141,CSE 191,A00,516875,Minnes Kemp; Mor Mia,9999,0,9999,0
1713325626167,CSS 201S,A01,494383,Staff,35,0,35,0
1713325627191,CSS 202S,A01,494387,Staff,35,0,35,0
1713325628218,EAP 100,A00,516065,Staff,9792,0,9999,207
1713325629246,ECE 45,A01,507414,Staff,51,0,60,9
1713325630277,ECE 100,A01,507416,Baghdadchi; Saharnaz,11,0,20,9
1713325630277,ECE 100,A02,507418,Baghdadchi; Saharnaz,20,0,20,0
1713325631304,ECE 111,A01,507420,Staff,39,0,50,11
1713325632333,ECE 197,001,548057,Sievenpiper; Daniel F.,9998,0,9999,1
1713325633357,EDS 115,A00,507243,Choi; Bailey Miyeon,28,0,28,0
1713325634383,EDS 117,A01,494379,Staff,23,0,25,2
1713325635429,EDS 125,A00,507246,Hopkins; Megan Beth,29,0,30,1
1713325636454,EDS 128A,A01,507264,Fargason; Sharon Gayle,26,0,26,0
1713325637479,EDS 128B,A01,507293,Pappas; Elizabeth,30,0,30,0
1713325638504,EDS 139,A00,507294,Fargason; Sharon Gayle,30,0,30,0
1713325638504,EDS 139,B00,507313,Pappas; Elizabeth,30,0,30,0
1713325639531,EDS 201,A00,507315,Staff,26,0,30,4
1713325640556,EDS 203,A01,507317,Halter; Christopher P.,26,0,30,4
1713325641581,EDS 204R,A01,507319,Halter; Christopher P.,3,0,30,27
1713325641581,EDS 204R,B01,507331,Heinzman; Erica M.,28,0,30,2
1713325642608,EDS 206R,A00,507332,Staff,4,0,30,26
1713325642608,EDS 206R,B00,507343,Staff,28,0,30,2
1713325643637,EDS 250,A00,507344,Hemans; Patricia Ann Benitez,36,0,40,4
1713325644665,EDS 281,A00,507345,Daly; Alan J.,18,0,18,0
1713325645689,EDS 284,A00,507350,Daly; Alan J.,16,0,16,0
1713325646715,EDS 286,A00,507359,Fine; Sarah,18,0,18,0
1713325647743,EDS 289C,A01,507361,Daly; Alan J.,18,0,18,0
1713325648820,EDS 290,A00,507366,Hofstetter; Carolyn,15,0,15,0
1713325649849,LIGM 5A,A00,507421,Fischer-Grunski; Eva K,20,0,20,0
1713325650875,LIGM 5B,A00,507423,Fischer-Grunski; Eva K,20,0,20,0
1713325651899,LIGM 5C,A00,507425,Fischer-Grunski; Eva K,20,0,20,0
1713325652932,LIIT 5AS,A00,507427,Carnelos; Chiara,20,0,20,0
1713325653956,LIIT 5BS,A00,507430,Carnelos; Chiara,20,0,20,0
1713325654984,LIIT 5CS,A00,507432,Carnelos; Chiara,20,0,20,0
1713325656012,LISP 5A,A00,507541,Munoz Sanchez; Alicia,17,0,20,3
1713325657041,LISP 5B,A00,507671,Munoz Sanchez; Alicia,15,0,20,5
1713325658070,LISP 5C,A00,507696,Munoz Sanchez; Alicia,15,0,20,5
1713325659098,MAE 197,001,528363,Boechler; Nicholas Sebastia,9998,0,9999,1
1713325660125,MATH 197,001,523477,Kedlaya; Kiran S.,9999,0,9999,0
1713325660125,MATH 197,002,563811,Zhang; Danna,9999,0,9999,0
1713325661153,MCWP 40R,A00,518780,Staff,20,0,20,0
1713325661153,MCWP 40R,B00,518781,Staff,19,0,20,1
1713325661153,MCWP 40R,C00,518783,Staff,19,0,20,1
1713325662177,MCWP 50R,A00,518791,Staff,20,0,20,0
1713325662177,MCWP 50R,B00,518792,Staff,17,0,20,3
1713325662177,MCWP 50R,C00,518793,Staff,19,0,20,1
1713325662177,MCWP 50R,D00,518794,Staff,16,0,20,4
1713325662177,MCWP 50R,E00,518795,Staff,16,0,20,4
1713325662177,MCWP 50R,F00,518796,Staff,19,0,20,1
1713325662177,MCWP 50R,G00,518797,Staff,19,0,20,1
1713325663205,MMW 12R,A01,514034,Herbst; Matthew,15,0,16,1
1713325663205,MMW 12R,A02,514035,Herbst; Matthew,16,0,16,0
1713325664230,MMW 13R,A01,514037,Staff,12,0,16,4
1713325664230,MMW 13R,A02,514039,Staff,16,0,16,0
1713325666279,SIO 295LS,A00,523233,Staff,19,0,30,11
1713325667307,SIO 295S,A00,523232,Staff,19,0,30,11
1713325668334,SOCI 117,A01,494376,Staff,2,0,5,3
1713325669359,WES 237B,A00,494380,Staff,19,0,20,1
1713325671421,AESE 279B,A00,494370,Wade; Jon P,33,0,33,0
1713325672443,ANAR 135S,A00,494369,Braswell; Geoffrey E.,0,0,0,0
1713325673467,CAT 124RS,A01,519847,Geibel; William,17,0,20,3
1713325674494,CAT 125RS,A01,515971,Geibel; William,17,0,20,3
1713325675518,CLRE 250,A00,511389,Morris; Sheldon,9996,0,9999,3
1713325676546,CLRE 251,A00,507176,Mehta; Ravindra L.,9996,0,9999,3
1713325676546,CLRE 251,B00,511410,Mehta; Ravindra L.,9998,0,9999,1
1713325677572,CLRE 252,A00,507189,Cuomo; Raphael Eduardo,9998,0,9999,1
1713325678601,CLRE 253,A00,507199,Vaida; Florin,9997,0,9999,2
1713325678601,CLRE 253,B00,507202,Vaida; Florin,9999,0,9999,0
1713325679629,CLRE 259,A00,507211,Patel; Hemal,9996,0,9999,3
1713325680658,CLRE 260,A00,507221,Cuomo; Raphael Eduardo,9999,0,9999,0
1713325681682,CLRE 297,001,507242,Cuomo; Raphael Eduardo,9999,0,9999,0
1713325682707,CSE 191,A00,516875,Minnes Kemp; Mor Mia,9999,0,9999,0
1713325683736,CSS 201S,A01,494383,Staff,35,0,35,0
1713325684762,CSS 202S,A01,494387,Staff,35,0,35,0
1713325685786,EAP 100,A00,516065,Staff,9792,0,9999,207
1713325686814,ECE 45,A01,507414,Staff,51,0,60,9
1713325687842,ECE 100,A01,507416,Baghdadchi; Saharnaz,11,0,20,9
1713325687842,ECE 100,A02,507418,Baghdadchi; Saharnaz,20,0,20,0
1713325688868,ECE 111,A01,507420,Staff,39,0,50,11
1713325689893,ECE 197,001,548057,Sievenpiper; Daniel F.,9998,0,9999,1
1713325690923,EDS 115,A00,507243,Choi; Bailey Miyeon,28,0,28,0
1713325691948,EDS 117,A01,494379,Staff,23,0,25,2
1713325692976,EDS 125,A00,507246,Hopkins; Megan Beth,29,0,30,1
1713325694000,EDS 128A,A01,507264,Fargason; Sharon Gayle,26,0,26,0
1713325695029,EDS 128B,A01,507293,Pappas; Elizabeth,30,0,30,0
1713325696052,EDS 139,A00,507294,Fargason; Sharon Gayle,30,0,30,0
1713325696052,EDS 139,B00,507313,Pappas; Elizabeth,30,0,30,0
1713325697081,EDS 201,A00,507315,Staff,26,0,30,4
1713325698109,EDS 203,A01,507317,Halter; Christopher P.,26,0,30,4
1713325699134,EDS 204R,A01,507319,Halter; Christopher P.,3,0,30,27
1713325699134,EDS 204R,B01,507331,Heinzman; Erica M.,28,0,30,2
1713325700158,EDS 206R,A00,507332,Staff,4,0,30,26
1713325700158,EDS 206R,B00,507343,Staff,28,0,30,2
1713325701190,EDS 250,A00,507344,Hemans; Patricia Ann Benitez,36,0,40,4
1713325702216,EDS 281,A00,507345,Daly; Alan J.,18,0,18,0
1713325703244,EDS 284,A00,507350,Daly; Alan J.,16,0,16,0
1713325704271,EDS 286,A00,507359,Fine; Sarah,18,0,18,0
1713325705299,EDS 289C,A01,507361,Daly; Alan J.,18,0,18,0
1713325706325,EDS 290,A00,507366,Hofstetter; Carolyn,15,0,15,0
1713325707349,LIGM 5A,A00,507421,Fischer-Grunski; Eva K,20,0,20,0
1713325708376,LIGM 5B,A00,507423,Fischer-Grunski; Eva K,20,0,20,0
1713325709407,LIGM 5C,A00,507425,Fischer-Grunski; Eva K,20,0,20,0
1713325710431,LIIT 5AS,A00,507427,Carnelos; Chiara,20,0,20,0
1713325711456,LIIT 5BS,A00,507430,Carnelos; Chiara,20,0,20,0
1713325712482,LIIT 5CS,A00,507432,Carnelos; Chiara,20,0,20,0
1713325713510,LISP 5A,A00,507541,Munoz Sanchez; Alicia,17,0,20,3
1713325714537,LISP 5B,A00,507671,Munoz Sanchez; Alicia,15,0,20,5
1713325715563,LISP 5C,A00,507696,Munoz Sanchez; Alicia,15,0,20,5
1713325716591,MAE 197,001,528363,Boechler; Nicholas Sebastia,9998,0,9999,1
1713325717621,MATH 197,001,523477,Kedlaya; Kiran S.,9999,0,9999,0
1713325717621,MATH 197,002,563811,Zhang; Danna,9999,0,9999,0
1713325718650,MCWP 40R,A00,518780,Staff,20,0,20,0
1713325718650,MCWP 40R,B00,518781,Staff,19,0,20,1
1713325718650,MCWP 40R,C00,518783,Staff,19,0,20,1
1713325719676,MCWP 50R,A00,518791,Staff,20,0,20,0
1713325719676,MCWP 50R,B00,518792,Staff,17,0,20,3
1713325719676,MCWP 50R,C00,518793,Staff,19,0,20,1
1713325719676,MCWP 50R,D00,518794,Staff,16,0,20,4
1713325719676,MCWP 50R,E00,518795,Staff,16,0,20,4
1713325719676,MCWP 50R,F00,518796,Staff,19,0,20,1
1713325719676,MCWP 50R,G00,518797,Staff,19,0,20,1
1713325720701,MMW 12R,A01,514034,Herbst; Matthew,15,0,16,1
1713325720701,MMW 12R,A02,514035,Herbst; Matthew,16,0,16,0
1713325721729,MMW 13R,A01,514037,Staff,12,0,16,4
1713325721729,MMW 13R,A02,514039,Staff,16,0,16,0
1713325723786,SIO 295LS,A00,523233,Staff,19,0,30,11
1713325724816,SIO 295S,A00,523232,Staff,19,0,30,11
1713325725843,SOCI 117,A01,494376,Staff,2,0,5,3
1713325726869,WES 237B,A00,494380,Staff,19,0,20,1
1713325728937,AESE 279B,A00,494370,Wade; Jon P,33,0,33,0
1713325729961,ANAR 135S,A00,494369,Braswell; Geoffrey E.,0,0,0,0
1713325730986,CAT 124RS,A01,519847,Geibel; William,17,0,20,3
1713325732013,CAT 125RS,A01,515971,Geibel; William,17,0,20,3
1713325733040,CLRE 250,A00,511389,Morris; Sheldon,9996,0,9999,3
1713325734070,CLRE 251,A00,507176,Mehta; Ravindra L.,9996,0,9999,3
1713325734070,CLRE 251,B00,511410,Mehta; Ravindra L.,9998,0,9999,1
1713325735095,CLRE 252,A00,507189,Cuomo; Raphael Eduardo,9998,0,9999,1
1713325736124,CLRE 253,A00,507199,Vaida; Florin,9997,0,9999,2
1713325736124,CLRE 253,B00,507202,Vaida; Florin,9999,0,9999,0
1713325737148,CLRE 259,A00,507211,Patel; Hemal,9996,0,9999,3
1713325738175,CLRE 260,A00,507221,Cuomo; Raphael Eduardo,9999,0,9999,0
1713325739200,CLRE 297,001,507242,Cuomo; Raphael Eduardo,9999,0,9999,0
1713325740224,CSE 191,A00,516875,Minnes Kemp; Mor Mia,9999,0,9999,0
1713325741254,CSS 201S,A01,494383,Staff,35,0,35,0
1713325742284,CSS 202S,A01,494387,Staff,35,0,35,0
1713325743311,EAP 100,A00,516065,Staff,9792,0,9999,207
1713325744339,ECE 45,A01,507414,Staff,51,0,60,9
1713325745367,ECE 100,A01,507416,Baghdadchi; Saharnaz,11,0,20,9
1713325745367,ECE 100,A02,507418,Baghdadchi; Saharnaz,20,0,20,0
1713325746391,ECE 111,A01,507420,Staff,39,0,50,11
1713325747417,ECE 197,001,548057,Sievenpiper; Daniel F.,9998,0,9999,1
1713325748441,EDS 115,A00,507243,Choi; Bailey Miyeon,28,0,28,0
1713325749469,EDS 117,A01,494379,Staff,23,0,25,2
1713325750494,EDS 125,A00,507246,Hopkins; Megan Beth,29,0,30,1
1713325751522,EDS 128A,A01,507264,Fargason; Sharon Gayle,26,0,26,0
1713325752605,EDS 128B,A01,507293,Pappas; Elizabeth,30,0,30,0
1713325753630,EDS 139,A00,507294,Fargason; Sharon Gayle,30,0,30,0
1713325753630,EDS 139,B00,507313,Pappas; Elizabeth,30,0,30,0
1713325754656,EDS 201,A00,507315,Staff,26,0,30,4
1713325755681,EDS 203,A01,507317,Halter; Christopher P.,26,0,30,4
1713325756706,EDS 204R,A01,507319,Halter; Christopher P.,3,0,30,27
1713325756706,EDS 204R,B01,507331,Heinzman; Erica M.,28,0,30,2
1713325757732,EDS 206R,A00,507332,Staff,4,0,30,26
1713325757732,EDS 206R,B00,507343,Staff,28,0,30,2
1713325758760,EDS 250,A00,507344,Hemans; Patricia Ann Benitez,36,0,40,4
1713325759787,EDS 281,A00,507345,Daly; Alan J.,18,0,18,0
1713325760815,EDS 284,A00,507350,Daly; Alan J.,16,0,16,0
1713325761841,EDS 286,A00,507359,Fine; Sarah,18,0,18,0
1713325762869,EDS 289C,A01,507361,Daly; Alan J.,18,0,18,0
1713325763897,EDS 290,A00,507366,Hofstetter; Carolyn,15,0,15,0
1713325764926,LIGM 5A,A00,507421,Fischer-Grunski; Eva K,20,0,20,0
1713325765957,LIGM 5B,A00,507423,Fischer-Grunski; Eva K,20,0,20,0
1713325766982,LIGM 5C,A00,507425,Fischer-Grunski; Eva K,20,0,20,0
1713325768010,LIIT 5AS,A00,507427,Carnelos; Chiara,20,0,20,0
1713325769035,LIIT 5BS,A00,507430,Carnelos; Chiara,20,0,20,0
1713325770063,LIIT 5CS,A00,507432,Carnelos; Chiara,20,0,20,0
1713325771087,LISP 5A,A00,507541,Munoz Sanchez; Alicia,17,0,20,3
1713325772114,LISP 5B,A00,507671,Munoz Sanchez; Alicia,15,0,20,5
1713325773139,LISP 5C,A00,507696,Munoz Sanchez; Alicia,15,0,20,5
1713325774167,MAE 197,001,528363,Boechler; Nicholas Sebastia,9998,0,9999,1
1713325775191,MATH 197,001,523477,Kedlaya; Kiran S.,9999,0,9999,0
1713325775191,MATH 197,002,563811,Zhang; Danna,9999,0,9999,0
1713325776215,MCWP 40R,A00,518780,Staff,20,0,20,0
1713325776215,MCWP 40R,B00,518781,Staff,19,0,20,1
1713325776215,MCWP 40R,C00,518783,Staff,19,0,20,1
1713325777240,MCWP 50R,A00,518791,Staff,20,0,20,0
1713325777240,MCWP 50R,B00,518792,Staff,17,0,20,3
1713325777240,MCWP 50R,C00,518793,Staff,19,0,20,1
1713325777240,MCWP 50R,D00,518794,Staff,16,0,20,4
1713325777240,MCWP 50R,E00,518795,Staff,16,0,20,4
1713325777240,MCWP 50R,F00,518796,Staff,19,0,20,1
1713325777240,MCWP 50R,G00,518797,Staff,19,0,20,1
1713325778265,MMW 12R,A01,514034,Herbst; Matthew,15,0,16,1
1713325778265,MMW 12R,A02,514035,Herbst; Matthew,16,0,16,0
1713325779289,MMW 13R,A01,514037,Staff,12,0,16,4
1713325779289,MMW 13R,A02,514039,Staff,16,0,16,0
1713325781341,SIO 295LS,A00,523233,Staff,19,0,30,11
1713325782365,SIO 295S,A00,523232,Staff,19,0,30,11
1713325783390,SOCI 117,A01,494376,Staff,2,0,5,3
1713325784419,WES 237B,A00,494380,Staff,19,0,20,1
1713325786485,AESE 279B,A00,494370,Wade; Jon P,33,0,33,0
1713325787512,ANAR 135S,A00,494369,Braswell; Geoffrey E.,0,0,0,0
1713325788539,CAT 124RS,A01,519847,Geibel; William,17,0,20,3
1713325789567,CAT 125RS,A01,515971,Geibel; William,17,0,20,3
1713325790595,CLRE 250,A00,511389,Morris; Sheldon,9996,0,9999,3
1713325791620,CLRE 251,A00,507176,Mehta; Ravindra L.,9996,0,9999,3
1713325791620,CLRE 251,B00,511410,Mehta; Ravindra L.,9998,0,9999,1
1713325792648,CLRE 252,A00,507189,Cuomo; Raphael Eduardo,9998,0,9999,1
1713325793673,CLRE 253,A00,507199,Vaida; Florin,9997,0,9999,2
1713325793673,CLRE 253,B00,507202,Vaida; Florin,9999,0,9999,0
1713325794698,CLRE 259,A00,507211,Patel; Hemal,9996,0,9999,3
1713325795723,CLRE 260,A00,507221,Cuomo; Raphael Eduardo,9999,0,9999,0
1713325796749,CLRE 297,001,507242,Cuomo; Raphael Eduardo,9999,0,9999,0
1713325797777,CSE 191,A00,516875,Minnes Kemp; Mor Mia,9999,0,9999,0
1713325798803,CSS 201S,A01,494383,Staff,35,0,35,0
1713325799831,CSS 202S,A01,494387,Staff,35,0,35,0
1713325800858,EAP 100,A00,516065,Staff,9792,0,9999,207
1713325801885,ECE 45,A01,507414,Staff,51,0,60,9
1713325802913,ECE 100,A01,507416,Baghdadchi; Saharnaz,11,0,20,9
1713325802913,ECE 100,A02,507418,Baghdadchi; Saharnaz,20,0,20,0
1713325803937,ECE 111,A01,507420,Staff,39,0,50,11
1713325804965,ECE 197,001,548057,Sievenpiper; Daniel F.,9998,0,9999,1
1713325805990,EDS 115,A00,507243,Choi; Bailey Miyeon,28,0,28,0
1713325807017,EDS 117,A01,494379,Staff,23,0,25,2
1713325808041,EDS 125,A00,507246,Hopkins; Megan Beth,29,0,30,1
1713325809070,EDS 128A,A01,507264,Fargason; Sharon Gayle,26,0,26,0
1713325810095,EDS 128B,A01,507293,Pappas; Elizabeth,30,0,30,0
1713325811125,EDS 139,A00,507294,Fargason; Sharon Gayle,30,0,30,0
1713325811125,EDS 139,B00,507313,Pappas; Elizabeth,30,0,30,0
1713325812148,EDS 201,A00,507315,Staff,26,0,30,4
1713325813177,EDS 203,A01,507317,Halter; Christopher P.,26,0,30,4
1713325814206,EDS 204R,A01,507319,Halter; Christopher P.,3,0,30,27
1713325814206,EDS 204R,B01,507331,Heinzman; Erica M.,28,0,30,2
1713325815234,EDS 206R,A00,507332,Staff,4,0,30,26
1713325815234,EDS 206R,B00,507343,Staff,28,0,30,2
1713325816262,EDS 250,A00,507344,Hemans; Patricia Ann Benitez,36,0,40,4
1713325817286,EDS 281,A00,507345,Daly; Alan J.,18,0,18,0
1713325818311,EDS 284,A00,507350,Daly; Alan J.,16,0,16,0
1713325819338,EDS 286,A00,507359,Fine; Sarah,18,0,18,0
1713325820366,EDS 289C,A01,507361,Daly; Alan J.,18,0,18,0
1713325821391,EDS 290,A00,507366,Hofstetter; Carolyn,15,0,15,0
1713325822416,LIGM 5A,A00,507421,Fischer-Grunski; Eva K,20,0,20,0
1713325823446,LIGM 5B,A00,507423,Fischer-Grunski; Eva K,20,0,20,0
1713325824470,LIGM 5C,A00,507425,Fischer-Grunski; Eva K,20,0,20,0
1713325825499,LIIT 5AS,A00,507427,Carnelos; Chiara,20,0,20,0
1713325826524,LIIT 5BS,A00,507430,Carnelos; Chiara,20,0,20,0
1713325827549,LIIT 5CS,A00,507432,Carnelos; Chiara,20,0,20,0
1713325828574,LISP 5A,A00,507541,Munoz Sanchez; Alicia,17,0,20,3
1713325829598,LISP 5B,A00,507671,Munoz Sanchez; Alicia,15,0,20,5
1713325830628,LISP 5C,A00,507696,Munoz Sanchez; Alicia,15,0,20,5
1713325831654,MAE 197,001,528363,Boechler; Nicholas Sebastia,9998,0,9999,1
1713325832680,MATH 197,001,523477,Kedlaya; Kiran S.,9999,0,9999,0
1713325832680,MATH 197,002,563811,Zhang; Danna,9999,0,9999,0
1713325833705,MCWP 40R,A00,518780,Staff,20,0,20,0
1713325833705,MCWP 40R,B00,518781,Staff,19,0,20,1
1713325833705,MCWP 40R,C00,518783,Staff,19,0,20,1
1713325834747,MCWP 50R,A00,518791,Staff,20,0,20,0
1713325834747,MCWP 50R,B00,518792,Staff,17,0,20,3
1713325834747,MCWP 50R,C00,518793,Staff,19,0,20,1
1713325834747,MCWP 50R,D00,518794,Staff,16,0,20,4
1713325834747,MCWP 50R,E00,518795,Staff,16,0,20,4
1713325834747,MCWP 50R,F00,518796,Staff,19,0,20,1
1713325834747,MCWP 50R,G00,518797,Staff,19,0,20,1
1713325835776,MMW 12R,A01,514034,Herbst; Matthew,15,0,16,1
1713325835776,MMW 12R,A02,514035,Herbst; Matthew,16,0,16,0
1713325836800,MMW 13R,A01,514037,Staff,12,0,16,4
1713325836800,MMW 13R,A02,514039,Staff,16,0,16,0
1713325838857,SIO 295LS,A00,523233,Staff,19,0,30,11
1713325839885,SIO 295S,A00,523232,Staff,19,0,30,11
1713325840914,SOCI 117,A01,494376,Staff,2,0,5,3
1713325841938,WES 237B,A00,494380,Staff,19,0,20,1
1713325843999,AESE 279B,A00,494370,Wade; Jon P,33,0,33,0
1713325845024,ANAR 135S,A00,494369,Braswell; Geoffrey E.,0,0,0,0
1713325846051,CAT 124RS,A01,519847,Geibel; William,17,0,20,3
1713325847075,CAT 125RS,A01,515971,Geibel; William,17,0,20,3
1713325848101,CLRE 250,A00,511389,Morris; Sheldon,9996,0,9999,3
1713325849131,CLRE 251,A00,507176,Mehta; Ravindra L.,9996,0,9999,3
1713325849131,CLRE 251,B00,511410,Mehta; Ravindra L.,9998,0,9999,1
1713325850156,CLRE 252,A00,507189,Cuomo; Raphael Eduardo,9998,0,9999,1
1713325851185,CLRE 253,A00,507199,Vaida; Florin,9997,0,9999,2
1713325851185,CLRE 253,B00,507202,Vaida; Florin,9999,0,9999,0
1713325852211,CLRE 259,A00,507211,Patel; Hemal,9996,0,9999,3
1713325853236,CLRE 260,A00,507221,Cuomo; Raphael Eduardo,9999,0,9999,0
1713325854265,CLRE 297,001,507242,Cuomo; Raphael Eduardo,9999,0,9999,0
1713325855290,CSE 191,A00,516875,Minnes Kemp; Mor Mia,9999,0,9999,0
1713325856369,CSS 201S,A01,494383,Staff,35,0,35,0
1713325857394,CSS 202S,A01,494387,Staff,35,0,35,0
1713325858419,EAP 100,A00,516065,Staff,9792,0,9999,207
1713325859448,ECE 45,A01,507414,Staff,51,0,60,9
1713325860471,ECE 100,A01,507416,Baghdadchi; Saharnaz,11,0,20,9
1713325860471,ECE 100,A02,507418,Baghdadchi; Saharnaz,20,0,20,0
1713325861497,ECE 111,A01,507420,Staff,39,0,50,11
1713325862525,ECE 197,001,548057,Sievenpiper; Daniel F.,9998,0,9999,1
1713325863550,EDS 115,A00,507243,Choi; Bailey Miyeon,28,0,28,0
1713325864575,EDS 117,A01,494379,Staff,23,0,25,2
1713325865606,EDS 125,A00,507246,Hopkins; Megan Beth,29,0,30,1
1713325866630,EDS 128A,A01,507264,Fargason; Sharon Gayle,26,0,26,0
1713325867660,EDS 128B,A01,507293,Pappas; Elizabeth,30,0,30,0
1713325868689,EDS 139,A00,507294,Fargason; Sharon Gayle,30,0,30,0
1713325868689,EDS 139,B00,507313,Pappas; Elizabeth,30,0,30,0
1713325869717,EDS 201,A00,507315,Staff,26,0,30,4
1713325870742,EDS 203,A01,507317,Halter; Christopher P.,26,0,30,4
1713325871767,EDS 204R,A01,507319,Halter; Christopher P.,3,0,30,27
1713325871767,EDS 204R,B01,507331,Heinzman; Erica M.,28,0,30,2
1713325872791,EDS 206R,A00,507332,Staff,4,0,30,26
1713325872791,EDS 206R,B00,507343,Staff,28,0,30,2
1713325873818,EDS 250,A00,507344,Hemans; Patricia Ann Benitez,36,0,40,4
1713325874841,EDS 281,A00,507345,Daly; Alan J.,18,0,18,0
1713325875867,EDS 284,A00,507350,Daly; Alan J.,16,0,16,0
1713325876890,EDS 286,A00,507359,Fine; Sarah,18,0,18,0
1713325877918,EDS 289C,A01,507361,Daly; Alan J.,18,0,18,0
1713325878944,EDS 290,A00,507366,Hofstetter; Carolyn,15,0,15,0
1713325879976,LIGM 5A,A00,507421,Fischer-Grunski; Eva K,20,0,20,0
1713325881000,LIGM 5B,A00,507423,Fischer-Grunski; Eva K,20,0,20,0
1713325882025,LIGM 5C,A00,507425,Fischer-Grunski; Eva K,20,0,20,0
1713325883053,LIIT 5AS,A00,507427,Carnelos; Chiara,20,0,20,0
1713325884078,LIIT 5BS,A00,507430,Carnelos; Chiara,20,0,20,0
1713325885102,LIIT 5CS,A00,507432,Carnelos; Chiara,20,0,20,0
1713325886133,LISP 5A,A00,507541,Munoz Sanchez; Alicia,17,0,20,3
1713325887157,LISP 5B,A00,507671,Munoz Sanchez; Alicia,15,0,20,5
1713325888187,LISP 5C,A00,507696,Munoz Sanchez; Alicia,15,0,20,5
1713325889212,MAE 197,001,528363,Boechler; Nicholas Sebastia,9998,0,9999,1
1713325890237,MATH 197,001,523477,Kedlaya; Kiran S.,9999,0,9999,0
1713325890237,MATH 197,002,563811,Zhang; Danna,9999,0,9999,0
1713325891263,MCWP 40R,A00,518780,Staff,20,0,20,0
1713325891263,MCWP 40R,B00,518781,Staff,19,0,20,1
1713325891263,MCWP 40R,C00,518783,Staff,19,0,20,1
1713325892288,MCWP 50R,A00,518791,Staff,20,0,20,0
1713325892288,MCWP 50R,B00,518792,Staff,17,0,20,3
1713325892288,MCWP 50R,C00,518793,Staff,19,0,20,1
1713325892288,MCWP 50R,D00,518794,Staff,16,0,20,4
1713325892288,MCWP 50R,E00,518795,Staff,16,0,20,4
1713325892288,MCWP 50R,F00,518796,Staff,19,0,20,1
1713325892288,MCWP 50R,G00,518797,Staff,19,0,20,1
1713325893314,MMW 12R,A01,514034,Herbst; Matthew,15,0,16,1
1713325893314,MMW 12R,A02,514035,Herbst; Matthew,16,0,16,0
1713325894338,MMW 13R,A01,514037,Staff,12,0,16,4
1713325894338,MMW 13R,A02,514039,Staff,16,0,16,0
1713325896386,SIO 295LS,A00,523233,Staff,19,0,30,11
1713325897413,SIO 295S,A00,523232,Staff,19,0,30,11
1713325898442,SOCI 117,A01,494376,Staff,2,0,5,3
1713325899465,WES 237B,A00,494380,Staff,19,0,20,1
1713325901528,AESE 279B,A00,494370,Wade; Jon P,33,0,33,0
1713325902556,ANAR 135S,A00,494369,Braswell; Geoffrey E.,0,0,0,0
1713325903584,CAT 124RS,A01,519847,Geibel; William,17,0,20,3
1713325904609,CAT 125RS,A01,515971,Geibel; William,17,0,20,3
1713325905634,CLRE 250,A00,511389,Morris; Sheldon,9996,0,9999,3
1713325906660,CLRE 251,A00,507176,Mehta; Ravindra L.,9996,0,9999,3
1713325906660,CLRE 251,B00,511410,Mehta; Ravindra L.,9998,0,9999,1
1713325907686,CLRE 252,A00,507189,Cuomo; Raphael Eduardo,9998,0,9999,1
1713325908712,CLRE 253,A00,507199,Vaida; Florin,9997,0,9999,2
1713325908712,CLRE 253,B00,507202,Vaida; Florin,9999,0,9999,0
1713325909740,CLRE 259,A00,507211,Patel; Hemal,9996,0,9999,3
1713325910767,CLRE 260,A00,507221,Cuomo; Raphael Eduardo,9999,0,9999,0
1713325911794,CLRE 297,001,507242,Cuomo; Raphael Eduardo,9999,0,9999,0
1713325912818,CSE 191,A00,516875,Minnes Kemp; Mor Mia,9999,0,9999,0
1713325913843,CSS 201S,A01,494383,Staff,35,0,35,0
1713325914872,CSS 202S,A01,494387,Staff,35,0,35,0
1713325915898,EAP 100,A00,516065,Staff,9792,0,9999,207
1713325916927,ECE 45,A01,507414,Staff,51,0,60,9
1713325917953,ECE 100,A01,507416,Baghdadchi; Saharnaz,11,0,20,9
1713325917953,ECE 100,A02,507418,Baghdadchi; Saharnaz,20,0,20,0
1713325918977,ECE 111,A01,507420,Staff,39,0,50,11
1713325920005,ECE 197,001,548057,Sievenpiper; Daniel F.,9998,0,9999,1
1713325921028,EDS 115,A00,507243,Choi; Bailey Miyeon,28,0,28,0
1713325922055,EDS 117,A01,494379,Staff,23,0,25,2
1713325923083,EDS 125,A00,507246,Hopkins; Megan Beth,29,0,30,1
1713325924112,EDS 128A,A01,507264,Fargason; Sharon Gayle,26,0,26,0
1713325925136,EDS 128B,A01,507293,Pappas; Elizabeth,30,0,30,0
1713325926165,EDS 139,A00,507294,Fargason; Sharon Gayle,30,0,30,0
1713325926165,EDS 139,B00,507313,Pappas; Elizabeth,30,0,30,0
1713325927190,EDS 201,A00,507315,Staff,26,0,30,4
1713325928215,EDS 203,A01,507317,Halter; Christopher P.,26,0,30,4
1713325929238,EDS 204R,A01,507319,Halter; Christopher P.,3,0,30,27
1713325929238,EDS 204R,B01,507331,Heinzman; Erica M.,28,0,30,2
1713325930266,EDS 206R,A00,507332,Staff,4,0,30,26
1713325930266,EDS 206R,B00,507343,Staff,28,0,30,2
1713325931293,EDS 250,A00,507344,Hemans; Patricia Ann Benitez,36,0,40,4
1713325932323,EDS 281,A00,507345,Daly; Alan J.,18,0,18,0
1713325933349,EDS 284,A00,507350,Daly; Alan J.,16,0,16,0
1713325934377,EDS 286,A00,507359,Fine; Sarah,18,0,18,0
1713325935405,EDS 289C,A01,507361,Daly; Alan J.,18,0,18,0
1713325936431,EDS 290,A00,507366,Hofstetter; Carolyn,15,0,15,0
1713325937457,LIGM 5A,A00,507421,Fischer-Grunski; Eva K,20,0,20,0
1713325938481,LIGM 5B,A00,507423,Fischer-Grunski; Eva K,20,0,20,0
1713325939507,LIGM 5C,A00,507425,Fischer-Grunski; Eva K,20,0,20,0
1713325940532,LIIT 5AS,A00,507427,Carnelos; Chiara,20,0,20,0
1713325941561,LIIT 5BS,A00,507430,Carnelos; Chiara,20,0,20,0
1713325942586,LIIT 5CS,A00,507432,Carnelos; Chiara,20,0,20,0
1713325943610,LISP 5A,A00,507541,Munoz Sanchez; Alicia,17,0,20,3
1713325944633,LISP 5B,A00,507671,Munoz Sanchez; Alicia,15,0,20,5
1713325945660,LISP 5C,A00,507696,Munoz Sanchez; Alicia,15,0,20,5
1713325946685,MAE 197,001,528363,Boechler; Nicholas Sebastia,9998,0,9999,1
1713325947713,MATH 197,001,523477,Kedlaya; Kiran S.,9999,0,9999,0
1713325947713,MATH 197,002,563811,Zhang; Danna,9999,0,9999,0
1713325948737,MCWP 40R,A00,518780,Staff,20,0,20,0
1713325948737,MCWP 40R,B00,518781,Staff,19,0,20,1
1713325948737,MCWP 40R,C00,518783,Staff,19,0,20,1
1713325949761,MCWP 50R,A00,518791,Staff,20,0,20,0
1713325949761,MCWP 50R,B00,518792,Staff,17,0,20,3
1713325949761,MCWP 50R,C00,518793,Staff,19,0,20,1
1713325949761,MCWP 50R,D00,518794,Staff,16,0,20,4
1713325949761,MCWP 50R,E00,518795,Staff,16,0,20,4
1713325949761,MCWP 50R,F00,518796,Staff,19,0,20,1
1713325949761,MCWP 50R,G00,518797,Staff,19,0,20,1
1713325950790,MMW 12R,A01,514034,Herbst; Matthew,15,0,16,1
1713325950790,MMW 12R,A02,514035,Herbst; Matthew,16,0,16,0
1713325951817,MMW 13R,A01,514037,Staff,12,0,16,4
1713325951817,MMW 13R,A02,514039,Staff,16,0,16,0
1713325953867,SIO 295LS,A00,523233,Staff,19,0,30,11
1713325954892,SIO 295S,A00,523232,Staff,19,0,30,11
1713325955919,SOCI 117,A01,494376,Staff,2,0,5,3
1713325956947,WES 237B,A00,494380,Staff,19,0,20,1
1713325959006,AESE 279B,A00,494370,Wade; Jon P,33,0,33,0
1713325960089,ANAR 135S,A00,494369,Braswell; Geoffrey E.,0,0,0,0
1713325961114,CAT 124RS,A01,519847,Geibel; William,17,0,20,3
1713325962142,CAT 125RS,A01,515971,Geibel; William,17,0,20,3
1713325963168,CLRE 250,A00,511389,Morris; Sheldon,9996,0,9999,3
1713325964196,CLRE 251,A00,507176,Mehta; Ravindra L.,9996,0,9999,3
1713325964196,CLRE 251,B00,511410,Mehta; Ravindra L.,9998,0,9999,1
1713325965222,CLRE 252,A00,507189,Cuomo; Raphael Eduardo,9998,0,9999,1
1713325966247,CLRE 253,A00,507199,Vaida; Florin,9997,0,9999,2
1713325966247,CLRE 253,B00,507202,Vaida; Florin,9999,0,9999,0
1713325967276,CLRE 259,A00,507211,Patel; Hemal,9996,0,9999,3
1713325968299,CLRE 260,A00,507221,Cuomo; Raphael Eduardo,9999,0,9999,0
1713325969327,CLRE 297,001,507242,Cuomo; Raphael Eduardo,9999,0,9999,0
1713325970355,CSE 191,A00,516875,Minnes Kemp; Mor Mia,9999,0,9999,0
1713325971381,CSS 201S,A01,494383,Staff,35,0,35,0
1713325972411,CSS 202S,A01,494387,Staff,35,0,35,0
1713325973436,EAP 100,A00,516065,Staff,9792,0,9999,207
1713325974461,ECE 45,A01,507414,Staff,51,0,60,9
1713325975489,ECE 100,A01,507416,Baghdadchi; Saharnaz,11,0,20,9
1713325975489,ECE 100,A02,507418,Baghdadchi; Saharnaz,20,0,20,0
1713325976513,ECE 111,A01,507420,Staff,39,0,50,11
1713325977539,ECE 197,001,548057,Sievenpiper; Daniel F.,9998,0,9999,1
1713325978568,EDS 115,A00,507243,Choi; Bailey Miyeon,28,0,28,0
1713325979592,EDS 117,A01,494379,Staff,23,0,25,2
1713325980621,EDS 125,A00,507246,Hopkins; Megan Beth,29,0,30,1
1713325981650,EDS 128A,A01,507264,Fargason; Sharon Gayle,26,0,26,0
1713325982679,EDS 128B,A01,507293,Pappas; Elizabeth,30,0,30,0
1713325983707,EDS 139,A00,507294,Fargason; Sharon Gayle,30,0,30,0
1713325983707,EDS 139,B00,507313,Pappas; Elizabeth,30,0,30,0
1713325984732,EDS 201,A00,507315,Staff,26,0,30,4
1713325985758,EDS 203,A01,507317,Halter; Christopher P.,26,0,30,4
1713325986784,EDS 204R,A01,507319,Halter; Christopher P.,3,0,30,27
1713325986784,EDS 204R,B01,507331,Heinzman; Erica M.,28,0,30,2
1713325987809,EDS 206R,A00,507332,Staff,4,0,30,26
1713325987809,EDS 206R,B00,507343,Staff,28,0,30,2
1713325988834,EDS 250,A00,507344,Hemans; Patricia Ann Benitez,36,0,40,4
1713325989858,EDS 281,A00,507345,Daly; Alan J.,18,0,18,0
1713325990886,EDS 284,A00,507350,Daly; Alan J.,16,0,16,0
1713325991911,EDS 286,A00,507359,Fine; Sarah,18,0,18,0
1713325992935,EDS 289C,A01,507361,Daly; Alan J.,18,0,18,0
1713325993960,EDS 290,A00,507366,Hofstetter; Carolyn,15,0,15,0
1713325994986,LIGM 5A,A00,507421,Fischer-Grunski; Eva K,20,0,20,0
1713325996014,LIGM 5B,A00,507423,Fischer-Grunski; Eva K,20,0,20,0
1713325997039,LIGM 5C,A00,507425,Fischer-Grunski; Eva K,20,0,20,0
1713325998065,LIIT 5AS,A00,507427,Carnelos; Chiara,20,0,20,0
1713325999090,LIIT 5BS,A00,507430,Carnelos; Chiara,20,0,20,0
1713326000115,LIIT 5CS,A00,507432,Carnelos; Chiara,20,0,20,0
1713326001145,LISP 5A,A00,507541,Munoz Sanchez; Alicia,17,0,20,3
1713326002173,LISP 5B,A00,507671,Munoz Sanchez; Alicia,15,0,20,5
1713326003199,LISP 5C,A00,507696,Munoz Sanchez; Alicia,15,0,20,5
1713326004227,MAE 197,001,528363,Boechler; Nicholas Sebastia,9998,0,9999,1
1713326005255,MATH 197,001,523477,Kedlaya; Kiran S.,9999,0,9999,0
1713326005255,MATH 197,002,563811,Zhang; Danna,9999,0,9999,0
1713326006281,MCWP 40R,A00,518780,Staff,20,0,20,0
1713326006281,MCWP 40R,B00,518781,Staff,19,0,20,1
1713326006281,MCWP 40R,C00,518783,Staff,19,0,20,1
1713326007310,MCWP 50R,A00,518791,Staff,20,0,20,0
1713326007310,MCWP 50R,B00,518792,Staff,17,0,20,3
1713326007310,MCWP 50R,C00,518793,Staff,19,0,20,1
1713326007310,MCWP 50R,D00,518794,Staff,16,0,20,4
1713326007310,MCWP 50R,E00,518795,Staff,16,0,20,4
1713326007310,MCWP 50R,F00,518796,Staff,19,0,20,1
1713326007310,MCWP 50R,G00,518797,Staff,19,0,20,1
1713326008338,MMW 12R,A01,514034,Herbst; Matthew,15,0,16,1
1713326008338,MMW 12R,A02,514035,Herbst; Matthew,16,0,16,0
1713326009363,MMW 13R,A01,514037,Staff,12,0,16,4
1713326009363,MMW 13R,A02,514039,Staff,16,0,16,0
1713326011417,SIO 295LS,A00,523233,Staff,19,0,30,11
1713326012445,SIO 295S,A00,523232,Staff,19,0,30,11
1713326013469,SOCI 117,A01,494376,Staff,2,0,5,3
1713326014493,WES 237B,A00,494380,Staff,19,0,20,1
1713326016545,AESE 279B,A00,494370,Wade; Jon P,33,0,33,0
1713326017570,ANAR 135S,A00,494369,Braswell; Geoffrey E.,0,0,0,0
1713326018593,CAT 124RS,A01,519847,Geibel; William,17,0,20,3
1713326019618,CAT 125RS,A01,515971,Geibel; William,17,0,20,3
1713326020642,CLRE 250,A00,511389,Morris; Sheldon,9996,0,9999,3
1713326021667,CLRE 251,A00,507176,Mehta; Ravindra L.,9996,0,9999,3
1713326021667,CLRE 251,B00,511410,Mehta; Ravindra L.,9998,0,9999,1
1713326022692,CLRE 252,A00,507189,Cuomo; Raphael Eduardo,9998,0,9999,1
1713326023720,CLRE 253,A00,507199,Vaida; Florin,9997,0,9999,2
1713326023720,CLRE 253,B00,507202,Vaida; Florin,9999,0,9999,0
1713326024745,CLRE 259,A00,507211,Patel; Hemal,9996,0,9999,3
1713326025774,CLRE 260,A00,507221,Cuomo; Raphael Eduardo,9999,0,9999,0
1713326026803,CLRE 297,001,507242,Cuomo; Raphael Eduardo,9999,0,9999,0
1713326027829,CSE 191,A00,516875,Minnes Kemp; Mor Mia,9999,0,9999,0
1713326028858,CSS 201S,A01,494383,Staff,35,0,35,0
1713326029883,CSS 202S,A01,494387,Staff,35,0,35,0
1713326030908,EAP 100,A00,516065,Staff,9792,0,9999,207
1713326031933,ECE 45,A01,507414,Staff,51,0,60,9
1713326032958,ECE 100,A01,507416,Baghdadchi; Saharnaz,11,0,20,9
1713326032958,ECE 100,A02,507418,Baghdadchi; Saharnaz,20,0,20,0
1713326033986,ECE 111,A01,507420,Staff,39,0,50,11
1713326035016,ECE 197,001,548057,Sievenpiper; Daniel F.,9998,0,9999,1
1713326036041,EDS 115,A00,507243,Choi; Bailey Miyeon,28,0,28,0
1713326037068,EDS 117,A01,494379,Staff,23,0,25,2
1713326038094,EDS 125,A00,507246,Hopkins; Megan Beth,29,0,30,1
1713326039119,EDS 128A,A01,507264,Fargason; Sharon Gayle,26,0,26,0
1713326040147,EDS 128B,A01,507293,Pappas; Elizabeth,30,0,30,0
1713326041173,EDS 139,A00,507294,Fargason; Sharon Gayle,30,0,30,0
1713326041173,EDS 139,B00,507313,Pappas; Elizabeth,30,0,30,0
1713326042198,EDS 201,A00,507315,Staff,26,0,30,4
1713326043270,EDS 203,A01,507317,Halter; Christopher P.,26,0,30,4
1713326044297,EDS 204R,A01,507319,Halter; Christopher P.,3,0,30,27
1713326044297,EDS 204R,B01,507331,Heinzman; Erica M.,28,0,30,2
1713326045320,EDS 206R,A00,507332,Staff,4,0,30,26
1713326045320,EDS 206R,B00,507343,Staff,28,0,30,2
1713326046348,EDS 250,A00,507344,Hemans; Patricia Ann Benitez,36,0,40,4
1713326047374,EDS 281,A00,507345,Daly; Alan J.,18,0,18,0
1713326048402,EDS 284,A00,507350,Daly; Alan J.,16,0,16,0
1713326049426,EDS 286,A00,507359,Fine; Sarah,18,0,18,0
1713326050451,EDS 289C,A01,507361,Daly; Alan J.,18,0,18,0
1713326051475,EDS 290,A00,507366,Hofstetter; Carolyn,15,0,15,0
1713326052504,LIGM 5A,A00,507421,Fischer-Grunski; Eva K,20,0,20,0
1713326053532,LIGM 5B,A00,507423,Fischer-Grunski; Eva K,20,0,20,0
1713326054558,LIGM 5C,A00,507425,Fischer-Grunski; Eva K,20,0,20,0
1713326055584,LIIT 5AS,A00,507427,Carnelos; Chiara,20,0,20,0
1713326056612,LIIT 5BS,A00,507430,Carnelos; Chiara,20,0,20,0
1713326057637,LIIT 5CS,A00,507432,Carnelos; Chiara,20,0,20,0
1713326058663,LISP 5A,A00,507541,Munoz Sanchez; Alicia,17,0,20,3
1713326059689,LISP 5B,A00,507671,Munoz Sanchez; Alicia,15,0,20,5
1713326060714,LISP 5C,A00,507696,Munoz Sanchez; Alicia,15,0,20,5
1713326061739,MAE 197,001,528363,Boechler; Nicholas Sebastia,9998,0,9999,1
1713326062767,MATH 197,001,523477,Kedlaya; Kiran S.,9999,0,9999,0
1713326062767,MATH 197,002,563811,Zhang; Danna,9999,0,9999,0
1713326063848,MCWP 40R,A00,518780,Staff,20,0,20,0
1713326063848,MCWP 40R,B00,518781,Staff,19,0,20,1
1713326063848,MCWP 40R,C00,518783,Staff,19,0,20,1
1713326064877,MCWP 50R,A00,518791,Staff,20,0,20,0
1713326064877,MCWP 50R,B00,518792,Staff,17,0,20,3
1713326064877,MCWP 50R,C00,518793,Staff,19,0,20,1
1713326064877,MCWP 50R,D00,518794,Staff,16,0,20,4
1713326064877,MCWP 50R,E00,518795,Staff,16,0,20,4
1713326064877,MCWP 50R,F00,518796,Staff,19,0,20,1
1713326064877,MCWP 50R,G00,518797,Staff,19,0,20,1
1713326065904,MMW 12R,A01,514034,Herbst; Matthew,15,0,16,1
1713326065904,MMW 12R,A02,514035,Herbst; Matthew,16,0,16,0
1713326066935,MMW 13R,A01,514037,Staff,12,0,16,4
1713326066935,MMW 13R,A02,514039,Staff,16,0,16,0
1713326068988,SIO 295LS,A00,523233,Staff,19,0,30,11
1713326070014,SIO 295S,A00,523232,Staff,19,0,30,11
1713326071041,SOCI 117,A01,494376,Staff,2,0,5,3
1713326072068,WES 237B,A00,494380,Staff,19,0,20,1
1713326074125,AESE 279B,A00,494370,Wade; Jon P,33,0,33,0
1713326075150,ANAR 135S,A00,494369,Braswell; Geoffrey E.,0,0,0,0
1713326076175,CAT 124RS,A01,519847,Geibel; William,17,0,20,3
1713326077199,CAT 125RS,A01,515971,Geibel; William,17,0,20,3
1713326078224,CLRE 250,A00,511389,Morris; Sheldon,9996,0,9999,3
1713326079250,CLRE 251,A00,507176,Mehta; Ravindra L.,9996,0,9999,3
1713326079250,CLRE 251,B00,511410,Mehta; Ravindra L.,9998,0,9999,1
1713326080280,CLRE 252,A00,507189,Cuomo; Raphael Eduardo,9998,0,9999,1
1713326081309,CLRE 253,A00,507199,Vaida; Florin,9997,0,9999,2
1713326081309,CLRE 253,B00,507202,Vaida; Florin,9999,0,9999,0
1713326082333,CLRE 259,A00,507211,Patel; Hemal,9996,0,9999,3
1713326083363,CLRE 260,A00,507221,Cuomo; Raphael Eduardo,9999,0,9999,0
1713326084387,CLRE 297,001,507242,Cuomo; Raphael Eduardo,9999,0,9999,0
1713326085415,CSE 191,A00,516875,Minnes Kemp; Mor Mia,9999,0,9999,0
1713326086443,CSS 201S,A01,494383,Staff,35,0,35,0
1713326087469,CSS 202S,A01,494387,Staff,35,0,35,0
1713326088495,EAP 100,A00,516065,Staff,9792,0,9999,207
1713326089522,ECE 45,A01,507414,Staff,51,0,60,9
1713326090552,ECE 100,A01,507416,Baghdadchi; Saharnaz,11,0,20,9
1713326090552,ECE 100,A02,507418,Baghdadchi; Saharnaz,20,0,20,0
1713326091577,ECE 111,A01,507420,Staff,39,0,50,11
1713326092604,ECE 197,001,548057,Sievenpiper; Daniel F.,9998,0,9999,1
1713326093628,EDS 115,A00,507243,Choi; Bailey Miyeon,28,0,28,0
1713326094654,EDS 117,A01,494379,Staff,23,0,25,2
1713326095687,EDS 125,A00,507246,Hopkins; Megan Beth,29,0,30,1
1713326096711,EDS 128A,A01,507264,Fargason; Sharon Gayle,26,0,26,0
1713326097745,EDS 128B,A01,507293,Pappas; Elizabeth,30,0,30,0
1713326098769,EDS 139,A00,507294,Fargason; Sharon Gayle,30,0,30,0
1713326098769,EDS 139,B00,507313,Pappas; Elizabeth,30,0,30,0
1713326099795,EDS 201,A00,507315,Staff,26,0,30,4
1713326100819,EDS 203,A01,507317,Halter; Christopher P.,26,0,30,4
1713326101845,EDS 204R,A01,507319,Halter; Christopher P.,3,0,30,27
1713326101845,EDS 204R,B01,507331,Heinzman; Erica M.,28,0,30,2
1713326102870,EDS 206R,A00,507332,Staff,4,0,30,26
1713326102870,EDS 206R,B00,507343,Staff,28,0,30,2
1713326103900,EDS 250,A00,507344,Hemans; Patricia Ann Benitez,36,0,40,4
1713326105011,EDS 281,A00,507345,Daly; Alan J.,18,0,18,0
1713326106037,EDS 284,A00,507350,Daly; Alan J.,16,0,16,0
1713326107063,EDS 286,A00,507359,Fine; Sarah,18,0,18,0
1713326108089,EDS 289C,A01,507361,Daly; Alan J.,18,0,18,0
1713326109113,EDS 290,A00,507366,Hofstetter; Carolyn,15,0,15,0
1713326110142,LIGM 5A,A00,507421,Fischer-Grunski; Eva K,20,0,20,0
1713326111170,LIGM 5B,A00,507423,Fischer-Grunski; Eva K,20,0,20,0
1713326112196,LIGM 5C,A00,507425,Fischer-Grunski; Eva K,20,0,20,0
1713326113315,LIIT 5AS,A00,507427,Carnelos; Chiara,20,0,20,0
1713326114339,LIIT 5BS,A00,507430,Carnelos; Chiara,20,0,20,0
1713326115365,LIIT 5CS,A00,507432,Carnelos; Chiara,20,0,20,0
1713326116390,LISP 5A,A00,507541,Munoz Sanchez; Alicia,17,0,20,3
1713326117414,LISP 5B,A00,507671,Munoz Sanchez; Alicia,15,0,20,5
1713326118437,LISP 5C,A00,507696,Munoz Sanchez; Alicia,15,0,20,5
1713326119462,MAE 197,001,528363,Boechler; Nicholas Sebastia,9998,0,9999,1
1713326120490,MATH 197,001,523477,Kedlaya; Kiran S.,9999,0,9999,0
1713326120490,MATH 197,002,563811,Zhang; Danna,9999,0,9999,0
1713326121517,MCWP 40R,A00,518780,Staff,20,0,20,0
1713326121517,MCWP 40R,B00,518781,Staff,19,0,20,1
1713326121517,MCWP 40R,C00,518783,Staff,19,0,20,1
1713326122549,MCWP 50R,A00,518791,Staff,20,0,20,0
1713326122549,MCWP 50R,B00,518792,Staff,17,0,20,3
1713326122549,MCWP 50R,C00,518793,Staff,19,0,20,1
1713326122549,MCWP 50R,D00,518794,Staff,16,0,20,4
1713326122549,MCWP 50R,E00,518795,Staff,16,0,20,4
1713326122549,MCWP 50R,F00,518796,Staff,19,0,20,1
1713326122549,MCWP 50R,G00,518797,Staff,19,0,20,1
1713326123575,MMW 12R,A01,514034,Herbst; Matthew,15,0,16,1
1713326123575,MMW 12R,A02,514035,Herbst; Matthew,16,0,16,0
1713326124602,MMW 13R,A01,514037,Staff,12,0,16,4
1713326124602,MMW 13R,A02,514039,Staff,16,0,16,0
1713326126654,SIO 295LS,A00,523233,Staff,19,0,30,11
1713326127679,SIO 295S,A00,523232,Staff,19,0,30,11
1713326128706,SOCI 117,A01,494376,Staff,2,0,5,3
1713326129734,WES 237B,A00,494380,Staff,19,0,20,1
1713326131788,AESE 279B,A00,494370,Wade; Jon P,33,0,33,0
1713326132813,ANAR 135S,A00,494369,Braswell; Geoffrey E.,0,0,0,0
1713326133838,CAT 124RS,A01,519847,Geibel; William,17,0,20,3
1713326134862,CAT 125RS,A01,515971,Geibel; William,17,0,20,3
1713326135890,CLRE 250,A00,511389,Morris; Sheldon,9996,0,9999,3
1713326136914,CLRE 251,A00,507176,Mehta; Ravindra L.,9996,0,9999,3
1713326136914,CLRE 251,B00,511410,Mehta; Ravindra L.,9998,0,9999,1
1713326137940,CLRE 252,A00,507189,Cuomo; Raphael Eduardo,9998,0,9999,1
1713326138973,CLRE 253,A00,507199,Vaida; Florin,9997,0,9999,2
1713326138973,CLRE 253,B00,507202,Vaida; Florin,9999,0,9999,0
1713326140002,CLRE 259,A00,507211,Patel; Hemal,9996,0,9999,3
1713326141027,CLRE 260,A00,507221,Cuomo; Raphael Eduardo,9999,0,9999,0
1713326142052,CLRE 297,001,507242,Cuomo; Raphael Eduardo,9999,0,9999,0
1713326143076,CSE 191,A00,516875,Minnes Kemp; Mor Mia,9999,0,9999,0
1713326144101,CSS 201S,A01,494383,Staff,35,0,35,0
1713326145127,CSS 202S,A01,494387,Staff,35,0,35,0
1713326146155,EAP 100,A00,516065,Staff,9792,0,9999,207
1713326147181,ECE 45,A01,507414,Staff,51,0,60,9
1713326148209,ECE 100,A01,507416,Baghdadchi; Saharnaz,11,0,20,9
1713326148209,ECE 100,A02,507418,Baghdadchi; Saharnaz,20,0,20,0
1713326149234,ECE 111,A01,507420,Staff,39,0,50,11
1713326150260,ECE 197,001,548057,Sievenpiper; Daniel F.,9998,0,9999,1
1713326151285,EDS 115,A00,507243,Choi; Bailey Miyeon,28,0,28,0
1713326152309,EDS 117,A01,494379,Staff,23,0,25,2
1713326153333,EDS 125,A00,507246,Hopkins; Megan Beth,29,0,30,1
1713326154357,EDS 128A,A01,507264,Fargason; Sharon Gayle,26,0,26,0
1713326155385,EDS 128B,A01,507293,Pappas; Elizabeth,30,0,30,0
1713326156412,EDS 139,A00,507294,Fargason; Sharon Gayle,30,0,30,0
1713326156412,EDS 139,B00,507313,Pappas; Elizabeth,30,0,30,0
1713326157436,EDS 201,A00,507315,Staff,26,0,30,4
1713326158464,EDS 203,A01,507317,Halter; Christopher P.,26,0,30,4
1713326159490,EDS 204R,A01,507319,Halter; Christopher P.,3,0,30,27
1713326159490,EDS 204R,B01,507331,Heinzman; Erica M.,28,0,30,2
1713326160517,EDS 206R,A00,507332,Staff,4,0,30,26
1713326160517,EDS 206R,B00,507343,Staff,28,0,30,2
1713326161548,EDS 250,A00,507344,Hemans; Patricia Ann Benitez,36,0,40,4
1713326162572,EDS 281,A00,507345,Daly; Alan J.,18,0,18,0
1713326163599,EDS 284,A00,507350,Daly; Alan J.,16,0,16,0
1713326164625,EDS 286,A00,507359,Fine; Sarah,18,0,18,0
1713326165649,EDS 289C,A01,507361,Daly; Alan J.,18,0,18,0
1713326166674,EDS 290,A00,507366,Hofstetter; Carolyn,15,0,15,0
1713326167752,LIGM 5A,A00,507421,Fischer-Grunski; Eva K,20,0,20,0
1713326168778,LIGM 5B,A00,507423,Fischer-Grunski; Eva K,20,0,20,0
1713326169801,LIGM 5C,A00,507425,Fischer-Grunski; Eva K,20,0,20,0
1713326170830,LIIT 5AS,A00,507427,Carnelos; Chiara,20,0,20,0
1713326171855,LIIT 5BS,A00,507430,Carnelos; Chiara,20,0,20,0
1713326172878,LIIT 5CS,A00,507432,Carnelos; Chiara,20,0,20,0
1713326173908,LISP 5A,A00,507541,Munoz Sanchez; Alicia,17,0,20,3
1713326174933,LISP 5B,A00,507671,Munoz Sanchez; Alicia,15,0,20,5
1713326175962,LISP 5C,A00,507696,Munoz Sanchez; Alicia,15,0,20,5
1713326176988,MAE 197,001,528363,Boechler; Nicholas Sebastia,9998,0,9999,1
1713326178017,MATH 197,001,523477,Kedlaya; Kiran S.,9999,0,9999,0
1713326178017,MATH 197,002,563811,Zhang; Danna,9999,0,9999,0
1713326179041,MCWP 40R,A00,518780,Staff,20,0,20,0
1713326179041,MCWP 40R,B00,518781,Staff,19,0,20,1
1713326179041,MCWP 40R,C00,518783,Staff,19,0,20,1
1713326180066,MCWP 50R,A00,518791,Staff,20,0,20,0
1713326180066,MCWP 50R,B00,518792,Staff,17,0,20,3
1713326180066,MCWP 50R,C00,518793,Staff,19,0,20,1
1713326180066,MCWP 50R,D00,518794,Staff,16,0,20,4
1713326180066,MCWP 50R,E00,518795,Staff,16,0,20,4
1713326180066,MCWP 50R,F00,518796,Staff,19,0,20,1
1713326180066,MCWP 50R,G00,518797,Staff,19,0,20,1
1713326181094,MMW 12R,A01,514034,Herbst; Matthew,15,0,16,1
1713326181094,MMW 12R,A02,514035,Herbst; Matthew,16,0,16,0
1713326182122,MMW 13R,A01,514037,Staff,12,0,16,4
1713326182122,MMW 13R,A02,514039,Staff,16,0,16,0
1713326184177,SIO 295LS,A00,523233,Staff,19,0,30,11
1713326185201,SIO 295S,A00,523232,Staff,19,0,30,11
1713326186225,SOCI 117,A01,494376,Staff,2,0,5,3
1713326187261,WES 237B,A00,494380,Staff,19,0,20,1
1713326189316,AESE 279B,A00,494370,Wade; Jon P,33,0,33,0
1713326190339,ANAR 135S,A00,494369,Braswell; Geoffrey E.,0,0,0,0
1713326191367,CAT 124RS,A01,519847,Geibel; William,17,0,20,3
1713326192394,CAT 125RS,A01,515971,Geibel; William,17,0,20,3
1713326193421,CLRE 250,A00,511389,Morris; Sheldon,9996,0,9999,3
1713326194450,CLRE 251,A00,507176,Mehta; Ravindra L.,9996,0,9999,3
1713326194450,CLRE 251,B00,511410,Mehta; Ravindra L.,9998,0,9999,1
1713326195476,CLRE 252,A00,507189,Cuomo; Raphael Eduardo,9998,0,9999,1
1713326196504,CLRE 253,A00,507199,Vaida; Florin,9997,0,9999,2
1713326196504,CLRE 253,B00,507202,Vaida; Florin,9999,0,9999,0
1713326197531,CLRE 259,A00,507211,Patel; Hemal,9996,0,9999,3
1713326198559,CLRE 260,A00,507221,Cuomo; Raphael Eduardo,9999,0,9999,0
1713326199584,CLRE 297,001,507242,Cuomo; Raphael Eduardo,9999,0,9999,0
1713326200609,CSE 191,A00,516875,Minnes Kemp; Mor Mia,9999,0,9999,0
1713326201634,CSS 201S,A01,494383,Staff,35,0,35,0
1713326202664,CSS 202S,A01,494387,Staff,35,0,35,0
1713326203689,EAP 100,A00,516065,Staff,9792,0,9999,207
1713326204714,ECE 45,A01,507414,Staff,51,0,60,9
1713326205739,ECE 100,A01,507416,Baghdadchi; Saharnaz,11,0,20,9
1713326205739,ECE 100,A02,507418,Baghdadchi; Saharnaz,20,0,20,0
1713326206766,ECE 111,A01,507420,Staff,39,0,50,11
1713326207793,ECE 197,001,548057,Sievenpiper; Daniel F.,9998,0,9999,1
1713326208818,EDS 115,A00,507243,Choi; Bailey Miyeon,28,0,28,0
1713326209842,EDS 117,A01,494379,Staff,23,0,25,2
1713326210867,EDS 125,A00,507246,Hopkins; Megan Beth,29,0,30,1
1713326211893,EDS 128A,A01,507264,Fargason; Sharon Gayle,26,0,26,0
1713326212921,EDS 128B,A01,507293,Pappas; Elizabeth,30,0,30,0
1713326213946,EDS 139,A00,507294,Fargason; Sharon Gayle,30,0,30,0
1713326213946,EDS 139,B00,507313,Pappas; Elizabeth,30,0,30,0
1713326214970,EDS 201,A00,507315,Staff,26,0,30,4
1713326215994,EDS 203,A01,507317,Halter; Christopher P.,26,0,30,4
1713326217020,EDS 204R,A01,507319,Halter; Christopher P.,3,0,30,27
1713326217020,EDS 204R,B01,507331,Heinzman; Erica M.,28,0,30,2
1713326218044,EDS 206R,A00,507332,Staff,4,0,30,26
1713326218044,EDS 206R,B00,507343,Staff,28,0,30,2
1713326219069,EDS 250,A00,507344,Hemans; Patricia Ann Benitez,36,0,40,4
1713326220098,EDS 281,A00,507345,Daly; Alan J.,18,0,18,0
1713326221128,EDS 284,A00,507350,Daly; Alan J.,16,0,16,0
1713326222151,EDS 286,A00,507359,Fine; Sarah,18,0,18,0
1713326223175,EDS 289C,A01,507361,Daly; Alan J.,18,0,18,0
1713326224200,EDS 290,A00,507366,Hofstetter; Carolyn,15,0,15,0
1713326225225,LIGM 5A,A00,507421,Fischer-Grunski; Eva K,20,0,20,0
1713326226251,LIGM 5B,A00,507423,Fischer-Grunski; Eva K,20,0,20,0
1713326227281,LIGM 5C,A00,507425,Fischer-Grunski; Eva K,20,0,20,0
1713326228306,LIIT 5AS,A00,507427,Carnelos; Chiara,20,0,20,0
1713326229329,LIIT 5BS,A00,507430,Carnelos; Chiara,20,0,20,0
1713326230352,LIIT 5CS,A00,507432,Carnelos; Chiara,20,0,20,0
1713326231380,LISP 5A,A00,507541,Munoz Sanchez; Alicia,17,0,20,3
1713326232409,LISP 5B,A00,507671,Munoz Sanchez; Alicia,15,0,20,5
1713326233434,LISP 5C,A00,507696,Munoz Sanchez; Alicia,15,0,20,5
1713326234459,MAE 197,001,528363,Boechler; Nicholas Sebastia,9998,0,9999,1
1713326235483,MATH 197,001,523477,Kedlaya; Kiran S.,9999,0,9999,0
1713326235483,MATH 197,002,563811,Zhang; Danna,9999,0,9999,0
1713326236508,MCWP 40R,A00,518780,Staff,20,0,20,0
1713326236508,MCWP 40R,B00,518781,Staff,19,0,20,1
1713326236508,MCWP 40R,C00,518783,Staff,19,0,20,1
1713326237537,MCWP 50R,A00,518791,Staff,20,0,20,0
1713326237537,MCWP 50R,B00,518792,Staff,17,0,20,3
1713326237537,MCWP 50R,C00,518793,Staff,19,0,20,1
1713326237537,MCWP 50R,D00,518794,Staff,16,0,20,4
1713326237537,MCWP 50R,E00,518795,Staff,16,0,20,4
1713326237537,MCWP 50R,F00,518796,Staff,19,0,20,1
1713326237537,MCWP 50R,G00,518797,Staff,19,0,20,1
1713326238566,MMW 12R,A01,514034,Herbst; Matthew,15,0,16,1
1713326238566,MMW 12R,A02,514035,Herbst; Matthew,16,0,16,0
1713326239595,MMW 13R,A01,514037,Staff,12,0,16,4
1713326239595,MMW 13R,A02,514039,Staff,16,0,16,0
1713326241645,SIO 295LS,A00,523233,Staff,19,0,30,11
1713326242670,SIO 295S,A00,523232,Staff,19,0,30,11
1713326243698,SOCI 117,A01,494376,Staff,2,0,5,3
1713326244722,WES 237B,A00,494380,Staff,19,0,20,1
1713326246785,AESE 279B,A00,494370,Wade; Jon P,33,0,33,0
1713326247812,ANAR 135S,A00,494369,Braswell; Geoffrey E.,0,0,0,0
1713326248840,CAT 124RS,A01,519847,Geibel; William,17,0,20,3
1713326249864,CAT 125RS,A01,515971,Geibel; William,17,0,20,3
1713326250893,CLRE 250,A00,511389,Morris; Sheldon,9996,0,9999,3
1713326251918,CLRE 251,A00,507176,Mehta; Ravindra L.,9996,0,9999,3
1713326251918,CLRE 251,B00,511410,Mehta; Ravindra L.,9998,0,9999,1
1713326252945,CLRE 252,A00,507189,Cuomo; Raphael Eduardo,9998,0,9999,1
1713326253971,CLRE 253,A00,507199,Vaida; Florin,9997,0,9999,2
1713326253971,CLRE 253,B00,507202,Vaida; Florin,9999,0,9999,0
1713326255002,CLRE 259,A00,507211,Patel; Hemal,9996,0,9999,3
1713326256026,CLRE 260,A00,507221,Cuomo; Raphael Eduardo,9999,0,9999,0
1713326257050,CLRE 297,001,507242,Cuomo; Raphael Eduardo,9999,0,9999,0
1713326258074,CSE 191,A00,516875,Minnes Kemp; Mor Mia,9999,0,9999,0
1713326259103,CSS 201S,A01,494383,Staff,35,0,35,0
1713326260133,CSS 202S,A01,494387,Staff,35,0,35,0
1713326261157,EAP 100,A00,516065,Staff,9792,0,9999,207
1713326262182,ECE 45,A01,507414,Staff,51,0,60,9
1713326263207,ECE 100,A01,507416,Baghdadchi; Saharnaz,11,0,20,9
1713326263207,ECE 100,A02,507418,Baghdadchi; Saharnaz,20,0,20,0
1713326264237,ECE 111,A01,507420,Staff,39,0,50,11
1713326265264,ECE 197,001,548057,Sievenpiper; Daniel F.,9998,0,9999,1
1713326266290,EDS 115,A00,507243,Choi; Bailey Miyeon,28,0,28,0
1713326267314,EDS 117,A01,494379,Staff,23,0,25,2
1713326268340,EDS 125,A00,507246,Hopkins; Megan Beth,29,0,30,1
1713326269367,EDS 128A,A01,507264,Fargason; Sharon Gayle,26,0,26,0
1713326270392,EDS 128B,A01,507293,Pappas; Elizabeth,30,0,30,0
1713326271470,EDS 139,A00,507294,Fargason; Sharon Gayle,30,0,30,0
1713326271470,EDS 139,B00,507313,Pappas; Elizabeth,30,0,30,0
1713326272499,EDS 201,A00,507315,Staff,26,0,30,4
1713326273523,EDS 203,A01,507317,Halter; Christopher P.,26,0,30,4
1713326274553,EDS 204R,A01,507319,Halter; Christopher P.,3,0,30,27
1713326274553,EDS 204R,B01,507331,Heinzman; Erica M.,28,0,30,2
1713326275577,EDS 206R,A00,507332,Staff,4,0,30,26
1713326275577,EDS 206R,B00,507343,Staff,28,0,30,2
1713326276602,EDS 250,A00,507344,Hemans; Patricia Ann Benitez,36,0,40,4
1713326277627,EDS 281,A00,507345,Daly; Alan J.,18,0,18,0
1713326278652,EDS 284,A00,507350,Daly; Alan J.,16,0,16,0
1713326279681,EDS 286,A00,507359,Fine; Sarah,18,0,18,0
1713326280710,EDS 289C,A01,507361,Daly; Alan J.,18,0,18,0
1713326281739,EDS 290,A00,507366,Hofstetter; Carolyn,15,0,15,0
1713326282765,LIGM 5A,A00,507421,Fischer-Grunski; Eva K,20,0,20,0
1713326283796,LIGM 5B,A00,507423,Fischer-Grunski; Eva K,20,0,20,0
1713326284824,LIGM 5C,A00,507425,Fischer-Grunski; Eva K,20,0,20,0
1713326285849,LIIT 5AS,A00,507427,Carnelos; Chiara,20,0,20,0
1713326286878,LIIT 5BS,A00,507430,Carnelos; Chiara,20,0,20,0
1713326287907,LIIT 5CS,A00,507432,Carnelos; Chiara,20,0,20,0
1713326288932,LISP 5A,A00,507541,Munoz Sanchez; Alicia,17,0,20,3
1713326289957,LISP 5B,A00,507671,Munoz Sanchez; Alicia,15,0,20,5
1713326290984,LISP 5C,A00,507696,Munoz Sanchez; Alicia,15,0,20,5
1713326292009,MAE 197,001,528363,Boechler; Nicholas Sebastia,9998,0,9999,1
1713326293033,MATH 197,001,523477,Kedlaya; Kiran S.,9999,0,9999,0
1713326293033,MATH 197,002,563811,Zhang; Danna,9999,0,9999,0
1713326294059,MCWP 40R,A00,518780,Staff,20,0,20,0
1713326294059,MCWP 40R,B00,518781,Staff,19,0,20,1
1713326294059,MCWP 40R,C00,518783,Staff,19,0,20,1
1713326295083,MCWP 50R,A00,518791,Staff,20,0,20,0
1713326295083,MCWP 50R,B00,518792,Staff,17,0,20,3
1713326295083,MCWP 50R,C00,518793,Staff,19,0,20,1
1713326295083,MCWP 50R,D00,518794,Staff,16,0,20,4
1713326295083,MCWP 50R,E00,518795,Staff,16,0,20,4
1713326295083,MCWP 50R,F00,518796,Staff,19,0,20,1
1713326295083,MCWP 50R,G00,518797,Staff,19,0,20,1
1713326296107,MMW 12R,A01,514034,Herbst; Matthew,15,0,16,1
1713326296107,MMW 12R,A02,514035,Herbst; Matthew,16,0,16,0
1713326297131,MMW 13R,A01,514037,Staff,12,0,16,4
1713326297131,MMW 13R,A02,514039,Staff,16,0,16,0
1713326299187,SIO 295LS,A00,523233,Staff,19,0,30,11
1713326300212,SIO 295S,A00,523232,Staff,19,0,30,11
1713326301237,SOCI 117,A01,494376,Staff,2,0,5,3
1713326302264,WES 237B,A00,494380,Staff,19,0,20,1
1713326304320,AESE 279B,A00,494370,Wade; Jon P,33,0,33,0
1713326305345,ANAR 135S,A00,494369,Braswell; Geoffrey E.,0,0,0,0
1713326306370,CAT 124RS,A01,519847,Geibel; William,17,0,20,3
1713326307398,CAT 125RS,A01,515971,Geibel; William,17,0,20,3
1713326308425,CLRE 250,A00,511389,Morris; Sheldon,9996,0,9999,3
1713326309450,CLRE 251,A00,507176,Mehta; Ravindra L.,9996,0,9999,3
1713326309450,CLRE 251,B00,511410,Mehta; Ravindra L.,9998,0,9999,1
1713326310481,CLRE 252,A00,507189,Cuomo; Raphael Eduardo,9998,0,9999,1
1713326311509,CLRE 253,A00,507199,Vaida; Florin,9997,0,9999,2
1713326311509,CLRE 253,B00,507202,Vaida; Florin,9999,0,9999,0
1713326312534,CLRE 259,A00,507211,Patel; Hemal,9996,0,9999,3
1713326313559,CLRE 260,A00,507221,Cuomo; Raphael Eduardo,9999,0,9999,0
1713326314587,CLRE 297,001,507242,Cuomo; Raphael Eduardo,9999,0,9999,0
1713326315612,CSE 191,A00,516875,Minnes Kemp; Mor Mia,9999,0,9999,0
1713326316638,CSS 201S,A01,494383,Staff,35,0,35,0
1713326317664,CSS 202S,A01,494387,Staff,35,0,35,0
1713326318689,EAP 100,A00,516065,Staff,9792,0,9999,207
1713326319783,ECE 45,A01,507414,Staff,51,0,60,9
1713326320811,ECE 100,A01,507416,Baghdadchi; Saharnaz,11,0,20,9
1713326320811,ECE 100,A02,507418,Baghdadchi; Saharnaz,20,0,20,0
1713326321834,ECE 111,A01,507420,Staff,39,0,50,11
1713326322861,ECE 197,001,548057,Sievenpiper; Daniel F.,9998,0,9999,1
1713326323886,EDS 115,A00,507243,Choi; Bailey Miyeon,28,0,28,0
1713326324910,EDS 117,A01,494379,Staff,23,0,25,2
1713326325934,EDS 125,A00,507246,Hopkins; Megan Beth,29,0,30,1
1713326326958,EDS 128A,A01,507264,Fargason; Sharon Gayle,26,0,26,0
1713326327989,EDS 128B,A01,507293,Pappas; Elizabeth,30,0,30,0
1713326329015,EDS 139,A00,507294,Fargason; Sharon Gayle,30,0,30,0
1713326329015,EDS 139,B00,507313,Pappas; Elizabeth,30,0,30,0
1713326330039,EDS 201,A00,507315,Staff,26,0,30,4
1713326331061,EDS 203,A01,507317,Halter; Christopher P.,26,0,30,4
1713326332086,EDS 204R,A01,507319,Halter; Christopher P.,3,0,30,27
1713326332086,EDS 204R,B01,507331,Heinzman; Erica M.,28,0,30,2
1713326333111,EDS 206R,A00,507332,Staff,4,0,30,26
1713326333111,EDS 206R,B00,507343,Staff,28,0,30,2
1713326334140,EDS 250,A00,507344,Hemans; Patricia Ann Benitez,36,0,40,4
1713326335165,EDS 281,A00,507345,Daly; Alan J.,18,0,18,0
1713326336192,EDS 284,A00,507350,Daly; Alan J.,16,0,16,0
1713326337220,EDS 286,A00,507359,Fine; Sarah,18,0,18,0
1713326338250,EDS 289C,A01,507361,Daly; Alan J.,18,0,18,0
1713326339275,EDS 290,A00,507366,Hofstetter; Carolyn,15,0,15,0
1713326340300,LIGM 5A,A00,507421,Fischer-Grunski; Eva K,20,0,20,0
1713326341324,LIGM 5B,A00,507423,Fischer-Grunski; Eva K,20,0,20,0
1713326342350,LIGM 5C,A00,507425,Fischer-Grunski; Eva K,20,0,20,0
1713326343373,LIIT 5AS,A00,507427,Carnelos; Chiara,20,0,20,0
1713326344401,LIIT 5BS,A00,507430,Carnelos; Chiara,20,0,20,0
1713326345425,LIIT 5CS,A00,507432,Carnelos; Chiara,20,0,20,0
1713326346449,LISP 5A,A00,507541,Munoz Sanchez; Alicia,17,0,20,3
1713326347475,LISP 5B,A00,507671,Munoz Sanchez; Alicia,15,0,20,5
1713326348500,LISP 5C,A00,507696,Munoz Sanchez; Alicia,15,0,20,5
1713326349525,MAE 197,001,528363,Boechler; Nicholas Sebastia,9998,0,9999,1
1713326350553,MATH 197,001,523477,Kedlaya; Kiran S.,9999,0,9999,0
1713326350553,MATH 197,002,563811,Zhang; Danna,9999,0,9999,0
1713326351578,MCWP 40R,A00,518780,Staff,20,0,20,0
1713326351578,MCWP 40R,B00,518781,Staff,19,0,20,1
1713326351578,MCWP 40R,C00,518783,Staff,19,0,20,1
1713326352606,MCWP 50R,A00,518791,Staff,20,0,20,0
1713326352606,MCWP 50R,B00,518792,Staff,17,0,20,3
1713326352606,MCWP 50R,C00,518793,Staff,19,0,20,1
1713326352606,MCWP 50R,D00,518794,Staff,16,0,20,4
1713326352606,MCWP 50R,E00,518795,Staff,16,0,20,4
1713326352606,MCWP 50R,F00,518796,Staff,19,0,20,1
1713326352606,MCWP 50R,G00,518797,Staff,19,0,20,1
1713326353634,MMW 12R,A01,514034,Herbst; Matthew,15,0,16,1
1713326353634,MMW 12R,A02,514035,Herbst; Matthew,16,0,16,0
1713326354659,MMW 13R,A01,514037,Staff,12,0,16,4
1713326354659,MMW 13R,A02,514039,Staff,16,0,16,0
1713326356712,SIO 295LS,A00,523233,Staff,19,0,30,11
1713326357735,SIO 295S,A00,523232,Staff,19,0,30,11
1713326358760,SOCI 117,A01,494376,Staff,2,0,5,3
1713326359787,WES 237B,A00,494380,Staff,19,0,20,1
1713326361844,AESE 279B,A00,494370,Wade; Jon P,33,0,33,0
1713326362870,ANAR 135S,A00,494369,Braswell; Geoffrey E.,0,0,0,0
1713326363895,CAT 124RS,A01,519847,Geibel; William,17,0,20,3
1713326364924,CAT 125RS,A01,515971,Geibel; William,17,0,20,3
1713326365952,CLRE 250,A00,511389,Morris; Sheldon,9996,0,9999,3
1713326366981,CLRE 251,A00,507176,Mehta; Ravindra L.,9996,0,9999,3
1713326366981,CLRE 251,B00,511410,Mehta; Ravindra L.,9998,0,9999,1
1713326368009,CLRE 252,A00,507189,Cuomo; Raphael Eduardo,9998,0,9999,1
1713326369034,CLRE 253,A00,507199,Vaida; Florin,9997,0,9999,2
1713326369034,CLRE 253,B00,507202,Vaida; Florin,9999,0,9999,0
1713326370063,CLRE 259,A00,507211,Patel; Hemal,9996,0,9999,3
1713326371090,CLRE 260,A00,507221,Cuomo; Raphael Eduardo,9999,0,9999,0
1713326372120,CLRE 297,001,507242,Cuomo; Raphael Eduardo,9999,0,9999,0
1713326373148,CSE 191,A00,516875,Minnes Kemp; Mor Mia,9999,0,9999,0
1713326374174,CSS 201S,A01,494383,Staff,35,0,35,0
1713326375254,CSS 202S,A01,494387,Staff,35,0,35,0
1713326376281,EAP 100,A00,516065,Staff,9792,0,9999,207
1713326377306,ECE 45,A01,507414,Staff,51,0,60,9
1713326378334,ECE 100,A01,507416,Baghdadchi; Saharnaz,11,0,20,9
1713326378334,ECE 100,A02,507418,Baghdadchi; Saharnaz,20,0,20,0
1713326379360,ECE 111,A01,507420,Staff,39,0,50,11
1713326380386,ECE 197,001,548057,Sievenpiper; Daniel F.,9998,0,9999,1
1713326381410,EDS 115,A00,507243,Choi; Bailey Miyeon,28,0,28,0
1713326382438,EDS 117,A01,494379,Staff,23,0,25,2
1713326383464,EDS 125,A00,507246,Hopkins; Megan Beth,29,0,30,1
1713326384489,EDS 128A,A01,507264,Fargason; Sharon Gayle,26,0,26,0
1713326385513,EDS 128B,A01,507293,Pappas; Elizabeth,30,0,30,0
1713326386542,EDS 139,A00,507294,Fargason; Sharon Gayle,30,0,30,0
1713326386542,EDS 139,B00,507313,Pappas; Elizabeth,30,0,30,0
1713326387567,EDS 201,A00,507315,Staff,26,0,30,4
1713326388592,EDS 203,A01,507317,Halter; Christopher P.,26,0,30,4
1713326389623,EDS 204R,A01,507319,Halter; Christopher P.,3,0,30,27
1713326389623,EDS 204R,B01,507331,Heinzman; Erica M.,28,0,30,2
1713326390646,EDS 206R,A00,507332,Staff,4,0,30,26
1713326390646,EDS 206R,B00,507343,Staff,28,0,30,2
1713326391675,EDS 250,A00,507344,Hemans; Patricia Ann Benitez,36,0,40,4
1713326392698,EDS 281,A00,507345,Daly; Alan J.,18,0,18,0
1713326393723,EDS 284,A00,507350,Daly; Alan J.,16,0,16,0
1713326394747,EDS 286,A00,507359,Fine; Sarah,18,0,18,0
1713326395772,EDS 289C,A01,507361,Daly; Alan J.,18,0,18,0
1713326396799,EDS 290,A00,507366,Hofstetter; Carolyn,15,0,15,0
1713326397828,LIGM 5A,A00,507421,Fischer-Grunski; Eva K,20,0,20,0
1713326398855,LIGM 5B,A00,507423,Fischer-Grunski; Eva K,20,0,20,0
1713326399880,LIGM 5C,A00,507425,Fischer-Grunski; Eva K,20,0,20,0
1713326400911,LIIT 5AS,A00,507427,Carnelos; Chiara,20,0,20,0
1713326401939,LIIT 5BS,A00,507430,Carnelos; Chiara,20,0,20,0
1713326402962,LIIT 5CS,A00,507432,Carnelos; Chiara,20,0,20,0
1713326403987,LISP 5A,A00,507541,Munoz Sanchez; Alicia,17,0,20,3
1713326405018,LISP 5B,A00,507671,Munoz Sanchez; Alicia,15,0,20,5
1713326406047,LISP 5C,A00,507696,Munoz Sanchez; Alicia,15,0,20,5
1713326407078,MAE 197,001,528363,Boechler; Nicholas Sebastia,9998,0,9999,1
1713326408104,MATH 197,001,523477,Kedlaya; Kiran S.,9999,0,9999,0
1713326408104,MATH 197,002,563811,Zhang; Danna,9999,0,9999,0
1713326409130,MCWP 40R,A00,518780,Staff,20,0,20,0
1713326409130,MCWP 40R,B00,518781,Staff,19,0,20,1
1713326409130,MCWP 40R,C00,518783,Staff,19,0,20,1
1713326410158,MCWP 50R,A00,518791,Staff,20,0,20,0
1713326410158,MCWP 50R,B00,518792,Staff,17,0,20,3
1713326410158,MCWP 50R,C00,518793,Staff,19,0,20,1
1713326410158,MCWP 50R,D00,518794,Staff,16,0,20,4
1713326410158,MCWP 50R,E00,518795,Staff,16,0,20,4
1713326410158,MCWP 50R,F00,518796,Staff,19,0,20,1
1713326410158,MCWP 50R,G00,518797,Staff,19,0,20,1
1713326411187,MMW 12R,A01,514034,Herbst; Matthew,15,0,16,1
1713326411187,MMW 12R,A02,514035,Herbst; Matthew,16,0,16,0
1713326412216,MMW 13R,A01,514037,Staff,12,0,16,4
1713326412216,MMW 13R,A02,514039,Staff,16,0,16,0
1713326414271,SIO 295LS,A00,523233,Staff,19,0,30,11
1713326415294,SIO 295S,A00,523232,Staff,19,0,30,11
1713326416321,SOCI 117,A01,494376,Staff,2,0,5,3
1713326417347,WES 237B,A00,494380,Staff,19,0,20,1
1713326419415,AESE 279B,A00,494370,Wade; Jon P,33,0,33,0
1713326420441,ANAR 135S,A00,494369,Braswell; Geoffrey E.,0,0,0,0
1713326421465,CAT 124RS,A01,519847,Geibel; William,17,0,20,3
1713326422488,CAT 125RS,A01,515971,Geibel; William,17,0,20,3
1713326423525,CLRE 250,A00,511389,Morris; Sheldon,9996,0,9999,3
1713326424550,CLRE 251,A00,507176,Mehta; Ravindra L.,9996,0,9999,3
1713326424550,CLRE 251,B00,511410,Mehta; Ravindra L.,9998,0,9999,1
1713326425576,CLRE 252,A00,507189,Cuomo; Raphael Eduardo,9998,0,9999,1
1713326426607,CLRE 253,A00,507199,Vaida; Florin,9997,0,9999,2
1713326426607,CLRE 253,B00,507202,Vaida; Florin,9999,0,9999,0
1713326427638,CLRE 259,A00,507211,Patel; Hemal,9996,0,9999,3
1713326428663,CLRE 260,A00,507221,Cuomo; Raphael Eduardo,9999,0,9999,0
1713326429687,CLRE 297,001,507242,Cuomo; Raphael Eduardo,9999,0,9999,0
1713326430713,CSE 191,A00,516875,Minnes Kemp; Mor Mia,9999,0,9999,0
1713326431738,CSS 201S,A01,494383,Staff,35,0,35,0
1713326432766,CSS 202S,A01,494387,Staff,35,0,35,0
1713326433791,EAP 100,A00,516065,Staff,9792,0,9999,207
1713326434818,ECE 45,A01,507414,Staff,51,0,60,9
1713326435846,ECE 100,A01,507416,Baghdadchi; Saharnaz,11,0,20,9
1713326435846,ECE 100,A02,507418,Baghdadchi; Saharnaz,20,0,20,0
1713326436874,ECE 111,A01,507420,Staff,39,0,50,11
1713326437899,ECE 197,001,548057,Sievenpiper; Daniel F.,9998,0,9999,1
1713326438924,EDS 115,A00,507243,Choi; Bailey Miyeon,28,0,28,0
1713326439948,EDS 117,A01,494379,Staff,23,0,25,2
1713326440973,EDS 125,A00,507246,Hopkins; Megan Beth,29,0,30,1
1713326441999,EDS 128A,A01,507264,Fargason; Sharon Gayle,26,0,26,0
1713326443027,EDS 128B,A01,507293,Pappas; Elizabeth,30,0,30,0
1713326444051,EDS 139,A00,507294,Fargason; Sharon Gayle,30,0,30,0
1713326444051,EDS 139,B00,507313,Pappas; Elizabeth,30,0,30,0
1713326445075,EDS 201,A00,507315,Staff,26,0,30,4
1713326446099,EDS 203,A01,507317,Halter; Christopher P.,26,0,30,4
1713326447124,EDS 204R,A01,507319,Halter; Christopher P.,3,0,30,27
1713326447124,EDS 204R,B01,507331,Heinzman; Erica M.,28,0,30,2
1713326448148,EDS 206R,A00,507332,Staff,4,0,30,26
1713326448148,EDS 206R,B00,507343,Staff,28,0,30,2
1713326449176,EDS 250,A00,507344,Hemans; Patricia Ann Benitez,36,0,40,4
1713326450201,EDS 281,A00,507345,Daly; Alan J.,18,0,18,0
1713326451225,EDS 284,A00,507350,Daly; Alan J.,16,0,16,0
1713326452253,EDS 286,A00,507359,Fine; Sarah,18,0,18,0
1713326453281,EDS 289C,A01,507361,Daly; Alan J.,18,0,18,0
1713326454305,EDS 290,A00,507366,Hofstetter; Carolyn,15,0,15,0
1713326455333,LIGM 5A,A00,507421,Fischer-Grunski; Eva K,20,0,20,0
1713326456357,LIGM 5B,A00,507423,Fischer-Grunski; Eva K,20,0,20,0
1713326457381,LIGM 5C,A00,507425,Fischer-Grunski; Eva K,20,0,20,0
1713326458411,LIIT 5AS,A00,507427,Carnelos; Chiara,20,0,20,0
1713326459438,LIIT 5BS,A00,507430,Carnelos; Chiara,20,0,20,0
1713326460467,LIIT 5CS,A00,507432,Carnelos; Chiara,20,0,20,0
1713326461493,LISP 5A,A00,507541,Munoz Sanchez; Alicia,17,0,20,3
1713326462522,LISP 5B,A00,507671,Munoz Sanchez; Alicia,15,0,20,5
1713326463546,LISP 5C,A00,507696,Munoz Sanchez; Alicia,15,0,20,5
1713326464571,MAE 197,001,528363,Boechler; Nicholas Sebastia,9998,0,9999,1
1713326465598,MATH 197,001,523477,Kedlaya; Kiran S.,9999,0,9999,0
1713326465598,MATH 197,002,563811,Zhang; Danna,9999,0,9999,0
1713326466625,MCWP 40R,A00,518780,Staff,20,0,20,0
1713326466625,MCWP 40R,B00,518781,Staff,19,0,20,1
1713326466625,MCWP 40R,C00,518783,Staff,19,0,20,1
1713326467650,MCWP 50R,A00,518791,Staff,20,0,20,0
1713326467650,MCWP 50R,B00,518792,Staff,17,0,20,3
1713326467650,MCWP 50R,C00,518793,Staff,19,0,20,1
1713326467650,MCWP 50R,D00,518794,Staff,16,0,20,4
1713326467650,MCWP 50R,E00,518795,Staff,16,0,20,4
1713326467650,MCWP 50R,F00,518796,Staff,19,0,20,1
1713326467650,MCWP 50R,G00,518797,Staff,19,0,20,1
1713326468675,MMW 12R,A01,514034,Herbst; Matthew,15,0,16,1
1713326468675,MMW 12R,A02,514035,Herbst; Matthew,16,0,16,0
1713326469699,MMW 13R,A01,514037,Staff,12,0,16,4
1713326469699,MMW 13R,A02,514039,Staff,16,0,16,0
1713326471753,SIO 295LS,A00,523233,Staff,19,0,30,11
1713326472780,SIO 295S,A00,523232,Staff,19,0,30,11
1713326473807,SOCI 117,A01,494376,Staff,2,0,5,3
1713326474832,WES 237B,A00,494380,Staff,19,0,20,1
1713326476896,AESE 279B,A00,494370,Wade; Jon P,33,0,33,0
1713326477922,ANAR 135S,A00,494369,Braswell; Geoffrey E.,0,0,0,0
1713326479001,CAT 124RS,A01,519847,Geibel; William,17,0,20,3
1713326480025,CAT 125RS,A01,515971,Geibel; William,17,0,20,3
1713326481052,CLRE 250,A00,511389,Morris; Sheldon,9996,0,9999,3
1713326482077,CLRE 251,A00,507176,Mehta; Ravindra L.,9996,0,9999,3
1713326482077,CLRE 251,B00,511410,Mehta; Ravindra L.,9998,0,9999,1
1713326483102,CLRE 252,A00,507189,Cuomo; Raphael Eduardo,9998,0,9999,1
1713326484131,CLRE 253,A00,507199,Vaida; Florin,9997,0,9999,2
1713326484131,CLRE 253,B00,507202,Vaida; Florin,9999,0,9999,0
1713326485157,CLRE 259,A00,507211,Patel; Hemal,9996,0,9999,3
1713326486180,CLRE 260,A00,507221,Cuomo; Raphael Eduardo,9999,0,9999,0
1713326487205,CLRE 297,001,507242,Cuomo; Raphael Eduardo,9999,0,9999,0
1713326488231,CSE 191,A00,516875,Minnes Kemp; Mor Mia,9999,0,9999,0
1713326489260,CSS 201S,A01,494383,Staff,35,0,35,0
1713326490285,CSS 202S,A01,494387,Staff,35,0,35,0
1713326491308,EAP 100,A00,516065,Staff,9792,0,9999,207
1713326492340,ECE 45,A01,507414,Staff,51,0,60,9
1713326493367,ECE 100,A01,507416,Baghdadchi; Saharnaz,11,0,20,9
1713326493367,ECE 100,A02,507418,Baghdadchi; Saharnaz,20,0,20,0
1713326494394,ECE 111,A01,507420,Staff,39,0,50,11
1713326495418,ECE 197,001,548057,Sievenpiper; Daniel F.,9998,0,9999,1
1713326496441,EDS 115,A00,507243,Choi; Bailey Miyeon,28,0,28,0
1713326497465,EDS 117,A01,494379,Staff,23,0,25,2
1713326498488,EDS 125,A00,507246,Hopkins; Megan Beth,29,0,30,1
1713326499510,EDS 128A,A01,507264,Fargason; Sharon Gayle,26,0,26,0
1713326500537,EDS 128B,A01,507293,Pappas; Elizabeth,30,0,30,0
1713326501564,EDS 139,A00,507294,Fargason; Sharon Gayle,30,0,30,0
1713326501564,EDS 139,B00,507313,Pappas; Elizabeth,30,0,30,0
1713326502593,EDS 201,A00,507315,Staff,26,0,30,4
1713326503617,EDS 203,A01,507317,Halter; Christopher P.,26,0,30,4
1713326504642,EDS 204R,A01,507319,Halter; Christopher P.,3,0,30,27
1713326504642,EDS 204R,B01,507331,Heinzman; Erica M.,28,0,30,2
1713326505670,EDS 206R,A00,507332,Staff,4,0,30,26
1713326505670,EDS 206R,B00,507343,Staff,28,0,30,2
1713326506694,EDS 250,A00,507344,Hemans; Patricia Ann Benitez,36,0,40,4
1713326507719,EDS 281,A00,507345,Daly; Alan J.,18,0,18,0
1713326508744,EDS 284,A00,507350,Daly; Alan J.,16,0,16,0
1713326509768,EDS 286,A00,507359,Fine; Sarah,18,0,18,0
1713326510800,EDS 289C,A01,507361,Daly; Alan J.,18,0,18,0
1713326511827,EDS 290,A00,507366,Hofstetter; Carolyn,15,0,15,0
1713326512851,LIGM 5A,A00,507421,Fischer-Grunski; Eva K,20,0,20,0
1713326513879,LIGM 5B,A00,507423,Fischer-Grunski; Eva K,20,0,20,0
1713326514903,LIGM 5C,A00,507425,Fischer-Grunski; Eva K,20,0,20,0
1713326515933,LIIT 5AS,A00,507427,Carnelos; Chiara,20,0,20,0
1713326516961,LIIT 5BS,A00,507430,Carnelos; Chiara,20,0,20,0
1713326517986,LIIT 5CS,A00,507432,Carnelos; Chiara,20,0,20,0
1713326519013,LISP 5A,A00,507541,Munoz Sanchez; Alicia,17,0,20,3
1713326520040,LISP 5B,A00,507671,Munoz Sanchez; Alicia,15,0,20,5
1713326521065,LISP 5C,A00,507696,Munoz Sanchez; Alicia,15,0,20,5
1713326522089,MAE 197,001,528363,Boechler; Nicholas Sebastia,9998,0,9999,1
1713326523115,MATH 197,001,523477,Kedlaya; Kiran S.,9999,0,9999,0
1713326523115,MATH 197,002,563811,Zhang; Danna,9999,0,9999,0
1713326524143,MCWP 40R,A00,518780,Staff,20,0,20,0
1713326524143,MCWP 40R,B00,518781,Staff,19,0,20,1
1713326524143,MCWP 40R,C00,518783,Staff,19,0,20,1
1713326525167,MCWP 50R,A00,518791,Staff,20,0,20,0
1713326525167,MCWP 50R,B00,518792,Staff,17,0,20,3
1713326525167,MCWP 50R,C00,518793,Staff,19,0,20,1
1713326525167,MCWP 50R,D00,518794,Staff,16,0,20,4
1713326525167,MCWP 50R,E00,518795,Staff,16,0,20,4
1713326525167,MCWP 50R,F00,518796,Staff,19,0,20,1
1713326525167,MCWP 50R,G00,518797,Staff,19,0,20,1
1713326526194,MMW 12R,A01,514034,Herbst; Matthew,15,0,16,1
1713326526194,MMW 12R,A02,514035,Herbst; Matthew,16,0,16,0
1713326527220,MMW 13R,A01,514037,Staff,12,0,16,4
1713326527220,MMW 13R,A02,514039,Staff,16,0,16,0
1713326529269,SIO 295LS,A00,523233,Staff,19,0,30,11
1713326530296,SIO 295S,A00,523232,Staff,19,0,30,11
1713326531320,SOCI 117,A01,494376,Staff,2,0,5,3
1713326532345,WES 237B,A00,494380,Staff,19,0,20,1
1713326534402,AESE 279B,A00,494370,Wade; Jon P,33,0,33,0
1713326535428,ANAR 135S,A00,494369,Braswell; Geoffrey E.,0,0,0,0
1713326536453,CAT 124RS,A01,519847,Geibel; William,17,0,20,3
1713326537477,CAT 125RS,A01,515971,Geibel; William,17,0,20,3
1713326538501,CLRE 250,A00,511389,Morris; Sheldon,9996,0,9999,3
1713326539525,CLRE 251,A00,507176,Mehta; Ravindra L.,9996,0,9999,3
1713326539525,CLRE 251,B00,511410,Mehta; Ravindra L.,9998,0,9999,1
1713326540555,CLRE 252,A00,507189,Cuomo; Raphael Eduardo,9998,0,9999,1
1713326541579,CLRE 253,A00,507199,Vaida; Florin,9997,0,9999,2
1713326541579,CLRE 253,B00,507202,Vaida; Florin,9999,0,9999,0
1713326542607,CLRE 259,A00,507211,Patel; Hemal,9996,0,9999,3
1713326543631,CLRE 260,A00,507221,Cuomo; Raphael Eduardo,9999,0,9999,0
1713326544657,CLRE 297,001,507242,Cuomo; Raphael Eduardo,9999,0,9999,0
1713326545682,CSE 191,A00,516875,Minnes Kemp; Mor Mia,9999,0,9999,0
1713326546711,CSS 201S,A01,494383,Staff,35,0,35,0
1713326547739,CSS 202S,A01,494387,Staff,35,0,35,0
1713326548766,EAP 100,A00,516065,Staff,9792,0,9999,207
1713326549790,ECE 45,A01,507414,Staff,51,0,60,9
1713326550818,ECE 100,A01,507416,Baghdadchi; Saharnaz,11,0,20,9
1713326550818,ECE 100,A02,507418,Baghdadchi; Saharnaz,20,0,20,0
1713326551845,ECE 111,A01,507420,Staff,39,0,50,11
1713326552873,ECE 197,001,548057,Sievenpiper; Daniel F.,9998,0,9999,1
1713326553901,EDS 115,A00,507243,Choi; Bailey Miyeon,28,0,28,0
1713326554925,EDS 117,A01,494379,Staff,23,0,25,2
1713326555948,EDS 125,A00,507246,Hopkins; Megan Beth,29,0,30,1
1713326556974,EDS 128A,A01,507264,Fargason; Sharon Gayle,26,0,26,0
1713326557998,EDS 128B,A01,507293,Pappas; Elizabeth,30,0,30,0
1713326559027,EDS 139,A00,507294,Fargason; Sharon Gayle,30,0,30,0
1713326559027,EDS 139,B00,507313,Pappas; Elizabeth,30,0,30,0
1713326560052,EDS 201,A00,507315,Staff,26,0,30,4
1713326561081,EDS 203,A01,507317,Halter; Christopher P.,26,0,30,4
1713326562105,EDS 204R,A01,507319,Halter; Christopher P.,3,0,30,27
1713326562105,EDS 204R,B01,507331,Heinzman; Erica M.,28,0,30,2
1713326563129,EDS 206R,A00,507332,Staff,4,0,30,26
1713326563129,EDS 206R,B00,507343,Staff,28,0,30,2
1713326564154,EDS 250,A00,507344,Hemans; Patricia Ann Benitez,36,0,40,4
1713326565180,EDS 281,A00,507345,Daly; Alan J.,18,0,18,0
1713326566205,EDS 284,A00,507350,Daly; Alan J.,16,0,16,0
1713326567232,EDS 286,A00,507359,Fine; Sarah,18,0,18,0
1713326568256,EDS 289C,A01,507361,Daly; Alan J.,18,0,18,0
1713326569284,EDS 290,A00,507366,Hofstetter; Carolyn,15,0,15,0
1713326570309,LIGM 5A,A00,507421,Fischer-Grunski; Eva K,20,0,20,0
1713326571336,LIGM 5B,A00,507423,Fischer-Grunski; Eva K,20,0,20,0
1713326572364,LIGM 5C,A00,507425,Fischer-Grunski; Eva K,20,0,20,0
1713326573392,LIIT 5AS,A00,507427,Carnelos; Chiara,20,0,20,0
1713326574415,LIIT 5BS,A00,507430,Carnelos; Chiara,20,0,20,0
1713326575439,LIIT 5CS,A00,507432,Carnelos; Chiara,20,0,20,0
1713326576462,LISP 5A,A00,507541,Munoz Sanchez; Alicia,17,0,20,3
1713326577486,LISP 5B,A00,507671,Munoz Sanchez; Alicia,15,0,20,5
1713326578511,LISP 5C,A00,507696,Munoz Sanchez; Alicia,15,0,20,5
1713326579541,MAE 197,001,528363,Boechler; Nicholas Sebastia,9998,0,9999,1
1713326580565,MATH 197,001,523477,Kedlaya; Kiran S.,9999,0,9999,0
1713326580565,MATH 197,002,563811,Zhang; Danna,9999,0,9999,0
1713326581591,MCWP 40R,A00,518780,Staff,20,0,20,0
1713326581591,MCWP 40R,B00,518781,Staff,19,0,20,1
1713326581591,MCWP 40R,C00,518783,Staff,19,0,20,1
1713326582673,MCWP 50R,A00,518791,Staff,20,0,20,0
1713326582673,MCWP 50R,B00,518792,Staff,17,0,20,3
1713326582673,MCWP 50R,C00,518793,Staff,19,0,20,1
1713326582673,MCWP 50R,D00,518794,Staff,16,0,20,4
1713326582673,MCWP 50R,E00,518795,Staff,16,0,20,4
1713326582673,MCWP 50R,F00,518796,Staff,19,0,20,1
1713326582673,MCWP 50R,G00,518797,Staff,19,0,20,1
1713326583701,MMW 12R,A01,514034,Herbst; Matthew,15,0,16,1
1713326583701,MMW 12R,A02,514035,Herbst; Matthew,16,0,16,0
1713326584727,MMW 13R,A01,514037,Staff,12,0,16,4
1713326584727,MMW 13R,A02,514039,Staff,16,0,16,0
1713326586777,SIO 295LS,A00,523233,Staff,19,0,30,11
1713326587805,SIO 295S,A00,523232,Staff,19,0,30,11
1713326588829,SOCI 117,A01,494376,Staff,2,0,5,3
1713326589854,WES 237B,A00,494380,Staff,19,0,20,1
1713326591907,AESE 279B,A00,494370,Wade; Jon P,33,0,33,0
1713326592934,ANAR 135S,A00,494369,Braswell; Geoffrey E.,0,0,0,0
1713326593959,CAT 124RS,A01,519847,Geibel; William,17,0,20,3
1713326594989,CAT 125RS,A01,515971,Geibel; William,17,0,20,3
1713326596014,CLRE 250,A00,511389,Morris; Sheldon,9996,0,9999,3
1713326597043,CLRE 251,A00,507176,Mehta; Ravindra L.,9996,0,9999,3
1713326597043,CLRE 251,B00,511410,Mehta; Ravindra L.,9998,0,9999,1
1713326598073,CLRE 252,A00,507189,Cuomo; Raphael Eduardo,9998,0,9999,1
1713326599101,CLRE 253,A00,507199,Vaida; Florin,9997,0,9999,2
1713326599101,CLRE 253,B00,507202,Vaida; Florin,9999,0,9999,0
1713326600130,CLRE 259,A00,507211,Patel; Hemal,9996,0,9999,3
1713326601156,CLRE 260,A00,507221,Cuomo; Raphael Eduardo,9999,0,9999,0
1713326602183,CLRE 297,001,507242,Cuomo; Raphael Eduardo,9999,0,9999,0
1713326603209,CSE 191,A00,516875,Minnes Kemp; Mor Mia,9999,0,9999,0
1713326604235,CSS 201S,A01,494383,Staff,35,0,35,0
1713326605264,CSS 202S,A01,494387,Staff,35,0,35,0
1713326606291,EAP 100,A00,516065,Staff,9792,0,9999,207
1713326607316,ECE 45,A01,507414,Staff,51,0,60,9
1713326608344,ECE 100,A01,507416,Baghdadchi; Saharnaz,11,0,20,9
1713326608344,ECE 100,A02,507418,Baghdadchi; Saharnaz,20,0,20,0
1713326609370,ECE 111,A01,507420,Staff,39,0,50,11
1713326610397,ECE 197,001,548057,Sievenpiper; Daniel F.,9998,0,9999,1
1713326611424,EDS 115,A00,507243,Choi; Bailey Miyeon,28,0,28,0
1713326612447,EDS 117,A01,494379,Staff,23,0,25,2
1713326613471,EDS 125,A00,507246,Hopkins; Megan Beth,29,0,30,1
1713326614499,EDS 128A,A01,507264,Fargason; Sharon Gayle,26,0,26,0
1713326615529,EDS 128B,A01,507293,Pappas; Elizabeth,30,0,30,0
1713326616556,EDS 139,A00,507294,Fargason; Sharon Gayle,30,0,30,0
1713326616556,EDS 139,B00,507313,Pappas; Elizabeth,30,0,30,0
1713326617585,EDS 201,A00,507315,Staff,26,0,30,4
1713326618609,EDS 203,A01,507317,Halter; Christopher P.,26,0,30,4
1713326619638,EDS 204R,A01,507319,Halter; Christopher P.,3,0,30,27
1713326619638,EDS 204R,B01,507331,Heinzman; Erica M.,28,0,30,2
1713326620666,EDS 206R,A00,507332,Staff,4,0,30,26
1713326620666,EDS 206R,B00,507343,Staff,28,0,30,2
1713326621691,EDS 250,A00,507344,Hemans; Patricia Ann Benitez,36,0,40,4
1713326622717,EDS 281,A00,507345,Daly; Alan J.,18,0,18,0
1713326623742,EDS 284,A00,507350,Daly; Alan J.,16,0,16,0
1713326624766,EDS 286,A00,507359,Fine; Sarah,18,0,18,0
1713326625793,EDS 289C,A01,507361,Daly; Alan J.,18,0,18,0
1713326626817,EDS 290,A00,507366,Hofstetter; Carolyn,15,0,15,0
1713326627841,LIGM 5A,A00,507421,Fischer-Grunski; Eva K,20,0,20,0
1713326628869,LIGM 5B,A00,507423,Fischer-Grunski; Eva K,20,0,20,0
1713326629898,LIGM 5C,A00,507425,Fischer-Grunski; Eva K,20,0,20,0
1713326630925,LIIT 5AS,A00,507427,Carnelos; Chiara,20,0,20,0
1713326631950,LIIT 5BS,A00,507430,Carnelos; Chiara,20,0,20,0
1713326632975,LIIT 5CS,A00,507432,Carnelos; Chiara,20,0,20,0
1713326634005,LISP 5A,A00,507541,Munoz Sanchez; Alicia,17,0,20,3
1713326635071,LISP 5B,A00,507671,Munoz Sanchez; Alicia,15,0,20,5
1713326636097,LISP 5C,A00,507696,Munoz Sanchez; Alicia,15,0,20,5
1713326637125,MAE 197,001,528363,Boechler; Nicholas Sebastia,9998,0,9999,1
1713326638150,MATH 197,001,523477,Kedlaya; Kiran S.,9999,0,9999,0
1713326638150,MATH 197,002,563811,Zhang; Danna,9999,0,9999,0
1713326639174,MCWP 40R,A00,518780,Staff,20,0,20,0
1713326639174,MCWP 40R,B00,518781,Staff,19,0,20,1
1713326639174,MCWP 40R,C00,518783,Staff,19,0,20,1
1713326640204,MCWP 50R,A00,518791,Staff,20,0,20,0
1713326640204,MCWP 50R,B00,518792,Staff,17,0,20,3
1713326640204,MCWP 50R,C00,518793,Staff,19,0,20,1
1713326640204,MCWP 50R,D00,518794,Staff,16,0,20,4
1713326640204,MCWP 50R,E00,518795,Staff,16,0,20,4
1713326640204,MCWP 50R,F00,518796,Staff,19,0,20,1
1713326640204,MCWP 50R,G00,518797,Staff,19,0,20,1
1713326641231,MMW 12R,A01,514034,Herbst; Matthew,15,0,16,1
1713326641231,MMW 12R,A02,514035,Herbst; Matthew,16,0,16,0
1713326642253,MMW 13R,A01,514037,Staff,12,0,16,4
1713326642253,MMW 13R,A02,514039,Staff,16,0,16,0
1713326644307,SIO 295LS,A00,523233,Staff,19,0,30,11
1713326645332,SIO 295S,A00,523232,Staff,19,0,30,11
1713326646357,SOCI 117,A01,494376,Staff,2,0,5,3
1713326647379,WES 237B,A00,494380,Staff,19,0,20,1
1713326649447,AESE 279B,A00,494370,Wade; Jon P,33,0,33,0
1713326650474,ANAR 135S,A00,494369,Braswell; Geoffrey E.,0,0,0,0
1713326651498,CAT 124RS,A01,519847,Geibel; William,17,0,20,3
1713326652522,CAT 125RS,A01,515971,Geibel; William,17,0,20,3
1713326653547,CLRE 250,A00,511389,Morris; Sheldon,9996,0,9999,3
1713326654574,CLRE 251,A00,507176,Mehta; Ravindra L.,9996,0,9999,3
1713326654574,CLRE 251,B00,511410,Mehta; Ravindra L.,9998,0,9999,1
1713326655597,CLRE 252,A00,507189,Cuomo; Raphael Eduardo,9998,0,9999,1
1713326656625,CLRE 253,A00,507199,Vaida; Florin,9997,0,9999,2
1713326656625,CLRE 253,B00,507202,Vaida; Florin,9999,0,9999,0
1713326657649,CLRE 259,A00,507211,Patel; Hemal,9996,0,9999,3
1713326658674,CLRE 260,A00,507221,Cuomo; Raphael Eduardo,9999,0,9999,0
1713326659700,CLRE 297,001,507242,Cuomo; Raphael Eduardo,9999,0,9999,0
1713326660731,CSE 191,A00,516875,Minnes Kemp; Mor Mia,9999,0,9999,0
1713326661759,CSS 201S,A01,494383,Staff,35,0,35,0
1713326662786,CSS 202S,A01,494387,Staff,35,0,35,0
1713326663810,EAP 100,A00,516065,Staff,9792,0,9999,207
1713326664836,ECE 45,A01,507414,Staff,51,0,60,9
1713326665860,ECE 100,A01,507416,Baghdadchi; Saharnaz,11,0,20,9
1713326665860,ECE 100,A02,507418,Baghdadchi; Saharnaz,20,0,20,0
1713326666886,ECE 111,A01,507420,Staff,39,0,50,11
1713326667909,ECE 197,001,548057,Sievenpiper; Daniel F.,9998,0,9999,1
1713326668937,EDS 115,A00,507243,Choi; Bailey Miyeon,28,0,28,0
1713326669961,EDS 117,A01,494379,Staff,23,0,25,2
1713326670985,EDS 125,A00,507246,Hopkins; Megan Beth,29,0,30,1
1713326672010,EDS 128A,A01,507264,Fargason; Sharon Gayle,26,0,26,0
1713326673036,EDS 128B,A01,507293,Pappas; Elizabeth,30,0,30,0
1713326674060,EDS 139,A00,507294,Fargason; Sharon Gayle,30,0,30,0
1713326674060,EDS 139,B00,507313,Pappas; Elizabeth,30,0,30,0
1713326675085,EDS 201,A00,507315,Staff,26,0,30,4
1713326676107,EDS 203,A01,507317,Halter; Christopher P.,26,0,30,4
1713326677132,EDS 204R,A01,507319,Halter; Christopher P.,3,0,30,27
1713326677132,EDS 204R,B01,507331,Heinzman; Erica M.,28,0,30,2
1713326678156,EDS 206R,A00,507332,Staff,4,0,30,26
1713326678156,EDS 206R,B00,507343,Staff,28,0,30,2
1713326679184,EDS 250,A00,507344,Hemans; Patricia Ann Benitez,36,0,40,4
1713326680209,EDS 281,A00,507345,Daly; Alan J.,18,0,18,0
1713326681236,EDS 284,A00,507350,Daly; Alan J.,16,0,16,0
1713326682261,EDS 286,A00,507359,Fine; Sarah,18,0,18,0
1713326683285,EDS 289C,A01,507361,Daly; Alan J.,18,0,18,0
1713326684308,EDS 290,A00,507366,Hofstetter; Carolyn,15,0,15,0
1713326685333,LIGM 5A,A00,507421,Fischer-Grunski; Eva K,20,0,20,0
1713326686411,LIGM 5B,A00,507423,Fischer-Grunski; Eva K,20,0,20,0
1713326687439,LIGM 5C,A00,507425,Fischer-Grunski; Eva K,20,0,20,0
1713326688463,LIIT 5AS,A00,507427,Carnelos; Chiara,20,0,20,0
1713326689491,LIIT 5BS,A00,507430,Carnelos; Chiara,20,0,20,0
1713326690519,LIIT 5CS,A00,507432,Carnelos; Chiara,20,0,20,0
1713326691547,LISP 5A,A00,507541,Munoz Sanchez; Alicia,17,0,20,3
1713326692575,LISP 5B,A00,507671,Munoz Sanchez; Alicia,15,0,20,5
1713326693600,LISP 5C,A00,507696,Munoz Sanchez; Alicia,15,0,20,5
1713326694628,MAE 197,001,528363,Boechler; Nicholas Sebastia,9998,0,9999,1
1713326695653,MATH 197,001,523477,Kedlaya; Kiran S.,9999,0,9999,0
1713326695653,MATH 197,002,563811,Zhang; Danna,9999,0,9999,0
1713326696681,MCWP 40R,A00,518780,Staff,20,0,20,0
1713326696681,MCWP 40R,B00,518781,Staff,19,0,20,1
1713326696681,MCWP 40R,C00,518783,Staff,19,0,20,1
1713326697707,MCWP 50R,A00,518791,Staff,20,0,20,0
1713326697707,MCWP 50R,B00,518792,Staff,17,0,20,3
1713326697707,MCWP 50R,C00,518793,Staff,19,0,20,1
1713326697707,MCWP 50R,D00,518794,Staff,16,0,20,4
1713326697707,MCWP 50R,E00,518795,Staff,16,0,20,4
1713326697707,MCWP 50R,F00,518796,Staff,19,0,20,1
1713326697707,MCWP 50R,G00,518797,Staff,19,0,20,1
1713326698732,MMW 12R,A01,514034,Herbst; Matthew,15,0,16,1
1713326698732,MMW 12R,A02,514035,Herbst; Matthew,16,0,16,0
1713326699760,MMW 13R,A01,514037,Staff,12,0,16,4
1713326699760,MMW 13R,A02,514039,Staff,16,0,16,0
1713326701812,SIO 295LS,A00,523233,Staff,19,0,30,11
1713326702836,SIO 295S,A00,523232,Staff,19,0,30,11
1713326703867,SOCI 117,A01,494376,Staff,2,0,5,3
1713326704891,WES 237B,A00,494380,Staff,19,0,20,1
1713326706949,AESE 279B,A00,494370,Wade; Jon P,33,0,33,0
1713326707976,ANAR 135S,A00,494369,Braswell; Geoffrey E.,0,0,0,0
1713326709001,CAT 124RS,A01,519847,Geibel; William,17,0,20,3
1713326710026,CAT 125RS,A01,515971,Geibel; William,17,0,20,3
1713326711050,CLRE 250,A00,511389,Morris; Sheldon,9996,0,9999,3
1713326712075,CLRE 251,A00,507176,Mehta; Ravindra L.,9996,0,9999,3
1713326712075,CLRE 251,B00,511410,Mehta; Ravindra L.,9998,0,9999,1
1713326713101,CLRE 252,A00,507189,Cuomo; Raphael Eduardo,9998,0,9999,1
1713326714126,CLRE 253,A00,507199,Vaida; Florin,9997,0,9999,2
1713326714126,CLRE 253,B00,507202,Vaida; Florin,9999,0,9999,0
1713326715151,CLRE 259,A00,507211,Patel; Hemal,9996,0,9999,3
1713326716179,CLRE 260,A00,507221,Cuomo; Raphael Eduardo,9999,0,9999,0
1713326717204,CLRE 297,001,507242,Cuomo; Raphael Eduardo,9999,0,9999,0
1713326718231,CSE 191,A00,516875,Minnes Kemp; Mor Mia,9999,0,9999,0
1713326719259,CSS 201S,A01,494383,Staff,35,0,35,0
1713326720287,CSS 202S,A01,494387,Staff,35,0,35,0
1713326721317,EAP 100,A00,516065,Staff,9792,0,9999,207
1713326722344,ECE 45,A01,507414,Staff,51,0,60,9
1713326723369,ECE 100,A01,507416,Baghdadchi; Saharnaz,11,0,20,9
1713326723369,ECE 100,A02,507418,Baghdadchi; Saharnaz,20,0,20,0
1713326724393,ECE 111,A01,507420,Staff,39,0,50,11
1713326725420,ECE 197,001,548057,Sievenpiper; Daniel F.,9998,0,9999,1
1713326726445,EDS 115,A00,507243,Choi; Bailey Miyeon,28,0,28,0
1713326727471,EDS 117,A01,494379,Staff,23,0,25,2
1713326728495,EDS 125,A00,507246,Hopkins; Megan Beth,29,0,30,1
1713326729518,EDS 128A,A01,507264,Fargason; Sharon Gayle,26,0,26,0
1713326730544,EDS 128B,A01,507293,Pappas; Elizabeth,30,0,30,0
1713326731569,EDS 139,A00,507294,Fargason; Sharon Gayle,30,0,30,0
1713326731569,EDS 139,B00,507313,Pappas; Elizabeth,30,0,30,0
1713326732594,EDS 201,A00,507315,Staff,26,0,30,4
1713326733617,EDS 203,A01,507317,Halter; Christopher P.,26,0,30,4
1713326734646,EDS 204R,A01,507319,Halter; Christopher P.,3,0,30,27
1713326734646,EDS 204R,B01,507331,Heinzman; Erica M.,28,0,30,2
1713326735673,EDS 206R,A00,507332,Staff,4,0,30,26
1713326735673,EDS 206R,B00,507343,Staff,28,0,30,2
1713326736698,EDS 250,A00,507344,Hemans; Patricia Ann Benitez,36,0,40,4
1713326737723,EDS 281,A00,507345,Daly; Alan J.,18,0,18,0
1713326738747,EDS 284,A00,507350,Daly; Alan J.,16,0,16,0
1713326739775,EDS 286,A00,507359,Fine; Sarah,18,0,18,0
1713326740803,EDS 289C,A01,507361,Daly; Alan J.,18,0,18,0
1713326741826,EDS 290,A00,507366,Hofstetter; Carolyn,15,0,15,0
1713326742850,LIGM 5A,A00,507421,Fischer-Grunski; Eva K,20,0,20,0
1713326743877,LIGM 5B,A00,507423,Fischer-Grunski; Eva K,20,0,20,0
1713326744902,LIGM 5C,A00,507425,Fischer-Grunski; Eva K,20,0,20,0
1713326745928,LIIT 5AS,A00,507427,Carnelos; Chiara,20,0,20,0
1713326746953,LIIT 5BS,A00,507430,Carnelos; Chiara,20,0,20,0
1713326747977,LIIT 5CS,A00,507432,Carnelos; Chiara,20,0,20,0
1713326749010,LISP 5A,A00,507541,Munoz Sanchez; Alicia,17,0,20,3
1713326750034,LISP 5B,A00,507671,Munoz Sanchez; Alicia,15,0,20,5
1713326751062,LISP 5C,A00,507696,Munoz Sanchez; Alicia,15,0,20,5
1713326752086,MAE 197,001,528363,Boechler; Nicholas Sebastia,9998,0,9999,1
1713326753110,MATH 197,001,523477,Kedlaya; Kiran S.,9999,0,9999,0
1713326753110,MATH 197,002,563811,Zhang; Danna,9999,0,9999,0
1713326754141,MCWP 40R,A00,518780,Staff,20,0,20,0
1713326754141,MCWP 40R,B00,518781,Staff,19,0,20,1
1713326754141,MCWP 40R,C00,518783,Staff,19,0,20,1
1713326755168,MCWP 50R,A00,518791,Staff,20,0,20,0
1713326755168,MCWP 50R,B00,518792,Staff,17,0,20,3
1713326755168,MCWP 50R,C00,518793,Staff,19,0,20,1
1713326755168,MCWP 50R,D00,518794,Staff,16,0,20,4
1713326755168,MCWP 50R,E00,518795,Staff,16,0,20,4
1713326755168,MCWP 50R,F00,518796,Staff,19,0,20,1
1713326755168,MCWP 50R,G00,518797,Staff,19,0,20,1
1713326756192,MMW 12R,A01,514034,Herbst; Matthew,15,0,16,1
1713326756192,MMW 12R,A02,514035,Herbst; Matthew,16,0,16,0
1713326757215,MMW 13R,A01,514037,Staff,12,0,16,4
1713326757215,MMW 13R,A02,514039,Staff,16,0,16,0
1713326759265,SIO 295LS,A00,523233,Staff,19,0,30,11
1713326760289,SIO 295S,A00,523232,Staff,19,0,30,11
1713326761313,SOCI 117,A01,494376,Staff,2,0,5,3
1713326762336,WES 237B,A00,494380,Staff,19,0,20,1
1713326764404,AESE 279B,A00,494370,Wade; Jon P,33,0,33,0
1713326765432,ANAR 135S,A00,494369,Braswell; Geoffrey E.,0,0,0,0
1713326766454,CAT 124RS,A01,519847,Geibel; William,17,0,20,3
1713326767479,CAT 125RS,A01,515971,Geibel; William,17,0,20,3
1713326768503,CLRE 250,A00,511389,Morris; Sheldon,9996,0,9999,3
1713326769527,CLRE 251,A00,507176,Mehta; Ravindra L.,9996,0,9999,3
1713326769527,CLRE 251,B00,511410,Mehta; Ravindra L.,9998,0,9999,1
1713326770556,CLRE 252,A00,507189,Cuomo; Raphael Eduardo,9998,0,9999,1
1713326771581,CLRE 253,A00,507199,Vaida; Florin,9997,0,9999,2
1713326771581,CLRE 253,B00,507202,Vaida; Florin,9999,0,9999,0
1713326772608,CLRE 259,A00,507211,Patel; Hemal,9996,0,9999,3
1713326773631,CLRE 260,A00,507221,Cuomo; Raphael Eduardo,9999,0,9999,0
1713326774655,CLRE 297,001,507242,Cuomo; Raphael Eduardo,9999,0,9999,0
1713326775678,CSE 191,A00,516875,Minnes Kemp; Mor Mia,9999,0,9999,0
1713326776708,CSS 201S,A01,494383,Staff,35,0,35,0
1713326777733,CSS 202S,A01,494387,Staff,35,0,35,0
1713326778761,EAP 100,A00,516065,Staff,9792,0,9999,207
1713326779786,ECE 45,A01,507414,Staff,51,0,60,9
1713326780810,ECE 100,A01,507416,Baghdadchi; Saharnaz,11,0,20,9
1713326780810,ECE 100,A02,507418,Baghdadchi; Saharnaz,20,0,20,0
1713326781837,ECE 111,A01,507420,Staff,39,0,50,11
1713326782878,ECE 197,001,548057,Sievenpiper; Daniel F.,9998,0,9999,1
1713326783903,EDS 115,A00,507243,Choi; Bailey Miyeon,28,0,28,0
1713326784933,EDS 117,A01,494379,Staff,23,0,25,2
1713326785956,EDS 125,A00,507246,Hopkins; Megan Beth,29,0,30,1
1713326786981,EDS 128A,A01,507264,Fargason; Sharon Gayle,26,0,26,0
1713326788005,EDS 128B,A01,507293,Pappas; Elizabeth,30,0,30,0
1713326789032,EDS 139,A00,507294,Fargason; Sharon Gayle,30,0,30,0
1713326789032,EDS 139,B00,507313,Pappas; Elizabeth,30,0,30,0
1713326790113,EDS 201,A00,507315,Staff,26,0,30,4
1713326791139,EDS 203,A01,507317,Halter; Christopher P.,26,0,30,4
1713326792167,EDS 204R,A01,507319,Halter; Christopher P.,3,0,30,27
1713326792167,EDS 204R,B01,507331,Heinzman; Erica M.,28,0,30,2
1713326793190,EDS 206R,A00,507332,Staff,4,0,30,26
1713326793190,EDS 206R,B00,507343,Staff,28,0,30,2
1713326794215,EDS 250,A00,507344,Hemans; Patricia Ann Benitez,36,0,40,4
1713326795244,EDS 281,A00,507345,Daly; Alan J.,18,0,18,0
1713326796273,EDS 284,A00,507350,Daly; Alan J.,16,0,16,0
1713326797296,EDS 286,A00,507359,Fine; Sarah,18,0,18,0
1713326798326,EDS 289C,A01,507361,Daly; Alan J.,18,0,18,0
1713326799354,EDS 290,A00,507366,Hofstetter; Carolyn,15,0,15,0
1713326800383,LIGM 5A,A00,507421,Fischer-Grunski; Eva K,20,0,20,0
1713326801408,LIGM 5B,A00,507423,Fischer-Grunski; Eva K,20,0,20,0
1713326802437,LIGM 5C,A00,507425,Fischer-Grunski; Eva K,20,0,20,0
1713326803462,LIIT 5AS,A00,507427,Carnelos; Chiara,20,0,20,0
1713326804490,LIIT 5BS,A00,507430,Carnelos; Chiara,20,0,20,0
1713326805519,LIIT 5CS,A00,507432,Carnelos; Chiara,20,0,20,0
1713326806545,LISP 5A,A00,507541,Munoz Sanchez; Alicia,17,0,20,3
1713326807569,LISP 5B,A00,507671,Munoz Sanchez; Alicia,15,0,20,5
1713326808598,LISP 5C,A00,507696,Munoz Sanchez; Alicia,15,0,20,5
1713326809623,MAE 197,001,528363,Boechler; Nicholas Sebastia,9998,0,9999,1
1713326810650,MATH 197,001,523477,Kedlaya; Kiran S.,9999,0,9999,0
1713326810650,MATH 197,002,563811,Zhang; Danna,9999,0,9999,0
1713326811675,MCWP 40R,A00,518780,Staff,20,0,20,0
1713326811675,MCWP 40R,B00,518781,Staff,19,0,20,1
1713326811675,MCWP 40R,C00,518783,Staff,19,0,20,1
1713326812704,MCWP 50R,A00,518791,Staff,20,0,20,0
1713326812704,MCWP 50R,B00,518792,Staff,17,0,20,3
1713326812704,MCWP 50R,C00,518793,Staff,19,0,20,1
1713326812704,MCWP 50R,D00,518794,Staff,16,0,20,4
1713326812704,MCWP 50R,E00,518795,Staff,16,0,20,4
1713326812704,MCWP 50R,F00,518796,Staff,19,0,20,1
1713326812704,MCWP 50R,G00,518797,Staff,19,0,20,1
1713326813728,MMW 12R,A01,514034,Herbst; Matthew,15,0,16,1
1713326813728,MMW 12R,A02,514035,Herbst; Matthew,16,0,16,0
1713326814753,MMW 13R,A01,514037,Staff,12,0,16,4
1713326814753,MMW 13R,A02,514039,Staff,16,0,16,0
1713326816812,SIO 295LS,A00,523233,Staff,19,0,30,11
1713326817836,SIO 295S,A00,523232,Staff,19,0,30,11
1713326818861,SOCI 117,A01,494376,Staff,2,0,5,3
1713326819885,WES 237B,A00,494380,Staff,19,0,20,1
1713326821943,AESE 279B,A00,494370,Wade; Jon P,33,0,33,0
1713326822968,ANAR 135S,A00,494369,Braswell; Geoffrey E.,0,0,0,0
1713326823997,CAT 124RS,A01,519847,Geibel; William,17,0,20,3
1713326825022,CAT 125RS,A01,515971,Geibel; William,17,0,20,3
1713326826046,CLRE 250,A00,511389,Morris; Sheldon,9996,0,9999,3
1713326827072,CLRE 251,A00,507176,Mehta; Ravindra L.,9996,0,9999,3
1713326827072,CLRE 251,B00,511410,Mehta; Ravindra L.,9998,0,9999,1
1713326828097,CLRE 252,A00,507189,Cuomo; Raphael Eduardo,9998,0,9999,1
1713326829123,CLRE 253,A00,507199,Vaida; Florin,9997,0,9999,2
1713326829123,CLRE 253,B00,507202,Vaida; Florin,9999,0,9999,0
1713326830147,CLRE 259,A00,507211,Patel; Hemal,9996,0,9999,3
1713326831170,CLRE 260,A00,507221,Cuomo; Raphael Eduardo,9999,0,9999,0
1713326832198,CLRE 297,001,507242,Cuomo; Raphael Eduardo,9999,0,9999,0
1713326833226,CSE 191,A00,516875,Minnes Kemp; Mor Mia,9999,0,9999,0
1713326834251,CSS 201S,A01,494383,Staff,35,0,35,0
1713326835276,CSS 202S,A01,494387,Staff,35,0,35,0
1713326836301,EAP 100,A00,516065,Staff,9792,0,9999,207
1713326837325,ECE 45,A01,507414,Staff,51,0,60,9
1713326838349,ECE 100,A01,507416,Baghdadchi; Saharnaz,11,0,20,9
1713326838349,ECE 100,A02,507418,Baghdadchi; Saharnaz,20,0,20,0
1713326839372,ECE 111,A01,507420,Staff,39,0,50,11
1713326840398,ECE 197,001,548057,Sievenpiper; Daniel F.,9998,0,9999,1
1713326841425,EDS 115,A00,507243,Choi; Bailey Miyeon,28,0,28,0
1713326842451,EDS 117,A01,494379,Staff,23,0,25,2
1713326843476,EDS 125,A00,507246,Hopkins; Megan Beth,29,0,30,1
1713326844503,EDS 128A,A01,507264,Fargason; Sharon Gayle,26,0,26,0
1713326845532,EDS 128B,A01,507293,Pappas; Elizabeth,30,0,30,0
1713326846556,EDS 139,A00,507294,Fargason; Sharon Gayle,30,0,30,0
1713326846556,EDS 139,B00,507313,Pappas; Elizabeth,30,0,30,0
1713326847580,EDS 201,A00,507315,Staff,26,0,30,4
1713326848605,EDS 203,A01,507317,Halter; Christopher P.,26,0,30,4
1713326849628,EDS 204R,A01,507319,Halter; Christopher P.,3,0,30,27
1713326849628,EDS 204R,B01,507331,Heinzman; Erica M.,28,0,30,2
1713326850653,EDS 206R,A00,507332,Staff,4,0,30,26
1713326850653,EDS 206R,B00,507343,Staff,28,0,30,2
1713326851679,EDS 250,A00,507344,Hemans; Patricia Ann Benitez,36,0,40,4
1713326852703,EDS 281,A00,507345,Daly; Alan J.,18,0,18,0
1713326853730,EDS 284,A00,507350,Daly; Alan J.,16,0,16,0
1713326854758,EDS 286,A00,507359,Fine; Sarah,18,0,18,0
1713326855782,EDS 289C,A01,507361,Daly; Alan J.,18,0,18,0
1713326856809,EDS 290,A00,507366,Hofstetter; Carolyn,15,0,15,0
1713326857835,LIGM 5A,A00,507421,Fischer-Grunski; Eva K,20,0,20,0
1713326858858,LIGM 5B,A00,507423,Fischer-Grunski; Eva K,20,0,20,0
1713326859883,LIGM 5C,A00,507425,Fischer-Grunski; Eva K,20,0,20,0
1713326860908,LIIT 5AS,A00,507427,Carnelos; Chiara,20,0,20,0
1713326861933,LIIT 5BS,A00,507430,Carnelos; Chiara,20,0,20,0
1713326862958,LIIT 5CS,A00,507432,Carnelos; Chiara,20,0,20,0
1713326863983,LISP 5A,A00,507541,Munoz Sanchez; Alicia,17,0,20,3
1713326865008,LISP 5B,A00,507671,Munoz Sanchez; Alicia,15,0,20,5
1713326866033,LISP 5C,A00,507696,Munoz Sanchez; Alicia,15,0,20,5
1713326867057,MAE 197,001,528363,Boechler; Nicholas Sebastia,9998,0,9999,1
1713326868086,MATH 197,001,523477,Kedlaya; Kiran S.,9999,0,9999,0
1713326868086,MATH 197,002,563811,Zhang; Danna,9999,0,9999,0
1713326869111,MCWP 40R,A00,518780,Staff,20,0,20,0
1713326869111,MCWP 40R,B00,518781,Staff,19,0,20,1
1713326869111,MCWP 40R,C00,518783,Staff,19,0,20,1
1713326870136,MCWP 50R,A00,518791,Staff,20,0,20,0
1713326870136,MCWP 50R,B00,518792,Staff,17,0,20,3
1713326870136,MCWP 50R,C00,518793,Staff,19,0,20,1
1713326870136,MCWP 50R,D00,518794,Staff,16,0,20,4
1713326870136,MCWP 50R,E00,518795,Staff,16,0,20,4
1713326870136,MCWP 50R,F00,518796,Staff,19,0,20,1
1713326870136,MCWP 50R,G00,518797,Staff,19,0,20,1
1713326871162,MMW 12R,A01,514034,Herbst; Matthew,15,0,16,1
1713326871162,MMW 12R,A02,514035,Herbst; Matthew,16,0,16,0
1713326872186,MMW 13R,A01,514037,Staff,12,0,16,4
1713326872186,MMW 13R,A02,514039,Staff,16,0,16,0
1713326874236,SIO 295LS,A00,523233,Staff,19,0,30,11
1713326875266,SIO 295S,A00,523232,Staff,19,0,30,11
1713326876289,SOCI 117,A01,494376,Staff,2,0,5,3
1713326877312,WES 237B,A00,494380,Staff,19,0,20,1
1713326879371,AESE 279B,A00,494370,Wade; Jon P,33,0,33,0
1713326880395,ANAR 135S,A00,494369,Braswell; Geoffrey E.,0,0,0,0
1713326881422,CAT 124RS,A01,519847,Geibel; William,17,0,20,3
1713326882447,CAT 125RS,A01,515971,Geibel; William,17,0,20,3
1713326883470,CLRE 250,A00,511389,Morris; Sheldon,9996,0,9999,3
1713326884495,CLRE 251,A00,507176,Mehta; Ravindra L.,9996,0,9999,3
1713326884495,CLRE 251,B00,511410,Mehta; Ravindra L.,9998,0,9999,1
1713326885521,CLRE 252,A00,507189,Cuomo; Raphael Eduardo,9998,0,9999,1
1713326886547,CLRE 253,A00,507199,Vaida; Florin,9997,0,9999,2
1713326886547,CLRE 253,B00,507202,Vaida; Florin,9999,0,9999,0
1713326887576,CLRE 259,A00,507211,Patel; Hemal,9996,0,9999,3
1713326888602,CLRE 260,A00,507221,Cuomo; Raphael Eduardo,9999,0,9999,0
1713326889628,CLRE 297,001,507242,Cuomo; Raphael Eduardo,9999,0,9999,0
1713326890655,CSE 191,A00,516875,Minnes Kemp; Mor Mia,9999,0,9999,0
1713326891684,CSS 201S,A01,494383,Staff,35,0,35,0
1713326892709,CSS 202S,A01,494387,Staff,35,0,35,0
1713326893788,EAP 100,A00,516065,Staff,9792,0,9999,207
1713326894815,ECE 45,A01,507414,Staff,51,0,60,9
1713326895840,ECE 100,A01,507416,Baghdadchi; Saharnaz,11,0,20,9
1713326895840,ECE 100,A02,507418,Baghdadchi; Saharnaz,20,0,20,0
1713326896868,ECE 111,A01,507420,Staff,39,0,50,11
1713326897894,ECE 197,001,548057,Sievenpiper; Daniel F.,9998,0,9999,1
1713326898921,EDS 115,A00,507243,Choi; Bailey Miyeon,28,0,28,0
1713326899948,EDS 117,A01,494379,Staff,23,0,25,2
1713326900976,EDS 125,A00,507246,Hopkins; Megan Beth,29,0,30,1
1713326902002,EDS 128A,A01,507264,Fargason; Sharon Gayle,26,0,26,0
1713326903031,EDS 128B,A01,507293,Pappas; Elizabeth,30,0,30,0
1713326904055,EDS 139,A00,507294,Fargason; Sharon Gayle,30,0,30,0
1713326904055,EDS 139,B00,507313,Pappas; Elizabeth,30,0,30,0
1713326905083,EDS 201,A00,507315,Staff,26,0,30,4
1713326906108,EDS 203,A01,507317,Halter; Christopher P.,26,0,30,4
1713326907136,EDS 204R,A01,507319,Halter; Christopher P.,3,0,30,27
1713326907136,EDS 204R,B01,507331,Heinzman; Erica M.,28,0,30,2
1713326908160,EDS 206R,A00,507332,Staff,4,0,30,26
1713326908160,EDS 206R,B00,507343,Staff,28,0,30,2
1713326909188,EDS 250,A00,507344,Hemans; Patricia Ann Benitez,36,0,40,4
1713326910214,EDS 281,A00,507345,Daly; Alan J.,18,0,18,0
1713326911239,EDS 284,A00,507350,Daly; Alan J.,16,0,16,0
1713326912263,EDS 286,A00,507359,Fine; Sarah,18,0,18,0
1713326913352,EDS 289C,A01,507361,Daly; Alan J.,18,0,18,0
1713326914375,EDS 290,A00,507366,Hofstetter; Carolyn,15,0,15,0
1713326915400,LIGM 5A,A00,507421,Fischer-Grunski; Eva K,20,0,20,0
1713326916425,LIGM 5B,A00,507423,Fischer-Grunski; Eva K,20,0,20,0
1713326917450,LIGM 5C,A00,507425,Fischer-Grunski; Eva K,20,0,20,0
1713326918477,LIIT 5AS,A00,507427,Carnelos; Chiara,20,0,20,0
1713326919505,LIIT 5BS,A00,507430,Carnelos; Chiara,20,0,20,0
1713326920530,LIIT 5CS,A00,507432,Carnelos; Chiara,20,0,20,0
1713326921556,LISP 5A,A00,507541,Munoz Sanchez; Alicia,17,0,20,3
1713326922582,LISP 5B,A00,507671,Munoz Sanchez; Alicia,15,0,20,5
1713326923608,LISP 5C,A00,507696,Munoz Sanchez; Alicia,15,0,20,5
1713326924634,MAE 197,001,528363,Boechler; Nicholas Sebastia,9998,0,9999,1
1713326925658,MATH 197,001,523477,Kedlaya; Kiran S.,9999,0,9999,0
1713326925658,MATH 197,002,563811,Zhang; Danna,9999,0,9999,0
1713326926687,MCWP 40R,A00,518780,Staff,20,0,20,0
1713326926687,MCWP 40R,B00,518781,Staff,19,0,20,1
1713326926687,MCWP 40R,C00,518783,Staff,19,0,20,1
1713326927717,MCWP 50R,A00,518791,Staff,20,0,20,0
1713326927717,MCWP 50R,B00,518792,Staff,17,0,20,3
1713326927717,MCWP 50R,C00,518793,Staff,19,0,20,1
1713326927717,MCWP 50R,D00,518794,Staff,16,0,20,4
1713326927717,MCWP 50R,E00,518795,Staff,16,0,20,4
1713326927717,MCWP 50R,F00,518796,Staff,19,0,20,1
1713326927717,MCWP 50R,G00,518797,Staff,19,0,20,1
1713326928742,MMW 12R,A01,514034,Herbst; Matthew,15,0,16,1
1713326928742,MMW 12R,A02,514035,Herbst; Matthew,16,0,16,0
1713326929765,MMW 13R,A01,514037,Staff,12,0,16,4
1713326929765,MMW 13R,A02,514039,Staff,16,0,16,0
1713326931816,SIO 295LS,A00,523233,Staff,19,0,30,11
1713326932843,SIO 295S,A00,523232,Staff,19,0,30,11
1713326933872,SOCI 117,A01,494376,Staff,2,0,5,3
1713326934898,WES 237B,A00,494380,Staff,19,0,20,1
1713326936961,AESE 279B,A00,494370,Wade; Jon P,33,0,33,0
1713326937984,ANAR 135S,A00,494369,Braswell; Geoffrey E.,0,0,0,0
1713326939016,CAT 124RS,A01,519847,Geibel; William,17,0,20,3
1713326940041,CAT 125RS,A01,515971,Geibel; William,17,0,20,3
1713326941064,CLRE 250,A00,511389,Morris; Sheldon,9996,0,9999,3
1713326942091,CLRE 251,A00,507176,Mehta; Ravindra L.,9996,0,9999,3
1713326942091,CLRE 251,B00,511410,Mehta; Ravindra L.,9998,0,9999,1
1713326943117,CLRE 252,A00,507189,Cuomo; Raphael Eduardo,9998,0,9999,1
1713326944141,CLRE 253,A00,507199,Vaida; Florin,9997,0,9999,2
1713326944141,CLRE 253,B00,507202,Vaida; Florin,9999,0,9999,0
1713326945165,CLRE 259,A00,507211,Patel; Hemal,9996,0,9999,3
1713326946192,CLRE 260,A00,507221,Cuomo; Raphael Eduardo,9999,0,9999,0
1713326947217,CLRE 297,001,507242,Cuomo; Raphael Eduardo,9999,0,9999,0
1713326948244,CSE 191,A00,516875,Minnes Kemp; Mor Mia,9999,0,9999,0
1713326949272,CSS 201S,A01,494383,Staff,35,0,35,0
1713326950296,CSS 202S,A01,494387,Staff,35,0,35,0
1713326951320,EAP 100,A00,516065,Staff,9792,0,9999,207
1713326952344,ECE 45,A01,507414,Staff,51,0,60,9
1713326953372,ECE 100,A01,507416,Baghdadchi; Saharnaz,11,0,20,9
1713326953372,ECE 100,A02,507418,Baghdadchi; Saharnaz,20,0,20,0
1713326954396,ECE 111,A01,507420,Staff,39,0,50,11
1713326955422,ECE 197,001,548057,Sievenpiper; Daniel F.,9998,0,9999,1
1713326956448,EDS 115,A00,507243,Choi; Bailey Miyeon,28,0,28,0
1713326957479,EDS 117,A01,494379,Staff,23,0,25,2
1713326958505,EDS 125,A00,507246,Hopkins; Megan Beth,29,0,30,1
1713326959534,EDS 128A,A01,507264,Fargason; Sharon Gayle,26,0,26,0
1713326960563,EDS 128B,A01,507293,Pappas; Elizabeth,30,0,30,0
1713326961589,EDS 139,A00,507294,Fargason; Sharon Gayle,30,0,30,0
1713326961589,EDS 139,B00,507313,Pappas; Elizabeth,30,0,30,0
1713326962614,EDS 201,A00,507315,Staff,26,0,30,4
1713326963640,EDS 203,A01,507317,Halter; Christopher P.,26,0,30,4
1713326964665,EDS 204R,A01,507319,Halter; Christopher P.,3,0,30,27
1713326964665,EDS 204R,B01,507331,Heinzman; Erica M.,28,0,30,2
1713326965691,EDS 206R,A00,507332,Staff,4,0,30,26
1713326965691,EDS 206R,B00,507343,Staff,28,0,30,2
1713326966715,EDS 250,A00,507344,Hemans; Patricia Ann Benitez,36,0,40,4
1713326967742,EDS 281,A00,507345,Daly; Alan J.,18,0,18,0
1713326968767,EDS 284,A00,507350,Daly; Alan J.,16,0,16,0
1713326969790,EDS 286,A00,507359,Fine; Sarah,18,0,18,0
1713326970814,EDS 289C,A01,507361,Daly; Alan J.,18,0,18,0
1713326971841,EDS 290,A00,507366,Hofstetter; Carolyn,15,0,15,0
1713326972866,LIGM 5A,A00,507421,Fischer-Grunski; Eva K,20,0,20,0
1713326973904,LIGM 5B,A00,507423,Fischer-Grunski; Eva K,20,0,20,0
1713326974928,LIGM 5C,A00,507425,Fischer-Grunski; Eva K,20,0,20,0
1713326975954,LIIT 5AS,A00,507427,Carnelos; Chiara,20,0,20,0
1713326976977,LIIT 5BS,A00,507430,Carnelos; Chiara,20,0,20,0
1713326978002,LIIT 5CS,A00,507432,Carnelos; Chiara,20,0,20,0
1713326979027,LISP 5A,A00,507541,Munoz Sanchez; Alicia,17,0,20,3
1713326980051,LISP 5B,A00,507671,Munoz Sanchez; Alicia,15,0,20,5
1713326981076,LISP 5C,A00,507696,Munoz Sanchez; Alicia,15,0,20,5
1713326982101,MAE 197,001,528363,Boechler; Nicholas Sebastia,9998,0,9999,1
1713326983126,MATH 197,001,523477,Kedlaya; Kiran S.,9999,0,9999,0
1713326983126,MATH 197,002,563811,Zhang; Danna,9999,0,9999,0
1713326984155,MCWP 40R,A00,518780,Staff,20,0,20,0
1713326984155,MCWP 40R,B00,518781,Staff,19,0,20,1
1713326984155,MCWP 40R,C00,518783,Staff,19,0,20,1
1713326985183,MCWP 50R,A00,518791,Staff,20,0,20,0
1713326985183,MCWP 50R,B00,518792,Staff,17,0,20,3
1713326985183,MCWP 50R,C00,518793,Staff,19,0,20,1
1713326985183,MCWP 50R,D00,518794,Staff,16,0,20,4
1713326985183,MCWP 50R,E00,518795,Staff,16,0,20,4
1713326985183,MCWP 50R,F00,518796,Staff,19,0,20,1
1713326985183,MCWP 50R,G00,518797,Staff,19,0,20,1
1713326986212,MMW 12R,A01,514034,Herbst; Matthew,15,0,16,1
1713326986212,MMW 12R,A02,514035,Herbst; Matthew,16,0,16,0
1713326987240,MMW 13R,A01,514037,Staff,12,0,16,4
1713326987240,MMW 13R,A02,514039,Staff,16,0,16,0
1713326989289,SIO 295LS,A00,523233,Staff,19,0,30,11
1713326990318,SIO 295S,A00,523232,Staff,19,0,30,11
1713326991345,SOCI 117,A01,494376,Staff,2,0,5,3
1713326992368,WES 237B,A00,494380,Staff,19,0,20,1
1713326994422,AESE 279B,A00,494370,Wade; Jon P,33,0,33,0
1713326995448,ANAR 135S,A00,494369,Braswell; Geoffrey E.,0,0,0,0
1713326996475,CAT 124RS,A01,519847,Geibel; William,17,0,20,3
1713326997556,CAT 125RS,A01,515971,Geibel; William,17,0,20,3
1713326998584,CLRE 250,A00,511389,Morris; Sheldon,9996,0,9999,3
1713326999608,CLRE 251,A00,507176,Mehta; Ravindra L.,9996,0,9999,3
1713326999608,CLRE 251,B00,511410,Mehta; Ravindra L.,9998,0,9999,1
1713327000636,CLRE 252,A00,507189,Cuomo; Raphael Eduardo,9998,0,9999,1
1713327001661,CLRE 253,A00,507199,Vaida; Florin,9997,0,9999,2
1713327001661,CLRE 253,B00,507202,Vaida; Florin,9999,0,9999,0
1713327002685,CLRE 259,A00,507211,Patel; Hemal,9996,0,9999,3
1713327003709,CLRE 260,A00,507221,Cuomo; Raphael Eduardo,9999,0,9999,0
1713327004736,CLRE 297,001,507242,Cuomo; Raphael Eduardo,9999,0,9999,0
1713327005763,CSE 191,A00,516875,Minnes Kemp; Mor Mia,9999,0,9999,0
1713327006790,CSS 201S,A01,494383,Staff,35,0,35,0
1713327007819,CSS 202S,A01,494387,Staff,35,0,35,0
1713327008846,EAP 100,A00,516065,Staff,9792,0,9999,207
1713327009870,ECE 45,A01,507414,Staff,51,0,60,9
1713327010896,ECE 100,A01,507416,Baghdadchi; Saharnaz,11,0,20,9
1713327010896,ECE 100,A02,507418,Baghdadchi; Saharnaz,20,0,20,0
1713327011924,ECE 111,A01,507420,Staff,39,0,50,11
1713327012952,ECE 197,001,548057,Sievenpiper; Daniel F.,9998,0,9999,1
1713327013976,EDS 115,A00,507243,Choi; Bailey Miyeon,28,0,28,0
1713327015000,EDS 117,A01,494379,Staff,23,0,25,2
1713327016025,EDS 125,A00,507246,Hopkins; Megan Beth,29,0,30,1
1713327017050,EDS 128A,A01,507264,Fargason; Sharon Gayle,26,0,26,0
1713327018074,EDS 128B,A01,507293,Pappas; Elizabeth,30,0,30,0
1713327019102,EDS 139,A00,507294,Fargason; Sharon Gayle,30,0,30,0
1713327019102,EDS 139,B00,507313,Pappas; Elizabeth,30,0,30,0
1713327020131,EDS 201,A00,507315,Staff,26,0,30,4
1713327021156,EDS 203,A01,507317,Halter; Christopher P.,26,0,30,4
1713327022182,EDS 204R,A01,507319,Halter; Christopher P.,3,0,30,27
1713327022182,EDS 204R,B01,507331,Heinzman; Erica M.,28,0,30,2
1713327023207,EDS 206R,A00,507332,Staff,4,0,30,26
1713327023207,EDS 206R,B00,507343,Staff,28,0,30,2
1713327024232,EDS 250,A00,507344,Hemans; Patricia Ann Benitez,36,0,40,4
1713327025258,EDS 281,A00,507345,Daly; Alan J.,18,0,18,0
1713327026285,EDS 284,A00,507350,Daly; Alan J.,16,0,16,0
1713327027312,EDS 286,A00,507359,Fine; Sarah,18,0,18,0
1713327028338,EDS 289C,A01,507361,Daly; Alan J.,18,0,18,0
1713327029363,EDS 290,A00,507366,Hofstetter; Carolyn,15,0,15,0
1713327030389,LIGM 5A,A00,507421,Fischer-Grunski; Eva K,20,0,20,0
1713327031418,LIGM 5B,A00,507423,Fischer-Grunski; Eva K,20,0,20,0
1713327032443,LIGM 5C,A00,507425,Fischer-Grunski; Eva K,20,0,20,0
1713327033470,LIIT 5AS,A00,507427,Carnelos; Chiara,20,0,20,0
1713327034499,LIIT 5BS,A00,507430,Carnelos; Chiara,20,0,20,0
1713327035524,LIIT 5CS,A00,507432,Carnelos; Chiara,20,0,20,0
1713327036549,LISP 5A,A00,507541,Munoz Sanchez; Alicia,17,0,20,3
1713327037576,LISP 5B,A00,507671,Munoz Sanchez; Alicia,15,0,20,5
1713327038605,LISP 5C,A00,507696,Munoz Sanchez; Alicia,15,0,20,5
1713327039633,MAE 197,001,528363,Boechler; Nicholas Sebastia,9998,0,9999,1
1713327040658,MATH 197,001,523477,Kedlaya; Kiran S.,9999,0,9999,0
1713327040658,MATH 197,002,563811,Zhang; Danna,9999,0,9999,0
1713327041683,MCWP 40R,A00,518780,Staff,20,0,20,0
1713327041683,MCWP 40R,B00,518781,Staff,19,0,20,1
1713327041683,MCWP 40R,C00,518783,Staff,19,0,20,1
1713327042709,MCWP 50R,A00,518791,Staff,20,0,20,0
1713327042709,MCWP 50R,B00,518792,Staff,17,0,20,3
1713327042709,MCWP 50R,C00,518793,Staff,19,0,20,1
1713327042709,MCWP 50R,D00,518794,Staff,16,0,20,4
1713327042709,MCWP 50R,E00,518795,Staff,16,0,20,4
1713327042709,MCWP 50R,F00,518796,Staff,19,0,20,1
1713327042709,MCWP 50R,G00,518797,Staff,19,0,20,1
1713327043734,MMW 12R,A01,514034,Herbst; Matthew,15,0,16,1
1713327043734,MMW 12R,A02,514035,Herbst; Matthew,16,0,16,0
1713327044759,MMW 13R,A01,514037,Staff,12,0,16,4
1713327044759,MMW 13R,A02,514039,Staff,16,0,16,0
1713327046807,SIO 295LS,A00,523233,Staff,19,0,30,11
1713327047831,SIO 295S,A00,523232,Staff,19,0,30,11
1713327048858,SOCI 117,A01,494376,Staff,2,0,5,3
1713327049881,WES 237B,A00,494380,Staff,19,0,20,1
1713327051948,AESE 279B,A00,494370,Wade; Jon P,33,0,33,0
1713327052977,ANAR 135S,A00,494369,Braswell; Geoffrey E.,0,0,0,0
1713327054004,CAT 124RS,A01,519847,Geibel; William,17,0,20,3
1713327055029,CAT 125RS,A01,515971,Geibel; William,17,0,20,3
1713327056057,CLRE 250,A00,511389,Morris; Sheldon,9996,0,9999,3
1713327057082,CLRE 251,A00,507176,Mehta; Ravindra L.,9996,0,9999,3
1713327057082,CLRE 251,B00,511410,Mehta; Ravindra L.,9998,0,9999,1
1713327058106,CLRE 252,A00,507189,Cuomo; Raphael Eduardo,9998,0,9999,1
1713327059134,CLRE 253,A00,507199,Vaida; Florin,9997,0,9999,2
1713327059134,CLRE 253,B00,507202,Vaida; Florin,9999,0,9999,0
1713327060158,CLRE 259,A00,507211,Patel; Hemal,9996,0,9999,3
1713327061183,CLRE 260,A00,507221,Cuomo; Raphael Eduardo,9999,0,9999,0
1713327062209,CLRE 297,001,507242,Cuomo; Raphael Eduardo,9999,0,9999,0
1713327063235,CSE 191,A00,516875,Minnes Kemp; Mor Mia,9999,0,9999,0
1713327064265,CSS 201S,A01,494383,Staff,35,0,35,0
1713327065294,CSS 202S,A01,494387,Staff,35,0,35,0
1713327066318,EAP 100,A00,516065,Staff,9792,0,9999,207
1713327067344,ECE 45,A01,507414,Staff,51,0,60,9
1713327068372,ECE 100,A01,507416,Baghdadchi; Saharnaz,11,0,20,9
1713327068372,ECE 100,A02,507418,Baghdadchi; Saharnaz,20,0,20,0
1713327069398,ECE 111,A01,507420,Staff,39,0,50,11
1713327070423,ECE 197,001,548057,Sievenpiper; Daniel F.,9998,0,9999,1
1713327071452,EDS 115,A00,507243,Choi; Bailey Miyeon,28,0,28,0
1713327072478,EDS 117,A01,494379,Staff,23,0,25,2
1713327073506,EDS 125,A00,507246,Hopkins; Megan Beth,29,0,30,1
1713327074532,EDS 128A,A01,507264,Fargason; Sharon Gayle,26,0,26,0
1713327075555,EDS 128B,A01,507293,Pappas; Elizabeth,30,0,30,0
1713327076579,EDS 139,A00,507294,Fargason; Sharon Gayle,30,0,30,0
1713327076579,EDS 139,B00,507313,Pappas; Elizabeth,30,0,30,0
1713327077603,EDS 201,A00,507315,Staff,26,0,30,4
1713327078627,EDS 203,A01,507317,Halter; Christopher P.,26,0,30,4
1713327079656,EDS 204R,A01,507319,Halter; Christopher P.,3,0,30,27
1713327079656,EDS 204R,B01,507331,Heinzman; Erica M.,28,0,30,2
1713327080685,EDS 206R,A00,507332,Staff,4,0,30,26
1713327080685,EDS 206R,B00,507343,Staff,28,0,30,2
1713327081709,EDS 250,A00,507344,Hemans; Patricia Ann Benitez,36,0,40,4
1713327082737,EDS 281,A00,507345,Daly; Alan J.,18,0,18,0
1713327083761,EDS 284,A00,507350,Daly; Alan J.,16,0,16,0
1713327084788,EDS 286,A00,507359,Fine; Sarah,18,0,18,0
1713327085813,EDS 289C,A01,507361,Daly; Alan J.,18,0,18,0
1713327086841,EDS 290,A00,507366,Hofstetter; Carolyn,15,0,15,0
1713327087869,LIGM 5A,A00,507421,Fischer-Grunski; Eva K,20,0,20,0
1713327088895,LIGM 5B,A00,507423,Fischer-Grunski; Eva K,20,0,20,0
1713327089923,LIGM 5C,A00,507425,Fischer-Grunski; Eva K,20,0,20,0
1713327090951,LIIT 5AS,A00,507427,Carnelos; Chiara,20,0,20,0
1713327091982,LIIT 5BS,A00,507430,Carnelos; Chiara,20,0,20,0
1713327093014,LIIT 5CS,A00,507432,Carnelos; Chiara,20,0,20,0
1713327094042,LISP 5A,A00,507541,Munoz Sanchez; Alicia,17,0,20,3
1713327095066,LISP 5B,A00,507671,Munoz Sanchez; Alicia,15,0,20,5
1713327096091,LISP 5C,A00,507696,Munoz Sanchez; Alicia,15,0,20,5
1713327097118,MAE 197,001,528363,Boechler; Nicholas Sebastia,9998,0,9999,1
1713327098141,MATH 197,001,523477,Kedlaya; Kiran S.,9999,0,9999,0
1713327098141,MATH 197,002,563811,Zhang; Danna,9999,0,9999,0
1713327099165,MCWP 40R,A00,518780,Staff,20,0,20,0
1713327099165,MCWP 40R,B00,518781,Staff,19,0,20,1
1713327099165,MCWP 40R,C00,518783,Staff,19,0,20,1
1713327100194,MCWP 50R,A00,518791,Staff,20,0,20,0
1713327100194,MCWP 50R,B00,518792,Staff,17,0,20,3
1713327100194,MCWP 50R,C00,518793,Staff,19,0,20,1
1713327100194,MCWP 50R,D00,518794,Staff,16,0,20,4
1713327100194,MCWP 50R,E00,518795,Staff,16,0,20,4
1713327100194,MCWP 50R,F00,518796,Staff,19,0,20,1
1713327100194,MCWP 50R,G00,518797,Staff,19,0,20,1
1713327101273,MMW 12R,A01,514034,Herbst; Matthew,15,0,16,1
1713327101273,MMW 12R,A02,514035,Herbst; Matthew,16,0,16,0
1713327102299,MMW 13R,A01,514037,Staff,12,0,16,4
1713327102299,MMW 13R,A02,514039,Staff,16,0,16,0
1713327104350,SIO 295LS,A00,523233,Staff,19,0,30,11
1713327105376,SIO 295S,A00,523232,Staff,19,0,30,11
1713327106402,SOCI 117,A01,494376,Staff,2,0,5,3
1713327107430,WES 237B,A00,494380,Staff,19,0,20,1
1713327109497,AESE 279B,A00,494370,Wade; Jon P,33,0,33,0
1713327110522,ANAR 135S,A00,494369,Braswell; Geoffrey E.,0,0,0,0
1713327111546,CAT 124RS,A01,519847,Geibel; William,17,0,20,3
1713327112574,CAT 125RS,A01,515971,Geibel; William,17,0,20,3
1713327113601,CLRE 250,A00,511389,Morris; Sheldon,9996,0,9999,3
1713327114630,CLRE 251,A00,507176,Mehta; Ravindra L.,9996,0,9999,3
1713327114630,CLRE 251,B00,511410,Mehta; Ravindra L.,9998,0,9999,1
1713327115655,CLRE 252,A00,507189,Cuomo; Raphael Eduardo,9998,0,9999,1
1713327116681,CLRE 253,A00,507199,Vaida; Florin,9997,0,9999,2
1713327116681,CLRE 253,B00,507202,Vaida; Florin,9999,0,9999,0
1713327117709,CLRE 259,A00,507211,Patel; Hemal,9996,0,9999,3
1713327118738,CLRE 260,A00,507221,Cuomo; Raphael Eduardo,9999,0,9999,0
1713327119766,CLRE 297,001,507242,Cuomo; Raphael Eduardo,9999,0,9999,0
1713327120792,CSE 191,A00,516875,Minnes Kemp; Mor Mia,9999,0,9999,0
1713327121817,CSS 201S,A01,494383,Staff,35,0,35,0
1713327122846,CSS 202S,A01,494387,Staff,35,0,35,0
1713327123874,EAP 100,A00,516065,Staff,9792,0,9999,207
1713327124902,ECE 45,A01,507414,Staff,51,0,60,9
1713327125933,ECE 100,A01,507416,Baghdadchi; Saharnaz,11,0,20,9
1713327125933,ECE 100,A02,507418,Baghdadchi; Saharnaz,20,0,20,0
1713327126958,ECE 111,A01,507420,Staff,39,0,50,11
1713327127983,ECE 197,001,548057,Sievenpiper; Daniel F.,9998,0,9999,1
1713327129011,EDS 115,A00,507243,Choi; Bailey Miyeon,28,0,28,0
1713327130035,EDS 117,A01,494379,Staff,23,0,25,2
1713327131061,EDS 125,A00,507246,Hopkins; Megan Beth,29,0,30,1
1713327132087,EDS 128A,A01,507264,Fargason; Sharon Gayle,26,0,26,0
1713327133112,EDS 128B,A01,507293,Pappas; Elizabeth,30,0,30,0
1713327134138,EDS 139,A00,507294,Fargason; Sharon Gayle,30,0,30,0
1713327134138,EDS 139,B00,507313,Pappas; Elizabeth,30,0,30,0
1713327135165,EDS 201,A00,507315,Staff,26,0,30,4
1713327136192,EDS 203,A01,507317,Halter; Christopher P.,26,0,30,4
1713327137217,EDS 204R,A01,507319,Halter; Christopher P.,3,0,30,27
1713327137217,EDS 204R,B01,507331,Heinzman; Erica M.,28,0,30,2
1713327138242,EDS 206R,A00,507332,Staff,4,0,30,26
1713327138242,EDS 206R,B00,507343,Staff,28,0,30,2
1713327139270,EDS 250,A00,507344,Hemans; Patricia Ann Benitez,36,0,40,4
1713327140295,EDS 281,A00,507345,Daly; Alan J.,18,0,18,0
1713327141323,EDS 284,A00,507350,Daly; Alan J.,16,0,16,0
1713327142351,EDS 286,A00,507359,Fine; Sarah,18,0,18,0
1713327143376,EDS 289C,A01,507361,Daly; Alan J.,18,0,18,0
1713327144401,EDS 290,A00,507366,Hofstetter; Carolyn,15,0,15,0
1713327145426,LIGM 5A,A00,507421,Fischer-Grunski; Eva K,20,0,20,0
1713327146453,LIGM 5B,A00,507423,Fischer-Grunski; Eva K,20,0,20,0
1713327147477,LIGM 5C,A00,507425,Fischer-Grunski; Eva K,20,0,20,0
1713327148505,LIIT 5AS,A00,507427,Carnelos; Chiara,20,0,20,0
1713327149533,LIIT 5BS,A00,507430,Carnelos; Chiara,20,0,20,0
1713327150561,LIIT 5CS,A00,507432,Carnelos; Chiara,20,0,20,0
1713327151585,LISP 5A,A00,507541,Munoz Sanchez; Alicia,17,0,20,3
1713327152610,LISP 5B,A00,507671,Munoz Sanchez; Alicia,15,0,20,5
1713327153637,LISP 5C,A00,507696,Munoz Sanchez; Alicia,15,0,20,5
1713327154663,MAE 197,001,528363,Boechler; Nicholas Sebastia,9998,0,9999,1
1713327155690,MATH 197,001,523477,Kedlaya; Kiran S.,9999,0,9999,0
1713327155690,MATH 197,002,563811,Zhang; Danna,9999,0,9999,0
1713327156719,MCWP 40R,A00,518780,Staff,20,0,20,0
1713327156719,MCWP 40R,B00,518781,Staff,19,0,20,1
1713327156719,MCWP 40R,C00,518783,Staff,19,0,20,1
1713327157746,MCWP 50R,A00,518791,Staff,20,0,20,0
1713327157746,MCWP 50R,B00,518792,Staff,17,0,20,3
1713327157746,MCWP 50R,C00,518793,Staff,19,0,20,1
1713327157746,MCWP 50R,D00,518794,Staff,16,0,20,4
1713327157746,MCWP 50R,E00,518795,Staff,16,0,20,4
1713327157746,MCWP 50R,F00,518796,Staff,19,0,20,1
1713327157746,MCWP 50R,G00,518797,Staff,19,0,20,1
1713327158772,MMW 12R,A01,514034,Herbst; Matthew,15,0,16,1
1713327158772,MMW 12R,A02,514035,Herbst; Matthew,16,0,16,0
1713327159798,MMW 13R,A01,514037,Staff,12,0,16,4
1713327159798,MMW 13R,A02,514039,Staff,16,0,16,0
1713327161853,SIO 295LS,A00,523233,Staff,19,0,30,11
1713327162879,SIO 295S,A00,523232,Staff,19,0,30,11
1713327163907,SOCI 117,A01,494376,Staff,2,0,5,3
1713327164932,WES 237B,A00,494380,Staff,19,0,20,1
1713327166997,AESE 279B,A00,494370,Wade; Jon P,33,0,33,0
1713327168022,ANAR 135S,A00,494369,Braswell; Geoffrey E.,0,0,0,0
1713327169052,CAT 124RS,A01,519847,Geibel; William,17,0,20,3
1713327170076,CAT 125RS,A01,515971,Geibel; William,17,0,20,3
1713327171101,CLRE 250,A00,511389,Morris; Sheldon,9996,0,9999,3
1713327172125,CLRE 251,A00,507176,Mehta; Ravindra L.,9996,0,9999,3
1713327172125,CLRE 251,B00,511410,Mehta; Ravindra L.,9998,0,9999,1
1713327173153,CLRE 252,A00,507189,Cuomo; Raphael Eduardo,9998,0,9999,1
1713327174179,CLRE 253,A00,507199,Vaida; Florin,9997,0,9999,2
1713327174179,CLRE 253,B00,507202,Vaida; Florin,9999,0,9999,0
1713327175203,CLRE 259,A00,507211,Patel; Hemal,9996,0,9999,3
1713327176227,CLRE 260,A00,507221,Cuomo; Raphael Eduardo,9999,0,9999,0
1713327177252,CLRE 297,001,507242,Cuomo; Raphael Eduardo,9999,0,9999,0
1713327178276,CSE 191,A00,516875,Minnes Kemp; Mor Mia,9999,0,9999,0
1713327179301,CSS 201S,A01,494383,Staff,35,0,35,0
1713327180327,CSS 202S,A01,494387,Staff,35,0,35,0
1713327181351,EAP 100,A00,516065,Staff,9792,0,9999,207
1713327182377,ECE 45,A01,507414,Staff,51,0,60,9
1713327183401,ECE 100,A01,507416,Baghdadchi; Saharnaz,11,0,20,9
1713327183401,ECE 100,A02,507418,Baghdadchi; Saharnaz,20,0,20,0
1713327184430,ECE 111,A01,507420,Staff,39,0,50,11
1713327185454,ECE 197,001,548057,Sievenpiper; Daniel F.,9998,0,9999,1
1713327186479,EDS 115,A00,507243,Choi; Bailey Miyeon,28,0,28,0
1713327187509,EDS 117,A01,494379,Staff,23,0,25,2
1713327188537,EDS 125,A00,507246,Hopkins; Megan Beth,29,0,30,1
1713327189564,EDS 128A,A01,507264,Fargason; Sharon Gayle,26,0,26,0
1713327190591,EDS 128B,A01,507293,Pappas; Elizabeth,30,0,30,0
1713327191620,EDS 139,A00,507294,Fargason; Sharon Gayle,30,0,30,0
1713327191620,EDS 139,B00,507313,Pappas; Elizabeth,30,0,30,0
1713327192644,EDS 201,A00,507315,Staff,26,0,30,4
1713327193671,EDS 203,A01,507317,Halter; Christopher P.,26,0,30,4
1713327194699,EDS 204R,A01,507319,Halter; Christopher P.,3,0,30,27
1713327194699,EDS 204R,B01,507331,Heinzman; Erica M.,28,0,30,2
1713327195725,EDS 206R,A00,507332,Staff,4,0,30,26
1713327195725,EDS 206R,B00,507343,Staff,28,0,30,2
1713327196750,EDS 250,A00,507344,Hemans; Patricia Ann Benitez,36,0,40,4
1713327197778,EDS 281,A00,507345,Daly; Alan J.,18,0,18,0
1713327198806,EDS 284,A00,507350,Daly; Alan J.,16,0,16,0
1713327199832,EDS 286,A00,507359,Fine; Sarah,18,0,18,0
1713327200861,EDS 289C,A01,507361,Daly; Alan J.,18,0,18,0
1713327201889,EDS 290,A00,507366,Hofstetter; Carolyn,15,0,15,0
1713327202914,LIGM 5A,A00,507421,Fischer-Grunski; Eva K,20,0,20,0
1713327204026,LIGM 5B,A00,507423,Fischer-Grunski; Eva K,20,0,20,0
1713327205106,LIGM 5C,A00,507425,Fischer-Grunski; Eva K,20,0,20,0
1713327206132,LIIT 5AS,A00,507427,Carnelos; Chiara,20,0,20,0
1713327207158,LIIT 5BS,A00,507430,Carnelos; Chiara,20,0,20,0
1713327208183,LIIT 5CS,A00,507432,Carnelos; Chiara,20,0,20,0
1713327209208,LISP 5A,A00,507541,Munoz Sanchez; Alicia,17,0,20,3
1713327210232,LISP 5B,A00,507671,Munoz Sanchez; Alicia,15,0,20,5
1713327211256,LISP 5C,A00,507696,Munoz Sanchez; Alicia,15,0,20,5
1713327212282,MAE 197,001,528363,Boechler; Nicholas Sebastia,9998,0,9999,1
1713327213309,MATH 197,001,523477,Kedlaya; Kiran S.,9999,0,9999,0
1713327213309,MATH 197,002,563811,Zhang; Danna,9999,0,9999,0
1713327214337,MCWP 40R,A00,518780,Staff,20,0,20,0
1713327214337,MCWP 40R,B00,518781,Staff,19,0,20,1
1713327214337,MCWP 40R,C00,518783,Staff,19,0,20,1
1713327215361,MCWP 50R,A00,518791,Staff,20,0,20,0
1713327215361,MCWP 50R,B00,518792,Staff,17,0,20,3
1713327215361,MCWP 50R,C00,518793,Staff,19,0,20,1
1713327215361,MCWP 50R,D00,518794,Staff,16,0,20,4
1713327215361,MCWP 50R,E00,518795,Staff,16,0,20,4
1713327215361,MCWP 50R,F00,518796,Staff,19,0,20,1
1713327215361,MCWP 50R,G00,518797,Staff,19,0,20,1
1713327216388,MMW 12R,A01,514034,Herbst; Matthew,15,0,16,1
1713327216388,MMW 12R,A02,514035,Herbst; Matthew,16,0,16,0
1713327217414,MMW 13R,A01,514037,Staff,12,0,16,4
1713327217414,MMW 13R,A02,514039,Staff,16,0,16,0
1713327219462,SIO 295LS,A00,523233,Staff,19,0,30,11
1713327220488,SIO 295S,A00,523232,Staff,19,0,30,11
1713327221513,SOCI 117,A01,494376,Staff,2,0,5,3
1713327222538,WES 237B,A00,494380,Staff,19,0,20,1
1713327224596,AESE 279B,A00,494370,Wade; Jon P,33,0,33,0
1713327225623,ANAR 135S,A00,494369,Braswell; Geoffrey E.,0,0,0,0
1713327226650,CAT 124RS,A01,519847,Geibel; William,17,0,20,3
1713327227675,CAT 125RS,A01,515971,Geibel; William,17,0,20,3
1713327228702,CLRE 250,A00,511389,Morris; Sheldon,9996,0,9999,3
1713327229732,CLRE 251,A00,507176,Mehta; Ravindra L.,9996,0,9999,3
1713327229732,CLRE 251,B00,511410,Mehta; Ravindra L.,9998,0,9999,1
1713327230759,CLRE 252,A00,507189,Cuomo; Raphael Eduardo,9998,0,9999,1
1713327231789,CLRE 253,A00,507199,Vaida; Florin,9997,0,9999,2
1713327231789,CLRE 253,B00,507202,Vaida; Florin,9999,0,9999,0
1713327232814,CLRE 259,A00,507211,Patel; Hemal,9996,0,9999,3
1713327233840,CLRE 260,A00,507221,Cuomo; Raphael Eduardo,9999,0,9999,0
1713327234866,CLRE 297,001,507242,Cuomo; Raphael Eduardo,9999,0,9999,0
1713327235890,CSE 191,A00,516875,Minnes Kemp; Mor Mia,9999,0,9999,0
1713327236916,CSS 201S,A01,494383,Staff,35,0,35,0
1713327237942,CSS 202S,A01,494387,Staff,35,0,35,0
1713327238967,EAP 100,A00,516065,Staff,9792,0,9999,207
1713327239994,ECE 45,A01,507414,Staff,51,0,60,9
1713327241018,ECE 100,A01,507416,Baghdadchi; Saharnaz,11,0,20,9
1713327241018,ECE 100,A02,507418,Baghdadchi; Saharnaz,20,0,20,0
1713327242043,ECE 111,A01,507420,Staff,39,0,50,11
1713327243067,ECE 197,001,548057,Sievenpiper; Daniel F.,9998,0,9999,1
1713327244093,EDS 115,A00,507243,Choi; Bailey Miyeon,28,0,28,0
1713327245119,EDS 117,A01,494379,Staff,23,0,25,2
1713327246144,EDS 125,A00,507246,Hopkins; Megan Beth,29,0,30,1
1713327247170,EDS 128A,A01,507264,Fargason; Sharon Gayle,26,0,26,0
1713327248197,EDS 128B,A01,507293,Pappas; Elizabeth,30,0,30,0
1713327249228,EDS 139,A00,507294,Fargason; Sharon Gayle,30,0,30,0
1713327249228,EDS 139,B00,507313,Pappas; Elizabeth,30,0,30,0
1713327250257,EDS 201,A00,507315,Staff,26,0,30,4
1713327251284,EDS 203,A01,507317,Halter; Christopher P.,26,0,30,4
1713327252309,EDS 204R,A01,507319,Halter; Christopher P.,3,0,30,27
1713327252309,EDS 204R,B01,507331,Heinzman; Erica M.,28,0,30,2
1713327253337,EDS 206R,A00,507332,Staff,4,0,30,26
1713327253337,EDS 206R,B00,507343,Staff,28,0,30,2
1713327254366,EDS 250,A00,507344,Hemans; Patricia Ann Benitez,36,0,40,4
1713327255389,EDS 281,A00,507345,Daly; Alan J.,18,0,18,0
1713327256418,EDS 284,A00,507350,Daly; Alan J.,16,0,16,0
1713327257447,EDS 286,A00,507359,Fine; Sarah,18,0,18,0
1713327258473,EDS 289C,A01,507361,Daly; Alan J.,18,0,18,0
1713327259501,EDS 290,A00,507366,Hofstetter; Carolyn,15,0,15,0
1713327260524,LIGM 5A,A00,507421,Fischer-Grunski; Eva K,20,0,20,0
1713327261552,LIGM 5B,A00,507423,Fischer-Grunski; Eva K,20,0,20,0
1713327262578,LIGM 5C,A00,507425,Fischer-Grunski; Eva K,20,0,20,0
1713327263605,LIIT 5AS,A00,507427,Carnelos; Chiara,20,0,20,0
1713327264631,LIIT 5BS,A00,507430,Carnelos; Chiara,20,0,20,0
1713327265661,LIIT 5CS,A00,507432,Carnelos; Chiara,20,0,20,0
1713327266685,LISP 5A,A00,507541,Munoz Sanchez; Alicia,17,0,20,3
1713327267712,LISP 5B,A00,507671,Munoz Sanchez; Alicia,15,0,20,5
1713327268738,LISP 5C,A00,507696,Munoz Sanchez; Alicia,15,0,20,5
1713327269763,MAE 197,001,528363,Boechler; Nicholas Sebastia,9998,0,9999,1
1713327270788,MATH 197,001,523477,Kedlaya; Kiran S.,9999,0,9999,0
1713327270788,MATH 197,002,563811,Zhang; Danna,9999,0,9999,0
1713327271814,MCWP 40R,A00,518780,Staff,20,0,20,0
1713327271814,MCWP 40R,B00,518781,Staff,19,0,20,1
1713327271814,MCWP 40R,C00,518783,Staff,19,0,20,1
1713327272843,MCWP 50R,A00,518791,Staff,20,0,20,0
1713327272843,MCWP 50R,B00,518792,Staff,17,0,20,3
1713327272843,MCWP 50R,C00,518793,Staff,19,0,20,1
1713327272843,MCWP 50R,D00,518794,Staff,16,0,20,4
1713327272843,MCWP 50R,E00,518795,Staff,16,0,20,4
1713327272843,MCWP 50R,F00,518796,Staff,19,0,20,1
1713327272843,MCWP 50R,G00,518797,Staff,19,0,20,1
1713327273867,MMW 12R,A01,514034,Herbst; Matthew,15,0,16,1
1713327273867,MMW 12R,A02,514035,Herbst; Matthew,16,0,16,0
1713327274892,MMW 13R,A01,514037,Staff,12,0,16,4
1713327274892,MMW 13R,A02,514039,Staff,16,0,16,0
1713327276943,SIO 295LS,A00,523233,Staff,19,0,30,11
1713327277969,SIO 295S,A00,523232,Staff,19,0,30,11
1713327278997,SOCI 117,A01,494376,Staff,2,0,5,3
1713327280022,WES 237B,A00,494380,Staff,19,0,20,1
1713327282087,AESE 279B,A00,494370,Wade; Jon P,33,0,33,0
1713327283115,ANAR 135S,A00,494369,Braswell; Geoffrey E.,0,0,0,0
1713327284139,CAT 124RS,A01,519847,Geibel; William,17,0,20,3
1713327285163,CAT 125RS,A01,515971,Geibel; William,17,0,20,3
1713327286186,CLRE 250,A00,511389,Morris; Sheldon,9996,0,9999,3
1713327287211,CLRE 251,A00,507176,Mehta; Ravindra L.,9996,0,9999,3
1713327287211,CLRE 251,B00,511410,Mehta; Ravindra L.,9998,0,9999,1
1713327288236,CLRE 252,A00,507189,Cuomo; Raphael Eduardo,9998,0,9999,1
1713327289262,CLRE 253,A00,507199,Vaida; Florin,9997,0,9999,2
1713327289262,CLRE 253,B00,507202,Vaida; Florin,9999,0,9999,0
1713327290289,CLRE 259,A00,507211,Patel; Hemal,9996,0,9999,3
1713327291317,CLRE 260,A00,507221,Cuomo; Raphael Eduardo,9999,0,9999,0
1713327292347,CLRE 297,001,507242,Cuomo; Raphael Eduardo,9999,0,9999,0
1713327293371,CSE 191,A00,516875,Minnes Kemp; Mor Mia,9999,0,9999,0
1713327294396,CSS 201S,A01,494383,Staff,35,0,35,0
1713327295422,CSS 202S,A01,494387,Staff,35,0,35,0
1713327296449,EAP 100,A00,516065,Staff,9792,0,9999,207
1713327297475,ECE 45,A01,507414,Staff,51,0,60,9
1713327298502,ECE 100,A01,507416,Baghdadchi; Saharnaz,11,0,20,9
1713327298502,ECE 100,A02,507418,Baghdadchi; Saharnaz,20,0,20,0
1713327299527,ECE 111,A01,507420,Staff,39,0,50,11
1713327300556,ECE 197,001,548057,Sievenpiper; Daniel F.,9998,0,9999,1
1713327301584,EDS 115,A00,507243,Choi; Bailey Miyeon,28,0,28,0
1713327302611,EDS 117,A01,494379,Staff,23,0,25,2
1713327303639,EDS 125,A00,507246,Hopkins; Megan Beth,29,0,30,1
1713327304664,EDS 128A,A01,507264,Fargason; Sharon Gayle,26,0,26,0
1713327305693,EDS 128B,A01,507293,Pappas; Elizabeth,30,0,30,0
1713327306721,EDS 139,A00,507294,Fargason; Sharon Gayle,30,0,30,0
1713327306721,EDS 139,B00,507313,Pappas; Elizabeth,30,0,30,0
1713327307746,EDS 201,A00,507315,Staff,26,0,30,4
1713327308827,EDS 203,A01,507317,Halter; Christopher P.,26,0,30,4
1713327309855,EDS 204R,A01,507319,Halter; Christopher P.,3,0,30,27
1713327309855,EDS 204R,B01,507331,Heinzman; Erica M.,28,0,30,2
1713327310881,EDS 206R,A00,507332,Staff,4,0,30,26
1713327310881,EDS 206R,B00,507343,Staff,28,0,30,2
1713327311906,EDS 250,A00,507344,Hemans; Patricia Ann Benitez,36,0,40,4
1713327312934,EDS 281,A00,507345,Daly; Alan J.,18,0,18,0
1713327313958,EDS 284,A00,507350,Daly; Alan J.,16,0,16,0
1713327314983,EDS 286,A00,507359,Fine; Sarah,18,0,18,0
1713327316007,EDS 289C,A01,507361,Daly; Alan J.,18,0,18,0
1713327317031,EDS 290,A00,507366,Hofstetter; Carolyn,15,0,15,0
1713327318057,LIGM 5A,A00,507421,Fischer-Grunski; Eva K,20,0,20,0
1713327319089,LIGM 5B,A00,507423,Fischer-Grunski; Eva K,20,0,20,0
1713327320118,LIGM 5C,A00,507425,Fischer-Grunski; Eva K,20,0,20,0
1713327321143,LIIT 5AS,A00,507427,Carnelos; Chiara,20,0,20,0
1713327322169,LIIT 5BS,A00,507430,Carnelos; Chiara,20,0,20,0
1713327323193,LIIT 5CS,A00,507432,Carnelos; Chiara,20,0,20,0
1713327324217,LISP 5A,A00,507541,Munoz Sanchez; Alicia,17,0,20,3
1713327325244,LISP 5B,A00,507671,Munoz Sanchez; Alicia,15,0,20,5
1713327326271,LISP 5C,A00,507696,Munoz Sanchez; Alicia,15,0,20,5
1713327327296,MAE 197,001,528363,Boechler; Nicholas Sebastia,9998,0,9999,1
1713327328321,MATH 197,001,523477,Kedlaya; Kiran S.,9999,0,9999,0
1713327328321,MATH 197,002,563811,Zhang; Danna,9999,0,9999,0
1713327329349,MCWP 40R,A00,518780,Staff,20,0,20,0
1713327329349,MCWP 40R,B00,518781,Staff,19,0,20,1
1713327329349,MCWP 40R,C00,518783,Staff,19,0,20,1
1713327330375,MCWP 50R,A00,518791,Staff,20,0,20,0
1713327330375,MCWP 50R,B00,518792,Staff,17,0,20,3
1713327330375,MCWP 50R,C00,518793,Staff,19,0,20,1
1713327330375,MCWP 50R,D00,518794,Staff,16,0,20,4
1713327330375,MCWP 50R,E00,518795,Staff,16,0,20,4
1713327330375,MCWP 50R,F00,518796,Staff,19,0,20,1
1713327330375,MCWP 50R,G00,518797,Staff,19,0,20,1
1713327331400,MMW 12R,A01,514034,Herbst; Matthew,15,0,16,1
1713327331400,MMW 12R,A02,514035,Herbst; Matthew,16,0,16,0
1713327332427,MMW 13R,A01,514037,Staff,12,0,16,4
1713327332427,MMW 13R,A02,514039,Staff,16,0,16,0
1713327334477,SIO 295LS,A00,523233,Staff,19,0,30,11
1713327335501,SIO 295S,A00,523232,Staff,19,0,30,11
1713327336525,SOCI 117,A01,494376,Staff,2,0,5,3
1713327337552,WES 237B,A00,494380,Staff,19,0,20,1
1713327339618,AESE 279B,A00,494370,Wade; Jon P,33,0,33,0
1713327340643,ANAR 135S,A00,494369,Braswell; Geoffrey E.,0,0,0,0
1713327341669,CAT 124RS,A01,519847,Geibel; William,17,0,20,3
1713327342697,CAT 125RS,A01,515971,Geibel; William,17,0,20,3
1713327343726,CLRE 250,A00,511389,Morris; Sheldon,9996,0,9999,3
1713327344752,CLRE 251,A00,507176,Mehta; Ravindra L.,9996,0,9999,3
1713327344752,CLRE 251,B00,511410,Mehta; Ravindra L.,9998,0,9999,1
1713327345778,CLRE 252,A00,507189,Cuomo; Raphael Eduardo,9998,0,9999,1
1713327346803,CLRE 253,A00,507199,Vaida; Florin,9997,0,9999,2
1713327346803,CLRE 253,B00,507202,Vaida; Florin,9999,0,9999,0
1713327347828,CLRE 259,A00,507211,Patel; Hemal,9996,0,9999,3
1713327348853,CLRE 260,A00,507221,Cuomo; Raphael Eduardo,9999,0,9999,0
1713327349879,CLRE 297,001,507242,Cuomo; Raphael Eduardo,9999,0,9999,0
1713327350905,CSE 191,A00,516875,Minnes Kemp; Mor Mia,9999,0,9999,0
1713327351930,CSS 201S,A01,494383,Staff,35,0,35,0
1713327352957,CSS 202S,A01,494387,Staff,35,0,35,0
1713327353986,EAP 100,A00,516065,Staff,9792,0,9999,207
1713327355015,ECE 45,A01,507414,Staff,51,0,60,9
1713327356046,ECE 100,A01,507416,Baghdadchi; Saharnaz,11,0,20,9
1713327356046,ECE 100,A02,507418,Baghdadchi; Saharnaz,20,0,20,0
1713327357071,ECE 111,A01,507420,Staff,39,0,50,11
1713327358096,ECE 197,001,548057,Sievenpiper; Daniel F.,9998,0,9999,1
1713327359120,EDS 115,A00,507243,Choi; Bailey Miyeon,28,0,28,0
1713327360148,EDS 117,A01,494379,Staff,23,0,25,2
1713327361171,EDS 125,A00,507246,Hopkins; Megan Beth,29,0,30,1
1713327362197,EDS 128A,A01,507264,Fargason; Sharon Gayle,26,0,26,0
1713327363224,EDS 128B,A01,507293,Pappas; Elizabeth,30,0,30,0
1713327364248,EDS 139,A00,507294,Fargason; Sharon Gayle,30,0,30,0
1713327364248,EDS 139,B00,507313,Pappas; Elizabeth,30,0,30,0
1713327365273,EDS 201,A00,507315,Staff,26,0,30,4
1713327366298,EDS 203,A01,507317,Halter; Christopher P.,26,0,30,4
1713327367326,EDS 204R,A01,507319,Halter; Christopher P.,3,0,30,27
1713327367326,EDS 204R,B01,507331,Heinzman; Erica M.,28,0,30,2
1713327368351,EDS 206R,A00,507332,Staff,4,0,30,26
1713327368351,EDS 206R,B00,507343,Staff,28,0,30,2
1713327369376,EDS 250,A00,507344,Hemans; Patricia Ann Benitez,36,0,40,4
1713327370400,EDS 281,A00,507345,Daly; Alan J.,18,0,18,0
1713327371423,EDS 284,A00,507350,Daly; Alan J.,16,0,16,0
1713327372447,EDS 286,A00,507359,Fine; Sarah,18,0,18,0
1713327373473,EDS 289C,A01,507361,Daly; Alan J.,18,0,18,0
1713327374498,EDS 290,A00,507366,Hofstetter; Carolyn,15,0,15,0
1713327375521,LIGM 5A,A00,507421,Fischer-Grunski; Eva K,20,0,20,0
1713327376550,LIGM 5B,A00,507423,Fischer-Grunski; Eva K,20,0,20,0
1713327377575,LIGM 5C,A00,507425,Fischer-Grunski; Eva K,20,0,20,0
1713327378603,LIIT 5AS,A00,507427,Carnelos; Chiara,20,0,20,0
1713327379627,LIIT 5BS,A00,507430,Carnelos; Chiara,20,0,20,0
1713327380651,LIIT 5CS,A00,507432,Carnelos; Chiara,20,0,20,0
1713327381677,LISP 5A,A00,507541,Munoz Sanchez; Alicia,17,0,20,3
1713327382703,LISP 5B,A00,507671,Munoz Sanchez; Alicia,15,0,20,5
1713327383727,LISP 5C,A00,507696,Munoz Sanchez; Alicia,15,0,20,5
1713327384753,MAE 197,001,528363,Boechler; Nicholas Sebastia,9998,0,9999,1
1713327385780,MATH 197,001,523477,Kedlaya; Kiran S.,9999,0,9999,0
1713327385780,MATH 197,002,563811,Zhang; Danna,9999,0,9999,0
1713327386807,MCWP 40R,A00,518780,Staff,20,0,20,0
1713327386807,MCWP 40R,B00,518781,Staff,19,0,20,1
1713327386807,MCWP 40R,C00,518783,Staff,19,0,20,1
1713327387836,MCWP 50R,A00,518791,Staff,20,0,20,0
1713327387836,MCWP 50R,B00,518792,Staff,17,0,20,3
1713327387836,MCWP 50R,C00,518793,Staff,19,0,20,1
1713327387836,MCWP 50R,D00,518794,Staff,16,0,20,4
1713327387836,MCWP 50R,E00,518795,Staff,16,0,20,4
1713327387836,MCWP 50R,F00,518796,Staff,19,0,20,1
1713327387836,MCWP 50R,G00,518797,Staff,19,0,20,1
1713327388861,MMW 12R,A01,514034,Herbst; Matthew,15,0,16,1
1713327388861,MMW 12R,A02,514035,Herbst; Matthew,16,0,16,0
1713327389888,MMW 13R,A01,514037,Staff,12,0,16,4
1713327389888,MMW 13R,A02,514039,Staff,16,0,16,0
1713327391940,SIO 295LS,A00,523233,Staff,19,0,30,11
1713327392965,SIO 295S,A00,523232,Staff,19,0,30,11
1713327393992,SOCI 117,A01,494376,Staff,2,0,5,3
1713327395017,WES 237B,A00,494380,Staff,19,0,20,1
1713327397088,AESE 279B,A00,494370,Wade; Jon P,33,0,33,0
1713327398111,ANAR 135S,A00,494369,Braswell; Geoffrey E.,0,0,0,0
1713327399140,CAT 124RS,A01,519847,Geibel; William,17,0,20,3
1713327400165,CAT 125RS,A01,515971,Geibel; William,17,0,20,3
1713327401191,CLRE 250,A00,511389,Morris; Sheldon,9996,0,9999,3
1713327402214,CLRE 251,A00,507176,Mehta; Ravindra L.,9996,0,9999,3
1713327402214,CLRE 251,B00,511410,Mehta; Ravindra L.,9998,0,9999,1
1713327403240,CLRE 252,A00,507189,Cuomo; Raphael Eduardo,9998,0,9999,1
1713327404267,CLRE 253,A00,507199,Vaida; Florin,9997,0,9999,2
1713327404267,CLRE 253,B00,507202,Vaida; Florin,9999,0,9999,0
1713327405292,CLRE 259,A00,507211,Patel; Hemal,9996,0,9999,3
1713327406315,CLRE 260,A00,507221,Cuomo; Raphael Eduardo,9999,0,9999,0
1713327407340,CLRE 297,001,507242,Cuomo; Raphael Eduardo,9999,0,9999,0
1713327408366,CSE 191,A00,516875,Minnes Kemp; Mor Mia,9999,0,9999,0
1713327409394,CSS 201S,A01,494383,Staff,35,0,35,0
1713327410424,CSS 202S,A01,494387,Staff,35,0,35,0
1713327411451,EAP 100,A00,516065,Staff,9792,0,9999,207
1713327412530,ECE 45,A01,507414,Staff,51,0,60,9
1713327413554,ECE 100,A01,507416,Baghdadchi; Saharnaz,11,0,20,9
1713327413554,ECE 100,A02,507418,Baghdadchi; Saharnaz,20,0,20,0
1713327414582,ECE 111,A01,507420,Staff,39,0,50,11
1713327415607,ECE 197,001,548057,Sievenpiper; Daniel F.,9998,0,9999,1
1713327416634,EDS 115,A00,507243,Choi; Bailey Miyeon,28,0,28,0
1713327417658,EDS 117,A01,494379,Staff,23,0,25,2
1713327418686,EDS 125,A00,507246,Hopkins; Megan Beth,29,0,30,1
1713327419715,EDS 128A,A01,507264,Fargason; Sharon Gayle,26,0,26,0
1713327420739,EDS 128B,A01,507293,Pappas; Elizabeth,30,0,30,0
1713327421762,EDS 139,A00,507294,Fargason; Sharon Gayle,30,0,30,0
1713327421762,EDS 139,B00,507313,Pappas; Elizabeth,30,0,30,0
1713327422790,EDS 201,A00,507315,Staff,26,0,30,4
1713327423815,EDS 203,A01,507317,Halter; Christopher P.,26,0,30,4
1713327424838,EDS 204R,A01,507319,Halter; Christopher P.,3,0,30,27
1713327424838,EDS 204R,B01,507331,Heinzman; Erica M.,28,0,30,2
1713327425865,EDS 206R,A00,507332,Staff,4,0,30,26
1713327425865,EDS 206R,B00,507343,Staff,28,0,30,2
1713327426890,EDS 250,A00,507344,Hemans; Patricia Ann Benitez,36,0,40,4
1713327427918,EDS 281,A00,507345,Daly; Alan J.,18,0,18,0
1713327428944,EDS 284,A00,507350,Daly; Alan J.,16,0,16,0
1713327429972,EDS 286,A00,507359,Fine; Sarah,18,0,18,0
1713327431000,EDS 289C,A01,507361,Daly; Alan J.,18,0,18,0
1713327432025,EDS 290,A00,507366,Hofstetter; Carolyn,15,0,15,0
1713327433049,LIGM 5A,A00,507421,Fischer-Grunski; Eva K,20,0,20,0
1713327434073,LIGM 5B,A00,507423,Fischer-Grunski; Eva K,20,0,20,0
1713327435098,LIGM 5C,A00,507425,Fischer-Grunski; Eva K,20,0,20,0
1713327436126,LIIT 5AS,A00,507427,Carnelos; Chiara,20,0,20,0
1713327437152,LIIT 5BS,A00,507430,Carnelos; Chiara,20,0,20,0
1713327438181,LIIT 5CS,A00,507432,Carnelos; Chiara,20,0,20,0
1713327439207,LISP 5A,A00,507541,Munoz Sanchez; Alicia,17,0,20,3
1713327440237,LISP 5B,A00,507671,Munoz Sanchez; Alicia,15,0,20,5
1713327441264,LISP 5C,A00,507696,Munoz Sanchez; Alicia,15,0,20,5
1713327442289,MAE 197,001,528363,Boechler; Nicholas Sebastia,9998,0,9999,1
1713327443317,MATH 197,001,523477,Kedlaya; Kiran S.,9999,0,9999,0
1713327443317,MATH 197,002,563811,Zhang; Danna,9999,0,9999,0
1713327444345,MCWP 40R,A00,518780,Staff,20,0,20,0
1713327444345,MCWP 40R,B00,518781,Staff,19,0,20,1
1713327444345,MCWP 40R,C00,518783,Staff,19,0,20,1
1713327445370,MCWP 50R,A00,518791,Staff,20,0,20,0
1713327445370,MCWP 50R,B00,518792,Staff,17,0,20,3
1713327445370,MCWP 50R,C00,518793,Staff,19,0,20,1
1713327445370,MCWP 50R,D00,518794,Staff,16,0,20,4
1713327445370,MCWP 50R,E00,518795,Staff,16,0,20,4
1713327445370,MCWP 50R,F00,518796,Staff,19,0,20,1
1713327445370,MCWP 50R,G00,518797,Staff,19,0,20,1
1713327446396,MMW 12R,A01,514034,Herbst; Matthew,15,0,16,1
1713327446396,MMW 12R,A02,514035,Herbst; Matthew,16,0,16,0
1713327447420,MMW 13R,A01,514037,Staff,12,0,16,4
1713327447420,MMW 13R,A02,514039,Staff,16,0,16,0
1713327449478,SIO 295LS,A00,523233,Staff,19,0,30,11
1713327450505,SIO 295S,A00,523232,Staff,19,0,30,11
1713327451529,SOCI 117,A01,494376,Staff,2,0,5,3
1713327452568,WES 237B,A00,494380,Staff,19,0,20,1
1713327454627,AESE 279B,A00,494370,Wade; Jon P,33,0,33,0
1713327455653,ANAR 135S,A00,494369,Braswell; Geoffrey E.,0,0,0,0
1713327456681,CAT 124RS,A01,519847,Geibel; William,17,0,20,3
1713327457707,CAT 125RS,A01,515971,Geibel; William,17,0,20,3
1713327458735,CLRE 250,A00,511389,Morris; Sheldon,9996,0,9999,3
1713327459759,CLRE 251,A00,507176,Mehta; Ravindra L.,9996,0,9999,3
1713327459759,CLRE 251,B00,511410,Mehta; Ravindra L.,9998,0,9999,1
1713327460783,CLRE 252,A00,507189,Cuomo; Raphael Eduardo,9998,0,9999,1
1713327461810,CLRE 253,A00,507199,Vaida; Florin,9997,0,9999,2
1713327461810,CLRE 253,B00,507202,Vaida; Florin,9999,0,9999,0
1713327462836,CLRE 259,A00,507211,Patel; Hemal,9996,0,9999,3
1713327463865,CLRE 260,A00,507221,Cuomo; Raphael Eduardo,9999,0,9999,0
1713327464892,CLRE 297,001,507242,Cuomo; Raphael Eduardo,9999,0,9999,0
1713327465919,CSE 191,A00,516875,Minnes Kemp; Mor Mia,9999,0,9999,0
1713327466943,CSS 201S,A01,494383,Staff,35,0,35,0
1713327467967,CSS 202S,A01,494387,Staff,35,0,35,0
1713327468991,EAP 100,A00,516065,Staff,9792,0,9999,207
1713327470017,ECE 45,A01,507414,Staff,51,0,60,9
1713327471043,ECE 100,A01,507416,Baghdadchi; Saharnaz,11,0,20,9
1713327471043,ECE 100,A02,507418,Baghdadchi; Saharnaz,20,0,20,0
1713327472071,ECE 111,A01,507420,Staff,39,0,50,11
1713327473095,ECE 197,001,548057,Sievenpiper; Daniel F.,9998,0,9999,1
1713327474122,EDS 115,A00,507243,Choi; Bailey Miyeon,28,0,28,0
1713327475151,EDS 117,A01,494379,Staff,23,0,25,2
1713327476179,EDS 125,A00,507246,Hopkins; Megan Beth,29,0,30,1
1713327477204,EDS 128A,A01,507264,Fargason; Sharon Gayle,26,0,26,0
1713327478230,EDS 128B,A01,507293,Pappas; Elizabeth,30,0,30,0
1713327479254,EDS 139,A00,507294,Fargason; Sharon Gayle,30,0,30,0
1713327479254,EDS 139,B00,507313,Pappas; Elizabeth,30,0,30,0
1713327480282,EDS 201,A00,507315,Staff,26,0,30,4
1713327481306,EDS 203,A01,507317,Halter; Christopher P.,26,0,30,4
1713327482335,EDS 204R,A01,507319,Halter; Christopher P.,3,0,30,27
1713327482335,EDS 204R,B01,507331,Heinzman; Erica M.,28,0,30,2
1713327483361,EDS 206R,A00,507332,Staff,4,0,30,26
1713327483361,EDS 206R,B00,507343,Staff,28,0,30,2
1713327484388,EDS 250,A00,507344,Hemans; Patricia Ann Benitez,36,0,40,4
1713327485414,EDS 281,A00,507345,Daly; Alan J.,18,0,18,0
1713327486441,EDS 284,A00,507350,Daly; Alan J.,16,0,16,0
1713327487465,EDS 286,A00,507359,Fine; Sarah,18,0,18,0
1713327488493,EDS 289C,A01,507361,Daly; Alan J.,18,0,18,0
1713327490087,EDS 290,A00,507366,Hofstetter; Carolyn,15,0,15,0
1713327491113,LIGM 5A,A00,507421,Fischer-Grunski; Eva K,20,0,20,0
1713327492141,LIGM 5B,A00,507423,Fischer-Grunski; Eva K,20,0,20,0
1713327493165,LIGM 5C,A00,507425,Fischer-Grunski; Eva K,20,0,20,0
1713327494190,LIIT 5AS,A00,507427,Carnelos; Chiara,20,0,20,0
1713327495219,LIIT 5BS,A00,507430,Carnelos; Chiara,20,0,20,0
1713327496248,LIIT 5CS,A00,507432,Carnelos; Chiara,20,0,20,0
1713327497277,LISP 5A,A00,507541,Munoz Sanchez; Alicia,17,0,20,3
1713327498306,LISP 5B,A00,507671,Munoz Sanchez; Alicia,15,0,20,5
1713327499335,LISP 5C,A00,507696,Munoz Sanchez; Alicia,15,0,20,5
1713327500359,MAE 197,001,528363,Boechler; Nicholas Sebastia,9998,0,9999,1
1713327501382,MATH 197,001,523477,Kedlaya; Kiran S.,9999,0,9999,0
1713327501382,MATH 197,002,563811,Zhang; Danna,9999,0,9999,0
1713327502408,MCWP 40R,A00,518780,Staff,20,0,20,0
1713327502408,MCWP 40R,B00,518781,Staff,19,0,20,1
1713327502408,MCWP 40R,C00,518783,Staff,19,0,20,1
1713327503434,MCWP 50R,A00,518791,Staff,20,0,20,0
1713327503434,MCWP 50R,B00,518792,Staff,17,0,20,3
1713327503434,MCWP 50R,C00,518793,Staff,19,0,20,1
1713327503434,MCWP 50R,D00,518794,Staff,16,0,20,4
1713327503434,MCWP 50R,E00,518795,Staff,16,0,20,4
1713327503434,MCWP 50R,F00,518796,Staff,19,0,20,1
1713327503434,MCWP 50R,G00,518797,Staff,19,0,20,1
1713327504460,MMW 12R,A01,514034,Herbst; Matthew,15,0,16,1
1713327504460,MMW 12R,A02,514035,Herbst; Matthew,16,0,16,0
1713327505484,MMW 13R,A01,514037,Staff,12,0,16,4
1713327505484,MMW 13R,A02,514039,Staff,16,0,16,0
1713327507536,SIO 295LS,A00,523233,Staff,19,0,30,11
1713327508562,SIO 295S,A00,523232,Staff,19,0,30,11
1713327509586,SOCI 117,A01,494376,Staff,2,0,5,3
1713327510610,WES 237B,A00,494380,Staff,19,0,20,1
1713327512664,AESE 279B,A00,494370,Wade; Jon P,33,0,33,0
1713327513691,ANAR 135S,A00,494369,Braswell; Geoffrey E.,0,0,0,0
1713327514715,CAT 124RS,A01,519847,Geibel; William,17,0,20,3
1713327515739,CAT 125RS,A01,515971,Geibel; William,17,0,20,3
1713327516820,CLRE 250,A00,511389,Morris; Sheldon,9996,0,9999,3
1713327517845,CLRE 251,A00,507176,Mehta; Ravindra L.,9996,0,9999,3
1713327517845,CLRE 251,B00,511410,Mehta; Ravindra L.,9998,0,9999,1
1713327518872,CLRE 252,A00,507189,Cuomo; Raphael Eduardo,9998,0,9999,1
1713327519898,CLRE 253,A00,507199,Vaida; Florin,9997,0,9999,2
1713327519898,CLRE 253,B00,507202,Vaida; Florin,9999,0,9999,0
1713327520922,CLRE 259,A00,507211,Patel; Hemal,9996,0,9999,3
1713327521946,CLRE 260,A00,507221,Cuomo; Raphael Eduardo,9999,0,9999,0
1713327522974,CLRE 297,001,507242,Cuomo; Raphael Eduardo,9999,0,9999,0
1713327524001,CSE 191,A00,516875,Minnes Kemp; Mor Mia,9999,0,9999,0
1713327525029,CSS 201S,A01,494383,Staff,35,0,35,0
1713327526053,CSS 202S,A01,494387,Staff,35,0,35,0
1713327527076,EAP 100,A00,516065,Staff,9792,0,9999,207
1713327528099,ECE 45,A01,507414,Staff,51,0,60,9
1713327529128,ECE 100,A01,507416,Baghdadchi; Saharnaz,11,0,20,9
1713327529128,ECE 100,A02,507418,Baghdadchi; Saharnaz,20,0,20,0
1713327530153,ECE 111,A01,507420,Staff,39,0,50,11
1713327531178,ECE 197,001,548057,Sievenpiper; Daniel F.,9998,0,9999,1
1713327532208,EDS 115,A00,507243,Choi; Bailey Miyeon,28,0,28,0
1713327533231,EDS 117,A01,494379,Staff,23,0,25,2
1713327534260,EDS 125,A00,507246,Hopkins; Megan Beth,29,0,30,1
1713327535289,EDS 128A,A01,507264,Fargason; Sharon Gayle,26,0,26,0
1713327536313,EDS 128B,A01,507293,Pappas; Elizabeth,30,0,30,0
1713327537339,EDS 139,A00,507294,Fargason; Sharon Gayle,30,0,30,0
1713327537339,EDS 139,B00,507313,Pappas; Elizabeth,30,0,30,0
1713327538369,EDS 201,A00,507315,Staff,26,0,30,4
1713327539398,EDS 203,A01,507317,Halter; Christopher P.,26,0,30,4
1713327540426,EDS 204R,A01,507319,Halter; Christopher P.,3,0,30,27
1713327540426,EDS 204R,B01,507331,Heinzman; Erica M.,28,0,30,2
1713327541454,EDS 206R,A00,507332,Staff,4,0,30,26
1713327541454,EDS 206R,B00,507343,Staff,28,0,30,2
1713327542481,EDS 250,A00,507344,Hemans; Patricia Ann Benitez,36,0,40,4
1713327543508,EDS 281,A00,507345,Daly; Alan J.,18,0,18,0
1713327544532,EDS 284,A00,507350,Daly; Alan J.,16,0,16,0
1713327545561,EDS 286,A00,507359,Fine; Sarah,18,0,18,0
1713327546587,EDS 289C,A01,507361,Daly; Alan J.,18,0,18,0
1713327547612,EDS 290,A00,507366,Hofstetter; Carolyn,15,0,15,0
1713327548638,LIGM 5A,A00,507421,Fischer-Grunski; Eva K,20,0,20,0
1713327549664,LIGM 5B,A00,507423,Fischer-Grunski; Eva K,20,0,20,0
1713327550691,LIGM 5C,A00,507425,Fischer-Grunski; Eva K,20,0,20,0
1713327551721,LIIT 5AS,A00,507427,Carnelos; Chiara,20,0,20,0
1713327552750,LIIT 5BS,A00,507430,Carnelos; Chiara,20,0,20,0
1713327553775,LIIT 5CS,A00,507432,Carnelos; Chiara,20,0,20,0
1713327554799,LISP 5A,A00,507541,Munoz Sanchez; Alicia,17,0,20,3
1713327555830,LISP 5B,A00,507671,Munoz Sanchez; Alicia,15,0,20,5
1713327556859,LISP 5C,A00,507696,Munoz Sanchez; Alicia,15,0,20,5
1713327557882,MAE 197,001,528363,Boechler; Nicholas Sebastia,9998,0,9999,1
1713327558907,MATH 197,001,523477,Kedlaya; Kiran S.,9999,0,9999,0
1713327558907,MATH 197,002,563811,Zhang; Danna,9999,0,9999,0
1713327559930,MCWP 40R,A00,518780,Staff,20,0,20,0
1713327559930,MCWP 40R,B00,518781,Staff,19,0,20,1
1713327559930,MCWP 40R,C00,518783,Staff,19,0,20,1
1713327560956,MCWP 50R,A00,518791,Staff,20,0,20,0
1713327560956,MCWP 50R,B00,518792,Staff,17,0,20,3
1713327560956,MCWP 50R,C00,518793,Staff,19,0,20,1
1713327560956,MCWP 50R,D00,518794,Staff,16,0,20,4
1713327560956,MCWP 50R,E00,518795,Staff,16,0,20,4
1713327560956,MCWP 50R,F00,518796,Staff,19,0,20,1
1713327560956,MCWP 50R,G00,518797,Staff,19,0,20,1
1713327561981,MMW 12R,A01,514034,Herbst; Matthew,15,0,16,1
1713327561981,MMW 12R,A02,514035,Herbst; Matthew,16,0,16,0
1713327563006,MMW 13R,A01,514037,Staff,12,0,16,4
1713327563006,MMW 13R,A02,514039,Staff,16,0,16,0
1713327565059,SIO 295LS,A00,523233,Staff,19,0,30,11
1713327566084,SIO 295S,A00,523232,Staff,19,0,30,11
1713327567109,SOCI 117,A01,494376,Staff,2,0,5,3
1713327568134,WES 237B,A00,494380,Staff,19,0,20,1
1713327570197,AESE 279B,A00,494370,Wade; Jon P,33,0,33,0
1713327571222,ANAR 135S,A00,494369,Braswell; Geoffrey E.,0,0,0,0
1713327572245,CAT 124RS,A01,519847,Geibel; William,17,0,20,3
1713327573270,CAT 125RS,A01,515971,Geibel; William,17,0,20,3
1713327574295,CLRE 250,A00,511389,Morris; Sheldon,9996,0,9999,3
1713327575318,CLRE 251,A00,507176,Mehta; Ravindra L.,9996,0,9999,3
1713327575318,CLRE 251,B00,511410,Mehta; Ravindra L.,9998,0,9999,1
1713327576342,CLRE 252,A00,507189,Cuomo; Raphael Eduardo,9998,0,9999,1
1713327577367,CLRE 253,A00,507199,Vaida; Florin,9997,0,9999,2
1713327577367,CLRE 253,B00,507202,Vaida; Florin,9999,0,9999,0
1713327578394,CLRE 259,A00,507211,Patel; Hemal,9996,0,9999,3
1713327579420,CLRE 260,A00,507221,Cuomo; Raphael Eduardo,9999,0,9999,0
1713327580447,CLRE 297,001,507242,Cuomo; Raphael Eduardo,9999,0,9999,0
1713327581472,CSE 191,A00,516875,Minnes Kemp; Mor Mia,9999,0,9999,0
1713327582497,CSS 201S,A01,494383,Staff,35,0,35,0
1713327583523,CSS 202S,A01,494387,Staff,35,0,35,0
1713327584550,EAP 100,A00,516065,Staff,9792,0,9999,207
1713327585575,ECE 45,A01,507414,Staff,51,0,60,9
1713327586600,ECE 100,A01,507416,Baghdadchi; Saharnaz,11,0,20,9
1713327586600,ECE 100,A02,507418,Baghdadchi; Saharnaz,20,0,20,0
1713327587628,ECE 111,A01,507420,Staff,39,0,50,11
1713327588653,ECE 197,001,548057,Sievenpiper; Daniel F.,9998,0,9999,1
1713327589677,EDS 115,A00,507243,Choi; Bailey Miyeon,28,0,28,0
1713327590702,EDS 117,A01,494379,Staff,23,0,25,2
1713327591726,EDS 125,A00,507246,Hopkins; Megan Beth,29,0,30,1
1713327592752,EDS 128A,A01,507264,Fargason; Sharon Gayle,26,0,26,0
1713327593777,EDS 128B,A01,507293,Pappas; Elizabeth,30,0,30,0
1713327594800,EDS 139,A00,507294,Fargason; Sharon Gayle,30,0,30,0
1713327594800,EDS 139,B00,507313,Pappas; Elizabeth,30,0,30,0
1713327595827,EDS 201,A00,507315,Staff,26,0,30,4
1713327596857,EDS 203,A01,507317,Halter; Christopher P.,26,0,30,4
1713327597883,EDS 204R,A01,507319,Halter; Christopher P.,3,0,30,27
1713327597883,EDS 204R,B01,507331,Heinzman; Erica M.,28,0,30,2
1713327598907,EDS 206R,A00,507332,Staff,4,0,30,26
1713327598907,EDS 206R,B00,507343,Staff,28,0,30,2
1713327599935,EDS 250,A00,507344,Hemans; Patricia Ann Benitez,36,0,40,4
1713327600960,EDS 281,A00,507345,Daly; Alan J.,18,0,18,0
1713327601989,EDS 284,A00,507350,Daly; Alan J.,16,0,16,0
1713327603013,EDS 286,A00,507359,Fine; Sarah,18,0,18,0
1713327604038,EDS 289C,A01,507361,Daly; Alan J.,18,0,18,0
1713327605066,EDS 290,A00,507366,Hofstetter; Carolyn,15,0,15,0
1713327606092,LIGM 5A,A00,507421,Fischer-Grunski; Eva K,20,0,20,0
1713327607118,LIGM 5B,A00,507423,Fischer-Grunski; Eva K,20,0,20,0
1713327608143,LIGM 5C,A00,507425,Fischer-Grunski; Eva K,20,0,20,0
1713327609173,LIIT 5AS,A00,507427,Carnelos; Chiara,20,0,20,0
1713327610202,LIIT 5BS,A00,507430,Carnelos; Chiara,20,0,20,0
1713327611226,LIIT 5CS,A00,507432,Carnelos; Chiara,20,0,20,0
1713327612252,LISP 5A,A00,507541,Munoz Sanchez; Alicia,17,0,20,3
1713327613281,LISP 5B,A00,507671,Munoz Sanchez; Alicia,15,0,20,5
1713327614311,LISP 5C,A00,507696,Munoz Sanchez; Alicia,15,0,20,5
1713327615338,MAE 197,001,528363,Boechler; Nicholas Sebastia,9998,0,9999,1
1713327616363,MATH 197,001,523477,Kedlaya; Kiran S.,9999,0,9999,0
1713327616363,MATH 197,002,563811,Zhang; Danna,9999,0,9999,0
1713327617392,MCWP 40R,A00,518780,Staff,20,0,20,0
1713327617392,MCWP 40R,B00,518781,Staff,19,0,20,1
1713327617392,MCWP 40R,C00,518783,Staff,19,0,20,1
1713327618422,MCWP 50R,A00,518791,Staff,20,0,20,0
1713327618422,MCWP 50R,B00,518792,Staff,17,0,20,3
1713327618422,MCWP 50R,C00,518793,Staff,19,0,20,1
1713327618422,MCWP 50R,D00,518794,Staff,16,0,20,4
1713327618422,MCWP 50R,E00,518795,Staff,16,0,20,4
1713327618422,MCWP 50R,F00,518796,Staff,19,0,20,1
1713327618422,MCWP 50R,G00,518797,Staff,19,0,20,1
1713327619449,MMW 12R,A01,514034,Herbst; Matthew,15,0,16,1
1713327619449,MMW 12R,A02,514035,Herbst; Matthew,16,0,16,0
1713327620529,MMW 13R,A01,514037,Staff,12,0,16,4
1713327620529,MMW 13R,A02,514039,Staff,16,0,16,0
1713327622581,SIO 295LS,A00,523233,Staff,19,0,30,11
1713327623609,SIO 295S,A00,523232,Staff,19,0,30,11
1713327624634,SOCI 117,A01,494376,Staff,2,0,5,3
1713327625659,WES 237B,A00,494380,Staff,19,0,20,1
1713327627733,AESE 279B,A00,494370,Wade; Jon P,33,0,33,0
1713327628759,ANAR 135S,A00,494369,Braswell; Geoffrey E.,0,0,0,0
1713327629784,CAT 124RS,A01,519847,Geibel; William,17,0,20,3
1713327630810,CAT 125RS,A01,515971,Geibel; William,17,0,20,3
1713327631837,CLRE 250,A00,511389,Morris; Sheldon,9996,0,9999,3
1713327632863,CLRE 251,A00,507176,Mehta; Ravindra L.,9996,0,9999,3
1713327632863,CLRE 251,B00,511410,Mehta; Ravindra L.,9998,0,9999,1
1713327633889,CLRE 252,A00,507189,Cuomo; Raphael Eduardo,9998,0,9999,1
1713327634917,CLRE 253,A00,507199,Vaida; Florin,9997,0,9999,2
1713327634917,CLRE 253,B00,507202,Vaida; Florin,9999,0,9999,0
1713327635942,CLRE 259,A00,507211,Patel; Hemal,9996,0,9999,3
1713327636970,CLRE 260,A00,507221,Cuomo; Raphael Eduardo,9999,0,9999,0
1713327637998,CLRE 297,001,507242,Cuomo; Raphael Eduardo,9999,0,9999,0
1713327639026,CSE 191,A00,516875,Minnes Kemp; Mor Mia,9999,0,9999,0
1713327640057,CSS 201S,A01,494383,Staff,35,0,35,0
1713327641083,CSS 202S,A01,494387,Staff,35,0,35,0
1713327642113,EAP 100,A00,516065,Staff,9792,0,9999,207
1713327643139,ECE 45,A01,507414,Staff,51,0,60,9
1713327644164,ECE 100,A01,507416,Baghdadchi; Saharnaz,11,0,20,9
1713327644164,ECE 100,A02,507418,Baghdadchi; Saharnaz,20,0,20,0
1713327645189,ECE 111,A01,507420,Staff,39,0,50,11
1713327646214,ECE 197,001,548057,Sievenpiper; Daniel F.,9998,0,9999,1
1713327647244,EDS 115,A00,507243,Choi; Bailey Miyeon,28,0,28,0
1713327648271,EDS 117,A01,494379,Staff,23,0,25,2
1713327649295,EDS 125,A00,507246,Hopkins; Megan Beth,29,0,30,1
1713327650326,EDS 128A,A01,507264,Fargason; Sharon Gayle,26,0,26,0
1713327651355,EDS 128B,A01,507293,Pappas; Elizabeth,30,0,30,0
1713327652381,EDS 139,A00,507294,Fargason; Sharon Gayle,30,0,30,0
1713327652381,EDS 139,B00,507313,Pappas; Elizabeth,30,0,30,0
1713327653407,EDS 201,A00,507315,Staff,26,0,30,4
1713327654437,EDS 203,A01,507317,Halter; Christopher P.,26,0,30,4
1713327655463,EDS 204R,A01,507319,Halter; Christopher P.,3,0,30,27
1713327655463,EDS 204R,B01,507331,Heinzman; Erica M.,28,0,30,2
1713327656489,EDS 206R,A00,507332,Staff,4,0,30,26
1713327656489,EDS 206R,B00,507343,Staff,28,0,30,2
1713327657514,EDS 250,A00,507344,Hemans; Patricia Ann Benitez,36,0,40,4
1713327658539,EDS 281,A00,507345,Daly; Alan J.,18,0,18,0
1713327659569,EDS 284,A00,507350,Daly; Alan J.,16,0,16,0
1713327660595,EDS 286,A00,507359,Fine; Sarah,18,0,18,0
1713327661620,EDS 289C,A01,507361,Daly; Alan J.,18,0,18,0
1713327662646,EDS 290,A00,507366,Hofstetter; Carolyn,15,0,15,0
1713327663701,LIGM 5A,A00,507421,Fischer-Grunski; Eva K,20,0,20,0
1713327664726,LIGM 5B,A00,507423,Fischer-Grunski; Eva K,20,0,20,0
1713327665769,LIGM 5C,A00,507425,Fischer-Grunski; Eva K,20,0,20,0
1713327666801,LIIT 5AS,A00,507427,Carnelos; Chiara,20,0,20,0
1713327667828,LIIT 5BS,A00,507430,Carnelos; Chiara,20,0,20,0
1713327668858,LIIT 5CS,A00,507432,Carnelos; Chiara,20,0,20,0
1713327669884,LISP 5A,A00,507541,Munoz Sanchez; Alicia,17,0,20,3
1713327670909,LISP 5B,A00,507671,Munoz Sanchez; Alicia,15,0,20,5
1713327671934,LISP 5C,A00,507696,Munoz Sanchez; Alicia,15,0,20,5
1713327672962,MAE 197,001,528363,Boechler; Nicholas Sebastia,9998,0,9999,1
1713327673989,MATH 197,001,523477,Kedlaya; Kiran S.,9999,0,9999,0
1713327673989,MATH 197,002,563811,Zhang; Danna,9999,0,9999,0
1713327675015,MCWP 40R,A00,518780,Staff,20,0,20,0
1713327675015,MCWP 40R,B00,518781,Staff,19,0,20,1
1713327675015,MCWP 40R,C00,518783,Staff,19,0,20,1
1713327676042,MCWP 50R,A00,518791,Staff,20,0,20,0
1713327676042,MCWP 50R,B00,518792,Staff,17,0,20,3
1713327676042,MCWP 50R,C00,518793,Staff,19,0,20,1
1713327676042,MCWP 50R,D00,518794,Staff,16,0,20,4
1713327676042,MCWP 50R,E00,518795,Staff,16,0,20,4
1713327676042,MCWP 50R,F00,518796,Staff,19,0,20,1
1713327676042,MCWP 50R,G00,518797,Staff,19,0,20,1
1713327677067,MMW 12R,A01,514034,Herbst; Matthew,15,0,16,1
1713327677067,MMW 12R,A02,514035,Herbst; Matthew,16,0,16,0
1713327678098,MMW 13R,A01,514037,Staff,12,0,16,4
1713327678098,MMW 13R,A02,514039,Staff,16,0,16,0
1713327680153,SIO 295LS,A00,523233,Staff,19,0,30,11
1713327681179,SIO 295S,A00,523232,Staff,19,0,30,11
1713327682205,SOCI 117,A01,494376,Staff,2,0,5,3
1713327683231,WES 237B,A00,494380,Staff,19,0,20,1
1713327685316,AESE 279B,A00,494370,Wade; Jon P,33,0,33,0
1713327686341,ANAR 135S,A00,494369,Braswell; Geoffrey E.,0,0,0,0
1713327687365,CAT 124RS,A01,519847,Geibel; William,17,0,20,3
1713327688390,CAT 125RS,A01,515971,Geibel; William,17,0,20,3
1713327689415,CLRE 250,A00,511389,Morris; Sheldon,9996,0,9999,3
1713327690449,CLRE 251,A00,507176,Mehta; Ravindra L.,9996,0,9999,3
1713327690449,CLRE 251,B00,511410,Mehta; Ravindra L.,9998,0,9999,1
1713327691475,CLRE 252,A00,507189,Cuomo; Raphael Eduardo,9998,0,9999,1
1713327692502,CLRE 253,A00,507199,Vaida; Florin,9997,0,9999,2
1713327692502,CLRE 253,B00,507202,Vaida; Florin,9999,0,9999,0
1713327693527,CLRE 259,A00,507211,Patel; Hemal,9996,0,9999,3
1713327694552,CLRE 260,A00,507221,Cuomo; Raphael Eduardo,9999,0,9999,0
1713327695576,CLRE 297,001,507242,Cuomo; Raphael Eduardo,9999,0,9999,0
1713327696605,CSE 191,A00,516875,Minnes Kemp; Mor Mia,9999,0,9999,0
1713327697635,CSS 201S,A01,494383,Staff,35,0,35,0
1713327698661,CSS 202S,A01,494387,Staff,35,0,35,0
1713327699689,EAP 100,A00,516065,Staff,9792,0,9999,207
1713327700715,ECE 45,A01,507414,Staff,51,0,60,9
1713327701741,ECE 100,A01,507416,Baghdadchi; Saharnaz,11,0,20,9
1713327701741,ECE 100,A02,507418,Baghdadchi; Saharnaz,20,0,20,0
1713327702770,ECE 111,A01,507420,Staff,39,0,50,11
1713327703794,ECE 197,001,548057,Sievenpiper; Daniel F.,9998,0,9999,1
1713327704821,EDS 115,A00,507243,Choi; Bailey Miyeon,28,0,28,0
1713327705849,EDS 117,A01,494379,Staff,23,0,25,2
1713327706876,EDS 125,A00,507246,Hopkins; Megan Beth,29,0,30,1
1713327707903,EDS 128A,A01,507264,Fargason; Sharon Gayle,26,0,26,0
1713327708930,EDS 128B,A01,507293,Pappas; Elizabeth,30,0,30,0
1713327709956,EDS 139,A00,507294,Fargason; Sharon Gayle,30,0,30,0
1713327709956,EDS 139,B00,507313,Pappas; Elizabeth,30,0,30,0
1713327710980,EDS 201,A00,507315,Staff,26,0,30,4
1713327712009,EDS 203,A01,507317,Halter; Christopher P.,26,0,30,4
1713327713034,EDS 204R,A01,507319,Halter; Christopher P.,3,0,30,27
1713327713034,EDS 204R,B01,507331,Heinzman; Erica M.,28,0,30,2
1713327714065,EDS 206R,A00,507332,Staff,4,0,30,26
1713327714065,EDS 206R,B00,507343,Staff,28,0,30,2
1713327715093,EDS 250,A00,507344,Hemans; Patricia Ann Benitez,36,0,40,4
1713327716118,EDS 281,A00,507345,Daly; Alan J.,18,0,18,0
1713327717147,EDS 284,A00,507350,Daly; Alan J.,16,0,16,0
1713327718175,EDS 286,A00,507359,Fine; Sarah,18,0,18,0
1713327719203,EDS 289C,A01,507361,Daly; Alan J.,18,0,18,0
1713327720229,EDS 290,A00,507366,Hofstetter; Carolyn,15,0,15,0
1713327721259,LIGM 5A,A00,507421,Fischer-Grunski; Eva K,20,0,20,0
1713327722284,LIGM 5B,A00,507423,Fischer-Grunski; Eva K,20,0,20,0
1713327723309,LIGM 5C,A00,507425,Fischer-Grunski; Eva K,20,0,20,0
1713327724391,LIIT 5AS,A00,507427,Carnelos; Chiara,20,0,20,0
1713327725416,LIIT 5BS,A00,507430,Carnelos; Chiara,20,0,20,0
1713327726441,LIIT 5CS,A00,507432,Carnelos; Chiara,20,0,20,0
1713327727471,LISP 5A,A00,507541,Munoz Sanchez; Alicia,17,0,20,3
1713327728502,LISP 5B,A00,507671,Munoz Sanchez; Alicia,15,0,20,5
1713327729525,LISP 5C,A00,507696,Munoz Sanchez; Alicia,15,0,20,5
1713327730551,MAE 197,001,528363,Boechler; Nicholas Sebastia,9998,0,9999,1
1713327731578,MATH 197,001,523477,Kedlaya; Kiran S.,9999,0,9999,0
1713327731578,MATH 197,002,563811,Zhang; Danna,9999,0,9999,0
1713327732607,MCWP 40R,A00,518780,Staff,20,0,20,0
1713327732607,MCWP 40R,B00,518781,Staff,19,0,20,1
1713327732607,MCWP 40R,C00,518783,Staff,19,0,20,1
1713327733633,MCWP 50R,A00,518791,Staff,20,0,20,0
1713327733633,MCWP 50R,B00,518792,Staff,17,0,20,3
1713327733633,MCWP 50R,C00,518793,Staff,19,0,20,1
1713327733633,MCWP 50R,D00,518794,Staff,16,0,20,4
1713327733633,MCWP 50R,E00,518795,Staff,16,0,20,4
1713327733633,MCWP 50R,F00,518796,Staff,19,0,20,1
1713327733633,MCWP 50R,G00,518797,Staff,19,0,20,1
1713327734662,MMW 12R,A01,514034,Herbst; Matthew,15,0,16,1
1713327734662,MMW 12R,A02,514035,Herbst; Matthew,16,0,16,0
1713327735687,MMW 13R,A01,514037,Staff,12,0,16,4
1713327735687,MMW 13R,A02,514039,Staff,16,0,16,0
1713327737741,SIO 295LS,A00,523233,Staff,19,0,30,11
1713327738768,SIO 295S,A00,523232,Staff,19,0,30,11
1713327739794,SOCI 117,A01,494376,Staff,2,0,5,3
1713327740822,WES 237B,A00,494380,Staff,19,0,20,1
1713327742895,AESE 279B,A00,494370,Wade; Jon P,33,0,33,0
1713327743920,ANAR 135S,A00,494369,Braswell; Geoffrey E.,0,0,0,0
1713327744949,CAT 124RS,A01,519847,Geibel; William,17,0,20,3
1713327745973,CAT 125RS,A01,515971,Geibel; William,17,0,20,3
1713327746998,CLRE 250,A00,511389,Morris; Sheldon,9996,0,9999,3
1713327748029,CLRE 251,A00,507176,Mehta; Ravindra L.,9996,0,9999,3
1713327748029,CLRE 251,B00,511410,Mehta; Ravindra L.,9998,0,9999,1
1713327749055,CLRE 252,A00,507189,Cuomo; Raphael Eduardo,9998,0,9999,1
1713327750080,CLRE 253,A00,507199,Vaida; Florin,9997,0,9999,2
1713327750080,CLRE 253,B00,507202,Vaida; Florin,9999,0,9999,0
1713327751106,CLRE 259,A00,507211,Patel; Hemal,9996,0,9999,3
1713327752130,CLRE 260,A00,507221,Cuomo; Raphael Eduardo,9999,0,9999,0
1713327753154,CLRE 297,001,507242,Cuomo; Raphael Eduardo,9999,0,9999,0
1713327754184,CSE 191,A00,516875,Minnes Kemp; Mor Mia,9999,0,9999,0
1713327755216,CSS 201S,A01,494383,Staff,35,0,35,0
1713327756240,CSS 202S,A01,494387,Staff,35,0,35,0
1713327757265,EAP 100,A00,516065,Staff,9792,0,9999,207
1713327758294,ECE 45,A01,507414,Staff,51,0,60,9
1713327759318,ECE 100,A01,507416,Baghdadchi; Saharnaz,11,0,20,9
1713327759318,ECE 100,A02,507418,Baghdadchi; Saharnaz,20,0,20,0
1713327760341,ECE 111,A01,507420,Staff,39,0,50,11
1713327761372,ECE 197,001,548057,Sievenpiper; Daniel F.,9998,0,9999,1
1713327762398,EDS 115,A00,507243,Choi; Bailey Miyeon,28,0,28,0
1713327763423,EDS 117,A01,494379,Staff,23,0,25,2
1713327764451,EDS 125,A00,507246,Hopkins; Megan Beth,29,0,30,1
1713327765479,EDS 128A,A01,507264,Fargason; Sharon Gayle,26,0,26,0
1713327766504,EDS 128B,A01,507293,Pappas; Elizabeth,30,0,30,0
1713327767531,EDS 139,A00,507294,Fargason; Sharon Gayle,30,0,30,0
1713327767531,EDS 139,B00,507313,Pappas; Elizabeth,30,0,30,0
1713327768557,EDS 201,A00,507315,Staff,26,0,30,4
1713327769587,EDS 203,A01,507317,Halter; Christopher P.,26,0,30,4
1713327770612,EDS 204R,A01,507319,Halter; Christopher P.,3,0,30,27
1713327770612,EDS 204R,B01,507331,Heinzman; Erica M.,28,0,30,2
1713327771640,EDS 206R,A00,507332,Staff,4,0,30,26
1713327771640,EDS 206R,B00,507343,Staff,28,0,30,2
1713327772666,EDS 250,A00,507344,Hemans; Patricia Ann Benitez,36,0,40,4
1713327773694,EDS 281,A00,507345,Daly; Alan J.,18,0,18,0
1713327774722,EDS 284,A00,507350,Daly; Alan J.,16,0,16,0
1713327775748,EDS 286,A00,507359,Fine; Sarah,18,0,18,0
1713327776774,EDS 289C,A01,507361,Daly; Alan J.,18,0,18,0
1713327777799,EDS 290,A00,507366,Hofstetter; Carolyn,15,0,15,0
1713327778828,LIGM 5A,A00,507421,Fischer-Grunski; Eva K,20,0,20,0
1713327779856,LIGM 5B,A00,507423,Fischer-Grunski; Eva K,20,0,20,0
1713327780886,LIGM 5C,A00,507425,Fischer-Grunski; Eva K,20,0,20,0
1713327781915,LIIT 5AS,A00,507427,Carnelos; Chiara,20,0,20,0
1713327782940,LIIT 5BS,A00,507430,Carnelos; Chiara,20,0,20,0
1713327783965,LIIT 5CS,A00,507432,Carnelos; Chiara,20,0,20,0
1713327784993,LISP 5A,A00,507541,Munoz Sanchez; Alicia,17,0,20,3
1713327786019,LISP 5B,A00,507671,Munoz Sanchez; Alicia,15,0,20,5
1713327787045,LISP 5C,A00,507696,Munoz Sanchez; Alicia,15,0,20,5
1713327788070,MAE 197,001,528363,Boechler; Nicholas Sebastia,9998,0,9999,1
1713327789099,MATH 197,001,523477,Kedlaya; Kiran S.,9999,0,9999,0
1713327789099,MATH 197,002,563811,Zhang; Danna,9999,0,9999,0
1713327790126,MCWP 40R,A00,518780,Staff,20,0,20,0
1713327790126,MCWP 40R,B00,518781,Staff,19,0,20,1
1713327790126,MCWP 40R,C00,518783,Staff,19,0,20,1
1713327791152,MCWP 50R,A00,518791,Staff,20,0,20,0
1713327791152,MCWP 50R,B00,518792,Staff,17,0,20,3
1713327791152,MCWP 50R,C00,518793,Staff,19,0,20,1
1713327791152,MCWP 50R,D00,518794,Staff,16,0,20,4
1713327791152,MCWP 50R,E00,518795,Staff,16,0,20,4
1713327791152,MCWP 50R,F00,518796,Staff,19,0,20,1
1713327791152,MCWP 50R,G00,518797,Staff,19,0,20,1
1713327792179,MMW 12R,A01,514034,Herbst; Matthew,15,0,16,1
1713327792179,MMW 12R,A02,514035,Herbst; Matthew,16,0,16,0
1713327793204,MMW 13R,A01,514037,Staff,12,0,16,4
1713327793204,MMW 13R,A02,514039,Staff,16,0,16,0
1713327795257,SIO 295LS,A00,523233,Staff,19,0,30,11
1713327796281,SIO 295S,A00,523232,Staff,19,0,30,11
1713327797306,SOCI 117,A01,494376,Staff,2,0,5,3
1713327798332,WES 237B,A00,494380,Staff,19,0,20,1
1713327800401,AESE 279B,A00,494370,Wade; Jon P,33,0,33,0
1713327801425,ANAR 135S,A00,494369,Braswell; Geoffrey E.,0,0,0,0
1713327802460,CAT 124RS,A01,519847,Geibel; William,17,0,20,3
1713327803485,CAT 125RS,A01,515971,Geibel; William,17,0,20,3
1713327804515,CLRE 250,A00,511389,Morris; Sheldon,9996,0,9999,3
1713327805550,CLRE 251,A00,507176,Mehta; Ravindra L.,9996,0,9999,3
1713327805550,CLRE 251,B00,511410,Mehta; Ravindra L.,9998,0,9999,1
1713327806578,CLRE 252,A00,507189,Cuomo; Raphael Eduardo,9998,0,9999,1
1713327807609,CLRE 253,A00,507199,Vaida; Florin,9997,0,9999,2
1713327807609,CLRE 253,B00,507202,Vaida; Florin,9999,0,9999,0
1713327808638,CLRE 259,A00,507211,Patel; Hemal,9996,0,9999,3
1713327809661,CLRE 260,A00,507221,Cuomo; Raphael Eduardo,9999,0,9999,0
1713327810689,CLRE 297,001,507242,Cuomo; Raphael Eduardo,9999,0,9999,0
1713327811714,CSE 191,A00,516875,Minnes Kemp; Mor Mia,9999,0,9999,0
1713327812740,CSS 201S,A01,494383,Staff,35,0,35,0
1713327813764,CSS 202S,A01,494387,Staff,35,0,35,0
1713327814788,EAP 100,A00,516065,Staff,9792,0,9999,207
1713327815818,ECE 45,A01,507414,Staff,51,0,60,9
1713327816843,ECE 100,A01,507416,Baghdadchi; Saharnaz,11,0,20,9
1713327816843,ECE 100,A02,507418,Baghdadchi; Saharnaz,20,0,20,0
1713327817868,ECE 111,A01,507420,Staff,39,0,50,11
1713327818897,ECE 197,001,548057,Sievenpiper; Daniel F.,9998,0,9999,1
1713327819922,EDS 115,A00,507243,Choi; Bailey Miyeon,28,0,28,0
1713327820953,EDS 117,A01,494379,Staff,23,0,25,2
1713327821979,EDS 125,A00,507246,Hopkins; Megan Beth,29,0,30,1
1713327823008,EDS 128A,A01,507264,Fargason; Sharon Gayle,26,0,26,0
1713327824033,EDS 128B,A01,507293,Pappas; Elizabeth,30,0,30,0
1713327825058,EDS 139,A00,507294,Fargason; Sharon Gayle,30,0,30,0
1713327825058,EDS 139,B00,507313,Pappas; Elizabeth,30,0,30,0
1713327826085,EDS 201,A00,507315,Staff,26,0,30,4
1713327827111,EDS 203,A01,507317,Halter; Christopher P.,26,0,30,4
1713327828196,EDS 204R,A01,507319,Halter; Christopher P.,3,0,30,27
1713327828196,EDS 204R,B01,507331,Heinzman; Erica M.,28,0,30,2
1713327829221,EDS 206R,A00,507332,Staff,4,0,30,26
1713327829221,EDS 206R,B00,507343,Staff,28,0,30,2
1713327830246,EDS 250,A00,507344,Hemans; Patricia Ann Benitez,36,0,40,4
1713327831270,EDS 281,A00,507345,Daly; Alan J.,18,0,18,0
1713327832298,EDS 284,A00,507350,Daly; Alan J.,16,0,16,0
1713327833322,EDS 286,A00,507359,Fine; Sarah,18,0,18,0
1713327834350,EDS 289C,A01,507361,Daly; Alan J.,18,0,18,0
1713327835378,EDS 290,A00,507366,Hofstetter; Carolyn,15,0,15,0
1713327836409,LIGM 5A,A00,507421,Fischer-Grunski; Eva K,20,0,20,0
1713327837437,LIGM 5B,A00,507423,Fischer-Grunski; Eva K,20,0,20,0
1713327838464,LIGM 5C,A00,507425,Fischer-Grunski; Eva K,20,0,20,0
1713327839489,LIIT 5AS,A00,507427,Carnelos; Chiara,20,0,20,0
1713327840517,LIIT 5BS,A00,507430,Carnelos; Chiara,20,0,20,0
1713327841542,LIIT 5CS,A00,507432,Carnelos; Chiara,20,0,20,0
1713327842568,LISP 5A,A00,507541,Munoz Sanchez; Alicia,17,0,20,3
1713327843594,LISP 5B,A00,507671,Munoz Sanchez; Alicia,15,0,20,5
1713327844618,LISP 5C,A00,507696,Munoz Sanchez; Alicia,15,0,20,5
1713327845647,MAE 197,001,528363,Boechler; Nicholas Sebastia,9998,0,9999,1
1713327846672,MATH 197,001,523477,Kedlaya; Kiran S.,9999,0,9999,0
1713327846672,MATH 197,002,563811,Zhang; Danna,9999,0,9999,0
1713327847697,MCWP 40R,A00,518780,Staff,20,0,20,0
1713327847697,MCWP 40R,B00,518781,Staff,19,0,20,1
1713327847697,MCWP 40R,C00,518783,Staff,19,0,20,1
1713327848728,MCWP 50R,A00,518791,Staff,20,0,20,0
1713327848728,MCWP 50R,B00,518792,Staff,17,0,20,3
1713327848728,MCWP 50R,C00,518793,Staff,19,0,20,1
1713327848728,MCWP 50R,D00,518794,Staff,16,0,20,4
1713327848728,MCWP 50R,E00,518795,Staff,16,0,20,4
1713327848728,MCWP 50R,F00,518796,Staff,19,0,20,1
1713327848728,MCWP 50R,G00,518797,Staff,19,0,20,1
1713327849758,MMW 12R,A01,514034,Herbst; Matthew,15,0,16,1
1713327849758,MMW 12R,A02,514035,Herbst; Matthew,16,0,16,0
1713327850784,MMW 13R,A01,514037,Staff,12,0,16,4
1713327850784,MMW 13R,A02,514039,Staff,16,0,16,0
1713327852834,SIO 295LS,A00,523233,Staff,19,0,30,11
1713327853871,SIO 295S,A00,523232,Staff,19,0,30,11
1713327854897,SOCI 117,A01,494376,Staff,2,0,5,3
1713327855921,WES 237B,A00,494380,Staff,19,0,20,1
1713327857990,AESE 279B,A00,494370,Wade; Jon P,33,0,33,0
1713327859017,ANAR 135S,A00,494369,Braswell; Geoffrey E.,0,0,0,0
1713327860047,CAT 124RS,A01,519847,Geibel; William,17,0,20,3
1713327861075,CAT 125RS,A01,515971,Geibel; William,17,0,20,3
1713327862105,CLRE 250,A00,511389,Morris; Sheldon,9996,0,9999,3
1713327863133,CLRE 251,A00,507176,Mehta; Ravindra L.,9996,0,9999,3
1713327863133,CLRE 251,B00,511410,Mehta; Ravindra L.,9998,0,9999,1
1713327864158,CLRE 252,A00,507189,Cuomo; Raphael Eduardo,9998,0,9999,1
1713327865188,CLRE 253,A00,507199,Vaida; Florin,9997,0,9999,2
1713327865188,CLRE 253,B00,507202,Vaida; Florin,9999,0,9999,0
1713327866217,CLRE 259,A00,507211,Patel; Hemal,9996,0,9999,3
1713327867242,CLRE 260,A00,507221,Cuomo; Raphael Eduardo,9999,0,9999,0
1713327868268,CLRE 297,001,507242,Cuomo; Raphael Eduardo,9999,0,9999,0
1713327869294,CSE 191,A00,516875,Minnes Kemp; Mor Mia,9999,0,9999,0
1713327870322,CSS 201S,A01,494383,Staff,35,0,35,0
1713327871347,CSS 202S,A01,494387,Staff,35,0,35,0
1713327872376,EAP 100,A00,516065,Staff,9792,0,9999,207
1713327873402,ECE 45,A01,507414,Staff,51,0,60,9
1713327874431,ECE 100,A01,507416,Baghdadchi; Saharnaz,11,0,20,9
1713327874431,ECE 100,A02,507418,Baghdadchi; Saharnaz,20,0,20,0
1713327875455,ECE 111,A01,507420,Staff,39,0,50,11
1713327876481,ECE 197,001,548057,Sievenpiper; Daniel F.,9998,0,9999,1
1713327877508,EDS 115,A00,507243,Choi; Bailey Miyeon,28,0,28,0
1713327878536,EDS 117,A01,494379,Staff,23,0,25,2
1713327879564,EDS 125,A00,507246,Hopkins; Megan Beth,29,0,30,1
1713327880592,EDS 128A,A01,507264,Fargason; Sharon Gayle,26,0,26,0
1713327881622,EDS 128B,A01,507293,Pappas; Elizabeth,30,0,30,0
1713327882647,EDS 139,A00,507294,Fargason; Sharon Gayle,30,0,30,0
1713327882647,EDS 139,B00,507313,Pappas; Elizabeth,30,0,30,0
1713327883672,EDS 201,A00,507315,Staff,26,0,30,4
1713327884698,EDS 203,A01,507317,Halter; Christopher P.,26,0,30,4
1713327885724,EDS 204R,A01,507319,Halter; Christopher P.,3,0,30,27
1713327885724,EDS 204R,B01,507331,Heinzman; Erica M.,28,0,30,2
1713327886753,EDS 206R,A00,507332,Staff,4,0,30,26
1713327886753,EDS 206R,B00,507343,Staff,28,0,30,2
1713327887779,EDS 250,A00,507344,Hemans; Patricia Ann Benitez,36,0,40,4
1713327888810,EDS 281,A00,507345,Daly; Alan J.,18,0,18,0
1713327889838,EDS 284,A00,507350,Daly; Alan J.,16,0,16,0
1713327890867,EDS 286,A00,507359,Fine; Sarah,18,0,18,0
1713327891892,EDS 289C,A01,507361,Daly; Alan J.,18,0,18,0
1713327892918,EDS 290,A00,507366,Hofstetter; Carolyn,15,0,15,0
1713327893949,LIGM 5A,A00,507421,Fischer-Grunski; Eva K,20,0,20,0
1713327894978,LIGM 5B,A00,507423,Fischer-Grunski; Eva K,20,0,20,0
1713327896004,LIGM 5C,A00,507425,Fischer-Grunski; Eva K,20,0,20,0
1713327897029,LIIT 5AS,A00,507427,Carnelos; Chiara,20,0,20,0
1713327898062,LIIT 5BS,A00,507430,Carnelos; Chiara,20,0,20,0
1713327899091,LIIT 5CS,A00,507432,Carnelos; Chiara,20,0,20,0
1713327900117,LISP 5A,A00,507541,Munoz Sanchez; Alicia,17,0,20,3
1713327901146,LISP 5B,A00,507671,Munoz Sanchez; Alicia,15,0,20,5
1713327902175,LISP 5C,A00,507696,Munoz Sanchez; Alicia,15,0,20,5
1713327903200,MAE 197,001,528363,Boechler; Nicholas Sebastia,9998,0,9999,1
1713327904227,MATH 197,001,523477,Kedlaya; Kiran S.,9999,0,9999,0
1713327904227,MATH 197,002,563811,Zhang; Danna,9999,0,9999,0
1713327905252,MCWP 40R,A00,518780,Staff,20,0,20,0
1713327905252,MCWP 40R,B00,518781,Staff,19,0,20,1
1713327905252,MCWP 40R,C00,518783,Staff,19,0,20,1
1713327906282,MCWP 50R,A00,518791,Staff,20,0,20,0
1713327906282,MCWP 50R,B00,518792,Staff,17,0,20,3
1713327906282,MCWP 50R,C00,518793,Staff,19,0,20,1
1713327906282,MCWP 50R,D00,518794,Staff,16,0,20,4
1713327906282,MCWP 50R,E00,518795,Staff,16,0,20,4
1713327906282,MCWP 50R,F00,518796,Staff,19,0,20,1
1713327906282,MCWP 50R,G00,518797,Staff,19,0,20,1
1713327907310,MMW 12R,A01,514034,Herbst; Matthew,15,0,16,1
1713327907310,MMW 12R,A02,514035,Herbst; Matthew,16,0,16,0
1713327908337,MMW 13R,A01,514037,Staff,12,0,16,4
1713327908337,MMW 13R,A02,514039,Staff,16,0,16,0
1713327910389,SIO 295LS,A00,523233,Staff,19,0,30,11
1713327911415,SIO 295S,A00,523232,Staff,19,0,30,11
1713327912442,SOCI 117,A01,494376,Staff,2,0,5,3
1713327913468,WES 237B,A00,494380,Staff,19,0,20,1
1713327915551,AESE 279B,A00,494370,Wade; Jon P,33,0,33,0
1713327916577,ANAR 135S,A00,494369,Braswell; Geoffrey E.,0,0,0,0
1713327917605,CAT 124RS,A01,519847,Geibel; William,17,0,20,3
1713327918638,CAT 125RS,A01,515971,Geibel; William,17,0,20,3
1713327919984,CLRE 250,A00,511389,Morris; Sheldon,9996,0,9999,3
1713327921011,CLRE 251,A00,507176,Mehta; Ravindra L.,9996,0,9999,3
1713327921011,CLRE 251,B00,511410,Mehta; Ravindra L.,9998,0,9999,1
1713327922038,CLRE 252,A00,507189,Cuomo; Raphael Eduardo,9998,0,9999,1
1713327923067,CLRE 253,A00,507199,Vaida; Florin,9997,0,9999,2
1713327923067,CLRE 253,B00,507202,Vaida; Florin,9999,0,9999,0
1713327924097,CLRE 259,A00,507211,Patel; Hemal,9996,0,9999,3
1713327925125,CLRE 260,A00,507221,Cuomo; Raphael Eduardo,9999,0,9999,0
1713327926152,CLRE 297,001,507242,Cuomo; Raphael Eduardo,9999,0,9999,0
1713327927179,CSE 191,A00,516875,Minnes Kemp; Mor Mia,9999,0,9999,0
1713327928208,CSS 201S,A01,494383,Staff,35,0,35,0
1713327929235,CSS 202S,A01,494387,Staff,35,0,35,0
1713327930258,EAP 100,A00,516065,Staff,9792,0,9999,207
1713327931283,ECE 45,A01,507414,Staff,51,0,60,9
1713327932370,ECE 100,A01,507416,Baghdadchi; Saharnaz,11,0,20,9
1713327932370,ECE 100,A02,507418,Baghdadchi; Saharnaz,20,0,20,0
1713327933395,ECE 111,A01,507420,Staff,39,0,50,11
1713327934422,ECE 197,001,548057,Sievenpiper; Daniel F.,9998,0,9999,1
1713327935447,EDS 115,A00,507243,Choi; Bailey Miyeon,28,0,28,0
1713327936470,EDS 117,A01,494379,Staff,23,0,25,2
1713327937496,EDS 125,A00,507246,Hopkins; Megan Beth,29,0,30,1
1713327938521,EDS 128A,A01,507264,Fargason; Sharon Gayle,26,0,26,0
1713327939546,EDS 128B,A01,507293,Pappas; Elizabeth,30,0,30,0
1713327940570,EDS 139,A00,507294,Fargason; Sharon Gayle,30,0,30,0
1713327940570,EDS 139,B00,507313,Pappas; Elizabeth,30,0,30,0
1713327941602,EDS 201,A00,507315,Staff,26,0,30,4
1713327942636,EDS 203,A01,507317,Halter; Christopher P.,26,0,30,4
1713327943660,EDS 204R,A01,507319,Halter; Christopher P.,3,0,30,27
1713327943660,EDS 204R,B01,507331,Heinzman; Erica M.,28,0,30,2
1713327944688,EDS 206R,A00,507332,Staff,4,0,30,26
1713327944688,EDS 206R,B00,507343,Staff,28,0,30,2
1713327945714,EDS 250,A00,507344,Hemans; Patricia Ann Benitez,36,0,40,4
1713327946739,EDS 281,A00,507345,Daly; Alan J.,18,0,18,0
1713327947763,EDS 284,A00,507350,Daly; Alan J.,16,0,16,0
1713327948791,EDS 286,A00,507359,Fine; Sarah,18,0,18,0
1713327949816,EDS 289C,A01,507361,Daly; Alan J.,18,0,18,0
1713327950842,EDS 290,A00,507366,Hofstetter; Carolyn,15,0,15,0
1713327951874,LIGM 5A,A00,507421,Fischer-Grunski; Eva K,20,0,20,0
1713327952901,LIGM 5B,A00,507423,Fischer-Grunski; Eva K,20,0,20,0
1713327953929,LIGM 5C,A00,507425,Fischer-Grunski; Eva K,20,0,20,0
1713327954960,LIIT 5AS,A00,507427,Carnelos; Chiara,20,0,20,0
1713327955988,LIIT 5BS,A00,507430,Carnelos; Chiara,20,0,20,0
1713327957014,LIIT 5CS,A00,507432,Carnelos; Chiara,20,0,20,0
1713327958045,LISP 5A,A00,507541,Munoz Sanchez; Alicia,17,0,20,3
1713327959070,LISP 5B,A00,507671,Munoz Sanchez; Alicia,15,0,20,5
1713327960096,LISP 5C,A00,507696,Munoz Sanchez; Alicia,15,0,20,5
1713327961125,MAE 197,001,528363,Boechler; Nicholas Sebastia,9998,0,9999,1
1713327962156,MATH 197,001,523477,Kedlaya; Kiran S.,9999,0,9999,0
1713327962156,MATH 197,002,563811,Zhang; Danna,9999,0,9999,0
1713327963181,MCWP 40R,A00,518780,Staff,20,0,20,0
1713327963181,MCWP 40R,B00,518781,Staff,19,0,20,1
1713327963181,MCWP 40R,C00,518783,Staff,19,0,20,1
1713327964210,MCWP 50R,A00,518791,Staff,20,0,20,0
1713327964210,MCWP 50R,B00,518792,Staff,17,0,20,3
1713327964210,MCWP 50R,C00,518793,Staff,19,0,20,1
1713327964210,MCWP 50R,D00,518794,Staff,16,0,20,4
1713327964210,MCWP 50R,E00,518795,Staff,16,0,20,4
1713327964210,MCWP 50R,F00,518796,Staff,19,0,20,1
1713327964210,MCWP 50R,G00,518797,Staff,19,0,20,1
1713327965236,MMW 12R,A01,514034,Herbst; Matthew,15,0,16,1
1713327965236,MMW 12R,A02,514035,Herbst; Matthew,16,0,16,0
1713327966262,MMW 13R,A01,514037,Staff,12,0,16,4
1713327966262,MMW 13R,A02,514039,Staff,16,0,16,0
1713327968313,SIO 295LS,A00,523233,Staff,19,0,30,11
1713327969340,SIO 295S,A00,523232,Staff,19,0,30,11
1713327970366,SOCI 117,A01,494376,Staff,2,0,5,3
1713327971392,WES 237B,A00,494380,Staff,19,0,20,1
1713327973468,AESE 279B,A00,494370,Wade; Jon P,33,0,33,0
1713327974494,ANAR 135S,A00,494369,Braswell; Geoffrey E.,0,0,0,0
1713327975518,CAT 124RS,A01,519847,Geibel; William,17,0,20,3
1713327976545,CAT 125RS,A01,515971,Geibel; William,17,0,20,3
1713327977572,CLRE 250,A00,511389,Morris; Sheldon,9996,0,9999,3
1713327978598,CLRE 251,A00,507176,Mehta; Ravindra L.,9996,0,9999,3
1713327978598,CLRE 251,B00,511410,Mehta; Ravindra L.,9998,0,9999,1
1713327979625,CLRE 252,A00,507189,Cuomo; Raphael Eduardo,9998,0,9999,1
1713327980655,CLRE 253,A00,507199,Vaida; Florin,9997,0,9999,2
1713327980655,CLRE 253,B00,507202,Vaida; Florin,9999,0,9999,0
1713327981680,CLRE 259,A00,507211,Patel; Hemal,9996,0,9999,3
1713327982709,CLRE 260,A00,507221,Cuomo; Raphael Eduardo,9999,0,9999,0
1713327983736,CLRE 297,001,507242,Cuomo; Raphael Eduardo,9999,0,9999,0
1713327984764,CSE 191,A00,516875,Minnes Kemp; Mor Mia,9999,0,9999,0
1713327985789,CSS 201S,A01,494383,Staff,35,0,35,0
1713327986814,CSS 202S,A01,494387,Staff,35,0,35,0
1713327987838,EAP 100,A00,516065,Staff,9792,0,9999,207
1713327988867,ECE 45,A01,507414,Staff,51,0,60,9
1713327989898,ECE 100,A01,507416,Baghdadchi; Saharnaz,11,0,20,9
1713327989898,ECE 100,A02,507418,Baghdadchi; Saharnaz,20,0,20,0
1713327990924,ECE 111,A01,507420,Staff,39,0,50,11
1713327991949,ECE 197,001,548057,Sievenpiper; Daniel F.,9998,0,9999,1
1713327992976,EDS 115,A00,507243,Choi; Bailey Miyeon,28,0,28,0
1713327994004,EDS 117,A01,494379,Staff,23,0,25,2
1713327995029,EDS 125,A00,507246,Hopkins; Megan Beth,29,0,30,1
1713327996056,EDS 128A,A01,507264,Fargason; Sharon Gayle,26,0,26,0
1713327997082,EDS 128B,A01,507293,Pappas; Elizabeth,30,0,30,0
1713327998106,EDS 139,A00,507294,Fargason; Sharon Gayle,30,0,30,0
1713327998106,EDS 139,B00,507313,Pappas; Elizabeth,30,0,30,0
1713327999130,EDS 201,A00,507315,Staff,26,0,30,4
1713328000156,EDS 203,A01,507317,Halter; Christopher P.,26,0,30,4
1713328001187,EDS 204R,A01,507319,Halter; Christopher P.,3,0,30,27
1713328001187,EDS 204R,B01,507331,Heinzman; Erica M.,28,0,30,2
1713328002209,EDS 206R,A00,507332,Staff,4,0,30,26
1713328002209,EDS 206R,B00,507343,Staff,28,0,30,2
1713328003235,EDS 250,A00,507344,Hemans; Patricia Ann Benitez,36,0,40,4
1713328004263,EDS 281,A00,507345,Daly; Alan J.,18,0,18,0
1713328005286,EDS 284,A00,507350,Daly; Alan J.,16,0,16,0
1713328006312,EDS 286,A00,507359,Fine; Sarah,18,0,18,0
1713328007339,EDS 289C,A01,507361,Daly; Alan J.,18,0,18,0
1713328008364,EDS 290,A00,507366,Hofstetter; Carolyn,15,0,15,0
1713328009390,LIGM 5A,A00,507421,Fischer-Grunski; Eva K,20,0,20,0
1713328010415,LIGM 5B,A00,507423,Fischer-Grunski; Eva K,20,0,20,0
1713328011439,LIGM 5C,A00,507425,Fischer-Grunski; Eva K,20,0,20,0
1713328012470,LIIT 5AS,A00,507427,Carnelos; Chiara,20,0,20,0
1713328013498,LIIT 5BS,A00,507430,Carnelos; Chiara,20,0,20,0
1713328014523,LIIT 5CS,A00,507432,Carnelos; Chiara,20,0,20,0
1713328015549,LISP 5A,A00,507541,Munoz Sanchez; Alicia,17,0,20,3
1713328016573,LISP 5B,A00,507671,Munoz Sanchez; Alicia,15,0,20,5
1713328017597,LISP 5C,A00,507696,Munoz Sanchez; Alicia,15,0,20,5
1713328018623,MAE 197,001,528363,Boechler; Nicholas Sebastia,9998,0,9999,1
1713328019652,MATH 197,001,523477,Kedlaya; Kiran S.,9999,0,9999,0
1713328019652,MATH 197,002,563811,Zhang; Danna,9999,0,9999,0
1713328020678,MCWP 40R,A00,518780,Staff,20,0,20,0
1713328020678,MCWP 40R,B00,518781,Staff,19,0,20,1
1713328020678,MCWP 40R,C00,518783,Staff,19,0,20,1
1713328021707,MCWP 50R,A00,518791,Staff,20,0,20,0
1713328021707,MCWP 50R,B00,518792,Staff,17,0,20,3
1713328021707,MCWP 50R,C00,518793,Staff,19,0,20,1
1713328021707,MCWP 50R,D00,518794,Staff,16,0,20,4
1713328021707,MCWP 50R,E00,518795,Staff,16,0,20,4
1713328021707,MCWP 50R,F00,518796,Staff,19,0,20,1
1713328021707,MCWP 50R,G00,518797,Staff,19,0,20,1
1713328022730,MMW 12R,A01,514034,Herbst; Matthew,15,0,16,1
1713328022730,MMW 12R,A02,514035,Herbst; Matthew,16,0,16,0
1713328023759,MMW 13R,A01,514037,Staff,12,0,16,4
1713328023759,MMW 13R,A02,514039,Staff,16,0,16,0
1713328025808,SIO 295LS,A00,523233,Staff,19,0,30,11
1713328026831,SIO 295S,A00,523232,Staff,19,0,30,11
1713328027858,SOCI 117,A01,494376,Staff,2,0,5,3
1713328028888,WES 237B,A00,494380,Staff,19,0,20,1
1713328030957,AESE 279B,A00,494370,Wade; Jon P,33,0,33,0
1713328031985,ANAR 135S,A00,494369,Braswell; Geoffrey E.,0,0,0,0
1713328033009,CAT 124RS,A01,519847,Geibel; William,17,0,20,3
1713328034039,CAT 125RS,A01,515971,Geibel; William,17,0,20,3
1713328035064,CLRE 250,A00,511389,Morris; Sheldon,9996,0,9999,3
1713328036146,CLRE 251,A00,507176,Mehta; Ravindra L.,9996,0,9999,3
1713328036146,CLRE 251,B00,511410,Mehta; Ravindra L.,9998,0,9999,1
1713328037176,CLRE 252,A00,507189,Cuomo; Raphael Eduardo,9998,0,9999,1
1713328038202,CLRE 253,A00,507199,Vaida; Florin,9997,0,9999,2
1713328038202,CLRE 253,B00,507202,Vaida; Florin,9999,0,9999,0
1713328039226,CLRE 259,A00,507211,Patel; Hemal,9996,0,9999,3
1713328040253,CLRE 260,A00,507221,Cuomo; Raphael Eduardo,9999,0,9999,0
1713328041278,CLRE 297,001,507242,Cuomo; Raphael Eduardo,9999,0,9999,0
1713328042306,CSE 191,A00,516875,Minnes Kemp; Mor Mia,9999,0,9999,0
1713328043332,CSS 201S,A01,494383,Staff,35,0,35,0
1713328044357,CSS 202S,A01,494387,Staff,35,0,35,0
1713328045382,EAP 100,A00,516065,Staff,9792,0,9999,207
1713328046410,ECE 45,A01,507414,Staff,51,0,60,9
1713328047435,ECE 100,A01,507416,Baghdadchi; Saharnaz,11,0,20,9
1713328047435,ECE 100,A02,507418,Baghdadchi; Saharnaz,20,0,20,0
1713328048465,ECE 111,A01,507420,Staff,39,0,50,11
1713328049494,ECE 197,001,548057,Sievenpiper; Daniel F.,9998,0,9999,1
1713328050521,EDS 115,A00,507243,Choi; Bailey Miyeon,28,0,28,0
1713328051546,EDS 117,A01,494379,Staff,23,0,25,2
1713328052575,EDS 125,A00,507246,Hopkins; Megan Beth,29,0,30,1
1713328053602,EDS 128A,A01,507264,Fargason; Sharon Gayle,26,0,26,0
1713328054630,EDS 128B,A01,507293,Pappas; Elizabeth,30,0,30,0
1713328055659,EDS 139,A00,507294,Fargason; Sharon Gayle,30,0,30,0
1713328055659,EDS 139,B00,507313,Pappas; Elizabeth,30,0,30,0
1713328056686,EDS 201,A00,507315,Staff,26,0,30,4
1713328057711,EDS 203,A01,507317,Halter; Christopher P.,26,0,30,4
1713328058737,EDS 204R,A01,507319,Halter; Christopher P.,3,0,30,27
1713328058737,EDS 204R,B01,507331,Heinzman; Erica M.,28,0,30,2
1713328059766,EDS 206R,A00,507332,Staff,4,0,30,26
1713328059766,EDS 206R,B00,507343,Staff,28,0,30,2
1713328060792,EDS 250,A00,507344,Hemans; Patricia Ann Benitez,36,0,40,4
1713328061821,EDS 281,A00,507345,Daly; Alan J.,18,0,18,0
1713328062846,EDS 284,A00,507350,Daly; Alan J.,16,0,16,0
1713328063871,EDS 286,A00,507359,Fine; Sarah,18,0,18,0
1713328064900,EDS 289C,A01,507361,Daly; Alan J.,18,0,18,0
1713328065925,EDS 290,A00,507366,Hofstetter; Carolyn,15,0,15,0
1713328066957,LIGM 5A,A00,507421,Fischer-Grunski; Eva K,20,0,20,0
1713328067982,LIGM 5B,A00,507423,Fischer-Grunski; Eva K,20,0,20,0
1713328069010,LIGM 5C,A00,507425,Fischer-Grunski; Eva K,20,0,20,0
1713328070038,LIIT 5AS,A00,507427,Carnelos; Chiara,20,0,20,0
1713328071069,LIIT 5BS,A00,507430,Carnelos; Chiara,20,0,20,0
1713328072096,LIIT 5CS,A00,507432,Carnelos; Chiara,20,0,20,0
1713328073121,LISP 5A,A00,507541,Munoz Sanchez; Alicia,17,0,20,3
1713328074149,LISP 5B,A00,507671,Munoz Sanchez; Alicia,15,0,20,5
1713328075178,LISP 5C,A00,507696,Munoz Sanchez; Alicia,15,0,20,5
1713328076207,MAE 197,001,528363,Boechler; Nicholas Sebastia,9998,0,9999,1
1713328077237,MATH 197,001,523477,Kedlaya; Kiran S.,9999,0,9999,0
1713328077237,MATH 197,002,563811,Zhang; Danna,9999,0,9999,0
1713328078262,MCWP 40R,A00,518780,Staff,20,0,20,0
1713328078262,MCWP 40R,B00,518781,Staff,19,0,20,1
1713328078262,MCWP 40R,C00,518783,Staff,19,0,20,1
1713328079287,MCWP 50R,A00,518791,Staff,20,0,20,0
1713328079287,MCWP 50R,B00,518792,Staff,17,0,20,3
1713328079287,MCWP 50R,C00,518793,Staff,19,0,20,1
1713328079287,MCWP 50R,D00,518794,Staff,16,0,20,4
1713328079287,MCWP 50R,E00,518795,Staff,16,0,20,4
1713328079287,MCWP 50R,F00,518796,Staff,19,0,20,1
1713328079287,MCWP 50R,G00,518797,Staff,19,0,20,1
1713328080316,MMW 12R,A01,514034,Herbst; Matthew,15,0,16,1
1713328080316,MMW 12R,A02,514035,Herbst; Matthew,16,0,16,0
1713328081342,MMW 13R,A01,514037,Staff,12,0,16,4
1713328081342,MMW 13R,A02,514039,Staff,16,0,16,0
1713328083396,SIO 295LS,A00,523233,Staff,19,0,30,11
1713328084422,SIO 295S,A00,523232,Staff,19,0,30,11
1713328085452,SOCI 117,A01,494376,Staff,2,0,5,3
1713328086477,WES 237B,A00,494380,Staff,19,0,20,1
1713328088547,AESE 279B,A00,494370,Wade; Jon P,33,0,33,0
1713328089574,ANAR 135S,A00,494369,Braswell; Geoffrey E.,0,0,0,0
1713328090601,CAT 124RS,A01,519847,Geibel; William,17,0,20,3
1713328091626,CAT 125RS,A01,515971,Geibel; William,17,0,20,3
1713328092652,CLRE 250,A00,511389,Morris; Sheldon,9996,0,9999,3
1713328093679,CLRE 251,A00,507176,Mehta; Ravindra L.,9996,0,9999,3
1713328093679,CLRE 251,B00,511410,Mehta; Ravindra L.,9998,0,9999,1
1713328094706,CLRE 252,A00,507189,Cuomo; Raphael Eduardo,9998,0,9999,1
1713328095738,CLRE 253,A00,507199,Vaida; Florin,9997,0,9999,2
1713328095738,CLRE 253,B00,507202,Vaida; Florin,9999,0,9999,0
1713328096765,CLRE 259,A00,507211,Patel; Hemal,9996,0,9999,3
1713328097796,CLRE 260,A00,507221,Cuomo; Raphael Eduardo,9999,0,9999,0
1713328098822,CLRE 297,001,507242,Cuomo; Raphael Eduardo,9999,0,9999,0
1713328099848,CSE 191,A00,516875,Minnes Kemp; Mor Mia,9999,0,9999,0
1713328100881,CSS 201S,A01,494383,Staff,35,0,35,0
1713328101910,CSS 202S,A01,494387,Staff,35,0,35,0
1713328102942,EAP 100,A00,516065,Staff,9792,0,9999,207
1713328103970,ECE 45,A01,507414,Staff,51,0,60,9
1713328104999,ECE 100,A01,507416,Baghdadchi; Saharnaz,11,0,20,9
1713328104999,ECE 100,A02,507418,Baghdadchi; Saharnaz,20,0,20,0
1713328106032,ECE 111,A01,507420,Staff,39,0,50,11
1713328107061,ECE 197,001,548057,Sievenpiper; Daniel F.,9998,0,9999,1
1713328108092,EDS 115,A00,507243,Choi; Bailey Miyeon,28,0,28,0
1713328109119,EDS 117,A01,494379,Staff,23,0,25,2
1713328110149,EDS 125,A00,507246,Hopkins; Megan Beth,29,0,30,1
1713328111176,EDS 128A,A01,507264,Fargason; Sharon Gayle,26,0,26,0
1713328112203,EDS 128B,A01,507293,Pappas; Elizabeth,30,0,30,0
1713328113227,EDS 139,A00,507294,Fargason; Sharon Gayle,30,0,30,0
1713328113227,EDS 139,B00,507313,Pappas; Elizabeth,30,0,30,0
1713328114251,EDS 201,A00,507315,Staff,26,0,30,4
1713328115276,EDS 203,A01,507317,Halter; Christopher P.,26,0,30,4
1713328116301,EDS 204R,A01,507319,Halter; Christopher P.,3,0,30,27
1713328116301,EDS 204R,B01,507331,Heinzman; Erica M.,28,0,30,2
1713328117329,EDS 206R,A00,507332,Staff,4,0,30,26
1713328117329,EDS 206R,B00,507343,Staff,28,0,30,2
1713328118359,EDS 250,A00,507344,Hemans; Patricia Ann Benitez,36,0,40,4
1713328119383,EDS 281,A00,507345,Daly; Alan J.,18,0,18,0
1713328120411,EDS 284,A00,507350,Daly; Alan J.,16,0,16,0
1713328121440,EDS 286,A00,507359,Fine; Sarah,18,0,18,0
1713328122464,EDS 289C,A01,507361,Daly; Alan J.,18,0,18,0
1713328123492,EDS 290,A00,507366,Hofstetter; Carolyn,15,0,15,0
1713328124520,LIGM 5A,A00,507421,Fischer-Grunski; Eva K,20,0,20,0
1713328125544,LIGM 5B,A00,507423,Fischer-Grunski; Eva K,20,0,20,0
1713328126569,LIGM 5C,A00,507425,Fischer-Grunski; Eva K,20,0,20,0
1713328127600,LIIT 5AS,A00,507427,Carnelos; Chiara,20,0,20,0
1713328128625,LIIT 5BS,A00,507430,Carnelos; Chiara,20,0,20,0
1713328129651,LIIT 5CS,A00,507432,Carnelos; Chiara,20,0,20,0
1713328130681,LISP 5A,A00,507541,Munoz Sanchez; Alicia,17,0,20,3
1713328131711,LISP 5B,A00,507671,Munoz Sanchez; Alicia,15,0,20,5
1713328132741,LISP 5C,A00,507696,Munoz Sanchez; Alicia,15,0,20,5
1713328133769,MAE 197,001,528363,Boechler; Nicholas Sebastia,9998,0,9999,1
1713328134797,MATH 197,001,523477,Kedlaya; Kiran S.,9999,0,9999,0
1713328134797,MATH 197,002,563811,Zhang; Danna,9999,0,9999,0
1713328135826,MCWP 40R,A00,518780,Staff,20,0,20,0
1713328135826,MCWP 40R,B00,518781,Staff,19,0,20,1
1713328135826,MCWP 40R,C00,518783,Staff,19,0,20,1
1713328136851,MCWP 50R,A00,518791,Staff,20,0,20,0
1713328136851,MCWP 50R,B00,518792,Staff,17,0,20,3
1713328136851,MCWP 50R,C00,518793,Staff,19,0,20,1
1713328136851,MCWP 50R,D00,518794,Staff,16,0,20,4
1713328136851,MCWP 50R,E00,518795,Staff,16,0,20,4
1713328136851,MCWP 50R,F00,518796,Staff,19,0,20,1
1713328136851,MCWP 50R,G00,518797,Staff,19,0,20,1
1713328137880,MMW 12R,A01,514034,Herbst; Matthew,15,0,16,1
1713328137880,MMW 12R,A02,514035,Herbst; Matthew,16,0,16,0
1713328138905,MMW 13R,A01,514037,Staff,12,0,16,4
1713328138905,MMW 13R,A02,514039,Staff,16,0,16,0
1713328141013,SIO 295LS,A00,523233,Staff,19,0,30,11
1713328142040,SIO 295S,A00,523232,Staff,19,0,30,11
1713328143070,SOCI 117,A01,494376,Staff,2,0,5,3
1713328144095,WES 237B,A00,494380,Staff,19,0,20,1
1713328146167,AESE 279B,A00,494370,Wade; Jon P,33,0,33,0
1713328147192,ANAR 135S,A00,494369,Braswell; Geoffrey E.,0,0,0,0
1713328148218,CAT 124RS,A01,519847,Geibel; William,17,0,20,3
1713328149242,CAT 125RS,A01,515971,Geibel; William,17,0,20,3
1713328150269,CLRE 250,A00,511389,Morris; Sheldon,9996,0,9999,3
1713328151300,CLRE 251,A00,507176,Mehta; Ravindra L.,9996,0,9999,3
1713328151300,CLRE 251,B00,511410,Mehta; Ravindra L.,9998,0,9999,1
1713328152327,CLRE 252,A00,507189,Cuomo; Raphael Eduardo,9998,0,9999,1
1713328153353,CLRE 253,A00,507199,Vaida; Florin,9997,0,9999,2
1713328153353,CLRE 253,B00,507202,Vaida; Florin,9999,0,9999,0
1713328154382,CLRE 259,A00,507211,Patel; Hemal,9996,0,9999,3
1713328155406,CLRE 260,A00,507221,Cuomo; Raphael Eduardo,9999,0,9999,0
1713328156433,CLRE 297,001,507242,Cuomo; Raphael Eduardo,9999,0,9999,0
1713328157458,CSE 191,A00,516875,Minnes Kemp; Mor Mia,9999,0,9999,0
1713328158486,CSS 201S,A01,494383,Staff,35,0,35,0
1713328159513,CSS 202S,A01,494387,Staff,35,0,35,0
1713328160540,EAP 100,A00,516065,Staff,9792,0,9999,207
1713328161564,ECE 45,A01,507414,Staff,51,0,60,9
1713328162595,ECE 100,A01,507416,Baghdadchi; Saharnaz,11,0,20,9
1713328162595,ECE 100,A02,507418,Baghdadchi; Saharnaz,20,0,20,0
1713328163620,ECE 111,A01,507420,Staff,39,0,50,11
1713328164648,ECE 197,001,548057,Sievenpiper; Daniel F.,9998,0,9999,1
1713328165680,EDS 115,A00,507243,Choi; Bailey Miyeon,28,0,28,0
1713328166705,EDS 117,A01,494379,Staff,23,0,25,2
1713328167731,EDS 125,A00,507246,Hopkins; Megan Beth,29,0,30,1
1713328168762,EDS 128A,A01,507264,Fargason; Sharon Gayle,26,0,26,0
1713328169792,EDS 128B,A01,507293,Pappas; Elizabeth,30,0,30,0
1713328170818,EDS 139,A00,507294,Fargason; Sharon Gayle,30,0,30,0
1713328170818,EDS 139,B00,507313,Pappas; Elizabeth,30,0,30,0
1713328171843,EDS 201,A00,507315,Staff,26,0,30,4
1713328172867,EDS 203,A01,507317,Halter; Christopher P.,26,0,30,4
1713328173891,EDS 204R,A01,507319,Halter; Christopher P.,3,0,30,27
1713328173891,EDS 204R,B01,507331,Heinzman; Erica M.,28,0,30,2
1713328174918,EDS 206R,A00,507332,Staff,4,0,30,26
1713328174918,EDS 206R,B00,507343,Staff,28,0,30,2
1713328175943,EDS 250,A00,507344,Hemans; Patricia Ann Benitez,36,0,40,4
1713328176972,EDS 281,A00,507345,Daly; Alan J.,18,0,18,0
1713328177996,EDS 284,A00,507350,Daly; Alan J.,16,0,16,0
1713328179024,EDS 286,A00,507359,Fine; Sarah,18,0,18,0
1713328180049,EDS 289C,A01,507361,Daly; Alan J.,18,0,18,0
1713328181079,EDS 290,A00,507366,Hofstetter; Carolyn,15,0,15,0
1713328182104,LIGM 5A,A00,507421,Fischer-Grunski; Eva K,20,0,20,0
1713328183133,LIGM 5B,A00,507423,Fischer-Grunski; Eva K,20,0,20,0
1713328184160,LIGM 5C,A00,507425,Fischer-Grunski; Eva K,20,0,20,0
1713328185185,LIIT 5AS,A00,507427,Carnelos; Chiara,20,0,20,0
1713328186210,LIIT 5BS,A00,507430,Carnelos; Chiara,20,0,20,0
1713328187238,LIIT 5CS,A00,507432,Carnelos; Chiara,20,0,20,0
1713328188268,LISP 5A,A00,507541,Munoz Sanchez; Alicia,17,0,20,3
1713328189292,LISP 5B,A00,507671,Munoz Sanchez; Alicia,15,0,20,5
1713328190319,LISP 5C,A00,507696,Munoz Sanchez; Alicia,15,0,20,5
1713328191345,MAE 197,001,528363,Boechler; Nicholas Sebastia,9998,0,9999,1
1713328192370,MATH 197,001,523477,Kedlaya; Kiran S.,9999,0,9999,0
1713328192370,MATH 197,002,563811,Zhang; Danna,9999,0,9999,0
1713328193395,MCWP 40R,A00,518780,Staff,20,0,20,0
1713328193395,MCWP 40R,B00,518781,Staff,19,0,20,1
1713328193395,MCWP 40R,C00,518783,Staff,19,0,20,1
1713328194420,MCWP 50R,A00,518791,Staff,20,0,20,0
1713328194420,MCWP 50R,B00,518792,Staff,17,0,20,3
1713328194420,MCWP 50R,C00,518793,Staff,19,0,20,1
1713328194420,MCWP 50R,D00,518794,Staff,16,0,20,4
1713328194420,MCWP 50R,E00,518795,Staff,16,0,20,4
1713328194420,MCWP 50R,F00,518796,Staff,19,0,20,1
1713328194420,MCWP 50R,G00,518797,Staff,19,0,20,1
1713328195444,MMW 12R,A01,514034,Herbst; Matthew,15,0,16,1
1713328195444,MMW 12R,A02,514035,Herbst; Matthew,16,0,16,0
1713328196470,MMW 13R,A01,514037,Staff,12,0,16,4
1713328196470,MMW 13R,A02,514039,Staff,16,0,16,0
1713328198523,SIO 295LS,A00,523233,Staff,19,0,30,11
1713328199552,SIO 295S,A00,523232,Staff,19,0,30,11
1713328200577,SOCI 117,A01,494376,Staff,2,0,5,3
1713328201605,WES 237B,A00,494380,Staff,19,0,20,1
1713328203673,AESE 279B,A00,494370,Wade; Jon P,33,0,33,0
1713328204698,ANAR 135S,A00,494369,Braswell; Geoffrey E.,0,0,0,0
1713328205722,CAT 124RS,A01,519847,Geibel; William,17,0,20,3
1713328206747,CAT 125RS,A01,515971,Geibel; William,17,0,20,3
1713328207772,CLRE 250,A00,511389,Morris; Sheldon,9996,0,9999,3
1713328208799,CLRE 251,A00,507176,Mehta; Ravindra L.,9996,0,9999,3
1713328208799,CLRE 251,B00,511410,Mehta; Ravindra L.,9998,0,9999,1
1713328209828,CLRE 252,A00,507189,Cuomo; Raphael Eduardo,9998,0,9999,1
1713328210858,CLRE 253,A00,507199,Vaida; Florin,9997,0,9999,2
1713328210858,CLRE 253,B00,507202,Vaida; Florin,9999,0,9999,0
1713328211890,CLRE 259,A00,507211,Patel; Hemal,9996,0,9999,3
1713328212915,CLRE 260,A00,507221,Cuomo; Raphael Eduardo,9999,0,9999,0
1713328213939,CLRE 297,001,507242,Cuomo; Raphael Eduardo,9999,0,9999,0
1713328214965,CSE 191,A00,516875,Minnes Kemp; Mor Mia,9999,0,9999,0
1713328215992,CSS 201S,A01,494383,Staff,35,0,35,0
1713328217018,CSS 202S,A01,494387,Staff,35,0,35,0
1713328218042,EAP 100,A00,516065,Staff,9792,0,9999,207
1713328219069,ECE 45,A01,507414,Staff,51,0,60,9
1713328220095,ECE 100,A01,507416,Baghdadchi; Saharnaz,11,0,20,9
1713328220095,ECE 100,A02,507418,Baghdadchi; Saharnaz,20,0,20,0
1713328221121,ECE 111,A01,507420,Staff,39,0,50,11
1713328222147,ECE 197,001,548057,Sievenpiper; Daniel F.,9998,0,9999,1
1713328223174,EDS 115,A00,507243,Choi; Bailey Miyeon,28,0,28,0
1713328224200,EDS 117,A01,494379,Staff,23,0,25,2
1713328225226,EDS 125,A00,507246,Hopkins; Megan Beth,29,0,30,1
1713328226251,EDS 128A,A01,507264,Fargason; Sharon Gayle,26,0,26,0
1713328227278,EDS 128B,A01,507293,Pappas; Elizabeth,30,0,30,0
1713328228302,EDS 139,A00,507294,Fargason; Sharon Gayle,30,0,30,0
1713328228302,EDS 139,B00,507313,Pappas; Elizabeth,30,0,30,0
1713328229327,EDS 201,A00,507315,Staff,26,0,30,4
1713328230352,EDS 203,A01,507317,Halter; Christopher P.,26,0,30,4
1713328231382,EDS 204R,A01,507319,Halter; Christopher P.,3,0,30,27
1713328231382,EDS 204R,B01,507331,Heinzman; Erica M.,28,0,30,2
1713328232412,EDS 206R,A00,507332,Staff,4,0,30,26
1713328232412,EDS 206R,B00,507343,Staff,28,0,30,2
1713328233439,EDS 250,A00,507344,Hemans; Patricia Ann Benitez,36,0,40,4
1713328234467,EDS 281,A00,507345,Daly; Alan J.,18,0,18,0
1713328235492,EDS 284,A00,507350,Daly; Alan J.,16,0,16,0
1713328236517,EDS 286,A00,507359,Fine; Sarah,18,0,18,0
1713328237542,EDS 289C,A01,507361,Daly; Alan J.,18,0,18,0
1713328238568,EDS 290,A00,507366,Hofstetter; Carolyn,15,0,15,0
1713328239598,LIGM 5A,A00,507421,Fischer-Grunski; Eva K,20,0,20,0
1713328240623,LIGM 5B,A00,507423,Fischer-Grunski; Eva K,20,0,20,0
1713328241652,LIGM 5C,A00,507425,Fischer-Grunski; Eva K,20,0,20,0
1713328242677,LIIT 5AS,A00,507427,Carnelos; Chiara,20,0,20,0
1713328243762,LIIT 5BS,A00,507430,Carnelos; Chiara,20,0,20,0
1713328244992,LIIT 5CS,A00,507432,Carnelos; Chiara,20,0,20,0
1713328246023,LISP 5A,A00,507541,Munoz Sanchez; Alicia,17,0,20,3
1713328247053,LISP 5B,A00,507671,Munoz Sanchez; Alicia,15,0,20,5
1713328248078,LISP 5C,A00,507696,Munoz Sanchez; Alicia,15,0,20,5
1713328249109,MAE 197,001,528363,Boechler; Nicholas Sebastia,9998,0,9999,1
1713328250138,MATH 197,001,523477,Kedlaya; Kiran S.,9999,0,9999,0
1713328250138,MATH 197,002,563811,Zhang; Danna,9999,0,9999,0
1713328251164,MCWP 40R,A00,518780,Staff,20,0,20,0
1713328251164,MCWP 40R,B00,518781,Staff,19,0,20,1
1713328251164,MCWP 40R,C00,518783,Staff,19,0,20,1
1713328252190,MCWP 50R,A00,518791,Staff,20,0,20,0
1713328252190,MCWP 50R,B00,518792,Staff,17,0,20,3
1713328252190,MCWP 50R,C00,518793,Staff,19,0,20,1
1713328252190,MCWP 50R,D00,518794,Staff,16,0,20,4
1713328252190,MCWP 50R,E00,518795,Staff,16,0,20,4
1713328252190,MCWP 50R,F00,518796,Staff,19,0,20,1
1713328252190,MCWP 50R,G00,518797,Staff,19,0,20,1
1713328253218,MMW 12R,A01,514034,Herbst; Matthew,15,0,16,1
1713328253218,MMW 12R,A02,514035,Herbst; Matthew,16,0,16,0
1713328254246,MMW 13R,A01,514037,Staff,12,0,16,4
1713328254246,MMW 13R,A02,514039,Staff,16,0,16,0
1713328256295,SIO 295LS,A00,523233,Staff,19,0,30,11
1713328257320,SIO 295S,A00,523232,Staff,19,0,30,11
1713328258347,SOCI 117,A01,494376,Staff,2,0,5,3
1713328259377,WES 237B,A00,494380,Staff,19,0,20,1
1713328261656,AESE 279B,A00,494370,Wade; Jon P,33,0,33,0
1713328262682,ANAR 135S,A00,494369,Braswell; Geoffrey E.,0,0,0,0
1713328263708,CAT 124RS,A01,519847,Geibel; William,17,0,20,3
1713328264735,CAT 125RS,A01,515971,Geibel; William,17,0,20,3
1713328265766,CLRE 250,A00,511389,Morris; Sheldon,9996,0,9999,3
1713328266798,CLRE 251,A00,507176,Mehta; Ravindra L.,9996,0,9999,3
1713328266798,CLRE 251,B00,511410,Mehta; Ravindra L.,9998,0,9999,1
1713328267827,CLRE 252,A00,507189,Cuomo; Raphael Eduardo,9998,0,9999,1
1713328268857,CLRE 253,A00,507199,Vaida; Florin,9997,0,9999,2
1713328268857,CLRE 253,B00,507202,Vaida; Florin,9999,0,9999,0
1713328269886,CLRE 259,A00,507211,Patel; Hemal,9996,0,9999,3
1713328270911,CLRE 260,A00,507221,Cuomo; Raphael Eduardo,9999,0,9999,0
1713328271939,CLRE 297,001,507242,Cuomo; Raphael Eduardo,9999,0,9999,0
1713328272965,CSE 191,A00,516875,Minnes Kemp; Mor Mia,9999,0,9999,0
1713328273996,CSS 201S,A01,494383,Staff,35,0,35,0
1713328275023,CSS 202S,A01,494387,Staff,35,0,35,0
1713328276052,EAP 100,A00,516065,Staff,9792,0,9999,207
1713328277084,ECE 45,A01,507414,Staff,51,0,60,9
1713328278111,ECE 100,A01,507416,Baghdadchi; Saharnaz,11,0,20,9
1713328278111,ECE 100,A02,507418,Baghdadchi; Saharnaz,20,0,20,0
1713328279136,ECE 111,A01,507420,Staff,39,0,50,11
1713328280162,ECE 197,001,548057,Sievenpiper; Daniel F.,9998,0,9999,1
1713328281194,EDS 115,A00,507243,Choi; Bailey Miyeon,28,0,28,0
1713328282221,EDS 117,A01,494379,Staff,23,0,25,2
1713328283251,EDS 125,A00,507246,Hopkins; Megan Beth,29,0,30,1
1713328284278,EDS 128A,A01,507264,Fargason; Sharon Gayle,26,0,26,0
1713328285305,EDS 128B,A01,507293,Pappas; Elizabeth,30,0,30,0
1713328286332,EDS 139,A00,507294,Fargason; Sharon Gayle,30,0,30,0
1713328286332,EDS 139,B00,507313,Pappas; Elizabeth,30,0,30,0
1713328287358,EDS 201,A00,507315,Staff,26,0,30,4
1713328288383,EDS 203,A01,507317,Halter; Christopher P.,26,0,30,4
1713328289410,EDS 204R,A01,507319,Halter; Christopher P.,3,0,30,27
1713328289410,EDS 204R,B01,507331,Heinzman; Erica M.,28,0,30,2
1713328290439,EDS 206R,A00,507332,Staff,4,0,30,26
1713328290439,EDS 206R,B00,507343,Staff,28,0,30,2
1713328291467,EDS 250,A00,507344,Hemans; Patricia Ann Benitez,36,0,40,4
1713328292494,EDS 281,A00,507345,Daly; Alan J.,18,0,18,0
1713328293517,EDS 284,A00,507350,Daly; Alan J.,16,0,16,0
1713328294543,EDS 286,A00,507359,Fine; Sarah,18,0,18,0
1713328295572,EDS 289C,A01,507361,Daly; Alan J.,18,0,18,0
1713328296600,EDS 290,A00,507366,Hofstetter; Carolyn,15,0,15,0
1713328297625,LIGM 5A,A00,507421,Fischer-Grunski; Eva K,20,0,20,0
1713328298654,LIGM 5B,A00,507423,Fischer-Grunski; Eva K,20,0,20,0
1713328299679,LIGM 5C,A00,507425,Fischer-Grunski; Eva K,20,0,20,0
1713328300706,LIIT 5AS,A00,507427,Carnelos; Chiara,20,0,20,0
1713328301730,LIIT 5BS,A00,507430,Carnelos; Chiara,20,0,20,0
1713328302760,LIIT 5CS,A00,507432,Carnelos; Chiara,20,0,20,0
1713328303787,LISP 5A,A00,507541,Munoz Sanchez; Alicia,17,0,20,3
1713328304813,LISP 5B,A00,507671,Munoz Sanchez; Alicia,15,0,20,5
1713328305837,LISP 5C,A00,507696,Munoz Sanchez; Alicia,15,0,20,5
1713328306866,MAE 197,001,528363,Boechler; Nicholas Sebastia,9998,0,9999,1
1713328307896,MATH 197,001,523477,Kedlaya; Kiran S.,9999,0,9999,0
1713328307896,MATH 197,002,563811,Zhang; Danna,9999,0,9999,0
1713328308925,MCWP 40R,A00,518780,Staff,20,0,20,0
1713328308925,MCWP 40R,B00,518781,Staff,19,0,20,1
1713328308925,MCWP 40R,C00,518783,Staff,19,0,20,1
1713328309950,MCWP 50R,A00,518791,Staff,20,0,20,0
1713328309950,MCWP 50R,B00,518792,Staff,17,0,20,3
1713328309950,MCWP 50R,C00,518793,Staff,19,0,20,1
1713328309950,MCWP 50R,D00,518794,Staff,16,0,20,4
1713328309950,MCWP 50R,E00,518795,Staff,16,0,20,4
1713328309950,MCWP 50R,F00,518796,Staff,19,0,20,1
1713328309950,MCWP 50R,G00,518797,Staff,19,0,20,1
1713328310976,MMW 12R,A01,514034,Herbst; Matthew,15,0,16,1
1713328310976,MMW 12R,A02,514035,Herbst; Matthew,16,0,16,0
1713328312005,MMW 13R,A01,514037,Staff,12,0,16,4
1713328312005,MMW 13R,A02,514039,Staff,16,0,16,0
1713328314068,SIO 295LS,A00,523233,Staff,19,0,30,11
1713328315096,SIO 295S,A00,523232,Staff,19,0,30,11
1713328316123,SOCI 117,A01,494376,Staff,2,0,5,3
1713328317155,WES 237B,A00,494380,Staff,19,0,20,1
1713328319236,AESE 279B,A00,494370,Wade; Jon P,33,0,33,0
1713328320266,ANAR 135S,A00,494369,Braswell; Geoffrey E.,0,0,0,0
1713328321297,CAT 124RS,A01,519847,Geibel; William,17,0,20,3
1713328322322,CAT 125RS,A01,515971,Geibel; William,17,0,20,3
1713328323346,CLRE 250,A00,511389,Morris; Sheldon,9996,0,9999,3
1713328324377,CLRE 251,A00,507176,Mehta; Ravindra L.,9996,0,9999,3
1713328324377,CLRE 251,B00,511410,Mehta; Ravindra L.,9998,0,9999,1
1713328325407,CLRE 252,A00,507189,Cuomo; Raphael Eduardo,9998,0,9999,1
1713328326433,CLRE 253,A00,507199,Vaida; Florin,9997,0,9999,2
1713328326433,CLRE 253,B00,507202,Vaida; Florin,9999,0,9999,0
1713328327463,CLRE 259,A00,507211,Patel; Hemal,9996,0,9999,3
1713328328489,CLRE 260,A00,507221,Cuomo; Raphael Eduardo,9999,0,9999,0
1713328329516,CLRE 297,001,507242,Cuomo; Raphael Eduardo,9999,0,9999,0
1713328330547,CSE 191,A00,516875,Minnes Kemp; Mor Mia,9999,0,9999,0
1713328331574,CSS 201S,A01,494383,Staff,35,0,35,0
1713328332605,CSS 202S,A01,494387,Staff,35,0,35,0
1713328333633,EAP 100,A00,516065,Staff,9792,0,9999,207
1713328334803,ECE 45,A01,507414,Staff,51,0,60,9
1713328335835,ECE 100,A01,507416,Baghdadchi; Saharnaz,11,0,20,9
1713328335835,ECE 100,A02,507418,Baghdadchi; Saharnaz,20,0,20,0
1713328336860,ECE 111,A01,507420,Staff,39,0,50,11
1713328337886,ECE 197,001,548057,Sievenpiper; Daniel F.,9998,0,9999,1
1713328338916,EDS 115,A00,507243,Choi; Bailey Miyeon,28,0,28,0
1713328339945,EDS 117,A01,494379,Staff,23,0,25,2
1713328340970,EDS 125,A00,507246,Hopkins; Megan Beth,29,0,30,1
1713328342065,EDS 128A,A01,507264,Fargason; Sharon Gayle,26,0,26,0
1713328343090,EDS 128B,A01,507293,Pappas; Elizabeth,30,0,30,0
1713328344116,EDS 139,A00,507294,Fargason; Sharon Gayle,30,0,30,0
1713328344116,EDS 139,B00,507313,Pappas; Elizabeth,30,0,30,0
1713328345143,EDS 201,A00,507315,Staff,26,0,30,4
1713328346176,EDS 203,A01,507317,Halter; Christopher P.,26,0,30,4
1713328347201,EDS 204R,A01,507319,Halter; Christopher P.,3,0,30,27
1713328347201,EDS 204R,B01,507331,Heinzman; Erica M.,28,0,30,2
1713328348282,EDS 206R,A00,507332,Staff,4,0,30,26
1713328348282,EDS 206R,B00,507343,Staff,28,0,30,2
1713328349309,EDS 250,A00,507344,Hemans; Patricia Ann Benitez,36,0,40,4
1713328350335,EDS 281,A00,507345,Daly; Alan J.,18,0,18,0
1713328351359,EDS 284,A00,507350,Daly; Alan J.,16,0,16,0
1713328352387,EDS 286,A00,507359,Fine; Sarah,18,0,18,0
1713328353411,EDS 289C,A01,507361,Daly; Alan J.,18,0,18,0
1713328354440,EDS 290,A00,507366,Hofstetter; Carolyn,15,0,15,0
1713328355467,LIGM 5A,A00,507421,Fischer-Grunski; Eva K,20,0,20,0
1713328356494,LIGM 5B,A00,507423,Fischer-Grunski; Eva K,20,0,20,0
1713328357518,LIGM 5C,A00,507425,Fischer-Grunski; Eva K,20,0,20,0
1713328358543,LIIT 5AS,A00,507427,Carnelos; Chiara,20,0,20,0
1713328359570,LIIT 5BS,A00,507430,Carnelos; Chiara,20,0,20,0
1713328360596,LIIT 5CS,A00,507432,Carnelos; Chiara,20,0,20,0
1713328361621,LISP 5A,A00,507541,Munoz Sanchez; Alicia,17,0,20,3
1713328362650,LISP 5B,A00,507671,Munoz Sanchez; Alicia,15,0,20,5
1713328363675,LISP 5C,A00,507696,Munoz Sanchez; Alicia,15,0,20,5
1713328364703,MAE 197,001,528363,Boechler; Nicholas Sebastia,9998,0,9999,1
1713328365729,MATH 197,001,523477,Kedlaya; Kiran S.,9999,0,9999,0
1713328365729,MATH 197,002,563811,Zhang; Danna,9999,0,9999,0
1713328366754,MCWP 40R,A00,518780,Staff,20,0,20,0
1713328366754,MCWP 40R,B00,518781,Staff,19,0,20,1
1713328366754,MCWP 40R,C00,518783,Staff,19,0,20,1
1713328367782,MCWP 50R,A00,518791,Staff,20,0,20,0
1713328367782,MCWP 50R,B00,518792,Staff,17,0,20,3
1713328367782,MCWP 50R,C00,518793,Staff,19,0,20,1
1713328367782,MCWP 50R,D00,518794,Staff,16,0,20,4
1713328367782,MCWP 50R,E00,518795,Staff,16,0,20,4
1713328367782,MCWP 50R,F00,518796,Staff,19,0,20,1
1713328367782,MCWP 50R,G00,518797,Staff,19,0,20,1
1713328368852,MMW 12R,A01,514034,Herbst; Matthew,15,0,16,1
1713328368852,MMW 12R,A02,514035,Herbst; Matthew,16,0,16,0
1713328369878,MMW 13R,A01,514037,Staff,12,0,16,4
1713328369878,MMW 13R,A02,514039,Staff,16,0,16,0
1713328371932,SIO 295LS,A00,523233,Staff,19,0,30,11
1713328372958,SIO 295S,A00,523232,Staff,19,0,30,11
1713328373988,SOCI 117,A01,494376,Staff,2,0,5,3
1713328375014,WES 237B,A00,494380,Staff,19,0,20,1
1713328377124,AESE 279B,A00,494370,Wade; Jon P,33,0,33,0
1713328378150,ANAR 135S,A00,494369,Braswell; Geoffrey E.,0,0,0,0
1713328379180,CAT 124RS,A01,519847,Geibel; William,17,0,20,3
1713328380208,CAT 125RS,A01,515971,Geibel; William,17,0,20,3
1713328381234,CLRE 250,A00,511389,Morris; Sheldon,9996,0,9999,3
1713328382261,CLRE 251,A00,507176,Mehta; Ravindra L.,9996,0,9999,3
1713328382261,CLRE 251,B00,511410,Mehta; Ravindra L.,9998,0,9999,1
1713328383293,CLRE 252,A00,507189,Cuomo; Raphael Eduardo,9998,0,9999,1
1713328384323,CLRE 253,A00,507199,Vaida; Florin,9997,0,9999,2
1713328384323,CLRE 253,B00,507202,Vaida; Florin,9999,0,9999,0
1713328385350,CLRE 259,A00,507211,Patel; Hemal,9996,0,9999,3
1713328386375,CLRE 260,A00,507221,Cuomo; Raphael Eduardo,9999,0,9999,0
1713328387399,CLRE 297,001,507242,Cuomo; Raphael Eduardo,9999,0,9999,0
1713328388426,CSE 191,A00,516875,Minnes Kemp; Mor Mia,9999,0,9999,0
1713328389451,CSS 201S,A01,494383,Staff,35,0,35,0
1713328390479,CSS 202S,A01,494387,Staff,35,0,35,0
1713328391503,EAP 100,A00,516065,Staff,9792,0,9999,207
1713328392530,ECE 45,A01,507414,Staff,51,0,60,9
1713328393555,ECE 100,A01,507416,Baghdadchi; Saharnaz,10,0,20,10
1713328393555,ECE 100,A02,507418,Baghdadchi; Saharnaz,20,0,20,0
1713328394581,ECE 111,A01,507420,Staff,38,0,50,12
1713328395612,ECE 197,001,548057,Sievenpiper; Daniel F.,9998,0,9999,1
1713328396638,EDS 115,A00,507243,Choi; Bailey Miyeon,28,0,28,0
1713328397668,EDS 117,A01,494379,Staff,23,0,25,2
1713328398693,EDS 125,A00,507246,Hopkins; Megan Beth,29,0,30,1
1713328399720,EDS 128A,A01,507264,Fargason; Sharon Gayle,26,0,26,0
1713328400745,EDS 128B,A01,507293,Pappas; Elizabeth,30,0,30,0
1713328401770,EDS 139,A00,507294,Fargason; Sharon Gayle,30,0,30,0
1713328401770,EDS 139,B00,507313,Pappas; Elizabeth,30,0,30,0
1713328402794,EDS 201,A00,507315,Staff,26,0,30,4
1713328403821,EDS 203,A01,507317,Halter; Christopher P.,26,0,30,4
1713328404847,EDS 204R,A01,507319,Halter; Christopher P.,3,0,30,27
1713328404847,EDS 204R,B01,507331,Heinzman; Erica M.,28,0,30,2
1713328405876,EDS 206R,A00,507332,Staff,4,0,30,26
1713328405876,EDS 206R,B00,507343,Staff,28,0,30,2
1713328406906,EDS 250,A00,507344,Hemans; Patricia Ann Benitez,36,0,40,4
1713328407934,EDS 281,A00,507345,Daly; Alan J.,18,0,18,0
1713328408958,EDS 284,A00,507350,Daly; Alan J.,16,0,16,0
1713328410105,EDS 286,A00,507359,Fine; Sarah,18,0,18,0
1713328411133,EDS 289C,A01,507361,Daly; Alan J.,18,0,18,0
1713328412163,EDS 290,A00,507366,Hofstetter; Carolyn,15,0,15,0
1713328413192,LIGM 5A,A00,507421,Fischer-Grunski; Eva K,20,0,20,0
1713328414222,LIGM 5B,A00,507423,Fischer-Grunski; Eva K,20,0,20,0
1713328415251,LIGM 5C,A00,507425,Fischer-Grunski; Eva K,20,0,20,0
1713328416281,LIIT 5AS,A00,507427,Carnelos; Chiara,20,0,20,0
1713328417307,LIIT 5BS,A00,507430,Carnelos; Chiara,20,0,20,0
1713328418334,LIIT 5CS,A00,507432,Carnelos; Chiara,20,0,20,0
1713328419364,LISP 5A,A00,507541,Munoz Sanchez; Alicia,17,0,20,3
1713328420393,LISP 5B,A00,507671,Munoz Sanchez; Alicia,15,0,20,5
1713328421418,LISP 5C,A00,507696,Munoz Sanchez; Alicia,15,0,20,5
1713328422443,MAE 197,001,528363,Boechler; Nicholas Sebastia,9998,0,9999,1
1713328423478,MATH 197,001,523477,Kedlaya; Kiran S.,9999,0,9999,0
1713328423478,MATH 197,002,563811,Zhang; Danna,9999,0,9999,0
1713328424509,MCWP 40R,A00,518780,Staff,20,0,20,0
1713328424509,MCWP 40R,B00,518781,Staff,19,0,20,1
1713328424509,MCWP 40R,C00,518783,Staff,19,0,20,1
1713328425536,MCWP 50R,A00,518791,Staff,20,0,20,0
1713328425536,MCWP 50R,B00,518792,Staff,17,0,20,3
1713328425536,MCWP 50R,C00,518793,Staff,19,0,20,1
1713328425536,MCWP 50R,D00,518794,Staff,16,0,20,4
1713328425536,MCWP 50R,E00,518795,Staff,16,0,20,4
1713328425536,MCWP 50R,F00,518796,Staff,19,0,20,1
1713328425536,MCWP 50R,G00,518797,Staff,19,0,20,1
1713328426562,MMW 12R,A01,514034,Herbst; Matthew,15,0,16,1
1713328426562,MMW 12R,A02,514035,Herbst; Matthew,16,0,16,0
1713328427590,MMW 13R,A01,514037,Staff,12,0,16,4
1713328427590,MMW 13R,A02,514039,Staff,16,0,16,0
1713328429640,SIO 295LS,A00,523233,Staff,19,0,30,11
1713328430666,SIO 295S,A00,523232,Staff,19,0,30,11
1713328431694,SOCI 117,A01,494376,Staff,2,0,5,3
1713328432723,WES 237B,A00,494380,Staff,19,0,20,1
1713328434798,AESE 279B,A00,494370,Wade; Jon P,33,0,33,0
1713328435824,ANAR 135S,A00,494369,Braswell; Geoffrey E.,0,0,0,0
1713328436854,CAT 124RS,A01,519847,Geibel; William,17,0,20,3
1713328437882,CAT 125RS,A01,515971,Geibel; William,17,0,20,3
1713328438912,CLRE 250,A00,511389,Morris; Sheldon,9996,0,9999,3
1713328439940,CLRE 251,A00,507176,Mehta; Ravindra L.,9996,0,9999,3
1713328439940,CLRE 251,B00,511410,Mehta; Ravindra L.,9998,0,9999,1
1713328440968,CLRE 252,A00,507189,Cuomo; Raphael Eduardo,9998,0,9999,1
1713328441998,CLRE 253,A00,507199,Vaida; Florin,9997,0,9999,2
1713328441998,CLRE 253,B00,507202,Vaida; Florin,9999,0,9999,0
1713328443023,CLRE 259,A00,507211,Patel; Hemal,9996,0,9999,3
1713328444051,CLRE 260,A00,507221,Cuomo; Raphael Eduardo,9999,0,9999,0
1713328445078,CLRE 297,001,507242,Cuomo; Raphael Eduardo,9999,0,9999,0
1713328446106,CSE 191,A00,516875,Minnes Kemp; Mor Mia,9999,0,9999,0
1713328447131,CSS 201S,A01,494383,Staff,35,0,35,0
1713328448159,CSS 202S,A01,494387,Staff,35,0,35,0
1713328449184,EAP 100,A00,516065,Staff,9792,0,9999,207
1713328450211,ECE 45,A01,507414,Staff,51,0,60,9
1713328451237,ECE 100,A01,507416,Baghdadchi; Saharnaz,10,0,20,10
1713328451237,ECE 100,A02,507418,Baghdadchi; Saharnaz,20,0,20,0
1713328452321,ECE 111,A01,507420,Staff,38,0,50,12
1713328453347,ECE 197,001,548057,Sievenpiper; Daniel F.,9998,0,9999,1
1713328454376,EDS 115,A00,507243,Choi; Bailey Miyeon,28,0,28,0
1713328455401,EDS 117,A01,494379,Staff,23,0,25,2
1713328456424,EDS 125,A00,507246,Hopkins; Megan Beth,29,0,30,1
1713328457450,EDS 128A,A01,507264,Fargason; Sharon Gayle,26,0,26,0
1713328458475,EDS 128B,A01,507293,Pappas; Elizabeth,30,0,30,0
1713328459501,EDS 139,A00,507294,Fargason; Sharon Gayle,30,0,30,0
1713328459501,EDS 139,B00,507313,Pappas; Elizabeth,30,0,30,0
1713328460526,EDS 201,A00,507315,Staff,26,0,30,4
1713328461552,EDS 203,A01,507317,Halter; Christopher P.,26,0,30,4
1713328462582,EDS 204R,A01,507319,Halter; Christopher P.,3,0,30,27
1713328462582,EDS 204R,B01,507331,Heinzman; Erica M.,28,0,30,2
1713328463607,EDS 206R,A00,507332,Staff,4,0,30,26
1713328463607,EDS 206R,B00,507343,Staff,28,0,30,2
1713328464633,EDS 250,A00,507344,Hemans; Patricia Ann Benitez,36,0,40,4
1713328465659,EDS 281,A00,507345,Daly; Alan J.,18,0,18,0
1713328466684,EDS 284,A00,507350,Daly; Alan J.,16,0,16,0
1713328467709,EDS 286,A00,507359,Fine; Sarah,18,0,18,0
1713328468733,EDS 289C,A01,507361,Daly; Alan J.,18,0,18,0
1713328469759,EDS 290,A00,507366,Hofstetter; Carolyn,15,0,15,0
1713328470798,LIGM 5A,A00,507421,Fischer-Grunski; Eva K,20,0,20,0
1713328471842,LIGM 5B,A00,507423,Fischer-Grunski; Eva K,20,0,20,0
1713328472868,LIGM 5C,A00,507425,Fischer-Grunski; Eva K,20,0,20,0
1713328473893,LIIT 5AS,A00,507427,Carnelos; Chiara,20,0,20,0
1713328474922,LIIT 5BS,A00,507430,Carnelos; Chiara,20,0,20,0
1713328475951,LIIT 5CS,A00,507432,Carnelos; Chiara,20,0,20,0
1713328476982,LISP 5A,A00,507541,Munoz Sanchez; Alicia,17,0,20,3
1713328478008,LISP 5B,A00,507671,Munoz Sanchez; Alicia,15,0,20,5
1713328479039,LISP 5C,A00,507696,Munoz Sanchez; Alicia,15,0,20,5
1713328480065,MAE 197,001,528363,Boechler; Nicholas Sebastia,9998,0,9999,1
1713328481093,MATH 197,001,523477,Kedlaya; Kiran S.,9999,0,9999,0
1713328481093,MATH 197,002,563811,Zhang; Danna,9999,0,9999,0
1713328482118,MCWP 40R,A00,518780,Staff,20,0,20,0
1713328482118,MCWP 40R,B00,518781,Staff,19,0,20,1
1713328482118,MCWP 40R,C00,518783,Staff,19,0,20,1
1713328483144,MCWP 50R,A00,518791,Staff,20,0,20,0
1713328483144,MCWP 50R,B00,518792,Staff,17,0,20,3
1713328483144,MCWP 50R,C00,518793,Staff,19,0,20,1
1713328483144,MCWP 50R,D00,518794,Staff,16,0,20,4
1713328483144,MCWP 50R,E00,518795,Staff,16,0,20,4
1713328483144,MCWP 50R,F00,518796,Staff,19,0,20,1
1713328483144,MCWP 50R,G00,518797,Staff,19,0,20,1
1713328484174,MMW 12R,A01,514034,Herbst; Matthew,15,0,16,1
1713328484174,MMW 12R,A02,514035,Herbst; Matthew,16,0,16,0
1713328485198,MMW 13R,A01,514037,Staff,12,0,16,4
1713328485198,MMW 13R,A02,514039,Staff,16,0,16,0
1713328487255,SIO 295LS,A00,523233,Staff,19,0,30,11
1713328488279,SIO 295S,A00,523232,Staff,19,0,30,11
1713328489306,SOCI 117,A01,494376,Staff,2,0,5,3
1713328490332,WES 237B,A00,494380,Staff,19,0,20,1
1713328492402,AESE 279B,A00,494370,Wade; Jon P,33,0,33,0
1713328493430,ANAR 135S,A00,494369,Braswell; Geoffrey E.,0,0,0,0
1713328494460,CAT 124RS,A01,519847,Geibel; William,17,0,20,3
1713328495489,CAT 125RS,A01,515971,Geibel; William,17,0,20,3
1713328496516,CLRE 250,A00,511389,Morris; Sheldon,9996,0,9999,3
1713328497546,CLRE 251,A00,507176,Mehta; Ravindra L.,9996,0,9999,3
1713328497546,CLRE 251,B00,511410,Mehta; Ravindra L.,9998,0,9999,1
1713328498575,CLRE 252,A00,507189,Cuomo; Raphael Eduardo,9998,0,9999,1
1713328499605,CLRE 253,A00,507199,Vaida; Florin,9997,0,9999,2
1713328499605,CLRE 253,B00,507202,Vaida; Florin,9999,0,9999,0
1713328500633,CLRE 259,A00,507211,Patel; Hemal,9996,0,9999,3
1713328501662,CLRE 260,A00,507221,Cuomo; Raphael Eduardo,9999,0,9999,0
1713328502691,CLRE 297,001,507242,Cuomo; Raphael Eduardo,9999,0,9999,0
1713328503717,CSE 191,A00,516875,Minnes Kemp; Mor Mia,9999,0,9999,0
1713328504747,CSS 201S,A01,494383,Staff,35,0,35,0
1713328505776,CSS 202S,A01,494387,Staff,35,0,35,0
1713328506801,EAP 100,A00,516065,Staff,9792,0,9999,207
1713328507827,ECE 45,A01,507414,Staff,51,0,60,9
1713328508853,ECE 100,A01,507416,Baghdadchi; Saharnaz,10,0,20,10
1713328508853,ECE 100,A02,507418,Baghdadchi; Saharnaz,20,0,20,0
1713328509876,ECE 111,A01,507420,Staff,38,0,50,12
1713328510903,ECE 197,001,548057,Sievenpiper; Daniel F.,9998,0,9999,1
1713328511929,EDS 115,A00,507243,Choi; Bailey Miyeon,28,0,28,0
1713328512956,EDS 117,A01,494379,Staff,23,0,25,2
1713328513983,EDS 125,A00,507246,Hopkins; Megan Beth,29,0,30,1
1713328515010,EDS 128A,A01,507264,Fargason; Sharon Gayle,26,0,26,0
1713328516036,EDS 128B,A01,507293,Pappas; Elizabeth,30,0,30,0
1713328517061,EDS 139,A00,507294,Fargason; Sharon Gayle,30,0,30,0
1713328517061,EDS 139,B00,507313,Pappas; Elizabeth,30,0,30,0
1713328518090,EDS 201,A00,507315,Staff,26,0,30,4
1713328519119,EDS 203,A01,507317,Halter; Christopher P.,26,0,30,4
1713328520148,EDS 204R,A01,507319,Halter; Christopher P.,3,0,30,27
1713328520148,EDS 204R,B01,507331,Heinzman; Erica M.,28,0,30,2
1713328521173,EDS 206R,A00,507332,Staff,4,0,30,26
1713328521173,EDS 206R,B00,507343,Staff,28,0,30,2
1713328522200,EDS 250,A00,507344,Hemans; Patricia Ann Benitez,36,0,40,4
1713328523228,EDS 281,A00,507345,Daly; Alan J.,18,0,18,0
1713328524252,EDS 284,A00,507350,Daly; Alan J.,16,0,16,0
1713328525276,EDS 286,A00,507359,Fine; Sarah,18,0,18,0
1713328526302,EDS 289C,A01,507361,Daly; Alan J.,18,0,18,0
1713328527329,EDS 290,A00,507366,Hofstetter; Carolyn,15,0,15,0
1713328528355,LIGM 5A,A00,507421,Fischer-Grunski; Eva K,20,0,20,0
1713328529384,LIGM 5B,A00,507423,Fischer-Grunski; Eva K,20,0,20,0
1713328530413,LIGM 5C,A00,507425,Fischer-Grunski; Eva K,20,0,20,0
1713328531442,LIIT 5AS,A00,507427,Carnelos; Chiara,20,0,20,0
1713328532470,LIIT 5BS,A00,507430,Carnelos; Chiara,20,0,20,0
1713328533499,LIIT 5CS,A00,507432,Carnelos; Chiara,20,0,20,0
1713328534530,LISP 5A,A00,507541,Munoz Sanchez; Alicia,17,0,20,3
1713328535557,LISP 5B,A00,507671,Munoz Sanchez; Alicia,15,0,20,5
1713328536583,LISP 5C,A00,507696,Munoz Sanchez; Alicia,15,0,20,5
1713328537612,MAE 197,001,528363,Boechler; Nicholas Sebastia,9998,0,9999,1
1713328538640,MATH 197,001,523477,Kedlaya; Kiran S.,9999,0,9999,0
1713328538640,MATH 197,002,563811,Zhang; Danna,9999,0,9999,0
1713328539664,MCWP 40R,A00,518780,Staff,20,0,20,0
1713328539664,MCWP 40R,B00,518781,Staff,19,0,20,1
1713328539664,MCWP 40R,C00,518783,Staff,19,0,20,1
1713328540690,MCWP 50R,A00,518791,Staff,20,0,20,0
1713328540690,MCWP 50R,B00,518792,Staff,17,0,20,3
1713328540690,MCWP 50R,C00,518793,Staff,19,0,20,1
1713328540690,MCWP 50R,D00,518794,Staff,16,0,20,4
1713328540690,MCWP 50R,E00,518795,Staff,16,0,20,4
1713328540690,MCWP 50R,F00,518796,Staff,19,0,20,1
1713328540690,MCWP 50R,G00,518797,Staff,19,0,20,1
1713328541717,MMW 12R,A01,514034,Herbst; Matthew,15,0,16,1
1713328541717,MMW 12R,A02,514035,Herbst; Matthew,16,0,16,0
1713328542745,MMW 13R,A01,514037,Staff,12,0,16,4
1713328542745,MMW 13R,A02,514039,Staff,16,0,16,0
1713328544806,SIO 295LS,A00,523233,Staff,19,0,30,11
1713328545831,SIO 295S,A00,523232,Staff,19,0,30,11
1713328546861,SOCI 117,A01,494376,Staff,2,0,5,3
1713328547887,WES 237B,A00,494380,Staff,19,0,20,1
1713328549953,AESE 279B,A00,494370,Wade; Jon P,33,0,33,0
1713328550981,ANAR 135S,A00,494369,Braswell; Geoffrey E.,0,0,0,0
1713328552010,CAT 124RS,A01,519847,Geibel; William,17,0,20,3
1713328553036,CAT 125RS,A01,515971,Geibel; William,17,0,20,3
1713328554063,CLRE 250,A00,511389,Morris; Sheldon,9996,0,9999,3
1713328555093,CLRE 251,A00,507176,Mehta; Ravindra L.,9996,0,9999,3
1713328555093,CLRE 251,B00,511410,Mehta; Ravindra L.,9998,0,9999,1
1713328556173,CLRE 252,A00,507189,Cuomo; Raphael Eduardo,9998,0,9999,1
1713328557199,CLRE 253,A00,507199,Vaida; Florin,9997,0,9999,2
1713328557199,CLRE 253,B00,507202,Vaida; Florin,9999,0,9999,0
1713328558224,CLRE 259,A00,507211,Patel; Hemal,9996,0,9999,3
1713328559250,CLRE 260,A00,507221,Cuomo; Raphael Eduardo,9999,0,9999,0
1713328560276,CLRE 297,001,507242,Cuomo; Raphael Eduardo,9999,0,9999,0
1713328561305,CSE 191,A00,516875,Minnes Kemp; Mor Mia,9999,0,9999,0
1713328562335,CSS 201S,A01,494383,Staff,35,0,35,0
1713328563366,CSS 202S,A01,494387,Staff,35,0,35,0
1713328564394,EAP 100,A00,516065,Staff,9792,0,9999,207
1713328565422,ECE 45,A01,507414,Staff,51,0,60,9
1713328566453,ECE 100,A01,507416,Baghdadchi; Saharnaz,10,0,20,10
1713328566453,ECE 100,A02,507418,Baghdadchi; Saharnaz,20,0,20,0
1713328567478,ECE 111,A01,507420,Staff,38,0,50,12
1713328568504,ECE 197,001,548057,Sievenpiper; Daniel F.,9998,0,9999,1
1713328569530,EDS 115,A00,507243,Choi; Bailey Miyeon,28,0,28,0
1713328570556,EDS 117,A01,494379,Staff,23,0,25,2
1713328571585,EDS 125,A00,507246,Hopkins; Megan Beth,29,0,30,1
1713328572611,EDS 128A,A01,507264,Fargason; Sharon Gayle,26,0,26,0
1713328573642,EDS 128B,A01,507293,Pappas; Elizabeth,30,0,30,0
1713328574667,EDS 139,A00,507294,Fargason; Sharon Gayle,30,0,30,0
1713328574667,EDS 139,B00,507313,Pappas; Elizabeth,30,0,30,0
1713328575691,EDS 201,A00,507315,Staff,26,0,30,4
1713328576718,EDS 203,A01,507317,Halter; Christopher P.,26,0,30,4
1713328577744,EDS 204R,A01,507319,Halter; Christopher P.,3,0,30,27
1713328577744,EDS 204R,B01,507331,Heinzman; Erica M.,28,0,30,2
1713328578775,EDS 206R,A00,507332,Staff,4,0,30,26
1713328578775,EDS 206R,B00,507343,Staff,28,0,30,2
1713328579801,EDS 250,A00,507344,Hemans; Patricia Ann Benitez,36,0,40,4
1713328580826,EDS 281,A00,507345,Daly; Alan J.,18,0,18,0
1713328581854,EDS 284,A00,507350,Daly; Alan J.,16,0,16,0
1713328582878,EDS 286,A00,507359,Fine; Sarah,18,0,18,0
1713328583904,EDS 289C,A01,507361,Daly; Alan J.,18,0,18,0
1713328584931,EDS 290,A00,507366,Hofstetter; Carolyn,15,0,15,0
1713328585956,LIGM 5A,A00,507421,Fischer-Grunski; Eva K,20,0,20,0
1713328586981,LIGM 5B,A00,507423,Fischer-Grunski; Eva K,20,0,20,0
1713328588005,LIGM 5C,A00,507425,Fischer-Grunski; Eva K,20,0,20,0
1713328589031,LIIT 5AS,A00,507427,Carnelos; Chiara,20,0,20,0
1713328590062,LIIT 5BS,A00,507430,Carnelos; Chiara,20,0,20,0
1713328591088,LIIT 5CS,A00,507432,Carnelos; Chiara,20,0,20,0
1713328592119,LISP 5A,A00,507541,Munoz Sanchez; Alicia,17,0,20,3
1713328593144,LISP 5B,A00,507671,Munoz Sanchez; Alicia,15,0,20,5
1713328594171,LISP 5C,A00,507696,Munoz Sanchez; Alicia,15,0,20,5
1713328595196,MAE 197,001,528363,Boechler; Nicholas Sebastia,9998,0,9999,1
1713328596228,MATH 197,001,523477,Kedlaya; Kiran S.,9999,0,9999,0
1713328596228,MATH 197,002,563811,Zhang; Danna,9999,0,9999,0
1713328597254,MCWP 40R,A00,518780,Staff,20,0,20,0
1713328597254,MCWP 40R,B00,518781,Staff,19,0,20,1
1713328597254,MCWP 40R,C00,518783,Staff,19,0,20,1
1713328598281,MCWP 50R,A00,518791,Staff,20,0,20,0
1713328598281,MCWP 50R,B00,518792,Staff,17,0,20,3
1713328598281,MCWP 50R,C00,518793,Staff,19,0,20,1
1713328598281,MCWP 50R,D00,518794,Staff,16,0,20,4
1713328598281,MCWP 50R,E00,518795,Staff,16,0,20,4
1713328598281,MCWP 50R,F00,518796,Staff,19,0,20,1
1713328598281,MCWP 50R,G00,518797,Staff,19,0,20,1
1713328599305,MMW 12R,A01,514034,Herbst; Matthew,15,0,16,1
1713328599305,MMW 12R,A02,514035,Herbst; Matthew,16,0,16,0
1713328600330,MMW 13R,A01,514037,Staff,12,0,16,4
1713328600330,MMW 13R,A02,514039,Staff,16,0,16,0
1713328602381,SIO 295LS,A00,523233,Staff,19,0,30,11
1713328603409,SIO 295S,A00,523232,Staff,19,0,30,11
1713328604441,SOCI 117,A01,494376,Staff,2,0,5,3
1713328605466,WES 237B,A00,494380,Staff,19,0,20,1
1713328607532,AESE 279B,A00,494370,Wade; Jon P,33,0,33,0
1713328608558,ANAR 135S,A00,494369,Braswell; Geoffrey E.,0,0,0,0
1713328609584,CAT 124RS,A01,519847,Geibel; William,17,0,20,3
1713328610614,CAT 125RS,A01,515971,Geibel; William,17,0,20,3
1713328611646,CLRE 250,A00,511389,Morris; Sheldon,9996,0,9999,3
1713328612673,CLRE 251,A00,507176,Mehta; Ravindra L.,9996,0,9999,3
1713328612673,CLRE 251,B00,511410,Mehta; Ravindra L.,9998,0,9999,1
1713328613698,CLRE 252,A00,507189,Cuomo; Raphael Eduardo,9998,0,9999,1
1713328614724,CLRE 253,A00,507199,Vaida; Florin,9997,0,9999,2
1713328614724,CLRE 253,B00,507202,Vaida; Florin,9999,0,9999,0
1713328615754,CLRE 259,A00,507211,Patel; Hemal,9996,0,9999,3
1713328616778,CLRE 260,A00,507221,Cuomo; Raphael Eduardo,9999,0,9999,0
1713328617810,CLRE 297,001,507242,Cuomo; Raphael Eduardo,9999,0,9999,0
1713328618836,CSE 191,A00,516875,Minnes Kemp; Mor Mia,9999,0,9999,0
1713328619867,CSS 201S,A01,494383,Staff,35,0,35,0
1713328620894,CSS 202S,A01,494387,Staff,35,0,35,0
1713328621920,EAP 100,A00,516065,Staff,9792,0,9999,207
1713328622946,ECE 45,A01,507414,Staff,51,0,60,9
1713328623977,ECE 100,A01,507416,Baghdadchi; Saharnaz,10,0,20,10
1713328623977,ECE 100,A02,507418,Baghdadchi; Saharnaz,20,0,20,0
1713328625006,ECE 111,A01,507420,Staff,38,0,50,12
1713328626035,ECE 197,001,548057,Sievenpiper; Daniel F.,9998,0,9999,1
1713328627062,EDS 115,A00,507243,Choi; Bailey Miyeon,28,0,28,0
1713328628088,EDS 117,A01,494379,Staff,23,0,25,2
1713328629124,EDS 125,A00,507246,Hopkins; Megan Beth,29,0,30,1
1713328630150,EDS 128A,A01,507264,Fargason; Sharon Gayle,26,0,26,0
1713328631175,EDS 128B,A01,507293,Pappas; Elizabeth,30,0,30,0
1713328632204,EDS 139,A00,507294,Fargason; Sharon Gayle,30,0,30,0
1713328632204,EDS 139,B00,507313,Pappas; Elizabeth,30,0,30,0
1713328633230,EDS 201,A00,507315,Staff,26,0,30,4
1713328634255,EDS 203,A01,507317,Halter; Christopher P.,26,0,30,4
1713328635279,EDS 204R,A01,507319,Halter; Christopher P.,3,0,30,27
1713328635279,EDS 204R,B01,507331,Heinzman; Erica M.,28,0,30,2
1713328636309,EDS 206R,A00,507332,Staff,4,0,30,26
1713328636309,EDS 206R,B00,507343,Staff,28,0,30,2
1713328637339,EDS 250,A00,507344,Hemans; Patricia Ann Benitez,36,0,40,4
1713328638368,EDS 281,A00,507345,Daly; Alan J.,18,0,18,0
1713328639397,EDS 284,A00,507350,Daly; Alan J.,16,0,16,0
1713328640430,EDS 286,A00,507359,Fine; Sarah,18,0,18,0
1713328641457,EDS 289C,A01,507361,Daly; Alan J.,18,0,18,0
1713328642483,EDS 290,A00,507366,Hofstetter; Carolyn,15,0,15,0
1713328643510,LIGM 5A,A00,507421,Fischer-Grunski; Eva K,20,0,20,0
1713328644535,LIGM 5B,A00,507423,Fischer-Grunski; Eva K,20,0,20,0
1713328645565,LIGM 5C,A00,507425,Fischer-Grunski; Eva K,20,0,20,0
1713328646590,LIIT 5AS,A00,507427,Carnelos; Chiara,20,0,20,0
1713328647616,LIIT 5BS,A00,507430,Carnelos; Chiara,20,0,20,0
1713328648641,LIIT 5CS,A00,507432,Carnelos; Chiara,20,0,20,0
1713328649672,LISP 5A,A00,507541,Munoz Sanchez; Alicia,17,0,20,3
1713328650698,LISP 5B,A00,507671,Munoz Sanchez; Alicia,15,0,20,5
1713328651724,LISP 5C,A00,507696,Munoz Sanchez; Alicia,15,0,20,5
1713328652749,MAE 197,001,528363,Boechler; Nicholas Sebastia,9998,0,9999,1
1713328653780,MATH 197,001,523477,Kedlaya; Kiran S.,9999,0,9999,0
1713328653780,MATH 197,002,563811,Zhang; Danna,9999,0,9999,0
1713328654809,MCWP 40R,A00,518780,Staff,20,0,20,0
1713328654809,MCWP 40R,B00,518781,Staff,19,0,20,1
1713328654809,MCWP 40R,C00,518783,Staff,19,0,20,1
1713328655837,MCWP 50R,A00,518791,Staff,20,0,20,0
1713328655837,MCWP 50R,B00,518792,Staff,17,0,20,3
1713328655837,MCWP 50R,C00,518793,Staff,19,0,20,1
1713328655837,MCWP 50R,D00,518794,Staff,16,0,20,4
1713328655837,MCWP 50R,E00,518795,Staff,16,0,20,4
1713328655837,MCWP 50R,F00,518796,Staff,19,0,20,1
1713328655837,MCWP 50R,G00,518797,Staff,19,0,20,1
1713328656863,MMW 12R,A01,514034,Herbst; Matthew,15,0,16,1
1713328656863,MMW 12R,A02,514035,Herbst; Matthew,16,0,16,0
1713328657887,MMW 13R,A01,514037,Staff,12,0,16,4
1713328657887,MMW 13R,A02,514039,Staff,16,0,16,0
1713328659993,SIO 295LS,A00,523233,Staff,19,0,30,11
1713328661022,SIO 295S,A00,523232,Staff,19,0,30,11
1713328662053,SOCI 117,A01,494376,Staff,2,0,5,3
1713328663082,WES 237B,A00,494380,Staff,19,0,20,1
1713328665165,AESE 279B,A00,494370,Wade; Jon P,33,0,33,0
1713328666194,ANAR 135S,A00,494369,Braswell; Geoffrey E.,0,0,0,0
1713328667221,CAT 124RS,A01,519847,Geibel; William,17,0,20,3
1713328668249,CAT 125RS,A01,515971,Geibel; William,17,0,20,3
1713328669276,CLRE 250,A00,511389,Morris; Sheldon,9996,0,9999,3
1713328670307,CLRE 251,A00,507176,Mehta; Ravindra L.,9996,0,9999,3
1713328670307,CLRE 251,B00,511410,Mehta; Ravindra L.,9998,0,9999,1
1713328671332,CLRE 252,A00,507189,Cuomo; Raphael Eduardo,9998,0,9999,1
1713328672361,CLRE 253,A00,507199,Vaida; Florin,9997,0,9999,2
1713328672361,CLRE 253,B00,507202,Vaida; Florin,9999,0,9999,0
1713328673389,CLRE 259,A00,507211,Patel; Hemal,9996,0,9999,3
1713328674414,CLRE 260,A00,507221,Cuomo; Raphael Eduardo,9999,0,9999,0
1713328675443,CLRE 297,001,507242,Cuomo; Raphael Eduardo,9999,0,9999,0
1713328676470,CSE 191,A00,516875,Minnes Kemp; Mor Mia,9999,0,9999,0
1713328677498,CSS 201S,A01,494383,Staff,35,0,35,0
1713328678528,CSS 202S,A01,494387,Staff,35,0,35,0
1713328679553,EAP 100,A00,516065,Staff,9792,0,9999,207
1713328680583,ECE 45,A01,507414,Staff,51,0,60,9
1713328681608,ECE 100,A01,507416,Baghdadchi; Saharnaz,10,0,20,10
1713328681608,ECE 100,A02,507418,Baghdadchi; Saharnaz,20,0,20,0
1713328682634,ECE 111,A01,507420,Staff,38,0,50,12
1713328683660,ECE 197,001,548057,Sievenpiper; Daniel F.,9998,0,9999,1
1713328684691,EDS 115,A00,507243,Choi; Bailey Miyeon,28,0,28,0
1713328685718,EDS 117,A01,494379,Staff,23,0,25,2
1713328686744,EDS 125,A00,507246,Hopkins; Megan Beth,29,0,30,1
1713328687774,EDS 128A,A01,507264,Fargason; Sharon Gayle,26,0,26,0
1713328688799,EDS 128B,A01,507293,Pappas; Elizabeth,30,0,30,0
1713328689824,EDS 139,A00,507294,Fargason; Sharon Gayle,30,0,30,0
1713328689824,EDS 139,B00,507313,Pappas; Elizabeth,30,0,30,0
1713328690848,EDS 201,A00,507315,Staff,26,0,30,4
1713328691874,EDS 203,A01,507317,Halter; Christopher P.,26,0,30,4
1713328692903,EDS 204R,A01,507319,Halter; Christopher P.,3,0,30,27
1713328692903,EDS 204R,B01,507331,Heinzman; Erica M.,28,0,30,2
1713328693927,EDS 206R,A00,507332,Staff,4,0,30,26
1713328693927,EDS 206R,B00,507343,Staff,28,0,30,2
1713328694953,EDS 250,A00,507344,Hemans; Patricia Ann Benitez,36,0,40,4
1713328695978,EDS 281,A00,507345,Daly; Alan J.,18,0,18,0
1713328697003,EDS 284,A00,507350,Daly; Alan J.,16,0,16,0
1713328698032,EDS 286,A00,507359,Fine; Sarah,18,0,18,0
1713328699058,EDS 289C,A01,507361,Daly; Alan J.,18,0,18,0
1713328700086,EDS 290,A00,507366,Hofstetter; Carolyn,15,0,15,0
1713328701174,LIGM 5A,A00,507421,Fischer-Grunski; Eva K,20,0,20,0
1713328702203,LIGM 5B,A00,507423,Fischer-Grunski; Eva K,20,0,20,0
1713328703315,LIGM 5C,A00,507425,Fischer-Grunski; Eva K,20,0,20,0
1713328704339,LIIT 5AS,A00,507427,Carnelos; Chiara,20,0,20,0
1713328705371,LIIT 5BS,A00,507430,Carnelos; Chiara,20,0,20,0
1713328706396,LIIT 5CS,A00,507432,Carnelos; Chiara,20,0,20,0
1713328707429,LISP 5A,A00,507541,Munoz Sanchez; Alicia,17,0,20,3
1713328708458,LISP 5B,A00,507671,Munoz Sanchez; Alicia,15,0,20,5
1713328709482,LISP 5C,A00,507696,Munoz Sanchez; Alicia,15,0,20,5
1713328710512,MAE 197,001,528363,Boechler; Nicholas Sebastia,9998,0,9999,1
1713328711539,MATH 197,001,523477,Kedlaya; Kiran S.,9999,0,9999,0
1713328711539,MATH 197,002,563811,Zhang; Danna,9999,0,9999,0
1713328712564,MCWP 40R,A00,518780,Staff,20,0,20,0
1713328712564,MCWP 40R,B00,518781,Staff,19,0,20,1
1713328712564,MCWP 40R,C00,518783,Staff,19,0,20,1
1713328713588,MCWP 50R,A00,518791,Staff,20,0,20,0
1713328713588,MCWP 50R,B00,518792,Staff,17,0,20,3
1713328713588,MCWP 50R,C00,518793,Staff,19,0,20,1
1713328713588,MCWP 50R,D00,518794,Staff,16,0,20,4
1713328713588,MCWP 50R,E00,518795,Staff,16,0,20,4
1713328713588,MCWP 50R,F00,518796,Staff,19,0,20,1
1713328713588,MCWP 50R,G00,518797,Staff,19,0,20,1
1713328714615,MMW 12R,A01,514034,Herbst; Matthew,15,0,16,1
1713328714615,MMW 12R,A02,514035,Herbst; Matthew,16,0,16,0
1713328715640,MMW 13R,A01,514037,Staff,12,0,16,4
1713328715640,MMW 13R,A02,514039,Staff,16,0,16,0
1713328717694,SIO 295LS,A00,523233,Staff,19,0,30,11
1713328718720,SIO 295S,A00,523232,Staff,19,0,30,11
1713328719751,SOCI 117,A01,494376,Staff,2,0,5,3
1713328720776,WES 237B,A00,494380,Staff,19,0,20,1
1713328722849,AESE 279B,A00,494370,Wade; Jon P,33,0,33,0
1713328723874,ANAR 135S,A00,494369,Braswell; Geoffrey E.,0,0,0,0
1713328724898,CAT 124RS,A01,519847,Geibel; William,17,0,20,3
1713328725929,CAT 125RS,A01,515971,Geibel; William,17,0,20,3
1713328726956,CLRE 250,A00,511389,Morris; Sheldon,9996,0,9999,3
1713328727984,CLRE 251,A00,507176,Mehta; Ravindra L.,9996,0,9999,3
1713328727984,CLRE 251,B00,511410,Mehta; Ravindra L.,9998,0,9999,1
1713328729013,CLRE 252,A00,507189,Cuomo; Raphael Eduardo,9998,0,9999,1
1713328730039,CLRE 253,A00,507199,Vaida; Florin,9997,0,9999,2
1713328730039,CLRE 253,B00,507202,Vaida; Florin,9999,0,9999,0
1713328731064,CLRE 259,A00,507211,Patel; Hemal,9996,0,9999,3
1713328732091,CLRE 260,A00,507221,Cuomo; Raphael Eduardo,9999,0,9999,0
1713328733117,CLRE 297,001,507242,Cuomo; Raphael Eduardo,9999,0,9999,0
1713328734143,CSE 191,A00,516875,Minnes Kemp; Mor Mia,9999,0,9999,0
1713328735177,CSS 201S,A01,494383,Staff,35,0,35,0
1713328736203,CSS 202S,A01,494387,Staff,35,0,35,0
1713328737232,EAP 100,A00,516065,Staff,9792,0,9999,207
1713328738263,ECE 45,A01,507414,Staff,51,0,60,9
1713328739288,ECE 100,A01,507416,Baghdadchi; Saharnaz,10,0,20,10
1713328739288,ECE 100,A02,507418,Baghdadchi; Saharnaz,20,0,20,0
1713328740317,ECE 111,A01,507420,Staff,38,0,50,12
1713328741344,ECE 197,001,548057,Sievenpiper; Daniel F.,9998,0,9999,1
1713328742375,EDS 115,A00,507243,Choi; Bailey Miyeon,28,0,28,0
1713328743403,EDS 117,A01,494379,Staff,23,0,25,2
1713328744432,EDS 125,A00,507246,Hopkins; Megan Beth,29,0,30,1
1713328745458,EDS 128A,A01,507264,Fargason; Sharon Gayle,26,0,26,0
1713328746485,EDS 128B,A01,507293,Pappas; Elizabeth,30,0,30,0
1713328747512,EDS 139,A00,507294,Fargason; Sharon Gayle,30,0,30,0
1713328747512,EDS 139,B00,507313,Pappas; Elizabeth,30,0,30,0
1713328748541,EDS 201,A00,507315,Staff,26,0,30,4
1713328749566,EDS 203,A01,507317,Halter; Christopher P.,26,0,30,4
1713328750592,EDS 204R,A01,507319,Halter; Christopher P.,3,0,30,27
1713328750592,EDS 204R,B01,507331,Heinzman; Erica M.,28,0,30,2
1713328751689,EDS 206R,A00,507332,Staff,4,0,30,26
1713328751689,EDS 206R,B00,507343,Staff,28,0,30,2
1713328752714,EDS 250,A00,507344,Hemans; Patricia Ann Benitez,36,0,40,4
1713328753739,EDS 281,A00,507345,Daly; Alan J.,18,0,18,0
1713328754764,EDS 284,A00,507350,Daly; Alan J.,16,0,16,0
1713328755792,EDS 286,A00,507359,Fine; Sarah,18,0,18,0
1713328756817,EDS 289C,A01,507361,Daly; Alan J.,18,0,18,0
1713328757843,EDS 290,A00,507366,Hofstetter; Carolyn,15,0,15,0
1713328758876,LIGM 5A,A00,507421,Fischer-Grunski; Eva K,20,0,20,0
1713328759905,LIGM 5B,A00,507423,Fischer-Grunski; Eva K,20,0,20,0
1713328760934,LIGM 5C,A00,507425,Fischer-Grunski; Eva K,20,0,20,0
1713328761958,LIIT 5AS,A00,507427,Carnelos; Chiara,20,0,20,0
1713328762984,LIIT 5BS,A00,507430,Carnelos; Chiara,20,0,20,0
1713328764064,LIIT 5CS,A00,507432,Carnelos; Chiara,20,0,20,0
1713328765089,LISP 5A,A00,507541,Munoz Sanchez; Alicia,17,0,20,3
1713328766114,LISP 5B,A00,507671,Munoz Sanchez; Alicia,15,0,20,5
1713328767140,LISP 5C,A00,507696,Munoz Sanchez; Alicia,15,0,20,5
1713328768166,MAE 197,001,528363,Boechler; Nicholas Sebastia,9998,0,9999,1
1713328769196,MATH 197,001,523477,Kedlaya; Kiran S.,9999,0,9999,0
1713328769196,MATH 197,002,563811,Zhang; Danna,9999,0,9999,0
1713328770221,MCWP 40R,A00,518780,Staff,20,0,20,0
1713328770221,MCWP 40R,B00,518781,Staff,19,0,20,1
1713328770221,MCWP 40R,C00,518783,Staff,19,0,20,1
1713328771251,MCWP 50R,A00,518791,Staff,20,0,20,0
1713328771251,MCWP 50R,B00,518792,Staff,17,0,20,3
1713328771251,MCWP 50R,C00,518793,Staff,19,0,20,1
1713328771251,MCWP 50R,D00,518794,Staff,16,0,20,4
1713328771251,MCWP 50R,E00,518795,Staff,16,0,20,4
1713328771251,MCWP 50R,F00,518796,Staff,19,0,20,1
1713328771251,MCWP 50R,G00,518797,Staff,19,0,20,1
1713328772277,MMW 12R,A01,514034,Herbst; Matthew,15,0,16,1
1713328772277,MMW 12R,A02,514035,Herbst; Matthew,16,0,16,0
1713328773301,MMW 13R,A01,514037,Staff,12,0,16,4
1713328773301,MMW 13R,A02,514039,Staff,16,0,16,0
1713328775354,SIO 295LS,A00,523233,Staff,19,0,30,11
1713328776381,SIO 295S,A00,523232,Staff,19,0,30,11
1713328777408,SOCI 117,A01,494376,Staff,2,0,5,3
1713328778432,WES 237B,A00,494380,Staff,19,0,20,1
1713328780499,AESE 279B,A00,494370,Wade; Jon P,33,0,33,0
1713328781528,ANAR 135S,A00,494369,Braswell; Geoffrey E.,0,0,0,0
1713328782560,CAT 124RS,A01,519847,Geibel; William,17,0,20,3
1713328783589,CAT 125RS,A01,515971,Geibel; William,17,0,20,3
1713328784620,CLRE 250,A00,511389,Morris; Sheldon,9996,0,9999,3
1713328785655,CLRE 251,A00,507176,Mehta; Ravindra L.,9996,0,9999,3
1713328785655,CLRE 251,B00,511410,Mehta; Ravindra L.,9998,0,9999,1
1713328786680,CLRE 252,A00,507189,Cuomo; Raphael Eduardo,9998,0,9999,1
1713328787710,CLRE 253,A00,507199,Vaida; Florin,9997,0,9999,2
1713328787710,CLRE 253,B00,507202,Vaida; Florin,9999,0,9999,0
1713328788739,CLRE 259,A00,507211,Patel; Hemal,9996,0,9999,3
1713328789765,CLRE 260,A00,507221,Cuomo; Raphael Eduardo,9999,0,9999,0
1713328790789,CLRE 297,001,507242,Cuomo; Raphael Eduardo,9999,0,9999,0
1713328791815,CSE 191,A00,516875,Minnes Kemp; Mor Mia,9999,0,9999,0
1713328792840,CSS 201S,A01,494383,Staff,35,0,35,0
1713328793870,CSS 202S,A01,494387,Staff,35,0,35,0
1713328794897,EAP 100,A00,516065,Staff,9792,0,9999,207
1713328795925,ECE 45,A01,507414,Staff,51,0,60,9
1713328796951,ECE 100,A01,507416,Baghdadchi; Saharnaz,10,0,20,10
1713328796951,ECE 100,A02,507418,Baghdadchi; Saharnaz,20,0,20,0
1713328797976,ECE 111,A01,507420,Staff,38,0,50,12
1713328799006,ECE 197,001,548057,Sievenpiper; Daniel F.,9998,0,9999,1
1713328800032,EDS 115,A00,507243,Choi; Bailey Miyeon,28,0,28,0
1713328801056,EDS 117,A01,494379,Staff,23,0,25,2
1713328802081,EDS 125,A00,507246,Hopkins; Megan Beth,29,0,30,1
1713328803106,EDS 128A,A01,507264,Fargason; Sharon Gayle,26,0,26,0
1713328804131,EDS 128B,A01,507293,Pappas; Elizabeth,30,0,30,0
1713328805159,EDS 139,A00,507294,Fargason; Sharon Gayle,30,0,30,0
1713328805159,EDS 139,B00,507313,Pappas; Elizabeth,30,0,30,0
1713328806190,EDS 201,A00,507315,Staff,26,0,30,4
1713328807217,EDS 203,A01,507317,Halter; Christopher P.,26,0,30,4
1713328808246,EDS 204R,A01,507319,Halter; Christopher P.,3,0,30,27
1713328808246,EDS 204R,B01,507331,Heinzman; Erica M.,28,0,30,2
1713328809276,EDS 206R,A00,507332,Staff,4,0,30,26
1713328809276,EDS 206R,B00,507343,Staff,28,0,30,2
1713328810302,EDS 250,A00,507344,Hemans; Patricia Ann Benitez,36,0,40,4
1713328811327,EDS 281,A00,507345,Daly; Alan J.,18,0,18,0
1713328812352,EDS 284,A00,507350,Daly; Alan J.,16,0,16,0
1713328813380,EDS 286,A00,507359,Fine; Sarah,18,0,18,0
1713328814406,EDS 289C,A01,507361,Daly; Alan J.,18,0,18,0
1713328815432,EDS 290,A00,507366,Hofstetter; Carolyn,15,0,15,0
1713328816460,LIGM 5A,A00,507421,Fischer-Grunski; Eva K,20,0,20,0
1713328817485,LIGM 5B,A00,507423,Fischer-Grunski; Eva K,20,0,20,0
1713328818514,LIGM 5C,A00,507425,Fischer-Grunski; Eva K,20,0,20,0
1713328819542,LIIT 5AS,A00,507427,Carnelos; Chiara,20,0,20,0
1713328820568,LIIT 5BS,A00,507430,Carnelos; Chiara,20,0,20,0
1713328821595,LIIT 5CS,A00,507432,Carnelos; Chiara,20,0,20,0
1713328822624,LISP 5A,A00,507541,Munoz Sanchez; Alicia,17,0,20,3
1713328823650,LISP 5B,A00,507671,Munoz Sanchez; Alicia,15,0,20,5
1713328824676,LISP 5C,A00,507696,Munoz Sanchez; Alicia,15,0,20,5
1713328825706,MAE 197,001,528363,Boechler; Nicholas Sebastia,9998,0,9999,1
1713328826733,MATH 197,001,523477,Kedlaya; Kiran S.,9999,0,9999,0
1713328826733,MATH 197,002,563811,Zhang; Danna,9999,0,9999,0
1713328827760,MCWP 40R,A00,518780,Staff,20,0,20,0
1713328827760,MCWP 40R,B00,518781,Staff,19,0,20,1
1713328827760,MCWP 40R,C00,518783,Staff,19,0,20,1
1713328828787,MCWP 50R,A00,518791,Staff,20,0,20,0
1713328828787,MCWP 50R,B00,518792,Staff,17,0,20,3
1713328828787,MCWP 50R,C00,518793,Staff,19,0,20,1
1713328828787,MCWP 50R,D00,518794,Staff,16,0,20,4
1713328828787,MCWP 50R,E00,518795,Staff,16,0,20,4
1713328828787,MCWP 50R,F00,518796,Staff,19,0,20,1
1713328828787,MCWP 50R,G00,518797,Staff,19,0,20,1
1713328829815,MMW 12R,A01,514034,Herbst; Matthew,15,0,16,1
1713328829815,MMW 12R,A02,514035,Herbst; Matthew,16,0,16,0
1713328830838,MMW 13R,A01,514037,Staff,12,0,16,4
1713328830838,MMW 13R,A02,514039,Staff,16,0,16,0
1713328832891,SIO 295LS,A00,523233,Staff,19,0,30,11
1713328833915,SIO 295S,A00,523232,Staff,19,0,30,11
1713328834941,SOCI 117,A01,494376,Staff,2,0,5,3
1713328835970,WES 237B,A00,494380,Staff,19,0,20,1
1713328838045,AESE 279B,A00,494370,Wade; Jon P,33,0,33,0
1713328839074,ANAR 135S,A00,494369,Braswell; Geoffrey E.,0,0,0,0
1713328840104,CAT 124RS,A01,519847,Geibel; William,17,0,20,3
1713328841133,CAT 125RS,A01,515971,Geibel; William,17,0,20,3
1713328842158,CLRE 250,A00,511389,Morris; Sheldon,9996,0,9999,3
1713328843187,CLRE 251,A00,507176,Mehta; Ravindra L.,9996,0,9999,3
1713328843187,CLRE 251,B00,511410,Mehta; Ravindra L.,9998,0,9999,1
1713328844217,CLRE 252,A00,507189,Cuomo; Raphael Eduardo,9998,0,9999,1
1713328845242,CLRE 253,A00,507199,Vaida; Florin,9997,0,9999,2
1713328845242,CLRE 253,B00,507202,Vaida; Florin,9999,0,9999,0
1713328846265,CLRE 259,A00,507211,Patel; Hemal,9996,0,9999,3
1713328847290,CLRE 260,A00,507221,Cuomo; Raphael Eduardo,9999,0,9999,0
1713328848316,CLRE 297,001,507242,Cuomo; Raphael Eduardo,9999,0,9999,0
1713328849345,CSE 191,A00,516875,Minnes Kemp; Mor Mia,9999,0,9999,0
1713328850371,CSS 201S,A01,494383,Staff,35,0,35,0
1713328851400,CSS 202S,A01,494387,Staff,35,0,35,0
1713328852425,EAP 100,A00,516065,Staff,9792,0,9999,207
1713328853453,ECE 45,A01,507414,Staff,51,0,60,9
1713328854478,ECE 100,A01,507416,Baghdadchi; Saharnaz,10,0,20,10
1713328854478,ECE 100,A02,507418,Baghdadchi; Saharnaz,20,0,20,0
1713328855504,ECE 111,A01,507420,Staff,38,0,50,12
1713328856533,ECE 197,001,548057,Sievenpiper; Daniel F.,9998,0,9999,1
1713328857560,EDS 115,A00,507243,Choi; Bailey Miyeon,28,0,28,0
1713328858586,EDS 117,A01,494379,Staff,23,0,25,2
1713328859612,EDS 125,A00,507246,Hopkins; Megan Beth,29,0,30,1
1713328860639,EDS 128A,A01,507264,Fargason; Sharon Gayle,26,0,26,0
1713328861665,EDS 128B,A01,507293,Pappas; Elizabeth,30,0,30,0
1713328862689,EDS 139,A00,507294,Fargason; Sharon Gayle,30,0,30,0
1713328862689,EDS 139,B00,507313,Pappas; Elizabeth,30,0,30,0
1713328863719,EDS 201,A00,507315,Staff,26,0,30,4
1713328864745,EDS 203,A01,507317,Halter; Christopher P.,26,0,30,4
1713328865771,EDS 204R,A01,507319,Halter; Christopher P.,3,0,30,27
1713328865771,EDS 204R,B01,507331,Heinzman; Erica M.,28,0,30,2
1713328866804,EDS 206R,A00,507332,Staff,4,0,30,26
1713328866804,EDS 206R,B00,507343,Staff,28,0,30,2
1713328867883,EDS 250,A00,507344,Hemans; Patricia Ann Benitez,36,0,40,4
1713328868911,EDS 281,A00,507345,Daly; Alan J.,18,0,18,0
1713328869936,EDS 284,A00,507350,Daly; Alan J.,16,0,16,0
1713328870962,EDS 286,A00,507359,Fine; Sarah,18,0,18,0
1713328871988,EDS 289C,A01,507361,Daly; Alan J.,18,0,18,0
1713328873014,EDS 290,A00,507366,Hofstetter; Carolyn,15,0,15,0
1713328874041,LIGM 5A,A00,507421,Fischer-Grunski; Eva K,20,0,20,0
1713328875071,LIGM 5B,A00,507423,Fischer-Grunski; Eva K,20,0,20,0
1713328876098,LIGM 5C,A00,507425,Fischer-Grunski; Eva K,20,0,20,0
1713328877124,LIIT 5AS,A00,507427,Carnelos; Chiara,20,0,20,0
1713328878150,LIIT 5BS,A00,507430,Carnelos; Chiara,20,0,20,0
1713328879177,LIIT 5CS,A00,507432,Carnelos; Chiara,20,0,20,0
1713328880203,LISP 5A,A00,507541,Munoz Sanchez; Alicia,17,0,20,3
1713328881229,LISP 5B,A00,507671,Munoz Sanchez; Alicia,15,0,20,5
1713328882254,LISP 5C,A00,507696,Munoz Sanchez; Alicia,15,0,20,5
1713328883280,MAE 197,001,528363,Boechler; Nicholas Sebastia,9998,0,9999,1
1713328884306,MATH 197,001,523477,Kedlaya; Kiran S.,9999,0,9999,0
1713328884306,MATH 197,002,563811,Zhang; Danna,9999,0,9999,0
1713328885332,MCWP 40R,A00,518780,Staff,20,0,20,0
1713328885332,MCWP 40R,B00,518781,Staff,19,0,20,1
1713328885332,MCWP 40R,C00,518783,Staff,19,0,20,1
1713328886359,MCWP 50R,A00,518791,Staff,20,0,20,0
1713328886359,MCWP 50R,B00,518792,Staff,17,0,20,3
1713328886359,MCWP 50R,C00,518793,Staff,19,0,20,1
1713328886359,MCWP 50R,D00,518794,Staff,16,0,20,4
1713328886359,MCWP 50R,E00,518795,Staff,16,0,20,4
1713328886359,MCWP 50R,F00,518796,Staff,19,0,20,1
1713328886359,MCWP 50R,G00,518797,Staff,19,0,20,1
1713328887384,MMW 12R,A01,514034,Herbst; Matthew,15,0,16,1
1713328887384,MMW 12R,A02,514035,Herbst; Matthew,16,0,16,0
1713328888412,MMW 13R,A01,514037,Staff,12,0,16,4
1713328888412,MMW 13R,A02,514039,Staff,16,0,16,0
1713328890462,SIO 295LS,A00,523233,Staff,19,0,30,11
1713328891485,SIO 295S,A00,523232,Staff,19,0,30,11
1713328892512,SOCI 117,A01,494376,Staff,2,0,5,3
1713328893536,WES 237B,A00,494380,Staff,19,0,20,1
1713328895614,AESE 279B,A00,494370,Wade; Jon P,33,0,33,0
1713328896641,ANAR 135S,A00,494369,Braswell; Geoffrey E.,0,0,0,0
1713328897669,CAT 124RS,A01,519847,Geibel; William,17,0,20,3
1713328898698,CAT 125RS,A01,515971,Geibel; William,17,0,20,3
1713328899724,CLRE 250,A00,511389,Morris; Sheldon,9996,0,9999,3
1713328900752,CLRE 251,A00,507176,Mehta; Ravindra L.,9996,0,9999,3
1713328900752,CLRE 251,B00,511410,Mehta; Ravindra L.,9998,0,9999,1
1713328901778,CLRE 252,A00,507189,Cuomo; Raphael Eduardo,9998,0,9999,1
1713328902804,CLRE 253,A00,507199,Vaida; Florin,9997,0,9999,2
1713328902804,CLRE 253,B00,507202,Vaida; Florin,9999,0,9999,0
1713328903833,CLRE 259,A00,507211,Patel; Hemal,9996,0,9999,3
1713328904857,CLRE 260,A00,507221,Cuomo; Raphael Eduardo,9999,0,9999,0
1713328905882,CLRE 297,001,507242,Cuomo; Raphael Eduardo,9999,0,9999,0
1713328906914,CSE 191,A00,516875,Minnes Kemp; Mor Mia,9999,0,9999,0
1713328907940,CSS 201S,A01,494383,Staff,35,0,35,0
1713328908969,CSS 202S,A01,494387,Staff,35,0,35,0
1713328909992,EAP 100,A00,516065,Staff,9792,0,9999,207
1713328911017,ECE 45,A01,507414,Staff,51,0,60,9
1713328912044,ECE 100,A01,507416,Baghdadchi; Saharnaz,10,0,20,10
1713328912044,ECE 100,A02,507418,Baghdadchi; Saharnaz,20,0,20,0
1713328913070,ECE 111,A01,507420,Staff,38,0,50,12
1713328914095,ECE 197,001,548057,Sievenpiper; Daniel F.,9998,0,9999,1
1713328915125,EDS 115,A00,507243,Choi; Bailey Miyeon,28,0,28,0
1713328916151,EDS 117,A01,494379,Staff,23,0,25,2
1713328917176,EDS 125,A00,507246,Hopkins; Megan Beth,29,0,30,1
1713328918200,EDS 128A,A01,507264,Fargason; Sharon Gayle,26,0,26,0
1713328919228,EDS 128B,A01,507293,Pappas; Elizabeth,30,0,30,0
1713328920256,EDS 139,A00,507294,Fargason; Sharon Gayle,30,0,30,0
1713328920256,EDS 139,B00,507313,Pappas; Elizabeth,30,0,30,0
1713328921283,EDS 201,A00,507315,Staff,26,0,30,4
1713328922313,EDS 203,A01,507317,Halter; Christopher P.,26,0,30,4
1713328923344,EDS 204R,A01,507319,Halter; Christopher P.,3,0,30,27
1713328923344,EDS 204R,B01,507331,Heinzman; Erica M.,28,0,30,2
1713328924373,EDS 206R,A00,507332,Staff,4,0,30,26
1713328924373,EDS 206R,B00,507343,Staff,28,0,30,2
1713328925404,EDS 250,A00,507344,Hemans; Patricia Ann Benitez,36,0,40,4
1713328926428,EDS 281,A00,507345,Daly; Alan J.,18,0,18,0
1713328927457,EDS 284,A00,507350,Daly; Alan J.,16,0,16,0
1713328928483,EDS 286,A00,507359,Fine; Sarah,18,0,18,0
1713328929508,EDS 289C,A01,507361,Daly; Alan J.,18,0,18,0
1713328930539,EDS 290,A00,507366,Hofstetter; Carolyn,15,0,15,0
1713328931563,LIGM 5A,A00,507421,Fischer-Grunski; Eva K,20,0,20,0
1713328932592,LIGM 5B,A00,507423,Fischer-Grunski; Eva K,20,0,20,0
1713328933618,LIGM 5C,A00,507425,Fischer-Grunski; Eva K,20,0,20,0
1713328934645,LIIT 5AS,A00,507427,Carnelos; Chiara,20,0,20,0
1713328935674,LIIT 5BS,A00,507430,Carnelos; Chiara,20,0,20,0
1713328936699,LIIT 5CS,A00,507432,Carnelos; Chiara,20,0,20,0
1713328937731,LISP 5A,A00,507541,Munoz Sanchez; Alicia,17,0,20,3
1713328938758,LISP 5B,A00,507671,Munoz Sanchez; Alicia,15,0,20,5
1713328939783,LISP 5C,A00,507696,Munoz Sanchez; Alicia,15,0,20,5
1713328940812,MAE 197,001,528363,Boechler; Nicholas Sebastia,9998,0,9999,1
1713328941839,MATH 197,001,523477,Kedlaya; Kiran S.,9999,0,9999,0
1713328941839,MATH 197,002,563811,Zhang; Danna,9999,0,9999,0
1713328942869,MCWP 40R,A00,518780,Staff,20,0,20,0
1713328942869,MCWP 40R,B00,518781,Staff,19,0,20,1
1713328942869,MCWP 40R,C00,518783,Staff,19,0,20,1
1713328943902,MCWP 50R,A00,518791,Staff,20,0,20,0
1713328943902,MCWP 50R,B00,518792,Staff,17,0,20,3
1713328943902,MCWP 50R,C00,518793,Staff,19,0,20,1
1713328943902,MCWP 50R,D00,518794,Staff,16,0,20,4
1713328943902,MCWP 50R,E00,518795,Staff,16,0,20,4
1713328943902,MCWP 50R,F00,518796,Staff,19,0,20,1
1713328943902,MCWP 50R,G00,518797,Staff,19,0,20,1
1713328944927,MMW 12R,A01,514034,Herbst; Matthew,15,0,16,1
1713328944927,MMW 12R,A02,514035,Herbst; Matthew,16,0,16,0
1713328945954,MMW 13R,A01,514037,Staff,12,0,16,4
1713328945954,MMW 13R,A02,514039,Staff,16,0,16,0
1713328948004,SIO 295LS,A00,523233,Staff,19,0,30,11
1713328949030,SIO 295S,A00,523232,Staff,19,0,30,11
1713328950056,SOCI 117,A01,494376,Staff,2,0,5,3
1713328951086,WES 237B,A00,494380,Staff,19,0,20,1
1713328953160,AESE 279B,A00,494370,Wade; Jon P,33,0,33,0
1713328954190,ANAR 135S,A00,494369,Braswell; Geoffrey E.,0,0,0,0
1713328955216,CAT 124RS,A01,519847,Geibel; William,17,0,20,3
1713328956242,CAT 125RS,A01,515971,Geibel; William,17,0,20,3
1713328957272,CLRE 250,A00,511389,Morris; Sheldon,9996,0,9999,3
1713328958298,CLRE 251,A00,507176,Mehta; Ravindra L.,9996,0,9999,3
1713328958298,CLRE 251,B00,511410,Mehta; Ravindra L.,9998,0,9999,1
1713328959326,CLRE 252,A00,507189,Cuomo; Raphael Eduardo,9998,0,9999,1
1713328960351,CLRE 253,A00,507199,Vaida; Florin,9997,0,9999,2
1713328960351,CLRE 253,B00,507202,Vaida; Florin,9999,0,9999,0
1713328961377,CLRE 259,A00,507211,Patel; Hemal,9996,0,9999,3
1713328962401,CLRE 260,A00,507221,Cuomo; Raphael Eduardo,9999,0,9999,0
1713328963429,CLRE 297,001,507242,Cuomo; Raphael Eduardo,9999,0,9999,0
1713328964454,CSE 191,A00,516875,Minnes Kemp; Mor Mia,9999,0,9999,0
1713328965479,CSS 201S,A01,494383,Staff,35,0,35,0
1713328966504,CSS 202S,A01,494387,Staff,35,0,35,0
1713328967528,EAP 100,A00,516065,Staff,9792,0,9999,207
1713328968556,ECE 45,A01,507414,Staff,51,0,60,9
1713328969587,ECE 100,A01,507416,Baghdadchi; Saharnaz,10,0,20,10
1713328969587,ECE 100,A02,507418,Baghdadchi; Saharnaz,20,0,20,0
1713328970615,ECE 111,A01,507420,Staff,38,0,50,12
1713328971711,ECE 197,001,548057,Sievenpiper; Daniel F.,9998,0,9999,1
1713328972743,EDS 115,A00,507243,Choi; Bailey Miyeon,28,0,28,0
1713328973772,EDS 117,A01,494379,Staff,23,0,25,2
1713328974797,EDS 125,A00,507246,Hopkins; Megan Beth,29,0,30,1
1713328975827,EDS 128A,A01,507264,Fargason; Sharon Gayle,26,0,26,0
1713328976854,EDS 128B,A01,507293,Pappas; Elizabeth,30,0,30,0
1713328977883,EDS 139,A00,507294,Fargason; Sharon Gayle,30,0,30,0
1713328977883,EDS 139,B00,507313,Pappas; Elizabeth,30,0,30,0
1713328978910,EDS 201,A00,507315,Staff,26,0,30,4
1713328979939,EDS 203,A01,507317,Halter; Christopher P.,26,0,30,4
1713328980963,EDS 204R,A01,507319,Halter; Christopher P.,3,0,30,27
1713328980963,EDS 204R,B01,507331,Heinzman; Erica M.,28,0,30,2
1713328981992,EDS 206R,A00,507332,Staff,4,0,30,26
1713328981992,EDS 206R,B00,507343,Staff,28,0,30,2
1713328983018,EDS 250,A00,507344,Hemans; Patricia Ann Benitez,36,0,40,4
1713328984044,EDS 281,A00,507345,Daly; Alan J.,18,0,18,0
1713328985072,EDS 284,A00,507350,Daly; Alan J.,16,0,16,0
1713328986102,EDS 286,A00,507359,Fine; Sarah,18,0,18,0
1713328987130,EDS 289C,A01,507361,Daly; Alan J.,18,0,18,0
1713328988156,EDS 290,A00,507366,Hofstetter; Carolyn,15,0,15,0
1713328989186,LIGM 5A,A00,507421,Fischer-Grunski; Eva K,20,0,20,0
1713328990218,LIGM 5B,A00,507423,Fischer-Grunski; Eva K,20,0,20,0
1713328991242,LIGM 5C,A00,507425,Fischer-Grunski; Eva K,20,0,20,0
1713328992267,LIIT 5AS,A00,507427,Carnelos; Chiara,20,0,20,0
1713328993295,LIIT 5BS,A00,507430,Carnelos; Chiara,20,0,20,0
1713328994320,LIIT 5CS,A00,507432,Carnelos; Chiara,20,0,20,0
1713328995350,LISP 5A,A00,507541,Munoz Sanchez; Alicia,17,0,20,3
1713328996374,LISP 5B,A00,507671,Munoz Sanchez; Alicia,15,0,20,5
1713328997402,LISP 5C,A00,507696,Munoz Sanchez; Alicia,15,0,20,5
1713328998435,MAE 197,001,528363,Boechler; Nicholas Sebastia,9998,0,9999,1
1713328999467,MATH 197,001,523477,Kedlaya; Kiran S.,9999,0,9999,0
1713328999467,MATH 197,002,563811,Zhang; Danna,9999,0,9999,0
1713329000493,MCWP 40R,A00,518780,Staff,20,0,20,0
1713329000493,MCWP 40R,B00,518781,Staff,19,0,20,1
1713329000493,MCWP 40R,C00,518783,Staff,19,0,20,1
1713329001520,MCWP 50R,A00,518791,Staff,20,0,20,0
1713329001520,MCWP 50R,B00,518792,Staff,17,0,20,3
1713329001520,MCWP 50R,C00,518793,Staff,19,0,20,1
1713329001520,MCWP 50R,D00,518794,Staff,16,0,20,4
1713329001520,MCWP 50R,E00,518795,Staff,16,0,20,4
1713329001520,MCWP 50R,F00,518796,Staff,19,0,20,1
1713329001520,MCWP 50R,G00,518797,Staff,19,0,20,1
1713329002547,MMW 12R,A01,514034,Herbst; Matthew,15,0,16,1
1713329002547,MMW 12R,A02,514035,Herbst; Matthew,16,0,16,0
1713329003572,MMW 13R,A01,514037,Staff,12,0,16,4
1713329003572,MMW 13R,A02,514039,Staff,16,0,16,0
1713329005627,SIO 295LS,A00,523233,Staff,19,0,30,11
1713329006653,SIO 295S,A00,523232,Staff,19,0,30,11
1713329007678,SOCI 117,A01,494376,Staff,2,0,5,3
1713329008703,WES 237B,A00,494380,Staff,19,0,20,1
1713329010769,AESE 279B,A00,494370,Wade; Jon P,33,0,33,0
1713329011800,ANAR 135S,A00,494369,Braswell; Geoffrey E.,0,0,0,0
1713329012830,CAT 124RS,A01,519847,Geibel; William,17,0,20,3
1713329013857,CAT 125RS,A01,515971,Geibel; William,17,0,20,3
1713329014886,CLRE 250,A00,511389,Morris; Sheldon,9996,0,9999,3
1713329015913,CLRE 251,A00,507176,Mehta; Ravindra L.,9996,0,9999,3
1713329015913,CLRE 251,B00,511410,Mehta; Ravindra L.,9998,0,9999,1
1713329016940,CLRE 252,A00,507189,Cuomo; Raphael Eduardo,9998,0,9999,1
1713329017975,CLRE 253,A00,507199,Vaida; Florin,9997,0,9999,2
1713329017975,CLRE 253,B00,507202,Vaida; Florin,9999,0,9999,0
1713329019004,CLRE 259,A00,507211,Patel; Hemal,9996,0,9999,3
1713329020030,CLRE 260,A00,507221,Cuomo; Raphael Eduardo,9999,0,9999,0
1713329021063,CLRE 297,001,507242,Cuomo; Raphael Eduardo,9999,0,9999,0
1713329022094,CSE 191,A00,516875,Minnes Kemp; Mor Mia,9999,0,9999,0
1713329023117,CSS 201S,A01,494383,Staff,35,0,35,0
1713329024144,CSS 202S,A01,494387,Staff,35,0,35,0
1713329025171,EAP 100,A00,516065,Staff,9792,0,9999,207
1713329026197,ECE 45,A01,507414,Staff,51,0,60,9
1713329027227,ECE 100,A01,507416,Baghdadchi; Saharnaz,10,0,20,10
1713329027227,ECE 100,A02,507418,Baghdadchi; Saharnaz,20,0,20,0
1713329028256,ECE 111,A01,507420,Staff,38,0,50,12
1713329029281,ECE 197,001,548057,Sievenpiper; Daniel F.,9998,0,9999,1
1713329030308,EDS 115,A00,507243,Choi; Bailey Miyeon,28,0,28,0
1713329031333,EDS 117,A01,494379,Staff,23,0,25,2
1713329032358,EDS 125,A00,507246,Hopkins; Megan Beth,29,0,30,1
1713329033384,EDS 128A,A01,507264,Fargason; Sharon Gayle,26,0,26,0
1713329034410,EDS 128B,A01,507293,Pappas; Elizabeth,30,0,30,0
1713329035435,EDS 139,A00,507294,Fargason; Sharon Gayle,30,0,30,0
1713329035435,EDS 139,B00,507313,Pappas; Elizabeth,30,0,30,0
1713329036668,EDS 201,A00,507315,Staff,26,0,30,4
1713329037699,EDS 203,A01,507317,Halter; Christopher P.,26,0,30,4
1713329038722,EDS 204R,A01,507319,Halter; Christopher P.,3,0,30,27
1713329038722,EDS 204R,B01,507331,Heinzman; Erica M.,28,0,30,2
1713329039747,EDS 206R,A00,507332,Staff,4,0,30,26
1713329039747,EDS 206R,B00,507343,Staff,28,0,30,2
1713329040771,EDS 250,A00,507344,Hemans; Patricia Ann Benitez,36,0,40,4
1713329041802,EDS 281,A00,507345,Daly; Alan J.,18,0,18,0
1713329042832,EDS 284,A00,507350,Daly; Alan J.,16,0,16,0
1713329043860,EDS 286,A00,507359,Fine; Sarah,18,0,18,0
1713329044884,EDS 289C,A01,507361,Daly; Alan J.,18,0,18,0
1713329045910,EDS 290,A00,507366,Hofstetter; Carolyn,15,0,15,0
1713329046937,LIGM 5A,A00,507421,Fischer-Grunski; Eva K,20,0,20,0
1713329047963,LIGM 5B,A00,507423,Fischer-Grunski; Eva K,20,0,20,0
1713329048990,LIGM 5C,A00,507425,Fischer-Grunski; Eva K,20,0,20,0
1713329050017,LIIT 5AS,A00,507427,Carnelos; Chiara,20,0,20,0
1713329051049,LIIT 5BS,A00,507430,Carnelos; Chiara,20,0,20,0
1713329052075,LIIT 5CS,A00,507432,Carnelos; Chiara,20,0,20,0
1713329053106,LISP 5A,A00,507541,Munoz Sanchez; Alicia,17,0,20,3
1713329054131,LISP 5B,A00,507671,Munoz Sanchez; Alicia,15,0,20,5
1713329055156,LISP 5C,A00,507696,Munoz Sanchez; Alicia,15,0,20,5
1713329056182,MAE 197,001,528363,Boechler; Nicholas Sebastia,9998,0,9999,1
1713329057212,MATH 197,001,523477,Kedlaya; Kiran S.,9999,0,9999,0
1713329057212,MATH 197,002,563811,Zhang; Danna,9999,0,9999,0
1713329058240,MCWP 40R,A00,518780,Staff,20,0,20,0
1713329058240,MCWP 40R,B00,518781,Staff,19,0,20,1
1713329058240,MCWP 40R,C00,518783,Staff,19,0,20,1
1713329059266,MCWP 50R,A00,518791,Staff,20,0,20,0
1713329059266,MCWP 50R,B00,518792,Staff,17,0,20,3
1713329059266,MCWP 50R,C00,518793,Staff,19,0,20,1
1713329059266,MCWP 50R,D00,518794,Staff,16,0,20,4
1713329059266,MCWP 50R,E00,518795,Staff,16,0,20,4
1713329059266,MCWP 50R,F00,518796,Staff,19,0,20,1
1713329059266,MCWP 50R,G00,518797,Staff,19,0,20,1
1713329060296,MMW 12R,A01,514034,Herbst; Matthew,15,0,16,1
1713329060296,MMW 12R,A02,514035,Herbst; Matthew,16,0,16,0
1713329061320,MMW 13R,A01,514037,Staff,12,0,16,4
1713329061320,MMW 13R,A02,514039,Staff,16,0,16,0
1713329063375,SIO 295LS,A00,523233,Staff,19,0,30,11
1713329064401,SIO 295S,A00,523232,Staff,19,0,30,11
1713329065430,SOCI 117,A01,494376,Staff,2,0,5,3
1713329066455,WES 237B,A00,494380,Staff,19,0,20,1
1713329068519,AESE 279B,A00,494370,Wade; Jon P,33,0,33,0
1713329069546,ANAR 135S,A00,494369,Braswell; Geoffrey E.,0,0,0,0
1713329070575,CAT 124RS,A01,519847,Geibel; William,17,0,20,3
1713329071601,CAT 125RS,A01,515971,Geibel; William,17,0,20,3
1713329072630,CLRE 250,A00,511389,Morris; Sheldon,9996,0,9999,3
1713329073666,CLRE 251,A00,507176,Mehta; Ravindra L.,9996,0,9999,3
1713329073666,CLRE 251,B00,511410,Mehta; Ravindra L.,9998,0,9999,1
1713329074699,CLRE 252,A00,507189,Cuomo; Raphael Eduardo,9998,0,9999,1
1713329075779,CLRE 253,A00,507199,Vaida; Florin,9997,0,9999,2
1713329075779,CLRE 253,B00,507202,Vaida; Florin,9999,0,9999,0
1713329076806,CLRE 259,A00,507211,Patel; Hemal,9996,0,9999,3
1713329077834,CLRE 260,A00,507221,Cuomo; Raphael Eduardo,9999,0,9999,0
1713329078859,CLRE 297,001,507242,Cuomo; Raphael Eduardo,9999,0,9999,0
1713329079884,CSE 191,A00,516875,Minnes Kemp; Mor Mia,9999,0,9999,0
1713329080910,CSS 201S,A01,494383,Staff,35,0,35,0
1713329081939,CSS 202S,A01,494387,Staff,35,0,35,0
1713329082964,EAP 100,A00,516065,Staff,9792,0,9999,207
1713329083989,ECE 45,A01,507414,Staff,51,0,60,9
1713329085018,ECE 100,A01,507416,Baghdadchi; Saharnaz,10,0,20,10
1713329085018,ECE 100,A02,507418,Baghdadchi; Saharnaz,20,0,20,0
1713329086047,ECE 111,A01,507420,Staff,38,0,50,12
1713329087075,ECE 197,001,548057,Sievenpiper; Daniel F.,9998,0,9999,1
1713329088100,EDS 115,A00,507243,Choi; Bailey Miyeon,28,0,28,0
1713329089136,EDS 117,A01,494379,Staff,23,0,25,2
1713329090169,EDS 125,A00,507246,Hopkins; Megan Beth,29,0,30,1
1713329091193,EDS 128A,A01,507264,Fargason; Sharon Gayle,26,0,26,0
1713329092222,EDS 128B,A01,507293,Pappas; Elizabeth,30,0,30,0
1713329093250,EDS 139,A00,507294,Fargason; Sharon Gayle,30,0,30,0
1713329093250,EDS 139,B00,507313,Pappas; Elizabeth,30,0,30,0
1713329094275,EDS 201,A00,507315,Staff,26,0,30,4
1713329095302,EDS 203,A01,507317,Halter; Christopher P.,26,0,30,4
1713329096333,EDS 204R,A01,507319,Halter; Christopher P.,3,0,30,27
1713329096333,EDS 204R,B01,507331,Heinzman; Erica M.,28,0,30,2
1713329097362,EDS 206R,A00,507332,Staff,4,0,30,26
1713329097362,EDS 206R,B00,507343,Staff,28,0,30,2
1713329098393,EDS 250,A00,507344,Hemans; Patricia Ann Benitez,36,0,40,4
1713329099419,EDS 281,A00,507345,Daly; Alan J.,18,0,18,0
1713329100443,EDS 284,A00,507350,Daly; Alan J.,16,0,16,0
1713329101471,EDS 286,A00,507359,Fine; Sarah,18,0,18,0
1713329102498,EDS 289C,A01,507361,Daly; Alan J.,18,0,18,0
1713329103526,EDS 290,A00,507366,Hofstetter; Carolyn,15,0,15,0
1713329104553,LIGM 5A,A00,507421,Fischer-Grunski; Eva K,20,0,20,0
1713329105582,LIGM 5B,A00,507423,Fischer-Grunski; Eva K,20,0,20,0
1713329106606,LIGM 5C,A00,507425,Fischer-Grunski; Eva K,20,0,20,0
1713329107639,LIIT 5AS,A00,507427,Carnelos; Chiara,20,0,20,0
1713329108664,LIIT 5BS,A00,507430,Carnelos; Chiara,20,0,20,0
1713329109692,LIIT 5CS,A00,507432,Carnelos; Chiara,20,0,20,0
1713329110718,LISP 5A,A00,507541,Munoz Sanchez; Alicia,17,0,20,3
1713329111744,LISP 5B,A00,507671,Munoz Sanchez; Alicia,15,0,20,5
1713329112771,LISP 5C,A00,507696,Munoz Sanchez; Alicia,15,0,20,5
1713329113797,MAE 197,001,528363,Boechler; Nicholas Sebastia,9998,0,9999,1
1713329114823,MATH 197,001,523477,Kedlaya; Kiran S.,9999,0,9999,0
1713329114823,MATH 197,002,563811,Zhang; Danna,9999,0,9999,0
1713329115847,MCWP 40R,A00,518780,Staff,20,0,20,0
1713329115847,MCWP 40R,B00,518781,Staff,19,0,20,1
1713329115847,MCWP 40R,C00,518783,Staff,19,0,20,1
1713329116872,MCWP 50R,A00,518791,Staff,20,0,20,0
1713329116872,MCWP 50R,B00,518792,Staff,17,0,20,3
1713329116872,MCWP 50R,C00,518793,Staff,19,0,20,1
1713329116872,MCWP 50R,D00,518794,Staff,16,0,20,4
1713329116872,MCWP 50R,E00,518795,Staff,16,0,20,4
1713329116872,MCWP 50R,F00,518796,Staff,19,0,20,1
1713329116872,MCWP 50R,G00,518797,Staff,19,0,20,1
1713329117898,MMW 12R,A01,514034,Herbst; Matthew,15,0,16,1
1713329117898,MMW 12R,A02,514035,Herbst; Matthew,16,0,16,0
1713329118929,MMW 13R,A01,514037,Staff,12,0,16,4
1713329118929,MMW 13R,A02,514039,Staff,16,0,16,0
1713329120986,SIO 295LS,A00,523233,Staff,19,0,30,11
1713329122015,SIO 295S,A00,523232,Staff,19,0,30,11
1713329123045,SOCI 117,A01,494376,Staff,2,0,5,3
1713329124069,WES 237B,A00,494380,Staff,19,0,20,1
1713329126137,AESE 279B,A00,494370,Wade; Jon P,33,0,33,0
1713329127162,ANAR 135S,A00,494369,Braswell; Geoffrey E.,0,0,0,0
1713329128191,CAT 124RS,A01,519847,Geibel; William,17,0,20,3
1713329129215,CAT 125RS,A01,515971,Geibel; William,17,0,20,3
1713329130244,CLRE 250,A00,511389,Morris; Sheldon,9996,0,9999,3
1713329131270,CLRE 251,A00,507176,Mehta; Ravindra L.,9996,0,9999,3
1713329131270,CLRE 251,B00,511410,Mehta; Ravindra L.,9998,0,9999,1
1713329132296,CLRE 252,A00,507189,Cuomo; Raphael Eduardo,9998,0,9999,1
1713329133322,CLRE 253,A00,507199,Vaida; Florin,9997,0,9999,2
1713329133322,CLRE 253,B00,507202,Vaida; Florin,9999,0,9999,0
1713329134347,CLRE 259,A00,507211,Patel; Hemal,9996,0,9999,3
1713329135376,CLRE 260,A00,507221,Cuomo; Raphael Eduardo,9999,0,9999,0
1713329136404,CLRE 297,001,507242,Cuomo; Raphael Eduardo,9999,0,9999,0
1713329137432,CSE 191,A00,516875,Minnes Kemp; Mor Mia,9999,0,9999,0
1713329138458,CSS 201S,A01,494383,Staff,35,0,35,0
1713329139482,CSS 202S,A01,494387,Staff,35,0,35,0
1713329140509,EAP 100,A00,516065,Staff,9792,0,9999,207
1713329141537,ECE 45,A01,507414,Staff,51,0,60,9
1713329142562,ECE 100,A01,507416,Baghdadchi; Saharnaz,10,0,20,10
1713329142562,ECE 100,A02,507418,Baghdadchi; Saharnaz,20,0,20,0
1713329143586,ECE 111,A01,507420,Staff,38,0,50,12
1713329144614,ECE 197,001,548057,Sievenpiper; Daniel F.,9998,0,9999,1
1713329145642,EDS 115,A00,507243,Choi; Bailey Miyeon,28,0,28,0
1713329146674,EDS 117,A01,494379,Staff,23,0,25,2
1713329147700,EDS 125,A00,507246,Hopkins; Megan Beth,29,0,30,1
1713329148727,EDS 128A,A01,507264,Fargason; Sharon Gayle,26,0,26,0
1713329149755,EDS 128B,A01,507293,Pappas; Elizabeth,30,0,30,0
1713329150782,EDS 139,A00,507294,Fargason; Sharon Gayle,30,0,30,0
1713329150782,EDS 139,B00,507313,Pappas; Elizabeth,30,0,30,0
1713329151810,EDS 201,A00,507315,Staff,26,0,30,4
1713329152844,EDS 203,A01,507317,Halter; Christopher P.,26,0,30,4
1713329153874,EDS 204R,A01,507319,Halter; Christopher P.,3,0,30,27
1713329153874,EDS 204R,B01,507331,Heinzman; Erica M.,28,0,30,2
1713329154900,EDS 206R,A00,507332,Staff,4,0,30,26
1713329154900,EDS 206R,B00,507343,Staff,28,0,30,2
1713329155928,EDS 250,A00,507344,Hemans; Patricia Ann Benitez,36,0,40,4
1713329156957,EDS 281,A00,507345,Daly; Alan J.,18,0,18,0
1713329157985,EDS 284,A00,507350,Daly; Alan J.,16,0,16,0
1713329159014,EDS 286,A00,507359,Fine; Sarah,18,0,18,0
1713329160038,EDS 289C,A01,507361,Daly; Alan J.,18,0,18,0
1713329161068,EDS 290,A00,507366,Hofstetter; Carolyn,15,0,15,0
1713329162095,LIGM 5A,A00,507421,Fischer-Grunski; Eva K,20,0,20,0
1713329163128,LIGM 5B,A00,507423,Fischer-Grunski; Eva K,20,0,20,0
1713329164159,LIGM 5C,A00,507425,Fischer-Grunski; Eva K,20,0,20,0
1713329165189,LIIT 5AS,A00,507427,Carnelos; Chiara,20,0,20,0
1713329166221,LIIT 5BS,A00,507430,Carnelos; Chiara,20,0,20,0
1713329167253,LIIT 5CS,A00,507432,Carnelos; Chiara,20,0,20,0
1713329168279,LISP 5A,A00,507541,Munoz Sanchez; Alicia,17,0,20,3
1713329169308,LISP 5B,A00,507671,Munoz Sanchez; Alicia,15,0,20,5
1713329170336,LISP 5C,A00,507696,Munoz Sanchez; Alicia,15,0,20,5
1713329171362,MAE 197,001,528363,Boechler; Nicholas Sebastia,9998,0,9999,1
1713329172388,MATH 197,001,523477,Kedlaya; Kiran S.,9999,0,9999,0
1713329172388,MATH 197,002,563811,Zhang; Danna,9999,0,9999,0
1713329173419,MCWP 40R,A00,518780,Staff,20,0,20,0
1713329173419,MCWP 40R,B00,518781,Staff,19,0,20,1
1713329173419,MCWP 40R,C00,518783,Staff,19,0,20,1
1713329174447,MCWP 50R,A00,518791,Staff,20,0,20,0
1713329174447,MCWP 50R,B00,518792,Staff,17,0,20,3
1713329174447,MCWP 50R,C00,518793,Staff,19,0,20,1
1713329174447,MCWP 50R,D00,518794,Staff,16,0,20,4
1713329174447,MCWP 50R,E00,518795,Staff,16,0,20,4
1713329174447,MCWP 50R,F00,518796,Staff,19,0,20,1
1713329174447,MCWP 50R,G00,518797,Staff,19,0,20,1
1713329175472,MMW 12R,A01,514034,Herbst; Matthew,15,0,16,1
1713329175472,MMW 12R,A02,514035,Herbst; Matthew,16,0,16,0
1713329176498,MMW 13R,A01,514037,Staff,12,0,16,4
1713329176498,MMW 13R,A02,514039,Staff,16,0,16,0
1713329178559,SIO 295LS,A00,523233,Staff,19,0,30,11
1713329179659,SIO 295S,A00,523232,Staff,19,0,30,11
1713329180684,SOCI 117,A01,494376,Staff,2,0,5,3
1713329181714,WES 237B,A00,494380,Staff,19,0,20,1
1713329183783,AESE 279B,A00,494370,Wade; Jon P,33,0,33,0
1713329184808,ANAR 135S,A00,494369,Braswell; Geoffrey E.,0,0,0,0
1713329185834,CAT 124RS,A01,519847,Geibel; William,17,0,20,3
1713329186858,CAT 125RS,A01,515971,Geibel; William,17,0,20,3
1713329187888,CLRE 250,A00,511389,Morris; Sheldon,9996,0,9999,3
1713329188924,CLRE 251,A00,507176,Mehta; Ravindra L.,9996,0,9999,3
1713329188924,CLRE 251,B00,511410,Mehta; Ravindra L.,9998,0,9999,1
1713329189953,CLRE 252,A00,507189,Cuomo; Raphael Eduardo,9998,0,9999,1
1713329190979,CLRE 253,A00,507199,Vaida; Florin,9997,0,9999,2
1713329190979,CLRE 253,B00,507202,Vaida; Florin,9999,0,9999,0
1713329192008,CLRE 259,A00,507211,Patel; Hemal,9996,0,9999,3
1713329193037,CLRE 260,A00,507221,Cuomo; Raphael Eduardo,9999,0,9999,0
1713329194066,CLRE 297,001,507242,Cuomo; Raphael Eduardo,9999,0,9999,0
1713329195094,CSE 191,A00,516875,Minnes Kemp; Mor Mia,9999,0,9999,0
1713329196125,CSS 201S,A01,494383,Staff,35,0,35,0
1713329197153,CSS 202S,A01,494387,Staff,35,0,35,0
1713329198176,EAP 100,A00,516065,Staff,9792,0,9999,207
1713329199206,ECE 45,A01,507414,Staff,51,0,60,9
1713329200237,ECE 100,A01,507416,Baghdadchi; Saharnaz,10,0,20,10
1713329200237,ECE 100,A02,507418,Baghdadchi; Saharnaz,20,0,20,0
1713329201263,ECE 111,A01,507420,Staff,38,0,50,12
1713329202287,ECE 197,001,548057,Sievenpiper; Daniel F.,9998,0,9999,1
1713329203313,EDS 115,A00,507243,Choi; Bailey Miyeon,28,0,28,0
1713329204340,EDS 117,A01,494379,Staff,23,0,25,2
1713329205368,EDS 125,A00,507246,Hopkins; Megan Beth,29,0,30,1
1713329206392,EDS 128A,A01,507264,Fargason; Sharon Gayle,26,0,26,0
1713329207418,EDS 128B,A01,507293,Pappas; Elizabeth,30,0,30,0
1713329208441,EDS 139,A00,507294,Fargason; Sharon Gayle,30,0,30,0
1713329208441,EDS 139,B00,507313,Pappas; Elizabeth,30,0,30,0
1713329209468,EDS 201,A00,507315,Staff,26,0,30,4
1713329210491,EDS 203,A01,507317,Halter; Christopher P.,26,0,30,4
1713329211520,EDS 204R,A01,507319,Halter; Christopher P.,3,0,30,27
1713329211520,EDS 204R,B01,507331,Heinzman; Erica M.,28,0,30,2
1713329212545,EDS 206R,A00,507332,Staff,4,0,30,26
1713329212545,EDS 206R,B00,507343,Staff,28,0,30,2
1713329213570,EDS 250,A00,507344,Hemans; Patricia Ann Benitez,36,0,40,4
1713329214596,EDS 281,A00,507345,Daly; Alan J.,18,0,18,0
1713329215624,EDS 284,A00,507350,Daly; Alan J.,16,0,16,0
1713329216650,EDS 286,A00,507359,Fine; Sarah,18,0,18,0
1713329217675,EDS 289C,A01,507361,Daly; Alan J.,18,0,18,0
1713329218706,EDS 290,A00,507366,Hofstetter; Carolyn,15,0,15,0
1713329219738,LIGM 5A,A00,507421,Fischer-Grunski; Eva K,20,0,20,0
1713329220763,LIGM 5B,A00,507423,Fischer-Grunski; Eva K,20,0,20,0
1713329221789,LIGM 5C,A00,507425,Fischer-Grunski; Eva K,20,0,20,0
1713329222814,LIIT 5AS,A00,507427,Carnelos; Chiara,20,0,20,0
1713329223839,LIIT 5BS,A00,507430,Carnelos; Chiara,20,0,20,0
1713329224869,LIIT 5CS,A00,507432,Carnelos; Chiara,20,0,20,0
1713329225894,LISP 5A,A00,507541,Munoz Sanchez; Alicia,17,0,20,3
1713329226918,LISP 5B,A00,507671,Munoz Sanchez; Alicia,15,0,20,5
1713329227941,LISP 5C,A00,507696,Munoz Sanchez; Alicia,15,0,20,5
1713329228971,MAE 197,001,528363,Boechler; Nicholas Sebastia,9998,0,9999,1
1713329229998,MATH 197,001,523477,Kedlaya; Kiran S.,9999,0,9999,0
1713329229998,MATH 197,002,563811,Zhang; Danna,9999,0,9999,0
1713329231024,MCWP 40R,A00,518780,Staff,20,0,20,0
1713329231024,MCWP 40R,B00,518781,Staff,19,0,20,1
1713329231024,MCWP 40R,C00,518783,Staff,19,0,20,1
1713329232050,MCWP 50R,A00,518791,Staff,20,0,20,0
1713329232050,MCWP 50R,B00,518792,Staff,17,0,20,3
1713329232050,MCWP 50R,C00,518793,Staff,19,0,20,1
1713329232050,MCWP 50R,D00,518794,Staff,16,0,20,4
1713329232050,MCWP 50R,E00,518795,Staff,16,0,20,4
1713329232050,MCWP 50R,F00,518796,Staff,19,0,20,1
1713329232050,MCWP 50R,G00,518797,Staff,19,0,20,1
1713329233077,MMW 12R,A01,514034,Herbst; Matthew,15,0,16,1
1713329233077,MMW 12R,A02,514035,Herbst; Matthew,16,0,16,0
1713329234101,MMW 13R,A01,514037,Staff,12,0,16,4
1713329234101,MMW 13R,A02,514039,Staff,16,0,16,0
1713329236155,SIO 295LS,A00,523233,Staff,19,0,30,11
1713329237186,SIO 295S,A00,523232,Staff,19,0,30,11
1713329238211,SOCI 117,A01,494376,Staff,2,0,5,3
1713329239240,WES 237B,A00,494380,Staff,19,0,20,1
1713329241314,AESE 279B,A00,494370,Wade; Jon P,33,0,33,0
1713329242339,ANAR 135S,A00,494369,Braswell; Geoffrey E.,0,0,0,0
1713329243368,CAT 124RS,A01,519847,Geibel; William,17,0,20,3
1713329244392,CAT 125RS,A01,515971,Geibel; William,17,0,20,3
1713329245417,CLRE 250,A00,511389,Morris; Sheldon,9996,0,9999,3
1713329246444,CLRE 251,A00,507176,Mehta; Ravindra L.,9996,0,9999,3
1713329246444,CLRE 251,B00,511410,Mehta; Ravindra L.,9998,0,9999,1
1713329247472,CLRE 252,A00,507189,Cuomo; Raphael Eduardo,9998,0,9999,1
1713329248498,CLRE 253,A00,507199,Vaida; Florin,9997,0,9999,2
1713329248498,CLRE 253,B00,507202,Vaida; Florin,9999,0,9999,0
1713329249531,CLRE 259,A00,507211,Patel; Hemal,9996,0,9999,3
1713329250557,CLRE 260,A00,507221,Cuomo; Raphael Eduardo,9999,0,9999,0
1713329251581,CLRE 297,001,507242,Cuomo; Raphael Eduardo,9999,0,9999,0
1713329252609,CSE 191,A00,516875,Minnes Kemp; Mor Mia,9999,0,9999,0
1713329253634,CSS 201S,A01,494383,Staff,35,0,35,0
1713329254660,CSS 202S,A01,494387,Staff,35,0,35,0
1713329255688,EAP 100,A00,516065,Staff,9792,0,9999,207
1713329256713,ECE 45,A01,507414,Staff,51,0,60,9
1713329257738,ECE 100,A01,507416,Baghdadchi; Saharnaz,10,0,20,10
1713329257738,ECE 100,A02,507418,Baghdadchi; Saharnaz,20,0,20,0
1713329258763,ECE 111,A01,507420,Staff,38,0,50,12
1713329259792,ECE 197,001,548057,Sievenpiper; Daniel F.,9998,0,9999,1
1713329260820,EDS 115,A00,507243,Choi; Bailey Miyeon,28,0,28,0
1713329261846,EDS 117,A01,494379,Staff,23,0,25,2
1713329262870,EDS 125,A00,507246,Hopkins; Megan Beth,29,0,30,1
1713329263903,EDS 128A,A01,507264,Fargason; Sharon Gayle,26,0,26,0
1713329264982,EDS 128B,A01,507293,Pappas; Elizabeth,30,0,30,0
1713329266013,EDS 139,A00,507294,Fargason; Sharon Gayle,30,0,30,0
1713329266013,EDS 139,B00,507313,Pappas; Elizabeth,30,0,30,0
1713329267038,EDS 201,A00,507315,Staff,26,0,30,4
1713329268069,EDS 203,A01,507317,Halter; Christopher P.,26,0,30,4
1713329269103,EDS 204R,A01,507319,Halter; Christopher P.,3,0,30,27
1713329269103,EDS 204R,B01,507331,Heinzman; Erica M.,28,0,30,2
1713329270130,EDS 206R,A00,507332,Staff,4,0,30,26
1713329270130,EDS 206R,B00,507343,Staff,28,0,30,2
1713329271155,EDS 250,A00,507344,Hemans; Patricia Ann Benitez,36,0,40,4
1713329272184,EDS 281,A00,507345,Daly; Alan J.,18,0,18,0
1713329273208,EDS 284,A00,507350,Daly; Alan J.,16,0,16,0
1713329274232,EDS 286,A00,507359,Fine; Sarah,18,0,18,0
1713329275260,EDS 289C,A01,507361,Daly; Alan J.,18,0,18,0
1713329276288,EDS 290,A00,507366,Hofstetter; Carolyn,15,0,15,0
1713329277314,LIGM 5A,A00,507421,Fischer-Grunski; Eva K,20,0,20,0
1713329278340,LIGM 5B,A00,507423,Fischer-Grunski; Eva K,20,0,20,0
1713329279365,LIGM 5C,A00,507425,Fischer-Grunski; Eva K,20,0,20,0
1713329280389,LIIT 5AS,A00,507427,Carnelos; Chiara,20,0,20,0
1713329292934,LIIT 5BS,A00,507430,Carnelos; Chiara,20,0,20,0
1713329293964,LIIT 5CS,A00,507432,Carnelos; Chiara,20,0,20,0
1713329295050,LISP 5A,A00,507541,Munoz Sanchez; Alicia,17,0,20,3
1713329296075,LISP 5B,A00,507671,Munoz Sanchez; Alicia,15,0,20,5
1713329297103,LISP 5C,A00,507696,Munoz Sanchez; Alicia,15,0,20,5
1713329298129,MAE 197,001,528363,Boechler; Nicholas Sebastia,9998,0,9999,1
1713329299161,MATH 197,001,523477,Kedlaya; Kiran S.,9999,0,9999,0
1713329299161,MATH 197,002,563811,Zhang; Danna,9999,0,9999,0
1713329300187,MCWP 40R,A00,518780,Staff,20,0,20,0
1713329300187,MCWP 40R,B00,518781,Staff,19,0,20,1
1713329300187,MCWP 40R,C00,518783,Staff,19,0,20,1
1713329301213,MCWP 50R,A00,518791,Staff,20,0,20,0
1713329301213,MCWP 50R,B00,518792,Staff,17,0,20,3
1713329301213,MCWP 50R,C00,518793,Staff,19,0,20,1
1713329301213,MCWP 50R,D00,518794,Staff,16,0,20,4
1713329301213,MCWP 50R,E00,518795,Staff,16,0,20,4
1713329301213,MCWP 50R,F00,518796,Staff,19,0,20,1
1713329301213,MCWP 50R,G00,518797,Staff,19,0,20,1
1713329302242,MMW 12R,A01,514034,Herbst; Matthew,15,0,16,1
1713329302242,MMW 12R,A02,514035,Herbst; Matthew,16,0,16,0
1713329303266,MMW 13R,A01,514037,Staff,12,0,16,4
1713329303266,MMW 13R,A02,514039,Staff,16,0,16,0
1713329305318,SIO 295LS,A00,523233,Staff,19,0,30,11
1713329306343,SIO 295S,A00,523232,Staff,19,0,30,11
1713329307371,SOCI 117,A01,494376,Staff,2,0,5,3
1713329308394,WES 237B,A00,494380,Staff,19,0,20,1
1713329310473,AESE 279B,A00,494370,Wade; Jon P,33,0,33,0
1713329311500,ANAR 135S,A00,494369,Braswell; Geoffrey E.,0,0,0,0
1713329312524,CAT 124RS,A01,519847,Geibel; William,17,0,20,3
1713329313553,CAT 125RS,A01,515971,Geibel; William,17,0,20,3
1713329314580,CLRE 250,A00,511389,Morris; Sheldon,9996,0,9999,3
1713329315611,CLRE 251,A00,507176,Mehta; Ravindra L.,9996,0,9999,3
1713329315611,CLRE 251,B00,511410,Mehta; Ravindra L.,9998,0,9999,1
1713329316636,CLRE 252,A00,507189,Cuomo; Raphael Eduardo,9998,0,9999,1
1713329317662,CLRE 253,A00,507199,Vaida; Florin,9997,0,9999,2
1713329317662,CLRE 253,B00,507202,Vaida; Florin,9999,0,9999,0
1713329318690,CLRE 259,A00,507211,Patel; Hemal,9996,0,9999,3
1713329319719,CLRE 260,A00,507221,Cuomo; Raphael Eduardo,9999,0,9999,0
1713329320746,CLRE 297,001,507242,Cuomo; Raphael Eduardo,9999,0,9999,0
1713329321771,CSE 191,A00,516875,Minnes Kemp; Mor Mia,9999,0,9999,0
1713329322796,CSS 201S,A01,494383,Staff,35,0,35,0
1713329323821,CSS 202S,A01,494387,Staff,35,0,35,0
1713329324844,EAP 100,A00,516065,Staff,9792,0,9999,207
1713329325872,ECE 45,A01,507414,Staff,51,0,60,9
1713329326902,ECE 100,A01,507416,Baghdadchi; Saharnaz,10,0,20,10
1713329326902,ECE 100,A02,507418,Baghdadchi; Saharnaz,20,0,20,0
1713329327929,ECE 111,A01,507420,Staff,38,0,50,12
1713329328956,ECE 197,001,548057,Sievenpiper; Daniel F.,9998,0,9999,1
1713329329982,EDS 115,A00,507243,Choi; Bailey Miyeon,28,0,28,0
1713329331008,EDS 117,A01,494379,Staff,23,0,25,2
1713329332039,EDS 125,A00,507246,Hopkins; Megan Beth,29,0,30,1
1713329333068,EDS 128A,A01,507264,Fargason; Sharon Gayle,26,0,26,0
1713329334093,EDS 128B,A01,507293,Pappas; Elizabeth,30,0,30,0
1713329335119,EDS 139,A00,507294,Fargason; Sharon Gayle,30,0,30,0
1713329335119,EDS 139,B00,507313,Pappas; Elizabeth,30,0,30,0
1713329336147,EDS 201,A00,507315,Staff,26,0,30,4
1713329337173,EDS 203,A01,507317,Halter; Christopher P.,26,0,30,4
1713329338199,EDS 204R,A01,507319,Halter; Christopher P.,3,0,30,27
1713329338199,EDS 204R,B01,507331,Heinzman; Erica M.,28,0,30,2
1713329339225,EDS 206R,A00,507332,Staff,4,0,30,26
1713329339225,EDS 206R,B00,507343,Staff,28,0,30,2
1713329340255,EDS 250,A00,507344,Hemans; Patricia Ann Benitez,36,0,40,4
1713329341283,EDS 281,A00,507345,Daly; Alan J.,18,0,18,0
1713329342310,EDS 284,A00,507350,Daly; Alan J.,16,0,16,0
1713329343340,EDS 286,A00,507359,Fine; Sarah,18,0,18,0
1713329344368,EDS 289C,A01,507361,Daly; Alan J.,18,0,18,0
1713329345398,EDS 290,A00,507366,Hofstetter; Carolyn,15,0,15,0
1713329346429,LIGM 5A,A00,507421,Fischer-Grunski; Eva K,20,0,20,0
1713329347455,LIGM 5B,A00,507423,Fischer-Grunski; Eva K,20,0,20,0
1713329348480,LIGM 5C,A00,507425,Fischer-Grunski; Eva K,20,0,20,0
1713329349512,LIIT 5AS,A00,507427,Carnelos; Chiara,20,0,20,0
1713329350539,LIIT 5BS,A00,507430,Carnelos; Chiara,20,0,20,0
1713329351565,LIIT 5CS,A00,507432,Carnelos; Chiara,20,0,20,0
1713329352591,LISP 5A,A00,507541,Munoz Sanchez; Alicia,17,0,20,3
1713329353618,LISP 5B,A00,507671,Munoz Sanchez; Alicia,15,0,20,5
1713329354647,LISP 5C,A00,507696,Munoz Sanchez; Alicia,15,0,20,5
1713329355672,MAE 197,001,528363,Boechler; Nicholas Sebastia,9998,0,9999,1
1713329356698,MATH 197,001,523477,Kedlaya; Kiran S.,9999,0,9999,0
1713329356698,MATH 197,002,563811,Zhang; Danna,9999,0,9999,0
1713329357724,MCWP 40R,A00,518780,Staff,20,0,20,0
1713329357724,MCWP 40R,B00,518781,Staff,19,0,20,1
1713329357724,MCWP 40R,C00,518783,Staff,19,0,20,1
1713329358752,MCWP 50R,A00,518791,Staff,20,0,20,0
1713329358752,MCWP 50R,B00,518792,Staff,17,0,20,3
1713329358752,MCWP 50R,C00,518793,Staff,19,0,20,1
1713329358752,MCWP 50R,D00,518794,Staff,16,0,20,4
1713329358752,MCWP 50R,E00,518795,Staff,16,0,20,4
1713329358752,MCWP 50R,F00,518796,Staff,19,0,20,1
1713329358752,MCWP 50R,G00,518797,Staff,19,0,20,1
1713329359784,MMW 12R,A01,514034,Herbst; Matthew,15,0,16,1
1713329359784,MMW 12R,A02,514035,Herbst; Matthew,16,0,16,0
1713329360810,MMW 13R,A01,514037,Staff,12,0,16,4
1713329360810,MMW 13R,A02,514039,Staff,16,0,16,0
1713329362863,SIO 295LS,A00,523233,Staff,19,0,30,11
1713329363904,SIO 295S,A00,523232,Staff,19,0,30,11
1713329364933,SOCI 117,A01,494376,Staff,2,0,5,3
1713329365959,WES 237B,A00,494380,Staff,19,0,20,1
1713329368027,AESE 279B,A00,494370,Wade; Jon P,33,0,33,0
1713329369057,ANAR 135S,A00,494369,Braswell; Geoffrey E.,0,0,0,0
1713329370082,CAT 124RS,A01,519847,Geibel; William,17,0,20,3
1713329371106,CAT 125RS,A01,515971,Geibel; William,17,0,20,3
1713329372131,CLRE 250,A00,511389,Morris; Sheldon,9996,0,9999,3
1713329373157,CLRE 251,A00,507176,Mehta; Ravindra L.,9996,0,9999,3
1713329373157,CLRE 251,B00,511410,Mehta; Ravindra L.,9998,0,9999,1
1713329374180,CLRE 252,A00,507189,Cuomo; Raphael Eduardo,9998,0,9999,1
1713329375205,CLRE 253,A00,507199,Vaida; Florin,9997,0,9999,2
1713329375205,CLRE 253,B00,507202,Vaida; Florin,9999,0,9999,0
1713329376233,CLRE 259,A00,507211,Patel; Hemal,9996,0,9999,3
1713329377256,CLRE 260,A00,507221,Cuomo; Raphael Eduardo,9999,0,9999,0
1713329378284,CLRE 297,001,507242,Cuomo; Raphael Eduardo,9999,0,9999,0
1713329379311,CSE 191,A00,516875,Minnes Kemp; Mor Mia,9999,0,9999,0
1713329380338,CSS 201S,A01,494383,Staff,35,0,35,0
1713329381367,CSS 202S,A01,494387,Staff,35,0,35,0
1713329382390,EAP 100,A00,516065,Staff,9792,0,9999,207
1713329383415,ECE 45,A01,507414,Staff,51,0,60,9
1713329384443,ECE 100,A01,507416,Baghdadchi; Saharnaz,10,0,20,10
1713329384443,ECE 100,A02,507418,Baghdadchi; Saharnaz,20,0,20,0
1713329385466,ECE 111,A01,507420,Staff,38,0,50,12
1713329386491,ECE 197,001,548057,Sievenpiper; Daniel F.,9998,0,9999,1
1713329387518,EDS 115,A00,507243,Choi; Bailey Miyeon,28,0,28,0
1713329388545,EDS 117,A01,494379,Staff,23,0,25,2
1713329389569,EDS 125,A00,507246,Hopkins; Megan Beth,29,0,30,1
1713329390596,EDS 128A,A01,507264,Fargason; Sharon Gayle,26,0,26,0
1713329391622,EDS 128B,A01,507293,Pappas; Elizabeth,30,0,30,0
1713329392648,EDS 139,A00,507294,Fargason; Sharon Gayle,30,0,30,0
1713329392648,EDS 139,B00,507313,Pappas; Elizabeth,30,0,30,0
1713329393677,EDS 201,A00,507315,Staff,26,0,30,4
1713329394703,EDS 203,A01,507317,Halter; Christopher P.,26,0,30,4
1713329395728,EDS 204R,A01,507319,Halter; Christopher P.,3,0,30,27
1713329395728,EDS 204R,B01,507331,Heinzman; Erica M.,28,0,30,2
1713329396752,EDS 206R,A00,507332,Staff,4,0,30,26
1713329396752,EDS 206R,B00,507343,Staff,28,0,30,2
1713329397777,EDS 250,A00,507344,Hemans; Patricia Ann Benitez,36,0,40,4
1713329398871,EDS 281,A00,507345,Daly; Alan J.,18,0,18,0
1713329399896,EDS 284,A00,507350,Daly; Alan J.,16,0,16,0
1713329400921,EDS 286,A00,507359,Fine; Sarah,18,0,18,0
1713329401951,EDS 289C,A01,507361,Daly; Alan J.,18,0,18,0
1713329402975,EDS 290,A00,507366,Hofstetter; Carolyn,15,0,15,0
1713329404002,LIGM 5A,A00,507421,Fischer-Grunski; Eva K,20,0,20,0
1713329405028,LIGM 5B,A00,507423,Fischer-Grunski; Eva K,20,0,20,0
1713329406058,LIGM 5C,A00,507425,Fischer-Grunski; Eva K,20,0,20,0
1713329407083,LIIT 5AS,A00,507427,Carnelos; Chiara,20,0,20,0
1713329408107,LIIT 5BS,A00,507430,Carnelos; Chiara,20,0,20,0
1713329409132,LIIT 5CS,A00,507432,Carnelos; Chiara,20,0,20,0
1713329410156,LISP 5A,A00,507541,Munoz Sanchez; Alicia,17,0,20,3
1713329411184,LISP 5B,A00,507671,Munoz Sanchez; Alicia,15,0,20,5
1713329412209,LISP 5C,A00,507696,Munoz Sanchez; Alicia,15,0,20,5
1713329413236,MAE 197,001,528363,Boechler; Nicholas Sebastia,9998,0,9999,1
1713329414263,MATH 197,001,523477,Kedlaya; Kiran S.,9999,0,9999,0
1713329414263,MATH 197,002,563811,Zhang; Danna,9999,0,9999,0
1713329415290,MCWP 40R,A00,518780,Staff,20,0,20,0
1713329415290,MCWP 40R,B00,518781,Staff,19,0,20,1
1713329415290,MCWP 40R,C00,518783,Staff,19,0,20,1
1713329416315,MCWP 50R,A00,518791,Staff,20,0,20,0
1713329416315,MCWP 50R,B00,518792,Staff,17,0,20,3
1713329416315,MCWP 50R,C00,518793,Staff,19,0,20,1
1713329416315,MCWP 50R,D00,518794,Staff,16,0,20,4
1713329416315,MCWP 50R,E00,518795,Staff,16,0,20,4
1713329416315,MCWP 50R,F00,518796,Staff,19,0,20,1
1713329416315,MCWP 50R,G00,518797,Staff,19,0,20,1
1713329417343,MMW 12R,A01,514034,Herbst; Matthew,15,0,16,1
1713329417343,MMW 12R,A02,514035,Herbst; Matthew,16,0,16,0
1713329418370,MMW 13R,A01,514037,Staff,12,0,16,4
1713329418370,MMW 13R,A02,514039,Staff,16,0,16,0
1713329420424,SIO 295LS,A00,523233,Staff,19,0,30,11
1713329421448,SIO 295S,A00,523232,Staff,19,0,30,11
1713329422473,SOCI 117,A01,494376,Staff,2,0,5,3
1713329423502,WES 237B,A00,494380,Staff,19,0,20,1
1713329425570,AESE 279B,A00,494370,Wade; Jon P,33,0,33,0
1713329426595,ANAR 135S,A00,494369,Braswell; Geoffrey E.,0,0,0,0
1713329427620,CAT 124RS,A01,519847,Geibel; William,17,0,20,3
1713329428648,CAT 125RS,A01,515971,Geibel; William,17,0,20,3
1713329429677,CLRE 250,A00,511389,Morris; Sheldon,9996,0,9999,3
1713329430705,CLRE 251,A00,507176,Mehta; Ravindra L.,9996,0,9999,3
1713329430705,CLRE 251,B00,511410,Mehta; Ravindra L.,9998,0,9999,1
1713329431731,CLRE 252,A00,507189,Cuomo; Raphael Eduardo,9998,0,9999,1
1713329432759,CLRE 253,A00,507199,Vaida; Florin,9997,0,9999,2
1713329432759,CLRE 253,B00,507202,Vaida; Florin,9999,0,9999,0
1713329433785,CLRE 259,A00,507211,Patel; Hemal,9996,0,9999,3
1713329434810,CLRE 260,A00,507221,Cuomo; Raphael Eduardo,9999,0,9999,0
1713329435835,CLRE 297,001,507242,Cuomo; Raphael Eduardo,9999,0,9999,0
1713329436883,CSE 191,A00,516875,Minnes Kemp; Mor Mia,9999,0,9999,0
1713329437910,CSS 201S,A01,494383,Staff,35,0,35,0
1713329438936,CSS 202S,A01,494387,Staff,35,0,35,0
1713329439979,EAP 100,A00,516065,Staff,9792,0,9999,207
1713329441008,ECE 45,A01,507414,Staff,51,0,60,9
1713329442035,ECE 100,A01,507416,Baghdadchi; Saharnaz,10,0,20,10
1713329442035,ECE 100,A02,507418,Baghdadchi; Saharnaz,20,0,20,0
1713329443060,ECE 111,A01,507420,Staff,38,0,50,12
1713329444084,ECE 197,001,548057,Sievenpiper; Daniel F.,9998,0,9999,1
1713329445110,EDS 115,A00,507243,Choi; Bailey Miyeon,28,0,28,0
1713329446136,EDS 117,A01,494379,Staff,23,0,25,2
1713329447167,EDS 125,A00,507246,Hopkins; Megan Beth,29,0,30,1
1713329448196,EDS 128A,A01,507264,Fargason; Sharon Gayle,26,0,26,0
1713329449222,EDS 128B,A01,507293,Pappas; Elizabeth,30,0,30,0
1713329450249,EDS 139,A00,507294,Fargason; Sharon Gayle,30,0,30,0
1713329450249,EDS 139,B00,507313,Pappas; Elizabeth,30,0,30,0
1713329451277,EDS 201,A00,507315,Staff,26,0,30,4
1713329452308,EDS 203,A01,507317,Halter; Christopher P.,26,0,30,4
1713329453336,EDS 204R,A01,507319,Halter; Christopher P.,3,0,30,27
1713329453336,EDS 204R,B01,507331,Heinzman; Erica M.,28,0,30,2
1713329454360,EDS 206R,A00,507332,Staff,4,0,30,26
1713329454360,EDS 206R,B00,507343,Staff,28,0,30,2
1713329455389,EDS 250,A00,507344,Hemans; Patricia Ann Benitez,36,0,40,4
1713329456413,EDS 281,A00,507345,Daly; Alan J.,18,0,18,0
1713329457440,EDS 284,A00,507350,Daly; Alan J.,16,0,16,0
1713329458466,EDS 286,A00,507359,Fine; Sarah,18,0,18,0
1713329459491,EDS 289C,A01,507361,Daly; Alan J.,18,0,18,0
1713329460517,EDS 290,A00,507366,Hofstetter; Carolyn,15,0,15,0
1713329461544,LIGM 5A,A00,507421,Fischer-Grunski; Eva K,20,0,20,0
1713329462568,LIGM 5B,A00,507423,Fischer-Grunski; Eva K,20,0,20,0
1713329463598,LIGM 5C,A00,507425,Fischer-Grunski; Eva K,20,0,20,0
1713329464625,LIIT 5AS,A00,507427,Carnelos; Chiara,20,0,20,0
1713329465654,LIIT 5BS,A00,507430,Carnelos; Chiara,20,0,20,0
1713329466681,LIIT 5CS,A00,507432,Carnelos; Chiara,20,0,20,0
1713329467712,LISP 5A,A00,507541,Munoz Sanchez; Alicia,17,0,20,3
1713329468740,LISP 5B,A00,507671,Munoz Sanchez; Alicia,15,0,20,5
1713329469770,LISP 5C,A00,507696,Munoz Sanchez; Alicia,15,0,20,5
1713329470802,MAE 197,001,528363,Boechler; Nicholas Sebastia,9998,0,9999,1
1713329471837,MATH 197,001,523477,Kedlaya; Kiran S.,9999,0,9999,0
1713329471837,MATH 197,002,563811,Zhang; Danna,9999,0,9999,0
1713329472865,MCWP 40R,A00,518780,Staff,20,0,20,0
1713329472865,MCWP 40R,B00,518781,Staff,19,0,20,1
1713329472865,MCWP 40R,C00,518783,Staff,19,0,20,1
1713329473889,MCWP 50R,A00,518791,Staff,20,0,20,0
1713329473889,MCWP 50R,B00,518792,Staff,17,0,20,3
1713329473889,MCWP 50R,C00,518793,Staff,19,0,20,1
1713329473889,MCWP 50R,D00,518794,Staff,16,0,20,4
1713329473889,MCWP 50R,E00,518795,Staff,16,0,20,4
1713329473889,MCWP 50R,F00,518796,Staff,19,0,20,1
1713329473889,MCWP 50R,G00,518797,Staff,19,0,20,1
1713329474918,MMW 12R,A01,514034,Herbst; Matthew,15,0,16,1
1713329474918,MMW 12R,A02,514035,Herbst; Matthew,16,0,16,0
1713329475942,MMW 13R,A01,514037,Staff,12,0,16,4
1713329475942,MMW 13R,A02,514039,Staff,16,0,16,0
1713329477992,SIO 295LS,A00,523233,Staff,19,0,30,11
1713329479022,SIO 295S,A00,523232,Staff,19,0,30,11
1713329480050,SOCI 117,A01,494376,Staff,2,0,5,3
1713329481077,WES 237B,A00,494380,Staff,19,0,20,1
1713329483153,AESE 279B,A00,494370,Wade; Jon P,33,0,33,0
1713329484181,ANAR 135S,A00,494369,Braswell; Geoffrey E.,0,0,0,0
1713329485205,CAT 124RS,A01,519847,Geibel; William,17,0,20,3
1713329486231,CAT 125RS,A01,515971,Geibel; William,17,0,20,3
1713329487257,CLRE 250,A00,511389,Morris; Sheldon,9996,0,9999,3
1713329488282,CLRE 251,A00,507176,Mehta; Ravindra L.,9996,0,9999,3
1713329488282,CLRE 251,B00,511410,Mehta; Ravindra L.,9998,0,9999,1
1713329489310,CLRE 252,A00,507189,Cuomo; Raphael Eduardo,9998,0,9999,1
1713329490340,CLRE 253,A00,507199,Vaida; Florin,9997,0,9999,2
1713329490340,CLRE 253,B00,507202,Vaida; Florin,9999,0,9999,0
1713329491890,CLRE 259,A00,507211,Patel; Hemal,9996,0,9999,3
1713329492915,CLRE 260,A00,507221,Cuomo; Raphael Eduardo,9999,0,9999,0
1713329493941,CLRE 297,001,507242,Cuomo; Raphael Eduardo,9999,0,9999,0
1713329494966,CSE 191,A00,516875,Minnes Kemp; Mor Mia,9999,0,9999,0
1713329495991,CSS 201S,A01,494383,Staff,35,0,35,0
1713329497017,CSS 202S,A01,494387,Staff,35,0,35,0
1713329498043,EAP 100,A00,516065,Staff,9792,0,9999,207
1713329499069,ECE 45,A01,507414,Staff,51,0,60,9
1713329500095,ECE 100,A01,507416,Baghdadchi; Saharnaz,10,0,20,10
1713329500095,ECE 100,A02,507418,Baghdadchi; Saharnaz,20,0,20,0
1713329501124,ECE 111,A01,507420,Staff,38,0,50,12
1713329502150,ECE 197,001,548057,Sievenpiper; Daniel F.,9998,0,9999,1
1713329503230,EDS 115,A00,507243,Choi; Bailey Miyeon,28,0,28,0
1713329504256,EDS 117,A01,494379,Staff,23,0,25,2
1713329505282,EDS 125,A00,507246,Hopkins; Megan Beth,29,0,30,1
1713329506308,EDS 128A,A01,507264,Fargason; Sharon Gayle,26,0,26,0
1713329507334,EDS 128B,A01,507293,Pappas; Elizabeth,30,0,30,0
1713329508358,EDS 139,A00,507294,Fargason; Sharon Gayle,30,0,30,0
1713329508358,EDS 139,B00,507313,Pappas; Elizabeth,30,0,30,0
1713329509387,EDS 201,A00,507315,Staff,26,0,30,4
1713329510413,EDS 203,A01,507317,Halter; Christopher P.,26,0,30,4
1713329511439,EDS 204R,A01,507319,Halter; Christopher P.,3,0,30,27
1713329511439,EDS 204R,B01,507331,Heinzman; Erica M.,28,0,30,2
1713329512466,EDS 206R,A00,507332,Staff,4,0,30,26
1713329512466,EDS 206R,B00,507343,Staff,28,0,30,2
1713329513491,EDS 250,A00,507344,Hemans; Patricia Ann Benitez,36,0,40,4
1713329514518,EDS 281,A00,507345,Daly; Alan J.,18,0,18,0
1713329515543,EDS 284,A00,507350,Daly; Alan J.,16,0,16,0
1713329516569,EDS 286,A00,507359,Fine; Sarah,18,0,18,0
1713329517595,EDS 289C,A01,507361,Daly; Alan J.,18,0,18,0
1713329518625,EDS 290,A00,507366,Hofstetter; Carolyn,15,0,15,0
1713329519652,LIGM 5A,A00,507421,Fischer-Grunski; Eva K,20,0,20,0
1713329520681,LIGM 5B,A00,507423,Fischer-Grunski; Eva K,20,0,20,0
1713329521709,LIGM 5C,A00,507425,Fischer-Grunski; Eva K,20,0,20,0
1713329522738,LIIT 5AS,A00,507427,Carnelos; Chiara,20,0,20,0
1713329523766,LIIT 5BS,A00,507430,Carnelos; Chiara,20,0,20,0
1713329524792,LIIT 5CS,A00,507432,Carnelos; Chiara,20,0,20,0
1713329525819,LISP 5A,A00,507541,Munoz Sanchez; Alicia,17,0,20,3
1713329526844,LISP 5B,A00,507671,Munoz Sanchez; Alicia,15,0,20,5
1713329527873,LISP 5C,A00,507696,Munoz Sanchez; Alicia,15,0,20,5
1713329528902,MAE 197,001,528363,Boechler; Nicholas Sebastia,9998,0,9999,1
1713329529927,MATH 197,001,523477,Kedlaya; Kiran S.,9999,0,9999,0
1713329529927,MATH 197,002,563811,Zhang; Danna,9999,0,9999,0
1713329530953,MCWP 40R,A00,518780,Staff,20,0,20,0
1713329530953,MCWP 40R,B00,518781,Staff,19,0,20,1
1713329530953,MCWP 40R,C00,518783,Staff,19,0,20,1
1713329531984,MCWP 50R,A00,518791,Staff,20,0,20,0
1713329531984,MCWP 50R,B00,518792,Staff,17,0,20,3
1713329531984,MCWP 50R,C00,518793,Staff,19,0,20,1
1713329531984,MCWP 50R,D00,518794,Staff,16,0,20,4
1713329531984,MCWP 50R,E00,518795,Staff,16,0,20,4
1713329531984,MCWP 50R,F00,518796,Staff,19,0,20,1
1713329531984,MCWP 50R,G00,518797,Staff,19,0,20,1
1713329533013,MMW 12R,A01,514034,Herbst; Matthew,15,0,16,1
1713329533013,MMW 12R,A02,514035,Herbst; Matthew,16,0,16,0
1713329534042,MMW 13R,A01,514037,Staff,12,0,16,4
1713329534042,MMW 13R,A02,514039,Staff,16,0,16,0
1713329536096,SIO 295LS,A00,523233,Staff,19,0,30,11
1713329537121,SIO 295S,A00,523232,Staff,19,0,30,11
1713329538151,SOCI 117,A01,494376,Staff,2,0,5,3
1713329539177,WES 237B,A00,494380,Staff,19,0,20,1
1713329541243,AESE 279B,A00,494370,Wade; Jon P,33,0,33,0
1713329542269,ANAR 135S,A00,494369,Braswell; Geoffrey E.,0,0,0,0
1713329543299,CAT 124RS,A01,519847,Geibel; William,17,0,20,3
1713329544324,CAT 125RS,A01,515971,Geibel; William,17,0,20,3
1713329545352,CLRE 250,A00,511389,Morris; Sheldon,9996,0,9999,3
1713329546380,CLRE 251,A00,507176,Mehta; Ravindra L.,9996,0,9999,3
1713329546380,CLRE 251,B00,511410,Mehta; Ravindra L.,9998,0,9999,1
1713329547410,CLRE 252,A00,507189,Cuomo; Raphael Eduardo,9998,0,9999,1
1713329548441,CLRE 253,A00,507199,Vaida; Florin,9997,0,9999,2
1713329548441,CLRE 253,B00,507202,Vaida; Florin,9999,0,9999,0
1713329549466,CLRE 259,A00,507211,Patel; Hemal,9996,0,9999,3
1713329550495,CLRE 260,A00,507221,Cuomo; Raphael Eduardo,9999,0,9999,0
1713329551520,CLRE 297,001,507242,Cuomo; Raphael Eduardo,9999,0,9999,0
1713329552548,CSE 191,A00,516875,Minnes Kemp; Mor Mia,9999,0,9999,0
1713329553574,CSS 201S,A01,494383,Staff,35,0,35,0
1713329554605,CSS 202S,A01,494387,Staff,35,0,35,0
1713329555633,EAP 100,A00,516065,Staff,9792,0,9999,207
1713329556660,ECE 45,A01,507414,Staff,51,0,60,9
1713329557693,ECE 100,A01,507416,Baghdadchi; Saharnaz,10,0,20,10
1713329557693,ECE 100,A02,507418,Baghdadchi; Saharnaz,20,0,20,0
1713329558723,ECE 111,A01,507420,Staff,38,0,50,12
1713329559754,ECE 197,001,548057,Sievenpiper; Daniel F.,9998,0,9999,1
1713329560779,EDS 115,A00,507243,Choi; Bailey Miyeon,28,0,28,0
1713329561810,EDS 117,A01,494379,Staff,23,0,25,2
1713329562836,EDS 125,A00,507246,Hopkins; Megan Beth,29,0,30,1
1713329563873,EDS 128A,A01,507264,Fargason; Sharon Gayle,26,0,26,0
1713329564900,EDS 128B,A01,507293,Pappas; Elizabeth,30,0,30,0
1713329565927,EDS 139,A00,507294,Fargason; Sharon Gayle,30,0,30,0
1713329565927,EDS 139,B00,507313,Pappas; Elizabeth,30,0,30,0
1713329566954,EDS 201,A00,507315,Staff,26,0,30,4
1713329567980,EDS 203,A01,507317,Halter; Christopher P.,26,0,30,4
1713329569005,EDS 204R,A01,507319,Halter; Christopher P.,3,0,30,27
1713329569005,EDS 204R,B01,507331,Heinzman; Erica M.,28,0,30,2
1713329570032,EDS 206R,A00,507332,Staff,4,0,30,26
1713329570032,EDS 206R,B00,507343,Staff,28,0,30,2
1713329571059,EDS 250,A00,507344,Hemans; Patricia Ann Benitez,36,0,40,4
1713329572083,EDS 281,A00,507345,Daly; Alan J.,18,0,18,0
1713329573107,EDS 284,A00,507350,Daly; Alan J.,16,0,16,0
1713329574136,EDS 286,A00,507359,Fine; Sarah,18,0,18,0
1713329575160,EDS 289C,A01,507361,Daly; Alan J.,18,0,18,0
1713329576190,EDS 290,A00,507366,Hofstetter; Carolyn,15,0,15,0
1713329577219,LIGM 5A,A00,507421,Fischer-Grunski; Eva K,20,0,20,0
1713329578248,LIGM 5B,A00,507423,Fischer-Grunski; Eva K,20,0,20,0
1713329579273,LIGM 5C,A00,507425,Fischer-Grunski; Eva K,20,0,20,0
1713329580299,LIIT 5AS,A00,507427,Carnelos; Chiara,20,0,20,0
1713329581325,LIIT 5BS,A00,507430,Carnelos; Chiara,20,0,20,0
1713329582354,LIIT 5CS,A00,507432,Carnelos; Chiara,20,0,20,0
1713329583381,LISP 5A,A00,507541,Munoz Sanchez; Alicia,17,0,20,3
1713329584407,LISP 5B,A00,507671,Munoz Sanchez; Alicia,15,0,20,5
1713329585437,LISP 5C,A00,507696,Munoz Sanchez; Alicia,15,0,20,5
1713329586462,MAE 197,001,528363,Boechler; Nicholas Sebastia,9998,0,9999,1
1713329587488,MATH 197,001,523477,Kedlaya; Kiran S.,9999,0,9999,0
1713329587488,MATH 197,002,563811,Zhang; Danna,9999,0,9999,0
1713329588513,MCWP 40R,A00,518780,Staff,20,0,20,0
1713329588513,MCWP 40R,B00,518781,Staff,19,0,20,1
1713329588513,MCWP 40R,C00,518783,Staff,19,0,20,1
1713329589539,MCWP 50R,A00,518791,Staff,20,0,20,0
1713329589539,MCWP 50R,B00,518792,Staff,17,0,20,3
1713329589539,MCWP 50R,C00,518793,Staff,19,0,20,1
1713329589539,MCWP 50R,D00,518794,Staff,16,0,20,4
1713329589539,MCWP 50R,E00,518795,Staff,16,0,20,4
1713329589539,MCWP 50R,F00,518796,Staff,19,0,20,1
1713329589539,MCWP 50R,G00,518797,Staff,19,0,20,1
1713329590566,MMW 12R,A01,514034,Herbst; Matthew,15,0,16,1
1713329590566,MMW 12R,A02,514035,Herbst; Matthew,16,0,16,0
1713329591591,MMW 13R,A01,514037,Staff,12,0,16,4
1713329591591,MMW 13R,A02,514039,Staff,16,0,16,0
1713329593640,SIO 295LS,A00,523233,Staff,19,0,30,11
1713329594666,SIO 295S,A00,523232,Staff,19,0,30,11
1713329595691,SOCI 117,A01,494376,Staff,2,0,5,3
1713329596720,WES 237B,A00,494380,Staff,19,0,20,1
1713329598789,AESE 279B,A00,494370,Wade; Jon P,33,0,33,0
1713329599812,ANAR 135S,A00,494369,Braswell; Geoffrey E.,0,0,0,0
1713329600839,CAT 124RS,A01,519847,Geibel; William,17,0,20,3
1713329601865,CAT 125RS,A01,515971,Geibel; William,17,0,20,3
1713329602893,CLRE 250,A00,511389,Morris; Sheldon,9996,0,9999,3
1713329603920,CLRE 251,A00,507176,Mehta; Ravindra L.,9996,0,9999,3
1713329603920,CLRE 251,B00,511410,Mehta; Ravindra L.,9998,0,9999,1
1713329604947,CLRE 252,A00,507189,Cuomo; Raphael Eduardo,9998,0,9999,1
1713329605974,CLRE 253,A00,507199,Vaida; Florin,9997,0,9999,2
1713329605974,CLRE 253,B00,507202,Vaida; Florin,9999,0,9999,0
1713329607057,CLRE 259,A00,507211,Patel; Hemal,9996,0,9999,3
1713329608129,CLRE 260,A00,507221,Cuomo; Raphael Eduardo,9999,0,9999,0
1713329609153,CLRE 297,001,507242,Cuomo; Raphael Eduardo,9999,0,9999,0
1713329610180,CSE 191,A00,516875,Minnes Kemp; Mor Mia,9999,0,9999,0
1713329611212,CSS 201S,A01,494383,Staff,35,0,35,0
1713329612238,CSS 202S,A01,494387,Staff,35,0,35,0
1713329613265,EAP 100,A00,516065,Staff,9792,0,9999,207
1713329614294,ECE 45,A01,507414,Staff,51,0,60,9
1713329615324,ECE 100,A01,507416,Baghdadchi; Saharnaz,10,0,20,10
1713329615324,ECE 100,A02,507418,Baghdadchi; Saharnaz,20,0,20,0
1713329616349,ECE 111,A01,507420,Staff,38,0,50,12
1713329617376,ECE 197,001,548057,Sievenpiper; Daniel F.,9998,0,9999,1
1713329618405,EDS 115,A00,507243,Choi; Bailey Miyeon,28,0,28,0
1713329619431,EDS 117,A01,494379,Staff,23,0,25,2
1713329620460,EDS 125,A00,507246,Hopkins; Megan Beth,29,0,30,1
1713329621486,EDS 128A,A01,507264,Fargason; Sharon Gayle,26,0,26,0
1713329622514,EDS 128B,A01,507293,Pappas; Elizabeth,30,0,30,0
1713329623540,EDS 139,A00,507294,Fargason; Sharon Gayle,30,0,30,0
1713329623540,EDS 139,B00,507313,Pappas; Elizabeth,30,0,30,0
1713329624565,EDS 201,A00,507315,Staff,26,0,30,4
1713329625592,EDS 203,A01,507317,Halter; Christopher P.,26,0,30,4
1713329626623,EDS 204R,A01,507319,Halter; Christopher P.,3,0,30,27
1713329626623,EDS 204R,B01,507331,Heinzman; Erica M.,28,0,30,2
1713329627652,EDS 206R,A00,507332,Staff,4,0,30,26
1713329627652,EDS 206R,B00,507343,Staff,28,0,30,2
1713329628677,EDS 250,A00,507344,Hemans; Patricia Ann Benitez,36,0,40,4
1713329629704,EDS 281,A00,507345,Daly; Alan J.,18,0,18,0
1713329630731,EDS 284,A00,507350,Daly; Alan J.,16,0,16,0
1713329631756,EDS 286,A00,507359,Fine; Sarah,18,0,18,0
1713329632785,EDS 289C,A01,507361,Daly; Alan J.,18,0,18,0
1713329633814,EDS 290,A00,507366,Hofstetter; Carolyn,15,0,15,0
1713329634843,LIGM 5A,A00,507421,Fischer-Grunski; Eva K,20,0,20,0
1713329635872,LIGM 5B,A00,507423,Fischer-Grunski; Eva K,20,0,20,0
1713329636901,LIGM 5C,A00,507425,Fischer-Grunski; Eva K,20,0,20,0
1713329637927,LIIT 5AS,A00,507427,Carnelos; Chiara,20,0,20,0
1713329638952,LIIT 5BS,A00,507430,Carnelos; Chiara,20,0,20,0
1713329639980,LIIT 5CS,A00,507432,Carnelos; Chiara,20,0,20,0
1713329641011,LISP 5A,A00,507541,Munoz Sanchez; Alicia,17,0,20,3
1713329642038,LISP 5B,A00,507671,Munoz Sanchez; Alicia,15,0,20,5
1713329643067,LISP 5C,A00,507696,Munoz Sanchez; Alicia,15,0,20,5
1713329644092,MAE 197,001,528363,Boechler; Nicholas Sebastia,9998,0,9999,1
1713329645122,MATH 197,001,523477,Kedlaya; Kiran S.,9999,0,9999,0
1713329645122,MATH 197,002,563811,Zhang; Danna,9999,0,9999,0
1713329646148,MCWP 40R,A00,518780,Staff,20,0,20,0
1713329646148,MCWP 40R,B00,518781,Staff,19,0,20,1
1713329646148,MCWP 40R,C00,518783,Staff,19,0,20,1
1713329647173,MCWP 50R,A00,518791,Staff,20,0,20,0
1713329647173,MCWP 50R,B00,518792,Staff,17,0,20,3
1713329647173,MCWP 50R,C00,518793,Staff,19,0,20,1
1713329647173,MCWP 50R,D00,518794,Staff,16,0,20,4
1713329647173,MCWP 50R,E00,518795,Staff,16,0,20,4
1713329647173,MCWP 50R,F00,518796,Staff,19,0,20,1
1713329647173,MCWP 50R,G00,518797,Staff,19,0,20,1
1713329648198,MMW 12R,A01,514034,Herbst; Matthew,15,0,16,1
1713329648198,MMW 12R,A02,514035,Herbst; Matthew,16,0,16,0
1713329649223,MMW 13R,A01,514037,Staff,12,0,16,4
1713329649223,MMW 13R,A02,514039,Staff,16,0,16,0
1713329651273,SIO 295LS,A00,523233,Staff,19,0,30,11
1713329652304,SIO 295S,A00,523232,Staff,19,0,30,11
1713329653330,SOCI 117,A01,494376,Staff,2,0,5,3
1713329654353,WES 237B,A00,494380,Staff,19,0,20,1
1713329656433,AESE 279B,A00,494370,Wade; Jon P,33,0,33,0
1713329657458,ANAR 135S,A00,494369,Braswell; Geoffrey E.,0,0,0,0
1713329658487,CAT 124RS,A01,519847,Geibel; William,17,0,20,3
1713329659513,CAT 125RS,A01,515971,Geibel; William,17,0,20,3
1713329660538,CLRE 250,A00,511389,Morris; Sheldon,9996,0,9999,3
1713329661568,CLRE 251,A00,507176,Mehta; Ravindra L.,9996,0,9999,3
1713329661568,CLRE 251,B00,511410,Mehta; Ravindra L.,9998,0,9999,1
1713329662595,CLRE 252,A00,507189,Cuomo; Raphael Eduardo,9998,0,9999,1
1713329663624,CLRE 253,A00,507199,Vaida; Florin,9997,0,9999,2
1713329663624,CLRE 253,B00,507202,Vaida; Florin,9999,0,9999,0
1713329664650,CLRE 259,A00,507211,Patel; Hemal,9996,0,9999,3
1713329665675,CLRE 260,A00,507221,Cuomo; Raphael Eduardo,9999,0,9999,0
1713329666700,CLRE 297,001,507242,Cuomo; Raphael Eduardo,9999,0,9999,0
1713329667725,CSE 191,A00,516875,Minnes Kemp; Mor Mia,9999,0,9999,0
1713329668752,CSS 201S,A01,494383,Staff,35,0,35,0
1713329669782,CSS 202S,A01,494387,Staff,35,0,35,0
1713329670808,EAP 100,A00,516065,Staff,9792,0,9999,207
1713329671834,ECE 45,A01,507414,Staff,51,0,60,9
1713329672859,ECE 100,A01,507416,Baghdadchi; Saharnaz,10,0,20,10
1713329672859,ECE 100,A02,507418,Baghdadchi; Saharnaz,20,0,20,0
1713329673884,ECE 111,A01,507420,Staff,38,0,50,12
1713329674914,ECE 197,001,548057,Sievenpiper; Daniel F.,9998,0,9999,1
1713329675945,EDS 115,A00,507243,Choi; Bailey Miyeon,28,0,28,0
1713329676971,EDS 117,A01,494379,Staff,23,0,25,2
1713329677996,EDS 125,A00,507246,Hopkins; Megan Beth,29,0,30,1
1713329679025,EDS 128A,A01,507264,Fargason; Sharon Gayle,26,0,26,0
1713329680051,EDS 128B,A01,507293,Pappas; Elizabeth,30,0,30,0
1713329681079,EDS 139,A00,507294,Fargason; Sharon Gayle,30,0,30,0
1713329681079,EDS 139,B00,507313,Pappas; Elizabeth,30,0,30,0
1713329682105,EDS 201,A00,507315,Staff,26,0,30,4
1713329683129,EDS 203,A01,507317,Halter; Christopher P.,26,0,30,4
1713329684156,EDS 204R,A01,507319,Halter; Christopher P.,3,0,30,27
1713329684156,EDS 204R,B01,507331,Heinzman; Erica M.,28,0,30,2
1713329685180,EDS 206R,A00,507332,Staff,4,0,30,26
1713329685180,EDS 206R,B00,507343,Staff,28,0,30,2
1713329686206,EDS 250,A00,507344,Hemans; Patricia Ann Benitez,36,0,40,4
1713329687232,EDS 281,A00,507345,Daly; Alan J.,18,0,18,0
1713329688258,EDS 284,A00,507350,Daly; Alan J.,16,0,16,0
1713329689285,EDS 286,A00,507359,Fine; Sarah,18,0,18,0
1713329690313,EDS 289C,A01,507361,Daly; Alan J.,18,0,18,0
1713329691339,EDS 290,A00,507366,Hofstetter; Carolyn,15,0,15,0
1713329692366,LIGM 5A,A00,507421,Fischer-Grunski; Eva K,20,0,20,0
1713329693394,LIGM 5B,A00,507423,Fischer-Grunski; Eva K,20,0,20,0
1713329694423,LIGM 5C,A00,507425,Fischer-Grunski; Eva K,20,0,20,0
1713329695453,LIIT 5AS,A00,507427,Carnelos; Chiara,20,0,20,0
1713329696478,LIIT 5BS,A00,507430,Carnelos; Chiara,20,0,20,0
1713329697503,LIIT 5CS,A00,507432,Carnelos; Chiara,20,0,20,0
1713329698528,LISP 5A,A00,507541,Munoz Sanchez; Alicia,17,0,20,3
1713329699554,LISP 5B,A00,507671,Munoz Sanchez; Alicia,15,0,20,5
1713329700583,LISP 5C,A00,507696,Munoz Sanchez; Alicia,15,0,20,5
1713329701608,MAE 197,001,528363,Boechler; Nicholas Sebastia,9998,0,9999,1
1713329702633,MATH 197,001,523477,Kedlaya; Kiran S.,9999,0,9999,0
1713329702633,MATH 197,002,563811,Zhang; Danna,9999,0,9999,0
1713329703663,MCWP 40R,A00,518780,Staff,20,0,20,0
1713329703663,MCWP 40R,B00,518781,Staff,19,0,20,1
1713329703663,MCWP 40R,C00,518783,Staff,19,0,20,1
1713329704692,MCWP 50R,A00,518791,Staff,20,0,20,0
1713329704692,MCWP 50R,B00,518792,Staff,17,0,20,3
1713329704692,MCWP 50R,C00,518793,Staff,19,0,20,1
1713329704692,MCWP 50R,D00,518794,Staff,16,0,20,4
1713329704692,MCWP 50R,E00,518795,Staff,16,0,20,4
1713329704692,MCWP 50R,F00,518796,Staff,19,0,20,1
1713329704692,MCWP 50R,G00,518797,Staff,19,0,20,1
1713329705716,MMW 12R,A01,514034,Herbst; Matthew,15,0,16,1
1713329705716,MMW 12R,A02,514035,Herbst; Matthew,16,0,16,0
1713329706743,MMW 13R,A01,514037,Staff,12,0,16,4
1713329706743,MMW 13R,A02,514039,Staff,16,0,16,0
1713329708795,SIO 295LS,A00,523233,Staff,19,0,30,11
1713329709823,SIO 295S,A00,523232,Staff,19,0,30,11
1713329710902,SOCI 117,A01,494376,Staff,2,0,5,3
1713329711927,WES 237B,A00,494380,Staff,19,0,20,1
1713329713987,AESE 279B,A00,494370,Wade; Jon P,33,0,33,0
1713329715012,ANAR 135S,A00,494369,Braswell; Geoffrey E.,0,0,0,0
1713329716039,CAT 124RS,A01,519847,Geibel; William,17,0,20,3
1713329717066,CAT 125RS,A01,515971,Geibel; William,17,0,20,3
1713329718095,CLRE 250,A00,511389,Morris; Sheldon,9996,0,9999,3
1713329719121,CLRE 251,A00,507176,Mehta; Ravindra L.,9996,0,9999,3
1713329719121,CLRE 251,B00,511410,Mehta; Ravindra L.,9998,0,9999,1
1713329720147,CLRE 252,A00,507189,Cuomo; Raphael Eduardo,9998,0,9999,1
1713329721251,CLRE 253,A00,507199,Vaida; Florin,9997,0,9999,2
1713329721251,CLRE 253,B00,507202,Vaida; Florin,9999,0,9999,0
1713329722273,CLRE 259,A00,507211,Patel; Hemal,9996,0,9999,3
1713329723299,CLRE 260,A00,507221,Cuomo; Raphael Eduardo,9999,0,9999,0
1713329724326,CLRE 297,001,507242,Cuomo; Raphael Eduardo,9999,0,9999,0
1713329725356,CSE 191,A00,516875,Minnes Kemp; Mor Mia,9999,0,9999,0
1713329726383,CSS 201S,A01,494383,Staff,35,0,35,0
1713329727409,CSS 202S,A01,494387,Staff,35,0,35,0
1713329728435,EAP 100,A00,516065,Staff,9792,0,9999,207
1713329729462,ECE 45,A01,507414,Staff,51,0,60,9
1713329730489,ECE 100,A01,507416,Baghdadchi; Saharnaz,10,0,20,10
1713329730489,ECE 100,A02,507418,Baghdadchi; Saharnaz,20,0,20,0
1713329731518,ECE 111,A01,507420,Staff,38,0,50,12
1713329732546,ECE 197,001,548057,Sievenpiper; Daniel F.,9998,0,9999,1
1713329733575,EDS 115,A00,507243,Choi; Bailey Miyeon,28,0,28,0
1713329734603,EDS 117,A01,494379,Staff,23,0,25,2
1713329735629,EDS 125,A00,507246,Hopkins; Megan Beth,29,0,30,1
1713329736654,EDS 128A,A01,507264,Fargason; Sharon Gayle,26,0,26,0
1713329737683,EDS 128B,A01,507293,Pappas; Elizabeth,30,0,30,0
1713329738712,EDS 139,A00,507294,Fargason; Sharon Gayle,30,0,30,0
1713329738712,EDS 139,B00,507313,Pappas; Elizabeth,30,0,30,0
1713329739739,EDS 201,A00,507315,Staff,26,0,30,4
1713329740764,EDS 203,A01,507317,Halter; Christopher P.,26,0,30,4
1713329741793,EDS 204R,A01,507319,Halter; Christopher P.,3,0,30,27
1713329741793,EDS 204R,B01,507331,Heinzman; Erica M.,28,0,30,2
1713329742822,EDS 206R,A00,507332,Staff,4,0,30,26
1713329742822,EDS 206R,B00,507343,Staff,28,0,30,2
1713329743851,EDS 250,A00,507344,Hemans; Patricia Ann Benitez,36,0,40,4
1713329744877,EDS 281,A00,507345,Daly; Alan J.,18,0,18,0
1713329745902,EDS 284,A00,507350,Daly; Alan J.,16,0,16,0
1713329746927,EDS 286,A00,507359,Fine; Sarah,18,0,18,0
1713329747989,EDS 289C,A01,507361,Daly; Alan J.,18,0,18,0
1713329749014,EDS 290,A00,507366,Hofstetter; Carolyn,15,0,15,0
1713329750044,LIGM 5A,A00,507421,Fischer-Grunski; Eva K,20,0,20,0
1713329751073,LIGM 5B,A00,507423,Fischer-Grunski; Eva K,20,0,20,0
1713329752101,LIGM 5C,A00,507425,Fischer-Grunski; Eva K,20,0,20,0
1713329753129,LIIT 5AS,A00,507427,Carnelos; Chiara,20,0,20,0
1713329754155,LIIT 5BS,A00,507430,Carnelos; Chiara,20,0,20,0
1713329755179,LIIT 5CS,A00,507432,Carnelos; Chiara,20,0,20,0
1713329756205,LISP 5A,A00,507541,Munoz Sanchez; Alicia,17,0,20,3
1713329757228,LISP 5B,A00,507671,Munoz Sanchez; Alicia,15,0,20,5
1713329758254,LISP 5C,A00,507696,Munoz Sanchez; Alicia,15,0,20,5
1713329759284,MAE 197,001,528363,Boechler; Nicholas Sebastia,9998,0,9999,1
1713329760310,MATH 197,001,523477,Kedlaya; Kiran S.,9999,0,9999,0
1713329760310,MATH 197,002,563811,Zhang; Danna,9999,0,9999,0
1713329761337,MCWP 40R,A00,518780,Staff,20,0,20,0
1713329761337,MCWP 40R,B00,518781,Staff,19,0,20,1
1713329761337,MCWP 40R,C00,518783,Staff,19,0,20,1
1713329762368,MCWP 50R,A00,518791,Staff,20,0,20,0
1713329762368,MCWP 50R,B00,518792,Staff,17,0,20,3
1713329762368,MCWP 50R,C00,518793,Staff,19,0,20,1
1713329762368,MCWP 50R,D00,518794,Staff,16,0,20,4
1713329762368,MCWP 50R,E00,518795,Staff,16,0,20,4
1713329762368,MCWP 50R,F00,518796,Staff,19,0,20,1
1713329762368,MCWP 50R,G00,518797,Staff,19,0,20,1
1713329763397,MMW 12R,A01,514034,Herbst; Matthew,15,0,16,1
1713329763397,MMW 12R,A02,514035,Herbst; Matthew,16,0,16,0
1713329764422,MMW 13R,A01,514037,Staff,12,0,16,4
1713329764422,MMW 13R,A02,514039,Staff,16,0,16,0
1713329766473,SIO 295LS,A00,523233,Staff,19,0,30,11
1713329767498,SIO 295S,A00,523232,Staff,19,0,30,11
1713329768523,SOCI 117,A01,494376,Staff,2,0,5,3
1713329769547,WES 237B,A00,494380,Staff,19,0,20,1
1713329771621,AESE 279B,A00,494370,Wade; Jon P,33,0,33,0
1713329772646,ANAR 135S,A00,494369,Braswell; Geoffrey E.,0,0,0,0
1713329773673,CAT 124RS,A01,519847,Geibel; William,17,0,20,3
1713329774702,CAT 125RS,A01,515971,Geibel; William,17,0,20,3
1713329775729,CLRE 250,A00,511389,Morris; Sheldon,9996,0,9999,3
1713329776755,CLRE 251,A00,507176,Mehta; Ravindra L.,9996,0,9999,3
1713329776755,CLRE 251,B00,511410,Mehta; Ravindra L.,9998,0,9999,1
1713329777781,CLRE 252,A00,507189,Cuomo; Raphael Eduardo,9998,0,9999,1
1713329778810,CLRE 253,A00,507199,Vaida; Florin,9997,0,9999,2
1713329778810,CLRE 253,B00,507202,Vaida; Florin,9999,0,9999,0
1713329779835,CLRE 259,A00,507211,Patel; Hemal,9996,0,9999,3
1713329780859,CLRE 260,A00,507221,Cuomo; Raphael Eduardo,9999,0,9999,0
1713329781887,CLRE 297,001,507242,Cuomo; Raphael Eduardo,9999,0,9999,0
1713329782911,CSE 191,A00,516875,Minnes Kemp; Mor Mia,9999,0,9999,0
1713329783937,CSS 201S,A01,494383,Staff,35,0,35,0
1713329784966,CSS 202S,A01,494387,Staff,35,0,35,0
1713329785991,EAP 100,A00,516065,Staff,9792,0,9999,207
1713329787018,ECE 45,A01,507414,Staff,51,0,60,9
1713329788049,ECE 100,A01,507416,Baghdadchi; Saharnaz,10,0,20,10
1713329788049,ECE 100,A02,507418,Baghdadchi; Saharnaz,20,0,20,0
1713329789077,ECE 111,A01,507420,Staff,38,0,50,12
1713329790106,ECE 197,001,548057,Sievenpiper; Daniel F.,9998,0,9999,1
1713329791132,EDS 115,A00,507243,Choi; Bailey Miyeon,28,0,28,0
1713329792157,EDS 117,A01,494379,Staff,23,0,25,2
1713329793182,EDS 125,A00,507246,Hopkins; Megan Beth,29,0,30,1
1713329794209,EDS 128A,A01,507264,Fargason; Sharon Gayle,26,0,26,0
1713329795235,EDS 128B,A01,507293,Pappas; Elizabeth,30,0,30,0
1713329796259,EDS 139,A00,507294,Fargason; Sharon Gayle,30,0,30,0
1713329796259,EDS 139,B00,507313,Pappas; Elizabeth,30,0,30,0
1713329797288,EDS 201,A00,507315,Staff,26,0,30,4
1713329798314,EDS 203,A01,507317,Halter; Christopher P.,26,0,30,4
1713329799338,EDS 204R,A01,507319,Halter; Christopher P.,3,0,30,27
1713329799338,EDS 204R,B01,507331,Heinzman; Erica M.,28,0,30,2
1713329800366,EDS 206R,A00,507332,Staff,4,0,30,26
1713329800366,EDS 206R,B00,507343,Staff,28,0,30,2
1713329801390,EDS 250,A00,507344,Hemans; Patricia Ann Benitez,36,0,40,4
1713329802415,EDS 281,A00,507345,Daly; Alan J.,18,0,18,0
1713329803439,EDS 284,A00,507350,Daly; Alan J.,16,0,16,0
1713329804468,EDS 286,A00,507359,Fine; Sarah,18,0,18,0
1713329805495,EDS 289C,A01,507361,Daly; Alan J.,18,0,18,0
1713329806521,EDS 290,A00,507366,Hofstetter; Carolyn,15,0,15,0
1713329807550,LIGM 5A,A00,507421,Fischer-Grunski; Eva K,20,0,20,0
1713329808579,LIGM 5B,A00,507423,Fischer-Grunski; Eva K,20,0,20,0
1713329809607,LIGM 5C,A00,507425,Fischer-Grunski; Eva K,20,0,20,0
1713329810635,LIIT 5AS,A00,507427,Carnelos; Chiara,20,0,20,0
1713329811664,LIIT 5BS,A00,507430,Carnelos; Chiara,20,0,20,0
1713329812690,LIIT 5CS,A00,507432,Carnelos; Chiara,20,0,20,0
1713329813719,LISP 5A,A00,507541,Munoz Sanchez; Alicia,17,0,20,3
1713329814804,LISP 5B,A00,507671,Munoz Sanchez; Alicia,15,0,20,5
1713329815828,LISP 5C,A00,507696,Munoz Sanchez; Alicia,15,0,20,5
1713329816857,MAE 197,001,528363,Boechler; Nicholas Sebastia,9998,0,9999,1
1713329817883,MATH 197,001,523477,Kedlaya; Kiran S.,9999,0,9999,0
1713329817883,MATH 197,002,563811,Zhang; Danna,9999,0,9999,0
1713329818909,MCWP 40R,A00,518780,Staff,20,0,20,0
1713329818909,MCWP 40R,B00,518781,Staff,19,0,20,1
1713329818909,MCWP 40R,C00,518783,Staff,19,0,20,1
1713329819935,MCWP 50R,A00,518791,Staff,20,0,20,0
1713329819935,MCWP 50R,B00,518792,Staff,17,0,20,3
1713329819935,MCWP 50R,C00,518793,Staff,19,0,20,1
1713329819935,MCWP 50R,D00,518794,Staff,16,0,20,4
1713329819935,MCWP 50R,E00,518795,Staff,16,0,20,4
1713329819935,MCWP 50R,F00,518796,Staff,19,0,20,1
1713329819935,MCWP 50R,G00,518797,Staff,19,0,20,1
1713329820960,MMW 12R,A01,514034,Herbst; Matthew,15,0,16,1
1713329820960,MMW 12R,A02,514035,Herbst; Matthew,16,0,16,0
1713329821986,MMW 13R,A01,514037,Staff,12,0,16,4
1713329821986,MMW 13R,A02,514039,Staff,16,0,16,0
1713329824038,SIO 295LS,A00,523233,Staff,19,0,30,11
1713329825065,SIO 295S,A00,523232,Staff,19,0,30,11
1713329826090,SOCI 117,A01,494376,Staff,2,0,5,3
1713329827142,WES 237B,A00,494380,Staff,19,0,20,1
1713329829217,AESE 279B,A00,494370,Wade; Jon P,33,0,33,0
1713329830245,ANAR 135S,A00,494369,Braswell; Geoffrey E.,0,0,0,0
1713329831270,CAT 124RS,A01,519847,Geibel; William,17,0,20,3
1713329832298,CAT 125RS,A01,515971,Geibel; William,17,0,20,3
1713329833328,CLRE 250,A00,511389,Morris; Sheldon,9996,0,9999,3
1713329834356,CLRE 251,A00,507176,Mehta; Ravindra L.,9996,0,9999,3
1713329834356,CLRE 251,B00,511410,Mehta; Ravindra L.,9998,0,9999,1
1713329835382,CLRE 252,A00,507189,Cuomo; Raphael Eduardo,9998,0,9999,1
1713329836409,CLRE 253,A00,507199,Vaida; Florin,9997,0,9999,2
1713329836409,CLRE 253,B00,507202,Vaida; Florin,9999,0,9999,0
1713329837436,CLRE 259,A00,507211,Patel; Hemal,9996,0,9999,3
1713329838464,CLRE 260,A00,507221,Cuomo; Raphael Eduardo,9999,0,9999,0
1713329839492,CLRE 297,001,507242,Cuomo; Raphael Eduardo,9999,0,9999,0
1713329840521,CSE 191,A00,516875,Minnes Kemp; Mor Mia,9999,0,9999,0
1713329841550,CSS 201S,A01,494383,Staff,35,0,35,0
1713329842579,CSS 202S,A01,494387,Staff,35,0,35,0
1713329843608,EAP 100,A00,516065,Staff,9792,0,9999,207
1713329844636,ECE 45,A01,507414,Staff,51,0,60,9
1713329845660,ECE 100,A01,507416,Baghdadchi; Saharnaz,10,0,20,10
1713329845660,ECE 100,A02,507418,Baghdadchi; Saharnaz,20,0,20,0
1713329846685,ECE 111,A01,507420,Staff,38,0,50,12
1713329847711,ECE 197,001,548057,Sievenpiper; Daniel F.,9998,0,9999,1
1713329848739,EDS 115,A00,507243,Choi; Bailey Miyeon,28,0,28,0
1713329849767,EDS 117,A01,494379,Staff,23,0,25,2
1713329850797,EDS 125,A00,507246,Hopkins; Megan Beth,29,0,30,1
1713329851823,EDS 128A,A01,507264,Fargason; Sharon Gayle,26,0,26,0
1713329852853,EDS 128B,A01,507293,Pappas; Elizabeth,30,0,30,0
1713329853878,EDS 139,A00,507294,Fargason; Sharon Gayle,30,0,30,0
1713329853878,EDS 139,B00,507313,Pappas; Elizabeth,30,0,30,0
1713329854907,EDS 201,A00,507315,Staff,26,0,30,4
1713329855934,EDS 203,A01,507317,Halter; Christopher P.,26,0,30,4
1713329856960,EDS 204R,A01,507319,Halter; Christopher P.,3,0,30,27
1713329856960,EDS 204R,B01,507331,Heinzman; Erica M.,28,0,30,2
1713329857989,EDS 206R,A00,507332,Staff,4,0,30,26
1713329857989,EDS 206R,B00,507343,Staff,28,0,30,2
1713329859015,EDS 250,A00,507344,Hemans; Patricia Ann Benitez,36,0,40,4
1713329860044,EDS 281,A00,507345,Daly; Alan J.,18,0,18,0
1713329861072,EDS 284,A00,507350,Daly; Alan J.,16,0,16,0
1713329862098,EDS 286,A00,507359,Fine; Sarah,18,0,18,0
1713329863123,EDS 289C,A01,507361,Daly; Alan J.,18,0,18,0
1713329864148,EDS 290,A00,507366,Hofstetter; Carolyn,15,0,15,0
1713329865176,LIGM 5A,A00,507421,Fischer-Grunski; Eva K,20,0,20,0
1713329866205,LIGM 5B,A00,507423,Fischer-Grunski; Eva K,20,0,20,0
1713329867229,LIGM 5C,A00,507425,Fischer-Grunski; Eva K,20,0,20,0
1713329868259,LIIT 5AS,A00,507427,Carnelos; Chiara,20,0,20,0
1713329869284,LIIT 5BS,A00,507430,Carnelos; Chiara,20,0,20,0
1713329870313,LIIT 5CS,A00,507432,Carnelos; Chiara,20,0,20,0
1713329871345,LISP 5A,A00,507541,Munoz Sanchez; Alicia,17,0,20,3
1713329872370,LISP 5B,A00,507671,Munoz Sanchez; Alicia,15,0,20,5
1713329873396,LISP 5C,A00,507696,Munoz Sanchez; Alicia,15,0,20,5
1713329874423,MAE 197,001,528363,Boechler; Nicholas Sebastia,9998,0,9999,1
1713329875454,MATH 197,001,523477,Kedlaya; Kiran S.,9999,0,9999,0
1713329875454,MATH 197,002,563811,Zhang; Danna,9999,0,9999,0
1713329876481,MCWP 40R,A00,518780,Staff,20,0,20,0
1713329876481,MCWP 40R,B00,518781,Staff,19,0,20,1
1713329876481,MCWP 40R,C00,518783,Staff,19,0,20,1
1713329877511,MCWP 50R,A00,518791,Staff,20,0,20,0
1713329877511,MCWP 50R,B00,518792,Staff,17,0,20,3
1713329877511,MCWP 50R,C00,518793,Staff,19,0,20,1
1713329877511,MCWP 50R,D00,518794,Staff,16,0,20,4
1713329877511,MCWP 50R,E00,518795,Staff,16,0,20,4
1713329877511,MCWP 50R,F00,518796,Staff,19,0,20,1
1713329877511,MCWP 50R,G00,518797,Staff,19,0,20,1
1713329878540,MMW 12R,A01,514034,Herbst; Matthew,15,0,16,1
1713329878540,MMW 12R,A02,514035,Herbst; Matthew,16,0,16,0
1713329879565,MMW 13R,A01,514037,Staff,12,0,16,4
1713329879565,MMW 13R,A02,514039,Staff,16,0,16,0
1713329881618,SIO 295LS,A00,523233,Staff,19,0,30,11
1713329882643,SIO 295S,A00,523232,Staff,19,0,30,11
1713329883674,SOCI 117,A01,494376,Staff,2,0,5,3
1713329884700,WES 237B,A00,494380,Staff,19,0,20,1
1713329886783,AESE 279B,A00,494370,Wade; Jon P,33,0,33,0
1713329887808,ANAR 135S,A00,494369,Braswell; Geoffrey E.,0,0,0,0
1713329888833,CAT 124RS,A01,519847,Geibel; William,17,0,20,3
1713329889857,CAT 125RS,A01,515971,Geibel; William,17,0,20,3
1713329890884,CLRE 250,A00,511389,Morris; Sheldon,9996,0,9999,3
1713329891910,CLRE 251,A00,507176,Mehta; Ravindra L.,9996,0,9999,3
1713329891910,CLRE 251,B00,511410,Mehta; Ravindra L.,9998,0,9999,1
1713329892941,CLRE 252,A00,507189,Cuomo; Raphael Eduardo,9998,0,9999,1
1713329893966,CLRE 253,A00,507199,Vaida; Florin,9997,0,9999,2
1713329893966,CLRE 253,B00,507202,Vaida; Florin,9999,0,9999,0
1713329894991,CLRE 259,A00,507211,Patel; Hemal,9996,0,9999,3
1713329896016,CLRE 260,A00,507221,Cuomo; Raphael Eduardo,9999,0,9999,0
1713329897041,CLRE 297,001,507242,Cuomo; Raphael Eduardo,9999,0,9999,0
1713329898067,CSE 191,A00,516875,Minnes Kemp; Mor Mia,9999,0,9999,0
1713329899094,CSS 201S,A01,494383,Staff,35,0,35,0
1713329900120,CSS 202S,A01,494387,Staff,35,0,35,0
1713329901146,EAP 100,A00,516065,Staff,9792,0,9999,207
1713329902174,ECE 45,A01,507414,Staff,51,0,60,9
1713329903200,ECE 100,A01,507416,Baghdadchi; Saharnaz,10,0,20,10
1713329903200,ECE 100,A02,507418,Baghdadchi; Saharnaz,20,0,20,0
1713329904224,ECE 111,A01,507420,Staff,38,0,50,12
1713329905250,ECE 197,001,548057,Sievenpiper; Daniel F.,9998,0,9999,1
1713329906277,EDS 115,A00,507243,Choi; Bailey Miyeon,28,0,28,0
1713329907305,EDS 117,A01,494379,Staff,23,0,25,2
1713329908330,EDS 125,A00,507246,Hopkins; Megan Beth,29,0,30,1
1713329909357,EDS 128A,A01,507264,Fargason; Sharon Gayle,26,0,26,0
1713329910387,EDS 128B,A01,507293,Pappas; Elizabeth,30,0,30,0
1713329911412,EDS 139,A00,507294,Fargason; Sharon Gayle,30,0,30,0
1713329911412,EDS 139,B00,507313,Pappas; Elizabeth,30,0,30,0
1713329912437,EDS 201,A00,507315,Staff,26,0,30,4
1713329913467,EDS 203,A01,507317,Halter; Christopher P.,26,0,30,4
1713329914496,EDS 204R,A01,507319,Halter; Christopher P.,3,0,30,27
1713329914496,EDS 204R,B01,507331,Heinzman; Erica M.,28,0,30,2
1713329915524,EDS 206R,A00,507332,Staff,4,0,30,26
1713329915524,EDS 206R,B00,507343,Staff,28,0,30,2
1713329916549,EDS 250,A00,507344,Hemans; Patricia Ann Benitez,36,0,40,4
1713329917576,EDS 281,A00,507345,Daly; Alan J.,18,0,18,0
1713329918656,EDS 284,A00,507350,Daly; Alan J.,16,0,16,0
1713329919682,EDS 286,A00,507359,Fine; Sarah,18,0,18,0
1713329920707,EDS 289C,A01,507361,Daly; Alan J.,18,0,18,0
1713329921733,EDS 290,A00,507366,Hofstetter; Carolyn,15,0,15,0
1713329922760,LIGM 5A,A00,507421,Fischer-Grunski; Eva K,20,0,20,0
1713329923785,LIGM 5B,A00,507423,Fischer-Grunski; Eva K,20,0,20,0
1713329924811,LIGM 5C,A00,507425,Fischer-Grunski; Eva K,20,0,20,0
1713329925837,LIIT 5AS,A00,507427,Carnelos; Chiara,20,0,20,0
1713329926863,LIIT 5BS,A00,507430,Carnelos; Chiara,20,0,20,0
1713329927888,LIIT 5CS,A00,507432,Carnelos; Chiara,20,0,20,0
1713329928920,LISP 5A,A00,507541,Munoz Sanchez; Alicia,17,0,20,3
1713329929946,LISP 5B,A00,507671,Munoz Sanchez; Alicia,15,0,20,5
1713329930974,LISP 5C,A00,507696,Munoz Sanchez; Alicia,15,0,20,5
1713329932005,MAE 197,001,528363,Boechler; Nicholas Sebastia,9998,0,9999,1
1713329933035,MATH 197,001,523477,Kedlaya; Kiran S.,9999,0,9999,0
1713329933035,MATH 197,002,563811,Zhang; Danna,9999,0,9999,0
1713329934065,MCWP 40R,A00,518780,Staff,20,0,20,0
1713329934065,MCWP 40R,B00,518781,Staff,19,0,20,1
1713329934065,MCWP 40R,C00,518783,Staff,19,0,20,1
1713329935096,MCWP 50R,A00,518791,Staff,20,0,20,0
1713329935096,MCWP 50R,B00,518792,Staff,17,0,20,3
1713329935096,MCWP 50R,C00,518793,Staff,19,0,20,1
1713329935096,MCWP 50R,D00,518794,Staff,16,0,20,4
1713329935096,MCWP 50R,E00,518795,Staff,16,0,20,4
1713329935096,MCWP 50R,F00,518796,Staff,19,0,20,1
1713329935096,MCWP 50R,G00,518797,Staff,19,0,20,1
1713329936124,MMW 12R,A01,514034,Herbst; Matthew,15,0,16,1
1713329936124,MMW 12R,A02,514035,Herbst; Matthew,16,0,16,0
1713329937148,MMW 13R,A01,514037,Staff,12,0,16,4
1713329937148,MMW 13R,A02,514039,Staff,16,0,16,0
1713329939199,SIO 295LS,A00,523233,Staff,19,0,30,11
1713329940223,SIO 295S,A00,523232,Staff,19,0,30,11
1713329941249,SOCI 117,A01,494376,Staff,2,0,5,3
1713329942274,WES 237B,A00,494380,Staff,19,0,20,1
1713329944352,AESE 279B,A00,494370,Wade; Jon P,33,0,33,0
1713329945378,ANAR 135S,A00,494369,Braswell; Geoffrey E.,0,0,0,0
1713329946407,CAT 124RS,A01,519847,Geibel; William,17,0,20,3
1713329947430,CAT 125RS,A01,515971,Geibel; William,17,0,20,3
1713329948456,CLRE 250,A00,511389,Morris; Sheldon,9996,0,9999,3
1713329949481,CLRE 251,A00,507176,Mehta; Ravindra L.,9996,0,9999,3
1713329949481,CLRE 251,B00,511410,Mehta; Ravindra L.,9998,0,9999,1
1713329950507,CLRE 252,A00,507189,Cuomo; Raphael Eduardo,9998,0,9999,1
1713329951536,CLRE 253,A00,507199,Vaida; Florin,9997,0,9999,2
1713329951536,CLRE 253,B00,507202,Vaida; Florin,9999,0,9999,0
1713329952566,CLRE 259,A00,507211,Patel; Hemal,9996,0,9999,3
1713329953592,CLRE 260,A00,507221,Cuomo; Raphael Eduardo,9999,0,9999,0
1713329954618,CLRE 297,001,507242,Cuomo; Raphael Eduardo,9999,0,9999,0
1713329955643,CSE 191,A00,516875,Minnes Kemp; Mor Mia,9999,0,9999,0
1713329956674,CSS 201S,A01,494383,Staff,35,0,35,0
1713329957699,CSS 202S,A01,494387,Staff,35,0,35,0
1713329958723,EAP 100,A00,516065,Staff,9792,0,9999,207
1713329959750,ECE 45,A01,507414,Staff,51,0,60,9
1713329960775,ECE 100,A01,507416,Baghdadchi; Saharnaz,10,0,20,10
1713329960775,ECE 100,A02,507418,Baghdadchi; Saharnaz,20,0,20,0
1713329961803,ECE 111,A01,507420,Staff,38,0,50,12
1713329962829,ECE 197,001,548057,Sievenpiper; Daniel F.,9998,0,9999,1
1713329963863,EDS 115,A00,507243,Choi; Bailey Miyeon,28,0,28,0
1713329964889,EDS 117,A01,494379,Staff,23,0,25,2
1713329965917,EDS 125,A00,507246,Hopkins; Megan Beth,29,0,30,1
1713329966946,EDS 128A,A01,507264,Fargason; Sharon Gayle,26,0,26,0
1713329967970,EDS 128B,A01,507293,Pappas; Elizabeth,30,0,30,0
1713329968996,EDS 139,A00,507294,Fargason; Sharon Gayle,30,0,30,0
1713329968996,EDS 139,B00,507313,Pappas; Elizabeth,30,0,30,0
1713329970021,EDS 201,A00,507315,Staff,26,0,30,4
1713329971045,EDS 203,A01,507317,Halter; Christopher P.,26,0,30,4
1713329972071,EDS 204R,A01,507319,Halter; Christopher P.,3,0,30,27
1713329972071,EDS 204R,B01,507331,Heinzman; Erica M.,28,0,30,2
1713329973099,EDS 206R,A00,507332,Staff,4,0,30,26
1713329973099,EDS 206R,B00,507343,Staff,28,0,30,2
1713329974128,EDS 250,A00,507344,Hemans; Patricia Ann Benitez,36,0,40,4
1713329975160,EDS 281,A00,507345,Daly; Alan J.,18,0,18,0
1713329976183,EDS 284,A00,507350,Daly; Alan J.,16,0,16,0
1713329977221,EDS 286,A00,507359,Fine; Sarah,18,0,18,0
1713329978248,EDS 289C,A01,507361,Daly; Alan J.,18,0,18,0
1713329979274,EDS 290,A00,507366,Hofstetter; Carolyn,15,0,15,0
1713329980301,LIGM 5A,A00,507421,Fischer-Grunski; Eva K,20,0,20,0
1713329981326,LIGM 5B,A00,507423,Fischer-Grunski; Eva K,20,0,20,0
1713329982355,LIGM 5C,A00,507425,Fischer-Grunski; Eva K,20,0,20,0
1713329983381,LIIT 5AS,A00,507427,Carnelos; Chiara,20,0,20,0
1713329984407,LIIT 5BS,A00,507430,Carnelos; Chiara,20,0,20,0
1713329985437,LIIT 5CS,A00,507432,Carnelos; Chiara,20,0,20,0
1713329986461,LISP 5A,A00,507541,Munoz Sanchez; Alicia,17,0,20,3
1713329987486,LISP 5B,A00,507671,Munoz Sanchez; Alicia,15,0,20,5
1713329988511,LISP 5C,A00,507696,Munoz Sanchez; Alicia,15,0,20,5
1713329989536,MAE 197,001,528363,Boechler; Nicholas Sebastia,9998,0,9999,1
1713329990562,MATH 197,001,523477,Kedlaya; Kiran S.,9999,0,9999,0
1713329990562,MATH 197,002,563811,Zhang; Danna,9999,0,9999,0
1713329991588,MCWP 40R,A00,518780,Staff,20,0,20,0
1713329991588,MCWP 40R,B00,518781,Staff,19,0,20,1
1713329991588,MCWP 40R,C00,518783,Staff,19,0,20,1
1713329992619,MCWP 50R,A00,518791,Staff,20,0,20,0
1713329992619,MCWP 50R,B00,518792,Staff,17,0,20,3
1713329992619,MCWP 50R,C00,518793,Staff,19,0,20,1
1713329992619,MCWP 50R,D00,518794,Staff,16,0,20,4
1713329992619,MCWP 50R,E00,518795,Staff,16,0,20,4
1713329992619,MCWP 50R,F00,518796,Staff,19,0,20,1
1713329992619,MCWP 50R,G00,518797,Staff,19,0,20,1
1713329993645,MMW 12R,A01,514034,Herbst; Matthew,15,0,16,1
1713329993645,MMW 12R,A02,514035,Herbst; Matthew,16,0,16,0
1713329994670,MMW 13R,A01,514037,Staff,12,0,16,4
1713329994670,MMW 13R,A02,514039,Staff,16,0,16,0
1713329996724,SIO 295LS,A00,523233,Staff,19,0,30,11
1713329997753,SIO 295S,A00,523232,Staff,19,0,30,11
1713329998783,SOCI 117,A01,494376,Staff,2,0,5,3
1713329999813,WES 237B,A00,494380,Staff,19,0,20,1
1713330001879,AESE 279B,A00,494370,Wade; Jon P,33,0,33,0
1713330002913,ANAR 135S,A00,494369,Braswell; Geoffrey E.,0,0,0,0
1713330003944,CAT 124RS,A01,519847,Geibel; William,17,0,20,3
1713330004970,CAT 125RS,A01,515971,Geibel; William,17,0,20,3
1713330005994,CLRE 250,A00,511389,Morris; Sheldon,9996,0,9999,3
1713330007027,CLRE 251,A00,507176,Mehta; Ravindra L.,9996,0,9999,3
1713330007027,CLRE 251,B00,511410,Mehta; Ravindra L.,9998,0,9999,1
1713330008054,CLRE 252,A00,507189,Cuomo; Raphael Eduardo,9998,0,9999,1
1713330009077,CLRE 253,A00,507199,Vaida; Florin,9997,0,9999,2
1713330009077,CLRE 253,B00,507202,Vaida; Florin,9999,0,9999,0
1713330010103,CLRE 259,A00,507211,Patel; Hemal,9996,0,9999,3
1713330011128,CLRE 260,A00,507221,Cuomo; Raphael Eduardo,9999,0,9999,0
1713330012153,CLRE 297,001,507242,Cuomo; Raphael Eduardo,9999,0,9999,0
1713330013177,CSE 191,A00,516875,Minnes Kemp; Mor Mia,9999,0,9999,0
1713330014203,CSS 201S,A01,494383,Staff,35,0,35,0
1713330015230,CSS 202S,A01,494387,Staff,35,0,35,0
1713330016255,EAP 100,A00,516065,Staff,9792,0,9999,207
1713330017286,ECE 45,A01,507414,Staff,51,0,60,9
1713330018312,ECE 100,A01,507416,Baghdadchi; Saharnaz,10,0,20,10
1713330018312,ECE 100,A02,507418,Baghdadchi; Saharnaz,20,0,20,0
1713330019337,ECE 111,A01,507420,Staff,38,0,50,12
1713330020367,ECE 197,001,548057,Sievenpiper; Daniel F.,9998,0,9999,1
1713330021393,EDS 115,A00,507243,Choi; Bailey Miyeon,28,0,28,0
1713330022478,EDS 117,A01,494379,Staff,23,0,25,2
1713330023505,EDS 125,A00,507246,Hopkins; Megan Beth,29,0,30,1
1713330024535,EDS 128A,A01,507264,Fargason; Sharon Gayle,26,0,26,0
1713330025565,EDS 128B,A01,507293,Pappas; Elizabeth,30,0,30,0
1713330026590,EDS 139,A00,507294,Fargason; Sharon Gayle,30,0,30,0
1713330026590,EDS 139,B00,507313,Pappas; Elizabeth,30,0,30,0
1713330027615,EDS 201,A00,507315,Staff,26,0,30,4
1713330028641,EDS 203,A01,507317,Halter; Christopher P.,26,0,30,4
1713330029667,EDS 204R,A01,507319,Halter; Christopher P.,3,0,30,27
1713330029667,EDS 204R,B01,507331,Heinzman; Erica M.,28,0,30,2
1713330030693,EDS 206R,A00,507332,Staff,4,0,30,26
1713330030693,EDS 206R,B00,507343,Staff,28,0,30,2
1713330031720,EDS 250,A00,507344,Hemans; Patricia Ann Benitez,36,0,40,4
1713330032748,EDS 281,A00,507345,Daly; Alan J.,18,0,18,0
1713330033775,EDS 284,A00,507350,Daly; Alan J.,16,0,16,0
1713330034803,EDS 286,A00,507359,Fine; Sarah,18,0,18,0
1713330035828,EDS 289C,A01,507361,Daly; Alan J.,18,0,18,0
1713330036853,EDS 290,A00,507366,Hofstetter; Carolyn,15,0,15,0
1713330037879,LIGM 5A,A00,507421,Fischer-Grunski; Eva K,20,0,20,0
1713330038906,LIGM 5B,A00,507423,Fischer-Grunski; Eva K,20,0,20,0
1713330039931,LIGM 5C,A00,507425,Fischer-Grunski; Eva K,20,0,20,0
1713330040958,LIIT 5AS,A00,507427,Carnelos; Chiara,20,0,20,0
1713330041983,LIIT 5BS,A00,507430,Carnelos; Chiara,20,0,20,0
1713330043013,LIIT 5CS,A00,507432,Carnelos; Chiara,20,0,20,0
1713330044041,LISP 5A,A00,507541,Munoz Sanchez; Alicia,17,0,20,3
1713330045069,LISP 5B,A00,507671,Munoz Sanchez; Alicia,15,0,20,5
1713330046093,LISP 5C,A00,507696,Munoz Sanchez; Alicia,15,0,20,5
1713330047122,MAE 197,001,528363,Boechler; Nicholas Sebastia,9998,0,9999,1
1713330048149,MATH 197,001,523477,Kedlaya; Kiran S.,9999,0,9999,0
1713330048149,MATH 197,002,563811,Zhang; Danna,9999,0,9999,0
1713330049176,MCWP 40R,A00,518780,Staff,20,0,20,0
1713330049176,MCWP 40R,B00,518781,Staff,19,0,20,1
1713330049176,MCWP 40R,C00,518783,Staff,19,0,20,1
1713330050204,MCWP 50R,A00,518791,Staff,20,0,20,0
1713330050204,MCWP 50R,B00,518792,Staff,17,0,20,3
1713330050204,MCWP 50R,C00,518793,Staff,19,0,20,1
1713330050204,MCWP 50R,D00,518794,Staff,16,0,20,4
1713330050204,MCWP 50R,E00,518795,Staff,16,0,20,4
1713330050204,MCWP 50R,F00,518796,Staff,19,0,20,1
1713330050204,MCWP 50R,G00,518797,Staff,19,0,20,1
1713330051232,MMW 12R,A01,514034,Herbst; Matthew,15,0,16,1
1713330051232,MMW 12R,A02,514035,Herbst; Matthew,16,0,16,0
1713330052258,MMW 13R,A01,514037,Staff,12,0,16,4
1713330052258,MMW 13R,A02,514039,Staff,16,0,16,0
1713330054307,SIO 295LS,A00,523233,Staff,19,0,30,11
1713330055335,SIO 295S,A00,523232,Staff,19,0,30,11
1713330056363,SOCI 117,A01,494376,Staff,2,0,5,3
1713330057394,WES 237B,A00,494380,Staff,19,0,20,1
1713330059516,AESE 279B,A00,494370,Wade; Jon P,33,0,33,0
1713330060546,ANAR 135S,A00,494369,Braswell; Geoffrey E.,0,0,0,0
1713330061574,CAT 124RS,A01,519847,Geibel; William,17,0,20,3
1713330062600,CAT 125RS,A01,515971,Geibel; William,17,0,20,3
1713330063629,CLRE 250,A00,511389,Morris; Sheldon,9996,0,9999,3
1713330064662,CLRE 251,A00,507176,Mehta; Ravindra L.,9996,0,9999,3
1713330064662,CLRE 251,B00,511410,Mehta; Ravindra L.,9998,0,9999,1
1713330065686,CLRE 252,A00,507189,Cuomo; Raphael Eduardo,9998,0,9999,1
1713330066713,CLRE 253,A00,507199,Vaida; Florin,9997,0,9999,2
1713330066713,CLRE 253,B00,507202,Vaida; Florin,9999,0,9999,0
1713330067739,CLRE 259,A00,507211,Patel; Hemal,9996,0,9999,3
1713330068763,CLRE 260,A00,507221,Cuomo; Raphael Eduardo,9999,0,9999,0
1713330069789,CLRE 297,001,507242,Cuomo; Raphael Eduardo,9999,0,9999,0
1713330070818,CSE 191,A00,516875,Minnes Kemp; Mor Mia,9999,0,9999,0
1713330071848,CSS 201S,A01,494383,Staff,35,0,35,0
1713330072875,CSS 202S,A01,494387,Staff,35,0,35,0
1713330073901,EAP 100,A00,516065,Staff,9792,0,9999,207
1713330074926,ECE 45,A01,507414,Staff,51,0,60,9
1713330075952,ECE 100,A01,507416,Baghdadchi; Saharnaz,10,0,20,10
1713330075952,ECE 100,A02,507418,Baghdadchi; Saharnaz,20,0,20,0
1713330076982,ECE 111,A01,507420,Staff,38,0,50,12
1713330078010,ECE 197,001,548057,Sievenpiper; Daniel F.,9998,0,9999,1
1713330079042,EDS 115,A00,507243,Choi; Bailey Miyeon,28,0,28,0
1713330080071,EDS 117,A01,494379,Staff,23,0,25,2
1713330081097,EDS 125,A00,507246,Hopkins; Megan Beth,29,0,30,1
1713330082122,EDS 128A,A01,507264,Fargason; Sharon Gayle,26,0,26,0
1713330083152,EDS 128B,A01,507293,Pappas; Elizabeth,30,0,30,0
1713330084177,EDS 139,A00,507294,Fargason; Sharon Gayle,30,0,30,0
1713330084177,EDS 139,B00,507313,Pappas; Elizabeth,30,0,30,0
1713330085205,EDS 201,A00,507315,Staff,26,0,30,4
1713330086230,EDS 203,A01,507317,Halter; Christopher P.,26,0,30,4
1713330087257,EDS 204R,A01,507319,Halter; Christopher P.,3,0,30,27
1713330087257,EDS 204R,B01,507331,Heinzman; Erica M.,28,0,30,2
1713330088284,EDS 206R,A00,507332,Staff,4,0,30,26
1713330088284,EDS 206R,B00,507343,Staff,28,0,30,2
1713330089313,EDS 250,A00,507344,Hemans; Patricia Ann Benitez,36,0,40,4
1713330090340,EDS 281,A00,507345,Daly; Alan J.,18,0,18,0
1713330091365,EDS 284,A00,507350,Daly; Alan J.,16,0,16,0
1713330092394,EDS 286,A00,507359,Fine; Sarah,18,0,18,0
1713330093418,EDS 289C,A01,507361,Daly; Alan J.,18,0,18,0
1713330094447,EDS 290,A00,507366,Hofstetter; Carolyn,15,0,15,0
1713330095473,LIGM 5A,A00,507421,Fischer-Grunski; Eva K,20,0,20,0
1713330096501,LIGM 5B,A00,507423,Fischer-Grunski; Eva K,20,0,20,0
1713330097533,LIGM 5C,A00,507425,Fischer-Grunski; Eva K,20,0,20,0
1713330098561,LIIT 5AS,A00,507427,Carnelos; Chiara,20,0,20,0
1713330099584,LIIT 5BS,A00,507430,Carnelos; Chiara,20,0,20,0
1713330100609,LIIT 5CS,A00,507432,Carnelos; Chiara,20,0,20,0
1713330101635,LISP 5A,A00,507541,Munoz Sanchez; Alicia,17,0,20,3
1713330102664,LISP 5B,A00,507671,Munoz Sanchez; Alicia,15,0,20,5
1713330103689,LISP 5C,A00,507696,Munoz Sanchez; Alicia,15,0,20,5
1713330104714,MAE 197,001,528363,Boechler; Nicholas Sebastia,9998,0,9999,1
1713330105741,MATH 197,001,523477,Kedlaya; Kiran S.,9999,0,9999,0
1713330105741,MATH 197,002,563811,Zhang; Danna,9999,0,9999,0
1713330106767,MCWP 40R,A00,518780,Staff,20,0,20,0
1713330106767,MCWP 40R,B00,518781,Staff,19,0,20,1
1713330106767,MCWP 40R,C00,518783,Staff,19,0,20,1
1713330107798,MCWP 50R,A00,518791,Staff,20,0,20,0
1713330107798,MCWP 50R,B00,518792,Staff,17,0,20,3
1713330107798,MCWP 50R,C00,518793,Staff,19,0,20,1
1713330107798,MCWP 50R,D00,518794,Staff,16,0,20,4
1713330107798,MCWP 50R,E00,518795,Staff,16,0,20,4
1713330107798,MCWP 50R,F00,518796,Staff,19,0,20,1
1713330107798,MCWP 50R,G00,518797,Staff,19,0,20,1
1713330108825,MMW 12R,A01,514034,Herbst; Matthew,15,0,16,1
1713330108825,MMW 12R,A02,514035,Herbst; Matthew,16,0,16,0
1713330109849,MMW 13R,A01,514037,Staff,12,0,16,4
1713330109849,MMW 13R,A02,514039,Staff,16,0,16,0
1713330111904,SIO 295LS,A00,523233,Staff,19,0,30,11
1713330112934,SIO 295S,A00,523232,Staff,19,0,30,11
1713330113959,SOCI 117,A01,494376,Staff,2,0,5,3
1713330114983,WES 237B,A00,494380,Staff,19,0,20,1
1713330117053,AESE 279B,A00,494370,Wade; Jon P,33,0,33,0
1713330118080,ANAR 135S,A00,494369,Braswell; Geoffrey E.,0,0,0,0
1713330119111,CAT 124RS,A01,519847,Geibel; William,17,0,20,3
1713330120137,CAT 125RS,A01,515971,Geibel; William,17,0,20,3
1713330121163,CLRE 250,A00,511389,Morris; Sheldon,9996,0,9999,3
1713330122194,CLRE 251,A00,507176,Mehta; Ravindra L.,9996,0,9999,3
1713330122194,CLRE 251,B00,511410,Mehta; Ravindra L.,9998,0,9999,1
1713330123219,CLRE 252,A00,507189,Cuomo; Raphael Eduardo,9998,0,9999,1
1713330124251,CLRE 253,A00,507199,Vaida; Florin,9997,0,9999,2
1713330124251,CLRE 253,B00,507202,Vaida; Florin,9999,0,9999,0
1713330125277,CLRE 259,A00,507211,Patel; Hemal,9996,0,9999,3
1713330126357,CLRE 260,A00,507221,Cuomo; Raphael Eduardo,9999,0,9999,0
1713330127382,CLRE 297,001,507242,Cuomo; Raphael Eduardo,9999,0,9999,0
1713330128408,CSE 191,A00,516875,Minnes Kemp; Mor Mia,9999,0,9999,0
1713330129433,CSS 201S,A01,494383,Staff,35,0,35,0
1713330130457,CSS 202S,A01,494387,Staff,35,0,35,0
1713330131485,EAP 100,A00,516065,Staff,9792,0,9999,207
1713330132510,ECE 45,A01,507414,Staff,51,0,60,9
1713330133536,ECE 100,A01,507416,Baghdadchi; Saharnaz,10,0,20,10
1713330133536,ECE 100,A02,507418,Baghdadchi; Saharnaz,20,0,20,0
1713330134561,ECE 111,A01,507420,Staff,38,0,50,12
1713330135587,ECE 197,001,548057,Sievenpiper; Daniel F.,9998,0,9999,1
1713330136612,EDS 115,A00,507243,Choi; Bailey Miyeon,28,0,28,0
1713330137642,EDS 117,A01,494379,Staff,23,0,25,2
1713330138670,EDS 125,A00,507246,Hopkins; Megan Beth,29,0,30,1
1713330139696,EDS 128A,A01,507264,Fargason; Sharon Gayle,26,0,26,0
1713330140726,EDS 128B,A01,507293,Pappas; Elizabeth,30,0,30,0
1713330141750,EDS 139,A00,507294,Fargason; Sharon Gayle,30,0,30,0
1713330141750,EDS 139,B00,507313,Pappas; Elizabeth,30,0,30,0
1713330142774,EDS 201,A00,507315,Staff,26,0,30,4
1713330143805,EDS 203,A01,507317,Halter; Christopher P.,26,0,30,4
1713330144831,EDS 204R,A01,507319,Halter; Christopher P.,3,0,30,27
1713330144831,EDS 204R,B01,507331,Heinzman; Erica M.,28,0,30,2
1713330145858,EDS 206R,A00,507332,Staff,4,0,30,26
1713330145858,EDS 206R,B00,507343,Staff,28,0,30,2
1713330146887,EDS 250,A00,507344,Hemans; Patricia Ann Benitez,36,0,40,4
1713330147913,EDS 281,A00,507345,Daly; Alan J.,18,0,18,0
1713330148943,EDS 284,A00,507350,Daly; Alan J.,16,0,16,0
1713330149969,EDS 286,A00,507359,Fine; Sarah,18,0,18,0
1713330150994,EDS 289C,A01,507361,Daly; Alan J.,18,0,18,0
1713330152020,EDS 290,A00,507366,Hofstetter; Carolyn,15,0,15,0
1713330153051,LIGM 5A,A00,507421,Fischer-Grunski; Eva K,20,0,20,0
1713330154075,LIGM 5B,A00,507423,Fischer-Grunski; Eva K,20,0,20,0
1713330155104,LIGM 5C,A00,507425,Fischer-Grunski; Eva K,20,0,20,0
1713330156133,LIIT 5AS,A00,507427,Carnelos; Chiara,20,0,20,0
1713330157159,LIIT 5BS,A00,507430,Carnelos; Chiara,20,0,20,0
1713330158184,LIIT 5CS,A00,507432,Carnelos; Chiara,20,0,20,0
1713330159209,LISP 5A,A00,507541,Munoz Sanchez; Alicia,17,0,20,3
1713330160234,LISP 5B,A00,507671,Munoz Sanchez; Alicia,15,0,20,5
1713330161260,LISP 5C,A00,507696,Munoz Sanchez; Alicia,15,0,20,5
1713330162284,MAE 197,001,528363,Boechler; Nicholas Sebastia,9998,0,9999,1
1713330163311,MATH 197,001,523477,Kedlaya; Kiran S.,9999,0,9999,0
1713330163311,MATH 197,002,563811,Zhang; Danna,9999,0,9999,0
1713330164337,MCWP 40R,A00,518780,Staff,20,0,20,0
1713330164337,MCWP 40R,B00,518781,Staff,19,0,20,1
1713330164337,MCWP 40R,C00,518783,Staff,19,0,20,1
1713330165364,MCWP 50R,A00,518791,Staff,20,0,20,0
1713330165364,MCWP 50R,B00,518792,Staff,17,0,20,3
1713330165364,MCWP 50R,C00,518793,Staff,19,0,20,1
1713330165364,MCWP 50R,D00,518794,Staff,16,0,20,4
1713330165364,MCWP 50R,E00,518795,Staff,16,0,20,4
1713330165364,MCWP 50R,F00,518796,Staff,19,0,20,1
1713330165364,MCWP 50R,G00,518797,Staff,19,0,20,1
1713330166390,MMW 12R,A01,514034,Herbst; Matthew,15,0,16,1
1713330166390,MMW 12R,A02,514035,Herbst; Matthew,16,0,16,0
1713330167415,MMW 13R,A01,514037,Staff,12,0,16,4
1713330167415,MMW 13R,A02,514039,Staff,16,0,16,0
1713330169470,SIO 295LS,A00,523233,Staff,19,0,30,11
1713330170495,SIO 295S,A00,523232,Staff,19,0,30,11
1713330171526,SOCI 117,A01,494376,Staff,2,0,5,3
1713330172553,WES 237B,A00,494380,Staff,19,0,20,1
1713330174621,AESE 279B,A00,494370,Wade; Jon P,33,0,33,0
1713330175647,ANAR 135S,A00,494369,Braswell; Geoffrey E.,0,0,0,0
1713330176676,CAT 124RS,A01,519847,Geibel; William,17,0,20,3
1713330177705,CAT 125RS,A01,515971,Geibel; William,17,0,20,3
1713330178734,CLRE 250,A00,511389,Morris; Sheldon,9996,0,9999,3
1713330179768,CLRE 251,A00,507176,Mehta; Ravindra L.,9996,0,9999,3
1713330179768,CLRE 251,B00,511410,Mehta; Ravindra L.,9998,0,9999,1
1713330180798,CLRE 252,A00,507189,Cuomo; Raphael Eduardo,9998,0,9999,1
1713330181824,CLRE 253,A00,507199,Vaida; Florin,9997,0,9999,2
1713330181824,CLRE 253,B00,507202,Vaida; Florin,9999,0,9999,0
1713330182851,CLRE 259,A00,507211,Patel; Hemal,9996,0,9999,3
1713330183878,CLRE 260,A00,507221,Cuomo; Raphael Eduardo,9999,0,9999,0
1713330184903,CLRE 297,001,507242,Cuomo; Raphael Eduardo,9999,0,9999,0
1713330185928,CSE 191,A00,516875,Minnes Kemp; Mor Mia,9999,0,9999,0
1713330186957,CSS 201S,A01,494383,Staff,35,0,35,0
1713330187987,CSS 202S,A01,494387,Staff,35,0,35,0
1713330189012,EAP 100,A00,516065,Staff,9792,0,9999,207
1713330190037,ECE 45,A01,507414,Staff,51,0,60,9
1713330191065,ECE 100,A01,507416,Baghdadchi; Saharnaz,10,0,20,10
1713330191065,ECE 100,A02,507418,Baghdadchi; Saharnaz,20,0,20,0
1713330192092,ECE 111,A01,507420,Staff,38,0,50,12
1713330193118,ECE 197,001,548057,Sievenpiper; Daniel F.,9998,0,9999,1
1713330194145,EDS 115,A00,507243,Choi; Bailey Miyeon,28,0,28,0
1713330195170,EDS 117,A01,494379,Staff,23,0,25,2
1713330196200,EDS 125,A00,507246,Hopkins; Megan Beth,29,0,30,1
1713330197230,EDS 128A,A01,507264,Fargason; Sharon Gayle,26,0,26,0
1713330198259,EDS 128B,A01,507293,Pappas; Elizabeth,30,0,30,0
1713330199283,EDS 139,A00,507294,Fargason; Sharon Gayle,30,0,30,0
1713330199283,EDS 139,B00,507313,Pappas; Elizabeth,30,0,30,0
1713330200308,EDS 201,A00,507315,Staff,26,0,30,4
1713330201335,EDS 203,A01,507317,Halter; Christopher P.,26,0,30,4
1713330202461,EDS 204R,A01,507319,Halter; Christopher P.,3,0,30,27
1713330202461,EDS 204R,B01,507331,Heinzman; Erica M.,28,0,30,2
1713330203489,EDS 206R,A00,507332,Staff,4,0,30,26
1713330203489,EDS 206R,B00,507343,Staff,28,0,30,2
1713330204516,EDS 250,A00,507344,Hemans; Patricia Ann Benitez,36,0,40,4
1713330205543,EDS 281,A00,507345,Daly; Alan J.,18,0,18,0
1713330206567,EDS 284,A00,507350,Daly; Alan J.,16,0,16,0
1713330207592,EDS 286,A00,507359,Fine; Sarah,18,0,18,0
1713330208621,EDS 289C,A01,507361,Daly; Alan J.,18,0,18,0
1713330209650,EDS 290,A00,507366,Hofstetter; Carolyn,15,0,15,0
1713330210679,LIGM 5A,A00,507421,Fischer-Grunski; Eva K,20,0,20,0
1713330211705,LIGM 5B,A00,507423,Fischer-Grunski; Eva K,20,0,20,0
1713330212731,LIGM 5C,A00,507425,Fischer-Grunski; Eva K,20,0,20,0
1713330213757,LIIT 5AS,A00,507427,Carnelos; Chiara,20,0,20,0
1713330214787,LIIT 5BS,A00,507430,Carnelos; Chiara,20,0,20,0
1713330215816,LIIT 5CS,A00,507432,Carnelos; Chiara,20,0,20,0
1713330216842,LISP 5A,A00,507541,Munoz Sanchez; Alicia,17,0,20,3
1713330217867,LISP 5B,A00,507671,Munoz Sanchez; Alicia,15,0,20,5
1713330218898,LISP 5C,A00,507696,Munoz Sanchez; Alicia,15,0,20,5
1713330219927,MAE 197,001,528363,Boechler; Nicholas Sebastia,9998,0,9999,1
1713330220958,MATH 197,001,523477,Kedlaya; Kiran S.,9999,0,9999,0
1713330220958,MATH 197,002,563811,Zhang; Danna,9999,0,9999,0
1713330221984,MCWP 40R,A00,518780,Staff,20,0,20,0
1713330221984,MCWP 40R,B00,518781,Staff,19,0,20,1
1713330221984,MCWP 40R,C00,518783,Staff,19,0,20,1
1713330223015,MCWP 50R,A00,518791,Staff,20,0,20,0
1713330223015,MCWP 50R,B00,518792,Staff,17,0,20,3
1713330223015,MCWP 50R,C00,518793,Staff,19,0,20,1
1713330223015,MCWP 50R,D00,518794,Staff,16,0,20,4
1713330223015,MCWP 50R,E00,518795,Staff,16,0,20,4
1713330223015,MCWP 50R,F00,518796,Staff,19,0,20,1
1713330223015,MCWP 50R,G00,518797,Staff,19,0,20,1
1713330224041,MMW 12R,A01,514034,Herbst; Matthew,15,0,16,1
1713330224041,MMW 12R,A02,514035,Herbst; Matthew,16,0,16,0
1713330225068,MMW 13R,A01,514037,Staff,12,0,16,4
1713330225068,MMW 13R,A02,514039,Staff,16,0,16,0
1713330227127,SIO 295LS,A00,523233,Staff,19,0,30,11
1713330228155,SIO 295S,A00,523232,Staff,19,0,30,11
1713330229181,SOCI 117,A01,494376,Staff,2,0,5,3
1713330230263,WES 237B,A00,494380,Staff,19,0,20,1
1713330232331,AESE 279B,A00,494370,Wade; Jon P,33,0,33,0
1713330233356,ANAR 135S,A00,494369,Braswell; Geoffrey E.,0,0,0,0
1713330234381,CAT 124RS,A01,519847,Geibel; William,17,0,20,3
1713330235406,CAT 125RS,A01,515971,Geibel; William,17,0,20,3
1713330236433,CLRE 250,A00,511389,Morris; Sheldon,9996,0,9999,3
1713330237460,CLRE 251,A00,507176,Mehta; Ravindra L.,9996,0,9999,3
1713330237460,CLRE 251,B00,511410,Mehta; Ravindra L.,9998,0,9999,1
1713330238487,CLRE 252,A00,507189,Cuomo; Raphael Eduardo,9998,0,9999,1
1713330239515,CLRE 253,A00,507199,Vaida; Florin,9997,0,9999,2
1713330239515,CLRE 253,B00,507202,Vaida; Florin,9999,0,9999,0
1713330240540,CLRE 259,A00,507211,Patel; Hemal,9996,0,9999,3
1713330241568,CLRE 260,A00,507221,Cuomo; Raphael Eduardo,9999,0,9999,0
1713330242597,CLRE 297,001,507242,Cuomo; Raphael Eduardo,9999,0,9999,0
1713330243621,CSE 191,A00,516875,Minnes Kemp; Mor Mia,9999,0,9999,0
1713330244649,CSS 201S,A01,494383,Staff,35,0,35,0
1713330245676,CSS 202S,A01,494387,Staff,35,0,35,0
1713330246699,EAP 100,A00,516065,Staff,9792,0,9999,207
1713330247725,ECE 45,A01,507414,Staff,51,0,60,9
1713330248750,ECE 100,A01,507416,Baghdadchi; Saharnaz,10,0,20,10
1713330248750,ECE 100,A02,507418,Baghdadchi; Saharnaz,20,0,20,0
1713330249773,ECE 111,A01,507420,Staff,38,0,50,12
1713330250801,ECE 197,001,548057,Sievenpiper; Daniel F.,9998,0,9999,1
1713330251828,EDS 115,A00,507243,Choi; Bailey Miyeon,28,0,28,0
1713330252853,EDS 117,A01,494379,Staff,23,0,25,2
1713330253892,EDS 125,A00,507246,Hopkins; Megan Beth,29,0,30,1
1713330254921,EDS 128A,A01,507264,Fargason; Sharon Gayle,26,0,26,0
1713330255948,EDS 128B,A01,507293,Pappas; Elizabeth,30,0,30,0
1713330256982,EDS 139,A00,507294,Fargason; Sharon Gayle,30,0,30,0
1713330256982,EDS 139,B00,507313,Pappas; Elizabeth,30,0,30,0
1713330258008,EDS 201,A00,507315,Staff,26,0,30,4
1713330259038,EDS 203,A01,507317,Halter; Christopher P.,26,0,30,4
1713330260065,EDS 204R,A01,507319,Halter; Christopher P.,3,0,30,27
1713330260065,EDS 204R,B01,507331,Heinzman; Erica M.,28,0,30,2
1713330261090,EDS 206R,A00,507332,Staff,4,0,30,26
1713330261090,EDS 206R,B00,507343,Staff,28,0,30,2
1713330262119,EDS 250,A00,507344,Hemans; Patricia Ann Benitez,36,0,40,4
1713330263145,EDS 281,A00,507345,Daly; Alan J.,18,0,18,0
1713330264176,EDS 284,A00,507350,Daly; Alan J.,16,0,16,0
1713330265205,EDS 286,A00,507359,Fine; Sarah,18,0,18,0
1713330266230,EDS 289C,A01,507361,Daly; Alan J.,18,0,18,0
1713330267254,EDS 290,A00,507366,Hofstetter; Carolyn,15,0,15,0
1713330268281,LIGM 5A,A00,507421,Fischer-Grunski; Eva K,20,0,20,0
1713330269307,LIGM 5B,A00,507423,Fischer-Grunski; Eva K,20,0,20,0
1713330270332,LIGM 5C,A00,507425,Fischer-Grunski; Eva K,20,0,20,0
1713330271360,LIIT 5AS,A00,507427,Carnelos; Chiara,20,0,20,0
1713330272383,LIIT 5BS,A00,507430,Carnelos; Chiara,20,0,20,0
1713330273410,LIIT 5CS,A00,507432,Carnelos; Chiara,20,0,20,0
1713330274436,LISP 5A,A00,507541,Munoz Sanchez; Alicia,17,0,20,3
1713330275461,LISP 5B,A00,507671,Munoz Sanchez; Alicia,15,0,20,5
1713330276489,LISP 5C,A00,507696,Munoz Sanchez; Alicia,15,0,20,5
1713330277515,MAE 197,001,528363,Boechler; Nicholas Sebastia,9998,0,9999,1
1713330278548,MATH 197,001,523477,Kedlaya; Kiran S.,9999,0,9999,0
1713330278548,MATH 197,002,563811,Zhang; Danna,9999,0,9999,0
1713330279578,MCWP 40R,A00,518780,Staff,20,0,20,0
1713330279578,MCWP 40R,B00,518781,Staff,19,0,20,1
1713330279578,MCWP 40R,C00,518783,Staff,19,0,20,1
1713330280603,MCWP 50R,A00,518791,Staff,20,0,20,0
1713330280603,MCWP 50R,B00,518792,Staff,17,0,20,3
1713330280603,MCWP 50R,C00,518793,Staff,19,0,20,1
1713330280603,MCWP 50R,D00,518794,Staff,16,0,20,4
1713330280603,MCWP 50R,E00,518795,Staff,16,0,20,4
1713330280603,MCWP 50R,F00,518796,Staff,19,0,20,1
1713330280603,MCWP 50R,G00,518797,Staff,19,0,20,1
1713330281635,MMW 12R,A01,514034,Herbst; Matthew,15,0,16,1
1713330281635,MMW 12R,A02,514035,Herbst; Matthew,16,0,16,0
1713330282662,MMW 13R,A01,514037,Staff,12,0,16,4
1713330282662,MMW 13R,A02,514039,Staff,16,0,16,0
1713330284718,SIO 295LS,A00,523233,Staff,19,0,30,11
1713330285746,SIO 295S,A00,523232,Staff,19,0,30,11
1713330286771,SOCI 117,A01,494376,Staff,2,0,5,3
1713330287798,WES 237B,A00,494380,Staff,19,0,20,1
1713330289867,AESE 279B,A00,494370,Wade; Jon P,33,0,33,0
1713330290893,ANAR 135S,A00,494369,Braswell; Geoffrey E.,0,0,0,0
1713330291920,CAT 124RS,A01,519847,Geibel; William,17,0,20,3
1713330292948,CAT 125RS,A01,515971,Geibel; William,17,0,20,3
1713330293974,CLRE 250,A00,511389,Morris; Sheldon,9996,0,9999,3
1713330295000,CLRE 251,A00,507176,Mehta; Ravindra L.,9996,0,9999,3
1713330295000,CLRE 251,B00,511410,Mehta; Ravindra L.,9998,0,9999,1
1713330296026,CLRE 252,A00,507189,Cuomo; Raphael Eduardo,9998,0,9999,1
1713330297052,CLRE 253,A00,507199,Vaida; Florin,9997,0,9999,2
1713330297052,CLRE 253,B00,507202,Vaida; Florin,9999,0,9999,0
1713330298082,CLRE 259,A00,507211,Patel; Hemal,9996,0,9999,3
1713330299106,CLRE 260,A00,507221,Cuomo; Raphael Eduardo,9999,0,9999,0
1713330300134,CLRE 297,001,507242,Cuomo; Raphael Eduardo,9999,0,9999,0
1713330301160,CSE 191,A00,516875,Minnes Kemp; Mor Mia,9999,0,9999,0
1713330302188,CSS 201S,A01,494383,Staff,35,0,35,0
1713330303218,CSS 202S,A01,494387,Staff,35,0,35,0
1713330304242,EAP 100,A00,516065,Staff,9792,0,9999,207
1713330305265,ECE 45,A01,507414,Staff,51,0,60,9
1713330306296,ECE 100,A01,507416,Baghdadchi; Saharnaz,10,0,20,10
1713330306296,ECE 100,A02,507418,Baghdadchi; Saharnaz,20,0,20,0
1713330307321,ECE 111,A01,507420,Staff,38,0,50,12
1713330308347,ECE 197,001,548057,Sievenpiper; Daniel F.,9998,0,9999,1
1713330309373,EDS 115,A00,507243,Choi; Bailey Miyeon,28,0,28,0
1713330310398,EDS 117,A01,494379,Staff,23,0,25,2
1713330311427,EDS 125,A00,507246,Hopkins; Megan Beth,29,0,30,1
1713330312452,EDS 128A,A01,507264,Fargason; Sharon Gayle,26,0,26,0
1713330313479,EDS 128B,A01,507293,Pappas; Elizabeth,30,0,30,0
1713330314507,EDS 139,A00,507294,Fargason; Sharon Gayle,30,0,30,0
1713330314507,EDS 139,B00,507313,Pappas; Elizabeth,30,0,30,0
1713330315532,EDS 201,A00,507315,Staff,26,0,30,4
1713330316560,EDS 203,A01,507317,Halter; Christopher P.,26,0,30,4
1713330317590,EDS 204R,A01,507319,Halter; Christopher P.,3,0,30,27
1713330317590,EDS 204R,B01,507331,Heinzman; Erica M.,28,0,30,2
1713330318619,EDS 206R,A00,507332,Staff,4,0,30,26
1713330318619,EDS 206R,B00,507343,Staff,28,0,30,2
1713330319651,EDS 250,A00,507344,Hemans; Patricia Ann Benitez,36,0,40,4
1713330320680,EDS 281,A00,507345,Daly; Alan J.,18,0,18,0
1713330321710,EDS 284,A00,507350,Daly; Alan J.,16,0,16,0
1713330322734,EDS 286,A00,507359,Fine; Sarah,18,0,18,0
1713330323762,EDS 289C,A01,507361,Daly; Alan J.,18,0,18,0
1713330324790,EDS 290,A00,507366,Hofstetter; Carolyn,15,0,15,0
1713330325820,LIGM 5A,A00,507421,Fischer-Grunski; Eva K,20,0,20,0
1713330326850,LIGM 5B,A00,507423,Fischer-Grunski; Eva K,20,0,20,0
1713330327881,LIGM 5C,A00,507425,Fischer-Grunski; Eva K,20,0,20,0
1713330328907,LIIT 5AS,A00,507427,Carnelos; Chiara,20,0,20,0
1713330329931,LIIT 5BS,A00,507430,Carnelos; Chiara,20,0,20,0
1713330330969,LIIT 5CS,A00,507432,Carnelos; Chiara,20,0,20,0
1713330332000,LISP 5A,A00,507541,Munoz Sanchez; Alicia,17,0,20,3
1713330333024,LISP 5B,A00,507671,Munoz Sanchez; Alicia,15,0,20,5
1713330334108,LISP 5C,A00,507696,Munoz Sanchez; Alicia,15,0,20,5
1713330335133,MAE 197,001,528363,Boechler; Nicholas Sebastia,9998,0,9999,1
1713330336159,MATH 197,001,523477,Kedlaya; Kiran S.,9999,0,9999,0
1713330336159,MATH 197,002,563811,Zhang; Danna,9999,0,9999,0
1713330337188,MCWP 40R,A00,518780,Staff,20,0,20,0
1713330337188,MCWP 40R,B00,518781,Staff,19,0,20,1
1713330337188,MCWP 40R,C00,518783,Staff,19,0,20,1
1713330338216,MCWP 50R,A00,518791,Staff,20,0,20,0
1713330338216,MCWP 50R,B00,518792,Staff,17,0,20,3
1713330338216,MCWP 50R,C00,518793,Staff,19,0,20,1
1713330338216,MCWP 50R,D00,518794,Staff,16,0,20,4
1713330338216,MCWP 50R,E00,518795,Staff,16,0,20,4
1713330338216,MCWP 50R,F00,518796,Staff,19,0,20,1
1713330338216,MCWP 50R,G00,518797,Staff,19,0,20,1
1713330339247,MMW 12R,A01,514034,Herbst; Matthew,15,0,16,1
1713330339247,MMW 12R,A02,514035,Herbst; Matthew,16,0,16,0
1713330340273,MMW 13R,A01,514037,Staff,12,0,16,4
1713330340273,MMW 13R,A02,514039,Staff,16,0,16,0
1713330342467,SIO 295LS,A00,523233,Staff,19,0,30,11
1713330343491,SIO 295S,A00,523232,Staff,19,0,30,11
1713330344520,SOCI 117,A01,494376,Staff,2,0,5,3
1713330345546,WES 237B,A00,494380,Staff,19,0,20,1
1713330347616,AESE 279B,A00,494370,Wade; Jon P,33,0,33,0
1713330348645,ANAR 135S,A00,494369,Braswell; Geoffrey E.,0,0,0,0
1713330349674,CAT 124RS,A01,519847,Geibel; William,17,0,20,3
1713330350699,CAT 125RS,A01,515971,Geibel; William,17,0,20,3
1713330351728,CLRE 250,A00,511389,Morris; Sheldon,9996,0,9999,3
1713330352761,CLRE 251,A00,507176,Mehta; Ravindra L.,9996,0,9999,3
1713330352761,CLRE 251,B00,511410,Mehta; Ravindra L.,9998,0,9999,1
1713330353788,CLRE 252,A00,507189,Cuomo; Raphael Eduardo,9998,0,9999,1
1713330354814,CLRE 253,A00,507199,Vaida; Florin,9997,0,9999,2
1713330354814,CLRE 253,B00,507202,Vaida; Florin,9999,0,9999,0
1713330355840,CLRE 259,A00,507211,Patel; Hemal,9996,0,9999,3
1713330356865,CLRE 260,A00,507221,Cuomo; Raphael Eduardo,9999,0,9999,0
1713330357890,CLRE 297,001,507242,Cuomo; Raphael Eduardo,9999,0,9999,0
1713330358921,CSE 191,A00,516875,Minnes Kemp; Mor Mia,9999,0,9999,0
1713330359947,CSS 201S,A01,494383,Staff,35,0,35,0
1713330360974,CSS 202S,A01,494387,Staff,35,0,35,0
1713330361998,EAP 100,A00,516065,Staff,9792,0,9999,207
1713330363023,ECE 45,A01,507414,Staff,51,0,60,9
1713330364052,ECE 100,A01,507416,Baghdadchi; Saharnaz,10,0,20,10
1713330364052,ECE 100,A02,507418,Baghdadchi; Saharnaz,20,0,20,0
1713330365077,ECE 111,A01,507420,Staff,38,0,50,12
1713330366108,ECE 197,001,548057,Sievenpiper; Daniel F.,9998,0,9999,1
1713330367133,EDS 115,A00,507243,Choi; Bailey Miyeon,28,0,28,0
1713330368159,EDS 117,A01,494379,Staff,23,0,25,2
1713330369184,EDS 125,A00,507246,Hopkins; Megan Beth,29,0,30,1
1713330370208,EDS 128A,A01,507264,Fargason; Sharon Gayle,26,0,26,0
1713330371233,EDS 128B,A01,507293,Pappas; Elizabeth,30,0,30,0
1713330372260,EDS 139,A00,507294,Fargason; Sharon Gayle,30,0,30,0
1713330372260,EDS 139,B00,507313,Pappas; Elizabeth,30,0,30,0
1713330373287,EDS 201,A00,507315,Staff,26,0,30,4
1713330374315,EDS 203,A01,507317,Halter; Christopher P.,26,0,30,4
1713330375341,EDS 204R,A01,507319,Halter; Christopher P.,3,0,30,27
1713330375341,EDS 204R,B01,507331,Heinzman; Erica M.,28,0,30,2
1713330376367,EDS 206R,A00,507332,Staff,4,0,30,26
1713330376367,EDS 206R,B00,507343,Staff,28,0,30,2
1713330377395,EDS 250,A00,507344,Hemans; Patricia Ann Benitez,36,0,40,4
1713330378420,EDS 281,A00,507345,Daly; Alan J.,18,0,18,0
1713330379447,EDS 284,A00,507350,Daly; Alan J.,16,0,16,0
1713330380475,EDS 286,A00,507359,Fine; Sarah,18,0,18,0
1713330381503,EDS 289C,A01,507361,Daly; Alan J.,18,0,18,0
1713330382529,EDS 290,A00,507366,Hofstetter; Carolyn,15,0,15,0
1713330383558,LIGM 5A,A00,507421,Fischer-Grunski; Eva K,20,0,20,0
1713330384582,LIGM 5B,A00,507423,Fischer-Grunski; Eva K,20,0,20,0
1713330385611,LIGM 5C,A00,507425,Fischer-Grunski; Eva K,20,0,20,0
1713330386640,LIIT 5AS,A00,507427,Carnelos; Chiara,20,0,20,0
1713330387667,LIIT 5BS,A00,507430,Carnelos; Chiara,20,0,20,0
1713330388692,LIIT 5CS,A00,507432,Carnelos; Chiara,20,0,20,0
1713330389720,LISP 5A,A00,507541,Munoz Sanchez; Alicia,17,0,20,3
1713330390745,LISP 5B,A00,507671,Munoz Sanchez; Alicia,15,0,20,5
1713330391772,LISP 5C,A00,507696,Munoz Sanchez; Alicia,15,0,20,5
1713330392797,MAE 197,001,528363,Boechler; Nicholas Sebastia,9998,0,9999,1
1713330393827,MATH 197,001,523477,Kedlaya; Kiran S.,9999,0,9999,0
1713330393827,MATH 197,002,563811,Zhang; Danna,9999,0,9999,0
1713330394852,MCWP 40R,A00,518780,Staff,20,0,20,0
1713330394852,MCWP 40R,B00,518781,Staff,19,0,20,1
1713330394852,MCWP 40R,C00,518783,Staff,19,0,20,1
1713330395880,MCWP 50R,A00,518791,Staff,20,0,20,0
1713330395880,MCWP 50R,B00,518792,Staff,17,0,20,3
1713330395880,MCWP 50R,C00,518793,Staff,19,0,20,1
1713330395880,MCWP 50R,D00,518794,Staff,16,0,20,4
1713330395880,MCWP 50R,E00,518795,Staff,16,0,20,4
1713330395880,MCWP 50R,F00,518796,Staff,19,0,20,1
1713330395880,MCWP 50R,G00,518797,Staff,19,0,20,1
1713330396905,MMW 12R,A01,514034,Herbst; Matthew,15,0,16,1
1713330396905,MMW 12R,A02,514035,Herbst; Matthew,16,0,16,0
1713330397933,MMW 13R,A01,514037,Staff,12,0,16,4
1713330397933,MMW 13R,A02,514039,Staff,16,0,16,0
1713330399990,SIO 295LS,A00,523233,Staff,19,0,30,11
1713330401015,SIO 295S,A00,523232,Staff,19,0,30,11
1713330402042,SOCI 117,A01,494376,Staff,2,0,5,3
1713330403069,WES 237B,A00,494380,Staff,19,0,20,1
1713330405156,AESE 279B,A00,494370,Wade; Jon P,33,0,33,0
1713330406181,ANAR 135S,A00,494369,Braswell; Geoffrey E.,0,0,0,0
1713330407206,CAT 124RS,A01,519847,Geibel; William,17,0,20,3
1713330408230,CAT 125RS,A01,515971,Geibel; William,17,0,20,3
1713330409256,CLRE 250,A00,511389,Morris; Sheldon,9996,0,9999,3
1713330410281,CLRE 251,A00,507176,Mehta; Ravindra L.,9996,0,9999,3
1713330410281,CLRE 251,B00,511410,Mehta; Ravindra L.,9998,0,9999,1
1713330411306,CLRE 252,A00,507189,Cuomo; Raphael Eduardo,9998,0,9999,1
1713330412331,CLRE 253,A00,507199,Vaida; Florin,9997,0,9999,2
1713330412331,CLRE 253,B00,507202,Vaida; Florin,9999,0,9999,0
1713330413356,CLRE 259,A00,507211,Patel; Hemal,9996,0,9999,3
1713330414383,CLRE 260,A00,507221,Cuomo; Raphael Eduardo,9999,0,9999,0
1713330415410,CLRE 297,001,507242,Cuomo; Raphael Eduardo,9999,0,9999,0
1713330416438,CSE 191,A00,516875,Minnes Kemp; Mor Mia,9999,0,9999,0
1713330417463,CSS 201S,A01,494383,Staff,35,0,35,0
1713330418490,CSS 202S,A01,494387,Staff,35,0,35,0
1713330419518,EAP 100,A00,516065,Staff,9792,0,9999,207
1713330420546,ECE 45,A01,507414,Staff,51,0,60,9
1713330421571,ECE 100,A01,507416,Baghdadchi; Saharnaz,10,0,20,10
1713330421571,ECE 100,A02,507418,Baghdadchi; Saharnaz,20,0,20,0
1713330422598,ECE 111,A01,507420,Staff,38,0,50,12
1713330423624,ECE 197,001,548057,Sievenpiper; Daniel F.,9998,0,9999,1
1713330424650,EDS 115,A00,507243,Choi; Bailey Miyeon,28,0,28,0
1713330425676,EDS 117,A01,494379,Staff,23,0,25,2
1713330426704,EDS 125,A00,507246,Hopkins; Megan Beth,29,0,30,1
1713330427729,EDS 128A,A01,507264,Fargason; Sharon Gayle,26,0,26,0
1713330428755,EDS 128B,A01,507293,Pappas; Elizabeth,30,0,30,0
1713330429783,EDS 139,A00,507294,Fargason; Sharon Gayle,30,0,30,0
1713330429783,EDS 139,B00,507313,Pappas; Elizabeth,30,0,30,0
1713330430809,EDS 201,A00,507315,Staff,26,0,30,4
1713330431838,EDS 203,A01,507317,Halter; Christopher P.,26,0,30,4
1713330432864,EDS 204R,A01,507319,Halter; Christopher P.,3,0,30,27
1713330432864,EDS 204R,B01,507331,Heinzman; Erica M.,28,0,30,2
1713330433899,EDS 206R,A00,507332,Staff,4,0,30,26
1713330433899,EDS 206R,B00,507343,Staff,28,0,30,2
1713330434924,EDS 250,A00,507344,Hemans; Patricia Ann Benitez,36,0,40,4
1713330435952,EDS 281,A00,507345,Daly; Alan J.,18,0,18,0
1713330436981,EDS 284,A00,507350,Daly; Alan J.,16,0,16,0
1713330438064,EDS 286,A00,507359,Fine; Sarah,18,0,18,0
1713330439094,EDS 289C,A01,507361,Daly; Alan J.,18,0,18,0
1713330440120,EDS 290,A00,507366,Hofstetter; Carolyn,15,0,15,0
1713330441147,LIGM 5A,A00,507421,Fischer-Grunski; Eva K,20,0,20,0
1713330442174,LIGM 5B,A00,507423,Fischer-Grunski; Eva K,20,0,20,0
1713330443199,LIGM 5C,A00,507425,Fischer-Grunski; Eva K,20,0,20,0
1713330444225,LIIT 5AS,A00,507427,Carnelos; Chiara,20,0,20,0
1713330445250,LIIT 5BS,A00,507430,Carnelos; Chiara,20,0,20,0
1713330446280,LIIT 5CS,A00,507432,Carnelos; Chiara,20,0,20,0
1713330447304,LISP 5A,A00,507541,Munoz Sanchez; Alicia,17,0,20,3
1713330448333,LISP 5B,A00,507671,Munoz Sanchez; Alicia,15,0,20,5
1713330449358,LISP 5C,A00,507696,Munoz Sanchez; Alicia,15,0,20,5
1713330450382,MAE 197,001,528363,Boechler; Nicholas Sebastia,9998,0,9999,1
1713330451412,MATH 197,001,523477,Kedlaya; Kiran S.,9999,0,9999,0
1713330451412,MATH 197,002,563811,Zhang; Danna,9999,0,9999,0
1713330452436,MCWP 40R,A00,518780,Staff,20,0,20,0
1713330452436,MCWP 40R,B00,518781,Staff,19,0,20,1
1713330452436,MCWP 40R,C00,518783,Staff,19,0,20,1
1713330453463,MCWP 50R,A00,518791,Staff,20,0,20,0
1713330453463,MCWP 50R,B00,518792,Staff,17,0,20,3
1713330453463,MCWP 50R,C00,518793,Staff,19,0,20,1
1713330453463,MCWP 50R,D00,518794,Staff,16,0,20,4
1713330453463,MCWP 50R,E00,518795,Staff,16,0,20,4
1713330453463,MCWP 50R,F00,518796,Staff,19,0,20,1
1713330453463,MCWP 50R,G00,518797,Staff,19,0,20,1
1713330454493,MMW 12R,A01,514034,Herbst; Matthew,15,0,16,1
1713330454493,MMW 12R,A02,514035,Herbst; Matthew,16,0,16,0
1713330455520,MMW 13R,A01,514037,Staff,12,0,16,4
1713330455520,MMW 13R,A02,514039,Staff,16,0,16,0
1713330457572,SIO 295LS,A00,523233,Staff,19,0,30,11
1713330458598,SIO 295S,A00,523232,Staff,19,0,30,11
1713330459626,SOCI 117,A01,494376,Staff,2,0,5,3
1713330460668,WES 237B,A00,494380,Staff,19,0,20,1
1713330462729,AESE 279B,A00,494370,Wade; Jon P,33,0,33,0
1713330463757,ANAR 135S,A00,494369,Braswell; Geoffrey E.,0,0,0,0
1713330464784,CAT 124RS,A01,519847,Geibel; William,17,0,20,3
1713330465811,CAT 125RS,A01,515971,Geibel; William,17,0,20,3
1713330466837,CLRE 250,A00,511389,Morris; Sheldon,9996,0,9999,3
1713330467869,CLRE 251,A00,507176,Mehta; Ravindra L.,9996,0,9999,3
1713330467869,CLRE 251,B00,511410,Mehta; Ravindra L.,9998,0,9999,1
1713330468894,CLRE 252,A00,507189,Cuomo; Raphael Eduardo,9998,0,9999,1
1713330469920,CLRE 253,A00,507199,Vaida; Florin,9997,0,9999,2
1713330469920,CLRE 253,B00,507202,Vaida; Florin,9999,0,9999,0
1713330470946,CLRE 259,A00,507211,Patel; Hemal,9996,0,9999,3
1713330471971,CLRE 260,A00,507221,Cuomo; Raphael Eduardo,9999,0,9999,0
1713330472999,CLRE 297,001,507242,Cuomo; Raphael Eduardo,9999,0,9999,0
1713330474023,CSE 191,A00,516875,Minnes Kemp; Mor Mia,9999,0,9999,0
1713330475054,CSS 201S,A01,494383,Staff,35,0,35,0
1713330476083,CSS 202S,A01,494387,Staff,35,0,35,0
1713330477109,EAP 100,A00,516065,Staff,9792,0,9999,207
1713330478134,ECE 45,A01,507414,Staff,51,0,60,9
1713330479164,ECE 100,A01,507416,Baghdadchi; Saharnaz,10,0,20,10
1713330479164,ECE 100,A02,507418,Baghdadchi; Saharnaz,20,0,20,0
1713330480191,ECE 111,A01,507420,Staff,38,0,50,12
1713330481216,ECE 197,001,548057,Sievenpiper; Daniel F.,9998,0,9999,1
1713330482246,EDS 115,A00,507243,Choi; Bailey Miyeon,28,0,28,0
1713330483271,EDS 117,A01,494379,Staff,23,0,25,2
1713330484297,EDS 125,A00,507246,Hopkins; Megan Beth,29,0,30,1
1713330485321,EDS 128A,A01,507264,Fargason; Sharon Gayle,26,0,26,0
1713330486348,EDS 128B,A01,507293,Pappas; Elizabeth,30,0,30,0
1713330487373,EDS 139,A00,507294,Fargason; Sharon Gayle,30,0,30,0
1713330487373,EDS 139,B00,507313,Pappas; Elizabeth,30,0,30,0
1713330488398,EDS 201,A00,507315,Staff,26,0,30,4
1713330489422,EDS 203,A01,507317,Halter; Christopher P.,26,0,30,4
1713330490448,EDS 204R,A01,507319,Halter; Christopher P.,3,0,30,27
1713330490448,EDS 204R,B01,507331,Heinzman; Erica M.,28,0,30,2
1713330491473,EDS 206R,A00,507332,Staff,4,0,30,26
1713330491473,EDS 206R,B00,507343,Staff,28,0,30,2
1713330492496,EDS 250,A00,507344,Hemans; Patricia Ann Benitez,36,0,40,4
1713330493523,EDS 281,A00,507345,Daly; Alan J.,18,0,18,0
1713330494549,EDS 284,A00,507350,Daly; Alan J.,16,0,16,0
1713330495575,EDS 286,A00,507359,Fine; Sarah,18,0,18,0
1713330496601,EDS 289C,A01,507361,Daly; Alan J.,18,0,18,0
1713330497629,EDS 290,A00,507366,Hofstetter; Carolyn,15,0,15,0
1713330498656,LIGM 5A,A00,507421,Fischer-Grunski; Eva K,20,0,20,0
1713330499683,LIGM 5B,A00,507423,Fischer-Grunski; Eva K,20,0,20,0
1713330500708,LIGM 5C,A00,507425,Fischer-Grunski; Eva K,20,0,20,0
1713330501740,LIIT 5AS,A00,507427,Carnelos; Chiara,20,0,20,0
1713330502765,LIIT 5BS,A00,507430,Carnelos; Chiara,20,0,20,0
1713330503796,LIIT 5CS,A00,507432,Carnelos; Chiara,20,0,20,0
1713330504826,LISP 5A,A00,507541,Munoz Sanchez; Alicia,17,0,20,3
1713330505853,LISP 5B,A00,507671,Munoz Sanchez; Alicia,15,0,20,5
1713330506879,LISP 5C,A00,507696,Munoz Sanchez; Alicia,15,0,20,5
1713330507905,MAE 197,001,528363,Boechler; Nicholas Sebastia,9998,0,9999,1
1713330508931,MATH 197,001,523477,Kedlaya; Kiran S.,9999,0,9999,0
1713330508931,MATH 197,002,563811,Zhang; Danna,9999,0,9999,0
1713330509957,MCWP 40R,A00,518780,Staff,20,0,20,0
1713330509957,MCWP 40R,B00,518781,Staff,19,0,20,1
1713330509957,MCWP 40R,C00,518783,Staff,19,0,20,1
1713330510981,MCWP 50R,A00,518791,Staff,20,0,20,0
1713330510981,MCWP 50R,B00,518792,Staff,17,0,20,3
1713330510981,MCWP 50R,C00,518793,Staff,19,0,20,1
1713330510981,MCWP 50R,D00,518794,Staff,16,0,20,4
1713330510981,MCWP 50R,E00,518795,Staff,16,0,20,4
1713330510981,MCWP 50R,F00,518796,Staff,19,0,20,1
1713330510981,MCWP 50R,G00,518797,Staff,19,0,20,1
1713330512006,MMW 12R,A01,514034,Herbst; Matthew,15,0,16,1
1713330512006,MMW 12R,A02,514035,Herbst; Matthew,16,0,16,0
1713330513029,MMW 13R,A01,514037,Staff,12,0,16,4
1713330513029,MMW 13R,A02,514039,Staff,16,0,16,0
1713330515084,SIO 295LS,A00,523233,Staff,19,0,30,11
1713330516108,SIO 295S,A00,523232,Staff,19,0,30,11
1713330517134,SOCI 117,A01,494376,Staff,2,0,5,3
1713330518162,WES 237B,A00,494380,Staff,19,0,20,1
1713330520225,AESE 279B,A00,494370,Wade; Jon P,33,0,33,0
1713330521252,ANAR 135S,A00,494369,Braswell; Geoffrey E.,0,0,0,0
1713330522281,CAT 124RS,A01,519847,Geibel; William,17,0,20,3
1713330523310,CAT 125RS,A01,515971,Geibel; William,17,0,20,3
1713330524343,CLRE 250,A00,511389,Morris; Sheldon,9996,0,9999,3
1713330525369,CLRE 251,A00,507176,Mehta; Ravindra L.,9996,0,9999,3
1713330525369,CLRE 251,B00,511410,Mehta; Ravindra L.,9998,0,9999,1
1713330526401,CLRE 252,A00,507189,Cuomo; Raphael Eduardo,9998,0,9999,1
1713330527427,CLRE 253,A00,507199,Vaida; Florin,9997,0,9999,2
1713330527427,CLRE 253,B00,507202,Vaida; Florin,9999,0,9999,0
1713330528451,CLRE 259,A00,507211,Patel; Hemal,9996,0,9999,3
1713330529479,CLRE 260,A00,507221,Cuomo; Raphael Eduardo,9999,0,9999,0
1713330530505,CLRE 297,001,507242,Cuomo; Raphael Eduardo,9999,0,9999,0
1713330531529,CSE 191,A00,516875,Minnes Kemp; Mor Mia,9999,0,9999,0
1713330532556,CSS 201S,A01,494383,Staff,35,0,35,0
1713330533584,CSS 202S,A01,494387,Staff,35,0,35,0
1713330534611,EAP 100,A00,516065,Staff,9792,0,9999,207
1713330535640,ECE 45,A01,507414,Staff,51,0,60,9
1713330536668,ECE 100,A01,507416,Baghdadchi; Saharnaz,10,0,20,10
1713330536668,ECE 100,A02,507418,Baghdadchi; Saharnaz,20,0,20,0
1713330537696,ECE 111,A01,507420,Staff,38,0,50,12
1713330538721,ECE 197,001,548057,Sievenpiper; Daniel F.,9998,0,9999,1
1713330539751,EDS 115,A00,507243,Choi; Bailey Miyeon,28,0,28,0
1713330540780,EDS 117,A01,494379,Staff,23,0,25,2
1713330541868,EDS 125,A00,507246,Hopkins; Megan Beth,29,0,30,1
1713330542898,EDS 128A,A01,507264,Fargason; Sharon Gayle,26,0,26,0
1713330543927,EDS 128B,A01,507293,Pappas; Elizabeth,30,0,30,0
1713330544953,EDS 139,A00,507294,Fargason; Sharon Gayle,30,0,30,0
1713330544953,EDS 139,B00,507313,Pappas; Elizabeth,30,0,30,0
1713330545980,EDS 201,A00,507315,Staff,26,0,30,4
1713330547008,EDS 203,A01,507317,Halter; Christopher P.,26,0,30,4
1713330548043,EDS 204R,A01,507319,Halter; Christopher P.,3,0,30,27
1713330548043,EDS 204R,B01,507331,Heinzman; Erica M.,28,0,30,2
1713330549072,EDS 206R,A00,507332,Staff,4,0,30,26
1713330549072,EDS 206R,B00,507343,Staff,28,0,30,2
1713330550098,EDS 250,A00,507344,Hemans; Patricia Ann Benitez,36,0,40,4
1713330551125,EDS 281,A00,507345,Daly; Alan J.,18,0,18,0
1713330552153,EDS 284,A00,507350,Daly; Alan J.,16,0,16,0
1713330553180,EDS 286,A00,507359,Fine; Sarah,18,0,18,0
1713330554205,EDS 289C,A01,507361,Daly; Alan J.,18,0,18,0
1713330555232,EDS 290,A00,507366,Hofstetter; Carolyn,15,0,15,0
1713330556258,LIGM 5A,A00,507421,Fischer-Grunski; Eva K,20,0,20,0
1713330557283,LIGM 5B,A00,507423,Fischer-Grunski; Eva K,20,0,20,0
1713330558309,LIGM 5C,A00,507425,Fischer-Grunski; Eva K,20,0,20,0
1713330559340,LIIT 5AS,A00,507427,Carnelos; Chiara,20,0,20,0
1713330560364,LIIT 5BS,A00,507430,Carnelos; Chiara,20,0,20,0
1713330561390,LIIT 5CS,A00,507432,Carnelos; Chiara,20,0,20,0
1713330562420,LISP 5A,A00,507541,Munoz Sanchez; Alicia,17,0,20,3
1713330563447,LISP 5B,A00,507671,Munoz Sanchez; Alicia,15,0,20,5
1713330564472,LISP 5C,A00,507696,Munoz Sanchez; Alicia,15,0,20,5
1713330565501,MAE 197,001,528363,Boechler; Nicholas Sebastia,9998,0,9999,1
1713330566526,MATH 197,001,523477,Kedlaya; Kiran S.,9999,0,9999,0
1713330566526,MATH 197,002,563811,Zhang; Danna,9999,0,9999,0
1713330567555,MCWP 40R,A00,518780,Staff,20,0,20,0
1713330567555,MCWP 40R,B00,518781,Staff,19,0,20,1
1713330567555,MCWP 40R,C00,518783,Staff,19,0,20,1
1713330568584,MCWP 50R,A00,518791,Staff,20,0,20,0
1713330568584,MCWP 50R,B00,518792,Staff,17,0,20,3
1713330568584,MCWP 50R,C00,518793,Staff,19,0,20,1
1713330568584,MCWP 50R,D00,518794,Staff,16,0,20,4
1713330568584,MCWP 50R,E00,518795,Staff,16,0,20,4
1713330568584,MCWP 50R,F00,518796,Staff,19,0,20,1
1713330568584,MCWP 50R,G00,518797,Staff,19,0,20,1
1713330569614,MMW 12R,A01,514034,Herbst; Matthew,15,0,16,1
1713330569614,MMW 12R,A02,514035,Herbst; Matthew,16,0,16,0
1713330570643,MMW 13R,A01,514037,Staff,12,0,16,4
1713330570643,MMW 13R,A02,514039,Staff,16,0,16,0
1713330572698,SIO 295LS,A00,523233,Staff,19,0,30,11
1713330573726,SIO 295S,A00,523232,Staff,19,0,30,11
1713330574755,SOCI 117,A01,494376,Staff,2,0,5,3
1713330575780,WES 237B,A00,494380,Staff,19,0,20,1
1713330577850,AESE 279B,A00,494370,Wade; Jon P,33,0,33,0
1713330578875,ANAR 135S,A00,494369,Braswell; Geoffrey E.,0,0,0,0
1713330579901,CAT 124RS,A01,519847,Geibel; William,17,0,20,3
1713330580926,CAT 125RS,A01,515971,Geibel; William,17,0,20,3
1713330581953,CLRE 250,A00,511389,Morris; Sheldon,9996,0,9999,3
1713330582980,CLRE 251,A00,507176,Mehta; Ravindra L.,9996,0,9999,3
1713330582980,CLRE 251,B00,511410,Mehta; Ravindra L.,9998,0,9999,1
1713330584010,CLRE 252,A00,507189,Cuomo; Raphael Eduardo,9998,0,9999,1
1713330585041,CLRE 253,A00,507199,Vaida; Florin,9997,0,9999,2
1713330585041,CLRE 253,B00,507202,Vaida; Florin,9999,0,9999,0
1713330586066,CLRE 259,A00,507211,Patel; Hemal,9996,0,9999,3
1713330587092,CLRE 260,A00,507221,Cuomo; Raphael Eduardo,9999,0,9999,0
1713330588121,CLRE 297,001,507242,Cuomo; Raphael Eduardo,9999,0,9999,0
1713330589146,CSE 191,A00,516875,Minnes Kemp; Mor Mia,9999,0,9999,0
1713330590175,CSS 201S,A01,494383,Staff,35,0,35,0
1713330591205,CSS 202S,A01,494387,Staff,35,0,35,0
1713330592231,EAP 100,A00,516065,Staff,9792,0,9999,207
1713330593259,ECE 45,A01,507414,Staff,51,0,60,9
1713330594285,ECE 100,A01,507416,Baghdadchi; Saharnaz,10,0,20,10
1713330594285,ECE 100,A02,507418,Baghdadchi; Saharnaz,20,0,20,0
1713330595311,ECE 111,A01,507420,Staff,38,0,50,12
1713330596339,ECE 197,001,548057,Sievenpiper; Daniel F.,9998,0,9999,1
1713330597368,EDS 115,A00,507243,Choi; Bailey Miyeon,28,0,28,0
1713330598397,EDS 117,A01,494379,Staff,23,0,25,2
1713330599424,EDS 125,A00,507246,Hopkins; Megan Beth,29,0,30,1
1713330600454,EDS 128A,A01,507264,Fargason; Sharon Gayle,26,0,26,0
1713330601479,EDS 128B,A01,507293,Pappas; Elizabeth,30,0,30,0
1713330602504,EDS 139,A00,507294,Fargason; Sharon Gayle,30,0,30,0
1713330602504,EDS 139,B00,507313,Pappas; Elizabeth,30,0,30,0
1713330603529,EDS 201,A00,507315,Staff,26,0,30,4
1713330604560,EDS 203,A01,507317,Halter; Christopher P.,26,0,30,4
1713330605588,EDS 204R,A01,507319,Halter; Christopher P.,3,0,30,27
1713330605588,EDS 204R,B01,507331,Heinzman; Erica M.,28,0,30,2
1713330606619,EDS 206R,A00,507332,Staff,4,0,30,26
1713330606619,EDS 206R,B00,507343,Staff,28,0,30,2
1713330607645,EDS 250,A00,507344,Hemans; Patricia Ann Benitez,36,0,40,4
1713330608673,EDS 281,A00,507345,Daly; Alan J.,18,0,18,0
1713330609697,EDS 284,A00,507350,Daly; Alan J.,16,0,16,0
1713330610722,EDS 286,A00,507359,Fine; Sarah,18,0,18,0
1713330611746,EDS 289C,A01,507361,Daly; Alan J.,18,0,18,0
1713330612771,EDS 290,A00,507366,Hofstetter; Carolyn,15,0,15,0
1713330613797,LIGM 5A,A00,507421,Fischer-Grunski; Eva K,20,0,20,0
1713330614826,LIGM 5B,A00,507423,Fischer-Grunski; Eva K,20,0,20,0
1713330615856,LIGM 5C,A00,507425,Fischer-Grunski; Eva K,20,0,20,0
1713330616885,LIIT 5AS,A00,507427,Carnelos; Chiara,20,0,20,0
1713330617911,LIIT 5BS,A00,507430,Carnelos; Chiara,20,0,20,0
1713330618937,LIIT 5CS,A00,507432,Carnelos; Chiara,20,0,20,0
1713330619967,LISP 5A,A00,507541,Munoz Sanchez; Alicia,17,0,20,3
1713330620997,LISP 5B,A00,507671,Munoz Sanchez; Alicia,15,0,20,5
1713330622024,LISP 5C,A00,507696,Munoz Sanchez; Alicia,15,0,20,5
1713330623050,MAE 197,001,528363,Boechler; Nicholas Sebastia,9998,0,9999,1
1713330624074,MATH 197,001,523477,Kedlaya; Kiran S.,9999,0,9999,0
1713330624074,MATH 197,002,563811,Zhang; Danna,9999,0,9999,0
1713330625102,MCWP 40R,A00,518780,Staff,20,0,20,0
1713330625102,MCWP 40R,B00,518781,Staff,19,0,20,1
1713330625102,MCWP 40R,C00,518783,Staff,19,0,20,1
1713330626128,MCWP 50R,A00,518791,Staff,20,0,20,0
1713330626128,MCWP 50R,B00,518792,Staff,17,0,20,3
1713330626128,MCWP 50R,C00,518793,Staff,19,0,20,1
1713330626128,MCWP 50R,D00,518794,Staff,16,0,20,4
1713330626128,MCWP 50R,E00,518795,Staff,16,0,20,4
1713330626128,MCWP 50R,F00,518796,Staff,19,0,20,1
1713330626128,MCWP 50R,G00,518797,Staff,19,0,20,1
1713330627152,MMW 12R,A01,514034,Herbst; Matthew,15,0,16,1
1713330627152,MMW 12R,A02,514035,Herbst; Matthew,16,0,16,0
1713330628178,MMW 13R,A01,514037,Staff,12,0,16,4
1713330628178,MMW 13R,A02,514039,Staff,16,0,16,0
1713330630230,SIO 295LS,A00,523233,Staff,19,0,30,11
1713330631257,SIO 295S,A00,523232,Staff,19,0,30,11
1713330632286,SOCI 117,A01,494376,Staff,2,0,5,3
1713330633315,WES 237B,A00,494380,Staff,19,0,20,1
1713330635388,AESE 279B,A00,494370,Wade; Jon P,33,0,33,0
1713330636413,ANAR 135S,A00,494369,Braswell; Geoffrey E.,0,0,0,0
1713330637439,CAT 124RS,A01,519847,Geibel; William,17,0,20,3
1713330638468,CAT 125RS,A01,515971,Geibel; William,17,0,20,3
1713330639492,CLRE 250,A00,511389,Morris; Sheldon,9996,0,9999,3
1713330640525,CLRE 251,A00,507176,Mehta; Ravindra L.,9996,0,9999,3
1713330640525,CLRE 251,B00,511410,Mehta; Ravindra L.,9998,0,9999,1
1713330641550,CLRE 252,A00,507189,Cuomo; Raphael Eduardo,9998,0,9999,1
1713330642576,CLRE 253,A00,507199,Vaida; Florin,9997,0,9999,2
1713330642576,CLRE 253,B00,507202,Vaida; Florin,9999,0,9999,0
1713330643602,CLRE 259,A00,507211,Patel; Hemal,9996,0,9999,3
1713330644627,CLRE 260,A00,507221,Cuomo; Raphael Eduardo,9999,0,9999,0
1713330645706,CLRE 297,001,507242,Cuomo; Raphael Eduardo,9999,0,9999,0
1713330646730,CSE 191,A00,516875,Minnes Kemp; Mor Mia,9999,0,9999,0
1713330647763,CSS 201S,A01,494383,Staff,35,0,35,0
1713330648794,CSS 202S,A01,494387,Staff,35,0,35,0
1713330649822,EAP 100,A00,516065,Staff,9792,0,9999,207
1713330650846,ECE 45,A01,507414,Staff,51,0,60,9
1713330651872,ECE 100,A01,507416,Baghdadchi; Saharnaz,10,0,20,10
1713330651872,ECE 100,A02,507418,Baghdadchi; Saharnaz,20,0,20,0
1713330652900,ECE 111,A01,507420,Staff,38,0,50,12
1713330653926,ECE 197,001,548057,Sievenpiper; Daniel F.,9998,0,9999,1
1713330654955,EDS 115,A00,507243,Choi; Bailey Miyeon,28,0,28,0
1713330655983,EDS 117,A01,494379,Staff,23,0,25,2
1713330657012,EDS 125,A00,507246,Hopkins; Megan Beth,29,0,30,1
1713330658040,EDS 128A,A01,507264,Fargason; Sharon Gayle,26,0,26,0
1713330659065,EDS 128B,A01,507293,Pappas; Elizabeth,30,0,30,0
1713330660098,EDS 139,A00,507294,Fargason; Sharon Gayle,30,0,30,0
1713330660098,EDS 139,B00,507313,Pappas; Elizabeth,30,0,30,0
1713330661122,EDS 201,A00,507315,Staff,26,0,30,4
1713330662148,EDS 203,A01,507317,Halter; Christopher P.,26,0,30,4
1713330663177,EDS 204R,A01,507319,Halter; Christopher P.,3,0,30,27
1713330663177,EDS 204R,B01,507331,Heinzman; Erica M.,28,0,30,2
1713330664202,EDS 206R,A00,507332,Staff,4,0,30,26
1713330664202,EDS 206R,B00,507343,Staff,28,0,30,2
1713330665227,EDS 250,A00,507344,Hemans; Patricia Ann Benitez,36,0,40,4
1713330666256,EDS 281,A00,507345,Daly; Alan J.,18,0,18,0
1713330667283,EDS 284,A00,507350,Daly; Alan J.,16,0,16,0
1713330668310,EDS 286,A00,507359,Fine; Sarah,18,0,18,0
1713330669335,EDS 289C,A01,507361,Daly; Alan J.,18,0,18,0
1713330670360,EDS 290,A00,507366,Hofstetter; Carolyn,15,0,15,0
1713330671389,LIGM 5A,A00,507421,Fischer-Grunski; Eva K,20,0,20,0
1713330672418,LIGM 5B,A00,507423,Fischer-Grunski; Eva K,20,0,20,0
1713330673443,LIGM 5C,A00,507425,Fischer-Grunski; Eva K,20,0,20,0
1713330674469,LIIT 5AS,A00,507427,Carnelos; Chiara,20,0,20,0
1713330675499,LIIT 5BS,A00,507430,Carnelos; Chiara,20,0,20,0
1713330676528,LIIT 5CS,A00,507432,Carnelos; Chiara,20,0,20,0
1713330677554,LISP 5A,A00,507541,Munoz Sanchez; Alicia,17,0,20,3
1713330678584,LISP 5B,A00,507671,Munoz Sanchez; Alicia,15,0,20,5
1713330679613,LISP 5C,A00,507696,Munoz Sanchez; Alicia,15,0,20,5
1713330680638,MAE 197,001,528363,Boechler; Nicholas Sebastia,9998,0,9999,1
1713330681668,MATH 197,001,523477,Kedlaya; Kiran S.,9999,0,9999,0
1713330681668,MATH 197,002,563811,Zhang; Danna,9999,0,9999,0
1713330682696,MCWP 40R,A00,518780,Staff,20,0,20,0
1713330682696,MCWP 40R,B00,518781,Staff,19,0,20,1
1713330682696,MCWP 40R,C00,518783,Staff,19,0,20,1
1713330683726,MCWP 50R,A00,518791,Staff,20,0,20,0
1713330683726,MCWP 50R,B00,518792,Staff,17,0,20,3
1713330683726,MCWP 50R,C00,518793,Staff,19,0,20,1
1713330683726,MCWP 50R,D00,518794,Staff,16,0,20,4
1713330683726,MCWP 50R,E00,518795,Staff,16,0,20,4
1713330683726,MCWP 50R,F00,518796,Staff,19,0,20,1
1713330683726,MCWP 50R,G00,518797,Staff,19,0,20,1
1713330684754,MMW 12R,A01,514034,Herbst; Matthew,15,0,16,1
1713330684754,MMW 12R,A02,514035,Herbst; Matthew,16,0,16,0
1713330685779,MMW 13R,A01,514037,Staff,12,0,16,4
1713330685779,MMW 13R,A02,514039,Staff,16,0,16,0
1713330687834,SIO 295LS,A00,523233,Staff,19,0,30,11
1713330688862,SIO 295S,A00,523232,Staff,19,0,30,11
1713330689892,SOCI 117,A01,494376,Staff,2,0,5,3
1713330690917,WES 237B,A00,494380,Staff,19,0,20,1
1713330692993,AESE 279B,A00,494370,Wade; Jon P,33,0,33,0
1713330694019,ANAR 135S,A00,494369,Braswell; Geoffrey E.,0,0,0,0
1713330695045,CAT 124RS,A01,519847,Geibel; William,17,0,20,3
1713330696070,CAT 125RS,A01,515971,Geibel; William,17,0,20,3
1713330697096,CLRE 250,A00,511389,Morris; Sheldon,9996,0,9999,3
1713330698126,CLRE 251,A00,507176,Mehta; Ravindra L.,9996,0,9999,3
1713330698126,CLRE 251,B00,511410,Mehta; Ravindra L.,9998,0,9999,1
1713330699153,CLRE 252,A00,507189,Cuomo; Raphael Eduardo,9998,0,9999,1
1713330700181,CLRE 253,A00,507199,Vaida; Florin,9997,0,9999,2
1713330700181,CLRE 253,B00,507202,Vaida; Florin,9999,0,9999,0
1713330701206,CLRE 259,A00,507211,Patel; Hemal,9996,0,9999,3
1713330702232,CLRE 260,A00,507221,Cuomo; Raphael Eduardo,9999,0,9999,0
1713330703257,CLRE 297,001,507242,Cuomo; Raphael Eduardo,9999,0,9999,0
1713330704286,CSE 191,A00,516875,Minnes Kemp; Mor Mia,9999,0,9999,0
1713330705311,CSS 201S,A01,494383,Staff,35,0,35,0
1713330706339,CSS 202S,A01,494387,Staff,35,0,35,0
1713330707364,EAP 100,A00,516065,Staff,9792,0,9999,207
1713330708393,ECE 45,A01,507414,Staff,51,0,60,9
1713330709423,ECE 100,A01,507416,Baghdadchi; Saharnaz,10,0,20,10
1713330709423,ECE 100,A02,507418,Baghdadchi; Saharnaz,20,0,20,0
1713330710449,ECE 111,A01,507420,Staff,38,0,50,12
1713330711475,ECE 197,001,548057,Sievenpiper; Daniel F.,9998,0,9999,1
1713330712504,EDS 115,A00,507243,Choi; Bailey Miyeon,28,0,28,0
1713330713529,EDS 117,A01,494379,Staff,23,0,25,2
1713330714555,EDS 125,A00,507246,Hopkins; Megan Beth,29,0,30,1
1713330715585,EDS 128A,A01,507264,Fargason; Sharon Gayle,26,0,26,0
1713330716614,EDS 128B,A01,507293,Pappas; Elizabeth,30,0,30,0
1713330717642,EDS 139,A00,507294,Fargason; Sharon Gayle,30,0,30,0
1713330717642,EDS 139,B00,507313,Pappas; Elizabeth,30,0,30,0
1713330718667,EDS 201,A00,507315,Staff,26,0,30,4
1713330719693,EDS 203,A01,507317,Halter; Christopher P.,26,0,30,4
1713330720723,EDS 204R,A01,507319,Halter; Christopher P.,3,0,30,27
1713330720723,EDS 204R,B01,507331,Heinzman; Erica M.,28,0,30,2
1713330721752,EDS 206R,A00,507332,Staff,4,0,30,26
1713330721752,EDS 206R,B00,507343,Staff,28,0,30,2
1713330722778,EDS 250,A00,507344,Hemans; Patricia Ann Benitez,36,0,40,4
1713330723803,EDS 281,A00,507345,Daly; Alan J.,18,0,18,0
1713330724827,EDS 284,A00,507350,Daly; Alan J.,16,0,16,0
1713330725852,EDS 286,A00,507359,Fine; Sarah,18,0,18,0
1713330726876,EDS 289C,A01,507361,Daly; Alan J.,18,0,18,0
1713330727901,EDS 290,A00,507366,Hofstetter; Carolyn,15,0,15,0
1713330728929,LIGM 5A,A00,507421,Fischer-Grunski; Eva K,20,0,20,0
1713330729952,LIGM 5B,A00,507423,Fischer-Grunski; Eva K,20,0,20,0
1713330730980,LIGM 5C,A00,507425,Fischer-Grunski; Eva K,20,0,20,0
1713330732012,LIIT 5AS,A00,507427,Carnelos; Chiara,20,0,20,0
1713330733037,LIIT 5BS,A00,507430,Carnelos; Chiara,20,0,20,0
1713330734067,LIIT 5CS,A00,507432,Carnelos; Chiara,20,0,20,0
1713330735094,LISP 5A,A00,507541,Munoz Sanchez; Alicia,17,0,20,3
1713330736128,LISP 5B,A00,507671,Munoz Sanchez; Alicia,15,0,20,5
1713330737158,LISP 5C,A00,507696,Munoz Sanchez; Alicia,15,0,20,5
1713330738187,MAE 197,001,528363,Boechler; Nicholas Sebastia,9998,0,9999,1
1713330739214,MATH 197,001,523477,Kedlaya; Kiran S.,9999,0,9999,0
1713330739214,MATH 197,002,563811,Zhang; Danna,9999,0,9999,0
1713330740239,MCWP 40R,A00,518780,Staff,20,0,20,0
1713330740239,MCWP 40R,B00,518781,Staff,19,0,20,1
1713330740239,MCWP 40R,C00,518783,Staff,19,0,20,1
1713330741268,MCWP 50R,A00,518791,Staff,20,0,20,0
1713330741268,MCWP 50R,B00,518792,Staff,17,0,20,3
1713330741268,MCWP 50R,C00,518793,Staff,19,0,20,1
1713330741268,MCWP 50R,D00,518794,Staff,16,0,20,4
1713330741268,MCWP 50R,E00,518795,Staff,16,0,20,4
1713330741268,MCWP 50R,F00,518796,Staff,19,0,20,1
1713330741268,MCWP 50R,G00,518797,Staff,19,0,20,1
1713330742295,MMW 12R,A01,514034,Herbst; Matthew,15,0,16,1
1713330742295,MMW 12R,A02,514035,Herbst; Matthew,16,0,16,0
1713330743318,MMW 13R,A01,514037,Staff,12,0,16,4
1713330743318,MMW 13R,A02,514039,Staff,16,0,16,0
1713330745367,SIO 295LS,A00,523233,Staff,19,0,30,11
1713330746391,SIO 295S,A00,523232,Staff,19,0,30,11
1713330747419,SOCI 117,A01,494376,Staff,2,0,5,3
1713330748445,WES 237B,A00,494380,Staff,19,0,20,1
1713330750562,AESE 279B,A00,494370,Wade; Jon P,33,0,33,0
1713330751587,ANAR 135S,A00,494369,Braswell; Geoffrey E.,0,0,0,0
1713330752612,CAT 124RS,A01,519847,Geibel; William,17,0,20,3
1713330753636,CAT 125RS,A01,515971,Geibel; William,17,0,20,3
1713330754666,CLRE 250,A00,511389,Morris; Sheldon,9996,0,9999,3
1713330755699,CLRE 251,A00,507176,Mehta; Ravindra L.,9996,0,9999,3
1713330755699,CLRE 251,B00,511410,Mehta; Ravindra L.,9998,0,9999,1
1713330756725,CLRE 252,A00,507189,Cuomo; Raphael Eduardo,9998,0,9999,1
1713330757749,CLRE 253,A00,507199,Vaida; Florin,9997,0,9999,2
1713330757749,CLRE 253,B00,507202,Vaida; Florin,9999,0,9999,0
1713330758774,CLRE 259,A00,507211,Patel; Hemal,9996,0,9999,3
1713330759799,CLRE 260,A00,507221,Cuomo; Raphael Eduardo,9999,0,9999,0
1713330760824,CLRE 297,001,507242,Cuomo; Raphael Eduardo,9999,0,9999,0
1713330761851,CSE 191,A00,516875,Minnes Kemp; Mor Mia,9999,0,9999,0
1713330762882,CSS 201S,A01,494383,Staff,35,0,35,0
1713330763911,CSS 202S,A01,494387,Staff,35,0,35,0
1713330764939,EAP 100,A00,516065,Staff,9792,0,9999,207
1713330765966,ECE 45,A01,507414,Staff,51,0,60,9
1713330766990,ECE 100,A01,507416,Baghdadchi; Saharnaz,10,0,20,10
1713330766990,ECE 100,A02,507418,Baghdadchi; Saharnaz,20,0,20,0
1713330768020,ECE 111,A01,507420,Staff,38,0,50,12
1713330769047,ECE 197,001,548057,Sievenpiper; Daniel F.,9998,0,9999,1
1713330770078,EDS 115,A00,507243,Choi; Bailey Miyeon,28,0,28,0
1713330771108,EDS 117,A01,494379,Staff,23,0,25,2
1713330772138,EDS 125,A00,507246,Hopkins; Megan Beth,29,0,30,1
1713330773168,EDS 128A,A01,507264,Fargason; Sharon Gayle,26,0,26,0
1713330774197,EDS 128B,A01,507293,Pappas; Elizabeth,30,0,30,0
1713330775226,EDS 139,A00,507294,Fargason; Sharon Gayle,30,0,30,0
1713330775226,EDS 139,B00,507313,Pappas; Elizabeth,30,0,30,0
1713330776252,EDS 201,A00,507315,Staff,26,0,30,4
1713330777280,EDS 203,A01,507317,Halter; Christopher P.,26,0,30,4
1713330778305,EDS 204R,A01,507319,Halter; Christopher P.,3,0,30,27
1713330778305,EDS 204R,B01,507331,Heinzman; Erica M.,28,0,30,2
1713330779331,EDS 206R,A00,507332,Staff,4,0,30,26
1713330779331,EDS 206R,B00,507343,Staff,28,0,30,2
1713330780361,EDS 250,A00,507344,Hemans; Patricia Ann Benitez,36,0,40,4
1713330781387,EDS 281,A00,507345,Daly; Alan J.,18,0,18,0
1713330782416,EDS 284,A00,507350,Daly; Alan J.,16,0,16,0
1713330783441,EDS 286,A00,507359,Fine; Sarah,18,0,18,0
1713330784470,EDS 289C,A01,507361,Daly; Alan J.,18,0,18,0
1713330785496,EDS 290,A00,507366,Hofstetter; Carolyn,15,0,15,0
1713330786523,LIGM 5A,A00,507421,Fischer-Grunski; Eva K,20,0,20,0
1713330787552,LIGM 5B,A00,507423,Fischer-Grunski; Eva K,20,0,20,0
1713330788582,LIGM 5C,A00,507425,Fischer-Grunski; Eva K,20,0,20,0
1713330789607,LIIT 5AS,A00,507427,Carnelos; Chiara,20,0,20,0
1713330790633,LIIT 5BS,A00,507430,Carnelos; Chiara,20,0,20,0
1713330791658,LIIT 5CS,A00,507432,Carnelos; Chiara,20,0,20,0
1713330792684,LISP 5A,A00,507541,Munoz Sanchez; Alicia,17,0,20,3
1713330793709,LISP 5B,A00,507671,Munoz Sanchez; Alicia,15,0,20,5
1713330794739,LISP 5C,A00,507696,Munoz Sanchez; Alicia,15,0,20,5
1713330795766,MAE 197,001,528363,Boechler; Nicholas Sebastia,9998,0,9999,1
1713330796791,MATH 197,001,523477,Kedlaya; Kiran S.,9999,0,9999,0
1713330796791,MATH 197,002,563811,Zhang; Danna,9999,0,9999,0
1713330797817,MCWP 40R,A00,518780,Staff,20,0,20,0
1713330797817,MCWP 40R,B00,518781,Staff,19,0,20,1
1713330797817,MCWP 40R,C00,518783,Staff,19,0,20,1
1713330798842,MCWP 50R,A00,518791,Staff,20,0,20,0
1713330798842,MCWP 50R,B00,518792,Staff,17,0,20,3
1713330798842,MCWP 50R,C00,518793,Staff,19,0,20,1
1713330798842,MCWP 50R,D00,518794,Staff,16,0,20,4
1713330798842,MCWP 50R,E00,518795,Staff,16,0,20,4
1713330798842,MCWP 50R,F00,518796,Staff,19,0,20,1
1713330798842,MCWP 50R,G00,518797,Staff,19,0,20,1
1713330799866,MMW 12R,A01,514034,Herbst; Matthew,15,0,16,1
1713330799866,MMW 12R,A02,514035,Herbst; Matthew,16,0,16,0
1713330800896,MMW 13R,A01,514037,Staff,12,0,16,4
1713330800896,MMW 13R,A02,514039,Staff,16,0,16,0
1713330802952,SIO 295LS,A00,523233,Staff,19,0,30,11
1713330803977,SIO 295S,A00,523232,Staff,19,0,30,11
1713330805008,SOCI 117,A01,494376,Staff,2,0,5,3
1713330806033,WES 237B,A00,494380,Staff,19,0,20,1
1713330808104,AESE 279B,A00,494370,Wade; Jon P,33,0,33,0
1713330809129,ANAR 135S,A00,494369,Braswell; Geoffrey E.,0,0,0,0
1713330810158,CAT 124RS,A01,519847,Geibel; William,17,0,20,3
1713330811184,CAT 125RS,A01,515971,Geibel; William,17,0,20,3
1713330812210,CLRE 250,A00,511389,Morris; Sheldon,9996,0,9999,3
1713330813236,CLRE 251,A00,507176,Mehta; Ravindra L.,9996,0,9999,3
1713330813236,CLRE 251,B00,511410,Mehta; Ravindra L.,9998,0,9999,1
1713330814261,CLRE 252,A00,507189,Cuomo; Raphael Eduardo,9998,0,9999,1
1713330815287,CLRE 253,A00,507199,Vaida; Florin,9997,0,9999,2
1713330815287,CLRE 253,B00,507202,Vaida; Florin,9999,0,9999,0
1713330816312,CLRE 259,A00,507211,Patel; Hemal,9996,0,9999,3
1713330817341,CLRE 260,A00,507221,Cuomo; Raphael Eduardo,9999,0,9999,0
1713330818366,CLRE 297,001,507242,Cuomo; Raphael Eduardo,9999,0,9999,0
1713330819389,CSE 191,A00,516875,Minnes Kemp; Mor Mia,9999,0,9999,0
1713330820420,CSS 201S,A01,494383,Staff,35,0,35,0
1713330821450,CSS 202S,A01,494387,Staff,35,0,35,0
1713330822474,EAP 100,A00,516065,Staff,9792,0,9999,207
1713330823505,ECE 45,A01,507414,Staff,51,0,60,9
1713330824531,ECE 100,A01,507416,Baghdadchi; Saharnaz,10,0,20,10
1713330824531,ECE 100,A02,507418,Baghdadchi; Saharnaz,20,0,20,0
1713330825555,ECE 111,A01,507420,Staff,38,0,50,12
1713330826580,ECE 197,001,548057,Sievenpiper; Daniel F.,9998,0,9999,1
1713330827609,EDS 115,A00,507243,Choi; Bailey Miyeon,28,0,28,0
1713330828635,EDS 117,A01,494379,Staff,23,0,25,2
1713330829665,EDS 125,A00,507246,Hopkins; Megan Beth,29,0,30,1
1713330830691,EDS 128A,A01,507264,Fargason; Sharon Gayle,26,0,26,0
1713330831721,EDS 128B,A01,507293,Pappas; Elizabeth,30,0,30,0
1713330832748,EDS 139,A00,507294,Fargason; Sharon Gayle,30,0,30,0
1713330832748,EDS 139,B00,507313,Pappas; Elizabeth,30,0,30,0
1713330833774,EDS 201,A00,507315,Staff,26,0,30,4
1713330834800,EDS 203,A01,507317,Halter; Christopher P.,26,0,30,4
1713330835826,EDS 204R,A01,507319,Halter; Christopher P.,3,0,30,27
1713330835826,EDS 204R,B01,507331,Heinzman; Erica M.,28,0,30,2
1713330836852,EDS 206R,A00,507332,Staff,4,0,30,26
1713330836852,EDS 206R,B00,507343,Staff,28,0,30,2
1713330837882,EDS 250,A00,507344,Hemans; Patricia Ann Benitez,36,0,40,4
1713330838914,EDS 281,A00,507345,Daly; Alan J.,18,0,18,0
1713330839938,EDS 284,A00,507350,Daly; Alan J.,16,0,16,0
1713330840968,EDS 286,A00,507359,Fine; Sarah,18,0,18,0
1713330841994,EDS 289C,A01,507361,Daly; Alan J.,18,0,18,0
1713330843019,EDS 290,A00,507366,Hofstetter; Carolyn,15,0,15,0
1713330844050,LIGM 5A,A00,507421,Fischer-Grunski; Eva K,20,0,20,0
1713330845080,LIGM 5B,A00,507423,Fischer-Grunski; Eva K,20,0,20,0
1713330846106,LIGM 5C,A00,507425,Fischer-Grunski; Eva K,20,0,20,0
1713330847133,LIIT 5AS,A00,507427,Carnelos; Chiara,20,0,20,0
1713330848156,LIIT 5BS,A00,507430,Carnelos; Chiara,20,0,20,0
1713330849180,LIIT 5CS,A00,507432,Carnelos; Chiara,20,0,20,0
1713330850205,LISP 5A,A00,507541,Munoz Sanchez; Alicia,17,0,20,3
1713330851235,LISP 5B,A00,507671,Munoz Sanchez; Alicia,15,0,20,5
1713330852262,LISP 5C,A00,507696,Munoz Sanchez; Alicia,15,0,20,5
1713330853340,MAE 197,001,528363,Boechler; Nicholas Sebastia,9998,0,9999,1
1713330854372,MATH 197,001,523477,Kedlaya; Kiran S.,9999,0,9999,0
1713330854372,MATH 197,002,563811,Zhang; Danna,9999,0,9999,0
1713330855399,MCWP 40R,A00,518780,Staff,20,0,20,0
1713330855399,MCWP 40R,B00,518781,Staff,19,0,20,1
1713330855399,MCWP 40R,C00,518783,Staff,19,0,20,1
1713330856424,MCWP 50R,A00,518791,Staff,20,0,20,0
1713330856424,MCWP 50R,B00,518792,Staff,17,0,20,3
1713330856424,MCWP 50R,C00,518793,Staff,19,0,20,1
1713330856424,MCWP 50R,D00,518794,Staff,16,0,20,4
1713330856424,MCWP 50R,E00,518795,Staff,16,0,20,4
1713330856424,MCWP 50R,F00,518796,Staff,19,0,20,1
1713330856424,MCWP 50R,G00,518797,Staff,19,0,20,1
1713330857449,MMW 12R,A01,514034,Herbst; Matthew,15,0,16,1
1713330857449,MMW 12R,A02,514035,Herbst; Matthew,16,0,16,0
1713330858475,MMW 13R,A01,514037,Staff,12,0,16,4
1713330858475,MMW 13R,A02,514039,Staff,16,0,16,0
1713330860525,SIO 295LS,A00,523233,Staff,19,0,30,11
1713330861554,SIO 295S,A00,523232,Staff,19,0,30,11
1713330862579,SOCI 117,A01,494376,Staff,2,0,5,3
1713330863604,WES 237B,A00,494380,Staff,19,0,20,1
1713330865671,AESE 279B,A00,494370,Wade; Jon P,33,0,33,0
1713330866699,ANAR 135S,A00,494369,Braswell; Geoffrey E.,0,0,0,0
1713330867728,CAT 124RS,A01,519847,Geibel; William,17,0,20,3
1713330868757,CAT 125RS,A01,515971,Geibel; William,17,0,20,3
1713330869787,CLRE 250,A00,511389,Morris; Sheldon,9996,0,9999,3
1713330870817,CLRE 251,A00,507176,Mehta; Ravindra L.,9996,0,9999,3
1713330870817,CLRE 251,B00,511410,Mehta; Ravindra L.,9998,0,9999,1
1713330871846,CLRE 252,A00,507189,Cuomo; Raphael Eduardo,9998,0,9999,1
1713330872872,CLRE 253,A00,507199,Vaida; Florin,9997,0,9999,2
1713330872872,CLRE 253,B00,507202,Vaida; Florin,9999,0,9999,0
1713330873901,CLRE 259,A00,507211,Patel; Hemal,9996,0,9999,3
1713330874929,CLRE 260,A00,507221,Cuomo; Raphael Eduardo,9999,0,9999,0
1713330875958,CLRE 297,001,507242,Cuomo; Raphael Eduardo,9999,0,9999,0
1713330876987,CSE 191,A00,516875,Minnes Kemp; Mor Mia,9999,0,9999,0
1713330878021,CSS 201S,A01,494383,Staff,35,0,35,0
1713330879046,CSS 202S,A01,494387,Staff,35,0,35,0
1713330880074,EAP 100,A00,516065,Staff,9792,0,9999,207
1713330881101,ECE 45,A01,507414,Staff,51,0,60,9
1713330882131,ECE 100,A01,507416,Baghdadchi; Saharnaz,10,0,20,10
1713330882131,ECE 100,A02,507418,Baghdadchi; Saharnaz,20,0,20,0
1713330883158,ECE 111,A01,507420,Staff,38,0,50,12
1713330884183,ECE 197,001,548057,Sievenpiper; Daniel F.,9998,0,9999,1
1713330885207,EDS 115,A00,507243,Choi; Bailey Miyeon,28,0,28,0
1713330886233,EDS 117,A01,494379,Staff,23,0,25,2
1713330887259,EDS 125,A00,507246,Hopkins; Megan Beth,29,0,30,1
1713330888285,EDS 128A,A01,507264,Fargason; Sharon Gayle,26,0,26,0
1713330889315,EDS 128B,A01,507293,Pappas; Elizabeth,30,0,30,0
1713330890343,EDS 139,A00,507294,Fargason; Sharon Gayle,30,0,30,0
1713330890343,EDS 139,B00,507313,Pappas; Elizabeth,30,0,30,0
1713330891368,EDS 201,A00,507315,Staff,26,0,30,4
1713330892399,EDS 203,A01,507317,Halter; Christopher P.,26,0,30,4
1713330893427,EDS 204R,A01,507319,Halter; Christopher P.,3,0,30,27
1713330893427,EDS 204R,B01,507331,Heinzman; Erica M.,28,0,30,2
1713330894451,EDS 206R,A00,507332,Staff,4,0,30,26
1713330894451,EDS 206R,B00,507343,Staff,28,0,30,2
1713330895476,EDS 250,A00,507344,Hemans; Patricia Ann Benitez,36,0,40,4
1713330896502,EDS 281,A00,507345,Daly; Alan J.,18,0,18,0
1713330897530,EDS 284,A00,507350,Daly; Alan J.,16,0,16,0
1713330898557,EDS 286,A00,507359,Fine; Sarah,18,0,18,0
1713330899582,EDS 289C,A01,507361,Daly; Alan J.,18,0,18,0
1713330900607,EDS 290,A00,507366,Hofstetter; Carolyn,15,0,15,0
1713330901632,LIGM 5A,A00,507421,Fischer-Grunski; Eva K,20,0,20,0
1713330902660,LIGM 5B,A00,507423,Fischer-Grunski; Eva K,20,0,20,0
1713330903690,LIGM 5C,A00,507425,Fischer-Grunski; Eva K,20,0,20,0
1713330904715,LIIT 5AS,A00,507427,Carnelos; Chiara,20,0,20,0
1713330905740,LIIT 5BS,A00,507430,Carnelos; Chiara,20,0,20,0
1713330906771,LIIT 5CS,A00,507432,Carnelos; Chiara,20,0,20,0
1713330907801,LISP 5A,A00,507541,Munoz Sanchez; Alicia,17,0,20,3
1713330908831,LISP 5B,A00,507671,Munoz Sanchez; Alicia,15,0,20,5
1713330909861,LISP 5C,A00,507696,Munoz Sanchez; Alicia,15,0,20,5
1713330910887,MAE 197,001,528363,Boechler; Nicholas Sebastia,9998,0,9999,1
1713330911916,MATH 197,001,523477,Kedlaya; Kiran S.,9999,0,9999,0
1713330911916,MATH 197,002,563811,Zhang; Danna,9999,0,9999,0
1713330912942,MCWP 40R,A00,518780,Staff,20,0,20,0
1713330912942,MCWP 40R,B00,518781,Staff,19,0,20,1
1713330912942,MCWP 40R,C00,518783,Staff,19,0,20,1
1713330913971,MCWP 50R,A00,518791,Staff,20,0,20,0
1713330913971,MCWP 50R,B00,518792,Staff,17,0,20,3
1713330913971,MCWP 50R,C00,518793,Staff,19,0,20,1
1713330913971,MCWP 50R,D00,518794,Staff,16,0,20,4
1713330913971,MCWP 50R,E00,518795,Staff,16,0,20,4
1713330913971,MCWP 50R,F00,518796,Staff,19,0,20,1
1713330913971,MCWP 50R,G00,518797,Staff,19,0,20,1
1713330914998,MMW 12R,A01,514034,Herbst; Matthew,15,0,16,1
1713330914998,MMW 12R,A02,514035,Herbst; Matthew,16,0,16,0
1713330916022,MMW 13R,A01,514037,Staff,12,0,16,4
1713330916022,MMW 13R,A02,514039,Staff,16,0,16,0
1713330918070,SIO 295LS,A00,523233,Staff,19,0,30,11
1713330919098,SIO 295S,A00,523232,Staff,19,0,30,11
1713330920124,SOCI 117,A01,494376,Staff,2,0,5,3
1713330921153,WES 237B,A00,494380,Staff,19,0,20,1
1713330923212,AESE 279B,A00,494370,Wade; Jon P,33,0,33,0
1713330924245,ANAR 135S,A00,494369,Braswell; Geoffrey E.,0,0,0,0
1713330925275,CAT 124RS,A01,519847,Geibel; William,17,0,20,3
1713330926303,CAT 125RS,A01,515971,Geibel; William,17,0,20,3
1713330927334,CLRE 250,A00,511389,Morris; Sheldon,9996,0,9999,3
1713330928361,CLRE 251,A00,507176,Mehta; Ravindra L.,9996,0,9999,3
1713330928361,CLRE 251,B00,511410,Mehta; Ravindra L.,9998,0,9999,1
1713330929387,CLRE 252,A00,507189,Cuomo; Raphael Eduardo,9998,0,9999,1
1713330930419,CLRE 253,A00,507199,Vaida; Florin,9997,0,9999,2
1713330930419,CLRE 253,B00,507202,Vaida; Florin,9999,0,9999,0
1713330931445,CLRE 259,A00,507211,Patel; Hemal,9996,0,9999,3
1713330932475,CLRE 260,A00,507221,Cuomo; Raphael Eduardo,9999,0,9999,0
1713330933501,CLRE 297,001,507242,Cuomo; Raphael Eduardo,9999,0,9999,0
1713330934526,CSE 191,A00,516875,Minnes Kemp; Mor Mia,9999,0,9999,0
1713330935555,CSS 201S,A01,494383,Staff,35,0,35,0
1713330936593,CSS 202S,A01,494387,Staff,35,0,35,0
1713330937619,EAP 100,A00,516065,Staff,9792,0,9999,207
1713330938648,ECE 45,A01,507414,Staff,51,0,60,9
1713330939677,ECE 100,A01,507416,Baghdadchi; Saharnaz,10,0,20,10
1713330939677,ECE 100,A02,507418,Baghdadchi; Saharnaz,20,0,20,0
1713330940702,ECE 111,A01,507420,Staff,38,0,50,12
1713330941730,ECE 197,001,548057,Sievenpiper; Daniel F.,9998,0,9999,1
1713330942760,EDS 115,A00,507243,Choi; Bailey Miyeon,28,0,28,0
1713330943785,EDS 117,A01,494379,Staff,23,0,25,2
1713330944815,EDS 125,A00,507246,Hopkins; Megan Beth,29,0,30,1
1713330945844,EDS 128A,A01,507264,Fargason; Sharon Gayle,26,0,26,0
1713330946871,EDS 128B,A01,507293,Pappas; Elizabeth,30,0,30,0
1713330947901,EDS 139,A00,507294,Fargason; Sharon Gayle,30,0,30,0
1713330947901,EDS 139,B00,507313,Pappas; Elizabeth,30,0,30,0
1713330948926,EDS 201,A00,507315,Staff,26,0,30,4
1713330949951,EDS 203,A01,507317,Halter; Christopher P.,26,0,30,4
1713330950981,EDS 204R,A01,507319,Halter; Christopher P.,3,0,30,27
1713330950981,EDS 204R,B01,507331,Heinzman; Erica M.,28,0,30,2
1713330952007,EDS 206R,A00,507332,Staff,4,0,30,26
1713330952007,EDS 206R,B00,507343,Staff,28,0,30,2
1713330953034,EDS 250,A00,507344,Hemans; Patricia Ann Benitez,36,0,40,4
1713330954059,EDS 281,A00,507345,Daly; Alan J.,18,0,18,0
1713330955088,EDS 284,A00,507350,Daly; Alan J.,16,0,16,0
1713330956115,EDS 286,A00,507359,Fine; Sarah,18,0,18,0
1713330957192,EDS 289C,A01,507361,Daly; Alan J.,18,0,18,0
1713330958223,EDS 290,A00,507366,Hofstetter; Carolyn,15,0,15,0
1713330959254,LIGM 5A,A00,507421,Fischer-Grunski; Eva K,20,0,20,0
1713330960281,LIGM 5B,A00,507423,Fischer-Grunski; Eva K,20,0,20,0
1713330961306,LIGM 5C,A00,507425,Fischer-Grunski; Eva K,20,0,20,0
1713330962337,LIIT 5AS,A00,507427,Carnelos; Chiara,20,0,20,0
1713330963363,LIIT 5BS,A00,507430,Carnelos; Chiara,20,0,20,0
1713330964390,LIIT 5CS,A00,507432,Carnelos; Chiara,20,0,20,0
1713330965420,LISP 5A,A00,507541,Munoz Sanchez; Alicia,17,0,20,3
1713330966445,LISP 5B,A00,507671,Munoz Sanchez; Alicia,15,0,20,5
1713330967475,LISP 5C,A00,507696,Munoz Sanchez; Alicia,15,0,20,5
1713330968503,MAE 197,001,528363,Boechler; Nicholas Sebastia,9998,0,9999,1
1713330969529,MATH 197,001,523477,Kedlaya; Kiran S.,9999,0,9999,0
1713330969529,MATH 197,002,563811,Zhang; Danna,9999,0,9999,0
1713330970554,MCWP 40R,A00,518780,Staff,20,0,20,0
1713330970554,MCWP 40R,B00,518781,Staff,19,0,20,1
1713330970554,MCWP 40R,C00,518783,Staff,19,0,20,1
1713330971583,MCWP 50R,A00,518791,Staff,20,0,20,0
1713330971583,MCWP 50R,B00,518792,Staff,17,0,20,3
1713330971583,MCWP 50R,C00,518793,Staff,19,0,20,1
1713330971583,MCWP 50R,D00,518794,Staff,16,0,20,4
1713330971583,MCWP 50R,E00,518795,Staff,16,0,20,4
1713330971583,MCWP 50R,F00,518796,Staff,19,0,20,1
1713330971583,MCWP 50R,G00,518797,Staff,19,0,20,1
1713330972608,MMW 12R,A01,514034,Herbst; Matthew,15,0,16,1
1713330972608,MMW 12R,A02,514035,Herbst; Matthew,16,0,16,0
1713330973635,MMW 13R,A01,514037,Staff,12,0,16,4
1713330973635,MMW 13R,A02,514039,Staff,16,0,16,0
1713330975687,SIO 295LS,A00,523233,Staff,19,0,30,11
1713330976715,SIO 295S,A00,523232,Staff,19,0,30,11
1713330977744,SOCI 117,A01,494376,Staff,2,0,5,3
1713330978770,WES 237B,A00,494380,Staff,19,0,20,1
1713330980840,AESE 279B,A00,494370,Wade; Jon P,33,0,33,0
1713330981865,ANAR 135S,A00,494369,Braswell; Geoffrey E.,0,0,0,0
1713330982892,CAT 124RS,A01,519847,Geibel; William,17,0,20,3
1713330983922,CAT 125RS,A01,515971,Geibel; William,17,0,20,3
1713330984953,CLRE 250,A00,511389,Morris; Sheldon,9996,0,9999,3
1713330985980,CLRE 251,A00,507176,Mehta; Ravindra L.,9996,0,9999,3
1713330985980,CLRE 251,B00,511410,Mehta; Ravindra L.,9998,0,9999,1
1713330987007,CLRE 252,A00,507189,Cuomo; Raphael Eduardo,9998,0,9999,1
1713330988035,CLRE 253,A00,507199,Vaida; Florin,9997,0,9999,2
1713330988035,CLRE 253,B00,507202,Vaida; Florin,9999,0,9999,0
1713330989060,CLRE 259,A00,507211,Patel; Hemal,9996,0,9999,3
1713330990087,CLRE 260,A00,507221,Cuomo; Raphael Eduardo,9999,0,9999,0
1713330991117,CLRE 297,001,507242,Cuomo; Raphael Eduardo,9999,0,9999,0
1713330992142,CSE 191,A00,516875,Minnes Kemp; Mor Mia,9999,0,9999,0
1713330993168,CSS 201S,A01,494383,Staff,35,0,35,0
1713330994197,CSS 202S,A01,494387,Staff,35,0,35,0
1713330995221,EAP 100,A00,516065,Staff,9792,0,9999,207
1713330996248,ECE 45,A01,507414,Staff,51,0,60,9
1713330997272,ECE 100,A01,507416,Baghdadchi; Saharnaz,10,0,20,10
1713330997272,ECE 100,A02,507418,Baghdadchi; Saharnaz,20,0,20,0
1713330998300,ECE 111,A01,507420,Staff,38,0,50,12
1713330999327,ECE 197,001,548057,Sievenpiper; Daniel F.,9998,0,9999,1
1713331000357,EDS 115,A00,507243,Choi; Bailey Miyeon,28,0,28,0
1713331001382,EDS 117,A01,494379,Staff,23,0,25,2
1713331002410,EDS 125,A00,507246,Hopkins; Megan Beth,29,0,30,1
1713331003438,EDS 128A,A01,507264,Fargason; Sharon Gayle,26,0,26,0
1713331004466,EDS 128B,A01,507293,Pappas; Elizabeth,30,0,30,0
1713331005494,EDS 139,A00,507294,Fargason; Sharon Gayle,30,0,30,0
1713331005494,EDS 139,B00,507313,Pappas; Elizabeth,30,0,30,0
1713331006519,EDS 201,A00,507315,Staff,26,0,30,4
1713331007545,EDS 203,A01,507317,Halter; Christopher P.,26,0,30,4
1713331008570,EDS 204R,A01,507319,Halter; Christopher P.,3,0,30,27
1713331008570,EDS 204R,B01,507331,Heinzman; Erica M.,28,0,30,2
1713331009596,EDS 206R,A00,507332,Staff,4,0,30,26
1713331009596,EDS 206R,B00,507343,Staff,28,0,30,2
1713331010623,EDS 250,A00,507344,Hemans; Patricia Ann Benitez,36,0,40,4
1713331011647,EDS 281,A00,507345,Daly; Alan J.,18,0,18,0
1713331012671,EDS 284,A00,507350,Daly; Alan J.,16,0,16,0
1713331013697,EDS 286,A00,507359,Fine; Sarah,18,0,18,0
1713331014723,EDS 289C,A01,507361,Daly; Alan J.,18,0,18,0
1713331015748,EDS 290,A00,507366,Hofstetter; Carolyn,15,0,15,0
1713331016778,LIGM 5A,A00,507421,Fischer-Grunski; Eva K,20,0,20,0
1713331017804,LIGM 5B,A00,507423,Fischer-Grunski; Eva K,20,0,20,0
1713331018834,LIGM 5C,A00,507425,Fischer-Grunski; Eva K,20,0,20,0
1713331019860,LIIT 5AS,A00,507427,Carnelos; Chiara,20,0,20,0
1713331020884,LIIT 5BS,A00,507430,Carnelos; Chiara,20,0,20,0
1713331021914,LIIT 5CS,A00,507432,Carnelos; Chiara,20,0,20,0
1713331022940,LISP 5A,A00,507541,Munoz Sanchez; Alicia,17,0,20,3
1713331023969,LISP 5B,A00,507671,Munoz Sanchez; Alicia,15,0,20,5
1713331024996,LISP 5C,A00,507696,Munoz Sanchez; Alicia,15,0,20,5
1713331026024,MAE 197,001,528363,Boechler; Nicholas Sebastia,9998,0,9999,1
1713331027053,MATH 197,001,523477,Kedlaya; Kiran S.,9999,0,9999,0
1713331027053,MATH 197,002,563811,Zhang; Danna,9999,0,9999,0
1713331028079,MCWP 40R,A00,518780,Staff,20,0,20,0
1713331028079,MCWP 40R,B00,518781,Staff,19,0,20,1
1713331028079,MCWP 40R,C00,518783,Staff,19,0,20,1
1713331029104,MCWP 50R,A00,518791,Staff,20,0,20,0
1713331029104,MCWP 50R,B00,518792,Staff,17,0,20,3
1713331029104,MCWP 50R,C00,518793,Staff,19,0,20,1
1713331029104,MCWP 50R,D00,518794,Staff,16,0,20,4
1713331029104,MCWP 50R,E00,518795,Staff,16,0,20,4
1713331029104,MCWP 50R,F00,518796,Staff,19,0,20,1
1713331029104,MCWP 50R,G00,518797,Staff,19,0,20,1
1713331030133,MMW 12R,A01,514034,Herbst; Matthew,15,0,16,1
1713331030133,MMW 12R,A02,514035,Herbst; Matthew,16,0,16,0
1713331031158,MMW 13R,A01,514037,Staff,12,0,16,4
1713331031158,MMW 13R,A02,514039,Staff,16,0,16,0
1713331033209,SIO 295LS,A00,523233,Staff,19,0,30,11
1713331034235,SIO 295S,A00,523232,Staff,19,0,30,11
1713331035260,SOCI 117,A01,494376,Staff,2,0,5,3
1713331036290,WES 237B,A00,494380,Staff,19,0,20,1
1713331038369,AESE 279B,A00,494370,Wade; Jon P,33,0,33,0
1713331039395,ANAR 135S,A00,494369,Braswell; Geoffrey E.,0,0,0,0
1713331040421,CAT 124RS,A01,519847,Geibel; William,17,0,20,3
1713331041445,CAT 125RS,A01,515971,Geibel; William,17,0,20,3
1713331042470,CLRE 250,A00,511389,Morris; Sheldon,9996,0,9999,3
1713331043501,CLRE 251,A00,507176,Mehta; Ravindra L.,9996,0,9999,3
1713331043501,CLRE 251,B00,511410,Mehta; Ravindra L.,9998,0,9999,1
1713331044530,CLRE 252,A00,507189,Cuomo; Raphael Eduardo,9998,0,9999,1
1713331045555,CLRE 253,A00,507199,Vaida; Florin,9997,0,9999,2
1713331045555,CLRE 253,B00,507202,Vaida; Florin,9999,0,9999,0
1713331046583,CLRE 259,A00,507211,Patel; Hemal,9996,0,9999,3
1713331047612,CLRE 260,A00,507221,Cuomo; Raphael Eduardo,9999,0,9999,0
1713331048637,CLRE 297,001,507242,Cuomo; Raphael Eduardo,9999,0,9999,0
1713331049666,CSE 191,A00,516875,Minnes Kemp; Mor Mia,9999,0,9999,0
1713331050691,CSS 201S,A01,494383,Staff,35,0,35,0
1713331051715,CSS 202S,A01,494387,Staff,35,0,35,0
1713331052742,EAP 100,A00,516065,Staff,9792,0,9999,207
1713331053769,ECE 45,A01,507414,Staff,51,0,60,9
1713331054794,ECE 100,A01,507416,Baghdadchi; Saharnaz,10,0,20,10
1713331054794,ECE 100,A02,507418,Baghdadchi; Saharnaz,20,0,20,0
1713331055820,ECE 111,A01,507420,Staff,38,0,50,12
1713331056846,ECE 197,001,548057,Sievenpiper; Daniel F.,9998,0,9999,1
1713331057873,EDS 115,A00,507243,Choi; Bailey Miyeon,28,0,28,0
1713331058898,EDS 117,A01,494379,Staff,23,0,25,2
1713331059925,EDS 125,A00,507246,Hopkins; Megan Beth,29,0,30,1
1713331061006,EDS 128A,A01,507264,Fargason; Sharon Gayle,26,0,26,0
1713331062032,EDS 128B,A01,507293,Pappas; Elizabeth,30,0,30,0
1713331063057,EDS 139,A00,507294,Fargason; Sharon Gayle,30,0,30,0
1713331063057,EDS 139,B00,507313,Pappas; Elizabeth,30,0,30,0
1713331064082,EDS 201,A00,507315,Staff,26,0,30,4
1713331065108,EDS 203,A01,507317,Halter; Christopher P.,26,0,30,4
1713331066134,EDS 204R,A01,507319,Halter; Christopher P.,3,0,30,27
1713331066134,EDS 204R,B01,507331,Heinzman; Erica M.,28,0,30,2
1713331067160,EDS 206R,A00,507332,Staff,4,0,30,26
1713331067160,EDS 206R,B00,507343,Staff,28,0,30,2
1713331068188,EDS 250,A00,507344,Hemans; Patricia Ann Benitez,36,0,40,4
1713331069213,EDS 281,A00,507345,Daly; Alan J.,18,0,18,0
1713331070241,EDS 284,A00,507350,Daly; Alan J.,16,0,16,0
1713331071266,EDS 286,A00,507359,Fine; Sarah,18,0,18,0
1713331072290,EDS 289C,A01,507361,Daly; Alan J.,18,0,18,0
1713331073316,EDS 290,A00,507366,Hofstetter; Carolyn,15,0,15,0
1713331074345,LIGM 5A,A00,507421,Fischer-Grunski; Eva K,20,0,20,0
1713331075369,LIGM 5B,A00,507423,Fischer-Grunski; Eva K,20,0,20,0
1713331076395,LIGM 5C,A00,507425,Fischer-Grunski; Eva K,20,0,20,0
1713331077420,LIIT 5AS,A00,507427,Carnelos; Chiara,20,0,20,0
1713331078450,LIIT 5BS,A00,507430,Carnelos; Chiara,20,0,20,0
1713331079474,LIIT 5CS,A00,507432,Carnelos; Chiara,20,0,20,0
1713331080500,LISP 5A,A00,507541,Munoz Sanchez; Alicia,17,0,20,3
1713331081527,LISP 5B,A00,507671,Munoz Sanchez; Alicia,15,0,20,5
1713331082553,LISP 5C,A00,507696,Munoz Sanchez; Alicia,15,0,20,5
1713331083579,MAE 197,001,528363,Boechler; Nicholas Sebastia,9998,0,9999,1
1713331084609,MATH 197,001,523477,Kedlaya; Kiran S.,9999,0,9999,0
1713331084609,MATH 197,002,563811,Zhang; Danna,9999,0,9999,0
1713331085638,MCWP 40R,A00,518780,Staff,20,0,20,0
1713331085638,MCWP 40R,B00,518781,Staff,19,0,20,1
1713331085638,MCWP 40R,C00,518783,Staff,19,0,20,1
1713331086665,MCWP 50R,A00,518791,Staff,20,0,20,0
1713331086665,MCWP 50R,B00,518792,Staff,17,0,20,3
1713331086665,MCWP 50R,C00,518793,Staff,19,0,20,1
1713331086665,MCWP 50R,D00,518794,Staff,16,0,20,4
1713331086665,MCWP 50R,E00,518795,Staff,16,0,20,4
1713331086665,MCWP 50R,F00,518796,Staff,19,0,20,1
1713331086665,MCWP 50R,G00,518797,Staff,19,0,20,1
1713331087695,MMW 12R,A01,514034,Herbst; Matthew,15,0,16,1
1713331087695,MMW 12R,A02,514035,Herbst; Matthew,16,0,16,0
1713331088723,MMW 13R,A01,514037,Staff,12,0,16,4
1713331088723,MMW 13R,A02,514039,Staff,16,0,16,0
1713331090775,SIO 295LS,A00,523233,Staff,19,0,30,11
1713331091802,SIO 295S,A00,523232,Staff,19,0,30,11
1713331092827,SOCI 117,A01,494376,Staff,2,0,5,3
1713331093863,WES 237B,A00,494380,Staff,19,0,20,1
1713331095940,AESE 279B,A00,494370,Wade; Jon P,33,0,33,0
1713331096966,ANAR 135S,A00,494369,Braswell; Geoffrey E.,0,0,0,0
1713331097999,CAT 124RS,A01,519847,Geibel; William,17,0,20,3
1713331099022,CAT 125RS,A01,515971,Geibel; William,17,0,20,3
1713331100048,CLRE 250,A00,511389,Morris; Sheldon,9996,0,9999,3
1713331101074,CLRE 251,A00,507176,Mehta; Ravindra L.,9996,0,9999,3
1713331101074,CLRE 251,B00,511410,Mehta; Ravindra L.,9998,0,9999,1
1713331102103,CLRE 252,A00,507189,Cuomo; Raphael Eduardo,9998,0,9999,1
1713331103131,CLRE 253,A00,507199,Vaida; Florin,9997,0,9999,2
1713331103131,CLRE 253,B00,507202,Vaida; Florin,9999,0,9999,0
1713331104162,CLRE 259,A00,507211,Patel; Hemal,9996,0,9999,3
1713331105189,CLRE 260,A00,507221,Cuomo; Raphael Eduardo,9999,0,9999,0
1713331106218,CLRE 297,001,507242,Cuomo; Raphael Eduardo,9999,0,9999,0
1713331107243,CSE 191,A00,516875,Minnes Kemp; Mor Mia,9999,0,9999,0
1713331108269,CSS 201S,A01,494383,Staff,35,0,35,0
1713331109295,CSS 202S,A01,494387,Staff,35,0,35,0
1713331110322,EAP 100,A00,516065,Staff,9792,0,9999,207
1713331111347,ECE 45,A01,507414,Staff,51,0,60,9
1713331112372,ECE 100,A01,507416,Baghdadchi; Saharnaz,10,0,20,10
1713331112372,ECE 100,A02,507418,Baghdadchi; Saharnaz,20,0,20,0
1713331113401,ECE 111,A01,507420,Staff,38,0,50,12
1713331114432,ECE 197,001,548057,Sievenpiper; Daniel F.,9998,0,9999,1
1713331115458,EDS 115,A00,507243,Choi; Bailey Miyeon,28,0,28,0
1713331116481,EDS 117,A01,494379,Staff,23,0,25,2
1713331117508,EDS 125,A00,507246,Hopkins; Megan Beth,29,0,30,1
1713331118538,EDS 128A,A01,507264,Fargason; Sharon Gayle,26,0,26,0
1713331119672,EDS 128B,A01,507293,Pappas; Elizabeth,30,0,30,0
1713331120702,EDS 139,A00,507294,Fargason; Sharon Gayle,30,0,30,0
1713331120702,EDS 139,B00,507313,Pappas; Elizabeth,30,0,30,0
1713331121727,EDS 201,A00,507315,Staff,26,0,30,4
1713331122757,EDS 203,A01,507317,Halter; Christopher P.,26,0,30,4
1713331123784,EDS 204R,A01,507319,Halter; Christopher P.,3,0,30,27
1713331123784,EDS 204R,B01,507331,Heinzman; Erica M.,28,0,30,2
1713331124809,EDS 206R,A00,507332,Staff,4,0,30,26
1713331124809,EDS 206R,B00,507343,Staff,28,0,30,2
1713331125838,EDS 250,A00,507344,Hemans; Patricia Ann Benitez,36,0,40,4
1713331126867,EDS 281,A00,507345,Daly; Alan J.,18,0,18,0
1713331127895,EDS 284,A00,507350,Daly; Alan J.,16,0,16,0
1713331128921,EDS 286,A00,507359,Fine; Sarah,18,0,18,0
1713331129946,EDS 289C,A01,507361,Daly; Alan J.,18,0,18,0
1713331130971,EDS 290,A00,507366,Hofstetter; Carolyn,15,0,15,0
1713331131999,LIGM 5A,A00,507421,Fischer-Grunski; Eva K,20,0,20,0
1713331133025,LIGM 5B,A00,507423,Fischer-Grunski; Eva K,20,0,20,0
1713331134056,LIGM 5C,A00,507425,Fischer-Grunski; Eva K,20,0,20,0
1713331135082,LIIT 5AS,A00,507427,Carnelos; Chiara,20,0,20,0
1713331136108,LIIT 5BS,A00,507430,Carnelos; Chiara,20,0,20,0
1713331137134,LIIT 5CS,A00,507432,Carnelos; Chiara,20,0,20,0
1713331138165,LISP 5A,A00,507541,Munoz Sanchez; Alicia,17,0,20,3
1713331139192,LISP 5B,A00,507671,Munoz Sanchez; Alicia,15,0,20,5
1713331140222,LISP 5C,A00,507696,Munoz Sanchez; Alicia,15,0,20,5
1713331141248,MAE 197,001,528363,Boechler; Nicholas Sebastia,9998,0,9999,1
1713331142278,MATH 197,001,523477,Kedlaya; Kiran S.,9999,0,9999,0
1713331142278,MATH 197,002,563811,Zhang; Danna,9999,0,9999,0
1713331143303,MCWP 40R,A00,518780,Staff,20,0,20,0
1713331143303,MCWP 40R,B00,518781,Staff,19,0,20,1
1713331143303,MCWP 40R,C00,518783,Staff,19,0,20,1
1713331144330,MCWP 50R,A00,518791,Staff,20,0,20,0
1713331144330,MCWP 50R,B00,518792,Staff,17,0,20,3
1713331144330,MCWP 50R,C00,518793,Staff,19,0,20,1
1713331144330,MCWP 50R,D00,518794,Staff,16,0,20,4
1713331144330,MCWP 50R,E00,518795,Staff,16,0,20,4
1713331144330,MCWP 50R,F00,518796,Staff,19,0,20,1
1713331144330,MCWP 50R,G00,518797,Staff,19,0,20,1
1713331145356,MMW 12R,A01,514034,Herbst; Matthew,15,0,16,1
1713331145356,MMW 12R,A02,514035,Herbst; Matthew,16,0,16,0
1713331146385,MMW 13R,A01,514037,Staff,12,0,16,4
1713331146385,MMW 13R,A02,514039,Staff,16,0,16,0
1713331148439,SIO 295LS,A00,523233,Staff,19,0,30,11
1713331149466,SIO 295S,A00,523232,Staff,19,0,30,11
1713331150491,SOCI 117,A01,494376,Staff,2,0,5,3
1713331151516,WES 237B,A00,494380,Staff,19,0,20,1
1713331153579,AESE 279B,A00,494370,Wade; Jon P,33,0,33,0
1713331154605,ANAR 135S,A00,494369,Braswell; Geoffrey E.,0,0,0,0
1713331155634,CAT 124RS,A01,519847,Geibel; William,17,0,20,3
1713331156661,CAT 125RS,A01,515971,Geibel; William,17,0,20,3
1713331157690,CLRE 250,A00,511389,Morris; Sheldon,9996,0,9999,3
1713331158718,CLRE 251,A00,507176,Mehta; Ravindra L.,9996,0,9999,3
1713331158718,CLRE 251,B00,511410,Mehta; Ravindra L.,9998,0,9999,1
1713331159743,CLRE 252,A00,507189,Cuomo; Raphael Eduardo,9998,0,9999,1
1713331160767,CLRE 253,A00,507199,Vaida; Florin,9997,0,9999,2
1713331160767,CLRE 253,B00,507202,Vaida; Florin,9999,0,9999,0
1713331161792,CLRE 259,A00,507211,Patel; Hemal,9996,0,9999,3
1713331162817,CLRE 260,A00,507221,Cuomo; Raphael Eduardo,9999,0,9999,0
1713331163845,CLRE 297,001,507242,Cuomo; Raphael Eduardo,9999,0,9999,0
1713331164930,CSE 191,A00,516875,Minnes Kemp; Mor Mia,9999,0,9999,0
1713331165960,CSS 201S,A01,494383,Staff,35,0,35,0
1713331166988,CSS 202S,A01,494387,Staff,35,0,35,0
1713331168016,EAP 100,A00,516065,Staff,9792,0,9999,207
1713331169048,ECE 45,A01,507414,Staff,51,0,60,9
1713331170080,ECE 100,A01,507416,Baghdadchi; Saharnaz,10,0,20,10
1713331170080,ECE 100,A02,507418,Baghdadchi; Saharnaz,20,0,20,0
1713331171110,ECE 111,A01,507420,Staff,38,0,50,12
1713331172135,ECE 197,001,548057,Sievenpiper; Daniel F.,9998,0,9999,1
1713331173161,EDS 115,A00,507243,Choi; Bailey Miyeon,28,0,28,0
1713331174187,EDS 117,A01,494379,Staff,23,0,25,2
1713331175217,EDS 125,A00,507246,Hopkins; Megan Beth,29,0,30,1
1713331176247,EDS 128A,A01,507264,Fargason; Sharon Gayle,26,0,26,0
1713331177273,EDS 128B,A01,507293,Pappas; Elizabeth,30,0,30,0
1713331178301,EDS 139,A00,507294,Fargason; Sharon Gayle,30,0,30,0
1713331178301,EDS 139,B00,507313,Pappas; Elizabeth,30,0,30,0
1713331179325,EDS 201,A00,507315,Staff,26,0,30,4
1713331180351,EDS 203,A01,507317,Halter; Christopher P.,26,0,30,4
1713331181376,EDS 204R,A01,507319,Halter; Christopher P.,3,0,30,27
1713331181376,EDS 204R,B01,507331,Heinzman; Erica M.,28,0,30,2
1713331182402,EDS 206R,A00,507332,Staff,4,0,30,26
1713331182402,EDS 206R,B00,507343,Staff,28,0,30,2
1713331183430,EDS 250,A00,507344,Hemans; Patricia Ann Benitez,36,0,40,4
1713331184459,EDS 281,A00,507345,Daly; Alan J.,18,0,18,0
1713331185483,EDS 284,A00,507350,Daly; Alan J.,16,0,16,0
1713331186508,EDS 286,A00,507359,Fine; Sarah,18,0,18,0
1713331187535,EDS 289C,A01,507361,Daly; Alan J.,18,0,18,0
1713331188561,EDS 290,A00,507366,Hofstetter; Carolyn,15,0,15,0
1713331189591,LIGM 5A,A00,507421,Fischer-Grunski; Eva K,20,0,20,0
1713331190617,LIGM 5B,A00,507423,Fischer-Grunski; Eva K,20,0,20,0
1713331191644,LIGM 5C,A00,507425,Fischer-Grunski; Eva K,20,0,20,0
1713331192674,LIIT 5AS,A00,507427,Carnelos; Chiara,20,0,20,0
1713331193702,LIIT 5BS,A00,507430,Carnelos; Chiara,20,0,20,0
1713331194730,LIIT 5CS,A00,507432,Carnelos; Chiara,20,0,20,0
1713331195755,LISP 5A,A00,507541,Munoz Sanchez; Alicia,17,0,20,3
1713331196780,LISP 5B,A00,507671,Munoz Sanchez; Alicia,15,0,20,5
1713331197809,LISP 5C,A00,507696,Munoz Sanchez; Alicia,15,0,20,5
1713331198838,MAE 197,001,528363,Boechler; Nicholas Sebastia,9998,0,9999,1
1713331199867,MATH 197,001,523477,Kedlaya; Kiran S.,9999,0,9999,0
1713331199867,MATH 197,002,563811,Zhang; Danna,9999,0,9999,0
1713331200892,MCWP 40R,A00,518780,Staff,20,0,20,0
1713331200892,MCWP 40R,B00,518781,Staff,19,0,20,1
1713331200892,MCWP 40R,C00,518783,Staff,19,0,20,1
1713331201917,MCWP 50R,A00,518791,Staff,20,0,20,0
1713331201917,MCWP 50R,B00,518792,Staff,17,0,20,3
1713331201917,MCWP 50R,C00,518793,Staff,19,0,20,1
1713331201917,MCWP 50R,D00,518794,Staff,16,0,20,4
1713331201917,MCWP 50R,E00,518795,Staff,16,0,20,4
1713331201917,MCWP 50R,F00,518796,Staff,19,0,20,1
1713331201917,MCWP 50R,G00,518797,Staff,19,0,20,1
1713331202948,MMW 12R,A01,514034,Herbst; Matthew,15,0,16,1
1713331202948,MMW 12R,A02,514035,Herbst; Matthew,16,0,16,0
1713331203975,MMW 13R,A01,514037,Staff,12,0,16,4
1713331203975,MMW 13R,A02,514039,Staff,16,0,16,0
1713331206031,SIO 295LS,A00,523233,Staff,19,0,30,11
1713331207060,SIO 295S,A00,523232,Staff,19,0,30,11
1713331208085,SOCI 117,A01,494376,Staff,2,0,5,3
1713331209111,WES 237B,A00,494380,Staff,19,0,20,1
1713331211188,AESE 279B,A00,494370,Wade; Jon P,33,0,33,0
1713331212215,ANAR 135S,A00,494369,Braswell; Geoffrey E.,0,0,0,0
1713331213243,CAT 124RS,A01,519847,Geibel; William,17,0,20,3
1713331214271,CAT 125RS,A01,515971,Geibel; William,17,0,20,3
1713331215297,CLRE 250,A00,511389,Morris; Sheldon,9996,0,9999,3
1713331216329,CLRE 251,A00,507176,Mehta; Ravindra L.,9996,0,9999,3
1713331216329,CLRE 251,B00,511410,Mehta; Ravindra L.,9998,0,9999,1
1713331217355,CLRE 252,A00,507189,Cuomo; Raphael Eduardo,9998,0,9999,1
1713331218381,CLRE 253,A00,507199,Vaida; Florin,9997,0,9999,2
1713331218381,CLRE 253,B00,507202,Vaida; Florin,9999,0,9999,0
1713331219406,CLRE 259,A00,507211,Patel; Hemal,9996,0,9999,3
1713331220430,CLRE 260,A00,507221,Cuomo; Raphael Eduardo,9999,0,9999,0
1713331221456,CLRE 297,001,507242,Cuomo; Raphael Eduardo,9999,0,9999,0
1713331222481,CSE 191,A00,516875,Minnes Kemp; Mor Mia,9999,0,9999,0
1713331223508,CSS 201S,A01,494383,Staff,35,0,35,0
1713331224532,CSS 202S,A01,494387,Staff,35,0,35,0
1713331225557,EAP 100,A00,516065,Staff,9792,0,9999,207
1713331226587,ECE 45,A01,507414,Staff,51,0,60,9
1713331227612,ECE 100,A01,507416,Baghdadchi; Saharnaz,10,0,20,10
1713331227612,ECE 100,A02,507418,Baghdadchi; Saharnaz,20,0,20,0
1713331228678,ECE 111,A01,507420,Staff,38,0,50,12
1713331229706,ECE 197,001,548057,Sievenpiper; Daniel F.,9998,0,9999,1
1713331230737,EDS 115,A00,507243,Choi; Bailey Miyeon,28,0,28,0
1713331231762,EDS 117,A01,494379,Staff,23,0,25,2
1713331232788,EDS 125,A00,507246,Hopkins; Megan Beth,29,0,30,1
1713331233813,EDS 128A,A01,507264,Fargason; Sharon Gayle,26,0,26,0
1713331234838,EDS 128B,A01,507293,Pappas; Elizabeth,30,0,30,0
1713331235867,EDS 139,A00,507294,Fargason; Sharon Gayle,30,0,30,0
1713331235867,EDS 139,B00,507313,Pappas; Elizabeth,30,0,30,0
1713331236893,EDS 201,A00,507315,Staff,26,0,30,4
1713331237921,EDS 203,A01,507317,Halter; Christopher P.,26,0,30,4
1713331238948,EDS 204R,A01,507319,Halter; Christopher P.,3,0,30,27
1713331238948,EDS 204R,B01,507331,Heinzman; Erica M.,28,0,30,2
1713331239978,EDS 206R,A00,507332,Staff,4,0,30,26
1713331239978,EDS 206R,B00,507343,Staff,28,0,30,2
1713331241001,EDS 250,A00,507344,Hemans; Patricia Ann Benitez,36,0,40,4
1713331242027,EDS 281,A00,507345,Daly; Alan J.,18,0,18,0
1713331243051,EDS 284,A00,507350,Daly; Alan J.,16,0,16,0
1713331244082,EDS 286,A00,507359,Fine; Sarah,18,0,18,0
1713331245107,EDS 289C,A01,507361,Daly; Alan J.,18,0,18,0
1713331246135,EDS 290,A00,507366,Hofstetter; Carolyn,15,0,15,0
1713331247160,LIGM 5A,A00,507421,Fischer-Grunski; Eva K,20,0,20,0
1713331248185,LIGM 5B,A00,507423,Fischer-Grunski; Eva K,20,0,20,0
1713331249211,LIGM 5C,A00,507425,Fischer-Grunski; Eva K,20,0,20,0
1713331250234,LIIT 5AS,A00,507427,Carnelos; Chiara,20,0,20,0
1713331251262,LIIT 5BS,A00,507430,Carnelos; Chiara,20,0,20,0
1713331252285,LIIT 5CS,A00,507432,Carnelos; Chiara,20,0,20,0
1713331253310,LISP 5A,A00,507541,Munoz Sanchez; Alicia,17,0,20,3
1713331254335,LISP 5B,A00,507671,Munoz Sanchez; Alicia,15,0,20,5
1713331255365,LISP 5C,A00,507696,Munoz Sanchez; Alicia,15,0,20,5
1713331256390,MAE 197,001,528363,Boechler; Nicholas Sebastia,9998,0,9999,1
1713331257417,MATH 197,001,523477,Kedlaya; Kiran S.,9999,0,9999,0
1713331257417,MATH 197,002,563811,Zhang; Danna,9999,0,9999,0
1713331258447,MCWP 40R,A00,518780,Staff,20,0,20,0
1713331258447,MCWP 40R,B00,518781,Staff,19,0,20,1
1713331258447,MCWP 40R,C00,518783,Staff,19,0,20,1
1713331259473,MCWP 50R,A00,518791,Staff,20,0,20,0
1713331259473,MCWP 50R,B00,518792,Staff,17,0,20,3
1713331259473,MCWP 50R,C00,518793,Staff,19,0,20,1
1713331259473,MCWP 50R,D00,518794,Staff,16,0,20,4
1713331259473,MCWP 50R,E00,518795,Staff,16,0,20,4
1713331259473,MCWP 50R,F00,518796,Staff,19,0,20,1
1713331259473,MCWP 50R,G00,518797,Staff,19,0,20,1
1713331260497,MMW 12R,A01,514034,Herbst; Matthew,15,0,16,1
1713331260497,MMW 12R,A02,514035,Herbst; Matthew,16,0,16,0
1713331261527,MMW 13R,A01,514037,Staff,12,0,16,4
1713331261527,MMW 13R,A02,514039,Staff,16,0,16,0
1713331263582,SIO 295LS,A00,523233,Staff,19,0,30,11
1713331264608,SIO 295S,A00,523232,Staff,19,0,30,11
1713331265636,SOCI 117,A01,494376,Staff,2,0,5,3
1713331266711,WES 237B,A00,494380,Staff,19,0,20,1
1713331268835,AESE 279B,A00,494370,Wade; Jon P,33,0,33,0
1713331269863,ANAR 135S,A00,494369,Braswell; Geoffrey E.,0,0,0,0
1713331270889,CAT 124RS,A01,519847,Geibel; William,17,0,20,3
1713331271914,CAT 125RS,A01,515971,Geibel; William,17,0,20,3
1713331272939,CLRE 250,A00,511389,Morris; Sheldon,9996,0,9999,3
1713331273974,CLRE 251,A00,507176,Mehta; Ravindra L.,9996,0,9999,3
1713331273974,CLRE 251,B00,511410,Mehta; Ravindra L.,9998,0,9999,1
1713331275004,CLRE 252,A00,507189,Cuomo; Raphael Eduardo,9998,0,9999,1
1713331276033,CLRE 253,A00,507199,Vaida; Florin,9997,0,9999,2
1713331276033,CLRE 253,B00,507202,Vaida; Florin,9999,0,9999,0
1713331277057,CLRE 259,A00,507211,Patel; Hemal,9996,0,9999,3
1713331278083,CLRE 260,A00,507221,Cuomo; Raphael Eduardo,9999,0,9999,0
1713331279108,CLRE 297,001,507242,Cuomo; Raphael Eduardo,9999,0,9999,0
1713331280133,CSE 191,A00,516875,Minnes Kemp; Mor Mia,9999,0,9999,0
1713331281159,CSS 201S,A01,494383,Staff,35,0,35,0
1713331282185,CSS 202S,A01,494387,Staff,35,0,35,0
1713331283210,EAP 100,A00,516065,Staff,9792,0,9999,207
1713331284240,ECE 45,A01,507414,Staff,51,0,60,9
1713331285266,ECE 100,A01,507416,Baghdadchi; Saharnaz,10,0,20,10
1713331285266,ECE 100,A02,507418,Baghdadchi; Saharnaz,20,0,20,0
1713331286292,ECE 111,A01,507420,Staff,38,0,50,12
1713331287319,ECE 197,001,548057,Sievenpiper; Daniel F.,9998,0,9999,1
1713331288346,EDS 115,A00,507243,Choi; Bailey Miyeon,28,0,28,0
1713331289371,EDS 117,A01,494379,Staff,23,0,25,2
1713331290396,EDS 125,A00,507246,Hopkins; Megan Beth,29,0,30,1
1713331291422,EDS 128A,A01,507264,Fargason; Sharon Gayle,26,0,26,0
1713331292446,EDS 128B,A01,507293,Pappas; Elizabeth,30,0,30,0
1713331293471,EDS 139,A00,507294,Fargason; Sharon Gayle,30,0,30,0
1713331293471,EDS 139,B00,507313,Pappas; Elizabeth,30,0,30,0
1713331294496,EDS 201,A00,507315,Staff,26,0,30,4
1713331295523,EDS 203,A01,507317,Halter; Christopher P.,26,0,30,4
1713331296549,EDS 204R,A01,507319,Halter; Christopher P.,3,0,30,27
1713331296549,EDS 204R,B01,507331,Heinzman; Erica M.,28,0,30,2
1713331297577,EDS 206R,A00,507332,Staff,4,0,30,26
1713331297577,EDS 206R,B00,507343,Staff,28,0,30,2
1713331298604,EDS 250,A00,507344,Hemans; Patricia Ann Benitez,36,0,40,4
1713331299628,EDS 281,A00,507345,Daly; Alan J.,18,0,18,0
1713331300653,EDS 284,A00,507350,Daly; Alan J.,16,0,16,0
1713331301683,EDS 286,A00,507359,Fine; Sarah,18,0,18,0
1713331302708,EDS 289C,A01,507361,Daly; Alan J.,18,0,18,0
1713331303734,EDS 290,A00,507366,Hofstetter; Carolyn,15,0,15,0
1713331304759,LIGM 5A,A00,507421,Fischer-Grunski; Eva K,20,0,20,0
1713331305786,LIGM 5B,A00,507423,Fischer-Grunski; Eva K,20,0,20,0
1713331306812,LIGM 5C,A00,507425,Fischer-Grunski; Eva K,20,0,20,0
1713331307839,LIIT 5AS,A00,507427,Carnelos; Chiara,20,0,20,0
1713331308868,LIIT 5BS,A00,507430,Carnelos; Chiara,20,0,20,0
1713331309894,LIIT 5CS,A00,507432,Carnelos; Chiara,20,0,20,0
1713331310924,LISP 5A,A00,507541,Munoz Sanchez; Alicia,17,0,20,3
1713331311948,LISP 5B,A00,507671,Munoz Sanchez; Alicia,15,0,20,5
1713331312974,LISP 5C,A00,507696,Munoz Sanchez; Alicia,15,0,20,5
1713331314001,MAE 197,001,528363,Boechler; Nicholas Sebastia,9998,0,9999,1
1713331315028,MATH 197,001,523477,Kedlaya; Kiran S.,9999,0,9999,0
1713331315028,MATH 197,002,563811,Zhang; Danna,9999,0,9999,0
1713331316059,MCWP 40R,A00,518780,Staff,20,0,20,0
1713331316059,MCWP 40R,B00,518781,Staff,19,0,20,1
1713331316059,MCWP 40R,C00,518783,Staff,19,0,20,1
1713331317083,MCWP 50R,A00,518791,Staff,20,0,20,0
1713331317083,MCWP 50R,B00,518792,Staff,17,0,20,3
1713331317083,MCWP 50R,C00,518793,Staff,19,0,20,1
1713331317083,MCWP 50R,D00,518794,Staff,16,0,20,4
1713331317083,MCWP 50R,E00,518795,Staff,16,0,20,4
1713331317083,MCWP 50R,F00,518796,Staff,19,0,20,1
1713331317083,MCWP 50R,G00,518797,Staff,19,0,20,1
1713331318108,MMW 12R,A01,514034,Herbst; Matthew,15,0,16,1
1713331318108,MMW 12R,A02,514035,Herbst; Matthew,16,0,16,0
1713331319136,MMW 13R,A01,514037,Staff,12,0,16,4
1713331319136,MMW 13R,A02,514039,Staff,16,0,16,0
1713331321186,SIO 295LS,A00,523233,Staff,19,0,30,11
1713331322211,SIO 295S,A00,523232,Staff,19,0,30,11
1713331323241,SOCI 117,A01,494376,Staff,2,0,5,3
1713331324266,WES 237B,A00,494380,Staff,19,0,20,1
1713331326330,AESE 279B,A00,494370,Wade; Jon P,33,0,33,0
1713331327356,ANAR 135S,A00,494369,Braswell; Geoffrey E.,0,0,0,0
1713331328383,CAT 124RS,A01,519847,Geibel; William,17,0,20,3
1713331329409,CAT 125RS,A01,515971,Geibel; William,17,0,20,3
1713331330433,CLRE 250,A00,511389,Morris; Sheldon,9996,0,9999,3
1713331331462,CLRE 251,A00,507176,Mehta; Ravindra L.,9996,0,9999,3
1713331331462,CLRE 251,B00,511410,Mehta; Ravindra L.,9998,0,9999,1
1713331332491,CLRE 252,A00,507189,Cuomo; Raphael Eduardo,9998,0,9999,1
1713331333519,CLRE 253,A00,507199,Vaida; Florin,9997,0,9999,2
1713331333519,CLRE 253,B00,507202,Vaida; Florin,9999,0,9999,0
1713331334547,CLRE 259,A00,507211,Patel; Hemal,9996,0,9999,3
1713331335570,CLRE 260,A00,507221,Cuomo; Raphael Eduardo,9999,0,9999,0
1713331336596,CLRE 297,001,507242,Cuomo; Raphael Eduardo,9999,0,9999,0
1713331337621,CSE 191,A00,516875,Minnes Kemp; Mor Mia,9999,0,9999,0
1713331338651,CSS 201S,A01,494383,Staff,35,0,35,0
1713331339677,CSS 202S,A01,494387,Staff,35,0,35,0
1713331340701,EAP 100,A00,516065,Staff,9792,0,9999,207
1713331341729,ECE 45,A01,507414,Staff,51,0,60,9
1713331342756,ECE 100,A01,507416,Baghdadchi; Saharnaz,10,0,20,10
1713331342756,ECE 100,A02,507418,Baghdadchi; Saharnaz,20,0,20,0
1713331343783,ECE 111,A01,507420,Staff,38,0,50,12
1713331344808,ECE 197,001,548057,Sievenpiper; Daniel F.,9998,0,9999,1
1713331345835,EDS 115,A00,507243,Choi; Bailey Miyeon,28,0,28,0
1713331346860,EDS 117,A01,494379,Staff,23,0,25,2
1713331347886,EDS 125,A00,507246,Hopkins; Megan Beth,29,0,30,1
1713331348915,EDS 128A,A01,507264,Fargason; Sharon Gayle,26,0,26,0
1713331349943,EDS 128B,A01,507293,Pappas; Elizabeth,30,0,30,0
1713331350971,EDS 139,A00,507294,Fargason; Sharon Gayle,30,0,30,0
1713331350971,EDS 139,B00,507313,Pappas; Elizabeth,30,0,30,0
1713331351996,EDS 201,A00,507315,Staff,26,0,30,4
1713331353022,EDS 203,A01,507317,Halter; Christopher P.,26,0,30,4
1713331354048,EDS 204R,A01,507319,Halter; Christopher P.,3,0,30,27
1713331354048,EDS 204R,B01,507331,Heinzman; Erica M.,28,0,30,2
1713331355075,EDS 206R,A00,507332,Staff,4,0,30,26
1713331355075,EDS 206R,B00,507343,Staff,28,0,30,2
1713331356103,EDS 250,A00,507344,Hemans; Patricia Ann Benitez,36,0,40,4
1713331357129,EDS 281,A00,507345,Daly; Alan J.,18,0,18,0
1713331358153,EDS 284,A00,507350,Daly; Alan J.,16,0,16,0
1713331359181,EDS 286,A00,507359,Fine; Sarah,18,0,18,0
1713331360210,EDS 289C,A01,507361,Daly; Alan J.,18,0,18,0
1713331361240,EDS 290,A00,507366,Hofstetter; Carolyn,15,0,15,0
1713331362270,LIGM 5A,A00,507421,Fischer-Grunski; Eva K,20,0,20,0
1713331363296,LIGM 5B,A00,507423,Fischer-Grunski; Eva K,20,0,20,0
1713331364325,LIGM 5C,A00,507425,Fischer-Grunski; Eva K,20,0,20,0
1713331365356,LIIT 5AS,A00,507427,Carnelos; Chiara,20,0,20,0
1713331366384,LIIT 5BS,A00,507430,Carnelos; Chiara,20,0,20,0
1713331367408,LIIT 5CS,A00,507432,Carnelos; Chiara,20,0,20,0
1713331368439,LISP 5A,A00,507541,Munoz Sanchez; Alicia,17,0,20,3
1713331369469,LISP 5B,A00,507671,Munoz Sanchez; Alicia,15,0,20,5
1713331370497,LISP 5C,A00,507696,Munoz Sanchez; Alicia,15,0,20,5
1713331371522,MAE 197,001,528363,Boechler; Nicholas Sebastia,9998,0,9999,1
1713331372602,MATH 197,001,523477,Kedlaya; Kiran S.,9999,0,9999,0
1713331372602,MATH 197,002,563811,Zhang; Danna,9999,0,9999,0
1713331373627,MCWP 40R,A00,518780,Staff,20,0,20,0
1713331373627,MCWP 40R,B00,518781,Staff,19,0,20,1
1713331373627,MCWP 40R,C00,518783,Staff,19,0,20,1
1713331374652,MCWP 50R,A00,518791,Staff,20,0,20,0
1713331374652,MCWP 50R,B00,518792,Staff,17,0,20,3
1713331374652,MCWP 50R,C00,518793,Staff,19,0,20,1
1713331374652,MCWP 50R,D00,518794,Staff,16,0,20,4
1713331374652,MCWP 50R,E00,518795,Staff,16,0,20,4
1713331374652,MCWP 50R,F00,518796,Staff,19,0,20,1
1713331374652,MCWP 50R,G00,518797,Staff,19,0,20,1
1713331375678,MMW 12R,A01,514034,Herbst; Matthew,15,0,16,1
1713331375678,MMW 12R,A02,514035,Herbst; Matthew,16,0,16,0
1713331376701,MMW 13R,A01,514037,Staff,12,0,16,4
1713331376701,MMW 13R,A02,514039,Staff,16,0,16,0
1713331378751,SIO 295LS,A00,523233,Staff,19,0,30,11
1713331379779,SIO 295S,A00,523232,Staff,19,0,30,11
1713331380804,SOCI 117,A01,494376,Staff,2,0,5,3
1713331381833,WES 237B,A00,494380,Staff,19,0,20,1
1713331383898,AESE 279B,A00,494370,Wade; Jon P,33,0,33,0
1713331384927,ANAR 135S,A00,494369,Braswell; Geoffrey E.,0,0,0,0
1713331385955,CAT 124RS,A01,519847,Geibel; William,17,0,20,3
1713331386980,CAT 125RS,A01,515971,Geibel; William,17,0,20,3
1713331388006,CLRE 250,A00,511389,Morris; Sheldon,9996,0,9999,3
1713331389033,CLRE 251,A00,507176,Mehta; Ravindra L.,9996,0,9999,3
1713331389033,CLRE 251,B00,511410,Mehta; Ravindra L.,9998,0,9999,1
1713331390063,CLRE 252,A00,507189,Cuomo; Raphael Eduardo,9998,0,9999,1
1713331391091,CLRE 253,A00,507199,Vaida; Florin,9997,0,9999,2
1713331391091,CLRE 253,B00,507202,Vaida; Florin,9999,0,9999,0
1713331392121,CLRE 259,A00,507211,Patel; Hemal,9996,0,9999,3
1713331393148,CLRE 260,A00,507221,Cuomo; Raphael Eduardo,9999,0,9999,0
1713331394172,CLRE 297,001,507242,Cuomo; Raphael Eduardo,9999,0,9999,0
1713331395200,CSE 191,A00,516875,Minnes Kemp; Mor Mia,9999,0,9999,0
1713331396222,CSS 201S,A01,494383,Staff,35,0,35,0
1713331397248,CSS 202S,A01,494387,Staff,35,0,35,0
1713331398274,EAP 100,A00,516065,Staff,9792,0,9999,207
1713331399302,ECE 45,A01,507414,Staff,51,0,60,9
1713331400328,ECE 100,A01,507416,Baghdadchi; Saharnaz,10,0,20,10
1713331400328,ECE 100,A02,507418,Baghdadchi; Saharnaz,20,0,20,0
1713331401358,ECE 111,A01,507420,Staff,38,0,50,12
1713331402387,ECE 197,001,548057,Sievenpiper; Daniel F.,9998,0,9999,1
1713331403417,EDS 115,A00,507243,Choi; Bailey Miyeon,28,0,28,0
1713331404470,EDS 117,A01,494379,Staff,23,0,25,2
1713331405498,EDS 125,A00,507246,Hopkins; Megan Beth,29,0,30,1
1713331406529,EDS 128A,A01,507264,Fargason; Sharon Gayle,26,0,26,0
1713331407553,EDS 128B,A01,507293,Pappas; Elizabeth,30,0,30,0
1713331408578,EDS 139,A00,507294,Fargason; Sharon Gayle,30,0,30,0
1713331408578,EDS 139,B00,507313,Pappas; Elizabeth,30,0,30,0
1713331409604,EDS 201,A00,507315,Staff,26,0,30,4
1713331410635,EDS 203,A01,507317,Halter; Christopher P.,26,0,30,4
1713331411662,EDS 204R,A01,507319,Halter; Christopher P.,3,0,30,27
1713331411662,EDS 204R,B01,507331,Heinzman; Erica M.,28,0,30,2
1713331412691,EDS 206R,A00,507332,Staff,4,0,30,26
1713331412691,EDS 206R,B00,507343,Staff,28,0,30,2
1713331413720,EDS 250,A00,507344,Hemans; Patricia Ann Benitez,36,0,40,4
1713331414745,EDS 281,A00,507345,Daly; Alan J.,18,0,18,0
1713331415770,EDS 284,A00,507350,Daly; Alan J.,16,0,16,0
1713331416801,EDS 286,A00,507359,Fine; Sarah,18,0,18,0
1713331417826,EDS 289C,A01,507361,Daly; Alan J.,18,0,18,0
1713331418852,EDS 290,A00,507366,Hofstetter; Carolyn,15,0,15,0
1713331419884,LIGM 5A,A00,507421,Fischer-Grunski; Eva K,20,0,20,0
1713331420913,LIGM 5B,A00,507423,Fischer-Grunski; Eva K,20,0,20,0
1713331421938,LIGM 5C,A00,507425,Fischer-Grunski; Eva K,20,0,20,0
1713331422967,LIIT 5AS,A00,507427,Carnelos; Chiara,20,0,20,0
1713331423997,LIIT 5BS,A00,507430,Carnelos; Chiara,20,0,20,0
1713331425024,LIIT 5CS,A00,507432,Carnelos; Chiara,20,0,20,0
1713331426049,LISP 5A,A00,507541,Munoz Sanchez; Alicia,17,0,20,3
1713331427077,LISP 5B,A00,507671,Munoz Sanchez; Alicia,15,0,20,5
1713331428123,LISP 5C,A00,507696,Munoz Sanchez; Alicia,15,0,20,5
1713331429148,MAE 197,001,528363,Boechler; Nicholas Sebastia,9998,0,9999,1
1713331430174,MATH 197,001,523477,Kedlaya; Kiran S.,9999,0,9999,0
1713331430174,MATH 197,002,563811,Zhang; Danna,9999,0,9999,0
1713331431199,MCWP 40R,A00,518780,Staff,20,0,20,0
1713331431199,MCWP 40R,B00,518781,Staff,19,0,20,1
1713331431199,MCWP 40R,C00,518783,Staff,19,0,20,1
1713331432229,MCWP 50R,A00,518791,Staff,20,0,20,0
1713331432229,MCWP 50R,B00,518792,Staff,17,0,20,3
1713331432229,MCWP 50R,C00,518793,Staff,19,0,20,1
1713331432229,MCWP 50R,D00,518794,Staff,16,0,20,4
1713331432229,MCWP 50R,E00,518795,Staff,16,0,20,4
1713331432229,MCWP 50R,F00,518796,Staff,19,0,20,1
1713331432229,MCWP 50R,G00,518797,Staff,19,0,20,1
1713331433253,MMW 12R,A01,514034,Herbst; Matthew,15,0,16,1
1713331433253,MMW 12R,A02,514035,Herbst; Matthew,16,0,16,0
1713331434281,MMW 13R,A01,514037,Staff,12,0,16,4
1713331434281,MMW 13R,A02,514039,Staff,16,0,16,0
1713331436332,SIO 295LS,A00,523233,Staff,19,0,30,11
1713331437357,SIO 295S,A00,523232,Staff,19,0,30,11
1713331438384,SOCI 117,A01,494376,Staff,2,0,5,3
1713331439413,WES 237B,A00,494380,Staff,19,0,20,1
1713331441477,AESE 279B,A00,494370,Wade; Jon P,33,0,33,0
1713331442506,ANAR 135S,A00,494369,Braswell; Geoffrey E.,0,0,0,0
1713331443535,CAT 124RS,A01,519847,Geibel; William,17,0,20,3
1713331444561,CAT 125RS,A01,515971,Geibel; William,17,0,20,3
1713331445590,CLRE 250,A00,511389,Morris; Sheldon,9996,0,9999,3
1713331446617,CLRE 251,A00,507176,Mehta; Ravindra L.,9996,0,9999,3
1713331446617,CLRE 251,B00,511410,Mehta; Ravindra L.,9998,0,9999,1
1713331447643,CLRE 252,A00,507189,Cuomo; Raphael Eduardo,9998,0,9999,1
1713331448671,CLRE 253,A00,507199,Vaida; Florin,9997,0,9999,2
1713331448671,CLRE 253,B00,507202,Vaida; Florin,9999,0,9999,0
1713331449696,CLRE 259,A00,507211,Patel; Hemal,9996,0,9999,3
1713331450721,CLRE 260,A00,507221,Cuomo; Raphael Eduardo,9999,0,9999,0
1713331451744,CLRE 297,001,507242,Cuomo; Raphael Eduardo,9999,0,9999,0
1713331452773,CSE 191,A00,516875,Minnes Kemp; Mor Mia,9999,0,9999,0
1713331453799,CSS 201S,A01,494383,Staff,35,0,35,0
1713331454831,CSS 202S,A01,494387,Staff,35,0,35,0
1713331455859,EAP 100,A00,516065,Staff,9792,0,9999,207
1713331456889,ECE 45,A01,507414,Staff,51,0,60,9
1713331457916,ECE 100,A01,507416,Baghdadchi; Saharnaz,10,0,20,10
1713331457916,ECE 100,A02,507418,Baghdadchi; Saharnaz,20,0,20,0
1713331458940,ECE 111,A01,507420,Staff,38,0,50,12
1713331459966,ECE 197,001,548057,Sievenpiper; Daniel F.,9998,0,9999,1
1713331460997,EDS 115,A00,507243,Choi; Bailey Miyeon,28,0,28,0
1713331462026,EDS 117,A01,494379,Staff,23,0,25,2
1713331463052,EDS 125,A00,507246,Hopkins; Megan Beth,29,0,30,1
1713331464081,EDS 128A,A01,507264,Fargason; Sharon Gayle,26,0,26,0
1713331465107,EDS 128B,A01,507293,Pappas; Elizabeth,30,0,30,0
1713331466132,EDS 139,A00,507294,Fargason; Sharon Gayle,30,0,30,0
1713331466132,EDS 139,B00,507313,Pappas; Elizabeth,30,0,30,0
1713331467161,EDS 201,A00,507315,Staff,26,0,30,4
1713331468188,EDS 203,A01,507317,Halter; Christopher P.,26,0,30,4
1713331469215,EDS 204R,A01,507319,Halter; Christopher P.,3,0,30,27
1713331469215,EDS 204R,B01,507331,Heinzman; Erica M.,28,0,30,2
1713331470241,EDS 206R,A00,507332,Staff,4,0,30,26
1713331470241,EDS 206R,B00,507343,Staff,28,0,30,2
1713331471266,EDS 250,A00,507344,Hemans; Patricia Ann Benitez,36,0,40,4
1713331472297,EDS 281,A00,507345,Daly; Alan J.,18,0,18,0
1713331473324,EDS 284,A00,507350,Daly; Alan J.,16,0,16,0
1713331474353,EDS 286,A00,507359,Fine; Sarah,18,0,18,0
1713331475381,EDS 289C,A01,507361,Daly; Alan J.,18,0,18,0
1713331476461,EDS 290,A00,507366,Hofstetter; Carolyn,15,0,15,0
1713331477492,LIGM 5A,A00,507421,Fischer-Grunski; Eva K,20,0,20,0
1713331478522,LIGM 5B,A00,507423,Fischer-Grunski; Eva K,20,0,20,0
1713331479549,LIGM 5C,A00,507425,Fischer-Grunski; Eva K,20,0,20,0
1713331480575,LIIT 5AS,A00,507427,Carnelos; Chiara,20,0,20,0
1713331481599,LIIT 5BS,A00,507430,Carnelos; Chiara,20,0,20,0
1713331482625,LIIT 5CS,A00,507432,Carnelos; Chiara,20,0,20,0
1713331483655,LISP 5A,A00,507541,Munoz Sanchez; Alicia,17,0,20,3
1713331484684,LISP 5B,A00,507671,Munoz Sanchez; Alicia,15,0,20,5
1713331485714,LISP 5C,A00,507696,Munoz Sanchez; Alicia,15,0,20,5
1713331486742,MAE 197,001,528363,Boechler; Nicholas Sebastia,9998,0,9999,1
1713331487772,MATH 197,001,523477,Kedlaya; Kiran S.,9999,0,9999,0
1713331487772,MATH 197,002,563811,Zhang; Danna,9999,0,9999,0
1713331488797,MCWP 40R,A00,518780,Staff,20,0,20,0
1713331488797,MCWP 40R,B00,518781,Staff,19,0,20,1
1713331488797,MCWP 40R,C00,518783,Staff,19,0,20,1
1713331489824,MCWP 50R,A00,518791,Staff,20,0,20,0
1713331489824,MCWP 50R,B00,518792,Staff,17,0,20,3
1713331489824,MCWP 50R,C00,518793,Staff,19,0,20,1
1713331489824,MCWP 50R,D00,518794,Staff,16,0,20,4
1713331489824,MCWP 50R,E00,518795,Staff,16,0,20,4
1713331489824,MCWP 50R,F00,518796,Staff,19,0,20,1
1713331489824,MCWP 50R,G00,518797,Staff,19,0,20,1
1713331490853,MMW 12R,A01,514034,Herbst; Matthew,15,0,16,1
1713331490853,MMW 12R,A02,514035,Herbst; Matthew,16,0,16,0
1713331491878,MMW 13R,A01,514037,Staff,12,0,16,4
1713331491878,MMW 13R,A02,514039,Staff,16,0,16,0
1713331493928,SIO 295LS,A00,523233,Staff,19,0,30,11
1713331494953,SIO 295S,A00,523232,Staff,19,0,30,11
1713331495984,SOCI 117,A01,494376,Staff,2,0,5,3
1713331497011,WES 237B,A00,494380,Staff,19,0,20,1
1713331499092,AESE 279B,A00,494370,Wade; Jon P,33,0,33,0
1713331500118,ANAR 135S,A00,494369,Braswell; Geoffrey E.,0,0,0,0
1713331501143,CAT 124RS,A01,519847,Geibel; William,17,0,20,3
1713331502170,CAT 125RS,A01,515971,Geibel; William,17,0,20,3
1713331503196,CLRE 250,A00,511389,Morris; Sheldon,9996,0,9999,3
1713331504228,CLRE 251,A00,507176,Mehta; Ravindra L.,9996,0,9999,3
1713331504228,CLRE 251,B00,511410,Mehta; Ravindra L.,9998,0,9999,1
1713331505256,CLRE 252,A00,507189,Cuomo; Raphael Eduardo,9998,0,9999,1
1713331506286,CLRE 253,A00,507199,Vaida; Florin,9997,0,9999,2
1713331506286,CLRE 253,B00,507202,Vaida; Florin,9999,0,9999,0
1713331507316,CLRE 259,A00,507211,Patel; Hemal,9996,0,9999,3
1713331508341,CLRE 260,A00,507221,Cuomo; Raphael Eduardo,9999,0,9999,0
1713331509366,CLRE 297,001,507242,Cuomo; Raphael Eduardo,9999,0,9999,0
1713331510391,CSE 191,A00,516875,Minnes Kemp; Mor Mia,9999,0,9999,0
1713331511416,CSS 201S,A01,494383,Staff,35,0,35,0
1713331512446,CSS 202S,A01,494387,Staff,35,0,35,0
1713331513471,EAP 100,A00,516065,Staff,9792,0,9999,207
1713331514499,ECE 45,A01,507414,Staff,51,0,60,9
1713331515526,ECE 100,A01,507416,Baghdadchi; Saharnaz,10,0,20,10
1713331515526,ECE 100,A02,507418,Baghdadchi; Saharnaz,20,0,20,0
1713331516549,ECE 111,A01,507420,Staff,38,0,50,12
1713331517576,ECE 197,001,548057,Sievenpiper; Daniel F.,9998,0,9999,1
1713331518603,EDS 115,A00,507243,Choi; Bailey Miyeon,28,0,28,0
1713331519630,EDS 117,A01,494379,Staff,23,0,25,2
1713331520657,EDS 125,A00,507246,Hopkins; Megan Beth,29,0,30,1
1713331521683,EDS 128A,A01,507264,Fargason; Sharon Gayle,26,0,26,0
1713331522712,EDS 128B,A01,507293,Pappas; Elizabeth,30,0,30,0
1713331523737,EDS 139,A00,507294,Fargason; Sharon Gayle,30,0,30,0
1713331523737,EDS 139,B00,507313,Pappas; Elizabeth,30,0,30,0
1713331524761,EDS 201,A00,507315,Staff,26,0,30,4
1713331525787,EDS 203,A01,507317,Halter; Christopher P.,26,0,30,4
1713331526816,EDS 204R,A01,507319,Halter; Christopher P.,3,0,30,27
1713331526816,EDS 204R,B01,507331,Heinzman; Erica M.,28,0,30,2
1713331527842,EDS 206R,A00,507332,Staff,4,0,30,26
1713331527842,EDS 206R,B00,507343,Staff,28,0,30,2
1713331528867,EDS 250,A00,507344,Hemans; Patricia Ann Benitez,36,0,40,4
1713331529892,EDS 281,A00,507345,Daly; Alan J.,18,0,18,0
1713331530917,EDS 284,A00,507350,Daly; Alan J.,16,0,16,0
1713331531943,EDS 286,A00,507359,Fine; Sarah,18,0,18,0
1713331532968,EDS 289C,A01,507361,Daly; Alan J.,18,0,18,0
1713331533994,EDS 290,A00,507366,Hofstetter; Carolyn,15,0,15,0
1713331535026,LIGM 5A,A00,507421,Fischer-Grunski; Eva K,20,0,20,0
1713331536054,LIGM 5B,A00,507423,Fischer-Grunski; Eva K,20,0,20,0
1713331537079,LIGM 5C,A00,507425,Fischer-Grunski; Eva K,20,0,20,0
1713331538107,LIIT 5AS,A00,507427,Carnelos; Chiara,20,0,20,0
1713331539137,LIIT 5BS,A00,507430,Carnelos; Chiara,20,0,20,0
1713331540164,LIIT 5CS,A00,507432,Carnelos; Chiara,20,0,20,0
1713331541189,LISP 5A,A00,507541,Munoz Sanchez; Alicia,17,0,20,3
1713331542214,LISP 5B,A00,507671,Munoz Sanchez; Alicia,15,0,20,5
1713331543242,LISP 5C,A00,507696,Munoz Sanchez; Alicia,15,0,20,5
1713331544268,MAE 197,001,528363,Boechler; Nicholas Sebastia,9998,0,9999,1
1713331545295,MATH 197,001,523477,Kedlaya; Kiran S.,9999,0,9999,0
1713331545295,MATH 197,002,563811,Zhang; Danna,9999,0,9999,0
1713331546320,MCWP 40R,A00,518780,Staff,20,0,20,0
1713331546320,MCWP 40R,B00,518781,Staff,19,0,20,1
1713331546320,MCWP 40R,C00,518783,Staff,19,0,20,1
1713331547346,MCWP 50R,A00,518791,Staff,20,0,20,0
1713331547346,MCWP 50R,B00,518792,Staff,17,0,20,3
1713331547346,MCWP 50R,C00,518793,Staff,19,0,20,1
1713331547346,MCWP 50R,D00,518794,Staff,16,0,20,4
1713331547346,MCWP 50R,E00,518795,Staff,16,0,20,4
1713331547346,MCWP 50R,F00,518796,Staff,19,0,20,1
1713331547346,MCWP 50R,G00,518797,Staff,19,0,20,1
1713331548371,MMW 12R,A01,514034,Herbst; Matthew,15,0,16,1
1713331548371,MMW 12R,A02,514035,Herbst; Matthew,16,0,16,0
1713331549397,MMW 13R,A01,514037,Staff,12,0,16,4
1713331549397,MMW 13R,A02,514039,Staff,16,0,16,0
1713331551450,SIO 295LS,A00,523233,Staff,19,0,30,11
1713331552479,SIO 295S,A00,523232,Staff,19,0,30,11
1713331553504,SOCI 117,A01,494376,Staff,2,0,5,3
1713331554529,WES 237B,A00,494380,Staff,19,0,20,1
1713331556605,AESE 279B,A00,494370,Wade; Jon P,33,0,33,0
1713331557633,ANAR 135S,A00,494369,Braswell; Geoffrey E.,0,0,0,0
1713331558659,CAT 124RS,A01,519847,Geibel; William,17,0,20,3
1713331559683,CAT 125RS,A01,515971,Geibel; William,17,0,20,3
1713331560709,CLRE 250,A00,511389,Morris; Sheldon,9996,0,9999,3
1713331561737,CLRE 251,A00,507176,Mehta; Ravindra L.,9996,0,9999,3
1713331561737,CLRE 251,B00,511410,Mehta; Ravindra L.,9998,0,9999,1
1713331562767,CLRE 252,A00,507189,Cuomo; Raphael Eduardo,9998,0,9999,1
1713331563793,CLRE 253,A00,507199,Vaida; Florin,9997,0,9999,2
1713331563793,CLRE 253,B00,507202,Vaida; Florin,9999,0,9999,0
1713331564818,CLRE 259,A00,507211,Patel; Hemal,9996,0,9999,3
1713331565843,CLRE 260,A00,507221,Cuomo; Raphael Eduardo,9999,0,9999,0
1713331566871,CLRE 297,001,507242,Cuomo; Raphael Eduardo,9999,0,9999,0
1713331567897,CSE 191,A00,516875,Minnes Kemp; Mor Mia,9999,0,9999,0
1713331568922,CSS 201S,A01,494383,Staff,35,0,35,0
1713331569950,CSS 202S,A01,494387,Staff,35,0,35,0
1713331570975,EAP 100,A00,516065,Staff,9792,0,9999,207
1713331572000,ECE 45,A01,507414,Staff,51,0,60,9
1713331573027,ECE 100,A01,507416,Baghdadchi; Saharnaz,10,0,20,10
1713331573027,ECE 100,A02,507418,Baghdadchi; Saharnaz,20,0,20,0
1713331574056,ECE 111,A01,507420,Staff,38,0,50,12
1713331575081,ECE 197,001,548057,Sievenpiper; Daniel F.,9998,0,9999,1
1713331576107,EDS 115,A00,507243,Choi; Bailey Miyeon,28,0,28,0
1713331577132,EDS 117,A01,494379,Staff,23,0,25,2
1713331578160,EDS 125,A00,507246,Hopkins; Megan Beth,29,0,30,1
1713331579190,EDS 128A,A01,507264,Fargason; Sharon Gayle,26,0,26,0
1713331580293,EDS 128B,A01,507293,Pappas; Elizabeth,30,0,30,0
1713331581320,EDS 139,A00,507294,Fargason; Sharon Gayle,30,0,30,0
1713331581320,EDS 139,B00,507313,Pappas; Elizabeth,30,0,30,0
1713331582347,EDS 201,A00,507315,Staff,26,0,30,4
1713331583375,EDS 203,A01,507317,Halter; Christopher P.,26,0,30,4
1713331584405,EDS 204R,A01,507319,Halter; Christopher P.,3,0,30,27
1713331584405,EDS 204R,B01,507331,Heinzman; Erica M.,28,0,30,2
1713331585430,EDS 206R,A00,507332,Staff,4,0,30,26
1713331585430,EDS 206R,B00,507343,Staff,28,0,30,2
1713331586457,EDS 250,A00,507344,Hemans; Patricia Ann Benitez,36,0,40,4
1713331587483,EDS 281,A00,507345,Daly; Alan J.,18,0,18,0
1713331588507,EDS 284,A00,507350,Daly; Alan J.,16,0,16,0
1713331589533,EDS 286,A00,507359,Fine; Sarah,18,0,18,0
1713331590562,EDS 289C,A01,507361,Daly; Alan J.,18,0,18,0
1713331591587,EDS 290,A00,507366,Hofstetter; Carolyn,15,0,15,0
1713331592616,LIGM 5A,A00,507421,Fischer-Grunski; Eva K,20,0,20,0
1713331593642,LIGM 5B,A00,507423,Fischer-Grunski; Eva K,20,0,20,0
1713331594668,LIGM 5C,A00,507425,Fischer-Grunski; Eva K,20,0,20,0
1713331595699,LIIT 5AS,A00,507427,Carnelos; Chiara,20,0,20,0
1713331596729,LIIT 5BS,A00,507430,Carnelos; Chiara,20,0,20,0
1713331597754,LIIT 5CS,A00,507432,Carnelos; Chiara,20,0,20,0
1713331598780,LISP 5A,A00,507541,Munoz Sanchez; Alicia,17,0,20,3
1713331599805,LISP 5B,A00,507671,Munoz Sanchez; Alicia,15,0,20,5
1713331600831,LISP 5C,A00,507696,Munoz Sanchez; Alicia,15,0,20,5
1713331601856,MAE 197,001,528363,Boechler; Nicholas Sebastia,9998,0,9999,1
1713331602885,MATH 197,001,523477,Kedlaya; Kiran S.,9999,0,9999,0
1713331602885,MATH 197,002,563811,Zhang; Danna,9999,0,9999,0
1713331603909,MCWP 40R,A00,518780,Staff,20,0,20,0
1713331603909,MCWP 40R,B00,518781,Staff,19,0,20,1
1713331603909,MCWP 40R,C00,518783,Staff,19,0,20,1
1713331604938,MCWP 50R,A00,518791,Staff,20,0,20,0
1713331604938,MCWP 50R,B00,518792,Staff,17,0,20,3
1713331604938,MCWP 50R,C00,518793,Staff,19,0,20,1
1713331604938,MCWP 50R,D00,518794,Staff,16,0,20,4
1713331604938,MCWP 50R,E00,518795,Staff,16,0,20,4
1713331604938,MCWP 50R,F00,518796,Staff,19,0,20,1
1713331604938,MCWP 50R,G00,518797,Staff,19,0,20,1
1713331605963,MMW 12R,A01,514034,Herbst; Matthew,15,0,16,1
1713331605963,MMW 12R,A02,514035,Herbst; Matthew,16,0,16,0
1713331606987,MMW 13R,A01,514037,Staff,12,0,16,4
1713331606987,MMW 13R,A02,514039,Staff,16,0,16,0
1713331609040,SIO 295LS,A00,523233,Staff,19,0,30,11
1713331610065,SIO 295S,A00,523232,Staff,19,0,30,11
1713331611095,SOCI 117,A01,494376,Staff,2,0,5,3
1713331612121,WES 237B,A00,494380,Staff,19,0,20,1
1713331614190,AESE 279B,A00,494370,Wade; Jon P,33,0,33,0
1713331615215,ANAR 135S,A00,494369,Braswell; Geoffrey E.,0,0,0,0
1713331616241,CAT 124RS,A01,519847,Geibel; William,17,0,20,3
1713331617265,CAT 125RS,A01,515971,Geibel; William,17,0,20,3
1713331618291,CLRE 250,A00,511389,Morris; Sheldon,9996,0,9999,3
1713331619319,CLRE 251,A00,507176,Mehta; Ravindra L.,9996,0,9999,3
1713331619319,CLRE 251,B00,511410,Mehta; Ravindra L.,9998,0,9999,1
1713331620346,CLRE 252,A00,507189,Cuomo; Raphael Eduardo,9998,0,9999,1
1713331621376,CLRE 253,A00,507199,Vaida; Florin,9997,0,9999,2
1713331621376,CLRE 253,B00,507202,Vaida; Florin,9999,0,9999,0
1713331622403,CLRE 259,A00,507211,Patel; Hemal,9996,0,9999,3
1713331623427,CLRE 260,A00,507221,Cuomo; Raphael Eduardo,9999,0,9999,0
1713331624451,CLRE 297,001,507242,Cuomo; Raphael Eduardo,9999,0,9999,0
1713331625483,CSE 191,A00,516875,Minnes Kemp; Mor Mia,9999,0,9999,0
1713331626508,CSS 201S,A01,494383,Staff,35,0,35,0
1713331627538,CSS 202S,A01,494387,Staff,35,0,35,0
1713331628563,EAP 100,A00,516065,Staff,9792,0,9999,207
1713331629593,ECE 45,A01,507414,Staff,51,0,60,9
1713331630623,ECE 100,A01,507416,Baghdadchi; Saharnaz,10,0,20,10
1713331630623,ECE 100,A02,507418,Baghdadchi; Saharnaz,20,0,20,0
1713331631650,ECE 111,A01,507420,Staff,38,0,50,12
1713331632682,ECE 197,001,548057,Sievenpiper; Daniel F.,9998,0,9999,1
1713331633709,EDS 115,A00,507243,Choi; Bailey Miyeon,28,0,28,0
1713331634737,EDS 117,A01,494379,Staff,23,0,25,2
1713331635762,EDS 125,A00,507246,Hopkins; Megan Beth,29,0,30,1
1713331636788,EDS 128A,A01,507264,Fargason; Sharon Gayle,26,0,26,0
1713331637817,EDS 128B,A01,507293,Pappas; Elizabeth,30,0,30,0
1713331638843,EDS 139,A00,507294,Fargason; Sharon Gayle,30,0,30,0
1713331638843,EDS 139,B00,507313,Pappas; Elizabeth,30,0,30,0
1713331639868,EDS 201,A00,507315,Staff,26,0,30,4
1713331640894,EDS 203,A01,507317,Halter; Christopher P.,26,0,30,4
1713331641922,EDS 204R,A01,507319,Halter; Christopher P.,3,0,30,27
1713331641922,EDS 204R,B01,507331,Heinzman; Erica M.,28,0,30,2
1713331642946,EDS 206R,A00,507332,Staff,4,0,30,26
1713331642946,EDS 206R,B00,507343,Staff,28,0,30,2
1713331643974,EDS 250,A00,507344,Hemans; Patricia Ann Benitez,36,0,40,4
1713331644999,EDS 281,A00,507345,Daly; Alan J.,18,0,18,0
1713331646025,EDS 284,A00,507350,Daly; Alan J.,16,0,16,0
1713331647052,EDS 286,A00,507359,Fine; Sarah,18,0,18,0
1713331648078,EDS 289C,A01,507361,Daly; Alan J.,18,0,18,0
1713331649103,EDS 290,A00,507366,Hofstetter; Carolyn,15,0,15,0
1713331650157,LIGM 5A,A00,507421,Fischer-Grunski; Eva K,20,0,20,0
1713331651185,LIGM 5B,A00,507423,Fischer-Grunski; Eva K,20,0,20,0
1713331652230,LIGM 5C,A00,507425,Fischer-Grunski; Eva K,20,0,20,0
1713331653256,LIIT 5AS,A00,507427,Carnelos; Chiara,20,0,20,0
1713331654279,LIIT 5BS,A00,507430,Carnelos; Chiara,20,0,20,0
1713331655305,LIIT 5CS,A00,507432,Carnelos; Chiara,20,0,20,0
1713331656336,LISP 5A,A00,507541,Munoz Sanchez; Alicia,17,0,20,3
1713331657362,LISP 5B,A00,507671,Munoz Sanchez; Alicia,15,0,20,5
1713331658387,LISP 5C,A00,507696,Munoz Sanchez; Alicia,15,0,20,5
1713331659410,MAE 197,001,528363,Boechler; Nicholas Sebastia,9998,0,9999,1
1713331660441,MATH 197,001,523477,Kedlaya; Kiran S.,9999,0,9999,0
1713331660441,MATH 197,002,563811,Zhang; Danna,9999,0,9999,0
1713331661471,MCWP 40R,A00,518780,Staff,20,0,20,0
1713331661471,MCWP 40R,B00,518781,Staff,19,0,20,1
1713331661471,MCWP 40R,C00,518783,Staff,19,0,20,1
1713331662498,MCWP 50R,A00,518791,Staff,20,0,20,0
1713331662498,MCWP 50R,B00,518792,Staff,17,0,20,3
1713331662498,MCWP 50R,C00,518793,Staff,19,0,20,1
1713331662498,MCWP 50R,D00,518794,Staff,16,0,20,4
1713331662498,MCWP 50R,E00,518795,Staff,16,0,20,4
1713331662498,MCWP 50R,F00,518796,Staff,19,0,20,1
1713331662498,MCWP 50R,G00,518797,Staff,19,0,20,1
1713331663524,MMW 12R,A01,514034,Herbst; Matthew,15,0,16,1
1713331663524,MMW 12R,A02,514035,Herbst; Matthew,16,0,16,0
1713331664549,MMW 13R,A01,514037,Staff,12,0,16,4
1713331664549,MMW 13R,A02,514039,Staff,16,0,16,0
1713331666607,SIO 295LS,A00,523233,Staff,19,0,30,11
1713331667636,SIO 295S,A00,523232,Staff,19,0,30,11
1713331668662,SOCI 117,A01,494376,Staff,2,0,5,3
1713331669688,WES 237B,A00,494380,Staff,19,0,20,1
1713331671763,AESE 279B,A00,494370,Wade; Jon P,33,0,33,0
1713331672788,ANAR 135S,A00,494369,Braswell; Geoffrey E.,0,0,0,0
1713331673814,CAT 124RS,A01,519847,Geibel; William,17,0,20,3
1713331674841,CAT 125RS,A01,515971,Geibel; William,17,0,20,3
1713331675871,CLRE 250,A00,511389,Morris; Sheldon,9996,0,9999,3
1713331676898,CLRE 251,A00,507176,Mehta; Ravindra L.,9996,0,9999,3
1713331676898,CLRE 251,B00,511410,Mehta; Ravindra L.,9998,0,9999,1
1713331677922,CLRE 252,A00,507189,Cuomo; Raphael Eduardo,9998,0,9999,1
1713331678951,CLRE 253,A00,507199,Vaida; Florin,9997,0,9999,2
1713331678951,CLRE 253,B00,507202,Vaida; Florin,9999,0,9999,0
1713331679977,CLRE 259,A00,507211,Patel; Hemal,9996,0,9999,3
1713331681001,CLRE 260,A00,507221,Cuomo; Raphael Eduardo,9999,0,9999,0
1713331682043,CLRE 297,001,507242,Cuomo; Raphael Eduardo,9999,0,9999,0
1713331683073,CSE 191,A00,516875,Minnes Kemp; Mor Mia,9999,0,9999,0
1713331684155,CSS 201S,A01,494383,Staff,35,0,35,0
1713331685186,CSS 202S,A01,494387,Staff,35,0,35,0
1713331686211,EAP 100,A00,516065,Staff,9792,0,9999,207
1713331687239,ECE 45,A01,507414,Staff,51,0,60,9
1713331688265,ECE 100,A01,507416,Baghdadchi; Saharnaz,10,0,20,10
1713331688265,ECE 100,A02,507418,Baghdadchi; Saharnaz,20,0,20,0
1713331689295,ECE 111,A01,507420,Staff,38,0,50,12
1713331690325,ECE 197,001,548057,Sievenpiper; Daniel F.,9998,0,9999,1
1713331691350,EDS 115,A00,507243,Choi; Bailey Miyeon,28,0,28,0
1713331692379,EDS 117,A01,494379,Staff,23,0,25,2
1713331693411,EDS 125,A00,507246,Hopkins; Megan Beth,29,0,30,1
1713331694437,EDS 128A,A01,507264,Fargason; Sharon Gayle,26,0,26,0
1713331695461,EDS 128B,A01,507293,Pappas; Elizabeth,30,0,30,0
1713331696487,EDS 139,A00,507294,Fargason; Sharon Gayle,30,0,30,0
1713331696487,EDS 139,B00,507313,Pappas; Elizabeth,30,0,30,0
1713331697516,EDS 201,A00,507315,Staff,26,0,30,4
1713331698549,EDS 203,A01,507317,Halter; Christopher P.,26,0,30,4
1713331699579,EDS 204R,A01,507319,Halter; Christopher P.,3,0,30,27
1713331699579,EDS 204R,B01,507331,Heinzman; Erica M.,28,0,30,2
1713331700606,EDS 206R,A00,507332,Staff,4,0,30,26
1713331700606,EDS 206R,B00,507343,Staff,28,0,30,2
1713331701636,EDS 250,A00,507344,Hemans; Patricia Ann Benitez,36,0,40,4
1713331702665,EDS 281,A00,507345,Daly; Alan J.,18,0,18,0
1713331703693,EDS 284,A00,507350,Daly; Alan J.,16,0,16,0
1713331704721,EDS 286,A00,507359,Fine; Sarah,18,0,18,0
1713331705748,EDS 289C,A01,507361,Daly; Alan J.,18,0,18,0
1713331706774,EDS 290,A00,507366,Hofstetter; Carolyn,15,0,15,0
1713331707803,LIGM 5A,A00,507421,Fischer-Grunski; Eva K,20,0,20,0
1713331708828,LIGM 5B,A00,507423,Fischer-Grunski; Eva K,20,0,20,0
1713331709854,LIGM 5C,A00,507425,Fischer-Grunski; Eva K,20,0,20,0
1713331710881,LIIT 5AS,A00,507427,Carnelos; Chiara,20,0,20,0
1713331711907,LIIT 5BS,A00,507430,Carnelos; Chiara,20,0,20,0
1713331712937,LIIT 5CS,A00,507432,Carnelos; Chiara,20,0,20,0
1713331713964,LISP 5A,A00,507541,Munoz Sanchez; Alicia,17,0,20,3
1713331714995,LISP 5B,A00,507671,Munoz Sanchez; Alicia,15,0,20,5
1713331716021,LISP 5C,A00,507696,Munoz Sanchez; Alicia,15,0,20,5
1713331717046,MAE 197,001,528363,Boechler; Nicholas Sebastia,9998,0,9999,1
1713331718075,MATH 197,001,523477,Kedlaya; Kiran S.,9999,0,9999,0
1713331718075,MATH 197,002,563811,Zhang; Danna,9999,0,9999,0
1713331719103,MCWP 40R,A00,518780,Staff,20,0,20,0
1713331719103,MCWP 40R,B00,518781,Staff,19,0,20,1
1713331719103,MCWP 40R,C00,518783,Staff,19,0,20,1
1713331720132,MCWP 50R,A00,518791,Staff,20,0,20,0
1713331720132,MCWP 50R,B00,518792,Staff,17,0,20,3
1713331720132,MCWP 50R,C00,518793,Staff,19,0,20,1
1713331720132,MCWP 50R,D00,518794,Staff,16,0,20,4
1713331720132,MCWP 50R,E00,518795,Staff,16,0,20,4
1713331720132,MCWP 50R,F00,518796,Staff,19,0,20,1
1713331720132,MCWP 50R,G00,518797,Staff,19,0,20,1
1713331721160,MMW 12R,A01,514034,Herbst; Matthew,15,0,16,1
1713331721160,MMW 12R,A02,514035,Herbst; Matthew,16,0,16,0
1713331722184,MMW 13R,A01,514037,Staff,12,0,16,4
1713331722184,MMW 13R,A02,514039,Staff,16,0,16,0
1713331724233,SIO 295LS,A00,523233,Staff,19,0,30,11
1713331725262,SIO 295S,A00,523232,Staff,19,0,30,11
1713331726288,SOCI 117,A01,494376,Staff,2,0,5,3
1713331727317,WES 237B,A00,494380,Staff,19,0,20,1
1713331729383,AESE 279B,A00,494370,Wade; Jon P,33,0,33,0
1713331730414,ANAR 135S,A00,494369,Braswell; Geoffrey E.,0,0,0,0
1713331731441,CAT 124RS,A01,519847,Geibel; William,17,0,20,3
1713331732469,CAT 125RS,A01,515971,Geibel; William,17,0,20,3
1713331733496,CLRE 250,A00,511389,Morris; Sheldon,9996,0,9999,3
1713331734522,CLRE 251,A00,507176,Mehta; Ravindra L.,9996,0,9999,3
1713331734522,CLRE 251,B00,511410,Mehta; Ravindra L.,9998,0,9999,1
1713331735548,CLRE 252,A00,507189,Cuomo; Raphael Eduardo,9998,0,9999,1
1713331736574,CLRE 253,A00,507199,Vaida; Florin,9997,0,9999,2
1713331736574,CLRE 253,B00,507202,Vaida; Florin,9999,0,9999,0
1713331737601,CLRE 259,A00,507211,Patel; Hemal,9996,0,9999,3
1713331738629,CLRE 260,A00,507221,Cuomo; Raphael Eduardo,9999,0,9999,0
1713331739656,CLRE 297,001,507242,Cuomo; Raphael Eduardo,9999,0,9999,0
1713331740683,CSE 191,A00,516875,Minnes Kemp; Mor Mia,9999,0,9999,0
1713331741707,CSS 201S,A01,494383,Staff,35,0,35,0
1713331742733,CSS 202S,A01,494387,Staff,35,0,35,0
1713331743756,EAP 100,A00,516065,Staff,9792,0,9999,207
1713331744781,ECE 45,A01,507414,Staff,51,0,60,9
1713331745806,ECE 100,A01,507416,Baghdadchi; Saharnaz,10,0,20,10
1713331745806,ECE 100,A02,507418,Baghdadchi; Saharnaz,20,0,20,0
1713331746830,ECE 111,A01,507420,Staff,38,0,50,12
1713331747856,ECE 197,001,548057,Sievenpiper; Daniel F.,9998,0,9999,1
1713331748883,EDS 115,A00,507243,Choi; Bailey Miyeon,28,0,28,0
1713331749909,EDS 117,A01,494379,Staff,23,0,25,2
1713331750939,EDS 125,A00,507246,Hopkins; Megan Beth,29,0,30,1
1713331751964,EDS 128A,A01,507264,Fargason; Sharon Gayle,26,0,26,0
1713331752990,EDS 128B,A01,507293,Pappas; Elizabeth,30,0,30,0
1713331754015,EDS 139,A00,507294,Fargason; Sharon Gayle,30,0,30,0
1713331754015,EDS 139,B00,507313,Pappas; Elizabeth,30,0,30,0
1713331755041,EDS 201,A00,507315,Staff,26,0,30,4
1713331756066,EDS 203,A01,507317,Halter; Christopher P.,26,0,30,4
1713331757092,EDS 204R,A01,507319,Halter; Christopher P.,3,0,30,27
1713331757092,EDS 204R,B01,507331,Heinzman; Erica M.,28,0,30,2
1713331758118,EDS 206R,A00,507332,Staff,4,0,30,26
1713331758118,EDS 206R,B00,507343,Staff,28,0,30,2
1713331759144,EDS 250,A00,507344,Hemans; Patricia Ann Benitez,36,0,40,4
1713331760173,EDS 281,A00,507345,Daly; Alan J.,18,0,18,0
1713331761200,EDS 284,A00,507350,Daly; Alan J.,16,0,16,0
1713331762226,EDS 286,A00,507359,Fine; Sarah,18,0,18,0
1713331763255,EDS 289C,A01,507361,Daly; Alan J.,18,0,18,0
1713331764280,EDS 290,A00,507366,Hofstetter; Carolyn,15,0,15,0
1713331765307,LIGM 5A,A00,507421,Fischer-Grunski; Eva K,20,0,20,0
1713331766335,LIGM 5B,A00,507423,Fischer-Grunski; Eva K,20,0,20,0
1713331767360,LIGM 5C,A00,507425,Fischer-Grunski; Eva K,20,0,20,0
1713331768386,LIIT 5AS,A00,507427,Carnelos; Chiara,20,0,20,0
1713331769411,LIIT 5BS,A00,507430,Carnelos; Chiara,20,0,20,0
1713331770436,LIIT 5CS,A00,507432,Carnelos; Chiara,20,0,20,0
1713331771462,LISP 5A,A00,507541,Munoz Sanchez; Alicia,17,0,20,3
1713331772488,LISP 5B,A00,507671,Munoz Sanchez; Alicia,15,0,20,5
1713331773516,LISP 5C,A00,507696,Munoz Sanchez; Alicia,15,0,20,5
1713331774542,MAE 197,001,528363,Boechler; Nicholas Sebastia,9998,0,9999,1
1713331775571,MATH 197,001,523477,Kedlaya; Kiran S.,9999,0,9999,0
1713331775571,MATH 197,002,563811,Zhang; Danna,9999,0,9999,0
1713331776596,MCWP 40R,A00,518780,Staff,20,0,20,0
1713331776596,MCWP 40R,B00,518781,Staff,19,0,20,1
1713331776596,MCWP 40R,C00,518783,Staff,19,0,20,1
1713331777622,MCWP 50R,A00,518791,Staff,20,0,20,0
1713331777622,MCWP 50R,B00,518792,Staff,17,0,20,3
1713331777622,MCWP 50R,C00,518793,Staff,19,0,20,1
1713331777622,MCWP 50R,D00,518794,Staff,16,0,20,4
1713331777622,MCWP 50R,E00,518795,Staff,16,0,20,4
1713331777622,MCWP 50R,F00,518796,Staff,19,0,20,1
1713331777622,MCWP 50R,G00,518797,Staff,19,0,20,1
1713331778645,MMW 12R,A01,514034,Herbst; Matthew,15,0,16,1
1713331778645,MMW 12R,A02,514035,Herbst; Matthew,16,0,16,0
1713331779673,MMW 13R,A01,514037,Staff,12,0,16,4
1713331779673,MMW 13R,A02,514039,Staff,16,0,16,0
1713331781732,SIO 295LS,A00,523233,Staff,19,0,30,11
1713331782760,SIO 295S,A00,523232,Staff,19,0,30,11
1713331783786,SOCI 117,A01,494376,Staff,2,0,5,3
1713331784814,WES 237B,A00,494380,Staff,19,0,20,1
1713331786888,AESE 279B,A00,494370,Wade; Jon P,33,0,33,0
1713331787968,ANAR 135S,A00,494369,Braswell; Geoffrey E.,0,0,0,0
1713331788998,CAT 124RS,A01,519847,Geibel; William,17,0,20,3
1713331790026,CAT 125RS,A01,515971,Geibel; William,17,0,20,3
1713331791050,CLRE 250,A00,511389,Morris; Sheldon,9996,0,9999,3
1713331792076,CLRE 251,A00,507176,Mehta; Ravindra L.,9996,0,9999,3
1713331792076,CLRE 251,B00,511410,Mehta; Ravindra L.,9998,0,9999,1
1713331793101,CLRE 252,A00,507189,Cuomo; Raphael Eduardo,9998,0,9999,1
1713331794127,CLRE 253,A00,507199,Vaida; Florin,9997,0,9999,2
1713331794127,CLRE 253,B00,507202,Vaida; Florin,9999,0,9999,0
1713331795157,CLRE 259,A00,507211,Patel; Hemal,9996,0,9999,3
1713331796183,CLRE 260,A00,507221,Cuomo; Raphael Eduardo,9999,0,9999,0
1713331797211,CLRE 297,001,507242,Cuomo; Raphael Eduardo,9999,0,9999,0
1713331798302,CSE 191,A00,516875,Minnes Kemp; Mor Mia,9999,0,9999,0
1713331799331,CSS 201S,A01,494383,Staff,35,0,35,0
1713331800356,CSS 202S,A01,494387,Staff,35,0,35,0
1713331801383,EAP 100,A00,516065,Staff,9792,0,9999,207
1713331802409,ECE 45,A01,507414,Staff,51,0,60,9
1713331803434,ECE 100,A01,507416,Baghdadchi; Saharnaz,10,0,20,10
1713331803434,ECE 100,A02,507418,Baghdadchi; Saharnaz,20,0,20,0
1713331804461,ECE 111,A01,507420,Staff,38,0,50,12
1713331805493,ECE 197,001,548057,Sievenpiper; Daniel F.,9998,0,9999,1
1713331806522,EDS 115,A00,507243,Choi; Bailey Miyeon,28,0,28,0
1713331807552,EDS 117,A01,494379,Staff,23,0,25,2
1713331808581,EDS 125,A00,507246,Hopkins; Megan Beth,29,0,30,1
1713331809612,EDS 128A,A01,507264,Fargason; Sharon Gayle,26,0,26,0
1713331810638,EDS 128B,A01,507293,Pappas; Elizabeth,30,0,30,0
1713331811664,EDS 139,A00,507294,Fargason; Sharon Gayle,30,0,30,0
1713331811664,EDS 139,B00,507313,Pappas; Elizabeth,30,0,30,0
1713331812693,EDS 201,A00,507315,Staff,26,0,30,4
1713331813720,EDS 203,A01,507317,Halter; Christopher P.,26,0,30,4
1713331814747,EDS 204R,A01,507319,Halter; Christopher P.,3,0,30,27
1713331814747,EDS 204R,B01,507331,Heinzman; Erica M.,28,0,30,2
1713331815772,EDS 206R,A00,507332,Staff,4,0,30,26
1713331815772,EDS 206R,B00,507343,Staff,28,0,30,2
1713331816800,EDS 250,A00,507344,Hemans; Patricia Ann Benitez,36,0,40,4
1713331817825,EDS 281,A00,507345,Daly; Alan J.,18,0,18,0
1713331818854,EDS 284,A00,507350,Daly; Alan J.,16,0,16,0
1713331819880,EDS 286,A00,507359,Fine; Sarah,18,0,18,0
1713331820907,EDS 289C,A01,507361,Daly; Alan J.,18,0,18,0
1713331821938,EDS 290,A00,507366,Hofstetter; Carolyn,15,0,15,0
1713331822965,LIGM 5A,A00,507421,Fischer-Grunski; Eva K,20,0,20,0
1713331823990,LIGM 5B,A00,507423,Fischer-Grunski; Eva K,20,0,20,0
1713331825017,LIGM 5C,A00,507425,Fischer-Grunski; Eva K,20,0,20,0
1713331826044,LIIT 5AS,A00,507427,Carnelos; Chiara,20,0,20,0
1713331827070,LIIT 5BS,A00,507430,Carnelos; Chiara,20,0,20,0
1713331828095,LIIT 5CS,A00,507432,Carnelos; Chiara,20,0,20,0
1713331829122,LISP 5A,A00,507541,Munoz Sanchez; Alicia,17,0,20,3
1713331830147,LISP 5B,A00,507671,Munoz Sanchez; Alicia,15,0,20,5
1713331831176,LISP 5C,A00,507696,Munoz Sanchez; Alicia,15,0,20,5
1713331832202,MAE 197,001,528363,Boechler; Nicholas Sebastia,9998,0,9999,1
1713331833229,MATH 197,001,523477,Kedlaya; Kiran S.,9999,0,9999,0
1713331833229,MATH 197,002,563811,Zhang; Danna,9999,0,9999,0
1713331834261,MCWP 40R,A00,518780,Staff,20,0,20,0
1713331834261,MCWP 40R,B00,518781,Staff,19,0,20,1
1713331834261,MCWP 40R,C00,518783,Staff,19,0,20,1
1713331835288,MCWP 50R,A00,518791,Staff,20,0,20,0
1713331835288,MCWP 50R,B00,518792,Staff,17,0,20,3
1713331835288,MCWP 50R,C00,518793,Staff,19,0,20,1
1713331835288,MCWP 50R,D00,518794,Staff,16,0,20,4
1713331835288,MCWP 50R,E00,518795,Staff,16,0,20,4
1713331835288,MCWP 50R,F00,518796,Staff,19,0,20,1
1713331835288,MCWP 50R,G00,518797,Staff,19,0,20,1
1713331836317,MMW 12R,A01,514034,Herbst; Matthew,15,0,16,1
1713331836317,MMW 12R,A02,514035,Herbst; Matthew,16,0,16,0
1713331837344,MMW 13R,A01,514037,Staff,12,0,16,4
1713331837344,MMW 13R,A02,514039,Staff,16,0,16,0
1713331839399,SIO 295LS,A00,523233,Staff,19,0,30,11
1713331840424,SIO 295S,A00,523232,Staff,19,0,30,11
1713331841455,SOCI 117,A01,494376,Staff,2,0,5,3
1713331842479,WES 237B,A00,494380,Staff,19,0,20,1
1713331844546,AESE 279B,A00,494370,Wade; Jon P,33,0,33,0
1713331845572,ANAR 135S,A00,494369,Braswell; Geoffrey E.,0,0,0,0
1713331846598,CAT 124RS,A01,519847,Geibel; William,17,0,20,3
1713331847623,CAT 125RS,A01,515971,Geibel; William,17,0,20,3
1713331848650,CLRE 250,A00,511389,Morris; Sheldon,9996,0,9999,3
1713331849677,CLRE 251,A00,507176,Mehta; Ravindra L.,9996,0,9999,3
1713331849677,CLRE 251,B00,511410,Mehta; Ravindra L.,9998,0,9999,1
1713331850703,CLRE 252,A00,507189,Cuomo; Raphael Eduardo,9998,0,9999,1
1713331851728,CLRE 253,A00,507199,Vaida; Florin,9997,0,9999,2
1713331851728,CLRE 253,B00,507202,Vaida; Florin,9999,0,9999,0
1713331852757,CLRE 259,A00,507211,Patel; Hemal,9996,0,9999,3
1713331853781,CLRE 260,A00,507221,Cuomo; Raphael Eduardo,9999,0,9999,0
1713331854806,CLRE 297,001,507242,Cuomo; Raphael Eduardo,9999,0,9999,0
1713331855832,CSE 191,A00,516875,Minnes Kemp; Mor Mia,9999,0,9999,0
1713331856861,CSS 201S,A01,494383,Staff,35,0,35,0
1713331857888,CSS 202S,A01,494387,Staff,35,0,35,0
1713331858915,EAP 100,A00,516065,Staff,9792,0,9999,207
1713331859943,ECE 45,A01,507414,Staff,51,0,60,9
1713331860970,ECE 100,A01,507416,Baghdadchi; Saharnaz,10,0,20,10
1713331860970,ECE 100,A02,507418,Baghdadchi; Saharnaz,20,0,20,0
1713331861998,ECE 111,A01,507420,Staff,38,0,50,12
1713331863030,ECE 197,001,548057,Sievenpiper; Daniel F.,9998,0,9999,1
1713331864057,EDS 115,A00,507243,Choi; Bailey Miyeon,28,0,28,0
1713331865083,EDS 117,A01,494379,Staff,23,0,25,2
1713331866109,EDS 125,A00,507246,Hopkins; Megan Beth,29,0,30,1
1713331867138,EDS 128A,A01,507264,Fargason; Sharon Gayle,26,0,26,0
1713331868164,EDS 128B,A01,507293,Pappas; Elizabeth,30,0,30,0
1713331869188,EDS 139,A00,507294,Fargason; Sharon Gayle,30,0,30,0
1713331869188,EDS 139,B00,507313,Pappas; Elizabeth,30,0,30,0
1713331870217,EDS 201,A00,507315,Staff,26,0,30,4
1713331871244,EDS 203,A01,507317,Halter; Christopher P.,26,0,30,4
1713331872269,EDS 204R,A01,507319,Halter; Christopher P.,3,0,30,27
1713331872269,EDS 204R,B01,507331,Heinzman; Erica M.,28,0,30,2
1713331873295,EDS 206R,A00,507332,Staff,4,0,30,26
1713331873295,EDS 206R,B00,507343,Staff,28,0,30,2
1713331874325,EDS 250,A00,507344,Hemans; Patricia Ann Benitez,36,0,40,4
1713331875355,EDS 281,A00,507345,Daly; Alan J.,18,0,18,0
1713331876380,EDS 284,A00,507350,Daly; Alan J.,16,0,16,0
1713331877409,EDS 286,A00,507359,Fine; Sarah,18,0,18,0
1713331878467,EDS 289C,A01,507361,Daly; Alan J.,18,0,18,0
1713331879496,EDS 290,A00,507366,Hofstetter; Carolyn,15,0,15,0
1713331880526,LIGM 5A,A00,507421,Fischer-Grunski; Eva K,20,0,20,0
1713331881554,LIGM 5B,A00,507423,Fischer-Grunski; Eva K,20,0,20,0
1713331882581,LIGM 5C,A00,507425,Fischer-Grunski; Eva K,20,0,20,0
1713331883611,LIIT 5AS,A00,507427,Carnelos; Chiara,20,0,20,0
1713331884636,LIIT 5BS,A00,507430,Carnelos; Chiara,20,0,20,0
1713331885665,LIIT 5CS,A00,507432,Carnelos; Chiara,20,0,20,0
1713331886691,LISP 5A,A00,507541,Munoz Sanchez; Alicia,17,0,20,3
1713331887719,LISP 5B,A00,507671,Munoz Sanchez; Alicia,15,0,20,5
1713331888744,LISP 5C,A00,507696,Munoz Sanchez; Alicia,15,0,20,5
1713331889770,MAE 197,001,528363,Boechler; Nicholas Sebastia,9998,0,9999,1
1713331890796,MATH 197,001,523477,Kedlaya; Kiran S.,9999,0,9999,0
1713331890796,MATH 197,002,563811,Zhang; Danna,9999,0,9999,0
1713331891876,MCWP 40R,A00,518780,Staff,20,0,20,0
1713331891876,MCWP 40R,B00,518781,Staff,19,0,20,1
1713331891876,MCWP 40R,C00,518783,Staff,19,0,20,1
1713331892902,MCWP 50R,A00,518791,Staff,20,0,20,0
1713331892902,MCWP 50R,B00,518792,Staff,17,0,20,3
1713331892902,MCWP 50R,C00,518793,Staff,19,0,20,1
1713331892902,MCWP 50R,D00,518794,Staff,16,0,20,4
1713331892902,MCWP 50R,E00,518795,Staff,16,0,20,4
1713331892902,MCWP 50R,F00,518796,Staff,19,0,20,1
1713331892902,MCWP 50R,G00,518797,Staff,19,0,20,1
1713331893929,MMW 12R,A01,514034,Herbst; Matthew,15,0,16,1
1713331893929,MMW 12R,A02,514035,Herbst; Matthew,16,0,16,0
1713331894955,MMW 13R,A01,514037,Staff,12,0,16,4
1713331894955,MMW 13R,A02,514039,Staff,16,0,16,0
1713331897006,SIO 295LS,A00,523233,Staff,19,0,30,11
1713331898031,SIO 295S,A00,523232,Staff,19,0,30,11
1713331899058,SOCI 117,A01,494376,Staff,2,0,5,3
1713331900083,WES 237B,A00,494380,Staff,19,0,20,1
1713331902154,AESE 279B,A00,494370,Wade; Jon P,33,0,33,0
1713331903177,ANAR 135S,A00,494369,Braswell; Geoffrey E.,0,0,0,0
1713331904203,CAT 124RS,A01,519847,Geibel; William,17,0,20,3
1713331905231,CAT 125RS,A01,515971,Geibel; William,17,0,20,3
1713331906260,CLRE 250,A00,511389,Morris; Sheldon,9996,0,9999,3
1713331907288,CLRE 251,A00,507176,Mehta; Ravindra L.,9996,0,9999,3
1713331907288,CLRE 251,B00,511410,Mehta; Ravindra L.,9998,0,9999,1
1713331908311,CLRE 252,A00,507189,Cuomo; Raphael Eduardo,9998,0,9999,1
1713331909340,CLRE 253,A00,507199,Vaida; Florin,9997,0,9999,2
1713331909340,CLRE 253,B00,507202,Vaida; Florin,9999,0,9999,0
1713331910364,CLRE 259,A00,507211,Patel; Hemal,9996,0,9999,3
1713331911388,CLRE 260,A00,507221,Cuomo; Raphael Eduardo,9999,0,9999,0
1713331912411,CLRE 297,001,507242,Cuomo; Raphael Eduardo,9999,0,9999,0
1713331913437,CSE 191,A00,516875,Minnes Kemp; Mor Mia,9999,0,9999,0
1713331914467,CSS 201S,A01,494383,Staff,35,0,35,0
1713331915494,CSS 202S,A01,494387,Staff,35,0,35,0
1713331916517,EAP 100,A00,516065,Staff,9792,0,9999,207
1713331917546,ECE 45,A01,507414,Staff,51,0,60,9
1713331918571,ECE 100,A01,507416,Baghdadchi; Saharnaz,10,0,20,10
1713331918571,ECE 100,A02,507418,Baghdadchi; Saharnaz,20,0,20,0
1713331919600,ECE 111,A01,507420,Staff,38,0,50,12
1713331920629,ECE 197,001,548057,Sievenpiper; Daniel F.,9998,0,9999,1
1713331921656,EDS 115,A00,507243,Choi; Bailey Miyeon,28,0,28,0
1713331922680,EDS 117,A01,494379,Staff,23,0,25,2
1713331923713,EDS 125,A00,507246,Hopkins; Megan Beth,29,0,30,1
1713331924738,EDS 128A,A01,507264,Fargason; Sharon Gayle,26,0,26,0
1713331925765,EDS 128B,A01,507293,Pappas; Elizabeth,30,0,30,0
1713331926796,EDS 139,A00,507294,Fargason; Sharon Gayle,30,0,30,0
1713331926796,EDS 139,B00,507313,Pappas; Elizabeth,30,0,30,0
1713331927825,EDS 201,A00,507315,Staff,26,0,30,4
1713331928856,EDS 203,A01,507317,Halter; Christopher P.,26,0,30,4
1713331929887,EDS 204R,A01,507319,Halter; Christopher P.,3,0,30,27
1713331929887,EDS 204R,B01,507331,Heinzman; Erica M.,28,0,30,2
1713331930915,EDS 206R,A00,507332,Staff,4,0,30,26
1713331930915,EDS 206R,B00,507343,Staff,28,0,30,2
1713331931940,EDS 250,A00,507344,Hemans; Patricia Ann Benitez,36,0,40,4
1713331932968,EDS 281,A00,507345,Daly; Alan J.,18,0,18,0
1713331933992,EDS 284,A00,507350,Daly; Alan J.,16,0,16,0
1713331935020,EDS 286,A00,507359,Fine; Sarah,18,0,18,0
1713331936045,EDS 289C,A01,507361,Daly; Alan J.,18,0,18,0
1713331937072,EDS 290,A00,507366,Hofstetter; Carolyn,15,0,15,0
1713331938099,LIGM 5A,A00,507421,Fischer-Grunski; Eva K,20,0,20,0
1713331939124,LIGM 5B,A00,507423,Fischer-Grunski; Eva K,20,0,20,0
1713331940152,LIGM 5C,A00,507425,Fischer-Grunski; Eva K,20,0,20,0
1713331941176,LIIT 5AS,A00,507427,Carnelos; Chiara,20,0,20,0
1713331942202,LIIT 5BS,A00,507430,Carnelos; Chiara,20,0,20,0
1713331943227,LIIT 5CS,A00,507432,Carnelos; Chiara,20,0,20,0
1713331944253,LISP 5A,A00,507541,Munoz Sanchez; Alicia,17,0,20,3
1713331945281,LISP 5B,A00,507671,Munoz Sanchez; Alicia,15,0,20,5
1713331946311,LISP 5C,A00,507696,Munoz Sanchez; Alicia,15,0,20,5
1713331947336,MAE 197,001,528363,Boechler; Nicholas Sebastia,9998,0,9999,1
1713331948364,MATH 197,001,523477,Kedlaya; Kiran S.,9999,0,9999,0
1713331948364,MATH 197,002,563811,Zhang; Danna,9999,0,9999,0
1713331949391,MCWP 40R,A00,518780,Staff,20,0,20,0
1713331949391,MCWP 40R,B00,518781,Staff,19,0,20,1
1713331949391,MCWP 40R,C00,518783,Staff,19,0,20,1
1713331950417,MCWP 50R,A00,518791,Staff,20,0,20,0
1713331950417,MCWP 50R,B00,518792,Staff,17,0,20,3
1713331950417,MCWP 50R,C00,518793,Staff,19,0,20,1
1713331950417,MCWP 50R,D00,518794,Staff,16,0,20,4
1713331950417,MCWP 50R,E00,518795,Staff,16,0,20,4
1713331950417,MCWP 50R,F00,518796,Staff,19,0,20,1
1713331950417,MCWP 50R,G00,518797,Staff,19,0,20,1
1713331951443,MMW 12R,A01,514034,Herbst; Matthew,15,0,16,1
1713331951443,MMW 12R,A02,514035,Herbst; Matthew,16,0,16,0
1713331952471,MMW 13R,A01,514037,Staff,12,0,16,4
1713331952471,MMW 13R,A02,514039,Staff,16,0,16,0
1713331954526,SIO 295LS,A00,523233,Staff,19,0,30,11
1713331955554,SIO 295S,A00,523232,Staff,19,0,30,11
1713331956584,SOCI 117,A01,494376,Staff,2,0,5,3
1713331957610,WES 237B,A00,494380,Staff,19,0,20,1
1713331959678,AESE 279B,A00,494370,Wade; Jon P,33,0,33,0
1713331960703,ANAR 135S,A00,494369,Braswell; Geoffrey E.,0,0,0,0
1713331961734,CAT 124RS,A01,519847,Geibel; William,17,0,20,3
1713331962763,CAT 125RS,A01,515971,Geibel; William,17,0,20,3
1713331963789,CLRE 250,A00,511389,Morris; Sheldon,9996,0,9999,3
1713331964821,CLRE 251,A00,507176,Mehta; Ravindra L.,9996,0,9999,3
1713331964821,CLRE 251,B00,511410,Mehta; Ravindra L.,9998,0,9999,1
1713331965846,CLRE 252,A00,507189,Cuomo; Raphael Eduardo,9998,0,9999,1
1713331966875,CLRE 253,A00,507199,Vaida; Florin,9997,0,9999,2
1713331966875,CLRE 253,B00,507202,Vaida; Florin,9999,0,9999,0
1713331967905,CLRE 259,A00,507211,Patel; Hemal,9996,0,9999,3
1713331968932,CLRE 260,A00,507221,Cuomo; Raphael Eduardo,9999,0,9999,0
1713331969961,CLRE 297,001,507242,Cuomo; Raphael Eduardo,9999,0,9999,0
1713331970985,CSE 191,A00,516875,Minnes Kemp; Mor Mia,9999,0,9999,0
1713331972011,CSS 201S,A01,494383,Staff,35,0,35,0
1713331973041,CSS 202S,A01,494387,Staff,35,0,35,0
1713331974067,EAP 100,A00,516065,Staff,9792,0,9999,207
1713331975092,ECE 45,A01,507414,Staff,51,0,60,9
1713331976118,ECE 100,A01,507416,Baghdadchi; Saharnaz,10,0,20,10
1713331976118,ECE 100,A02,507418,Baghdadchi; Saharnaz,20,0,20,0
1713331977143,ECE 111,A01,507420,Staff,38,0,50,12
1713331978168,ECE 197,001,548057,Sievenpiper; Daniel F.,9998,0,9999,1
1713331979194,EDS 115,A00,507243,Choi; Bailey Miyeon,28,0,28,0
1713331980222,EDS 117,A01,494379,Staff,23,0,25,2
1713331981247,EDS 125,A00,507246,Hopkins; Megan Beth,29,0,30,1
1713331982277,EDS 128A,A01,507264,Fargason; Sharon Gayle,26,0,26,0
1713331983307,EDS 128B,A01,507293,Pappas; Elizabeth,30,0,30,0
1713331984333,EDS 139,A00,507294,Fargason; Sharon Gayle,30,0,30,0
1713331984333,EDS 139,B00,507313,Pappas; Elizabeth,30,0,30,0
1713331985363,EDS 201,A00,507315,Staff,26,0,30,4
1713331986387,EDS 203,A01,507317,Halter; Christopher P.,26,0,30,4
1713331987413,EDS 204R,A01,507319,Halter; Christopher P.,3,0,30,27
1713331987413,EDS 204R,B01,507331,Heinzman; Erica M.,28,0,30,2
1713331988440,EDS 206R,A00,507332,Staff,4,0,30,26
1713331988440,EDS 206R,B00,507343,Staff,28,0,30,2
1713331989467,EDS 250,A00,507344,Hemans; Patricia Ann Benitez,36,0,40,4
1713331990496,EDS 281,A00,507345,Daly; Alan J.,18,0,18,0
1713331991525,EDS 284,A00,507350,Daly; Alan J.,16,0,16,0
1713331992552,EDS 286,A00,507359,Fine; Sarah,18,0,18,0
1713331993576,EDS 289C,A01,507361,Daly; Alan J.,18,0,18,0
1713331994603,EDS 290,A00,507366,Hofstetter; Carolyn,15,0,15,0
1713331995684,LIGM 5A,A00,507421,Fischer-Grunski; Eva K,20,0,20,0
1713331996714,LIGM 5B,A00,507423,Fischer-Grunski; Eva K,20,0,20,0
1713331997740,LIGM 5C,A00,507425,Fischer-Grunski; Eva K,20,0,20,0
1713331998770,LIIT 5AS,A00,507427,Carnelos; Chiara,20,0,20,0
1713331999796,LIIT 5BS,A00,507430,Carnelos; Chiara,20,0,20,0
1713332000820,LIIT 5CS,A00,507432,Carnelos; Chiara,20,0,20,0
1713332001850,LISP 5A,A00,507541,Munoz Sanchez; Alicia,17,0,20,3
1713332002881,LISP 5B,A00,507671,Munoz Sanchez; Alicia,15,0,20,5
1713332003907,LISP 5C,A00,507696,Munoz Sanchez; Alicia,15,0,20,5
1713332004933,MAE 197,001,528363,Boechler; Nicholas Sebastia,9998,0,9999,1
1713332005964,MATH 197,001,523477,Kedlaya; Kiran S.,9999,0,9999,0
1713332005964,MATH 197,002,563811,Zhang; Danna,9999,0,9999,0
1713332006991,MCWP 40R,A00,518780,Staff,20,0,20,0
1713332006991,MCWP 40R,B00,518781,Staff,19,0,20,1
1713332006991,MCWP 40R,C00,518783,Staff,19,0,20,1
1713332008016,MCWP 50R,A00,518791,Staff,20,0,20,0
1713332008016,MCWP 50R,B00,518792,Staff,17,0,20,3
1713332008016,MCWP 50R,C00,518793,Staff,19,0,20,1
1713332008016,MCWP 50R,D00,518794,Staff,16,0,20,4
1713332008016,MCWP 50R,E00,518795,Staff,16,0,20,4
1713332008016,MCWP 50R,F00,518796,Staff,19,0,20,1
1713332008016,MCWP 50R,G00,518797,Staff,19,0,20,1
1713332009040,MMW 12R,A01,514034,Herbst; Matthew,15,0,16,1
1713332009040,MMW 12R,A02,514035,Herbst; Matthew,16,0,16,0
1713332010066,MMW 13R,A01,514037,Staff,12,0,16,4
1713332010066,MMW 13R,A02,514039,Staff,16,0,16,0
1713332012122,SIO 295LS,A00,523233,Staff,19,0,30,11
1713332013151,SIO 295S,A00,523232,Staff,19,0,30,11
1713332014180,SOCI 117,A01,494376,Staff,2,0,5,3
1713332015208,WES 237B,A00,494380,Staff,19,0,20,1
1713332017270,AESE 279B,A00,494370,Wade; Jon P,33,0,33,0
1713332018296,ANAR 135S,A00,494369,Braswell; Geoffrey E.,0,0,0,0
1713332019321,CAT 124RS,A01,519847,Geibel; William,17,0,20,3
1713332020350,CAT 125RS,A01,515971,Geibel; William,17,0,20,3
1713332021377,CLRE 250,A00,511389,Morris; Sheldon,9996,0,9999,3
1713332022405,CLRE 251,A00,507176,Mehta; Ravindra L.,9996,0,9999,3
1713332022405,CLRE 251,B00,511410,Mehta; Ravindra L.,9998,0,9999,1
1713332023430,CLRE 252,A00,507189,Cuomo; Raphael Eduardo,9998,0,9999,1
1713332024455,CLRE 253,A00,507199,Vaida; Florin,9997,0,9999,2
1713332024455,CLRE 253,B00,507202,Vaida; Florin,9999,0,9999,0
1713332025480,CLRE 259,A00,507211,Patel; Hemal,9996,0,9999,3
1713332026508,CLRE 260,A00,507221,Cuomo; Raphael Eduardo,9999,0,9999,0
1713332027537,CLRE 297,001,507242,Cuomo; Raphael Eduardo,9999,0,9999,0
1713332028565,CSE 191,A00,516875,Minnes Kemp; Mor Mia,9999,0,9999,0
1713332029589,CSS 201S,A01,494383,Staff,35,0,35,0
1713332030614,CSS 202S,A01,494387,Staff,35,0,35,0
1713332031640,EAP 100,A00,516065,Staff,9792,0,9999,207
1713332032670,ECE 45,A01,507414,Staff,51,0,60,9
1713332033696,ECE 100,A01,507416,Baghdadchi; Saharnaz,10,0,20,10
1713332033696,ECE 100,A02,507418,Baghdadchi; Saharnaz,20,0,20,0
1713332034726,ECE 111,A01,507420,Staff,38,0,50,12
1713332035757,ECE 197,001,548057,Sievenpiper; Daniel F.,9998,0,9999,1
1713332036785,EDS 115,A00,507243,Choi; Bailey Miyeon,28,0,28,0
1713332037811,EDS 117,A01,494379,Staff,23,0,25,2
1713332038836,EDS 125,A00,507246,Hopkins; Megan Beth,29,0,30,1
1713332039864,EDS 128A,A01,507264,Fargason; Sharon Gayle,26,0,26,0
1713332040891,EDS 128B,A01,507293,Pappas; Elizabeth,30,0,30,0
1713332041919,EDS 139,A00,507294,Fargason; Sharon Gayle,30,0,30,0
1713332041919,EDS 139,B00,507313,Pappas; Elizabeth,30,0,30,0
1713332042946,EDS 201,A00,507315,Staff,26,0,30,4
1713332043971,EDS 203,A01,507317,Halter; Christopher P.,26,0,30,4
1713332044994,EDS 204R,A01,507319,Halter; Christopher P.,3,0,30,27
1713332044994,EDS 204R,B01,507331,Heinzman; Erica M.,28,0,30,2
1713332046017,EDS 206R,A00,507332,Staff,4,0,30,26
1713332046017,EDS 206R,B00,507343,Staff,28,0,30,2
1713332047047,EDS 250,A00,507344,Hemans; Patricia Ann Benitez,36,0,40,4
1713332048072,EDS 281,A00,507345,Daly; Alan J.,18,0,18,0
1713332049099,EDS 284,A00,507350,Daly; Alan J.,16,0,16,0
1713332050123,EDS 286,A00,507359,Fine; Sarah,18,0,18,0
1713332051149,EDS 289C,A01,507361,Daly; Alan J.,18,0,18,0
1713332052175,EDS 290,A00,507366,Hofstetter; Carolyn,15,0,15,0
1713332053201,LIGM 5A,A00,507421,Fischer-Grunski; Eva K,20,0,20,0
1713332054229,LIGM 5B,A00,507423,Fischer-Grunski; Eva K,20,0,20,0
1713332055253,LIGM 5C,A00,507425,Fischer-Grunski; Eva K,20,0,20,0
1713332056283,LIIT 5AS,A00,507427,Carnelos; Chiara,20,0,20,0
1713332057312,LIIT 5BS,A00,507430,Carnelos; Chiara,20,0,20,0
1713332058340,LIIT 5CS,A00,507432,Carnelos; Chiara,20,0,20,0
1713332059370,LISP 5A,A00,507541,Munoz Sanchez; Alicia,17,0,20,3
1713332060399,LISP 5B,A00,507671,Munoz Sanchez; Alicia,15,0,20,5
1713332061427,LISP 5C,A00,507696,Munoz Sanchez; Alicia,15,0,20,5
1713332062455,MAE 197,001,528363,Boechler; Nicholas Sebastia,9998,0,9999,1
1713332063482,MATH 197,001,523477,Kedlaya; Kiran S.,9999,0,9999,0
1713332063482,MATH 197,002,563811,Zhang; Danna,9999,0,9999,0
1713332064509,MCWP 40R,A00,518780,Staff,20,0,20,0
1713332064509,MCWP 40R,B00,518781,Staff,19,0,20,1
1713332064509,MCWP 40R,C00,518783,Staff,19,0,20,1
1713332065540,MCWP 50R,A00,518791,Staff,20,0,20,0
1713332065540,MCWP 50R,B00,518792,Staff,17,0,20,3
1713332065540,MCWP 50R,C00,518793,Staff,19,0,20,1
1713332065540,MCWP 50R,D00,518794,Staff,16,0,20,4
1713332065540,MCWP 50R,E00,518795,Staff,16,0,20,4
1713332065540,MCWP 50R,F00,518796,Staff,19,0,20,1
1713332065540,MCWP 50R,G00,518797,Staff,19,0,20,1
1713332066565,MMW 12R,A01,514034,Herbst; Matthew,15,0,16,1
1713332066565,MMW 12R,A02,514035,Herbst; Matthew,16,0,16,0
1713332067590,MMW 13R,A01,514037,Staff,12,0,16,4
1713332067590,MMW 13R,A02,514039,Staff,16,0,16,0
1713332069645,SIO 295LS,A00,523233,Staff,19,0,30,11
1713332070670,SIO 295S,A00,523232,Staff,19,0,30,11
1713332071700,SOCI 117,A01,494376,Staff,2,0,5,3
1713332072730,WES 237B,A00,494380,Staff,19,0,20,1
1713332074795,AESE 279B,A00,494370,Wade; Jon P,33,0,33,0
1713332075823,ANAR 135S,A00,494369,Braswell; Geoffrey E.,0,0,0,0
1713332076850,CAT 124RS,A01,519847,Geibel; William,17,0,20,3
1713332077875,CAT 125RS,A01,515971,Geibel; William,17,0,20,3
1713332078903,CLRE 250,A00,511389,Morris; Sheldon,9996,0,9999,3
1713332079930,CLRE 251,A00,507176,Mehta; Ravindra L.,9996,0,9999,3
1713332079930,CLRE 251,B00,511410,Mehta; Ravindra L.,9998,0,9999,1
1713332080956,CLRE 252,A00,507189,Cuomo; Raphael Eduardo,9998,0,9999,1
1713332081981,CLRE 253,A00,507199,Vaida; Florin,9997,0,9999,2
1713332081981,CLRE 253,B00,507202,Vaida; Florin,9999,0,9999,0
1713332083007,CLRE 259,A00,507211,Patel; Hemal,9996,0,9999,3
1713332084033,CLRE 260,A00,507221,Cuomo; Raphael Eduardo,9999,0,9999,0
1713332085059,CLRE 297,001,507242,Cuomo; Raphael Eduardo,9999,0,9999,0
1713332086087,CSE 191,A00,516875,Minnes Kemp; Mor Mia,9999,0,9999,0
1713332087116,CSS 201S,A01,494383,Staff,35,0,35,0
1713332088142,CSS 202S,A01,494387,Staff,35,0,35,0
1713332089166,EAP 100,A00,516065,Staff,9792,0,9999,207
1713332090193,ECE 45,A01,507414,Staff,51,0,60,9
1713332091219,ECE 100,A01,507416,Baghdadchi; Saharnaz,10,0,20,10
1713332091219,ECE 100,A02,507418,Baghdadchi; Saharnaz,20,0,20,0
1713332092249,ECE 111,A01,507420,Staff,38,0,50,12
1713332093280,ECE 197,001,548057,Sievenpiper; Daniel F.,9998,0,9999,1
1713332094306,EDS 115,A00,507243,Choi; Bailey Miyeon,28,0,28,0
1713332095337,EDS 117,A01,494379,Staff,23,0,25,2
1713332096363,EDS 125,A00,507246,Hopkins; Megan Beth,29,0,30,1
1713332097387,EDS 128A,A01,507264,Fargason; Sharon Gayle,26,0,26,0
1713332098413,EDS 128B,A01,507293,Pappas; Elizabeth,30,0,30,0
1713332099495,EDS 139,A00,507294,Fargason; Sharon Gayle,30,0,30,0
1713332099495,EDS 139,B00,507313,Pappas; Elizabeth,30,0,30,0
1713332100522,EDS 201,A00,507315,Staff,26,0,30,4
1713332101547,EDS 203,A01,507317,Halter; Christopher P.,26,0,30,4
1713332102572,EDS 204R,A01,507319,Halter; Christopher P.,3,0,30,27
1713332102572,EDS 204R,B01,507331,Heinzman; Erica M.,28,0,30,2
1713332103597,EDS 206R,A00,507332,Staff,4,0,30,26
1713332103597,EDS 206R,B00,507343,Staff,28,0,30,2
1713332104627,EDS 250,A00,507344,Hemans; Patricia Ann Benitez,36,0,40,4
1713332105656,EDS 281,A00,507345,Daly; Alan J.,18,0,18,0
1713332106684,EDS 284,A00,507350,Daly; Alan J.,16,0,16,0
1713332107710,EDS 286,A00,507359,Fine; Sarah,18,0,18,0
1713332108736,EDS 289C,A01,507361,Daly; Alan J.,18,0,18,0
1713332109765,EDS 290,A00,507366,Hofstetter; Carolyn,15,0,15,0
1713332110796,LIGM 5A,A00,507421,Fischer-Grunski; Eva K,20,0,20,0
1713332111825,LIGM 5B,A00,507423,Fischer-Grunski; Eva K,20,0,20,0
1713332112850,LIGM 5C,A00,507425,Fischer-Grunski; Eva K,20,0,20,0
1713332113880,LIIT 5AS,A00,507427,Carnelos; Chiara,20,0,20,0
1713332114911,LIIT 5BS,A00,507430,Carnelos; Chiara,20,0,20,0
1713332115939,LIIT 5CS,A00,507432,Carnelos; Chiara,20,0,20,0
1713332117015,LISP 5A,A00,507541,Munoz Sanchez; Alicia,17,0,20,3
1713332118040,LISP 5B,A00,507671,Munoz Sanchez; Alicia,15,0,20,5
1713332119070,LISP 5C,A00,507696,Munoz Sanchez; Alicia,15,0,20,5
1713332120097,MAE 197,001,528363,Boechler; Nicholas Sebastia,9998,0,9999,1
1713332121125,MATH 197,001,523477,Kedlaya; Kiran S.,9999,0,9999,0
1713332121125,MATH 197,002,563811,Zhang; Danna,9999,0,9999,0
1713332122153,MCWP 40R,A00,518780,Staff,20,0,20,0
1713332122153,MCWP 40R,B00,518781,Staff,19,0,20,1
1713332122153,MCWP 40R,C00,518783,Staff,19,0,20,1
1713332123182,MCWP 50R,A00,518791,Staff,20,0,20,0
1713332123182,MCWP 50R,B00,518792,Staff,17,0,20,3
1713332123182,MCWP 50R,C00,518793,Staff,19,0,20,1
1713332123182,MCWP 50R,D00,518794,Staff,16,0,20,4
1713332123182,MCWP 50R,E00,518795,Staff,16,0,20,4
1713332123182,MCWP 50R,F00,518796,Staff,19,0,20,1
1713332123182,MCWP 50R,G00,518797,Staff,19,0,20,1
1713332124211,MMW 12R,A01,514034,Herbst; Matthew,15,0,16,1
1713332124211,MMW 12R,A02,514035,Herbst; Matthew,16,0,16,0
1713332125235,MMW 13R,A01,514037,Staff,12,0,16,4
1713332125235,MMW 13R,A02,514039,Staff,16,0,16,0
1713332127287,SIO 295LS,A00,523233,Staff,19,0,30,11
1713332128313,SIO 295S,A00,523232,Staff,19,0,30,11
1713332129342,SOCI 117,A01,494376,Staff,2,0,5,3
1713332130368,WES 237B,A00,494380,Staff,19,0,20,1
1713332132437,AESE 279B,A00,494370,Wade; Jon P,33,0,33,0
1713332133465,ANAR 135S,A00,494369,Braswell; Geoffrey E.,0,0,0,0
1713332134491,CAT 124RS,A01,519847,Geibel; William,17,0,20,3
1713332135516,CAT 125RS,A01,515971,Geibel; William,17,0,20,3
1713332136541,CLRE 250,A00,511389,Morris; Sheldon,9996,0,9999,3
1713332137567,CLRE 251,A00,507176,Mehta; Ravindra L.,9996,0,9999,3
1713332137567,CLRE 251,B00,511410,Mehta; Ravindra L.,9998,0,9999,1
1713332138595,CLRE 252,A00,507189,Cuomo; Raphael Eduardo,9998,0,9999,1
1713332139620,CLRE 253,A00,507199,Vaida; Florin,9997,0,9999,2
1713332139620,CLRE 253,B00,507202,Vaida; Florin,9999,0,9999,0
1713332140649,CLRE 259,A00,507211,Patel; Hemal,9996,0,9999,3
1713332141676,CLRE 260,A00,507221,Cuomo; Raphael Eduardo,9999,0,9999,0
1713332142701,CLRE 297,001,507242,Cuomo; Raphael Eduardo,9999,0,9999,0
1713332143726,CSE 191,A00,516875,Minnes Kemp; Mor Mia,9999,0,9999,0
1713332144751,CSS 201S,A01,494383,Staff,35,0,35,0
1713332145778,CSS 202S,A01,494387,Staff,35,0,35,0
1713332146802,EAP 100,A00,516065,Staff,9792,0,9999,207
1713332147828,ECE 45,A01,507414,Staff,51,0,60,9
1713332148854,ECE 100,A01,507416,Baghdadchi; Saharnaz,10,0,20,10
1713332148854,ECE 100,A02,507418,Baghdadchi; Saharnaz,20,0,20,0
1713332149882,ECE 111,A01,507420,Staff,38,0,50,12
1713332150908,ECE 197,001,548057,Sievenpiper; Daniel F.,9998,0,9999,1
1713332152493,EDS 115,A00,507243,Choi; Bailey Miyeon,28,0,28,0
1713332153522,EDS 117,A01,494379,Staff,23,0,25,2
1713332154551,EDS 125,A00,507246,Hopkins; Megan Beth,29,0,30,1
1713332155576,EDS 128A,A01,507264,Fargason; Sharon Gayle,26,0,26,0
1713332156601,EDS 128B,A01,507293,Pappas; Elizabeth,30,0,30,0
1713332157631,EDS 139,A00,507294,Fargason; Sharon Gayle,30,0,30,0
1713332157631,EDS 139,B00,507313,Pappas; Elizabeth,30,0,30,0
1713332158656,EDS 201,A00,507315,Staff,26,0,30,4
1713332159681,EDS 203,A01,507317,Halter; Christopher P.,26,0,30,4
1713332160711,EDS 204R,A01,507319,Halter; Christopher P.,3,0,30,27
1713332160711,EDS 204R,B01,507331,Heinzman; Erica M.,28,0,30,2
1713332161735,EDS 206R,A00,507332,Staff,4,0,30,26
1713332161735,EDS 206R,B00,507343,Staff,28,0,30,2
1713332162760,EDS 250,A00,507344,Hemans; Patricia Ann Benitez,36,0,40,4
1713332163789,EDS 281,A00,507345,Daly; Alan J.,18,0,18,0
1713332164816,EDS 284,A00,507350,Daly; Alan J.,16,0,16,0
1713332165846,EDS 286,A00,507359,Fine; Sarah,18,0,18,0
1713332166876,EDS 289C,A01,507361,Daly; Alan J.,18,0,18,0
1713332167900,EDS 290,A00,507366,Hofstetter; Carolyn,15,0,15,0
1713332169000,LIGM 5A,A00,507421,Fischer-Grunski; Eva K,20,0,20,0
1713332170025,LIGM 5B,A00,507423,Fischer-Grunski; Eva K,20,0,20,0
1713332171054,LIGM 5C,A00,507425,Fischer-Grunski; Eva K,20,0,20,0
1713332172083,LIIT 5AS,A00,507427,Carnelos; Chiara,20,0,20,0
1713332173108,LIIT 5BS,A00,507430,Carnelos; Chiara,20,0,20,0
1713332174133,LIIT 5CS,A00,507432,Carnelos; Chiara,20,0,20,0
1713332175159,LISP 5A,A00,507541,Munoz Sanchez; Alicia,17,0,20,3
1713332176190,LISP 5B,A00,507671,Munoz Sanchez; Alicia,15,0,20,5
1713332177218,LISP 5C,A00,507696,Munoz Sanchez; Alicia,15,0,20,5
1713332178243,MAE 197,001,528363,Boechler; Nicholas Sebastia,9998,0,9999,1
1713332179274,MATH 197,001,523477,Kedlaya; Kiran S.,9999,0,9999,0
1713332179274,MATH 197,002,563811,Zhang; Danna,9999,0,9999,0
1713332180300,MCWP 40R,A00,518780,Staff,20,0,20,0
1713332180300,MCWP 40R,B00,518781,Staff,19,0,20,1
1713332180300,MCWP 40R,C00,518783,Staff,19,0,20,1
1713332181330,MCWP 50R,A00,518791,Staff,20,0,20,0
1713332181330,MCWP 50R,B00,518792,Staff,17,0,20,3
1713332181330,MCWP 50R,C00,518793,Staff,19,0,20,1
1713332181330,MCWP 50R,D00,518794,Staff,16,0,20,4
1713332181330,MCWP 50R,E00,518795,Staff,16,0,20,4
1713332181330,MCWP 50R,F00,518796,Staff,19,0,20,1
1713332181330,MCWP 50R,G00,518797,Staff,19,0,20,1
1713332182357,MMW 12R,A01,514034,Herbst; Matthew,15,0,16,1
1713332182357,MMW 12R,A02,514035,Herbst; Matthew,16,0,16,0
1713332183383,MMW 13R,A01,514037,Staff,12,0,16,4
1713332183383,MMW 13R,A02,514039,Staff,16,0,16,0
1713332185440,SIO 295LS,A00,523233,Staff,19,0,30,11
1713332186464,SIO 295S,A00,523232,Staff,19,0,30,11
1713332187494,SOCI 117,A01,494376,Staff,2,0,5,3
1713332188520,WES 237B,A00,494380,Staff,19,0,20,1
1713332190602,AESE 279B,A00,494370,Wade; Jon P,33,0,33,0
1713332191632,ANAR 135S,A00,494369,Braswell; Geoffrey E.,0,0,0,0
1713332192663,CAT 124RS,A01,519847,Geibel; William,17,0,20,3
1713332193687,CAT 125RS,A01,515971,Geibel; William,17,0,20,3
1713332194713,CLRE 250,A00,511389,Morris; Sheldon,9996,0,9999,3
1713332195746,CLRE 251,A00,507176,Mehta; Ravindra L.,9996,0,9999,3
1713332195746,CLRE 251,B00,511410,Mehta; Ravindra L.,9998,0,9999,1
1713332196773,CLRE 252,A00,507189,Cuomo; Raphael Eduardo,9998,0,9999,1
1713332197802,CLRE 253,A00,507199,Vaida; Florin,9997,0,9999,2
1713332197802,CLRE 253,B00,507202,Vaida; Florin,9999,0,9999,0
1713332198826,CLRE 259,A00,507211,Patel; Hemal,9996,0,9999,3
1713332199849,CLRE 260,A00,507221,Cuomo; Raphael Eduardo,9999,0,9999,0
1713332200874,CLRE 297,001,507242,Cuomo; Raphael Eduardo,9999,0,9999,0
1713332201900,CSE 191,A00,516875,Minnes Kemp; Mor Mia,9999,0,9999,0
1713332202932,CSS 201S,A01,494383,Staff,35,0,35,0
1713332204053,CSS 202S,A01,494387,Staff,35,0,35,0
1713332205081,EAP 100,A00,516065,Staff,9792,0,9999,207
1713332206107,ECE 45,A01,507414,Staff,51,0,60,9
1713332207137,ECE 100,A01,507416,Baghdadchi; Saharnaz,10,0,20,10
1713332207137,ECE 100,A02,507418,Baghdadchi; Saharnaz,20,0,20,0
1713332208166,ECE 111,A01,507420,Staff,38,0,50,12
1713332209192,ECE 197,001,548057,Sievenpiper; Daniel F.,9998,0,9999,1
1713332210220,EDS 115,A00,507243,Choi; Bailey Miyeon,28,0,28,0
1713332211245,EDS 117,A01,494379,Staff,23,0,25,2
1713332212271,EDS 125,A00,507246,Hopkins; Megan Beth,29,0,30,1
1713332213299,EDS 128A,A01,507264,Fargason; Sharon Gayle,26,0,26,0
1713332214327,EDS 128B,A01,507293,Pappas; Elizabeth,30,0,30,0
1713332215355,EDS 139,A00,507294,Fargason; Sharon Gayle,30,0,30,0
1713332215355,EDS 139,B00,507313,Pappas; Elizabeth,30,0,30,0
1713332216379,EDS 201,A00,507315,Staff,26,0,30,4
1713332217407,EDS 203,A01,507317,Halter; Christopher P.,26,0,30,4
1713332218438,EDS 204R,A01,507319,Halter; Christopher P.,3,0,30,27
1713332218438,EDS 204R,B01,507331,Heinzman; Erica M.,28,0,30,2
1713332219462,EDS 206R,A00,507332,Staff,4,0,30,26
1713332219462,EDS 206R,B00,507343,Staff,28,0,30,2
1713332220487,EDS 250,A00,507344,Hemans; Patricia Ann Benitez,36,0,40,4
1713332221513,EDS 281,A00,507345,Daly; Alan J.,18,0,18,0
1713332222540,EDS 284,A00,507350,Daly; Alan J.,16,0,16,0
1713332223565,EDS 286,A00,507359,Fine; Sarah,18,0,18,0
1713332224590,EDS 289C,A01,507361,Daly; Alan J.,18,0,18,0
1713332225615,EDS 290,A00,507366,Hofstetter; Carolyn,15,0,15,0
1713332226647,LIGM 5A,A00,507421,Fischer-Grunski; Eva K,20,0,20,0
1713332227672,LIGM 5B,A00,507423,Fischer-Grunski; Eva K,20,0,20,0
1713332228700,LIGM 5C,A00,507425,Fischer-Grunski; Eva K,20,0,20,0
1713332229726,LIIT 5AS,A00,507427,Carnelos; Chiara,20,0,20,0
1713332230752,LIIT 5BS,A00,507430,Carnelos; Chiara,20,0,20,0
1713332231780,LIIT 5CS,A00,507432,Carnelos; Chiara,20,0,20,0
1713332232806,LISP 5A,A00,507541,Munoz Sanchez; Alicia,17,0,20,3
1713332233832,LISP 5B,A00,507671,Munoz Sanchez; Alicia,15,0,20,5
1713332234859,LISP 5C,A00,507696,Munoz Sanchez; Alicia,15,0,20,5
1713332235888,MAE 197,001,528363,Boechler; Nicholas Sebastia,9998,0,9999,1
1713332236916,MATH 197,001,523477,Kedlaya; Kiran S.,9999,0,9999,0
1713332236916,MATH 197,002,563811,Zhang; Danna,9999,0,9999,0
1713332237945,MCWP 40R,A00,518780,Staff,20,0,20,0
1713332237945,MCWP 40R,B00,518781,Staff,19,0,20,1
1713332237945,MCWP 40R,C00,518783,Staff,19,0,20,1
1713332238971,MCWP 50R,A00,518791,Staff,20,0,20,0
1713332238971,MCWP 50R,B00,518792,Staff,17,0,20,3
1713332238971,MCWP 50R,C00,518793,Staff,19,0,20,1
1713332238971,MCWP 50R,D00,518794,Staff,16,0,20,4
1713332238971,MCWP 50R,E00,518795,Staff,16,0,20,4
1713332238971,MCWP 50R,F00,518796,Staff,19,0,20,1
1713332238971,MCWP 50R,G00,518797,Staff,19,0,20,1
1713332240001,MMW 12R,A01,514034,Herbst; Matthew,15,0,16,1
1713332240001,MMW 12R,A02,514035,Herbst; Matthew,16,0,16,0
1713332241025,MMW 13R,A01,514037,Staff,12,0,16,4
1713332241025,MMW 13R,A02,514039,Staff,16,0,16,0
1713332243076,SIO 295LS,A00,523233,Staff,19,0,30,11
1713332244104,SIO 295S,A00,523232,Staff,19,0,30,11
1713332245133,SOCI 117,A01,494376,Staff,2,0,5,3
1713332246161,WES 237B,A00,494380,Staff,19,0,20,1
1713332248233,AESE 279B,A00,494370,Wade; Jon P,33,0,33,0
1713332249260,ANAR 135S,A00,494369,Braswell; Geoffrey E.,0,0,0,0
1713332250286,CAT 124RS,A01,519847,Geibel; William,17,0,20,3
1713332251311,CAT 125RS,A01,515971,Geibel; William,17,0,20,3
1713332252343,CLRE 250,A00,511389,Morris; Sheldon,9996,0,9999,3
1713332253374,CLRE 251,A00,507176,Mehta; Ravindra L.,9996,0,9999,3
1713332253374,CLRE 251,B00,511410,Mehta; Ravindra L.,9998,0,9999,1
1713332254401,CLRE 252,A00,507189,Cuomo; Raphael Eduardo,9998,0,9999,1
1713332255426,CLRE 253,A00,507199,Vaida; Florin,9997,0,9999,2
1713332255426,CLRE 253,B00,507202,Vaida; Florin,9999,0,9999,0
1713332256451,CLRE 259,A00,507211,Patel; Hemal,9996,0,9999,3
1713332257474,CLRE 260,A00,507221,Cuomo; Raphael Eduardo,9999,0,9999,0
1713332258502,CLRE 297,001,507242,Cuomo; Raphael Eduardo,9999,0,9999,0
1713332259529,CSE 191,A00,516875,Minnes Kemp; Mor Mia,9999,0,9999,0
1713332260558,CSS 201S,A01,494383,Staff,35,0,35,0
1713332261588,CSS 202S,A01,494387,Staff,35,0,35,0
1713332262613,EAP 100,A00,516065,Staff,9792,0,9999,207
1713332263638,ECE 45,A01,507414,Staff,51,0,60,9
1713332264667,ECE 100,A01,507416,Baghdadchi; Saharnaz,10,0,20,10
1713332264667,ECE 100,A02,507418,Baghdadchi; Saharnaz,20,0,20,0
1713332265695,ECE 111,A01,507420,Staff,38,0,50,12
1713332266722,ECE 197,001,548057,Sievenpiper; Daniel F.,9998,0,9999,1
1713332267752,EDS 115,A00,507243,Choi; Bailey Miyeon,28,0,28,0
1713332268778,EDS 117,A01,494379,Staff,23,0,25,2
1713332269807,EDS 125,A00,507246,Hopkins; Megan Beth,29,0,30,1
1713332270834,EDS 128A,A01,507264,Fargason; Sharon Gayle,26,0,26,0
1713332271860,EDS 128B,A01,507293,Pappas; Elizabeth,30,0,30,0
1713332272885,EDS 139,A00,507294,Fargason; Sharon Gayle,30,0,30,0
1713332272885,EDS 139,B00,507313,Pappas; Elizabeth,30,0,30,0
1713332273910,EDS 201,A00,507315,Staff,26,0,30,4
1713332274939,EDS 203,A01,507317,Halter; Christopher P.,26,0,30,4
1713332275968,EDS 204R,A01,507319,Halter; Christopher P.,3,0,30,27
1713332275968,EDS 204R,B01,507331,Heinzman; Erica M.,28,0,30,2
1713332276995,EDS 206R,A00,507332,Staff,4,0,30,26
1713332276995,EDS 206R,B00,507343,Staff,28,0,30,2
1713332278023,EDS 250,A00,507344,Hemans; Patricia Ann Benitez,36,0,40,4
1713332279049,EDS 281,A00,507345,Daly; Alan J.,18,0,18,0
1713332280075,EDS 284,A00,507350,Daly; Alan J.,16,0,16,0
1713332281105,EDS 286,A00,507359,Fine; Sarah,18,0,18,0
1713332282133,EDS 289C,A01,507361,Daly; Alan J.,18,0,18,0
1713332283159,EDS 290,A00,507366,Hofstetter; Carolyn,15,0,15,0
1713332284186,LIGM 5A,A00,507421,Fischer-Grunski; Eva K,20,0,20,0
1713332285215,LIGM 5B,A00,507423,Fischer-Grunski; Eva K,20,0,20,0
1713332286240,LIGM 5C,A00,507425,Fischer-Grunski; Eva K,20,0,20,0
1713332287266,LIIT 5AS,A00,507427,Carnelos; Chiara,20,0,20,0
1713332288291,LIIT 5BS,A00,507430,Carnelos; Chiara,20,0,20,0
1713332289315,LIIT 5CS,A00,507432,Carnelos; Chiara,20,0,20,0
1713332290345,LISP 5A,A00,507541,Munoz Sanchez; Alicia,17,0,20,3
1713332291374,LISP 5B,A00,507671,Munoz Sanchez; Alicia,15,0,20,5
1713332292404,LISP 5C,A00,507696,Munoz Sanchez; Alicia,15,0,20,5
1713332293433,MAE 197,001,528363,Boechler; Nicholas Sebastia,9998,0,9999,1
1713332294460,MATH 197,001,523477,Kedlaya; Kiran S.,9999,0,9999,0
1713332294460,MATH 197,002,563811,Zhang; Danna,9999,0,9999,0
1713332295487,MCWP 40R,A00,518780,Staff,20,0,20,0
1713332295487,MCWP 40R,B00,518781,Staff,19,0,20,1
1713332295487,MCWP 40R,C00,518783,Staff,19,0,20,1
1713332296516,MCWP 50R,A00,518791,Staff,20,0,20,0
1713332296516,MCWP 50R,B00,518792,Staff,17,0,20,3
1713332296516,MCWP 50R,C00,518793,Staff,19,0,20,1
1713332296516,MCWP 50R,D00,518794,Staff,16,0,20,4
1713332296516,MCWP 50R,E00,518795,Staff,16,0,20,4
1713332296516,MCWP 50R,F00,518796,Staff,19,0,20,1
1713332296516,MCWP 50R,G00,518797,Staff,19,0,20,1
1713332297546,MMW 12R,A01,514034,Herbst; Matthew,15,0,16,1
1713332297546,MMW 12R,A02,514035,Herbst; Matthew,16,0,16,0
1713332298571,MMW 13R,A01,514037,Staff,12,0,16,4
1713332298571,MMW 13R,A02,514039,Staff,16,0,16,0
1713332300624,SIO 295LS,A00,523233,Staff,19,0,30,11
1713332301650,SIO 295S,A00,523232,Staff,19,0,30,11
1713332302679,SOCI 117,A01,494376,Staff,2,0,5,3
1713332303710,WES 237B,A00,494380,Staff,19,0,20,1
1713332305788,AESE 279B,A00,494370,Wade; Jon P,33,0,33,0
1713332306816,ANAR 135S,A00,494369,Braswell; Geoffrey E.,0,0,0,0
1713332307902,CAT 124RS,A01,519847,Geibel; William,17,0,20,3
1713332308930,CAT 125RS,A01,515971,Geibel; William,17,0,20,3
1713332309954,CLRE 250,A00,511389,Morris; Sheldon,9996,0,9999,3
1713332310983,CLRE 251,A00,507176,Mehta; Ravindra L.,9996,0,9999,3
1713332310983,CLRE 251,B00,511410,Mehta; Ravindra L.,9998,0,9999,1
1713332312008,CLRE 252,A00,507189,Cuomo; Raphael Eduardo,9998,0,9999,1
1713332313034,CLRE 253,A00,507199,Vaida; Florin,9997,0,9999,2
1713332313034,CLRE 253,B00,507202,Vaida; Florin,9999,0,9999,0
1713332314063,CLRE 259,A00,507211,Patel; Hemal,9996,0,9999,3
1713332315090,CLRE 260,A00,507221,Cuomo; Raphael Eduardo,9999,0,9999,0
1713332316116,CLRE 297,001,507242,Cuomo; Raphael Eduardo,9999,0,9999,0
1713332317143,CSE 191,A00,516875,Minnes Kemp; Mor Mia,9999,0,9999,0
1713332318169,CSS 201S,A01,494383,Staff,35,0,35,0
1713332319197,CSS 202S,A01,494387,Staff,35,0,35,0
1713332320222,EAP 100,A00,516065,Staff,9792,0,9999,207
1713332321247,ECE 45,A01,507414,Staff,51,0,60,9
1713332322276,ECE 100,A01,507416,Baghdadchi; Saharnaz,10,0,20,10
1713332322276,ECE 100,A02,507418,Baghdadchi; Saharnaz,20,0,20,0
1713332323301,ECE 111,A01,507420,Staff,38,0,50,12
1713332324327,ECE 197,001,548057,Sievenpiper; Daniel F.,9998,0,9999,1
1713332325354,EDS 115,A00,507243,Choi; Bailey Miyeon,28,0,28,0
1713332326384,EDS 117,A01,494379,Staff,23,0,25,2
1713332327409,EDS 125,A00,507246,Hopkins; Megan Beth,29,0,30,1
1713332328435,EDS 128A,A01,507264,Fargason; Sharon Gayle,26,0,26,0
1713332329461,EDS 128B,A01,507293,Pappas; Elizabeth,30,0,30,0
1713332330485,EDS 139,A00,507294,Fargason; Sharon Gayle,30,0,30,0
1713332330485,EDS 139,B00,507313,Pappas; Elizabeth,30,0,30,0
1713332331510,EDS 201,A00,507315,Staff,26,0,30,4
1713332332539,EDS 203,A01,507317,Halter; Christopher P.,26,0,30,4
1713332333565,EDS 204R,A01,507319,Halter; Christopher P.,3,0,30,27
1713332333565,EDS 204R,B01,507331,Heinzman; Erica M.,28,0,30,2
1713332334599,EDS 206R,A00,507332,Staff,4,0,30,26
1713332334599,EDS 206R,B00,507343,Staff,28,0,30,2
1713332335625,EDS 250,A00,507344,Hemans; Patricia Ann Benitez,36,0,40,4
1713332336653,EDS 281,A00,507345,Daly; Alan J.,18,0,18,0
1713332337679,EDS 284,A00,507350,Daly; Alan J.,16,0,16,0
1713332338704,EDS 286,A00,507359,Fine; Sarah,18,0,18,0
1713332339730,EDS 289C,A01,507361,Daly; Alan J.,18,0,18,0
1713332340755,EDS 290,A00,507366,Hofstetter; Carolyn,15,0,15,0
1713332341786,LIGM 5A,A00,507421,Fischer-Grunski; Eva K,20,0,20,0
1713332342812,LIGM 5B,A00,507423,Fischer-Grunski; Eva K,20,0,20,0
1713332343839,LIGM 5C,A00,507425,Fischer-Grunski; Eva K,20,0,20,0
1713332344868,LIIT 5AS,A00,507427,Carnelos; Chiara,20,0,20,0
1713332345894,LIIT 5BS,A00,507430,Carnelos; Chiara,20,0,20,0
1713332346919,LIIT 5CS,A00,507432,Carnelos; Chiara,20,0,20,0
1713332347950,LISP 5A,A00,507541,Munoz Sanchez; Alicia,17,0,20,3
1713332348977,LISP 5B,A00,507671,Munoz Sanchez; Alicia,15,0,20,5
1713332350006,LISP 5C,A00,507696,Munoz Sanchez; Alicia,15,0,20,5
1713332351031,MAE 197,001,528363,Boechler; Nicholas Sebastia,9998,0,9999,1
1713332352059,MATH 197,001,523477,Kedlaya; Kiran S.,9999,0,9999,0
1713332352059,MATH 197,002,563811,Zhang; Danna,9999,0,9999,0
1713332353088,MCWP 40R,A00,518780,Staff,20,0,20,0
1713332353088,MCWP 40R,B00,518781,Staff,19,0,20,1
1713332353088,MCWP 40R,C00,518783,Staff,19,0,20,1
1713332354118,MCWP 50R,A00,518791,Staff,20,0,20,0
1713332354118,MCWP 50R,B00,518792,Staff,17,0,20,3
1713332354118,MCWP 50R,C00,518793,Staff,19,0,20,1
1713332354118,MCWP 50R,D00,518794,Staff,16,0,20,4
1713332354118,MCWP 50R,E00,518795,Staff,16,0,20,4
1713332354118,MCWP 50R,F00,518796,Staff,19,0,20,1
1713332354118,MCWP 50R,G00,518797,Staff,19,0,20,1
1713332355145,MMW 12R,A01,514034,Herbst; Matthew,15,0,16,1
1713332355145,MMW 12R,A02,514035,Herbst; Matthew,16,0,16,0
1713332356169,MMW 13R,A01,514037,Staff,12,0,16,4
1713332356169,MMW 13R,A02,514039,Staff,16,0,16,0
1713332358277,SIO 295LS,A00,523233,Staff,19,0,30,11
1713332359305,SIO 295S,A00,523232,Staff,19,0,30,11
1713332360329,SOCI 117,A01,494376,Staff,2,0,5,3
1713332361358,WES 237B,A00,494380,Staff,19,0,20,1
1713332363431,AESE 279B,A00,494370,Wade; Jon P,33,0,33,0
1713332364456,ANAR 135S,A00,494369,Braswell; Geoffrey E.,0,0,0,0
1713332365483,CAT 124RS,A01,519847,Geibel; William,17,0,20,3
1713332366509,CAT 125RS,A01,515971,Geibel; William,17,0,20,3
1713332367534,CLRE 250,A00,511389,Morris; Sheldon,9996,0,9999,3
1713332368559,CLRE 251,A00,507176,Mehta; Ravindra L.,9996,0,9999,3
1713332368559,CLRE 251,B00,511410,Mehta; Ravindra L.,9998,0,9999,1
1713332369589,CLRE 252,A00,507189,Cuomo; Raphael Eduardo,9998,0,9999,1
1713332370615,CLRE 253,A00,507199,Vaida; Florin,9997,0,9999,2
1713332370615,CLRE 253,B00,507202,Vaida; Florin,9999,0,9999,0
1713332371644,CLRE 259,A00,507211,Patel; Hemal,9996,0,9999,3
1713332372670,CLRE 260,A00,507221,Cuomo; Raphael Eduardo,9999,0,9999,0
1713332373698,CLRE 297,001,507242,Cuomo; Raphael Eduardo,9999,0,9999,0
1713332374726,CSE 191,A00,516875,Minnes Kemp; Mor Mia,9999,0,9999,0
1713332375751,CSS 201S,A01,494383,Staff,35,0,35,0
1713332376781,CSS 202S,A01,494387,Staff,35,0,35,0
1713332377808,EAP 100,A00,516065,Staff,9792,0,9999,207
1713332378834,ECE 45,A01,507414,Staff,51,0,60,9
1713332379863,ECE 100,A01,507416,Baghdadchi; Saharnaz,10,0,20,10
1713332379863,ECE 100,A02,507418,Baghdadchi; Saharnaz,20,0,20,0
1713332380893,ECE 111,A01,507420,Staff,38,0,50,12
1713332381921,ECE 197,001,548057,Sievenpiper; Daniel F.,9998,0,9999,1
1713332382947,EDS 115,A00,507243,Choi; Bailey Miyeon,28,0,28,0
1713332383977,EDS 117,A01,494379,Staff,23,0,25,2
1713332385002,EDS 125,A00,507246,Hopkins; Megan Beth,29,0,30,1
1713332386028,EDS 128A,A01,507264,Fargason; Sharon Gayle,26,0,26,0
1713332387053,EDS 128B,A01,507293,Pappas; Elizabeth,30,0,30,0
1713332388082,EDS 139,A00,507294,Fargason; Sharon Gayle,30,0,30,0
1713332388082,EDS 139,B00,507313,Pappas; Elizabeth,30,0,30,0
1713332389107,EDS 201,A00,507315,Staff,26,0,30,4
1713332390135,EDS 203,A01,507317,Halter; Christopher P.,26,0,30,4
1713332391165,EDS 204R,A01,507319,Halter; Christopher P.,3,0,30,27
1713332391165,EDS 204R,B01,507331,Heinzman; Erica M.,28,0,30,2
1713332392189,EDS 206R,A00,507332,Staff,4,0,30,26
1713332392189,EDS 206R,B00,507343,Staff,28,0,30,2
1713332393216,EDS 250,A00,507344,Hemans; Patricia Ann Benitez,36,0,40,4
1713332394241,EDS 281,A00,507345,Daly; Alan J.,18,0,18,0
1713332395269,EDS 284,A00,507350,Daly; Alan J.,16,0,16,0
1713332396295,EDS 286,A00,507359,Fine; Sarah,18,0,18,0
1713332397323,EDS 289C,A01,507361,Daly; Alan J.,18,0,18,0
1713332398350,EDS 290,A00,507366,Hofstetter; Carolyn,15,0,15,0
1713332399378,LIGM 5A,A00,507421,Fischer-Grunski; Eva K,20,0,20,0
1713332400409,LIGM 5B,A00,507423,Fischer-Grunski; Eva K,20,0,20,0
1713332401439,LIGM 5C,A00,507425,Fischer-Grunski; Eva K,20,0,20,0
1713332402468,LIIT 5AS,A00,507427,Carnelos; Chiara,20,0,20,0
1713332403492,LIIT 5BS,A00,507430,Carnelos; Chiara,20,0,20,0
1713332404516,LIIT 5CS,A00,507432,Carnelos; Chiara,20,0,20,0
1713332405541,LISP 5A,A00,507541,Munoz Sanchez; Alicia,17,0,20,3
1713332406567,LISP 5B,A00,507671,Munoz Sanchez; Alicia,15,0,20,5
1713332407592,LISP 5C,A00,507696,Munoz Sanchez; Alicia,15,0,20,5
1713332408617,MAE 197,001,528363,Boechler; Nicholas Sebastia,9998,0,9999,1
1713332409650,MATH 197,001,523477,Kedlaya; Kiran S.,9999,0,9999,0
1713332409650,MATH 197,002,563811,Zhang; Danna,9999,0,9999,0
1713332410675,MCWP 40R,A00,518780,Staff,20,0,20,0
1713332410675,MCWP 40R,B00,518781,Staff,19,0,20,1
1713332410675,MCWP 40R,C00,518783,Staff,19,0,20,1
1713332411759,MCWP 50R,A00,518791,Staff,20,0,20,0
1713332411759,MCWP 50R,B00,518792,Staff,17,0,20,3
1713332411759,MCWP 50R,C00,518793,Staff,19,0,20,1
1713332411759,MCWP 50R,D00,518794,Staff,16,0,20,4
1713332411759,MCWP 50R,E00,518795,Staff,16,0,20,4
1713332411759,MCWP 50R,F00,518796,Staff,19,0,20,1
1713332411759,MCWP 50R,G00,518797,Staff,19,0,20,1
1713332412789,MMW 12R,A01,514034,Herbst; Matthew,15,0,16,1
1713332412789,MMW 12R,A02,514035,Herbst; Matthew,16,0,16,0
1713332413814,MMW 13R,A01,514037,Staff,12,0,16,4
1713332413814,MMW 13R,A02,514039,Staff,16,0,16,0
1713332415867,SIO 295LS,A00,523233,Staff,19,0,30,11
1713332416892,SIO 295S,A00,523232,Staff,19,0,30,11
1713332417921,SOCI 117,A01,494376,Staff,2,0,5,3
1713332418948,WES 237B,A00,494380,Staff,19,0,20,1
1713332421012,AESE 279B,A00,494370,Wade; Jon P,33,0,33,0
1713332422038,ANAR 135S,A00,494369,Braswell; Geoffrey E.,0,0,0,0
1713332423064,CAT 124RS,A01,519847,Geibel; William,17,0,20,3
1713332424088,CAT 125RS,A01,515971,Geibel; William,17,0,20,3
1713332425114,CLRE 250,A00,511389,Morris; Sheldon,9996,0,9999,3
1713332426148,CLRE 251,A00,507176,Mehta; Ravindra L.,9996,0,9999,3
1713332426148,CLRE 251,B00,511410,Mehta; Ravindra L.,9998,0,9999,1
1713332427173,CLRE 252,A00,507189,Cuomo; Raphael Eduardo,9998,0,9999,1
1713332428200,CLRE 253,A00,507199,Vaida; Florin,9997,0,9999,2
1713332428200,CLRE 253,B00,507202,Vaida; Florin,9999,0,9999,0
1713332429227,CLRE 259,A00,507211,Patel; Hemal,9996,0,9999,3
1713332430253,CLRE 260,A00,507221,Cuomo; Raphael Eduardo,9999,0,9999,0
1713332431277,CLRE 297,001,507242,Cuomo; Raphael Eduardo,9999,0,9999,0
1713332432302,CSE 191,A00,516875,Minnes Kemp; Mor Mia,9999,0,9999,0
1713332433326,CSS 201S,A01,494383,Staff,35,0,35,0
1713332434356,CSS 202S,A01,494387,Staff,35,0,35,0
1713332435383,EAP 100,A00,516065,Staff,9792,0,9999,207
1713332436407,ECE 45,A01,507414,Staff,51,0,60,9
1713332437434,ECE 100,A01,507416,Baghdadchi; Saharnaz,10,0,20,10
1713332437434,ECE 100,A02,507418,Baghdadchi; Saharnaz,20,0,20,0
1713332438460,ECE 111,A01,507420,Staff,38,0,50,12
1713332439490,ECE 197,001,548057,Sievenpiper; Daniel F.,9998,0,9999,1
1713332440520,EDS 115,A00,507243,Choi; Bailey Miyeon,28,0,28,0
1713332441545,EDS 117,A01,494379,Staff,23,0,25,2
1713332442569,EDS 125,A00,507246,Hopkins; Megan Beth,29,0,30,1
1713332443595,EDS 128A,A01,507264,Fargason; Sharon Gayle,26,0,26,0
1713332444621,EDS 128B,A01,507293,Pappas; Elizabeth,30,0,30,0
1713332445651,EDS 139,A00,507294,Fargason; Sharon Gayle,30,0,30,0
1713332445651,EDS 139,B00,507313,Pappas; Elizabeth,30,0,30,0
1713332446677,EDS 201,A00,507315,Staff,26,0,30,4
1713332447706,EDS 203,A01,507317,Halter; Christopher P.,26,0,30,4
1713332448732,EDS 204R,A01,507319,Halter; Christopher P.,3,0,30,27
1713332448732,EDS 204R,B01,507331,Heinzman; Erica M.,28,0,30,2
1713332449760,EDS 206R,A00,507332,Staff,4,0,30,26
1713332449760,EDS 206R,B00,507343,Staff,28,0,30,2
1713332450785,EDS 250,A00,507344,Hemans; Patricia Ann Benitez,36,0,40,4
1713332451811,EDS 281,A00,507345,Daly; Alan J.,18,0,18,0
1713332452836,EDS 284,A00,507350,Daly; Alan J.,16,0,16,0
1713332453867,EDS 286,A00,507359,Fine; Sarah,18,0,18,0
1713332454890,EDS 289C,A01,507361,Daly; Alan J.,18,0,18,0
1713332455916,EDS 290,A00,507366,Hofstetter; Carolyn,15,0,15,0
1713332456943,LIGM 5A,A00,507421,Fischer-Grunski; Eva K,20,0,20,0
1713332457971,LIGM 5B,A00,507423,Fischer-Grunski; Eva K,20,0,20,0
1713332458998,LIGM 5C,A00,507425,Fischer-Grunski; Eva K,20,0,20,0
1713332460024,LIIT 5AS,A00,507427,Carnelos; Chiara,20,0,20,0
1713332461050,LIIT 5BS,A00,507430,Carnelos; Chiara,20,0,20,0
1713332462078,LIIT 5CS,A00,507432,Carnelos; Chiara,20,0,20,0
1713332463104,LISP 5A,A00,507541,Munoz Sanchez; Alicia,17,0,20,3
1713332464129,LISP 5B,A00,507671,Munoz Sanchez; Alicia,15,0,20,5
1713332465154,LISP 5C,A00,507696,Munoz Sanchez; Alicia,15,0,20,5
1713332466180,MAE 197,001,528363,Boechler; Nicholas Sebastia,9998,0,9999,1
1713332467210,MATH 197,001,523477,Kedlaya; Kiran S.,9999,0,9999,0
1713332467210,MATH 197,002,563811,Zhang; Danna,9999,0,9999,0
1713332468235,MCWP 40R,A00,518780,Staff,20,0,20,0
1713332468235,MCWP 40R,B00,518781,Staff,19,0,20,1
1713332468235,MCWP 40R,C00,518783,Staff,19,0,20,1
1713332469260,MCWP 50R,A00,518791,Staff,20,0,20,0
1713332469260,MCWP 50R,B00,518792,Staff,17,0,20,3
1713332469260,MCWP 50R,C00,518793,Staff,19,0,20,1
1713332469260,MCWP 50R,D00,518794,Staff,16,0,20,4
1713332469260,MCWP 50R,E00,518795,Staff,16,0,20,4
1713332469260,MCWP 50R,F00,518796,Staff,19,0,20,1
1713332469260,MCWP 50R,G00,518797,Staff,19,0,20,1
1713332470289,MMW 12R,A01,514034,Herbst; Matthew,15,0,16,1
1713332470289,MMW 12R,A02,514035,Herbst; Matthew,16,0,16,0
1713332471314,MMW 13R,A01,514037,Staff,12,0,16,4
1713332471314,MMW 13R,A02,514039,Staff,16,0,16,0
1713332473366,SIO 295LS,A00,523233,Staff,19,0,30,11
1713332474392,SIO 295S,A00,523232,Staff,19,0,30,11
1713332475421,SOCI 117,A01,494376,Staff,2,0,5,3
1713332476447,WES 237B,A00,494380,Staff,19,0,20,1
1713332478519,AESE 279B,A00,494370,Wade; Jon P,33,0,33,0
1713332479543,ANAR 135S,A00,494369,Braswell; Geoffrey E.,0,0,0,0
1713332480571,CAT 124RS,A01,519847,Geibel; William,17,0,20,3
1713332481596,CAT 125RS,A01,515971,Geibel; William,17,0,20,3
1713332482625,CLRE 250,A00,511389,Morris; Sheldon,9996,0,9999,3
1713332483656,CLRE 251,A00,507176,Mehta; Ravindra L.,9996,0,9999,3
1713332483656,CLRE 251,B00,511410,Mehta; Ravindra L.,9998,0,9999,1
1713332484681,CLRE 252,A00,507189,Cuomo; Raphael Eduardo,9998,0,9999,1
1713332485711,CLRE 253,A00,507199,Vaida; Florin,9997,0,9999,2
1713332485711,CLRE 253,B00,507202,Vaida; Florin,9999,0,9999,0
1713332486739,CLRE 259,A00,507211,Patel; Hemal,9996,0,9999,3
1713332487768,CLRE 260,A00,507221,Cuomo; Raphael Eduardo,9999,0,9999,0
1713332488794,CLRE 297,001,507242,Cuomo; Raphael Eduardo,9999,0,9999,0
1713332489823,CSE 191,A00,516875,Minnes Kemp; Mor Mia,9999,0,9999,0
1713332490852,CSS 201S,A01,494383,Staff,35,0,35,0
1713332491877,CSS 202S,A01,494387,Staff,35,0,35,0
1713332492904,EAP 100,A00,516065,Staff,9792,0,9999,207
1713332493929,ECE 45,A01,507414,Staff,51,0,60,9
1713332494955,ECE 100,A01,507416,Baghdadchi; Saharnaz,10,0,20,10
1713332494955,ECE 100,A02,507418,Baghdadchi; Saharnaz,20,0,20,0
1713332495980,ECE 111,A01,507420,Staff,38,0,50,12
1713332497011,ECE 197,001,548057,Sievenpiper; Daniel F.,9998,0,9999,1
1713332498038,EDS 115,A00,507243,Choi; Bailey Miyeon,28,0,28,0
1713332499064,EDS 117,A01,494379,Staff,23,0,25,2
1713332500090,EDS 125,A00,507246,Hopkins; Megan Beth,29,0,30,1
1713332501118,EDS 128A,A01,507264,Fargason; Sharon Gayle,26,0,26,0
1713332502144,EDS 128B,A01,507293,Pappas; Elizabeth,30,0,30,0
1713332503168,EDS 139,A00,507294,Fargason; Sharon Gayle,30,0,30,0
1713332503168,EDS 139,B00,507313,Pappas; Elizabeth,30,0,30,0
1713332504193,EDS 201,A00,507315,Staff,26,0,30,4
1713332505223,EDS 203,A01,507317,Halter; Christopher P.,26,0,30,4
1713332506254,EDS 204R,A01,507319,Halter; Christopher P.,3,0,30,27
1713332506254,EDS 204R,B01,507331,Heinzman; Erica M.,28,0,30,2
1713332507279,EDS 206R,A00,507332,Staff,4,0,30,26
1713332507279,EDS 206R,B00,507343,Staff,28,0,30,2
1713332508305,EDS 250,A00,507344,Hemans; Patricia Ann Benitez,36,0,40,4
1713332509330,EDS 281,A00,507345,Daly; Alan J.,18,0,18,0
1713332510355,EDS 284,A00,507350,Daly; Alan J.,16,0,16,0
1713332511380,EDS 286,A00,507359,Fine; Sarah,18,0,18,0
1713332512406,EDS 289C,A01,507361,Daly; Alan J.,18,0,18,0
1713332513436,EDS 290,A00,507366,Hofstetter; Carolyn,15,0,15,0
1713332514462,LIGM 5A,A00,507421,Fischer-Grunski; Eva K,20,0,20,0
1713332515540,LIGM 5B,A00,507423,Fischer-Grunski; Eva K,20,0,20,0
1713332516571,LIGM 5C,A00,507425,Fischer-Grunski; Eva K,20,0,20,0
1713332517600,LIIT 5AS,A00,507427,Carnelos; Chiara,20,0,20,0
1713332518630,LIIT 5BS,A00,507430,Carnelos; Chiara,20,0,20,0
1713332519658,LIIT 5CS,A00,507432,Carnelos; Chiara,20,0,20,0
1713332520688,LISP 5A,A00,507541,Munoz Sanchez; Alicia,17,0,20,3
1713332521718,LISP 5B,A00,507671,Munoz Sanchez; Alicia,15,0,20,5
1713332522743,LISP 5C,A00,507696,Munoz Sanchez; Alicia,15,0,20,5
1713332523767,MAE 197,001,528363,Boechler; Nicholas Sebastia,9998,0,9999,1
1713332524796,MATH 197,001,523477,Kedlaya; Kiran S.,9999,0,9999,0
1713332524796,MATH 197,002,563811,Zhang; Danna,9999,0,9999,0
1713332525823,MCWP 40R,A00,518780,Staff,20,0,20,0
1713332525823,MCWP 40R,B00,518781,Staff,19,0,20,1
1713332525823,MCWP 40R,C00,518783,Staff,19,0,20,1
1713332526850,MCWP 50R,A00,518791,Staff,20,0,20,0
1713332526850,MCWP 50R,B00,518792,Staff,17,0,20,3
1713332526850,MCWP 50R,C00,518793,Staff,19,0,20,1
1713332526850,MCWP 50R,D00,518794,Staff,16,0,20,4
1713332526850,MCWP 50R,E00,518795,Staff,16,0,20,4
1713332526850,MCWP 50R,F00,518796,Staff,19,0,20,1
1713332526850,MCWP 50R,G00,518797,Staff,19,0,20,1
1713332527875,MMW 12R,A01,514034,Herbst; Matthew,15,0,16,1
1713332527875,MMW 12R,A02,514035,Herbst; Matthew,16,0,16,0
1713332528898,MMW 13R,A01,514037,Staff,12,0,16,4
1713332528898,MMW 13R,A02,514039,Staff,16,0,16,0
1713332530962,SIO 295LS,A00,523233,Staff,19,0,30,11
1713332531986,SIO 295S,A00,523232,Staff,19,0,30,11
1713332533014,SOCI 117,A01,494376,Staff,2,0,5,3
1713332534038,WES 237B,A00,494380,Staff,19,0,20,1
1713332536117,AESE 279B,A00,494370,Wade; Jon P,33,0,33,0
1713332537142,ANAR 135S,A00,494369,Braswell; Geoffrey E.,0,0,0,0
1713332538170,CAT 124RS,A01,519847,Geibel; William,17,0,20,3
1713332539195,CAT 125RS,A01,515971,Geibel; William,17,0,20,3
1713332540222,CLRE 250,A00,511389,Morris; Sheldon,9996,0,9999,3
1713332541255,CLRE 251,A00,507176,Mehta; Ravindra L.,9996,0,9999,3
1713332541255,CLRE 251,B00,511410,Mehta; Ravindra L.,9998,0,9999,1
1713332542280,CLRE 252,A00,507189,Cuomo; Raphael Eduardo,9998,0,9999,1
1713332543313,CLRE 253,A00,507199,Vaida; Florin,9997,0,9999,2
1713332543313,CLRE 253,B00,507202,Vaida; Florin,9999,0,9999,0
1713332544337,CLRE 259,A00,507211,Patel; Hemal,9996,0,9999,3
1713332545362,CLRE 260,A00,507221,Cuomo; Raphael Eduardo,9999,0,9999,0
1713332546393,CLRE 297,001,507242,Cuomo; Raphael Eduardo,9999,0,9999,0
1713332547417,CSE 191,A00,516875,Minnes Kemp; Mor Mia,9999,0,9999,0
1713332548446,CSS 201S,A01,494383,Staff,35,0,35,0
1713332549472,CSS 202S,A01,494387,Staff,35,0,35,0
1713332550498,EAP 100,A00,516065,Staff,9792,0,9999,207
1713332551526,ECE 45,A01,507414,Staff,51,0,60,9
1713332552550,ECE 100,A01,507416,Baghdadchi; Saharnaz,10,0,20,10
1713332552550,ECE 100,A02,507418,Baghdadchi; Saharnaz,20,0,20,0
1713332553578,ECE 111,A01,507420,Staff,38,0,50,12
1713332554603,ECE 197,001,548057,Sievenpiper; Daniel F.,9998,0,9999,1
1713332555634,EDS 115,A00,507243,Choi; Bailey Miyeon,28,0,28,0
1713332556662,EDS 117,A01,494379,Staff,23,0,25,2
1713332557688,EDS 125,A00,507246,Hopkins; Megan Beth,29,0,30,1
1713332558719,EDS 128A,A01,507264,Fargason; Sharon Gayle,26,0,26,0
1713332559749,EDS 128B,A01,507293,Pappas; Elizabeth,30,0,30,0
1713332560777,EDS 139,A00,507294,Fargason; Sharon Gayle,30,0,30,0
1713332560777,EDS 139,B00,507313,Pappas; Elizabeth,30,0,30,0
1713332561810,EDS 201,A00,507315,Staff,26,0,30,4
1713332562834,EDS 203,A01,507317,Halter; Christopher P.,26,0,30,4
1713332563867,EDS 204R,A01,507319,Halter; Christopher P.,3,0,30,27
1713332563867,EDS 204R,B01,507331,Heinzman; Erica M.,28,0,30,2
1713332564892,EDS 206R,A00,507332,Staff,4,0,30,26
1713332564892,EDS 206R,B00,507343,Staff,28,0,30,2
1713332565917,EDS 250,A00,507344,Hemans; Patricia Ann Benitez,36,0,40,4
1713332566942,EDS 281,A00,507345,Daly; Alan J.,18,0,18,0
1713332567970,EDS 284,A00,507350,Daly; Alan J.,16,0,16,0
1713332568998,EDS 286,A00,507359,Fine; Sarah,18,0,18,0
1713332570023,EDS 289C,A01,507361,Daly; Alan J.,18,0,18,0
1713332571047,EDS 290,A00,507366,Hofstetter; Carolyn,15,0,15,0
1713332572073,LIGM 5A,A00,507421,Fischer-Grunski; Eva K,20,0,20,0
1713332573101,LIGM 5B,A00,507423,Fischer-Grunski; Eva K,20,0,20,0
1713332574125,LIGM 5C,A00,507425,Fischer-Grunski; Eva K,20,0,20,0
1713332575154,LIIT 5AS,A00,507427,Carnelos; Chiara,20,0,20,0
1713332576179,LIIT 5BS,A00,507430,Carnelos; Chiara,20,0,20,0
1713332577208,LIIT 5CS,A00,507432,Carnelos; Chiara,20,0,20,0
1713332578234,LISP 5A,A00,507541,Munoz Sanchez; Alicia,17,0,20,3
1713332579264,LISP 5B,A00,507671,Munoz Sanchez; Alicia,15,0,20,5
1713332580289,LISP 5C,A00,507696,Munoz Sanchez; Alicia,15,0,20,5
1713332581316,MAE 197,001,528363,Boechler; Nicholas Sebastia,9998,0,9999,1
1713332582344,MATH 197,001,523477,Kedlaya; Kiran S.,9999,0,9999,0
1713332582344,MATH 197,002,563811,Zhang; Danna,9999,0,9999,0
1713332583371,MCWP 40R,A00,518780,Staff,20,0,20,0
1713332583371,MCWP 40R,B00,518781,Staff,19,0,20,1
1713332583371,MCWP 40R,C00,518783,Staff,19,0,20,1
1713332584397,MCWP 50R,A00,518791,Staff,20,0,20,0
1713332584397,MCWP 50R,B00,518792,Staff,17,0,20,3
1713332584397,MCWP 50R,C00,518793,Staff,19,0,20,1
1713332584397,MCWP 50R,D00,518794,Staff,16,0,20,4
1713332584397,MCWP 50R,E00,518795,Staff,16,0,20,4
1713332584397,MCWP 50R,F00,518796,Staff,19,0,20,1
1713332584397,MCWP 50R,G00,518797,Staff,19,0,20,1
1713332585426,MMW 12R,A01,514034,Herbst; Matthew,15,0,16,1
1713332585426,MMW 12R,A02,514035,Herbst; Matthew,16,0,16,0
1713332586451,MMW 13R,A01,514037,Staff,12,0,16,4
1713332586451,MMW 13R,A02,514039,Staff,16,0,16,0
1713332588501,SIO 295LS,A00,523233,Staff,19,0,30,11
1713332589524,SIO 295S,A00,523232,Staff,19,0,30,11
1713332590551,SOCI 117,A01,494376,Staff,2,0,5,3
1713332591578,WES 237B,A00,494380,Staff,19,0,20,1
1713332593648,AESE 279B,A00,494370,Wade; Jon P,33,0,33,0
1713332594673,ANAR 135S,A00,494369,Braswell; Geoffrey E.,0,0,0,0
1713332595699,CAT 124RS,A01,519847,Geibel; William,17,0,20,3
1713332596724,CAT 125RS,A01,515971,Geibel; William,17,0,20,3
1713332597749,CLRE 250,A00,511389,Morris; Sheldon,9996,0,9999,3
1713332598774,CLRE 251,A00,507176,Mehta; Ravindra L.,9996,0,9999,3
1713332598774,CLRE 251,B00,511410,Mehta; Ravindra L.,9998,0,9999,1
1713332599804,CLRE 252,A00,507189,Cuomo; Raphael Eduardo,9998,0,9999,1
1713332600828,CLRE 253,A00,507199,Vaida; Florin,9997,0,9999,2
1713332600828,CLRE 253,B00,507202,Vaida; Florin,9999,0,9999,0
1713332601854,CLRE 259,A00,507211,Patel; Hemal,9996,0,9999,3
1713332602881,CLRE 260,A00,507221,Cuomo; Raphael Eduardo,9999,0,9999,0
1713332603910,CLRE 297,001,507242,Cuomo; Raphael Eduardo,9999,0,9999,0
1713332604937,CSE 191,A00,516875,Minnes Kemp; Mor Mia,9999,0,9999,0
1713332605965,CSS 201S,A01,494383,Staff,35,0,35,0
1713332606989,CSS 202S,A01,494387,Staff,35,0,35,0
1713332608017,EAP 100,A00,516065,Staff,9792,0,9999,207
1713332609047,ECE 45,A01,507414,Staff,51,0,60,9
1713332610079,ECE 100,A01,507416,Baghdadchi; Saharnaz,10,0,20,10
1713332610079,ECE 100,A02,507418,Baghdadchi; Saharnaz,20,0,20,0
1713332611104,ECE 111,A01,507420,Staff,38,0,50,12
1713332612131,ECE 197,001,548057,Sievenpiper; Daniel F.,9998,0,9999,1
1713332613157,EDS 115,A00,507243,Choi; Bailey Miyeon,28,0,28,0
1713332614187,EDS 117,A01,494379,Staff,23,0,25,2
1713332615212,EDS 125,A00,507246,Hopkins; Megan Beth,29,0,30,1
1713332616239,EDS 128A,A01,507264,Fargason; Sharon Gayle,26,0,26,0
1713332617266,EDS 128B,A01,507293,Pappas; Elizabeth,30,0,30,0
1713332618296,EDS 139,A00,507294,Fargason; Sharon Gayle,30,0,30,0
1713332618296,EDS 139,B00,507313,Pappas; Elizabeth,30,0,30,0
1713332619391,EDS 201,A00,507315,Staff,26,0,30,4
1713332620422,EDS 203,A01,507317,Halter; Christopher P.,26,0,30,4
1713332621452,EDS 204R,A01,507319,Halter; Christopher P.,3,0,30,27
1713332621452,EDS 204R,B01,507331,Heinzman; Erica M.,28,0,30,2
1713332622480,EDS 206R,A00,507332,Staff,4,0,30,26
1713332622480,EDS 206R,B00,507343,Staff,28,0,30,2
1713332623505,EDS 250,A00,507344,Hemans; Patricia Ann Benitez,36,0,40,4
1713332624607,EDS 281,A00,507345,Daly; Alan J.,18,0,18,0
1713332625636,EDS 284,A00,507350,Daly; Alan J.,16,0,16,0
1713332626667,EDS 286,A00,507359,Fine; Sarah,18,0,18,0
1713332627693,EDS 289C,A01,507361,Daly; Alan J.,18,0,18,0
1713332628721,EDS 290,A00,507366,Hofstetter; Carolyn,15,0,15,0
1713332629748,LIGM 5A,A00,507421,Fischer-Grunski; Eva K,20,0,20,0
1713332630778,LIGM 5B,A00,507423,Fischer-Grunski; Eva K,20,0,20,0
1713332631806,LIGM 5C,A00,507425,Fischer-Grunski; Eva K,20,0,20,0
1713332632835,LIIT 5AS,A00,507427,Carnelos; Chiara,20,0,20,0
1713332633864,LIIT 5BS,A00,507430,Carnelos; Chiara,20,0,20,0
1713332634889,LIIT 5CS,A00,507432,Carnelos; Chiara,20,0,20,0
1713332635922,LISP 5A,A00,507541,Munoz Sanchez; Alicia,17,0,20,3
1713332636957,LISP 5B,A00,507671,Munoz Sanchez; Alicia,15,0,20,5
1713332637982,LISP 5C,A00,507696,Munoz Sanchez; Alicia,15,0,20,5
1713332639009,MAE 197,001,528363,Boechler; Nicholas Sebastia,9998,0,9999,1
1713332640050,MATH 197,001,523477,Kedlaya; Kiran S.,9999,0,9999,0
1713332640050,MATH 197,002,563811,Zhang; Danna,9999,0,9999,0
1713332641076,MCWP 40R,A00,518780,Staff,20,0,20,0
1713332641076,MCWP 40R,B00,518781,Staff,19,0,20,1
1713332641076,MCWP 40R,C00,518783,Staff,19,0,20,1
1713332642106,MCWP 50R,A00,518791,Staff,20,0,20,0
1713332642106,MCWP 50R,B00,518792,Staff,17,0,20,3
1713332642106,MCWP 50R,C00,518793,Staff,19,0,20,1
1713332642106,MCWP 50R,D00,518794,Staff,16,0,20,4
1713332642106,MCWP 50R,E00,518795,Staff,16,0,20,4
1713332642106,MCWP 50R,F00,518796,Staff,19,0,20,1
1713332642106,MCWP 50R,G00,518797,Staff,19,0,20,1
1713332643131,MMW 12R,A01,514034,Herbst; Matthew,15,0,16,1
1713332643131,MMW 12R,A02,514035,Herbst; Matthew,16,0,16,0
1713332644157,MMW 13R,A01,514037,Staff,12,0,16,4
1713332644157,MMW 13R,A02,514039,Staff,16,0,16,0
1713332646210,SIO 295LS,A00,523233,Staff,19,0,30,11
1713332647238,SIO 295S,A00,523232,Staff,19,0,30,11
1713332648266,SOCI 117,A01,494376,Staff,2,0,5,3
1713332649294,WES 237B,A00,494380,Staff,19,0,20,1
1713332651358,AESE 279B,A00,494370,Wade; Jon P,33,0,33,0
1713332652384,ANAR 135S,A00,494369,Braswell; Geoffrey E.,0,0,0,0
1713332653412,CAT 124RS,A01,519847,Geibel; William,17,0,20,3
1713332654437,CAT 125RS,A01,515971,Geibel; William,17,0,20,3
1713332655461,CLRE 250,A00,511389,Morris; Sheldon,9996,0,9999,3
1713332656487,CLRE 251,A00,507176,Mehta; Ravindra L.,9996,0,9999,3
1713332656487,CLRE 251,B00,511410,Mehta; Ravindra L.,9998,0,9999,1
1713332657513,CLRE 252,A00,507189,Cuomo; Raphael Eduardo,9998,0,9999,1
1713332658539,CLRE 253,A00,507199,Vaida; Florin,9997,0,9999,2
1713332658539,CLRE 253,B00,507202,Vaida; Florin,9999,0,9999,0
1713332659564,CLRE 259,A00,507211,Patel; Hemal,9996,0,9999,3
1713332660592,CLRE 260,A00,507221,Cuomo; Raphael Eduardo,9999,0,9999,0
1713332661617,CLRE 297,001,507242,Cuomo; Raphael Eduardo,9999,0,9999,0
1713332662645,CSE 191,A00,516875,Minnes Kemp; Mor Mia,9999,0,9999,0
1713332663671,CSS 201S,A01,494383,Staff,35,0,35,0
1713332664696,CSS 202S,A01,494387,Staff,35,0,35,0
1713332665720,EAP 100,A00,516065,Staff,9792,0,9999,207
1713332666748,ECE 45,A01,507414,Staff,51,0,60,9
1713332667777,ECE 100,A01,507416,Baghdadchi; Saharnaz,10,0,20,10
1713332667777,ECE 100,A02,507418,Baghdadchi; Saharnaz,20,0,20,0
1713332668802,ECE 111,A01,507420,Staff,38,0,50,12
1713332669830,ECE 197,001,548057,Sievenpiper; Daniel F.,9998,0,9999,1
1713332670856,EDS 115,A00,507243,Choi; Bailey Miyeon,28,0,28,0
1713332671881,EDS 117,A01,494379,Staff,23,0,25,2
1713332672910,EDS 125,A00,507246,Hopkins; Megan Beth,29,0,30,1
1713332673935,EDS 128A,A01,507264,Fargason; Sharon Gayle,26,0,26,0
1713332674961,EDS 128B,A01,507293,Pappas; Elizabeth,30,0,30,0
1713332675985,EDS 139,A00,507294,Fargason; Sharon Gayle,30,0,30,0
1713332675985,EDS 139,B00,507313,Pappas; Elizabeth,30,0,30,0
1713332677011,EDS 201,A00,507315,Staff,26,0,30,4
1713332678035,EDS 203,A01,507317,Halter; Christopher P.,26,0,30,4
1713332679061,EDS 204R,A01,507319,Halter; Christopher P.,3,0,30,27
1713332679061,EDS 204R,B01,507331,Heinzman; Erica M.,28,0,30,2
1713332680091,EDS 206R,A00,507332,Staff,4,0,30,26
1713332680091,EDS 206R,B00,507343,Staff,28,0,30,2
1713332681117,EDS 250,A00,507344,Hemans; Patricia Ann Benitez,36,0,40,4
1713332682146,EDS 281,A00,507345,Daly; Alan J.,18,0,18,0
1713332683171,EDS 284,A00,507350,Daly; Alan J.,16,0,16,0
1713332684196,EDS 286,A00,507359,Fine; Sarah,18,0,18,0
1713332685223,EDS 289C,A01,507361,Daly; Alan J.,18,0,18,0
1713332686249,EDS 290,A00,507366,Hofstetter; Carolyn,15,0,15,0
1713332687276,LIGM 5A,A00,507421,Fischer-Grunski; Eva K,20,0,20,0
1713332688301,LIGM 5B,A00,507423,Fischer-Grunski; Eva K,20,0,20,0
1713332689333,LIGM 5C,A00,507425,Fischer-Grunski; Eva K,20,0,20,0
1713332690363,LIIT 5AS,A00,507427,Carnelos; Chiara,20,0,20,0
1713332691396,LIIT 5BS,A00,507430,Carnelos; Chiara,20,0,20,0
1713332692420,LIIT 5CS,A00,507432,Carnelos; Chiara,20,0,20,0
1713332693452,LISP 5A,A00,507541,Munoz Sanchez; Alicia,17,0,20,3
1713332694479,LISP 5B,A00,507671,Munoz Sanchez; Alicia,15,0,20,5
1713332695505,LISP 5C,A00,507696,Munoz Sanchez; Alicia,15,0,20,5
1713332696532,MAE 197,001,528363,Boechler; Nicholas Sebastia,9998,0,9999,1
1713332697557,MATH 197,001,523477,Kedlaya; Kiran S.,9999,0,9999,0
1713332697557,MATH 197,002,563811,Zhang; Danna,9999,0,9999,0
1713332698586,MCWP 40R,A00,518780,Staff,20,0,20,0
1713332698586,MCWP 40R,B00,518781,Staff,19,0,20,1
1713332698586,MCWP 40R,C00,518783,Staff,19,0,20,1
1713332699611,MCWP 50R,A00,518791,Staff,20,0,20,0
1713332699611,MCWP 50R,B00,518792,Staff,17,0,20,3
1713332699611,MCWP 50R,C00,518793,Staff,19,0,20,1
1713332699611,MCWP 50R,D00,518794,Staff,16,0,20,4
1713332699611,MCWP 50R,E00,518795,Staff,16,0,20,4
1713332699611,MCWP 50R,F00,518796,Staff,19,0,20,1
1713332699611,MCWP 50R,G00,518797,Staff,19,0,20,1
1713332700644,MMW 12R,A01,514034,Herbst; Matthew,15,0,16,1
1713332700644,MMW 12R,A02,514035,Herbst; Matthew,16,0,16,0
1713332701671,MMW 13R,A01,514037,Staff,12,0,16,4
1713332701671,MMW 13R,A02,514039,Staff,16,0,16,0
1713332703726,SIO 295LS,A00,523233,Staff,19,0,30,11
1713332704752,SIO 295S,A00,523232,Staff,19,0,30,11
1713332705777,SOCI 117,A01,494376,Staff,2,0,5,3
1713332706801,WES 237B,A00,494380,Staff,19,0,20,1
1713332708882,AESE 279B,A00,494370,Wade; Jon P,33,0,33,0
1713332709914,ANAR 135S,A00,494369,Braswell; Geoffrey E.,0,0,0,0
1713332710940,CAT 124RS,A01,519847,Geibel; William,17,0,20,3
1713332711965,CAT 125RS,A01,515971,Geibel; William,17,0,20,3
1713332712991,CLRE 250,A00,511389,Morris; Sheldon,9996,0,9999,3
1713332714018,CLRE 251,A00,507176,Mehta; Ravindra L.,9996,0,9999,3
1713332714018,CLRE 251,B00,511410,Mehta; Ravindra L.,9998,0,9999,1
1713332715046,CLRE 252,A00,507189,Cuomo; Raphael Eduardo,9998,0,9999,1
1713332716071,CLRE 253,A00,507199,Vaida; Florin,9997,0,9999,2
1713332716071,CLRE 253,B00,507202,Vaida; Florin,9999,0,9999,0
1713332717098,CLRE 259,A00,507211,Patel; Hemal,9996,0,9999,3
1713332718122,CLRE 260,A00,507221,Cuomo; Raphael Eduardo,9999,0,9999,0
1713332719150,CLRE 297,001,507242,Cuomo; Raphael Eduardo,9999,0,9999,0
1713332720174,CSE 191,A00,516875,Minnes Kemp; Mor Mia,9999,0,9999,0
1713332721200,CSS 201S,A01,494383,Staff,35,0,35,0
1713332722232,CSS 202S,A01,494387,Staff,35,0,35,0
1713332723312,EAP 100,A00,516065,Staff,9792,0,9999,207
1713332724340,ECE 45,A01,507414,Staff,51,0,60,9
1713332725366,ECE 100,A01,507416,Baghdadchi; Saharnaz,10,0,20,10
1713332725366,ECE 100,A02,507418,Baghdadchi; Saharnaz,20,0,20,0
1713332726394,ECE 111,A01,507420,Staff,38,0,50,12
1713332727423,ECE 197,001,548057,Sievenpiper; Daniel F.,9998,0,9999,1
1713332728450,EDS 115,A00,507243,Choi; Bailey Miyeon,28,0,28,0
1713332729477,EDS 117,A01,494379,Staff,23,0,25,2
1713332730505,EDS 125,A00,507246,Hopkins; Megan Beth,29,0,30,1
1713332731533,EDS 128A,A01,507264,Fargason; Sharon Gayle,26,0,26,0
1713332732563,EDS 128B,A01,507293,Pappas; Elizabeth,30,0,30,0
1713332733589,EDS 139,A00,507294,Fargason; Sharon Gayle,30,0,30,0
1713332733589,EDS 139,B00,507313,Pappas; Elizabeth,30,0,30,0
1713332734614,EDS 201,A00,507315,Staff,26,0,30,4
1713332735638,EDS 203,A01,507317,Halter; Christopher P.,26,0,30,4
1713332736668,EDS 204R,A01,507319,Halter; Christopher P.,3,0,30,27
1713332736668,EDS 204R,B01,507331,Heinzman; Erica M.,28,0,30,2
1713332737692,EDS 206R,A00,507332,Staff,4,0,30,26
1713332737692,EDS 206R,B00,507343,Staff,28,0,30,2
1713332738722,EDS 250,A00,507344,Hemans; Patricia Ann Benitez,36,0,40,4
1713332739749,EDS 281,A00,507345,Daly; Alan J.,18,0,18,0
1713332740774,EDS 284,A00,507350,Daly; Alan J.,16,0,16,0
1713332741805,EDS 286,A00,507359,Fine; Sarah,18,0,18,0
1713332742831,EDS 289C,A01,507361,Daly; Alan J.,18,0,18,0
1713332743871,EDS 290,A00,507366,Hofstetter; Carolyn,15,0,15,0
1713332744897,LIGM 5A,A00,507421,Fischer-Grunski; Eva K,20,0,20,0
1713332745924,LIGM 5B,A00,507423,Fischer-Grunski; Eva K,20,0,20,0
1713332746949,LIGM 5C,A00,507425,Fischer-Grunski; Eva K,20,0,20,0
1713332747976,LIIT 5AS,A00,507427,Carnelos; Chiara,20,0,20,0
1713332749005,LIIT 5BS,A00,507430,Carnelos; Chiara,20,0,20,0
1713332750030,LIIT 5CS,A00,507432,Carnelos; Chiara,20,0,20,0
1713332751055,LISP 5A,A00,507541,Munoz Sanchez; Alicia,17,0,20,3
1713332752080,LISP 5B,A00,507671,Munoz Sanchez; Alicia,15,0,20,5
1713332753109,LISP 5C,A00,507696,Munoz Sanchez; Alicia,15,0,20,5
1713332754134,MAE 197,001,528363,Boechler; Nicholas Sebastia,9998,0,9999,1
1713332755160,MATH 197,001,523477,Kedlaya; Kiran S.,9999,0,9999,0
1713332755160,MATH 197,002,563811,Zhang; Danna,9999,0,9999,0
1713332756185,MCWP 40R,A00,518780,Staff,20,0,20,0
1713332756185,MCWP 40R,B00,518781,Staff,19,0,20,1
1713332756185,MCWP 40R,C00,518783,Staff,19,0,20,1
1713332757213,MCWP 50R,A00,518791,Staff,20,0,20,0
1713332757213,MCWP 50R,B00,518792,Staff,17,0,20,3
1713332757213,MCWP 50R,C00,518793,Staff,19,0,20,1
1713332757213,MCWP 50R,D00,518794,Staff,16,0,20,4
1713332757213,MCWP 50R,E00,518795,Staff,16,0,20,4
1713332757213,MCWP 50R,F00,518796,Staff,19,0,20,1
1713332757213,MCWP 50R,G00,518797,Staff,19,0,20,1
1713332758239,MMW 12R,A01,514034,Herbst; Matthew,15,0,16,1
1713332758239,MMW 12R,A02,514035,Herbst; Matthew,16,0,16,0
1713332759264,MMW 13R,A01,514037,Staff,12,0,16,4
1713332759264,MMW 13R,A02,514039,Staff,16,0,16,0
1713332761317,SIO 295LS,A00,523233,Staff,19,0,30,11
1713332762345,SIO 295S,A00,523232,Staff,19,0,30,11
1713332763376,SOCI 117,A01,494376,Staff,2,0,5,3
1713332764402,WES 237B,A00,494380,Staff,19,0,20,1
1713332766482,AESE 279B,A00,494370,Wade; Jon P,33,0,33,0
1713332767507,ANAR 135S,A00,494369,Braswell; Geoffrey E.,0,0,0,0
1713332768532,CAT 124RS,A01,519847,Geibel; William,17,0,20,3
1713332769559,CAT 125RS,A01,515971,Geibel; William,17,0,20,3
1713332770588,CLRE 250,A00,511389,Morris; Sheldon,9996,0,9999,3
1713332771613,CLRE 251,A00,507176,Mehta; Ravindra L.,9996,0,9999,3
1713332771613,CLRE 251,B00,511410,Mehta; Ravindra L.,9998,0,9999,1
1713332772637,CLRE 252,A00,507189,Cuomo; Raphael Eduardo,9998,0,9999,1
1713332773664,CLRE 253,A00,507199,Vaida; Florin,9997,0,9999,2
1713332773664,CLRE 253,B00,507202,Vaida; Florin,9999,0,9999,0
1713332774692,CLRE 259,A00,507211,Patel; Hemal,9996,0,9999,3
1713332775717,CLRE 260,A00,507221,Cuomo; Raphael Eduardo,9999,0,9999,0
1713332776741,CLRE 297,001,507242,Cuomo; Raphael Eduardo,9999,0,9999,0
1713332777769,CSE 191,A00,516875,Minnes Kemp; Mor Mia,9999,0,9999,0
1713332778799,CSS 201S,A01,494383,Staff,35,0,35,0
1713332779867,CSS 202S,A01,494387,Staff,35,0,35,0
1713332780894,EAP 100,A00,516065,Staff,9792,0,9999,207
1713332781923,ECE 45,A01,507414,Staff,51,0,60,9
1713332782953,ECE 100,A01,507416,Baghdadchi; Saharnaz,10,0,20,10
1713332782953,ECE 100,A02,507418,Baghdadchi; Saharnaz,20,0,20,0
1713332783979,ECE 111,A01,507420,Staff,38,0,50,12
1713332785005,ECE 197,001,548057,Sievenpiper; Daniel F.,9998,0,9999,1
1713332786032,EDS 115,A00,507243,Choi; Bailey Miyeon,28,0,28,0
1713332787057,EDS 117,A01,494379,Staff,23,0,25,2
1713332788086,EDS 125,A00,507246,Hopkins; Megan Beth,29,0,30,1
1713332789115,EDS 128A,A01,507264,Fargason; Sharon Gayle,26,0,26,0
1713332790138,EDS 128B,A01,507293,Pappas; Elizabeth,30,0,30,0
1713332791168,EDS 139,A00,507294,Fargason; Sharon Gayle,30,0,30,0
1713332791168,EDS 139,B00,507313,Pappas; Elizabeth,30,0,30,0
1713332792195,EDS 201,A00,507315,Staff,26,0,30,4
1713332793219,EDS 203,A01,507317,Halter; Christopher P.,26,0,30,4
1713332794246,EDS 204R,A01,507319,Halter; Christopher P.,3,0,30,27
1713332794246,EDS 204R,B01,507331,Heinzman; Erica M.,28,0,30,2
1713332795276,EDS 206R,A00,507332,Staff,4,0,30,26
1713332795276,EDS 206R,B00,507343,Staff,28,0,30,2
1713332796300,EDS 250,A00,507344,Hemans; Patricia Ann Benitez,36,0,40,4
1713332797325,EDS 281,A00,507345,Daly; Alan J.,18,0,18,0
1713332798353,EDS 284,A00,507350,Daly; Alan J.,16,0,16,0
1713332799380,EDS 286,A00,507359,Fine; Sarah,18,0,18,0
1713332800408,EDS 289C,A01,507361,Daly; Alan J.,18,0,18,0
1713332801436,EDS 290,A00,507366,Hofstetter; Carolyn,15,0,15,0
1713332802465,LIGM 5A,A00,507421,Fischer-Grunski; Eva K,20,0,20,0
1713332803495,LIGM 5B,A00,507423,Fischer-Grunski; Eva K,20,0,20,0
1713332804521,LIGM 5C,A00,507425,Fischer-Grunski; Eva K,20,0,20,0
1713332805547,LIIT 5AS,A00,507427,Carnelos; Chiara,20,0,20,0
1713332806572,LIIT 5BS,A00,507430,Carnelos; Chiara,20,0,20,0
1713332807601,LIIT 5CS,A00,507432,Carnelos; Chiara,20,0,20,0
1713332808629,LISP 5A,A00,507541,Munoz Sanchez; Alicia,17,0,20,3
1713332809654,LISP 5B,A00,507671,Munoz Sanchez; Alicia,15,0,20,5
1713332810681,LISP 5C,A00,507696,Munoz Sanchez; Alicia,15,0,20,5
1713332811707,MAE 197,001,528363,Boechler; Nicholas Sebastia,9998,0,9999,1
1713332812732,MATH 197,001,523477,Kedlaya; Kiran S.,9999,0,9999,0
1713332812732,MATH 197,002,563811,Zhang; Danna,9999,0,9999,0
1713332813757,MCWP 40R,A00,518780,Staff,20,0,20,0
1713332813757,MCWP 40R,B00,518781,Staff,19,0,20,1
1713332813757,MCWP 40R,C00,518783,Staff,19,0,20,1
1713332814783,MCWP 50R,A00,518791,Staff,20,0,20,0
1713332814783,MCWP 50R,B00,518792,Staff,17,0,20,3
1713332814783,MCWP 50R,C00,518793,Staff,19,0,20,1
1713332814783,MCWP 50R,D00,518794,Staff,16,0,20,4
1713332814783,MCWP 50R,E00,518795,Staff,16,0,20,4
1713332814783,MCWP 50R,F00,518796,Staff,19,0,20,1
1713332814783,MCWP 50R,G00,518797,Staff,19,0,20,1
1713332815809,MMW 12R,A01,514034,Herbst; Matthew,15,0,16,1
1713332815809,MMW 12R,A02,514035,Herbst; Matthew,16,0,16,0
1713332816837,MMW 13R,A01,514037,Staff,12,0,16,4
1713332816837,MMW 13R,A02,514039,Staff,16,0,16,0
1713332818890,SIO 295LS,A00,523233,Staff,19,0,30,11
1713332819915,SIO 295S,A00,523232,Staff,19,0,30,11
1713332820943,SOCI 117,A01,494376,Staff,2,0,5,3
1713332821969,WES 237B,A00,494380,Staff,19,0,20,1
1713332824034,AESE 279B,A00,494370,Wade; Jon P,33,0,33,0
1713332825058,ANAR 135S,A00,494369,Braswell; Geoffrey E.,0,0,0,0
1713332826086,CAT 124RS,A01,519847,Geibel; William,17,0,20,3
1713332827165,CAT 125RS,A01,515971,Geibel; William,17,0,20,3
1713332828190,CLRE 250,A00,511389,Morris; Sheldon,9996,0,9999,3
1713332829214,CLRE 251,A00,507176,Mehta; Ravindra L.,9996,0,9999,3
1713332829214,CLRE 251,B00,511410,Mehta; Ravindra L.,9998,0,9999,1
1713332830240,CLRE 252,A00,507189,Cuomo; Raphael Eduardo,9998,0,9999,1
1713332831266,CLRE 253,A00,507199,Vaida; Florin,9997,0,9999,2
1713332831266,CLRE 253,B00,507202,Vaida; Florin,9999,0,9999,0
1713332832296,CLRE 259,A00,507211,Patel; Hemal,9996,0,9999,3
1713332833323,CLRE 260,A00,507221,Cuomo; Raphael Eduardo,9999,0,9999,0
1713332834348,CLRE 297,001,507242,Cuomo; Raphael Eduardo,9999,0,9999,0
1713332835370,CSE 191,A00,516875,Minnes Kemp; Mor Mia,9999,0,9999,0
1713332836395,CSS 201S,A01,494383,Staff,35,0,35,0
1713332837421,CSS 202S,A01,494387,Staff,35,0,35,0
1713332838443,EAP 100,A00,516065,Staff,9792,0,9999,207
1713332839472,ECE 45,A01,507414,Staff,51,0,60,9
1713332840503,ECE 100,A01,507416,Baghdadchi; Saharnaz,10,0,20,10
1713332840503,ECE 100,A02,507418,Baghdadchi; Saharnaz,20,0,20,0
1713332841527,ECE 111,A01,507420,Staff,38,0,50,12
1713332842554,ECE 197,001,548057,Sievenpiper; Daniel F.,9998,0,9999,1
1713332843579,EDS 115,A00,507243,Choi; Bailey Miyeon,28,0,28,0
1713332844604,EDS 117,A01,494379,Staff,23,0,25,2
1713332845632,EDS 125,A00,507246,Hopkins; Megan Beth,29,0,30,1
1713332846660,EDS 128A,A01,507264,Fargason; Sharon Gayle,26,0,26,0
1713332847691,EDS 128B,A01,507293,Pappas; Elizabeth,30,0,30,0
1713332848721,EDS 139,A00,507294,Fargason; Sharon Gayle,30,0,30,0
1713332848721,EDS 139,B00,507313,Pappas; Elizabeth,30,0,30,0
1713332849748,EDS 201,A00,507315,Staff,26,0,30,4
1713332850776,EDS 203,A01,507317,Halter; Christopher P.,26,0,30,4
1713332851883,EDS 204R,A01,507319,Halter; Christopher P.,3,0,30,27
1713332851883,EDS 204R,B01,507331,Heinzman; Erica M.,28,0,30,2
1713332852913,EDS 206R,A00,507332,Staff,4,0,30,26
1713332852913,EDS 206R,B00,507343,Staff,28,0,30,2
1713332853942,EDS 250,A00,507344,Hemans; Patricia Ann Benitez,36,0,40,4
1713332854969,EDS 281,A00,507345,Daly; Alan J.,18,0,18,0
1713332855992,EDS 284,A00,507350,Daly; Alan J.,16,0,16,0
1713332857019,EDS 286,A00,507359,Fine; Sarah,18,0,18,0
1713332858044,EDS 289C,A01,507361,Daly; Alan J.,18,0,18,0
1713332859068,EDS 290,A00,507366,Hofstetter; Carolyn,15,0,15,0
1713332860095,LIGM 5A,A00,507421,Fischer-Grunski; Eva K,20,0,20,0
1713332861121,LIGM 5B,A00,507423,Fischer-Grunski; Eva K,20,0,20,0
1713332862148,LIGM 5C,A00,507425,Fischer-Grunski; Eva K,20,0,20,0
1713332863174,LIIT 5AS,A00,507427,Carnelos; Chiara,20,0,20,0
1713332864205,LIIT 5BS,A00,507430,Carnelos; Chiara,20,0,20,0
1713332865229,LIIT 5CS,A00,507432,Carnelos; Chiara,20,0,20,0
1713332866255,LISP 5A,A00,507541,Munoz Sanchez; Alicia,17,0,20,3
1713332867285,LISP 5B,A00,507671,Munoz Sanchez; Alicia,15,0,20,5
1713332868321,LISP 5C,A00,507696,Munoz Sanchez; Alicia,15,0,20,5
1713332869354,MAE 197,001,528363,Boechler; Nicholas Sebastia,9998,0,9999,1
1713332870378,MATH 197,001,523477,Kedlaya; Kiran S.,9999,0,9999,0
1713332870378,MATH 197,002,563811,Zhang; Danna,9999,0,9999,0
1713332871404,MCWP 40R,A00,518780,Staff,20,0,20,0
1713332871404,MCWP 40R,B00,518781,Staff,19,0,20,1
1713332871404,MCWP 40R,C00,518783,Staff,19,0,20,1
1713332872433,MCWP 50R,A00,518791,Staff,20,0,20,0
1713332872433,MCWP 50R,B00,518792,Staff,17,0,20,3
1713332872433,MCWP 50R,C00,518793,Staff,19,0,20,1
1713332872433,MCWP 50R,D00,518794,Staff,16,0,20,4
1713332872433,MCWP 50R,E00,518795,Staff,16,0,20,4
1713332872433,MCWP 50R,F00,518796,Staff,19,0,20,1
1713332872433,MCWP 50R,G00,518797,Staff,19,0,20,1
1713332873461,MMW 12R,A01,514034,Herbst; Matthew,15,0,16,1
1713332873461,MMW 12R,A02,514035,Herbst; Matthew,16,0,16,0
1713332874489,MMW 13R,A01,514037,Staff,12,0,16,4
1713332874489,MMW 13R,A02,514039,Staff,16,0,16,0
1713332876538,SIO 295LS,A00,523233,Staff,19,0,30,11
1713332877564,SIO 295S,A00,523232,Staff,19,0,30,11
1713332878590,SOCI 117,A01,494376,Staff,2,0,5,3
1713332879616,WES 237B,A00,494380,Staff,19,0,20,1
1713332881683,AESE 279B,A00,494370,Wade; Jon P,33,0,33,0
1713332882711,ANAR 135S,A00,494369,Braswell; Geoffrey E.,0,0,0,0
1713332883736,CAT 124RS,A01,519847,Geibel; William,17,0,20,3
1713332884760,CAT 125RS,A01,515971,Geibel; William,17,0,20,3
1713332885786,CLRE 250,A00,511389,Morris; Sheldon,9996,0,9999,3
1713332886815,CLRE 251,A00,507176,Mehta; Ravindra L.,9996,0,9999,3
1713332886815,CLRE 251,B00,511410,Mehta; Ravindra L.,9998,0,9999,1
1713332887845,CLRE 252,A00,507189,Cuomo; Raphael Eduardo,9998,0,9999,1
1713332888868,CLRE 253,A00,507199,Vaida; Florin,9997,0,9999,2
1713332888868,CLRE 253,B00,507202,Vaida; Florin,9999,0,9999,0
1713332889893,CLRE 259,A00,507211,Patel; Hemal,9996,0,9999,3
1713332890917,CLRE 260,A00,507221,Cuomo; Raphael Eduardo,9999,0,9999,0
1713332891942,CLRE 297,001,507242,Cuomo; Raphael Eduardo,9999,0,9999,0
1713332892967,CSE 191,A00,516875,Minnes Kemp; Mor Mia,9999,0,9999,0
1713332893993,CSS 201S,A01,494383,Staff,35,0,35,0
1713332895021,CSS 202S,A01,494387,Staff,35,0,35,0
1713332896045,EAP 100,A00,516065,Staff,9792,0,9999,207
1713332897078,ECE 45,A01,507414,Staff,51,0,60,9
1713332898107,ECE 100,A01,507416,Baghdadchi; Saharnaz,10,0,20,10
1713332898107,ECE 100,A02,507418,Baghdadchi; Saharnaz,20,0,20,0
1713332899131,ECE 111,A01,507420,Staff,38,0,50,12
1713332900155,ECE 197,001,548057,Sievenpiper; Daniel F.,9998,0,9999,1
1713332901185,EDS 115,A00,507243,Choi; Bailey Miyeon,28,0,28,0
1713332902210,EDS 117,A01,494379,Staff,23,0,25,2
1713332903235,EDS 125,A00,507246,Hopkins; Megan Beth,29,0,30,1
1713332904262,EDS 128A,A01,507264,Fargason; Sharon Gayle,26,0,26,0
1713332905287,EDS 128B,A01,507293,Pappas; Elizabeth,30,0,30,0
1713332906320,EDS 139,A00,507294,Fargason; Sharon Gayle,30,0,30,0
1713332906320,EDS 139,B00,507313,Pappas; Elizabeth,30,0,30,0
1713332907346,EDS 201,A00,507315,Staff,26,0,30,4
1713332908372,EDS 203,A01,507317,Halter; Christopher P.,26,0,30,4
1713332909399,EDS 204R,A01,507319,Halter; Christopher P.,3,0,30,27
1713332909399,EDS 204R,B01,507331,Heinzman; Erica M.,28,0,30,2
1713332910423,EDS 206R,A00,507332,Staff,4,0,30,26
1713332910423,EDS 206R,B00,507343,Staff,28,0,30,2
1713332911454,EDS 250,A00,507344,Hemans; Patricia Ann Benitez,36,0,40,4
1713332912479,EDS 281,A00,507345,Daly; Alan J.,18,0,18,0
1713332913503,EDS 284,A00,507350,Daly; Alan J.,16,0,16,0
1713332914613,EDS 286,A00,507359,Fine; Sarah,18,0,18,0
1713332915638,EDS 289C,A01,507361,Daly; Alan J.,18,0,18,0
1713332916664,EDS 290,A00,507366,Hofstetter; Carolyn,15,0,15,0
1713332917697,LIGM 5A,A00,507421,Fischer-Grunski; Eva K,20,0,20,0
1713332918724,LIGM 5B,A00,507423,Fischer-Grunski; Eva K,20,0,20,0
1713332919750,LIGM 5C,A00,507425,Fischer-Grunski; Eva K,20,0,20,0
1713332920782,LIIT 5AS,A00,507427,Carnelos; Chiara,20,0,20,0
1713332921809,LIIT 5BS,A00,507430,Carnelos; Chiara,20,0,20,0
1713332922834,LIIT 5CS,A00,507432,Carnelos; Chiara,20,0,20,0
1713332923860,LISP 5A,A00,507541,Munoz Sanchez; Alicia,17,0,20,3
1713332924888,LISP 5B,A00,507671,Munoz Sanchez; Alicia,15,0,20,5
1713332925921,LISP 5C,A00,507696,Munoz Sanchez; Alicia,15,0,20,5
1713332926947,MAE 197,001,528363,Boechler; Nicholas Sebastia,9998,0,9999,1
1713332927973,MATH 197,001,523477,Kedlaya; Kiran S.,9999,0,9999,0
1713332927973,MATH 197,002,563811,Zhang; Danna,9999,0,9999,0
1713332928999,MCWP 40R,A00,518780,Staff,20,0,20,0
1713332928999,MCWP 40R,B00,518781,Staff,19,0,20,1
1713332928999,MCWP 40R,C00,518783,Staff,19,0,20,1
1713332930026,MCWP 50R,A00,518791,Staff,20,0,20,0
1713332930026,MCWP 50R,B00,518792,Staff,17,0,20,3
1713332930026,MCWP 50R,C00,518793,Staff,19,0,20,1
1713332930026,MCWP 50R,D00,518794,Staff,16,0,20,4
1713332930026,MCWP 50R,E00,518795,Staff,16,0,20,4
1713332930026,MCWP 50R,F00,518796,Staff,19,0,20,1
1713332930026,MCWP 50R,G00,518797,Staff,19,0,20,1
1713332931113,MMW 12R,A01,514034,Herbst; Matthew,15,0,16,1
1713332931113,MMW 12R,A02,514035,Herbst; Matthew,16,0,16,0
1713332932138,MMW 13R,A01,514037,Staff,12,0,16,4
1713332932138,MMW 13R,A02,514039,Staff,16,0,16,0
1713332934193,SIO 295LS,A00,523233,Staff,19,0,30,11
1713332935222,SIO 295S,A00,523232,Staff,19,0,30,11
1713332936249,SOCI 117,A01,494376,Staff,2,0,5,3
1713332937274,WES 237B,A00,494380,Staff,19,0,20,1
1713332939337,AESE 279B,A00,494370,Wade; Jon P,33,0,33,0
1713332940365,ANAR 135S,A00,494369,Braswell; Geoffrey E.,0,0,0,0
1713332941395,CAT 124RS,A01,519847,Geibel; William,17,0,20,3
1713332942419,CAT 125RS,A01,515971,Geibel; William,17,0,20,3
1713332943444,CLRE 250,A00,511389,Morris; Sheldon,9996,0,9999,3
1713332944470,CLRE 251,A00,507176,Mehta; Ravindra L.,9996,0,9999,3
1713332944470,CLRE 251,B00,511410,Mehta; Ravindra L.,9998,0,9999,1
1713332945499,CLRE 252,A00,507189,Cuomo; Raphael Eduardo,9998,0,9999,1
1713332946524,CLRE 253,A00,507199,Vaida; Florin,9997,0,9999,2
1713332946524,CLRE 253,B00,507202,Vaida; Florin,9999,0,9999,0
1713332947549,CLRE 259,A00,507211,Patel; Hemal,9996,0,9999,3
1713332948575,CLRE 260,A00,507221,Cuomo; Raphael Eduardo,9999,0,9999,0
1713332949600,CLRE 297,001,507242,Cuomo; Raphael Eduardo,9999,0,9999,0
1713332950629,CSE 191,A00,516875,Minnes Kemp; Mor Mia,9999,0,9999,0
1713332951657,CSS 201S,A01,494383,Staff,35,0,35,0
1713332952684,CSS 202S,A01,494387,Staff,35,0,35,0
1713332953710,EAP 100,A00,516065,Staff,9792,0,9999,207
1713332954737,ECE 45,A01,507414,Staff,51,0,60,9
1713332955763,ECE 100,A01,507416,Baghdadchi; Saharnaz,10,0,20,10
1713332955763,ECE 100,A02,507418,Baghdadchi; Saharnaz,20,0,20,0
1713332956792,ECE 111,A01,507420,Staff,38,0,50,12
1713332957818,ECE 197,001,548057,Sievenpiper; Daniel F.,9998,0,9999,1
1713332958845,EDS 115,A00,507243,Choi; Bailey Miyeon,28,0,28,0
1713332959874,EDS 117,A01,494379,Staff,23,0,25,2
1713332960898,EDS 125,A00,507246,Hopkins; Megan Beth,29,0,30,1
1713332961927,EDS 128A,A01,507264,Fargason; Sharon Gayle,26,0,26,0
1713332962959,EDS 128B,A01,507293,Pappas; Elizabeth,30,0,30,0
1713332963984,EDS 139,A00,507294,Fargason; Sharon Gayle,30,0,30,0
1713332963984,EDS 139,B00,507313,Pappas; Elizabeth,30,0,30,0
1713332965013,EDS 201,A00,507315,Staff,26,0,30,4
1713332966042,EDS 203,A01,507317,Halter; Christopher P.,26,0,30,4
1713332967067,EDS 204R,A01,507319,Halter; Christopher P.,3,0,30,27
1713332967067,EDS 204R,B01,507331,Heinzman; Erica M.,28,0,30,2
1713332968093,EDS 206R,A00,507332,Staff,4,0,30,26
1713332968093,EDS 206R,B00,507343,Staff,28,0,30,2
1713332969122,EDS 250,A00,507344,Hemans; Patricia Ann Benitez,36,0,40,4
1713332970147,EDS 281,A00,507345,Daly; Alan J.,18,0,18,0
1713332971174,EDS 284,A00,507350,Daly; Alan J.,16,0,16,0
1713332972205,EDS 286,A00,507359,Fine; Sarah,18,0,18,0
1713332973230,EDS 289C,A01,507361,Daly; Alan J.,18,0,18,0
1713332974259,EDS 290,A00,507366,Hofstetter; Carolyn,15,0,15,0
1713332975290,LIGM 5A,A00,507421,Fischer-Grunski; Eva K,20,0,20,0
1713332976315,LIGM 5B,A00,507423,Fischer-Grunski; Eva K,20,0,20,0
1713332977341,LIGM 5C,A00,507425,Fischer-Grunski; Eva K,20,0,20,0
1713332978367,LIIT 5AS,A00,507427,Carnelos; Chiara,20,0,20,0
1713332979395,LIIT 5BS,A00,507430,Carnelos; Chiara,20,0,20,0
1713332980421,LIIT 5CS,A00,507432,Carnelos; Chiara,20,0,20,0
1713332981447,LISP 5A,A00,507541,Munoz Sanchez; Alicia,17,0,20,3
1713332982471,LISP 5B,A00,507671,Munoz Sanchez; Alicia,15,0,20,5
1713332983497,LISP 5C,A00,507696,Munoz Sanchez; Alicia,15,0,20,5
1713332984523,MAE 197,001,528363,Boechler; Nicholas Sebastia,9998,0,9999,1
1713332985548,MATH 197,001,523477,Kedlaya; Kiran S.,9999,0,9999,0
1713332985548,MATH 197,002,563811,Zhang; Danna,9999,0,9999,0
1713332986573,MCWP 40R,A00,518780,Staff,20,0,20,0
1713332986573,MCWP 40R,B00,518781,Staff,19,0,20,1
1713332986573,MCWP 40R,C00,518783,Staff,19,0,20,1
1713332987599,MCWP 50R,A00,518791,Staff,20,0,20,0
1713332987599,MCWP 50R,B00,518792,Staff,17,0,20,3
1713332987599,MCWP 50R,C00,518793,Staff,19,0,20,1
1713332987599,MCWP 50R,D00,518794,Staff,16,0,20,4
1713332987599,MCWP 50R,E00,518795,Staff,16,0,20,4
1713332987599,MCWP 50R,F00,518796,Staff,19,0,20,1
1713332987599,MCWP 50R,G00,518797,Staff,19,0,20,1
1713332988625,MMW 12R,A01,514034,Herbst; Matthew,15,0,16,1
1713332988625,MMW 12R,A02,514035,Herbst; Matthew,16,0,16,0
1713332989651,MMW 13R,A01,514037,Staff,12,0,16,4
1713332989651,MMW 13R,A02,514039,Staff,16,0,16,0
1713332991704,SIO 295LS,A00,523233,Staff,19,0,30,11
1713332992729,SIO 295S,A00,523232,Staff,19,0,30,11
1713332993755,SOCI 117,A01,494376,Staff,2,0,5,3
1713332994781,WES 237B,A00,494380,Staff,19,0,20,1
1713332996844,AESE 279B,A00,494370,Wade; Jon P,33,0,33,0
1713332997869,ANAR 135S,A00,494369,Braswell; Geoffrey E.,0,0,0,0
1713332998894,CAT 124RS,A01,519847,Geibel; William,17,0,20,3
1713332999925,CAT 125RS,A01,515971,Geibel; William,17,0,20,3
1713333000954,CLRE 250,A00,511389,Morris; Sheldon,9996,0,9999,3
1713333001989,CLRE 251,A00,507176,Mehta; Ravindra L.,9996,0,9999,3
1713333001989,CLRE 251,B00,511410,Mehta; Ravindra L.,9998,0,9999,1
1713333003019,CLRE 252,A00,507189,Cuomo; Raphael Eduardo,9998,0,9999,1
1713333004049,CLRE 253,A00,507199,Vaida; Florin,9997,0,9999,2
1713333004049,CLRE 253,B00,507202,Vaida; Florin,9999,0,9999,0
1713333005080,CLRE 259,A00,507211,Patel; Hemal,9996,0,9999,3
1713333006105,CLRE 260,A00,507221,Cuomo; Raphael Eduardo,9999,0,9999,0
1713333007130,CLRE 297,001,507242,Cuomo; Raphael Eduardo,9999,0,9999,0
1713333008156,CSE 191,A00,516875,Minnes Kemp; Mor Mia,9999,0,9999,0
1713333009211,CSS 201S,A01,494383,Staff,35,0,35,0
1713333010240,CSS 202S,A01,494387,Staff,35,0,35,0
1713333011265,EAP 100,A00,516065,Staff,9792,0,9999,207
1713333012294,ECE 45,A01,507414,Staff,51,0,60,9
1713333013319,ECE 100,A01,507416,Baghdadchi; Saharnaz,10,0,20,10
1713333013319,ECE 100,A02,507418,Baghdadchi; Saharnaz,20,0,20,0
1713333014344,ECE 111,A01,507420,Staff,38,0,50,12
1713333015372,ECE 197,001,548057,Sievenpiper; Daniel F.,9998,0,9999,1
1713333016397,EDS 115,A00,507243,Choi; Bailey Miyeon,28,0,28,0
1713333017423,EDS 117,A01,494379,Staff,23,0,25,2
1713333018450,EDS 125,A00,507246,Hopkins; Megan Beth,29,0,30,1
1713333019479,EDS 128A,A01,507264,Fargason; Sharon Gayle,26,0,26,0
1713333020510,EDS 128B,A01,507293,Pappas; Elizabeth,30,0,30,0
1713333021534,EDS 139,A00,507294,Fargason; Sharon Gayle,30,0,30,0
1713333021534,EDS 139,B00,507313,Pappas; Elizabeth,30,0,30,0
1713333022562,EDS 201,A00,507315,Staff,26,0,30,4
1713333023592,EDS 203,A01,507317,Halter; Christopher P.,26,0,30,4
1713333024617,EDS 204R,A01,507319,Halter; Christopher P.,3,0,30,27
1713333024617,EDS 204R,B01,507331,Heinzman; Erica M.,28,0,30,2
1713333025642,EDS 206R,A00,507332,Staff,4,0,30,26
1713333025642,EDS 206R,B00,507343,Staff,28,0,30,2
1713333026667,EDS 250,A00,507344,Hemans; Patricia Ann Benitez,36,0,40,4
1713333027693,EDS 281,A00,507345,Daly; Alan J.,18,0,18,0
1713333028717,EDS 284,A00,507350,Daly; Alan J.,16,0,16,0
1713333029747,EDS 286,A00,507359,Fine; Sarah,18,0,18,0
1713333030775,EDS 289C,A01,507361,Daly; Alan J.,18,0,18,0
1713333031800,EDS 290,A00,507366,Hofstetter; Carolyn,15,0,15,0
1713333032831,LIGM 5A,A00,507421,Fischer-Grunski; Eva K,20,0,20,0
1713333033860,LIGM 5B,A00,507423,Fischer-Grunski; Eva K,20,0,20,0
1713333034940,LIGM 5C,A00,507425,Fischer-Grunski; Eva K,20,0,20,0
1713333035971,LIIT 5AS,A00,507427,Carnelos; Chiara,20,0,20,0
1713333036997,LIIT 5BS,A00,507430,Carnelos; Chiara,20,0,20,0
1713333038027,LIIT 5CS,A00,507432,Carnelos; Chiara,20,0,20,0
1713333039057,LISP 5A,A00,507541,Munoz Sanchez; Alicia,17,0,20,3
1713333040088,LISP 5B,A00,507671,Munoz Sanchez; Alicia,15,0,20,5
1713333041113,LISP 5C,A00,507696,Munoz Sanchez; Alicia,15,0,20,5
1713333042139,MAE 197,001,528363,Boechler; Nicholas Sebastia,9998,0,9999,1
1713333043172,MATH 197,001,523477,Kedlaya; Kiran S.,9999,0,9999,0
1713333043172,MATH 197,002,563811,Zhang; Danna,9999,0,9999,0
1713333044202,MCWP 40R,A00,518780,Staff,20,0,20,0
1713333044202,MCWP 40R,B00,518781,Staff,19,0,20,1
1713333044202,MCWP 40R,C00,518783,Staff,19,0,20,1
1713333045228,MCWP 50R,A00,518791,Staff,20,0,20,0
1713333045228,MCWP 50R,B00,518792,Staff,17,0,20,3
1713333045228,MCWP 50R,C00,518793,Staff,19,0,20,1
1713333045228,MCWP 50R,D00,518794,Staff,16,0,20,4
1713333045228,MCWP 50R,E00,518795,Staff,16,0,20,4
1713333045228,MCWP 50R,F00,518796,Staff,19,0,20,1
1713333045228,MCWP 50R,G00,518797,Staff,19,0,20,1
1713333046253,MMW 12R,A01,514034,Herbst; Matthew,15,0,16,1
1713333046253,MMW 12R,A02,514035,Herbst; Matthew,16,0,16,0
1713333047278,MMW 13R,A01,514037,Staff,12,0,16,4
1713333047278,MMW 13R,A02,514039,Staff,16,0,16,0
1713333049330,SIO 295LS,A00,523233,Staff,19,0,30,11
1713333050359,SIO 295S,A00,523232,Staff,19,0,30,11
1713333051384,SOCI 117,A01,494376,Staff,2,0,5,3
1713333052420,WES 237B,A00,494380,Staff,19,0,20,1
1713333054482,AESE 279B,A00,494370,Wade; Jon P,33,0,33,0
1713333055508,ANAR 135S,A00,494369,Braswell; Geoffrey E.,0,0,0,0
1713333056533,CAT 124RS,A01,519847,Geibel; William,17,0,20,3
1713333057559,CAT 125RS,A01,515971,Geibel; William,17,0,20,3
1713333058585,CLRE 250,A00,511389,Morris; Sheldon,9996,0,9999,3
1713333059617,CLRE 251,A00,507176,Mehta; Ravindra L.,9996,0,9999,3
1713333059617,CLRE 251,B00,511410,Mehta; Ravindra L.,9998,0,9999,1
1713333060644,CLRE 252,A00,507189,Cuomo; Raphael Eduardo,9998,0,9999,1
1713333061671,CLRE 253,A00,507199,Vaida; Florin,9997,0,9999,2
1713333061671,CLRE 253,B00,507202,Vaida; Florin,9999,0,9999,0
1713333062698,CLRE 259,A00,507211,Patel; Hemal,9996,0,9999,3
1713333063726,CLRE 260,A00,507221,Cuomo; Raphael Eduardo,9999,0,9999,0
1713333064752,CLRE 297,001,507242,Cuomo; Raphael Eduardo,9999,0,9999,0
1713333065777,CSE 191,A00,516875,Minnes Kemp; Mor Mia,9999,0,9999,0
1713333066802,CSS 201S,A01,494383,Staff,35,0,35,0
1713333067827,CSS 202S,A01,494387,Staff,35,0,35,0
1713333068856,EAP 100,A00,516065,Staff,9792,0,9999,207
1713333069883,ECE 45,A01,507414,Staff,51,0,60,9
1713333070908,ECE 100,A01,507416,Baghdadchi; Saharnaz,10,0,20,10
1713333070908,ECE 100,A02,507418,Baghdadchi; Saharnaz,20,0,20,0
1713333071934,ECE 111,A01,507420,Staff,38,0,50,12
1713333072965,ECE 197,001,548057,Sievenpiper; Daniel F.,9998,0,9999,1
1713333073997,EDS 115,A00,507243,Choi; Bailey Miyeon,28,0,28,0
1713333075022,EDS 117,A01,494379,Staff,23,0,25,2
1713333076052,EDS 125,A00,507246,Hopkins; Megan Beth,29,0,30,1
1713333077084,EDS 128A,A01,507264,Fargason; Sharon Gayle,26,0,26,0
1713333078111,EDS 128B,A01,507293,Pappas; Elizabeth,30,0,30,0
1713333079139,EDS 139,A00,507294,Fargason; Sharon Gayle,30,0,30,0
1713333079139,EDS 139,B00,507313,Pappas; Elizabeth,30,0,30,0
1713333080163,EDS 201,A00,507315,Staff,26,0,30,4
1713333081193,EDS 203,A01,507317,Halter; Christopher P.,26,0,30,4
1713333082219,EDS 204R,A01,507319,Halter; Christopher P.,3,0,30,27
1713333082219,EDS 204R,B01,507331,Heinzman; Erica M.,28,0,30,2
1713333083243,EDS 206R,A00,507332,Staff,4,0,30,26
1713333083243,EDS 206R,B00,507343,Staff,28,0,30,2
1713333084272,EDS 250,A00,507344,Hemans; Patricia Ann Benitez,36,0,40,4
1713333085298,EDS 281,A00,507345,Daly; Alan J.,18,0,18,0
1713333086323,EDS 284,A00,507350,Daly; Alan J.,16,0,16,0
1713333087346,EDS 286,A00,507359,Fine; Sarah,18,0,18,0
1713333088371,EDS 289C,A01,507361,Daly; Alan J.,18,0,18,0
1713333089397,EDS 290,A00,507366,Hofstetter; Carolyn,15,0,15,0
1713333090427,LIGM 5A,A00,507421,Fischer-Grunski; Eva K,20,0,20,0
1713333091451,LIGM 5B,A00,507423,Fischer-Grunski; Eva K,20,0,20,0
1713333092477,LIGM 5C,A00,507425,Fischer-Grunski; Eva K,20,0,20,0
1713333093506,LIIT 5AS,A00,507427,Carnelos; Chiara,20,0,20,0
1713333094532,LIIT 5BS,A00,507430,Carnelos; Chiara,20,0,20,0
1713333095561,LIIT 5CS,A00,507432,Carnelos; Chiara,20,0,20,0
1713333096591,LISP 5A,A00,507541,Munoz Sanchez; Alicia,17,0,20,3
1713333097619,LISP 5B,A00,507671,Munoz Sanchez; Alicia,15,0,20,5
1713333098648,LISP 5C,A00,507696,Munoz Sanchez; Alicia,15,0,20,5
1713333099678,MAE 197,001,528363,Boechler; Nicholas Sebastia,9998,0,9999,1
1713333100706,MATH 197,001,523477,Kedlaya; Kiran S.,9999,0,9999,0
1713333100706,MATH 197,002,563811,Zhang; Danna,9999,0,9999,0
1713333101733,MCWP 40R,A00,518780,Staff,20,0,20,0
1713333101733,MCWP 40R,B00,518781,Staff,19,0,20,1
1713333101733,MCWP 40R,C00,518783,Staff,19,0,20,1
1713333102760,MCWP 50R,A00,518791,Staff,20,0,20,0
1713333102760,MCWP 50R,B00,518792,Staff,17,0,20,3
1713333102760,MCWP 50R,C00,518793,Staff,19,0,20,1
1713333102760,MCWP 50R,D00,518794,Staff,16,0,20,4
1713333102760,MCWP 50R,E00,518795,Staff,16,0,20,4
1713333102760,MCWP 50R,F00,518796,Staff,19,0,20,1
1713333102760,MCWP 50R,G00,518797,Staff,19,0,20,1
1713333103784,MMW 12R,A01,514034,Herbst; Matthew,15,0,16,1
1713333103784,MMW 12R,A02,514035,Herbst; Matthew,16,0,16,0
1713333104811,MMW 13R,A01,514037,Staff,12,0,16,4
1713333104811,MMW 13R,A02,514039,Staff,16,0,16,0
1713333106861,SIO 295LS,A00,523233,Staff,19,0,30,11
1713333107889,SIO 295S,A00,523232,Staff,19,0,30,11
1713333108915,SOCI 117,A01,494376,Staff,2,0,5,3
1713333109940,WES 237B,A00,494380,Staff,19,0,20,1
1713333112012,AESE 279B,A00,494370,Wade; Jon P,33,0,33,0
1713333113038,ANAR 135S,A00,494369,Braswell; Geoffrey E.,0,0,0,0
1713333114069,CAT 124RS,A01,519847,Geibel; William,17,0,20,3
1713333115097,CAT 125RS,A01,515971,Geibel; William,17,0,20,3
1713333116123,CLRE 250,A00,511389,Morris; Sheldon,9996,0,9999,3
1713333117154,CLRE 251,A00,507176,Mehta; Ravindra L.,9996,0,9999,3
1713333117154,CLRE 251,B00,511410,Mehta; Ravindra L.,9998,0,9999,1
1713333118178,CLRE 252,A00,507189,Cuomo; Raphael Eduardo,9998,0,9999,1
1713333119205,CLRE 253,A00,507199,Vaida; Florin,9997,0,9999,2
1713333119205,CLRE 253,B00,507202,Vaida; Florin,9999,0,9999,0
1713333120235,CLRE 259,A00,507211,Patel; Hemal,9996,0,9999,3
1713333121267,CLRE 260,A00,507221,Cuomo; Raphael Eduardo,9999,0,9999,0
1713333122296,CLRE 297,001,507242,Cuomo; Raphael Eduardo,9999,0,9999,0
1713333123326,CSE 191,A00,516875,Minnes Kemp; Mor Mia,9999,0,9999,0
1713333124352,CSS 201S,A01,494383,Staff,35,0,35,0
1713333125377,CSS 202S,A01,494387,Staff,35,0,35,0
1713333126401,EAP 100,A00,516065,Staff,9792,0,9999,207
1713333127429,ECE 45,A01,507414,Staff,51,0,60,9
1713333128454,ECE 100,A01,507416,Baghdadchi; Saharnaz,10,0,20,10
1713333128454,ECE 100,A02,507418,Baghdadchi; Saharnaz,20,0,20,0
1713333129478,ECE 111,A01,507420,Staff,38,0,50,12
1713333130505,ECE 197,001,548057,Sievenpiper; Daniel F.,9998,0,9999,1
1713333131536,EDS 115,A00,507243,Choi; Bailey Miyeon,28,0,28,0
1713333132561,EDS 117,A01,494379,Staff,23,0,25,2
1713333133588,EDS 125,A00,507246,Hopkins; Megan Beth,29,0,30,1
1713333134620,EDS 128A,A01,507264,Fargason; Sharon Gayle,26,0,26,0
1713333135644,EDS 128B,A01,507293,Pappas; Elizabeth,30,0,30,0
1713333136672,EDS 139,A00,507294,Fargason; Sharon Gayle,30,0,30,0
1713333136672,EDS 139,B00,507313,Pappas; Elizabeth,30,0,30,0
1713333137697,EDS 201,A00,507315,Staff,26,0,30,4
1713333138778,EDS 203,A01,507317,Halter; Christopher P.,26,0,30,4
1713333139809,EDS 204R,A01,507319,Halter; Christopher P.,3,0,30,27
1713333139809,EDS 204R,B01,507331,Heinzman; Erica M.,28,0,30,2
1713333140834,EDS 206R,A00,507332,Staff,4,0,30,26
1713333140834,EDS 206R,B00,507343,Staff,28,0,30,2
1713333141861,EDS 250,A00,507344,Hemans; Patricia Ann Benitez,36,0,40,4
1713333142885,EDS 281,A00,507345,Daly; Alan J.,18,0,18,0
1713333143910,EDS 284,A00,507350,Daly; Alan J.,16,0,16,0
1713333144935,EDS 286,A00,507359,Fine; Sarah,18,0,18,0
1713333145963,EDS 289C,A01,507361,Daly; Alan J.,18,0,18,0
1713333146991,EDS 290,A00,507366,Hofstetter; Carolyn,15,0,15,0
1713333148022,LIGM 5A,A00,507421,Fischer-Grunski; Eva K,20,0,20,0
1713333149046,LIGM 5B,A00,507423,Fischer-Grunski; Eva K,20,0,20,0
1713333150075,LIGM 5C,A00,507425,Fischer-Grunski; Eva K,20,0,20,0
1713333151105,LIIT 5AS,A00,507427,Carnelos; Chiara,20,0,20,0
1713333152130,LIIT 5BS,A00,507430,Carnelos; Chiara,20,0,20,0
1713333153160,LIIT 5CS,A00,507432,Carnelos; Chiara,20,0,20,0
1713333154185,LISP 5A,A00,507541,Munoz Sanchez; Alicia,17,0,20,3
1713333155213,LISP 5B,A00,507671,Munoz Sanchez; Alicia,15,0,20,5
1713333156237,LISP 5C,A00,507696,Munoz Sanchez; Alicia,15,0,20,5
1713333157269,MAE 197,001,528363,Boechler; Nicholas Sebastia,9998,0,9999,1
1713333158295,MATH 197,001,523477,Kedlaya; Kiran S.,9999,0,9999,0
1713333158295,MATH 197,002,563811,Zhang; Danna,9999,0,9999,0
1713333159322,MCWP 40R,A00,518780,Staff,20,0,20,0
1713333159322,MCWP 40R,B00,518781,Staff,19,0,20,1
1713333159322,MCWP 40R,C00,518783,Staff,19,0,20,1
1713333160352,MCWP 50R,A00,518791,Staff,20,0,20,0
1713333160352,MCWP 50R,B00,518792,Staff,17,0,20,3
1713333160352,MCWP 50R,C00,518793,Staff,19,0,20,1
1713333160352,MCWP 50R,D00,518794,Staff,16,0,20,4
1713333160352,MCWP 50R,E00,518795,Staff,16,0,20,4
1713333160352,MCWP 50R,F00,518796,Staff,19,0,20,1
1713333160352,MCWP 50R,G00,518797,Staff,19,0,20,1
1713333161378,MMW 12R,A01,514034,Herbst; Matthew,15,0,16,1
1713333161378,MMW 12R,A02,514035,Herbst; Matthew,16,0,16,0
1713333162404,MMW 13R,A01,514037,Staff,12,0,16,4
1713333162404,MMW 13R,A02,514039,Staff,16,0,16,0
1713333164454,SIO 295LS,A00,523233,Staff,19,0,30,11
1713333165481,SIO 295S,A00,523232,Staff,19,0,30,11
1713333166514,SOCI 117,A01,494376,Staff,2,0,5,3
1713333167539,WES 237B,A00,494380,Staff,19,0,20,1
1713333169598,AESE 279B,A00,494370,Wade; Jon P,33,0,33,0
1713333170623,ANAR 135S,A00,494369,Braswell; Geoffrey E.,0,0,0,0
1713333171648,CAT 124RS,A01,519847,Geibel; William,17,0,20,3
1713333172672,CAT 125RS,A01,515971,Geibel; William,17,0,20,3
1713333173698,CLRE 250,A00,511389,Morris; Sheldon,9996,0,9999,3
1713333174725,CLRE 251,A00,507176,Mehta; Ravindra L.,9996,0,9999,3
1713333174725,CLRE 251,B00,511410,Mehta; Ravindra L.,9998,0,9999,1
1713333175750,CLRE 252,A00,507189,Cuomo; Raphael Eduardo,9998,0,9999,1
1713333176776,CLRE 253,A00,507199,Vaida; Florin,9997,0,9999,2
1713333176776,CLRE 253,B00,507202,Vaida; Florin,9999,0,9999,0
1713333177801,CLRE 259,A00,507211,Patel; Hemal,9996,0,9999,3
1713333178827,CLRE 260,A00,507221,Cuomo; Raphael Eduardo,9999,0,9999,0
1713333179853,CLRE 297,001,507242,Cuomo; Raphael Eduardo,9999,0,9999,0
1713333180878,CSE 191,A00,516875,Minnes Kemp; Mor Mia,9999,0,9999,0
1713333181904,CSS 201S,A01,494383,Staff,35,0,35,0
1713333182933,CSS 202S,A01,494387,Staff,35,0,35,0
1713333183960,EAP 100,A00,516065,Staff,9792,0,9999,207
1713333184987,ECE 45,A01,507414,Staff,51,0,60,9
1713333186011,ECE 100,A01,507416,Baghdadchi; Saharnaz,10,0,20,10
1713333186011,ECE 100,A02,507418,Baghdadchi; Saharnaz,20,0,20,0
1713333187036,ECE 111,A01,507420,Staff,38,0,50,12
1713333188060,ECE 197,001,548057,Sievenpiper; Daniel F.,9998,0,9999,1
1713333189085,EDS 115,A00,507243,Choi; Bailey Miyeon,28,0,28,0
1713333190114,EDS 117,A01,494379,Staff,23,0,25,2
1713333191141,EDS 125,A00,507246,Hopkins; Megan Beth,29,0,30,1
1713333192169,EDS 128A,A01,507264,Fargason; Sharon Gayle,26,0,26,0
1713333193194,EDS 128B,A01,507293,Pappas; Elizabeth,30,0,30,0
1713333194217,EDS 139,A00,507294,Fargason; Sharon Gayle,30,0,30,0
1713333194217,EDS 139,B00,507313,Pappas; Elizabeth,30,0,30,0
1713333195241,EDS 201,A00,507315,Staff,26,0,30,4
1713333196265,EDS 203,A01,507317,Halter; Christopher P.,26,0,30,4
1713333197293,EDS 204R,A01,507319,Halter; Christopher P.,3,0,30,27
1713333197293,EDS 204R,B01,507331,Heinzman; Erica M.,28,0,30,2
1713333198317,EDS 206R,A00,507332,Staff,4,0,30,26
1713333198317,EDS 206R,B00,507343,Staff,28,0,30,2
1713333199345,EDS 250,A00,507344,Hemans; Patricia Ann Benitez,36,0,40,4
1713333200369,EDS 281,A00,507345,Daly; Alan J.,18,0,18,0
1713333201393,EDS 284,A00,507350,Daly; Alan J.,16,0,16,0
1713333202417,EDS 286,A00,507359,Fine; Sarah,18,0,18,0
1713333203442,EDS 289C,A01,507361,Daly; Alan J.,18,0,18,0
1713333204466,EDS 290,A00,507366,Hofstetter; Carolyn,15,0,15,0
1713333205493,LIGM 5A,A00,507421,Fischer-Grunski; Eva K,20,0,20,0
1713333206518,LIGM 5B,A00,507423,Fischer-Grunski; Eva K,20,0,20,0
1713333207543,LIGM 5C,A00,507425,Fischer-Grunski; Eva K,20,0,20,0
1713333208567,LIIT 5AS,A00,507427,Carnelos; Chiara,20,0,20,0
1713333209593,LIIT 5BS,A00,507430,Carnelos; Chiara,20,0,20,0
1713333210623,LIIT 5CS,A00,507432,Carnelos; Chiara,20,0,20,0
1713333211649,LISP 5A,A00,507541,Munoz Sanchez; Alicia,17,0,20,3
1713333212680,LISP 5B,A00,507671,Munoz Sanchez; Alicia,15,0,20,5
1713333213709,LISP 5C,A00,507696,Munoz Sanchez; Alicia,15,0,20,5
1713333214734,MAE 197,001,528363,Boechler; Nicholas Sebastia,9998,0,9999,1
1713333215763,MATH 197,001,523477,Kedlaya; Kiran S.,9999,0,9999,0
1713333215763,MATH 197,002,563811,Zhang; Danna,9999,0,9999,0
1713333216788,MCWP 40R,A00,518780,Staff,20,0,20,0
1713333216788,MCWP 40R,B00,518781,Staff,19,0,20,1
1713333216788,MCWP 40R,C00,518783,Staff,19,0,20,1
1713333217812,MCWP 50R,A00,518791,Staff,20,0,20,0
1713333217812,MCWP 50R,B00,518792,Staff,17,0,20,3
1713333217812,MCWP 50R,C00,518793,Staff,19,0,20,1
1713333217812,MCWP 50R,D00,518794,Staff,16,0,20,4
1713333217812,MCWP 50R,E00,518795,Staff,16,0,20,4
1713333217812,MCWP 50R,F00,518796,Staff,19,0,20,1
1713333217812,MCWP 50R,G00,518797,Staff,19,0,20,1
1713333218838,MMW 12R,A01,514034,Herbst; Matthew,15,0,16,1
1713333218838,MMW 12R,A02,514035,Herbst; Matthew,16,0,16,0
1713333219863,MMW 13R,A01,514037,Staff,12,0,16,4
1713333219863,MMW 13R,A02,514039,Staff,16,0,16,0
1713333221916,SIO 295LS,A00,523233,Staff,19,0,30,11
1713333222943,SIO 295S,A00,523232,Staff,19,0,30,11
1713333223969,SOCI 117,A01,494376,Staff,2,0,5,3
1713333224997,WES 237B,A00,494380,Staff,19,0,20,1
1713333227062,AESE 279B,A00,494370,Wade; Jon P,33,0,33,0
1713333228089,ANAR 135S,A00,494369,Braswell; Geoffrey E.,0,0,0,0
1713333229114,CAT 124RS,A01,519847,Geibel; William,17,0,20,3
1713333230143,CAT 125RS,A01,515971,Geibel; William,17,0,20,3
1713333231173,CLRE 250,A00,511389,Morris; Sheldon,9996,0,9999,3
1713333232199,CLRE 251,A00,507176,Mehta; Ravindra L.,9996,0,9999,3
1713333232199,CLRE 251,B00,511410,Mehta; Ravindra L.,9998,0,9999,1
1713333233231,CLRE 252,A00,507189,Cuomo; Raphael Eduardo,9998,0,9999,1
1713333234259,CLRE 253,A00,507199,Vaida; Florin,9997,0,9999,2
1713333234259,CLRE 253,B00,507202,Vaida; Florin,9999,0,9999,0
1713333235285,CLRE 259,A00,507211,Patel; Hemal,9996,0,9999,3
1713333236309,CLRE 260,A00,507221,Cuomo; Raphael Eduardo,9999,0,9999,0
1713333237333,CLRE 297,001,507242,Cuomo; Raphael Eduardo,9999,0,9999,0
1713333238361,CSE 191,A00,516875,Minnes Kemp; Mor Mia,9999,0,9999,0
1713333239389,CSS 201S,A01,494383,Staff,35,0,35,0
1713333240413,CSS 202S,A01,494387,Staff,35,0,35,0
1713333241436,EAP 100,A00,516065,Staff,9792,0,9999,207
1713333242519,ECE 45,A01,507414,Staff,51,0,60,9
1713333243544,ECE 100,A01,507416,Baghdadchi; Saharnaz,10,0,20,10
1713333243544,ECE 100,A02,507418,Baghdadchi; Saharnaz,20,0,20,0
1713333244568,ECE 111,A01,507420,Staff,38,0,50,12
1713333245594,ECE 197,001,548057,Sievenpiper; Daniel F.,9998,0,9999,1
1713333246620,EDS 115,A00,507243,Choi; Bailey Miyeon,28,0,28,0
1713333247645,EDS 117,A01,494379,Staff,23,0,25,2
1713333248673,EDS 125,A00,507246,Hopkins; Megan Beth,29,0,30,1
1713333249703,EDS 128A,A01,507264,Fargason; Sharon Gayle,26,0,26,0
1713333250733,EDS 128B,A01,507293,Pappas; Elizabeth,30,0,30,0
1713333251757,EDS 139,A00,507294,Fargason; Sharon Gayle,30,0,30,0
1713333251757,EDS 139,B00,507313,Pappas; Elizabeth,30,0,30,0
1713333252783,EDS 201,A00,507315,Staff,26,0,30,4
1713333253809,EDS 203,A01,507317,Halter; Christopher P.,26,0,30,4
1713333254834,EDS 204R,A01,507319,Halter; Christopher P.,3,0,30,27
1713333254834,EDS 204R,B01,507331,Heinzman; Erica M.,28,0,30,2
1713333255858,EDS 206R,A00,507332,Staff,4,0,30,26
1713333255858,EDS 206R,B00,507343,Staff,28,0,30,2
1713333256883,EDS 250,A00,507344,Hemans; Patricia Ann Benitez,36,0,40,4
1713333257908,EDS 281,A00,507345,Daly; Alan J.,18,0,18,0
1713333258932,EDS 284,A00,507350,Daly; Alan J.,16,0,16,0
1713333259956,EDS 286,A00,507359,Fine; Sarah,18,0,18,0
1713333260981,EDS 289C,A01,507361,Daly; Alan J.,18,0,18,0
1713333262009,EDS 290,A00,507366,Hofstetter; Carolyn,15,0,15,0
1713333263038,LIGM 5A,A00,507421,Fischer-Grunski; Eva K,20,0,20,0
1713333264067,LIGM 5B,A00,507423,Fischer-Grunski; Eva K,20,0,20,0
1713333265092,LIGM 5C,A00,507425,Fischer-Grunski; Eva K,20,0,20,0
1713333266118,LIIT 5AS,A00,507427,Carnelos; Chiara,20,0,20,0
1713333267147,LIIT 5BS,A00,507430,Carnelos; Chiara,20,0,20,0
1713333268172,LIIT 5CS,A00,507432,Carnelos; Chiara,20,0,20,0
1713333269197,LISP 5A,A00,507541,Munoz Sanchez; Alicia,17,0,20,3
1713333270221,LISP 5B,A00,507671,Munoz Sanchez; Alicia,15,0,20,5
1713333271246,LISP 5C,A00,507696,Munoz Sanchez; Alicia,15,0,20,5
1713333272274,MAE 197,001,528363,Boechler; Nicholas Sebastia,9998,0,9999,1
1713333273298,MATH 197,001,523477,Kedlaya; Kiran S.,9999,0,9999,0
1713333273298,MATH 197,002,563811,Zhang; Danna,9999,0,9999,0
1713333274326,MCWP 40R,A00,518780,Staff,20,0,20,0
1713333274326,MCWP 40R,B00,518781,Staff,19,0,20,1
1713333274326,MCWP 40R,C00,518783,Staff,19,0,20,1
1713333275352,MCWP 50R,A00,518791,Staff,20,0,20,0
1713333275352,MCWP 50R,B00,518792,Staff,17,0,20,3
1713333275352,MCWP 50R,C00,518793,Staff,19,0,20,1
1713333275352,MCWP 50R,D00,518794,Staff,16,0,20,4
1713333275352,MCWP 50R,E00,518795,Staff,16,0,20,4
1713333275352,MCWP 50R,F00,518796,Staff,19,0,20,1
1713333275352,MCWP 50R,G00,518797,Staff,19,0,20,1
1713333276378,MMW 12R,A01,514034,Herbst; Matthew,15,0,16,1
1713333276378,MMW 12R,A02,514035,Herbst; Matthew,16,0,16,0
1713333277403,MMW 13R,A01,514037,Staff,12,0,16,4
1713333277403,MMW 13R,A02,514039,Staff,16,0,16,0
1713333279457,SIO 295LS,A00,523233,Staff,19,0,30,11
1713333280482,SIO 295S,A00,523232,Staff,19,0,30,11
1713333281508,SOCI 117,A01,494376,Staff,2,0,5,3
1713333282535,WES 237B,A00,494380,Staff,19,0,20,1
1713333284610,AESE 279B,A00,494370,Wade; Jon P,33,0,33,0
1713333285640,ANAR 135S,A00,494369,Braswell; Geoffrey E.,0,0,0,0
1713333286668,CAT 124RS,A01,519847,Geibel; William,17,0,20,3
1713333287694,CAT 125RS,A01,515971,Geibel; William,17,0,20,3
1713333288724,CLRE 250,A00,511389,Morris; Sheldon,9996,0,9999,3
1713333289751,CLRE 251,A00,507176,Mehta; Ravindra L.,9996,0,9999,3
1713333289751,CLRE 251,B00,511410,Mehta; Ravindra L.,9998,0,9999,1
1713333290775,CLRE 252,A00,507189,Cuomo; Raphael Eduardo,9998,0,9999,1
1713333291805,CLRE 253,A00,507199,Vaida; Florin,9997,0,9999,2
1713333291805,CLRE 253,B00,507202,Vaida; Florin,9999,0,9999,0
1713333292831,CLRE 259,A00,507211,Patel; Hemal,9996,0,9999,3
1713333293859,CLRE 260,A00,507221,Cuomo; Raphael Eduardo,9999,0,9999,0
1713333294885,CLRE 297,001,507242,Cuomo; Raphael Eduardo,9999,0,9999,0
1713333295915,CSE 191,A00,516875,Minnes Kemp; Mor Mia,9999,0,9999,0
1713333296941,CSS 201S,A01,494383,Staff,35,0,35,0
1713333297969,CSS 202S,A01,494387,Staff,35,0,35,0
1713333298994,EAP 100,A00,516065,Staff,9792,0,9999,207
1713333300020,ECE 45,A01,507414,Staff,51,0,60,9
1713333301045,ECE 100,A01,507416,Baghdadchi; Saharnaz,10,0,20,10
1713333301045,ECE 100,A02,507418,Baghdadchi; Saharnaz,20,0,20,0
1713333302072,ECE 111,A01,507420,Staff,38,0,50,12
1713333303097,ECE 197,001,548057,Sievenpiper; Daniel F.,9998,0,9999,1
1713333304124,EDS 115,A00,507243,Choi; Bailey Miyeon,28,0,28,0
1713333305151,EDS 117,A01,494379,Staff,23,0,25,2
1713333306182,EDS 125,A00,507246,Hopkins; Megan Beth,29,0,30,1
1713333307209,EDS 128A,A01,507264,Fargason; Sharon Gayle,26,0,26,0
1713333308235,EDS 128B,A01,507293,Pappas; Elizabeth,30,0,30,0
1713333309260,EDS 139,A00,507294,Fargason; Sharon Gayle,30,0,30,0
1713333309260,EDS 139,B00,507313,Pappas; Elizabeth,30,0,30,0
1713333310287,EDS 201,A00,507315,Staff,26,0,30,4
1713333311318,EDS 203,A01,507317,Halter; Christopher P.,26,0,30,4
1713333312348,EDS 204R,A01,507319,Halter; Christopher P.,3,0,30,27
1713333312348,EDS 204R,B01,507331,Heinzman; Erica M.,28,0,30,2
1713333313377,EDS 206R,A00,507332,Staff,4,0,30,26
1713333313377,EDS 206R,B00,507343,Staff,28,0,30,2
1713333314407,EDS 250,A00,507344,Hemans; Patricia Ann Benitez,36,0,40,4
1713333315431,EDS 281,A00,507345,Daly; Alan J.,18,0,18,0
1713333316457,EDS 284,A00,507350,Daly; Alan J.,16,0,16,0
1713333317483,EDS 286,A00,507359,Fine; Sarah,18,0,18,0
1713333318508,EDS 289C,A01,507361,Daly; Alan J.,18,0,18,0
1713333319538,EDS 290,A00,507366,Hofstetter; Carolyn,15,0,15,0
1713333320568,LIGM 5A,A00,507421,Fischer-Grunski; Eva K,20,0,20,0
1713333321596,LIGM 5B,A00,507423,Fischer-Grunski; Eva K,20,0,20,0
1713333322626,LIGM 5C,A00,507425,Fischer-Grunski; Eva K,20,0,20,0
1713333323654,LIIT 5AS,A00,507427,Carnelos; Chiara,20,0,20,0
1713333324684,LIIT 5BS,A00,507430,Carnelos; Chiara,20,0,20,0
1713333325711,LIIT 5CS,A00,507432,Carnelos; Chiara,20,0,20,0
1713333326740,LISP 5A,A00,507541,Munoz Sanchez; Alicia,17,0,20,3
1713333327766,LISP 5B,A00,507671,Munoz Sanchez; Alicia,15,0,20,5
1713333328795,LISP 5C,A00,507696,Munoz Sanchez; Alicia,15,0,20,5
1713333329821,MAE 197,001,528363,Boechler; Nicholas Sebastia,9998,0,9999,1
1713333330848,MATH 197,001,523477,Kedlaya; Kiran S.,9999,0,9999,0
1713333330848,MATH 197,002,563811,Zhang; Danna,9999,0,9999,0
1713333331879,MCWP 40R,A00,518780,Staff,20,0,20,0
1713333331879,MCWP 40R,B00,518781,Staff,19,0,20,1
1713333331879,MCWP 40R,C00,518783,Staff,19,0,20,1
1713333332905,MCWP 50R,A00,518791,Staff,20,0,20,0
1713333332905,MCWP 50R,B00,518792,Staff,17,0,20,3
1713333332905,MCWP 50R,C00,518793,Staff,19,0,20,1
1713333332905,MCWP 50R,D00,518794,Staff,16,0,20,4
1713333332905,MCWP 50R,E00,518795,Staff,16,0,20,4
1713333332905,MCWP 50R,F00,518796,Staff,19,0,20,1
1713333332905,MCWP 50R,G00,518797,Staff,19,0,20,1
1713333333935,MMW 12R,A01,514034,Herbst; Matthew,15,0,16,1
1713333333935,MMW 12R,A02,514035,Herbst; Matthew,16,0,16,0
1713333334968,MMW 13R,A01,514037,Staff,12,0,16,4
1713333334968,MMW 13R,A02,514039,Staff,16,0,16,0
1713333337016,SIO 295LS,A00,523233,Staff,19,0,30,11
1713333338044,SIO 295S,A00,523232,Staff,19,0,30,11
1713333339069,SOCI 117,A01,494376,Staff,2,0,5,3
1713333340095,WES 237B,A00,494380,Staff,19,0,20,1
1713333342172,AESE 279B,A00,494370,Wade; Jon P,33,0,33,0
1713333343196,ANAR 135S,A00,494369,Braswell; Geoffrey E.,0,0,0,0
1713333344222,CAT 124RS,A01,519847,Geibel; William,17,0,20,3
1713333345247,CAT 125RS,A01,515971,Geibel; William,17,0,20,3
1713333346327,CLRE 250,A00,511389,Morris; Sheldon,9996,0,9999,3
1713333347354,CLRE 251,A00,507176,Mehta; Ravindra L.,9996,0,9999,3
1713333347354,CLRE 251,B00,511410,Mehta; Ravindra L.,9998,0,9999,1
1713333348379,CLRE 252,A00,507189,Cuomo; Raphael Eduardo,9998,0,9999,1
1713333349408,CLRE 253,A00,507199,Vaida; Florin,9997,0,9999,2
1713333349408,CLRE 253,B00,507202,Vaida; Florin,9999,0,9999,0
1713333350432,CLRE 259,A00,507211,Patel; Hemal,9996,0,9999,3
1713333351457,CLRE 260,A00,507221,Cuomo; Raphael Eduardo,9999,0,9999,0
1713333352484,CLRE 297,001,507242,Cuomo; Raphael Eduardo,9999,0,9999,0
1713333353510,CSE 191,A00,516875,Minnes Kemp; Mor Mia,9999,0,9999,0
1713333354538,CSS 201S,A01,494383,Staff,35,0,35,0
1713333355563,CSS 202S,A01,494387,Staff,35,0,35,0
1713333356590,EAP 100,A00,516065,Staff,9792,0,9999,207
1713333357615,ECE 45,A01,507414,Staff,51,0,60,9
1713333358645,ECE 100,A01,507416,Baghdadchi; Saharnaz,10,0,20,10
1713333358645,ECE 100,A02,507418,Baghdadchi; Saharnaz,20,0,20,0
1713333359675,ECE 111,A01,507420,Staff,38,0,50,12
1713333360700,ECE 197,001,548057,Sievenpiper; Daniel F.,9998,0,9999,1
1713333361731,EDS 115,A00,507243,Choi; Bailey Miyeon,28,0,28,0
1713333362757,EDS 117,A01,494379,Staff,23,0,25,2
1713333363783,EDS 125,A00,507246,Hopkins; Megan Beth,29,0,30,1
1713333364809,EDS 128A,A01,507264,Fargason; Sharon Gayle,26,0,26,0
1713333365836,EDS 128B,A01,507293,Pappas; Elizabeth,30,0,30,0
1713333366861,EDS 139,A00,507294,Fargason; Sharon Gayle,30,0,30,0
1713333366861,EDS 139,B00,507313,Pappas; Elizabeth,30,0,30,0
1713333367890,EDS 201,A00,507315,Staff,26,0,30,4
1713333368918,EDS 203,A01,507317,Halter; Christopher P.,26,0,30,4
1713333369944,EDS 204R,A01,507319,Halter; Christopher P.,3,0,30,27
1713333369944,EDS 204R,B01,507331,Heinzman; Erica M.,28,0,30,2
1713333370969,EDS 206R,A00,507332,Staff,4,0,30,26
1713333370969,EDS 206R,B00,507343,Staff,28,0,30,2
1713333371992,EDS 250,A00,507344,Hemans; Patricia Ann Benitez,36,0,40,4
1713333373019,EDS 281,A00,507345,Daly; Alan J.,18,0,18,0
1713333374047,EDS 284,A00,507350,Daly; Alan J.,16,0,16,0
1713333375078,EDS 286,A00,507359,Fine; Sarah,18,0,18,0
1713333376104,EDS 289C,A01,507361,Daly; Alan J.,18,0,18,0
1713333377133,EDS 290,A00,507366,Hofstetter; Carolyn,15,0,15,0
1713333378159,LIGM 5A,A00,507421,Fischer-Grunski; Eva K,20,0,20,0
1713333379186,LIGM 5B,A00,507423,Fischer-Grunski; Eva K,20,0,20,0
1713333380209,LIGM 5C,A00,507425,Fischer-Grunski; Eva K,20,0,20,0
1713333381235,LIIT 5AS,A00,507427,Carnelos; Chiara,20,0,20,0
1713333382266,LIIT 5BS,A00,507430,Carnelos; Chiara,20,0,20,0
1713333383290,LIIT 5CS,A00,507432,Carnelos; Chiara,20,0,20,0
1713333384317,LISP 5A,A00,507541,Munoz Sanchez; Alicia,17,0,20,3
1713333385345,LISP 5B,A00,507671,Munoz Sanchez; Alicia,15,0,20,5
1713333386371,LISP 5C,A00,507696,Munoz Sanchez; Alicia,15,0,20,5
1713333387398,MAE 197,001,528363,Boechler; Nicholas Sebastia,9998,0,9999,1
1713333388429,MATH 197,001,523477,Kedlaya; Kiran S.,9999,0,9999,0
1713333388429,MATH 197,002,563811,Zhang; Danna,9999,0,9999,0
1713333389456,MCWP 40R,A00,518780,Staff,20,0,20,0
1713333389456,MCWP 40R,B00,518781,Staff,19,0,20,1
1713333389456,MCWP 40R,C00,518783,Staff,19,0,20,1
1713333390482,MCWP 50R,A00,518791,Staff,20,0,20,0
1713333390482,MCWP 50R,B00,518792,Staff,17,0,20,3
1713333390482,MCWP 50R,C00,518793,Staff,19,0,20,1
1713333390482,MCWP 50R,D00,518794,Staff,16,0,20,4
1713333390482,MCWP 50R,E00,518795,Staff,16,0,20,4
1713333390482,MCWP 50R,F00,518796,Staff,19,0,20,1
1713333390482,MCWP 50R,G00,518797,Staff,19,0,20,1
1713333391508,MMW 12R,A01,514034,Herbst; Matthew,15,0,16,1
1713333391508,MMW 12R,A02,514035,Herbst; Matthew,16,0,16,0
1713333392537,MMW 13R,A01,514037,Staff,12,0,16,4
1713333392537,MMW 13R,A02,514039,Staff,16,0,16,0
1713333394593,SIO 295LS,A00,523233,Staff,19,0,30,11
1713333395621,SIO 295S,A00,523232,Staff,19,0,30,11
1713333396649,SOCI 117,A01,494376,Staff,2,0,5,3
1713333397680,WES 237B,A00,494380,Staff,19,0,20,1
1713333399749,AESE 279B,A00,494370,Wade; Jon P,33,0,33,0
1713333400775,ANAR 135S,A00,494369,Braswell; Geoffrey E.,0,0,0,0
1713333401801,CAT 124RS,A01,519847,Geibel; William,17,0,20,3
1713333402826,CAT 125RS,A01,515971,Geibel; William,17,0,20,3
1713333403860,CLRE 250,A00,511389,Morris; Sheldon,9996,0,9999,3
1713333404887,CLRE 251,A00,507176,Mehta; Ravindra L.,9996,0,9999,3
1713333404887,CLRE 251,B00,511410,Mehta; Ravindra L.,9998,0,9999,1
1713333405918,CLRE 252,A00,507189,Cuomo; Raphael Eduardo,9998,0,9999,1
1713333406943,CLRE 253,A00,507199,Vaida; Florin,9997,0,9999,2
1713333406943,CLRE 253,B00,507202,Vaida; Florin,9999,0,9999,0
1713333407977,CLRE 259,A00,507211,Patel; Hemal,9996,0,9999,3
1713333409002,CLRE 260,A00,507221,Cuomo; Raphael Eduardo,9999,0,9999,0
1713333410027,CLRE 297,001,507242,Cuomo; Raphael Eduardo,9999,0,9999,0
1713333411050,CSE 191,A00,516875,Minnes Kemp; Mor Mia,9999,0,9999,0
1713333412083,CSS 201S,A01,494383,Staff,35,0,35,0
1713333413108,CSS 202S,A01,494387,Staff,35,0,35,0
1713333414135,EAP 100,A00,516065,Staff,9792,0,9999,207
1713333415166,ECE 45,A01,507414,Staff,51,0,60,9
1713333416194,ECE 100,A01,507416,Baghdadchi; Saharnaz,10,0,20,10
1713333416194,ECE 100,A02,507418,Baghdadchi; Saharnaz,20,0,20,0
1713333417218,ECE 111,A01,507420,Staff,38,0,50,12
1713333418243,ECE 197,001,548057,Sievenpiper; Daniel F.,9998,0,9999,1
1713333419275,EDS 115,A00,507243,Choi; Bailey Miyeon,28,0,28,0
1713333420304,EDS 117,A01,494379,Staff,23,0,25,2
1713333421333,EDS 125,A00,507246,Hopkins; Megan Beth,29,0,30,1
1713333422359,EDS 128A,A01,507264,Fargason; Sharon Gayle,26,0,26,0
1713333423384,EDS 128B,A01,507293,Pappas; Elizabeth,30,0,30,0
1713333424411,EDS 139,A00,507294,Fargason; Sharon Gayle,30,0,30,0
1713333424411,EDS 139,B00,507313,Pappas; Elizabeth,30,0,30,0
1713333425441,EDS 201,A00,507315,Staff,26,0,30,4
1713333426467,EDS 203,A01,507317,Halter; Christopher P.,26,0,30,4
1713333427498,EDS 204R,A01,507319,Halter; Christopher P.,3,0,30,27
1713333427498,EDS 204R,B01,507331,Heinzman; Erica M.,28,0,30,2
1713333428528,EDS 206R,A00,507332,Staff,4,0,30,26
1713333428528,EDS 206R,B00,507343,Staff,28,0,30,2
1713333429552,EDS 250,A00,507344,Hemans; Patricia Ann Benitez,36,0,40,4
1713333430577,EDS 281,A00,507345,Daly; Alan J.,18,0,18,0
1713333431602,EDS 284,A00,507350,Daly; Alan J.,16,0,16,0
1713333432628,EDS 286,A00,507359,Fine; Sarah,18,0,18,0
1713333433653,EDS 289C,A01,507361,Daly; Alan J.,18,0,18,0
1713333434684,EDS 290,A00,507366,Hofstetter; Carolyn,15,0,15,0
1713333435709,LIGM 5A,A00,507421,Fischer-Grunski; Eva K,20,0,20,0
1713333436734,LIGM 5B,A00,507423,Fischer-Grunski; Eva K,20,0,20,0
1713333437759,LIGM 5C,A00,507425,Fischer-Grunski; Eva K,20,0,20,0
1713333438785,LIIT 5AS,A00,507427,Carnelos; Chiara,20,0,20,0
1713333439815,LIIT 5BS,A00,507430,Carnelos; Chiara,20,0,20,0
1713333440840,LIIT 5CS,A00,507432,Carnelos; Chiara,20,0,20,0
1713333441871,LISP 5A,A00,507541,Munoz Sanchez; Alicia,17,0,20,3
1713333442895,LISP 5B,A00,507671,Munoz Sanchez; Alicia,15,0,20,5
1713333443925,LISP 5C,A00,507696,Munoz Sanchez; Alicia,15,0,20,5
1713333444950,MAE 197,001,528363,Boechler; Nicholas Sebastia,9998,0,9999,1
1713333445976,MATH 197,001,523477,Kedlaya; Kiran S.,9999,0,9999,0
1713333445976,MATH 197,002,563811,Zhang; Danna,9999,0,9999,0
1713333447005,MCWP 40R,A00,518780,Staff,20,0,20,0
1713333447005,MCWP 40R,B00,518781,Staff,19,0,20,1
1713333447005,MCWP 40R,C00,518783,Staff,19,0,20,1
1713333448030,MCWP 50R,A00,518791,Staff,20,0,20,0
1713333448030,MCWP 50R,B00,518792,Staff,17,0,20,3
1713333448030,MCWP 50R,C00,518793,Staff,19,0,20,1
1713333448030,MCWP 50R,D00,518794,Staff,16,0,20,4
1713333448030,MCWP 50R,E00,518795,Staff,16,0,20,4
1713333448030,MCWP 50R,F00,518796,Staff,19,0,20,1
1713333448030,MCWP 50R,G00,518797,Staff,19,0,20,1
1713333449059,MMW 12R,A01,514034,Herbst; Matthew,15,0,16,1
1713333449059,MMW 12R,A02,514035,Herbst; Matthew,16,0,16,0
1713333450140,MMW 13R,A01,514037,Staff,12,0,16,4
1713333450140,MMW 13R,A02,514039,Staff,16,0,16,0
1713333452191,SIO 295LS,A00,523233,Staff,19,0,30,11
1713333453216,SIO 295S,A00,523232,Staff,19,0,30,11
1713333454244,SOCI 117,A01,494376,Staff,2,0,5,3
1713333455270,WES 237B,A00,494380,Staff,19,0,20,1
1713333457343,AESE 279B,A00,494370,Wade; Jon P,33,0,33,0
1713333458369,ANAR 135S,A00,494369,Braswell; Geoffrey E.,0,0,0,0
1713333459393,CAT 124RS,A01,519847,Geibel; William,17,0,20,3
1713333460417,CAT 125RS,A01,515971,Geibel; William,17,0,20,3
1713333461445,CLRE 250,A00,511389,Morris; Sheldon,9996,0,9999,3
1713333462471,CLRE 251,A00,507176,Mehta; Ravindra L.,9996,0,9999,3
1713333462471,CLRE 251,B00,511410,Mehta; Ravindra L.,9998,0,9999,1
1713333463502,CLRE 252,A00,507189,Cuomo; Raphael Eduardo,9998,0,9999,1
1713333464529,CLRE 253,A00,507199,Vaida; Florin,9997,0,9999,2
1713333464529,CLRE 253,B00,507202,Vaida; Florin,9999,0,9999,0
1713333465552,CLRE 259,A00,507211,Patel; Hemal,9996,0,9999,3
1713333466581,CLRE 260,A00,507221,Cuomo; Raphael Eduardo,9999,0,9999,0
1713333467605,CLRE 297,001,507242,Cuomo; Raphael Eduardo,9999,0,9999,0
1713333468631,CSE 191,A00,516875,Minnes Kemp; Mor Mia,9999,0,9999,0
1713333469658,CSS 201S,A01,494383,Staff,35,0,35,0
1713333470687,CSS 202S,A01,494387,Staff,35,0,35,0
1713333471712,EAP 100,A00,516065,Staff,9792,0,9999,207
1713333472738,ECE 45,A01,507414,Staff,51,0,60,9
1713333473762,ECE 100,A01,507416,Baghdadchi; Saharnaz,10,0,20,10
1713333473762,ECE 100,A02,507418,Baghdadchi; Saharnaz,20,0,20,0
1713333474790,ECE 111,A01,507420,Staff,38,0,50,12
1713333475819,ECE 197,001,548057,Sievenpiper; Daniel F.,9998,0,9999,1
1713333476849,EDS 115,A00,507243,Choi; Bailey Miyeon,28,0,28,0
1713333477879,EDS 117,A01,494379,Staff,23,0,25,2
1713333478905,EDS 125,A00,507246,Hopkins; Megan Beth,29,0,30,1
1713333479936,EDS 128A,A01,507264,Fargason; Sharon Gayle,26,0,26,0
1713333480962,EDS 128B,A01,507293,Pappas; Elizabeth,30,0,30,0
1713333481987,EDS 139,A00,507294,Fargason; Sharon Gayle,30,0,30,0
1713333481987,EDS 139,B00,507313,Pappas; Elizabeth,30,0,30,0
1713333483013,EDS 201,A00,507315,Staff,26,0,30,4
1713333484038,EDS 203,A01,507317,Halter; Christopher P.,26,0,30,4
1713333485065,EDS 204R,A01,507319,Halter; Christopher P.,3,0,30,27
1713333485065,EDS 204R,B01,507331,Heinzman; Erica M.,28,0,30,2
1713333486090,EDS 206R,A00,507332,Staff,4,0,30,26
1713333486090,EDS 206R,B00,507343,Staff,28,0,30,2
1713333487123,EDS 250,A00,507344,Hemans; Patricia Ann Benitez,36,0,40,4
1713333488150,EDS 281,A00,507345,Daly; Alan J.,18,0,18,0
1713333489178,EDS 284,A00,507350,Daly; Alan J.,16,0,16,0
1713333490204,EDS 286,A00,507359,Fine; Sarah,18,0,18,0
1713333491229,EDS 289C,A01,507361,Daly; Alan J.,18,0,18,0
1713333492255,EDS 290,A00,507366,Hofstetter; Carolyn,15,0,15,0
1713333493280,LIGM 5A,A00,507421,Fischer-Grunski; Eva K,20,0,20,0
1713333494304,LIGM 5B,A00,507423,Fischer-Grunski; Eva K,20,0,20,0
1713333495328,LIGM 5C,A00,507425,Fischer-Grunski; Eva K,20,0,20,0
1713333496354,LIIT 5AS,A00,507427,Carnelos; Chiara,20,0,20,0
1713333497379,LIIT 5BS,A00,507430,Carnelos; Chiara,20,0,20,0
1713333498403,LIIT 5CS,A00,507432,Carnelos; Chiara,20,0,20,0
1713333499429,LISP 5A,A00,507541,Munoz Sanchez; Alicia,17,0,20,3
1713333500453,LISP 5B,A00,507671,Munoz Sanchez; Alicia,15,0,20,5
1713333501481,LISP 5C,A00,507696,Munoz Sanchez; Alicia,15,0,20,5
1713333502509,MAE 197,001,528363,Boechler; Nicholas Sebastia,9998,0,9999,1
1713333503533,MATH 197,001,523477,Kedlaya; Kiran S.,9999,0,9999,0
1713333503533,MATH 197,002,563811,Zhang; Danna,9999,0,9999,0
1713333504557,MCWP 40R,A00,518780,Staff,20,0,20,0
1713333504557,MCWP 40R,B00,518781,Staff,19,0,20,1
1713333504557,MCWP 40R,C00,518783,Staff,19,0,20,1
1713333505583,MCWP 50R,A00,518791,Staff,20,0,20,0
1713333505583,MCWP 50R,B00,518792,Staff,17,0,20,3
1713333505583,MCWP 50R,C00,518793,Staff,19,0,20,1
1713333505583,MCWP 50R,D00,518794,Staff,16,0,20,4
1713333505583,MCWP 50R,E00,518795,Staff,16,0,20,4
1713333505583,MCWP 50R,F00,518796,Staff,19,0,20,1
1713333505583,MCWP 50R,G00,518797,Staff,19,0,20,1
1713333506609,MMW 12R,A01,514034,Herbst; Matthew,15,0,16,1
1713333506609,MMW 12R,A02,514035,Herbst; Matthew,16,0,16,0
1713333507634,MMW 13R,A01,514037,Staff,12,0,16,4
1713333507634,MMW 13R,A02,514039,Staff,16,0,16,0
1713333509684,SIO 295LS,A00,523233,Staff,19,0,30,11
1713333510712,SIO 295S,A00,523232,Staff,19,0,30,11
1713333511740,SOCI 117,A01,494376,Staff,2,0,5,3
1713333512765,WES 237B,A00,494380,Staff,19,0,20,1
1713333514837,AESE 279B,A00,494370,Wade; Jon P,33,0,33,0
1713333515865,ANAR 135S,A00,494369,Braswell; Geoffrey E.,0,0,0,0
1713333516893,CAT 124RS,A01,519847,Geibel; William,17,0,20,3
1713333517919,CAT 125RS,A01,515971,Geibel; William,17,0,20,3
1713333518945,CLRE 250,A00,511389,Morris; Sheldon,9996,0,9999,3
1713333519976,CLRE 251,A00,507176,Mehta; Ravindra L.,9996,0,9999,3
1713333519976,CLRE 251,B00,511410,Mehta; Ravindra L.,9998,0,9999,1
1713333521002,CLRE 252,A00,507189,Cuomo; Raphael Eduardo,9998,0,9999,1
1713333522030,CLRE 253,A00,507199,Vaida; Florin,9997,0,9999,2
1713333522030,CLRE 253,B00,507202,Vaida; Florin,9999,0,9999,0
1713333523055,CLRE 259,A00,507211,Patel; Hemal,9996,0,9999,3
1713333524081,CLRE 260,A00,507221,Cuomo; Raphael Eduardo,9999,0,9999,0
1713333525108,CLRE 297,001,507242,Cuomo; Raphael Eduardo,9999,0,9999,0
1713333526136,CSE 191,A00,516875,Minnes Kemp; Mor Mia,9999,0,9999,0
1713333527161,CSS 201S,A01,494383,Staff,35,0,35,0
1713333528190,CSS 202S,A01,494387,Staff,35,0,35,0
1713333529220,EAP 100,A00,516065,Staff,9792,0,9999,207
1713333530245,ECE 45,A01,507414,Staff,51,0,60,9
1713333531275,ECE 100,A01,507416,Baghdadchi; Saharnaz,10,0,20,10
1713333531275,ECE 100,A02,507418,Baghdadchi; Saharnaz,20,0,20,0
1713333532299,ECE 111,A01,507420,Staff,38,0,50,12
1713333533328,ECE 197,001,548057,Sievenpiper; Daniel F.,9998,0,9999,1
1713333534354,EDS 115,A00,507243,Choi; Bailey Miyeon,28,0,28,0
1713333535380,EDS 117,A01,494379,Staff,23,0,25,2
1713333536409,EDS 125,A00,507246,Hopkins; Megan Beth,29,0,30,1
1713333537434,EDS 128A,A01,507264,Fargason; Sharon Gayle,26,0,26,0
1713333538460,EDS 128B,A01,507293,Pappas; Elizabeth,30,0,30,0
1713333539484,EDS 139,A00,507294,Fargason; Sharon Gayle,30,0,30,0
1713333539484,EDS 139,B00,507313,Pappas; Elizabeth,30,0,30,0
1713333540512,EDS 201,A00,507315,Staff,26,0,30,4
1713333541536,EDS 203,A01,507317,Halter; Christopher P.,26,0,30,4
1713333542567,EDS 204R,A01,507319,Halter; Christopher P.,3,0,30,27
1713333542567,EDS 204R,B01,507331,Heinzman; Erica M.,28,0,30,2
1713333543597,EDS 206R,A00,507332,Staff,4,0,30,26
1713333543597,EDS 206R,B00,507343,Staff,28,0,30,2
1713333544622,EDS 250,A00,507344,Hemans; Patricia Ann Benitez,36,0,40,4
1713333545647,EDS 281,A00,507345,Daly; Alan J.,18,0,18,0
1713333546672,EDS 284,A00,507350,Daly; Alan J.,16,0,16,0
1713333547701,EDS 286,A00,507359,Fine; Sarah,18,0,18,0
1713333548728,EDS 289C,A01,507361,Daly; Alan J.,18,0,18,0
1713333549753,EDS 290,A00,507366,Hofstetter; Carolyn,15,0,15,0
1713333550783,LIGM 5A,A00,507421,Fischer-Grunski; Eva K,20,0,20,0
1713333551810,LIGM 5B,A00,507423,Fischer-Grunski; Eva K,20,0,20,0
1713333552840,LIGM 5C,A00,507425,Fischer-Grunski; Eva K,20,0,20,0
1713333553936,LIIT 5AS,A00,507427,Carnelos; Chiara,20,0,20,0
1713333554962,LIIT 5BS,A00,507430,Carnelos; Chiara,20,0,20,0
1713333555991,LIIT 5CS,A00,507432,Carnelos; Chiara,20,0,20,0
1713333557018,LISP 5A,A00,507541,Munoz Sanchez; Alicia,17,0,20,3
1713333558045,LISP 5B,A00,507671,Munoz Sanchez; Alicia,15,0,20,5
1713333559074,LISP 5C,A00,507696,Munoz Sanchez; Alicia,15,0,20,5
1713333560101,MAE 197,001,528363,Boechler; Nicholas Sebastia,9998,0,9999,1
1713333561126,MATH 197,001,523477,Kedlaya; Kiran S.,9999,0,9999,0
1713333561126,MATH 197,002,563811,Zhang; Danna,9999,0,9999,0
1713333562150,MCWP 40R,A00,518780,Staff,20,0,20,0
1713333562150,MCWP 40R,B00,518781,Staff,19,0,20,1
1713333562150,MCWP 40R,C00,518783,Staff,19,0,20,1
1713333563179,MCWP 50R,A00,518791,Staff,20,0,20,0
1713333563179,MCWP 50R,B00,518792,Staff,17,0,20,3
1713333563179,MCWP 50R,C00,518793,Staff,19,0,20,1
1713333563179,MCWP 50R,D00,518794,Staff,16,0,20,4
1713333563179,MCWP 50R,E00,518795,Staff,16,0,20,4
1713333563179,MCWP 50R,F00,518796,Staff,19,0,20,1
1713333563179,MCWP 50R,G00,518797,Staff,19,0,20,1
1713333564207,MMW 12R,A01,514034,Herbst; Matthew,15,0,16,1
1713333564207,MMW 12R,A02,514035,Herbst; Matthew,16,0,16,0
1713333565233,MMW 13R,A01,514037,Staff,12,0,16,4
1713333565233,MMW 13R,A02,514039,Staff,16,0,16,0
1713333567283,SIO 295LS,A00,523233,Staff,19,0,30,11
1713333568309,SIO 295S,A00,523232,Staff,19,0,30,11
1713333569335,SOCI 117,A01,494376,Staff,2,0,5,3
1713333570360,WES 237B,A00,494380,Staff,19,0,20,1
1713333572425,AESE 279B,A00,494370,Wade; Jon P,33,0,33,0
1713333573454,ANAR 135S,A00,494369,Braswell; Geoffrey E.,0,0,0,0
1713333574483,CAT 124RS,A01,519847,Geibel; William,17,0,20,3
1713333575510,CAT 125RS,A01,515971,Geibel; William,17,0,20,3
1713333576539,CLRE 250,A00,511389,Morris; Sheldon,9996,0,9999,3
1713333577572,CLRE 251,A00,507176,Mehta; Ravindra L.,9996,0,9999,3
1713333577572,CLRE 251,B00,511410,Mehta; Ravindra L.,9998,0,9999,1
1713333578603,CLRE 252,A00,507189,Cuomo; Raphael Eduardo,9998,0,9999,1
1713333579631,CLRE 253,A00,507199,Vaida; Florin,9997,0,9999,2
1713333579631,CLRE 253,B00,507202,Vaida; Florin,9999,0,9999,0
1713333580656,CLRE 259,A00,507211,Patel; Hemal,9996,0,9999,3
1713333581687,CLRE 260,A00,507221,Cuomo; Raphael Eduardo,9999,0,9999,0
1713333582713,CLRE 297,001,507242,Cuomo; Raphael Eduardo,9999,0,9999,0
1713333583737,CSE 191,A00,516875,Minnes Kemp; Mor Mia,9999,0,9999,0
1713333584763,CSS 201S,A01,494383,Staff,35,0,35,0
1713333585785,CSS 202S,A01,494387,Staff,35,0,35,0
1713333586811,EAP 100,A00,516065,Staff,9792,0,9999,207
1713333587841,ECE 45,A01,507414,Staff,51,0,60,9
1713333588867,ECE 100,A01,507416,Baghdadchi; Saharnaz,10,0,20,10
1713333588867,ECE 100,A02,507418,Baghdadchi; Saharnaz,20,0,20,0
1713333589896,ECE 111,A01,507420,Staff,38,0,50,12
1713333590921,ECE 197,001,548057,Sievenpiper; Daniel F.,9998,0,9999,1
1713333591950,EDS 115,A00,507243,Choi; Bailey Miyeon,28,0,28,0
1713333592979,EDS 117,A01,494379,Staff,23,0,25,2
1713333594005,EDS 125,A00,507246,Hopkins; Megan Beth,29,0,30,1
1713333595034,EDS 128A,A01,507264,Fargason; Sharon Gayle,26,0,26,0
1713333596058,EDS 128B,A01,507293,Pappas; Elizabeth,30,0,30,0
1713333597084,EDS 139,A00,507294,Fargason; Sharon Gayle,30,0,30,0
1713333597084,EDS 139,B00,507313,Pappas; Elizabeth,30,0,30,0
1713333598110,EDS 201,A00,507315,Staff,26,0,30,4
1713333599134,EDS 203,A01,507317,Halter; Christopher P.,26,0,30,4
1713333600161,EDS 204R,A01,507319,Halter; Christopher P.,3,0,30,27
1713333600161,EDS 204R,B01,507331,Heinzman; Erica M.,28,0,30,2
1713333601186,EDS 206R,A00,507332,Staff,4,0,30,26
1713333601186,EDS 206R,B00,507343,Staff,28,0,30,2
1713333602214,EDS 250,A00,507344,Hemans; Patricia Ann Benitez,36,0,40,4
1713333603244,EDS 281,A00,507345,Daly; Alan J.,18,0,18,0
1713333604268,EDS 284,A00,507350,Daly; Alan J.,16,0,16,0
1713333605298,EDS 286,A00,507359,Fine; Sarah,18,0,18,0
1713333606324,EDS 289C,A01,507361,Daly; Alan J.,18,0,18,0
1713333607349,EDS 290,A00,507366,Hofstetter; Carolyn,15,0,15,0
1713333608377,LIGM 5A,A00,507421,Fischer-Grunski; Eva K,20,0,20,0
1713333609401,LIGM 5B,A00,507423,Fischer-Grunski; Eva K,20,0,20,0
1713333610426,LIGM 5C,A00,507425,Fischer-Grunski; Eva K,20,0,20,0
1713333611457,LIIT 5AS,A00,507427,Carnelos; Chiara,20,0,20,0
1713333612482,LIIT 5BS,A00,507430,Carnelos; Chiara,20,0,20,0
1713333613512,LIIT 5CS,A00,507432,Carnelos; Chiara,20,0,20,0
1713333614540,LISP 5A,A00,507541,Munoz Sanchez; Alicia,17,0,20,3
1713333615568,LISP 5B,A00,507671,Munoz Sanchez; Alicia,15,0,20,5
1713333616598,LISP 5C,A00,507696,Munoz Sanchez; Alicia,15,0,20,5
1713333617625,MAE 197,001,528363,Boechler; Nicholas Sebastia,9998,0,9999,1
1713333618654,MATH 197,001,523477,Kedlaya; Kiran S.,9999,0,9999,0
1713333618654,MATH 197,002,563811,Zhang; Danna,9999,0,9999,0
1713333619679,MCWP 40R,A00,518780,Staff,20,0,20,0
1713333619679,MCWP 40R,B00,518781,Staff,19,0,20,1
1713333619679,MCWP 40R,C00,518783,Staff,19,0,20,1
1713333620705,MCWP 50R,A00,518791,Staff,20,0,20,0
1713333620705,MCWP 50R,B00,518792,Staff,17,0,20,3
1713333620705,MCWP 50R,C00,518793,Staff,19,0,20,1
1713333620705,MCWP 50R,D00,518794,Staff,16,0,20,4
1713333620705,MCWP 50R,E00,518795,Staff,16,0,20,4
1713333620705,MCWP 50R,F00,518796,Staff,19,0,20,1
1713333620705,MCWP 50R,G00,518797,Staff,19,0,20,1
1713333621732,MMW 12R,A01,514034,Herbst; Matthew,15,0,16,1
1713333621732,MMW 12R,A02,514035,Herbst; Matthew,16,0,16,0
1713333622760,MMW 13R,A01,514037,Staff,12,0,16,4
1713333622760,MMW 13R,A02,514039,Staff,16,0,16,0
1713333624818,SIO 295LS,A00,523233,Staff,19,0,30,11
1713333625846,SIO 295S,A00,523232,Staff,19,0,30,11
1713333626872,SOCI 117,A01,494376,Staff,2,0,5,3
1713333627900,WES 237B,A00,494380,Staff,19,0,20,1
1713333629978,AESE 279B,A00,494370,Wade; Jon P,33,0,33,0
1713333631005,ANAR 135S,A00,494369,Braswell; Geoffrey E.,0,0,0,0
1713333632033,CAT 124RS,A01,519847,Geibel; William,17,0,20,3
1713333633059,CAT 125RS,A01,515971,Geibel; William,17,0,20,3
1713333634084,CLRE 250,A00,511389,Morris; Sheldon,9996,0,9999,3
1713333635111,CLRE 251,A00,507176,Mehta; Ravindra L.,9996,0,9999,3
1713333635111,CLRE 251,B00,511410,Mehta; Ravindra L.,9998,0,9999,1
1713333636140,CLRE 252,A00,507189,Cuomo; Raphael Eduardo,9998,0,9999,1
1713333637166,CLRE 253,A00,507199,Vaida; Florin,9997,0,9999,2
1713333637166,CLRE 253,B00,507202,Vaida; Florin,9999,0,9999,0
1713333638196,CLRE 259,A00,507211,Patel; Hemal,9996,0,9999,3
1713333639220,CLRE 260,A00,507221,Cuomo; Raphael Eduardo,9999,0,9999,0
1713333640244,CLRE 297,001,507242,Cuomo; Raphael Eduardo,9999,0,9999,0
1713333641273,CSE 191,A00,516875,Minnes Kemp; Mor Mia,9999,0,9999,0
1713333642304,CSS 201S,A01,494383,Staff,35,0,35,0
1713333643332,CSS 202S,A01,494387,Staff,35,0,35,0
1713333644357,EAP 100,A00,516065,Staff,9792,0,9999,207
1713333645383,ECE 45,A01,507414,Staff,51,0,60,9
1713333646408,ECE 100,A01,507416,Baghdadchi; Saharnaz,10,0,20,10
1713333646408,ECE 100,A02,507418,Baghdadchi; Saharnaz,20,0,20,0
1713333647436,ECE 111,A01,507420,Staff,38,0,50,12
1713333648461,ECE 197,001,548057,Sievenpiper; Daniel F.,9998,0,9999,1
1713333649490,EDS 115,A00,507243,Choi; Bailey Miyeon,28,0,28,0
1713333650519,EDS 117,A01,494379,Staff,23,0,25,2
1713333651544,EDS 125,A00,507246,Hopkins; Megan Beth,29,0,30,1
1713333652571,EDS 128A,A01,507264,Fargason; Sharon Gayle,26,0,26,0
1713333653599,EDS 128B,A01,507293,Pappas; Elizabeth,30,0,30,0
1713333654626,EDS 139,A00,507294,Fargason; Sharon Gayle,30,0,30,0
1713333654626,EDS 139,B00,507313,Pappas; Elizabeth,30,0,30,0
1713333655651,EDS 201,A00,507315,Staff,26,0,30,4
1713333656682,EDS 203,A01,507317,Halter; Christopher P.,26,0,30,4
1713333657765,EDS 204R,A01,507319,Halter; Christopher P.,3,0,30,27
1713333657765,EDS 204R,B01,507331,Heinzman; Erica M.,28,0,30,2
1713333658790,EDS 206R,A00,507332,Staff,4,0,30,26
1713333658790,EDS 206R,B00,507343,Staff,28,0,30,2
1713333659816,EDS 250,A00,507344,Hemans; Patricia Ann Benitez,36,0,40,4
1713333660841,EDS 281,A00,507345,Daly; Alan J.,18,0,18,0
1713333661866,EDS 284,A00,507350,Daly; Alan J.,16,0,16,0
1713333662892,EDS 286,A00,507359,Fine; Sarah,18,0,18,0
1713333663921,EDS 289C,A01,507361,Daly; Alan J.,18,0,18,0
1713333664947,EDS 290,A00,507366,Hofstetter; Carolyn,15,0,15,0
1713333665976,LIGM 5A,A00,507421,Fischer-Grunski; Eva K,20,0,20,0
1713333667001,LIGM 5B,A00,507423,Fischer-Grunski; Eva K,20,0,20,0
1713333668027,LIGM 5C,A00,507425,Fischer-Grunski; Eva K,20,0,20,0
1713333669053,LIIT 5AS,A00,507427,Carnelos; Chiara,20,0,20,0
1713333670077,LIIT 5BS,A00,507430,Carnelos; Chiara,20,0,20,0
1713333671106,LIIT 5CS,A00,507432,Carnelos; Chiara,20,0,20,0
1713333672131,LISP 5A,A00,507541,Munoz Sanchez; Alicia,17,0,20,3
1713333673156,LISP 5B,A00,507671,Munoz Sanchez; Alicia,15,0,20,5
1713333674184,LISP 5C,A00,507696,Munoz Sanchez; Alicia,15,0,20,5
1713333675210,MAE 197,001,528363,Boechler; Nicholas Sebastia,9998,0,9999,1
1713333676241,MATH 197,001,523477,Kedlaya; Kiran S.,9999,0,9999,0
1713333676241,MATH 197,002,563811,Zhang; Danna,9999,0,9999,0
1713333677265,MCWP 40R,A00,518780,Staff,20,0,20,0
1713333677265,MCWP 40R,B00,518781,Staff,19,0,20,1
1713333677265,MCWP 40R,C00,518783,Staff,19,0,20,1
1713333678293,MCWP 50R,A00,518791,Staff,20,0,20,0
1713333678293,MCWP 50R,B00,518792,Staff,17,0,20,3
1713333678293,MCWP 50R,C00,518793,Staff,19,0,20,1
1713333678293,MCWP 50R,D00,518794,Staff,16,0,20,4
1713333678293,MCWP 50R,E00,518795,Staff,16,0,20,4
1713333678293,MCWP 50R,F00,518796,Staff,19,0,20,1
1713333678293,MCWP 50R,G00,518797,Staff,19,0,20,1
1713333679320,MMW 12R,A01,514034,Herbst; Matthew,15,0,16,1
1713333679320,MMW 12R,A02,514035,Herbst; Matthew,16,0,16,0
1713333680348,MMW 13R,A01,514037,Staff,12,0,16,4
1713333680348,MMW 13R,A02,514039,Staff,16,0,16,0
1713333682406,SIO 295LS,A00,523233,Staff,19,0,30,11
1713333683432,SIO 295S,A00,523232,Staff,19,0,30,11
1713333684462,SOCI 117,A01,494376,Staff,2,0,5,3
1713333685488,WES 237B,A00,494380,Staff,19,0,20,1
1713333687552,AESE 279B,A00,494370,Wade; Jon P,33,0,33,0
1713333688577,ANAR 135S,A00,494369,Braswell; Geoffrey E.,0,0,0,0
1713333689610,CAT 124RS,A01,519847,Geibel; William,17,0,20,3
1713333690637,CAT 125RS,A01,515971,Geibel; William,17,0,20,3
1713333691667,CLRE 250,A00,511389,Morris; Sheldon,9996,0,9999,3
1713333692699,CLRE 251,A00,507176,Mehta; Ravindra L.,9996,0,9999,3
1713333692699,CLRE 251,B00,511410,Mehta; Ravindra L.,9998,0,9999,1
1713333693724,CLRE 252,A00,507189,Cuomo; Raphael Eduardo,9998,0,9999,1
1713333694754,CLRE 253,A00,507199,Vaida; Florin,9997,0,9999,2
1713333694754,CLRE 253,B00,507202,Vaida; Florin,9999,0,9999,0
1713333695779,CLRE 259,A00,507211,Patel; Hemal,9996,0,9999,3
1713333696803,CLRE 260,A00,507221,Cuomo; Raphael Eduardo,9999,0,9999,0
1713333697829,CLRE 297,001,507242,Cuomo; Raphael Eduardo,9999,0,9999,0
1713333698856,CSE 191,A00,516875,Minnes Kemp; Mor Mia,9999,0,9999,0
1713333699883,CSS 201S,A01,494383,Staff,35,0,35,0
1713333700910,CSS 202S,A01,494387,Staff,35,0,35,0
1713333701934,EAP 100,A00,516065,Staff,9792,0,9999,207
1713333702959,ECE 45,A01,507414,Staff,51,0,60,9
1713333703986,ECE 100,A01,507416,Baghdadchi; Saharnaz,10,0,20,10
1713333703986,ECE 100,A02,507418,Baghdadchi; Saharnaz,20,0,20,0
1713333705014,ECE 111,A01,507420,Staff,38,0,50,12
1713333706041,ECE 197,001,548057,Sievenpiper; Daniel F.,9998,0,9999,1
1713333707065,EDS 115,A00,507243,Choi; Bailey Miyeon,28,0,28,0
1713333708094,EDS 117,A01,494379,Staff,23,0,25,2
1713333709123,EDS 125,A00,507246,Hopkins; Megan Beth,29,0,30,1
1713333710151,EDS 128A,A01,507264,Fargason; Sharon Gayle,26,0,26,0
1713333711179,EDS 128B,A01,507293,Pappas; Elizabeth,30,0,30,0
1713333712211,EDS 139,A00,507294,Fargason; Sharon Gayle,30,0,30,0
1713333712211,EDS 139,B00,507313,Pappas; Elizabeth,30,0,30,0
1713333713237,EDS 201,A00,507315,Staff,26,0,30,4
1713333714261,EDS 203,A01,507317,Halter; Christopher P.,26,0,30,4
1713333715291,EDS 204R,A01,507319,Halter; Christopher P.,3,0,30,27
1713333715291,EDS 204R,B01,507331,Heinzman; Erica M.,28,0,30,2
1713333716316,EDS 206R,A00,507332,Staff,4,0,30,26
1713333716316,EDS 206R,B00,507343,Staff,28,0,30,2
1713333717340,EDS 250,A00,507344,Hemans; Patricia Ann Benitez,36,0,40,4
1713333718366,EDS 281,A00,507345,Daly; Alan J.,18,0,18,0
1713333719438,EDS 284,A00,507350,Daly; Alan J.,16,0,16,0
1713333720469,EDS 286,A00,507359,Fine; Sarah,18,0,18,0
1713333721495,EDS 289C,A01,507361,Daly; Alan J.,18,0,18,0
1713333722528,EDS 290,A00,507366,Hofstetter; Carolyn,15,0,15,0
1713333723555,LIGM 5A,A00,507421,Fischer-Grunski; Eva K,20,0,20,0
1713333724582,LIGM 5B,A00,507423,Fischer-Grunski; Eva K,20,0,20,0
1713333725610,LIGM 5C,A00,507425,Fischer-Grunski; Eva K,20,0,20,0
1713333726640,LIIT 5AS,A00,507427,Carnelos; Chiara,20,0,20,0
1713333727666,LIIT 5BS,A00,507430,Carnelos; Chiara,20,0,20,0
1713333728696,LIIT 5CS,A00,507432,Carnelos; Chiara,20,0,20,0
1713333729723,LISP 5A,A00,507541,Munoz Sanchez; Alicia,17,0,20,3
1713333730748,LISP 5B,A00,507671,Munoz Sanchez; Alicia,15,0,20,5
1713333731772,LISP 5C,A00,507696,Munoz Sanchez; Alicia,15,0,20,5
1713333732798,MAE 197,001,528363,Boechler; Nicholas Sebastia,9998,0,9999,1
1713333733830,MATH 197,001,523477,Kedlaya; Kiran S.,9999,0,9999,0
1713333733830,MATH 197,002,563811,Zhang; Danna,9999,0,9999,0
1713333734860,MCWP 40R,A00,518780,Staff,20,0,20,0
1713333734860,MCWP 40R,B00,518781,Staff,19,0,20,1
1713333734860,MCWP 40R,C00,518783,Staff,19,0,20,1
1713333735890,MCWP 50R,A00,518791,Staff,20,0,20,0
1713333735890,MCWP 50R,B00,518792,Staff,17,0,20,3
1713333735890,MCWP 50R,C00,518793,Staff,19,0,20,1
1713333735890,MCWP 50R,D00,518794,Staff,16,0,20,4
1713333735890,MCWP 50R,E00,518795,Staff,16,0,20,4
1713333735890,MCWP 50R,F00,518796,Staff,19,0,20,1
1713333735890,MCWP 50R,G00,518797,Staff,19,0,20,1
1713333736919,MMW 12R,A01,514034,Herbst; Matthew,15,0,16,1
1713333736919,MMW 12R,A02,514035,Herbst; Matthew,16,0,16,0
1713333737945,MMW 13R,A01,514037,Staff,12,0,16,4
1713333737945,MMW 13R,A02,514039,Staff,16,0,16,0
1713333740005,SIO 295LS,A00,523233,Staff,19,0,30,11
1713333741037,SIO 295S,A00,523232,Staff,19,0,30,11
1713333742063,SOCI 117,A01,494376,Staff,2,0,5,3
1713333743098,WES 237B,A00,494380,Staff,19,0,20,1
1713333745174,AESE 279B,A00,494370,Wade; Jon P,33,0,33,0
1713333746201,ANAR 135S,A00,494369,Braswell; Geoffrey E.,0,0,0,0
1713333747227,CAT 124RS,A01,519847,Geibel; William,17,0,20,3
1713333748255,CAT 125RS,A01,515971,Geibel; William,17,0,20,3
1713333749285,CLRE 250,A00,511389,Morris; Sheldon,9996,0,9999,3
1713333750317,CLRE 251,A00,507176,Mehta; Ravindra L.,9996,0,9999,3
1713333750317,CLRE 251,B00,511410,Mehta; Ravindra L.,9998,0,9999,1
1713333751342,CLRE 252,A00,507189,Cuomo; Raphael Eduardo,9998,0,9999,1
1713333752372,CLRE 253,A00,507199,Vaida; Florin,9997,0,9999,2
1713333752372,CLRE 253,B00,507202,Vaida; Florin,9999,0,9999,0
1713333753402,CLRE 259,A00,507211,Patel; Hemal,9996,0,9999,3
1713333754429,CLRE 260,A00,507221,Cuomo; Raphael Eduardo,9999,0,9999,0
1713333755457,CLRE 297,001,507242,Cuomo; Raphael Eduardo,9999,0,9999,0
1713333756485,CSE 191,A00,516875,Minnes Kemp; Mor Mia,9999,0,9999,0
1713333757516,CSS 201S,A01,494383,Staff,35,0,35,0
1713333758540,CSS 202S,A01,494387,Staff,35,0,35,0
1713333759565,EAP 100,A00,516065,Staff,9792,0,9999,207
1713333760593,ECE 45,A01,507414,Staff,51,0,60,9
1713333761678,ECE 100,A01,507416,Baghdadchi; Saharnaz,10,0,20,10
1713333761678,ECE 100,A02,507418,Baghdadchi; Saharnaz,20,0,20,0
1713333762706,ECE 111,A01,507420,Staff,38,0,50,12
1713333763742,ECE 197,001,548057,Sievenpiper; Daniel F.,9998,0,9999,1
1713333764769,EDS 115,A00,507243,Choi; Bailey Miyeon,28,0,28,0
1713333765798,EDS 117,A01,494379,Staff,23,0,25,2
1713333766824,EDS 125,A00,507246,Hopkins; Megan Beth,29,0,30,1
1713333767851,EDS 128A,A01,507264,Fargason; Sharon Gayle,26,0,26,0
1713333768877,EDS 128B,A01,507293,Pappas; Elizabeth,30,0,30,0
1713333769910,EDS 139,A00,507294,Fargason; Sharon Gayle,30,0,30,0
1713333769910,EDS 139,B00,507313,Pappas; Elizabeth,30,0,30,0
1713333770936,EDS 201,A00,507315,Staff,26,0,30,4
1713333771965,EDS 203,A01,507317,Halter; Christopher P.,26,0,30,4
1713333772991,EDS 204R,A01,507319,Halter; Christopher P.,3,0,30,27
1713333772991,EDS 204R,B01,507331,Heinzman; Erica M.,28,0,30,2
1713333774020,EDS 206R,A00,507332,Staff,4,0,30,26
1713333774020,EDS 206R,B00,507343,Staff,28,0,30,2
1713333775051,EDS 250,A00,507344,Hemans; Patricia Ann Benitez,36,0,40,4
1713333776084,EDS 281,A00,507345,Daly; Alan J.,18,0,18,0
1713333777113,EDS 284,A00,507350,Daly; Alan J.,16,0,16,0
1713333778143,EDS 286,A00,507359,Fine; Sarah,18,0,18,0
1713333779172,EDS 289C,A01,507361,Daly; Alan J.,18,0,18,0
1713333780197,EDS 290,A00,507366,Hofstetter; Carolyn,15,0,15,0
1713333781225,LIGM 5A,A00,507421,Fischer-Grunski; Eva K,20,0,20,0
1713333782251,LIGM 5B,A00,507423,Fischer-Grunski; Eva K,20,0,20,0
1713333783276,LIGM 5C,A00,507425,Fischer-Grunski; Eva K,20,0,20,0
1713333784304,LIIT 5AS,A00,507427,Carnelos; Chiara,20,0,20,0
1713333785330,LIIT 5BS,A00,507430,Carnelos; Chiara,20,0,20,0
1713333786357,LIIT 5CS,A00,507432,Carnelos; Chiara,20,0,20,0
1713333787384,LISP 5A,A00,507541,Munoz Sanchez; Alicia,17,0,20,3
1713333788413,LISP 5B,A00,507671,Munoz Sanchez; Alicia,15,0,20,5
1713333789452,LISP 5C,A00,507696,Munoz Sanchez; Alicia,15,0,20,5
1713333790482,MAE 197,001,528363,Boechler; Nicholas Sebastia,9998,0,9999,1
1713333791508,MATH 197,001,523477,Kedlaya; Kiran S.,9999,0,9999,0
1713333791508,MATH 197,002,563811,Zhang; Danna,9999,0,9999,0
1713333792534,MCWP 40R,A00,518780,Staff,20,0,20,0
1713333792534,MCWP 40R,B00,518781,Staff,19,0,20,1
1713333792534,MCWP 40R,C00,518783,Staff,19,0,20,1
1713333793561,MCWP 50R,A00,518791,Staff,20,0,20,0
1713333793561,MCWP 50R,B00,518792,Staff,17,0,20,3
1713333793561,MCWP 50R,C00,518793,Staff,19,0,20,1
1713333793561,MCWP 50R,D00,518794,Staff,16,0,20,4
1713333793561,MCWP 50R,E00,518795,Staff,16,0,20,4
1713333793561,MCWP 50R,F00,518796,Staff,19,0,20,1
1713333793561,MCWP 50R,G00,518797,Staff,19,0,20,1
1713333794587,MMW 12R,A01,514034,Herbst; Matthew,15,0,16,1
1713333794587,MMW 12R,A02,514035,Herbst; Matthew,16,0,16,0
1713333795613,MMW 13R,A01,514037,Staff,12,0,16,4
1713333795613,MMW 13R,A02,514039,Staff,16,0,16,0
1713333797686,SIO 295LS,A00,523233,Staff,19,0,30,11
1713333798718,SIO 295S,A00,523232,Staff,19,0,30,11
1713333799743,SOCI 117,A01,494376,Staff,2,0,5,3
1713333800779,WES 237B,A00,494380,Staff,19,0,20,1
1713333802861,AESE 279B,A00,494370,Wade; Jon P,33,0,33,0
1713333803890,ANAR 135S,A00,494369,Braswell; Geoffrey E.,0,0,0,0
1713333804916,CAT 124RS,A01,519847,Geibel; William,17,0,20,3
1713333805949,CAT 125RS,A01,515971,Geibel; William,17,0,20,3
1713333806975,CLRE 250,A00,511389,Morris; Sheldon,9996,0,9999,3
1713333808008,CLRE 251,A00,507176,Mehta; Ravindra L.,9996,0,9999,3
1713333808008,CLRE 251,B00,511410,Mehta; Ravindra L.,9998,0,9999,1
1713333809035,CLRE 252,A00,507189,Cuomo; Raphael Eduardo,9998,0,9999,1
1713333810063,CLRE 253,A00,507199,Vaida; Florin,9997,0,9999,2
1713333810063,CLRE 253,B00,507202,Vaida; Florin,9999,0,9999,0
1713333811092,CLRE 259,A00,507211,Patel; Hemal,9996,0,9999,3
1713333812118,CLRE 260,A00,507221,Cuomo; Raphael Eduardo,9999,0,9999,0
1713333813144,CLRE 297,001,507242,Cuomo; Raphael Eduardo,9999,0,9999,0
1713333814175,CSE 191,A00,516875,Minnes Kemp; Mor Mia,9999,0,9999,0
1713333815210,CSS 201S,A01,494383,Staff,35,0,35,0
1713333816236,CSS 202S,A01,494387,Staff,35,0,35,0
1713333817261,EAP 100,A00,516065,Staff,9792,0,9999,207
1713333818287,ECE 45,A01,507414,Staff,51,0,60,9
1713333819326,ECE 100,A01,507416,Baghdadchi; Saharnaz,10,0,20,10
1713333819326,ECE 100,A02,507418,Baghdadchi; Saharnaz,20,0,20,0
1713333820357,ECE 111,A01,507420,Staff,38,0,50,12
1713333821383,ECE 197,001,548057,Sievenpiper; Daniel F.,9998,0,9999,1
1713333822412,EDS 115,A00,507243,Choi; Bailey Miyeon,28,0,28,0
1713333823445,EDS 117,A01,494379,Staff,23,0,25,2
1713333824470,EDS 125,A00,507246,Hopkins; Megan Beth,29,0,30,1
1713333825498,EDS 128A,A01,507264,Fargason; Sharon Gayle,26,0,26,0
1713333826525,EDS 128B,A01,507293,Pappas; Elizabeth,30,0,30,0
1713333827555,EDS 139,A00,507294,Fargason; Sharon Gayle,30,0,30,0
1713333827555,EDS 139,B00,507313,Pappas; Elizabeth,30,0,30,0
1713333828584,EDS 201,A00,507315,Staff,26,0,30,4
1713333829615,EDS 203,A01,507317,Halter; Christopher P.,26,0,30,4
1713333830647,EDS 204R,A01,507319,Halter; Christopher P.,3,0,30,27
1713333830647,EDS 204R,B01,507331,Heinzman; Erica M.,28,0,30,2
1713333831677,EDS 206R,A00,507332,Staff,4,0,30,26
1713333831677,EDS 206R,B00,507343,Staff,28,0,30,2
1713333832702,EDS 250,A00,507344,Hemans; Patricia Ann Benitez,36,0,40,4
1713333833728,EDS 281,A00,507345,Daly; Alan J.,18,0,18,0
1713333834757,EDS 284,A00,507350,Daly; Alan J.,16,0,16,0
1713333835791,EDS 286,A00,507359,Fine; Sarah,18,0,18,0
1713333836817,EDS 289C,A01,507361,Daly; Alan J.,18,0,18,0
1713333837845,EDS 290,A00,507366,Hofstetter; Carolyn,15,0,15,0
1713333838870,LIGM 5A,A00,507421,Fischer-Grunski; Eva K,20,0,20,0
1713333839904,LIGM 5B,A00,507423,Fischer-Grunski; Eva K,20,0,20,0
1713333840933,LIGM 5C,A00,507425,Fischer-Grunski; Eva K,20,0,20,0
1713333841958,LIIT 5AS,A00,507427,Carnelos; Chiara,20,0,20,0
1713333843001,LIIT 5BS,A00,507430,Carnelos; Chiara,20,0,20,0
1713333844032,LIIT 5CS,A00,507432,Carnelos; Chiara,20,0,20,0
1713333845080,LISP 5A,A00,507541,Munoz Sanchez; Alicia,17,0,20,3
1713333846124,LISP 5B,A00,507671,Munoz Sanchez; Alicia,15,0,20,5
1713333847151,LISP 5C,A00,507696,Munoz Sanchez; Alicia,15,0,20,5
1713333848178,MAE 197,001,528363,Boechler; Nicholas Sebastia,9998,0,9999,1
1713333849210,MATH 197,001,523477,Kedlaya; Kiran S.,9999,0,9999,0
1713333849210,MATH 197,002,563811,Zhang; Danna,9999,0,9999,0
1713333850236,MCWP 40R,A00,518780,Staff,20,0,20,0
1713333850236,MCWP 40R,B00,518781,Staff,19,0,20,1
1713333850236,MCWP 40R,C00,518783,Staff,19,0,20,1
1713333851263,MCWP 50R,A00,518791,Staff,20,0,20,0
1713333851263,MCWP 50R,B00,518792,Staff,17,0,20,3
1713333851263,MCWP 50R,C00,518793,Staff,19,0,20,1
1713333851263,MCWP 50R,D00,518794,Staff,16,0,20,4
1713333851263,MCWP 50R,E00,518795,Staff,16,0,20,4
1713333851263,MCWP 50R,F00,518796,Staff,19,0,20,1
1713333851263,MCWP 50R,G00,518797,Staff,19,0,20,1
1713333852292,MMW 12R,A01,514034,Herbst; Matthew,15,0,16,1
1713333852292,MMW 12R,A02,514035,Herbst; Matthew,16,0,16,0
1713333853330,MMW 13R,A01,514037,Staff,12,0,16,4
1713333853330,MMW 13R,A02,514039,Staff,16,0,16,0
1713333855396,SIO 295LS,A00,523233,Staff,19,0,30,11
1713333856432,SIO 295S,A00,523232,Staff,19,0,30,11
1713333857461,SOCI 117,A01,494376,Staff,2,0,5,3
1713333858504,WES 237B,A00,494380,Staff,19,0,20,1
1713333860574,AESE 279B,A00,494370,Wade; Jon P,33,0,33,0
1713333861599,ANAR 135S,A00,494369,Braswell; Geoffrey E.,0,0,0,0
1713333862624,CAT 124RS,A01,519847,Geibel; William,17,0,20,3
1713333863650,CAT 125RS,A01,515971,Geibel; William,17,0,20,3
1713333864676,CLRE 250,A00,511389,Morris; Sheldon,9996,0,9999,3
1713333865763,CLRE 251,A00,507176,Mehta; Ravindra L.,9996,0,9999,3
1713333865763,CLRE 251,B00,511410,Mehta; Ravindra L.,9998,0,9999,1
1713333866795,CLRE 252,A00,507189,Cuomo; Raphael Eduardo,9998,0,9999,1
1713333867821,CLRE 253,A00,507199,Vaida; Florin,9997,0,9999,2
1713333867821,CLRE 253,B00,507202,Vaida; Florin,9999,0,9999,0
1713333868852,CLRE 259,A00,507211,Patel; Hemal,9996,0,9999,3
1713333869884,CLRE 260,A00,507221,Cuomo; Raphael Eduardo,9999,0,9999,0
1713333870907,CLRE 297,001,507242,Cuomo; Raphael Eduardo,9999,0,9999,0
1713333871936,CSE 191,A00,516875,Minnes Kemp; Mor Mia,9999,0,9999,0
1713333872968,CSS 201S,A01,494383,Staff,35,0,35,0
1713333873996,CSS 202S,A01,494387,Staff,35,0,35,0
1713333875020,EAP 100,A00,516065,Staff,9792,0,9999,207
1713333876045,ECE 45,A01,507414,Staff,51,0,60,9
1713333877074,ECE 100,A01,507416,Baghdadchi; Saharnaz,10,0,20,10
1713333877074,ECE 100,A02,507418,Baghdadchi; Saharnaz,20,0,20,0
1713333878099,ECE 111,A01,507420,Staff,38,0,50,12
1713333879128,ECE 197,001,548057,Sievenpiper; Daniel F.,9998,0,9999,1
1713333880154,EDS 115,A00,507243,Choi; Bailey Miyeon,28,0,28,0
1713333881179,EDS 117,A01,494379,Staff,23,0,25,2
1713333882207,EDS 125,A00,507246,Hopkins; Megan Beth,29,0,30,1
1713333883234,EDS 128A,A01,507264,Fargason; Sharon Gayle,26,0,26,0
1713333884262,EDS 128B,A01,507293,Pappas; Elizabeth,30,0,30,0
1713333885286,EDS 139,A00,507294,Fargason; Sharon Gayle,30,0,30,0
1713333885286,EDS 139,B00,507313,Pappas; Elizabeth,30,0,30,0
1713333886311,EDS 201,A00,507315,Staff,26,0,30,4
1713333887340,EDS 203,A01,507317,Halter; Christopher P.,26,0,30,4
1713333888364,EDS 204R,A01,507319,Halter; Christopher P.,3,0,30,27
1713333888364,EDS 204R,B01,507331,Heinzman; Erica M.,28,0,30,2
1713333889389,EDS 206R,A00,507332,Staff,4,0,30,26
1713333889389,EDS 206R,B00,507343,Staff,28,0,30,2
1713333890414,EDS 250,A00,507344,Hemans; Patricia Ann Benitez,36,0,40,4
1713333891442,EDS 281,A00,507345,Daly; Alan J.,18,0,18,0
1713333892470,EDS 284,A00,507350,Daly; Alan J.,16,0,16,0
1713333893494,EDS 286,A00,507359,Fine; Sarah,18,0,18,0
1713333894517,EDS 289C,A01,507361,Daly; Alan J.,18,0,18,0
1713333895543,EDS 290,A00,507366,Hofstetter; Carolyn,15,0,15,0
1713333896568,LIGM 5A,A00,507421,Fischer-Grunski; Eva K,20,0,20,0
1713333897598,LIGM 5B,A00,507423,Fischer-Grunski; Eva K,20,0,20,0
1713333898626,LIGM 5C,A00,507425,Fischer-Grunski; Eva K,20,0,20,0
1713333899652,LIIT 5AS,A00,507427,Carnelos; Chiara,20,0,20,0
1713333900678,LIIT 5BS,A00,507430,Carnelos; Chiara,20,0,20,0
1713333901712,LIIT 5CS,A00,507432,Carnelos; Chiara,20,0,20,0
1713333902737,LISP 5A,A00,507541,Munoz Sanchez; Alicia,17,0,20,3
1713333903767,LISP 5B,A00,507671,Munoz Sanchez; Alicia,15,0,20,5
1713333904792,LISP 5C,A00,507696,Munoz Sanchez; Alicia,15,0,20,5
1713333905818,MAE 197,001,528363,Boechler; Nicholas Sebastia,9998,0,9999,1
1713333906854,MATH 197,001,523477,Kedlaya; Kiran S.,9999,0,9999,0
1713333906854,MATH 197,002,563811,Zhang; Danna,9999,0,9999,0
1713333907885,MCWP 40R,A00,518780,Staff,20,0,20,0
1713333907885,MCWP 40R,B00,518781,Staff,19,0,20,1
1713333907885,MCWP 40R,C00,518783,Staff,19,0,20,1
1713333908911,MCWP 50R,A00,518791,Staff,20,0,20,0
1713333908911,MCWP 50R,B00,518792,Staff,17,0,20,3
1713333908911,MCWP 50R,C00,518793,Staff,19,0,20,1
1713333908911,MCWP 50R,D00,518794,Staff,16,0,20,4
1713333908911,MCWP 50R,E00,518795,Staff,16,0,20,4
1713333908911,MCWP 50R,F00,518796,Staff,19,0,20,1
1713333908911,MCWP 50R,G00,518797,Staff,19,0,20,1
1713333909939,MMW 12R,A01,514034,Herbst; Matthew,15,0,16,1
1713333909939,MMW 12R,A02,514035,Herbst; Matthew,16,0,16,0
1713333910965,MMW 13R,A01,514037,Staff,12,0,16,4
1713333910965,MMW 13R,A02,514039,Staff,16,0,16,0
1713333913019,SIO 295LS,A00,523233,Staff,19,0,30,11
1713333914052,SIO 295S,A00,523232,Staff,19,0,30,11
1713333915080,SOCI 117,A01,494376,Staff,2,0,5,3
1713333916105,WES 237B,A00,494380,Staff,19,0,20,1
1713333918208,AESE 279B,A00,494370,Wade; Jon P,33,0,33,0
1713333919240,ANAR 135S,A00,494369,Braswell; Geoffrey E.,0,0,0,0
1713333920268,CAT 124RS,A01,519847,Geibel; William,17,0,20,3
1713333921302,CAT 125RS,A01,515971,Geibel; William,17,0,20,3
1713333922333,CLRE 250,A00,511389,Morris; Sheldon,9996,0,9999,3
1713333923359,CLRE 251,A00,507176,Mehta; Ravindra L.,9996,0,9999,3
1713333923359,CLRE 251,B00,511410,Mehta; Ravindra L.,9998,0,9999,1
1713333924383,CLRE 252,A00,507189,Cuomo; Raphael Eduardo,9998,0,9999,1
1713333925413,CLRE 253,A00,507199,Vaida; Florin,9997,0,9999,2
1713333925413,CLRE 253,B00,507202,Vaida; Florin,9999,0,9999,0
1713333926439,CLRE 259,A00,507211,Patel; Hemal,9996,0,9999,3
1713333927465,CLRE 260,A00,507221,Cuomo; Raphael Eduardo,9999,0,9999,0
1713333928491,CLRE 297,001,507242,Cuomo; Raphael Eduardo,9999,0,9999,0
1713333929518,CSE 191,A00,516875,Minnes Kemp; Mor Mia,9999,0,9999,0
1713333930548,CSS 201S,A01,494383,Staff,35,0,35,0
1713333931576,CSS 202S,A01,494387,Staff,35,0,35,0
1713333932601,EAP 100,A00,516065,Staff,9792,0,9999,207
1713333933628,ECE 45,A01,507414,Staff,51,0,60,9
1713333934659,ECE 100,A01,507416,Baghdadchi; Saharnaz,10,0,20,10
1713333934659,ECE 100,A02,507418,Baghdadchi; Saharnaz,20,0,20,0
1713333935684,ECE 111,A01,507420,Staff,38,0,50,12
1713333936710,ECE 197,001,548057,Sievenpiper; Daniel F.,9998,0,9999,1
1713333937737,EDS 115,A00,507243,Choi; Bailey Miyeon,28,0,28,0
1713333938762,EDS 117,A01,494379,Staff,23,0,25,2
1713333939788,EDS 125,A00,507246,Hopkins; Megan Beth,29,0,30,1
1713333940813,EDS 128A,A01,507264,Fargason; Sharon Gayle,26,0,26,0
1713333941842,EDS 128B,A01,507293,Pappas; Elizabeth,30,0,30,0
1713333942867,EDS 139,A00,507294,Fargason; Sharon Gayle,30,0,30,0
1713333942867,EDS 139,B00,507313,Pappas; Elizabeth,30,0,30,0
1713333943904,EDS 201,A00,507315,Staff,26,0,30,4
1713333944931,EDS 203,A01,507317,Halter; Christopher P.,26,0,30,4
1713333945956,EDS 204R,A01,507319,Halter; Christopher P.,3,0,30,27
1713333945956,EDS 204R,B01,507331,Heinzman; Erica M.,28,0,30,2
1713333946989,EDS 206R,A00,507332,Staff,4,0,30,26
1713333946989,EDS 206R,B00,507343,Staff,28,0,30,2
1713333948013,EDS 250,A00,507344,Hemans; Patricia Ann Benitez,36,0,40,4
1713333949037,EDS 281,A00,507345,Daly; Alan J.,18,0,18,0
1713333950061,EDS 284,A00,507350,Daly; Alan J.,16,0,16,0
1713333951089,EDS 286,A00,507359,Fine; Sarah,18,0,18,0
1713333952114,EDS 289C,A01,507361,Daly; Alan J.,18,0,18,0
1713333953138,EDS 290,A00,507366,Hofstetter; Carolyn,15,0,15,0
1713333954165,LIGM 5A,A00,507421,Fischer-Grunski; Eva K,20,0,20,0
1713333955191,LIGM 5B,A00,507423,Fischer-Grunski; Eva K,20,0,20,0
1713333956216,LIGM 5C,A00,507425,Fischer-Grunski; Eva K,20,0,20,0
1713333957243,LIIT 5AS,A00,507427,Carnelos; Chiara,20,0,20,0
1713333958268,LIIT 5BS,A00,507430,Carnelos; Chiara,20,0,20,0
1713333959297,LIIT 5CS,A00,507432,Carnelos; Chiara,20,0,20,0
1713333960322,LISP 5A,A00,507541,Munoz Sanchez; Alicia,17,0,20,3
1713333961355,LISP 5B,A00,507671,Munoz Sanchez; Alicia,15,0,20,5
1713333962380,LISP 5C,A00,507696,Munoz Sanchez; Alicia,15,0,20,5
1713333963408,MAE 197,001,528363,Boechler; Nicholas Sebastia,9998,0,9999,1
1713333964437,MATH 197,001,523477,Kedlaya; Kiran S.,9999,0,9999,0
1713333964437,MATH 197,002,563811,Zhang; Danna,9999,0,9999,0
1713333965460,MCWP 40R,A00,518780,Staff,20,0,20,0
1713333965460,MCWP 40R,B00,518781,Staff,19,0,20,1
1713333965460,MCWP 40R,C00,518783,Staff,19,0,20,1
1713333966486,MCWP 50R,A00,518791,Staff,20,0,20,0
1713333966486,MCWP 50R,B00,518792,Staff,17,0,20,3
1713333966486,MCWP 50R,C00,518793,Staff,19,0,20,1
1713333966486,MCWP 50R,D00,518794,Staff,16,0,20,4
1713333966486,MCWP 50R,E00,518795,Staff,16,0,20,4
1713333966486,MCWP 50R,F00,518796,Staff,19,0,20,1
1713333966486,MCWP 50R,G00,518797,Staff,19,0,20,1
1713333967512,MMW 12R,A01,514034,Herbst; Matthew,15,0,16,1
1713333967512,MMW 12R,A02,514035,Herbst; Matthew,16,0,16,0
1713333968540,MMW 13R,A01,514037,Staff,12,0,16,4
1713333968540,MMW 13R,A02,514039,Staff,16,0,16,0
1713333970649,SIO 295LS,A00,523233,Staff,19,0,30,11
1713333971673,SIO 295S,A00,523232,Staff,19,0,30,11
1713333972704,SOCI 117,A01,494376,Staff,2,0,5,3
1713333973728,WES 237B,A00,494380,Staff,19,0,20,1
1713333975796,AESE 279B,A00,494370,Wade; Jon P,33,0,33,0
1713333976827,ANAR 135S,A00,494369,Braswell; Geoffrey E.,0,0,0,0
1713333977856,CAT 124RS,A01,519847,Geibel; William,17,0,20,3
1713333978886,CAT 125RS,A01,515971,Geibel; William,17,0,20,3
1713333979914,CLRE 250,A00,511389,Morris; Sheldon,9996,0,9999,3
1713333980940,CLRE 251,A00,507176,Mehta; Ravindra L.,9996,0,9999,3
1713333980940,CLRE 251,B00,511410,Mehta; Ravindra L.,9998,0,9999,1
1713333981969,CLRE 252,A00,507189,Cuomo; Raphael Eduardo,9998,0,9999,1
1713333982997,CLRE 253,A00,507199,Vaida; Florin,9997,0,9999,2
1713333982997,CLRE 253,B00,507202,Vaida; Florin,9999,0,9999,0
1713333984026,CLRE 259,A00,507211,Patel; Hemal,9996,0,9999,3
1713333985051,CLRE 260,A00,507221,Cuomo; Raphael Eduardo,9999,0,9999,0
1713333986075,CLRE 297,001,507242,Cuomo; Raphael Eduardo,9999,0,9999,0
1713333987099,CSE 191,A00,516875,Minnes Kemp; Mor Mia,9999,0,9999,0
1713333988129,CSS 201S,A01,494383,Staff,35,0,35,0
1713333989159,CSS 202S,A01,494387,Staff,35,0,35,0
1713333990185,EAP 100,A00,516065,Staff,9792,0,9999,207
1713333991212,ECE 45,A01,507414,Staff,51,0,60,9
1713333992242,ECE 100,A01,507416,Baghdadchi; Saharnaz,10,0,20,10
1713333992242,ECE 100,A02,507418,Baghdadchi; Saharnaz,20,0,20,0
1713333993268,ECE 111,A01,507420,Staff,38,0,50,12
1713333994293,ECE 197,001,548057,Sievenpiper; Daniel F.,9998,0,9999,1
1713333995321,EDS 115,A00,507243,Choi; Bailey Miyeon,28,0,28,0
1713333996347,EDS 117,A01,494379,Staff,23,0,25,2
1713333997377,EDS 125,A00,507246,Hopkins; Megan Beth,29,0,30,1
1713333998402,EDS 128A,A01,507264,Fargason; Sharon Gayle,26,0,26,0
1713333999434,EDS 128B,A01,507293,Pappas; Elizabeth,30,0,30,0
1713334000463,EDS 139,A00,507294,Fargason; Sharon Gayle,30,0,30,0
1713334000463,EDS 139,B00,507313,Pappas; Elizabeth,30,0,30,0
1713334001486,EDS 201,A00,507315,Staff,26,0,30,4
1713334002512,EDS 203,A01,507317,Halter; Christopher P.,26,0,30,4
1713334003537,EDS 204R,A01,507319,Halter; Christopher P.,3,0,30,27
1713334003537,EDS 204R,B01,507331,Heinzman; Erica M.,28,0,30,2
1713334004564,EDS 206R,A00,507332,Staff,4,0,30,26
1713334004564,EDS 206R,B00,507343,Staff,28,0,30,2
1713334005588,EDS 250,A00,507344,Hemans; Patricia Ann Benitez,36,0,40,4
1713334006613,EDS 281,A00,507345,Daly; Alan J.,18,0,18,0
1713334007638,EDS 284,A00,507350,Daly; Alan J.,16,0,16,0
1713334008663,EDS 286,A00,507359,Fine; Sarah,18,0,18,0
1713334009688,EDS 289C,A01,507361,Daly; Alan J.,18,0,18,0
1713334010711,EDS 290,A00,507366,Hofstetter; Carolyn,15,0,15,0
1713334011740,LIGM 5A,A00,507421,Fischer-Grunski; Eva K,20,0,20,0
1713334012769,LIGM 5B,A00,507423,Fischer-Grunski; Eva K,20,0,20,0
1713334013796,LIGM 5C,A00,507425,Fischer-Grunski; Eva K,20,0,20,0
1713334014821,LIIT 5AS,A00,507427,Carnelos; Chiara,20,0,20,0
1713334015851,LIIT 5BS,A00,507430,Carnelos; Chiara,20,0,20,0
1713334016875,LIIT 5CS,A00,507432,Carnelos; Chiara,20,0,20,0
1713334017905,LISP 5A,A00,507541,Munoz Sanchez; Alicia,17,0,20,3
1713334018930,LISP 5B,A00,507671,Munoz Sanchez; Alicia,15,0,20,5
1713334019954,LISP 5C,A00,507696,Munoz Sanchez; Alicia,15,0,20,5
1713334020979,MAE 197,001,528363,Boechler; Nicholas Sebastia,9998,0,9999,1
1713334022005,MATH 197,001,523477,Kedlaya; Kiran S.,9999,0,9999,0
1713334022005,MATH 197,002,563811,Zhang; Danna,9999,0,9999,0
1713334023029,MCWP 40R,A00,518780,Staff,20,0,20,0
1713334023029,MCWP 40R,B00,518781,Staff,19,0,20,1
1713334023029,MCWP 40R,C00,518783,Staff,19,0,20,1
1713334024056,MCWP 50R,A00,518791,Staff,20,0,20,0
1713334024056,MCWP 50R,B00,518792,Staff,17,0,20,3
1713334024056,MCWP 50R,C00,518793,Staff,19,0,20,1
1713334024056,MCWP 50R,D00,518794,Staff,16,0,20,4
1713334024056,MCWP 50R,E00,518795,Staff,16,0,20,4
1713334024056,MCWP 50R,F00,518796,Staff,19,0,20,1
1713334024056,MCWP 50R,G00,518797,Staff,19,0,20,1
1713334025085,MMW 12R,A01,514034,Herbst; Matthew,15,0,16,1
1713334025085,MMW 12R,A02,514035,Herbst; Matthew,16,0,16,0
1713334026115,MMW 13R,A01,514037,Staff,12,0,16,4
1713334026115,MMW 13R,A02,514039,Staff,16,0,16,0
1713334028167,SIO 295LS,A00,523233,Staff,19,0,30,11
1713334029193,SIO 295S,A00,523232,Staff,19,0,30,11
1713334030224,SOCI 117,A01,494376,Staff,2,0,5,3
1713334031252,WES 237B,A00,494380,Staff,19,0,20,1
1713334033320,AESE 279B,A00,494370,Wade; Jon P,33,0,33,0
1713334034347,ANAR 135S,A00,494369,Braswell; Geoffrey E.,0,0,0,0
1713334035578,CAT 124RS,A01,519847,Geibel; William,17,0,20,3
1713334036606,CAT 125RS,A01,515971,Geibel; William,17,0,20,3
1713334037632,CLRE 250,A00,511389,Morris; Sheldon,9996,0,9999,3
1713334038660,CLRE 251,A00,507176,Mehta; Ravindra L.,9996,0,9999,3
1713334038660,CLRE 251,B00,511410,Mehta; Ravindra L.,9998,0,9999,1
1713334039687,CLRE 252,A00,507189,Cuomo; Raphael Eduardo,9998,0,9999,1
1713334040715,CLRE 253,A00,507199,Vaida; Florin,9997,0,9999,2
1713334040715,CLRE 253,B00,507202,Vaida; Florin,9999,0,9999,0
1713334041742,CLRE 259,A00,507211,Patel; Hemal,9996,0,9999,3
1713334042767,CLRE 260,A00,507221,Cuomo; Raphael Eduardo,9999,0,9999,0
1713334043796,CLRE 297,001,507242,Cuomo; Raphael Eduardo,9999,0,9999,0
1713334044821,CSE 191,A00,516875,Minnes Kemp; Mor Mia,9999,0,9999,0
1713334045846,CSS 201S,A01,494383,Staff,35,0,35,0
1713334046870,CSS 202S,A01,494387,Staff,35,0,35,0
1713334047896,EAP 100,A00,516065,Staff,9792,0,9999,207
1713334048921,ECE 45,A01,507414,Staff,51,0,60,9
1713334049954,ECE 100,A01,507416,Baghdadchi; Saharnaz,10,0,20,10
1713334049954,ECE 100,A02,507418,Baghdadchi; Saharnaz,20,0,20,0
1713334050979,ECE 111,A01,507420,Staff,38,0,50,12
1713334052008,ECE 197,001,548057,Sievenpiper; Daniel F.,9998,0,9999,1
1713334053033,EDS 115,A00,507243,Choi; Bailey Miyeon,28,0,28,0
1713334054058,EDS 117,A01,494379,Staff,23,0,25,2
1713334055088,EDS 125,A00,507246,Hopkins; Megan Beth,29,0,30,1
1713334056113,EDS 128A,A01,507264,Fargason; Sharon Gayle,26,0,26,0
1713334057138,EDS 128B,A01,507293,Pappas; Elizabeth,30,0,30,0
1713334058167,EDS 139,A00,507294,Fargason; Sharon Gayle,30,0,30,0
1713334058167,EDS 139,B00,507313,Pappas; Elizabeth,30,0,30,0
1713334059195,EDS 201,A00,507315,Staff,26,0,30,4
1713334060220,EDS 203,A01,507317,Halter; Christopher P.,26,0,30,4
1713334061250,EDS 204R,A01,507319,Halter; Christopher P.,3,0,30,27
1713334061250,EDS 204R,B01,507331,Heinzman; Erica M.,28,0,30,2
1713334062278,EDS 206R,A00,507332,Staff,4,0,30,26
1713334062278,EDS 206R,B00,507343,Staff,28,0,30,2
1713334063306,EDS 250,A00,507344,Hemans; Patricia Ann Benitez,36,0,40,4
1713334064336,EDS 281,A00,507345,Daly; Alan J.,18,0,18,0
1713334065360,EDS 284,A00,507350,Daly; Alan J.,16,0,16,0
1713334066389,EDS 286,A00,507359,Fine; Sarah,18,0,18,0
1713334067413,EDS 289C,A01,507361,Daly; Alan J.,18,0,18,0
1713334068441,EDS 290,A00,507366,Hofstetter; Carolyn,15,0,15,0
1713334069467,LIGM 5A,A00,507421,Fischer-Grunski; Eva K,20,0,20,0
1713334070496,LIGM 5B,A00,507423,Fischer-Grunski; Eva K,20,0,20,0
1713334071521,LIGM 5C,A00,507425,Fischer-Grunski; Eva K,20,0,20,0
1713334072547,LIIT 5AS,A00,507427,Carnelos; Chiara,20,0,20,0
1713334073629,LIIT 5BS,A00,507430,Carnelos; Chiara,20,0,20,0
1713334074655,LIIT 5CS,A00,507432,Carnelos; Chiara,20,0,20,0
1713334075682,LISP 5A,A00,507541,Munoz Sanchez; Alicia,17,0,20,3
1713334076710,LISP 5B,A00,507671,Munoz Sanchez; Alicia,15,0,20,5
1713334077740,LISP 5C,A00,507696,Munoz Sanchez; Alicia,15,0,20,5
1713334078769,MAE 197,001,528363,Boechler; Nicholas Sebastia,9998,0,9999,1
1713334079800,MATH 197,001,523477,Kedlaya; Kiran S.,9999,0,9999,0
1713334079800,MATH 197,002,563811,Zhang; Danna,9999,0,9999,0
1713334080827,MCWP 40R,A00,518780,Staff,20,0,20,0
1713334080827,MCWP 40R,B00,518781,Staff,19,0,20,1
1713334080827,MCWP 40R,C00,518783,Staff,19,0,20,1
1713334081852,MCWP 50R,A00,518791,Staff,20,0,20,0
1713334081852,MCWP 50R,B00,518792,Staff,17,0,20,3
1713334081852,MCWP 50R,C00,518793,Staff,19,0,20,1
1713334081852,MCWP 50R,D00,518794,Staff,16,0,20,4
1713334081852,MCWP 50R,E00,518795,Staff,16,0,20,4
1713334081852,MCWP 50R,F00,518796,Staff,19,0,20,1
1713334081852,MCWP 50R,G00,518797,Staff,19,0,20,1
1713334082883,MMW 12R,A01,514034,Herbst; Matthew,15,0,16,1
1713334082883,MMW 12R,A02,514035,Herbst; Matthew,16,0,16,0
1713334083908,MMW 13R,A01,514037,Staff,12,0,16,4
1713334083908,MMW 13R,A02,514039,Staff,16,0,16,0
1713334085964,SIO 295LS,A00,523233,Staff,19,0,30,11
1713334086991,SIO 295S,A00,523232,Staff,19,0,30,11
1713334088018,SOCI 117,A01,494376,Staff,2,0,5,3
1713334089045,WES 237B,A00,494380,Staff,19,0,20,1
1713334091128,AESE 279B,A00,494370,Wade; Jon P,33,0,33,0
1713334092153,ANAR 135S,A00,494369,Braswell; Geoffrey E.,0,0,0,0
1713334093179,CAT 124RS,A01,519847,Geibel; William,17,0,20,3
1713334094207,CAT 125RS,A01,515971,Geibel; William,17,0,20,3
1713334095237,CLRE 250,A00,511389,Morris; Sheldon,9996,0,9999,3
1713334096264,CLRE 251,A00,507176,Mehta; Ravindra L.,9996,0,9999,3
1713334096264,CLRE 251,B00,511410,Mehta; Ravindra L.,9998,0,9999,1
1713334097290,CLRE 252,A00,507189,Cuomo; Raphael Eduardo,9998,0,9999,1
1713334098321,CLRE 253,A00,507199,Vaida; Florin,9997,0,9999,2
1713334098321,CLRE 253,B00,507202,Vaida; Florin,9999,0,9999,0
1713334099346,CLRE 259,A00,507211,Patel; Hemal,9996,0,9999,3
1713334100370,CLRE 260,A00,507221,Cuomo; Raphael Eduardo,9999,0,9999,0
1713334101395,CLRE 297,001,507242,Cuomo; Raphael Eduardo,9999,0,9999,0
1713334102423,CSE 191,A00,516875,Minnes Kemp; Mor Mia,9999,0,9999,0
1713334103453,CSS 201S,A01,494383,Staff,35,0,35,0
1713334104479,CSS 202S,A01,494387,Staff,35,0,35,0
1713334105507,EAP 100,A00,516065,Staff,9792,0,9999,207
1713334106533,ECE 45,A01,507414,Staff,51,0,60,9
1713334107559,ECE 100,A01,507416,Baghdadchi; Saharnaz,10,0,20,10
1713334107559,ECE 100,A02,507418,Baghdadchi; Saharnaz,20,0,20,0
1713334108583,ECE 111,A01,507420,Staff,38,0,50,12
1713334109607,ECE 197,001,548057,Sievenpiper; Daniel F.,9998,0,9999,1
1713334110636,EDS 115,A00,507243,Choi; Bailey Miyeon,28,0,28,0
1713334111665,EDS 117,A01,494379,Staff,23,0,25,2
1713334112694,EDS 125,A00,507246,Hopkins; Megan Beth,29,0,30,1
1713334113723,EDS 128A,A01,507264,Fargason; Sharon Gayle,26,0,26,0
1713334114748,EDS 128B,A01,507293,Pappas; Elizabeth,30,0,30,0
1713334115774,EDS 139,A00,507294,Fargason; Sharon Gayle,30,0,30,0
1713334115774,EDS 139,B00,507313,Pappas; Elizabeth,30,0,30,0
1713334116802,EDS 201,A00,507315,Staff,26,0,30,4
1713334117830,EDS 203,A01,507317,Halter; Christopher P.,26,0,30,4
1713334118856,EDS 204R,A01,507319,Halter; Christopher P.,3,0,30,27
1713334118856,EDS 204R,B01,507331,Heinzman; Erica M.,28,0,30,2
1713334119882,EDS 206R,A00,507332,Staff,4,0,30,26
1713334119882,EDS 206R,B00,507343,Staff,28,0,30,2
1713334120912,EDS 250,A00,507344,Hemans; Patricia Ann Benitez,36,0,40,4
1713334121940,EDS 281,A00,507345,Daly; Alan J.,18,0,18,0
1713334122966,EDS 284,A00,507350,Daly; Alan J.,16,0,16,0
1713334123994,EDS 286,A00,507359,Fine; Sarah,18,0,18,0
1713334125020,EDS 289C,A01,507361,Daly; Alan J.,18,0,18,0
1713334126048,EDS 290,A00,507366,Hofstetter; Carolyn,15,0,15,0
1713334127078,LIGM 5A,A00,507421,Fischer-Grunski; Eva K,20,0,20,0
1713334128103,LIGM 5B,A00,507423,Fischer-Grunski; Eva K,20,0,20,0
1713334129126,LIGM 5C,A00,507425,Fischer-Grunski; Eva K,20,0,20,0
1713334130153,LIIT 5AS,A00,507427,Carnelos; Chiara,20,0,20,0
1713334131179,LIIT 5BS,A00,507430,Carnelos; Chiara,20,0,20,0
1713334132202,LIIT 5CS,A00,507432,Carnelos; Chiara,20,0,20,0
1713334133228,LISP 5A,A00,507541,Munoz Sanchez; Alicia,17,0,20,3
1713334134253,LISP 5B,A00,507671,Munoz Sanchez; Alicia,15,0,20,5
1713334135278,LISP 5C,A00,507696,Munoz Sanchez; Alicia,15,0,20,5
1713334136304,MAE 197,001,528363,Boechler; Nicholas Sebastia,9998,0,9999,1
1713334137329,MATH 197,001,523477,Kedlaya; Kiran S.,9999,0,9999,0
1713334137329,MATH 197,002,563811,Zhang; Danna,9999,0,9999,0
1713334138358,MCWP 40R,A00,518780,Staff,20,0,20,0
1713334138358,MCWP 40R,B00,518781,Staff,19,0,20,1
1713334138358,MCWP 40R,C00,518783,Staff,19,0,20,1
1713334139385,MCWP 50R,A00,518791,Staff,20,0,20,0
1713334139385,MCWP 50R,B00,518792,Staff,17,0,20,3
1713334139385,MCWP 50R,C00,518793,Staff,19,0,20,1
1713334139385,MCWP 50R,D00,518794,Staff,16,0,20,4
1713334139385,MCWP 50R,E00,518795,Staff,16,0,20,4
1713334139385,MCWP 50R,F00,518796,Staff,19,0,20,1
1713334139385,MCWP 50R,G00,518797,Staff,19,0,20,1
1713334140414,MMW 12R,A01,514034,Herbst; Matthew,15,0,16,1
1713334140414,MMW 12R,A02,514035,Herbst; Matthew,16,0,16,0
1713334141445,MMW 13R,A01,514037,Staff,12,0,16,4
1713334141445,MMW 13R,A02,514039,Staff,16,0,16,0
1713334143502,SIO 295LS,A00,523233,Staff,19,0,30,11
1713334144527,SIO 295S,A00,523232,Staff,19,0,30,11
1713334145552,SOCI 117,A01,494376,Staff,2,0,5,3
1713334146582,WES 237B,A00,494380,Staff,19,0,20,1
1713334148645,AESE 279B,A00,494370,Wade; Jon P,33,0,33,0
1713334149670,ANAR 135S,A00,494369,Braswell; Geoffrey E.,0,0,0,0
1713334150695,CAT 124RS,A01,519847,Geibel; William,17,0,20,3
1713334151721,CAT 125RS,A01,515971,Geibel; William,17,0,20,3
1713334152746,CLRE 250,A00,511389,Morris; Sheldon,9996,0,9999,3
1713334153778,CLRE 251,A00,507176,Mehta; Ravindra L.,9996,0,9999,3
1713334153778,CLRE 251,B00,511410,Mehta; Ravindra L.,9998,0,9999,1
1713334154809,CLRE 252,A00,507189,Cuomo; Raphael Eduardo,9998,0,9999,1
1713334155839,CLRE 253,A00,507199,Vaida; Florin,9997,0,9999,2
1713334155839,CLRE 253,B00,507202,Vaida; Florin,9999,0,9999,0
1713334157102,CLRE 259,A00,507211,Patel; Hemal,9996,0,9999,3
1713334158128,CLRE 260,A00,507221,Cuomo; Raphael Eduardo,9999,0,9999,0
1713334159157,CLRE 297,001,507242,Cuomo; Raphael Eduardo,9999,0,9999,0
1713334160182,CSE 191,A00,516875,Minnes Kemp; Mor Mia,9999,0,9999,0
1713334161214,CSS 201S,A01,494383,Staff,35,0,35,0
1713334162240,CSS 202S,A01,494387,Staff,35,0,35,0
1713334163268,EAP 100,A00,516065,Staff,9792,0,9999,207
1713334164293,ECE 45,A01,507414,Staff,51,0,60,9
1713334165323,ECE 100,A01,507416,Baghdadchi; Saharnaz,10,0,20,10
1713334165323,ECE 100,A02,507418,Baghdadchi; Saharnaz,20,0,20,0
1713334166349,ECE 111,A01,507420,Staff,38,0,50,12
1713334167373,ECE 197,001,548057,Sievenpiper; Daniel F.,9998,0,9999,1
1713334168398,EDS 115,A00,507243,Choi; Bailey Miyeon,28,0,28,0
1713334169427,EDS 117,A01,494379,Staff,23,0,25,2
1713334170457,EDS 125,A00,507246,Hopkins; Megan Beth,29,0,30,1
1713334171486,EDS 128A,A01,507264,Fargason; Sharon Gayle,26,0,26,0
1713334172513,EDS 128B,A01,507293,Pappas; Elizabeth,30,0,30,0
1713334173537,EDS 139,A00,507294,Fargason; Sharon Gayle,30,0,30,0
1713334173537,EDS 139,B00,507313,Pappas; Elizabeth,30,0,30,0
1713334174561,EDS 201,A00,507315,Staff,26,0,30,4
1713334175592,EDS 203,A01,507317,Halter; Christopher P.,26,0,30,4
1713334176618,EDS 204R,A01,507319,Halter; Christopher P.,3,0,30,27
1713334176618,EDS 204R,B01,507331,Heinzman; Erica M.,28,0,30,2
1713334177698,EDS 206R,A00,507332,Staff,4,0,30,26
1713334177698,EDS 206R,B00,507343,Staff,28,0,30,2
1713334178728,EDS 250,A00,507344,Hemans; Patricia Ann Benitez,36,0,40,4
1713334179757,EDS 281,A00,507345,Daly; Alan J.,18,0,18,0
1713334180785,EDS 284,A00,507350,Daly; Alan J.,16,0,16,0
1713334181811,EDS 286,A00,507359,Fine; Sarah,18,0,18,0
1713334182834,EDS 289C,A01,507361,Daly; Alan J.,18,0,18,0
1713334183870,EDS 290,A00,507366,Hofstetter; Carolyn,15,0,15,0
1713334184899,LIGM 5A,A00,507421,Fischer-Grunski; Eva K,20,0,20,0
1713334185927,LIGM 5B,A00,507423,Fischer-Grunski; Eva K,20,0,20,0
1713334186953,LIGM 5C,A00,507425,Fischer-Grunski; Eva K,20,0,20,0
1713334187981,LIIT 5AS,A00,507427,Carnelos; Chiara,20,0,20,0
1713334189007,LIIT 5BS,A00,507430,Carnelos; Chiara,20,0,20,0
1713334190032,LIIT 5CS,A00,507432,Carnelos; Chiara,20,0,20,0
1713334191059,LISP 5A,A00,507541,Munoz Sanchez; Alicia,17,0,20,3
1713334192088,LISP 5B,A00,507671,Munoz Sanchez; Alicia,15,0,20,5
1713334193114,LISP 5C,A00,507696,Munoz Sanchez; Alicia,15,0,20,5
1713334194144,MAE 197,001,528363,Boechler; Nicholas Sebastia,9998,0,9999,1
1713334195175,MATH 197,001,523477,Kedlaya; Kiran S.,9999,0,9999,0
1713334195175,MATH 197,002,563811,Zhang; Danna,9999,0,9999,0
1713334196204,MCWP 40R,A00,518780,Staff,20,0,20,0
1713334196204,MCWP 40R,B00,518781,Staff,19,0,20,1
1713334196204,MCWP 40R,C00,518783,Staff,19,0,20,1
1713334197233,MCWP 50R,A00,518791,Staff,20,0,20,0
1713334197233,MCWP 50R,B00,518792,Staff,17,0,20,3
1713334197233,MCWP 50R,C00,518793,Staff,19,0,20,1
1713334197233,MCWP 50R,D00,518794,Staff,16,0,20,4
1713334197233,MCWP 50R,E00,518795,Staff,16,0,20,4
1713334197233,MCWP 50R,F00,518796,Staff,19,0,20,1
1713334197233,MCWP 50R,G00,518797,Staff,19,0,20,1
1713334198263,MMW 12R,A01,514034,Herbst; Matthew,15,0,16,1
1713334198263,MMW 12R,A02,514035,Herbst; Matthew,16,0,16,0
1713334199290,MMW 13R,A01,514037,Staff,12,0,16,4
1713334199290,MMW 13R,A02,514039,Staff,16,0,16,0
1713334201339,SIO 295LS,A00,523233,Staff,19,0,30,11
1713334202368,SIO 295S,A00,523232,Staff,19,0,30,11
1713334203397,SOCI 117,A01,494376,Staff,2,0,5,3
1713334204421,WES 237B,A00,494380,Staff,19,0,20,1
1713334206479,AESE 279B,A00,494370,Wade; Jon P,33,0,33,0
1713334207504,ANAR 135S,A00,494369,Braswell; Geoffrey E.,0,0,0,0
1713334208531,CAT 124RS,A01,519847,Geibel; William,17,0,20,3
1713334209560,CAT 125RS,A01,515971,Geibel; William,17,0,20,3
1713334210587,CLRE 250,A00,511389,Morris; Sheldon,9996,0,9999,3
1713334211614,CLRE 251,A00,507176,Mehta; Ravindra L.,9996,0,9999,3
1713334211614,CLRE 251,B00,511410,Mehta; Ravindra L.,9998,0,9999,1
1713334212641,CLRE 252,A00,507189,Cuomo; Raphael Eduardo,9998,0,9999,1
1713334213682,CLRE 253,A00,507199,Vaida; Florin,9997,0,9999,2
1713334213682,CLRE 253,B00,507202,Vaida; Florin,9999,0,9999,0
1713334214706,CLRE 259,A00,507211,Patel; Hemal,9996,0,9999,3
1713334215732,CLRE 260,A00,507221,Cuomo; Raphael Eduardo,9999,0,9999,0
1713334216761,CLRE 297,001,507242,Cuomo; Raphael Eduardo,9999,0,9999,0
1713334217787,CSE 191,A00,516875,Minnes Kemp; Mor Mia,9999,0,9999,0
1713334218812,CSS 201S,A01,494383,Staff,35,0,35,0
1713334219838,CSS 202S,A01,494387,Staff,35,0,35,0
1713334220866,EAP 100,A00,516065,Staff,9792,0,9999,207
1713334221890,ECE 45,A01,507414,Staff,51,0,60,9
1713334222919,ECE 100,A01,507416,Baghdadchi; Saharnaz,10,0,20,10
1713334222919,ECE 100,A02,507418,Baghdadchi; Saharnaz,20,0,20,0
1713334223944,ECE 111,A01,507420,Staff,38,0,50,12
1713334224974,ECE 197,001,548057,Sievenpiper; Daniel F.,9998,0,9999,1
1713334226005,EDS 115,A00,507243,Choi; Bailey Miyeon,28,0,28,0
1713334227036,EDS 117,A01,494379,Staff,23,0,25,2
1713334228066,EDS 125,A00,507246,Hopkins; Megan Beth,29,0,30,1
1713334229095,EDS 128A,A01,507264,Fargason; Sharon Gayle,26,0,26,0
1713334230121,EDS 128B,A01,507293,Pappas; Elizabeth,30,0,30,0
1713334231145,EDS 139,A00,507294,Fargason; Sharon Gayle,30,0,30,0
1713334231145,EDS 139,B00,507313,Pappas; Elizabeth,30,0,30,0
1713334232173,EDS 201,A00,507315,Staff,26,0,30,4
1713334233197,EDS 203,A01,507317,Halter; Christopher P.,26,0,30,4
1713334234223,EDS 204R,A01,507319,Halter; Christopher P.,3,0,30,27
1713334234223,EDS 204R,B01,507331,Heinzman; Erica M.,28,0,30,2
1713334235249,EDS 206R,A00,507332,Staff,4,0,30,26
1713334235249,EDS 206R,B00,507343,Staff,28,0,30,2
1713334236277,EDS 250,A00,507344,Hemans; Patricia Ann Benitez,36,0,40,4
1713334237304,EDS 281,A00,507345,Daly; Alan J.,18,0,18,0
1713334238332,EDS 284,A00,507350,Daly; Alan J.,16,0,16,0
1713334239357,EDS 286,A00,507359,Fine; Sarah,18,0,18,0
1713334240387,EDS 289C,A01,507361,Daly; Alan J.,18,0,18,0
1713334241412,EDS 290,A00,507366,Hofstetter; Carolyn,15,0,15,0
1713334242442,LIGM 5A,A00,507421,Fischer-Grunski; Eva K,20,0,20,0
1713334243472,LIGM 5B,A00,507423,Fischer-Grunski; Eva K,20,0,20,0
1713334244498,LIGM 5C,A00,507425,Fischer-Grunski; Eva K,20,0,20,0
1713334245524,LIIT 5AS,A00,507427,Carnelos; Chiara,20,0,20,0
1713334246553,LIIT 5BS,A00,507430,Carnelos; Chiara,20,0,20,0
1713334247577,LIIT 5CS,A00,507432,Carnelos; Chiara,20,0,20,0
1713334248603,LISP 5A,A00,507541,Munoz Sanchez; Alicia,17,0,20,3
1713334249628,LISP 5B,A00,507671,Munoz Sanchez; Alicia,15,0,20,5
1713334250656,LISP 5C,A00,507696,Munoz Sanchez; Alicia,15,0,20,5
1713334251686,MAE 197,001,528363,Boechler; Nicholas Sebastia,9998,0,9999,1
1713334252712,MATH 197,001,523477,Kedlaya; Kiran S.,9999,0,9999,0
1713334252712,MATH 197,002,563811,Zhang; Danna,9999,0,9999,0
1713334253738,MCWP 40R,A00,518780,Staff,20,0,20,0
1713334253738,MCWP 40R,B00,518781,Staff,19,0,20,1
1713334253738,MCWP 40R,C00,518783,Staff,19,0,20,1
1713334254765,MCWP 50R,A00,518791,Staff,20,0,20,0
1713334254765,MCWP 50R,B00,518792,Staff,17,0,20,3
1713334254765,MCWP 50R,C00,518793,Staff,19,0,20,1
1713334254765,MCWP 50R,D00,518794,Staff,16,0,20,4
1713334254765,MCWP 50R,E00,518795,Staff,16,0,20,4
1713334254765,MCWP 50R,F00,518796,Staff,19,0,20,1
1713334254765,MCWP 50R,G00,518797,Staff,19,0,20,1
1713334255795,MMW 12R,A01,514034,Herbst; Matthew,15,0,16,1
1713334255795,MMW 12R,A02,514035,Herbst; Matthew,16,0,16,0
1713334256823,MMW 13R,A01,514037,Staff,12,0,16,4
1713334256823,MMW 13R,A02,514039,Staff,16,0,16,0
1713334258877,SIO 295LS,A00,523233,Staff,19,0,30,11
1713334259902,SIO 295S,A00,523232,Staff,19,0,30,11
1713334260928,SOCI 117,A01,494376,Staff,2,0,5,3
1713334261956,WES 237B,A00,494380,Staff,19,0,20,1
1713334264022,AESE 279B,A00,494370,Wade; Jon P,33,0,33,0
1713334265048,ANAR 135S,A00,494369,Braswell; Geoffrey E.,0,0,0,0
1713334266074,CAT 124RS,A01,519847,Geibel; William,17,0,20,3
1713334267101,CAT 125RS,A01,515971,Geibel; William,17,0,20,3
1713334268128,CLRE 250,A00,511389,Morris; Sheldon,9996,0,9999,3
1713334269160,CLRE 251,A00,507176,Mehta; Ravindra L.,9996,0,9999,3
1713334269160,CLRE 251,B00,511410,Mehta; Ravindra L.,9998,0,9999,1
1713334270191,CLRE 252,A00,507189,Cuomo; Raphael Eduardo,9998,0,9999,1
1713334271217,CLRE 253,A00,507199,Vaida; Florin,9997,0,9999,2
1713334271217,CLRE 253,B00,507202,Vaida; Florin,9999,0,9999,0
1713334272244,CLRE 259,A00,507211,Patel; Hemal,9996,0,9999,3
1713334273270,CLRE 260,A00,507221,Cuomo; Raphael Eduardo,9999,0,9999,0
1713334274296,CLRE 297,001,507242,Cuomo; Raphael Eduardo,9999,0,9999,0
1713334275324,CSE 191,A00,516875,Minnes Kemp; Mor Mia,9999,0,9999,0
1713334276351,CSS 201S,A01,494383,Staff,35,0,35,0
1713334277375,CSS 202S,A01,494387,Staff,35,0,35,0
1713334278400,EAP 100,A00,516065,Staff,9792,0,9999,207
1713334279426,ECE 45,A01,507414,Staff,51,0,60,9
1713334280456,ECE 100,A01,507416,Baghdadchi; Saharnaz,10,0,20,10
1713334280456,ECE 100,A02,507418,Baghdadchi; Saharnaz,20,0,20,0
1713334281535,ECE 111,A01,507420,Staff,38,0,50,12
1713334282560,ECE 197,001,548057,Sievenpiper; Daniel F.,9998,0,9999,1
1713334283589,EDS 115,A00,507243,Choi; Bailey Miyeon,28,0,28,0
1713334284615,EDS 117,A01,494379,Staff,23,0,25,2
1713334285641,EDS 125,A00,507246,Hopkins; Megan Beth,29,0,30,1
1713334286666,EDS 128A,A01,507264,Fargason; Sharon Gayle,26,0,26,0
1713334287696,EDS 128B,A01,507293,Pappas; Elizabeth,30,0,30,0
1713334288723,EDS 139,A00,507294,Fargason; Sharon Gayle,30,0,30,0
1713334288723,EDS 139,B00,507313,Pappas; Elizabeth,30,0,30,0
1713334289748,EDS 201,A00,507315,Staff,26,0,30,4
1713334290779,EDS 203,A01,507317,Halter; Christopher P.,26,0,30,4
1713334291804,EDS 204R,A01,507319,Halter; Christopher P.,3,0,30,27
1713334291804,EDS 204R,B01,507331,Heinzman; Erica M.,28,0,30,2
1713334292830,EDS 206R,A00,507332,Staff,4,0,30,26
1713334292830,EDS 206R,B00,507343,Staff,28,0,30,2
1713334293869,EDS 250,A00,507344,Hemans; Patricia Ann Benitez,36,0,40,4
1713334294898,EDS 281,A00,507345,Daly; Alan J.,18,0,18,0
1713334295925,EDS 284,A00,507350,Daly; Alan J.,16,0,16,0
1713334296950,EDS 286,A00,507359,Fine; Sarah,18,0,18,0
1713334297977,EDS 289C,A01,507361,Daly; Alan J.,18,0,18,0
1713334299005,EDS 290,A00,507366,Hofstetter; Carolyn,15,0,15,0
1713334300032,LIGM 5A,A00,507421,Fischer-Grunski; Eva K,20,0,20,0
1713334301060,LIGM 5B,A00,507423,Fischer-Grunski; Eva K,20,0,20,0
1713334302083,LIGM 5C,A00,507425,Fischer-Grunski; Eva K,20,0,20,0
1713334303109,LIIT 5AS,A00,507427,Carnelos; Chiara,20,0,20,0
1713334304138,LIIT 5BS,A00,507430,Carnelos; Chiara,20,0,20,0
1713334305164,LIIT 5CS,A00,507432,Carnelos; Chiara,20,0,20,0
1713334306189,LISP 5A,A00,507541,Munoz Sanchez; Alicia,17,0,20,3
1713334307213,LISP 5B,A00,507671,Munoz Sanchez; Alicia,15,0,20,5
1713334308242,LISP 5C,A00,507696,Munoz Sanchez; Alicia,15,0,20,5
1713334309267,MAE 197,001,528363,Boechler; Nicholas Sebastia,9998,0,9999,1
1713334310296,MATH 197,001,523477,Kedlaya; Kiran S.,9999,0,9999,0
1713334310296,MATH 197,002,563811,Zhang; Danna,9999,0,9999,0
1713334311325,MCWP 40R,A00,518780,Staff,20,0,20,0
1713334311325,MCWP 40R,B00,518781,Staff,19,0,20,1
1713334311325,MCWP 40R,C00,518783,Staff,19,0,20,1
1713334312355,MCWP 50R,A00,518791,Staff,20,0,20,0
1713334312355,MCWP 50R,B00,518792,Staff,17,0,20,3
1713334312355,MCWP 50R,C00,518793,Staff,19,0,20,1
1713334312355,MCWP 50R,D00,518794,Staff,16,0,20,4
1713334312355,MCWP 50R,E00,518795,Staff,16,0,20,4
1713334312355,MCWP 50R,F00,518796,Staff,19,0,20,1
1713334312355,MCWP 50R,G00,518797,Staff,19,0,20,1
1713334313380,MMW 12R,A01,514034,Herbst; Matthew,15,0,16,1
1713334313380,MMW 12R,A02,514035,Herbst; Matthew,16,0,16,0
1713334314405,MMW 13R,A01,514037,Staff,12,0,16,4
1713334314405,MMW 13R,A02,514039,Staff,16,0,16,0
1713334316455,SIO 295LS,A00,523233,Staff,19,0,30,11
1713334317481,SIO 295S,A00,523232,Staff,19,0,30,11
1713334318506,SOCI 117,A01,494376,Staff,2,0,5,3
1713334319530,WES 237B,A00,494380,Staff,19,0,20,1
1713334321604,AESE 279B,A00,494370,Wade; Jon P,33,0,33,0
1713334322632,ANAR 135S,A00,494369,Braswell; Geoffrey E.,0,0,0,0
1713334323658,CAT 124RS,A01,519847,Geibel; William,17,0,20,3
1713334324683,CAT 125RS,A01,515971,Geibel; William,17,0,20,3
1713334325712,CLRE 250,A00,511389,Morris; Sheldon,9996,0,9999,3
1713334326738,CLRE 251,A00,507176,Mehta; Ravindra L.,9996,0,9999,3
1713334326738,CLRE 251,B00,511410,Mehta; Ravindra L.,9998,0,9999,1
1713334327762,CLRE 252,A00,507189,Cuomo; Raphael Eduardo,9998,0,9999,1
1713334328788,CLRE 253,A00,507199,Vaida; Florin,9997,0,9999,2
1713334328788,CLRE 253,B00,507202,Vaida; Florin,9999,0,9999,0
1713334329812,CLRE 259,A00,507211,Patel; Hemal,9996,0,9999,3
1713334330838,CLRE 260,A00,507221,Cuomo; Raphael Eduardo,9999,0,9999,0
1713334331867,CLRE 297,001,507242,Cuomo; Raphael Eduardo,9999,0,9999,0
1713334332898,CSE 191,A00,516875,Minnes Kemp; Mor Mia,9999,0,9999,0
1713334333935,CSS 201S,A01,494383,Staff,35,0,35,0
1713334334961,CSS 202S,A01,494387,Staff,35,0,35,0
1713334335985,EAP 100,A00,516065,Staff,9792,0,9999,207
1713334337010,ECE 45,A01,507414,Staff,51,0,60,9
1713334338040,ECE 100,A01,507416,Baghdadchi; Saharnaz,10,0,20,10
1713334338040,ECE 100,A02,507418,Baghdadchi; Saharnaz,20,0,20,0
1713334339067,ECE 111,A01,507420,Staff,38,0,50,12
1713334340091,ECE 197,001,548057,Sievenpiper; Daniel F.,9998,0,9999,1
1713334341115,EDS 115,A00,507243,Choi; Bailey Miyeon,28,0,28,0
1713334342141,EDS 117,A01,494379,Staff,23,0,25,2
1713334343167,EDS 125,A00,507246,Hopkins; Megan Beth,29,0,30,1
1713334344196,EDS 128A,A01,507264,Fargason; Sharon Gayle,26,0,26,0
1713334345223,EDS 128B,A01,507293,Pappas; Elizabeth,30,0,30,0
1713334346249,EDS 139,A00,507294,Fargason; Sharon Gayle,30,0,30,0
1713334346249,EDS 139,B00,507313,Pappas; Elizabeth,30,0,30,0
1713334347273,EDS 201,A00,507315,Staff,26,0,30,4
1713334348300,EDS 203,A01,507317,Halter; Christopher P.,26,0,30,4
1713334349332,EDS 204R,A01,507319,Halter; Christopher P.,3,0,30,27
1713334349332,EDS 204R,B01,507331,Heinzman; Erica M.,28,0,30,2
1713334350359,EDS 206R,A00,507332,Staff,4,0,30,26
1713334350359,EDS 206R,B00,507343,Staff,28,0,30,2
1713334351387,EDS 250,A00,507344,Hemans; Patricia Ann Benitez,36,0,40,4
1713334352415,EDS 281,A00,507345,Daly; Alan J.,18,0,18,0
1713334353443,EDS 284,A00,507350,Daly; Alan J.,16,0,16,0
1713334354469,EDS 286,A00,507359,Fine; Sarah,18,0,18,0
1713334355495,EDS 289C,A01,507361,Daly; Alan J.,18,0,18,0
1713334356522,EDS 290,A00,507366,Hofstetter; Carolyn,15,0,15,0
1713334357551,LIGM 5A,A00,507421,Fischer-Grunski; Eva K,20,0,20,0
1713334358575,LIGM 5B,A00,507423,Fischer-Grunski; Eva K,20,0,20,0
1713334359602,LIGM 5C,A00,507425,Fischer-Grunski; Eva K,20,0,20,0
1713334360630,LIIT 5AS,A00,507427,Carnelos; Chiara,20,0,20,0
1713334361656,LIIT 5BS,A00,507430,Carnelos; Chiara,20,0,20,0
1713334362681,LIIT 5CS,A00,507432,Carnelos; Chiara,20,0,20,0
1713334363711,LISP 5A,A00,507541,Munoz Sanchez; Alicia,17,0,20,3
1713334364741,LISP 5B,A00,507671,Munoz Sanchez; Alicia,15,0,20,5
1713334365766,LISP 5C,A00,507696,Munoz Sanchez; Alicia,15,0,20,5
1713334366793,MAE 197,001,528363,Boechler; Nicholas Sebastia,9998,0,9999,1
1713334367823,MATH 197,001,523477,Kedlaya; Kiran S.,9999,0,9999,0
1713334367823,MATH 197,002,563811,Zhang; Danna,9999,0,9999,0
1713334368849,MCWP 40R,A00,518780,Staff,20,0,20,0
1713334368849,MCWP 40R,B00,518781,Staff,19,0,20,1
1713334368849,MCWP 40R,C00,518783,Staff,19,0,20,1
1713334369880,MCWP 50R,A00,518791,Staff,20,0,20,0
1713334369880,MCWP 50R,B00,518792,Staff,17,0,20,3
1713334369880,MCWP 50R,C00,518793,Staff,19,0,20,1
1713334369880,MCWP 50R,D00,518794,Staff,16,0,20,4
1713334369880,MCWP 50R,E00,518795,Staff,16,0,20,4
1713334369880,MCWP 50R,F00,518796,Staff,19,0,20,1
1713334369880,MCWP 50R,G00,518797,Staff,19,0,20,1
1713334370909,MMW 12R,A01,514034,Herbst; Matthew,15,0,16,1
1713334370909,MMW 12R,A02,514035,Herbst; Matthew,16,0,16,0
1713334371937,MMW 13R,A01,514037,Staff,12,0,16,4
1713334371937,MMW 13R,A02,514039,Staff,16,0,16,0
1713334373985,SIO 295LS,A00,523233,Staff,19,0,30,11
1713334375011,SIO 295S,A00,523232,Staff,19,0,30,11
1713334376037,SOCI 117,A01,494376,Staff,2,0,5,3
1713334377062,WES 237B,A00,494380,Staff,19,0,20,1
1713334379131,AESE 279B,A00,494370,Wade; Jon P,33,0,33,0
1713334380163,ANAR 135S,A00,494369,Braswell; Geoffrey E.,0,0,0,0
1713334381189,CAT 124RS,A01,519847,Geibel; William,17,0,20,3
1713334382218,CAT 125RS,A01,515971,Geibel; William,17,0,20,3
1713334383258,CLRE 250,A00,511389,Morris; Sheldon,9996,0,9999,3
1713334384283,CLRE 251,A00,507176,Mehta; Ravindra L.,9996,0,9999,3
1713334384283,CLRE 251,B00,511410,Mehta; Ravindra L.,9998,0,9999,1
1713334385367,CLRE 252,A00,507189,Cuomo; Raphael Eduardo,9998,0,9999,1
1713334386391,CLRE 253,A00,507199,Vaida; Florin,9997,0,9999,2
1713334386391,CLRE 253,B00,507202,Vaida; Florin,9999,0,9999,0
1713334387418,CLRE 259,A00,507211,Patel; Hemal,9996,0,9999,3
1713334388445,CLRE 260,A00,507221,Cuomo; Raphael Eduardo,9999,0,9999,0
1713334389472,CLRE 297,001,507242,Cuomo; Raphael Eduardo,9999,0,9999,0
1713334390500,CSE 191,A00,516875,Minnes Kemp; Mor Mia,9999,0,9999,0
1713334391530,CSS 201S,A01,494383,Staff,35,0,35,0
1713334392560,CSS 202S,A01,494387,Staff,35,0,35,0
1713334393585,EAP 100,A00,516065,Staff,9792,0,9999,207
1713334394611,ECE 45,A01,507414,Staff,51,0,60,9
1713334395642,ECE 100,A01,507416,Baghdadchi; Saharnaz,10,0,20,10
1713334395642,ECE 100,A02,507418,Baghdadchi; Saharnaz,20,0,20,0
1713334396669,ECE 111,A01,507420,Staff,38,0,50,12
1713334397699,ECE 197,001,548057,Sievenpiper; Daniel F.,9998,0,9999,1
1713334398724,EDS 115,A00,507243,Choi; Bailey Miyeon,28,0,28,0
1713334399752,EDS 117,A01,494379,Staff,23,0,25,2
1713334400781,EDS 125,A00,507246,Hopkins; Megan Beth,29,0,30,1
1713334401806,EDS 128A,A01,507264,Fargason; Sharon Gayle,26,0,26,0
1713334402834,EDS 128B,A01,507293,Pappas; Elizabeth,30,0,30,0
1713334403874,EDS 139,A00,507294,Fargason; Sharon Gayle,30,0,30,0
1713334403874,EDS 139,B00,507313,Pappas; Elizabeth,30,0,30,0
1713334404899,EDS 201,A00,507315,Staff,26,0,30,4
1713334405929,EDS 203,A01,507317,Halter; Christopher P.,26,0,30,4
1713334406959,EDS 204R,A01,507319,Halter; Christopher P.,3,0,30,27
1713334406959,EDS 204R,B01,507331,Heinzman; Erica M.,28,0,30,2
1713334407984,EDS 206R,A00,507332,Staff,4,0,30,26
1713334407984,EDS 206R,B00,507343,Staff,28,0,30,2
1713334409014,EDS 250,A00,507344,Hemans; Patricia Ann Benitez,36,0,40,4
1713334410038,EDS 281,A00,507345,Daly; Alan J.,18,0,18,0
1713334411065,EDS 284,A00,507350,Daly; Alan J.,16,0,16,0
1713334412093,EDS 286,A00,507359,Fine; Sarah,18,0,18,0
1713334413122,EDS 289C,A01,507361,Daly; Alan J.,18,0,18,0
1713334414149,EDS 290,A00,507366,Hofstetter; Carolyn,15,0,15,0
1713334415175,LIGM 5A,A00,507421,Fischer-Grunski; Eva K,20,0,20,0
1713334416198,LIGM 5B,A00,507423,Fischer-Grunski; Eva K,20,0,20,0
1713334417223,LIGM 5C,A00,507425,Fischer-Grunski; Eva K,20,0,20,0
1713334418253,LIIT 5AS,A00,507427,Carnelos; Chiara,20,0,20,0
1713334419281,LIIT 5BS,A00,507430,Carnelos; Chiara,20,0,20,0
1713334420311,LIIT 5CS,A00,507432,Carnelos; Chiara,20,0,20,0
1713334421335,LISP 5A,A00,507541,Munoz Sanchez; Alicia,17,0,20,3
1713334422361,LISP 5B,A00,507671,Munoz Sanchez; Alicia,15,0,20,5
1713334423390,LISP 5C,A00,507696,Munoz Sanchez; Alicia,15,0,20,5
1713334424417,MAE 197,001,528363,Boechler; Nicholas Sebastia,9998,0,9999,1
1713334425447,MATH 197,001,523477,Kedlaya; Kiran S.,9999,0,9999,0
1713334425447,MATH 197,002,563811,Zhang; Danna,9999,0,9999,0
1713334426477,MCWP 40R,A00,518780,Staff,20,0,20,0
1713334426477,MCWP 40R,B00,518781,Staff,19,0,20,1
1713334426477,MCWP 40R,C00,518783,Staff,19,0,20,1
1713334427505,MCWP 50R,A00,518791,Staff,20,0,20,0
1713334427505,MCWP 50R,B00,518792,Staff,17,0,20,3
1713334427505,MCWP 50R,C00,518793,Staff,19,0,20,1
1713334427505,MCWP 50R,D00,518794,Staff,16,0,20,4
1713334427505,MCWP 50R,E00,518795,Staff,16,0,20,4
1713334427505,MCWP 50R,F00,518796,Staff,19,0,20,1
1713334427505,MCWP 50R,G00,518797,Staff,19,0,20,1
1713334428532,MMW 12R,A01,514034,Herbst; Matthew,15,0,16,1
1713334428532,MMW 12R,A02,514035,Herbst; Matthew,16,0,16,0
1713334429557,MMW 13R,A01,514037,Staff,12,0,16,4
1713334429557,MMW 13R,A02,514039,Staff,16,0,16,0
1713334431610,SIO 295LS,A00,523233,Staff,19,0,30,11
1713334432638,SIO 295S,A00,523232,Staff,19,0,30,11
1713334433669,SOCI 117,A01,494376,Staff,2,0,5,3
1713334434697,WES 237B,A00,494380,Staff,19,0,20,1
1713334436781,AESE 279B,A00,494370,Wade; Jon P,33,0,33,0
1713334437807,ANAR 135S,A00,494369,Braswell; Geoffrey E.,0,0,0,0
1713334438838,CAT 124RS,A01,519847,Geibel; William,17,0,20,3
1713334439927,CAT 125RS,A01,515971,Geibel; William,17,0,20,3
1713334440958,CLRE 250,A00,511389,Morris; Sheldon,9996,0,9999,3
1713334441990,CLRE 251,A00,507176,Mehta; Ravindra L.,9996,0,9999,3
1713334441990,CLRE 251,B00,511410,Mehta; Ravindra L.,9998,0,9999,1
1713334443014,CLRE 252,A00,507189,Cuomo; Raphael Eduardo,9998,0,9999,1
1713334444044,CLRE 253,A00,507199,Vaida; Florin,9997,0,9999,2
1713334444044,CLRE 253,B00,507202,Vaida; Florin,9999,0,9999,0
1713334445069,CLRE 259,A00,507211,Patel; Hemal,9996,0,9999,3
1713334446094,CLRE 260,A00,507221,Cuomo; Raphael Eduardo,9999,0,9999,0
1713334447123,CLRE 297,001,507242,Cuomo; Raphael Eduardo,9999,0,9999,0
1713334448152,CSE 191,A00,516875,Minnes Kemp; Mor Mia,9999,0,9999,0
1713334449177,CSS 201S,A01,494383,Staff,35,0,35,0
1713334450206,CSS 202S,A01,494387,Staff,35,0,35,0
1713334451233,EAP 100,A00,516065,Staff,9792,0,9999,207
1713334452261,ECE 45,A01,507414,Staff,51,0,60,9
1713334453287,ECE 100,A01,507416,Baghdadchi; Saharnaz,10,0,20,10
1713334453287,ECE 100,A02,507418,Baghdadchi; Saharnaz,20,0,20,0
1713334454415,ECE 111,A01,507420,Staff,38,0,50,12
1713334455440,ECE 197,001,548057,Sievenpiper; Daniel F.,9998,0,9999,1
1713334456472,EDS 115,A00,507243,Choi; Bailey Miyeon,28,0,28,0
1713334457497,EDS 117,A01,494379,Staff,23,0,25,2
1713334458526,EDS 125,A00,507246,Hopkins; Megan Beth,29,0,30,1
1713334459556,EDS 128A,A01,507264,Fargason; Sharon Gayle,26,0,26,0
1713334460581,EDS 128B,A01,507293,Pappas; Elizabeth,30,0,30,0
1713334461606,EDS 139,A00,507294,Fargason; Sharon Gayle,30,0,30,0
1713334461606,EDS 139,B00,507313,Pappas; Elizabeth,30,0,30,0
1713334462634,EDS 201,A00,507315,Staff,26,0,30,4
1713334463659,EDS 203,A01,507317,Halter; Christopher P.,26,0,30,4
1713334464684,EDS 204R,A01,507319,Halter; Christopher P.,3,0,30,27
1713334464684,EDS 204R,B01,507331,Heinzman; Erica M.,28,0,30,2
1713334465709,EDS 206R,A00,507332,Staff,4,0,30,26
1713334465709,EDS 206R,B00,507343,Staff,28,0,30,2
1713334466734,EDS 250,A00,507344,Hemans; Patricia Ann Benitez,36,0,40,4
1713334467759,EDS 281,A00,507345,Daly; Alan J.,18,0,18,0
1713334468785,EDS 284,A00,507350,Daly; Alan J.,16,0,16,0
1713334469810,EDS 286,A00,507359,Fine; Sarah,18,0,18,0
1713334470837,EDS 289C,A01,507361,Daly; Alan J.,18,0,18,0
1713334471884,EDS 290,A00,507366,Hofstetter; Carolyn,15,0,15,0
1713334472911,LIGM 5A,A00,507421,Fischer-Grunski; Eva K,20,0,20,0
1713334473939,LIGM 5B,A00,507423,Fischer-Grunski; Eva K,20,0,20,0
1713334474964,LIGM 5C,A00,507425,Fischer-Grunski; Eva K,20,0,20,0
1713334475994,LIIT 5AS,A00,507427,Carnelos; Chiara,20,0,20,0
1713334477026,LIIT 5BS,A00,507430,Carnelos; Chiara,20,0,20,0
1713334478054,LIIT 5CS,A00,507432,Carnelos; Chiara,20,0,20,0
1713334479080,LISP 5A,A00,507541,Munoz Sanchez; Alicia,17,0,20,3
1713334480105,LISP 5B,A00,507671,Munoz Sanchez; Alicia,15,0,20,5
1713334481137,LISP 5C,A00,507696,Munoz Sanchez; Alicia,15,0,20,5
1713334482163,MAE 197,001,528363,Boechler; Nicholas Sebastia,9998,0,9999,1
1713334483191,MATH 197,001,523477,Kedlaya; Kiran S.,9999,0,9999,0
1713334483191,MATH 197,002,563811,Zhang; Danna,9999,0,9999,0
1713334484215,MCWP 40R,A00,518780,Staff,20,0,20,0
1713334484215,MCWP 40R,B00,518781,Staff,19,0,20,1
1713334484215,MCWP 40R,C00,518783,Staff,19,0,20,1
1713334485240,MCWP 50R,A00,518791,Staff,20,0,20,0
1713334485240,MCWP 50R,B00,518792,Staff,17,0,20,3
1713334485240,MCWP 50R,C00,518793,Staff,19,0,20,1
1713334485240,MCWP 50R,D00,518794,Staff,16,0,20,4
1713334485240,MCWP 50R,E00,518795,Staff,16,0,20,4
1713334485240,MCWP 50R,F00,518796,Staff,19,0,20,1
1713334485240,MCWP 50R,G00,518797,Staff,19,0,20,1
1713334486270,MMW 12R,A01,514034,Herbst; Matthew,15,0,16,1
1713334486270,MMW 12R,A02,514035,Herbst; Matthew,16,0,16,0
1713334487296,MMW 13R,A01,514037,Staff,12,0,16,4
1713334487296,MMW 13R,A02,514039,Staff,16,0,16,0
1713334489403,SIO 295LS,A00,523233,Staff,19,0,30,11
1713334490432,SIO 295S,A00,523232,Staff,19,0,30,11
1713334491457,SOCI 117,A01,494376,Staff,2,0,5,3
1713334492482,WES 237B,A00,494380,Staff,19,0,20,1
1713334494546,AESE 279B,A00,494370,Wade; Jon P,33,0,33,0
1713334495572,ANAR 135S,A00,494369,Braswell; Geoffrey E.,0,0,0,0
1713334496604,CAT 124RS,A01,519847,Geibel; William,17,0,20,3
1713334497630,CAT 125RS,A01,515971,Geibel; William,17,0,20,3
1713334498662,CLRE 250,A00,511389,Morris; Sheldon,9996,0,9999,3
1713334499694,CLRE 251,A00,507176,Mehta; Ravindra L.,9996,0,9999,3
1713334499694,CLRE 251,B00,511410,Mehta; Ravindra L.,9998,0,9999,1
1713334500721,CLRE 252,A00,507189,Cuomo; Raphael Eduardo,9998,0,9999,1
1713334501755,CLRE 253,A00,507199,Vaida; Florin,9997,0,9999,2
1713334501755,CLRE 253,B00,507202,Vaida; Florin,9999,0,9999,0
1713334502781,CLRE 259,A00,507211,Patel; Hemal,9996,0,9999,3
1713334503805,CLRE 260,A00,507221,Cuomo; Raphael Eduardo,9999,0,9999,0
1713334504832,CLRE 297,001,507242,Cuomo; Raphael Eduardo,9999,0,9999,0
1713334505859,CSE 191,A00,516875,Minnes Kemp; Mor Mia,9999,0,9999,0
1713334506891,CSS 201S,A01,494383,Staff,35,0,35,0
1713334507921,CSS 202S,A01,494387,Staff,35,0,35,0
1713334508945,EAP 100,A00,516065,Staff,9792,0,9999,207
1713334510081,ECE 45,A01,507414,Staff,51,0,60,9
1713334511111,ECE 100,A01,507416,Baghdadchi; Saharnaz,10,0,20,10
1713334511111,ECE 100,A02,507418,Baghdadchi; Saharnaz,20,0,20,0
1713334512137,ECE 111,A01,507420,Staff,38,0,50,12
1713334513166,ECE 197,001,548057,Sievenpiper; Daniel F.,9998,0,9999,1
1713334514196,EDS 115,A00,507243,Choi; Bailey Miyeon,28,0,28,0
1713334515226,EDS 117,A01,494379,Staff,23,0,25,2
1713334516250,EDS 125,A00,507246,Hopkins; Megan Beth,29,0,30,1
1713334517274,EDS 128A,A01,507264,Fargason; Sharon Gayle,26,0,26,0
1713334518300,EDS 128B,A01,507293,Pappas; Elizabeth,30,0,30,0
1713334519329,EDS 139,A00,507294,Fargason; Sharon Gayle,30,0,30,0
1713334519329,EDS 139,B00,507313,Pappas; Elizabeth,30,0,30,0
1713334520361,EDS 201,A00,507315,Staff,26,0,30,4
1713334521395,EDS 203,A01,507317,Halter; Christopher P.,26,0,30,4
1713334522425,EDS 204R,A01,507319,Halter; Christopher P.,3,0,30,27
1713334522425,EDS 204R,B01,507331,Heinzman; Erica M.,28,0,30,2
1713334523450,EDS 206R,A00,507332,Staff,4,0,30,26
1713334523450,EDS 206R,B00,507343,Staff,28,0,30,2
1713334524541,EDS 250,A00,507344,Hemans; Patricia Ann Benitez,36,0,40,4
1713334525569,EDS 281,A00,507345,Daly; Alan J.,18,0,18,0
1713334526598,EDS 284,A00,507350,Daly; Alan J.,16,0,16,0
1713334527628,EDS 286,A00,507359,Fine; Sarah,18,0,18,0
1713334528660,EDS 289C,A01,507361,Daly; Alan J.,18,0,18,0
1713334529690,EDS 290,A00,507366,Hofstetter; Carolyn,15,0,15,0
1713334530721,LIGM 5A,A00,507421,Fischer-Grunski; Eva K,20,0,20,0
1713334531750,LIGM 5B,A00,507423,Fischer-Grunski; Eva K,20,0,20,0
1713334532776,LIGM 5C,A00,507425,Fischer-Grunski; Eva K,20,0,20,0
1713334533801,LIIT 5AS,A00,507427,Carnelos; Chiara,20,0,20,0
1713334534827,LIIT 5BS,A00,507430,Carnelos; Chiara,20,0,20,0
1713334535850,LIIT 5CS,A00,507432,Carnelos; Chiara,20,0,20,0
1713334536880,LISP 5A,A00,507541,Munoz Sanchez; Alicia,17,0,20,3
1713334537906,LISP 5B,A00,507671,Munoz Sanchez; Alicia,15,0,20,5
1713334538933,LISP 5C,A00,507696,Munoz Sanchez; Alicia,15,0,20,5
1713334539960,MAE 197,001,528363,Boechler; Nicholas Sebastia,9998,0,9999,1
1713334540987,MATH 197,001,523477,Kedlaya; Kiran S.,9999,0,9999,0
1713334540987,MATH 197,002,563811,Zhang; Danna,9999,0,9999,0
1713334542014,MCWP 40R,A00,518780,Staff,20,0,20,0
1713334542014,MCWP 40R,B00,518781,Staff,19,0,20,1
1713334542014,MCWP 40R,C00,518783,Staff,19,0,20,1
1713334543045,MCWP 50R,A00,518791,Staff,20,0,20,0
1713334543045,MCWP 50R,B00,518792,Staff,17,0,20,3
1713334543045,MCWP 50R,C00,518793,Staff,19,0,20,1
1713334543045,MCWP 50R,D00,518794,Staff,16,0,20,4
1713334543045,MCWP 50R,E00,518795,Staff,16,0,20,4
1713334543045,MCWP 50R,F00,518796,Staff,19,0,20,1
1713334543045,MCWP 50R,G00,518797,Staff,19,0,20,1
1713334544073,MMW 12R,A01,514034,Herbst; Matthew,15,0,16,1
1713334544073,MMW 12R,A02,514035,Herbst; Matthew,16,0,16,0
1713334545103,MMW 13R,A01,514037,Staff,12,0,16,4
1713334545103,MMW 13R,A02,514039,Staff,16,0,16,0
1713334547153,SIO 295LS,A00,523233,Staff,19,0,30,11
1713334548180,SIO 295S,A00,523232,Staff,19,0,30,11
1713334549204,SOCI 117,A01,494376,Staff,2,0,5,3
1713334550231,WES 237B,A00,494380,Staff,19,0,20,1
1713334552297,AESE 279B,A00,494370,Wade; Jon P,33,0,33,0
1713334553324,ANAR 135S,A00,494369,Braswell; Geoffrey E.,0,0,0,0
1713334554354,CAT 124RS,A01,519847,Geibel; William,17,0,20,3
1713334555380,CAT 125RS,A01,515971,Geibel; William,17,0,20,3
1713334556404,CLRE 250,A00,511389,Morris; Sheldon,9996,0,9999,3
1713334557431,CLRE 251,A00,507176,Mehta; Ravindra L.,9996,0,9999,3
1713334557431,CLRE 251,B00,511410,Mehta; Ravindra L.,9998,0,9999,1
1713334558459,CLRE 252,A00,507189,Cuomo; Raphael Eduardo,9998,0,9999,1
1713334559487,CLRE 253,A00,507199,Vaida; Florin,9997,0,9999,2
1713334559487,CLRE 253,B00,507202,Vaida; Florin,9999,0,9999,0
1713334560512,CLRE 259,A00,507211,Patel; Hemal,9996,0,9999,3
1713334561541,CLRE 260,A00,507221,Cuomo; Raphael Eduardo,9999,0,9999,0
1713334562565,CLRE 297,001,507242,Cuomo; Raphael Eduardo,9999,0,9999,0
1713334563593,CSE 191,A00,516875,Minnes Kemp; Mor Mia,9999,0,9999,0
1713334564618,CSS 201S,A01,494383,Staff,35,0,35,0
1713334565645,CSS 202S,A01,494387,Staff,35,0,35,0
1713334566670,EAP 100,A00,516065,Staff,9792,0,9999,207
1713334567696,ECE 45,A01,507414,Staff,51,0,60,9
1713334568726,ECE 100,A01,507416,Baghdadchi; Saharnaz,10,0,20,10
1713334568726,ECE 100,A02,507418,Baghdadchi; Saharnaz,20,0,20,0
1713334569755,ECE 111,A01,507420,Staff,38,0,50,12
1713334570781,ECE 197,001,548057,Sievenpiper; Daniel F.,9998,0,9999,1
1713334571807,EDS 115,A00,507243,Choi; Bailey Miyeon,28,0,28,0
1713334572833,EDS 117,A01,494379,Staff,23,0,25,2
1713334573865,EDS 125,A00,507246,Hopkins; Megan Beth,29,0,30,1
1713334574895,EDS 128A,A01,507264,Fargason; Sharon Gayle,26,0,26,0
1713334575923,EDS 128B,A01,507293,Pappas; Elizabeth,30,0,30,0
1713334576950,EDS 139,A00,507294,Fargason; Sharon Gayle,30,0,30,0
1713334576950,EDS 139,B00,507313,Pappas; Elizabeth,30,0,30,0
1713334577978,EDS 201,A00,507315,Staff,26,0,30,4
1713334579003,EDS 203,A01,507317,Halter; Christopher P.,26,0,30,4
1713334580029,EDS 204R,A01,507319,Halter; Christopher P.,3,0,30,27
1713334580029,EDS 204R,B01,507331,Heinzman; Erica M.,28,0,30,2
1713334581055,EDS 206R,A00,507332,Staff,4,0,30,26
1713334581055,EDS 206R,B00,507343,Staff,28,0,30,2
1713334582087,EDS 250,A00,507344,Hemans; Patricia Ann Benitez,36,0,40,4
1713334583112,EDS 281,A00,507345,Daly; Alan J.,18,0,18,0
1713334584139,EDS 284,A00,507350,Daly; Alan J.,16,0,16,0
1713334585166,EDS 286,A00,507359,Fine; Sarah,18,0,18,0
1713334586193,EDS 289C,A01,507361,Daly; Alan J.,18,0,18,0
1713334587223,EDS 290,A00,507366,Hofstetter; Carolyn,15,0,15,0
1713334588257,LIGM 5A,A00,507421,Fischer-Grunski; Eva K,20,0,20,0
1713334589281,LIGM 5B,A00,507423,Fischer-Grunski; Eva K,20,0,20,0
1713334590307,LIGM 5C,A00,507425,Fischer-Grunski; Eva K,20,0,20,0
1713334591333,LIIT 5AS,A00,507427,Carnelos; Chiara,20,0,20,0
1713334592360,LIIT 5BS,A00,507430,Carnelos; Chiara,20,0,20,0
1713334593437,LIIT 5CS,A00,507432,Carnelos; Chiara,20,0,20,0
1713334594463,LISP 5A,A00,507541,Munoz Sanchez; Alicia,17,0,20,3
1713334595489,LISP 5B,A00,507671,Munoz Sanchez; Alicia,15,0,20,5
1713334596514,LISP 5C,A00,507696,Munoz Sanchez; Alicia,15,0,20,5
1713334597541,MAE 197,001,528363,Boechler; Nicholas Sebastia,9998,0,9999,1
1713334598567,MATH 197,001,523477,Kedlaya; Kiran S.,9999,0,9999,0
1713334598567,MATH 197,002,563811,Zhang; Danna,9999,0,9999,0
1713334599592,MCWP 40R,A00,518780,Staff,20,0,20,0
1713334599592,MCWP 40R,B00,518781,Staff,19,0,20,1
1713334599592,MCWP 40R,C00,518783,Staff,19,0,20,1
1713334600620,MCWP 50R,A00,518791,Staff,20,0,20,0
1713334600620,MCWP 50R,B00,518792,Staff,17,0,20,3
1713334600620,MCWP 50R,C00,518793,Staff,19,0,20,1
1713334600620,MCWP 50R,D00,518794,Staff,16,0,20,4
1713334600620,MCWP 50R,E00,518795,Staff,16,0,20,4
1713334600620,MCWP 50R,F00,518796,Staff,19,0,20,1
1713334600620,MCWP 50R,G00,518797,Staff,19,0,20,1
1713334601650,MMW 12R,A01,514034,Herbst; Matthew,15,0,16,1
1713334601650,MMW 12R,A02,514035,Herbst; Matthew,16,0,16,0
1713334602679,MMW 13R,A01,514037,Staff,12,0,16,4
1713334602679,MMW 13R,A02,514039,Staff,16,0,16,0
1713334604732,SIO 295LS,A00,523233,Staff,19,0,30,11
1713334605756,SIO 295S,A00,523232,Staff,19,0,30,11
1713334606782,SOCI 117,A01,494376,Staff,2,0,5,3
1713334607813,WES 237B,A00,494380,Staff,19,0,20,1
1713334609882,AESE 279B,A00,494370,Wade; Jon P,33,0,33,0
1713334610911,ANAR 135S,A00,494369,Braswell; Geoffrey E.,0,0,0,0
1713334611943,CAT 124RS,A01,519847,Geibel; William,17,0,20,3
1713334612969,CAT 125RS,A01,515971,Geibel; William,17,0,20,3
1713334613997,CLRE 250,A00,511389,Morris; Sheldon,9996,0,9999,3
1713334615025,CLRE 251,A00,507176,Mehta; Ravindra L.,9996,0,9999,3
1713334615025,CLRE 251,B00,511410,Mehta; Ravindra L.,9998,0,9999,1
1713334616054,CLRE 252,A00,507189,Cuomo; Raphael Eduardo,9998,0,9999,1
1713334617080,CLRE 253,A00,507199,Vaida; Florin,9997,0,9999,2
1713334617080,CLRE 253,B00,507202,Vaida; Florin,9999,0,9999,0
1713334618105,CLRE 259,A00,507211,Patel; Hemal,9996,0,9999,3
1713334619135,CLRE 260,A00,507221,Cuomo; Raphael Eduardo,9999,0,9999,0
1713334620164,CLRE 297,001,507242,Cuomo; Raphael Eduardo,9999,0,9999,0
1713334621189,CSE 191,A00,516875,Minnes Kemp; Mor Mia,9999,0,9999,0
1713334622219,CSS 201S,A01,494383,Staff,35,0,35,0
1713334623246,CSS 202S,A01,494387,Staff,35,0,35,0
1713334624271,EAP 100,A00,516065,Staff,9792,0,9999,207
1713334625298,ECE 45,A01,507414,Staff,51,0,60,9
1713334626322,ECE 100,A01,507416,Baghdadchi; Saharnaz,10,0,20,10
1713334626322,ECE 100,A02,507418,Baghdadchi; Saharnaz,20,0,20,0
1713334627347,ECE 111,A01,507420,Staff,38,0,50,12
1713334628378,ECE 197,001,548057,Sievenpiper; Daniel F.,9998,0,9999,1
1713334629406,EDS 115,A00,507243,Choi; Bailey Miyeon,28,0,28,0
1713334630429,EDS 117,A01,494379,Staff,23,0,25,2
1713334631458,EDS 125,A00,507246,Hopkins; Megan Beth,29,0,30,1
1713334632482,EDS 128A,A01,507264,Fargason; Sharon Gayle,26,0,26,0
1713334633507,EDS 128B,A01,507293,Pappas; Elizabeth,30,0,30,0
1713334634535,EDS 139,A00,507294,Fargason; Sharon Gayle,30,0,30,0
1713334634535,EDS 139,B00,507313,Pappas; Elizabeth,30,0,30,0
1713334635561,EDS 201,A00,507315,Staff,26,0,30,4
1713334636587,EDS 203,A01,507317,Halter; Christopher P.,26,0,30,4
1713334637617,EDS 204R,A01,507319,Halter; Christopher P.,3,0,30,27
1713334637617,EDS 204R,B01,507331,Heinzman; Erica M.,28,0,30,2
1713334638648,EDS 206R,A00,507332,Staff,4,0,30,26
1713334638648,EDS 206R,B00,507343,Staff,28,0,30,2
1713334639673,EDS 250,A00,507344,Hemans; Patricia Ann Benitez,36,0,40,4
1713334640699,EDS 281,A00,507345,Daly; Alan J.,18,0,18,0
1713334641724,EDS 284,A00,507350,Daly; Alan J.,16,0,16,0
1713334642753,EDS 286,A00,507359,Fine; Sarah,18,0,18,0
1713334643780,EDS 289C,A01,507361,Daly; Alan J.,18,0,18,0
1713334644809,EDS 290,A00,507366,Hofstetter; Carolyn,15,0,15,0
1713334645842,LIGM 5A,A00,507421,Fischer-Grunski; Eva K,20,0,20,0
1713334646871,LIGM 5B,A00,507423,Fischer-Grunski; Eva K,20,0,20,0
1713334647895,LIGM 5C,A00,507425,Fischer-Grunski; Eva K,20,0,20,0
1713334648925,LIIT 5AS,A00,507427,Carnelos; Chiara,20,0,20,0
1713334649949,LIIT 5BS,A00,507430,Carnelos; Chiara,20,0,20,0
1713334650974,LIIT 5CS,A00,507432,Carnelos; Chiara,20,0,20,0
1713334652005,LISP 5A,A00,507541,Munoz Sanchez; Alicia,17,0,20,3
1713334653032,LISP 5B,A00,507671,Munoz Sanchez; Alicia,15,0,20,5
1713334654057,LISP 5C,A00,507696,Munoz Sanchez; Alicia,15,0,20,5
1713334655083,MAE 197,001,528363,Boechler; Nicholas Sebastia,9998,0,9999,1
1713334656109,MATH 197,001,523477,Kedlaya; Kiran S.,9999,0,9999,0
1713334656109,MATH 197,002,563811,Zhang; Danna,9999,0,9999,0
1713334657133,MCWP 40R,A00,518780,Staff,20,0,20,0
1713334657133,MCWP 40R,B00,518781,Staff,19,0,20,1
1713334657133,MCWP 40R,C00,518783,Staff,19,0,20,1
1713334658160,MCWP 50R,A00,518791,Staff,20,0,20,0
1713334658160,MCWP 50R,B00,518792,Staff,17,0,20,3
1713334658160,MCWP 50R,C00,518793,Staff,19,0,20,1
1713334658160,MCWP 50R,D00,518794,Staff,16,0,20,4
1713334658160,MCWP 50R,E00,518795,Staff,16,0,20,4
1713334658160,MCWP 50R,F00,518796,Staff,19,0,20,1
1713334658160,MCWP 50R,G00,518797,Staff,19,0,20,1
1713334659184,MMW 12R,A01,514034,Herbst; Matthew,15,0,16,1
1713334659184,MMW 12R,A02,514035,Herbst; Matthew,16,0,16,0
1713334660211,MMW 13R,A01,514037,Staff,12,0,16,4
1713334660211,MMW 13R,A02,514039,Staff,16,0,16,0
1713334662264,SIO 295LS,A00,523233,Staff,19,0,30,11
1713334663295,SIO 295S,A00,523232,Staff,19,0,30,11
1713334664326,SOCI 117,A01,494376,Staff,2,0,5,3
1713334665349,WES 237B,A00,494380,Staff,19,0,20,1
1713334667413,AESE 279B,A00,494370,Wade; Jon P,33,0,33,0
1713334668441,ANAR 135S,A00,494369,Braswell; Geoffrey E.,0,0,0,0
1713334669466,CAT 124RS,A01,519847,Geibel; William,17,0,20,3
1713334670489,CAT 125RS,A01,515971,Geibel; William,17,0,20,3
1713334671518,CLRE 250,A00,511389,Morris; Sheldon,9996,0,9999,3
1713334672542,CLRE 251,A00,507176,Mehta; Ravindra L.,9996,0,9999,3
1713334672542,CLRE 251,B00,511410,Mehta; Ravindra L.,9998,0,9999,1
1713334673579,CLRE 252,A00,507189,Cuomo; Raphael Eduardo,9998,0,9999,1
1713334674610,CLRE 253,A00,507199,Vaida; Florin,9997,0,9999,2
1713334674610,CLRE 253,B00,507202,Vaida; Florin,9999,0,9999,0
1713334675635,CLRE 259,A00,507211,Patel; Hemal,9996,0,9999,3
1713334676666,CLRE 260,A00,507221,Cuomo; Raphael Eduardo,9999,0,9999,0
1713334677690,CLRE 297,001,507242,Cuomo; Raphael Eduardo,9999,0,9999,0
1713334678717,CSE 191,A00,516875,Minnes Kemp; Mor Mia,9999,0,9999,0
1713334679743,CSS 201S,A01,494383,Staff,35,0,35,0
1713334680774,CSS 202S,A01,494387,Staff,35,0,35,0
1713334681802,EAP 100,A00,516065,Staff,9792,0,9999,207
1713334682826,ECE 45,A01,507414,Staff,51,0,60,9
1713334683861,ECE 100,A01,507416,Baghdadchi; Saharnaz,10,0,20,10
1713334683861,ECE 100,A02,507418,Baghdadchi; Saharnaz,20,0,20,0
1713334684889,ECE 111,A01,507420,Staff,38,0,50,12
1713334685917,ECE 197,001,548057,Sievenpiper; Daniel F.,9998,0,9999,1
1713334686944,EDS 115,A00,507243,Choi; Bailey Miyeon,28,0,28,0
1713334687971,EDS 117,A01,494379,Staff,23,0,25,2
1713334688996,EDS 125,A00,507246,Hopkins; Megan Beth,29,0,30,1
1713334690022,EDS 128A,A01,507264,Fargason; Sharon Gayle,26,0,26,0
1713334691048,EDS 128B,A01,507293,Pappas; Elizabeth,30,0,30,0
1713334692077,EDS 139,A00,507294,Fargason; Sharon Gayle,30,0,30,0
1713334692077,EDS 139,B00,507313,Pappas; Elizabeth,30,0,30,0
1713334693103,EDS 201,A00,507315,Staff,26,0,30,4
1713334694130,EDS 203,A01,507317,Halter; Christopher P.,26,0,30,4
1713334695161,EDS 204R,A01,507319,Halter; Christopher P.,3,0,30,27
1713334695161,EDS 204R,B01,507331,Heinzman; Erica M.,28,0,30,2
1713334696187,EDS 206R,A00,507332,Staff,4,0,30,26
1713334696187,EDS 206R,B00,507343,Staff,28,0,30,2
1713334697266,EDS 250,A00,507344,Hemans; Patricia Ann Benitez,36,0,40,4
1713334698292,EDS 281,A00,507345,Daly; Alan J.,18,0,18,0
1713334699315,EDS 284,A00,507350,Daly; Alan J.,16,0,16,0
1713334700340,EDS 286,A00,507359,Fine; Sarah,18,0,18,0
1713334701363,EDS 289C,A01,507361,Daly; Alan J.,18,0,18,0
1713334702393,EDS 290,A00,507366,Hofstetter; Carolyn,15,0,15,0
1713334703418,LIGM 5A,A00,507421,Fischer-Grunski; Eva K,20,0,20,0
1713334704442,LIGM 5B,A00,507423,Fischer-Grunski; Eva K,20,0,20,0
1713334705466,LIGM 5C,A00,507425,Fischer-Grunski; Eva K,20,0,20,0
1713334706493,LIIT 5AS,A00,507427,Carnelos; Chiara,20,0,20,0
1713334707522,LIIT 5BS,A00,507430,Carnelos; Chiara,20,0,20,0
1713334708551,LIIT 5CS,A00,507432,Carnelos; Chiara,20,0,20,0
1713334709581,LISP 5A,A00,507541,Munoz Sanchez; Alicia,17,0,20,3
1713334710608,LISP 5B,A00,507671,Munoz Sanchez; Alicia,15,0,20,5
1713334711633,LISP 5C,A00,507696,Munoz Sanchez; Alicia,15,0,20,5
1713334712664,MAE 197,001,528363,Boechler; Nicholas Sebastia,9998,0,9999,1
1713334713692,MATH 197,001,523477,Kedlaya; Kiran S.,9999,0,9999,0
1713334713692,MATH 197,002,563811,Zhang; Danna,9999,0,9999,0
1713334714720,MCWP 40R,A00,518780,Staff,20,0,20,0
1713334714720,MCWP 40R,B00,518781,Staff,19,0,20,1
1713334714720,MCWP 40R,C00,518783,Staff,19,0,20,1
1713334715756,MCWP 50R,A00,518791,Staff,20,0,20,0
1713334715756,MCWP 50R,B00,518792,Staff,17,0,20,3
1713334715756,MCWP 50R,C00,518793,Staff,19,0,20,1
1713334715756,MCWP 50R,D00,518794,Staff,16,0,20,4
1713334715756,MCWP 50R,E00,518795,Staff,16,0,20,4
1713334715756,MCWP 50R,F00,518796,Staff,19,0,20,1
1713334715756,MCWP 50R,G00,518797,Staff,19,0,20,1
1713334716780,MMW 12R,A01,514034,Herbst; Matthew,15,0,16,1
1713334716780,MMW 12R,A02,514035,Herbst; Matthew,16,0,16,0
1713334717806,MMW 13R,A01,514037,Staff,12,0,16,4
1713334717806,MMW 13R,A02,514039,Staff,16,0,16,0
1713334719859,SIO 295LS,A00,523233,Staff,19,0,30,11
1713334720884,SIO 295S,A00,523232,Staff,19,0,30,11
1713334721913,SOCI 117,A01,494376,Staff,2,0,5,3
1713334722940,WES 237B,A00,494380,Staff,19,0,20,1
1713334725006,AESE 279B,A00,494370,Wade; Jon P,33,0,33,0
1713334726032,ANAR 135S,A00,494369,Braswell; Geoffrey E.,0,0,0,0
1713334727059,CAT 124RS,A01,519847,Geibel; William,17,0,20,3
1713334728083,CAT 125RS,A01,515971,Geibel; William,17,0,20,3
1713334729109,CLRE 250,A00,511389,Morris; Sheldon,9996,0,9999,3
1713334730139,CLRE 251,A00,507176,Mehta; Ravindra L.,9996,0,9999,3
1713334730139,CLRE 251,B00,511410,Mehta; Ravindra L.,9998,0,9999,1
1713334731165,CLRE 252,A00,507189,Cuomo; Raphael Eduardo,9998,0,9999,1
1713334732190,CLRE 253,A00,507199,Vaida; Florin,9997,0,9999,2
1713334732190,CLRE 253,B00,507202,Vaida; Florin,9999,0,9999,0
1713334733221,CLRE 259,A00,507211,Patel; Hemal,9996,0,9999,3
1713334734251,CLRE 260,A00,507221,Cuomo; Raphael Eduardo,9999,0,9999,0
1713334735279,CLRE 297,001,507242,Cuomo; Raphael Eduardo,9999,0,9999,0
1713334736307,CSE 191,A00,516875,Minnes Kemp; Mor Mia,9999,0,9999,0
1713334737337,CSS 201S,A01,494383,Staff,35,0,35,0
1713334738372,CSS 202S,A01,494387,Staff,35,0,35,0
1713334739397,EAP 100,A00,516065,Staff,9792,0,9999,207
1713334740425,ECE 45,A01,507414,Staff,51,0,60,9
1713334741452,ECE 100,A01,507416,Baghdadchi; Saharnaz,10,0,20,10
1713334741452,ECE 100,A02,507418,Baghdadchi; Saharnaz,20,0,20,0
1713334742475,ECE 111,A01,507420,Staff,38,0,50,12
1713334743501,ECE 197,001,548057,Sievenpiper; Daniel F.,9998,0,9999,1
1713334744533,EDS 115,A00,507243,Choi; Bailey Miyeon,28,0,28,0
1713334745561,EDS 117,A01,494379,Staff,23,0,25,2
1713334746586,EDS 125,A00,507246,Hopkins; Megan Beth,29,0,30,1
1713334747615,EDS 128A,A01,507264,Fargason; Sharon Gayle,26,0,26,0
1713334748642,EDS 128B,A01,507293,Pappas; Elizabeth,30,0,30,0
1713334749672,EDS 139,A00,507294,Fargason; Sharon Gayle,30,0,30,0
1713334749672,EDS 139,B00,507313,Pappas; Elizabeth,30,0,30,0
1713334750696,EDS 201,A00,507315,Staff,26,0,30,4
1713334751724,EDS 203,A01,507317,Halter; Christopher P.,26,0,30,4
1713334752753,EDS 204R,A01,507319,Halter; Christopher P.,3,0,30,27
1713334752753,EDS 204R,B01,507331,Heinzman; Erica M.,28,0,30,2
1713334753781,EDS 206R,A00,507332,Staff,4,0,30,26
1713334753781,EDS 206R,B00,507343,Staff,28,0,30,2
1713334754809,EDS 250,A00,507344,Hemans; Patricia Ann Benitez,36,0,40,4
1713334755837,EDS 281,A00,507345,Daly; Alan J.,18,0,18,0
1713334756863,EDS 284,A00,507350,Daly; Alan J.,16,0,16,0
1713334757893,EDS 286,A00,507359,Fine; Sarah,18,0,18,0
1713334758967,EDS 289C,A01,507361,Daly; Alan J.,18,0,18,0
1713334759998,EDS 290,A00,507366,Hofstetter; Carolyn,15,0,15,0
1713334761030,LIGM 5A,A00,507421,Fischer-Grunski; Eva K,20,0,20,0
1713334762061,LIGM 5B,A00,507423,Fischer-Grunski; Eva K,20,0,20,0
1713334763090,LIGM 5C,A00,507425,Fischer-Grunski; Eva K,20,0,20,0
1713334764116,LIIT 5AS,A00,507427,Carnelos; Chiara,20,0,20,0
1713334765140,LIIT 5BS,A00,507430,Carnelos; Chiara,20,0,20,0
1713334766170,LIIT 5CS,A00,507432,Carnelos; Chiara,20,0,20,0
1713334767195,LISP 5A,A00,507541,Munoz Sanchez; Alicia,17,0,20,3
1713334768219,LISP 5B,A00,507671,Munoz Sanchez; Alicia,15,0,20,5
1713334769245,LISP 5C,A00,507696,Munoz Sanchez; Alicia,15,0,20,5
1713334770273,MAE 197,001,528363,Boechler; Nicholas Sebastia,9998,0,9999,1
1713334771298,MATH 197,001,523477,Kedlaya; Kiran S.,9999,0,9999,0
1713334771298,MATH 197,002,563811,Zhang; Danna,9999,0,9999,0
1713334772325,MCWP 40R,A00,518780,Staff,20,0,20,0
1713334772325,MCWP 40R,B00,518781,Staff,19,0,20,1
1713334772325,MCWP 40R,C00,518783,Staff,19,0,20,1
1713334773355,MCWP 50R,A00,518791,Staff,20,0,20,0
1713334773355,MCWP 50R,B00,518792,Staff,17,0,20,3
1713334773355,MCWP 50R,C00,518793,Staff,19,0,20,1
1713334773355,MCWP 50R,D00,518794,Staff,16,0,20,4
1713334773355,MCWP 50R,E00,518795,Staff,16,0,20,4
1713334773355,MCWP 50R,F00,518796,Staff,19,0,20,1
1713334773355,MCWP 50R,G00,518797,Staff,19,0,20,1
1713334774383,MMW 12R,A01,514034,Herbst; Matthew,15,0,16,1
1713334774383,MMW 12R,A02,514035,Herbst; Matthew,16,0,16,0
1713334775411,MMW 13R,A01,514037,Staff,12,0,16,4
1713334775411,MMW 13R,A02,514039,Staff,16,0,16,0
1713334777461,SIO 295LS,A00,523233,Staff,19,0,30,11
1713334778489,SIO 295S,A00,523232,Staff,19,0,30,11
1713334779517,SOCI 117,A01,494376,Staff,2,0,5,3
1713334780542,WES 237B,A00,494380,Staff,19,0,20,1
1713334782607,AESE 279B,A00,494370,Wade; Jon P,33,0,33,0
1713334783636,ANAR 135S,A00,494369,Braswell; Geoffrey E.,0,0,0,0
1713334784666,CAT 124RS,A01,519847,Geibel; William,17,0,20,3
1713334785696,CAT 125RS,A01,515971,Geibel; William,17,0,20,3
1713334786722,CLRE 250,A00,511389,Morris; Sheldon,9996,0,9999,3
1713334787756,CLRE 251,A00,507176,Mehta; Ravindra L.,9996,0,9999,3
1713334787756,CLRE 251,B00,511410,Mehta; Ravindra L.,9998,0,9999,1
1713334788786,CLRE 252,A00,507189,Cuomo; Raphael Eduardo,9998,0,9999,1
1713334789815,CLRE 253,A00,507199,Vaida; Florin,9997,0,9999,2
1713334789815,CLRE 253,B00,507202,Vaida; Florin,9999,0,9999,0
1713334790841,CLRE 259,A00,507211,Patel; Hemal,9996,0,9999,3
1713334791870,CLRE 260,A00,507221,Cuomo; Raphael Eduardo,9999,0,9999,0
1713334792895,CLRE 297,001,507242,Cuomo; Raphael Eduardo,9999,0,9999,0
1713334793920,CSE 191,A00,516875,Minnes Kemp; Mor Mia,9999,0,9999,0
1713334794953,CSS 201S,A01,494383,Staff,35,0,35,0
1713334795978,CSS 202S,A01,494387,Staff,35,0,35,0
1713334797007,EAP 100,A00,516065,Staff,9792,0,9999,207
1713334798036,ECE 45,A01,507414,Staff,51,0,60,9
1713334799086,ECE 100,A01,507416,Baghdadchi; Saharnaz,10,0,20,10
1713334799086,ECE 100,A02,507418,Baghdadchi; Saharnaz,20,0,20,0
1713334800111,ECE 111,A01,507420,Staff,38,0,50,12
1713334801191,ECE 197,001,548057,Sievenpiper; Daniel F.,9998,0,9999,1
1713334802218,EDS 115,A00,507243,Choi; Bailey Miyeon,28,0,28,0
1713334803245,EDS 117,A01,494379,Staff,23,0,25,2
1713334804274,EDS 125,A00,507246,Hopkins; Megan Beth,29,0,30,1
1713334805301,EDS 128A,A01,507264,Fargason; Sharon Gayle,26,0,26,0
1713334806328,EDS 128B,A01,507293,Pappas; Elizabeth,30,0,30,0
1713334807362,EDS 139,A00,507294,Fargason; Sharon Gayle,30,0,30,0
1713334807362,EDS 139,B00,507313,Pappas; Elizabeth,30,0,30,0
1713334808395,EDS 201,A00,507315,Staff,26,0,30,4
1713334809419,EDS 203,A01,507317,Halter; Christopher P.,26,0,30,4
1713334810445,EDS 204R,A01,507319,Halter; Christopher P.,3,0,30,27
1713334810445,EDS 204R,B01,507331,Heinzman; Erica M.,28,0,30,2
1713334811475,EDS 206R,A00,507332,Staff,4,0,30,26
1713334811475,EDS 206R,B00,507343,Staff,28,0,30,2
1713334812502,EDS 250,A00,507344,Hemans; Patricia Ann Benitez,36,0,40,4
1713334813532,EDS 281,A00,507345,Daly; Alan J.,18,0,18,0
1713334814557,EDS 284,A00,507350,Daly; Alan J.,16,0,16,0
1713334815581,EDS 286,A00,507359,Fine; Sarah,18,0,18,0
1713334816607,EDS 289C,A01,507361,Daly; Alan J.,18,0,18,0
1713334817631,EDS 290,A00,507366,Hofstetter; Carolyn,15,0,15,0
1713334818659,LIGM 5A,A00,507421,Fischer-Grunski; Eva K,20,0,20,0
1713334819694,LIGM 5B,A00,507423,Fischer-Grunski; Eva K,20,0,20,0
1713334820722,LIGM 5C,A00,507425,Fischer-Grunski; Eva K,20,0,20,0
1713334821758,LIIT 5AS,A00,507427,Carnelos; Chiara,20,0,20,0
1713334822791,LIIT 5BS,A00,507430,Carnelos; Chiara,20,0,20,0
1713334823818,LIIT 5CS,A00,507432,Carnelos; Chiara,20,0,20,0
1713334824853,LISP 5A,A00,507541,Munoz Sanchez; Alicia,17,0,20,3
1713334825881,LISP 5B,A00,507671,Munoz Sanchez; Alicia,15,0,20,5
1713334826906,LISP 5C,A00,507696,Munoz Sanchez; Alicia,15,0,20,5
1713334827931,MAE 197,001,528363,Boechler; Nicholas Sebastia,9998,0,9999,1
1713334828958,MATH 197,001,523477,Kedlaya; Kiran S.,9999,0,9999,0
1713334828958,MATH 197,002,563811,Zhang; Danna,9999,0,9999,0
1713334829984,MCWP 40R,A00,518780,Staff,20,0,20,0
1713334829984,MCWP 40R,B00,518781,Staff,19,0,20,1
1713334829984,MCWP 40R,C00,518783,Staff,19,0,20,1
1713334831010,MCWP 50R,A00,518791,Staff,20,0,20,0
1713334831010,MCWP 50R,B00,518792,Staff,17,0,20,3
1713334831010,MCWP 50R,C00,518793,Staff,19,0,20,1
1713334831010,MCWP 50R,D00,518794,Staff,16,0,20,4
1713334831010,MCWP 50R,E00,518795,Staff,16,0,20,4
1713334831010,MCWP 50R,F00,518796,Staff,19,0,20,1
1713334831010,MCWP 50R,G00,518797,Staff,19,0,20,1
1713334832039,MMW 12R,A01,514034,Herbst; Matthew,15,0,16,1
1713334832039,MMW 12R,A02,514035,Herbst; Matthew,16,0,16,0
1713334833063,MMW 13R,A01,514037,Staff,12,0,16,4
1713334833063,MMW 13R,A02,514039,Staff,16,0,16,0
1713334835117,SIO 295LS,A00,523233,Staff,19,0,30,11
1713334836143,SIO 295S,A00,523232,Staff,19,0,30,11
1713334837169,SOCI 117,A01,494376,Staff,2,0,5,3
1713334838195,WES 237B,A00,494380,Staff,19,0,20,1
1713334840255,AESE 279B,A00,494370,Wade; Jon P,33,0,33,0
1713334841287,ANAR 135S,A00,494369,Braswell; Geoffrey E.,0,0,0,0
1713334842312,CAT 124RS,A01,519847,Geibel; William,17,0,20,3
1713334843336,CAT 125RS,A01,515971,Geibel; William,17,0,20,3
1713334844365,CLRE 250,A00,511389,Morris; Sheldon,9996,0,9999,3
1713334845397,CLRE 251,A00,507176,Mehta; Ravindra L.,9996,0,9999,3
1713334845397,CLRE 251,B00,511410,Mehta; Ravindra L.,9998,0,9999,1
1713334846424,CLRE 252,A00,507189,Cuomo; Raphael Eduardo,9998,0,9999,1
1713334847450,CLRE 253,A00,507199,Vaida; Florin,9997,0,9999,2
1713334847450,CLRE 253,B00,507202,Vaida; Florin,9999,0,9999,0
1713334848479,CLRE 259,A00,507211,Patel; Hemal,9996,0,9999,3
1713334849506,CLRE 260,A00,507221,Cuomo; Raphael Eduardo,9999,0,9999,0
1713334850532,CLRE 297,001,507242,Cuomo; Raphael Eduardo,9999,0,9999,0
1713334851557,CSE 191,A00,516875,Minnes Kemp; Mor Mia,9999,0,9999,0
1713334852582,CSS 201S,A01,494383,Staff,35,0,35,0
1713334853607,CSS 202S,A01,494387,Staff,35,0,35,0
1713334854632,EAP 100,A00,516065,Staff,9792,0,9999,207
1713334855664,ECE 45,A01,507414,Staff,51,0,60,9
1713334856690,ECE 100,A01,507416,Baghdadchi; Saharnaz,10,0,20,10
1713334856690,ECE 100,A02,507418,Baghdadchi; Saharnaz,20,0,20,0
1713334857715,ECE 111,A01,507420,Staff,38,0,50,12
1713334858742,ECE 197,001,548057,Sievenpiper; Daniel F.,9998,0,9999,1
1713334859772,EDS 115,A00,507243,Choi; Bailey Miyeon,28,0,28,0
1713334860798,EDS 117,A01,494379,Staff,23,0,25,2
1713334861833,EDS 125,A00,507246,Hopkins; Megan Beth,29,0,30,1
1713334862864,EDS 128A,A01,507264,Fargason; Sharon Gayle,26,0,26,0
1713334863894,EDS 128B,A01,507293,Pappas; Elizabeth,30,0,30,0
1713334864924,EDS 139,A00,507294,Fargason; Sharon Gayle,30,0,30,0
1713334864924,EDS 139,B00,507313,Pappas; Elizabeth,30,0,30,0
1713334865950,EDS 201,A00,507315,Staff,26,0,30,4
1713334866984,EDS 203,A01,507317,Halter; Christopher P.,26,0,30,4
1713334868010,EDS 204R,A01,507319,Halter; Christopher P.,3,0,30,27
1713334868010,EDS 204R,B01,507331,Heinzman; Erica M.,28,0,30,2
1713334869037,EDS 206R,A00,507332,Staff,4,0,30,26
1713334869037,EDS 206R,B00,507343,Staff,28,0,30,2
1713334870068,EDS 250,A00,507344,Hemans; Patricia Ann Benitez,36,0,40,4
1713334871094,EDS 281,A00,507345,Daly; Alan J.,18,0,18,0
1713334872119,EDS 284,A00,507350,Daly; Alan J.,16,0,16,0
1713334873147,EDS 286,A00,507359,Fine; Sarah,18,0,18,0
1713334874178,EDS 289C,A01,507361,Daly; Alan J.,18,0,18,0
1713334875203,EDS 290,A00,507366,Hofstetter; Carolyn,15,0,15,0
1713334876237,LIGM 5A,A00,507421,Fischer-Grunski; Eva K,20,0,20,0
1713334877263,LIGM 5B,A00,507423,Fischer-Grunski; Eva K,20,0,20,0
1713334878293,LIGM 5C,A00,507425,Fischer-Grunski; Eva K,20,0,20,0
1713334879319,LIIT 5AS,A00,507427,Carnelos; Chiara,20,0,20,0
1713334880344,LIIT 5BS,A00,507430,Carnelos; Chiara,20,0,20,0
1713334881374,LIIT 5CS,A00,507432,Carnelos; Chiara,20,0,20,0
1713334882419,LISP 5A,A00,507541,Munoz Sanchez; Alicia,17,0,20,3
1713334883450,LISP 5B,A00,507671,Munoz Sanchez; Alicia,15,0,20,5
1713334884475,LISP 5C,A00,507696,Munoz Sanchez; Alicia,15,0,20,5
1713334885504,MAE 197,001,528363,Boechler; Nicholas Sebastia,9998,0,9999,1
1713334886535,MATH 197,001,523477,Kedlaya; Kiran S.,9999,0,9999,0
1713334886535,MATH 197,002,563811,Zhang; Danna,9999,0,9999,0
1713334887569,MCWP 40R,A00,518780,Staff,20,0,20,0
1713334887569,MCWP 40R,B00,518781,Staff,19,0,20,1
1713334887569,MCWP 40R,C00,518783,Staff,19,0,20,1
1713334888594,MCWP 50R,A00,518791,Staff,20,0,20,0
1713334888594,MCWP 50R,B00,518792,Staff,17,0,20,3
1713334888594,MCWP 50R,C00,518793,Staff,19,0,20,1
1713334888594,MCWP 50R,D00,518794,Staff,16,0,20,4
1713334888594,MCWP 50R,E00,518795,Staff,16,0,20,4
1713334888594,MCWP 50R,F00,518796,Staff,19,0,20,1
1713334888594,MCWP 50R,G00,518797,Staff,19,0,20,1
1713334889618,MMW 12R,A01,514034,Herbst; Matthew,15,0,16,1
1713334889618,MMW 12R,A02,514035,Herbst; Matthew,16,0,16,0
1713334890643,MMW 13R,A01,514037,Staff,12,0,16,4
1713334890643,MMW 13R,A02,514039,Staff,16,0,16,0
1713334892698,SIO 295LS,A00,523233,Staff,19,0,30,11
1713334893725,SIO 295S,A00,523232,Staff,19,0,30,11
1713334894750,SOCI 117,A01,494376,Staff,2,0,5,3
1713334895776,WES 237B,A00,494380,Staff,19,0,20,1
1713334897855,AESE 279B,A00,494370,Wade; Jon P,33,0,33,0
1713334898881,ANAR 135S,A00,494369,Braswell; Geoffrey E.,0,0,0,0
1713334899906,CAT 124RS,A01,519847,Geibel; William,17,0,20,3
1713334900932,CAT 125RS,A01,515971,Geibel; William,17,0,20,3
1713334901965,CLRE 250,A00,511389,Morris; Sheldon,9996,0,9999,3
1713334903018,CLRE 251,A00,507176,Mehta; Ravindra L.,9996,0,9999,3
1713334903018,CLRE 251,B00,511410,Mehta; Ravindra L.,9998,0,9999,1
1713334904045,CLRE 252,A00,507189,Cuomo; Raphael Eduardo,9998,0,9999,1
1713334905125,CLRE 253,A00,507199,Vaida; Florin,9997,0,9999,2
1713334905125,CLRE 253,B00,507202,Vaida; Florin,9999,0,9999,0
1713334906156,CLRE 259,A00,507211,Patel; Hemal,9996,0,9999,3
1713334907186,CLRE 260,A00,507221,Cuomo; Raphael Eduardo,9999,0,9999,0
1713334908212,CLRE 297,001,507242,Cuomo; Raphael Eduardo,9999,0,9999,0
1713334909237,CSE 191,A00,516875,Minnes Kemp; Mor Mia,9999,0,9999,0
1713334910263,CSS 201S,A01,494383,Staff,35,0,35,0
1713334911288,CSS 202S,A01,494387,Staff,35,0,35,0
1713334912312,EAP 100,A00,516065,Staff,9792,0,9999,207
1713334913335,ECE 45,A01,507414,Staff,51,0,60,9
1713334914362,ECE 100,A01,507416,Baghdadchi; Saharnaz,10,0,20,10
1713334914362,ECE 100,A02,507418,Baghdadchi; Saharnaz,20,0,20,0
1713334915389,ECE 111,A01,507420,Staff,38,0,50,12
1713334916418,ECE 197,001,548057,Sievenpiper; Daniel F.,9998,0,9999,1
1713334917447,EDS 115,A00,507243,Choi; Bailey Miyeon,28,0,28,0
1713334918478,EDS 117,A01,494379,Staff,23,0,25,2
1713334919505,EDS 125,A00,507246,Hopkins; Megan Beth,29,0,30,1
1713334920529,EDS 128A,A01,507264,Fargason; Sharon Gayle,26,0,26,0
1713334921555,EDS 128B,A01,507293,Pappas; Elizabeth,30,0,30,0
1713334922581,EDS 139,A00,507294,Fargason; Sharon Gayle,30,0,30,0
1713334922581,EDS 139,B00,507313,Pappas; Elizabeth,30,0,30,0
1713334923606,EDS 201,A00,507315,Staff,26,0,30,4
1713334924633,EDS 203,A01,507317,Halter; Christopher P.,26,0,30,4
1713334925660,EDS 204R,A01,507319,Halter; Christopher P.,3,0,30,27
1713334925660,EDS 204R,B01,507331,Heinzman; Erica M.,28,0,30,2
1713334926688,EDS 206R,A00,507332,Staff,4,0,30,26
1713334926688,EDS 206R,B00,507343,Staff,28,0,30,2
1713334927715,EDS 250,A00,507344,Hemans; Patricia Ann Benitez,36,0,40,4
1713334928741,EDS 281,A00,507345,Daly; Alan J.,18,0,18,0
1713334929766,EDS 284,A00,507350,Daly; Alan J.,16,0,16,0
1713334930795,EDS 286,A00,507359,Fine; Sarah,18,0,18,0
1713334931824,EDS 289C,A01,507361,Daly; Alan J.,18,0,18,0
1713334932850,EDS 290,A00,507366,Hofstetter; Carolyn,15,0,15,0
1713334933876,LIGM 5A,A00,507421,Fischer-Grunski; Eva K,20,0,20,0
1713334934907,LIGM 5B,A00,507423,Fischer-Grunski; Eva K,20,0,20,0
1713334935931,LIGM 5C,A00,507425,Fischer-Grunski; Eva K,20,0,20,0
1713334936957,LIIT 5AS,A00,507427,Carnelos; Chiara,20,0,20,0
1713334937981,LIIT 5BS,A00,507430,Carnelos; Chiara,20,0,20,0
1713334939008,LIIT 5CS,A00,507432,Carnelos; Chiara,20,0,20,0
1713334940038,LISP 5A,A00,507541,Munoz Sanchez; Alicia,17,0,20,3
1713334941063,LISP 5B,A00,507671,Munoz Sanchez; Alicia,15,0,20,5
1713334942091,LISP 5C,A00,507696,Munoz Sanchez; Alicia,15,0,20,5
1713334943118,MAE 197,001,528363,Boechler; Nicholas Sebastia,9998,0,9999,1
1713334944143,MATH 197,001,523477,Kedlaya; Kiran S.,9999,0,9999,0
1713334944143,MATH 197,002,563811,Zhang; Danna,9999,0,9999,0
1713334945173,MCWP 40R,A00,518780,Staff,20,0,20,0
1713334945173,MCWP 40R,B00,518781,Staff,19,0,20,1
1713334945173,MCWP 40R,C00,518783,Staff,19,0,20,1
1713334946200,MCWP 50R,A00,518791,Staff,20,0,20,0
1713334946200,MCWP 50R,B00,518792,Staff,17,0,20,3
1713334946200,MCWP 50R,C00,518793,Staff,19,0,20,1
1713334946200,MCWP 50R,D00,518794,Staff,16,0,20,4
1713334946200,MCWP 50R,E00,518795,Staff,16,0,20,4
1713334946200,MCWP 50R,F00,518796,Staff,19,0,20,1
1713334946200,MCWP 50R,G00,518797,Staff,19,0,20,1
1713334947225,MMW 12R,A01,514034,Herbst; Matthew,15,0,16,1
1713334947225,MMW 12R,A02,514035,Herbst; Matthew,16,0,16,0
1713334948250,MMW 13R,A01,514037,Staff,12,0,16,4
1713334948250,MMW 13R,A02,514039,Staff,16,0,16,0
1713334950306,SIO 295LS,A00,523233,Staff,19,0,30,11
1713334951330,SIO 295S,A00,523232,Staff,19,0,30,11
1713334952357,SOCI 117,A01,494376,Staff,2,0,5,3
1713334953382,WES 237B,A00,494380,Staff,19,0,20,1
1713334955448,AESE 279B,A00,494370,Wade; Jon P,33,0,33,0
1713334956475,ANAR 135S,A00,494369,Braswell; Geoffrey E.,0,0,0,0
1713334957505,CAT 124RS,A01,519847,Geibel; William,17,0,20,3
1713334958531,CAT 125RS,A01,515971,Geibel; William,17,0,20,3
1713334959559,CLRE 250,A00,511389,Morris; Sheldon,9996,0,9999,3
1713334960591,CLRE 251,A00,507176,Mehta; Ravindra L.,9996,0,9999,3
1713334960591,CLRE 251,B00,511410,Mehta; Ravindra L.,9998,0,9999,1
1713334961619,CLRE 252,A00,507189,Cuomo; Raphael Eduardo,9998,0,9999,1
1713334962643,CLRE 253,A00,507199,Vaida; Florin,9997,0,9999,2
1713334962643,CLRE 253,B00,507202,Vaida; Florin,9999,0,9999,0
1713334963673,CLRE 259,A00,507211,Patel; Hemal,9996,0,9999,3
1713334964699,CLRE 260,A00,507221,Cuomo; Raphael Eduardo,9999,0,9999,0
1713334965727,CLRE 297,001,507242,Cuomo; Raphael Eduardo,9999,0,9999,0
1713334966753,CSE 191,A00,516875,Minnes Kemp; Mor Mia,9999,0,9999,0
1713334967779,CSS 201S,A01,494383,Staff,35,0,35,0
1713334968806,CSS 202S,A01,494387,Staff,35,0,35,0
1713334969831,EAP 100,A00,516065,Staff,9792,0,9999,207
1713334970857,ECE 45,A01,507414,Staff,51,0,60,9
1713334971887,ECE 100,A01,507416,Baghdadchi; Saharnaz,10,0,20,10
1713334971887,ECE 100,A02,507418,Baghdadchi; Saharnaz,20,0,20,0
1713334972913,ECE 111,A01,507420,Staff,38,0,50,12
1713334973937,ECE 197,001,548057,Sievenpiper; Daniel F.,9998,0,9999,1
1713334974965,EDS 115,A00,507243,Choi; Bailey Miyeon,28,0,28,0
1713334975991,EDS 117,A01,494379,Staff,23,0,25,2
1713334977026,EDS 125,A00,507246,Hopkins; Megan Beth,29,0,30,1
1713334978062,EDS 128A,A01,507264,Fargason; Sharon Gayle,26,0,26,0
1713334979088,EDS 128B,A01,507293,Pappas; Elizabeth,30,0,30,0
1713334980118,EDS 139,A00,507294,Fargason; Sharon Gayle,30,0,30,0
1713334980118,EDS 139,B00,507313,Pappas; Elizabeth,30,0,30,0
1713334981143,EDS 201,A00,507315,Staff,26,0,30,4
1713334982170,EDS 203,A01,507317,Halter; Christopher P.,26,0,30,4
1713334983195,EDS 204R,A01,507319,Halter; Christopher P.,3,0,30,27
1713334983195,EDS 204R,B01,507331,Heinzman; Erica M.,28,0,30,2
1713334984220,EDS 206R,A00,507332,Staff,4,0,30,26
1713334984220,EDS 206R,B00,507343,Staff,28,0,30,2
1713334985245,EDS 250,A00,507344,Hemans; Patricia Ann Benitez,36,0,40,4
1713334986270,EDS 281,A00,507345,Daly; Alan J.,18,0,18,0
1713334987294,EDS 284,A00,507350,Daly; Alan J.,16,0,16,0
1713334988323,EDS 286,A00,507359,Fine; Sarah,18,0,18,0
1713334989346,EDS 289C,A01,507361,Daly; Alan J.,18,0,18,0
1713334990373,EDS 290,A00,507366,Hofstetter; Carolyn,15,0,15,0
1713334991404,LIGM 5A,A00,507421,Fischer-Grunski; Eva K,20,0,20,0
1713334992429,LIGM 5B,A00,507423,Fischer-Grunski; Eva K,20,0,20,0
1713334993456,LIGM 5C,A00,507425,Fischer-Grunski; Eva K,20,0,20,0
1713334994482,LIIT 5AS,A00,507427,Carnelos; Chiara,20,0,20,0
1713334995506,LIIT 5BS,A00,507430,Carnelos; Chiara,20,0,20,0
1713334996532,LIIT 5CS,A00,507432,Carnelos; Chiara,20,0,20,0
1713334997558,LISP 5A,A00,507541,Munoz Sanchez; Alicia,17,0,20,3
1713334998586,LISP 5B,A00,507671,Munoz Sanchez; Alicia,15,0,20,5
1713334999612,LISP 5C,A00,507696,Munoz Sanchez; Alicia,15,0,20,5
1713335000643,MAE 197,001,528363,Boechler; Nicholas Sebastia,9998,0,9999,1
1713335001675,MATH 197,001,523477,Kedlaya; Kiran S.,9999,0,9999,0
1713335001675,MATH 197,002,563811,Zhang; Danna,9999,0,9999,0
1713335002699,MCWP 40R,A00,518780,Staff,20,0,20,0
1713335002699,MCWP 40R,B00,518781,Staff,19,0,20,1
1713335002699,MCWP 40R,C00,518783,Staff,19,0,20,1
1713335003725,MCWP 50R,A00,518791,Staff,20,0,20,0
1713335003725,MCWP 50R,B00,518792,Staff,17,0,20,3
1713335003725,MCWP 50R,C00,518793,Staff,19,0,20,1
1713335003725,MCWP 50R,D00,518794,Staff,16,0,20,4
1713335003725,MCWP 50R,E00,518795,Staff,16,0,20,4
1713335003725,MCWP 50R,F00,518796,Staff,19,0,20,1
1713335003725,MCWP 50R,G00,518797,Staff,19,0,20,1
1713335004749,MMW 12R,A01,514034,Herbst; Matthew,15,0,16,1
1713335004749,MMW 12R,A02,514035,Herbst; Matthew,16,0,16,0
1713335005777,MMW 13R,A01,514037,Staff,12,0,16,4
1713335005777,MMW 13R,A02,514039,Staff,16,0,16,0
1713335007831,SIO 295LS,A00,523233,Staff,19,0,30,11
1713335008914,SIO 295S,A00,523232,Staff,19,0,30,11
1713335009938,SOCI 117,A01,494376,Staff,2,0,5,3
1713335010967,WES 237B,A00,494380,Staff,19,0,20,1
1713335013047,AESE 279B,A00,494370,Wade; Jon P,33,0,33,0
1713335014073,ANAR 135S,A00,494369,Braswell; Geoffrey E.,0,0,0,0
1713335015098,CAT 124RS,A01,519847,Geibel; William,17,0,20,3
1713335016124,CAT 125RS,A01,515971,Geibel; William,17,0,20,3
1713335017153,CLRE 250,A00,511389,Morris; Sheldon,9996,0,9999,3
1713335018184,CLRE 251,A00,507176,Mehta; Ravindra L.,9996,0,9999,3
1713335018184,CLRE 251,B00,511410,Mehta; Ravindra L.,9998,0,9999,1
1713335019210,CLRE 252,A00,507189,Cuomo; Raphael Eduardo,9998,0,9999,1
1713335020245,CLRE 253,A00,507199,Vaida; Florin,9997,0,9999,2
1713335020245,CLRE 253,B00,507202,Vaida; Florin,9999,0,9999,0
1713335021275,CLRE 259,A00,507211,Patel; Hemal,9996,0,9999,3
1713335022300,CLRE 260,A00,507221,Cuomo; Raphael Eduardo,9999,0,9999,0
1713335023327,CLRE 297,001,507242,Cuomo; Raphael Eduardo,9999,0,9999,0
1713335024353,CSE 191,A00,516875,Minnes Kemp; Mor Mia,9999,0,9999,0
1713335025379,CSS 201S,A01,494383,Staff,35,0,35,0
1713335026407,CSS 202S,A01,494387,Staff,35,0,35,0
1713335027435,EAP 100,A00,516065,Staff,9792,0,9999,207
1713335028459,ECE 45,A01,507414,Staff,51,0,60,9
1713335029483,ECE 100,A01,507416,Baghdadchi; Saharnaz,10,0,20,10
1713335029483,ECE 100,A02,507418,Baghdadchi; Saharnaz,20,0,20,0
1713335030511,ECE 111,A01,507420,Staff,38,0,50,12
1713335031537,ECE 197,001,548057,Sievenpiper; Daniel F.,9998,0,9999,1
1713335032564,EDS 115,A00,507243,Choi; Bailey Miyeon,28,0,28,0
1713335033589,EDS 117,A01,494379,Staff,23,0,25,2
1713335034614,EDS 125,A00,507246,Hopkins; Megan Beth,29,0,30,1
1713335035638,EDS 128A,A01,507264,Fargason; Sharon Gayle,26,0,26,0
1713335036664,EDS 128B,A01,507293,Pappas; Elizabeth,30,0,30,0
1713335037692,EDS 139,A00,507294,Fargason; Sharon Gayle,30,0,30,0
1713335037692,EDS 139,B00,507313,Pappas; Elizabeth,30,0,30,0
1713335038722,EDS 201,A00,507315,Staff,26,0,30,4
1713335039747,EDS 203,A01,507317,Halter; Christopher P.,26,0,30,4
1713335040777,EDS 204R,A01,507319,Halter; Christopher P.,3,0,30,27
1713335040777,EDS 204R,B01,507331,Heinzman; Erica M.,28,0,30,2
1713335041805,EDS 206R,A00,507332,Staff,4,0,30,26
1713335041805,EDS 206R,B00,507343,Staff,28,0,30,2
1713335042835,EDS 250,A00,507344,Hemans; Patricia Ann Benitez,36,0,40,4
1713335043872,EDS 281,A00,507345,Daly; Alan J.,18,0,18,0
1713335044899,EDS 284,A00,507350,Daly; Alan J.,16,0,16,0
1713335045926,EDS 286,A00,507359,Fine; Sarah,18,0,18,0
1713335046954,EDS 289C,A01,507361,Daly; Alan J.,18,0,18,0
1713335047977,EDS 290,A00,507366,Hofstetter; Carolyn,15,0,15,0
1713335049003,LIGM 5A,A00,507421,Fischer-Grunski; Eva K,20,0,20,0
1713335050032,LIGM 5B,A00,507423,Fischer-Grunski; Eva K,20,0,20,0
1713335051057,LIGM 5C,A00,507425,Fischer-Grunski; Eva K,20,0,20,0
1713335052085,LIIT 5AS,A00,507427,Carnelos; Chiara,20,0,20,0
1713335053111,LIIT 5BS,A00,507430,Carnelos; Chiara,20,0,20,0
1713335054137,LIIT 5CS,A00,507432,Carnelos; Chiara,20,0,20,0
1713335055162,LISP 5A,A00,507541,Munoz Sanchez; Alicia,17,0,20,3
1713335056189,LISP 5B,A00,507671,Munoz Sanchez; Alicia,15,0,20,5
1713335057214,LISP 5C,A00,507696,Munoz Sanchez; Alicia,15,0,20,5
1713335058240,MAE 197,001,528363,Boechler; Nicholas Sebastia,9998,0,9999,1
1713335059264,MATH 197,001,523477,Kedlaya; Kiran S.,9999,0,9999,0
1713335059264,MATH 197,002,563811,Zhang; Danna,9999,0,9999,0
1713335060291,MCWP 40R,A00,518780,Staff,20,0,20,0
1713335060291,MCWP 40R,B00,518781,Staff,19,0,20,1
1713335060291,MCWP 40R,C00,518783,Staff,19,0,20,1
1713335061321,MCWP 50R,A00,518791,Staff,20,0,20,0
1713335061321,MCWP 50R,B00,518792,Staff,17,0,20,3
1713335061321,MCWP 50R,C00,518793,Staff,19,0,20,1
1713335061321,MCWP 50R,D00,518794,Staff,16,0,20,4
1713335061321,MCWP 50R,E00,518795,Staff,16,0,20,4
1713335061321,MCWP 50R,F00,518796,Staff,19,0,20,1
1713335061321,MCWP 50R,G00,518797,Staff,19,0,20,1
1713335062347,MMW 12R,A01,514034,Herbst; Matthew,15,0,16,1
1713335062347,MMW 12R,A02,514035,Herbst; Matthew,16,0,16,0
1713335063377,MMW 13R,A01,514037,Staff,12,0,16,4
1713335063377,MMW 13R,A02,514039,Staff,16,0,16,0
1713335065435,SIO 295LS,A00,523233,Staff,19,0,30,11
1713335066459,SIO 295S,A00,523232,Staff,19,0,30,11
1713335067485,SOCI 117,A01,494376,Staff,2,0,5,3
1713335068511,WES 237B,A00,494380,Staff,19,0,20,1
1713335070581,AESE 279B,A00,494370,Wade; Jon P,33,0,33,0
1713335071608,ANAR 135S,A00,494369,Braswell; Geoffrey E.,0,0,0,0
1713335072635,CAT 124RS,A01,519847,Geibel; William,17,0,20,3
1713335073663,CAT 125RS,A01,515971,Geibel; William,17,0,20,3
1713335074688,CLRE 250,A00,511389,Morris; Sheldon,9996,0,9999,3
1713335075715,CLRE 251,A00,507176,Mehta; Ravindra L.,9996,0,9999,3
1713335075715,CLRE 251,B00,511410,Mehta; Ravindra L.,9998,0,9999,1
1713335076743,CLRE 252,A00,507189,Cuomo; Raphael Eduardo,9998,0,9999,1
1713335077769,CLRE 253,A00,507199,Vaida; Florin,9997,0,9999,2
1713335077769,CLRE 253,B00,507202,Vaida; Florin,9999,0,9999,0
1713335078795,CLRE 259,A00,507211,Patel; Hemal,9996,0,9999,3
1713335079818,CLRE 260,A00,507221,Cuomo; Raphael Eduardo,9999,0,9999,0
1713335080846,CLRE 297,001,507242,Cuomo; Raphael Eduardo,9999,0,9999,0
1713335081871,CSE 191,A00,516875,Minnes Kemp; Mor Mia,9999,0,9999,0
1713335082897,CSS 201S,A01,494383,Staff,35,0,35,0
1713335083926,CSS 202S,A01,494387,Staff,35,0,35,0
1713335084950,EAP 100,A00,516065,Staff,9792,0,9999,207
1713335085980,ECE 45,A01,507414,Staff,51,0,60,9
1713335087006,ECE 100,A01,507416,Baghdadchi; Saharnaz,10,0,20,10
1713335087006,ECE 100,A02,507418,Baghdadchi; Saharnaz,20,0,20,0
1713335088035,ECE 111,A01,507420,Staff,38,0,50,12
1713335089060,ECE 197,001,548057,Sievenpiper; Daniel F.,9998,0,9999,1
1713335090091,EDS 115,A00,507243,Choi; Bailey Miyeon,28,0,28,0
1713335091117,EDS 117,A01,494379,Staff,23,0,25,2
1713335092143,EDS 125,A00,507246,Hopkins; Megan Beth,29,0,30,1
1713335093169,EDS 128A,A01,507264,Fargason; Sharon Gayle,26,0,26,0
1713335094199,EDS 128B,A01,507293,Pappas; Elizabeth,30,0,30,0
1713335095224,EDS 139,A00,507294,Fargason; Sharon Gayle,30,0,30,0
1713335095224,EDS 139,B00,507313,Pappas; Elizabeth,30,0,30,0
1713335096248,EDS 201,A00,507315,Staff,26,0,30,4
1713335097272,EDS 203,A01,507317,Halter; Christopher P.,26,0,30,4
1713335098299,EDS 204R,A01,507319,Halter; Christopher P.,3,0,30,27
1713335098299,EDS 204R,B01,507331,Heinzman; Erica M.,28,0,30,2
1713335099326,EDS 206R,A00,507332,Staff,4,0,30,26
1713335099326,EDS 206R,B00,507343,Staff,28,0,30,2
1713335100355,EDS 250,A00,507344,Hemans; Patricia Ann Benitez,36,0,40,4
1713335101382,EDS 281,A00,507345,Daly; Alan J.,18,0,18,0
1713335102407,EDS 284,A00,507350,Daly; Alan J.,16,0,16,0
1713335103432,EDS 286,A00,507359,Fine; Sarah,18,0,18,0
1713335104457,EDS 289C,A01,507361,Daly; Alan J.,18,0,18,0
1713335105487,EDS 290,A00,507366,Hofstetter; Carolyn,15,0,15,0
1713335106518,LIGM 5A,A00,507421,Fischer-Grunski; Eva K,20,0,20,0
1713335107543,LIGM 5B,A00,507423,Fischer-Grunski; Eva K,20,0,20,0
1713335108573,LIGM 5C,A00,507425,Fischer-Grunski; Eva K,20,0,20,0
1713335109606,LIIT 5AS,A00,507427,Carnelos; Chiara,20,0,20,0
1713335110631,LIIT 5BS,A00,507430,Carnelos; Chiara,20,0,20,0
1713335111658,LIIT 5CS,A00,507432,Carnelos; Chiara,20,0,20,0
1713335112739,LISP 5A,A00,507541,Munoz Sanchez; Alicia,17,0,20,3
1713335113765,LISP 5B,A00,507671,Munoz Sanchez; Alicia,15,0,20,5
1713335114790,LISP 5C,A00,507696,Munoz Sanchez; Alicia,15,0,20,5
1713335115819,MAE 197,001,528363,Boechler; Nicholas Sebastia,9998,0,9999,1
1713335116844,MATH 197,001,523477,Kedlaya; Kiran S.,9999,0,9999,0
1713335116844,MATH 197,002,563811,Zhang; Danna,9999,0,9999,0
1713335117869,MCWP 40R,A00,518780,Staff,20,0,20,0
1713335117869,MCWP 40R,B00,518781,Staff,19,0,20,1
1713335117869,MCWP 40R,C00,518783,Staff,19,0,20,1
1713335118899,MCWP 50R,A00,518791,Staff,20,0,20,0
1713335118899,MCWP 50R,B00,518792,Staff,17,0,20,3
1713335118899,MCWP 50R,C00,518793,Staff,19,0,20,1
1713335118899,MCWP 50R,D00,518794,Staff,16,0,20,4
1713335118899,MCWP 50R,E00,518795,Staff,16,0,20,4
1713335118899,MCWP 50R,F00,518796,Staff,19,0,20,1
1713335118899,MCWP 50R,G00,518797,Staff,19,0,20,1
1713335119933,MMW 12R,A01,514034,Herbst; Matthew,15,0,16,1
1713335119933,MMW 12R,A02,514035,Herbst; Matthew,16,0,16,0
1713335120962,MMW 13R,A01,514037,Staff,12,0,16,4
1713335120962,MMW 13R,A02,514039,Staff,16,0,16,0
1713335123014,SIO 295LS,A00,523233,Staff,19,0,30,11
1713335124039,SIO 295S,A00,523232,Staff,19,0,30,11
1713335125065,SOCI 117,A01,494376,Staff,2,0,5,3
1713335126091,WES 237B,A00,494380,Staff,19,0,20,1
1713335128158,AESE 279B,A00,494370,Wade; Jon P,33,0,33,0
1713335129184,ANAR 135S,A00,494369,Braswell; Geoffrey E.,0,0,0,0
1713335130213,CAT 124RS,A01,519847,Geibel; William,17,0,20,3
1713335131240,CAT 125RS,A01,515971,Geibel; William,17,0,20,3
1713335132265,CLRE 250,A00,511389,Morris; Sheldon,9996,0,9999,3
1713335133299,CLRE 251,A00,507176,Mehta; Ravindra L.,9996,0,9999,3
1713335133299,CLRE 251,B00,511410,Mehta; Ravindra L.,9998,0,9999,1
1713335134329,CLRE 252,A00,507189,Cuomo; Raphael Eduardo,9998,0,9999,1
1713335135355,CLRE 253,A00,507199,Vaida; Florin,9997,0,9999,2
1713335135355,CLRE 253,B00,507202,Vaida; Florin,9999,0,9999,0
1713335136381,CLRE 259,A00,507211,Patel; Hemal,9996,0,9999,3
1713335137404,CLRE 260,A00,507221,Cuomo; Raphael Eduardo,9999,0,9999,0
1713335138428,CLRE 297,001,507242,Cuomo; Raphael Eduardo,9999,0,9999,0
1713335139457,CSE 191,A00,516875,Minnes Kemp; Mor Mia,9999,0,9999,0
1713335140482,CSS 201S,A01,494383,Staff,35,0,35,0
1713335141507,CSS 202S,A01,494387,Staff,35,0,35,0
1713335142531,EAP 100,A00,516065,Staff,9792,0,9999,207
1713335143557,ECE 45,A01,507414,Staff,51,0,60,9
1713335144582,ECE 100,A01,507416,Baghdadchi; Saharnaz,10,0,20,10
1713335144582,ECE 100,A02,507418,Baghdadchi; Saharnaz,20,0,20,0
1713335145608,ECE 111,A01,507420,Staff,38,0,50,12
1713335146633,ECE 197,001,548057,Sievenpiper; Daniel F.,9998,0,9999,1
1713335147664,EDS 115,A00,507243,Choi; Bailey Miyeon,28,0,28,0
1713335148692,EDS 117,A01,494379,Staff,23,0,25,2
1713335149721,EDS 125,A00,507246,Hopkins; Megan Beth,29,0,30,1
1713335150747,EDS 128A,A01,507264,Fargason; Sharon Gayle,26,0,26,0
1713335151775,EDS 128B,A01,507293,Pappas; Elizabeth,30,0,30,0
1713335152802,EDS 139,A00,507294,Fargason; Sharon Gayle,30,0,30,0
1713335152802,EDS 139,B00,507313,Pappas; Elizabeth,30,0,30,0
1713335153827,EDS 201,A00,507315,Staff,26,0,30,4
1713335154853,EDS 203,A01,507317,Halter; Christopher P.,26,0,30,4
1713335155880,EDS 204R,A01,507319,Halter; Christopher P.,3,0,30,27
1713335155880,EDS 204R,B01,507331,Heinzman; Erica M.,28,0,30,2
1713335156909,EDS 206R,A00,507332,Staff,4,0,30,26
1713335156909,EDS 206R,B00,507343,Staff,28,0,30,2
1713335157938,EDS 250,A00,507344,Hemans; Patricia Ann Benitez,36,0,40,4
1713335158972,EDS 281,A00,507345,Daly; Alan J.,18,0,18,0
1713335160001,EDS 284,A00,507350,Daly; Alan J.,16,0,16,0
1713335161027,EDS 286,A00,507359,Fine; Sarah,18,0,18,0
1713335162060,EDS 289C,A01,507361,Daly; Alan J.,18,0,18,0
1713335163093,EDS 290,A00,507366,Hofstetter; Carolyn,15,0,15,0
1713335164119,LIGM 5A,A00,507421,Fischer-Grunski; Eva K,20,0,20,0
1713335165148,LIGM 5B,A00,507423,Fischer-Grunski; Eva K,20,0,20,0
1713335166173,LIGM 5C,A00,507425,Fischer-Grunski; Eva K,20,0,20,0
1713335167201,LIIT 5AS,A00,507427,Carnelos; Chiara,20,0,20,0
1713335168226,LIIT 5BS,A00,507430,Carnelos; Chiara,20,0,20,0
1713335169251,LIIT 5CS,A00,507432,Carnelos; Chiara,20,0,20,0
1713335170278,LISP 5A,A00,507541,Munoz Sanchez; Alicia,17,0,20,3
1713335171303,LISP 5B,A00,507671,Munoz Sanchez; Alicia,15,0,20,5
1713335172328,LISP 5C,A00,507696,Munoz Sanchez; Alicia,15,0,20,5
1713335173356,MAE 197,001,528363,Boechler; Nicholas Sebastia,9998,0,9999,1
1713335174383,MATH 197,001,523477,Kedlaya; Kiran S.,9999,0,9999,0
1713335174383,MATH 197,002,563811,Zhang; Danna,9999,0,9999,0
1713335175415,MCWP 40R,A00,518780,Staff,20,0,20,0
1713335175415,MCWP 40R,B00,518781,Staff,19,0,20,1
1713335175415,MCWP 40R,C00,518783,Staff,19,0,20,1
1713335176447,MCWP 50R,A00,518791,Staff,20,0,20,0
1713335176447,MCWP 50R,B00,518792,Staff,17,0,20,3
1713335176447,MCWP 50R,C00,518793,Staff,19,0,20,1
1713335176447,MCWP 50R,D00,518794,Staff,16,0,20,4
1713335176447,MCWP 50R,E00,518795,Staff,16,0,20,4
1713335176447,MCWP 50R,F00,518796,Staff,19,0,20,1
1713335176447,MCWP 50R,G00,518797,Staff,19,0,20,1
1713335177477,MMW 12R,A01,514034,Herbst; Matthew,15,0,16,1
1713335177477,MMW 12R,A02,514035,Herbst; Matthew,16,0,16,0
1713335178504,MMW 13R,A01,514037,Staff,12,0,16,4
1713335178504,MMW 13R,A02,514039,Staff,16,0,16,0
1713335180555,SIO 295LS,A00,523233,Staff,19,0,30,11
1713335181581,SIO 295S,A00,523232,Staff,19,0,30,11
1713335182607,SOCI 117,A01,494376,Staff,2,0,5,3
1713335183635,WES 237B,A00,494380,Staff,19,0,20,1
1713335185707,AESE 279B,A00,494370,Wade; Jon P,33,0,33,0
1713335186732,ANAR 135S,A00,494369,Braswell; Geoffrey E.,0,0,0,0
1713335187762,CAT 124RS,A01,519847,Geibel; William,17,0,20,3
1713335188787,CAT 125RS,A01,515971,Geibel; William,17,0,20,3
1713335189813,CLRE 250,A00,511389,Morris; Sheldon,9996,0,9999,3
1713335190845,CLRE 251,A00,507176,Mehta; Ravindra L.,9996,0,9999,3
1713335190845,CLRE 251,B00,511410,Mehta; Ravindra L.,9998,0,9999,1
1713335191872,CLRE 252,A00,507189,Cuomo; Raphael Eduardo,9998,0,9999,1
1713335192900,CLRE 253,A00,507199,Vaida; Florin,9997,0,9999,2
1713335192900,CLRE 253,B00,507202,Vaida; Florin,9999,0,9999,0
1713335193925,CLRE 259,A00,507211,Patel; Hemal,9996,0,9999,3
1713335194953,CLRE 260,A00,507221,Cuomo; Raphael Eduardo,9999,0,9999,0
1713335195983,CLRE 297,001,507242,Cuomo; Raphael Eduardo,9999,0,9999,0
1713335197011,CSE 191,A00,516875,Minnes Kemp; Mor Mia,9999,0,9999,0
1713335198044,CSS 201S,A01,494383,Staff,35,0,35,0
1713335199073,CSS 202S,A01,494387,Staff,35,0,35,0
1713335200102,EAP 100,A00,516065,Staff,9792,0,9999,207
1713335201129,ECE 45,A01,507414,Staff,51,0,60,9
1713335202158,ECE 100,A01,507416,Baghdadchi; Saharnaz,10,0,20,10
1713335202158,ECE 100,A02,507418,Baghdadchi; Saharnaz,20,0,20,0
1713335203181,ECE 111,A01,507420,Staff,38,0,50,12
1713335204205,ECE 197,001,548057,Sievenpiper; Daniel F.,9998,0,9999,1
1713335205235,EDS 115,A00,507243,Choi; Bailey Miyeon,28,0,28,0
1713335206259,EDS 117,A01,494379,Staff,23,0,25,2
1713335207285,EDS 125,A00,507246,Hopkins; Megan Beth,29,0,30,1
1713335208314,EDS 128A,A01,507264,Fargason; Sharon Gayle,26,0,26,0
1713335209338,EDS 128B,A01,507293,Pappas; Elizabeth,30,0,30,0
1713335210364,EDS 139,A00,507294,Fargason; Sharon Gayle,30,0,30,0
1713335210364,EDS 139,B00,507313,Pappas; Elizabeth,30,0,30,0
1713335211391,EDS 201,A00,507315,Staff,26,0,30,4
1713335212418,EDS 203,A01,507317,Halter; Christopher P.,26,0,30,4
1713335213445,EDS 204R,A01,507319,Halter; Christopher P.,3,0,30,27
1713335213445,EDS 204R,B01,507331,Heinzman; Erica M.,28,0,30,2
1713335214471,EDS 206R,A00,507332,Staff,4,0,30,26
1713335214471,EDS 206R,B00,507343,Staff,28,0,30,2
1713335215503,EDS 250,A00,507344,Hemans; Patricia Ann Benitez,36,0,40,4
1713335216588,EDS 281,A00,507345,Daly; Alan J.,18,0,18,0
1713335217612,EDS 284,A00,507350,Daly; Alan J.,16,0,16,0
1713335218637,EDS 286,A00,507359,Fine; Sarah,18,0,18,0
1713335219665,EDS 289C,A01,507361,Daly; Alan J.,18,0,18,0
1713335220690,EDS 290,A00,507366,Hofstetter; Carolyn,15,0,15,0
1713335221735,LIGM 5A,A00,507421,Fischer-Grunski; Eva K,20,0,20,0
1713335222761,LIGM 5B,A00,507423,Fischer-Grunski; Eva K,20,0,20,0
1713335223793,LIGM 5C,A00,507425,Fischer-Grunski; Eva K,20,0,20,0
1713335224827,LIIT 5AS,A00,507427,Carnelos; Chiara,20,0,20,0
1713335225853,LIIT 5BS,A00,507430,Carnelos; Chiara,20,0,20,0
1713335226878,LIIT 5CS,A00,507432,Carnelos; Chiara,20,0,20,0
1713335227903,LISP 5A,A00,507541,Munoz Sanchez; Alicia,17,0,20,3
1713335228934,LISP 5B,A00,507671,Munoz Sanchez; Alicia,15,0,20,5
1713335229959,LISP 5C,A00,507696,Munoz Sanchez; Alicia,15,0,20,5
1713335230985,MAE 197,001,528363,Boechler; Nicholas Sebastia,9998,0,9999,1
1713335232010,MATH 197,001,523477,Kedlaya; Kiran S.,9999,0,9999,0
1713335232010,MATH 197,002,563811,Zhang; Danna,9999,0,9999,0
1713335233037,MCWP 40R,A00,518780,Staff,20,0,20,0
1713335233037,MCWP 40R,B00,518781,Staff,19,0,20,1
1713335233037,MCWP 40R,C00,518783,Staff,19,0,20,1
1713335234069,MCWP 50R,A00,518791,Staff,20,0,20,0
1713335234069,MCWP 50R,B00,518792,Staff,17,0,20,3
1713335234069,MCWP 50R,C00,518793,Staff,19,0,20,1
1713335234069,MCWP 50R,D00,518794,Staff,16,0,20,4
1713335234069,MCWP 50R,E00,518795,Staff,16,0,20,4
1713335234069,MCWP 50R,F00,518796,Staff,19,0,20,1
1713335234069,MCWP 50R,G00,518797,Staff,19,0,20,1
1713335235097,MMW 12R,A01,514034,Herbst; Matthew,15,0,16,1
1713335235097,MMW 12R,A02,514035,Herbst; Matthew,16,0,16,0
1713335236121,MMW 13R,A01,514037,Staff,12,0,16,4
1713335236121,MMW 13R,A02,514039,Staff,16,0,16,0
1713335238179,SIO 295LS,A00,523233,Staff,19,0,30,11
1713335239204,SIO 295S,A00,523232,Staff,19,0,30,11
1713335240229,SOCI 117,A01,494376,Staff,2,0,5,3
1713335241256,WES 237B,A00,494380,Staff,19,0,20,1
1713335243321,AESE 279B,A00,494370,Wade; Jon P,33,0,33,0
1713335244350,ANAR 135S,A00,494369,Braswell; Geoffrey E.,0,0,0,0
1713335245385,CAT 124RS,A01,519847,Geibel; William,17,0,20,3
1713335246410,CAT 125RS,A01,515971,Geibel; William,17,0,20,3
1713335247435,CLRE 250,A00,511389,Morris; Sheldon,9996,0,9999,3
1713335248470,CLRE 251,A00,507176,Mehta; Ravindra L.,9996,0,9999,3
1713335248470,CLRE 251,B00,511410,Mehta; Ravindra L.,9998,0,9999,1
1713335249503,CLRE 252,A00,507189,Cuomo; Raphael Eduardo,9998,0,9999,1
1713335250533,CLRE 253,A00,507199,Vaida; Florin,9997,0,9999,2
1713335250533,CLRE 253,B00,507202,Vaida; Florin,9999,0,9999,0
1713335251563,CLRE 259,A00,507211,Patel; Hemal,9996,0,9999,3
1713335252589,CLRE 260,A00,507221,Cuomo; Raphael Eduardo,9999,0,9999,0
1713335253616,CLRE 297,001,507242,Cuomo; Raphael Eduardo,9999,0,9999,0
1713335254646,CSE 191,A00,516875,Minnes Kemp; Mor Mia,9999,0,9999,0
1713335255673,CSS 201S,A01,494383,Staff,35,0,35,0
1713335256704,CSS 202S,A01,494387,Staff,35,0,35,0
1713335257728,EAP 100,A00,516065,Staff,9792,0,9999,207
1713335258754,ECE 45,A01,507414,Staff,51,0,60,9
1713335259778,ECE 100,A01,507416,Baghdadchi; Saharnaz,10,0,20,10
1713335259778,ECE 100,A02,507418,Baghdadchi; Saharnaz,20,0,20,0
1713335260804,ECE 111,A01,507420,Staff,38,0,50,12
1713335261833,ECE 197,001,548057,Sievenpiper; Daniel F.,9998,0,9999,1
1713335262864,EDS 115,A00,507243,Choi; Bailey Miyeon,28,0,28,0
1713335263894,EDS 117,A01,494379,Staff,23,0,25,2
1713335264920,EDS 125,A00,507246,Hopkins; Megan Beth,29,0,30,1
1713335265953,EDS 128A,A01,507264,Fargason; Sharon Gayle,26,0,26,0
1713335266978,EDS 128B,A01,507293,Pappas; Elizabeth,30,0,30,0
1713335268003,EDS 139,A00,507294,Fargason; Sharon Gayle,30,0,30,0
1713335268003,EDS 139,B00,507313,Pappas; Elizabeth,30,0,30,0
1713335269029,EDS 201,A00,507315,Staff,26,0,30,4
1713335270055,EDS 203,A01,507317,Halter; Christopher P.,26,0,30,4
1713335271086,EDS 204R,A01,507319,Halter; Christopher P.,3,0,30,27
1713335271086,EDS 204R,B01,507331,Heinzman; Erica M.,28,0,30,2
1713335272114,EDS 206R,A00,507332,Staff,4,0,30,26
1713335272114,EDS 206R,B00,507343,Staff,28,0,30,2
1713335273144,EDS 250,A00,507344,Hemans; Patricia Ann Benitez,36,0,40,4
1713335274174,EDS 281,A00,507345,Daly; Alan J.,18,0,18,0
1713335275202,EDS 284,A00,507350,Daly; Alan J.,16,0,16,0
1713335276232,EDS 286,A00,507359,Fine; Sarah,18,0,18,0
1713335277256,EDS 289C,A01,507361,Daly; Alan J.,18,0,18,0
1713335278282,EDS 290,A00,507366,Hofstetter; Carolyn,15,0,15,0
1713335279315,LIGM 5A,A00,507421,Fischer-Grunski; Eva K,20,0,20,0
1713335280342,LIGM 5B,A00,507423,Fischer-Grunski; Eva K,20,0,20,0
1713335281368,LIGM 5C,A00,507425,Fischer-Grunski; Eva K,20,0,20,0
1713335282393,LIIT 5AS,A00,507427,Carnelos; Chiara,20,0,20,0
1713335283417,LIIT 5BS,A00,507430,Carnelos; Chiara,20,0,20,0
1713335284449,LIIT 5CS,A00,507432,Carnelos; Chiara,20,0,20,0
1713335285479,LISP 5A,A00,507541,Munoz Sanchez; Alicia,17,0,20,3
1713335286505,LISP 5B,A00,507671,Munoz Sanchez; Alicia,15,0,20,5
1713335287530,LISP 5C,A00,507696,Munoz Sanchez; Alicia,15,0,20,5
1713335288555,MAE 197,001,528363,Boechler; Nicholas Sebastia,9998,0,9999,1
1713335289581,MATH 197,001,523477,Kedlaya; Kiran S.,9999,0,9999,0
1713335289581,MATH 197,002,563811,Zhang; Danna,9999,0,9999,0
1713335290612,MCWP 40R,A00,518780,Staff,20,0,20,0
1713335290612,MCWP 40R,B00,518781,Staff,19,0,20,1
1713335290612,MCWP 40R,C00,518783,Staff,19,0,20,1
1713335291637,MCWP 50R,A00,518791,Staff,20,0,20,0
1713335291637,MCWP 50R,B00,518792,Staff,17,0,20,3
1713335291637,MCWP 50R,C00,518793,Staff,19,0,20,1
1713335291637,MCWP 50R,D00,518794,Staff,16,0,20,4
1713335291637,MCWP 50R,E00,518795,Staff,16,0,20,4
1713335291637,MCWP 50R,F00,518796,Staff,19,0,20,1
1713335291637,MCWP 50R,G00,518797,Staff,19,0,20,1
1713335292663,MMW 12R,A01,514034,Herbst; Matthew,15,0,16,1
1713335292663,MMW 12R,A02,514035,Herbst; Matthew,16,0,16,0
1713335293688,MMW 13R,A01,514037,Staff,12,0,16,4
1713335293688,MMW 13R,A02,514039,Staff,16,0,16,0
1713335295741,SIO 295LS,A00,523233,Staff,19,0,30,11
1713335296767,SIO 295S,A00,523232,Staff,19,0,30,11
1713335297793,SOCI 117,A01,494376,Staff,2,0,5,3
1713335298821,WES 237B,A00,494380,Staff,19,0,20,1
1713335300897,AESE 279B,A00,494370,Wade; Jon P,33,0,33,0
1713335301927,ANAR 135S,A00,494369,Braswell; Geoffrey E.,0,0,0,0
1713335302950,CAT 124RS,A01,519847,Geibel; William,17,0,20,3
1713335303976,CAT 125RS,A01,515971,Geibel; William,17,0,20,3
1713335305002,CLRE 250,A00,511389,Morris; Sheldon,9996,0,9999,3
1713335306029,CLRE 251,A00,507176,Mehta; Ravindra L.,9996,0,9999,3
1713335306029,CLRE 251,B00,511410,Mehta; Ravindra L.,9998,0,9999,1
1713335307058,CLRE 252,A00,507189,Cuomo; Raphael Eduardo,9998,0,9999,1
1713335308085,CLRE 253,A00,507199,Vaida; Florin,9997,0,9999,2
1713335308085,CLRE 253,B00,507202,Vaida; Florin,9999,0,9999,0
1713335309110,CLRE 259,A00,507211,Patel; Hemal,9996,0,9999,3
1713335310136,CLRE 260,A00,507221,Cuomo; Raphael Eduardo,9999,0,9999,0
1713335311161,CLRE 297,001,507242,Cuomo; Raphael Eduardo,9999,0,9999,0
1713335312188,CSE 191,A00,516875,Minnes Kemp; Mor Mia,9999,0,9999,0
1713335313215,CSS 201S,A01,494383,Staff,35,0,35,0
1713335314244,CSS 202S,A01,494387,Staff,35,0,35,0
1713335315270,EAP 100,A00,516065,Staff,9792,0,9999,207
1713335316297,ECE 45,A01,507414,Staff,51,0,60,9
1713335317323,ECE 100,A01,507416,Baghdadchi; Saharnaz,10,0,20,10
1713335317323,ECE 100,A02,507418,Baghdadchi; Saharnaz,20,0,20,0
1713335318351,ECE 111,A01,507420,Staff,38,0,50,12
1713335319376,ECE 197,001,548057,Sievenpiper; Daniel F.,9998,0,9999,1
1713335320460,EDS 115,A00,507243,Choi; Bailey Miyeon,28,0,28,0
1713335321485,EDS 117,A01,494379,Staff,23,0,25,2
1713335322510,EDS 125,A00,507246,Hopkins; Megan Beth,29,0,30,1
1713335323540,EDS 128A,A01,507264,Fargason; Sharon Gayle,26,0,26,0
1713335324566,EDS 128B,A01,507293,Pappas; Elizabeth,30,0,30,0
1713335325595,EDS 139,A00,507294,Fargason; Sharon Gayle,30,0,30,0
1713335325595,EDS 139,B00,507313,Pappas; Elizabeth,30,0,30,0
1713335326618,EDS 201,A00,507315,Staff,26,0,30,4
1713335327671,EDS 203,A01,507317,Halter; Christopher P.,26,0,30,4
1713335328700,EDS 204R,A01,507319,Halter; Christopher P.,3,0,30,27
1713335328700,EDS 204R,B01,507331,Heinzman; Erica M.,28,0,30,2
1713335329733,EDS 206R,A00,507332,Staff,4,0,30,26
1713335329733,EDS 206R,B00,507343,Staff,28,0,30,2
1713335330759,EDS 250,A00,507344,Hemans; Patricia Ann Benitez,36,0,40,4
1713335331788,EDS 281,A00,507345,Daly; Alan J.,18,0,18,0
1713335332816,EDS 284,A00,507350,Daly; Alan J.,16,0,16,0
1713335333842,EDS 286,A00,507359,Fine; Sarah,18,0,18,0
1713335334867,EDS 289C,A01,507361,Daly; Alan J.,18,0,18,0
1713335335893,EDS 290,A00,507366,Hofstetter; Carolyn,15,0,15,0
1713335336926,LIGM 5A,A00,507421,Fischer-Grunski; Eva K,20,0,20,0
1713335337951,LIGM 5B,A00,507423,Fischer-Grunski; Eva K,20,0,20,0
1713335338977,LIGM 5C,A00,507425,Fischer-Grunski; Eva K,20,0,20,0
1713335340008,LIIT 5AS,A00,507427,Carnelos; Chiara,20,0,20,0
1713335341033,LIIT 5BS,A00,507430,Carnelos; Chiara,20,0,20,0
1713335342065,LIIT 5CS,A00,507432,Carnelos; Chiara,20,0,20,0
1713335343100,LISP 5A,A00,507541,Munoz Sanchez; Alicia,17,0,20,3
1713335344130,LISP 5B,A00,507671,Munoz Sanchez; Alicia,15,0,20,5
1713335345162,LISP 5C,A00,507696,Munoz Sanchez; Alicia,15,0,20,5
1713335346191,MAE 197,001,528363,Boechler; Nicholas Sebastia,9998,0,9999,1
1713335347218,MATH 197,001,523477,Kedlaya; Kiran S.,9999,0,9999,0
1713335347218,MATH 197,002,563811,Zhang; Danna,9999,0,9999,0
1713335348244,MCWP 40R,A00,518780,Staff,20,0,20,0
1713335348244,MCWP 40R,B00,518781,Staff,19,0,20,1
1713335348244,MCWP 40R,C00,518783,Staff,19,0,20,1
1713335349270,MCWP 50R,A00,518791,Staff,20,0,20,0
1713335349270,MCWP 50R,B00,518792,Staff,17,0,20,3
1713335349270,MCWP 50R,C00,518793,Staff,19,0,20,1
1713335349270,MCWP 50R,D00,518794,Staff,16,0,20,4
1713335349270,MCWP 50R,E00,518795,Staff,16,0,20,4
1713335349270,MCWP 50R,F00,518796,Staff,19,0,20,1
1713335349270,MCWP 50R,G00,518797,Staff,19,0,20,1
1713335350300,MMW 12R,A01,514034,Herbst; Matthew,15,0,16,1
1713335350300,MMW 12R,A02,514035,Herbst; Matthew,16,0,16,0
1713335351328,MMW 13R,A01,514037,Staff,12,0,16,4
1713335351328,MMW 13R,A02,514039,Staff,16,0,16,0
1713335353384,SIO 295LS,A00,523233,Staff,19,0,30,11
1713335354410,SIO 295S,A00,523232,Staff,19,0,30,11
1713335355440,SOCI 117,A01,494376,Staff,2,0,5,3
1713335356539,WES 237B,A00,494380,Staff,19,0,20,1
1713335358606,AESE 279B,A00,494370,Wade; Jon P,33,0,33,0
1713335359634,ANAR 135S,A00,494369,Braswell; Geoffrey E.,0,0,0,0
1713335360657,CAT 124RS,A01,519847,Geibel; William,17,0,20,3
1713335361684,CAT 125RS,A01,515971,Geibel; William,17,0,20,3
1713335362709,CLRE 250,A00,511389,Morris; Sheldon,9996,0,9999,3
1713335363736,CLRE 251,A00,507176,Mehta; Ravindra L.,9996,0,9999,3
1713335363736,CLRE 251,B00,511410,Mehta; Ravindra L.,9998,0,9999,1
1713335364762,CLRE 252,A00,507189,Cuomo; Raphael Eduardo,9998,0,9999,1
1713335365789,CLRE 253,A00,507199,Vaida; Florin,9997,0,9999,2
1713335365789,CLRE 253,B00,507202,Vaida; Florin,9999,0,9999,0
1713335366815,CLRE 259,A00,507211,Patel; Hemal,9996,0,9999,3
1713335367843,CLRE 260,A00,507221,Cuomo; Raphael Eduardo,9999,0,9999,0
1713335368867,CLRE 297,001,507242,Cuomo; Raphael Eduardo,9999,0,9999,0
1713335369894,CSE 191,A00,516875,Minnes Kemp; Mor Mia,9999,0,9999,0
1713335370919,CSS 201S,A01,494383,Staff,35,0,35,0
1713335371946,CSS 202S,A01,494387,Staff,35,0,35,0
1713335372972,EAP 100,A00,516065,Staff,9792,0,9999,207
1713335374003,ECE 45,A01,507414,Staff,51,0,60,9
1713335375033,ECE 100,A01,507416,Baghdadchi; Saharnaz,10,0,20,10
1713335375033,ECE 100,A02,507418,Baghdadchi; Saharnaz,20,0,20,0
1713335376057,ECE 111,A01,507420,Staff,38,0,50,12
1713335377084,ECE 197,001,548057,Sievenpiper; Daniel F.,9998,0,9999,1
1713335378111,EDS 115,A00,507243,Choi; Bailey Miyeon,28,0,28,0
1713335379139,EDS 117,A01,494379,Staff,23,0,25,2
1713335380177,EDS 125,A00,507246,Hopkins; Megan Beth,29,0,30,1
1713335381209,EDS 128A,A01,507264,Fargason; Sharon Gayle,26,0,26,0
1713335382235,EDS 128B,A01,507293,Pappas; Elizabeth,30,0,30,0
1713335383336,EDS 139,A00,507294,Fargason; Sharon Gayle,30,0,30,0
1713335383336,EDS 139,B00,507313,Pappas; Elizabeth,30,0,30,0
1713335384364,EDS 201,A00,507315,Staff,26,0,30,4
1713335385395,EDS 203,A01,507317,Halter; Christopher P.,26,0,30,4
1713335386421,EDS 204R,A01,507319,Halter; Christopher P.,3,0,30,27
1713335386421,EDS 204R,B01,507331,Heinzman; Erica M.,28,0,30,2
1713335387449,EDS 206R,A00,507332,Staff,4,0,30,26
1713335387449,EDS 206R,B00,507343,Staff,28,0,30,2
1713335388475,EDS 250,A00,507344,Hemans; Patricia Ann Benitez,36,0,40,4
1713335389501,EDS 281,A00,507345,Daly; Alan J.,18,0,18,0
1713335390531,EDS 284,A00,507350,Daly; Alan J.,16,0,16,0
1713335391560,EDS 286,A00,507359,Fine; Sarah,18,0,18,0
1713335392589,EDS 289C,A01,507361,Daly; Alan J.,18,0,18,0
1713335393619,EDS 290,A00,507366,Hofstetter; Carolyn,15,0,15,0
1713335394647,LIGM 5A,A00,507421,Fischer-Grunski; Eva K,20,0,20,0
1713335395672,LIGM 5B,A00,507423,Fischer-Grunski; Eva K,20,0,20,0
1713335396698,LIGM 5C,A00,507425,Fischer-Grunski; Eva K,20,0,20,0
1713335397728,LIIT 5AS,A00,507427,Carnelos; Chiara,20,0,20,0
1713335398754,LIIT 5BS,A00,507430,Carnelos; Chiara,20,0,20,0
1713335399779,LIIT 5CS,A00,507432,Carnelos; Chiara,20,0,20,0
1713335400804,LISP 5A,A00,507541,Munoz Sanchez; Alicia,17,0,20,3
1713335401831,LISP 5B,A00,507671,Munoz Sanchez; Alicia,15,0,20,5
1713335402857,LISP 5C,A00,507696,Munoz Sanchez; Alicia,15,0,20,5
1713335403886,MAE 197,001,528363,Boechler; Nicholas Sebastia,9998,0,9999,1
1713335404912,MATH 197,001,523477,Kedlaya; Kiran S.,9999,0,9999,0
1713335404912,MATH 197,002,563811,Zhang; Danna,9999,0,9999,0
1713335405941,MCWP 40R,A00,518780,Staff,20,0,20,0
1713335405941,MCWP 40R,B00,518781,Staff,19,0,20,1
1713335405941,MCWP 40R,C00,518783,Staff,19,0,20,1
1713335406968,MCWP 50R,A00,518791,Staff,20,0,20,0
1713335406968,MCWP 50R,B00,518792,Staff,17,0,20,3
1713335406968,MCWP 50R,C00,518793,Staff,19,0,20,1
1713335406968,MCWP 50R,D00,518794,Staff,16,0,20,4
1713335406968,MCWP 50R,E00,518795,Staff,16,0,20,4
1713335406968,MCWP 50R,F00,518796,Staff,19,0,20,1
1713335406968,MCWP 50R,G00,518797,Staff,19,0,20,1
1713335407992,MMW 12R,A01,514034,Herbst; Matthew,15,0,16,1
1713335407992,MMW 12R,A02,514035,Herbst; Matthew,16,0,16,0
1713335409018,MMW 13R,A01,514037,Staff,12,0,16,4
1713335409018,MMW 13R,A02,514039,Staff,16,0,16,0
1713335411070,SIO 295LS,A00,523233,Staff,19,0,30,11
1713335412099,SIO 295S,A00,523232,Staff,19,0,30,11
1713335413126,SOCI 117,A01,494376,Staff,2,0,5,3
1713335414151,WES 237B,A00,494380,Staff,19,0,20,1
1713335416230,AESE 279B,A00,494370,Wade; Jon P,33,0,33,0
1713335417259,ANAR 135S,A00,494369,Braswell; Geoffrey E.,0,0,0,0
1713335418284,CAT 124RS,A01,519847,Geibel; William,17,0,20,3
1713335419314,CAT 125RS,A01,515971,Geibel; William,17,0,20,3
1713335420340,CLRE 250,A00,511389,Morris; Sheldon,9996,0,9999,3
1713335421365,CLRE 251,A00,507176,Mehta; Ravindra L.,9996,0,9999,3
1713335421365,CLRE 251,B00,511410,Mehta; Ravindra L.,9998,0,9999,1
1713335422397,CLRE 252,A00,507189,Cuomo; Raphael Eduardo,9998,0,9999,1
1713335423424,CLRE 253,A00,507199,Vaida; Florin,9997,0,9999,2
1713335423424,CLRE 253,B00,507202,Vaida; Florin,9999,0,9999,0
1713335424507,CLRE 259,A00,507211,Patel; Hemal,9996,0,9999,3
1713335425531,CLRE 260,A00,507221,Cuomo; Raphael Eduardo,9999,0,9999,0
1713335426557,CLRE 297,001,507242,Cuomo; Raphael Eduardo,9999,0,9999,0
1713335427587,CSE 191,A00,516875,Minnes Kemp; Mor Mia,9999,0,9999,0
1713335428617,CSS 201S,A01,494383,Staff,35,0,35,0
1713335429647,CSS 202S,A01,494387,Staff,35,0,35,0
1713335430673,EAP 100,A00,516065,Staff,9792,0,9999,207
1713335431699,ECE 45,A01,507414,Staff,51,0,60,9
1713335432723,ECE 100,A01,507416,Baghdadchi; Saharnaz,10,0,20,10
1713335432723,ECE 100,A02,507418,Baghdadchi; Saharnaz,20,0,20,0
1713335433751,ECE 111,A01,507420,Staff,38,0,50,12
1713335434779,ECE 197,001,548057,Sievenpiper; Daniel F.,9998,0,9999,1
1713335435809,EDS 115,A00,507243,Choi; Bailey Miyeon,28,0,28,0
1713335436836,EDS 117,A01,494379,Staff,23,0,25,2
1713335437866,EDS 125,A00,507246,Hopkins; Megan Beth,29,0,30,1
1713335438893,EDS 128A,A01,507264,Fargason; Sharon Gayle,26,0,26,0
1713335439918,EDS 128B,A01,507293,Pappas; Elizabeth,30,0,30,0
1713335440943,EDS 139,A00,507294,Fargason; Sharon Gayle,30,0,30,0
1713335440943,EDS 139,B00,507313,Pappas; Elizabeth,30,0,30,0
1713335441967,EDS 201,A00,507315,Staff,26,0,30,4
1713335442994,EDS 203,A01,507317,Halter; Christopher P.,26,0,30,4
1713335444022,EDS 204R,A01,507319,Halter; Christopher P.,3,0,30,27
1713335444022,EDS 204R,B01,507331,Heinzman; Erica M.,28,0,30,2
1713335445049,EDS 206R,A00,507332,Staff,4,0,30,26
1713335445049,EDS 206R,B00,507343,Staff,28,0,30,2
1713335446076,EDS 250,A00,507344,Hemans; Patricia Ann Benitez,36,0,40,4
1713335447107,EDS 281,A00,507345,Daly; Alan J.,18,0,18,0
1713335448131,EDS 284,A00,507350,Daly; Alan J.,16,0,16,0
1713335449161,EDS 286,A00,507359,Fine; Sarah,18,0,18,0
1713335450187,EDS 289C,A01,507361,Daly; Alan J.,18,0,18,0
1713335451213,EDS 290,A00,507366,Hofstetter; Carolyn,15,0,15,0
1713335452239,LIGM 5A,A00,507421,Fischer-Grunski; Eva K,20,0,20,0
1713335453265,LIGM 5B,A00,507423,Fischer-Grunski; Eva K,20,0,20,0
1713335454294,LIGM 5C,A00,507425,Fischer-Grunski; Eva K,20,0,20,0
1713335455326,LIIT 5AS,A00,507427,Carnelos; Chiara,20,0,20,0
1713335456355,LIIT 5BS,A00,507430,Carnelos; Chiara,20,0,20,0
1713335457384,LIIT 5CS,A00,507432,Carnelos; Chiara,20,0,20,0
1713335458416,LISP 5A,A00,507541,Munoz Sanchez; Alicia,17,0,20,3
1713335459440,LISP 5B,A00,507671,Munoz Sanchez; Alicia,15,0,20,5
1713335460485,LISP 5C,A00,507696,Munoz Sanchez; Alicia,15,0,20,5
1713335461510,MAE 197,001,528363,Boechler; Nicholas Sebastia,9998,0,9999,1
1713335462543,MATH 197,001,523477,Kedlaya; Kiran S.,9999,0,9999,0
1713335462543,MATH 197,002,563811,Zhang; Danna,9999,0,9999,0
1713335463568,MCWP 40R,A00,518780,Staff,20,0,20,0
1713335463568,MCWP 40R,B00,518781,Staff,19,0,20,1
1713335463568,MCWP 40R,C00,518783,Staff,19,0,20,1
1713335464607,MCWP 50R,A00,518791,Staff,20,0,20,0
1713335464607,MCWP 50R,B00,518792,Staff,17,0,20,3
1713335464607,MCWP 50R,C00,518793,Staff,19,0,20,1
1713335464607,MCWP 50R,D00,518794,Staff,16,0,20,4
1713335464607,MCWP 50R,E00,518795,Staff,16,0,20,4
1713335464607,MCWP 50R,F00,518796,Staff,19,0,20,1
1713335464607,MCWP 50R,G00,518797,Staff,19,0,20,1
1713335465634,MMW 12R,A01,514034,Herbst; Matthew,15,0,16,1
1713335465634,MMW 12R,A02,514035,Herbst; Matthew,16,0,16,0
1713335466656,MMW 13R,A01,514037,Staff,12,0,16,4
1713335466656,MMW 13R,A02,514039,Staff,16,0,16,0
1713335468711,SIO 295LS,A00,523233,Staff,19,0,30,11
1713335469737,SIO 295S,A00,523232,Staff,19,0,30,11
1713335470782,SOCI 117,A01,494376,Staff,2,0,5,3
1713335471807,WES 237B,A00,494380,Staff,19,0,20,1
1713335473873,AESE 279B,A00,494370,Wade; Jon P,33,0,33,0
1713335474901,ANAR 135S,A00,494369,Braswell; Geoffrey E.,0,0,0,0
1713335475929,CAT 124RS,A01,519847,Geibel; William,17,0,20,3
1713335476953,CAT 125RS,A01,515971,Geibel; William,17,0,20,3
1713335477979,CLRE 250,A00,511389,Morris; Sheldon,9996,0,9999,3
1713335479006,CLRE 251,A00,507176,Mehta; Ravindra L.,9996,0,9999,3
1713335479006,CLRE 251,B00,511410,Mehta; Ravindra L.,9998,0,9999,1
1713335480033,CLRE 252,A00,507189,Cuomo; Raphael Eduardo,9998,0,9999,1
1713335481064,CLRE 253,A00,507199,Vaida; Florin,9997,0,9999,2
1713335481064,CLRE 253,B00,507202,Vaida; Florin,9999,0,9999,0
1713335482091,CLRE 259,A00,507211,Patel; Hemal,9996,0,9999,3
1713335483115,CLRE 260,A00,507221,Cuomo; Raphael Eduardo,9999,0,9999,0
1713335484139,CLRE 297,001,507242,Cuomo; Raphael Eduardo,9999,0,9999,0
1713335485163,CSE 191,A00,516875,Minnes Kemp; Mor Mia,9999,0,9999,0
1713335486193,CSS 201S,A01,494383,Staff,35,0,35,0
1713335487221,CSS 202S,A01,494387,Staff,35,0,35,0
1713335488248,EAP 100,A00,516065,Staff,9792,0,9999,207
1713335489274,ECE 45,A01,507414,Staff,51,0,60,9
1713335490300,ECE 100,A01,507416,Baghdadchi; Saharnaz,10,0,20,10
1713335490300,ECE 100,A02,507418,Baghdadchi; Saharnaz,20,0,20,0
1713335491326,ECE 111,A01,507420,Staff,38,0,50,12
1713335492351,ECE 197,001,548057,Sievenpiper; Daniel F.,9998,0,9999,1
1713335493375,EDS 115,A00,507243,Choi; Bailey Miyeon,28,0,28,0
1713335494402,EDS 117,A01,494379,Staff,23,0,25,2
1713335495427,EDS 125,A00,507246,Hopkins; Megan Beth,29,0,30,1
1713335496455,EDS 128A,A01,507264,Fargason; Sharon Gayle,26,0,26,0
1713335497481,EDS 128B,A01,507293,Pappas; Elizabeth,30,0,30,0
1713335498508,EDS 139,A00,507294,Fargason; Sharon Gayle,30,0,30,0
1713335498508,EDS 139,B00,507313,Pappas; Elizabeth,30,0,30,0
1713335499533,EDS 201,A00,507315,Staff,26,0,30,4
1713335500579,EDS 203,A01,507317,Halter; Christopher P.,26,0,30,4
1713335501605,EDS 204R,A01,507319,Halter; Christopher P.,3,0,30,27
1713335501605,EDS 204R,B01,507331,Heinzman; Erica M.,28,0,30,2
1713335502638,EDS 206R,A00,507332,Staff,4,0,30,26
1713335502638,EDS 206R,B00,507343,Staff,28,0,30,2
1713335503663,EDS 250,A00,507344,Hemans; Patricia Ann Benitez,36,0,40,4
1713335504693,EDS 281,A00,507345,Daly; Alan J.,18,0,18,0
1713335505719,EDS 284,A00,507350,Daly; Alan J.,16,0,16,0
1713335506745,EDS 286,A00,507359,Fine; Sarah,18,0,18,0
1713335507772,EDS 289C,A01,507361,Daly; Alan J.,18,0,18,0
1713335508798,EDS 290,A00,507366,Hofstetter; Carolyn,15,0,15,0
1713335509823,LIGM 5A,A00,507421,Fischer-Grunski; Eva K,20,0,20,0
1713335510849,LIGM 5B,A00,507423,Fischer-Grunski; Eva K,20,0,20,0
1713335511873,LIGM 5C,A00,507425,Fischer-Grunski; Eva K,20,0,20,0
1713335512898,LIIT 5AS,A00,507427,Carnelos; Chiara,20,0,20,0
1713335513923,LIIT 5BS,A00,507430,Carnelos; Chiara,20,0,20,0
1713335514948,LIIT 5CS,A00,507432,Carnelos; Chiara,20,0,20,0
1713335515973,LISP 5A,A00,507541,Munoz Sanchez; Alicia,17,0,20,3
1713335516998,LISP 5B,A00,507671,Munoz Sanchez; Alicia,15,0,20,5
1713335518029,LISP 5C,A00,507696,Munoz Sanchez; Alicia,15,0,20,5
1713335519058,MAE 197,001,528363,Boechler; Nicholas Sebastia,9998,0,9999,1
1713335520089,MATH 197,001,523477,Kedlaya; Kiran S.,9999,0,9999,0
1713335520089,MATH 197,002,563811,Zhang; Danna,9999,0,9999,0
1713335521118,MCWP 40R,A00,518780,Staff,20,0,20,0
1713335521118,MCWP 40R,B00,518781,Staff,19,0,20,1
1713335521118,MCWP 40R,C00,518783,Staff,19,0,20,1
1713335522142,MCWP 50R,A00,518791,Staff,20,0,20,0
1713335522142,MCWP 50R,B00,518792,Staff,17,0,20,3
1713335522142,MCWP 50R,C00,518793,Staff,19,0,20,1
1713335522142,MCWP 50R,D00,518794,Staff,16,0,20,4
1713335522142,MCWP 50R,E00,518795,Staff,16,0,20,4
1713335522142,MCWP 50R,F00,518796,Staff,19,0,20,1
1713335522142,MCWP 50R,G00,518797,Staff,19,0,20,1
1713335523168,MMW 12R,A01,514034,Herbst; Matthew,15,0,16,1
1713335523168,MMW 12R,A02,514035,Herbst; Matthew,16,0,16,0
1713335524194,MMW 13R,A01,514037,Staff,12,0,16,4
1713335524194,MMW 13R,A02,514039,Staff,16,0,16,0
1713335526242,SIO 295LS,A00,523233,Staff,19,0,30,11
1713335527269,SIO 295S,A00,523232,Staff,19,0,30,11
1713335528352,SOCI 117,A01,494376,Staff,2,0,5,3
1713335529377,WES 237B,A00,494380,Staff,19,0,20,1
1713335531440,AESE 279B,A00,494370,Wade; Jon P,33,0,33,0
1713335532466,ANAR 135S,A00,494369,Braswell; Geoffrey E.,0,0,0,0
1713335533490,CAT 124RS,A01,519847,Geibel; William,17,0,20,3
1713335534518,CAT 125RS,A01,515971,Geibel; William,17,0,20,3
1713335535543,CLRE 250,A00,511389,Morris; Sheldon,9996,0,9999,3
1713335536574,CLRE 251,A00,507176,Mehta; Ravindra L.,9996,0,9999,3
1713335536574,CLRE 251,B00,511410,Mehta; Ravindra L.,9998,0,9999,1
1713335537600,CLRE 252,A00,507189,Cuomo; Raphael Eduardo,9998,0,9999,1
1713335538626,CLRE 253,A00,507199,Vaida; Florin,9997,0,9999,2
1713335538626,CLRE 253,B00,507202,Vaida; Florin,9999,0,9999,0
1713335539652,CLRE 259,A00,507211,Patel; Hemal,9996,0,9999,3
1713335540679,CLRE 260,A00,507221,Cuomo; Raphael Eduardo,9999,0,9999,0
1713335541706,CLRE 297,001,507242,Cuomo; Raphael Eduardo,9999,0,9999,0
1713335542732,CSE 191,A00,516875,Minnes Kemp; Mor Mia,9999,0,9999,0
1713335543758,CSS 201S,A01,494383,Staff,35,0,35,0
1713335544788,CSS 202S,A01,494387,Staff,35,0,35,0
1713335545815,EAP 100,A00,516065,Staff,9792,0,9999,207
1713335546860,ECE 45,A01,507414,Staff,51,0,60,9
1713335547890,ECE 100,A01,507416,Baghdadchi; Saharnaz,10,0,20,10
1713335547890,ECE 100,A02,507418,Baghdadchi; Saharnaz,20,0,20,0
1713335548918,ECE 111,A01,507420,Staff,38,0,50,12
1713335549943,ECE 197,001,548057,Sievenpiper; Daniel F.,9998,0,9999,1
1713335550970,EDS 115,A00,507243,Choi; Bailey Miyeon,28,0,28,0
1713335551998,EDS 117,A01,494379,Staff,23,0,25,2
1713335553025,EDS 125,A00,507246,Hopkins; Megan Beth,29,0,30,1
1713335554050,EDS 128A,A01,507264,Fargason; Sharon Gayle,26,0,26,0
1713335555080,EDS 128B,A01,507293,Pappas; Elizabeth,30,0,30,0
1713335556106,EDS 139,A00,507294,Fargason; Sharon Gayle,30,0,30,0
1713335556106,EDS 139,B00,507313,Pappas; Elizabeth,30,0,30,0
1713335557132,EDS 201,A00,507315,Staff,26,0,30,4
1713335558158,EDS 203,A01,507317,Halter; Christopher P.,26,0,30,4
1713335559183,EDS 204R,A01,507319,Halter; Christopher P.,3,0,30,27
1713335559183,EDS 204R,B01,507331,Heinzman; Erica M.,28,0,30,2
1713335560207,EDS 206R,A00,507332,Staff,4,0,30,26
1713335560207,EDS 206R,B00,507343,Staff,28,0,30,2
1713335561232,EDS 250,A00,507344,Hemans; Patricia Ann Benitez,36,0,40,4
1713335562257,EDS 281,A00,507345,Daly; Alan J.,18,0,18,0
1713335563282,EDS 284,A00,507350,Daly; Alan J.,16,0,16,0
1713335564308,EDS 286,A00,507359,Fine; Sarah,18,0,18,0
1713335565334,EDS 289C,A01,507361,Daly; Alan J.,18,0,18,0
1713335566360,EDS 290,A00,507366,Hofstetter; Carolyn,15,0,15,0
1713335567385,LIGM 5A,A00,507421,Fischer-Grunski; Eva K,20,0,20,0
1713335568416,LIGM 5B,A00,507423,Fischer-Grunski; Eva K,20,0,20,0
1713335569442,LIGM 5C,A00,507425,Fischer-Grunski; Eva K,20,0,20,0
1713335570467,LIIT 5AS,A00,507427,Carnelos; Chiara,20,0,20,0
1713335571493,LIIT 5BS,A00,507430,Carnelos; Chiara,20,0,20,0
1713335572516,LIIT 5CS,A00,507432,Carnelos; Chiara,20,0,20,0
1713335573549,LISP 5A,A00,507541,Munoz Sanchez; Alicia,17,0,20,3
1713335574575,LISP 5B,A00,507671,Munoz Sanchez; Alicia,15,0,20,5
1713335575599,LISP 5C,A00,507696,Munoz Sanchez; Alicia,15,0,20,5
1713335576626,MAE 197,001,528363,Boechler; Nicholas Sebastia,9998,0,9999,1
1713335577652,MATH 197,001,523477,Kedlaya; Kiran S.,9999,0,9999,0
1713335577652,MATH 197,002,563811,Zhang; Danna,9999,0,9999,0
1713335578682,MCWP 40R,A00,518780,Staff,20,0,20,0
1713335578682,MCWP 40R,B00,518781,Staff,19,0,20,1
1713335578682,MCWP 40R,C00,518783,Staff,19,0,20,1
1713335579708,MCWP 50R,A00,518791,Staff,20,0,20,0
1713335579708,MCWP 50R,B00,518792,Staff,17,0,20,3
1713335579708,MCWP 50R,C00,518793,Staff,19,0,20,1
1713335579708,MCWP 50R,D00,518794,Staff,16,0,20,4
1713335579708,MCWP 50R,E00,518795,Staff,16,0,20,4
1713335579708,MCWP 50R,F00,518796,Staff,19,0,20,1
1713335579708,MCWP 50R,G00,518797,Staff,19,0,20,1
1713335580732,MMW 12R,A01,514034,Herbst; Matthew,15,0,16,1
1713335580732,MMW 12R,A02,514035,Herbst; Matthew,16,0,16,0
1713335581758,MMW 13R,A01,514037,Staff,12,0,16,4
1713335581758,MMW 13R,A02,514039,Staff,16,0,16,0
1713335583811,SIO 295LS,A00,523233,Staff,19,0,30,11
1713335584836,SIO 295S,A00,523232,Staff,19,0,30,11
1713335585866,SOCI 117,A01,494376,Staff,2,0,5,3
1713335586891,WES 237B,A00,494380,Staff,19,0,20,1
1713335588970,AESE 279B,A00,494370,Wade; Jon P,33,0,33,0
1713335589996,ANAR 135S,A00,494369,Braswell; Geoffrey E.,0,0,0,0
1713335591022,CAT 124RS,A01,519847,Geibel; William,17,0,20,3
1713335592054,CAT 125RS,A01,515971,Geibel; William,17,0,20,3
1713335593080,CLRE 250,A00,511389,Morris; Sheldon,9996,0,9999,3
1713335594113,CLRE 251,A00,507176,Mehta; Ravindra L.,9996,0,9999,3
1713335594113,CLRE 251,B00,511410,Mehta; Ravindra L.,9998,0,9999,1
1713335595144,CLRE 252,A00,507189,Cuomo; Raphael Eduardo,9998,0,9999,1
1713335596173,CLRE 253,A00,507199,Vaida; Florin,9997,0,9999,2
1713335596173,CLRE 253,B00,507202,Vaida; Florin,9999,0,9999,0
1713335597200,CLRE 259,A00,507211,Patel; Hemal,9996,0,9999,3
1713335598231,CLRE 260,A00,507221,Cuomo; Raphael Eduardo,9999,0,9999,0
1713335599256,CLRE 297,001,507242,Cuomo; Raphael Eduardo,9999,0,9999,0
1713335600282,CSE 191,A00,516875,Minnes Kemp; Mor Mia,9999,0,9999,0
1713335601307,CSS 201S,A01,494383,Staff,35,0,35,0
1713335602331,CSS 202S,A01,494387,Staff,35,0,35,0
1713335603356,EAP 100,A00,516065,Staff,9792,0,9999,207
1713335604381,ECE 45,A01,507414,Staff,51,0,60,9
1713335605418,ECE 100,A01,507416,Baghdadchi; Saharnaz,10,0,20,10
1713335605418,ECE 100,A02,507418,Baghdadchi; Saharnaz,20,0,20,0
1713335606445,ECE 111,A01,507420,Staff,38,0,50,12
1713335607469,ECE 197,001,548057,Sievenpiper; Daniel F.,9998,0,9999,1
1713335608548,EDS 115,A00,507243,Choi; Bailey Miyeon,28,0,28,0
1713335609577,EDS 117,A01,494379,Staff,23,0,25,2
1713335610602,EDS 125,A00,507246,Hopkins; Megan Beth,29,0,30,1
1713335611632,EDS 128A,A01,507264,Fargason; Sharon Gayle,26,0,26,0
1713335612657,EDS 128B,A01,507293,Pappas; Elizabeth,30,0,30,0
1713335613686,EDS 139,A00,507294,Fargason; Sharon Gayle,30,0,30,0
1713335613686,EDS 139,B00,507313,Pappas; Elizabeth,30,0,30,0
1713335614713,EDS 201,A00,507315,Staff,26,0,30,4
1713335615736,EDS 203,A01,507317,Halter; Christopher P.,26,0,30,4
1713335616771,EDS 204R,A01,507319,Halter; Christopher P.,3,0,30,27
1713335616771,EDS 204R,B01,507331,Heinzman; Erica M.,28,0,30,2
1713335617796,EDS 206R,A00,507332,Staff,4,0,30,26
1713335617796,EDS 206R,B00,507343,Staff,28,0,30,2
1713335618822,EDS 250,A00,507344,Hemans; Patricia Ann Benitez,36,0,40,4
1713335619848,EDS 281,A00,507345,Daly; Alan J.,18,0,18,0
1713335620872,EDS 284,A00,507350,Daly; Alan J.,16,0,16,0
1713335621900,EDS 286,A00,507359,Fine; Sarah,18,0,18,0
1713335622926,EDS 289C,A01,507361,Daly; Alan J.,18,0,18,0
1713335623955,EDS 290,A00,507366,Hofstetter; Carolyn,15,0,15,0
1713335624984,LIGM 5A,A00,507421,Fischer-Grunski; Eva K,20,0,20,0
1713335626014,LIGM 5B,A00,507423,Fischer-Grunski; Eva K,20,0,20,0
1713335627041,LIGM 5C,A00,507425,Fischer-Grunski; Eva K,20,0,20,0
1713335628071,LIIT 5AS,A00,507427,Carnelos; Chiara,20,0,20,0
1713335629098,LIIT 5BS,A00,507430,Carnelos; Chiara,20,0,20,0
1713335630123,LIIT 5CS,A00,507432,Carnelos; Chiara,20,0,20,0
1713335631152,LISP 5A,A00,507541,Munoz Sanchez; Alicia,17,0,20,3
1713335632231,LISP 5B,A00,507671,Munoz Sanchez; Alicia,15,0,20,5
1713335633257,LISP 5C,A00,507696,Munoz Sanchez; Alicia,15,0,20,5
1713335634281,MAE 197,001,528363,Boechler; Nicholas Sebastia,9998,0,9999,1
1713335635307,MATH 197,001,523477,Kedlaya; Kiran S.,9999,0,9999,0
1713335635307,MATH 197,002,563811,Zhang; Danna,9999,0,9999,0
1713335636334,MCWP 40R,A00,518780,Staff,20,0,20,0
1713335636334,MCWP 40R,B00,518781,Staff,19,0,20,1
1713335636334,MCWP 40R,C00,518783,Staff,19,0,20,1
1713335637359,MCWP 50R,A00,518791,Staff,20,0,20,0
1713335637359,MCWP 50R,B00,518792,Staff,17,0,20,3
1713335637359,MCWP 50R,C00,518793,Staff,19,0,20,1
1713335637359,MCWP 50R,D00,518794,Staff,16,0,20,4
1713335637359,MCWP 50R,E00,518795,Staff,16,0,20,4
1713335637359,MCWP 50R,F00,518796,Staff,19,0,20,1
1713335637359,MCWP 50R,G00,518797,Staff,19,0,20,1
1713335638386,MMW 12R,A01,514034,Herbst; Matthew,15,0,16,1
1713335638386,MMW 12R,A02,514035,Herbst; Matthew,16,0,16,0
1713335639415,MMW 13R,A01,514037,Staff,12,0,16,4
1713335639415,MMW 13R,A02,514039,Staff,16,0,16,0
1713335641464,SIO 295LS,A00,523233,Staff,19,0,30,11
1713335642489,SIO 295S,A00,523232,Staff,19,0,30,11
1713335643513,SOCI 117,A01,494376,Staff,2,0,5,3
1713335644539,WES 237B,A00,494380,Staff,19,0,20,1
1713335646620,AESE 279B,A00,494370,Wade; Jon P,33,0,33,0
1713335647651,ANAR 135S,A00,494369,Braswell; Geoffrey E.,0,0,0,0
1713335648682,CAT 124RS,A01,519847,Geibel; William,17,0,20,3
1713335649709,CAT 125RS,A01,515971,Geibel; William,17,0,20,3
1713335650739,CLRE 250,A00,511389,Morris; Sheldon,9996,0,9999,3
1713335651765,CLRE 251,A00,507176,Mehta; Ravindra L.,9996,0,9999,3
1713335651765,CLRE 251,B00,511410,Mehta; Ravindra L.,9998,0,9999,1
1713335652793,CLRE 252,A00,507189,Cuomo; Raphael Eduardo,9998,0,9999,1
1713335653818,CLRE 253,A00,507199,Vaida; Florin,9997,0,9999,2
1713335653818,CLRE 253,B00,507202,Vaida; Florin,9999,0,9999,0
1713335654847,CLRE 259,A00,507211,Patel; Hemal,9996,0,9999,3
1713335655875,CLRE 260,A00,507221,Cuomo; Raphael Eduardo,9999,0,9999,0
1713335656901,CLRE 297,001,507242,Cuomo; Raphael Eduardo,9999,0,9999,0
1713335657927,CSE 191,A00,516875,Minnes Kemp; Mor Mia,9999,0,9999,0
1713335658952,CSS 201S,A01,494383,Staff,35,0,35,0
1713335659977,CSS 202S,A01,494387,Staff,35,0,35,0
1713335661007,EAP 100,A00,516065,Staff,9792,0,9999,207
1713335662034,ECE 45,A01,507414,Staff,51,0,60,9
1713335663060,ECE 100,A01,507416,Baghdadchi; Saharnaz,10,0,20,10
1713335663060,ECE 100,A02,507418,Baghdadchi; Saharnaz,20,0,20,0
1713335664086,ECE 111,A01,507420,Staff,38,0,50,12
1713335665111,ECE 197,001,548057,Sievenpiper; Daniel F.,9998,0,9999,1
1713335666143,EDS 115,A00,507243,Choi; Bailey Miyeon,28,0,28,0
1713335667169,EDS 117,A01,494379,Staff,23,0,25,2
1713335668198,EDS 125,A00,507246,Hopkins; Megan Beth,29,0,30,1
1713335669226,EDS 128A,A01,507264,Fargason; Sharon Gayle,26,0,26,0
1713335670250,EDS 128B,A01,507293,Pappas; Elizabeth,30,0,30,0
1713335671276,EDS 139,A00,507294,Fargason; Sharon Gayle,30,0,30,0
1713335671276,EDS 139,B00,507313,Pappas; Elizabeth,30,0,30,0
1713335672302,EDS 201,A00,507315,Staff,26,0,30,4
1713335673327,EDS 203,A01,507317,Halter; Christopher P.,26,0,30,4
1713335674352,EDS 204R,A01,507319,Halter; Christopher P.,3,0,30,27
1713335674352,EDS 204R,B01,507331,Heinzman; Erica M.,28,0,30,2
1713335675378,EDS 206R,A00,507332,Staff,4,0,30,26
1713335675378,EDS 206R,B00,507343,Staff,28,0,30,2
1713335676407,EDS 250,A00,507344,Hemans; Patricia Ann Benitez,36,0,40,4
1713335677436,EDS 281,A00,507345,Daly; Alan J.,18,0,18,0
1713335678460,EDS 284,A00,507350,Daly; Alan J.,16,0,16,0
1713335679486,EDS 286,A00,507359,Fine; Sarah,18,0,18,0
1713335680514,EDS 289C,A01,507361,Daly; Alan J.,18,0,18,0
1713335681538,EDS 290,A00,507366,Hofstetter; Carolyn,15,0,15,0
1713335682568,LIGM 5A,A00,507421,Fischer-Grunski; Eva K,20,0,20,0
1713335683597,LIGM 5B,A00,507423,Fischer-Grunski; Eva K,20,0,20,0
1713335684622,LIGM 5C,A00,507425,Fischer-Grunski; Eva K,20,0,20,0
1713335685652,LIIT 5AS,A00,507427,Carnelos; Chiara,20,0,20,0
1713335686683,LIIT 5BS,A00,507430,Carnelos; Chiara,20,0,20,0
1713335687713,LIIT 5CS,A00,507432,Carnelos; Chiara,20,0,20,0
1713335688741,LISP 5A,A00,507541,Munoz Sanchez; Alicia,17,0,20,3
1713335689765,LISP 5B,A00,507671,Munoz Sanchez; Alicia,15,0,20,5
1713335690791,LISP 5C,A00,507696,Munoz Sanchez; Alicia,15,0,20,5
1713335691820,MAE 197,001,528363,Boechler; Nicholas Sebastia,9998,0,9999,1
1713335692847,MATH 197,001,523477,Kedlaya; Kiran S.,9999,0,9999,0
1713335692847,MATH 197,002,563811,Zhang; Danna,9999,0,9999,0
1713335693875,MCWP 40R,A00,518780,Staff,20,0,20,0
1713335693875,MCWP 40R,B00,518781,Staff,19,0,20,1
1713335693875,MCWP 40R,C00,518783,Staff,19,0,20,1
1713335694901,MCWP 50R,A00,518791,Staff,20,0,20,0
1713335694901,MCWP 50R,B00,518792,Staff,17,0,20,3
1713335694901,MCWP 50R,C00,518793,Staff,19,0,20,1
1713335694901,MCWP 50R,D00,518794,Staff,16,0,20,4
1713335694901,MCWP 50R,E00,518795,Staff,16,0,20,4
1713335694901,MCWP 50R,F00,518796,Staff,19,0,20,1
1713335694901,MCWP 50R,G00,518797,Staff,19,0,20,1
1713335695934,MMW 12R,A01,514034,Herbst; Matthew,15,0,16,1
1713335695934,MMW 12R,A02,514035,Herbst; Matthew,16,0,16,0
1713335696965,MMW 13R,A01,514037,Staff,12,0,16,4
1713335696965,MMW 13R,A02,514039,Staff,16,0,16,0
1713335699021,SIO 295LS,A00,523233,Staff,19,0,30,11
1713335700046,SIO 295S,A00,523232,Staff,19,0,30,11
1713335701071,SOCI 117,A01,494376,Staff,2,0,5,3
1713335702100,WES 237B,A00,494380,Staff,19,0,20,1
1713335704192,AESE 279B,A00,494370,Wade; Jon P,33,0,33,0
1713335705221,ANAR 135S,A00,494369,Braswell; Geoffrey E.,0,0,0,0
1713335706253,CAT 124RS,A01,519847,Geibel; William,17,0,20,3
1713335707279,CAT 125RS,A01,515971,Geibel; William,17,0,20,3
1713335708307,CLRE 250,A00,511389,Morris; Sheldon,9996,0,9999,3
1713335709333,CLRE 251,A00,507176,Mehta; Ravindra L.,9996,0,9999,3
1713335709333,CLRE 251,B00,511410,Mehta; Ravindra L.,9998,0,9999,1
1713335710363,CLRE 252,A00,507189,Cuomo; Raphael Eduardo,9998,0,9999,1
1713335711391,CLRE 253,A00,507199,Vaida; Florin,9997,0,9999,2
1713335711391,CLRE 253,B00,507202,Vaida; Florin,9999,0,9999,0
1713335712423,CLRE 259,A00,507211,Patel; Hemal,9996,0,9999,3
1713335713453,CLRE 260,A00,507221,Cuomo; Raphael Eduardo,9999,0,9999,0
1713335714478,CLRE 297,001,507242,Cuomo; Raphael Eduardo,9999,0,9999,0
1713335715503,CSE 191,A00,516875,Minnes Kemp; Mor Mia,9999,0,9999,0
1713335716528,CSS 201S,A01,494383,Staff,35,0,35,0
1713335717554,CSS 202S,A01,494387,Staff,35,0,35,0
1713335718582,EAP 100,A00,516065,Staff,9792,0,9999,207
1713335719607,ECE 45,A01,507414,Staff,51,0,60,9
1713335720637,ECE 100,A01,507416,Baghdadchi; Saharnaz,10,0,20,10
1713335720637,ECE 100,A02,507418,Baghdadchi; Saharnaz,20,0,20,0
1713335721665,ECE 111,A01,507420,Staff,38,0,50,12
1713335722694,ECE 197,001,548057,Sievenpiper; Daniel F.,9998,0,9999,1
1713335723724,EDS 115,A00,507243,Choi; Bailey Miyeon,28,0,28,0
1713335724754,EDS 117,A01,494379,Staff,23,0,25,2
1713335725783,EDS 125,A00,507246,Hopkins; Megan Beth,29,0,30,1
1713335726814,EDS 128A,A01,507264,Fargason; Sharon Gayle,26,0,26,0
1713335727839,EDS 128B,A01,507293,Pappas; Elizabeth,30,0,30,0
1713335728867,EDS 139,A00,507294,Fargason; Sharon Gayle,30,0,30,0
1713335728867,EDS 139,B00,507313,Pappas; Elizabeth,30,0,30,0
1713335729895,EDS 201,A00,507315,Staff,26,0,30,4
1713335730925,EDS 203,A01,507317,Halter; Christopher P.,26,0,30,4
1713335731956,EDS 204R,A01,507319,Halter; Christopher P.,3,0,30,27
1713335731956,EDS 204R,B01,507331,Heinzman; Erica M.,28,0,30,2
1713335732981,EDS 206R,A00,507332,Staff,4,0,30,26
1713335732981,EDS 206R,B00,507343,Staff,28,0,30,2
1713335734006,EDS 250,A00,507344,Hemans; Patricia Ann Benitez,36,0,40,4
1713335735032,EDS 281,A00,507345,Daly; Alan J.,18,0,18,0
1713335736116,EDS 284,A00,507350,Daly; Alan J.,16,0,16,0
1713335737142,EDS 286,A00,507359,Fine; Sarah,18,0,18,0
1713335738167,EDS 289C,A01,507361,Daly; Alan J.,18,0,18,0
1713335739193,EDS 290,A00,507366,Hofstetter; Carolyn,15,0,15,0
1713335740221,LIGM 5A,A00,507421,Fischer-Grunski; Eva K,20,0,20,0
1713335741247,LIGM 5B,A00,507423,Fischer-Grunski; Eva K,20,0,20,0
1713335742274,LIGM 5C,A00,507425,Fischer-Grunski; Eva K,20,0,20,0
1713335743307,LIIT 5AS,A00,507427,Carnelos; Chiara,20,0,20,0
1713335744338,LIIT 5BS,A00,507430,Carnelos; Chiara,20,0,20,0
1713335745362,LIIT 5CS,A00,507432,Carnelos; Chiara,20,0,20,0
1713335746392,LISP 5A,A00,507541,Munoz Sanchez; Alicia,17,0,20,3
1713335747418,LISP 5B,A00,507671,Munoz Sanchez; Alicia,15,0,20,5
1713335748442,LISP 5C,A00,507696,Munoz Sanchez; Alicia,15,0,20,5
1713335749471,MAE 197,001,528363,Boechler; Nicholas Sebastia,9998,0,9999,1
1713335750498,MATH 197,001,523477,Kedlaya; Kiran S.,9999,0,9999,0
1713335750498,MATH 197,002,563811,Zhang; Danna,9999,0,9999,0
1713335751524,MCWP 40R,A00,518780,Staff,20,0,20,0
1713335751524,MCWP 40R,B00,518781,Staff,19,0,20,1
1713335751524,MCWP 40R,C00,518783,Staff,19,0,20,1
1713335752554,MCWP 50R,A00,518791,Staff,20,0,20,0
1713335752554,MCWP 50R,B00,518792,Staff,17,0,20,3
1713335752554,MCWP 50R,C00,518793,Staff,19,0,20,1
1713335752554,MCWP 50R,D00,518794,Staff,16,0,20,4
1713335752554,MCWP 50R,E00,518795,Staff,16,0,20,4
1713335752554,MCWP 50R,F00,518796,Staff,19,0,20,1
1713335752554,MCWP 50R,G00,518797,Staff,19,0,20,1
1713335753579,MMW 12R,A01,514034,Herbst; Matthew,15,0,16,1
1713335753579,MMW 12R,A02,514035,Herbst; Matthew,16,0,16,0
1713335754604,MMW 13R,A01,514037,Staff,12,0,16,4
1713335754604,MMW 13R,A02,514039,Staff,16,0,16,0
1713335756658,SIO 295LS,A00,523233,Staff,19,0,30,11
1713335757776,SIO 295S,A00,523232,Staff,19,0,30,11
1713335758801,SOCI 117,A01,494376,Staff,2,0,5,3
1713335759829,WES 237B,A00,494380,Staff,19,0,20,1
1713335761901,AESE 279B,A00,494370,Wade; Jon P,33,0,33,0
1713335762932,ANAR 135S,A00,494369,Braswell; Geoffrey E.,0,0,0,0
1713335763957,CAT 124RS,A01,519847,Geibel; William,17,0,20,3
1713335764987,CAT 125RS,A01,515971,Geibel; William,17,0,20,3
1713335766010,CLRE 250,A00,511389,Morris; Sheldon,9996,0,9999,3
1713335767037,CLRE 251,A00,507176,Mehta; Ravindra L.,9996,0,9999,3
1713335767037,CLRE 251,B00,511410,Mehta; Ravindra L.,9998,0,9999,1
1713335768069,CLRE 252,A00,507189,Cuomo; Raphael Eduardo,9998,0,9999,1
1713335769095,CLRE 253,A00,507199,Vaida; Florin,9997,0,9999,2
1713335769095,CLRE 253,B00,507202,Vaida; Florin,9999,0,9999,0
1713335770120,CLRE 259,A00,507211,Patel; Hemal,9996,0,9999,3
1713335771149,CLRE 260,A00,507221,Cuomo; Raphael Eduardo,9999,0,9999,0
1713335772175,CLRE 297,001,507242,Cuomo; Raphael Eduardo,9999,0,9999,0
1713335773200,CSE 191,A00,516875,Minnes Kemp; Mor Mia,9999,0,9999,0
1713335774225,CSS 201S,A01,494383,Staff,35,0,35,0
1713335775249,CSS 202S,A01,494387,Staff,35,0,35,0
1713335776275,EAP 100,A00,516065,Staff,9792,0,9999,207
1713335777306,ECE 45,A01,507414,Staff,51,0,60,9
1713335778331,ECE 100,A01,507416,Baghdadchi; Saharnaz,10,0,20,10
1713335778331,ECE 100,A02,507418,Baghdadchi; Saharnaz,20,0,20,0
1713335779356,ECE 111,A01,507420,Staff,38,0,50,12
1713335780386,ECE 197,001,548057,Sievenpiper; Daniel F.,9998,0,9999,1
1713335781414,EDS 115,A00,507243,Choi; Bailey Miyeon,28,0,28,0
1713335782440,EDS 117,A01,494379,Staff,23,0,25,2
1713335783466,EDS 125,A00,507246,Hopkins; Megan Beth,29,0,30,1
1713335784489,EDS 128A,A01,507264,Fargason; Sharon Gayle,26,0,26,0
1713335785521,EDS 128B,A01,507293,Pappas; Elizabeth,30,0,30,0
1713335786546,EDS 139,A00,507294,Fargason; Sharon Gayle,30,0,30,0
1713335786546,EDS 139,B00,507313,Pappas; Elizabeth,30,0,30,0
1713335787575,EDS 201,A00,507315,Staff,26,0,30,4
1713335788600,EDS 203,A01,507317,Halter; Christopher P.,26,0,30,4
1713335789626,EDS 204R,A01,507319,Halter; Christopher P.,3,0,30,27
1713335789626,EDS 204R,B01,507331,Heinzman; Erica M.,28,0,30,2
1713335790655,EDS 206R,A00,507332,Staff,4,0,30,26
1713335790655,EDS 206R,B00,507343,Staff,28,0,30,2
1713335791685,EDS 250,A00,507344,Hemans; Patricia Ann Benitez,36,0,40,4
1713335792714,EDS 281,A00,507345,Daly; Alan J.,18,0,18,0
1713335793739,EDS 284,A00,507350,Daly; Alan J.,16,0,16,0
1713335794765,EDS 286,A00,507359,Fine; Sarah,18,0,18,0
1713335795793,EDS 289C,A01,507361,Daly; Alan J.,18,0,18,0
1713335796819,EDS 290,A00,507366,Hofstetter; Carolyn,15,0,15,0
1713335797845,LIGM 5A,A00,507421,Fischer-Grunski; Eva K,20,0,20,0
1713335798869,LIGM 5B,A00,507423,Fischer-Grunski; Eva K,20,0,20,0
1713335799894,LIGM 5C,A00,507425,Fischer-Grunski; Eva K,20,0,20,0
1713335800919,LIIT 5AS,A00,507427,Carnelos; Chiara,20,0,20,0
1713335801948,LIIT 5BS,A00,507430,Carnelos; Chiara,20,0,20,0
1713335802982,LIIT 5CS,A00,507432,Carnelos; Chiara,20,0,20,0
1713335804014,LISP 5A,A00,507541,Munoz Sanchez; Alicia,17,0,20,3
1713335805043,LISP 5B,A00,507671,Munoz Sanchez; Alicia,15,0,20,5
1713335806071,LISP 5C,A00,507696,Munoz Sanchez; Alicia,15,0,20,5
1713335807096,MAE 197,001,528363,Boechler; Nicholas Sebastia,9998,0,9999,1
1713335808121,MATH 197,001,523477,Kedlaya; Kiran S.,9999,0,9999,0
1713335808121,MATH 197,002,563811,Zhang; Danna,9999,0,9999,0
1713335809147,MCWP 40R,A00,518780,Staff,20,0,20,0
1713335809147,MCWP 40R,B00,518781,Staff,19,0,20,1
1713335809147,MCWP 40R,C00,518783,Staff,19,0,20,1
1713335810173,MCWP 50R,A00,518791,Staff,20,0,20,0
1713335810173,MCWP 50R,B00,518792,Staff,17,0,20,3
1713335810173,MCWP 50R,C00,518793,Staff,19,0,20,1
1713335810173,MCWP 50R,D00,518794,Staff,16,0,20,4
1713335810173,MCWP 50R,E00,518795,Staff,16,0,20,4
1713335810173,MCWP 50R,F00,518796,Staff,19,0,20,1
1713335810173,MCWP 50R,G00,518797,Staff,19,0,20,1
1713335811201,MMW 12R,A01,514034,Herbst; Matthew,15,0,16,1
1713335811201,MMW 12R,A02,514035,Herbst; Matthew,16,0,16,0
1713335812226,MMW 13R,A01,514037,Staff,12,0,16,4
1713335812226,MMW 13R,A02,514039,Staff,16,0,16,0
1713335814278,SIO 295LS,A00,523233,Staff,19,0,30,11
1713335815306,SIO 295S,A00,523232,Staff,19,0,30,11
1713335816332,SOCI 117,A01,494376,Staff,2,0,5,3
1713335817360,WES 237B,A00,494380,Staff,19,0,20,1
1713335819446,AESE 279B,A00,494370,Wade; Jon P,33,0,33,0
1713335820476,ANAR 135S,A00,494369,Braswell; Geoffrey E.,0,0,0,0
1713335821502,CAT 124RS,A01,519847,Geibel; William,17,0,20,3
1713335822532,CAT 125RS,A01,515971,Geibel; William,17,0,20,3
1713335823565,CLRE 250,A00,511389,Morris; Sheldon,9996,0,9999,3
1713335824596,CLRE 251,A00,507176,Mehta; Ravindra L.,9996,0,9999,3
1713335824596,CLRE 251,B00,511410,Mehta; Ravindra L.,9998,0,9999,1
1713335825621,CLRE 252,A00,507189,Cuomo; Raphael Eduardo,9998,0,9999,1
1713335826652,CLRE 253,A00,507199,Vaida; Florin,9997,0,9999,2
1713335826652,CLRE 253,B00,507202,Vaida; Florin,9999,0,9999,0
1713335827677,CLRE 259,A00,507211,Patel; Hemal,9996,0,9999,3
1713335828704,CLRE 260,A00,507221,Cuomo; Raphael Eduardo,9999,0,9999,0
1713335829732,CLRE 297,001,507242,Cuomo; Raphael Eduardo,9999,0,9999,0
1713335830764,CSE 191,A00,516875,Minnes Kemp; Mor Mia,9999,0,9999,0
1713335831790,CSS 201S,A01,494383,Staff,35,0,35,0
1713335832814,CSS 202S,A01,494387,Staff,35,0,35,0
1713335833839,EAP 100,A00,516065,Staff,9792,0,9999,207
1713335834865,ECE 45,A01,507414,Staff,51,0,60,9
1713335835896,ECE 100,A01,507416,Baghdadchi; Saharnaz,10,0,20,10
1713335835896,ECE 100,A02,507418,Baghdadchi; Saharnaz,20,0,20,0
1713335836922,ECE 111,A01,507420,Staff,38,0,50,12
1713335837951,ECE 197,001,548057,Sievenpiper; Daniel F.,9998,0,9999,1
1713335838984,EDS 115,A00,507243,Choi; Bailey Miyeon,28,0,28,0
1713335840069,EDS 117,A01,494379,Staff,23,0,25,2
1713335841098,EDS 125,A00,507246,Hopkins; Megan Beth,29,0,30,1
1713335842128,EDS 128A,A01,507264,Fargason; Sharon Gayle,26,0,26,0
1713335843154,EDS 128B,A01,507293,Pappas; Elizabeth,30,0,30,0
1713335844186,EDS 139,A00,507294,Fargason; Sharon Gayle,30,0,30,0
1713335844186,EDS 139,B00,507313,Pappas; Elizabeth,30,0,30,0
1713335845216,EDS 201,A00,507315,Staff,26,0,30,4
1713335846247,EDS 203,A01,507317,Halter; Christopher P.,26,0,30,4
1713335847279,EDS 204R,A01,507319,Halter; Christopher P.,3,0,30,27
1713335847279,EDS 204R,B01,507331,Heinzman; Erica M.,28,0,30,2
1713335848306,EDS 206R,A00,507332,Staff,4,0,30,26
1713335848306,EDS 206R,B00,507343,Staff,28,0,30,2
1713335849334,EDS 250,A00,507344,Hemans; Patricia Ann Benitez,36,0,40,4
1713335850365,EDS 281,A00,507345,Daly; Alan J.,18,0,18,0
1713335851391,EDS 284,A00,507350,Daly; Alan J.,16,0,16,0
1713335852417,EDS 286,A00,507359,Fine; Sarah,18,0,18,0
1713335853442,EDS 289C,A01,507361,Daly; Alan J.,18,0,18,0
1713335854466,EDS 290,A00,507366,Hofstetter; Carolyn,15,0,15,0
1713335855496,LIGM 5A,A00,507421,Fischer-Grunski; Eva K,20,0,20,0
1713335856523,LIGM 5B,A00,507423,Fischer-Grunski; Eva K,20,0,20,0
1713335857551,LIGM 5C,A00,507425,Fischer-Grunski; Eva K,20,0,20,0
1713335858582,LIIT 5AS,A00,507427,Carnelos; Chiara,20,0,20,0
1713335859610,LIIT 5BS,A00,507430,Carnelos; Chiara,20,0,20,0
1713335860636,LIIT 5CS,A00,507432,Carnelos; Chiara,20,0,20,0
1713335861662,LISP 5A,A00,507541,Munoz Sanchez; Alicia,17,0,20,3
1713335862691,LISP 5B,A00,507671,Munoz Sanchez; Alicia,15,0,20,5
1713335863716,LISP 5C,A00,507696,Munoz Sanchez; Alicia,15,0,20,5
1713335864741,MAE 197,001,528363,Boechler; Nicholas Sebastia,9998,0,9999,1
1713335865770,MATH 197,001,523477,Kedlaya; Kiran S.,9999,0,9999,0
1713335865770,MATH 197,002,563811,Zhang; Danna,9999,0,9999,0
1713335866797,MCWP 40R,A00,518780,Staff,20,0,20,0
1713335866797,MCWP 40R,B00,518781,Staff,19,0,20,1
1713335866797,MCWP 40R,C00,518783,Staff,19,0,20,1
1713335867821,MCWP 50R,A00,518791,Staff,20,0,20,0
1713335867821,MCWP 50R,B00,518792,Staff,17,0,20,3
1713335867821,MCWP 50R,C00,518793,Staff,19,0,20,1
1713335867821,MCWP 50R,D00,518794,Staff,16,0,20,4
1713335867821,MCWP 50R,E00,518795,Staff,16,0,20,4
1713335867821,MCWP 50R,F00,518796,Staff,19,0,20,1
1713335867821,MCWP 50R,G00,518797,Staff,19,0,20,1
1713335868851,MMW 12R,A01,514034,Herbst; Matthew,15,0,16,1
1713335868851,MMW 12R,A02,514035,Herbst; Matthew,16,0,16,0
1713335869876,MMW 13R,A01,514037,Staff,12,0,16,4
1713335869876,MMW 13R,A02,514039,Staff,16,0,16,0
1713335871935,SIO 295LS,A00,523233,Staff,19,0,30,11
1713335872963,SIO 295S,A00,523232,Staff,19,0,30,11
1713335873988,SOCI 117,A01,494376,Staff,2,0,5,3
1713335875015,WES 237B,A00,494380,Staff,19,0,20,1
1713335877096,AESE 279B,A00,494370,Wade; Jon P,33,0,33,0
1713335878121,ANAR 135S,A00,494369,Braswell; Geoffrey E.,0,0,0,0
1713335879147,CAT 124RS,A01,519847,Geibel; William,17,0,20,3
1713335880177,CAT 125RS,A01,515971,Geibel; William,17,0,20,3
1713335881203,CLRE 250,A00,511389,Morris; Sheldon,9996,0,9999,3
1713335882229,CLRE 251,A00,507176,Mehta; Ravindra L.,9996,0,9999,3
1713335882229,CLRE 251,B00,511410,Mehta; Ravindra L.,9998,0,9999,1
1713335883261,CLRE 252,A00,507189,Cuomo; Raphael Eduardo,9998,0,9999,1
1713335884287,CLRE 253,A00,507199,Vaida; Florin,9997,0,9999,2
1713335884287,CLRE 253,B00,507202,Vaida; Florin,9999,0,9999,0
1713335885313,CLRE 259,A00,507211,Patel; Hemal,9996,0,9999,3
1713335886340,CLRE 260,A00,507221,Cuomo; Raphael Eduardo,9999,0,9999,0
1713335887365,CLRE 297,001,507242,Cuomo; Raphael Eduardo,9999,0,9999,0
1713335888392,CSE 191,A00,516875,Minnes Kemp; Mor Mia,9999,0,9999,0
1713335889416,CSS 201S,A01,494383,Staff,35,0,35,0
1713335890444,CSS 202S,A01,494387,Staff,35,0,35,0
1713335891469,EAP 100,A00,516065,Staff,9792,0,9999,207
1713335892494,ECE 45,A01,507414,Staff,51,0,60,9
1713335893520,ECE 100,A01,507416,Baghdadchi; Saharnaz,10,0,20,10
1713335893520,ECE 100,A02,507418,Baghdadchi; Saharnaz,20,0,20,0
1713335894547,ECE 111,A01,507420,Staff,38,0,50,12
1713335895575,ECE 197,001,548057,Sievenpiper; Daniel F.,9998,0,9999,1
1713335896676,EDS 115,A00,507243,Choi; Bailey Miyeon,28,0,28,0
1713335897706,EDS 117,A01,494379,Staff,23,0,25,2
1713335898734,EDS 125,A00,507246,Hopkins; Megan Beth,29,0,30,1
1713335899765,EDS 128A,A01,507264,Fargason; Sharon Gayle,26,0,26,0
1713335900790,EDS 128B,A01,507293,Pappas; Elizabeth,30,0,30,0
1713335901817,EDS 139,A00,507294,Fargason; Sharon Gayle,30,0,30,0
1713335901817,EDS 139,B00,507313,Pappas; Elizabeth,30,0,30,0
1713335902843,EDS 201,A00,507315,Staff,26,0,30,4
1713335903876,EDS 203,A01,507317,Halter; Christopher P.,26,0,30,4
1713335904902,EDS 204R,A01,507319,Halter; Christopher P.,3,0,30,27
1713335904902,EDS 204R,B01,507331,Heinzman; Erica M.,28,0,30,2
1713335905926,EDS 206R,A00,507332,Staff,4,0,30,26
1713335905926,EDS 206R,B00,507343,Staff,28,0,30,2
1713335906956,EDS 250,A00,507344,Hemans; Patricia Ann Benitez,36,0,40,4
1713335907981,EDS 281,A00,507345,Daly; Alan J.,18,0,18,0
1713335909011,EDS 284,A00,507350,Daly; Alan J.,16,0,16,0
1713335910041,EDS 286,A00,507359,Fine; Sarah,18,0,18,0
1713335911066,EDS 289C,A01,507361,Daly; Alan J.,18,0,18,0
1713335912098,EDS 290,A00,507366,Hofstetter; Carolyn,15,0,15,0
1713335913126,LIGM 5A,A00,507421,Fischer-Grunski; Eva K,20,0,20,0
1713335914150,LIGM 5B,A00,507423,Fischer-Grunski; Eva K,20,0,20,0
1713335915182,LIGM 5C,A00,507425,Fischer-Grunski; Eva K,20,0,20,0
1713335916207,LIIT 5AS,A00,507427,Carnelos; Chiara,20,0,20,0
1713335917236,LIIT 5BS,A00,507430,Carnelos; Chiara,20,0,20,0
1713335918261,LIIT 5CS,A00,507432,Carnelos; Chiara,20,0,20,0
1713335919287,LISP 5A,A00,507541,Munoz Sanchez; Alicia,17,0,20,3
1713335920315,LISP 5B,A00,507671,Munoz Sanchez; Alicia,15,0,20,5
1713335921344,LISP 5C,A00,507696,Munoz Sanchez; Alicia,15,0,20,5
1713335922369,MAE 197,001,528363,Boechler; Nicholas Sebastia,9998,0,9999,1
1713335923396,MATH 197,001,523477,Kedlaya; Kiran S.,9999,0,9999,0
1713335923396,MATH 197,002,563811,Zhang; Danna,9999,0,9999,0
1713335924421,MCWP 40R,A00,518780,Staff,20,0,20,0
1713335924421,MCWP 40R,B00,518781,Staff,19,0,20,1
1713335924421,MCWP 40R,C00,518783,Staff,19,0,20,1
1713335925450,MCWP 50R,A00,518791,Staff,20,0,20,0
1713335925450,MCWP 50R,B00,518792,Staff,17,0,20,3
1713335925450,MCWP 50R,C00,518793,Staff,19,0,20,1
1713335925450,MCWP 50R,D00,518794,Staff,16,0,20,4
1713335925450,MCWP 50R,E00,518795,Staff,16,0,20,4
1713335925450,MCWP 50R,F00,518796,Staff,19,0,20,1
1713335925450,MCWP 50R,G00,518797,Staff,19,0,20,1
1713335926480,MMW 12R,A01,514034,Herbst; Matthew,15,0,16,1
1713335926480,MMW 12R,A02,514035,Herbst; Matthew,16,0,16,0
1713335927506,MMW 13R,A01,514037,Staff,12,0,16,4
1713335927506,MMW 13R,A02,514039,Staff,16,0,16,0
1713335929558,SIO 295LS,A00,523233,Staff,19,0,30,11
1713335930583,SIO 295S,A00,523232,Staff,19,0,30,11
1713335931612,SOCI 117,A01,494376,Staff,2,0,5,3
1713335932642,WES 237B,A00,494380,Staff,19,0,20,1
1713335934717,AESE 279B,A00,494370,Wade; Jon P,33,0,33,0
1713335935741,ANAR 135S,A00,494369,Braswell; Geoffrey E.,0,0,0,0
1713335936768,CAT 124RS,A01,519847,Geibel; William,17,0,20,3
1713335937792,CAT 125RS,A01,515971,Geibel; William,17,0,20,3
1713335938820,CLRE 250,A00,511389,Morris; Sheldon,9996,0,9999,3
1713335939852,CLRE 251,A00,507176,Mehta; Ravindra L.,9996,0,9999,3
1713335939852,CLRE 251,B00,511410,Mehta; Ravindra L.,9998,0,9999,1
1713335940882,CLRE 252,A00,507189,Cuomo; Raphael Eduardo,9998,0,9999,1
1713335941911,CLRE 253,A00,507199,Vaida; Florin,9997,0,9999,2
1713335941911,CLRE 253,B00,507202,Vaida; Florin,9999,0,9999,0
1713335942939,CLRE 259,A00,507211,Patel; Hemal,9996,0,9999,3
1713335944019,CLRE 260,A00,507221,Cuomo; Raphael Eduardo,9999,0,9999,0
1713335945044,CLRE 297,001,507242,Cuomo; Raphael Eduardo,9999,0,9999,0
1713335946071,CSE 191,A00,516875,Minnes Kemp; Mor Mia,9999,0,9999,0
1713335947096,CSS 201S,A01,494383,Staff,35,0,35,0
1713335948122,CSS 202S,A01,494387,Staff,35,0,35,0
1713335949148,EAP 100,A00,516065,Staff,9792,0,9999,207
1713335950173,ECE 45,A01,507414,Staff,51,0,60,9
1713335951197,ECE 100,A01,507416,Baghdadchi; Saharnaz,10,0,20,10
1713335951197,ECE 100,A02,507418,Baghdadchi; Saharnaz,20,0,20,0
1713335952223,ECE 111,A01,507420,Staff,38,0,50,12
1713335953253,ECE 197,001,548057,Sievenpiper; Daniel F.,9998,0,9999,1
1713335954278,EDS 115,A00,507243,Choi; Bailey Miyeon,28,0,28,0
1713335955303,EDS 117,A01,494379,Staff,23,0,25,2
1713335956329,EDS 125,A00,507246,Hopkins; Megan Beth,29,0,30,1
1713335957360,EDS 128A,A01,507264,Fargason; Sharon Gayle,26,0,26,0
1713335958386,EDS 128B,A01,507293,Pappas; Elizabeth,30,0,30,0
1713335959414,EDS 139,A00,507294,Fargason; Sharon Gayle,30,0,30,0
1713335959414,EDS 139,B00,507313,Pappas; Elizabeth,30,0,30,0
1713335960439,EDS 201,A00,507315,Staff,26,0,30,4
1713335961464,EDS 203,A01,507317,Halter; Christopher P.,26,0,30,4
1713335962489,EDS 204R,A01,507319,Halter; Christopher P.,3,0,30,27
1713335962489,EDS 204R,B01,507331,Heinzman; Erica M.,28,0,30,2
1713335963514,EDS 206R,A00,507332,Staff,4,0,30,26
1713335963514,EDS 206R,B00,507343,Staff,28,0,30,2
1713335964543,EDS 250,A00,507344,Hemans; Patricia Ann Benitez,36,0,40,4
1713335965571,EDS 281,A00,507345,Daly; Alan J.,18,0,18,0
1713335966596,EDS 284,A00,507350,Daly; Alan J.,16,0,16,0
1713335967622,EDS 286,A00,507359,Fine; Sarah,18,0,18,0
1713335968647,EDS 289C,A01,507361,Daly; Alan J.,18,0,18,0
1713335969675,EDS 290,A00,507366,Hofstetter; Carolyn,15,0,15,0
1713335970705,LIGM 5A,A00,507421,Fischer-Grunski; Eva K,20,0,20,0
1713335971734,LIGM 5B,A00,507423,Fischer-Grunski; Eva K,20,0,20,0
1713335972762,LIGM 5C,A00,507425,Fischer-Grunski; Eva K,20,0,20,0
1713335973792,LIIT 5AS,A00,507427,Carnelos; Chiara,20,0,20,0
1713335974821,LIIT 5BS,A00,507430,Carnelos; Chiara,20,0,20,0
1713335975851,LIIT 5CS,A00,507432,Carnelos; Chiara,20,0,20,0
1713335976878,LISP 5A,A00,507541,Munoz Sanchez; Alicia,17,0,20,3
1713335977903,LISP 5B,A00,507671,Munoz Sanchez; Alicia,15,0,20,5
1713335978935,LISP 5C,A00,507696,Munoz Sanchez; Alicia,15,0,20,5
1713335979961,MAE 197,001,528363,Boechler; Nicholas Sebastia,9998,0,9999,1
1713335980989,MATH 197,001,523477,Kedlaya; Kiran S.,9999,0,9999,0
1713335980989,MATH 197,002,563811,Zhang; Danna,9999,0,9999,0
1713335982018,MCWP 40R,A00,518780,Staff,20,0,20,0
1713335982018,MCWP 40R,B00,518781,Staff,19,0,20,1
1713335982018,MCWP 40R,C00,518783,Staff,19,0,20,1
1713335983044,MCWP 50R,A00,518791,Staff,20,0,20,0
1713335983044,MCWP 50R,B00,518792,Staff,17,0,20,3
1713335983044,MCWP 50R,C00,518793,Staff,19,0,20,1
1713335983044,MCWP 50R,D00,518794,Staff,16,0,20,4
1713335983044,MCWP 50R,E00,518795,Staff,16,0,20,4
1713335983044,MCWP 50R,F00,518796,Staff,19,0,20,1
1713335983044,MCWP 50R,G00,518797,Staff,19,0,20,1
1713335984070,MMW 12R,A01,514034,Herbst; Matthew,15,0,16,1
1713335984070,MMW 12R,A02,514035,Herbst; Matthew,16,0,16,0
1713335985095,MMW 13R,A01,514037,Staff,12,0,16,4
1713335985095,MMW 13R,A02,514039,Staff,16,0,16,0
1713335987146,SIO 295LS,A00,523233,Staff,19,0,30,11
1713335988174,SIO 295S,A00,523232,Staff,19,0,30,11
1713335989204,SOCI 117,A01,494376,Staff,2,0,5,3
1713335990233,WES 237B,A00,494380,Staff,19,0,20,1
1713335992317,AESE 279B,A00,494370,Wade; Jon P,33,0,33,0
1713335993345,ANAR 135S,A00,494369,Braswell; Geoffrey E.,0,0,0,0
1713335994371,CAT 124RS,A01,519847,Geibel; William,17,0,20,3
1713335995396,CAT 125RS,A01,515971,Geibel; William,17,0,20,3
1713335996424,CLRE 250,A00,511389,Morris; Sheldon,9996,0,9999,3
1713335997450,CLRE 251,A00,507176,Mehta; Ravindra L.,9996,0,9999,3
1713335997450,CLRE 251,B00,511410,Mehta; Ravindra L.,9998,0,9999,1
1713335998479,CLRE 252,A00,507189,Cuomo; Raphael Eduardo,9998,0,9999,1
1713335999504,CLRE 253,A00,507199,Vaida; Florin,9997,0,9999,2
1713335999504,CLRE 253,B00,507202,Vaida; Florin,9999,0,9999,0
1713336000530,CLRE 259,A00,507211,Patel; Hemal,9996,0,9999,3
1713336001557,CLRE 260,A00,507221,Cuomo; Raphael Eduardo,9999,0,9999,0
1713336002582,CLRE 297,001,507242,Cuomo; Raphael Eduardo,9999,0,9999,0
1713336003606,CSE 191,A00,516875,Minnes Kemp; Mor Mia,9999,0,9999,0
1713336004632,CSS 201S,A01,494383,Staff,35,0,35,0
1713336005659,CSS 202S,A01,494387,Staff,35,0,35,0
1713336006688,EAP 100,A00,516065,Staff,9792,0,9999,207
1713336007713,ECE 45,A01,507414,Staff,51,0,60,9
1713336008738,ECE 100,A01,507416,Baghdadchi; Saharnaz,10,0,20,10
1713336008738,ECE 100,A02,507418,Baghdadchi; Saharnaz,20,0,20,0
1713336009764,ECE 111,A01,507420,Staff,38,0,50,12
1713336010790,ECE 197,001,548057,Sievenpiper; Daniel F.,9998,0,9999,1
1713336011816,EDS 115,A00,507243,Choi; Bailey Miyeon,28,0,28,0
1713336012842,EDS 117,A01,494379,Staff,23,0,25,2
1713336013872,EDS 125,A00,507246,Hopkins; Megan Beth,29,0,30,1
1713336014902,EDS 128A,A01,507264,Fargason; Sharon Gayle,26,0,26,0
1713336015932,EDS 128B,A01,507293,Pappas; Elizabeth,30,0,30,0
1713336016960,EDS 139,A00,507294,Fargason; Sharon Gayle,30,0,30,0
1713336016960,EDS 139,B00,507313,Pappas; Elizabeth,30,0,30,0
1713336017986,EDS 201,A00,507315,Staff,26,0,30,4
1713336019016,EDS 203,A01,507317,Halter; Christopher P.,26,0,30,4
1713336020052,EDS 204R,A01,507319,Halter; Christopher P.,3,0,30,27
1713336020052,EDS 204R,B01,507331,Heinzman; Erica M.,28,0,30,2
1713336021077,EDS 206R,A00,507332,Staff,4,0,30,26
1713336021077,EDS 206R,B00,507343,Staff,28,0,30,2
1713336022112,EDS 250,A00,507344,Hemans; Patricia Ann Benitez,36,0,40,4
1713336023137,EDS 281,A00,507345,Daly; Alan J.,18,0,18,0
1713336024164,EDS 284,A00,507350,Daly; Alan J.,16,0,16,0
1713336025195,EDS 286,A00,507359,Fine; Sarah,18,0,18,0
1713336026227,EDS 289C,A01,507361,Daly; Alan J.,18,0,18,0
1713336027251,EDS 290,A00,507366,Hofstetter; Carolyn,15,0,15,0
1713336028277,LIGM 5A,A00,507421,Fischer-Grunski; Eva K,20,0,20,0
1713336029308,LIGM 5B,A00,507423,Fischer-Grunski; Eva K,20,0,20,0
1713336030332,LIGM 5C,A00,507425,Fischer-Grunski; Eva K,20,0,20,0
1713336031359,LIIT 5AS,A00,507427,Carnelos; Chiara,20,0,20,0
1713336032384,LIIT 5BS,A00,507430,Carnelos; Chiara,20,0,20,0
1713336033414,LIIT 5CS,A00,507432,Carnelos; Chiara,20,0,20,0
1713336034441,LISP 5A,A00,507541,Munoz Sanchez; Alicia,17,0,20,3
1713336035468,LISP 5B,A00,507671,Munoz Sanchez; Alicia,15,0,20,5
1713336036491,LISP 5C,A00,507696,Munoz Sanchez; Alicia,15,0,20,5
1713336037518,MAE 197,001,528363,Boechler; Nicholas Sebastia,9998,0,9999,1
1713336038546,MATH 197,001,523477,Kedlaya; Kiran S.,9999,0,9999,0
1713336038546,MATH 197,002,563811,Zhang; Danna,9999,0,9999,0
1713336039572,MCWP 40R,A00,518780,Staff,20,0,20,0
1713336039572,MCWP 40R,B00,518781,Staff,19,0,20,1
1713336039572,MCWP 40R,C00,518783,Staff,19,0,20,1
1713336040599,MCWP 50R,A00,518791,Staff,20,0,20,0
1713336040599,MCWP 50R,B00,518792,Staff,17,0,20,3
1713336040599,MCWP 50R,C00,518793,Staff,19,0,20,1
1713336040599,MCWP 50R,D00,518794,Staff,16,0,20,4
1713336040599,MCWP 50R,E00,518795,Staff,16,0,20,4
1713336040599,MCWP 50R,F00,518796,Staff,19,0,20,1
1713336040599,MCWP 50R,G00,518797,Staff,19,0,20,1
1713336041631,MMW 12R,A01,514034,Herbst; Matthew,15,0,16,1
1713336041631,MMW 12R,A02,514035,Herbst; Matthew,16,0,16,0
1713336042658,MMW 13R,A01,514037,Staff,12,0,16,4
1713336042658,MMW 13R,A02,514039,Staff,16,0,16,0
1713336044714,SIO 295LS,A00,523233,Staff,19,0,30,11
1713336045740,SIO 295S,A00,523232,Staff,19,0,30,11
1713336046766,SOCI 117,A01,494376,Staff,2,0,5,3
1713336047852,WES 237B,A00,494380,Staff,19,0,20,1
1713336049915,AESE 279B,A00,494370,Wade; Jon P,33,0,33,0
1713336050942,ANAR 135S,A00,494369,Braswell; Geoffrey E.,0,0,0,0
1713336051967,CAT 124RS,A01,519847,Geibel; William,17,0,20,3
1713336052995,CAT 125RS,A01,515971,Geibel; William,17,0,20,3
1713336054022,CLRE 250,A00,511389,Morris; Sheldon,9996,0,9999,3
1713336055050,CLRE 251,A00,507176,Mehta; Ravindra L.,9996,0,9999,3
1713336055050,CLRE 251,B00,511410,Mehta; Ravindra L.,9998,0,9999,1
1713336056081,CLRE 252,A00,507189,Cuomo; Raphael Eduardo,9998,0,9999,1
1713336057106,CLRE 253,A00,507199,Vaida; Florin,9997,0,9999,2
1713336057106,CLRE 253,B00,507202,Vaida; Florin,9999,0,9999,0
1713336058132,CLRE 259,A00,507211,Patel; Hemal,9996,0,9999,3
1713336059161,CLRE 260,A00,507221,Cuomo; Raphael Eduardo,9999,0,9999,0
1713336060193,CLRE 297,001,507242,Cuomo; Raphael Eduardo,9999,0,9999,0
1713336061217,CSE 191,A00,516875,Minnes Kemp; Mor Mia,9999,0,9999,0
1713336062249,CSS 201S,A01,494383,Staff,35,0,35,0
1713336063274,CSS 202S,A01,494387,Staff,35,0,35,0
1713336064300,EAP 100,A00,516065,Staff,9792,0,9999,207
1713336065326,ECE 45,A01,507414,Staff,51,0,60,9
1713336066350,ECE 100,A01,507416,Baghdadchi; Saharnaz,10,0,20,10
1713336066350,ECE 100,A02,507418,Baghdadchi; Saharnaz,20,0,20,0
1713336067379,ECE 111,A01,507420,Staff,38,0,50,12
1713336068405,ECE 197,001,548057,Sievenpiper; Daniel F.,9998,0,9999,1
1713336069438,EDS 115,A00,507243,Choi; Bailey Miyeon,28,0,28,0
1713336070462,EDS 117,A01,494379,Staff,23,0,25,2
1713336071490,EDS 125,A00,507246,Hopkins; Megan Beth,29,0,30,1
1713336072520,EDS 128A,A01,507264,Fargason; Sharon Gayle,26,0,26,0
1713336073552,EDS 128B,A01,507293,Pappas; Elizabeth,30,0,30,0
1713336074582,EDS 139,A00,507294,Fargason; Sharon Gayle,30,0,30,0
1713336074582,EDS 139,B00,507313,Pappas; Elizabeth,30,0,30,0
1713336075608,EDS 201,A00,507315,Staff,26,0,30,4
1713336076633,EDS 203,A01,507317,Halter; Christopher P.,26,0,30,4
1713336077659,EDS 204R,A01,507319,Halter; Christopher P.,3,0,30,27
1713336077659,EDS 204R,B01,507331,Heinzman; Erica M.,28,0,30,2
1713336078685,EDS 206R,A00,507332,Staff,4,0,30,26
1713336078685,EDS 206R,B00,507343,Staff,28,0,30,2
1713336079709,EDS 250,A00,507344,Hemans; Patricia Ann Benitez,36,0,40,4
1713336080739,EDS 281,A00,507345,Daly; Alan J.,18,0,18,0
1713336081765,EDS 284,A00,507350,Daly; Alan J.,16,0,16,0
1713336082790,EDS 286,A00,507359,Fine; Sarah,18,0,18,0
1713336083817,EDS 289C,A01,507361,Daly; Alan J.,18,0,18,0
1713336084842,EDS 290,A00,507366,Hofstetter; Carolyn,15,0,15,0
1713336085874,LIGM 5A,A00,507421,Fischer-Grunski; Eva K,20,0,20,0
1713336086898,LIGM 5B,A00,507423,Fischer-Grunski; Eva K,20,0,20,0
1713336087929,LIGM 5C,A00,507425,Fischer-Grunski; Eva K,20,0,20,0
1713336088954,LIIT 5AS,A00,507427,Carnelos; Chiara,20,0,20,0
1713336089978,LIIT 5BS,A00,507430,Carnelos; Chiara,20,0,20,0
1713336091004,LIIT 5CS,A00,507432,Carnelos; Chiara,20,0,20,0
1713336092029,LISP 5A,A00,507541,Munoz Sanchez; Alicia,17,0,20,3
1713336093056,LISP 5B,A00,507671,Munoz Sanchez; Alicia,15,0,20,5
1713336094082,LISP 5C,A00,507696,Munoz Sanchez; Alicia,15,0,20,5
1713336095107,MAE 197,001,528363,Boechler; Nicholas Sebastia,9998,0,9999,1
1713336096134,MATH 197,001,523477,Kedlaya; Kiran S.,9999,0,9999,0
1713336096134,MATH 197,002,563811,Zhang; Danna,9999,0,9999,0
1713336097164,MCWP 40R,A00,518780,Staff,20,0,20,0
1713336097164,MCWP 40R,B00,518781,Staff,19,0,20,1
1713336097164,MCWP 40R,C00,518783,Staff,19,0,20,1
1713336098190,MCWP 50R,A00,518791,Staff,20,0,20,0
1713336098190,MCWP 50R,B00,518792,Staff,17,0,20,3
1713336098190,MCWP 50R,C00,518793,Staff,19,0,20,1
1713336098190,MCWP 50R,D00,518794,Staff,16,0,20,4
1713336098190,MCWP 50R,E00,518795,Staff,16,0,20,4
1713336098190,MCWP 50R,F00,518796,Staff,19,0,20,1
1713336098190,MCWP 50R,G00,518797,Staff,19,0,20,1
1713336099212,MMW 12R,A01,514034,Herbst; Matthew,15,0,16,1
1713336099212,MMW 12R,A02,514035,Herbst; Matthew,16,0,16,0
1713336100236,MMW 13R,A01,514037,Staff,12,0,16,4
1713336100236,MMW 13R,A02,514039,Staff,16,0,16,0
1713336102286,SIO 295LS,A00,523233,Staff,19,0,30,11
1713336103314,SIO 295S,A00,523232,Staff,19,0,30,11
1713336104343,SOCI 117,A01,494376,Staff,2,0,5,3
1713336105369,WES 237B,A00,494380,Staff,19,0,20,1
1713336107434,AESE 279B,A00,494370,Wade; Jon P,33,0,33,0
1713336108459,ANAR 135S,A00,494369,Braswell; Geoffrey E.,0,0,0,0
1713336109485,CAT 124RS,A01,519847,Geibel; William,17,0,20,3
1713336110515,CAT 125RS,A01,515971,Geibel; William,17,0,20,3
1713336111543,CLRE 250,A00,511389,Morris; Sheldon,9996,0,9999,3
1713336112570,CLRE 251,A00,507176,Mehta; Ravindra L.,9996,0,9999,3
1713336112570,CLRE 251,B00,511410,Mehta; Ravindra L.,9998,0,9999,1
1713336113595,CLRE 252,A00,507189,Cuomo; Raphael Eduardo,9998,0,9999,1
1713336114622,CLRE 253,A00,507199,Vaida; Florin,9997,0,9999,2
1713336114622,CLRE 253,B00,507202,Vaida; Florin,9999,0,9999,0
1713336115650,CLRE 259,A00,507211,Patel; Hemal,9996,0,9999,3
1713336116675,CLRE 260,A00,507221,Cuomo; Raphael Eduardo,9999,0,9999,0
1713336117700,CLRE 297,001,507242,Cuomo; Raphael Eduardo,9999,0,9999,0
1713336118725,CSE 191,A00,516875,Minnes Kemp; Mor Mia,9999,0,9999,0
1713336119750,CSS 201S,A01,494383,Staff,35,0,35,0
1713336120776,CSS 202S,A01,494387,Staff,35,0,35,0
1713336121802,EAP 100,A00,516065,Staff,9792,0,9999,207
1713336122828,ECE 45,A01,507414,Staff,51,0,60,9
1713336123856,ECE 100,A01,507416,Baghdadchi; Saharnaz,10,0,20,10
1713336123856,ECE 100,A02,507418,Baghdadchi; Saharnaz,20,0,20,0
1713336124882,ECE 111,A01,507420,Staff,38,0,50,12
1713336125914,ECE 197,001,548057,Sievenpiper; Daniel F.,9998,0,9999,1
1713336126940,EDS 115,A00,507243,Choi; Bailey Miyeon,28,0,28,0
1713336127964,EDS 117,A01,494379,Staff,23,0,25,2
1713336128991,EDS 125,A00,507246,Hopkins; Megan Beth,29,0,30,1
1713336130023,EDS 128A,A01,507264,Fargason; Sharon Gayle,26,0,26,0
1713336131056,EDS 128B,A01,507293,Pappas; Elizabeth,30,0,30,0
1713336132082,EDS 139,A00,507294,Fargason; Sharon Gayle,30,0,30,0
1713336132082,EDS 139,B00,507313,Pappas; Elizabeth,30,0,30,0
1713336133111,EDS 201,A00,507315,Staff,26,0,30,4
1713336134137,EDS 203,A01,507317,Halter; Christopher P.,26,0,30,4
1713336135163,EDS 204R,A01,507319,Halter; Christopher P.,3,0,30,27
1713336135163,EDS 204R,B01,507331,Heinzman; Erica M.,28,0,30,2
1713336136188,EDS 206R,A00,507332,Staff,4,0,30,26
1713336136188,EDS 206R,B00,507343,Staff,28,0,30,2
1713336137212,EDS 250,A00,507344,Hemans; Patricia Ann Benitez,36,0,40,4
1713336138241,EDS 281,A00,507345,Daly; Alan J.,18,0,18,0
1713336139269,EDS 284,A00,507350,Daly; Alan J.,16,0,16,0
1713336140300,EDS 286,A00,507359,Fine; Sarah,18,0,18,0
1713336141325,EDS 289C,A01,507361,Daly; Alan J.,18,0,18,0
1713336142351,EDS 290,A00,507366,Hofstetter; Carolyn,15,0,15,0
1713336143377,LIGM 5A,A00,507421,Fischer-Grunski; Eva K,20,0,20,0
1713336144407,LIGM 5B,A00,507423,Fischer-Grunski; Eva K,20,0,20,0
1713336145437,LIGM 5C,A00,507425,Fischer-Grunski; Eva K,20,0,20,0
1713336146470,LIIT 5AS,A00,507427,Carnelos; Chiara,20,0,20,0
1713336147494,LIIT 5BS,A00,507430,Carnelos; Chiara,20,0,20,0
1713336148519,LIIT 5CS,A00,507432,Carnelos; Chiara,20,0,20,0
1713336149545,LISP 5A,A00,507541,Munoz Sanchez; Alicia,17,0,20,3
1713336150574,LISP 5B,A00,507671,Munoz Sanchez; Alicia,15,0,20,5
1713336151654,LISP 5C,A00,507696,Munoz Sanchez; Alicia,15,0,20,5
1713336152683,MAE 197,001,528363,Boechler; Nicholas Sebastia,9998,0,9999,1
1713336153709,MATH 197,001,523477,Kedlaya; Kiran S.,9999,0,9999,0
1713336153709,MATH 197,002,563811,Zhang; Danna,9999,0,9999,0
1713336154740,MCWP 40R,A00,518780,Staff,20,0,20,0
1713336154740,MCWP 40R,B00,518781,Staff,19,0,20,1
1713336154740,MCWP 40R,C00,518783,Staff,19,0,20,1
1713336155768,MCWP 50R,A00,518791,Staff,20,0,20,0
1713336155768,MCWP 50R,B00,518792,Staff,17,0,20,3
1713336155768,MCWP 50R,C00,518793,Staff,19,0,20,1
1713336155768,MCWP 50R,D00,518794,Staff,16,0,20,4
1713336155768,MCWP 50R,E00,518795,Staff,16,0,20,4
1713336155768,MCWP 50R,F00,518796,Staff,19,0,20,1
1713336155768,MCWP 50R,G00,518797,Staff,19,0,20,1
1713336156799,MMW 12R,A01,514034,Herbst; Matthew,15,0,16,1
1713336156799,MMW 12R,A02,514035,Herbst; Matthew,16,0,16,0
1713336157825,MMW 13R,A01,514037,Staff,12,0,16,4
1713336157825,MMW 13R,A02,514039,Staff,16,0,16,0
1713336159880,SIO 295LS,A00,523233,Staff,19,0,30,11
1713336160906,SIO 295S,A00,523232,Staff,19,0,30,11
1713336161930,SOCI 117,A01,494376,Staff,2,0,5,3
1713336162959,WES 237B,A00,494380,Staff,19,0,20,1
1713336165031,AESE 279B,A00,494370,Wade; Jon P,33,0,33,0
1713336166108,ANAR 135S,A00,494369,Braswell; Geoffrey E.,0,0,0,0
1713336167136,CAT 124RS,A01,519847,Geibel; William,17,0,20,3
1713336168163,CAT 125RS,A01,515971,Geibel; William,17,0,20,3
1713336169188,CLRE 250,A00,511389,Morris; Sheldon,9996,0,9999,3
1713336170217,CLRE 251,A00,507176,Mehta; Ravindra L.,9996,0,9999,3
1713336170217,CLRE 251,B00,511410,Mehta; Ravindra L.,9998,0,9999,1
1713336171242,CLRE 252,A00,507189,Cuomo; Raphael Eduardo,9998,0,9999,1
1713336172268,CLRE 253,A00,507199,Vaida; Florin,9997,0,9999,2
1713336172268,CLRE 253,B00,507202,Vaida; Florin,9999,0,9999,0
1713336173300,CLRE 259,A00,507211,Patel; Hemal,9996,0,9999,3
1713336174325,CLRE 260,A00,507221,Cuomo; Raphael Eduardo,9999,0,9999,0
1713336175351,CLRE 297,001,507242,Cuomo; Raphael Eduardo,9999,0,9999,0
1713336176380,CSE 191,A00,516875,Minnes Kemp; Mor Mia,9999,0,9999,0
1713336177405,CSS 201S,A01,494383,Staff,35,0,35,0
1713336178431,CSS 202S,A01,494387,Staff,35,0,35,0
1713336179456,EAP 100,A00,516065,Staff,9792,0,9999,207
1713336180487,ECE 45,A01,507414,Staff,51,0,60,9
1713336181510,ECE 100,A01,507416,Baghdadchi; Saharnaz,10,0,20,10
1713336181510,ECE 100,A02,507418,Baghdadchi; Saharnaz,20,0,20,0
1713336182540,ECE 111,A01,507420,Staff,38,0,50,12
1713336183565,ECE 197,001,548057,Sievenpiper; Daniel F.,9998,0,9999,1
1713336184593,EDS 115,A00,507243,Choi; Bailey Miyeon,28,0,28,0
1713336185617,EDS 117,A01,494379,Staff,23,0,25,2
1713336186643,EDS 125,A00,507246,Hopkins; Megan Beth,29,0,30,1
1713336187669,EDS 128A,A01,507264,Fargason; Sharon Gayle,26,0,26,0
1713336188695,EDS 128B,A01,507293,Pappas; Elizabeth,30,0,30,0
1713336189724,EDS 139,A00,507294,Fargason; Sharon Gayle,30,0,30,0
1713336189724,EDS 139,B00,507313,Pappas; Elizabeth,30,0,30,0
1713336190751,EDS 201,A00,507315,Staff,26,0,30,4
1713336191779,EDS 203,A01,507317,Halter; Christopher P.,26,0,30,4
1713336192804,EDS 204R,A01,507319,Halter; Christopher P.,3,0,30,27
1713336192804,EDS 204R,B01,507331,Heinzman; Erica M.,28,0,30,2
1713336193832,EDS 206R,A00,507332,Staff,4,0,30,26
1713336193832,EDS 206R,B00,507343,Staff,28,0,30,2
1713336194858,EDS 250,A00,507344,Hemans; Patricia Ann Benitez,36,0,40,4
1713336195886,EDS 281,A00,507345,Daly; Alan J.,18,0,18,0
1713336196911,EDS 284,A00,507350,Daly; Alan J.,16,0,16,0
1713336197939,EDS 286,A00,507359,Fine; Sarah,18,0,18,0
1713336198968,EDS 289C,A01,507361,Daly; Alan J.,18,0,18,0
1713336199999,EDS 290,A00,507366,Hofstetter; Carolyn,15,0,15,0
1713336201034,LIGM 5A,A00,507421,Fischer-Grunski; Eva K,20,0,20,0
1713336202061,LIGM 5B,A00,507423,Fischer-Grunski; Eva K,20,0,20,0
1713336203086,LIGM 5C,A00,507425,Fischer-Grunski; Eva K,20,0,20,0
1713336204111,LIIT 5AS,A00,507427,Carnelos; Chiara,20,0,20,0
1713336205137,LIIT 5BS,A00,507430,Carnelos; Chiara,20,0,20,0
1713336206167,LIIT 5CS,A00,507432,Carnelos; Chiara,20,0,20,0
1713336207194,LISP 5A,A00,507541,Munoz Sanchez; Alicia,17,0,20,3
1713336208219,LISP 5B,A00,507671,Munoz Sanchez; Alicia,15,0,20,5
1713336209250,LISP 5C,A00,507696,Munoz Sanchez; Alicia,15,0,20,5
1713336210276,MAE 197,001,528363,Boechler; Nicholas Sebastia,9998,0,9999,1
1713336211311,MATH 197,001,523477,Kedlaya; Kiran S.,9999,0,9999,0
1713336211311,MATH 197,002,563811,Zhang; Danna,9999,0,9999,0
1713336212338,MCWP 40R,A00,518780,Staff,20,0,20,0
1713336212338,MCWP 40R,B00,518781,Staff,19,0,20,1
1713336212338,MCWP 40R,C00,518783,Staff,19,0,20,1
1713336213363,MCWP 50R,A00,518791,Staff,20,0,20,0
1713336213363,MCWP 50R,B00,518792,Staff,17,0,20,3
1713336213363,MCWP 50R,C00,518793,Staff,19,0,20,1
1713336213363,MCWP 50R,D00,518794,Staff,16,0,20,4
1713336213363,MCWP 50R,E00,518795,Staff,16,0,20,4
1713336213363,MCWP 50R,F00,518796,Staff,19,0,20,1
1713336213363,MCWP 50R,G00,518797,Staff,19,0,20,1
1713336214394,MMW 12R,A01,514034,Herbst; Matthew,15,0,16,1
1713336214394,MMW 12R,A02,514035,Herbst; Matthew,16,0,16,0
1713336215418,MMW 13R,A01,514037,Staff,12,0,16,4
1713336215418,MMW 13R,A02,514039,Staff,16,0,16,0
1713336217470,SIO 295LS,A00,523233,Staff,19,0,30,11
1713336218496,SIO 295S,A00,523232,Staff,19,0,30,11
1713336219524,SOCI 117,A01,494376,Staff,2,0,5,3
1713336220549,WES 237B,A00,494380,Staff,19,0,20,1
1713336222618,AESE 279B,A00,494370,Wade; Jon P,33,0,33,0
1713336223646,ANAR 135S,A00,494369,Braswell; Geoffrey E.,0,0,0,0
1713336224677,CAT 124RS,A01,519847,Geibel; William,17,0,20,3
1713336225702,CAT 125RS,A01,515971,Geibel; William,17,0,20,3
1713336226727,CLRE 250,A00,511389,Morris; Sheldon,9996,0,9999,3
1713336227760,CLRE 251,A00,507176,Mehta; Ravindra L.,9996,0,9999,3
1713336227760,CLRE 251,B00,511410,Mehta; Ravindra L.,9998,0,9999,1
1713336228787,CLRE 252,A00,507189,Cuomo; Raphael Eduardo,9998,0,9999,1
1713336229818,CLRE 253,A00,507199,Vaida; Florin,9997,0,9999,2
1713336229818,CLRE 253,B00,507202,Vaida; Florin,9999,0,9999,0
1713336230844,CLRE 259,A00,507211,Patel; Hemal,9996,0,9999,3
1713336231871,CLRE 260,A00,507221,Cuomo; Raphael Eduardo,9999,0,9999,0
1713336232898,CLRE 297,001,507242,Cuomo; Raphael Eduardo,9999,0,9999,0
1713336233926,CSE 191,A00,516875,Minnes Kemp; Mor Mia,9999,0,9999,0
1713336234956,CSS 201S,A01,494383,Staff,35,0,35,0
1713336235986,CSS 202S,A01,494387,Staff,35,0,35,0
1713336237010,EAP 100,A00,516065,Staff,9792,0,9999,207
1713336238041,ECE 45,A01,507414,Staff,51,0,60,9
1713336239070,ECE 100,A01,507416,Baghdadchi; Saharnaz,10,0,20,10
1713336239070,ECE 100,A02,507418,Baghdadchi; Saharnaz,20,0,20,0
1713336240096,ECE 111,A01,507420,Staff,38,0,50,12
1713336241121,ECE 197,001,548057,Sievenpiper; Daniel F.,9998,0,9999,1
1713336242146,EDS 115,A00,507243,Choi; Bailey Miyeon,28,0,28,0
1713336243171,EDS 117,A01,494379,Staff,23,0,25,2
1713336244200,EDS 125,A00,507246,Hopkins; Megan Beth,29,0,30,1
1713336245225,EDS 128A,A01,507264,Fargason; Sharon Gayle,26,0,26,0
1713336246257,EDS 128B,A01,507293,Pappas; Elizabeth,30,0,30,0
1713336247282,EDS 139,A00,507294,Fargason; Sharon Gayle,30,0,30,0
1713336247282,EDS 139,B00,507313,Pappas; Elizabeth,30,0,30,0
1713336248308,EDS 201,A00,507315,Staff,26,0,30,4
1713336249331,EDS 203,A01,507317,Halter; Christopher P.,26,0,30,4
1713336250357,EDS 204R,A01,507319,Halter; Christopher P.,3,0,30,27
1713336250357,EDS 204R,B01,507331,Heinzman; Erica M.,28,0,30,2
1713336251382,EDS 206R,A00,507332,Staff,4,0,30,26
1713336251382,EDS 206R,B00,507343,Staff,28,0,30,2
1713336252407,EDS 250,A00,507344,Hemans; Patricia Ann Benitez,36,0,40,4
1713336253434,EDS 281,A00,507345,Daly; Alan J.,18,0,18,0
1713336254462,EDS 284,A00,507350,Daly; Alan J.,16,0,16,0
1713336255544,EDS 286,A00,507359,Fine; Sarah,18,0,18,0
1713336256570,EDS 289C,A01,507361,Daly; Alan J.,18,0,18,0
1713336257595,EDS 290,A00,507366,Hofstetter; Carolyn,15,0,15,0
1713336258621,LIGM 5A,A00,507421,Fischer-Grunski; Eva K,20,0,20,0
1713336259646,LIGM 5B,A00,507423,Fischer-Grunski; Eva K,20,0,20,0
1713336260672,LIGM 5C,A00,507425,Fischer-Grunski; Eva K,20,0,20,0
1713336261698,LIIT 5AS,A00,507427,Carnelos; Chiara,20,0,20,0
1713336262728,LIIT 5BS,A00,507430,Carnelos; Chiara,20,0,20,0
1713336263758,LIIT 5CS,A00,507432,Carnelos; Chiara,20,0,20,0
1713336264783,LISP 5A,A00,507541,Munoz Sanchez; Alicia,17,0,20,3
1713336265814,LISP 5B,A00,507671,Munoz Sanchez; Alicia,15,0,20,5
1713336266838,LISP 5C,A00,507696,Munoz Sanchez; Alicia,15,0,20,5
1713336267864,MAE 197,001,528363,Boechler; Nicholas Sebastia,9998,0,9999,1
1713336268889,MATH 197,001,523477,Kedlaya; Kiran S.,9999,0,9999,0
1713336268889,MATH 197,002,563811,Zhang; Danna,9999,0,9999,0
1713336269915,MCWP 40R,A00,518780,Staff,20,0,20,0
1713336269915,MCWP 40R,B00,518781,Staff,19,0,20,1
1713336269915,MCWP 40R,C00,518783,Staff,19,0,20,1
1713336270944,MCWP 50R,A00,518791,Staff,20,0,20,0
1713336270944,MCWP 50R,B00,518792,Staff,17,0,20,3
1713336270944,MCWP 50R,C00,518793,Staff,19,0,20,1
1713336270944,MCWP 50R,D00,518794,Staff,16,0,20,4
1713336270944,MCWP 50R,E00,518795,Staff,16,0,20,4
1713336270944,MCWP 50R,F00,518796,Staff,19,0,20,1
1713336270944,MCWP 50R,G00,518797,Staff,19,0,20,1
1713336271971,MMW 12R,A01,514034,Herbst; Matthew,15,0,16,1
1713336271971,MMW 12R,A02,514035,Herbst; Matthew,16,0,16,0
1713336272997,MMW 13R,A01,514037,Staff,12,0,16,4
1713336272997,MMW 13R,A02,514039,Staff,16,0,16,0
1713336275048,SIO 295LS,A00,523233,Staff,19,0,30,11
1713336276076,SIO 295S,A00,523232,Staff,19,0,30,11
1713336277100,SOCI 117,A01,494376,Staff,2,0,5,3
1713336278131,WES 237B,A00,494380,Staff,19,0,20,1
1713336280198,AESE 279B,A00,494370,Wade; Jon P,33,0,33,0
1713336281223,ANAR 135S,A00,494369,Braswell; Geoffrey E.,0,0,0,0
1713336282252,CAT 124RS,A01,519847,Geibel; William,17,0,20,3
1713336283276,CAT 125RS,A01,515971,Geibel; William,17,0,20,3
1713336284303,CLRE 250,A00,511389,Morris; Sheldon,9996,0,9999,3
1713336285329,CLRE 251,A00,507176,Mehta; Ravindra L.,9996,0,9999,3
1713336285329,CLRE 251,B00,511410,Mehta; Ravindra L.,9998,0,9999,1
1713336286358,CLRE 252,A00,507189,Cuomo; Raphael Eduardo,9998,0,9999,1
1713336287388,CLRE 253,A00,507199,Vaida; Florin,9997,0,9999,2
1713336287388,CLRE 253,B00,507202,Vaida; Florin,9999,0,9999,0
1713336288418,CLRE 259,A00,507211,Patel; Hemal,9996,0,9999,3
1713336289442,CLRE 260,A00,507221,Cuomo; Raphael Eduardo,9999,0,9999,0
1713336290468,CLRE 297,001,507242,Cuomo; Raphael Eduardo,9999,0,9999,0
1713336291493,CSE 191,A00,516875,Minnes Kemp; Mor Mia,9999,0,9999,0
1713336292518,CSS 201S,A01,494383,Staff,35,0,35,0
1713336293548,CSS 202S,A01,494387,Staff,35,0,35,0
1713336294578,EAP 100,A00,516065,Staff,9792,0,9999,207
1713336295608,ECE 45,A01,507414,Staff,51,0,60,9
1713336296633,ECE 100,A01,507416,Baghdadchi; Saharnaz,10,0,20,10
1713336296633,ECE 100,A02,507418,Baghdadchi; Saharnaz,20,0,20,0
1713336297659,ECE 111,A01,507420,Staff,38,0,50,12
1713336298683,ECE 197,001,548057,Sievenpiper; Daniel F.,9998,0,9999,1
1713336299710,EDS 115,A00,507243,Choi; Bailey Miyeon,28,0,28,0
1713336300739,EDS 117,A01,494379,Staff,23,0,25,2
1713336301768,EDS 125,A00,507246,Hopkins; Megan Beth,29,0,30,1
1713336302795,EDS 128A,A01,507264,Fargason; Sharon Gayle,26,0,26,0
1713336303821,EDS 128B,A01,507293,Pappas; Elizabeth,30,0,30,0
1713336304846,EDS 139,A00,507294,Fargason; Sharon Gayle,30,0,30,0
1713336304846,EDS 139,B00,507313,Pappas; Elizabeth,30,0,30,0
1713336305872,EDS 201,A00,507315,Staff,26,0,30,4
1713336306902,EDS 203,A01,507317,Halter; Christopher P.,26,0,30,4
1713336307927,EDS 204R,A01,507319,Halter; Christopher P.,3,0,30,27
1713336307927,EDS 204R,B01,507331,Heinzman; Erica M.,28,0,30,2
1713336308954,EDS 206R,A00,507332,Staff,4,0,30,26
1713336308954,EDS 206R,B00,507343,Staff,28,0,30,2
1713336309980,EDS 250,A00,507344,Hemans; Patricia Ann Benitez,36,0,40,4
1713336311010,EDS 281,A00,507345,Daly; Alan J.,18,0,18,0
1713336312035,EDS 284,A00,507350,Daly; Alan J.,16,0,16,0
1713336313064,EDS 286,A00,507359,Fine; Sarah,18,0,18,0
1713336314093,EDS 289C,A01,507361,Daly; Alan J.,18,0,18,0
1713336315123,EDS 290,A00,507366,Hofstetter; Carolyn,15,0,15,0
1713336316151,LIGM 5A,A00,507421,Fischer-Grunski; Eva K,20,0,20,0
1713336317181,LIGM 5B,A00,507423,Fischer-Grunski; Eva K,20,0,20,0
1713336318206,LIGM 5C,A00,507425,Fischer-Grunski; Eva K,20,0,20,0
1713336319235,LIIT 5AS,A00,507427,Carnelos; Chiara,20,0,20,0
1713336320261,LIIT 5BS,A00,507430,Carnelos; Chiara,20,0,20,0
1713336321290,LIIT 5CS,A00,507432,Carnelos; Chiara,20,0,20,0
1713336322320,LISP 5A,A00,507541,Munoz Sanchez; Alicia,17,0,20,3
1713336323348,LISP 5B,A00,507671,Munoz Sanchez; Alicia,15,0,20,5
1713336324372,LISP 5C,A00,507696,Munoz Sanchez; Alicia,15,0,20,5
1713336325401,MAE 197,001,528363,Boechler; Nicholas Sebastia,9998,0,9999,1
1713336326427,MATH 197,001,523477,Kedlaya; Kiran S.,9999,0,9999,0
1713336326427,MATH 197,002,563811,Zhang; Danna,9999,0,9999,0
1713336327451,MCWP 40R,A00,518780,Staff,20,0,20,0
1713336327451,MCWP 40R,B00,518781,Staff,19,0,20,1
1713336327451,MCWP 40R,C00,518783,Staff,19,0,20,1
1713336328483,MCWP 50R,A00,518791,Staff,20,0,20,0
1713336328483,MCWP 50R,B00,518792,Staff,17,0,20,3
1713336328483,MCWP 50R,C00,518793,Staff,19,0,20,1
1713336328483,MCWP 50R,D00,518794,Staff,16,0,20,4
1713336328483,MCWP 50R,E00,518795,Staff,16,0,20,4
1713336328483,MCWP 50R,F00,518796,Staff,19,0,20,1
1713336328483,MCWP 50R,G00,518797,Staff,19,0,20,1
1713336329515,MMW 12R,A01,514034,Herbst; Matthew,15,0,16,1
1713336329515,MMW 12R,A02,514035,Herbst; Matthew,16,0,16,0
1713336330540,MMW 13R,A01,514037,Staff,12,0,16,4
1713336330540,MMW 13R,A02,514039,Staff,16,0,16,0
1713336332593,SIO 295LS,A00,523233,Staff,19,0,30,11
1713336333618,SIO 295S,A00,523232,Staff,19,0,30,11
1713336334647,SOCI 117,A01,494376,Staff,2,0,5,3
1713336335674,WES 237B,A00,494380,Staff,19,0,20,1
1713336337749,AESE 279B,A00,494370,Wade; Jon P,33,0,33,0
1713336338774,ANAR 135S,A00,494369,Braswell; Geoffrey E.,0,0,0,0
1713336339801,CAT 124RS,A01,519847,Geibel; William,17,0,20,3
1713336340826,CAT 125RS,A01,515971,Geibel; William,17,0,20,3
1713336341852,CLRE 250,A00,511389,Morris; Sheldon,9996,0,9999,3
1713336342883,CLRE 251,A00,507176,Mehta; Ravindra L.,9996,0,9999,3
1713336342883,CLRE 251,B00,511410,Mehta; Ravindra L.,9998,0,9999,1
1713336343912,CLRE 252,A00,507189,Cuomo; Raphael Eduardo,9998,0,9999,1
1713336344944,CLRE 253,A00,507199,Vaida; Florin,9997,0,9999,2
1713336344944,CLRE 253,B00,507202,Vaida; Florin,9999,0,9999,0
1713336345968,CLRE 259,A00,507211,Patel; Hemal,9996,0,9999,3
1713336346996,CLRE 260,A00,507221,Cuomo; Raphael Eduardo,9999,0,9999,0
1713336348021,CLRE 297,001,507242,Cuomo; Raphael Eduardo,9999,0,9999,0
1713336349052,CSE 191,A00,516875,Minnes Kemp; Mor Mia,9999,0,9999,0
1713336350079,CSS 201S,A01,494383,Staff,35,0,35,0
1713336351107,CSS 202S,A01,494387,Staff,35,0,35,0
1713336352132,EAP 100,A00,516065,Staff,9792,0,9999,207
1713336353158,ECE 45,A01,507414,Staff,51,0,60,9
1713336354184,ECE 100,A01,507416,Baghdadchi; Saharnaz,10,0,20,10
1713336354184,ECE 100,A02,507418,Baghdadchi; Saharnaz,20,0,20,0
1713336355210,ECE 111,A01,507420,Staff,38,0,50,12
1713336356236,ECE 197,001,548057,Sievenpiper; Daniel F.,9998,0,9999,1
1713336357262,EDS 115,A00,507243,Choi; Bailey Miyeon,28,0,28,0
1713336358312,EDS 117,A01,494379,Staff,23,0,25,2
1713336359395,EDS 125,A00,507246,Hopkins; Megan Beth,29,0,30,1
1713336360421,EDS 128A,A01,507264,Fargason; Sharon Gayle,26,0,26,0
1713336361446,EDS 128B,A01,507293,Pappas; Elizabeth,30,0,30,0
1713336362471,EDS 139,A00,507294,Fargason; Sharon Gayle,30,0,30,0
1713336362471,EDS 139,B00,507313,Pappas; Elizabeth,30,0,30,0
1713336363496,EDS 201,A00,507315,Staff,26,0,30,4
1713336364522,EDS 203,A01,507317,Halter; Christopher P.,26,0,30,4
1713336365553,EDS 204R,A01,507319,Halter; Christopher P.,3,0,30,27
1713336365553,EDS 204R,B01,507331,Heinzman; Erica M.,28,0,30,2
1713336366578,EDS 206R,A00,507332,Staff,4,0,30,26
1713336366578,EDS 206R,B00,507343,Staff,28,0,30,2
1713336367604,EDS 250,A00,507344,Hemans; Patricia Ann Benitez,36,0,40,4
1713336368632,EDS 281,A00,507345,Daly; Alan J.,18,0,18,0
1713336369658,EDS 284,A00,507350,Daly; Alan J.,16,0,16,0
1713336370686,EDS 286,A00,507359,Fine; Sarah,18,0,18,0
1713336371712,EDS 289C,A01,507361,Daly; Alan J.,18,0,18,0
1713336372739,EDS 290,A00,507366,Hofstetter; Carolyn,15,0,15,0
1713336373768,LIGM 5A,A00,507421,Fischer-Grunski; Eva K,20,0,20,0
1713336374793,LIGM 5B,A00,507423,Fischer-Grunski; Eva K,20,0,20,0
1713336375818,LIGM 5C,A00,507425,Fischer-Grunski; Eva K,20,0,20,0
1713336376848,LIIT 5AS,A00,507427,Carnelos; Chiara,20,0,20,0
1713336377874,LIIT 5BS,A00,507430,Carnelos; Chiara,20,0,20,0
1713336378898,LIIT 5CS,A00,507432,Carnelos; Chiara,20,0,20,0
1713336379924,LISP 5A,A00,507541,Munoz Sanchez; Alicia,17,0,20,3
1713336380950,LISP 5B,A00,507671,Munoz Sanchez; Alicia,15,0,20,5
1713336381974,LISP 5C,A00,507696,Munoz Sanchez; Alicia,15,0,20,5
1713336382999,MAE 197,001,528363,Boechler; Nicholas Sebastia,9998,0,9999,1
1713336384028,MATH 197,001,523477,Kedlaya; Kiran S.,9999,0,9999,0
1713336384028,MATH 197,002,563811,Zhang; Danna,9999,0,9999,0
1713336385052,MCWP 40R,A00,518780,Staff,20,0,20,0
1713336385052,MCWP 40R,B00,518781,Staff,19,0,20,1
1713336385052,MCWP 40R,C00,518783,Staff,19,0,20,1
1713336386084,MCWP 50R,A00,518791,Staff,20,0,20,0
1713336386084,MCWP 50R,B00,518792,Staff,17,0,20,3
1713336386084,MCWP 50R,C00,518793,Staff,19,0,20,1
1713336386084,MCWP 50R,D00,518794,Staff,16,0,20,4
1713336386084,MCWP 50R,E00,518795,Staff,16,0,20,4
1713336386084,MCWP 50R,F00,518796,Staff,19,0,20,1
1713336386084,MCWP 50R,G00,518797,Staff,19,0,20,1
1713336387113,MMW 12R,A01,514034,Herbst; Matthew,15,0,16,1
1713336387113,MMW 12R,A02,514035,Herbst; Matthew,16,0,16,0
1713336388142,MMW 13R,A01,514037,Staff,12,0,16,4
1713336388142,MMW 13R,A02,514039,Staff,16,0,16,0
1713336390199,SIO 295LS,A00,523233,Staff,19,0,30,11
1713336391228,SIO 295S,A00,523232,Staff,19,0,30,11
1713336392255,SOCI 117,A01,494376,Staff,2,0,5,3
1713336393283,WES 237B,A00,494380,Staff,19,0,20,1
1713336395365,AESE 279B,A00,494370,Wade; Jon P,33,0,33,0
1713336396394,ANAR 135S,A00,494369,Braswell; Geoffrey E.,0,0,0,0
1713336397419,CAT 124RS,A01,519847,Geibel; William,17,0,20,3
1713336398445,CAT 125RS,A01,515971,Geibel; William,17,0,20,3
1713336399470,CLRE 250,A00,511389,Morris; Sheldon,9996,0,9999,3
1713336400496,CLRE 251,A00,507176,Mehta; Ravindra L.,9996,0,9999,3
1713336400496,CLRE 251,B00,511410,Mehta; Ravindra L.,9998,0,9999,1
1713336401527,CLRE 252,A00,507189,Cuomo; Raphael Eduardo,9998,0,9999,1
1713336402556,CLRE 253,A00,507199,Vaida; Florin,9997,0,9999,2
1713336402556,CLRE 253,B00,507202,Vaida; Florin,9999,0,9999,0
1713336403580,CLRE 259,A00,507211,Patel; Hemal,9996,0,9999,3
1713336404610,CLRE 260,A00,507221,Cuomo; Raphael Eduardo,9999,0,9999,0
1713336405635,CLRE 297,001,507242,Cuomo; Raphael Eduardo,9999,0,9999,0
1713336406660,CSE 191,A00,516875,Minnes Kemp; Mor Mia,9999,0,9999,0
1713336407687,CSS 201S,A01,494383,Staff,35,0,35,0
1713336408718,CSS 202S,A01,494387,Staff,35,0,35,0
1713336409743,EAP 100,A00,516065,Staff,9792,0,9999,207
1713336410767,ECE 45,A01,507414,Staff,51,0,60,9
1713336411794,ECE 100,A01,507416,Baghdadchi; Saharnaz,10,0,20,10
1713336411794,ECE 100,A02,507418,Baghdadchi; Saharnaz,20,0,20,0
1713336412823,ECE 111,A01,507420,Staff,38,0,50,12
1713336413862,ECE 197,001,548057,Sievenpiper; Daniel F.,9998,0,9999,1
1713336414894,EDS 115,A00,507243,Choi; Bailey Miyeon,28,0,28,0
1713336415924,EDS 117,A01,494379,Staff,23,0,25,2
1713336416950,EDS 125,A00,507246,Hopkins; Megan Beth,29,0,30,1
1713336417977,EDS 128A,A01,507264,Fargason; Sharon Gayle,26,0,26,0
1713336419008,EDS 128B,A01,507293,Pappas; Elizabeth,30,0,30,0
1713336420039,EDS 139,A00,507294,Fargason; Sharon Gayle,30,0,30,0
1713336420039,EDS 139,B00,507313,Pappas; Elizabeth,30,0,30,0
1713336421068,EDS 201,A00,507315,Staff,26,0,30,4
1713336422097,EDS 203,A01,507317,Halter; Christopher P.,26,0,30,4
1713336423127,EDS 204R,A01,507319,Halter; Christopher P.,3,0,30,27
1713336423127,EDS 204R,B01,507331,Heinzman; Erica M.,28,0,30,2
1713336424154,EDS 206R,A00,507332,Staff,4,0,30,26
1713336424154,EDS 206R,B00,507343,Staff,28,0,30,2
1713336425183,EDS 250,A00,507344,Hemans; Patricia Ann Benitez,36,0,40,4
1713336426209,EDS 281,A00,507345,Daly; Alan J.,18,0,18,0
1713336427240,EDS 284,A00,507350,Daly; Alan J.,16,0,16,0
1713336428265,EDS 286,A00,507359,Fine; Sarah,18,0,18,0
1713336429291,EDS 289C,A01,507361,Daly; Alan J.,18,0,18,0
1713336430320,EDS 290,A00,507366,Hofstetter; Carolyn,15,0,15,0
1713336431346,LIGM 5A,A00,507421,Fischer-Grunski; Eva K,20,0,20,0
1713336432372,LIGM 5B,A00,507423,Fischer-Grunski; Eva K,20,0,20,0
1713336433397,LIGM 5C,A00,507425,Fischer-Grunski; Eva K,20,0,20,0
1713336434423,LIIT 5AS,A00,507427,Carnelos; Chiara,20,0,20,0
1713336435453,LIIT 5BS,A00,507430,Carnelos; Chiara,20,0,20,0
1713336436478,LIIT 5CS,A00,507432,Carnelos; Chiara,20,0,20,0
1713336437509,LISP 5A,A00,507541,Munoz Sanchez; Alicia,17,0,20,3
1713336438534,LISP 5B,A00,507671,Munoz Sanchez; Alicia,15,0,20,5
1713336439563,LISP 5C,A00,507696,Munoz Sanchez; Alicia,15,0,20,5
1713336440593,MAE 197,001,528363,Boechler; Nicholas Sebastia,9998,0,9999,1
1713336441618,MATH 197,001,523477,Kedlaya; Kiran S.,9999,0,9999,0
1713336441618,MATH 197,002,563811,Zhang; Danna,9999,0,9999,0
1713336442648,MCWP 40R,A00,518780,Staff,20,0,20,0
1713336442648,MCWP 40R,B00,518781,Staff,19,0,20,1
1713336442648,MCWP 40R,C00,518783,Staff,19,0,20,1
1713336443674,MCWP 50R,A00,518791,Staff,20,0,20,0
1713336443674,MCWP 50R,B00,518792,Staff,17,0,20,3
1713336443674,MCWP 50R,C00,518793,Staff,19,0,20,1
1713336443674,MCWP 50R,D00,518794,Staff,16,0,20,4
1713336443674,MCWP 50R,E00,518795,Staff,16,0,20,4
1713336443674,MCWP 50R,F00,518796,Staff,19,0,20,1
1713336443674,MCWP 50R,G00,518797,Staff,19,0,20,1
1713336444710,MMW 12R,A01,514034,Herbst; Matthew,15,0,16,1
1713336444710,MMW 12R,A02,514035,Herbst; Matthew,16,0,16,0
1713336445737,MMW 13R,A01,514037,Staff,12,0,16,4
1713336445737,MMW 13R,A02,514039,Staff,16,0,16,0
1713336447788,SIO 295LS,A00,523233,Staff,19,0,30,11
1713336448817,SIO 295S,A00,523232,Staff,19,0,30,11
1713336449846,SOCI 117,A01,494376,Staff,2,0,5,3
1713336450874,WES 237B,A00,494380,Staff,19,0,20,1
1713336452954,AESE 279B,A00,494370,Wade; Jon P,33,0,33,0
1713336453982,ANAR 135S,A00,494369,Braswell; Geoffrey E.,0,0,0,0
1713336455008,CAT 124RS,A01,519847,Geibel; William,17,0,20,3
1713336456036,CAT 125RS,A01,515971,Geibel; William,17,0,20,3
1713336457063,CLRE 250,A00,511389,Morris; Sheldon,9996,0,9999,3
1713336458097,CLRE 251,A00,507176,Mehta; Ravindra L.,9996,0,9999,3
1713336458097,CLRE 251,B00,511410,Mehta; Ravindra L.,9998,0,9999,1
1713336459123,CLRE 252,A00,507189,Cuomo; Raphael Eduardo,9998,0,9999,1
1713336460155,CLRE 253,A00,507199,Vaida; Florin,9997,0,9999,2
1713336460155,CLRE 253,B00,507202,Vaida; Florin,9999,0,9999,0
1713336461184,CLRE 259,A00,507211,Patel; Hemal,9996,0,9999,3
1713336462210,CLRE 260,A00,507221,Cuomo; Raphael Eduardo,9999,0,9999,0
1713336463292,CLRE 297,001,507242,Cuomo; Raphael Eduardo,9999,0,9999,0
1713336464319,CSE 191,A00,516875,Minnes Kemp; Mor Mia,9999,0,9999,0
1713336465344,CSS 201S,A01,494383,Staff,35,0,35,0
1713336466375,CSS 202S,A01,494387,Staff,35,0,35,0
1713336467399,EAP 100,A00,516065,Staff,9792,0,9999,207
1713336468424,ECE 45,A01,507414,Staff,51,0,60,9
1713336469450,ECE 100,A01,507416,Baghdadchi; Saharnaz,10,0,20,10
1713336469450,ECE 100,A02,507418,Baghdadchi; Saharnaz,20,0,20,0
1713336470477,ECE 111,A01,507420,Staff,38,0,50,12
1713336471501,ECE 197,001,548057,Sievenpiper; Daniel F.,9998,0,9999,1
1713336472528,EDS 115,A00,507243,Choi; Bailey Miyeon,28,0,28,0
1713336473558,EDS 117,A01,494379,Staff,23,0,25,2
1713336474589,EDS 125,A00,507246,Hopkins; Megan Beth,29,0,30,1
1713336475614,EDS 128A,A01,507264,Fargason; Sharon Gayle,26,0,26,0
1713336476642,EDS 128B,A01,507293,Pappas; Elizabeth,30,0,30,0
1713336477669,EDS 139,A00,507294,Fargason; Sharon Gayle,30,0,30,0
1713336477669,EDS 139,B00,507313,Pappas; Elizabeth,30,0,30,0
1713336478697,EDS 201,A00,507315,Staff,26,0,30,4
1713336479728,EDS 203,A01,507317,Halter; Christopher P.,26,0,30,4
1713336480754,EDS 204R,A01,507319,Halter; Christopher P.,3,0,30,27
1713336480754,EDS 204R,B01,507331,Heinzman; Erica M.,28,0,30,2
1713336481784,EDS 206R,A00,507332,Staff,4,0,30,26
1713336481784,EDS 206R,B00,507343,Staff,28,0,30,2
1713336482812,EDS 250,A00,507344,Hemans; Patricia Ann Benitez,36,0,40,4
1713336483838,EDS 281,A00,507345,Daly; Alan J.,18,0,18,0
1713336484862,EDS 284,A00,507350,Daly; Alan J.,16,0,16,0
1713336485889,EDS 286,A00,507359,Fine; Sarah,18,0,18,0
1713336486913,EDS 289C,A01,507361,Daly; Alan J.,18,0,18,0
1713336487940,EDS 290,A00,507366,Hofstetter; Carolyn,15,0,15,0
1713336488972,LIGM 5A,A00,507421,Fischer-Grunski; Eva K,20,0,20,0
1713336489997,LIGM 5B,A00,507423,Fischer-Grunski; Eva K,20,0,20,0
1713336491026,LIGM 5C,A00,507425,Fischer-Grunski; Eva K,20,0,20,0
1713336492058,LIIT 5AS,A00,507427,Carnelos; Chiara,20,0,20,0
1713336493088,LIIT 5BS,A00,507430,Carnelos; Chiara,20,0,20,0
1713336494114,LIIT 5CS,A00,507432,Carnelos; Chiara,20,0,20,0
1713336495146,LISP 5A,A00,507541,Munoz Sanchez; Alicia,17,0,20,3
1713336496176,LISP 5B,A00,507671,Munoz Sanchez; Alicia,15,0,20,5
1713336497201,LISP 5C,A00,507696,Munoz Sanchez; Alicia,15,0,20,5
1713336498225,MAE 197,001,528363,Boechler; Nicholas Sebastia,9998,0,9999,1
1713336499252,MATH 197,001,523477,Kedlaya; Kiran S.,9999,0,9999,0
1713336499252,MATH 197,002,563811,Zhang; Danna,9999,0,9999,0
1713336500276,MCWP 40R,A00,518780,Staff,20,0,20,0
1713336500276,MCWP 40R,B00,518781,Staff,19,0,20,1
1713336500276,MCWP 40R,C00,518783,Staff,19,0,20,1
1713336501311,MCWP 50R,A00,518791,Staff,20,0,20,0
1713336501311,MCWP 50R,B00,518792,Staff,17,0,20,3
1713336501311,MCWP 50R,C00,518793,Staff,19,0,20,1
1713336501311,MCWP 50R,D00,518794,Staff,16,0,20,4
1713336501311,MCWP 50R,E00,518795,Staff,16,0,20,4
1713336501311,MCWP 50R,F00,518796,Staff,19,0,20,1
1713336501311,MCWP 50R,G00,518797,Staff,19,0,20,1
1713336502343,MMW 12R,A01,514034,Herbst; Matthew,15,0,16,1
1713336502343,MMW 12R,A02,514035,Herbst; Matthew,16,0,16,0
1713336503368,MMW 13R,A01,514037,Staff,12,0,16,4
1713336503368,MMW 13R,A02,514039,Staff,16,0,16,0
1713336505419,SIO 295LS,A00,523233,Staff,19,0,30,11
1713336506443,SIO 295S,A00,523232,Staff,19,0,30,11
1713336507470,SOCI 117,A01,494376,Staff,2,0,5,3
1713336508496,WES 237B,A00,494380,Staff,19,0,20,1
1713336510573,AESE 279B,A00,494370,Wade; Jon P,33,0,33,0
1713336511598,ANAR 135S,A00,494369,Braswell; Geoffrey E.,0,0,0,0
1713336512630,CAT 124RS,A01,519847,Geibel; William,17,0,20,3
1713336513659,CAT 125RS,A01,515971,Geibel; William,17,0,20,3
1713336514688,CLRE 250,A00,511389,Morris; Sheldon,9996,0,9999,3
1713336515713,CLRE 251,A00,507176,Mehta; Ravindra L.,9996,0,9999,3
1713336515713,CLRE 251,B00,511410,Mehta; Ravindra L.,9998,0,9999,1
1713336516742,CLRE 252,A00,507189,Cuomo; Raphael Eduardo,9998,0,9999,1
1713336517771,CLRE 253,A00,507199,Vaida; Florin,9997,0,9999,2
1713336517771,CLRE 253,B00,507202,Vaida; Florin,9999,0,9999,0
1713336518796,CLRE 259,A00,507211,Patel; Hemal,9996,0,9999,3
1713336519822,CLRE 260,A00,507221,Cuomo; Raphael Eduardo,9999,0,9999,0
1713336520845,CLRE 297,001,507242,Cuomo; Raphael Eduardo,9999,0,9999,0
1713336521871,CSE 191,A00,516875,Minnes Kemp; Mor Mia,9999,0,9999,0
1713336522898,CSS 201S,A01,494383,Staff,35,0,35,0
1713336523923,CSS 202S,A01,494387,Staff,35,0,35,0
1713336524953,EAP 100,A00,516065,Staff,9792,0,9999,207
1713336525979,ECE 45,A01,507414,Staff,51,0,60,9
1713336527006,ECE 100,A01,507416,Baghdadchi; Saharnaz,10,0,20,10
1713336527006,ECE 100,A02,507418,Baghdadchi; Saharnaz,20,0,20,0
1713336528032,ECE 111,A01,507420,Staff,38,0,50,12
1713336529060,ECE 197,001,548057,Sievenpiper; Daniel F.,9998,0,9999,1
1713336530087,EDS 115,A00,507243,Choi; Bailey Miyeon,28,0,28,0
1713336531114,EDS 117,A01,494379,Staff,23,0,25,2
1713336532144,EDS 125,A00,507246,Hopkins; Megan Beth,29,0,30,1
1713336533170,EDS 128A,A01,507264,Fargason; Sharon Gayle,26,0,26,0
1713336534196,EDS 128B,A01,507293,Pappas; Elizabeth,30,0,30,0
1713336535225,EDS 139,A00,507294,Fargason; Sharon Gayle,30,0,30,0
1713336535225,EDS 139,B00,507313,Pappas; Elizabeth,30,0,30,0
1713336536254,EDS 201,A00,507315,Staff,26,0,30,4
1713336537281,EDS 203,A01,507317,Halter; Christopher P.,26,0,30,4
1713336538329,EDS 204R,A01,507319,Halter; Christopher P.,3,0,30,27
1713336538329,EDS 204R,B01,507331,Heinzman; Erica M.,28,0,30,2
1713336539358,EDS 206R,A00,507332,Staff,4,0,30,26
1713336539358,EDS 206R,B00,507343,Staff,28,0,30,2
1713336540384,EDS 250,A00,507344,Hemans; Patricia Ann Benitez,36,0,40,4
1713336541414,EDS 281,A00,507345,Daly; Alan J.,18,0,18,0
1713336542443,EDS 284,A00,507350,Daly; Alan J.,16,0,16,0
1713336543474,EDS 286,A00,507359,Fine; Sarah,18,0,18,0
1713336544502,EDS 289C,A01,507361,Daly; Alan J.,18,0,18,0
1713336545531,EDS 290,A00,507366,Hofstetter; Carolyn,15,0,15,0
1713336546558,LIGM 5A,A00,507421,Fischer-Grunski; Eva K,20,0,20,0
1713336547585,LIGM 5B,A00,507423,Fischer-Grunski; Eva K,20,0,20,0
1713336548616,LIGM 5C,A00,507425,Fischer-Grunski; Eva K,20,0,20,0
1713336549643,LIIT 5AS,A00,507427,Carnelos; Chiara,20,0,20,0
1713336550667,LIIT 5BS,A00,507430,Carnelos; Chiara,20,0,20,0
1713336551693,LIIT 5CS,A00,507432,Carnelos; Chiara,20,0,20,0
1713336552719,LISP 5A,A00,507541,Munoz Sanchez; Alicia,17,0,20,3
1713336553744,LISP 5B,A00,507671,Munoz Sanchez; Alicia,15,0,20,5
1713336554773,LISP 5C,A00,507696,Munoz Sanchez; Alicia,15,0,20,5
1713336555799,MAE 197,001,528363,Boechler; Nicholas Sebastia,9998,0,9999,1
1713336556826,MATH 197,001,523477,Kedlaya; Kiran S.,9999,0,9999,0
1713336556826,MATH 197,002,563811,Zhang; Danna,9999,0,9999,0
1713336557857,MCWP 40R,A00,518780,Staff,20,0,20,0
1713336557857,MCWP 40R,B00,518781,Staff,19,0,20,1
1713336557857,MCWP 40R,C00,518783,Staff,19,0,20,1
1713336558883,MCWP 50R,A00,518791,Staff,20,0,20,0
1713336558883,MCWP 50R,B00,518792,Staff,17,0,20,3
1713336558883,MCWP 50R,C00,518793,Staff,19,0,20,1
1713336558883,MCWP 50R,D00,518794,Staff,16,0,20,4
1713336558883,MCWP 50R,E00,518795,Staff,16,0,20,4
1713336558883,MCWP 50R,F00,518796,Staff,19,0,20,1
1713336558883,MCWP 50R,G00,518797,Staff,19,0,20,1
1713336559912,MMW 12R,A01,514034,Herbst; Matthew,15,0,16,1
1713336559912,MMW 12R,A02,514035,Herbst; Matthew,16,0,16,0
1713336560936,MMW 13R,A01,514037,Staff,12,0,16,4
1713336560936,MMW 13R,A02,514039,Staff,16,0,16,0
1713336562990,SIO 295LS,A00,523233,Staff,19,0,30,11
1713336564018,SIO 295S,A00,523232,Staff,19,0,30,11
1713336565042,SOCI 117,A01,494376,Staff,2,0,5,3
1713336566070,WES 237B,A00,494380,Staff,19,0,20,1
1713336568198,AESE 279B,A00,494370,Wade; Jon P,33,0,33,0
1713336569224,ANAR 135S,A00,494369,Braswell; Geoffrey E.,0,0,0,0
1713336570249,CAT 124RS,A01,519847,Geibel; William,17,0,20,3
1713336571274,CAT 125RS,A01,515971,Geibel; William,17,0,20,3
1713336572305,CLRE 250,A00,511389,Morris; Sheldon,9996,0,9999,3
1713336573331,CLRE 251,A00,507176,Mehta; Ravindra L.,9996,0,9999,3
1713336573331,CLRE 251,B00,511410,Mehta; Ravindra L.,9998,0,9999,1
1713336574363,CLRE 252,A00,507189,Cuomo; Raphael Eduardo,9998,0,9999,1
1713336575387,CLRE 253,A00,507199,Vaida; Florin,9997,0,9999,2
1713336575387,CLRE 253,B00,507202,Vaida; Florin,9999,0,9999,0
1713336576412,CLRE 259,A00,507211,Patel; Hemal,9996,0,9999,3
1713336577438,CLRE 260,A00,507221,Cuomo; Raphael Eduardo,9999,0,9999,0
1713336578462,CLRE 297,001,507242,Cuomo; Raphael Eduardo,9999,0,9999,0
1713336579488,CSE 191,A00,516875,Minnes Kemp; Mor Mia,9999,0,9999,0
1713336580519,CSS 201S,A01,494383,Staff,35,0,35,0
1713336581547,CSS 202S,A01,494387,Staff,35,0,35,0
1713336582573,EAP 100,A00,516065,Staff,9792,0,9999,207
1713336583598,ECE 45,A01,507414,Staff,51,0,60,9
1713336584624,ECE 100,A01,507416,Baghdadchi; Saharnaz,10,0,20,10
1713336584624,ECE 100,A02,507418,Baghdadchi; Saharnaz,20,0,20,0
1713336585650,ECE 111,A01,507420,Staff,38,0,50,12
1713336586680,ECE 197,001,548057,Sievenpiper; Daniel F.,9998,0,9999,1
1713336587712,EDS 115,A00,507243,Choi; Bailey Miyeon,28,0,28,0
1713336588743,EDS 117,A01,494379,Staff,23,0,25,2
1713336589770,EDS 125,A00,507246,Hopkins; Megan Beth,29,0,30,1
1713336590803,EDS 128A,A01,507264,Fargason; Sharon Gayle,26,0,26,0
1713336591830,EDS 128B,A01,507293,Pappas; Elizabeth,30,0,30,0
1713336592855,EDS 139,A00,507294,Fargason; Sharon Gayle,30,0,30,0
1713336592855,EDS 139,B00,507313,Pappas; Elizabeth,30,0,30,0
1713336593882,EDS 201,A00,507315,Staff,26,0,30,4
1713336594908,EDS 203,A01,507317,Halter; Christopher P.,26,0,30,4
1713336595933,EDS 204R,A01,507319,Halter; Christopher P.,3,0,30,27
1713336595933,EDS 204R,B01,507331,Heinzman; Erica M.,28,0,30,2
1713336596957,EDS 206R,A00,507332,Staff,4,0,30,26
1713336596957,EDS 206R,B00,507343,Staff,28,0,30,2
1713336597988,EDS 250,A00,507344,Hemans; Patricia Ann Benitez,36,0,40,4
1713336599015,EDS 281,A00,507345,Daly; Alan J.,18,0,18,0
1713336600041,EDS 284,A00,507350,Daly; Alan J.,16,0,16,0
1713336601066,EDS 286,A00,507359,Fine; Sarah,18,0,18,0
1713336602094,EDS 289C,A01,507361,Daly; Alan J.,18,0,18,0
1713336603122,EDS 290,A00,507366,Hofstetter; Carolyn,15,0,15,0
1713336604148,LIGM 5A,A00,507421,Fischer-Grunski; Eva K,20,0,20,0
1713336605178,LIGM 5B,A00,507423,Fischer-Grunski; Eva K,20,0,20,0
1713336606209,LIGM 5C,A00,507425,Fischer-Grunski; Eva K,20,0,20,0
1713336607236,LIIT 5AS,A00,507427,Carnelos; Chiara,20,0,20,0
1713336608266,LIIT 5BS,A00,507430,Carnelos; Chiara,20,0,20,0
1713336609294,LIIT 5CS,A00,507432,Carnelos; Chiara,20,0,20,0
1713336610319,LISP 5A,A00,507541,Munoz Sanchez; Alicia,17,0,20,3
1713336611346,LISP 5B,A00,507671,Munoz Sanchez; Alicia,15,0,20,5
1713336612374,LISP 5C,A00,507696,Munoz Sanchez; Alicia,15,0,20,5
1713336613400,MAE 197,001,528363,Boechler; Nicholas Sebastia,9998,0,9999,1
1713336614426,MATH 197,001,523477,Kedlaya; Kiran S.,9999,0,9999,0
1713336614426,MATH 197,002,563811,Zhang; Danna,9999,0,9999,0
1713336615454,MCWP 40R,A00,518780,Staff,20,0,20,0
1713336615454,MCWP 40R,B00,518781,Staff,19,0,20,1
1713336615454,MCWP 40R,C00,518783,Staff,19,0,20,1
1713336616479,MCWP 50R,A00,518791,Staff,20,0,20,0
1713336616479,MCWP 50R,B00,518792,Staff,17,0,20,3
1713336616479,MCWP 50R,C00,518793,Staff,19,0,20,1
1713336616479,MCWP 50R,D00,518794,Staff,16,0,20,4
1713336616479,MCWP 50R,E00,518795,Staff,16,0,20,4
1713336616479,MCWP 50R,F00,518796,Staff,19,0,20,1
1713336616479,MCWP 50R,G00,518797,Staff,19,0,20,1
1713336617510,MMW 12R,A01,514034,Herbst; Matthew,15,0,16,1
1713336617510,MMW 12R,A02,514035,Herbst; Matthew,16,0,16,0
1713336618537,MMW 13R,A01,514037,Staff,12,0,16,4
1713336618537,MMW 13R,A02,514039,Staff,16,0,16,0
1713336620714,SIO 295LS,A00,523233,Staff,19,0,30,11
1713336621742,SIO 295S,A00,523232,Staff,19,0,30,11
1713336622768,SOCI 117,A01,494376,Staff,2,0,5,3
1713336623797,WES 237B,A00,494380,Staff,19,0,20,1
1713336625863,AESE 279B,A00,494370,Wade; Jon P,33,0,33,0
1713336626894,ANAR 135S,A00,494369,Braswell; Geoffrey E.,0,0,0,0
1713336627919,CAT 124RS,A01,519847,Geibel; William,17,0,20,3
1713336628950,CAT 125RS,A01,515971,Geibel; William,17,0,20,3
1713336629982,CLRE 250,A00,511389,Morris; Sheldon,9996,0,9999,3
1713336631018,CLRE 251,A00,507176,Mehta; Ravindra L.,9996,0,9999,3
1713336631018,CLRE 251,B00,511410,Mehta; Ravindra L.,9998,0,9999,1
1713336632049,CLRE 252,A00,507189,Cuomo; Raphael Eduardo,9998,0,9999,1
1713336633079,CLRE 253,A00,507199,Vaida; Florin,9997,0,9999,2
1713336633079,CLRE 253,B00,507202,Vaida; Florin,9999,0,9999,0
1713336634105,CLRE 259,A00,507211,Patel; Hemal,9996,0,9999,3
1713336635133,CLRE 260,A00,507221,Cuomo; Raphael Eduardo,9999,0,9999,0
1713336636157,CLRE 297,001,507242,Cuomo; Raphael Eduardo,9999,0,9999,0
1713336637180,CSE 191,A00,516875,Minnes Kemp; Mor Mia,9999,0,9999,0
1713336638207,CSS 201S,A01,494383,Staff,35,0,35,0
1713336639234,CSS 202S,A01,494387,Staff,35,0,35,0
1713336640262,EAP 100,A00,516065,Staff,9792,0,9999,207
1713336641296,ECE 45,A01,507414,Staff,51,0,60,9
1713336642327,ECE 100,A01,507416,Baghdadchi; Saharnaz,10,0,20,10
1713336642327,ECE 100,A02,507418,Baghdadchi; Saharnaz,20,0,20,0
1713336643353,ECE 111,A01,507420,Staff,38,0,50,12
1713336644378,ECE 197,001,548057,Sievenpiper; Daniel F.,9998,0,9999,1
1713336645403,EDS 115,A00,507243,Choi; Bailey Miyeon,28,0,28,0
1713336646431,EDS 117,A01,494379,Staff,23,0,25,2
1713336647456,EDS 125,A00,507246,Hopkins; Megan Beth,29,0,30,1
1713336648483,EDS 128A,A01,507264,Fargason; Sharon Gayle,26,0,26,0
1713336649508,EDS 128B,A01,507293,Pappas; Elizabeth,30,0,30,0
1713336650537,EDS 139,A00,507294,Fargason; Sharon Gayle,30,0,30,0
1713336650537,EDS 139,B00,507313,Pappas; Elizabeth,30,0,30,0
1713336651561,EDS 201,A00,507315,Staff,26,0,30,4
1713336652592,EDS 203,A01,507317,Halter; Christopher P.,26,0,30,4
1713336653622,EDS 204R,A01,507319,Halter; Christopher P.,3,0,30,27
1713336653622,EDS 204R,B01,507331,Heinzman; Erica M.,28,0,30,2
1713336654648,EDS 206R,A00,507332,Staff,4,0,30,26
1713336654648,EDS 206R,B00,507343,Staff,28,0,30,2
1713336655674,EDS 250,A00,507344,Hemans; Patricia Ann Benitez,36,0,40,4
1713336656698,EDS 281,A00,507345,Daly; Alan J.,18,0,18,0
1713336657726,EDS 284,A00,507350,Daly; Alan J.,16,0,16,0
1713336658752,EDS 286,A00,507359,Fine; Sarah,18,0,18,0
1713336659777,EDS 289C,A01,507361,Daly; Alan J.,18,0,18,0
1713336660804,EDS 290,A00,507366,Hofstetter; Carolyn,15,0,15,0
1713336661836,LIGM 5A,A00,507421,Fischer-Grunski; Eva K,20,0,20,0
1713336662865,LIGM 5B,A00,507423,Fischer-Grunski; Eva K,20,0,20,0
1713336663894,LIGM 5C,A00,507425,Fischer-Grunski; Eva K,20,0,20,0
1713336664928,LIIT 5AS,A00,507427,Carnelos; Chiara,20,0,20,0
1713336665959,LIIT 5BS,A00,507430,Carnelos; Chiara,20,0,20,0
1713336666990,LIIT 5CS,A00,507432,Carnelos; Chiara,20,0,20,0
1713336668020,LISP 5A,A00,507541,Munoz Sanchez; Alicia,17,0,20,3
1713336669046,LISP 5B,A00,507671,Munoz Sanchez; Alicia,15,0,20,5
1713336670076,LISP 5C,A00,507696,Munoz Sanchez; Alicia,15,0,20,5
1713336671161,MAE 197,001,528363,Boechler; Nicholas Sebastia,9998,0,9999,1
1713336672193,MATH 197,001,523477,Kedlaya; Kiran S.,9999,0,9999,0
1713336672193,MATH 197,002,563811,Zhang; Danna,9999,0,9999,0
1713336673220,MCWP 40R,A00,518780,Staff,20,0,20,0
1713336673220,MCWP 40R,B00,518781,Staff,19,0,20,1
1713336673220,MCWP 40R,C00,518783,Staff,19,0,20,1
1713336674247,MCWP 50R,A00,518791,Staff,20,0,20,0
1713336674247,MCWP 50R,B00,518792,Staff,17,0,20,3
1713336674247,MCWP 50R,C00,518793,Staff,19,0,20,1
1713336674247,MCWP 50R,D00,518794,Staff,16,0,20,4
1713336674247,MCWP 50R,E00,518795,Staff,16,0,20,4
1713336674247,MCWP 50R,F00,518796,Staff,19,0,20,1
1713336674247,MCWP 50R,G00,518797,Staff,19,0,20,1
1713336675272,MMW 12R,A01,514034,Herbst; Matthew,15,0,16,1
1713336675272,MMW 12R,A02,514035,Herbst; Matthew,16,0,16,0
1713336676298,MMW 13R,A01,514037,Staff,12,0,16,4
1713336676298,MMW 13R,A02,514039,Staff,16,0,16,0
1713336678345,SIO 295LS,A00,523233,Staff,19,0,30,11
1713336679374,SIO 295S,A00,523232,Staff,19,0,30,11
1713336680400,SOCI 117,A01,494376,Staff,2,0,5,3
1713336681425,WES 237B,A00,494380,Staff,19,0,20,1
1713336683490,AESE 279B,A00,494370,Wade; Jon P,33,0,33,0
1713336684514,ANAR 135S,A00,494369,Braswell; Geoffrey E.,0,0,0,0
1713336685540,CAT 124RS,A01,519847,Geibel; William,17,0,20,3
1713336686565,CAT 125RS,A01,515971,Geibel; William,17,0,20,3
1713336687597,CLRE 250,A00,511389,Morris; Sheldon,9996,0,9999,3
1713336688635,CLRE 251,A00,507176,Mehta; Ravindra L.,9996,0,9999,3
1713336688635,CLRE 251,B00,511410,Mehta; Ravindra L.,9998,0,9999,1
1713336689664,CLRE 252,A00,507189,Cuomo; Raphael Eduardo,9998,0,9999,1
1713336690695,CLRE 253,A00,507199,Vaida; Florin,9997,0,9999,2
1713336690695,CLRE 253,B00,507202,Vaida; Florin,9999,0,9999,0
1713336691725,CLRE 259,A00,507211,Patel; Hemal,9996,0,9999,3
1713336692750,CLRE 260,A00,507221,Cuomo; Raphael Eduardo,9999,0,9999,0
1713336693775,CLRE 297,001,507242,Cuomo; Raphael Eduardo,9999,0,9999,0
1713336694806,CSE 191,A00,516875,Minnes Kemp; Mor Mia,9999,0,9999,0
1713336695834,CSS 201S,A01,494383,Staff,35,0,35,0
1713336696865,CSS 202S,A01,494387,Staff,35,0,35,0
1713336697891,EAP 100,A00,516065,Staff,9792,0,9999,207
1713336698924,ECE 45,A01,507414,Staff,51,0,60,9
1713336699954,ECE 100,A01,507416,Baghdadchi; Saharnaz,10,0,20,10
1713336699954,ECE 100,A02,507418,Baghdadchi; Saharnaz,20,0,20,0
1713336700979,ECE 111,A01,507420,Staff,38,0,50,12
1713336702004,ECE 197,001,548057,Sievenpiper; Daniel F.,9998,0,9999,1
1713336703030,EDS 115,A00,507243,Choi; Bailey Miyeon,28,0,28,0
1713336704054,EDS 117,A01,494379,Staff,23,0,25,2
1713336705080,EDS 125,A00,507246,Hopkins; Megan Beth,29,0,30,1
1713336706109,EDS 128A,A01,507264,Fargason; Sharon Gayle,26,0,26,0
1713336707135,EDS 128B,A01,507293,Pappas; Elizabeth,30,0,30,0
1713336708161,EDS 139,A00,507294,Fargason; Sharon Gayle,30,0,30,0
1713336708161,EDS 139,B00,507313,Pappas; Elizabeth,30,0,30,0
1713336709187,EDS 201,A00,507315,Staff,26,0,30,4
1713336710220,EDS 203,A01,507317,Halter; Christopher P.,26,0,30,4
1713336711246,EDS 204R,A01,507319,Halter; Christopher P.,3,0,30,27
1713336711246,EDS 204R,B01,507331,Heinzman; Erica M.,28,0,30,2
1713336712273,EDS 206R,A00,507332,Staff,4,0,30,26
1713336712273,EDS 206R,B00,507343,Staff,28,0,30,2
1713336713298,EDS 250,A00,507344,Hemans; Patricia Ann Benitez,36,0,40,4
1713336714327,EDS 281,A00,507345,Daly; Alan J.,18,0,18,0
1713336715351,EDS 284,A00,507350,Daly; Alan J.,16,0,16,0
1713336716376,EDS 286,A00,507359,Fine; Sarah,18,0,18,0
1713336717401,EDS 289C,A01,507361,Daly; Alan J.,18,0,18,0
1713336718426,EDS 290,A00,507366,Hofstetter; Carolyn,15,0,15,0
1713336719458,LIGM 5A,A00,507421,Fischer-Grunski; Eva K,20,0,20,0
1713336720483,LIGM 5B,A00,507423,Fischer-Grunski; Eva K,20,0,20,0
1713336721509,LIGM 5C,A00,507425,Fischer-Grunski; Eva K,20,0,20,0
1713336722534,LIIT 5AS,A00,507427,Carnelos; Chiara,20,0,20,0
1713336723561,LIIT 5BS,A00,507430,Carnelos; Chiara,20,0,20,0
1713336724590,LIIT 5CS,A00,507432,Carnelos; Chiara,20,0,20,0
1713336725616,LISP 5A,A00,507541,Munoz Sanchez; Alicia,17,0,20,3
1713336726644,LISP 5B,A00,507671,Munoz Sanchez; Alicia,15,0,20,5
1713336727678,LISP 5C,A00,507696,Munoz Sanchez; Alicia,15,0,20,5
1713336728701,MAE 197,001,528363,Boechler; Nicholas Sebastia,9998,0,9999,1
1713336729731,MATH 197,001,523477,Kedlaya; Kiran S.,9999,0,9999,0
1713336729731,MATH 197,002,563811,Zhang; Danna,9999,0,9999,0
1713336730756,MCWP 40R,A00,518780,Staff,20,0,20,0
1713336730756,MCWP 40R,B00,518781,Staff,19,0,20,1
1713336730756,MCWP 40R,C00,518783,Staff,19,0,20,1
1713336731782,MCWP 50R,A00,518791,Staff,20,0,20,0
1713336731782,MCWP 50R,B00,518792,Staff,17,0,20,3
1713336731782,MCWP 50R,C00,518793,Staff,19,0,20,1
1713336731782,MCWP 50R,D00,518794,Staff,16,0,20,4
1713336731782,MCWP 50R,E00,518795,Staff,16,0,20,4
1713336731782,MCWP 50R,F00,518796,Staff,19,0,20,1
1713336731782,MCWP 50R,G00,518797,Staff,19,0,20,1
1713336732812,MMW 12R,A01,514034,Herbst; Matthew,15,0,16,1
1713336732812,MMW 12R,A02,514035,Herbst; Matthew,16,0,16,0
1713336733841,MMW 13R,A01,514037,Staff,12,0,16,4
1713336733841,MMW 13R,A02,514039,Staff,16,0,16,0
1713336746116,SIO 295LS,A00,523233,Staff,19,0,30,11
1713336747144,SIO 295S,A00,523232,Staff,19,0,30,11
1713336748170,SOCI 117,A01,494376,Staff,2,0,5,3
1713336749198,WES 237B,A00,494380,Staff,19,0,20,1
1713336751260,AESE 279B,A00,494370,Wade; Jon P,33,0,33,0
1713336752284,ANAR 135S,A00,494369,Braswell; Geoffrey E.,0,0,0,0
1713336753310,CAT 124RS,A01,519847,Geibel; William,17,0,20,3
1713336754336,CAT 125RS,A01,515971,Geibel; William,17,0,20,3
1713336755363,CLRE 250,A00,511389,Morris; Sheldon,9996,0,9999,3
1713336756391,CLRE 251,A00,507176,Mehta; Ravindra L.,9996,0,9999,3
1713336756391,CLRE 251,B00,511410,Mehta; Ravindra L.,9998,0,9999,1
1713336757420,CLRE 252,A00,507189,Cuomo; Raphael Eduardo,9998,0,9999,1
1713336758446,CLRE 253,A00,507199,Vaida; Florin,9997,0,9999,2
1713336758446,CLRE 253,B00,507202,Vaida; Florin,9999,0,9999,0
1713336759472,CLRE 259,A00,507211,Patel; Hemal,9996,0,9999,3
1713336760498,CLRE 260,A00,507221,Cuomo; Raphael Eduardo,9999,0,9999,0
1713336761526,CLRE 297,001,507242,Cuomo; Raphael Eduardo,9999,0,9999,0
1713336762559,CSE 191,A00,516875,Minnes Kemp; Mor Mia,9999,0,9999,0
1713336763592,CSS 201S,A01,494383,Staff,35,0,35,0
1713336764621,CSS 202S,A01,494387,Staff,35,0,35,0
1713336765646,EAP 100,A00,516065,Staff,9792,0,9999,207
1713336766674,ECE 45,A01,507414,Staff,51,0,60,9
1713336767699,ECE 100,A01,507416,Baghdadchi; Saharnaz,10,0,20,10
1713336767699,ECE 100,A02,507418,Baghdadchi; Saharnaz,20,0,20,0
1713336768723,ECE 111,A01,507420,Staff,38,0,50,12
1713336769753,ECE 197,001,548057,Sievenpiper; Daniel F.,9998,0,9999,1
1713336770779,EDS 115,A00,507243,Choi; Bailey Miyeon,28,0,28,0
1713336771804,EDS 117,A01,494379,Staff,23,0,25,2
1713336772835,EDS 125,A00,507246,Hopkins; Megan Beth,29,0,30,1
1713336773861,EDS 128A,A01,507264,Fargason; Sharon Gayle,26,0,26,0
1713336774887,EDS 128B,A01,507293,Pappas; Elizabeth,30,0,30,0
1713336775914,EDS 139,A00,507294,Fargason; Sharon Gayle,30,0,30,0
1713336775914,EDS 139,B00,507313,Pappas; Elizabeth,30,0,30,0
1713336776939,EDS 201,A00,507315,Staff,26,0,30,4
1713336777970,EDS 203,A01,507317,Halter; Christopher P.,26,0,30,4
1713336779001,EDS 204R,A01,507319,Halter; Christopher P.,3,0,30,27
1713336779001,EDS 204R,B01,507331,Heinzman; Erica M.,28,0,30,2
1713336780031,EDS 206R,A00,507332,Staff,4,0,30,26
1713336780031,EDS 206R,B00,507343,Staff,28,0,30,2
1713336781059,EDS 250,A00,507344,Hemans; Patricia Ann Benitez,36,0,40,4
1713336782086,EDS 281,A00,507345,Daly; Alan J.,18,0,18,0
1713336783111,EDS 284,A00,507350,Daly; Alan J.,16,0,16,0
1713336784138,EDS 286,A00,507359,Fine; Sarah,18,0,18,0
1713336785239,EDS 289C,A01,507361,Daly; Alan J.,18,0,18,0
1713336786263,EDS 290,A00,507366,Hofstetter; Carolyn,15,0,15,0
1713336787290,LIGM 5A,A00,507421,Fischer-Grunski; Eva K,20,0,20,0
1713336788314,LIGM 5B,A00,507423,Fischer-Grunski; Eva K,20,0,20,0
1713336789337,LIGM 5C,A00,507425,Fischer-Grunski; Eva K,20,0,20,0
1713336790364,LIIT 5AS,A00,507427,Carnelos; Chiara,20,0,20,0
1713336791388,LIIT 5BS,A00,507430,Carnelos; Chiara,20,0,20,0
1713336792414,LIIT 5CS,A00,507432,Carnelos; Chiara,20,0,20,0
1713336793440,LISP 5A,A00,507541,Munoz Sanchez; Alicia,17,0,20,3
1713336794469,LISP 5B,A00,507671,Munoz Sanchez; Alicia,15,0,20,5
1713336795496,LISP 5C,A00,507696,Munoz Sanchez; Alicia,15,0,20,5
1713336796523,MAE 197,001,528363,Boechler; Nicholas Sebastia,9998,0,9999,1
1713336797557,MATH 197,001,523477,Kedlaya; Kiran S.,9999,0,9999,0
1713336797557,MATH 197,002,563811,Zhang; Danna,9999,0,9999,0
1713336798587,MCWP 40R,A00,518780,Staff,20,0,20,0
1713336798587,MCWP 40R,B00,518781,Staff,19,0,20,1
1713336798587,MCWP 40R,C00,518783,Staff,19,0,20,1
1713336799613,MCWP 50R,A00,518791,Staff,20,0,20,0
1713336799613,MCWP 50R,B00,518792,Staff,17,0,20,3
1713336799613,MCWP 50R,C00,518793,Staff,19,0,20,1
1713336799613,MCWP 50R,D00,518794,Staff,16,0,20,4
1713336799613,MCWP 50R,E00,518795,Staff,16,0,20,4
1713336799613,MCWP 50R,F00,518796,Staff,19,0,20,1
1713336799613,MCWP 50R,G00,518797,Staff,19,0,20,1
1713336800644,MMW 12R,A01,514034,Herbst; Matthew,15,0,16,1
1713336800644,MMW 12R,A02,514035,Herbst; Matthew,16,0,16,0
1713336801669,MMW 13R,A01,514037,Staff,12,0,16,4
1713336801669,MMW 13R,A02,514039,Staff,16,0,16,0
1713336803718,SIO 295LS,A00,523233,Staff,19,0,30,11
1713336804748,SIO 295S,A00,523232,Staff,19,0,30,11
1713336805772,SOCI 117,A01,494376,Staff,2,0,5,3
1713336806800,WES 237B,A00,494380,Staff,19,0,20,1
1713336808863,AESE 279B,A00,494370,Wade; Jon P,33,0,33,0
1713336809888,ANAR 135S,A00,494369,Braswell; Geoffrey E.,0,0,0,0
1713336810913,CAT 124RS,A01,519847,Geibel; William,17,0,20,3
1713336811940,CAT 125RS,A01,515971,Geibel; William,17,0,20,3
1713336812970,CLRE 250,A00,511389,Morris; Sheldon,9996,0,9999,3
1713336814001,CLRE 251,A00,507176,Mehta; Ravindra L.,9996,0,9999,3
1713336814001,CLRE 251,B00,511410,Mehta; Ravindra L.,9998,0,9999,1
1713336815030,CLRE 252,A00,507189,Cuomo; Raphael Eduardo,9998,0,9999,1
1713336816059,CLRE 253,A00,507199,Vaida; Florin,9997,0,9999,2
1713336816059,CLRE 253,B00,507202,Vaida; Florin,9999,0,9999,0
1713336817088,CLRE 259,A00,507211,Patel; Hemal,9996,0,9999,3
1713336818112,CLRE 260,A00,507221,Cuomo; Raphael Eduardo,9999,0,9999,0
1713336819142,CLRE 297,001,507242,Cuomo; Raphael Eduardo,9999,0,9999,0
1713336820166,CSE 191,A00,516875,Minnes Kemp; Mor Mia,9999,0,9999,0
1713336821195,CSS 201S,A01,494383,Staff,35,0,35,0
1713336822223,CSS 202S,A01,494387,Staff,35,0,35,0
1713336823251,EAP 100,A00,516065,Staff,9792,0,9999,207
1713336824282,ECE 45,A01,507414,Staff,51,0,60,9
1713336825307,ECE 100,A01,507416,Baghdadchi; Saharnaz,10,0,20,10
1713336825307,ECE 100,A02,507418,Baghdadchi; Saharnaz,20,0,20,0
1713336826332,ECE 111,A01,507420,Staff,38,0,50,12
1713336827362,ECE 197,001,548057,Sievenpiper; Daniel F.,9998,0,9999,1
1713336828392,EDS 115,A00,507243,Choi; Bailey Miyeon,28,0,28,0
1713336829422,EDS 117,A01,494379,Staff,23,0,25,2
1713336830451,EDS 125,A00,507246,Hopkins; Megan Beth,29,0,30,1
1713336831482,EDS 128A,A01,507264,Fargason; Sharon Gayle,26,0,26,0
1713336832510,EDS 128B,A01,507293,Pappas; Elizabeth,30,0,30,0
1713336833534,EDS 139,A00,507294,Fargason; Sharon Gayle,30,0,30,0
1713336833534,EDS 139,B00,507313,Pappas; Elizabeth,30,0,30,0
1713336834564,EDS 201,A00,507315,Staff,26,0,30,4
1713336835590,EDS 203,A01,507317,Halter; Christopher P.,26,0,30,4
1713336836615,EDS 204R,A01,507319,Halter; Christopher P.,3,0,30,27
1713336836615,EDS 204R,B01,507331,Heinzman; Erica M.,28,0,30,2
1713336837641,EDS 206R,A00,507332,Staff,4,0,30,26
1713336837641,EDS 206R,B00,507343,Staff,28,0,30,2
1713336838665,EDS 250,A00,507344,Hemans; Patricia Ann Benitez,36,0,40,4
1713336839693,EDS 281,A00,507345,Daly; Alan J.,18,0,18,0
1713336840718,EDS 284,A00,507350,Daly; Alan J.,16,0,16,0
1713336841747,EDS 286,A00,507359,Fine; Sarah,18,0,18,0
1713336842771,EDS 289C,A01,507361,Daly; Alan J.,18,0,18,0
1713336843798,EDS 290,A00,507366,Hofstetter; Carolyn,15,0,15,0
1713336844825,LIGM 5A,A00,507421,Fischer-Grunski; Eva K,20,0,20,0
1713336845851,LIGM 5B,A00,507423,Fischer-Grunski; Eva K,20,0,20,0
1713336846876,LIGM 5C,A00,507425,Fischer-Grunski; Eva K,20,0,20,0
1713336847902,LIIT 5AS,A00,507427,Carnelos; Chiara,20,0,20,0
1713336848929,LIIT 5BS,A00,507430,Carnelos; Chiara,20,0,20,0
1713336849959,LIIT 5CS,A00,507432,Carnelos; Chiara,20,0,20,0
1713336850984,LISP 5A,A00,507541,Munoz Sanchez; Alicia,17,0,20,3
1713336852009,LISP 5B,A00,507671,Munoz Sanchez; Alicia,15,0,20,5
1713336853034,LISP 5C,A00,507696,Munoz Sanchez; Alicia,15,0,20,5
1713336854061,MAE 197,001,528363,Boechler; Nicholas Sebastia,9998,0,9999,1
1713336855089,MATH 197,001,523477,Kedlaya; Kiran S.,9999,0,9999,0
1713336855089,MATH 197,002,563811,Zhang; Danna,9999,0,9999,0
1713336856119,MCWP 40R,A00,518780,Staff,20,0,20,0
1713336856119,MCWP 40R,B00,518781,Staff,19,0,20,1
1713336856119,MCWP 40R,C00,518783,Staff,19,0,20,1
1713336857151,MCWP 50R,A00,518791,Staff,20,0,20,0
1713336857151,MCWP 50R,B00,518792,Staff,17,0,20,3
1713336857151,MCWP 50R,C00,518793,Staff,19,0,20,1
1713336857151,MCWP 50R,D00,518794,Staff,16,0,20,4
1713336857151,MCWP 50R,E00,518795,Staff,16,0,20,4
1713336857151,MCWP 50R,F00,518796,Staff,19,0,20,1
1713336857151,MCWP 50R,G00,518797,Staff,19,0,20,1
1713336858181,MMW 12R,A01,514034,Herbst; Matthew,15,0,16,1
1713336858181,MMW 12R,A02,514035,Herbst; Matthew,16,0,16,0
1713336859207,MMW 13R,A01,514037,Staff,12,0,16,4
1713336859207,MMW 13R,A02,514039,Staff,16,0,16,0
1713336861257,SIO 295LS,A00,523233,Staff,19,0,30,11
1713336862283,SIO 295S,A00,523232,Staff,19,0,30,11
1713336863307,SOCI 117,A01,494376,Staff,2,0,5,3
1713336864331,WES 237B,A00,494380,Staff,19,0,20,1
1713336866395,AESE 279B,A00,494370,Wade; Jon P,33,0,33,0
1713336867425,ANAR 135S,A00,494369,Braswell; Geoffrey E.,0,0,0,0
1713336868453,CAT 124RS,A01,519847,Geibel; William,17,0,20,3
1713336869478,CAT 125RS,A01,515971,Geibel; William,17,0,20,3
1713336870508,CLRE 250,A00,511389,Morris; Sheldon,9996,0,9999,3
1713336871544,CLRE 251,A00,507176,Mehta; Ravindra L.,9996,0,9999,3
1713336871544,CLRE 251,B00,511410,Mehta; Ravindra L.,9998,0,9999,1
1713336872573,CLRE 252,A00,507189,Cuomo; Raphael Eduardo,9998,0,9999,1
1713336873599,CLRE 253,A00,507199,Vaida; Florin,9997,0,9999,2
1713336873599,CLRE 253,B00,507202,Vaida; Florin,9999,0,9999,0
1713336874624,CLRE 259,A00,507211,Patel; Hemal,9996,0,9999,3
1713336875649,CLRE 260,A00,507221,Cuomo; Raphael Eduardo,9999,0,9999,0
1713336876673,CLRE 297,001,507242,Cuomo; Raphael Eduardo,9999,0,9999,0
1713336877700,CSE 191,A00,516875,Minnes Kemp; Mor Mia,9999,0,9999,0
1713336878724,CSS 201S,A01,494383,Staff,35,0,35,0
1713336879754,CSS 202S,A01,494387,Staff,35,0,35,0
1713336880780,EAP 100,A00,516065,Staff,9792,0,9999,207
1713336881808,ECE 45,A01,507414,Staff,51,0,60,9
1713336882834,ECE 100,A01,507416,Baghdadchi; Saharnaz,10,0,20,10
1713336882834,ECE 100,A02,507418,Baghdadchi; Saharnaz,20,0,20,0
1713336883864,ECE 111,A01,507420,Staff,38,0,50,12
1713336884894,ECE 197,001,548057,Sievenpiper; Daniel F.,9998,0,9999,1
1713336885920,EDS 115,A00,507243,Choi; Bailey Miyeon,28,0,28,0
1713336886945,EDS 117,A01,494379,Staff,23,0,25,2
1713336887972,EDS 125,A00,507246,Hopkins; Megan Beth,29,0,30,1
1713336889062,EDS 128A,A01,507264,Fargason; Sharon Gayle,26,0,26,0
1713336890090,EDS 128B,A01,507293,Pappas; Elizabeth,30,0,30,0
1713336891116,EDS 139,A00,507294,Fargason; Sharon Gayle,30,0,30,0
1713336891116,EDS 139,B00,507313,Pappas; Elizabeth,30,0,30,0
1713336892141,EDS 201,A00,507315,Staff,26,0,30,4
1713336893167,EDS 203,A01,507317,Halter; Christopher P.,26,0,30,4
1713336894194,EDS 204R,A01,507319,Halter; Christopher P.,3,0,30,27
1713336894194,EDS 204R,B01,507331,Heinzman; Erica M.,28,0,30,2
1713336895221,EDS 206R,A00,507332,Staff,4,0,30,26
1713336895221,EDS 206R,B00,507343,Staff,28,0,30,2
1713336896246,EDS 250,A00,507344,Hemans; Patricia Ann Benitez,36,0,40,4
1713336897275,EDS 281,A00,507345,Daly; Alan J.,18,0,18,0
1713336898309,EDS 284,A00,507350,Daly; Alan J.,16,0,16,0
1713336899334,EDS 286,A00,507359,Fine; Sarah,18,0,18,0
1713336900359,EDS 289C,A01,507361,Daly; Alan J.,18,0,18,0
1713336901386,EDS 290,A00,507366,Hofstetter; Carolyn,15,0,15,0
1713336902414,LIGM 5A,A00,507421,Fischer-Grunski; Eva K,20,0,20,0
1713336903443,LIGM 5B,A00,507423,Fischer-Grunski; Eva K,20,0,20,0
1713336904469,LIGM 5C,A00,507425,Fischer-Grunski; Eva K,20,0,20,0
1713336905692,LIIT 5AS,A00,507427,Carnelos; Chiara,20,0,20,0
1713336906722,LIIT 5BS,A00,507430,Carnelos; Chiara,20,0,20,0
1713336907749,LIIT 5CS,A00,507432,Carnelos; Chiara,20,0,20,0
1713336908774,LISP 5A,A00,507541,Munoz Sanchez; Alicia,17,0,20,3
1713336909806,LISP 5B,A00,507671,Munoz Sanchez; Alicia,15,0,20,5
1713336910832,LISP 5C,A00,507696,Munoz Sanchez; Alicia,15,0,20,5
1713336911858,MAE 197,001,528363,Boechler; Nicholas Sebastia,9998,0,9999,1
1713336912888,MATH 197,001,523477,Kedlaya; Kiran S.,9999,0,9999,0
1713336912888,MATH 197,002,563811,Zhang; Danna,9999,0,9999,0
1713336913915,MCWP 40R,A00,518780,Staff,20,0,20,0
1713336913915,MCWP 40R,B00,518781,Staff,19,0,20,1
1713336913915,MCWP 40R,C00,518783,Staff,19,0,20,1
1713336914940,MCWP 50R,A00,518791,Staff,20,0,20,0
1713336914940,MCWP 50R,B00,518792,Staff,17,0,20,3
1713336914940,MCWP 50R,C00,518793,Staff,19,0,20,1
1713336914940,MCWP 50R,D00,518794,Staff,16,0,20,4
1713336914940,MCWP 50R,E00,518795,Staff,16,0,20,4
1713336914940,MCWP 50R,F00,518796,Staff,19,0,20,1
1713336914940,MCWP 50R,G00,518797,Staff,19,0,20,1
1713336915969,MMW 12R,A01,514034,Herbst; Matthew,15,0,16,1
1713336915969,MMW 12R,A02,514035,Herbst; Matthew,16,0,16,0
1713336916997,MMW 13R,A01,514037,Staff,12,0,16,4
1713336916997,MMW 13R,A02,514039,Staff,16,0,16,0
1713336919049,SIO 295LS,A00,523233,Staff,19,0,30,11
1713336920086,SIO 295S,A00,523232,Staff,19,0,30,11
1713336921113,SOCI 117,A01,494376,Staff,2,0,5,3
1713336922144,WES 237B,A00,494380,Staff,19,0,20,1
1713336924221,AESE 279B,A00,494370,Wade; Jon P,33,0,33,0
1713336925248,ANAR 135S,A00,494369,Braswell; Geoffrey E.,0,0,0,0
1713336926277,CAT 124RS,A01,519847,Geibel; William,17,0,20,3
1713336927302,CAT 125RS,A01,515971,Geibel; William,17,0,20,3
1713336928335,CLRE 250,A00,511389,Morris; Sheldon,9996,0,9999,3
1713336929362,CLRE 251,A00,507176,Mehta; Ravindra L.,9996,0,9999,3
1713336929362,CLRE 251,B00,511410,Mehta; Ravindra L.,9998,0,9999,1
1713336930390,CLRE 252,A00,507189,Cuomo; Raphael Eduardo,9998,0,9999,1
1713336931416,CLRE 253,A00,507199,Vaida; Florin,9997,0,9999,2
1713336931416,CLRE 253,B00,507202,Vaida; Florin,9999,0,9999,0
1713336932487,CLRE 259,A00,507211,Patel; Hemal,9996,0,9999,3
1713336933514,CLRE 260,A00,507221,Cuomo; Raphael Eduardo,9999,0,9999,0
1713336934539,CLRE 297,001,507242,Cuomo; Raphael Eduardo,9999,0,9999,0
1713336935568,CSE 191,A00,516875,Minnes Kemp; Mor Mia,9999,0,9999,0
1713336936594,CSS 201S,A01,494383,Staff,35,0,35,0
1713336937619,CSS 202S,A01,494387,Staff,35,0,35,0
1713336938645,EAP 100,A00,516065,Staff,9792,0,9999,207
1713336939683,ECE 45,A01,507414,Staff,51,0,60,9
1713336940715,ECE 100,A01,507416,Baghdadchi; Saharnaz,10,0,20,10
1713336940715,ECE 100,A02,507418,Baghdadchi; Saharnaz,20,0,20,0
1713336941740,ECE 111,A01,507420,Staff,38,0,50,12
1713336942767,ECE 197,001,548057,Sievenpiper; Daniel F.,9998,0,9999,1
1713336943795,EDS 115,A00,507243,Choi; Bailey Miyeon,28,0,28,0
1713336944820,EDS 117,A01,494379,Staff,23,0,25,2
1713336945851,EDS 125,A00,507246,Hopkins; Megan Beth,29,0,30,1
1713336946878,EDS 128A,A01,507264,Fargason; Sharon Gayle,26,0,26,0
1713336947906,EDS 128B,A01,507293,Pappas; Elizabeth,30,0,30,0
1713336948932,EDS 139,A00,507294,Fargason; Sharon Gayle,30,0,30,0
1713336948932,EDS 139,B00,507313,Pappas; Elizabeth,30,0,30,0
1713336949958,EDS 201,A00,507315,Staff,26,0,30,4
1713336950993,EDS 203,A01,507317,Halter; Christopher P.,26,0,30,4
1713336952020,EDS 204R,A01,507319,Halter; Christopher P.,3,0,30,27
1713336952020,EDS 204R,B01,507331,Heinzman; Erica M.,28,0,30,2
1713336953045,EDS 206R,A00,507332,Staff,4,0,30,26
1713336953045,EDS 206R,B00,507343,Staff,28,0,30,2
1713336954086,EDS 250,A00,507344,Hemans; Patricia Ann Benitez,36,0,40,4
1713336955113,EDS 281,A00,507345,Daly; Alan J.,18,0,18,0
1713336956136,EDS 284,A00,507350,Daly; Alan J.,16,0,16,0
1713336957164,EDS 286,A00,507359,Fine; Sarah,18,0,18,0
1713336958193,EDS 289C,A01,507361,Daly; Alan J.,18,0,18,0
1713336959219,EDS 290,A00,507366,Hofstetter; Carolyn,15,0,15,0
1713336960244,LIGM 5A,A00,507421,Fischer-Grunski; Eva K,20,0,20,0
1713336961275,LIGM 5B,A00,507423,Fischer-Grunski; Eva K,20,0,20,0
1713336962300,LIGM 5C,A00,507425,Fischer-Grunski; Eva K,20,0,20,0
1713336963326,LIIT 5AS,A00,507427,Carnelos; Chiara,20,0,20,0
1713336964355,LIIT 5BS,A00,507430,Carnelos; Chiara,20,0,20,0
1713336965386,LIIT 5CS,A00,507432,Carnelos; Chiara,20,0,20,0
1713336966416,LISP 5A,A00,507541,Munoz Sanchez; Alicia,17,0,20,3
1713336967442,LISP 5B,A00,507671,Munoz Sanchez; Alicia,15,0,20,5
1713336968471,LISP 5C,A00,507696,Munoz Sanchez; Alicia,15,0,20,5
1713336969500,MAE 197,001,528363,Boechler; Nicholas Sebastia,9998,0,9999,1
1713336970526,MATH 197,001,523477,Kedlaya; Kiran S.,9999,0,9999,0
1713336970526,MATH 197,002,563811,Zhang; Danna,9999,0,9999,0
1713336971552,MCWP 40R,A00,518780,Staff,20,0,20,0
1713336971552,MCWP 40R,B00,518781,Staff,19,0,20,1
1713336971552,MCWP 40R,C00,518783,Staff,19,0,20,1
1713336972575,MCWP 50R,A00,518791,Staff,20,0,20,0
1713336972575,MCWP 50R,B00,518792,Staff,17,0,20,3
1713336972575,MCWP 50R,C00,518793,Staff,19,0,20,1
1713336972575,MCWP 50R,D00,518794,Staff,16,0,20,4
1713336972575,MCWP 50R,E00,518795,Staff,16,0,20,4
1713336972575,MCWP 50R,F00,518796,Staff,19,0,20,1
1713336972575,MCWP 50R,G00,518797,Staff,19,0,20,1
1713336973605,MMW 12R,A01,514034,Herbst; Matthew,15,0,16,1
1713336973605,MMW 12R,A02,514035,Herbst; Matthew,16,0,16,0
1713336974630,MMW 13R,A01,514037,Staff,12,0,16,4
1713336974630,MMW 13R,A02,514039,Staff,16,0,16,0
1713336976683,SIO 295LS,A00,523233,Staff,19,0,30,11
1713336977707,SIO 295S,A00,523232,Staff,19,0,30,11
1713336978737,SOCI 117,A01,494376,Staff,2,0,5,3
1713336979765,WES 237B,A00,494380,Staff,19,0,20,1
1713336981830,AESE 279B,A00,494370,Wade; Jon P,33,0,33,0
1713336982856,ANAR 135S,A00,494369,Braswell; Geoffrey E.,0,0,0,0
1713336983893,CAT 124RS,A01,519847,Geibel; William,17,0,20,3
1713336984919,CAT 125RS,A01,515971,Geibel; William,17,0,20,3
1713336985949,CLRE 250,A00,511389,Morris; Sheldon,9996,0,9999,3
1713336986974,CLRE 251,A00,507176,Mehta; Ravindra L.,9996,0,9999,3
1713336986974,CLRE 251,B00,511410,Mehta; Ravindra L.,9998,0,9999,1
1713336988000,CLRE 252,A00,507189,Cuomo; Raphael Eduardo,9998,0,9999,1
1713336989025,CLRE 253,A00,507199,Vaida; Florin,9997,0,9999,2
1713336989025,CLRE 253,B00,507202,Vaida; Florin,9999,0,9999,0
1713336990053,CLRE 259,A00,507211,Patel; Hemal,9996,0,9999,3
1713336991078,CLRE 260,A00,507221,Cuomo; Raphael Eduardo,9999,0,9999,0
1713336992103,CLRE 297,001,507242,Cuomo; Raphael Eduardo,9999,0,9999,0
1713336993187,CSE 191,A00,516875,Minnes Kemp; Mor Mia,9999,0,9999,0
1713336994213,CSS 201S,A01,494383,Staff,35,0,35,0
1713336995238,CSS 202S,A01,494387,Staff,35,0,35,0
1713336996263,EAP 100,A00,516065,Staff,9792,0,9999,207
1713336997291,ECE 45,A01,507414,Staff,51,0,60,9
1713336998322,ECE 100,A01,507416,Baghdadchi; Saharnaz,10,0,20,10
1713336998322,ECE 100,A02,507418,Baghdadchi; Saharnaz,20,0,20,0
1713336999346,ECE 111,A01,507420,Staff,38,0,50,12
1713337000373,ECE 197,001,548057,Sievenpiper; Daniel F.,9998,0,9999,1
1713337001400,EDS 115,A00,507243,Choi; Bailey Miyeon,28,0,28,0
1713337002424,EDS 117,A01,494379,Staff,23,0,25,2
1713337003449,EDS 125,A00,507246,Hopkins; Megan Beth,29,0,30,1
1713337004481,EDS 128A,A01,507264,Fargason; Sharon Gayle,26,0,26,0
1713337005507,EDS 128B,A01,507293,Pappas; Elizabeth,30,0,30,0
1713337006532,EDS 139,A00,507294,Fargason; Sharon Gayle,30,0,30,0
1713337006532,EDS 139,B00,507313,Pappas; Elizabeth,30,0,30,0
1713337007558,EDS 201,A00,507315,Staff,26,0,30,4
1713337008585,EDS 203,A01,507317,Halter; Christopher P.,26,0,30,4
1713337009611,EDS 204R,A01,507319,Halter; Christopher P.,3,0,30,27
1713337009611,EDS 204R,B01,507331,Heinzman; Erica M.,28,0,30,2
1713337010635,EDS 206R,A00,507332,Staff,4,0,30,26
1713337010635,EDS 206R,B00,507343,Staff,28,0,30,2
1713337011659,EDS 250,A00,507344,Hemans; Patricia Ann Benitez,36,0,40,4
1713337012688,EDS 281,A00,507345,Daly; Alan J.,18,0,18,0
1713337013714,EDS 284,A00,507350,Daly; Alan J.,16,0,16,0
1713337014740,EDS 286,A00,507359,Fine; Sarah,18,0,18,0
1713337015765,EDS 289C,A01,507361,Daly; Alan J.,18,0,18,0
1713337016791,EDS 290,A00,507366,Hofstetter; Carolyn,15,0,15,0
1713337017826,LIGM 5A,A00,507421,Fischer-Grunski; Eva K,20,0,20,0
1713337018855,LIGM 5B,A00,507423,Fischer-Grunski; Eva K,20,0,20,0
1713337019881,LIGM 5C,A00,507425,Fischer-Grunski; Eva K,20,0,20,0
1713337020906,LIIT 5AS,A00,507427,Carnelos; Chiara,20,0,20,0
1713337021936,LIIT 5BS,A00,507430,Carnelos; Chiara,20,0,20,0
1713337022962,LIIT 5CS,A00,507432,Carnelos; Chiara,20,0,20,0
1713337023987,LISP 5A,A00,507541,Munoz Sanchez; Alicia,17,0,20,3
1713337025014,LISP 5B,A00,507671,Munoz Sanchez; Alicia,15,0,20,5
1713337026042,LISP 5C,A00,507696,Munoz Sanchez; Alicia,15,0,20,5
1713337027072,MAE 197,001,528363,Boechler; Nicholas Sebastia,9998,0,9999,1
1713337028098,MATH 197,001,523477,Kedlaya; Kiran S.,9999,0,9999,0
1713337028098,MATH 197,002,563811,Zhang; Danna,9999,0,9999,0
1713337029129,MCWP 40R,A00,518780,Staff,20,0,20,0
1713337029129,MCWP 40R,B00,518781,Staff,19,0,20,1
1713337029129,MCWP 40R,C00,518783,Staff,19,0,20,1
1713337030160,MCWP 50R,A00,518791,Staff,20,0,20,0
1713337030160,MCWP 50R,B00,518792,Staff,17,0,20,3
1713337030160,MCWP 50R,C00,518793,Staff,19,0,20,1
1713337030160,MCWP 50R,D00,518794,Staff,16,0,20,4
1713337030160,MCWP 50R,E00,518795,Staff,16,0,20,4
1713337030160,MCWP 50R,F00,518796,Staff,19,0,20,1
1713337030160,MCWP 50R,G00,518797,Staff,19,0,20,1
1713337031190,MMW 12R,A01,514034,Herbst; Matthew,15,0,16,1
1713337031190,MMW 12R,A02,514035,Herbst; Matthew,16,0,16,0
1713337032216,MMW 13R,A01,514037,Staff,12,0,16,4
1713337032216,MMW 13R,A02,514039,Staff,16,0,16,0
1713337034272,SIO 295LS,A00,523233,Staff,19,0,30,11
1713337035300,SIO 295S,A00,523232,Staff,19,0,30,11
1713337036326,SOCI 117,A01,494376,Staff,2,0,5,3
1713337037355,WES 237B,A00,494380,Staff,19,0,20,1
1713337039435,AESE 279B,A00,494370,Wade; Jon P,33,0,33,0
1713337040461,ANAR 135S,A00,494369,Braswell; Geoffrey E.,0,0,0,0
1713337041490,CAT 124RS,A01,519847,Geibel; William,17,0,20,3
1713337042515,CAT 125RS,A01,515971,Geibel; William,17,0,20,3
1713337043541,CLRE 250,A00,511389,Morris; Sheldon,9996,0,9999,3
1713337044571,CLRE 251,A00,507176,Mehta; Ravindra L.,9996,0,9999,3
1713337044571,CLRE 251,B00,511410,Mehta; Ravindra L.,9998,0,9999,1
1713337045597,CLRE 252,A00,507189,Cuomo; Raphael Eduardo,9998,0,9999,1
1713337046625,CLRE 253,A00,507199,Vaida; Florin,9997,0,9999,2
1713337046625,CLRE 253,B00,507202,Vaida; Florin,9999,0,9999,0
1713337047650,CLRE 259,A00,507211,Patel; Hemal,9996,0,9999,3
1713337048676,CLRE 260,A00,507221,Cuomo; Raphael Eduardo,9999,0,9999,0
1713337049702,CLRE 297,001,507242,Cuomo; Raphael Eduardo,9999,0,9999,0
1713337050727,CSE 191,A00,516875,Minnes Kemp; Mor Mia,9999,0,9999,0
1713337051759,CSS 201S,A01,494383,Staff,35,0,35,0
1713337052790,CSS 202S,A01,494387,Staff,35,0,35,0
1713337053815,EAP 100,A00,516065,Staff,9792,0,9999,207
1713337054841,ECE 45,A01,507414,Staff,51,0,60,9
1713337055866,ECE 100,A01,507416,Baghdadchi; Saharnaz,10,0,20,10
1713337055866,ECE 100,A02,507418,Baghdadchi; Saharnaz,20,0,20,0
1713337056896,ECE 111,A01,507420,Staff,38,0,50,12
1713337057924,ECE 197,001,548057,Sievenpiper; Daniel F.,9998,0,9999,1
1713337058957,EDS 115,A00,507243,Choi; Bailey Miyeon,28,0,28,0
1713337059985,EDS 117,A01,494379,Staff,23,0,25,2
1713337061010,EDS 125,A00,507246,Hopkins; Megan Beth,29,0,30,1
1713337062041,EDS 128A,A01,507264,Fargason; Sharon Gayle,26,0,26,0
1713337063067,EDS 128B,A01,507293,Pappas; Elizabeth,30,0,30,0
1713337064095,EDS 139,A00,507294,Fargason; Sharon Gayle,30,0,30,0
1713337064095,EDS 139,B00,507313,Pappas; Elizabeth,30,0,30,0
1713337065121,EDS 201,A00,507315,Staff,26,0,30,4
1713337066147,EDS 203,A01,507317,Halter; Christopher P.,26,0,30,4
1713337067172,EDS 204R,A01,507319,Halter; Christopher P.,3,0,30,27
1713337067172,EDS 204R,B01,507331,Heinzman; Erica M.,28,0,30,2
1713337068200,EDS 206R,A00,507332,Staff,4,0,30,26
1713337068200,EDS 206R,B00,507343,Staff,28,0,30,2
1713337069230,EDS 250,A00,507344,Hemans; Patricia Ann Benitez,36,0,40,4
1713337070258,EDS 281,A00,507345,Daly; Alan J.,18,0,18,0
1713337071286,EDS 284,A00,507350,Daly; Alan J.,16,0,16,0
1713337072311,EDS 286,A00,507359,Fine; Sarah,18,0,18,0
1713337073336,EDS 289C,A01,507361,Daly; Alan J.,18,0,18,0
1713337074362,EDS 290,A00,507366,Hofstetter; Carolyn,15,0,15,0
1713337075392,LIGM 5A,A00,507421,Fischer-Grunski; Eva K,20,0,20,0
1713337076417,LIGM 5B,A00,507423,Fischer-Grunski; Eva K,20,0,20,0
1713337077441,LIGM 5C,A00,507425,Fischer-Grunski; Eva K,20,0,20,0
1713337078472,LIIT 5AS,A00,507427,Carnelos; Chiara,20,0,20,0
1713337079497,LIIT 5BS,A00,507430,Carnelos; Chiara,20,0,20,0
1713337080522,LIIT 5CS,A00,507432,Carnelos; Chiara,20,0,20,0
1713337081549,LISP 5A,A00,507541,Munoz Sanchez; Alicia,17,0,20,3
1713337082574,LISP 5B,A00,507671,Munoz Sanchez; Alicia,15,0,20,5
1713337083598,LISP 5C,A00,507696,Munoz Sanchez; Alicia,15,0,20,5
1713337084624,MAE 197,001,528363,Boechler; Nicholas Sebastia,9998,0,9999,1
1713337085651,MATH 197,001,523477,Kedlaya; Kiran S.,9999,0,9999,0
1713337085651,MATH 197,002,563811,Zhang; Danna,9999,0,9999,0
1713337086676,MCWP 40R,A00,518780,Staff,20,0,20,0
1713337086676,MCWP 40R,B00,518781,Staff,19,0,20,1
1713337086676,MCWP 40R,C00,518783,Staff,19,0,20,1
1713337087703,MCWP 50R,A00,518791,Staff,20,0,20,0
1713337087703,MCWP 50R,B00,518792,Staff,17,0,20,3
1713337087703,MCWP 50R,C00,518793,Staff,19,0,20,1
1713337087703,MCWP 50R,D00,518794,Staff,16,0,20,4
1713337087703,MCWP 50R,E00,518795,Staff,16,0,20,4
1713337087703,MCWP 50R,F00,518796,Staff,19,0,20,1
1713337087703,MCWP 50R,G00,518797,Staff,19,0,20,1
1713337088729,MMW 12R,A01,514034,Herbst; Matthew,15,0,16,1
1713337088729,MMW 12R,A02,514035,Herbst; Matthew,16,0,16,0
1713337089758,MMW 13R,A01,514037,Staff,12,0,16,4
1713337089758,MMW 13R,A02,514039,Staff,16,0,16,0
1713337091816,SIO 295LS,A00,523233,Staff,19,0,30,11
1713337092840,SIO 295S,A00,523232,Staff,19,0,30,11
1713337093866,SOCI 117,A01,494376,Staff,2,0,5,3
1713337094890,WES 237B,A00,494380,Staff,19,0,20,1
1713337097013,AESE 279B,A00,494370,Wade; Jon P,33,0,33,0
1713337098039,ANAR 135S,A00,494369,Braswell; Geoffrey E.,0,0,0,0
1713337099068,CAT 124RS,A01,519847,Geibel; William,17,0,20,3
1713337100092,CAT 125RS,A01,515971,Geibel; William,17,0,20,3
1713337101122,CLRE 250,A00,511389,Morris; Sheldon,9996,0,9999,3
1713337102154,CLRE 251,A00,507176,Mehta; Ravindra L.,9996,0,9999,3
1713337102154,CLRE 251,B00,511410,Mehta; Ravindra L.,9998,0,9999,1
1713337103180,CLRE 252,A00,507189,Cuomo; Raphael Eduardo,9998,0,9999,1
1713337104211,CLRE 253,A00,507199,Vaida; Florin,9997,0,9999,2
1713337104211,CLRE 253,B00,507202,Vaida; Florin,9999,0,9999,0
1713337105237,CLRE 259,A00,507211,Patel; Hemal,9996,0,9999,3
1713337106265,CLRE 260,A00,507221,Cuomo; Raphael Eduardo,9999,0,9999,0
1713337107290,CLRE 297,001,507242,Cuomo; Raphael Eduardo,9999,0,9999,0
1713337108315,CSE 191,A00,516875,Minnes Kemp; Mor Mia,9999,0,9999,0
1713337109346,CSS 201S,A01,494383,Staff,35,0,35,0
1713337110372,CSS 202S,A01,494387,Staff,35,0,35,0
1713337111396,EAP 100,A00,516065,Staff,9792,0,9999,207
1713337112422,ECE 45,A01,507414,Staff,51,0,60,9
1713337113447,ECE 100,A01,507416,Baghdadchi; Saharnaz,10,0,20,10
1713337113447,ECE 100,A02,507418,Baghdadchi; Saharnaz,20,0,20,0
1713337114472,ECE 111,A01,507420,Staff,38,0,50,12
1713337115498,ECE 197,001,548057,Sievenpiper; Daniel F.,9998,0,9999,1
1713337116523,EDS 115,A00,507243,Choi; Bailey Miyeon,28,0,28,0
1713337117549,EDS 117,A01,494379,Staff,23,0,25,2
1713337118575,EDS 125,A00,507246,Hopkins; Megan Beth,29,0,30,1
1713337119605,EDS 128A,A01,507264,Fargason; Sharon Gayle,26,0,26,0
1713337120631,EDS 128B,A01,507293,Pappas; Elizabeth,30,0,30,0
1713337121655,EDS 139,A00,507294,Fargason; Sharon Gayle,30,0,30,0
1713337121655,EDS 139,B00,507313,Pappas; Elizabeth,30,0,30,0
1713337122678,EDS 201,A00,507315,Staff,26,0,30,4
1713337123707,EDS 203,A01,507317,Halter; Christopher P.,26,0,30,4
1713337124733,EDS 204R,A01,507319,Halter; Christopher P.,3,0,30,27
1713337124733,EDS 204R,B01,507331,Heinzman; Erica M.,28,0,30,2
1713337125757,EDS 206R,A00,507332,Staff,4,0,30,26
1713337125757,EDS 206R,B00,507343,Staff,28,0,30,2
1713337126783,EDS 250,A00,507344,Hemans; Patricia Ann Benitez,36,0,40,4
1713337127808,EDS 281,A00,507345,Daly; Alan J.,18,0,18,0
1713337128837,EDS 284,A00,507350,Daly; Alan J.,16,0,16,0
1713337129867,EDS 286,A00,507359,Fine; Sarah,18,0,18,0
1713337130892,EDS 289C,A01,507361,Daly; Alan J.,18,0,18,0
1713337131923,EDS 290,A00,507366,Hofstetter; Carolyn,15,0,15,0
1713337132950,LIGM 5A,A00,507421,Fischer-Grunski; Eva K,20,0,20,0
1713337133977,LIGM 5B,A00,507423,Fischer-Grunski; Eva K,20,0,20,0
1713337135007,LIGM 5C,A00,507425,Fischer-Grunski; Eva K,20,0,20,0
1713337136037,LIIT 5AS,A00,507427,Carnelos; Chiara,20,0,20,0
1713337137067,LIIT 5BS,A00,507430,Carnelos; Chiara,20,0,20,0
1713337138094,LIIT 5CS,A00,507432,Carnelos; Chiara,20,0,20,0
1713337139127,LISP 5A,A00,507541,Munoz Sanchez; Alicia,17,0,20,3
1713337140159,LISP 5B,A00,507671,Munoz Sanchez; Alicia,15,0,20,5
1713337141187,LISP 5C,A00,507696,Munoz Sanchez; Alicia,15,0,20,5
1713337142213,MAE 197,001,528363,Boechler; Nicholas Sebastia,9998,0,9999,1
1713337143239,MATH 197,001,523477,Kedlaya; Kiran S.,9999,0,9999,0
1713337143239,MATH 197,002,563811,Zhang; Danna,9999,0,9999,0
1713337144268,MCWP 40R,A00,518780,Staff,20,0,20,0
1713337144268,MCWP 40R,B00,518781,Staff,19,0,20,1
1713337144268,MCWP 40R,C00,518783,Staff,19,0,20,1
1713337145293,MCWP 50R,A00,518791,Staff,20,0,20,0
1713337145293,MCWP 50R,B00,518792,Staff,17,0,20,3
1713337145293,MCWP 50R,C00,518793,Staff,19,0,20,1
1713337145293,MCWP 50R,D00,518794,Staff,16,0,20,4
1713337145293,MCWP 50R,E00,518795,Staff,16,0,20,4
1713337145293,MCWP 50R,F00,518796,Staff,19,0,20,1
1713337145293,MCWP 50R,G00,518797,Staff,19,0,20,1
1713337146320,MMW 12R,A01,514034,Herbst; Matthew,15,0,16,1
1713337146320,MMW 12R,A02,514035,Herbst; Matthew,16,0,16,0
1713337147349,MMW 13R,A01,514037,Staff,12,0,16,4
1713337147349,MMW 13R,A02,514039,Staff,16,0,16,0
1713337149404,SIO 295LS,A00,523233,Staff,19,0,30,11
1713337150430,SIO 295S,A00,523232,Staff,19,0,30,11
1713337151463,SOCI 117,A01,494376,Staff,2,0,5,3
1713337152488,WES 237B,A00,494380,Staff,19,0,20,1
1713337154561,AESE 279B,A00,494370,Wade; Jon P,33,0,33,0
1713337155590,ANAR 135S,A00,494369,Braswell; Geoffrey E.,0,0,0,0
1713337156620,CAT 124RS,A01,519847,Geibel; William,17,0,20,3
1713337157647,CAT 125RS,A01,515971,Geibel; William,17,0,20,3
1713337158674,CLRE 250,A00,511389,Morris; Sheldon,9996,0,9999,3
1713337159707,CLRE 251,A00,507176,Mehta; Ravindra L.,9996,0,9999,3
1713337159707,CLRE 251,B00,511410,Mehta; Ravindra L.,9998,0,9999,1
1713337160736,CLRE 252,A00,507189,Cuomo; Raphael Eduardo,9998,0,9999,1
1713337161761,CLRE 253,A00,507199,Vaida; Florin,9997,0,9999,2
1713337161761,CLRE 253,B00,507202,Vaida; Florin,9999,0,9999,0
1713337162788,CLRE 259,A00,507211,Patel; Hemal,9996,0,9999,3
1713337163812,CLRE 260,A00,507221,Cuomo; Raphael Eduardo,9999,0,9999,0
1713337164840,CLRE 297,001,507242,Cuomo; Raphael Eduardo,9999,0,9999,0
1713337165869,CSE 191,A00,516875,Minnes Kemp; Mor Mia,9999,0,9999,0
1713337166897,CSS 201S,A01,494383,Staff,35,0,35,0
1713337167927,CSS 202S,A01,494387,Staff,35,0,35,0
1713337168951,EAP 100,A00,516065,Staff,9792,0,9999,207
1713337169977,ECE 45,A01,507414,Staff,51,0,60,9
1713337171003,ECE 100,A01,507416,Baghdadchi; Saharnaz,10,0,20,10
1713337171003,ECE 100,A02,507418,Baghdadchi; Saharnaz,20,0,20,0
1713337172029,ECE 111,A01,507420,Staff,38,0,50,12
1713337173053,ECE 197,001,548057,Sievenpiper; Daniel F.,9998,0,9999,1
1713337174078,EDS 115,A00,507243,Choi; Bailey Miyeon,28,0,28,0
1713337175109,EDS 117,A01,494379,Staff,23,0,25,2
1713337176136,EDS 125,A00,507246,Hopkins; Megan Beth,29,0,30,1
1713337177161,EDS 128A,A01,507264,Fargason; Sharon Gayle,26,0,26,0
1713337178190,EDS 128B,A01,507293,Pappas; Elizabeth,30,0,30,0
1713337179219,EDS 139,A00,507294,Fargason; Sharon Gayle,30,0,30,0
1713337179219,EDS 139,B00,507313,Pappas; Elizabeth,30,0,30,0
1713337180246,EDS 201,A00,507315,Staff,26,0,30,4
1713337181274,EDS 203,A01,507317,Halter; Christopher P.,26,0,30,4
1713337182306,EDS 204R,A01,507319,Halter; Christopher P.,3,0,30,27
1713337182306,EDS 204R,B01,507331,Heinzman; Erica M.,28,0,30,2
1713337183334,EDS 206R,A00,507332,Staff,4,0,30,26
1713337183334,EDS 206R,B00,507343,Staff,28,0,30,2
1713337184364,EDS 250,A00,507344,Hemans; Patricia Ann Benitez,36,0,40,4
1713337185387,EDS 281,A00,507345,Daly; Alan J.,18,0,18,0
1713337186411,EDS 284,A00,507350,Daly; Alan J.,16,0,16,0
1713337187435,EDS 286,A00,507359,Fine; Sarah,18,0,18,0
1713337188460,EDS 289C,A01,507361,Daly; Alan J.,18,0,18,0
1713337189488,EDS 290,A00,507366,Hofstetter; Carolyn,15,0,15,0
1713337190522,LIGM 5A,A00,507421,Fischer-Grunski; Eva K,20,0,20,0
1713337191551,LIGM 5B,A00,507423,Fischer-Grunski; Eva K,20,0,20,0
1713337192577,LIGM 5C,A00,507425,Fischer-Grunski; Eva K,20,0,20,0
1713337193603,LIIT 5AS,A00,507427,Carnelos; Chiara,20,0,20,0
1713337194632,LIIT 5BS,A00,507430,Carnelos; Chiara,20,0,20,0
1713337195663,LIIT 5CS,A00,507432,Carnelos; Chiara,20,0,20,0
1713337196695,LISP 5A,A00,507541,Munoz Sanchez; Alicia,17,0,20,3
1713337197725,LISP 5B,A00,507671,Munoz Sanchez; Alicia,15,0,20,5
1713337198751,LISP 5C,A00,507696,Munoz Sanchez; Alicia,15,0,20,5
1713337199781,MAE 197,001,528363,Boechler; Nicholas Sebastia,9998,0,9999,1
1713337200862,MATH 197,001,523477,Kedlaya; Kiran S.,9999,0,9999,0
1713337200862,MATH 197,002,563811,Zhang; Danna,9999,0,9999,0
1713337201892,MCWP 40R,A00,518780,Staff,20,0,20,0
1713337201892,MCWP 40R,B00,518781,Staff,19,0,20,1
1713337201892,MCWP 40R,C00,518783,Staff,19,0,20,1
1713337202918,MCWP 50R,A00,518791,Staff,20,0,20,0
1713337202918,MCWP 50R,B00,518792,Staff,17,0,20,3
1713337202918,MCWP 50R,C00,518793,Staff,19,0,20,1
1713337202918,MCWP 50R,D00,518794,Staff,16,0,20,4
1713337202918,MCWP 50R,E00,518795,Staff,16,0,20,4
1713337202918,MCWP 50R,F00,518796,Staff,19,0,20,1
1713337202918,MCWP 50R,G00,518797,Staff,19,0,20,1
1713337203943,MMW 12R,A01,514034,Herbst; Matthew,15,0,16,1
1713337203943,MMW 12R,A02,514035,Herbst; Matthew,16,0,16,0
1713337204967,MMW 13R,A01,514037,Staff,12,0,16,4
1713337204967,MMW 13R,A02,514039,Staff,16,0,16,0
1713337207018,SIO 295LS,A00,523233,Staff,19,0,30,11
1713337208045,SIO 295S,A00,523232,Staff,19,0,30,11
1713337209072,SOCI 117,A01,494376,Staff,2,0,5,3
1713337210100,WES 237B,A00,494380,Staff,19,0,20,1
1713337212203,AESE 279B,A00,494370,Wade; Jon P,33,0,33,0
1713337213230,ANAR 135S,A00,494369,Braswell; Geoffrey E.,0,0,0,0
1713337214259,CAT 124RS,A01,519847,Geibel; William,17,0,20,3
1713337215283,CAT 125RS,A01,515971,Geibel; William,17,0,20,3
1713337216310,CLRE 250,A00,511389,Morris; Sheldon,9996,0,9999,3
1713337217336,CLRE 251,A00,507176,Mehta; Ravindra L.,9996,0,9999,3
1713337217336,CLRE 251,B00,511410,Mehta; Ravindra L.,9998,0,9999,1
1713337218366,CLRE 252,A00,507189,Cuomo; Raphael Eduardo,9998,0,9999,1
1713337219393,CLRE 253,A00,507199,Vaida; Florin,9997,0,9999,2
1713337219393,CLRE 253,B00,507202,Vaida; Florin,9999,0,9999,0
1713337220423,CLRE 259,A00,507211,Patel; Hemal,9996,0,9999,3
1713337221448,CLRE 260,A00,507221,Cuomo; Raphael Eduardo,9999,0,9999,0
1713337222475,CLRE 297,001,507242,Cuomo; Raphael Eduardo,9999,0,9999,0
1713337223504,CSE 191,A00,516875,Minnes Kemp; Mor Mia,9999,0,9999,0
1713337224532,CSS 201S,A01,494383,Staff,35,0,35,0
1713337225572,CSS 202S,A01,494387,Staff,35,0,35,0
1713337226599,EAP 100,A00,516065,Staff,9792,0,9999,207
1713337227629,ECE 45,A01,507414,Staff,51,0,60,9
1713337228655,ECE 100,A01,507416,Baghdadchi; Saharnaz,10,0,20,10
1713337228655,ECE 100,A02,507418,Baghdadchi; Saharnaz,20,0,20,0
1713337229681,ECE 111,A01,507420,Staff,38,0,50,12
1713337230711,ECE 197,001,548057,Sievenpiper; Daniel F.,9998,0,9999,1
1713337231738,EDS 115,A00,507243,Choi; Bailey Miyeon,28,0,28,0
1713337232762,EDS 117,A01,494379,Staff,23,0,25,2
1713337233790,EDS 125,A00,507246,Hopkins; Megan Beth,29,0,30,1
1713337234815,EDS 128A,A01,507264,Fargason; Sharon Gayle,26,0,26,0
1713337235845,EDS 128B,A01,507293,Pappas; Elizabeth,30,0,30,0
1713337236869,EDS 139,A00,507294,Fargason; Sharon Gayle,30,0,30,0
1713337236869,EDS 139,B00,507313,Pappas; Elizabeth,30,0,30,0
1713337237899,EDS 201,A00,507315,Staff,26,0,30,4
1713337238929,EDS 203,A01,507317,Halter; Christopher P.,26,0,30,4
1713337239954,EDS 204R,A01,507319,Halter; Christopher P.,3,0,30,27
1713337239954,EDS 204R,B01,507331,Heinzman; Erica M.,28,0,30,2
1713337240983,EDS 206R,A00,507332,Staff,4,0,30,26
1713337240983,EDS 206R,B00,507343,Staff,28,0,30,2
1713337242009,EDS 250,A00,507344,Hemans; Patricia Ann Benitez,36,0,40,4
1713337243033,EDS 281,A00,507345,Daly; Alan J.,18,0,18,0
1713337244061,EDS 284,A00,507350,Daly; Alan J.,16,0,16,0
1713337245088,EDS 286,A00,507359,Fine; Sarah,18,0,18,0
1713337246114,EDS 289C,A01,507361,Daly; Alan J.,18,0,18,0
1713337247143,EDS 290,A00,507366,Hofstetter; Carolyn,15,0,15,0
1713337248172,LIGM 5A,A00,507421,Fischer-Grunski; Eva K,20,0,20,0
1713337249201,LIGM 5B,A00,507423,Fischer-Grunski; Eva K,20,0,20,0
1713337250227,LIGM 5C,A00,507425,Fischer-Grunski; Eva K,20,0,20,0
1713337251254,LIIT 5AS,A00,507427,Carnelos; Chiara,20,0,20,0
1713337252283,LIIT 5BS,A00,507430,Carnelos; Chiara,20,0,20,0
1713337253312,LIIT 5CS,A00,507432,Carnelos; Chiara,20,0,20,0
1713337254338,LISP 5A,A00,507541,Munoz Sanchez; Alicia,17,0,20,3
1713337255371,LISP 5B,A00,507671,Munoz Sanchez; Alicia,15,0,20,5
1713337256402,LISP 5C,A00,507696,Munoz Sanchez; Alicia,15,0,20,5
1713337257426,MAE 197,001,528363,Boechler; Nicholas Sebastia,9998,0,9999,1
1713337258460,MATH 197,001,523477,Kedlaya; Kiran S.,9999,0,9999,0
1713337258460,MATH 197,002,563811,Zhang; Danna,9999,0,9999,0
1713337259495,MCWP 40R,A00,518780,Staff,20,0,20,0
1713337259495,MCWP 40R,B00,518781,Staff,19,0,20,1
1713337259495,MCWP 40R,C00,518783,Staff,19,0,20,1
1713337260587,MCWP 50R,A00,518791,Staff,20,0,20,0
1713337260587,MCWP 50R,B00,518792,Staff,17,0,20,3
1713337260587,MCWP 50R,C00,518793,Staff,19,0,20,1
1713337260587,MCWP 50R,D00,518794,Staff,16,0,20,4
1713337260587,MCWP 50R,E00,518795,Staff,16,0,20,4
1713337260587,MCWP 50R,F00,518796,Staff,19,0,20,1
1713337260587,MCWP 50R,G00,518797,Staff,19,0,20,1
1713337261623,MMW 12R,A01,514034,Herbst; Matthew,15,0,16,1
1713337261623,MMW 12R,A02,514035,Herbst; Matthew,16,0,16,0
1713337262654,MMW 13R,A01,514037,Staff,12,0,16,4
1713337262654,MMW 13R,A02,514039,Staff,16,0,16,0
1713337264706,SIO 295LS,A00,523233,Staff,19,0,30,11
1713337265732,SIO 295S,A00,523232,Staff,19,0,30,11
1713337266760,SOCI 117,A01,494376,Staff,2,0,5,3
1713337267824,WES 237B,A00,494380,Staff,19,0,20,1
1713337269911,AESE 279B,A00,494370,Wade; Jon P,33,0,33,0
1713337270938,ANAR 135S,A00,494369,Braswell; Geoffrey E.,0,0,0,0
1713337271965,CAT 124RS,A01,519847,Geibel; William,17,0,20,3
1713337272991,CAT 125RS,A01,515971,Geibel; William,17,0,20,3
1713337274016,CLRE 250,A00,511389,Morris; Sheldon,9996,0,9999,3
1713337275044,CLRE 251,A00,507176,Mehta; Ravindra L.,9996,0,9999,3
1713337275044,CLRE 251,B00,511410,Mehta; Ravindra L.,9998,0,9999,1
1713337276092,CLRE 252,A00,507189,Cuomo; Raphael Eduardo,9998,0,9999,1
1713337277132,CLRE 253,A00,507199,Vaida; Florin,9997,0,9999,2
1713337277132,CLRE 253,B00,507202,Vaida; Florin,9999,0,9999,0
1713337278156,CLRE 259,A00,507211,Patel; Hemal,9996,0,9999,3
1713337279182,CLRE 260,A00,507221,Cuomo; Raphael Eduardo,9999,0,9999,0
1713337280227,CLRE 297,001,507242,Cuomo; Raphael Eduardo,9999,0,9999,0
1713337281260,CSE 191,A00,516875,Minnes Kemp; Mor Mia,9999,0,9999,0
1713337282312,CSS 201S,A01,494383,Staff,35,0,35,0
1713337283347,CSS 202S,A01,494387,Staff,35,0,35,0
1713337284371,EAP 100,A00,516065,Staff,9792,0,9999,207
1713337285407,ECE 45,A01,507414,Staff,51,0,60,9
1713337286432,ECE 100,A01,507416,Baghdadchi; Saharnaz,10,0,20,10
1713337286432,ECE 100,A02,507418,Baghdadchi; Saharnaz,20,0,20,0
1713337287465,ECE 111,A01,507420,Staff,38,0,50,12
1713337288491,ECE 197,001,548057,Sievenpiper; Daniel F.,9998,0,9999,1
1713337289526,EDS 115,A00,507243,Choi; Bailey Miyeon,28,0,28,0
1713337290550,EDS 117,A01,494379,Staff,23,0,25,2
1713337291587,EDS 125,A00,507246,Hopkins; Megan Beth,29,0,30,1
1713337292654,EDS 128A,A01,507264,Fargason; Sharon Gayle,26,0,26,0
1713337293680,EDS 128B,A01,507293,Pappas; Elizabeth,30,0,30,0
1713337294732,EDS 139,A00,507294,Fargason; Sharon Gayle,30,0,30,0
1713337294732,EDS 139,B00,507313,Pappas; Elizabeth,30,0,30,0
1713337295760,EDS 201,A00,507315,Staff,26,0,30,4
1713337296788,EDS 203,A01,507317,Halter; Christopher P.,26,0,30,4
1713337297823,EDS 204R,A01,507319,Halter; Christopher P.,3,0,30,27
1713337297823,EDS 204R,B01,507331,Heinzman; Erica M.,28,0,30,2
1713337298848,EDS 206R,A00,507332,Staff,4,0,30,26
1713337298848,EDS 206R,B00,507343,Staff,28,0,30,2
1713337299875,EDS 250,A00,507344,Hemans; Patricia Ann Benitez,36,0,40,4
1713337300905,EDS 281,A00,507345,Daly; Alan J.,18,0,18,0
1713337301936,EDS 284,A00,507350,Daly; Alan J.,16,0,16,0
1713337303018,EDS 286,A00,507359,Fine; Sarah,18,0,18,0
1713337304053,EDS 289C,A01,507361,Daly; Alan J.,18,0,18,0
1713337305151,EDS 290,A00,507366,Hofstetter; Carolyn,15,0,15,0
1713337306189,LIGM 5A,A00,507421,Fischer-Grunski; Eva K,20,0,20,0
1713337307217,LIGM 5B,A00,507423,Fischer-Grunski; Eva K,20,0,20,0
1713337308252,LIGM 5C,A00,507425,Fischer-Grunski; Eva K,20,0,20,0
1713337309284,LIIT 5AS,A00,507427,Carnelos; Chiara,20,0,20,0
1713337310319,LIIT 5BS,A00,507430,Carnelos; Chiara,20,0,20,0
1713337311343,LIIT 5CS,A00,507432,Carnelos; Chiara,20,0,20,0
1713337312404,LISP 5A,A00,507541,Munoz Sanchez; Alicia,17,0,20,3
1713337313432,LISP 5B,A00,507671,Munoz Sanchez; Alicia,15,0,20,5
1713337314458,LISP 5C,A00,507696,Munoz Sanchez; Alicia,15,0,20,5
1713337315513,MAE 197,001,528363,Boechler; Nicholas Sebastia,9998,0,9999,1
1713337316539,MATH 197,001,523477,Kedlaya; Kiran S.,9999,0,9999,0
1713337316539,MATH 197,002,563811,Zhang; Danna,9999,0,9999,0
1713337317565,MCWP 40R,A00,518780,Staff,20,0,20,0
1713337317565,MCWP 40R,B00,518781,Staff,19,0,20,1
1713337317565,MCWP 40R,C00,518783,Staff,19,0,20,1
1713337318591,MCWP 50R,A00,518791,Staff,20,0,20,0
1713337318591,MCWP 50R,B00,518792,Staff,17,0,20,3
1713337318591,MCWP 50R,C00,518793,Staff,19,0,20,1
1713337318591,MCWP 50R,D00,518794,Staff,16,0,20,4
1713337318591,MCWP 50R,E00,518795,Staff,16,0,20,4
1713337318591,MCWP 50R,F00,518796,Staff,19,0,20,1
1713337318591,MCWP 50R,G00,518797,Staff,19,0,20,1
1713337319621,MMW 12R,A01,514034,Herbst; Matthew,15,0,16,1
1713337319621,MMW 12R,A02,514035,Herbst; Matthew,16,0,16,0
1713337320651,MMW 13R,A01,514037,Staff,12,0,16,4
1713337320651,MMW 13R,A02,514039,Staff,16,0,16,0
1713337322720,SIO 295LS,A00,523233,Staff,19,0,30,11
1713337323752,SIO 295S,A00,523232,Staff,19,0,30,11
1713337324788,SOCI 117,A01,494376,Staff,2,0,5,3
1713337325818,WES 237B,A00,494380,Staff,19,0,20,1
1713337327888,AESE 279B,A00,494370,Wade; Jon P,33,0,33,0
1713337328915,ANAR 135S,A00,494369,Braswell; Geoffrey E.,0,0,0,0
1713337329950,CAT 124RS,A01,519847,Geibel; William,17,0,20,3
1713337330980,CAT 125RS,A01,515971,Geibel; William,17,0,20,3
1713337332012,CLRE 250,A00,511389,Morris; Sheldon,9996,0,9999,3
1713337333045,CLRE 251,A00,507176,Mehta; Ravindra L.,9996,0,9999,3
1713337333045,CLRE 251,B00,511410,Mehta; Ravindra L.,9998,0,9999,1
1713337334077,CLRE 252,A00,507189,Cuomo; Raphael Eduardo,9998,0,9999,1
1713337335109,CLRE 253,A00,507199,Vaida; Florin,9997,0,9999,2
1713337335109,CLRE 253,B00,507202,Vaida; Florin,9999,0,9999,0
1713337336139,CLRE 259,A00,507211,Patel; Hemal,9996,0,9999,3
1713337337170,CLRE 260,A00,507221,Cuomo; Raphael Eduardo,9999,0,9999,0
1713337338275,CLRE 297,001,507242,Cuomo; Raphael Eduardo,9999,0,9999,0
1713337339318,CSE 191,A00,516875,Minnes Kemp; Mor Mia,9999,0,9999,0
1713337340344,CSS 201S,A01,494383,Staff,35,0,35,0
1713337341370,CSS 202S,A01,494387,Staff,35,0,35,0
1713337342396,EAP 100,A00,516065,Staff,9792,0,9999,207
1713337343425,ECE 45,A01,507414,Staff,51,0,60,9
1713337344455,ECE 100,A01,507416,Baghdadchi; Saharnaz,10,0,20,10
1713337344455,ECE 100,A02,507418,Baghdadchi; Saharnaz,20,0,20,0
1713337345485,ECE 111,A01,507420,Staff,38,0,50,12
1713337346511,ECE 197,001,548057,Sievenpiper; Daniel F.,9998,0,9999,1
1713337347549,EDS 115,A00,507243,Choi; Bailey Miyeon,28,0,28,0
1713337348577,EDS 117,A01,494379,Staff,23,0,25,2
1713337349611,EDS 125,A00,507246,Hopkins; Megan Beth,29,0,30,1
1713337350642,EDS 128A,A01,507264,Fargason; Sharon Gayle,26,0,26,0
1713337351670,EDS 128B,A01,507293,Pappas; Elizabeth,30,0,30,0
1713337352705,EDS 139,A00,507294,Fargason; Sharon Gayle,30,0,30,0
1713337352705,EDS 139,B00,507313,Pappas; Elizabeth,30,0,30,0
1713337353740,EDS 201,A00,507315,Staff,26,0,30,4
1713337354765,EDS 203,A01,507317,Halter; Christopher P.,26,0,30,4
1713337355838,EDS 204R,A01,507319,Halter; Christopher P.,3,0,30,27
1713337355838,EDS 204R,B01,507331,Heinzman; Erica M.,28,0,30,2
1713337356873,EDS 206R,A00,507332,Staff,4,0,30,26
1713337356873,EDS 206R,B00,507343,Staff,28,0,30,2
1713337357904,EDS 250,A00,507344,Hemans; Patricia Ann Benitez,36,0,40,4
1713337358942,EDS 281,A00,507345,Daly; Alan J.,18,0,18,0
1713337359974,EDS 284,A00,507350,Daly; Alan J.,16,0,16,0
1713337361004,EDS 286,A00,507359,Fine; Sarah,18,0,18,0
1713337362038,EDS 289C,A01,507361,Daly; Alan J.,18,0,18,0
1713337363073,EDS 290,A00,507366,Hofstetter; Carolyn,15,0,15,0
1713337364109,LIGM 5A,A00,507421,Fischer-Grunski; Eva K,20,0,20,0
1713337365150,LIGM 5B,A00,507423,Fischer-Grunski; Eva K,20,0,20,0
1713337366183,LIGM 5C,A00,507425,Fischer-Grunski; Eva K,20,0,20,0
1713337367252,LIIT 5AS,A00,507427,Carnelos; Chiara,20,0,20,0
1713337368310,LIIT 5BS,A00,507430,Carnelos; Chiara,20,0,20,0
1713337369346,LIIT 5CS,A00,507432,Carnelos; Chiara,20,0,20,0
1713337370406,LISP 5A,A00,507541,Munoz Sanchez; Alicia,17,0,20,3
1713337371449,LISP 5B,A00,507671,Munoz Sanchez; Alicia,15,0,20,5
1713337372478,LISP 5C,A00,507696,Munoz Sanchez; Alicia,15,0,20,5
1713337373507,MAE 197,001,528363,Boechler; Nicholas Sebastia,9998,0,9999,1
1713337374543,MATH 197,001,523477,Kedlaya; Kiran S.,9999,0,9999,0
1713337374543,MATH 197,002,563811,Zhang; Danna,9999,0,9999,0
1713337375598,MCWP 40R,A00,518780,Staff,20,0,20,0
1713337375598,MCWP 40R,B00,518781,Staff,19,0,20,1
1713337375598,MCWP 40R,C00,518783,Staff,19,0,20,1
1713337376627,MCWP 50R,A00,518791,Staff,20,0,20,0
1713337376627,MCWP 50R,B00,518792,Staff,17,0,20,3
1713337376627,MCWP 50R,C00,518793,Staff,19,0,20,1
1713337376627,MCWP 50R,D00,518794,Staff,16,0,20,4
1713337376627,MCWP 50R,E00,518795,Staff,16,0,20,4
1713337376627,MCWP 50R,F00,518796,Staff,19,0,20,1
1713337376627,MCWP 50R,G00,518797,Staff,19,0,20,1
1713337377656,MMW 12R,A01,514034,Herbst; Matthew,15,0,16,1
1713337377656,MMW 12R,A02,514035,Herbst; Matthew,16,0,16,0
1713337378687,MMW 13R,A01,514037,Staff,12,0,16,4
1713337378687,MMW 13R,A02,514039,Staff,16,0,16,0
1713337380778,SIO 295LS,A00,523233,Staff,19,0,30,11
1713337381813,SIO 295S,A00,523232,Staff,19,0,30,11
1713337382882,SOCI 117,A01,494376,Staff,2,0,5,3
1713337383912,WES 237B,A00,494380,Staff,19,0,20,1
1713337386006,AESE 279B,A00,494370,Wade; Jon P,33,0,33,0
1713337387032,ANAR 135S,A00,494369,Braswell; Geoffrey E.,0,0,0,0
1713337388057,CAT 124RS,A01,519847,Geibel; William,17,0,20,3
1713337389087,CAT 125RS,A01,515971,Geibel; William,17,0,20,3
1713337390136,CLRE 250,A00,511389,Morris; Sheldon,9996,0,9999,3
1713337391162,CLRE 251,A00,507176,Mehta; Ravindra L.,9996,0,9999,3
1713337391162,CLRE 251,B00,511410,Mehta; Ravindra L.,9998,0,9999,1
1713337392187,CLRE 252,A00,507189,Cuomo; Raphael Eduardo,9998,0,9999,1
1713337393213,CLRE 253,A00,507199,Vaida; Florin,9997,0,9999,2
1713337393213,CLRE 253,B00,507202,Vaida; Florin,9999,0,9999,0
1713337394239,CLRE 259,A00,507211,Patel; Hemal,9996,0,9999,3
1713337395270,CLRE 260,A00,507221,Cuomo; Raphael Eduardo,9999,0,9999,0
1713337396295,CLRE 297,001,507242,Cuomo; Raphael Eduardo,9999,0,9999,0
1713337397320,CSE 191,A00,516875,Minnes Kemp; Mor Mia,9999,0,9999,0
1713337398357,CSS 201S,A01,494383,Staff,35,0,35,0
1713337399390,CSS 202S,A01,494387,Staff,35,0,35,0
1713337400415,EAP 100,A00,516065,Staff,9792,0,9999,207
1713337401440,ECE 45,A01,507414,Staff,51,0,60,9
1713337402467,ECE 100,A01,507416,Baghdadchi; Saharnaz,10,0,20,10
1713337402467,ECE 100,A02,507418,Baghdadchi; Saharnaz,20,0,20,0
1713337403492,ECE 111,A01,507420,Staff,38,0,50,12
1713337404518,ECE 197,001,548057,Sievenpiper; Daniel F.,9998,0,9999,1
1713337405555,EDS 115,A00,507243,Choi; Bailey Miyeon,28,0,28,0
1713337406589,EDS 117,A01,494379,Staff,23,0,25,2
1713337407619,EDS 125,A00,507246,Hopkins; Megan Beth,29,0,30,1
1713337408653,EDS 128A,A01,507264,Fargason; Sharon Gayle,26,0,26,0
1713337409733,EDS 128B,A01,507293,Pappas; Elizabeth,30,0,30,0
1713337410760,EDS 139,A00,507294,Fargason; Sharon Gayle,30,0,30,0
1713337410760,EDS 139,B00,507313,Pappas; Elizabeth,30,0,30,0
1713337411784,EDS 201,A00,507315,Staff,26,0,30,4
1713337412815,EDS 203,A01,507317,Halter; Christopher P.,26,0,30,4
1713337413840,EDS 204R,A01,507319,Halter; Christopher P.,3,0,30,27
1713337413840,EDS 204R,B01,507331,Heinzman; Erica M.,28,0,30,2
1713337414867,EDS 206R,A00,507332,Staff,4,0,30,26
1713337414867,EDS 206R,B00,507343,Staff,28,0,30,2
1713337415897,EDS 250,A00,507344,Hemans; Patricia Ann Benitez,36,0,40,4
1713337416927,EDS 281,A00,507345,Daly; Alan J.,18,0,18,0
1713337417952,EDS 284,A00,507350,Daly; Alan J.,16,0,16,0
1713337418985,EDS 286,A00,507359,Fine; Sarah,18,0,18,0
1713337420016,EDS 289C,A01,507361,Daly; Alan J.,18,0,18,0
1713337421042,EDS 290,A00,507366,Hofstetter; Carolyn,15,0,15,0
1713337422077,LIGM 5A,A00,507421,Fischer-Grunski; Eva K,20,0,20,0
1713337423110,LIGM 5B,A00,507423,Fischer-Grunski; Eva K,20,0,20,0
1713337424137,LIGM 5C,A00,507425,Fischer-Grunski; Eva K,20,0,20,0
1713337425165,LIIT 5AS,A00,507427,Carnelos; Chiara,20,0,20,0
1713337426191,LIIT 5BS,A00,507430,Carnelos; Chiara,20,0,20,0
1713337427216,LIIT 5CS,A00,507432,Carnelos; Chiara,20,0,20,0
1713337428241,LISP 5A,A00,507541,Munoz Sanchez; Alicia,17,0,20,3
1713337429272,LISP 5B,A00,507671,Munoz Sanchez; Alicia,15,0,20,5
1713337430297,LISP 5C,A00,507696,Munoz Sanchez; Alicia,15,0,20,5
1713337431322,MAE 197,001,528363,Boechler; Nicholas Sebastia,9998,0,9999,1
1713337432360,MATH 197,001,523477,Kedlaya; Kiran S.,9999,0,9999,0
1713337432360,MATH 197,002,563811,Zhang; Danna,9999,0,9999,0
1713337433392,MCWP 40R,A00,518780,Staff,20,0,20,0
1713337433392,MCWP 40R,B00,518781,Staff,19,0,20,1
1713337433392,MCWP 40R,C00,518783,Staff,19,0,20,1
1713337434423,MCWP 50R,A00,518791,Staff,20,0,20,0
1713337434423,MCWP 50R,B00,518792,Staff,17,0,20,3
1713337434423,MCWP 50R,C00,518793,Staff,19,0,20,1
1713337434423,MCWP 50R,D00,518794,Staff,16,0,20,4
1713337434423,MCWP 50R,E00,518795,Staff,16,0,20,4
1713337434423,MCWP 50R,F00,518796,Staff,19,0,20,1
1713337434423,MCWP 50R,G00,518797,Staff,19,0,20,1
1713337435448,MMW 12R,A01,514034,Herbst; Matthew,15,0,16,1
1713337435448,MMW 12R,A02,514035,Herbst; Matthew,16,0,16,0
1713337436478,MMW 13R,A01,514037,Staff,12,0,16,4
1713337436478,MMW 13R,A02,514039,Staff,16,0,16,0
1713337438530,SIO 295LS,A00,523233,Staff,19,0,30,11
1713337439555,SIO 295S,A00,523232,Staff,19,0,30,11
1713337440582,SOCI 117,A01,494376,Staff,2,0,5,3
1713337441609,WES 237B,A00,494380,Staff,19,0,20,1
1713337443686,AESE 279B,A00,494370,Wade; Jon P,33,0,33,0
1713337444714,ANAR 135S,A00,494369,Braswell; Geoffrey E.,0,0,0,0
1713337445740,CAT 124RS,A01,519847,Geibel; William,17,0,20,3
1713337446766,CAT 125RS,A01,515971,Geibel; William,17,0,20,3
1713337447792,CLRE 250,A00,511389,Morris; Sheldon,9996,0,9999,3
1713337448827,CLRE 251,A00,507176,Mehta; Ravindra L.,9996,0,9999,3
1713337448827,CLRE 251,B00,511410,Mehta; Ravindra L.,9998,0,9999,1
1713337449862,CLRE 252,A00,507189,Cuomo; Raphael Eduardo,9998,0,9999,1
1713337450889,CLRE 253,A00,507199,Vaida; Florin,9997,0,9999,2
1713337450889,CLRE 253,B00,507202,Vaida; Florin,9999,0,9999,0
1713337451936,CLRE 259,A00,507211,Patel; Hemal,9996,0,9999,3
1713337452968,CLRE 260,A00,507221,Cuomo; Raphael Eduardo,9999,0,9999,0
1713337454002,CLRE 297,001,507242,Cuomo; Raphael Eduardo,9999,0,9999,0
1713337455035,CSE 191,A00,516875,Minnes Kemp; Mor Mia,9999,0,9999,0
1713337456063,CSS 201S,A01,494383,Staff,35,0,35,0
1713337457097,CSS 202S,A01,494387,Staff,35,0,35,0
1713337458122,EAP 100,A00,516065,Staff,9792,0,9999,207
1713337459152,ECE 45,A01,507414,Staff,51,0,60,9
1713337460179,ECE 100,A01,507416,Baghdadchi; Saharnaz,10,0,20,10
1713337460179,ECE 100,A02,507418,Baghdadchi; Saharnaz,20,0,20,0
1713337461205,ECE 111,A01,507420,Staff,38,0,50,12
1713337462233,ECE 197,001,548057,Sievenpiper; Daniel F.,9998,0,9999,1
1713337463260,EDS 115,A00,507243,Choi; Bailey Miyeon,28,0,28,0
1713337464291,EDS 117,A01,494379,Staff,23,0,25,2
1713337465323,EDS 125,A00,507246,Hopkins; Megan Beth,29,0,30,1
1713337466355,EDS 128A,A01,507264,Fargason; Sharon Gayle,26,0,26,0
1713337467389,EDS 128B,A01,507293,Pappas; Elizabeth,30,0,30,0
1713337468414,EDS 139,A00,507294,Fargason; Sharon Gayle,30,0,30,0
1713337468414,EDS 139,B00,507313,Pappas; Elizabeth,30,0,30,0
1713337469445,EDS 201,A00,507315,Staff,26,0,30,4
1713337470473,EDS 203,A01,507317,Halter; Christopher P.,26,0,30,4
1713337471501,EDS 204R,A01,507319,Halter; Christopher P.,3,0,30,27
1713337471501,EDS 204R,B01,507331,Heinzman; Erica M.,28,0,30,2
1713337472531,EDS 206R,A00,507332,Staff,4,0,30,26
1713337472531,EDS 206R,B00,507343,Staff,28,0,30,2
1713337473561,EDS 250,A00,507344,Hemans; Patricia Ann Benitez,36,0,40,4
1713337474591,EDS 281,A00,507345,Daly; Alan J.,18,0,18,0
1713337475615,EDS 284,A00,507350,Daly; Alan J.,16,0,16,0
1713337476642,EDS 286,A00,507359,Fine; Sarah,18,0,18,0
1713337477667,EDS 289C,A01,507361,Daly; Alan J.,18,0,18,0
1713337478694,EDS 290,A00,507366,Hofstetter; Carolyn,15,0,15,0
1713337479722,LIGM 5A,A00,507421,Fischer-Grunski; Eva K,20,0,20,0
1713337480754,LIGM 5B,A00,507423,Fischer-Grunski; Eva K,20,0,20,0
1713337481780,LIGM 5C,A00,507425,Fischer-Grunski; Eva K,20,0,20,0
1713337482811,LIIT 5AS,A00,507427,Carnelos; Chiara,20,0,20,0
1713337483848,LIIT 5BS,A00,507430,Carnelos; Chiara,20,0,20,0
1713337484881,LIIT 5CS,A00,507432,Carnelos; Chiara,20,0,20,0
1713337485908,LISP 5A,A00,507541,Munoz Sanchez; Alicia,17,0,20,3
1713337486933,LISP 5B,A00,507671,Munoz Sanchez; Alicia,15,0,20,5
1713337487959,LISP 5C,A00,507696,Munoz Sanchez; Alicia,15,0,20,5
1713337488985,MAE 197,001,528363,Boechler; Nicholas Sebastia,9998,0,9999,1
1713337490019,MATH 197,001,523477,Kedlaya; Kiran S.,9999,0,9999,0
1713337490019,MATH 197,002,563811,Zhang; Danna,9999,0,9999,0
1713337491044,MCWP 40R,A00,518780,Staff,20,0,20,0
1713337491044,MCWP 40R,B00,518781,Staff,19,0,20,1
1713337491044,MCWP 40R,C00,518783,Staff,19,0,20,1
1713337492070,MCWP 50R,A00,518791,Staff,20,0,20,0
1713337492070,MCWP 50R,B00,518792,Staff,17,0,20,3
1713337492070,MCWP 50R,C00,518793,Staff,19,0,20,1
1713337492070,MCWP 50R,D00,518794,Staff,16,0,20,4
1713337492070,MCWP 50R,E00,518795,Staff,16,0,20,4
1713337492070,MCWP 50R,F00,518796,Staff,19,0,20,1
1713337492070,MCWP 50R,G00,518797,Staff,19,0,20,1
1713337493101,MMW 12R,A01,514034,Herbst; Matthew,15,0,16,1
1713337493101,MMW 12R,A02,514035,Herbst; Matthew,16,0,16,0
1713337494129,MMW 13R,A01,514037,Staff,12,0,16,4
1713337494129,MMW 13R,A02,514039,Staff,16,0,16,0
1713337496186,SIO 295LS,A00,523233,Staff,19,0,30,11
1713337497209,SIO 295S,A00,523232,Staff,19,0,30,11
1713337498235,SOCI 117,A01,494376,Staff,1,0,5,4
1713337499265,WES 237B,A00,494380,Staff,19,0,20,1
1713337501348,AESE 279B,A00,494370,Wade; Jon P,33,0,33,0
1713337502379,ANAR 135S,A00,494369,Braswell; Geoffrey E.,0,0,0,0
1713337503403,CAT 124RS,A01,519847,Geibel; William,17,0,20,3
1713337504429,CAT 125RS,A01,515971,Geibel; William,17,0,20,3
1713337505455,CLRE 250,A00,511389,Morris; Sheldon,9996,0,9999,3
1713337506483,CLRE 251,A00,507176,Mehta; Ravindra L.,9996,0,9999,3
1713337506483,CLRE 251,B00,511410,Mehta; Ravindra L.,9998,0,9999,1
1713337507510,CLRE 252,A00,507189,Cuomo; Raphael Eduardo,9998,0,9999,1
1713337508536,CLRE 253,A00,507199,Vaida; Florin,9997,0,9999,2
1713337508536,CLRE 253,B00,507202,Vaida; Florin,9999,0,9999,0
1713337509566,CLRE 259,A00,507211,Patel; Hemal,9996,0,9999,3
1713337510592,CLRE 260,A00,507221,Cuomo; Raphael Eduardo,9999,0,9999,0
1713337511620,CLRE 297,001,507242,Cuomo; Raphael Eduardo,9999,0,9999,0
1713337512653,CSE 191,A00,516875,Minnes Kemp; Mor Mia,9999,0,9999,0
1713337513732,CSS 201S,A01,494383,Staff,35,0,35,0
1713337514764,CSS 202S,A01,494387,Staff,35,0,35,0
1713337515790,EAP 100,A00,516065,Staff,9792,0,9999,207
1713337516820,ECE 45,A01,507414,Staff,51,0,60,9
1713337517845,ECE 100,A01,507416,Baghdadchi; Saharnaz,10,0,20,10
1713337517845,ECE 100,A02,507418,Baghdadchi; Saharnaz,20,0,20,0
1713337518927,ECE 111,A01,507420,Staff,38,0,50,12
1713337519956,ECE 197,001,548057,Sievenpiper; Daniel F.,9998,0,9999,1
1713337520986,EDS 115,A00,507243,Choi; Bailey Miyeon,28,0,28,0
1713337522012,EDS 117,A01,494379,Staff,23,0,25,2
1713337523044,EDS 125,A00,507246,Hopkins; Megan Beth,29,0,30,1
1713337524072,EDS 128A,A01,507264,Fargason; Sharon Gayle,26,0,26,0
1713337525099,EDS 128B,A01,507293,Pappas; Elizabeth,30,0,30,0
1713337526132,EDS 139,A00,507294,Fargason; Sharon Gayle,30,0,30,0
1713337526132,EDS 139,B00,507313,Pappas; Elizabeth,30,0,30,0
1713337527176,EDS 201,A00,507315,Staff,26,0,30,4
1713337528220,EDS 203,A01,507317,Halter; Christopher P.,26,0,30,4
1713337529253,EDS 204R,A01,507319,Halter; Christopher P.,3,0,30,27
1713337529253,EDS 204R,B01,507331,Heinzman; Erica M.,28,0,30,2
1713337530277,EDS 206R,A00,507332,Staff,4,0,30,26
1713337530277,EDS 206R,B00,507343,Staff,28,0,30,2
1713337531308,EDS 250,A00,507344,Hemans; Patricia Ann Benitez,36,0,40,4
1713337532333,EDS 281,A00,507345,Daly; Alan J.,18,0,18,0
1713337533357,EDS 284,A00,507350,Daly; Alan J.,16,0,16,0
1713337534390,EDS 286,A00,507359,Fine; Sarah,18,0,18,0
1713337535423,EDS 289C,A01,507361,Daly; Alan J.,18,0,18,0
1713337536448,EDS 290,A00,507366,Hofstetter; Carolyn,15,0,15,0
1713337537477,LIGM 5A,A00,507421,Fischer-Grunski; Eva K,20,0,20,0
1713337538516,LIGM 5B,A00,507423,Fischer-Grunski; Eva K,20,0,20,0
1713337539542,LIGM 5C,A00,507425,Fischer-Grunski; Eva K,20,0,20,0
1713337540569,LIIT 5AS,A00,507427,Carnelos; Chiara,20,0,20,0
1713337541601,LIIT 5BS,A00,507430,Carnelos; Chiara,20,0,20,0
1713337542628,LIIT 5CS,A00,507432,Carnelos; Chiara,20,0,20,0
1713337543659,LISP 5A,A00,507541,Munoz Sanchez; Alicia,17,0,20,3
1713337544685,LISP 5B,A00,507671,Munoz Sanchez; Alicia,15,0,20,5
1713337545710,LISP 5C,A00,507696,Munoz Sanchez; Alicia,15,0,20,5
1713337546749,MAE 197,001,528363,Boechler; Nicholas Sebastia,9998,0,9999,1
1713337547780,MATH 197,001,523477,Kedlaya; Kiran S.,9999,0,9999,0
1713337547780,MATH 197,002,563811,Zhang; Danna,9999,0,9999,0
1713337548815,MCWP 40R,A00,518780,Staff,20,0,20,0
1713337548815,MCWP 40R,B00,518781,Staff,19,0,20,1
1713337548815,MCWP 40R,C00,518783,Staff,19,0,20,1
1713337549841,MCWP 50R,A00,518791,Staff,20,0,20,0
1713337549841,MCWP 50R,B00,518792,Staff,17,0,20,3
1713337549841,MCWP 50R,C00,518793,Staff,19,0,20,1
1713337549841,MCWP 50R,D00,518794,Staff,16,0,20,4
1713337549841,MCWP 50R,E00,518795,Staff,16,0,20,4
1713337549841,MCWP 50R,F00,518796,Staff,19,0,20,1
1713337549841,MCWP 50R,G00,518797,Staff,19,0,20,1
1713337550866,MMW 12R,A01,514034,Herbst; Matthew,15,0,16,1
1713337550866,MMW 12R,A02,514035,Herbst; Matthew,16,0,16,0
1713337551890,MMW 13R,A01,514037,Staff,12,0,16,4
1713337551890,MMW 13R,A02,514039,Staff,16,0,16,0
1713337553944,SIO 295LS,A00,523233,Staff,19,0,30,11
1713337554970,SIO 295S,A00,523232,Staff,19,0,30,11
1713337556024,SOCI 117,A01,494376,Staff,1,0,5,4
1713337557054,WES 237B,A00,494380,Staff,19,0,20,1
1713337559143,AESE 279B,A00,494370,Wade; Jon P,33,0,33,0
1713337560175,ANAR 135S,A00,494369,Braswell; Geoffrey E.,0,0,0,0
1713337561202,CAT 124RS,A01,519847,Geibel; William,17,0,20,3
1713337562228,CAT 125RS,A01,515971,Geibel; William,17,0,20,3
1713337563277,CLRE 250,A00,511389,Morris; Sheldon,9996,0,9999,3
1713337564305,CLRE 251,A00,507176,Mehta; Ravindra L.,9996,0,9999,3
1713337564305,CLRE 251,B00,511410,Mehta; Ravindra L.,9998,0,9999,1
1713337565332,CLRE 252,A00,507189,Cuomo; Raphael Eduardo,9998,0,9999,1
1713337566359,CLRE 253,A00,507199,Vaida; Florin,9997,0,9999,2
1713337566359,CLRE 253,B00,507202,Vaida; Florin,9999,0,9999,0
1713337567386,CLRE 259,A00,507211,Patel; Hemal,9996,0,9999,3
1713337568416,CLRE 260,A00,507221,Cuomo; Raphael Eduardo,9999,0,9999,0
1713337569441,CLRE 297,001,507242,Cuomo; Raphael Eduardo,9999,0,9999,0
1713337570466,CSE 191,A00,516875,Minnes Kemp; Mor Mia,9999,0,9999,0
1713337571492,CSS 201S,A01,494383,Staff,35,0,35,0
1713337572529,CSS 202S,A01,494387,Staff,35,0,35,0
1713337573560,EAP 100,A00,516065,Staff,9792,0,9999,207
1713337574594,ECE 45,A01,507414,Staff,51,0,60,9
1713337575621,ECE 100,A01,507416,Baghdadchi; Saharnaz,10,0,20,10
1713337575621,ECE 100,A02,507418,Baghdadchi; Saharnaz,20,0,20,0
1713337576651,ECE 111,A01,507420,Staff,38,0,50,12
1713337577680,ECE 197,001,548057,Sievenpiper; Daniel F.,9998,0,9999,1
1713337578724,EDS 115,A00,507243,Choi; Bailey Miyeon,28,0,28,0
1713337579760,EDS 117,A01,494379,Staff,23,0,25,2
1713337580785,EDS 125,A00,507246,Hopkins; Megan Beth,29,0,30,1
1713337581809,EDS 128A,A01,507264,Fargason; Sharon Gayle,26,0,26,0
1713337582840,EDS 128B,A01,507293,Pappas; Elizabeth,30,0,30,0
1713337583872,EDS 139,A00,507294,Fargason; Sharon Gayle,30,0,30,0
1713337583872,EDS 139,B00,507313,Pappas; Elizabeth,30,0,30,0
1713337584903,EDS 201,A00,507315,Staff,26,0,30,4
1713337585935,EDS 203,A01,507317,Halter; Christopher P.,26,0,30,4
1713337586969,EDS 204R,A01,507319,Halter; Christopher P.,3,0,30,27
1713337586969,EDS 204R,B01,507331,Heinzman; Erica M.,28,0,30,2
1713337587993,EDS 206R,A00,507332,Staff,4,0,30,26
1713337587993,EDS 206R,B00,507343,Staff,28,0,30,2
1713337589019,EDS 250,A00,507344,Hemans; Patricia Ann Benitez,36,0,40,4
1713337590047,EDS 281,A00,507345,Daly; Alan J.,18,0,18,0
1713337591079,EDS 284,A00,507350,Daly; Alan J.,16,0,16,0
1713337592109,EDS 286,A00,507359,Fine; Sarah,18,0,18,0
1713337593134,EDS 289C,A01,507361,Daly; Alan J.,18,0,18,0
1713337594159,EDS 290,A00,507366,Hofstetter; Carolyn,15,0,15,0
1713337595187,LIGM 5A,A00,507421,Fischer-Grunski; Eva K,20,0,20,0
1713337596216,LIGM 5B,A00,507423,Fischer-Grunski; Eva K,20,0,20,0
1713337597242,LIGM 5C,A00,507425,Fischer-Grunski; Eva K,20,0,20,0
1713337598274,LIIT 5AS,A00,507427,Carnelos; Chiara,20,0,20,0
1713337599305,LIIT 5BS,A00,507430,Carnelos; Chiara,20,0,20,0
1713337600335,LIIT 5CS,A00,507432,Carnelos; Chiara,20,0,20,0
1713337601367,LISP 5A,A00,507541,Munoz Sanchez; Alicia,17,0,20,3
1713337602398,LISP 5B,A00,507671,Munoz Sanchez; Alicia,15,0,20,5
1713337603423,LISP 5C,A00,507696,Munoz Sanchez; Alicia,15,0,20,5
1713337604450,MAE 197,001,528363,Boechler; Nicholas Sebastia,9998,0,9999,1
1713337605484,MATH 197,001,523477,Kedlaya; Kiran S.,9999,0,9999,0
1713337605484,MATH 197,002,563811,Zhang; Danna,9999,0,9999,0
1713337606516,MCWP 40R,A00,518780,Staff,20,0,20,0
1713337606516,MCWP 40R,B00,518781,Staff,19,0,20,1
1713337606516,MCWP 40R,C00,518783,Staff,19,0,20,1
1713337607550,MCWP 50R,A00,518791,Staff,20,0,20,0
1713337607550,MCWP 50R,B00,518792,Staff,17,0,20,3
1713337607550,MCWP 50R,C00,518793,Staff,19,0,20,1
1713337607550,MCWP 50R,D00,518794,Staff,16,0,20,4
1713337607550,MCWP 50R,E00,518795,Staff,16,0,20,4
1713337607550,MCWP 50R,F00,518796,Staff,19,0,20,1
1713337607550,MCWP 50R,G00,518797,Staff,19,0,20,1
1713337608580,MMW 12R,A01,514034,Herbst; Matthew,15,0,16,1
1713337608580,MMW 12R,A02,514035,Herbst; Matthew,16,0,16,0
1713337609611,MMW 13R,A01,514037,Staff,12,0,16,4
1713337609611,MMW 13R,A02,514039,Staff,16,0,16,0
1713337611669,SIO 295LS,A00,523233,Staff,19,0,30,11
1713337612698,SIO 295S,A00,523232,Staff,19,0,30,11
1713337613728,SOCI 117,A01,494376,Staff,1,0,5,4
1713337614757,WES 237B,A00,494380,Staff,19,0,20,1
1713337616826,AESE 279B,A00,494370,Wade; Jon P,33,0,33,0
1713337617910,ANAR 135S,A00,494369,Braswell; Geoffrey E.,0,0,0,0
1713337618937,CAT 124RS,A01,519847,Geibel; William,17,0,20,3
1713337619963,CAT 125RS,A01,515971,Geibel; William,17,0,20,3
1713337620996,CLRE 250,A00,511389,Morris; Sheldon,9996,0,9999,3
1713337622025,CLRE 251,A00,507176,Mehta; Ravindra L.,9996,0,9999,3
1713337622025,CLRE 251,B00,511410,Mehta; Ravindra L.,9998,0,9999,1
1713337623051,CLRE 252,A00,507189,Cuomo; Raphael Eduardo,9998,0,9999,1
1713337624077,CLRE 253,A00,507199,Vaida; Florin,9997,0,9999,2
1713337624077,CLRE 253,B00,507202,Vaida; Florin,9999,0,9999,0
1713337625103,CLRE 259,A00,507211,Patel; Hemal,9996,0,9999,3
1713337626132,CLRE 260,A00,507221,Cuomo; Raphael Eduardo,9999,0,9999,0
1713337627160,CLRE 297,001,507242,Cuomo; Raphael Eduardo,9999,0,9999,0
1713337628187,CSE 191,A00,516875,Minnes Kemp; Mor Mia,9999,0,9999,0
1713337629218,CSS 201S,A01,494383,Staff,35,0,35,0
1713337630249,CSS 202S,A01,494387,Staff,35,0,35,0
1713337631277,EAP 100,A00,516065,Staff,9792,0,9999,207
1713337632303,ECE 45,A01,507414,Staff,51,0,60,9
1713337633335,ECE 100,A01,507416,Baghdadchi; Saharnaz,10,0,20,10
1713337633335,ECE 100,A02,507418,Baghdadchi; Saharnaz,20,0,20,0
1713337634358,ECE 111,A01,507420,Staff,38,0,50,12
1713337635388,ECE 197,001,548057,Sievenpiper; Daniel F.,9998,0,9999,1
1713337636419,EDS 115,A00,507243,Choi; Bailey Miyeon,28,0,28,0
1713337637446,EDS 117,A01,494379,Staff,23,0,25,2
1713337638475,EDS 125,A00,507246,Hopkins; Megan Beth,29,0,30,1
1713337639506,EDS 128A,A01,507264,Fargason; Sharon Gayle,26,0,26,0
1713337640536,EDS 128B,A01,507293,Pappas; Elizabeth,30,0,30,0
1713337641564,EDS 139,A00,507294,Fargason; Sharon Gayle,30,0,30,0
1713337641564,EDS 139,B00,507313,Pappas; Elizabeth,30,0,30,0
1713337642587,EDS 201,A00,507315,Staff,26,0,30,4
1713337643614,EDS 203,A01,507317,Halter; Christopher P.,26,0,30,4
1713337644640,EDS 204R,A01,507319,Halter; Christopher P.,3,0,30,27
1713337644640,EDS 204R,B01,507331,Heinzman; Erica M.,28,0,30,2
1713337645666,EDS 206R,A00,507332,Staff,4,0,30,26
1713337645666,EDS 206R,B00,507343,Staff,28,0,30,2
1713337646695,EDS 250,A00,507344,Hemans; Patricia Ann Benitez,36,0,40,4
1713337647721,EDS 281,A00,507345,Daly; Alan J.,18,0,18,0
1713337648748,EDS 284,A00,507350,Daly; Alan J.,16,0,16,0
1713337649780,EDS 286,A00,507359,Fine; Sarah,18,0,18,0
1713337650808,EDS 289C,A01,507361,Daly; Alan J.,18,0,18,0
1713337651838,EDS 290,A00,507366,Hofstetter; Carolyn,15,0,15,0
1713337652868,LIGM 5A,A00,507421,Fischer-Grunski; Eva K,20,0,20,0
1713337653901,LIGM 5B,A00,507423,Fischer-Grunski; Eva K,20,0,20,0
1713337654930,LIGM 5C,A00,507425,Fischer-Grunski; Eva K,20,0,20,0
1713337655956,LIIT 5AS,A00,507427,Carnelos; Chiara,20,0,20,0
1713337656981,LIIT 5BS,A00,507430,Carnelos; Chiara,20,0,20,0
1713337658012,LIIT 5CS,A00,507432,Carnelos; Chiara,20,0,20,0
1713337659043,LISP 5A,A00,507541,Munoz Sanchez; Alicia,17,0,20,3
1713337660067,LISP 5B,A00,507671,Munoz Sanchez; Alicia,15,0,20,5
1713337661093,LISP 5C,A00,507696,Munoz Sanchez; Alicia,15,0,20,5
1713337662118,MAE 197,001,528363,Boechler; Nicholas Sebastia,9998,0,9999,1
1713337663147,MATH 197,001,523477,Kedlaya; Kiran S.,9999,0,9999,0
1713337663147,MATH 197,002,563811,Zhang; Danna,9999,0,9999,0
1713337664178,MCWP 40R,A00,518780,Staff,20,0,20,0
1713337664178,MCWP 40R,B00,518781,Staff,19,0,20,1
1713337664178,MCWP 40R,C00,518783,Staff,19,0,20,1
1713337665208,MCWP 50R,A00,518791,Staff,20,0,20,0
1713337665208,MCWP 50R,B00,518792,Staff,17,0,20,3
1713337665208,MCWP 50R,C00,518793,Staff,19,0,20,1
1713337665208,MCWP 50R,D00,518794,Staff,16,0,20,4
1713337665208,MCWP 50R,E00,518795,Staff,16,0,20,4
1713337665208,MCWP 50R,F00,518796,Staff,19,0,20,1
1713337665208,MCWP 50R,G00,518797,Staff,19,0,20,1
1713337666235,MMW 12R,A01,514034,Herbst; Matthew,15,0,16,1
1713337666235,MMW 12R,A02,514035,Herbst; Matthew,16,0,16,0
1713337667264,MMW 13R,A01,514037,Staff,12,0,16,4
1713337667264,MMW 13R,A02,514039,Staff,16,0,16,0
1713337669316,SIO 295LS,A00,523233,Staff,19,0,30,11
1713337670346,SIO 295S,A00,523232,Staff,19,0,30,11
1713337671371,SOCI 117,A01,494376,Staff,1,0,5,4
1713337672397,WES 237B,A00,494380,Staff,19,0,20,1
1713337674473,AESE 279B,A00,494370,Wade; Jon P,33,0,33,0
1713337675503,ANAR 135S,A00,494369,Braswell; Geoffrey E.,0,0,0,0
1713337676541,CAT 124RS,A01,519847,Geibel; William,17,0,20,3
1713337677571,CAT 125RS,A01,515971,Geibel; William,17,0,20,3
1713337678595,CLRE 250,A00,511389,Morris; Sheldon,9996,0,9999,3
1713337679622,CLRE 251,A00,507176,Mehta; Ravindra L.,9996,0,9999,3
1713337679622,CLRE 251,B00,511410,Mehta; Ravindra L.,9998,0,9999,1
1713337680648,CLRE 252,A00,507189,Cuomo; Raphael Eduardo,9998,0,9999,1
1713337681674,CLRE 253,A00,507199,Vaida; Florin,9997,0,9999,2
1713337681674,CLRE 253,B00,507202,Vaida; Florin,9999,0,9999,0
1713337682700,CLRE 259,A00,507211,Patel; Hemal,9996,0,9999,3
1713337683729,CLRE 260,A00,507221,Cuomo; Raphael Eduardo,9999,0,9999,0
1713337684757,CLRE 297,001,507242,Cuomo; Raphael Eduardo,9999,0,9999,0
1713337685782,CSE 191,A00,516875,Minnes Kemp; Mor Mia,9999,0,9999,0
1713337686809,CSS 201S,A01,494383,Staff,35,0,35,0
1713337687839,CSS 202S,A01,494387,Staff,35,0,35,0
1713337688864,EAP 100,A00,516065,Staff,9792,0,9999,207
1713337689893,ECE 45,A01,507414,Staff,51,0,60,9
1713337690943,ECE 100,A01,507416,Baghdadchi; Saharnaz,10,0,20,10
1713337690943,ECE 100,A02,507418,Baghdadchi; Saharnaz,20,0,20,0
1713337691968,ECE 111,A01,507420,Staff,38,0,50,12
1713337692994,ECE 197,001,548057,Sievenpiper; Daniel F.,9998,0,9999,1
1713337694021,EDS 115,A00,507243,Choi; Bailey Miyeon,28,0,28,0
1713337695052,EDS 117,A01,494379,Staff,23,0,25,2
1713337696082,EDS 125,A00,507246,Hopkins; Megan Beth,29,0,30,1
1713337697109,EDS 128A,A01,507264,Fargason; Sharon Gayle,26,0,26,0
1713337698133,EDS 128B,A01,507293,Pappas; Elizabeth,30,0,30,0
1713337699159,EDS 139,A00,507294,Fargason; Sharon Gayle,30,0,30,0
1713337699159,EDS 139,B00,507313,Pappas; Elizabeth,30,0,30,0
1713337700184,EDS 201,A00,507315,Staff,26,0,30,4
1713337701210,EDS 203,A01,507317,Halter; Christopher P.,26,0,30,4
1713337702236,EDS 204R,A01,507319,Halter; Christopher P.,3,0,30,27
1713337702236,EDS 204R,B01,507331,Heinzman; Erica M.,28,0,30,2
1713337703260,EDS 206R,A00,507332,Staff,4,0,30,26
1713337703260,EDS 206R,B00,507343,Staff,28,0,30,2
1713337704285,EDS 250,A00,507344,Hemans; Patricia Ann Benitez,36,0,40,4
1713337705312,EDS 281,A00,507345,Daly; Alan J.,18,0,18,0
1713337706338,EDS 284,A00,507350,Daly; Alan J.,16,0,16,0
1713337707364,EDS 286,A00,507359,Fine; Sarah,18,0,18,0
1713337708389,EDS 289C,A01,507361,Daly; Alan J.,18,0,18,0
1713337709414,EDS 290,A00,507366,Hofstetter; Carolyn,15,0,15,0
1713337710444,LIGM 5A,A00,507421,Fischer-Grunski; Eva K,20,0,20,0
1713337711475,LIGM 5B,A00,507423,Fischer-Grunski; Eva K,20,0,20,0
1713337712500,LIGM 5C,A00,507425,Fischer-Grunski; Eva K,20,0,20,0
1713337713531,LIIT 5AS,A00,507427,Carnelos; Chiara,20,0,20,0
1713337714560,LIIT 5BS,A00,507430,Carnelos; Chiara,20,0,20,0
1713337715595,LIIT 5CS,A00,507432,Carnelos; Chiara,20,0,20,0
1713337716622,LISP 5A,A00,507541,Munoz Sanchez; Alicia,17,0,20,3
1713337717651,LISP 5B,A00,507671,Munoz Sanchez; Alicia,15,0,20,5
1713337718677,LISP 5C,A00,507696,Munoz Sanchez; Alicia,15,0,20,5
1713337719702,MAE 197,001,528363,Boechler; Nicholas Sebastia,9998,0,9999,1
1713337720733,MATH 197,001,523477,Kedlaya; Kiran S.,9999,0,9999,0
1713337720733,MATH 197,002,563811,Zhang; Danna,9999,0,9999,0
1713337721813,MCWP 40R,A00,518780,Staff,20,0,20,0
1713337721813,MCWP 40R,B00,518781,Staff,19,0,20,1
1713337721813,MCWP 40R,C00,518783,Staff,19,0,20,1
1713337722840,MCWP 50R,A00,518791,Staff,20,0,20,0
1713337722840,MCWP 50R,B00,518792,Staff,17,0,20,3
1713337722840,MCWP 50R,C00,518793,Staff,19,0,20,1
1713337722840,MCWP 50R,D00,518794,Staff,16,0,20,4
1713337722840,MCWP 50R,E00,518795,Staff,16,0,20,4
1713337722840,MCWP 50R,F00,518796,Staff,19,0,20,1
1713337722840,MCWP 50R,G00,518797,Staff,19,0,20,1
1713337723876,MMW 12R,A01,514034,Herbst; Matthew,15,0,16,1
1713337723876,MMW 12R,A02,514035,Herbst; Matthew,16,0,16,0
1713337724901,MMW 13R,A01,514037,Staff,12,0,16,4
1713337724901,MMW 13R,A02,514039,Staff,16,0,16,0
1713337726954,SIO 295LS,A00,523233,Staff,19,0,30,11
1713337727980,SIO 295S,A00,523232,Staff,19,0,30,11
1713337729007,SOCI 117,A01,494376,Staff,1,0,5,4
1713337730037,WES 237B,A00,494380,Staff,19,0,20,1
1713337732129,AESE 279B,A00,494370,Wade; Jon P,33,0,33,0
1713337733156,ANAR 135S,A00,494369,Braswell; Geoffrey E.,0,0,0,0
1713337734181,CAT 124RS,A01,519847,Geibel; William,17,0,20,3
1713337735206,CAT 125RS,A01,515971,Geibel; William,17,0,20,3
1713337736233,CLRE 250,A00,511389,Morris; Sheldon,9996,0,9999,3
1713337737262,CLRE 251,A00,507176,Mehta; Ravindra L.,9996,0,9999,3
1713337737262,CLRE 251,B00,511410,Mehta; Ravindra L.,9998,0,9999,1
1713337738294,CLRE 252,A00,507189,Cuomo; Raphael Eduardo,9998,0,9999,1
1713337739321,CLRE 253,A00,507199,Vaida; Florin,9997,0,9999,2
1713337739321,CLRE 253,B00,507202,Vaida; Florin,9999,0,9999,0
1713337740354,CLRE 259,A00,507211,Patel; Hemal,9996,0,9999,3
1713337741385,CLRE 260,A00,507221,Cuomo; Raphael Eduardo,9999,0,9999,0
1713337742411,CLRE 297,001,507242,Cuomo; Raphael Eduardo,9999,0,9999,0
1713337743436,CSE 191,A00,516875,Minnes Kemp; Mor Mia,9999,0,9999,0
1713337744463,CSS 201S,A01,494383,Staff,35,0,35,0
1713337745495,CSS 202S,A01,494387,Staff,35,0,35,0
1713337746542,EAP 100,A00,516065,Staff,9792,0,9999,207
1713337747568,ECE 45,A01,507414,Staff,51,0,60,9
1713337748605,ECE 100,A01,507416,Baghdadchi; Saharnaz,10,0,20,10
1713337748605,ECE 100,A02,507418,Baghdadchi; Saharnaz,20,0,20,0
1713337749631,ECE 111,A01,507420,Staff,38,0,50,12
1713337750669,ECE 197,001,548057,Sievenpiper; Daniel F.,9998,0,9999,1
1713337751701,EDS 115,A00,507243,Choi; Bailey Miyeon,28,0,28,0
1713337752724,EDS 117,A01,494379,Staff,23,0,25,2
1713337753754,EDS 125,A00,507246,Hopkins; Megan Beth,29,0,30,1
1713337754787,EDS 128A,A01,507264,Fargason; Sharon Gayle,26,0,26,0
1713337755813,EDS 128B,A01,507293,Pappas; Elizabeth,30,0,30,0
1713337756839,EDS 139,A00,507294,Fargason; Sharon Gayle,30,0,30,0
1713337756839,EDS 139,B00,507313,Pappas; Elizabeth,30,0,30,0
1713337757863,EDS 201,A00,507315,Staff,26,0,30,4
1713337758888,EDS 203,A01,507317,Halter; Christopher P.,26,0,30,4
1713337759913,EDS 204R,A01,507319,Halter; Christopher P.,3,0,30,27
1713337759913,EDS 204R,B01,507331,Heinzman; Erica M.,28,0,30,2
1713337760942,EDS 206R,A00,507332,Staff,4,0,30,26
1713337760942,EDS 206R,B00,507343,Staff,28,0,30,2
1713337761967,EDS 250,A00,507344,Hemans; Patricia Ann Benitez,36,0,40,4
1713337762997,EDS 281,A00,507345,Daly; Alan J.,18,0,18,0
1713337764022,EDS 284,A00,507350,Daly; Alan J.,16,0,16,0
1713337765047,EDS 286,A00,507359,Fine; Sarah,18,0,18,0
1713337766073,EDS 289C,A01,507361,Daly; Alan J.,18,0,18,0
1713337767104,EDS 290,A00,507366,Hofstetter; Carolyn,15,0,15,0
1713337768131,LIGM 5A,A00,507421,Fischer-Grunski; Eva K,20,0,20,0
1713337769157,LIGM 5B,A00,507423,Fischer-Grunski; Eva K,20,0,20,0
1713337770187,LIGM 5C,A00,507425,Fischer-Grunski; Eva K,20,0,20,0
1713337771214,LIIT 5AS,A00,507427,Carnelos; Chiara,20,0,20,0
1713337772244,LIIT 5BS,A00,507430,Carnelos; Chiara,20,0,20,0
1713337773273,LIIT 5CS,A00,507432,Carnelos; Chiara,20,0,20,0
1713337774309,LISP 5A,A00,507541,Munoz Sanchez; Alicia,17,0,20,3
1713337775334,LISP 5B,A00,507671,Munoz Sanchez; Alicia,15,0,20,5
1713337776363,LISP 5C,A00,507696,Munoz Sanchez; Alicia,15,0,20,5
1713337777391,MAE 197,001,528363,Boechler; Nicholas Sebastia,9998,0,9999,1
1713337778420,MATH 197,001,523477,Kedlaya; Kiran S.,9999,0,9999,0
1713337778420,MATH 197,002,563811,Zhang; Danna,9999,0,9999,0
1713337779443,MCWP 40R,A00,518780,Staff,20,0,20,0
1713337779443,MCWP 40R,B00,518781,Staff,19,0,20,1
1713337779443,MCWP 40R,C00,518783,Staff,19,0,20,1
1713337780469,MCWP 50R,A00,518791,Staff,20,0,20,0
1713337780469,MCWP 50R,B00,518792,Staff,17,0,20,3
1713337780469,MCWP 50R,C00,518793,Staff,19,0,20,1
1713337780469,MCWP 50R,D00,518794,Staff,16,0,20,4
1713337780469,MCWP 50R,E00,518795,Staff,16,0,20,4
1713337780469,MCWP 50R,F00,518796,Staff,19,0,20,1
1713337780469,MCWP 50R,G00,518797,Staff,19,0,20,1
1713337781494,MMW 12R,A01,514034,Herbst; Matthew,15,0,16,1
1713337781494,MMW 12R,A02,514035,Herbst; Matthew,16,0,16,0
1713337782521,MMW 13R,A01,514037,Staff,12,0,16,4
1713337782521,MMW 13R,A02,514039,Staff,16,0,16,0
1713337784573,SIO 295LS,A00,523233,Staff,19,0,30,11
1713337785604,SIO 295S,A00,523232,Staff,19,0,30,11
1713337786630,SOCI 117,A01,494376,Staff,1,0,5,4
1713337787659,WES 237B,A00,494380,Staff,19,0,20,1
1713337789719,AESE 279B,A00,494370,Wade; Jon P,33,0,33,0
1713337790748,ANAR 135S,A00,494369,Braswell; Geoffrey E.,0,0,0,0
1713337791778,CAT 124RS,A01,519847,Geibel; William,17,0,20,3
1713337792805,CAT 125RS,A01,515971,Geibel; William,17,0,20,3
1713337793831,CLRE 250,A00,511389,Morris; Sheldon,9996,0,9999,3
1713337794859,CLRE 251,A00,507176,Mehta; Ravindra L.,9996,0,9999,3
1713337794859,CLRE 251,B00,511410,Mehta; Ravindra L.,9998,0,9999,1
1713337795890,CLRE 252,A00,507189,Cuomo; Raphael Eduardo,9998,0,9999,1
1713337796917,CLRE 253,A00,507199,Vaida; Florin,9997,0,9999,2
1713337796917,CLRE 253,B00,507202,Vaida; Florin,9999,0,9999,0
1713337797946,CLRE 259,A00,507211,Patel; Hemal,9996,0,9999,3
1713337798985,CLRE 260,A00,507221,Cuomo; Raphael Eduardo,9999,0,9999,0
1713337800138,CLRE 297,001,507242,Cuomo; Raphael Eduardo,9999,0,9999,0
1713337801166,CSE 191,A00,516875,Minnes Kemp; Mor Mia,9999,0,9999,0
1713337802192,CSS 201S,A01,494383,Staff,35,0,35,0
1713337803232,CSS 202S,A01,494387,Staff,35,0,35,0
1713337804257,EAP 100,A00,516065,Staff,9792,0,9999,207
1713337805287,ECE 45,A01,507414,Staff,51,0,60,9
1713337806316,ECE 100,A01,507416,Baghdadchi; Saharnaz,10,0,20,10
1713337806316,ECE 100,A02,507418,Baghdadchi; Saharnaz,20,0,20,0
1713337807342,ECE 111,A01,507420,Staff,38,0,50,12
1713337808367,ECE 197,001,548057,Sievenpiper; Daniel F.,9998,0,9999,1
1713337809397,EDS 115,A00,507243,Choi; Bailey Miyeon,28,0,28,0
1713337810427,EDS 117,A01,494379,Staff,23,0,25,2
1713337811456,EDS 125,A00,507246,Hopkins; Megan Beth,29,0,30,1
1713337812486,EDS 128A,A01,507264,Fargason; Sharon Gayle,26,0,26,0
1713337813511,EDS 128B,A01,507293,Pappas; Elizabeth,30,0,30,0
1713337814534,EDS 139,A00,507294,Fargason; Sharon Gayle,30,0,30,0
1713337814534,EDS 139,B00,507313,Pappas; Elizabeth,30,0,30,0
1713337815559,EDS 201,A00,507315,Staff,26,0,30,4
1713337816593,EDS 203,A01,507317,Halter; Christopher P.,26,0,30,4
1713337817619,EDS 204R,A01,507319,Halter; Christopher P.,3,0,30,27
1713337817619,EDS 204R,B01,507331,Heinzman; Erica M.,28,0,30,2
1713337818645,EDS 206R,A00,507332,Staff,4,0,30,26
1713337818645,EDS 206R,B00,507343,Staff,28,0,30,2
1713337819675,EDS 250,A00,507344,Hemans; Patricia Ann Benitez,36,0,40,4
1713337820700,EDS 281,A00,507345,Daly; Alan J.,18,0,18,0
1713337821728,EDS 284,A00,507350,Daly; Alan J.,16,0,16,0
1713337822758,EDS 286,A00,507359,Fine; Sarah,18,0,18,0
1713337823784,EDS 289C,A01,507361,Daly; Alan J.,18,0,18,0
1713337824813,EDS 290,A00,507366,Hofstetter; Carolyn,15,0,15,0
1713337825900,LIGM 5A,A00,507421,Fischer-Grunski; Eva K,20,0,20,0
1713337826927,LIGM 5B,A00,507423,Fischer-Grunski; Eva K,20,0,20,0
1713337827958,LIGM 5C,A00,507425,Fischer-Grunski; Eva K,20,0,20,0
1713337828983,LIIT 5AS,A00,507427,Carnelos; Chiara,20,0,20,0
1713337830012,LIIT 5BS,A00,507430,Carnelos; Chiara,20,0,20,0
1713337831038,LIIT 5CS,A00,507432,Carnelos; Chiara,20,0,20,0
1713337832065,LISP 5A,A00,507541,Munoz Sanchez; Alicia,17,0,20,3
1713337833092,LISP 5B,A00,507671,Munoz Sanchez; Alicia,15,0,20,5
1713337834121,LISP 5C,A00,507696,Munoz Sanchez; Alicia,15,0,20,5
1713337835145,MAE 197,001,528363,Boechler; Nicholas Sebastia,9998,0,9999,1
1713337836175,MATH 197,001,523477,Kedlaya; Kiran S.,9999,0,9999,0
1713337836175,MATH 197,002,563811,Zhang; Danna,9999,0,9999,0
1713337837203,MCWP 40R,A00,518780,Staff,20,0,20,0
1713337837203,MCWP 40R,B00,518781,Staff,19,0,20,1
1713337837203,MCWP 40R,C00,518783,Staff,19,0,20,1
1713337838233,MCWP 50R,A00,518791,Staff,20,0,20,0
1713337838233,MCWP 50R,B00,518792,Staff,17,0,20,3
1713337838233,MCWP 50R,C00,518793,Staff,19,0,20,1
1713337838233,MCWP 50R,D00,518794,Staff,16,0,20,4
1713337838233,MCWP 50R,E00,518795,Staff,16,0,20,4
1713337838233,MCWP 50R,F00,518796,Staff,19,0,20,1
1713337838233,MCWP 50R,G00,518797,Staff,19,0,20,1
1713337839258,MMW 12R,A01,514034,Herbst; Matthew,15,0,16,1
1713337839258,MMW 12R,A02,514035,Herbst; Matthew,16,0,16,0
1713337840288,MMW 13R,A01,514037,Staff,12,0,16,4
1713337840288,MMW 13R,A02,514039,Staff,16,0,16,0
1713337842338,SIO 295LS,A00,523233,Staff,19,0,30,11
1713337843369,SIO 295S,A00,523232,Staff,19,0,30,11
1713337844399,SOCI 117,A01,494376,Staff,1,0,5,4
1713337845429,WES 237B,A00,494380,Staff,19,0,20,1
1713337847507,AESE 279B,A00,494370,Wade; Jon P,33,0,33,0
1713337848531,ANAR 135S,A00,494369,Braswell; Geoffrey E.,0,0,0,0
1713337849561,CAT 124RS,A01,519847,Geibel; William,17,0,20,3
1713337850585,CAT 125RS,A01,515971,Geibel; William,17,0,20,3
1713337851609,CLRE 250,A00,511389,Morris; Sheldon,9996,0,9999,3
1713337852642,CLRE 251,A00,507176,Mehta; Ravindra L.,9996,0,9999,3
1713337852642,CLRE 251,B00,511410,Mehta; Ravindra L.,9998,0,9999,1
1713337853669,CLRE 252,A00,507189,Cuomo; Raphael Eduardo,9998,0,9999,1
1713337854700,CLRE 253,A00,507199,Vaida; Florin,9997,0,9999,2
1713337854700,CLRE 253,B00,507202,Vaida; Florin,9999,0,9999,0
1713337855725,CLRE 259,A00,507211,Patel; Hemal,9996,0,9999,3
1713337856750,CLRE 260,A00,507221,Cuomo; Raphael Eduardo,9999,0,9999,0
1713337857775,CLRE 297,001,507242,Cuomo; Raphael Eduardo,9999,0,9999,0
1713337858804,CSE 191,A00,516875,Minnes Kemp; Mor Mia,9999,0,9999,0
1713337859829,CSS 201S,A01,494383,Staff,35,0,35,0
1713337860855,CSS 202S,A01,494387,Staff,35,0,35,0
1713337861883,EAP 100,A00,516065,Staff,9792,0,9999,207
1713337862909,ECE 45,A01,507414,Staff,51,0,60,9
1713337863934,ECE 100,A01,507416,Baghdadchi; Saharnaz,10,0,20,10
1713337863934,ECE 100,A02,507418,Baghdadchi; Saharnaz,20,0,20,0
1713337864964,ECE 111,A01,507420,Staff,38,0,50,12
1713337865989,ECE 197,001,548057,Sievenpiper; Daniel F.,9998,0,9999,1
1713337867020,EDS 115,A00,507243,Choi; Bailey Miyeon,28,0,28,0
1713337868063,EDS 117,A01,494379,Staff,23,0,25,2
1713337869091,EDS 125,A00,507246,Hopkins; Megan Beth,29,0,30,1
1713337870127,EDS 128A,A01,507264,Fargason; Sharon Gayle,26,0,26,0
1713337871156,EDS 128B,A01,507293,Pappas; Elizabeth,30,0,30,0
1713337872188,EDS 139,A00,507294,Fargason; Sharon Gayle,30,0,30,0
1713337872188,EDS 139,B00,507313,Pappas; Elizabeth,30,0,30,0
1713337873212,EDS 201,A00,507315,Staff,26,0,30,4
1713337874239,EDS 203,A01,507317,Halter; Christopher P.,26,0,30,4
1713337875270,EDS 204R,A01,507319,Halter; Christopher P.,3,0,30,27
1713337875270,EDS 204R,B01,507331,Heinzman; Erica M.,28,0,30,2
1713337876296,EDS 206R,A00,507332,Staff,4,0,30,26
1713337876296,EDS 206R,B00,507343,Staff,28,0,30,2
1713337877320,EDS 250,A00,507344,Hemans; Patricia Ann Benitez,36,0,40,4
1713337878347,EDS 281,A00,507345,Daly; Alan J.,18,0,18,0
1713337879375,EDS 284,A00,507350,Daly; Alan J.,16,0,16,0
1713337880414,EDS 286,A00,507359,Fine; Sarah,18,0,18,0
1713337881441,EDS 289C,A01,507361,Daly; Alan J.,18,0,18,0
1713337882465,EDS 290,A00,507366,Hofstetter; Carolyn,15,0,15,0
1713337883492,LIGM 5A,A00,507421,Fischer-Grunski; Eva K,20,0,20,0
1713337884517,LIGM 5B,A00,507423,Fischer-Grunski; Eva K,20,0,20,0
1713337885542,LIGM 5C,A00,507425,Fischer-Grunski; Eva K,20,0,20,0
1713337886569,LIIT 5AS,A00,507427,Carnelos; Chiara,20,0,20,0
1713337887593,LIIT 5BS,A00,507430,Carnelos; Chiara,20,0,20,0
1713337888618,LIIT 5CS,A00,507432,Carnelos; Chiara,20,0,20,0
1713337889657,LISP 5A,A00,507541,Munoz Sanchez; Alicia,17,0,20,3
1713337890684,LISP 5B,A00,507671,Munoz Sanchez; Alicia,15,0,20,5
1713337891712,LISP 5C,A00,507696,Munoz Sanchez; Alicia,15,0,20,5
1713337892737,MAE 197,001,528363,Boechler; Nicholas Sebastia,9998,0,9999,1
1713337893774,MATH 197,001,523477,Kedlaya; Kiran S.,9999,0,9999,0
1713337893774,MATH 197,002,563811,Zhang; Danna,9999,0,9999,0
1713337894810,MCWP 40R,A00,518780,Staff,20,0,20,0
1713337894810,MCWP 40R,B00,518781,Staff,19,0,20,1
1713337894810,MCWP 40R,C00,518783,Staff,19,0,20,1
1713337895847,MCWP 50R,A00,518791,Staff,20,0,20,0
1713337895847,MCWP 50R,B00,518792,Staff,17,0,20,3
1713337895847,MCWP 50R,C00,518793,Staff,19,0,20,1
1713337895847,MCWP 50R,D00,518794,Staff,16,0,20,4
1713337895847,MCWP 50R,E00,518795,Staff,16,0,20,4
1713337895847,MCWP 50R,F00,518796,Staff,19,0,20,1
1713337895847,MCWP 50R,G00,518797,Staff,19,0,20,1
1713337896881,MMW 12R,A01,514034,Herbst; Matthew,15,0,16,1
1713337896881,MMW 12R,A02,514035,Herbst; Matthew,16,0,16,0
1713337897912,MMW 13R,A01,514037,Staff,12,0,16,4
1713337897912,MMW 13R,A02,514039,Staff,16,0,16,0
1713337899971,SIO 295LS,A00,523233,Staff,19,0,30,11
1713337901003,SIO 295S,A00,523232,Staff,19,0,30,11
1713337902028,SOCI 117,A01,494376,Staff,1,0,5,4
1713337903060,WES 237B,A00,494380,Staff,19,0,20,1
1713337905165,AESE 279B,A00,494370,Wade; Jon P,33,0,33,0
1713337906191,ANAR 135S,A00,494369,Braswell; Geoffrey E.,0,0,0,0
1713337907219,CAT 124RS,A01,519847,Geibel; William,17,0,20,3
1713337908244,CAT 125RS,A01,515971,Geibel; William,17,0,20,3
1713337909270,CLRE 250,A00,511389,Morris; Sheldon,9996,0,9999,3
1713337910299,CLRE 251,A00,507176,Mehta; Ravindra L.,9996,0,9999,3
1713337910299,CLRE 251,B00,511410,Mehta; Ravindra L.,9998,0,9999,1
1713337911336,CLRE 252,A00,507189,Cuomo; Raphael Eduardo,9998,0,9999,1
1713337912361,CLRE 253,A00,507199,Vaida; Florin,9997,0,9999,2
1713337912361,CLRE 253,B00,507202,Vaida; Florin,9999,0,9999,0
1713337913387,CLRE 259,A00,507211,Patel; Hemal,9996,0,9999,3
1713337914418,CLRE 260,A00,507221,Cuomo; Raphael Eduardo,9999,0,9999,0
1713337915452,CLRE 297,001,507242,Cuomo; Raphael Eduardo,9999,0,9999,0
1713337916479,CSE 191,A00,516875,Minnes Kemp; Mor Mia,9999,0,9999,0
1713337917505,CSS 201S,A01,494383,Staff,35,0,35,0
1713337918537,CSS 202S,A01,494387,Staff,35,0,35,0
1713337919562,EAP 100,A00,516065,Staff,9792,0,9999,207
1713337920590,ECE 45,A01,507414,Staff,51,0,60,9
1713337921643,ECE 100,A01,507416,Baghdadchi; Saharnaz,10,0,20,10
1713337921643,ECE 100,A02,507418,Baghdadchi; Saharnaz,20,0,20,0
1713337922668,ECE 111,A01,507420,Staff,38,0,50,12
1713337923695,ECE 197,001,548057,Sievenpiper; Daniel F.,9998,0,9999,1
1713337924722,EDS 115,A00,507243,Choi; Bailey Miyeon,28,0,28,0
1713337925747,EDS 117,A01,494379,Staff,23,0,25,2
1713337926773,EDS 125,A00,507246,Hopkins; Megan Beth,29,0,30,1
1713337927804,EDS 128A,A01,507264,Fargason; Sharon Gayle,26,0,26,0
1713337928829,EDS 128B,A01,507293,Pappas; Elizabeth,30,0,30,0
1713337929912,EDS 139,A00,507294,Fargason; Sharon Gayle,30,0,30,0
1713337929912,EDS 139,B00,507313,Pappas; Elizabeth,30,0,30,0
1713337930942,EDS 201,A00,507315,Staff,26,0,30,4
1713337931976,EDS 203,A01,507317,Halter; Christopher P.,26,0,30,4
1713337933011,EDS 204R,A01,507319,Halter; Christopher P.,3,0,30,27
1713337933011,EDS 204R,B01,507331,Heinzman; Erica M.,28,0,30,2
1713337934040,EDS 206R,A00,507332,Staff,4,0,30,26
1713337934040,EDS 206R,B00,507343,Staff,28,0,30,2
1713337935073,EDS 250,A00,507344,Hemans; Patricia Ann Benitez,36,0,40,4
1713337936098,EDS 281,A00,507345,Daly; Alan J.,18,0,18,0
1713337937125,EDS 284,A00,507350,Daly; Alan J.,16,0,16,0
1713337938153,EDS 286,A00,507359,Fine; Sarah,18,0,18,0
1713337939185,EDS 289C,A01,507361,Daly; Alan J.,18,0,18,0
1713337940224,EDS 290,A00,507366,Hofstetter; Carolyn,15,0,15,0
1713337941252,LIGM 5A,A00,507421,Fischer-Grunski; Eva K,20,0,20,0
1713337942301,LIGM 5B,A00,507423,Fischer-Grunski; Eva K,20,0,20,0
1713337943337,LIGM 5C,A00,507425,Fischer-Grunski; Eva K,20,0,20,0
1713337944374,LIIT 5AS,A00,507427,Carnelos; Chiara,20,0,20,0
1713337945411,LIIT 5BS,A00,507430,Carnelos; Chiara,20,0,20,0
1713337946436,LIIT 5CS,A00,507432,Carnelos; Chiara,20,0,20,0
1713337947462,LISP 5A,A00,507541,Munoz Sanchez; Alicia,17,0,20,3
1713337948488,LISP 5B,A00,507671,Munoz Sanchez; Alicia,15,0,20,5
1713337949514,LISP 5C,A00,507696,Munoz Sanchez; Alicia,15,0,20,5
1713337950542,MAE 197,001,528363,Boechler; Nicholas Sebastia,9998,0,9999,1
1713337951569,MATH 197,001,523477,Kedlaya; Kiran S.,9999,0,9999,0
1713337951569,MATH 197,002,563811,Zhang; Danna,9999,0,9999,0
1713337952597,MCWP 40R,A00,518780,Staff,20,0,20,0
1713337952597,MCWP 40R,B00,518781,Staff,19,0,20,1
1713337952597,MCWP 40R,C00,518783,Staff,19,0,20,1
1713337953627,MCWP 50R,A00,518791,Staff,20,0,20,0
1713337953627,MCWP 50R,B00,518792,Staff,17,0,20,3
1713337953627,MCWP 50R,C00,518793,Staff,19,0,20,1
1713337953627,MCWP 50R,D00,518794,Staff,16,0,20,4
1713337953627,MCWP 50R,E00,518795,Staff,16,0,20,4
1713337953627,MCWP 50R,F00,518796,Staff,19,0,20,1
1713337953627,MCWP 50R,G00,518797,Staff,19,0,20,1
1713337954673,MMW 12R,A01,514034,Herbst; Matthew,15,0,16,1
1713337954673,MMW 12R,A02,514035,Herbst; Matthew,16,0,16,0
1713337955714,MMW 13R,A01,514037,Staff,12,0,16,4
1713337955714,MMW 13R,A02,514039,Staff,16,0,16,0
1713337957791,SIO 295LS,A00,523233,Staff,19,0,30,11
1713337958829,SIO 295S,A00,523232,Staff,19,0,30,11
1713337959855,SOCI 117,A01,494376,Staff,1,0,5,4
1713337960886,WES 237B,A00,494380,Staff,19,0,20,1
1713337962999,AESE 279B,A00,494370,Wade; Jon P,33,0,33,0
1713337964038,ANAR 135S,A00,494369,Braswell; Geoffrey E.,0,0,0,0
1713337965071,CAT 124RS,A01,519847,Geibel; William,17,0,20,3
1713337966115,CAT 125RS,A01,515971,Geibel; William,17,0,20,3
1713337967144,CLRE 250,A00,511389,Morris; Sheldon,9996,0,9999,3
1713337968196,CLRE 251,A00,507176,Mehta; Ravindra L.,9996,0,9999,3
1713337968196,CLRE 251,B00,511410,Mehta; Ravindra L.,9998,0,9999,1
1713337969243,CLRE 252,A00,507189,Cuomo; Raphael Eduardo,9998,0,9999,1
1713337970280,CLRE 253,A00,507199,Vaida; Florin,9997,0,9999,2
1713337970280,CLRE 253,B00,507202,Vaida; Florin,9999,0,9999,0
1713337971309,CLRE 259,A00,507211,Patel; Hemal,9996,0,9999,3
1713337972353,CLRE 260,A00,507221,Cuomo; Raphael Eduardo,9999,0,9999,0
1713337973383,CLRE 297,001,507242,Cuomo; Raphael Eduardo,9999,0,9999,0
1713337974427,CSE 191,A00,516875,Minnes Kemp; Mor Mia,9999,0,9999,0
1713337975457,CSS 201S,A01,494383,Staff,35,0,35,0
1713337976486,CSS 202S,A01,494387,Staff,35,0,35,0
1713337977517,EAP 100,A00,516065,Staff,9792,0,9999,207
1713337978564,ECE 45,A01,507414,Staff,51,0,60,9
1713337979598,ECE 100,A01,507416,Baghdadchi; Saharnaz,10,0,20,10
1713337979598,ECE 100,A02,507418,Baghdadchi; Saharnaz,20,0,20,0
1713337980631,ECE 111,A01,507420,Staff,38,0,50,12
1713337981660,ECE 197,001,548057,Sievenpiper; Daniel F.,9998,0,9999,1
1713337982689,EDS 115,A00,507243,Choi; Bailey Miyeon,28,0,28,0
1713337983727,EDS 117,A01,494379,Staff,23,0,25,2
1713337984758,EDS 125,A00,507246,Hopkins; Megan Beth,29,0,30,1
1713337985788,EDS 128A,A01,507264,Fargason; Sharon Gayle,26,0,26,0
1713337986833,EDS 128B,A01,507293,Pappas; Elizabeth,30,0,30,0
1713337987878,EDS 139,A00,507294,Fargason; Sharon Gayle,30,0,30,0
1713337987878,EDS 139,B00,507313,Pappas; Elizabeth,30,0,30,0
1713337988914,EDS 201,A00,507315,Staff,26,0,30,4
1713337989944,EDS 203,A01,507317,Halter; Christopher P.,26,0,30,4
1713337990971,EDS 204R,A01,507319,Halter; Christopher P.,3,0,30,27
1713337990971,EDS 204R,B01,507331,Heinzman; Erica M.,28,0,30,2
1713337992001,EDS 206R,A00,507332,Staff,4,0,30,26
1713337992001,EDS 206R,B00,507343,Staff,28,0,30,2
1713337993040,EDS 250,A00,507344,Hemans; Patricia Ann Benitez,36,0,40,4
1713337994080,EDS 281,A00,507345,Daly; Alan J.,18,0,18,0
1713337995112,EDS 284,A00,507350,Daly; Alan J.,16,0,16,0
1713337996141,EDS 286,A00,507359,Fine; Sarah,18,0,18,0
1713337997168,EDS 289C,A01,507361,Daly; Alan J.,18,0,18,0
1713337998197,EDS 290,A00,507366,Hofstetter; Carolyn,15,0,15,0
1713337999237,LIGM 5A,A00,507421,Fischer-Grunski; Eva K,20,0,20,0
1713338000264,LIGM 5B,A00,507423,Fischer-Grunski; Eva K,20,0,20,0
1713338001295,LIGM 5C,A00,507425,Fischer-Grunski; Eva K,20,0,20,0
1713338002373,LIIT 5AS,A00,507427,Carnelos; Chiara,20,0,20,0
1713338003412,LIIT 5BS,A00,507430,Carnelos; Chiara,20,0,20,0
1713338004441,LIIT 5CS,A00,507432,Carnelos; Chiara,20,0,20,0
1713338005506,LISP 5A,A00,507541,Munoz Sanchez; Alicia,17,0,20,3
1713338006551,LISP 5B,A00,507671,Munoz Sanchez; Alicia,15,0,20,5
1713338007581,LISP 5C,A00,507696,Munoz Sanchez; Alicia,15,0,20,5
1713338008621,MAE 197,001,528363,Boechler; Nicholas Sebastia,9998,0,9999,1
1713338009659,MATH 197,001,523477,Kedlaya; Kiran S.,9999,0,9999,0
1713338009659,MATH 197,002,563811,Zhang; Danna,9999,0,9999,0
1713338010696,MCWP 40R,A00,518780,Staff,20,0,20,0
1713338010696,MCWP 40R,B00,518781,Staff,19,0,20,1
1713338010696,MCWP 40R,C00,518783,Staff,19,0,20,1
1713338011727,MCWP 50R,A00,518791,Staff,20,0,20,0
1713338011727,MCWP 50R,B00,518792,Staff,17,0,20,3
1713338011727,MCWP 50R,C00,518793,Staff,19,0,20,1
1713338011727,MCWP 50R,D00,518794,Staff,16,0,20,4
1713338011727,MCWP 50R,E00,518795,Staff,16,0,20,4
1713338011727,MCWP 50R,F00,518796,Staff,19,0,20,1
1713338011727,MCWP 50R,G00,518797,Staff,19,0,20,1
1713338012755,MMW 12R,A01,514034,Herbst; Matthew,15,0,16,1
1713338012755,MMW 12R,A02,514035,Herbst; Matthew,16,0,16,0
1713338013786,MMW 13R,A01,514037,Staff,12,0,16,4
1713338013786,MMW 13R,A02,514039,Staff,16,0,16,0
1713338015852,SIO 295LS,A00,523233,Staff,19,0,30,11
1713338016891,SIO 295S,A00,523232,Staff,19,0,30,11
1713338017918,SOCI 117,A01,494376,Staff,1,0,5,4
1713338018943,WES 237B,A00,494380,Staff,19,0,20,1
1713338021022,AESE 279B,A00,494370,Wade; Jon P,33,0,33,0
1713338022053,ANAR 135S,A00,494369,Braswell; Geoffrey E.,0,0,0,0
1713338023082,CAT 124RS,A01,519847,Geibel; William,17,0,20,3
1713338024109,CAT 125RS,A01,515971,Geibel; William,17,0,20,3
1713338025135,CLRE 250,A00,511389,Morris; Sheldon,9996,0,9999,3
1713338026167,CLRE 251,A00,507176,Mehta; Ravindra L.,9996,0,9999,3
1713338026167,CLRE 251,B00,511410,Mehta; Ravindra L.,9998,0,9999,1
1713338027206,CLRE 252,A00,507189,Cuomo; Raphael Eduardo,9998,0,9999,1
1713338028252,CLRE 253,A00,507199,Vaida; Florin,9997,0,9999,2
1713338028252,CLRE 253,B00,507202,Vaida; Florin,9999,0,9999,0
1713338029307,CLRE 259,A00,507211,Patel; Hemal,9996,0,9999,3
1713338030342,CLRE 260,A00,507221,Cuomo; Raphael Eduardo,9999,0,9999,0
1713338031372,CLRE 297,001,507242,Cuomo; Raphael Eduardo,9999,0,9999,0
1713338032409,CSE 191,A00,516875,Minnes Kemp; Mor Mia,9999,0,9999,0
1713338033456,CSS 201S,A01,494383,Staff,35,0,35,0
1713338034560,CSS 202S,A01,494387,Staff,35,0,35,0
1713338035587,EAP 100,A00,516065,Staff,9792,0,9999,207
1713338036615,ECE 45,A01,507414,Staff,51,0,60,9
1713338037646,ECE 100,A01,507416,Baghdadchi; Saharnaz,10,0,20,10
1713338037646,ECE 100,A02,507418,Baghdadchi; Saharnaz,20,0,20,0
1713338038674,ECE 111,A01,507420,Staff,38,0,50,12
1713338039706,ECE 197,001,548057,Sievenpiper; Daniel F.,9998,0,9999,1
1713338040740,EDS 115,A00,507243,Choi; Bailey Miyeon,28,0,28,0
1713338041767,EDS 117,A01,494379,Staff,23,0,25,2
1713338042804,EDS 125,A00,507246,Hopkins; Megan Beth,29,0,30,1
1713338043842,EDS 128A,A01,507264,Fargason; Sharon Gayle,26,0,26,0
1713338044881,EDS 128B,A01,507293,Pappas; Elizabeth,30,0,30,0
1713338045907,EDS 139,A00,507294,Fargason; Sharon Gayle,30,0,30,0
1713338045907,EDS 139,B00,507313,Pappas; Elizabeth,30,0,30,0
1713338046936,EDS 201,A00,507315,Staff,26,0,30,4
1713338047965,EDS 203,A01,507317,Halter; Christopher P.,26,0,30,4
1713338048998,EDS 204R,A01,507319,Halter; Christopher P.,3,0,30,27
1713338048998,EDS 204R,B01,507331,Heinzman; Erica M.,28,0,30,2
1713338050033,EDS 206R,A00,507332,Staff,4,0,30,26
1713338050033,EDS 206R,B00,507343,Staff,28,0,30,2
1713338051068,EDS 250,A00,507344,Hemans; Patricia Ann Benitez,36,0,40,4
1713338052098,EDS 281,A00,507345,Daly; Alan J.,18,0,18,0
1713338053138,EDS 284,A00,507350,Daly; Alan J.,16,0,16,0
1713338054165,EDS 286,A00,507359,Fine; Sarah,18,0,18,0
1713338055198,EDS 289C,A01,507361,Daly; Alan J.,18,0,18,0
1713338056226,EDS 290,A00,507366,Hofstetter; Carolyn,15,0,15,0
1713338057262,LIGM 5A,A00,507421,Fischer-Grunski; Eva K,20,0,20,0
1713338058292,LIGM 5B,A00,507423,Fischer-Grunski; Eva K,20,0,20,0
1713338059321,LIGM 5C,A00,507425,Fischer-Grunski; Eva K,20,0,20,0
1713338060368,LIIT 5AS,A00,507427,Carnelos; Chiara,20,0,20,0
1713338061397,LIIT 5BS,A00,507430,Carnelos; Chiara,20,0,20,0
1713338062435,LIIT 5CS,A00,507432,Carnelos; Chiara,20,0,20,0
1713338063464,LISP 5A,A00,507541,Munoz Sanchez; Alicia,17,0,20,3
1713338064493,LISP 5B,A00,507671,Munoz Sanchez; Alicia,15,0,20,5
1713338065521,LISP 5C,A00,507696,Munoz Sanchez; Alicia,15,0,20,5
1713338066551,MAE 197,001,528363,Boechler; Nicholas Sebastia,9998,0,9999,1
1713338067579,MATH 197,001,523477,Kedlaya; Kiran S.,9999,0,9999,0
1713338067579,MATH 197,002,563811,Zhang; Danna,9999,0,9999,0
1713338068617,MCWP 40R,A00,518780,Staff,20,0,20,0
1713338068617,MCWP 40R,B00,518781,Staff,19,0,20,1
1713338068617,MCWP 40R,C00,518783,Staff,19,0,20,1
1713338069644,MCWP 50R,A00,518791,Staff,20,0,20,0
1713338069644,MCWP 50R,B00,518792,Staff,17,0,20,3
1713338069644,MCWP 50R,C00,518793,Staff,19,0,20,1
1713338069644,MCWP 50R,D00,518794,Staff,16,0,20,4
1713338069644,MCWP 50R,E00,518795,Staff,16,0,20,4
1713338069644,MCWP 50R,F00,518796,Staff,19,0,20,1
1713338069644,MCWP 50R,G00,518797,Staff,19,0,20,1
1713338070679,MMW 12R,A01,514034,Herbst; Matthew,15,0,16,1
1713338070679,MMW 12R,A02,514035,Herbst; Matthew,16,0,16,0
1713338071706,MMW 13R,A01,514037,Staff,12,0,16,4
1713338071706,MMW 13R,A02,514039,Staff,16,0,16,0
1713338073760,SIO 295LS,A00,523233,Staff,19,0,30,11
1713338074791,SIO 295S,A00,523232,Staff,19,0,30,11
1713338075824,SOCI 117,A01,494376,Staff,1,0,5,4
1713338076851,WES 237B,A00,494380,Staff,19,0,20,1
1713338078924,AESE 279B,A00,494370,Wade; Jon P,33,0,33,0
1713338079955,ANAR 135S,A00,494369,Braswell; Geoffrey E.,0,0,0,0
1713338080993,CAT 124RS,A01,519847,Geibel; William,17,0,20,3
1713338082021,CAT 125RS,A01,515971,Geibel; William,17,0,20,3
1713338083059,CLRE 250,A00,511389,Morris; Sheldon,9996,0,9999,3
1713338084091,CLRE 251,A00,507176,Mehta; Ravindra L.,9996,0,9999,3
1713338084091,CLRE 251,B00,511410,Mehta; Ravindra L.,9998,0,9999,1
1713338085120,CLRE 252,A00,507189,Cuomo; Raphael Eduardo,9998,0,9999,1
1713338086177,CLRE 253,A00,507199,Vaida; Florin,9997,0,9999,2
1713338086177,CLRE 253,B00,507202,Vaida; Florin,9999,0,9999,0
1713338087204,CLRE 259,A00,507211,Patel; Hemal,9996,0,9999,3
1713338088236,CLRE 260,A00,507221,Cuomo; Raphael Eduardo,9999,0,9999,0
1713338089262,CLRE 297,001,507242,Cuomo; Raphael Eduardo,9999,0,9999,0
1713338090290,CSE 191,A00,516875,Minnes Kemp; Mor Mia,9999,0,9999,0
1713338091318,CSS 201S,A01,494383,Staff,35,0,35,0
1713338092347,CSS 202S,A01,494387,Staff,35,0,35,0
1713338093373,EAP 100,A00,516065,Staff,9792,0,9999,207
1713338094399,ECE 45,A01,507414,Staff,51,0,60,9
1713338095429,ECE 100,A01,507416,Baghdadchi; Saharnaz,10,0,20,10
1713338095429,ECE 100,A02,507418,Baghdadchi; Saharnaz,20,0,20,0
1713338096455,ECE 111,A01,507420,Staff,38,0,50,12
1713338097507,ECE 197,001,548057,Sievenpiper; Daniel F.,9998,0,9999,1
1713338098539,EDS 115,A00,507243,Choi; Bailey Miyeon,28,0,28,0
1713338099574,EDS 117,A01,494379,Staff,23,0,25,2
1713338100618,EDS 125,A00,507246,Hopkins; Megan Beth,29,0,30,1
1713338101645,EDS 128A,A01,507264,Fargason; Sharon Gayle,26,0,26,0
1713338102678,EDS 128B,A01,507293,Pappas; Elizabeth,30,0,30,0
1713338103704,EDS 139,A00,507294,Fargason; Sharon Gayle,30,0,30,0
1713338103704,EDS 139,B00,507313,Pappas; Elizabeth,30,0,30,0
1713338104731,EDS 201,A00,507315,Staff,26,0,30,4
1713338105758,EDS 203,A01,507317,Halter; Christopher P.,26,0,30,4
1713338106785,EDS 204R,A01,507319,Halter; Christopher P.,3,0,30,27
1713338106785,EDS 204R,B01,507331,Heinzman; Erica M.,28,0,30,2
1713338107812,EDS 206R,A00,507332,Staff,4,0,30,26
1713338107812,EDS 206R,B00,507343,Staff,28,0,30,2
1713338108838,EDS 250,A00,507344,Hemans; Patricia Ann Benitez,36,0,40,4
1713338109864,EDS 281,A00,507345,Daly; Alan J.,18,0,18,0
1713338110888,EDS 284,A00,507350,Daly; Alan J.,16,0,16,0
1713338111920,EDS 286,A00,507359,Fine; Sarah,18,0,18,0
1713338112946,EDS 289C,A01,507361,Daly; Alan J.,18,0,18,0
1713338113977,EDS 290,A00,507366,Hofstetter; Carolyn,15,0,15,0
1713338115017,LIGM 5A,A00,507421,Fischer-Grunski; Eva K,20,0,20,0
1713338116054,LIGM 5B,A00,507423,Fischer-Grunski; Eva K,20,0,20,0
1713338117081,LIGM 5C,A00,507425,Fischer-Grunski; Eva K,20,0,20,0
1713338118119,LIIT 5AS,A00,507427,Carnelos; Chiara,20,0,20,0
1713338119152,LIIT 5BS,A00,507430,Carnelos; Chiara,20,0,20,0
1713338120180,LIIT 5CS,A00,507432,Carnelos; Chiara,20,0,20,0
1713338121230,LISP 5A,A00,507541,Munoz Sanchez; Alicia,17,0,20,3
1713338122256,LISP 5B,A00,507671,Munoz Sanchez; Alicia,15,0,20,5
1713338123283,LISP 5C,A00,507696,Munoz Sanchez; Alicia,15,0,20,5
1713338124308,MAE 197,001,528363,Boechler; Nicholas Sebastia,9998,0,9999,1
1713338125350,MATH 197,001,523477,Kedlaya; Kiran S.,9999,0,9999,0
1713338125350,MATH 197,002,563811,Zhang; Danna,9999,0,9999,0
1713338126387,MCWP 40R,A00,518780,Staff,20,0,20,0
1713338126387,MCWP 40R,B00,518781,Staff,19,0,20,1
1713338126387,MCWP 40R,C00,518783,Staff,19,0,20,1
1713338127415,MCWP 50R,A00,518791,Staff,20,0,20,0
1713338127415,MCWP 50R,B00,518792,Staff,17,0,20,3
1713338127415,MCWP 50R,C00,518793,Staff,19,0,20,1
1713338127415,MCWP 50R,D00,518794,Staff,16,0,20,4
1713338127415,MCWP 50R,E00,518795,Staff,16,0,20,4
1713338127415,MCWP 50R,F00,518796,Staff,19,0,20,1
1713338127415,MCWP 50R,G00,518797,Staff,19,0,20,1
1713338128442,MMW 12R,A01,514034,Herbst; Matthew,15,0,16,1
1713338128442,MMW 12R,A02,514035,Herbst; Matthew,16,0,16,0
1713338129468,MMW 13R,A01,514037,Staff,12,0,16,4
1713338129468,MMW 13R,A02,514039,Staff,16,0,16,0
1713338131543,SIO 295LS,A00,523233,Staff,19,0,30,11
1713338132568,SIO 295S,A00,523232,Staff,19,0,30,11
1713338133595,SOCI 117,A01,494376,Staff,1,0,5,4
1713338134627,WES 237B,A00,494380,Staff,19,0,20,1
1713338136719,AESE 279B,A00,494370,Wade; Jon P,33,0,33,0
1713338137749,ANAR 135S,A00,494369,Braswell; Geoffrey E.,0,0,0,0
1713338138832,CAT 124RS,A01,519847,Geibel; William,17,0,20,3
1713338139869,CAT 125RS,A01,515971,Geibel; William,17,0,20,3
1713338140896,CLRE 250,A00,511389,Morris; Sheldon,9996,0,9999,3
1713338141924,CLRE 251,A00,507176,Mehta; Ravindra L.,9996,0,9999,3
1713338141924,CLRE 251,B00,511410,Mehta; Ravindra L.,9998,0,9999,1
1713338142960,CLRE 252,A00,507189,Cuomo; Raphael Eduardo,9998,0,9999,1
1713338143994,CLRE 253,A00,507199,Vaida; Florin,9997,0,9999,2
1713338143994,CLRE 253,B00,507202,Vaida; Florin,9999,0,9999,0
1713338145031,CLRE 259,A00,507211,Patel; Hemal,9996,0,9999,3
1713338146056,CLRE 260,A00,507221,Cuomo; Raphael Eduardo,9999,0,9999,0
1713338147088,CLRE 297,001,507242,Cuomo; Raphael Eduardo,9999,0,9999,0
1713338148125,CSE 191,A00,516875,Minnes Kemp; Mor Mia,9999,0,9999,0
1713338149167,CSS 201S,A01,494383,Staff,35,0,35,0
1713338150210,CSS 202S,A01,494387,Staff,35,0,35,0
1713338151248,EAP 100,A00,516065,Staff,9792,0,9999,207
1713338152284,ECE 45,A01,507414,Staff,51,0,60,9
1713338153312,ECE 100,A01,507416,Baghdadchi; Saharnaz,10,0,20,10
1713338153312,ECE 100,A02,507418,Baghdadchi; Saharnaz,20,0,20,0
1713338154341,ECE 111,A01,507420,Staff,38,0,50,12
1713338155380,ECE 197,001,548057,Sievenpiper; Daniel F.,9998,0,9999,1
1713338156410,EDS 115,A00,507243,Choi; Bailey Miyeon,28,0,28,0
1713338157438,EDS 117,A01,494379,Staff,23,0,25,2
1713338158470,EDS 125,A00,507246,Hopkins; Megan Beth,29,0,30,1
1713338159502,EDS 128A,A01,507264,Fargason; Sharon Gayle,26,0,26,0
1713338160622,EDS 128B,A01,507293,Pappas; Elizabeth,30,0,30,0
1713338161652,EDS 139,A00,507294,Fargason; Sharon Gayle,30,0,30,0
1713338161652,EDS 139,B00,507313,Pappas; Elizabeth,30,0,30,0
1713338162677,EDS 201,A00,507315,Staff,26,0,30,4
1713338163708,EDS 203,A01,507317,Halter; Christopher P.,26,0,30,4
1713338164736,EDS 204R,A01,507319,Halter; Christopher P.,3,0,30,27
1713338164736,EDS 204R,B01,507331,Heinzman; Erica M.,28,0,30,2
1713338165763,EDS 206R,A00,507332,Staff,4,0,30,26
1713338165763,EDS 206R,B00,507343,Staff,28,0,30,2
1713338166796,EDS 250,A00,507344,Hemans; Patricia Ann Benitez,36,0,40,4
1713338167823,EDS 281,A00,507345,Daly; Alan J.,18,0,18,0
1713338168851,EDS 284,A00,507350,Daly; Alan J.,16,0,16,0
1713338169882,EDS 286,A00,507359,Fine; Sarah,18,0,18,0
1713338170907,EDS 289C,A01,507361,Daly; Alan J.,18,0,18,0
1713338171937,EDS 290,A00,507366,Hofstetter; Carolyn,15,0,15,0
1713338172964,LIGM 5A,A00,507421,Fischer-Grunski; Eva K,20,0,20,0
1713338173999,LIGM 5B,A00,507423,Fischer-Grunski; Eva K,20,0,20,0
1713338175027,LIGM 5C,A00,507425,Fischer-Grunski; Eva K,20,0,20,0
1713338176073,LIIT 5AS,A00,507427,Carnelos; Chiara,20,0,20,0
1713338177098,LIIT 5BS,A00,507430,Carnelos; Chiara,20,0,20,0
1713338178134,LIIT 5CS,A00,507432,Carnelos; Chiara,20,0,20,0
1713338179168,LISP 5A,A00,507541,Munoz Sanchez; Alicia,17,0,20,3
1713338180197,LISP 5B,A00,507671,Munoz Sanchez; Alicia,15,0,20,5
1713338181238,LISP 5C,A00,507696,Munoz Sanchez; Alicia,15,0,20,5
1713338182269,MAE 197,001,528363,Boechler; Nicholas Sebastia,9998,0,9999,1
1713338183303,MATH 197,001,523477,Kedlaya; Kiran S.,9999,0,9999,0
1713338183303,MATH 197,002,563811,Zhang; Danna,9999,0,9999,0
1713338184340,MCWP 40R,A00,518780,Staff,20,0,20,0
1713338184340,MCWP 40R,B00,518781,Staff,19,0,20,1
1713338184340,MCWP 40R,C00,518783,Staff,19,0,20,1
1713338185369,MCWP 50R,A00,518791,Staff,20,0,20,0
1713338185369,MCWP 50R,B00,518792,Staff,17,0,20,3
1713338185369,MCWP 50R,C00,518793,Staff,19,0,20,1
1713338185369,MCWP 50R,D00,518794,Staff,16,0,20,4
1713338185369,MCWP 50R,E00,518795,Staff,16,0,20,4
1713338185369,MCWP 50R,F00,518796,Staff,19,0,20,1
1713338185369,MCWP 50R,G00,518797,Staff,19,0,20,1
1713338186402,MMW 12R,A01,514034,Herbst; Matthew,15,0,16,1
1713338186402,MMW 12R,A02,514035,Herbst; Matthew,16,0,16,0
1713338187432,MMW 13R,A01,514037,Staff,12,0,16,4
1713338187432,MMW 13R,A02,514039,Staff,16,0,16,0
1713338189492,SIO 295LS,A00,523233,Staff,19,0,30,11
1713338190520,SIO 295S,A00,523232,Staff,19,0,30,11
1713338191546,SOCI 117,A01,494376,Staff,1,0,5,4
1713338192576,WES 237B,A00,494380,Staff,19,0,20,1
1713338194671,AESE 279B,A00,494370,Wade; Jon P,33,0,33,0
1713338195702,ANAR 135S,A00,494369,Braswell; Geoffrey E.,0,0,0,0
1713338196729,CAT 124RS,A01,519847,Geibel; William,17,0,20,3
1713338197761,CAT 125RS,A01,515971,Geibel; William,17,0,20,3
1713338198801,CLRE 250,A00,511389,Morris; Sheldon,9996,0,9999,3
1713338199829,CLRE 251,A00,507176,Mehta; Ravindra L.,9996,0,9999,3
1713338199829,CLRE 251,B00,511410,Mehta; Ravindra L.,9998,0,9999,1
1713338200854,CLRE 252,A00,507189,Cuomo; Raphael Eduardo,9998,0,9999,1
1713338201882,CLRE 253,A00,507199,Vaida; Florin,9997,0,9999,2
1713338201882,CLRE 253,B00,507202,Vaida; Florin,9999,0,9999,0
1713338202910,CLRE 259,A00,507211,Patel; Hemal,9996,0,9999,3
1713338203936,CLRE 260,A00,507221,Cuomo; Raphael Eduardo,9999,0,9999,0
1713338204963,CLRE 297,001,507242,Cuomo; Raphael Eduardo,9999,0,9999,0
1713338205991,CSE 191,A00,516875,Minnes Kemp; Mor Mia,9999,0,9999,0
1713338207021,CSS 201S,A01,494383,Staff,35,0,35,0
1713338208050,CSS 202S,A01,494387,Staff,35,0,35,0
1713338209080,EAP 100,A00,516065,Staff,9792,0,9999,207
1713338210107,ECE 45,A01,507414,Staff,51,0,60,9
1713338211137,ECE 100,A01,507416,Baghdadchi; Saharnaz,10,0,20,10
1713338211137,ECE 100,A02,507418,Baghdadchi; Saharnaz,20,0,20,0
1713338212164,ECE 111,A01,507420,Staff,38,0,50,12
1713338213190,ECE 197,001,548057,Sievenpiper; Daniel F.,9998,0,9999,1
1713338214221,EDS 115,A00,507243,Choi; Bailey Miyeon,28,0,28,0
1713338215259,EDS 117,A01,494379,Staff,23,0,25,2
1713338216292,EDS 125,A00,507246,Hopkins; Megan Beth,29,0,30,1
1713338217330,EDS 128A,A01,507264,Fargason; Sharon Gayle,26,0,26,0
1713338218396,EDS 128B,A01,507293,Pappas; Elizabeth,30,0,30,0
1713338219440,EDS 139,A00,507294,Fargason; Sharon Gayle,30,0,30,0
1713338219440,EDS 139,B00,507313,Pappas; Elizabeth,30,0,30,0
1713338220466,EDS 201,A00,507315,Staff,26,0,30,4
1713338221491,EDS 203,A01,507317,Halter; Christopher P.,26,0,30,4
1713338222520,EDS 204R,A01,507319,Halter; Christopher P.,3,0,30,27
1713338222520,EDS 204R,B01,507331,Heinzman; Erica M.,28,0,30,2
1713338223555,EDS 206R,A00,507332,Staff,4,0,30,26
1713338223555,EDS 206R,B00,507343,Staff,28,0,30,2
1713338224583,EDS 250,A00,507344,Hemans; Patricia Ann Benitez,36,0,40,4
1713338225614,EDS 281,A00,507345,Daly; Alan J.,18,0,18,0
1713338226645,EDS 284,A00,507350,Daly; Alan J.,16,0,16,0
1713338227713,EDS 286,A00,507359,Fine; Sarah,18,0,18,0
1713338228739,EDS 289C,A01,507361,Daly; Alan J.,18,0,18,0
1713338229767,EDS 290,A00,507366,Hofstetter; Carolyn,15,0,15,0
1713338230792,LIGM 5A,A00,507421,Fischer-Grunski; Eva K,20,0,20,0
1713338231818,LIGM 5B,A00,507423,Fischer-Grunski; Eva K,20,0,20,0
1713338232843,LIGM 5C,A00,507425,Fischer-Grunski; Eva K,20,0,20,0
1713338233875,LIIT 5AS,A00,507427,Carnelos; Chiara,20,0,20,0
1713338234905,LIIT 5BS,A00,507430,Carnelos; Chiara,20,0,20,0
1713338235930,LIIT 5CS,A00,507432,Carnelos; Chiara,20,0,20,0
1713338236956,LISP 5A,A00,507541,Munoz Sanchez; Alicia,17,0,20,3
1713338237990,LISP 5B,A00,507671,Munoz Sanchez; Alicia,15,0,20,5
1713338239016,LISP 5C,A00,507696,Munoz Sanchez; Alicia,15,0,20,5
1713338240049,MAE 197,001,528363,Boechler; Nicholas Sebastia,9998,0,9999,1
1713338241088,MATH 197,001,523477,Kedlaya; Kiran S.,9999,0,9999,0
1713338241088,MATH 197,002,563811,Zhang; Danna,9999,0,9999,0
1713338242120,MCWP 40R,A00,518780,Staff,20,0,20,0
1713338242120,MCWP 40R,B00,518781,Staff,19,0,20,1
1713338242120,MCWP 40R,C00,518783,Staff,19,0,20,1
1713338243203,MCWP 50R,A00,518791,Staff,20,0,20,0
1713338243203,MCWP 50R,B00,518792,Staff,17,0,20,3
1713338243203,MCWP 50R,C00,518793,Staff,19,0,20,1
1713338243203,MCWP 50R,D00,518794,Staff,16,0,20,4
1713338243203,MCWP 50R,E00,518795,Staff,16,0,20,4
1713338243203,MCWP 50R,F00,518796,Staff,19,0,20,1
1713338243203,MCWP 50R,G00,518797,Staff,19,0,20,1
1713338244229,MMW 12R,A01,514034,Herbst; Matthew,15,0,16,1
1713338244229,MMW 12R,A02,514035,Herbst; Matthew,16,0,16,0
1713338245266,MMW 13R,A01,514037,Staff,12,0,16,4
1713338245266,MMW 13R,A02,514039,Staff,16,0,16,0
1713338247319,SIO 295LS,A00,523233,Staff,19,0,30,11
1713338248347,SIO 295S,A00,523232,Staff,19,0,30,11
1713338249381,SOCI 117,A01,494376,Staff,1,0,5,4
1713338250414,WES 237B,A00,494380,Staff,19,0,20,1
1713338252495,AESE 279B,A00,494370,Wade; Jon P,33,0,33,0
1713338253534,ANAR 135S,A00,494369,Braswell; Geoffrey E.,0,0,0,0
1713338254574,CAT 124RS,A01,519847,Geibel; William,17,0,20,3
1713338255600,CAT 125RS,A01,515971,Geibel; William,17,0,20,3
1713338256627,CLRE 250,A00,511389,Morris; Sheldon,9996,0,9999,3
1713338257672,CLRE 251,A00,507176,Mehta; Ravindra L.,9996,0,9999,3
1713338257672,CLRE 251,B00,511410,Mehta; Ravindra L.,9998,0,9999,1
1713338258696,CLRE 252,A00,507189,Cuomo; Raphael Eduardo,9998,0,9999,1
1713338259726,CLRE 253,A00,507199,Vaida; Florin,9997,0,9999,2
1713338259726,CLRE 253,B00,507202,Vaida; Florin,9999,0,9999,0
1713338260751,CLRE 259,A00,507211,Patel; Hemal,9996,0,9999,3
1713338261777,CLRE 260,A00,507221,Cuomo; Raphael Eduardo,9999,0,9999,0
1713338262802,CLRE 297,001,507242,Cuomo; Raphael Eduardo,9999,0,9999,0
1713338263829,CSE 191,A00,516875,Minnes Kemp; Mor Mia,9999,0,9999,0
1713338264860,CSS 201S,A01,494383,Staff,35,0,35,0
1713338265885,CSS 202S,A01,494387,Staff,35,0,35,0
1713338266914,EAP 100,A00,516065,Staff,9792,0,9999,207
1713338267937,ECE 45,A01,507414,Staff,51,0,60,9
1713338268968,ECE 100,A01,507416,Baghdadchi; Saharnaz,10,0,20,10
1713338268968,ECE 100,A02,507418,Baghdadchi; Saharnaz,20,0,20,0
1713338269994,ECE 111,A01,507420,Staff,38,0,50,12
1713338271021,ECE 197,001,548057,Sievenpiper; Daniel F.,9998,0,9999,1
1713338272048,EDS 115,A00,507243,Choi; Bailey Miyeon,28,0,28,0
1713338273075,EDS 117,A01,494379,Staff,23,0,25,2
1713338274102,EDS 125,A00,507246,Hopkins; Megan Beth,29,0,30,1
1713338275129,EDS 128A,A01,507264,Fargason; Sharon Gayle,26,0,26,0
1713338276156,EDS 128B,A01,507293,Pappas; Elizabeth,30,0,30,0
1713338277183,EDS 139,A00,507294,Fargason; Sharon Gayle,30,0,30,0
1713338277183,EDS 139,B00,507313,Pappas; Elizabeth,30,0,30,0
1713338278209,EDS 201,A00,507315,Staff,26,0,30,4
1713338279244,EDS 203,A01,507317,Halter; Christopher P.,26,0,30,4
1713338280278,EDS 204R,A01,507319,Halter; Christopher P.,3,0,30,27
1713338280278,EDS 204R,B01,507331,Heinzman; Erica M.,28,0,30,2
1713338281304,EDS 206R,A00,507332,Staff,4,0,30,26
1713338281304,EDS 206R,B00,507343,Staff,28,0,30,2
1713338282333,EDS 250,A00,507344,Hemans; Patricia Ann Benitez,36,0,40,4
1713338283363,EDS 281,A00,507345,Daly; Alan J.,18,0,18,0
1713338284403,EDS 284,A00,507350,Daly; Alan J.,16,0,16,0
1713338285430,EDS 286,A00,507359,Fine; Sarah,18,0,18,0
1713338286462,EDS 289C,A01,507361,Daly; Alan J.,18,0,18,0
1713338287490,EDS 290,A00,507366,Hofstetter; Carolyn,15,0,15,0
1713338288522,LIGM 5A,A00,507421,Fischer-Grunski; Eva K,20,0,20,0
1713338289547,LIGM 5B,A00,507423,Fischer-Grunski; Eva K,20,0,20,0
1713338290577,LIGM 5C,A00,507425,Fischer-Grunski; Eva K,20,0,20,0
1713338291601,LIIT 5AS,A00,507427,Carnelos; Chiara,20,0,20,0
1713338292627,LIIT 5BS,A00,507430,Carnelos; Chiara,20,0,20,0
1713338293656,LIIT 5CS,A00,507432,Carnelos; Chiara,20,0,20,0
1713338294690,LISP 5A,A00,507541,Munoz Sanchez; Alicia,17,0,20,3
1713338295718,LISP 5B,A00,507671,Munoz Sanchez; Alicia,15,0,20,5
1713338296749,LISP 5C,A00,507696,Munoz Sanchez; Alicia,15,0,20,5
1713338297785,MAE 197,001,528363,Boechler; Nicholas Sebastia,9998,0,9999,1
1713338298819,MATH 197,001,523477,Kedlaya; Kiran S.,9999,0,9999,0
1713338298819,MATH 197,002,563811,Zhang; Danna,9999,0,9999,0
1713338299851,MCWP 40R,A00,518780,Staff,20,0,20,0
1713338299851,MCWP 40R,B00,518781,Staff,19,0,20,1
1713338299851,MCWP 40R,C00,518783,Staff,19,0,20,1
1713338300880,MCWP 50R,A00,518791,Staff,20,0,20,0
1713338300880,MCWP 50R,B00,518792,Staff,17,0,20,3
1713338300880,MCWP 50R,C00,518793,Staff,19,0,20,1
1713338300880,MCWP 50R,D00,518794,Staff,16,0,20,4
1713338300880,MCWP 50R,E00,518795,Staff,16,0,20,4
1713338300880,MCWP 50R,F00,518796,Staff,19,0,20,1
1713338300880,MCWP 50R,G00,518797,Staff,19,0,20,1
1713338301906,MMW 12R,A01,514034,Herbst; Matthew,15,0,16,1
1713338301906,MMW 12R,A02,514035,Herbst; Matthew,16,0,16,0
1713338302934,MMW 13R,A01,514037,Staff,12,0,16,4
1713338302934,MMW 13R,A02,514039,Staff,16,0,16,0
1713338304993,SIO 295LS,A00,523233,Staff,19,0,30,11
1713338306022,SIO 295S,A00,523232,Staff,19,0,30,11
1713338307048,SOCI 117,A01,494376,Staff,1,0,5,4
1713338308074,WES 237B,A00,494380,Staff,19,0,20,1
1713338310191,AESE 279B,A00,494370,Wade; Jon P,33,0,33,0
1713338311219,ANAR 135S,A00,494369,Braswell; Geoffrey E.,0,0,0,0
1713338312250,CAT 124RS,A01,519847,Geibel; William,17,0,20,3
1713338313275,CAT 125RS,A01,515971,Geibel; William,17,0,20,3
1713338314305,CLRE 250,A00,511389,Morris; Sheldon,9996,0,9999,3
1713338315332,CLRE 251,A00,507176,Mehta; Ravindra L.,9996,0,9999,3
1713338315332,CLRE 251,B00,511410,Mehta; Ravindra L.,9998,0,9999,1
1713338316359,CLRE 252,A00,507189,Cuomo; Raphael Eduardo,9998,0,9999,1
1713338317389,CLRE 253,A00,507199,Vaida; Florin,9997,0,9999,2
1713338317389,CLRE 253,B00,507202,Vaida; Florin,9999,0,9999,0
1713338318416,CLRE 259,A00,507211,Patel; Hemal,9996,0,9999,3
1713338319443,CLRE 260,A00,507221,Cuomo; Raphael Eduardo,9999,0,9999,0
1713338320471,CLRE 297,001,507242,Cuomo; Raphael Eduardo,9999,0,9999,0
1713338321502,CSE 191,A00,516875,Minnes Kemp; Mor Mia,9999,0,9999,0
1713338322529,CSS 201S,A01,494383,Staff,35,0,35,0
1713338323554,CSS 202S,A01,494387,Staff,35,0,35,0
1713338324581,EAP 100,A00,516065,Staff,9792,0,9999,207
1713338325614,ECE 45,A01,507414,Staff,51,0,60,9
1713338326638,ECE 100,A01,507416,Baghdadchi; Saharnaz,10,0,20,10
1713338326638,ECE 100,A02,507418,Baghdadchi; Saharnaz,20,0,20,0
1713338327668,ECE 111,A01,507420,Staff,38,0,50,12
1713338328695,ECE 197,001,548057,Sievenpiper; Daniel F.,9998,0,9999,1
1713338329721,EDS 115,A00,507243,Choi; Bailey Miyeon,28,0,28,0
1713338330753,EDS 117,A01,494379,Staff,23,0,25,2
1713338331781,EDS 125,A00,507246,Hopkins; Megan Beth,29,0,30,1
1713338332813,EDS 128A,A01,507264,Fargason; Sharon Gayle,26,0,26,0
1713338333844,EDS 128B,A01,507293,Pappas; Elizabeth,30,0,30,0
1713338334875,EDS 139,A00,507294,Fargason; Sharon Gayle,30,0,30,0
1713338334875,EDS 139,B00,507313,Pappas; Elizabeth,30,0,30,0
1713338335902,EDS 201,A00,507315,Staff,26,0,30,4
1713338336928,EDS 203,A01,507317,Halter; Christopher P.,26,0,30,4
1713338337954,EDS 204R,A01,507319,Halter; Christopher P.,3,0,30,27
1713338337954,EDS 204R,B01,507331,Heinzman; Erica M.,28,0,30,2
1713338338979,EDS 206R,A00,507332,Staff,4,0,30,26
1713338338979,EDS 206R,B00,507343,Staff,28,0,30,2
1713338340011,EDS 250,A00,507344,Hemans; Patricia Ann Benitez,36,0,40,4
1713338341038,EDS 281,A00,507345,Daly; Alan J.,18,0,18,0
1713338342064,EDS 284,A00,507350,Daly; Alan J.,16,0,16,0
1713338343220,EDS 286,A00,507359,Fine; Sarah,18,0,18,0
1713338344250,EDS 289C,A01,507361,Daly; Alan J.,18,0,18,0
1713338345284,EDS 290,A00,507366,Hofstetter; Carolyn,15,0,15,0
1713338346327,LIGM 5A,A00,507421,Fischer-Grunski; Eva K,20,0,20,0
1713338347410,LIGM 5B,A00,507423,Fischer-Grunski; Eva K,20,0,20,0
1713338348444,LIGM 5C,A00,507425,Fischer-Grunski; Eva K,20,0,20,0
1713338349468,LIIT 5AS,A00,507427,Carnelos; Chiara,20,0,20,0
1713338350492,LIIT 5BS,A00,507430,Carnelos; Chiara,20,0,20,0
1713338351521,LIIT 5CS,A00,507432,Carnelos; Chiara,20,0,20,0
1713338352549,LISP 5A,A00,507541,Munoz Sanchez; Alicia,17,0,20,3
1713338353574,LISP 5B,A00,507671,Munoz Sanchez; Alicia,15,0,20,5
1713338354601,LISP 5C,A00,507696,Munoz Sanchez; Alicia,15,0,20,5
1713338355633,MAE 197,001,528363,Boechler; Nicholas Sebastia,9998,0,9999,1
1713338356673,MATH 197,001,523477,Kedlaya; Kiran S.,9999,0,9999,0
1713338356673,MATH 197,002,563811,Zhang; Danna,9999,0,9999,0
1713338357705,MCWP 40R,A00,518780,Staff,20,0,20,0
1713338357705,MCWP 40R,B00,518781,Staff,19,0,20,1
1713338357705,MCWP 40R,C00,518783,Staff,19,0,20,1
1713338358735,MCWP 50R,A00,518791,Staff,20,0,20,0
1713338358735,MCWP 50R,B00,518792,Staff,17,0,20,3
1713338358735,MCWP 50R,C00,518793,Staff,19,0,20,1
1713338358735,MCWP 50R,D00,518794,Staff,16,0,20,4
1713338358735,MCWP 50R,E00,518795,Staff,16,0,20,4
1713338358735,MCWP 50R,F00,518796,Staff,19,0,20,1
1713338358735,MCWP 50R,G00,518797,Staff,19,0,20,1
1713338359768,MMW 12R,A01,514034,Herbst; Matthew,15,0,16,1
1713338359768,MMW 12R,A02,514035,Herbst; Matthew,16,0,16,0
1713338360799,MMW 13R,A01,514037,Staff,12,0,16,4
1713338360799,MMW 13R,A02,514039,Staff,16,0,16,0
1713338362856,SIO 295LS,A00,523233,Staff,19,0,30,11
1713338363883,SIO 295S,A00,523232,Staff,19,0,30,11
1713338364909,SOCI 117,A01,494376,Staff,1,0,5,4
1713338365935,WES 237B,A00,494380,Staff,19,0,20,1
1713338368030,AESE 279B,A00,494370,Wade; Jon P,33,0,33,0
1713338369061,ANAR 135S,A00,494369,Braswell; Geoffrey E.,0,0,0,0
1713338370086,CAT 124RS,A01,519847,Geibel; William,17,0,20,3
1713338371113,CAT 125RS,A01,515971,Geibel; William,17,0,20,3
1713338372144,CLRE 250,A00,511389,Morris; Sheldon,9996,0,9999,3
1713338373186,CLRE 251,A00,507176,Mehta; Ravindra L.,9996,0,9999,3
1713338373186,CLRE 251,B00,511410,Mehta; Ravindra L.,9998,0,9999,1
1713338374220,CLRE 252,A00,507189,Cuomo; Raphael Eduardo,9998,0,9999,1
1713338375248,CLRE 253,A00,507199,Vaida; Florin,9997,0,9999,2
1713338375248,CLRE 253,B00,507202,Vaida; Florin,9999,0,9999,0
1713338376273,CLRE 259,A00,507211,Patel; Hemal,9996,0,9999,3
1713338377298,CLRE 260,A00,507221,Cuomo; Raphael Eduardo,9999,0,9999,0
1713338378327,CLRE 297,001,507242,Cuomo; Raphael Eduardo,9999,0,9999,0
1713338379352,CSE 191,A00,516875,Minnes Kemp; Mor Mia,9999,0,9999,0
1713338380378,CSS 201S,A01,494383,Staff,35,0,35,0
1713338381403,CSS 202S,A01,494387,Staff,35,0,35,0
1713338382432,EAP 100,A00,516065,Staff,9792,0,9999,207
1713338383458,ECE 45,A01,507414,Staff,51,0,60,9
1713338384484,ECE 100,A01,507416,Baghdadchi; Saharnaz,10,0,20,10
1713338384484,ECE 100,A02,507418,Baghdadchi; Saharnaz,20,0,20,0
1713338385518,ECE 111,A01,507420,Staff,38,0,50,12
1713338386545,ECE 197,001,548057,Sievenpiper; Daniel F.,9998,0,9999,1
1713338387573,EDS 115,A00,507243,Choi; Bailey Miyeon,28,0,28,0
1713338388600,EDS 117,A01,494379,Staff,23,0,25,2
1713338389626,EDS 125,A00,507246,Hopkins; Megan Beth,29,0,30,1
1713338390654,EDS 128A,A01,507264,Fargason; Sharon Gayle,26,0,26,0
1713338391681,EDS 128B,A01,507293,Pappas; Elizabeth,30,0,30,0
1713338392712,EDS 139,A00,507294,Fargason; Sharon Gayle,30,0,30,0
1713338392712,EDS 139,B00,507313,Pappas; Elizabeth,30,0,30,0
1713338393744,EDS 201,A00,507315,Staff,26,0,30,4
1713338394781,EDS 203,A01,507317,Halter; Christopher P.,26,0,30,4
1713338395810,EDS 204R,A01,507319,Halter; Christopher P.,3,0,30,27
1713338395810,EDS 204R,B01,507331,Heinzman; Erica M.,28,0,30,2
1713338396835,EDS 206R,A00,507332,Staff,4,0,30,26
1713338396835,EDS 206R,B00,507343,Staff,28,0,30,2
1713338397866,EDS 250,A00,507344,Hemans; Patricia Ann Benitez,36,0,40,4
1713338398897,EDS 281,A00,507345,Daly; Alan J.,18,0,18,0
1713338399929,EDS 284,A00,507350,Daly; Alan J.,16,0,16,0
1713338400959,EDS 286,A00,507359,Fine; Sarah,18,0,18,0
1713338401985,EDS 289C,A01,507361,Daly; Alan J.,18,0,18,0
1713338403015,EDS 290,A00,507366,Hofstetter; Carolyn,15,0,15,0
1713338404048,LIGM 5A,A00,507421,Fischer-Grunski; Eva K,20,0,20,0
1713338405074,LIGM 5B,A00,507423,Fischer-Grunski; Eva K,20,0,20,0
1713338406099,LIGM 5C,A00,507425,Fischer-Grunski; Eva K,20,0,20,0
1713338407125,LIIT 5AS,A00,507427,Carnelos; Chiara,20,0,20,0
1713338408157,LIIT 5BS,A00,507430,Carnelos; Chiara,20,0,20,0
1713338409183,LIIT 5CS,A00,507432,Carnelos; Chiara,20,0,20,0
1713338410209,LISP 5A,A00,507541,Munoz Sanchez; Alicia,17,0,20,3
1713338411236,LISP 5B,A00,507671,Munoz Sanchez; Alicia,15,0,20,5
1713338412262,LISP 5C,A00,507696,Munoz Sanchez; Alicia,15,0,20,5
1713338413297,MAE 197,001,528363,Boechler; Nicholas Sebastia,9998,0,9999,1
1713338414334,MATH 197,001,523477,Kedlaya; Kiran S.,9999,0,9999,0
1713338414334,MATH 197,002,563811,Zhang; Danna,9999,0,9999,0
1713338415367,MCWP 40R,A00,518780,Staff,20,0,20,0
1713338415367,MCWP 40R,B00,518781,Staff,19,0,20,1
1713338415367,MCWP 40R,C00,518783,Staff,19,0,20,1
1713338416392,MCWP 50R,A00,518791,Staff,20,0,20,0
1713338416392,MCWP 50R,B00,518792,Staff,17,0,20,3
1713338416392,MCWP 50R,C00,518793,Staff,19,0,20,1
1713338416392,MCWP 50R,D00,518794,Staff,16,0,20,4
1713338416392,MCWP 50R,E00,518795,Staff,16,0,20,4
1713338416392,MCWP 50R,F00,518796,Staff,19,0,20,1
1713338416392,MCWP 50R,G00,518797,Staff,19,0,20,1
1713338417418,MMW 12R,A01,514034,Herbst; Matthew,15,0,16,1
1713338417418,MMW 12R,A02,514035,Herbst; Matthew,16,0,16,0
1713338418447,MMW 13R,A01,514037,Staff,12,0,16,4
1713338418447,MMW 13R,A02,514039,Staff,16,0,16,0
1713338420499,SIO 295LS,A00,523233,Staff,19,0,30,11
1713338421529,SIO 295S,A00,523232,Staff,19,0,30,11
1713338422561,SOCI 117,A01,494376,Staff,1,0,5,4
1713338423589,WES 237B,A00,494380,Staff,19,0,20,1
1713338425665,AESE 279B,A00,494370,Wade; Jon P,33,0,33,0
1713338426690,ANAR 135S,A00,494369,Braswell; Geoffrey E.,0,0,0,0
1713338427715,CAT 124RS,A01,519847,Geibel; William,17,0,20,3
1713338428740,CAT 125RS,A01,515971,Geibel; William,17,0,20,3
1713338429767,CLRE 250,A00,511389,Morris; Sheldon,9996,0,9999,3
1713338430801,CLRE 251,A00,507176,Mehta; Ravindra L.,9996,0,9999,3
1713338430801,CLRE 251,B00,511410,Mehta; Ravindra L.,9998,0,9999,1
1713338431828,CLRE 252,A00,507189,Cuomo; Raphael Eduardo,9998,0,9999,1
1713338432854,CLRE 253,A00,507199,Vaida; Florin,9997,0,9999,2
1713338432854,CLRE 253,B00,507202,Vaida; Florin,9999,0,9999,0
1713338433880,CLRE 259,A00,507211,Patel; Hemal,9996,0,9999,3
1713338434905,CLRE 260,A00,507221,Cuomo; Raphael Eduardo,9999,0,9999,0
1713338435929,CLRE 297,001,507242,Cuomo; Raphael Eduardo,9999,0,9999,0
1713338436955,CSE 191,A00,516875,Minnes Kemp; Mor Mia,9999,0,9999,0
1713338437983,CSS 201S,A01,494383,Staff,35,0,35,0
1713338439520,CSS 202S,A01,494387,Staff,35,0,35,0
1713338440546,EAP 100,A00,516065,Staff,9792,0,9999,207
1713338441577,ECE 45,A01,507414,Staff,51,0,60,9
1713338442606,ECE 100,A01,507416,Baghdadchi; Saharnaz,10,0,20,10
1713338442606,ECE 100,A02,507418,Baghdadchi; Saharnaz,20,0,20,0
1713338443663,ECE 111,A01,507420,Staff,38,0,50,12
1713338444689,ECE 197,001,548057,Sievenpiper; Daniel F.,9998,0,9999,1
1713338445723,EDS 115,A00,507243,Choi; Bailey Miyeon,28,0,28,0
1713338446755,EDS 117,A01,494379,Staff,23,0,25,2
1713338447780,EDS 125,A00,507246,Hopkins; Megan Beth,29,0,30,1
1713338448808,EDS 128A,A01,507264,Fargason; Sharon Gayle,26,0,26,0
1713338449835,EDS 128B,A01,507293,Pappas; Elizabeth,30,0,30,0
1713338450864,EDS 139,A00,507294,Fargason; Sharon Gayle,30,0,30,0
1713338450864,EDS 139,B00,507313,Pappas; Elizabeth,30,0,30,0
1713338451944,EDS 201,A00,507315,Staff,26,0,30,4
1713338452972,EDS 203,A01,507317,Halter; Christopher P.,26,0,30,4
1713338454003,EDS 204R,A01,507319,Halter; Christopher P.,3,0,30,27
1713338454003,EDS 204R,B01,507331,Heinzman; Erica M.,28,0,30,2
1713338455029,EDS 206R,A00,507332,Staff,4,0,30,26
1713338455029,EDS 206R,B00,507343,Staff,28,0,30,2
1713338456056,EDS 250,A00,507344,Hemans; Patricia Ann Benitez,36,0,40,4
1713338457081,EDS 281,A00,507345,Daly; Alan J.,18,0,18,0
1713338458111,EDS 284,A00,507350,Daly; Alan J.,16,0,16,0
1713338459140,EDS 286,A00,507359,Fine; Sarah,18,0,18,0
1713338460173,EDS 289C,A01,507361,Daly; Alan J.,18,0,18,0
1713338461198,EDS 290,A00,507366,Hofstetter; Carolyn,15,0,15,0
1713338462231,LIGM 5A,A00,507421,Fischer-Grunski; Eva K,20,0,20,0
1713338463257,LIGM 5B,A00,507423,Fischer-Grunski; Eva K,20,0,20,0
1713338464283,LIGM 5C,A00,507425,Fischer-Grunski; Eva K,20,0,20,0
1713338465315,LIIT 5AS,A00,507427,Carnelos; Chiara,20,0,20,0
1713338466341,LIIT 5BS,A00,507430,Carnelos; Chiara,20,0,20,0
1713338467372,LIIT 5CS,A00,507432,Carnelos; Chiara,20,0,20,0
1713338468403,LISP 5A,A00,507541,Munoz Sanchez; Alicia,17,0,20,3
1713338469437,LISP 5B,A00,507671,Munoz Sanchez; Alicia,15,0,20,5
1713338470469,LISP 5C,A00,507696,Munoz Sanchez; Alicia,15,0,20,5
1713338471496,MAE 197,001,528363,Boechler; Nicholas Sebastia,9998,0,9999,1
1713338472534,MATH 197,001,523477,Kedlaya; Kiran S.,9999,0,9999,0
1713338472534,MATH 197,002,563811,Zhang; Danna,9999,0,9999,0
1713338473562,MCWP 40R,A00,518780,Staff,20,0,20,0
1713338473562,MCWP 40R,B00,518781,Staff,19,0,20,1
1713338473562,MCWP 40R,C00,518783,Staff,19,0,20,1
1713338474589,MCWP 50R,A00,518791,Staff,20,0,20,0
1713338474589,MCWP 50R,B00,518792,Staff,17,0,20,3
1713338474589,MCWP 50R,C00,518793,Staff,19,0,20,1
1713338474589,MCWP 50R,D00,518794,Staff,16,0,20,4
1713338474589,MCWP 50R,E00,518795,Staff,16,0,20,4
1713338474589,MCWP 50R,F00,518796,Staff,19,0,20,1
1713338474589,MCWP 50R,G00,518797,Staff,19,0,20,1
1713338475616,MMW 12R,A01,514034,Herbst; Matthew,15,0,16,1
1713338475616,MMW 12R,A02,514035,Herbst; Matthew,16,0,16,0
1713338476647,MMW 13R,A01,514037,Staff,12,0,16,4
1713338476647,MMW 13R,A02,514039,Staff,16,0,16,0
1713338478697,SIO 295LS,A00,523233,Staff,19,0,30,11
1713338479729,SIO 295S,A00,523232,Staff,19,0,30,11
1713338480755,SOCI 117,A01,494376,Staff,1,0,5,4
1713338481785,WES 237B,A00,494380,Staff,19,0,20,1
1713338483870,AESE 279B,A00,494370,Wade; Jon P,33,0,33,0
1713338484898,ANAR 135S,A00,494369,Braswell; Geoffrey E.,0,0,0,0
1713338485925,CAT 124RS,A01,519847,Geibel; William,17,0,20,3
1713338486949,CAT 125RS,A01,515971,Geibel; William,17,0,20,3
1713338487976,CLRE 250,A00,511389,Morris; Sheldon,9996,0,9999,3
1713338489002,CLRE 251,A00,507176,Mehta; Ravindra L.,9996,0,9999,3
1713338489002,CLRE 251,B00,511410,Mehta; Ravindra L.,9998,0,9999,1
1713338490030,CLRE 252,A00,507189,Cuomo; Raphael Eduardo,9998,0,9999,1
1713338491057,CLRE 253,A00,507199,Vaida; Florin,9997,0,9999,2
1713338491057,CLRE 253,B00,507202,Vaida; Florin,9999,0,9999,0
1713338492089,CLRE 259,A00,507211,Patel; Hemal,9996,0,9999,3
1713338493120,CLRE 260,A00,507221,Cuomo; Raphael Eduardo,9999,0,9999,0
1713338494143,CLRE 297,001,507242,Cuomo; Raphael Eduardo,9999,0,9999,0
1713338495169,CSE 191,A00,516875,Minnes Kemp; Mor Mia,9999,0,9999,0
1713338496201,CSS 201S,A01,494383,Staff,35,0,35,0
1713338497233,CSS 202S,A01,494387,Staff,35,0,35,0
1713338498259,EAP 100,A00,516065,Staff,9792,0,9999,207
1713338499286,ECE 45,A01,507414,Staff,51,0,60,9
1713338500313,ECE 100,A01,507416,Baghdadchi; Saharnaz,10,0,20,10
1713338500313,ECE 100,A02,507418,Baghdadchi; Saharnaz,20,0,20,0
1713338501338,ECE 111,A01,507420,Staff,38,0,50,12
1713338502366,ECE 197,001,548057,Sievenpiper; Daniel F.,9998,0,9999,1
1713338503399,EDS 115,A00,507243,Choi; Bailey Miyeon,28,0,28,0
1713338504425,EDS 117,A01,494379,Staff,23,0,25,2
1713338505456,EDS 125,A00,507246,Hopkins; Megan Beth,29,0,30,1
1713338506483,EDS 128A,A01,507264,Fargason; Sharon Gayle,26,0,26,0
1713338507515,EDS 128B,A01,507293,Pappas; Elizabeth,30,0,30,0
1713338508539,EDS 139,A00,507294,Fargason; Sharon Gayle,30,0,30,0
1713338508539,EDS 139,B00,507313,Pappas; Elizabeth,30,0,30,0
1713338509566,EDS 201,A00,507315,Staff,26,0,30,4
1713338510598,EDS 203,A01,507317,Halter; Christopher P.,26,0,30,4
1713338511625,EDS 204R,A01,507319,Halter; Christopher P.,3,0,30,27
1713338511625,EDS 204R,B01,507331,Heinzman; Erica M.,28,0,30,2
1713338512650,EDS 206R,A00,507332,Staff,4,0,30,26
1713338512650,EDS 206R,B00,507343,Staff,28,0,30,2
1713338513683,EDS 250,A00,507344,Hemans; Patricia Ann Benitez,36,0,40,4
1713338514716,EDS 281,A00,507345,Daly; Alan J.,18,0,18,0
1713338515747,EDS 284,A00,507350,Daly; Alan J.,16,0,16,0
1713338516780,EDS 286,A00,507359,Fine; Sarah,18,0,18,0
1713338517807,EDS 289C,A01,507361,Daly; Alan J.,18,0,18,0
1713338518837,EDS 290,A00,507366,Hofstetter; Carolyn,15,0,15,0
1713338519866,LIGM 5A,A00,507421,Fischer-Grunski; Eva K,20,0,20,0
1713338520903,LIGM 5B,A00,507423,Fischer-Grunski; Eva K,20,0,20,0
1713338521934,LIGM 5C,A00,507425,Fischer-Grunski; Eva K,20,0,20,0
1713338522965,LIIT 5AS,A00,507427,Carnelos; Chiara,20,0,20,0
1713338523996,LIIT 5BS,A00,507430,Carnelos; Chiara,20,0,20,0
1713338525030,LIIT 5CS,A00,507432,Carnelos; Chiara,20,0,20,0
1713338526056,LISP 5A,A00,507541,Munoz Sanchez; Alicia,17,0,20,3
1713338527081,LISP 5B,A00,507671,Munoz Sanchez; Alicia,15,0,20,5
1713338528111,LISP 5C,A00,507696,Munoz Sanchez; Alicia,15,0,20,5
1713338529140,MAE 197,001,528363,Boechler; Nicholas Sebastia,9998,0,9999,1
1713338530171,MATH 197,001,523477,Kedlaya; Kiran S.,9999,0,9999,0
1713338530171,MATH 197,002,563811,Zhang; Danna,9999,0,9999,0
1713338531199,MCWP 40R,A00,518780,Staff,20,0,20,0
1713338531199,MCWP 40R,B00,518781,Staff,19,0,20,1
1713338531199,MCWP 40R,C00,518783,Staff,19,0,20,1
1713338532231,MCWP 50R,A00,518791,Staff,20,0,20,0
1713338532231,MCWP 50R,B00,518792,Staff,17,0,20,3
1713338532231,MCWP 50R,C00,518793,Staff,19,0,20,1
1713338532231,MCWP 50R,D00,518794,Staff,16,0,20,4
1713338532231,MCWP 50R,E00,518795,Staff,16,0,20,4
1713338532231,MCWP 50R,F00,518796,Staff,19,0,20,1
1713338532231,MCWP 50R,G00,518797,Staff,19,0,20,1
1713338533257,MMW 12R,A01,514034,Herbst; Matthew,15,0,16,1
1713338533257,MMW 12R,A02,514035,Herbst; Matthew,16,0,16,0
1713338534283,MMW 13R,A01,514037,Staff,12,0,16,4
1713338534283,MMW 13R,A02,514039,Staff,16,0,16,0
1713338536334,SIO 295LS,A00,523233,Staff,19,0,30,11
1713338537365,SIO 295S,A00,523232,Staff,19,0,30,11
1713338538396,SOCI 117,A01,494376,Staff,1,0,5,4
1713338539423,WES 237B,A00,494380,Staff,19,0,20,1
1713338541496,AESE 279B,A00,494370,Wade; Jon P,33,0,33,0
1713338542522,ANAR 135S,A00,494369,Braswell; Geoffrey E.,0,0,0,0
1713338543547,CAT 124RS,A01,519847,Geibel; William,17,0,20,3
1713338544574,CAT 125RS,A01,515971,Geibel; William,17,0,20,3
1713338545603,CLRE 250,A00,511389,Morris; Sheldon,9996,0,9999,3
1713338546646,CLRE 251,A00,507176,Mehta; Ravindra L.,9996,0,9999,3
1713338546646,CLRE 251,B00,511410,Mehta; Ravindra L.,9998,0,9999,1
1713338547673,CLRE 252,A00,507189,Cuomo; Raphael Eduardo,9998,0,9999,1
1713338548710,CLRE 253,A00,507199,Vaida; Florin,9997,0,9999,2
1713338548710,CLRE 253,B00,507202,Vaida; Florin,9999,0,9999,0
1713338549746,CLRE 259,A00,507211,Patel; Hemal,9996,0,9999,3
1713338550770,CLRE 260,A00,507221,Cuomo; Raphael Eduardo,9999,0,9999,0
1713338551795,CLRE 297,001,507242,Cuomo; Raphael Eduardo,9999,0,9999,0
1713338552820,CSE 191,A00,516875,Minnes Kemp; Mor Mia,9999,0,9999,0
1713338553847,CSS 201S,A01,494383,Staff,35,0,35,0
1713338554879,CSS 202S,A01,494387,Staff,35,0,35,0
1713338555963,EAP 100,A00,516065,Staff,9792,0,9999,207
1713338556989,ECE 45,A01,507414,Staff,51,0,60,9
1713338558016,ECE 100,A01,507416,Baghdadchi; Saharnaz,10,0,20,10
1713338558016,ECE 100,A02,507418,Baghdadchi; Saharnaz,20,0,20,0
1713338559052,ECE 111,A01,507420,Staff,38,0,50,12
1713338560077,ECE 197,001,548057,Sievenpiper; Daniel F.,9998,0,9999,1
1713338561105,EDS 115,A00,507243,Choi; Bailey Miyeon,28,0,28,0
1713338562132,EDS 117,A01,494379,Staff,23,0,25,2
1713338563158,EDS 125,A00,507246,Hopkins; Megan Beth,29,0,30,1
1713338564213,EDS 128A,A01,507264,Fargason; Sharon Gayle,26,0,26,0
1713338565246,EDS 128B,A01,507293,Pappas; Elizabeth,30,0,30,0
1713338566272,EDS 139,A00,507294,Fargason; Sharon Gayle,30,0,30,0
1713338566272,EDS 139,B00,507313,Pappas; Elizabeth,30,0,30,0
1713338567298,EDS 201,A00,507315,Staff,26,0,30,4
1713338568325,EDS 203,A01,507317,Halter; Christopher P.,26,0,30,4
1713338569352,EDS 204R,A01,507319,Halter; Christopher P.,3,0,30,27
1713338569352,EDS 204R,B01,507331,Heinzman; Erica M.,28,0,30,2
1713338570382,EDS 206R,A00,507332,Staff,4,0,30,26
1713338570382,EDS 206R,B00,507343,Staff,28,0,30,2
1713338571406,EDS 250,A00,507344,Hemans; Patricia Ann Benitez,36,0,40,4
1713338572430,EDS 281,A00,507345,Daly; Alan J.,18,0,18,0
1713338573458,EDS 284,A00,507350,Daly; Alan J.,16,0,16,0
1713338574488,EDS 286,A00,507359,Fine; Sarah,18,0,18,0
1713338575515,EDS 289C,A01,507361,Daly; Alan J.,18,0,18,0
1713338576543,EDS 290,A00,507366,Hofstetter; Carolyn,15,0,15,0
1713338577573,LIGM 5A,A00,507421,Fischer-Grunski; Eva K,20,0,20,0
1713338578607,LIGM 5B,A00,507423,Fischer-Grunski; Eva K,20,0,20,0
1713338579633,LIGM 5C,A00,507425,Fischer-Grunski; Eva K,20,0,20,0
1713338580672,LIIT 5AS,A00,507427,Carnelos; Chiara,20,0,20,0
1713338581698,LIIT 5BS,A00,507430,Carnelos; Chiara,20,0,20,0
1713338582723,LIIT 5CS,A00,507432,Carnelos; Chiara,20,0,20,0
1713338583755,LISP 5A,A00,507541,Munoz Sanchez; Alicia,17,0,20,3
1713338584781,LISP 5B,A00,507671,Munoz Sanchez; Alicia,15,0,20,5
1713338585807,LISP 5C,A00,507696,Munoz Sanchez; Alicia,15,0,20,5
1713338586833,MAE 197,001,528363,Boechler; Nicholas Sebastia,9998,0,9999,1
1713338587869,MATH 197,001,523477,Kedlaya; Kiran S.,9999,0,9999,0
1713338587869,MATH 197,002,563811,Zhang; Danna,9999,0,9999,0
1713338588900,MCWP 40R,A00,518780,Staff,20,0,20,0
1713338588900,MCWP 40R,B00,518781,Staff,19,0,20,1
1713338588900,MCWP 40R,C00,518783,Staff,19,0,20,1
1713338589927,MCWP 50R,A00,518791,Staff,20,0,20,0
1713338589927,MCWP 50R,B00,518792,Staff,17,0,20,3
1713338589927,MCWP 50R,C00,518793,Staff,19,0,20,1
1713338589927,MCWP 50R,D00,518794,Staff,16,0,20,4
1713338589927,MCWP 50R,E00,518795,Staff,16,0,20,4
1713338589927,MCWP 50R,F00,518796,Staff,19,0,20,1
1713338589927,MCWP 50R,G00,518797,Staff,19,0,20,1
1713338590958,MMW 12R,A01,514034,Herbst; Matthew,15,0,16,1
1713338590958,MMW 12R,A02,514035,Herbst; Matthew,16,0,16,0
1713338591985,MMW 13R,A01,514037,Staff,12,0,16,4
1713338591985,MMW 13R,A02,514039,Staff,16,0,16,0
1713338594046,SIO 295LS,A00,523233,Staff,19,0,30,11
1713338595076,SIO 295S,A00,523232,Staff,19,0,30,11
1713338596107,SOCI 117,A01,494376,Staff,1,0,5,4
1713338597132,WES 237B,A00,494380,Staff,19,0,20,1
1713338599216,AESE 279B,A00,494370,Wade; Jon P,33,0,33,0
1713338600247,ANAR 135S,A00,494369,Braswell; Geoffrey E.,0,0,0,0
1713338601273,CAT 124RS,A01,519847,Geibel; William,17,0,20,3
1713338602303,CAT 125RS,A01,515971,Geibel; William,17,0,20,3
1713338603330,CLRE 250,A00,511389,Morris; Sheldon,9996,0,9999,3
1713338604359,CLRE 251,A00,507176,Mehta; Ravindra L.,9996,0,9999,3
1713338604359,CLRE 251,B00,511410,Mehta; Ravindra L.,9998,0,9999,1
1713338605386,CLRE 252,A00,507189,Cuomo; Raphael Eduardo,9998,0,9999,1
1713338606423,CLRE 253,A00,507199,Vaida; Florin,9997,0,9999,2
1713338606423,CLRE 253,B00,507202,Vaida; Florin,9999,0,9999,0
1713338607456,CLRE 259,A00,507211,Patel; Hemal,9996,0,9999,3
1713338608482,CLRE 260,A00,507221,Cuomo; Raphael Eduardo,9999,0,9999,0
1713338609508,CLRE 297,001,507242,Cuomo; Raphael Eduardo,9999,0,9999,0
1713338610542,CSE 191,A00,516875,Minnes Kemp; Mor Mia,9999,0,9999,0
1713338611569,CSS 201S,A01,494383,Staff,35,0,35,0
1713338612594,CSS 202S,A01,494387,Staff,35,0,35,0
1713338613620,EAP 100,A00,516065,Staff,9792,0,9999,207
1713338614646,ECE 45,A01,507414,Staff,51,0,60,9
1713338615680,ECE 100,A01,507416,Baghdadchi; Saharnaz,10,0,20,10
1713338615680,ECE 100,A02,507418,Baghdadchi; Saharnaz,20,0,20,0
1713338616706,ECE 111,A01,507420,Staff,38,0,50,12
1713338617730,ECE 197,001,548057,Sievenpiper; Daniel F.,9998,0,9999,1
1713338618758,EDS 115,A00,507243,Choi; Bailey Miyeon,28,0,28,0
1713338619784,EDS 117,A01,494379,Staff,23,0,25,2
1713338620812,EDS 125,A00,507246,Hopkins; Megan Beth,29,0,30,1
1713338621839,EDS 128A,A01,507264,Fargason; Sharon Gayle,26,0,26,0
1713338622866,EDS 128B,A01,507293,Pappas; Elizabeth,30,0,30,0
1713338623904,EDS 139,A00,507294,Fargason; Sharon Gayle,30,0,30,0
1713338623904,EDS 139,B00,507313,Pappas; Elizabeth,30,0,30,0
1713338625042,EDS 201,A00,507315,Staff,26,0,30,4
1713338626075,EDS 203,A01,507317,Halter; Christopher P.,26,0,30,4
1713338627105,EDS 204R,A01,507319,Halter; Christopher P.,3,0,30,27
1713338627105,EDS 204R,B01,507331,Heinzman; Erica M.,28,0,30,2
1713338628141,EDS 206R,A00,507332,Staff,4,0,30,26
1713338628141,EDS 206R,B00,507343,Staff,28,0,30,2
1713338629167,EDS 250,A00,507344,Hemans; Patricia Ann Benitez,36,0,40,4
1713338630201,EDS 281,A00,507345,Daly; Alan J.,18,0,18,0
1713338631224,EDS 284,A00,507350,Daly; Alan J.,16,0,16,0
1713338632251,EDS 286,A00,507359,Fine; Sarah,18,0,18,0
1713338633275,EDS 289C,A01,507361,Daly; Alan J.,18,0,18,0
1713338634303,EDS 290,A00,507366,Hofstetter; Carolyn,15,0,15,0
1713338635332,LIGM 5A,A00,507421,Fischer-Grunski; Eva K,20,0,20,0
1713338636358,LIGM 5B,A00,507423,Fischer-Grunski; Eva K,20,0,20,0
1713338637390,LIGM 5C,A00,507425,Fischer-Grunski; Eva K,20,0,20,0
1713338638417,LIIT 5AS,A00,507427,Carnelos; Chiara,20,0,20,0
1713338639450,LIIT 5BS,A00,507430,Carnelos; Chiara,20,0,20,0
1713338640479,LIIT 5CS,A00,507432,Carnelos; Chiara,20,0,20,0
1713338641524,LISP 5A,A00,507541,Munoz Sanchez; Alicia,17,0,20,3
1713338642556,LISP 5B,A00,507671,Munoz Sanchez; Alicia,15,0,20,5
1713338643587,LISP 5C,A00,507696,Munoz Sanchez; Alicia,15,0,20,5
1713338644617,MAE 197,001,528363,Boechler; Nicholas Sebastia,9998,0,9999,1
1713338645653,MATH 197,001,523477,Kedlaya; Kiran S.,9999,0,9999,0
1713338645653,MATH 197,002,563811,Zhang; Danna,9999,0,9999,0
1713338646688,MCWP 40R,A00,518780,Staff,20,0,20,0
1713338646688,MCWP 40R,B00,518781,Staff,19,0,20,1
1713338646688,MCWP 40R,C00,518783,Staff,19,0,20,1
1713338647721,MCWP 50R,A00,518791,Staff,20,0,20,0
1713338647721,MCWP 50R,B00,518792,Staff,17,0,20,3
1713338647721,MCWP 50R,C00,518793,Staff,19,0,20,1
1713338647721,MCWP 50R,D00,518794,Staff,16,0,20,4
1713338647721,MCWP 50R,E00,518795,Staff,16,0,20,4
1713338647721,MCWP 50R,F00,518796,Staff,19,0,20,1
1713338647721,MCWP 50R,G00,518797,Staff,19,0,20,1
1713338648748,MMW 12R,A01,514034,Herbst; Matthew,15,0,16,1
1713338648748,MMW 12R,A02,514035,Herbst; Matthew,16,0,16,0
1713338649775,MMW 13R,A01,514037,Staff,12,0,16,4
1713338649775,MMW 13R,A02,514039,Staff,16,0,16,0
1713338651834,SIO 295LS,A00,523233,Staff,19,0,30,11
1713338652860,SIO 295S,A00,523232,Staff,19,0,30,11
1713338653901,SOCI 117,A01,494376,Staff,1,0,5,4
1713338654932,WES 237B,A00,494380,Staff,19,0,20,1
1713338657013,AESE 279B,A00,494370,Wade; Jon P,33,0,33,0
1713338658039,ANAR 135S,A00,494369,Braswell; Geoffrey E.,0,0,0,0
1713338659069,CAT 124RS,A01,519847,Geibel; William,17,0,20,3
1713338660151,CAT 125RS,A01,515971,Geibel; William,17,0,20,3
1713338661183,CLRE 250,A00,511389,Morris; Sheldon,9996,0,9999,3
1713338662213,CLRE 251,A00,507176,Mehta; Ravindra L.,9996,0,9999,3
1713338662213,CLRE 251,B00,511410,Mehta; Ravindra L.,9998,0,9999,1
1713338663239,CLRE 252,A00,507189,Cuomo; Raphael Eduardo,9998,0,9999,1
1713338664265,CLRE 253,A00,507199,Vaida; Florin,9997,0,9999,2
1713338664265,CLRE 253,B00,507202,Vaida; Florin,9999,0,9999,0
1713338665292,CLRE 259,A00,507211,Patel; Hemal,9996,0,9999,3
1713338666325,CLRE 260,A00,507221,Cuomo; Raphael Eduardo,9999,0,9999,0
1713338667349,CLRE 297,001,507242,Cuomo; Raphael Eduardo,9999,0,9999,0
1713338668377,CSE 191,A00,516875,Minnes Kemp; Mor Mia,9999,0,9999,0
1713338669415,CSS 201S,A01,494383,Staff,35,0,35,0
1713338670442,CSS 202S,A01,494387,Staff,35,0,35,0
1713338671469,EAP 100,A00,516065,Staff,9792,0,9999,207
1713338672494,ECE 45,A01,507414,Staff,51,0,60,9
1713338673526,ECE 100,A01,507416,Baghdadchi; Saharnaz,10,0,20,10
1713338673526,ECE 100,A02,507418,Baghdadchi; Saharnaz,20,0,20,0
1713338674555,ECE 111,A01,507420,Staff,38,0,50,12
1713338675588,ECE 197,001,548057,Sievenpiper; Daniel F.,9998,0,9999,1
1713338676615,EDS 115,A00,507243,Choi; Bailey Miyeon,28,0,28,0
1713338677642,EDS 117,A01,494379,Staff,23,0,25,2
1713338678668,EDS 125,A00,507246,Hopkins; Megan Beth,29,0,30,1
1713338679694,EDS 128A,A01,507264,Fargason; Sharon Gayle,26,0,26,0
1713338680724,EDS 128B,A01,507293,Pappas; Elizabeth,30,0,30,0
1713338681751,EDS 139,A00,507294,Fargason; Sharon Gayle,30,0,30,0
1713338681751,EDS 139,B00,507313,Pappas; Elizabeth,30,0,30,0
1713338682797,EDS 201,A00,507315,Staff,26,0,30,4
1713338683824,EDS 203,A01,507317,Halter; Christopher P.,26,0,30,4
1713338684855,EDS 204R,A01,507319,Halter; Christopher P.,3,0,30,27
1713338684855,EDS 204R,B01,507331,Heinzman; Erica M.,28,0,30,2
1713338685881,EDS 206R,A00,507332,Staff,4,0,30,26
1713338685881,EDS 206R,B00,507343,Staff,28,0,30,2
1713338686907,EDS 250,A00,507344,Hemans; Patricia Ann Benitez,36,0,40,4
1713338687933,EDS 281,A00,507345,Daly; Alan J.,18,0,18,0
1713338688960,EDS 284,A00,507350,Daly; Alan J.,16,0,16,0
1713338689991,EDS 286,A00,507359,Fine; Sarah,18,0,18,0
1713338691016,EDS 289C,A01,507361,Daly; Alan J.,18,0,18,0
1713338692043,EDS 290,A00,507366,Hofstetter; Carolyn,15,0,15,0
1713338693081,LIGM 5A,A00,507421,Fischer-Grunski; Eva K,20,0,20,0
1713338694122,LIGM 5B,A00,507423,Fischer-Grunski; Eva K,20,0,20,0
1713338695155,LIGM 5C,A00,507425,Fischer-Grunski; Eva K,20,0,20,0
1713338696182,LIIT 5AS,A00,507427,Carnelos; Chiara,20,0,20,0
1713338697221,LIIT 5BS,A00,507430,Carnelos; Chiara,20,0,20,0
1713338698252,LIIT 5CS,A00,507432,Carnelos; Chiara,20,0,20,0
1713338699295,LISP 5A,A00,507541,Munoz Sanchez; Alicia,17,0,20,3
1713338700320,LISP 5B,A00,507671,Munoz Sanchez; Alicia,15,0,20,5
1713338701350,LISP 5C,A00,507696,Munoz Sanchez; Alicia,15,0,20,5
1713338702375,MAE 197,001,528363,Boechler; Nicholas Sebastia,9998,0,9999,1
1713338703426,MATH 197,001,523477,Kedlaya; Kiran S.,9999,0,9999,0
1713338703426,MATH 197,002,563811,Zhang; Danna,9999,0,9999,0
1713338704459,MCWP 40R,A00,518780,Staff,20,0,20,0
1713338704459,MCWP 40R,B00,518781,Staff,19,0,20,1
1713338704459,MCWP 40R,C00,518783,Staff,19,0,20,1
1713338705489,MCWP 50R,A00,518791,Staff,20,0,20,0
1713338705489,MCWP 50R,B00,518792,Staff,17,0,20,3
1713338705489,MCWP 50R,C00,518793,Staff,19,0,20,1
1713338705489,MCWP 50R,D00,518794,Staff,16,0,20,4
1713338705489,MCWP 50R,E00,518795,Staff,16,0,20,4
1713338705489,MCWP 50R,F00,518796,Staff,19,0,20,1
1713338705489,MCWP 50R,G00,518797,Staff,19,0,20,1
1713338706517,MMW 12R,A01,514034,Herbst; Matthew,15,0,16,1
1713338706517,MMW 12R,A02,514035,Herbst; Matthew,16,0,16,0
1713338707549,MMW 13R,A01,514037,Staff,12,0,16,4
1713338707549,MMW 13R,A02,514039,Staff,16,0,16,0
1713338709606,SIO 295LS,A00,523233,Staff,19,0,30,11
1713338710631,SIO 295S,A00,523232,Staff,19,0,30,11
1713338711677,SOCI 117,A01,494376,Staff,1,0,5,4
1713338712710,WES 237B,A00,494380,Staff,19,0,20,1
1713338714782,AESE 279B,A00,494370,Wade; Jon P,33,0,33,0
1713338715809,ANAR 135S,A00,494369,Braswell; Geoffrey E.,0,0,0,0
1713338716844,CAT 124RS,A01,519847,Geibel; William,17,0,20,3
1713338717871,CAT 125RS,A01,515971,Geibel; William,17,0,20,3
1713338718902,CLRE 250,A00,511389,Morris; Sheldon,9996,0,9999,3
1713338719946,CLRE 251,A00,507176,Mehta; Ravindra L.,9996,0,9999,3
1713338719946,CLRE 251,B00,511410,Mehta; Ravindra L.,9998,0,9999,1
1713338720971,CLRE 252,A00,507189,Cuomo; Raphael Eduardo,9998,0,9999,1
1713338721999,CLRE 253,A00,507199,Vaida; Florin,9997,0,9999,2
1713338721999,CLRE 253,B00,507202,Vaida; Florin,9999,0,9999,0
1713338723024,CLRE 259,A00,507211,Patel; Hemal,9996,0,9999,3
1713338724051,CLRE 260,A00,507221,Cuomo; Raphael Eduardo,9999,0,9999,0
1713338725077,CLRE 297,001,507242,Cuomo; Raphael Eduardo,9999,0,9999,0
1713338726110,CSE 191,A00,516875,Minnes Kemp; Mor Mia,9999,0,9999,0
1713338727138,CSS 201S,A01,494383,Staff,35,0,35,0
1713338728165,CSS 202S,A01,494387,Staff,35,0,35,0
1713338729197,EAP 100,A00,516065,Staff,9792,0,9999,207
1713338730228,ECE 45,A01,507414,Staff,51,0,60,9
1713338731261,ECE 100,A01,507416,Baghdadchi; Saharnaz,10,0,20,10
1713338731261,ECE 100,A02,507418,Baghdadchi; Saharnaz,20,0,20,0
1713338732291,ECE 111,A01,507420,Staff,38,0,50,12
1713338733320,ECE 197,001,548057,Sievenpiper; Daniel F.,9998,0,9999,1
1713338734346,EDS 115,A00,507243,Choi; Bailey Miyeon,28,0,28,0
1713338735381,EDS 117,A01,494379,Staff,23,0,25,2
1713338736422,EDS 125,A00,507246,Hopkins; Megan Beth,29,0,30,1
1713338737447,EDS 128A,A01,507264,Fargason; Sharon Gayle,26,0,26,0
1713338738475,EDS 128B,A01,507293,Pappas; Elizabeth,30,0,30,0
1713338739500,EDS 139,A00,507294,Fargason; Sharon Gayle,30,0,30,0
1713338739500,EDS 139,B00,507313,Pappas; Elizabeth,30,0,30,0
1713338740527,EDS 201,A00,507315,Staff,26,0,30,4
1713338741562,EDS 203,A01,507317,Halter; Christopher P.,26,0,30,4
1713338742587,EDS 204R,A01,507319,Halter; Christopher P.,3,0,30,27
1713338742587,EDS 204R,B01,507331,Heinzman; Erica M.,28,0,30,2
1713338743613,EDS 206R,A00,507332,Staff,4,0,30,26
1713338743613,EDS 206R,B00,507343,Staff,28,0,30,2
1713338744640,EDS 250,A00,507344,Hemans; Patricia Ann Benitez,36,0,40,4
1713338745672,EDS 281,A00,507345,Daly; Alan J.,18,0,18,0
1713338746698,EDS 284,A00,507350,Daly; Alan J.,16,0,16,0
1713338747725,EDS 286,A00,507359,Fine; Sarah,18,0,18,0
1713338748752,EDS 289C,A01,507361,Daly; Alan J.,18,0,18,0
1713338749778,EDS 290,A00,507366,Hofstetter; Carolyn,15,0,15,0
1713338750814,LIGM 5A,A00,507421,Fischer-Grunski; Eva K,20,0,20,0
1713338751840,LIGM 5B,A00,507423,Fischer-Grunski; Eva K,20,0,20,0
1713338752872,LIGM 5C,A00,507425,Fischer-Grunski; Eva K,20,0,20,0
1713338753907,LIIT 5AS,A00,507427,Carnelos; Chiara,20,0,20,0
1713338754934,LIIT 5BS,A00,507430,Carnelos; Chiara,20,0,20,0
1713338755961,LIIT 5CS,A00,507432,Carnelos; Chiara,20,0,20,0
1713338756990,LISP 5A,A00,507541,Munoz Sanchez; Alicia,17,0,20,3
1713338758016,LISP 5B,A00,507671,Munoz Sanchez; Alicia,15,0,20,5
1713338759046,LISP 5C,A00,507696,Munoz Sanchez; Alicia,15,0,20,5
1713338760098,MAE 197,001,528363,Boechler; Nicholas Sebastia,9998,0,9999,1
1713338761122,MATH 197,001,523477,Kedlaya; Kiran S.,9999,0,9999,0
1713338761122,MATH 197,002,563811,Zhang; Danna,9999,0,9999,0
1713338762151,MCWP 40R,A00,518780,Staff,20,0,20,0
1713338762151,MCWP 40R,B00,518781,Staff,19,0,20,1
1713338762151,MCWP 40R,C00,518783,Staff,19,0,20,1
1713338763184,MCWP 50R,A00,518791,Staff,20,0,20,0
1713338763184,MCWP 50R,B00,518792,Staff,17,0,20,3
1713338763184,MCWP 50R,C00,518793,Staff,19,0,20,1
1713338763184,MCWP 50R,D00,518794,Staff,16,0,20,4
1713338763184,MCWP 50R,E00,518795,Staff,16,0,20,4
1713338763184,MCWP 50R,F00,518796,Staff,19,0,20,1
1713338763184,MCWP 50R,G00,518797,Staff,19,0,20,1
1713338764265,MMW 12R,A01,514034,Herbst; Matthew,15,0,16,1
1713338764265,MMW 12R,A02,514035,Herbst; Matthew,16,0,16,0
1713338765298,MMW 13R,A01,514037,Staff,12,0,16,4
1713338765298,MMW 13R,A02,514039,Staff,16,0,16,0
1713338767349,SIO 295LS,A00,523233,Staff,19,0,30,11
1713338768387,SIO 295S,A00,523232,Staff,19,0,30,11
1713338769421,SOCI 117,A01,494376,Staff,1,0,5,4
1713338770450,WES 237B,A00,494380,Staff,19,0,20,1
1713338772515,AESE 279B,A00,494370,Wade; Jon P,33,0,33,0
1713338773542,ANAR 135S,A00,494369,Braswell; Geoffrey E.,0,0,0,0
1713338774567,CAT 124RS,A01,519847,Geibel; William,17,0,20,3
1713338775598,CAT 125RS,A01,515971,Geibel; William,17,0,20,3
1713338776630,CLRE 250,A00,511389,Morris; Sheldon,9996,0,9999,3
1713338777657,CLRE 251,A00,507176,Mehta; Ravindra L.,9996,0,9999,3
1713338777657,CLRE 251,B00,511410,Mehta; Ravindra L.,9998,0,9999,1
1713338778690,CLRE 252,A00,507189,Cuomo; Raphael Eduardo,9998,0,9999,1
1713338779717,CLRE 253,A00,507199,Vaida; Florin,9997,0,9999,2
1713338779717,CLRE 253,B00,507202,Vaida; Florin,9999,0,9999,0
1713338780743,CLRE 259,A00,507211,Patel; Hemal,9996,0,9999,3
1713338781775,CLRE 260,A00,507221,Cuomo; Raphael Eduardo,9999,0,9999,0
1713338782798,CLRE 297,001,507242,Cuomo; Raphael Eduardo,9999,0,9999,0
1713338783828,CSE 191,A00,516875,Minnes Kemp; Mor Mia,9999,0,9999,0
1713338784852,CSS 201S,A01,494383,Staff,35,0,35,0
1713338785885,CSS 202S,A01,494387,Staff,35,0,35,0
1713338786915,EAP 100,A00,516065,Staff,9792,0,9999,207
1713338787945,ECE 45,A01,507414,Staff,51,0,60,9
1713338788977,ECE 100,A01,507416,Baghdadchi; Saharnaz,10,0,20,10
1713338788977,ECE 100,A02,507418,Baghdadchi; Saharnaz,20,0,20,0
1713338790008,ECE 111,A01,507420,Staff,38,0,50,12
1713338791035,ECE 197,001,548057,Sievenpiper; Daniel F.,9998,0,9999,1
1713338792065,EDS 115,A00,507243,Choi; Bailey Miyeon,28,0,28,0
1713338793092,EDS 117,A01,494379,Staff,23,0,25,2
1713338794123,EDS 125,A00,507246,Hopkins; Megan Beth,29,0,30,1
1713338795149,EDS 128A,A01,507264,Fargason; Sharon Gayle,26,0,26,0
1713338796176,EDS 128B,A01,507293,Pappas; Elizabeth,30,0,30,0
1713338797202,EDS 139,A00,507294,Fargason; Sharon Gayle,30,0,30,0
1713338797202,EDS 139,B00,507313,Pappas; Elizabeth,30,0,30,0
1713338798229,EDS 201,A00,507315,Staff,26,0,30,4
1713338799263,EDS 203,A01,507317,Halter; Christopher P.,26,0,30,4
1713338800290,EDS 204R,A01,507319,Halter; Christopher P.,3,0,30,27
1713338800290,EDS 204R,B01,507331,Heinzman; Erica M.,28,0,30,2
1713338801320,EDS 206R,A00,507332,Staff,4,0,30,26
1713338801320,EDS 206R,B00,507343,Staff,28,0,30,2
1713338802349,EDS 250,A00,507344,Hemans; Patricia Ann Benitez,36,0,40,4
1713338803382,EDS 281,A00,507345,Daly; Alan J.,18,0,18,0
1713338804408,EDS 284,A00,507350,Daly; Alan J.,16,0,16,0
1713338805435,EDS 286,A00,507359,Fine; Sarah,18,0,18,0
1713338806464,EDS 289C,A01,507361,Daly; Alan J.,18,0,18,0
1713338807490,EDS 290,A00,507366,Hofstetter; Carolyn,15,0,15,0
1713338808515,LIGM 5A,A00,507421,Fischer-Grunski; Eva K,20,0,20,0
1713338809546,LIGM 5B,A00,507423,Fischer-Grunski; Eva K,20,0,20,0
1713338810574,LIGM 5C,A00,507425,Fischer-Grunski; Eva K,20,0,20,0
1713338811607,LIIT 5AS,A00,507427,Carnelos; Chiara,20,0,20,0
1713338812633,LIIT 5BS,A00,507430,Carnelos; Chiara,20,0,20,0
1713338813664,LIIT 5CS,A00,507432,Carnelos; Chiara,20,0,20,0
1713338814699,LISP 5A,A00,507541,Munoz Sanchez; Alicia,17,0,20,3
1713338815725,LISP 5B,A00,507671,Munoz Sanchez; Alicia,15,0,20,5
1713338816751,LISP 5C,A00,507696,Munoz Sanchez; Alicia,15,0,20,5
1713338817779,MAE 197,001,528363,Boechler; Nicholas Sebastia,9998,0,9999,1
1713338818808,MATH 197,001,523477,Kedlaya; Kiran S.,9999,0,9999,0
1713338818808,MATH 197,002,563811,Zhang; Danna,9999,0,9999,0
1713338819834,MCWP 40R,A00,518780,Staff,20,0,20,0
1713338819834,MCWP 40R,B00,518781,Staff,19,0,20,1
1713338819834,MCWP 40R,C00,518783,Staff,19,0,20,1
1713338820877,MCWP 50R,A00,518791,Staff,20,0,20,0
1713338820877,MCWP 50R,B00,518792,Staff,17,0,20,3
1713338820877,MCWP 50R,C00,518793,Staff,19,0,20,1
1713338820877,MCWP 50R,D00,518794,Staff,16,0,20,4
1713338820877,MCWP 50R,E00,518795,Staff,16,0,20,4
1713338820877,MCWP 50R,F00,518796,Staff,19,0,20,1
1713338820877,MCWP 50R,G00,518797,Staff,19,0,20,1
1713338821910,MMW 12R,A01,514034,Herbst; Matthew,15,0,16,1
1713338821910,MMW 12R,A02,514035,Herbst; Matthew,16,0,16,0
1713338822936,MMW 13R,A01,514037,Staff,12,0,16,4
1713338822936,MMW 13R,A02,514039,Staff,16,0,16,0
1713338824996,SIO 295LS,A00,523233,Staff,19,0,30,11
1713338826026,SIO 295S,A00,523232,Staff,19,0,30,11
1713338827054,SOCI 117,A01,494376,Staff,1,0,5,4
1713338828081,WES 237B,A00,494380,Staff,19,0,20,1
1713338830157,AESE 279B,A00,494370,Wade; Jon P,33,0,33,0
1713338831189,ANAR 135S,A00,494369,Braswell; Geoffrey E.,0,0,0,0
1713338832224,CAT 124RS,A01,519847,Geibel; William,17,0,20,3
1713338833253,CAT 125RS,A01,515971,Geibel; William,17,0,20,3
1713338834283,CLRE 250,A00,511389,Morris; Sheldon,9996,0,9999,3
1713338835313,CLRE 251,A00,507176,Mehta; Ravindra L.,9996,0,9999,3
1713338835313,CLRE 251,B00,511410,Mehta; Ravindra L.,9998,0,9999,1
1713338836340,CLRE 252,A00,507189,Cuomo; Raphael Eduardo,9998,0,9999,1
1713338837367,CLRE 253,A00,507199,Vaida; Florin,9997,0,9999,2
1713338837367,CLRE 253,B00,507202,Vaida; Florin,9999,0,9999,0
1713338838394,CLRE 259,A00,507211,Patel; Hemal,9996,0,9999,3
1713338839420,CLRE 260,A00,507221,Cuomo; Raphael Eduardo,9999,0,9999,0
1713338840451,CLRE 297,001,507242,Cuomo; Raphael Eduardo,9999,0,9999,0
1713338841477,CSE 191,A00,516875,Minnes Kemp; Mor Mia,9999,0,9999,0
1713338842502,CSS 201S,A01,494383,Staff,35,0,35,0
1713338843533,CSS 202S,A01,494387,Staff,35,0,35,0
1713338844558,EAP 100,A00,516065,Staff,9792,0,9999,207
1713338845589,ECE 45,A01,507414,Staff,51,0,60,9
1713338846617,ECE 100,A01,507416,Baghdadchi; Saharnaz,10,0,20,10
1713338846617,ECE 100,A02,507418,Baghdadchi; Saharnaz,20,0,20,0
1713338847647,ECE 111,A01,507420,Staff,38,0,50,12
1713338848673,ECE 197,001,548057,Sievenpiper; Daniel F.,9998,0,9999,1
1713338849700,EDS 115,A00,507243,Choi; Bailey Miyeon,28,0,28,0
1713338850727,EDS 117,A01,494379,Staff,23,0,25,2
1713338851758,EDS 125,A00,507246,Hopkins; Megan Beth,29,0,30,1
1713338852792,EDS 128A,A01,507264,Fargason; Sharon Gayle,26,0,26,0
1713338853819,EDS 128B,A01,507293,Pappas; Elizabeth,30,0,30,0
1713338854850,EDS 139,A00,507294,Fargason; Sharon Gayle,30,0,30,0
1713338854850,EDS 139,B00,507313,Pappas; Elizabeth,30,0,30,0
1713338855875,EDS 201,A00,507315,Staff,26,0,30,4
1713338856901,EDS 203,A01,507317,Halter; Christopher P.,26,0,30,4
1713338857928,EDS 204R,A01,507319,Halter; Christopher P.,3,0,30,27
1713338857928,EDS 204R,B01,507331,Heinzman; Erica M.,28,0,30,2
1713338858954,EDS 206R,A00,507332,Staff,4,0,30,26
1713338858954,EDS 206R,B00,507343,Staff,28,0,30,2
1713338859982,EDS 250,A00,507344,Hemans; Patricia Ann Benitez,36,0,40,4
1713338861013,EDS 281,A00,507345,Daly; Alan J.,18,0,18,0
1713338862039,EDS 284,A00,507350,Daly; Alan J.,16,0,16,0
1713338863069,EDS 286,A00,507359,Fine; Sarah,18,0,18,0
1713338864094,EDS 289C,A01,507361,Daly; Alan J.,18,0,18,0
1713338865123,EDS 290,A00,507366,Hofstetter; Carolyn,15,0,15,0
1713338866154,LIGM 5A,A00,507421,Fischer-Grunski; Eva K,20,0,20,0
1713338867182,LIGM 5B,A00,507423,Fischer-Grunski; Eva K,20,0,20,0
1713338868264,LIGM 5C,A00,507425,Fischer-Grunski; Eva K,20,0,20,0
1713338869289,LIIT 5AS,A00,507427,Carnelos; Chiara,20,0,20,0
1713338870315,LIIT 5BS,A00,507430,Carnelos; Chiara,20,0,20,0
1713338871345,LIIT 5CS,A00,507432,Carnelos; Chiara,20,0,20,0
1713338872375,LISP 5A,A00,507541,Munoz Sanchez; Alicia,17,0,20,3
1713338873407,LISP 5B,A00,507671,Munoz Sanchez; Alicia,15,0,20,5
1713338874437,LISP 5C,A00,507696,Munoz Sanchez; Alicia,15,0,20,5
1713338875463,MAE 197,001,528363,Boechler; Nicholas Sebastia,9998,0,9999,1
1713338876496,MATH 197,001,523477,Kedlaya; Kiran S.,9999,0,9999,0
1713338876496,MATH 197,002,563811,Zhang; Danna,9999,0,9999,0
1713338877520,MCWP 40R,A00,518780,Staff,20,0,20,0
1713338877520,MCWP 40R,B00,518781,Staff,19,0,20,1
1713338877520,MCWP 40R,C00,518783,Staff,19,0,20,1
1713338878548,MCWP 50R,A00,518791,Staff,20,0,20,0
1713338878548,MCWP 50R,B00,518792,Staff,17,0,20,3
1713338878548,MCWP 50R,C00,518793,Staff,19,0,20,1
1713338878548,MCWP 50R,D00,518794,Staff,16,0,20,4
1713338878548,MCWP 50R,E00,518795,Staff,16,0,20,4
1713338878548,MCWP 50R,F00,518796,Staff,19,0,20,1
1713338878548,MCWP 50R,G00,518797,Staff,19,0,20,1
1713338879573,MMW 12R,A01,514034,Herbst; Matthew,15,0,16,1
1713338879573,MMW 12R,A02,514035,Herbst; Matthew,16,0,16,0
1713338880601,MMW 13R,A01,514037,Staff,12,0,16,4
1713338880601,MMW 13R,A02,514039,Staff,16,0,16,0
1713338882658,SIO 295LS,A00,523233,Staff,19,0,30,11
1713338883685,SIO 295S,A00,523232,Staff,19,0,30,11
1713338884714,SOCI 117,A01,494376,Staff,1,0,5,4
1713338885744,WES 237B,A00,494380,Staff,19,0,20,1
1713338887810,AESE 279B,A00,494370,Wade; Jon P,33,0,33,0
1713338888836,ANAR 135S,A00,494369,Braswell; Geoffrey E.,0,0,0,0
1713338889863,CAT 124RS,A01,519847,Geibel; William,17,0,20,3
1713338890889,CAT 125RS,A01,515971,Geibel; William,17,0,20,3
1713338891920,CLRE 250,A00,511389,Morris; Sheldon,9996,0,9999,3
1713338892954,CLRE 251,A00,507176,Mehta; Ravindra L.,9996,0,9999,3
1713338892954,CLRE 251,B00,511410,Mehta; Ravindra L.,9998,0,9999,1
1713338893981,CLRE 252,A00,507189,Cuomo; Raphael Eduardo,9998,0,9999,1
1713338895010,CLRE 253,A00,507199,Vaida; Florin,9997,0,9999,2
1713338895010,CLRE 253,B00,507202,Vaida; Florin,9999,0,9999,0
1713338896037,CLRE 259,A00,507211,Patel; Hemal,9996,0,9999,3
1713338897062,CLRE 260,A00,507221,Cuomo; Raphael Eduardo,9999,0,9999,0
1713338898088,CLRE 297,001,507242,Cuomo; Raphael Eduardo,9999,0,9999,0
1713338899120,CSE 191,A00,516875,Minnes Kemp; Mor Mia,9999,0,9999,0
1713338900155,CSS 201S,A01,494383,Staff,35,0,35,0
1713338901186,CSS 202S,A01,494387,Staff,35,0,35,0
1713338902216,EAP 100,A00,516065,Staff,9792,0,9999,207
1713338903250,ECE 45,A01,507414,Staff,51,0,60,9
1713338904283,ECE 100,A01,507416,Baghdadchi; Saharnaz,10,0,20,10
1713338904283,ECE 100,A02,507418,Baghdadchi; Saharnaz,20,0,20,0
1713338905314,ECE 111,A01,507420,Staff,38,0,50,12
1713338906347,ECE 197,001,548057,Sievenpiper; Daniel F.,9998,0,9999,1
1713338907378,EDS 115,A00,507243,Choi; Bailey Miyeon,28,0,28,0
1713338908407,EDS 117,A01,494379,Staff,23,0,25,2
1713338909443,EDS 125,A00,507246,Hopkins; Megan Beth,29,0,30,1
1713338910474,EDS 128A,A01,507264,Fargason; Sharon Gayle,26,0,26,0
1713338911504,EDS 128B,A01,507293,Pappas; Elizabeth,30,0,30,0
1713338912533,EDS 139,A00,507294,Fargason; Sharon Gayle,30,0,30,0
1713338912533,EDS 139,B00,507313,Pappas; Elizabeth,30,0,30,0
1713338913561,EDS 201,A00,507315,Staff,26,0,30,4
1713338914588,EDS 203,A01,507317,Halter; Christopher P.,26,0,30,4
1713338915626,EDS 204R,A01,507319,Halter; Christopher P.,3,0,30,27
1713338915626,EDS 204R,B01,507331,Heinzman; Erica M.,28,0,30,2
1713338916654,EDS 206R,A00,507332,Staff,4,0,30,26
1713338916654,EDS 206R,B00,507343,Staff,28,0,30,2
1713338917682,EDS 250,A00,507344,Hemans; Patricia Ann Benitez,36,0,40,4
1713338918716,EDS 281,A00,507345,Daly; Alan J.,18,0,18,0
1713338919745,EDS 284,A00,507350,Daly; Alan J.,16,0,16,0
1713338920771,EDS 286,A00,507359,Fine; Sarah,18,0,18,0
1713338921799,EDS 289C,A01,507361,Daly; Alan J.,18,0,18,0
1713338922828,EDS 290,A00,507366,Hofstetter; Carolyn,15,0,15,0
1713338923859,LIGM 5A,A00,507421,Fischer-Grunski; Eva K,20,0,20,0
1713338924890,LIGM 5B,A00,507423,Fischer-Grunski; Eva K,20,0,20,0
1713338925922,LIGM 5C,A00,507425,Fischer-Grunski; Eva K,20,0,20,0
1713338926953,LIIT 5AS,A00,507427,Carnelos; Chiara,20,0,20,0
1713338927983,LIIT 5BS,A00,507430,Carnelos; Chiara,20,0,20,0
1713338929014,LIIT 5CS,A00,507432,Carnelos; Chiara,20,0,20,0
1713338930042,LISP 5A,A00,507541,Munoz Sanchez; Alicia,17,0,20,3
1713338931070,LISP 5B,A00,507671,Munoz Sanchez; Alicia,15,0,20,5
1713338932097,LISP 5C,A00,507696,Munoz Sanchez; Alicia,15,0,20,5
1713338933127,MAE 197,001,528363,Boechler; Nicholas Sebastia,9998,0,9999,1
1713338934154,MATH 197,001,523477,Kedlaya; Kiran S.,9999,0,9999,0
1713338934154,MATH 197,002,563811,Zhang; Danna,9999,0,9999,0
1713338935180,MCWP 40R,A00,518780,Staff,20,0,20,0
1713338935180,MCWP 40R,B00,518781,Staff,19,0,20,1
1713338935180,MCWP 40R,C00,518783,Staff,19,0,20,1
1713338936212,MCWP 50R,A00,518791,Staff,20,0,20,0
1713338936212,MCWP 50R,B00,518792,Staff,17,0,20,3
1713338936212,MCWP 50R,C00,518793,Staff,19,0,20,1
1713338936212,MCWP 50R,D00,518794,Staff,16,0,20,4
1713338936212,MCWP 50R,E00,518795,Staff,16,0,20,4
1713338936212,MCWP 50R,F00,518796,Staff,19,0,20,1
1713338936212,MCWP 50R,G00,518797,Staff,19,0,20,1
1713338937243,MMW 12R,A01,514034,Herbst; Matthew,15,0,16,1
1713338937243,MMW 12R,A02,514035,Herbst; Matthew,16,0,16,0
1713338938269,MMW 13R,A01,514037,Staff,12,0,16,4
1713338938269,MMW 13R,A02,514039,Staff,16,0,16,0
1713338940325,SIO 295LS,A00,523233,Staff,19,0,30,11
1713338941354,SIO 295S,A00,523232,Staff,19,0,30,11
1713338942386,SOCI 117,A01,494376,Staff,1,0,5,4
1713338943411,WES 237B,A00,494380,Staff,19,0,20,1
1713338945497,AESE 279B,A00,494370,Wade; Jon P,33,0,33,0
1713338946523,ANAR 135S,A00,494369,Braswell; Geoffrey E.,0,0,0,0
1713338947550,CAT 124RS,A01,519847,Geibel; William,17,0,20,3
1713338948576,CAT 125RS,A01,515971,Geibel; William,17,0,20,3
1713338949603,CLRE 250,A00,511389,Morris; Sheldon,9996,0,9999,3
1713338950628,CLRE 251,A00,507176,Mehta; Ravindra L.,9996,0,9999,3
1713338950628,CLRE 251,B00,511410,Mehta; Ravindra L.,9998,0,9999,1
1713338951654,CLRE 252,A00,507189,Cuomo; Raphael Eduardo,9998,0,9999,1
1713338952684,CLRE 253,A00,507199,Vaida; Florin,9997,0,9999,2
1713338952684,CLRE 253,B00,507202,Vaida; Florin,9999,0,9999,0
1713338953711,CLRE 259,A00,507211,Patel; Hemal,9996,0,9999,3
1713338954741,CLRE 260,A00,507221,Cuomo; Raphael Eduardo,9999,0,9999,0
1713338955766,CLRE 297,001,507242,Cuomo; Raphael Eduardo,9999,0,9999,0
1713338956794,CSE 191,A00,516875,Minnes Kemp; Mor Mia,9999,0,9999,0
1713338957820,CSS 201S,A01,494383,Staff,35,0,35,0
1713338958850,CSS 202S,A01,494387,Staff,35,0,35,0
1713338959879,EAP 100,A00,516065,Staff,9792,0,9999,207
1713338960907,ECE 45,A01,507414,Staff,51,0,60,9
1713338961932,ECE 100,A01,507416,Baghdadchi; Saharnaz,10,0,20,10
1713338961932,ECE 100,A02,507418,Baghdadchi; Saharnaz,20,0,20,0
1713338962960,ECE 111,A01,507420,Staff,38,0,50,12
1713338963997,ECE 197,001,548057,Sievenpiper; Daniel F.,9998,0,9999,1
1713338965025,EDS 115,A00,507243,Choi; Bailey Miyeon,28,0,28,0
1713338966056,EDS 117,A01,494379,Staff,23,0,25,2
1713338967083,EDS 125,A00,507246,Hopkins; Megan Beth,29,0,30,1
1713338968120,EDS 128A,A01,507264,Fargason; Sharon Gayle,26,0,26,0
1713338969147,EDS 128B,A01,507293,Pappas; Elizabeth,30,0,30,0
1713338970172,EDS 139,A00,507294,Fargason; Sharon Gayle,30,0,30,0
1713338970172,EDS 139,B00,507313,Pappas; Elizabeth,30,0,30,0
1713338971203,EDS 201,A00,507315,Staff,26,0,30,4
1713338972282,EDS 203,A01,507317,Halter; Christopher P.,26,0,30,4
1713338973312,EDS 204R,A01,507319,Halter; Christopher P.,3,0,30,27
1713338973312,EDS 204R,B01,507331,Heinzman; Erica M.,28,0,30,2
1713338974338,EDS 206R,A00,507332,Staff,4,0,30,26
1713338974338,EDS 206R,B00,507343,Staff,28,0,30,2
1713338975365,EDS 250,A00,507344,Hemans; Patricia Ann Benitez,36,0,40,4
1713338976391,EDS 281,A00,507345,Daly; Alan J.,18,0,18,0
1713338977419,EDS 284,A00,507350,Daly; Alan J.,16,0,16,0
1713338978446,EDS 286,A00,507359,Fine; Sarah,18,0,18,0
1713338979472,EDS 289C,A01,507361,Daly; Alan J.,18,0,18,0
1713338980497,EDS 290,A00,507366,Hofstetter; Carolyn,15,0,15,0
1713338981530,LIGM 5A,A00,507421,Fischer-Grunski; Eva K,20,0,20,0
1713338982562,LIGM 5B,A00,507423,Fischer-Grunski; Eva K,20,0,20,0
1713338983594,LIGM 5C,A00,507425,Fischer-Grunski; Eva K,20,0,20,0
1713338984626,LIIT 5AS,A00,507427,Carnelos; Chiara,20,0,20,0
1713338985655,LIIT 5BS,A00,507430,Carnelos; Chiara,20,0,20,0
1713338986684,LIIT 5CS,A00,507432,Carnelos; Chiara,20,0,20,0
1713338987715,LISP 5A,A00,507541,Munoz Sanchez; Alicia,17,0,20,3
1713338988740,LISP 5B,A00,507671,Munoz Sanchez; Alicia,15,0,20,5
1713338989770,LISP 5C,A00,507696,Munoz Sanchez; Alicia,15,0,20,5
1713338990802,MAE 197,001,528363,Boechler; Nicholas Sebastia,9998,0,9999,1
1713338991835,MATH 197,001,523477,Kedlaya; Kiran S.,9999,0,9999,0
1713338991835,MATH 197,002,563811,Zhang; Danna,9999,0,9999,0
1713338992861,MCWP 40R,A00,518780,Staff,20,0,20,0
1713338992861,MCWP 40R,B00,518781,Staff,19,0,20,1
1713338992861,MCWP 40R,C00,518783,Staff,19,0,20,1
1713338993901,MCWP 50R,A00,518791,Staff,20,0,20,0
1713338993901,MCWP 50R,B00,518792,Staff,17,0,20,3
1713338993901,MCWP 50R,C00,518793,Staff,19,0,20,1
1713338993901,MCWP 50R,D00,518794,Staff,16,0,20,4
1713338993901,MCWP 50R,E00,518795,Staff,16,0,20,4
1713338993901,MCWP 50R,F00,518796,Staff,19,0,20,1
1713338993901,MCWP 50R,G00,518797,Staff,19,0,20,1
1713338994932,MMW 12R,A01,514034,Herbst; Matthew,15,0,16,1
1713338994932,MMW 12R,A02,514035,Herbst; Matthew,16,0,16,0
1713338995961,MMW 13R,A01,514037,Staff,12,0,16,4
1713338995961,MMW 13R,A02,514039,Staff,16,0,16,0
1713338998018,SIO 295LS,A00,523233,Staff,19,0,30,11
1713338999043,SIO 295S,A00,523232,Staff,19,0,30,11
1713339000070,SOCI 117,A01,494376,Staff,1,0,5,4
1713339001095,WES 237B,A00,494380,Staff,19,0,20,1
1713339003173,AESE 279B,A00,494370,Wade; Jon P,33,0,33,0
1713339004202,ANAR 135S,A00,494369,Braswell; Geoffrey E.,0,0,0,0
1713339005232,CAT 124RS,A01,519847,Geibel; William,17,0,20,3
1713339006265,CAT 125RS,A01,515971,Geibel; William,17,0,20,3
1713339007292,CLRE 250,A00,511389,Morris; Sheldon,9996,0,9999,3
1713339008319,CLRE 251,A00,507176,Mehta; Ravindra L.,9996,0,9999,3
1713339008319,CLRE 251,B00,511410,Mehta; Ravindra L.,9998,0,9999,1
1713339009350,CLRE 252,A00,507189,Cuomo; Raphael Eduardo,9998,0,9999,1
1713339010381,CLRE 253,A00,507199,Vaida; Florin,9997,0,9999,2
1713339010381,CLRE 253,B00,507202,Vaida; Florin,9999,0,9999,0
1713339011412,CLRE 259,A00,507211,Patel; Hemal,9996,0,9999,3
1713339012437,CLRE 260,A00,507221,Cuomo; Raphael Eduardo,9999,0,9999,0
1713339013465,CLRE 297,001,507242,Cuomo; Raphael Eduardo,9999,0,9999,0
1713339014490,CSE 191,A00,516875,Minnes Kemp; Mor Mia,9999,0,9999,0
1713339015515,CSS 201S,A01,494383,Staff,35,0,35,0
1713339016542,CSS 202S,A01,494387,Staff,35,0,35,0
1713339017568,EAP 100,A00,516065,Staff,9792,0,9999,207
1713339018599,ECE 45,A01,507414,Staff,51,0,60,9
1713339019625,ECE 100,A01,507416,Baghdadchi; Saharnaz,10,0,20,10
1713339019625,ECE 100,A02,507418,Baghdadchi; Saharnaz,20,0,20,0
1713339020655,ECE 111,A01,507420,Staff,38,0,50,12
1713339021682,ECE 197,001,548057,Sievenpiper; Daniel F.,9998,0,9999,1
1713339022707,EDS 115,A00,507243,Choi; Bailey Miyeon,28,0,28,0
1713339023736,EDS 117,A01,494379,Staff,23,0,25,2
1713339024767,EDS 125,A00,507246,Hopkins; Megan Beth,29,0,30,1
1713339025796,EDS 128A,A01,507264,Fargason; Sharon Gayle,26,0,26,0
1713339026821,EDS 128B,A01,507293,Pappas; Elizabeth,30,0,30,0
1713339027850,EDS 139,A00,507294,Fargason; Sharon Gayle,30,0,30,0
1713339027850,EDS 139,B00,507313,Pappas; Elizabeth,30,0,30,0
1713339028881,EDS 201,A00,507315,Staff,26,0,30,4
1713339029911,EDS 203,A01,507317,Halter; Christopher P.,26,0,30,4
1713339030942,EDS 204R,A01,507319,Halter; Christopher P.,3,0,30,27
1713339030942,EDS 204R,B01,507331,Heinzman; Erica M.,28,0,30,2
1713339031968,EDS 206R,A00,507332,Staff,4,0,30,26
1713339031968,EDS 206R,B00,507343,Staff,28,0,30,2
1713339032995,EDS 250,A00,507344,Hemans; Patricia Ann Benitez,36,0,40,4
1713339034020,EDS 281,A00,507345,Daly; Alan J.,18,0,18,0
1713339035045,EDS 284,A00,507350,Daly; Alan J.,16,0,16,0
1713339036069,EDS 286,A00,507359,Fine; Sarah,18,0,18,0
1713339037096,EDS 289C,A01,507361,Daly; Alan J.,18,0,18,0
1713339038121,EDS 290,A00,507366,Hofstetter; Carolyn,15,0,15,0
1713339039149,LIGM 5A,A00,507421,Fischer-Grunski; Eva K,20,0,20,0
1713339040179,LIGM 5B,A00,507423,Fischer-Grunski; Eva K,20,0,20,0
1713339041208,LIGM 5C,A00,507425,Fischer-Grunski; Eva K,20,0,20,0
1713339042237,LIIT 5AS,A00,507427,Carnelos; Chiara,20,0,20,0
1713339043263,LIIT 5BS,A00,507430,Carnelos; Chiara,20,0,20,0
1713339044292,LIIT 5CS,A00,507432,Carnelos; Chiara,20,0,20,0
1713339045323,LISP 5A,A00,507541,Munoz Sanchez; Alicia,17,0,20,3
1713339046348,LISP 5B,A00,507671,Munoz Sanchez; Alicia,15,0,20,5
1713339047382,LISP 5C,A00,507696,Munoz Sanchez; Alicia,15,0,20,5
1713339048407,MAE 197,001,528363,Boechler; Nicholas Sebastia,9998,0,9999,1
1713339049434,MATH 197,001,523477,Kedlaya; Kiran S.,9999,0,9999,0
1713339049434,MATH 197,002,563811,Zhang; Danna,9999,0,9999,0
1713339050461,MCWP 40R,A00,518780,Staff,20,0,20,0
1713339050461,MCWP 40R,B00,518781,Staff,19,0,20,1
1713339050461,MCWP 40R,C00,518783,Staff,19,0,20,1
1713339051487,MCWP 50R,A00,518791,Staff,20,0,20,0
1713339051487,MCWP 50R,B00,518792,Staff,17,0,20,3
1713339051487,MCWP 50R,C00,518793,Staff,19,0,20,1
1713339051487,MCWP 50R,D00,518794,Staff,16,0,20,4
1713339051487,MCWP 50R,E00,518795,Staff,16,0,20,4
1713339051487,MCWP 50R,F00,518796,Staff,19,0,20,1
1713339051487,MCWP 50R,G00,518797,Staff,19,0,20,1
1713339052514,MMW 12R,A01,514034,Herbst; Matthew,15,0,16,1
1713339052514,MMW 12R,A02,514035,Herbst; Matthew,16,0,16,0
1713339053540,MMW 13R,A01,514037,Staff,12,0,16,4
1713339053540,MMW 13R,A02,514039,Staff,16,0,16,0
1713339055597,SIO 295LS,A00,523233,Staff,19,0,30,11
1713339056628,SIO 295S,A00,523232,Staff,19,0,30,11
1713339057654,SOCI 117,A01,494376,Staff,1,0,5,4
1713339058688,WES 237B,A00,494380,Staff,19,0,20,1
1713339060761,AESE 279B,A00,494370,Wade; Jon P,33,0,33,0
1713339061789,ANAR 135S,A00,494369,Braswell; Geoffrey E.,0,0,0,0
1713339062821,CAT 124RS,A01,519847,Geibel; William,17,0,20,3
1713339063847,CAT 125RS,A01,515971,Geibel; William,17,0,20,3
1713339064877,CLRE 250,A00,511389,Morris; Sheldon,9996,0,9999,3
1713339065904,CLRE 251,A00,507176,Mehta; Ravindra L.,9996,0,9999,3
1713339065904,CLRE 251,B00,511410,Mehta; Ravindra L.,9998,0,9999,1
1713339066937,CLRE 252,A00,507189,Cuomo; Raphael Eduardo,9998,0,9999,1
1713339067964,CLRE 253,A00,507199,Vaida; Florin,9997,0,9999,2
1713339067964,CLRE 253,B00,507202,Vaida; Florin,9999,0,9999,0
1713339068991,CLRE 259,A00,507211,Patel; Hemal,9996,0,9999,3
1713339070018,CLRE 260,A00,507221,Cuomo; Raphael Eduardo,9999,0,9999,0
1713339071049,CLRE 297,001,507242,Cuomo; Raphael Eduardo,9999,0,9999,0
1713339072074,CSE 191,A00,516875,Minnes Kemp; Mor Mia,9999,0,9999,0
1713339073103,CSS 201S,A01,494383,Staff,35,0,35,0
1713339074129,CSS 202S,A01,494387,Staff,35,0,35,0
1713339075155,EAP 100,A00,516065,Staff,9792,0,9999,207
1713339076246,ECE 45,A01,507414,Staff,51,0,60,9
1713339077285,ECE 100,A01,507416,Baghdadchi; Saharnaz,10,0,20,10
1713339077285,ECE 100,A02,507418,Baghdadchi; Saharnaz,20,0,20,0
1713339078310,ECE 111,A01,507420,Staff,38,0,50,12
1713339079339,ECE 197,001,548057,Sievenpiper; Daniel F.,9998,0,9999,1
1713339080371,EDS 115,A00,507243,Choi; Bailey Miyeon,28,0,28,0
1713339081399,EDS 117,A01,494379,Staff,23,0,25,2
1713339082435,EDS 125,A00,507246,Hopkins; Megan Beth,29,0,30,1
1713339083466,EDS 128A,A01,507264,Fargason; Sharon Gayle,26,0,26,0
1713339084495,EDS 128B,A01,507293,Pappas; Elizabeth,30,0,30,0
1713339085521,EDS 139,A00,507294,Fargason; Sharon Gayle,30,0,30,0
1713339085521,EDS 139,B00,507313,Pappas; Elizabeth,30,0,30,0
1713339086547,EDS 201,A00,507315,Staff,26,0,30,4
1713339087574,EDS 203,A01,507317,Halter; Christopher P.,26,0,30,4
1713339088680,EDS 204R,A01,507319,Halter; Christopher P.,3,0,30,27
1713339088680,EDS 204R,B01,507331,Heinzman; Erica M.,28,0,30,2
1713339089704,EDS 206R,A00,507332,Staff,4,0,30,26
1713339089704,EDS 206R,B00,507343,Staff,28,0,30,2
1713339090735,EDS 250,A00,507344,Hemans; Patricia Ann Benitez,36,0,40,4
1713339091768,EDS 281,A00,507345,Daly; Alan J.,18,0,18,0
1713339092799,EDS 284,A00,507350,Daly; Alan J.,16,0,16,0
1713339093825,EDS 286,A00,507359,Fine; Sarah,18,0,18,0
1713339094853,EDS 289C,A01,507361,Daly; Alan J.,18,0,18,0
1713339095879,EDS 290,A00,507366,Hofstetter; Carolyn,15,0,15,0
1713339096905,LIGM 5A,A00,507421,Fischer-Grunski; Eva K,20,0,20,0
1713339097932,LIGM 5B,A00,507423,Fischer-Grunski; Eva K,20,0,20,0
1713339098965,LIGM 5C,A00,507425,Fischer-Grunski; Eva K,20,0,20,0
1713339099993,LIIT 5AS,A00,507427,Carnelos; Chiara,20,0,20,0
1713339101031,LIIT 5BS,A00,507430,Carnelos; Chiara,20,0,20,0
1713339102067,LIIT 5CS,A00,507432,Carnelos; Chiara,20,0,20,0
1713339103094,LISP 5A,A00,507541,Munoz Sanchez; Alicia,17,0,20,3
1713339104125,LISP 5B,A00,507671,Munoz Sanchez; Alicia,15,0,20,5
1713339105157,LISP 5C,A00,507696,Munoz Sanchez; Alicia,15,0,20,5
1713339106191,MAE 197,001,528363,Boechler; Nicholas Sebastia,9998,0,9999,1
1713339107222,MATH 197,001,523477,Kedlaya; Kiran S.,9999,0,9999,0
1713339107222,MATH 197,002,563811,Zhang; Danna,9999,0,9999,0
1713339108250,MCWP 40R,A00,518780,Staff,20,0,20,0
1713339108250,MCWP 40R,B00,518781,Staff,19,0,20,1
1713339108250,MCWP 40R,C00,518783,Staff,19,0,20,1
1713339109278,MCWP 50R,A00,518791,Staff,20,0,20,0
1713339109278,MCWP 50R,B00,518792,Staff,17,0,20,3
1713339109278,MCWP 50R,C00,518793,Staff,19,0,20,1
1713339109278,MCWP 50R,D00,518794,Staff,16,0,20,4
1713339109278,MCWP 50R,E00,518795,Staff,16,0,20,4
1713339109278,MCWP 50R,F00,518796,Staff,19,0,20,1
1713339109278,MCWP 50R,G00,518797,Staff,19,0,20,1
1713339110310,MMW 12R,A01,514034,Herbst; Matthew,15,0,16,1
1713339110310,MMW 12R,A02,514035,Herbst; Matthew,16,0,16,0
1713339111335,MMW 13R,A01,514037,Staff,12,0,16,4
1713339111335,MMW 13R,A02,514039,Staff,16,0,16,0
1713339113397,SIO 295LS,A00,523233,Staff,19,0,30,11
1713339114426,SIO 295S,A00,523232,Staff,19,0,30,11
1713339115453,SOCI 117,A01,494376,Staff,1,0,5,4
1713339116479,WES 237B,A00,494380,Staff,19,0,20,1
1713339118564,AESE 279B,A00,494370,Wade; Jon P,33,0,33,0
1713339119592,ANAR 135S,A00,494369,Braswell; Geoffrey E.,0,0,0,0
1713339120619,CAT 124RS,A01,519847,Geibel; William,17,0,20,3
1713339121646,CAT 125RS,A01,515971,Geibel; William,17,0,20,3
1713339122674,CLRE 250,A00,511389,Morris; Sheldon,9996,0,9999,3
1713339123701,CLRE 251,A00,507176,Mehta; Ravindra L.,9996,0,9999,3
1713339123701,CLRE 251,B00,511410,Mehta; Ravindra L.,9998,0,9999,1
1713339124732,CLRE 252,A00,507189,Cuomo; Raphael Eduardo,9998,0,9999,1
1713339125760,CLRE 253,A00,507199,Vaida; Florin,9997,0,9999,2
1713339125760,CLRE 253,B00,507202,Vaida; Florin,9999,0,9999,0
1713339126788,CLRE 259,A00,507211,Patel; Hemal,9996,0,9999,3
1713339127817,CLRE 260,A00,507221,Cuomo; Raphael Eduardo,9999,0,9999,0
1713339128843,CLRE 297,001,507242,Cuomo; Raphael Eduardo,9999,0,9999,0
1713339129868,CSE 191,A00,516875,Minnes Kemp; Mor Mia,9999,0,9999,0
1713339130902,CSS 201S,A01,494383,Staff,35,0,35,0
1713339131929,CSS 202S,A01,494387,Staff,35,0,35,0
1713339132959,EAP 100,A00,516065,Staff,9792,0,9999,207
1713339133992,ECE 45,A01,507414,Staff,51,0,60,9
1713339135018,ECE 100,A01,507416,Baghdadchi; Saharnaz,10,0,20,10
1713339135018,ECE 100,A02,507418,Baghdadchi; Saharnaz,20,0,20,0
1713339136046,ECE 111,A01,507420,Staff,38,0,50,12
1713339137073,ECE 197,001,548057,Sievenpiper; Daniel F.,9998,0,9999,1
1713339138103,EDS 115,A00,507243,Choi; Bailey Miyeon,28,0,28,0
1713339139130,EDS 117,A01,494379,Staff,23,0,25,2
1713339140167,EDS 125,A00,507246,Hopkins; Megan Beth,29,0,30,1
1713339141194,EDS 128A,A01,507264,Fargason; Sharon Gayle,26,0,26,0
1713339142221,EDS 128B,A01,507293,Pappas; Elizabeth,30,0,30,0
1713339143247,EDS 139,A00,507294,Fargason; Sharon Gayle,30,0,30,0
1713339143247,EDS 139,B00,507313,Pappas; Elizabeth,30,0,30,0
1713339144274,EDS 201,A00,507315,Staff,26,0,30,4
1713339145304,EDS 203,A01,507317,Halter; Christopher P.,26,0,30,4
1713339146331,EDS 204R,A01,507319,Halter; Christopher P.,3,0,30,27
1713339146331,EDS 204R,B01,507331,Heinzman; Erica M.,28,0,30,2
1713339147363,EDS 206R,A00,507332,Staff,4,0,30,26
1713339147363,EDS 206R,B00,507343,Staff,28,0,30,2
1713339148390,EDS 250,A00,507344,Hemans; Patricia Ann Benitez,36,0,40,4
1713339149421,EDS 281,A00,507345,Daly; Alan J.,18,0,18,0
1713339150450,EDS 284,A00,507350,Daly; Alan J.,16,0,16,0
1713339151481,EDS 286,A00,507359,Fine; Sarah,18,0,18,0
1713339152509,EDS 289C,A01,507361,Daly; Alan J.,18,0,18,0
1713339153541,EDS 290,A00,507366,Hofstetter; Carolyn,15,0,15,0
1713339154578,LIGM 5A,A00,507421,Fischer-Grunski; Eva K,20,0,20,0
1713339155607,LIGM 5B,A00,507423,Fischer-Grunski; Eva K,20,0,20,0
1713339156640,LIGM 5C,A00,507425,Fischer-Grunski; Eva K,20,0,20,0
1713339157673,LIIT 5AS,A00,507427,Carnelos; Chiara,20,0,20,0
1713339158698,LIIT 5BS,A00,507430,Carnelos; Chiara,20,0,20,0
1713339159724,LIIT 5CS,A00,507432,Carnelos; Chiara,20,0,20,0
1713339160762,LISP 5A,A00,507541,Munoz Sanchez; Alicia,17,0,20,3
1713339161796,LISP 5B,A00,507671,Munoz Sanchez; Alicia,15,0,20,5
1713339162821,LISP 5C,A00,507696,Munoz Sanchez; Alicia,15,0,20,5
1713339163859,MAE 197,001,528363,Boechler; Nicholas Sebastia,9998,0,9999,1
1713339164894,MATH 197,001,523477,Kedlaya; Kiran S.,9999,0,9999,0
1713339164894,MATH 197,002,563811,Zhang; Danna,9999,0,9999,0
1713339165926,MCWP 40R,A00,518780,Staff,20,0,20,0
1713339165926,MCWP 40R,B00,518781,Staff,19,0,20,1
1713339165926,MCWP 40R,C00,518783,Staff,19,0,20,1
1713339166960,MCWP 50R,A00,518791,Staff,20,0,20,0
1713339166960,MCWP 50R,B00,518792,Staff,17,0,20,3
1713339166960,MCWP 50R,C00,518793,Staff,19,0,20,1
1713339166960,MCWP 50R,D00,518794,Staff,16,0,20,4
1713339166960,MCWP 50R,E00,518795,Staff,16,0,20,4
1713339166960,MCWP 50R,F00,518796,Staff,19,0,20,1
1713339166960,MCWP 50R,G00,518797,Staff,19,0,20,1
1713339167985,MMW 12R,A01,514034,Herbst; Matthew,15,0,16,1
1713339167985,MMW 12R,A02,514035,Herbst; Matthew,16,0,16,0
1713339169011,MMW 13R,A01,514037,Staff,12,0,16,4
1713339169011,MMW 13R,A02,514039,Staff,16,0,16,0
1713339171076,SIO 295LS,A00,523233,Staff,19,0,30,11
1713339172103,SIO 295S,A00,523232,Staff,19,0,30,11
1713339173131,SOCI 117,A01,494376,Staff,1,0,5,4
1713339174156,WES 237B,A00,494380,Staff,19,0,20,1
1713339176226,AESE 279B,A00,494370,Wade; Jon P,33,0,33,0
1713339177255,ANAR 135S,A00,494369,Braswell; Geoffrey E.,0,0,0,0
1713339178285,CAT 124RS,A01,519847,Geibel; William,17,0,20,3
1713339179311,CAT 125RS,A01,515971,Geibel; William,17,0,20,3
1713339180405,CLRE 250,A00,511389,Morris; Sheldon,9996,0,9999,3
1713339181441,CLRE 251,A00,507176,Mehta; Ravindra L.,9996,0,9999,3
1713339181441,CLRE 251,B00,511410,Mehta; Ravindra L.,9998,0,9999,1
1713339182472,CLRE 252,A00,507189,Cuomo; Raphael Eduardo,9998,0,9999,1
1713339183505,CLRE 253,A00,507199,Vaida; Florin,9997,0,9999,2
1713339183505,CLRE 253,B00,507202,Vaida; Florin,9999,0,9999,0
1713339184541,CLRE 259,A00,507211,Patel; Hemal,9996,0,9999,3
1713339185566,CLRE 260,A00,507221,Cuomo; Raphael Eduardo,9999,0,9999,0
1713339186591,CLRE 297,001,507242,Cuomo; Raphael Eduardo,9999,0,9999,0
1713339187626,CSE 191,A00,516875,Minnes Kemp; Mor Mia,9999,0,9999,0
1713339188654,CSS 201S,A01,494383,Staff,35,0,35,0
1713339189689,CSS 202S,A01,494387,Staff,35,0,35,0
1713339190716,EAP 100,A00,516065,Staff,9792,0,9999,207
1713339191750,ECE 45,A01,507414,Staff,51,0,60,9
1713339192778,ECE 100,A01,507416,Baghdadchi; Saharnaz,10,0,20,10
1713339192778,ECE 100,A02,507418,Baghdadchi; Saharnaz,20,0,20,0
1713339193804,ECE 111,A01,507420,Staff,38,0,50,12
1713339194830,ECE 197,001,548057,Sievenpiper; Daniel F.,9998,0,9999,1
1713339195857,EDS 115,A00,507243,Choi; Bailey Miyeon,28,0,28,0
1713339196885,EDS 117,A01,494379,Staff,23,0,25,2
1713339197912,EDS 125,A00,507246,Hopkins; Megan Beth,29,0,30,1
1713339198941,EDS 128A,A01,507264,Fargason; Sharon Gayle,26,0,26,0
1713339199968,EDS 128B,A01,507293,Pappas; Elizabeth,30,0,30,0
1713339201000,EDS 139,A00,507294,Fargason; Sharon Gayle,30,0,30,0
1713339201000,EDS 139,B00,507313,Pappas; Elizabeth,30,0,30,0
1713339202030,EDS 201,A00,507315,Staff,26,0,30,4
1713339203055,EDS 203,A01,507317,Halter; Christopher P.,26,0,30,4
1713339204084,EDS 204R,A01,507319,Halter; Christopher P.,3,0,30,27
1713339204084,EDS 204R,B01,507331,Heinzman; Erica M.,28,0,30,2
1713339205116,EDS 206R,A00,507332,Staff,4,0,30,26
1713339205116,EDS 206R,B00,507343,Staff,28,0,30,2
1713339206141,EDS 250,A00,507344,Hemans; Patricia Ann Benitez,36,0,40,4
1713339207171,EDS 281,A00,507345,Daly; Alan J.,18,0,18,0
1713339208198,EDS 284,A00,507350,Daly; Alan J.,16,0,16,0
1713339209223,EDS 286,A00,507359,Fine; Sarah,18,0,18,0
1713339210256,EDS 289C,A01,507361,Daly; Alan J.,18,0,18,0
1713339211289,EDS 290,A00,507366,Hofstetter; Carolyn,15,0,15,0
1713339212318,LIGM 5A,A00,507421,Fischer-Grunski; Eva K,20,0,20,0
1713339213344,LIGM 5B,A00,507423,Fischer-Grunski; Eva K,20,0,20,0
1713339214381,LIGM 5C,A00,507425,Fischer-Grunski; Eva K,20,0,20,0
1713339215408,LIIT 5AS,A00,507427,Carnelos; Chiara,20,0,20,0
1713339216433,LIIT 5BS,A00,507430,Carnelos; Chiara,20,0,20,0
1713339217461,LIIT 5CS,A00,507432,Carnelos; Chiara,20,0,20,0
1713339218488,LISP 5A,A00,507541,Munoz Sanchez; Alicia,17,0,20,3
1713339219515,LISP 5B,A00,507671,Munoz Sanchez; Alicia,15,0,20,5
1713339220547,LISP 5C,A00,507696,Munoz Sanchez; Alicia,15,0,20,5
1713339221573,MAE 197,001,528363,Boechler; Nicholas Sebastia,9998,0,9999,1
1713339222610,MATH 197,001,523477,Kedlaya; Kiran S.,9999,0,9999,0
1713339222610,MATH 197,002,563811,Zhang; Danna,9999,0,9999,0
1713339223639,MCWP 40R,A00,518780,Staff,20,0,20,0
1713339223639,MCWP 40R,B00,518781,Staff,19,0,20,1
1713339223639,MCWP 40R,C00,518783,Staff,19,0,20,1
1713339224665,MCWP 50R,A00,518791,Staff,20,0,20,0
1713339224665,MCWP 50R,B00,518792,Staff,17,0,20,3
1713339224665,MCWP 50R,C00,518793,Staff,19,0,20,1
1713339224665,MCWP 50R,D00,518794,Staff,16,0,20,4
1713339224665,MCWP 50R,E00,518795,Staff,16,0,20,4
1713339224665,MCWP 50R,F00,518796,Staff,19,0,20,1
1713339224665,MCWP 50R,G00,518797,Staff,19,0,20,1
1713339225692,MMW 12R,A01,514034,Herbst; Matthew,15,0,16,1
1713339225692,MMW 12R,A02,514035,Herbst; Matthew,16,0,16,0
1713339226717,MMW 13R,A01,514037,Staff,12,0,16,4
1713339226717,MMW 13R,A02,514039,Staff,16,0,16,0
1713339228769,SIO 295LS,A00,523233,Staff,19,0,30,11
1713339229797,SIO 295S,A00,523232,Staff,19,0,30,11
1713339230828,SOCI 117,A01,494376,Staff,1,0,5,4
1713339231853,WES 237B,A00,494380,Staff,19,0,20,1
1713339233941,AESE 279B,A00,494370,Wade; Jon P,33,0,33,0
1713339234968,ANAR 135S,A00,494369,Braswell; Geoffrey E.,0,0,0,0
1713339236001,CAT 124RS,A01,519847,Geibel; William,17,0,20,3
1713339237027,CAT 125RS,A01,515971,Geibel; William,17,0,20,3
1713339238054,CLRE 250,A00,511389,Morris; Sheldon,9996,0,9999,3
1713339239089,CLRE 251,A00,507176,Mehta; Ravindra L.,9996,0,9999,3
1713339239089,CLRE 251,B00,511410,Mehta; Ravindra L.,9998,0,9999,1
1713339240117,CLRE 252,A00,507189,Cuomo; Raphael Eduardo,9998,0,9999,1
1713339241144,CLRE 253,A00,507199,Vaida; Florin,9997,0,9999,2
1713339241144,CLRE 253,B00,507202,Vaida; Florin,9999,0,9999,0
1713339242171,CLRE 259,A00,507211,Patel; Hemal,9996,0,9999,3
1713339243218,CLRE 260,A00,507221,Cuomo; Raphael Eduardo,9999,0,9999,0
1713339244261,CLRE 297,001,507242,Cuomo; Raphael Eduardo,9999,0,9999,0
1713339245291,CSE 191,A00,516875,Minnes Kemp; Mor Mia,9999,0,9999,0
1713339246325,CSS 201S,A01,494383,Staff,35,0,35,0
1713339247359,CSS 202S,A01,494387,Staff,35,0,35,0
1713339248386,EAP 100,A00,516065,Staff,9792,0,9999,207
1713339249425,ECE 45,A01,507414,Staff,51,0,60,9
1713339250452,ECE 100,A01,507416,Baghdadchi; Saharnaz,10,0,20,10
1713339250452,ECE 100,A02,507418,Baghdadchi; Saharnaz,20,0,20,0
1713339251479,ECE 111,A01,507420,Staff,38,0,50,12
1713339252508,ECE 197,001,548057,Sievenpiper; Daniel F.,9998,0,9999,1
1713339253538,EDS 115,A00,507243,Choi; Bailey Miyeon,28,0,28,0
1713339254569,EDS 117,A01,494379,Staff,23,0,25,2
1713339255598,EDS 125,A00,507246,Hopkins; Megan Beth,29,0,30,1
1713339256625,EDS 128A,A01,507264,Fargason; Sharon Gayle,26,0,26,0
1713339257652,EDS 128B,A01,507293,Pappas; Elizabeth,30,0,30,0
1713339258686,EDS 139,A00,507294,Fargason; Sharon Gayle,30,0,30,0
1713339258686,EDS 139,B00,507313,Pappas; Elizabeth,30,0,30,0
1713339259711,EDS 201,A00,507315,Staff,26,0,30,4
1713339260739,EDS 203,A01,507317,Halter; Christopher P.,26,0,30,4
1713339261765,EDS 204R,A01,507319,Halter; Christopher P.,3,0,30,27
1713339261765,EDS 204R,B01,507331,Heinzman; Erica M.,28,0,30,2
1713339262798,EDS 206R,A00,507332,Staff,4,0,30,26
1713339262798,EDS 206R,B00,507343,Staff,28,0,30,2
1713339263825,EDS 250,A00,507344,Hemans; Patricia Ann Benitez,36,0,40,4
1713339264853,EDS 281,A00,507345,Daly; Alan J.,18,0,18,0
1713339265877,EDS 284,A00,507350,Daly; Alan J.,16,0,16,0
1713339266904,EDS 286,A00,507359,Fine; Sarah,18,0,18,0
1713339267932,EDS 289C,A01,507361,Daly; Alan J.,18,0,18,0
1713339268963,EDS 290,A00,507366,Hofstetter; Carolyn,15,0,15,0
1713339269995,LIGM 5A,A00,507421,Fischer-Grunski; Eva K,20,0,20,0
1713339271025,LIGM 5B,A00,507423,Fischer-Grunski; Eva K,20,0,20,0
1713339272051,LIGM 5C,A00,507425,Fischer-Grunski; Eva K,20,0,20,0
1713339273082,LIIT 5AS,A00,507427,Carnelos; Chiara,20,0,20,0
1713339274109,LIIT 5BS,A00,507430,Carnelos; Chiara,20,0,20,0
1713339275143,LIIT 5CS,A00,507432,Carnelos; Chiara,20,0,20,0
1713339276170,LISP 5A,A00,507541,Munoz Sanchez; Alicia,17,0,20,3
1713339277196,LISP 5B,A00,507671,Munoz Sanchez; Alicia,15,0,20,5
1713339278231,LISP 5C,A00,507696,Munoz Sanchez; Alicia,15,0,20,5
1713339279271,MAE 197,001,528363,Boechler; Nicholas Sebastia,9998,0,9999,1
1713339280298,MATH 197,001,523477,Kedlaya; Kiran S.,9999,0,9999,0
1713339280298,MATH 197,002,563811,Zhang; Danna,9999,0,9999,0
1713339281325,MCWP 40R,A00,518780,Staff,20,0,20,0
1713339281325,MCWP 40R,B00,518781,Staff,19,0,20,1
1713339281325,MCWP 40R,C00,518783,Staff,19,0,20,1
1713339282350,MCWP 50R,A00,518791,Staff,20,0,20,0
1713339282350,MCWP 50R,B00,518792,Staff,17,0,20,3
1713339282350,MCWP 50R,C00,518793,Staff,19,0,20,1
1713339282350,MCWP 50R,D00,518794,Staff,16,0,20,4
1713339282350,MCWP 50R,E00,518795,Staff,16,0,20,4
1713339282350,MCWP 50R,F00,518796,Staff,19,0,20,1
1713339282350,MCWP 50R,G00,518797,Staff,19,0,20,1
1713339283378,MMW 12R,A01,514034,Herbst; Matthew,15,0,16,1
1713339283378,MMW 12R,A02,514035,Herbst; Matthew,16,0,16,0
1713339284462,MMW 13R,A01,514037,Staff,12,0,16,4
1713339284462,MMW 13R,A02,514039,Staff,16,0,16,0
1713339286514,SIO 295LS,A00,523233,Staff,19,0,30,11
1713339287542,SIO 295S,A00,523232,Staff,19,0,30,11
1713339288572,SOCI 117,A01,494376,Staff,1,0,5,4
1713339289598,WES 237B,A00,494380,Staff,19,0,20,1
1713339291674,AESE 279B,A00,494370,Wade; Jon P,33,0,33,0
1713339292702,ANAR 135S,A00,494369,Braswell; Geoffrey E.,0,0,0,0
1713339293729,CAT 124RS,A01,519847,Geibel; William,17,0,20,3
1713339294756,CAT 125RS,A01,515971,Geibel; William,17,0,20,3
1713339295782,CLRE 250,A00,511389,Morris; Sheldon,9996,0,9999,3
1713339296822,CLRE 251,A00,507176,Mehta; Ravindra L.,9996,0,9999,3
1713339296822,CLRE 251,B00,511410,Mehta; Ravindra L.,9998,0,9999,1
1713339297852,CLRE 252,A00,507189,Cuomo; Raphael Eduardo,9998,0,9999,1
1713339298883,CLRE 253,A00,507199,Vaida; Florin,9997,0,9999,2
1713339298883,CLRE 253,B00,507202,Vaida; Florin,9999,0,9999,0
1713339299909,CLRE 259,A00,507211,Patel; Hemal,9996,0,9999,3
1713339300942,CLRE 260,A00,507221,Cuomo; Raphael Eduardo,9999,0,9999,0
1713339301973,CLRE 297,001,507242,Cuomo; Raphael Eduardo,9999,0,9999,0
1713339303001,CSE 191,A00,516875,Minnes Kemp; Mor Mia,9999,0,9999,0
1713339304029,CSS 201S,A01,494383,Staff,35,0,35,0
1713339305064,CSS 202S,A01,494387,Staff,35,0,35,0
1713339306095,EAP 100,A00,516065,Staff,9792,0,9999,207
1713339307131,ECE 45,A01,507414,Staff,51,0,60,9
1713339308160,ECE 100,A01,507416,Baghdadchi; Saharnaz,10,0,20,10
1713339308160,ECE 100,A02,507418,Baghdadchi; Saharnaz,20,0,20,0
1713339309190,ECE 111,A01,507420,Staff,38,0,50,12
1713339310217,ECE 197,001,548057,Sievenpiper; Daniel F.,9998,0,9999,1
1713339311253,EDS 115,A00,507243,Choi; Bailey Miyeon,28,0,28,0
1713339312279,EDS 117,A01,494379,Staff,23,0,25,2
1713339313317,EDS 125,A00,507246,Hopkins; Megan Beth,29,0,30,1
1713339314360,EDS 128A,A01,507264,Fargason; Sharon Gayle,26,0,26,0
1713339315416,EDS 128B,A01,507293,Pappas; Elizabeth,30,0,30,0
1713339316448,EDS 139,A00,507294,Fargason; Sharon Gayle,30,0,30,0
1713339316448,EDS 139,B00,507313,Pappas; Elizabeth,30,0,30,0
1713339317479,EDS 201,A00,507315,Staff,26,0,30,4
1713339318510,EDS 203,A01,507317,Halter; Christopher P.,26,0,30,4
1713339319537,EDS 204R,A01,507319,Halter; Christopher P.,3,0,30,27
1713339319537,EDS 204R,B01,507331,Heinzman; Erica M.,28,0,30,2
1713339320590,EDS 206R,A00,507332,Staff,4,0,30,26
1713339320590,EDS 206R,B00,507343,Staff,28,0,30,2
1713339321621,EDS 250,A00,507344,Hemans; Patricia Ann Benitez,36,0,40,4
1713339322653,EDS 281,A00,507345,Daly; Alan J.,18,0,18,0
1713339323688,EDS 284,A00,507350,Daly; Alan J.,16,0,16,0
1713339324717,EDS 286,A00,507359,Fine; Sarah,18,0,18,0
1713339325747,EDS 289C,A01,507361,Daly; Alan J.,18,0,18,0
1713339326778,EDS 290,A00,507366,Hofstetter; Carolyn,15,0,15,0
1713339327811,LIGM 5A,A00,507421,Fischer-Grunski; Eva K,20,0,20,0
1713339328838,LIGM 5B,A00,507423,Fischer-Grunski; Eva K,20,0,20,0
1713339329864,LIGM 5C,A00,507425,Fischer-Grunski; Eva K,20,0,20,0
1713339330891,LIIT 5AS,A00,507427,Carnelos; Chiara,20,0,20,0
1713339331918,LIIT 5BS,A00,507430,Carnelos; Chiara,20,0,20,0
1713339332942,LIIT 5CS,A00,507432,Carnelos; Chiara,20,0,20,0
1713339333971,LISP 5A,A00,507541,Munoz Sanchez; Alicia,17,0,20,3
1713339335003,LISP 5B,A00,507671,Munoz Sanchez; Alicia,15,0,20,5
1713339336031,LISP 5C,A00,507696,Munoz Sanchez; Alicia,15,0,20,5
1713339337059,MAE 197,001,528363,Boechler; Nicholas Sebastia,9998,0,9999,1
1713339338088,MATH 197,001,523477,Kedlaya; Kiran S.,9999,0,9999,0
1713339338088,MATH 197,002,563811,Zhang; Danna,9999,0,9999,0
1713339339118,MCWP 40R,A00,518780,Staff,20,0,20,0
1713339339118,MCWP 40R,B00,518781,Staff,19,0,20,1
1713339339118,MCWP 40R,C00,518783,Staff,19,0,20,1
1713339340146,MCWP 50R,A00,518791,Staff,20,0,20,0
1713339340146,MCWP 50R,B00,518792,Staff,17,0,20,3
1713339340146,MCWP 50R,C00,518793,Staff,19,0,20,1
1713339340146,MCWP 50R,D00,518794,Staff,16,0,20,4
1713339340146,MCWP 50R,E00,518795,Staff,16,0,20,4
1713339340146,MCWP 50R,F00,518796,Staff,19,0,20,1
1713339340146,MCWP 50R,G00,518797,Staff,19,0,20,1
1713339341184,MMW 12R,A01,514034,Herbst; Matthew,15,0,16,1
1713339341184,MMW 12R,A02,514035,Herbst; Matthew,16,0,16,0
1713339342213,MMW 13R,A01,514037,Staff,12,0,16,4
1713339342213,MMW 13R,A02,514039,Staff,16,0,16,0
1713339344285,SIO 295LS,A00,523233,Staff,19,0,30,11
1713339345314,SIO 295S,A00,523232,Staff,19,0,30,11
1713339346343,SOCI 117,A01,494376,Staff,1,0,5,4
1713339347374,WES 237B,A00,494380,Staff,19,0,20,1
1713339349457,AESE 279B,A00,494370,Wade; Jon P,33,0,33,0
1713339350487,ANAR 135S,A00,494369,Braswell; Geoffrey E.,0,0,0,0
1713339351517,CAT 124RS,A01,519847,Geibel; William,17,0,20,3
1713339352550,CAT 125RS,A01,515971,Geibel; William,17,0,20,3
1713339353580,CLRE 250,A00,511389,Morris; Sheldon,9996,0,9999,3
1713339354616,CLRE 251,A00,507176,Mehta; Ravindra L.,9996,0,9999,3
1713339354616,CLRE 251,B00,511410,Mehta; Ravindra L.,9998,0,9999,1
1713339355652,CLRE 252,A00,507189,Cuomo; Raphael Eduardo,9998,0,9999,1
1713339356683,CLRE 253,A00,507199,Vaida; Florin,9997,0,9999,2
1713339356683,CLRE 253,B00,507202,Vaida; Florin,9999,0,9999,0
1713339357715,CLRE 259,A00,507211,Patel; Hemal,9996,0,9999,3
1713339358740,CLRE 260,A00,507221,Cuomo; Raphael Eduardo,9999,0,9999,0
1713339359769,CLRE 297,001,507242,Cuomo; Raphael Eduardo,9999,0,9999,0
1713339360794,CSE 191,A00,516875,Minnes Kemp; Mor Mia,9999,0,9999,0
1713339361832,CSS 201S,A01,494383,Staff,35,0,35,0
1713339362861,CSS 202S,A01,494387,Staff,35,0,35,0
1713339363903,EAP 100,A00,516065,Staff,9792,0,9999,207
1713339364937,ECE 45,A01,507414,Staff,51,0,60,9
1713339365964,ECE 100,A01,507416,Baghdadchi; Saharnaz,10,0,20,10
1713339365964,ECE 100,A02,507418,Baghdadchi; Saharnaz,20,0,20,0
1713339366998,ECE 111,A01,507420,Staff,38,0,50,12
1713339368028,ECE 197,001,548057,Sievenpiper; Daniel F.,9998,0,9999,1
1713339369057,EDS 115,A00,507243,Choi; Bailey Miyeon,28,0,28,0
1713339370083,EDS 117,A01,494379,Staff,23,0,25,2
1713339371115,EDS 125,A00,507246,Hopkins; Megan Beth,29,0,30,1
1713339372147,EDS 128A,A01,507264,Fargason; Sharon Gayle,26,0,26,0
1713339373173,EDS 128B,A01,507293,Pappas; Elizabeth,30,0,30,0
1713339374204,EDS 139,A00,507294,Fargason; Sharon Gayle,30,0,30,0
1713339374204,EDS 139,B00,507313,Pappas; Elizabeth,30,0,30,0
1713339375231,EDS 201,A00,507315,Staff,26,0,30,4
1713339376259,EDS 203,A01,507317,Halter; Christopher P.,26,0,30,4
1713339377287,EDS 204R,A01,507319,Halter; Christopher P.,3,0,30,27
1713339377287,EDS 204R,B01,507331,Heinzman; Erica M.,28,0,30,2
1713339378312,EDS 206R,A00,507332,Staff,4,0,30,26
1713339378312,EDS 206R,B00,507343,Staff,28,0,30,2
1713339379338,EDS 250,A00,507344,Hemans; Patricia Ann Benitez,36,0,40,4
1713339380366,EDS 281,A00,507345,Daly; Alan J.,18,0,18,0
1713339381395,EDS 284,A00,507350,Daly; Alan J.,16,0,16,0
1713339382422,EDS 286,A00,507359,Fine; Sarah,18,0,18,0
1713339383448,EDS 289C,A01,507361,Daly; Alan J.,18,0,18,0
1713339384477,EDS 290,A00,507366,Hofstetter; Carolyn,15,0,15,0
1713339385510,LIGM 5A,A00,507421,Fischer-Grunski; Eva K,20,0,20,0
1713339386540,LIGM 5B,A00,507423,Fischer-Grunski; Eva K,20,0,20,0
1713339387572,LIGM 5C,A00,507425,Fischer-Grunski; Eva K,20,0,20,0
1713339388656,LIIT 5AS,A00,507427,Carnelos; Chiara,20,0,20,0
1713339389683,LIIT 5BS,A00,507430,Carnelos; Chiara,20,0,20,0
1713339390710,LIIT 5CS,A00,507432,Carnelos; Chiara,20,0,20,0
1713339391737,LISP 5A,A00,507541,Munoz Sanchez; Alicia,17,0,20,3
1713339392763,LISP 5B,A00,507671,Munoz Sanchez; Alicia,15,0,20,5
1713339393796,LISP 5C,A00,507696,Munoz Sanchez; Alicia,15,0,20,5
1713339394828,MAE 197,001,528363,Boechler; Nicholas Sebastia,9998,0,9999,1
1713339395857,MATH 197,001,523477,Kedlaya; Kiran S.,9999,0,9999,0
1713339395857,MATH 197,002,563811,Zhang; Danna,9999,0,9999,0
1713339396885,MCWP 40R,A00,518780,Staff,20,0,20,0
1713339396885,MCWP 40R,B00,518781,Staff,19,0,20,1
1713339396885,MCWP 40R,C00,518783,Staff,19,0,20,1
1713339397913,MCWP 50R,A00,518791,Staff,20,0,20,0
1713339397913,MCWP 50R,B00,518792,Staff,17,0,20,3
1713339397913,MCWP 50R,C00,518793,Staff,19,0,20,1
1713339397913,MCWP 50R,D00,518794,Staff,16,0,20,4
1713339397913,MCWP 50R,E00,518795,Staff,16,0,20,4
1713339397913,MCWP 50R,F00,518796,Staff,19,0,20,1
1713339397913,MCWP 50R,G00,518797,Staff,19,0,20,1
1713339398944,MMW 12R,A01,514034,Herbst; Matthew,15,0,16,1
1713339398944,MMW 12R,A02,514035,Herbst; Matthew,16,0,16,0
1713339399975,MMW 13R,A01,514037,Staff,12,0,16,4
1713339399975,MMW 13R,A02,514039,Staff,16,0,16,0
1713339402104,SIO 295LS,A00,523233,Staff,19,0,30,11
1713339403134,SIO 295S,A00,523232,Staff,19,0,30,11
1713339404166,SOCI 117,A01,494376,Staff,1,0,5,4
1713339405193,WES 237B,A00,494380,Staff,19,0,20,1
1713339407278,AESE 279B,A00,494370,Wade; Jon P,33,0,33,0
1713339408308,ANAR 135S,A00,494369,Braswell; Geoffrey E.,0,0,0,0
1713339409336,CAT 124RS,A01,519847,Geibel; William,17,0,20,3
1713339410365,CAT 125RS,A01,515971,Geibel; William,17,0,20,3
1713339411395,CLRE 250,A00,511389,Morris; Sheldon,9996,0,9999,3
1713339412424,CLRE 251,A00,507176,Mehta; Ravindra L.,9996,0,9999,3
1713339412424,CLRE 251,B00,511410,Mehta; Ravindra L.,9998,0,9999,1
1713339413451,CLRE 252,A00,507189,Cuomo; Raphael Eduardo,9998,0,9999,1
1713339414483,CLRE 253,A00,507199,Vaida; Florin,9997,0,9999,2
1713339414483,CLRE 253,B00,507202,Vaida; Florin,9999,0,9999,0
1713339415512,CLRE 259,A00,507211,Patel; Hemal,9996,0,9999,3
1713339416539,CLRE 260,A00,507221,Cuomo; Raphael Eduardo,9999,0,9999,0
1713339417565,CLRE 297,001,507242,Cuomo; Raphael Eduardo,9999,0,9999,0
1713339418596,CSE 191,A00,516875,Minnes Kemp; Mor Mia,9999,0,9999,0
1713339419739,CSS 201S,A01,494383,Staff,35,0,35,0
1713339420765,CSS 202S,A01,494387,Staff,35,0,35,0
1713339421790,EAP 100,A00,516065,Staff,9792,0,9999,207
1713339422818,ECE 45,A01,507414,Staff,51,0,60,9
1713339423860,ECE 100,A01,507416,Baghdadchi; Saharnaz,10,0,20,10
1713339423860,ECE 100,A02,507418,Baghdadchi; Saharnaz,20,0,20,0
1713339424887,ECE 111,A01,507420,Staff,38,0,50,12
1713339425915,ECE 197,001,548057,Sievenpiper; Daniel F.,9998,0,9999,1
1713339426943,EDS 115,A00,507243,Choi; Bailey Miyeon,28,0,28,0
1713339427974,EDS 117,A01,494379,Staff,23,0,25,2
1713339428999,EDS 125,A00,507246,Hopkins; Megan Beth,29,0,30,1
1713339430030,EDS 128A,A01,507264,Fargason; Sharon Gayle,26,0,26,0
1713339431056,EDS 128B,A01,507293,Pappas; Elizabeth,30,0,30,0
1713339432087,EDS 139,A00,507294,Fargason; Sharon Gayle,30,0,30,0
1713339432087,EDS 139,B00,507313,Pappas; Elizabeth,30,0,30,0
1713339433113,EDS 201,A00,507315,Staff,26,0,30,4
1713339434140,EDS 203,A01,507317,Halter; Christopher P.,26,0,30,4
1713339435177,EDS 204R,A01,507319,Halter; Christopher P.,3,0,30,27
1713339435177,EDS 204R,B01,507331,Heinzman; Erica M.,28,0,30,2
1713339436203,EDS 206R,A00,507332,Staff,4,0,30,26
1713339436203,EDS 206R,B00,507343,Staff,28,0,30,2
1713339437232,EDS 250,A00,507344,Hemans; Patricia Ann Benitez,36,0,40,4
1713339438264,EDS 281,A00,507345,Daly; Alan J.,18,0,18,0
1713339439292,EDS 284,A00,507350,Daly; Alan J.,16,0,16,0
1713339440320,EDS 286,A00,507359,Fine; Sarah,18,0,18,0
1713339441351,EDS 289C,A01,507361,Daly; Alan J.,18,0,18,0
1713339442380,EDS 290,A00,507366,Hofstetter; Carolyn,15,0,15,0
1713339443411,LIGM 5A,A00,507421,Fischer-Grunski; Eva K,20,0,20,0
1713339444441,LIGM 5B,A00,507423,Fischer-Grunski; Eva K,20,0,20,0
1713339445469,LIGM 5C,A00,507425,Fischer-Grunski; Eva K,20,0,20,0
1713339446500,LIIT 5AS,A00,507427,Carnelos; Chiara,20,0,20,0
1713339447538,LIIT 5BS,A00,507430,Carnelos; Chiara,20,0,20,0
1713339448567,LIIT 5CS,A00,507432,Carnelos; Chiara,20,0,20,0
1713339449595,LISP 5A,A00,507541,Munoz Sanchez; Alicia,17,0,20,3
1713339450624,LISP 5B,A00,507671,Munoz Sanchez; Alicia,15,0,20,5
1713339451650,LISP 5C,A00,507696,Munoz Sanchez; Alicia,15,0,20,5
1713339452681,MAE 197,001,528363,Boechler; Nicholas Sebastia,9998,0,9999,1
1713339453715,MATH 197,001,523477,Kedlaya; Kiran S.,9999,0,9999,0
1713339453715,MATH 197,002,563811,Zhang; Danna,9999,0,9999,0
1713339454745,MCWP 40R,A00,518780,Staff,20,0,20,0
1713339454745,MCWP 40R,B00,518781,Staff,19,0,20,1
1713339454745,MCWP 40R,C00,518783,Staff,19,0,20,1
1713339455773,MCWP 50R,A00,518791,Staff,20,0,20,0
1713339455773,MCWP 50R,B00,518792,Staff,17,0,20,3
1713339455773,MCWP 50R,C00,518793,Staff,19,0,20,1
1713339455773,MCWP 50R,D00,518794,Staff,16,0,20,4
1713339455773,MCWP 50R,E00,518795,Staff,16,0,20,4
1713339455773,MCWP 50R,F00,518796,Staff,19,0,20,1
1713339455773,MCWP 50R,G00,518797,Staff,19,0,20,1
1713339456801,MMW 12R,A01,514034,Herbst; Matthew,15,0,16,1
1713339456801,MMW 12R,A02,514035,Herbst; Matthew,16,0,16,0
1713339457829,MMW 13R,A01,514037,Staff,12,0,16,4
1713339457829,MMW 13R,A02,514039,Staff,16,0,16,0
1713339459886,SIO 295LS,A00,523233,Staff,19,0,30,11
1713339460919,SIO 295S,A00,523232,Staff,19,0,30,11
1713339461949,SOCI 117,A01,494376,Staff,1,0,5,4
1713339462978,WES 237B,A00,494380,Staff,19,0,20,1
1713339465065,AESE 279B,A00,494370,Wade; Jon P,33,0,33,0
1713339466097,ANAR 135S,A00,494369,Braswell; Geoffrey E.,0,0,0,0
1713339467126,CAT 124RS,A01,519847,Geibel; William,17,0,20,3
1713339468153,CAT 125RS,A01,515971,Geibel; William,17,0,20,3
1713339469189,CLRE 250,A00,511389,Morris; Sheldon,9996,0,9999,3
1713339470224,CLRE 251,A00,507176,Mehta; Ravindra L.,9996,0,9999,3
1713339470224,CLRE 251,B00,511410,Mehta; Ravindra L.,9998,0,9999,1
1713339471260,CLRE 252,A00,507189,Cuomo; Raphael Eduardo,9998,0,9999,1
1713339472288,CLRE 253,A00,507199,Vaida; Florin,9997,0,9999,2
1713339472288,CLRE 253,B00,507202,Vaida; Florin,9999,0,9999,0
1713339473342,CLRE 259,A00,507211,Patel; Hemal,9996,0,9999,3
1713339474372,CLRE 260,A00,507221,Cuomo; Raphael Eduardo,9999,0,9999,0
1713339475401,CLRE 297,001,507242,Cuomo; Raphael Eduardo,9999,0,9999,0
1713339476425,CSE 191,A00,516875,Minnes Kemp; Mor Mia,9999,0,9999,0
1713339477453,CSS 201S,A01,494383,Staff,35,0,35,0
1713339478481,CSS 202S,A01,494387,Staff,35,0,35,0
1713339479507,EAP 100,A00,516065,Staff,9792,0,9999,207
1713339480535,ECE 45,A01,507414,Staff,51,0,60,9
1713339481568,ECE 100,A01,507416,Baghdadchi; Saharnaz,10,0,20,10
1713339481568,ECE 100,A02,507418,Baghdadchi; Saharnaz,20,0,20,0
1713339482596,ECE 111,A01,507420,Staff,38,0,50,12
1713339483626,ECE 197,001,548057,Sievenpiper; Daniel F.,9998,0,9999,1
1713339484656,EDS 115,A00,507243,Choi; Bailey Miyeon,28,0,28,0
1713339485684,EDS 117,A01,494379,Staff,23,0,25,2
1713339486715,EDS 125,A00,507246,Hopkins; Megan Beth,29,0,30,1
1713339487747,EDS 128A,A01,507264,Fargason; Sharon Gayle,26,0,26,0
1713339488775,EDS 128B,A01,507293,Pappas; Elizabeth,30,0,30,0
1713339489803,EDS 139,A00,507294,Fargason; Sharon Gayle,30,0,30,0
1713339489803,EDS 139,B00,507313,Pappas; Elizabeth,30,0,30,0
1713339490830,EDS 201,A00,507315,Staff,26,0,30,4
1713339491860,EDS 203,A01,507317,Halter; Christopher P.,26,0,30,4
1713339492940,EDS 204R,A01,507319,Halter; Christopher P.,3,0,30,27
1713339492940,EDS 204R,B01,507331,Heinzman; Erica M.,28,0,30,2
1713339493965,EDS 206R,A00,507332,Staff,4,0,30,26
1713339493965,EDS 206R,B00,507343,Staff,28,0,30,2
1713339494992,EDS 250,A00,507344,Hemans; Patricia Ann Benitez,36,0,40,4
1713339496020,EDS 281,A00,507345,Daly; Alan J.,18,0,18,0
1713339497047,EDS 284,A00,507350,Daly; Alan J.,16,0,16,0
1713339498075,EDS 286,A00,507359,Fine; Sarah,18,0,18,0
1713339499102,EDS 289C,A01,507361,Daly; Alan J.,18,0,18,0
1713339500128,EDS 290,A00,507366,Hofstetter; Carolyn,15,0,15,0
1713339501163,LIGM 5A,A00,507421,Fischer-Grunski; Eva K,20,0,20,0
1713339502193,LIGM 5B,A00,507423,Fischer-Grunski; Eva K,20,0,20,0
1713339503220,LIGM 5C,A00,507425,Fischer-Grunski; Eva K,20,0,20,0
1713339504251,LIIT 5AS,A00,507427,Carnelos; Chiara,20,0,20,0
1713339505280,LIIT 5BS,A00,507430,Carnelos; Chiara,20,0,20,0
1713339506311,LIIT 5CS,A00,507432,Carnelos; Chiara,20,0,20,0
1713339507340,LISP 5A,A00,507541,Munoz Sanchez; Alicia,17,0,20,3
1713339508366,LISP 5B,A00,507671,Munoz Sanchez; Alicia,15,0,20,5
1713339509393,LISP 5C,A00,507696,Munoz Sanchez; Alicia,15,0,20,5
1713339510419,MAE 197,001,528363,Boechler; Nicholas Sebastia,9998,0,9999,1
1713339511451,MATH 197,001,523477,Kedlaya; Kiran S.,9999,0,9999,0
1713339511451,MATH 197,002,563811,Zhang; Danna,9999,0,9999,0
1713339512482,MCWP 40R,A00,518780,Staff,20,0,20,0
1713339512482,MCWP 40R,B00,518781,Staff,19,0,20,1
1713339512482,MCWP 40R,C00,518783,Staff,19,0,20,1
1713339513512,MCWP 50R,A00,518791,Staff,20,0,20,0
1713339513512,MCWP 50R,B00,518792,Staff,17,0,20,3
1713339513512,MCWP 50R,C00,518793,Staff,19,0,20,1
1713339513512,MCWP 50R,D00,518794,Staff,16,0,20,4
1713339513512,MCWP 50R,E00,518795,Staff,16,0,20,4
1713339513512,MCWP 50R,F00,518796,Staff,19,0,20,1
1713339513512,MCWP 50R,G00,518797,Staff,19,0,20,1
1713339514539,MMW 12R,A01,514034,Herbst; Matthew,15,0,16,1
1713339514539,MMW 12R,A02,514035,Herbst; Matthew,16,0,16,0
1713339515565,MMW 13R,A01,514037,Staff,12,0,16,4
1713339515565,MMW 13R,A02,514039,Staff,16,0,16,0
1713339517621,SIO 295LS,A00,523233,Staff,19,0,30,11
1713339518647,SIO 295S,A00,523232,Staff,19,0,30,11
1713339519672,SOCI 117,A01,494376,Staff,1,0,5,4
1713339520854,WES 237B,A00,494380,Staff,19,0,20,1
1713339522946,AESE 279B,A00,494370,Wade; Jon P,33,0,33,0
1713339523981,ANAR 135S,A00,494369,Braswell; Geoffrey E.,0,0,0,0
1713339525012,CAT 124RS,A01,519847,Geibel; William,17,0,20,3
1713339526041,CAT 125RS,A01,515971,Geibel; William,17,0,20,3
1713339527067,CLRE 250,A00,511389,Morris; Sheldon,9996,0,9999,3
1713339528102,CLRE 251,A00,507176,Mehta; Ravindra L.,9996,0,9999,3
1713339528102,CLRE 251,B00,511410,Mehta; Ravindra L.,9998,0,9999,1
1713339529132,CLRE 252,A00,507189,Cuomo; Raphael Eduardo,9998,0,9999,1
1713339530160,CLRE 253,A00,507199,Vaida; Florin,9997,0,9999,2
1713339530160,CLRE 253,B00,507202,Vaida; Florin,9999,0,9999,0
1713339531187,CLRE 259,A00,507211,Patel; Hemal,9996,0,9999,3
1713339532212,CLRE 260,A00,507221,Cuomo; Raphael Eduardo,9999,0,9999,0
1713339533241,CLRE 297,001,507242,Cuomo; Raphael Eduardo,9999,0,9999,0
1713339534272,CSE 191,A00,516875,Minnes Kemp; Mor Mia,9999,0,9999,0
1713339535300,CSS 201S,A01,494383,Staff,35,0,35,0
1713339536331,CSS 202S,A01,494387,Staff,35,0,35,0
1713339537356,EAP 100,A00,516065,Staff,9792,0,9999,207
1713339538390,ECE 45,A01,507414,Staff,51,0,60,9
1713339539417,ECE 100,A01,507416,Baghdadchi; Saharnaz,10,0,20,10
1713339539417,ECE 100,A02,507418,Baghdadchi; Saharnaz,20,0,20,0
1713339540447,ECE 111,A01,507420,Staff,38,0,50,12
1713339541477,ECE 197,001,548057,Sievenpiper; Daniel F.,9998,0,9999,1
1713339542505,EDS 115,A00,507243,Choi; Bailey Miyeon,28,0,28,0
1713339543534,EDS 117,A01,494379,Staff,23,0,25,2
1713339544559,EDS 125,A00,507246,Hopkins; Megan Beth,29,0,30,1
1713339545586,EDS 128A,A01,507264,Fargason; Sharon Gayle,26,0,26,0
1713339546611,EDS 128B,A01,507293,Pappas; Elizabeth,30,0,30,0
1713339547639,EDS 139,A00,507294,Fargason; Sharon Gayle,30,0,30,0
1713339547639,EDS 139,B00,507313,Pappas; Elizabeth,30,0,30,0
1713339548665,EDS 201,A00,507315,Staff,26,0,30,4
1713339549692,EDS 203,A01,507317,Halter; Christopher P.,26,0,30,4
1713339550719,EDS 204R,A01,507319,Halter; Christopher P.,3,0,30,27
1713339550719,EDS 204R,B01,507331,Heinzman; Erica M.,28,0,30,2
1713339551748,EDS 206R,A00,507332,Staff,4,0,30,26
1713339551748,EDS 206R,B00,507343,Staff,28,0,30,2
1713339552774,EDS 250,A00,507344,Hemans; Patricia Ann Benitez,36,0,40,4
1713339553801,EDS 281,A00,507345,Daly; Alan J.,18,0,18,0
1713339554830,EDS 284,A00,507350,Daly; Alan J.,16,0,16,0
1713339555857,EDS 286,A00,507359,Fine; Sarah,18,0,18,0
1713339556883,EDS 289C,A01,507361,Daly; Alan J.,18,0,18,0
1713339557909,EDS 290,A00,507366,Hofstetter; Carolyn,15,0,15,0
1713339558940,LIGM 5A,A00,507421,Fischer-Grunski; Eva K,20,0,20,0
1713339559966,LIGM 5B,A00,507423,Fischer-Grunski; Eva K,20,0,20,0
1713339560997,LIGM 5C,A00,507425,Fischer-Grunski; Eva K,20,0,20,0
1713339562024,LIIT 5AS,A00,507427,Carnelos; Chiara,20,0,20,0
1713339563050,LIIT 5BS,A00,507430,Carnelos; Chiara,20,0,20,0
1713339564075,LIIT 5CS,A00,507432,Carnelos; Chiara,20,0,20,0
1713339565101,LISP 5A,A00,507541,Munoz Sanchez; Alicia,17,0,20,3
1713339566129,LISP 5B,A00,507671,Munoz Sanchez; Alicia,15,0,20,5
1713339567162,LISP 5C,A00,507696,Munoz Sanchez; Alicia,15,0,20,5
1713339568190,MAE 197,001,528363,Boechler; Nicholas Sebastia,9998,0,9999,1
1713339569221,MATH 197,001,523477,Kedlaya; Kiran S.,9999,0,9999,0
1713339569221,MATH 197,002,563811,Zhang; Danna,9999,0,9999,0
1713339570253,MCWP 40R,A00,518780,Staff,20,0,20,0
1713339570253,MCWP 40R,B00,518781,Staff,19,0,20,1
1713339570253,MCWP 40R,C00,518783,Staff,19,0,20,1
1713339571284,MCWP 50R,A00,518791,Staff,20,0,20,0
1713339571284,MCWP 50R,B00,518792,Staff,17,0,20,3
1713339571284,MCWP 50R,C00,518793,Staff,19,0,20,1
1713339571284,MCWP 50R,D00,518794,Staff,16,0,20,4
1713339571284,MCWP 50R,E00,518795,Staff,16,0,20,4
1713339571284,MCWP 50R,F00,518796,Staff,19,0,20,1
1713339571284,MCWP 50R,G00,518797,Staff,19,0,20,1
1713339572310,MMW 12R,A01,514034,Herbst; Matthew,15,0,16,1
1713339572310,MMW 12R,A02,514035,Herbst; Matthew,16,0,16,0
1713339573340,MMW 13R,A01,514037,Staff,12,0,16,4
1713339573340,MMW 13R,A02,514039,Staff,16,0,16,0
1713339575395,SIO 295LS,A00,523233,Staff,19,0,30,11
1713339576421,SIO 295S,A00,523232,Staff,19,0,30,11
1713339577449,SOCI 117,A01,494376,Staff,1,0,5,4
1713339578475,WES 237B,A00,494380,Staff,19,0,20,1
1713339580559,AESE 279B,A00,494370,Wade; Jon P,33,0,33,0
1713339581586,ANAR 135S,A00,494369,Braswell; Geoffrey E.,0,0,0,0
1713339582617,CAT 124RS,A01,519847,Geibel; William,17,0,20,3
1713339583646,CAT 125RS,A01,515971,Geibel; William,17,0,20,3
1713339584674,CLRE 250,A00,511389,Morris; Sheldon,9996,0,9999,3
1713339585701,CLRE 251,A00,507176,Mehta; Ravindra L.,9996,0,9999,3
1713339585701,CLRE 251,B00,511410,Mehta; Ravindra L.,9998,0,9999,1
1713339586731,CLRE 252,A00,507189,Cuomo; Raphael Eduardo,9998,0,9999,1
1713339587758,CLRE 253,A00,507199,Vaida; Florin,9997,0,9999,2
1713339587758,CLRE 253,B00,507202,Vaida; Florin,9999,0,9999,0
1713339588785,CLRE 259,A00,507211,Patel; Hemal,9996,0,9999,3
1713339589809,CLRE 260,A00,507221,Cuomo; Raphael Eduardo,9999,0,9999,0
1713339590836,CLRE 297,001,507242,Cuomo; Raphael Eduardo,9999,0,9999,0
1713339591862,CSE 191,A00,516875,Minnes Kemp; Mor Mia,9999,0,9999,0
1713339592890,CSS 201S,A01,494383,Staff,35,0,35,0
1713339593917,CSS 202S,A01,494387,Staff,35,0,35,0
1713339594943,EAP 100,A00,516065,Staff,9792,0,9999,207
1713339595970,ECE 45,A01,507414,Staff,51,0,60,9
1713339597054,ECE 100,A01,507416,Baghdadchi; Saharnaz,10,0,20,10
1713339597054,ECE 100,A02,507418,Baghdadchi; Saharnaz,20,0,20,0
1713339598083,ECE 111,A01,507420,Staff,38,0,50,12
1713339599112,ECE 197,001,548057,Sievenpiper; Daniel F.,9998,0,9999,1
1713339600148,EDS 115,A00,507243,Choi; Bailey Miyeon,28,0,28,0
1713339601180,EDS 117,A01,494379,Staff,23,0,25,2
1713339602208,EDS 125,A00,507246,Hopkins; Megan Beth,29,0,30,1
1713339603239,EDS 128A,A01,507264,Fargason; Sharon Gayle,26,0,26,0
1713339604272,EDS 128B,A01,507293,Pappas; Elizabeth,30,0,30,0
1713339605298,EDS 139,A00,507294,Fargason; Sharon Gayle,30,0,30,0
1713339605298,EDS 139,B00,507313,Pappas; Elizabeth,30,0,30,0
1713339606325,EDS 201,A00,507315,Staff,26,0,30,4
1713339607354,EDS 203,A01,507317,Halter; Christopher P.,26,0,30,4
1713339608382,EDS 204R,A01,507319,Halter; Christopher P.,3,0,30,27
1713339608382,EDS 204R,B01,507331,Heinzman; Erica M.,28,0,30,2
1713339609405,EDS 206R,A00,507332,Staff,4,0,30,26
1713339609405,EDS 206R,B00,507343,Staff,28,0,30,2
1713339610433,EDS 250,A00,507344,Hemans; Patricia Ann Benitez,36,0,40,4
1713339611463,EDS 281,A00,507345,Daly; Alan J.,18,0,18,0
1713339612487,EDS 284,A00,507350,Daly; Alan J.,16,0,16,0
1713339613512,EDS 286,A00,507359,Fine; Sarah,18,0,18,0
1713339614541,EDS 289C,A01,507361,Daly; Alan J.,18,0,18,0
1713339615566,EDS 290,A00,507366,Hofstetter; Carolyn,15,0,15,0
1713339616593,LIGM 5A,A00,507421,Fischer-Grunski; Eva K,20,0,20,0
1713339617624,LIGM 5B,A00,507423,Fischer-Grunski; Eva K,20,0,20,0
1713339618650,LIGM 5C,A00,507425,Fischer-Grunski; Eva K,20,0,20,0
1713339619681,LIIT 5AS,A00,507427,Carnelos; Chiara,20,0,20,0
1713339620705,LIIT 5BS,A00,507430,Carnelos; Chiara,20,0,20,0
1713339621734,LIIT 5CS,A00,507432,Carnelos; Chiara,20,0,20,0
1713339622759,LISP 5A,A00,507541,Munoz Sanchez; Alicia,17,0,20,3
1713339623786,LISP 5B,A00,507671,Munoz Sanchez; Alicia,15,0,20,5
1713339624811,LISP 5C,A00,507696,Munoz Sanchez; Alicia,15,0,20,5
1713339625849,MAE 197,001,528363,Boechler; Nicholas Sebastia,9998,0,9999,1
1713339626877,MATH 197,001,523477,Kedlaya; Kiran S.,9999,0,9999,0
1713339626877,MATH 197,002,563811,Zhang; Danna,9999,0,9999,0
1713339627903,MCWP 40R,A00,518780,Staff,20,0,20,0
1713339627903,MCWP 40R,B00,518781,Staff,19,0,20,1
1713339627903,MCWP 40R,C00,518783,Staff,19,0,20,1
1713339628934,MCWP 50R,A00,518791,Staff,20,0,20,0
1713339628934,MCWP 50R,B00,518792,Staff,17,0,20,3
1713339628934,MCWP 50R,C00,518793,Staff,19,0,20,1
1713339628934,MCWP 50R,D00,518794,Staff,16,0,20,4
1713339628934,MCWP 50R,E00,518795,Staff,16,0,20,4
1713339628934,MCWP 50R,F00,518796,Staff,19,0,20,1
1713339628934,MCWP 50R,G00,518797,Staff,19,0,20,1
1713339629963,MMW 12R,A01,514034,Herbst; Matthew,15,0,16,1
1713339629963,MMW 12R,A02,514035,Herbst; Matthew,16,0,16,0
1713339630989,MMW 13R,A01,514037,Staff,12,0,16,4
1713339630989,MMW 13R,A02,514039,Staff,16,0,16,0
1713339633120,SIO 295LS,A00,523233,Staff,19,0,30,11
1713339634146,SIO 295S,A00,523232,Staff,19,0,30,11
1713339635177,SOCI 117,A01,494376,Staff,1,0,5,4
1713339636203,WES 237B,A00,494380,Staff,19,0,20,1
1713339638281,AESE 279B,A00,494370,Wade; Jon P,33,0,33,0
1713339639307,ANAR 135S,A00,494369,Braswell; Geoffrey E.,0,0,0,0
1713339640333,CAT 124RS,A01,519847,Geibel; William,17,0,20,3
1713339641361,CAT 125RS,A01,515971,Geibel; William,17,0,20,3
1713339642389,CLRE 250,A00,511389,Morris; Sheldon,9996,0,9999,3
1713339643421,CLRE 251,A00,507176,Mehta; Ravindra L.,9996,0,9999,3
1713339643421,CLRE 251,B00,511410,Mehta; Ravindra L.,9998,0,9999,1
1713339644453,CLRE 252,A00,507189,Cuomo; Raphael Eduardo,9998,0,9999,1
1713339645480,CLRE 253,A00,507199,Vaida; Florin,9997,0,9999,2
1713339645480,CLRE 253,B00,507202,Vaida; Florin,9999,0,9999,0
1713339646508,CLRE 259,A00,507211,Patel; Hemal,9996,0,9999,3
1713339647537,CLRE 260,A00,507221,Cuomo; Raphael Eduardo,9999,0,9999,0
1713339648562,CLRE 297,001,507242,Cuomo; Raphael Eduardo,9999,0,9999,0
1713339649594,CSE 191,A00,516875,Minnes Kemp; Mor Mia,9999,0,9999,0
1713339650628,CSS 201S,A01,494383,Staff,35,0,35,0
1713339651658,CSS 202S,A01,494387,Staff,35,0,35,0
1713339652683,EAP 100,A00,516065,Staff,9792,0,9999,207
1713339653716,ECE 45,A01,507414,Staff,51,0,60,9
1713339654747,ECE 100,A01,507416,Baghdadchi; Saharnaz,10,0,20,10
1713339654747,ECE 100,A02,507418,Baghdadchi; Saharnaz,20,0,20,0
1713339655775,ECE 111,A01,507420,Staff,38,0,50,12
1713339656806,ECE 197,001,548057,Sievenpiper; Daniel F.,9998,0,9999,1
1713339657841,EDS 115,A00,507243,Choi; Bailey Miyeon,28,0,28,0
1713339658867,EDS 117,A01,494379,Staff,23,0,25,2
1713339659896,EDS 125,A00,507246,Hopkins; Megan Beth,29,0,30,1
1713339660928,EDS 128A,A01,507264,Fargason; Sharon Gayle,26,0,26,0
1713339661960,EDS 128B,A01,507293,Pappas; Elizabeth,30,0,30,0
1713339662986,EDS 139,A00,507294,Fargason; Sharon Gayle,30,0,30,0
1713339662986,EDS 139,B00,507313,Pappas; Elizabeth,30,0,30,0
1713339664015,EDS 201,A00,507315,Staff,26,0,30,4
1713339665049,EDS 203,A01,507317,Halter; Christopher P.,26,0,30,4
1713339666076,EDS 204R,A01,507319,Halter; Christopher P.,3,0,30,27
1713339666076,EDS 204R,B01,507331,Heinzman; Erica M.,28,0,30,2
1713339667105,EDS 206R,A00,507332,Staff,4,0,30,26
1713339667105,EDS 206R,B00,507343,Staff,28,0,30,2
1713339668150,EDS 250,A00,507344,Hemans; Patricia Ann Benitez,36,0,40,4
1713339669176,EDS 281,A00,507345,Daly; Alan J.,18,0,18,0
1713339670201,EDS 284,A00,507350,Daly; Alan J.,16,0,16,0
1713339671234,EDS 286,A00,507359,Fine; Sarah,18,0,18,0
1713339672260,EDS 289C,A01,507361,Daly; Alan J.,18,0,18,0
1713339673290,EDS 290,A00,507366,Hofstetter; Carolyn,15,0,15,0
1713339674323,LIGM 5A,A00,507421,Fischer-Grunski; Eva K,20,0,20,0
1713339675350,LIGM 5B,A00,507423,Fischer-Grunski; Eva K,20,0,20,0
1713339676381,LIGM 5C,A00,507425,Fischer-Grunski; Eva K,20,0,20,0
1713339677409,LIIT 5AS,A00,507427,Carnelos; Chiara,20,0,20,0
1713339678434,LIIT 5BS,A00,507430,Carnelos; Chiara,20,0,20,0
1713339679462,LIIT 5CS,A00,507432,Carnelos; Chiara,20,0,20,0
1713339680489,LISP 5A,A00,507541,Munoz Sanchez; Alicia,17,0,20,3
1713339681515,LISP 5B,A00,507671,Munoz Sanchez; Alicia,15,0,20,5
1713339682541,LISP 5C,A00,507696,Munoz Sanchez; Alicia,15,0,20,5
1713339683567,MAE 197,001,528363,Boechler; Nicholas Sebastia,9998,0,9999,1
1713339684595,MATH 197,001,523477,Kedlaya; Kiran S.,9999,0,9999,0
1713339684595,MATH 197,002,563811,Zhang; Danna,9999,0,9999,0
1713339685622,MCWP 40R,A00,518780,Staff,20,0,20,0
1713339685622,MCWP 40R,B00,518781,Staff,19,0,20,1
1713339685622,MCWP 40R,C00,518783,Staff,19,0,20,1
1713339686651,MCWP 50R,A00,518791,Staff,20,0,20,0
1713339686651,MCWP 50R,B00,518792,Staff,17,0,20,3
1713339686651,MCWP 50R,C00,518793,Staff,19,0,20,1
1713339686651,MCWP 50R,D00,518794,Staff,16,0,20,4
1713339686651,MCWP 50R,E00,518795,Staff,16,0,20,4
1713339686651,MCWP 50R,F00,518796,Staff,19,0,20,1
1713339686651,MCWP 50R,G00,518797,Staff,19,0,20,1
1713339687683,MMW 12R,A01,514034,Herbst; Matthew,15,0,16,1
1713339687683,MMW 12R,A02,514035,Herbst; Matthew,16,0,16,0
1713339688709,MMW 13R,A01,514037,Staff,12,0,16,4
1713339688709,MMW 13R,A02,514039,Staff,16,0,16,0
1713339690763,SIO 295LS,A00,523233,Staff,19,0,30,11
1713339691791,SIO 295S,A00,523232,Staff,19,0,30,11
1713339692840,SOCI 117,A01,494376,Staff,1,0,5,4
1713339693944,WES 237B,A00,494380,Staff,19,0,20,1
1713339696026,AESE 279B,A00,494370,Wade; Jon P,33,0,33,0
1713339697059,ANAR 135S,A00,494369,Braswell; Geoffrey E.,0,0,0,0
1713339698085,CAT 124RS,A01,519847,Geibel; William,17,0,20,3
1713339699111,CAT 125RS,A01,515971,Geibel; William,17,0,20,3
1713339700139,CLRE 250,A00,511389,Morris; Sheldon,9996,0,9999,3
1713339701221,CLRE 251,A00,507176,Mehta; Ravindra L.,9996,0,9999,3
1713339701221,CLRE 251,B00,511410,Mehta; Ravindra L.,9998,0,9999,1
1713339702255,CLRE 252,A00,507189,Cuomo; Raphael Eduardo,9998,0,9999,1
1713339703282,CLRE 253,A00,507199,Vaida; Florin,9997,0,9999,2
1713339703282,CLRE 253,B00,507202,Vaida; Florin,9999,0,9999,0
1713339704309,CLRE 259,A00,507211,Patel; Hemal,9996,0,9999,3
1713339705336,CLRE 260,A00,507221,Cuomo; Raphael Eduardo,9999,0,9999,0
1713339706362,CLRE 297,001,507242,Cuomo; Raphael Eduardo,9999,0,9999,0
1713339707393,CSE 191,A00,516875,Minnes Kemp; Mor Mia,9999,0,9999,0
1713339708432,CSS 201S,A01,494383,Staff,35,0,35,0
1713339709457,CSS 202S,A01,494387,Staff,35,0,35,0
1713339710483,EAP 100,A00,516065,Staff,9792,0,9999,207
1713339711510,ECE 45,A01,507414,Staff,51,0,60,9
1713339712537,ECE 100,A01,507416,Baghdadchi; Saharnaz,10,0,20,10
1713339712537,ECE 100,A02,507418,Baghdadchi; Saharnaz,20,0,20,0
1713339713563,ECE 111,A01,507420,Staff,38,0,50,12
1713339714590,ECE 197,001,548057,Sievenpiper; Daniel F.,9998,0,9999,1
1713339715620,EDS 115,A00,507243,Choi; Bailey Miyeon,28,0,28,0
1713339716647,EDS 117,A01,494379,Staff,23,0,25,2
1713339717674,EDS 125,A00,507246,Hopkins; Megan Beth,29,0,30,1
1713339718702,EDS 128A,A01,507264,Fargason; Sharon Gayle,26,0,26,0
1713339719729,EDS 128B,A01,507293,Pappas; Elizabeth,30,0,30,0
1713339720753,EDS 139,A00,507294,Fargason; Sharon Gayle,30,0,30,0
1713339720753,EDS 139,B00,507313,Pappas; Elizabeth,30,0,30,0
1713339721781,EDS 201,A00,507315,Staff,26,0,30,4
1713339722811,EDS 203,A01,507317,Halter; Christopher P.,26,0,30,4
1713339723839,EDS 204R,A01,507319,Halter; Christopher P.,3,0,30,27
1713339723839,EDS 204R,B01,507331,Heinzman; Erica M.,28,0,30,2
1713339724866,EDS 206R,A00,507332,Staff,4,0,30,26
1713339724866,EDS 206R,B00,507343,Staff,28,0,30,2
1713339725896,EDS 250,A00,507344,Hemans; Patricia Ann Benitez,36,0,40,4
1713339726926,EDS 281,A00,507345,Daly; Alan J.,18,0,18,0
1713339727951,EDS 284,A00,507350,Daly; Alan J.,16,0,16,0
1713339728981,EDS 286,A00,507359,Fine; Sarah,18,0,18,0
1713339730006,EDS 289C,A01,507361,Daly; Alan J.,18,0,18,0
1713339731033,EDS 290,A00,507366,Hofstetter; Carolyn,15,0,15,0
1713339732064,LIGM 5A,A00,507421,Fischer-Grunski; Eva K,20,0,20,0
1713339733091,LIGM 5B,A00,507423,Fischer-Grunski; Eva K,20,0,20,0
1713339734118,LIGM 5C,A00,507425,Fischer-Grunski; Eva K,20,0,20,0
1713339735145,LIIT 5AS,A00,507427,Carnelos; Chiara,20,0,20,0
1713339736176,LIIT 5BS,A00,507430,Carnelos; Chiara,20,0,20,0
1713339737206,LIIT 5CS,A00,507432,Carnelos; Chiara,20,0,20,0
1713339738235,LISP 5A,A00,507541,Munoz Sanchez; Alicia,17,0,20,3
1713339739261,LISP 5B,A00,507671,Munoz Sanchez; Alicia,15,0,20,5
1713339740295,LISP 5C,A00,507696,Munoz Sanchez; Alicia,15,0,20,5
1713339741322,MAE 197,001,528363,Boechler; Nicholas Sebastia,9998,0,9999,1
1713339742353,MATH 197,001,523477,Kedlaya; Kiran S.,9999,0,9999,0
1713339742353,MATH 197,002,563811,Zhang; Danna,9999,0,9999,0
1713339743440,MCWP 40R,A00,518780,Staff,20,0,20,0
1713339743440,MCWP 40R,B00,518781,Staff,19,0,20,1
1713339743440,MCWP 40R,C00,518783,Staff,19,0,20,1
1713339744465,MCWP 50R,A00,518791,Staff,20,0,20,0
1713339744465,MCWP 50R,B00,518792,Staff,17,0,20,3
1713339744465,MCWP 50R,C00,518793,Staff,19,0,20,1
1713339744465,MCWP 50R,D00,518794,Staff,16,0,20,4
1713339744465,MCWP 50R,E00,518795,Staff,16,0,20,4
1713339744465,MCWP 50R,F00,518796,Staff,19,0,20,1
1713339744465,MCWP 50R,G00,518797,Staff,19,0,20,1
1713339745493,MMW 12R,A01,514034,Herbst; Matthew,15,0,16,1
1713339745493,MMW 12R,A02,514035,Herbst; Matthew,16,0,16,0
1713339746522,MMW 13R,A01,514037,Staff,12,0,16,4
1713339746522,MMW 13R,A02,514039,Staff,16,0,16,0
1713339748580,SIO 295LS,A00,523233,Staff,19,0,30,11
1713339749606,SIO 295S,A00,523232,Staff,19,0,30,11
1713339750633,SOCI 117,A01,494376,Staff,1,0,5,4
1713339751662,WES 237B,A00,494380,Staff,19,0,20,1
1713339753732,AESE 279B,A00,494370,Wade; Jon P,33,0,33,0
1713339754760,ANAR 135S,A00,494369,Braswell; Geoffrey E.,0,0,0,0
1713339755792,CAT 124RS,A01,519847,Geibel; William,17,0,20,3
1713339756822,CAT 125RS,A01,515971,Geibel; William,17,0,20,3
1713339757855,CLRE 250,A00,511389,Morris; Sheldon,9996,0,9999,3
1713339758885,CLRE 251,A00,507176,Mehta; Ravindra L.,9996,0,9999,3
1713339758885,CLRE 251,B00,511410,Mehta; Ravindra L.,9998,0,9999,1
1713339759913,CLRE 252,A00,507189,Cuomo; Raphael Eduardo,9998,0,9999,1
1713339760941,CLRE 253,A00,507199,Vaida; Florin,9997,0,9999,2
1713339760941,CLRE 253,B00,507202,Vaida; Florin,9999,0,9999,0
1713339761973,CLRE 259,A00,507211,Patel; Hemal,9996,0,9999,3
1713339763001,CLRE 260,A00,507221,Cuomo; Raphael Eduardo,9999,0,9999,0
1713339764028,CLRE 297,001,507242,Cuomo; Raphael Eduardo,9999,0,9999,0
1713339765063,CSE 191,A00,516875,Minnes Kemp; Mor Mia,9999,0,9999,0
1713339766096,CSS 201S,A01,494383,Staff,35,0,35,0
1713339767121,CSS 202S,A01,494387,Staff,35,0,35,0
1713339768151,EAP 100,A00,516065,Staff,9792,0,9999,207
1713339769178,ECE 45,A01,507414,Staff,51,0,60,9
1713339770206,ECE 100,A01,507416,Baghdadchi; Saharnaz,10,0,20,10
1713339770206,ECE 100,A02,507418,Baghdadchi; Saharnaz,20,0,20,0
1713339771230,ECE 111,A01,507420,Staff,38,0,50,12
1713339772257,ECE 197,001,548057,Sievenpiper; Daniel F.,9998,0,9999,1
1713339773290,EDS 115,A00,507243,Choi; Bailey Miyeon,28,0,28,0
1713339774317,EDS 117,A01,494379,Staff,23,0,25,2
1713339775344,EDS 125,A00,507246,Hopkins; Megan Beth,29,0,30,1
1713339776375,EDS 128A,A01,507264,Fargason; Sharon Gayle,26,0,26,0
1713339777407,EDS 128B,A01,507293,Pappas; Elizabeth,30,0,30,0
1713339778434,EDS 139,A00,507294,Fargason; Sharon Gayle,30,0,30,0
1713339778434,EDS 139,B00,507313,Pappas; Elizabeth,30,0,30,0
1713339779463,EDS 201,A00,507315,Staff,26,0,30,4
1713339780488,EDS 203,A01,507317,Halter; Christopher P.,26,0,30,4
1713339781521,EDS 204R,A01,507319,Halter; Christopher P.,3,0,30,27
1713339781521,EDS 204R,B01,507331,Heinzman; Erica M.,28,0,30,2
1713339782548,EDS 206R,A00,507332,Staff,4,0,30,26
1713339782548,EDS 206R,B00,507343,Staff,28,0,30,2
1713339783577,EDS 250,A00,507344,Hemans; Patricia Ann Benitez,36,0,40,4
1713339784609,EDS 281,A00,507345,Daly; Alan J.,18,0,18,0
1713339785636,EDS 284,A00,507350,Daly; Alan J.,16,0,16,0
1713339786668,EDS 286,A00,507359,Fine; Sarah,18,0,18,0
1713339787694,EDS 289C,A01,507361,Daly; Alan J.,18,0,18,0
1713339788721,EDS 290,A00,507366,Hofstetter; Carolyn,15,0,15,0
1713339789746,LIGM 5A,A00,507421,Fischer-Grunski; Eva K,20,0,20,0
1713339790780,LIGM 5B,A00,507423,Fischer-Grunski; Eva K,20,0,20,0
1713339791810,LIGM 5C,A00,507425,Fischer-Grunski; Eva K,20,0,20,0
1713339792837,LIIT 5AS,A00,507427,Carnelos; Chiara,20,0,20,0
1713339793874,LIIT 5BS,A00,507430,Carnelos; Chiara,20,0,20,0
1713339794905,LIIT 5CS,A00,507432,Carnelos; Chiara,20,0,20,0
1713339795931,LISP 5A,A00,507541,Munoz Sanchez; Alicia,17,0,20,3
1713339796958,LISP 5B,A00,507671,Munoz Sanchez; Alicia,15,0,20,5
1713339797985,LISP 5C,A00,507696,Munoz Sanchez; Alicia,15,0,20,5
1713339799012,MAE 197,001,528363,Boechler; Nicholas Sebastia,9998,0,9999,1
1713339800039,MATH 197,001,523477,Kedlaya; Kiran S.,9999,0,9999,0
1713339800039,MATH 197,002,563811,Zhang; Danna,9999,0,9999,0
1713339801068,MCWP 40R,A00,518780,Staff,20,0,20,0
1713339801068,MCWP 40R,B00,518781,Staff,19,0,20,1
1713339801068,MCWP 40R,C00,518783,Staff,19,0,20,1
1713339802096,MCWP 50R,A00,518791,Staff,20,0,20,0
1713339802096,MCWP 50R,B00,518792,Staff,17,0,20,3
1713339802096,MCWP 50R,C00,518793,Staff,19,0,20,1
1713339802096,MCWP 50R,D00,518794,Staff,16,0,20,4
1713339802096,MCWP 50R,E00,518795,Staff,16,0,20,4
1713339802096,MCWP 50R,F00,518796,Staff,19,0,20,1
1713339802096,MCWP 50R,G00,518797,Staff,19,0,20,1
1713339803124,MMW 12R,A01,514034,Herbst; Matthew,15,0,16,1
1713339803124,MMW 12R,A02,514035,Herbst; Matthew,16,0,16,0
1713339804152,MMW 13R,A01,514037,Staff,12,0,16,4
1713339804152,MMW 13R,A02,514039,Staff,16,0,16,0
1713339806261,SIO 295LS,A00,523233,Staff,19,0,30,11
1713339807287,SIO 295S,A00,523232,Staff,19,0,30,11
1713339808315,SOCI 117,A01,494376,Staff,1,0,5,4
1713339809347,WES 237B,A00,494380,Staff,19,0,20,1
1713339811423,AESE 279B,A00,494370,Wade; Jon P,33,0,33,0
1713339812450,ANAR 135S,A00,494369,Braswell; Geoffrey E.,0,0,0,0
1713339813496,CAT 124RS,A01,519847,Geibel; William,17,0,20,3
1713339814522,CAT 125RS,A01,515971,Geibel; William,17,0,20,3
1713339815596,CLRE 250,A00,511389,Morris; Sheldon,9996,0,9999,3
1713339816629,CLRE 251,A00,507176,Mehta; Ravindra L.,9996,0,9999,3
1713339816629,CLRE 251,B00,511410,Mehta; Ravindra L.,9998,0,9999,1
1713339817660,CLRE 252,A00,507189,Cuomo; Raphael Eduardo,9998,0,9999,1
1713339818687,CLRE 253,A00,507199,Vaida; Florin,9997,0,9999,2
1713339818687,CLRE 253,B00,507202,Vaida; Florin,9999,0,9999,0
1713339819714,CLRE 259,A00,507211,Patel; Hemal,9996,0,9999,3
1713339820740,CLRE 260,A00,507221,Cuomo; Raphael Eduardo,9999,0,9999,0
1713339821767,CLRE 297,001,507242,Cuomo; Raphael Eduardo,9999,0,9999,0
1713339822796,CSE 191,A00,516875,Minnes Kemp; Mor Mia,9999,0,9999,0
1713339823822,CSS 201S,A01,494383,Staff,35,0,35,0
1713339824852,CSS 202S,A01,494387,Staff,35,0,35,0
1713339825879,EAP 100,A00,516065,Staff,9792,0,9999,207
1713339826916,ECE 45,A01,507414,Staff,51,0,60,9
1713339827942,ECE 100,A01,507416,Baghdadchi; Saharnaz,10,0,20,10
1713339827942,ECE 100,A02,507418,Baghdadchi; Saharnaz,20,0,20,0
1713339828967,ECE 111,A01,507420,Staff,38,0,50,12
1713339829992,ECE 197,001,548057,Sievenpiper; Daniel F.,9998,0,9999,1
1713339831024,EDS 115,A00,507243,Choi; Bailey Miyeon,28,0,28,0
1713339832051,EDS 117,A01,494379,Staff,23,0,25,2
1713339833077,EDS 125,A00,507246,Hopkins; Megan Beth,29,0,30,1
1713339834108,EDS 128A,A01,507264,Fargason; Sharon Gayle,26,0,26,0
1713339835140,EDS 128B,A01,507293,Pappas; Elizabeth,30,0,30,0
1713339836166,EDS 139,A00,507294,Fargason; Sharon Gayle,30,0,30,0
1713339836166,EDS 139,B00,507313,Pappas; Elizabeth,30,0,30,0
1713339837192,EDS 201,A00,507315,Staff,26,0,30,4
1713339838218,EDS 203,A01,507317,Halter; Christopher P.,26,0,30,4
1713339839246,EDS 204R,A01,507319,Halter; Christopher P.,3,0,30,27
1713339839246,EDS 204R,B01,507331,Heinzman; Erica M.,28,0,30,2
1713339840272,EDS 206R,A00,507332,Staff,4,0,30,26
1713339840272,EDS 206R,B00,507343,Staff,28,0,30,2
1713339841297,EDS 250,A00,507344,Hemans; Patricia Ann Benitez,36,0,40,4
1713339842323,EDS 281,A00,507345,Daly; Alan J.,18,0,18,0
1713339843350,EDS 284,A00,507350,Daly; Alan J.,16,0,16,0
1713339844375,EDS 286,A00,507359,Fine; Sarah,18,0,18,0
1713339845402,EDS 289C,A01,507361,Daly; Alan J.,18,0,18,0
1713339846429,EDS 290,A00,507366,Hofstetter; Carolyn,15,0,15,0
1713339847463,LIGM 5A,A00,507421,Fischer-Grunski; Eva K,20,0,20,0
1713339848496,LIGM 5B,A00,507423,Fischer-Grunski; Eva K,20,0,20,0
1713339849524,LIGM 5C,A00,507425,Fischer-Grunski; Eva K,20,0,20,0
1713339850550,LIIT 5AS,A00,507427,Carnelos; Chiara,20,0,20,0
1713339851580,LIIT 5BS,A00,507430,Carnelos; Chiara,20,0,20,0
1713339852607,LIIT 5CS,A00,507432,Carnelos; Chiara,20,0,20,0
1713339853679,LISP 5A,A00,507541,Munoz Sanchez; Alicia,17,0,20,3
1713339854704,LISP 5B,A00,507671,Munoz Sanchez; Alicia,15,0,20,5
1713339855730,LISP 5C,A00,507696,Munoz Sanchez; Alicia,15,0,20,5
1713339856765,MAE 197,001,528363,Boechler; Nicholas Sebastia,9998,0,9999,1
1713339857792,MATH 197,001,523477,Kedlaya; Kiran S.,9999,0,9999,0
1713339857792,MATH 197,002,563811,Zhang; Danna,9999,0,9999,0
1713339858818,MCWP 40R,A00,518780,Staff,20,0,20,0
1713339858818,MCWP 40R,B00,518781,Staff,19,0,20,1
1713339858818,MCWP 40R,C00,518783,Staff,19,0,20,1
1713339859845,MCWP 50R,A00,518791,Staff,20,0,20,0
1713339859845,MCWP 50R,B00,518792,Staff,17,0,20,3
1713339859845,MCWP 50R,C00,518793,Staff,19,0,20,1
1713339859845,MCWP 50R,D00,518794,Staff,16,0,20,4
1713339859845,MCWP 50R,E00,518795,Staff,16,0,20,4
1713339859845,MCWP 50R,F00,518796,Staff,19,0,20,1
1713339859845,MCWP 50R,G00,518797,Staff,19,0,20,1
1713339860872,MMW 12R,A01,514034,Herbst; Matthew,15,0,16,1
1713339860872,MMW 12R,A02,514035,Herbst; Matthew,16,0,16,0
1713339861898,MMW 13R,A01,514037,Staff,12,0,16,4
1713339861898,MMW 13R,A02,514039,Staff,16,0,16,0
1713339863955,SIO 295LS,A00,523233,Staff,19,0,30,11
1713339864984,SIO 295S,A00,523232,Staff,19,0,30,11
1713339866043,SOCI 117,A01,494376,Staff,1,0,5,4
1713339867069,WES 237B,A00,494380,Staff,19,0,20,1
1713339869155,AESE 279B,A00,494370,Wade; Jon P,33,0,33,0
1713339870181,ANAR 135S,A00,494369,Braswell; Geoffrey E.,0,0,0,0
1713339871207,CAT 124RS,A01,519847,Geibel; William,17,0,20,3
1713339872238,CAT 125RS,A01,515971,Geibel; William,17,0,20,3
1713339873269,CLRE 250,A00,511389,Morris; Sheldon,9996,0,9999,3
1713339874297,CLRE 251,A00,507176,Mehta; Ravindra L.,9996,0,9999,3
1713339874297,CLRE 251,B00,511410,Mehta; Ravindra L.,9998,0,9999,1
1713339875327,CLRE 252,A00,507189,Cuomo; Raphael Eduardo,9998,0,9999,1
1713339876354,CLRE 253,A00,507199,Vaida; Florin,9997,0,9999,2
1713339876354,CLRE 253,B00,507202,Vaida; Florin,9999,0,9999,0
1713339877382,CLRE 259,A00,507211,Patel; Hemal,9996,0,9999,3
1713339878410,CLRE 260,A00,507221,Cuomo; Raphael Eduardo,9999,0,9999,0
1713339879437,CLRE 297,001,507242,Cuomo; Raphael Eduardo,9999,0,9999,0
1713339880463,CSE 191,A00,516875,Minnes Kemp; Mor Mia,9999,0,9999,0
1713339881489,CSS 201S,A01,494383,Staff,35,0,35,0
1713339882514,CSS 202S,A01,494387,Staff,35,0,35,0
1713339883543,EAP 100,A00,516065,Staff,9792,0,9999,207
1713339884570,ECE 45,A01,507414,Staff,51,0,60,9
1713339885596,ECE 100,A01,507416,Baghdadchi; Saharnaz,10,0,20,10
1713339885596,ECE 100,A02,507418,Baghdadchi; Saharnaz,20,0,20,0
1713339886622,ECE 111,A01,507420,Staff,38,0,50,12
1713339887647,ECE 197,001,548057,Sievenpiper; Daniel F.,9998,0,9999,1
1713339888695,EDS 115,A00,507243,Choi; Bailey Miyeon,28,0,28,0
1713339889875,EDS 117,A01,494379,Staff,23,0,25,2
1713339890902,EDS 125,A00,507246,Hopkins; Megan Beth,29,0,30,1
1713339891933,EDS 128A,A01,507264,Fargason; Sharon Gayle,26,0,26,0
1713339892963,EDS 128B,A01,507293,Pappas; Elizabeth,30,0,30,0
1713339893989,EDS 139,A00,507294,Fargason; Sharon Gayle,30,0,30,0
1713339893989,EDS 139,B00,507313,Pappas; Elizabeth,30,0,30,0
1713339895018,EDS 201,A00,507315,Staff,26,0,30,4
1713339896047,EDS 203,A01,507317,Halter; Christopher P.,26,0,30,4
1713339897074,EDS 204R,A01,507319,Halter; Christopher P.,3,0,30,27
1713339897074,EDS 204R,B01,507331,Heinzman; Erica M.,28,0,30,2
1713339898100,EDS 206R,A00,507332,Staff,4,0,30,26
1713339898100,EDS 206R,B00,507343,Staff,28,0,30,2
1713339899129,EDS 250,A00,507344,Hemans; Patricia Ann Benitez,36,0,40,4
1713339900154,EDS 281,A00,507345,Daly; Alan J.,18,0,18,0
1713339901180,EDS 284,A00,507350,Daly; Alan J.,16,0,16,0
1713339902206,EDS 286,A00,507359,Fine; Sarah,18,0,18,0
1713339903234,EDS 289C,A01,507361,Daly; Alan J.,18,0,18,0
1713339904263,EDS 290,A00,507366,Hofstetter; Carolyn,15,0,15,0
1713339905294,LIGM 5A,A00,507421,Fischer-Grunski; Eva K,20,0,20,0
1713339906322,LIGM 5B,A00,507423,Fischer-Grunski; Eva K,20,0,20,0
1713339907347,LIGM 5C,A00,507425,Fischer-Grunski; Eva K,20,0,20,0
1713339908378,LIIT 5AS,A00,507427,Carnelos; Chiara,20,0,20,0
1713339909458,LIIT 5BS,A00,507430,Carnelos; Chiara,20,0,20,0
1713339910487,LIIT 5CS,A00,507432,Carnelos; Chiara,20,0,20,0
1713339911514,LISP 5A,A00,507541,Munoz Sanchez; Alicia,17,0,20,3
1713339912538,LISP 5B,A00,507671,Munoz Sanchez; Alicia,15,0,20,5
1713339913568,LISP 5C,A00,507696,Munoz Sanchez; Alicia,15,0,20,5
1713339914597,MAE 197,001,528363,Boechler; Nicholas Sebastia,9998,0,9999,1
1713339915624,MATH 197,001,523477,Kedlaya; Kiran S.,9999,0,9999,0
1713339915624,MATH 197,002,563811,Zhang; Danna,9999,0,9999,0
1713339916653,MCWP 40R,A00,518780,Staff,20,0,20,0
1713339916653,MCWP 40R,B00,518781,Staff,19,0,20,1
1713339916653,MCWP 40R,C00,518783,Staff,19,0,20,1
1713339917686,MCWP 50R,A00,518791,Staff,20,0,20,0
1713339917686,MCWP 50R,B00,518792,Staff,17,0,20,3
1713339917686,MCWP 50R,C00,518793,Staff,19,0,20,1
1713339917686,MCWP 50R,D00,518794,Staff,16,0,20,4
1713339917686,MCWP 50R,E00,518795,Staff,16,0,20,4
1713339917686,MCWP 50R,F00,518796,Staff,19,0,20,1
1713339917686,MCWP 50R,G00,518797,Staff,19,0,20,1
1713339918712,MMW 12R,A01,514034,Herbst; Matthew,15,0,16,1
1713339918712,MMW 12R,A02,514035,Herbst; Matthew,16,0,16,0
1713339919742,MMW 13R,A01,514037,Staff,12,0,16,4
1713339919742,MMW 13R,A02,514039,Staff,16,0,16,0
1713339921833,SIO 295LS,A00,523233,Staff,19,0,30,11
1713339922860,SIO 295S,A00,523232,Staff,19,0,30,11
1713339923901,SOCI 117,A01,494376,Staff,1,0,5,4
1713339924930,WES 237B,A00,494380,Staff,19,0,20,1
1713339927011,AESE 279B,A00,494370,Wade; Jon P,33,0,33,0
1713339928037,ANAR 135S,A00,494369,Braswell; Geoffrey E.,0,0,0,0
1713339929068,CAT 124RS,A01,519847,Geibel; William,17,0,20,3
1713339930096,CAT 125RS,A01,515971,Geibel; William,17,0,20,3
1713339931122,CLRE 250,A00,511389,Morris; Sheldon,9996,0,9999,3
1713339932150,CLRE 251,A00,507176,Mehta; Ravindra L.,9996,0,9999,3
1713339932150,CLRE 251,B00,511410,Mehta; Ravindra L.,9998,0,9999,1
1713339933176,CLRE 252,A00,507189,Cuomo; Raphael Eduardo,9998,0,9999,1
1713339934207,CLRE 253,A00,507199,Vaida; Florin,9997,0,9999,2
1713339934207,CLRE 253,B00,507202,Vaida; Florin,9999,0,9999,0
1713339935235,CLRE 259,A00,507211,Patel; Hemal,9996,0,9999,3
1713339936264,CLRE 260,A00,507221,Cuomo; Raphael Eduardo,9999,0,9999,0
1713339937289,CLRE 297,001,507242,Cuomo; Raphael Eduardo,9999,0,9999,0
1713339938316,CSE 191,A00,516875,Minnes Kemp; Mor Mia,9999,0,9999,0
1713339939345,CSS 201S,A01,494383,Staff,35,0,35,0
1713339940370,CSS 202S,A01,494387,Staff,35,0,35,0
1713339941402,EAP 100,A00,516065,Staff,9792,0,9999,207
1713339942428,ECE 45,A01,507414,Staff,51,0,60,9
1713339943459,ECE 100,A01,507416,Baghdadchi; Saharnaz,10,0,20,10
1713339943459,ECE 100,A02,507418,Baghdadchi; Saharnaz,20,0,20,0
1713339944488,ECE 111,A01,507420,Staff,38,0,50,12
1713339945514,ECE 197,001,548057,Sievenpiper; Daniel F.,9998,0,9999,1
1713339946544,EDS 115,A00,507243,Choi; Bailey Miyeon,28,0,28,0
1713339947753,EDS 117,A01,494379,Staff,23,0,25,2
1713339948780,EDS 125,A00,507246,Hopkins; Megan Beth,29,0,30,1
1713339949806,EDS 128A,A01,507264,Fargason; Sharon Gayle,26,0,26,0
1713339950833,EDS 128B,A01,507293,Pappas; Elizabeth,30,0,30,0
1713339951860,EDS 139,A00,507294,Fargason; Sharon Gayle,30,0,30,0
1713339951860,EDS 139,B00,507313,Pappas; Elizabeth,30,0,30,0
1713339952888,EDS 201,A00,507315,Staff,26,0,30,4
1713339953915,EDS 203,A01,507317,Halter; Christopher P.,26,0,30,4
1713339954947,EDS 204R,A01,507319,Halter; Christopher P.,3,0,30,27
1713339954947,EDS 204R,B01,507331,Heinzman; Erica M.,28,0,30,2
1713339955972,EDS 206R,A00,507332,Staff,4,0,30,26
1713339955972,EDS 206R,B00,507343,Staff,28,0,30,2
1713339957003,EDS 250,A00,507344,Hemans; Patricia Ann Benitez,36,0,40,4
1713339958029,EDS 281,A00,507345,Daly; Alan J.,18,0,18,0
1713339959057,EDS 284,A00,507350,Daly; Alan J.,16,0,16,0
1713339960109,EDS 286,A00,507359,Fine; Sarah,18,0,18,0
1713339961136,EDS 289C,A01,507361,Daly; Alan J.,18,0,18,0
1713339962168,EDS 290,A00,507366,Hofstetter; Carolyn,15,0,15,0
1713339963200,LIGM 5A,A00,507421,Fischer-Grunski; Eva K,20,0,20,0
1713339964229,LIGM 5B,A00,507423,Fischer-Grunski; Eva K,20,0,20,0
1713339965262,LIGM 5C,A00,507425,Fischer-Grunski; Eva K,20,0,20,0
1713339966293,LIIT 5AS,A00,507427,Carnelos; Chiara,20,0,20,0
1713339967323,LIIT 5BS,A00,507430,Carnelos; Chiara,20,0,20,0
1713339968355,LIIT 5CS,A00,507432,Carnelos; Chiara,20,0,20,0
1713339969385,LISP 5A,A00,507541,Munoz Sanchez; Alicia,17,0,20,3
1713339970411,LISP 5B,A00,507671,Munoz Sanchez; Alicia,15,0,20,5
1713339971442,LISP 5C,A00,507696,Munoz Sanchez; Alicia,15,0,20,5
1713339972477,MAE 197,001,528363,Boechler; Nicholas Sebastia,9998,0,9999,1
1713339973509,MATH 197,001,523477,Kedlaya; Kiran S.,9999,0,9999,0
1713339973509,MATH 197,002,563811,Zhang; Danna,9999,0,9999,0
1713339974535,MCWP 40R,A00,518780,Staff,20,0,20,0
1713339974535,MCWP 40R,B00,518781,Staff,19,0,20,1
1713339974535,MCWP 40R,C00,518783,Staff,19,0,20,1
1713339975591,MCWP 50R,A00,518791,Staff,20,0,20,0
1713339975591,MCWP 50R,B00,518792,Staff,17,0,20,3
1713339975591,MCWP 50R,C00,518793,Staff,19,0,20,1
1713339975591,MCWP 50R,D00,518794,Staff,16,0,20,4
1713339975591,MCWP 50R,E00,518795,Staff,16,0,20,4
1713339975591,MCWP 50R,F00,518796,Staff,19,0,20,1
1713339975591,MCWP 50R,G00,518797,Staff,19,0,20,1
1713339976622,MMW 12R,A01,514034,Herbst; Matthew,15,0,16,1
1713339976622,MMW 12R,A02,514035,Herbst; Matthew,16,0,16,0
1713339977653,MMW 13R,A01,514037,Staff,12,0,16,4
1713339977653,MMW 13R,A02,514039,Staff,16,0,16,0
1713339979704,SIO 295LS,A00,523233,Staff,19,0,30,11
1713339980730,SIO 295S,A00,523232,Staff,19,0,30,11
1713339981863,SOCI 117,A01,494376,Staff,1,0,5,4
1713339982893,WES 237B,A00,494380,Staff,19,0,20,1
1713339984971,AESE 279B,A00,494370,Wade; Jon P,33,0,33,0
1713339986000,ANAR 135S,A00,494369,Braswell; Geoffrey E.,0,0,0,0
1713339987027,CAT 124RS,A01,519847,Geibel; William,17,0,20,3
1713339988053,CAT 125RS,A01,515971,Geibel; William,17,0,20,3
1713339989084,CLRE 250,A00,511389,Morris; Sheldon,9996,0,9999,3
1713339990121,CLRE 251,A00,507176,Mehta; Ravindra L.,9996,0,9999,3
1713339990121,CLRE 251,B00,511410,Mehta; Ravindra L.,9998,0,9999,1
1713339991152,CLRE 252,A00,507189,Cuomo; Raphael Eduardo,9998,0,9999,1
1713339992222,CLRE 253,A00,507199,Vaida; Florin,9997,0,9999,2
1713339992222,CLRE 253,B00,507202,Vaida; Florin,9999,0,9999,0
1713339993248,CLRE 259,A00,507211,Patel; Hemal,9996,0,9999,3
1713339994274,CLRE 260,A00,507221,Cuomo; Raphael Eduardo,9999,0,9999,0
1713339995299,CLRE 297,001,507242,Cuomo; Raphael Eduardo,9999,0,9999,0
1713339996329,CSE 191,A00,516875,Minnes Kemp; Mor Mia,9999,0,9999,0
1713339997402,CSS 201S,A01,494383,Staff,35,0,35,0
1713339998428,CSS 202S,A01,494387,Staff,35,0,35,0
1713339999455,EAP 100,A00,516065,Staff,9792,0,9999,207
1713340000483,ECE 45,A01,507414,Staff,51,0,60,9
1713340001510,ECE 100,A01,507416,Baghdadchi; Saharnaz,10,0,20,10
1713340001510,ECE 100,A02,507418,Baghdadchi; Saharnaz,20,0,20,0
1713340002536,ECE 111,A01,507420,Staff,38,0,50,12
1713340003562,ECE 197,001,548057,Sievenpiper; Daniel F.,9998,0,9999,1
1713340004590,EDS 115,A00,507243,Choi; Bailey Miyeon,28,0,28,0
1713340005619,EDS 117,A01,494379,Staff,23,0,25,2
1713340006646,EDS 125,A00,507246,Hopkins; Megan Beth,29,0,30,1
1713340007672,EDS 128A,A01,507264,Fargason; Sharon Gayle,26,0,26,0
1713340008698,EDS 128B,A01,507293,Pappas; Elizabeth,30,0,30,0
1713340009725,EDS 139,A00,507294,Fargason; Sharon Gayle,30,0,30,0
1713340009725,EDS 139,B00,507313,Pappas; Elizabeth,30,0,30,0
1713340010751,EDS 201,A00,507315,Staff,26,0,30,4
1713340011781,EDS 203,A01,507317,Halter; Christopher P.,26,0,30,4
1713340012809,EDS 204R,A01,507319,Halter; Christopher P.,3,0,30,27
1713340012809,EDS 204R,B01,507331,Heinzman; Erica M.,28,0,30,2
1713340013903,EDS 206R,A00,507332,Staff,4,0,30,26
1713340013903,EDS 206R,B00,507343,Staff,28,0,30,2
1713340014929,EDS 250,A00,507344,Hemans; Patricia Ann Benitez,36,0,40,4
1713340015955,EDS 281,A00,507345,Daly; Alan J.,18,0,18,0
1713340016985,EDS 284,A00,507350,Daly; Alan J.,16,0,16,0
1713340018011,EDS 286,A00,507359,Fine; Sarah,18,0,18,0
1713340019042,EDS 289C,A01,507361,Daly; Alan J.,18,0,18,0
1713340020071,EDS 290,A00,507366,Hofstetter; Carolyn,15,0,15,0
1713340021112,LIGM 5A,A00,507421,Fischer-Grunski; Eva K,20,0,20,0
1713340022138,LIGM 5B,A00,507423,Fischer-Grunski; Eva K,20,0,20,0
1713340023277,LIGM 5C,A00,507425,Fischer-Grunski; Eva K,20,0,20,0
1713340024311,LIIT 5AS,A00,507427,Carnelos; Chiara,20,0,20,0
1713340025337,LIIT 5BS,A00,507430,Carnelos; Chiara,20,0,20,0
1713340026365,LIIT 5CS,A00,507432,Carnelos; Chiara,20,0,20,0
1713340027390,LISP 5A,A00,507541,Munoz Sanchez; Alicia,17,0,20,3
1713340028419,LISP 5B,A00,507671,Munoz Sanchez; Alicia,15,0,20,5
1713340029445,LISP 5C,A00,507696,Munoz Sanchez; Alicia,15,0,20,5
1713340030471,MAE 197,001,528363,Boechler; Nicholas Sebastia,9998,0,9999,1
1713340031503,MATH 197,001,523477,Kedlaya; Kiran S.,9999,0,9999,0
1713340031503,MATH 197,002,563811,Zhang; Danna,9999,0,9999,0
1713340032533,MCWP 40R,A00,518780,Staff,20,0,20,0
1713340032533,MCWP 40R,B00,518781,Staff,19,0,20,1
1713340032533,MCWP 40R,C00,518783,Staff,19,0,20,1
1713340033564,MCWP 50R,A00,518791,Staff,20,0,20,0
1713340033564,MCWP 50R,B00,518792,Staff,17,0,20,3
1713340033564,MCWP 50R,C00,518793,Staff,19,0,20,1
1713340033564,MCWP 50R,D00,518794,Staff,16,0,20,4
1713340033564,MCWP 50R,E00,518795,Staff,16,0,20,4
1713340033564,MCWP 50R,F00,518796,Staff,19,0,20,1
1713340033564,MCWP 50R,G00,518797,Staff,19,0,20,1
1713340034589,MMW 12R,A01,514034,Herbst; Matthew,15,0,16,1
1713340034589,MMW 12R,A02,514035,Herbst; Matthew,16,0,16,0
1713340035619,MMW 13R,A01,514037,Staff,12,0,16,4
1713340035619,MMW 13R,A02,514039,Staff,16,0,16,0
1713340037710,SIO 295LS,A00,523233,Staff,19,0,30,11
1713340038735,SIO 295S,A00,523232,Staff,19,0,30,11
1713340039822,SOCI 117,A01,494376,Staff,1,0,5,4
1713340040848,WES 237B,A00,494380,Staff,19,0,20,1
1713340042917,AESE 279B,A00,494370,Wade; Jon P,33,0,33,0
1713340043943,ANAR 135S,A00,494369,Braswell; Geoffrey E.,0,0,0,0
1713340044970,CAT 124RS,A01,519847,Geibel; William,17,0,20,3
1713340046001,CAT 125RS,A01,515971,Geibel; William,17,0,20,3
1713340047029,CLRE 250,A00,511389,Morris; Sheldon,9996,0,9999,3
1713340048057,CLRE 251,A00,507176,Mehta; Ravindra L.,9996,0,9999,3
1713340048057,CLRE 251,B00,511410,Mehta; Ravindra L.,9998,0,9999,1
1713340049085,CLRE 252,A00,507189,Cuomo; Raphael Eduardo,9998,0,9999,1
1713340050113,CLRE 253,A00,507199,Vaida; Florin,9997,0,9999,2
1713340050113,CLRE 253,B00,507202,Vaida; Florin,9999,0,9999,0
1713340051139,CLRE 259,A00,507211,Patel; Hemal,9996,0,9999,3
1713340052165,CLRE 260,A00,507221,Cuomo; Raphael Eduardo,9999,0,9999,0
1713340053195,CLRE 297,001,507242,Cuomo; Raphael Eduardo,9999,0,9999,0
1713340054222,CSE 191,A00,516875,Minnes Kemp; Mor Mia,9999,0,9999,0
1713340055252,CSS 201S,A01,494383,Staff,35,0,35,0
1713340056279,CSS 202S,A01,494387,Staff,35,0,35,0
1713340057305,EAP 100,A00,516065,Staff,9792,0,9999,207
1713340058333,ECE 45,A01,507414,Staff,51,0,60,9
1713340059358,ECE 100,A01,507416,Baghdadchi; Saharnaz,10,0,20,10
1713340059358,ECE 100,A02,507418,Baghdadchi; Saharnaz,20,0,20,0
1713340060390,ECE 111,A01,507420,Staff,38,0,50,12
1713340061421,ECE 197,001,548057,Sievenpiper; Daniel F.,9998,0,9999,1
1713340062449,EDS 115,A00,507243,Choi; Bailey Miyeon,28,0,28,0
1713340063478,EDS 117,A01,494379,Staff,23,0,25,2
1713340064510,EDS 125,A00,507246,Hopkins; Megan Beth,29,0,30,1
1713340065538,EDS 128A,A01,507264,Fargason; Sharon Gayle,26,0,26,0
1713340066570,EDS 128B,A01,507293,Pappas; Elizabeth,30,0,30,0
1713340067597,EDS 139,A00,507294,Fargason; Sharon Gayle,30,0,30,0
1713340067597,EDS 139,B00,507313,Pappas; Elizabeth,30,0,30,0
1713340068627,EDS 201,A00,507315,Staff,26,0,30,4
1713340069655,EDS 203,A01,507317,Halter; Christopher P.,26,0,30,4
1713340070691,EDS 204R,A01,507319,Halter; Christopher P.,3,0,30,27
1713340070691,EDS 204R,B01,507331,Heinzman; Erica M.,28,0,30,2
1713340071719,EDS 206R,A00,507332,Staff,4,0,30,26
1713340071719,EDS 206R,B00,507343,Staff,28,0,30,2
1713340072750,EDS 250,A00,507344,Hemans; Patricia Ann Benitez,36,0,40,4
1713340073779,EDS 281,A00,507345,Daly; Alan J.,18,0,18,0
1713340074807,EDS 284,A00,507350,Daly; Alan J.,16,0,16,0
1713340075835,EDS 286,A00,507359,Fine; Sarah,18,0,18,0
1713340076861,EDS 289C,A01,507361,Daly; Alan J.,18,0,18,0
1713340077887,EDS 290,A00,507366,Hofstetter; Carolyn,15,0,15,0
1713340078913,LIGM 5A,A00,507421,Fischer-Grunski; Eva K,20,0,20,0
1713340079944,LIGM 5B,A00,507423,Fischer-Grunski; Eva K,20,0,20,0
1713340080971,LIGM 5C,A00,507425,Fischer-Grunski; Eva K,20,0,20,0
1713340082001,LIIT 5AS,A00,507427,Carnelos; Chiara,20,0,20,0
1713340083027,LIIT 5BS,A00,507430,Carnelos; Chiara,20,0,20,0
1713340084059,LIIT 5CS,A00,507432,Carnelos; Chiara,20,0,20,0
1713340085091,LISP 5A,A00,507541,Munoz Sanchez; Alicia,17,0,20,3
1713340086117,LISP 5B,A00,507671,Munoz Sanchez; Alicia,15,0,20,5
1713340087147,LISP 5C,A00,507696,Munoz Sanchez; Alicia,15,0,20,5
1713340088174,MAE 197,001,528363,Boechler; Nicholas Sebastia,9998,0,9999,1
1713340089201,MATH 197,001,523477,Kedlaya; Kiran S.,9999,0,9999,0
1713340089201,MATH 197,002,563811,Zhang; Danna,9999,0,9999,0
1713340090232,MCWP 40R,A00,518780,Staff,20,0,20,0
1713340090232,MCWP 40R,B00,518781,Staff,19,0,20,1
1713340090232,MCWP 40R,C00,518783,Staff,19,0,20,1
1713340091262,MCWP 50R,A00,518791,Staff,20,0,20,0
1713340091262,MCWP 50R,B00,518792,Staff,17,0,20,3
1713340091262,MCWP 50R,C00,518793,Staff,19,0,20,1
1713340091262,MCWP 50R,D00,518794,Staff,16,0,20,4
1713340091262,MCWP 50R,E00,518795,Staff,16,0,20,4
1713340091262,MCWP 50R,F00,518796,Staff,19,0,20,1
1713340091262,MCWP 50R,G00,518797,Staff,19,0,20,1
1713340092288,MMW 12R,A01,514034,Herbst; Matthew,15,0,16,1
1713340092288,MMW 12R,A02,514035,Herbst; Matthew,16,0,16,0
1713340093318,MMW 13R,A01,514037,Staff,12,0,16,4
1713340093318,MMW 13R,A02,514039,Staff,16,0,16,0
1713340095371,SIO 295LS,A00,523233,Staff,19,0,30,11
1713340096397,SIO 295S,A00,523232,Staff,19,0,30,11
1713340097428,SOCI 117,A01,494376,Staff,1,0,5,4
1713340098454,WES 237B,A00,494380,Staff,19,0,20,1
1713340100526,AESE 279B,A00,494370,Wade; Jon P,33,0,33,0
1713340101554,ANAR 135S,A00,494369,Braswell; Geoffrey E.,0,0,0,0
1713340102579,CAT 124RS,A01,519847,Geibel; William,17,0,20,3
1713340103604,CAT 125RS,A01,515971,Geibel; William,17,0,20,3
1713340104630,CLRE 250,A00,511389,Morris; Sheldon,9996,0,9999,3
1713340105661,CLRE 251,A00,507176,Mehta; Ravindra L.,9996,0,9999,3
1713340105661,CLRE 251,B00,511410,Mehta; Ravindra L.,9998,0,9999,1
1713340106687,CLRE 252,A00,507189,Cuomo; Raphael Eduardo,9998,0,9999,1
1713340107714,CLRE 253,A00,507199,Vaida; Florin,9997,0,9999,2
1713340107714,CLRE 253,B00,507202,Vaida; Florin,9999,0,9999,0
1713340108744,CLRE 259,A00,507211,Patel; Hemal,9996,0,9999,3
1713340109770,CLRE 260,A00,507221,Cuomo; Raphael Eduardo,9999,0,9999,0
1713340110795,CLRE 297,001,507242,Cuomo; Raphael Eduardo,9999,0,9999,0
1713340111826,CSE 191,A00,516875,Minnes Kemp; Mor Mia,9999,0,9999,0
1713340112857,CSS 201S,A01,494383,Staff,35,0,35,0
1713340113892,CSS 202S,A01,494387,Staff,35,0,35,0
1713340114921,EAP 100,A00,516065,Staff,9792,0,9999,207
1713340115946,ECE 45,A01,507414,Staff,51,0,60,9
1713340116973,ECE 100,A01,507416,Baghdadchi; Saharnaz,10,0,20,10
1713340116973,ECE 100,A02,507418,Baghdadchi; Saharnaz,20,0,20,0
1713340118053,ECE 111,A01,507420,Staff,38,0,50,12
1713340119081,ECE 197,001,548057,Sievenpiper; Daniel F.,9998,0,9999,1
1713340120109,EDS 115,A00,507243,Choi; Bailey Miyeon,28,0,28,0
1713340121137,EDS 117,A01,494379,Staff,23,0,25,2
1713340122164,EDS 125,A00,507246,Hopkins; Megan Beth,29,0,30,1
1713340123195,EDS 128A,A01,507264,Fargason; Sharon Gayle,26,0,26,0
1713340124226,EDS 128B,A01,507293,Pappas; Elizabeth,30,0,30,0
1713340125249,EDS 139,A00,507294,Fargason; Sharon Gayle,30,0,30,0
1713340125249,EDS 139,B00,507313,Pappas; Elizabeth,30,0,30,0
1713340126280,EDS 201,A00,507315,Staff,26,0,30,4
1713340127307,EDS 203,A01,507317,Halter; Christopher P.,26,0,30,4
1713340128336,EDS 204R,A01,507319,Halter; Christopher P.,3,0,30,27
1713340128336,EDS 204R,B01,507331,Heinzman; Erica M.,28,0,30,2
1713340129361,EDS 206R,A00,507332,Staff,4,0,30,26
1713340129361,EDS 206R,B00,507343,Staff,28,0,30,2
1713340130389,EDS 250,A00,507344,Hemans; Patricia Ann Benitez,36,0,40,4
1713340131412,EDS 281,A00,507345,Daly; Alan J.,18,0,18,0
1713340132436,EDS 284,A00,507350,Daly; Alan J.,16,0,16,0
1713340133463,EDS 286,A00,507359,Fine; Sarah,18,0,18,0
1713340134486,EDS 289C,A01,507361,Daly; Alan J.,18,0,18,0
1713340135511,EDS 290,A00,507366,Hofstetter; Carolyn,15,0,15,0
1713340136538,LIGM 5A,A00,507421,Fischer-Grunski; Eva K,20,0,20,0
1713340137563,LIGM 5B,A00,507423,Fischer-Grunski; Eva K,20,0,20,0
1713340138590,LIGM 5C,A00,507425,Fischer-Grunski; Eva K,20,0,20,0
1713340139622,LIIT 5AS,A00,507427,Carnelos; Chiara,20,0,20,0
1713340140650,LIIT 5BS,A00,507430,Carnelos; Chiara,20,0,20,0
1713340141676,LIIT 5CS,A00,507432,Carnelos; Chiara,20,0,20,0
1713340142703,LISP 5A,A00,507541,Munoz Sanchez; Alicia,17,0,20,3
1713340143732,LISP 5B,A00,507671,Munoz Sanchez; Alicia,15,0,20,5
1713340144762,LISP 5C,A00,507696,Munoz Sanchez; Alicia,15,0,20,5
1713340145789,MAE 197,001,528363,Boechler; Nicholas Sebastia,9998,0,9999,1
1713340146817,MATH 197,001,523477,Kedlaya; Kiran S.,9999,0,9999,0
1713340146817,MATH 197,002,563811,Zhang; Danna,9999,0,9999,0
1713340147842,MCWP 40R,A00,518780,Staff,20,0,20,0
1713340147842,MCWP 40R,B00,518781,Staff,19,0,20,1
1713340147842,MCWP 40R,C00,518783,Staff,19,0,20,1
1713340148875,MCWP 50R,A00,518791,Staff,20,0,20,0
1713340148875,MCWP 50R,B00,518792,Staff,17,0,20,3
1713340148875,MCWP 50R,C00,518793,Staff,19,0,20,1
1713340148875,MCWP 50R,D00,518794,Staff,16,0,20,4
1713340148875,MCWP 50R,E00,518795,Staff,16,0,20,4
1713340148875,MCWP 50R,F00,518796,Staff,19,0,20,1
1713340148875,MCWP 50R,G00,518797,Staff,19,0,20,1
1713340149901,MMW 12R,A01,514034,Herbst; Matthew,15,0,16,1
1713340149901,MMW 12R,A02,514035,Herbst; Matthew,16,0,16,0
1713340150929,MMW 13R,A01,514037,Staff,12,0,16,4
1713340150929,MMW 13R,A02,514039,Staff,16,0,16,0
1713340152982,SIO 295LS,A00,523233,Staff,19,0,30,11
1713340154011,SIO 295S,A00,523232,Staff,19,0,30,11
1713340155045,SOCI 117,A01,494376,Staff,1,0,5,4
1713340156070,WES 237B,A00,494380,Staff,19,0,20,1
1713340158147,AESE 279B,A00,494370,Wade; Jon P,33,0,33,0
1713340159176,ANAR 135S,A00,494369,Braswell; Geoffrey E.,0,0,0,0
1713340160201,CAT 124RS,A01,519847,Geibel; William,17,0,20,3
1713340161231,CAT 125RS,A01,515971,Geibel; William,17,0,20,3
1713340162258,CLRE 250,A00,511389,Morris; Sheldon,9996,0,9999,3
1713340163292,CLRE 251,A00,507176,Mehta; Ravindra L.,9996,0,9999,3
1713340163292,CLRE 251,B00,511410,Mehta; Ravindra L.,9998,0,9999,1
1713340164321,CLRE 252,A00,507189,Cuomo; Raphael Eduardo,9998,0,9999,1
1713340165354,CLRE 253,A00,507199,Vaida; Florin,9997,0,9999,2
1713340165354,CLRE 253,B00,507202,Vaida; Florin,9999,0,9999,0
1713340166380,CLRE 259,A00,507211,Patel; Hemal,9996,0,9999,3
1713340167411,CLRE 260,A00,507221,Cuomo; Raphael Eduardo,9999,0,9999,0
1713340168436,CLRE 297,001,507242,Cuomo; Raphael Eduardo,9999,0,9999,0
1713340169463,CSE 191,A00,516875,Minnes Kemp; Mor Mia,9999,0,9999,0
1713340170521,CSS 201S,A01,494383,Staff,35,0,35,0
1713340171548,CSS 202S,A01,494387,Staff,35,0,35,0
1713340172579,EAP 100,A00,516065,Staff,9792,0,9999,207
1713340173709,ECE 45,A01,507414,Staff,51,0,60,9
1713340174740,ECE 100,A01,507416,Baghdadchi; Saharnaz,10,0,20,10
1713340174740,ECE 100,A02,507418,Baghdadchi; Saharnaz,20,0,20,0
1713340175768,ECE 111,A01,507420,Staff,38,0,50,12
1713340176802,ECE 197,001,548057,Sievenpiper; Daniel F.,9998,0,9999,1
1713340177835,EDS 115,A00,507243,Choi; Bailey Miyeon,28,0,28,0
1713340178867,EDS 117,A01,494379,Staff,23,0,25,2
1713340179897,EDS 125,A00,507246,Hopkins; Megan Beth,29,0,30,1
1713340180924,EDS 128A,A01,507264,Fargason; Sharon Gayle,26,0,26,0
1713340181951,EDS 128B,A01,507293,Pappas; Elizabeth,30,0,30,0
1713340182977,EDS 139,A00,507294,Fargason; Sharon Gayle,30,0,30,0
1713340182977,EDS 139,B00,507313,Pappas; Elizabeth,30,0,30,0
1713340184006,EDS 201,A00,507315,Staff,26,0,30,4
1713340185033,EDS 203,A01,507317,Halter; Christopher P.,26,0,30,4
1713340186060,EDS 204R,A01,507319,Halter; Christopher P.,3,0,30,27
1713340186060,EDS 204R,B01,507331,Heinzman; Erica M.,28,0,30,2
1713340187085,EDS 206R,A00,507332,Staff,4,0,30,26
1713340187085,EDS 206R,B00,507343,Staff,28,0,30,2
1713340188112,EDS 250,A00,507344,Hemans; Patricia Ann Benitez,36,0,40,4
1713340189138,EDS 281,A00,507345,Daly; Alan J.,18,0,18,0
1713340190163,EDS 284,A00,507350,Daly; Alan J.,16,0,16,0
1713340191189,EDS 286,A00,507359,Fine; Sarah,18,0,18,0
1713340192219,EDS 289C,A01,507361,Daly; Alan J.,18,0,18,0
1713340193249,EDS 290,A00,507366,Hofstetter; Carolyn,15,0,15,0
1713340194280,LIGM 5A,A00,507421,Fischer-Grunski; Eva K,20,0,20,0
1713340195304,LIGM 5B,A00,507423,Fischer-Grunski; Eva K,20,0,20,0
1713340196329,LIGM 5C,A00,507425,Fischer-Grunski; Eva K,20,0,20,0
1713340197354,LIIT 5AS,A00,507427,Carnelos; Chiara,20,0,20,0
1713340198384,LIIT 5BS,A00,507430,Carnelos; Chiara,20,0,20,0
1713340199415,LIIT 5CS,A00,507432,Carnelos; Chiara,20,0,20,0
1713340200449,LISP 5A,A00,507541,Munoz Sanchez; Alicia,17,0,20,3
1713340201473,LISP 5B,A00,507671,Munoz Sanchez; Alicia,15,0,20,5
1713340202560,LISP 5C,A00,507696,Munoz Sanchez; Alicia,15,0,20,5
1713340203592,MAE 197,001,528363,Boechler; Nicholas Sebastia,9998,0,9999,1
1713340204621,MATH 197,001,523477,Kedlaya; Kiran S.,9999,0,9999,0
1713340204621,MATH 197,002,563811,Zhang; Danna,9999,0,9999,0
1713340205654,MCWP 40R,A00,518780,Staff,20,0,20,0
1713340205654,MCWP 40R,B00,518781,Staff,19,0,20,1
1713340205654,MCWP 40R,C00,518783,Staff,19,0,20,1
1713340206686,MCWP 50R,A00,518791,Staff,20,0,20,0
1713340206686,MCWP 50R,B00,518792,Staff,17,0,20,3
1713340206686,MCWP 50R,C00,518793,Staff,19,0,20,1
1713340206686,MCWP 50R,D00,518794,Staff,16,0,20,4
1713340206686,MCWP 50R,E00,518795,Staff,16,0,20,4
1713340206686,MCWP 50R,F00,518796,Staff,19,0,20,1
1713340206686,MCWP 50R,G00,518797,Staff,19,0,20,1
1713340207714,MMW 12R,A01,514034,Herbst; Matthew,15,0,16,1
1713340207714,MMW 12R,A02,514035,Herbst; Matthew,16,0,16,0
1713340208739,MMW 13R,A01,514037,Staff,12,0,16,4
1713340208739,MMW 13R,A02,514039,Staff,16,0,16,0
1713340210803,SIO 295LS,A00,523233,Staff,19,0,30,11
1713340211833,SIO 295S,A00,523232,Staff,19,0,30,11
1713340212865,SOCI 117,A01,494376,Staff,1,0,5,4
1713340213905,WES 237B,A00,494380,Staff,19,0,20,1
1713340215980,AESE 279B,A00,494370,Wade; Jon P,33,0,33,0
1713340217006,ANAR 135S,A00,494369,Braswell; Geoffrey E.,0,0,0,0
1713340218033,CAT 124RS,A01,519847,Geibel; William,17,0,20,3
1713340219059,CAT 125RS,A01,515971,Geibel; William,17,0,20,3
1713340220096,CLRE 250,A00,511389,Morris; Sheldon,9996,0,9999,3
1713340221124,CLRE 251,A00,507176,Mehta; Ravindra L.,9996,0,9999,3
1713340221124,CLRE 251,B00,511410,Mehta; Ravindra L.,9998,0,9999,1
1713340222211,CLRE 252,A00,507189,Cuomo; Raphael Eduardo,9998,0,9999,1
1713340223238,CLRE 253,A00,507199,Vaida; Florin,9997,0,9999,2
1713340223238,CLRE 253,B00,507202,Vaida; Florin,9999,0,9999,0
1713340224270,CLRE 259,A00,507211,Patel; Hemal,9996,0,9999,3
1713340225300,CLRE 260,A00,507221,Cuomo; Raphael Eduardo,9999,0,9999,0
1713340226329,CLRE 297,001,507242,Cuomo; Raphael Eduardo,9999,0,9999,0
1713340227356,CSE 191,A00,516875,Minnes Kemp; Mor Mia,9999,0,9999,0
1713340228384,CSS 201S,A01,494383,Staff,35,0,35,0
1713340229408,CSS 202S,A01,494387,Staff,35,0,35,0
1713340230433,EAP 100,A00,516065,Staff,9792,0,9999,207
1713340231459,ECE 45,A01,507414,Staff,51,0,60,9
1713340232486,ECE 100,A01,507416,Baghdadchi; Saharnaz,10,0,20,10
1713340232486,ECE 100,A02,507418,Baghdadchi; Saharnaz,20,0,20,0
1713340233511,ECE 111,A01,507420,Staff,38,0,50,12
1713340234540,ECE 197,001,548057,Sievenpiper; Daniel F.,9998,0,9999,1
1713340235571,EDS 115,A00,507243,Choi; Bailey Miyeon,28,0,28,0
1713340236601,EDS 117,A01,494379,Staff,23,0,25,2
1713340237631,EDS 125,A00,507246,Hopkins; Megan Beth,29,0,30,1
1713340238663,EDS 128A,A01,507264,Fargason; Sharon Gayle,26,0,26,0
1713340239691,EDS 128B,A01,507293,Pappas; Elizabeth,30,0,30,0
1713340240720,EDS 139,A00,507294,Fargason; Sharon Gayle,30,0,30,0
1713340240720,EDS 139,B00,507313,Pappas; Elizabeth,30,0,30,0
1713340241748,EDS 201,A00,507315,Staff,26,0,30,4
1713340242776,EDS 203,A01,507317,Halter; Christopher P.,26,0,30,4
1713340243806,EDS 204R,A01,507319,Halter; Christopher P.,3,0,30,27
1713340243806,EDS 204R,B01,507331,Heinzman; Erica M.,28,0,30,2
1713340244831,EDS 206R,A00,507332,Staff,4,0,30,26
1713340244831,EDS 206R,B00,507343,Staff,28,0,30,2
1713340245859,EDS 250,A00,507344,Hemans; Patricia Ann Benitez,36,0,40,4
1713340246885,EDS 281,A00,507345,Daly; Alan J.,18,0,18,0
1713340247912,EDS 284,A00,507350,Daly; Alan J.,16,0,16,0
1713340248938,EDS 286,A00,507359,Fine; Sarah,18,0,18,0
1713340249968,EDS 289C,A01,507361,Daly; Alan J.,18,0,18,0
1713340251000,EDS 290,A00,507366,Hofstetter; Carolyn,15,0,15,0
1713340252027,LIGM 5A,A00,507421,Fischer-Grunski; Eva K,20,0,20,0
1713340253057,LIGM 5B,A00,507423,Fischer-Grunski; Eva K,20,0,20,0
1713340254088,LIGM 5C,A00,507425,Fischer-Grunski; Eva K,20,0,20,0
1713340255113,LIIT 5AS,A00,507427,Carnelos; Chiara,20,0,20,0
1713340256140,LIIT 5BS,A00,507430,Carnelos; Chiara,20,0,20,0
1713340257171,LIIT 5CS,A00,507432,Carnelos; Chiara,20,0,20,0
1713340258198,LISP 5A,A00,507541,Munoz Sanchez; Alicia,17,0,20,3
1713340259228,LISP 5B,A00,507671,Munoz Sanchez; Alicia,15,0,20,5
1713340260259,LISP 5C,A00,507696,Munoz Sanchez; Alicia,15,0,20,5
1713340261298,MAE 197,001,528363,Boechler; Nicholas Sebastia,9998,0,9999,1
1713340262326,MATH 197,001,523477,Kedlaya; Kiran S.,9999,0,9999,0
1713340262326,MATH 197,002,563811,Zhang; Danna,9999,0,9999,0
1713340263354,MCWP 40R,A00,518780,Staff,20,0,20,0
1713340263354,MCWP 40R,B00,518781,Staff,19,0,20,1
1713340263354,MCWP 40R,C00,518783,Staff,19,0,20,1
1713340264389,MCWP 50R,A00,518791,Staff,20,0,20,0
1713340264389,MCWP 50R,B00,518792,Staff,17,0,20,3
1713340264389,MCWP 50R,C00,518793,Staff,19,0,20,1
1713340264389,MCWP 50R,D00,518794,Staff,16,0,20,4
1713340264389,MCWP 50R,E00,518795,Staff,16,0,20,4
1713340264389,MCWP 50R,F00,518796,Staff,19,0,20,1
1713340264389,MCWP 50R,G00,518797,Staff,19,0,20,1
1713340265420,MMW 12R,A01,514034,Herbst; Matthew,15,0,16,1
1713340265420,MMW 12R,A02,514035,Herbst; Matthew,16,0,16,0
1713340266449,MMW 13R,A01,514037,Staff,12,0,16,4
1713340266449,MMW 13R,A02,514039,Staff,16,0,16,0
1713340268506,SIO 295LS,A00,523233,Staff,19,0,30,11
1713340269531,SIO 295S,A00,523232,Staff,19,0,30,11
1713340270557,SOCI 117,A01,494376,Staff,1,0,5,4
1713340271587,WES 237B,A00,494380,Staff,19,0,20,1
1713340273664,AESE 279B,A00,494370,Wade; Jon P,33,0,33,0
1713340274690,ANAR 135S,A00,494369,Braswell; Geoffrey E.,0,0,0,0
1713340275720,CAT 124RS,A01,519847,Geibel; William,17,0,20,3
1713340276745,CAT 125RS,A01,515971,Geibel; William,17,0,20,3
1713340277776,CLRE 250,A00,511389,Morris; Sheldon,9996,0,9999,3
1713340278802,CLRE 251,A00,507176,Mehta; Ravindra L.,9996,0,9999,3
1713340278802,CLRE 251,B00,511410,Mehta; Ravindra L.,9998,0,9999,1
1713340279830,CLRE 252,A00,507189,Cuomo; Raphael Eduardo,9998,0,9999,1
1713340280857,CLRE 253,A00,507199,Vaida; Florin,9997,0,9999,2
1713340280857,CLRE 253,B00,507202,Vaida; Florin,9999,0,9999,0
1713340281888,CLRE 259,A00,507211,Patel; Hemal,9996,0,9999,3
1713340282919,CLRE 260,A00,507221,Cuomo; Raphael Eduardo,9999,0,9999,0
1713340283944,CLRE 297,001,507242,Cuomo; Raphael Eduardo,9999,0,9999,0
1713340284974,CSE 191,A00,516875,Minnes Kemp; Mor Mia,9999,0,9999,0
1713340286004,CSS 201S,A01,494383,Staff,35,0,35,0
1713340287031,CSS 202S,A01,494387,Staff,35,0,35,0
1713340288062,EAP 100,A00,516065,Staff,9792,0,9999,207
1713340289088,ECE 45,A01,507414,Staff,51,0,60,9
1713340290113,ECE 100,A01,507416,Baghdadchi; Saharnaz,10,0,20,10
1713340290113,ECE 100,A02,507418,Baghdadchi; Saharnaz,20,0,20,0
1713340291140,ECE 111,A01,507420,Staff,38,0,50,12
1713340292170,ECE 197,001,548057,Sievenpiper; Daniel F.,9998,0,9999,1
1713340293195,EDS 115,A00,507243,Choi; Bailey Miyeon,28,0,28,0
1713340294223,EDS 117,A01,494379,Staff,23,0,25,2
1713340295250,EDS 125,A00,507246,Hopkins; Megan Beth,29,0,30,1
1713340296282,EDS 128A,A01,507264,Fargason; Sharon Gayle,26,0,26,0
1713340297311,EDS 128B,A01,507293,Pappas; Elizabeth,30,0,30,0
1713340298336,EDS 139,A00,507294,Fargason; Sharon Gayle,30,0,30,0
1713340298336,EDS 139,B00,507313,Pappas; Elizabeth,30,0,30,0
1713340299364,EDS 201,A00,507315,Staff,26,0,30,4
1713340300390,EDS 203,A01,507317,Halter; Christopher P.,26,0,30,4
1713340301421,EDS 204R,A01,507319,Halter; Christopher P.,3,0,30,27
1713340301421,EDS 204R,B01,507331,Heinzman; Erica M.,28,0,30,2
1713340302450,EDS 206R,A00,507332,Staff,4,0,30,26
1713340302450,EDS 206R,B00,507343,Staff,28,0,30,2
1713340303480,EDS 250,A00,507344,Hemans; Patricia Ann Benitez,36,0,40,4
1713340304506,EDS 281,A00,507345,Daly; Alan J.,18,0,18,0
1713340305534,EDS 284,A00,507350,Daly; Alan J.,16,0,16,0
1713340306562,EDS 286,A00,507359,Fine; Sarah,18,0,18,0
1713340307590,EDS 289C,A01,507361,Daly; Alan J.,18,0,18,0
1713340308619,EDS 290,A00,507366,Hofstetter; Carolyn,15,0,15,0
1713340309645,LIGM 5A,A00,507421,Fischer-Grunski; Eva K,20,0,20,0
1713340310671,LIGM 5B,A00,507423,Fischer-Grunski; Eva K,20,0,20,0
1713340311696,LIGM 5C,A00,507425,Fischer-Grunski; Eva K,20,0,20,0
1713340312728,LIIT 5AS,A00,507427,Carnelos; Chiara,20,0,20,0
1713340313766,LIIT 5BS,A00,507430,Carnelos; Chiara,20,0,20,0
1713340314797,LIIT 5CS,A00,507432,Carnelos; Chiara,20,0,20,0
1713340315848,LISP 5A,A00,507541,Munoz Sanchez; Alicia,17,0,20,3
1713340316876,LISP 5B,A00,507671,Munoz Sanchez; Alicia,15,0,20,5
1713340317907,LISP 5C,A00,507696,Munoz Sanchez; Alicia,15,0,20,5
1713340318943,MAE 197,001,528363,Boechler; Nicholas Sebastia,9998,0,9999,1
1713340319971,MATH 197,001,523477,Kedlaya; Kiran S.,9999,0,9999,0
1713340319971,MATH 197,002,563811,Zhang; Danna,9999,0,9999,0
1713340321003,MCWP 40R,A00,518780,Staff,20,0,20,0
1713340321003,MCWP 40R,B00,518781,Staff,19,0,20,1
1713340321003,MCWP 40R,C00,518783,Staff,19,0,20,1
1713340322029,MCWP 50R,A00,518791,Staff,20,0,20,0
1713340322029,MCWP 50R,B00,518792,Staff,17,0,20,3
1713340322029,MCWP 50R,C00,518793,Staff,19,0,20,1
1713340322029,MCWP 50R,D00,518794,Staff,16,0,20,4
1713340322029,MCWP 50R,E00,518795,Staff,16,0,20,4
1713340322029,MCWP 50R,F00,518796,Staff,19,0,20,1
1713340322029,MCWP 50R,G00,518797,Staff,19,0,20,1
1713340323063,MMW 12R,A01,514034,Herbst; Matthew,15,0,16,1
1713340323063,MMW 12R,A02,514035,Herbst; Matthew,16,0,16,0
1713340324091,MMW 13R,A01,514037,Staff,12,0,16,4
1713340324091,MMW 13R,A02,514039,Staff,16,0,16,0
1713340326196,SIO 295LS,A00,523233,Staff,19,0,30,11
1713340327223,SIO 295S,A00,523232,Staff,19,0,30,11
1713340328252,SOCI 117,A01,494376,Staff,1,0,5,4
1713340329278,WES 237B,A00,494380,Staff,19,0,20,1
1713340331365,AESE 279B,A00,494370,Wade; Jon P,33,0,33,0
1713340332390,ANAR 135S,A00,494369,Braswell; Geoffrey E.,0,0,0,0
1713340333421,CAT 124RS,A01,519847,Geibel; William,17,0,20,3
1713340334452,CAT 125RS,A01,515971,Geibel; William,17,0,20,3
1713340335477,CLRE 250,A00,511389,Morris; Sheldon,9996,0,9999,3
1713340336510,CLRE 251,A00,507176,Mehta; Ravindra L.,9996,0,9999,3
1713340336510,CLRE 251,B00,511410,Mehta; Ravindra L.,9998,0,9999,1
1713340337542,CLRE 252,A00,507189,Cuomo; Raphael Eduardo,9998,0,9999,1
1713340338568,CLRE 253,A00,507199,Vaida; Florin,9997,0,9999,2
1713340338568,CLRE 253,B00,507202,Vaida; Florin,9999,0,9999,0
1713340339595,CLRE 259,A00,507211,Patel; Hemal,9996,0,9999,3
1713340340620,CLRE 260,A00,507221,Cuomo; Raphael Eduardo,9999,0,9999,0
1713340341645,CLRE 297,001,507242,Cuomo; Raphael Eduardo,9999,0,9999,0
1713340342672,CSE 191,A00,516875,Minnes Kemp; Mor Mia,9999,0,9999,0
1713340343699,CSS 201S,A01,494383,Staff,35,0,35,0
1713340344725,CSS 202S,A01,494387,Staff,35,0,35,0
1713340345754,EAP 100,A00,516065,Staff,9792,0,9999,207
1713340346789,ECE 45,A01,507414,Staff,51,0,60,9
1713340347817,ECE 100,A01,507416,Baghdadchi; Saharnaz,10,0,20,10
1713340347817,ECE 100,A02,507418,Baghdadchi; Saharnaz,20,0,20,0
1713340348847,ECE 111,A01,507420,Staff,38,0,50,12
1713340349877,ECE 197,001,548057,Sievenpiper; Daniel F.,9998,0,9999,1
1713340350912,EDS 115,A00,507243,Choi; Bailey Miyeon,28,0,28,0
1713340351938,EDS 117,A01,494379,Staff,23,0,25,2
1713340352968,EDS 125,A00,507246,Hopkins; Megan Beth,29,0,30,1
1713340353998,EDS 128A,A01,507264,Fargason; Sharon Gayle,26,0,26,0
1713340355029,EDS 128B,A01,507293,Pappas; Elizabeth,30,0,30,0
1713340356057,EDS 139,A00,507294,Fargason; Sharon Gayle,30,0,30,0
1713340356057,EDS 139,B00,507313,Pappas; Elizabeth,30,0,30,0
1713340357082,EDS 201,A00,507315,Staff,26,0,30,4
1713340358109,EDS 203,A01,507317,Halter; Christopher P.,26,0,30,4
1713340359141,EDS 204R,A01,507319,Halter; Christopher P.,3,0,30,27
1713340359141,EDS 204R,B01,507331,Heinzman; Erica M.,28,0,30,2
1713340360167,EDS 206R,A00,507332,Staff,4,0,30,26
1713340360167,EDS 206R,B00,507343,Staff,28,0,30,2
1713340361194,EDS 250,A00,507344,Hemans; Patricia Ann Benitez,36,0,40,4
1713340362222,EDS 281,A00,507345,Daly; Alan J.,18,0,18,0
1713340363251,EDS 284,A00,507350,Daly; Alan J.,16,0,16,0
1713340364283,EDS 286,A00,507359,Fine; Sarah,18,0,18,0
1713340365312,EDS 289C,A01,507361,Daly; Alan J.,18,0,18,0
1713340366337,EDS 290,A00,507366,Hofstetter; Carolyn,15,0,15,0
1713340367364,LIGM 5A,A00,507421,Fischer-Grunski; Eva K,20,0,20,0
1713340368389,LIGM 5B,A00,507423,Fischer-Grunski; Eva K,20,0,20,0
1713340369420,LIGM 5C,A00,507425,Fischer-Grunski; Eva K,20,0,20,0
1713340370446,LIIT 5AS,A00,507427,Carnelos; Chiara,20,0,20,0
1713340371476,LIIT 5BS,A00,507430,Carnelos; Chiara,20,0,20,0
1713340372501,LIIT 5CS,A00,507432,Carnelos; Chiara,20,0,20,0
1713340373533,LISP 5A,A00,507541,Munoz Sanchez; Alicia,17,0,20,3
1713340374559,LISP 5B,A00,507671,Munoz Sanchez; Alicia,15,0,20,5
1713340375589,LISP 5C,A00,507696,Munoz Sanchez; Alicia,15,0,20,5
1713340376620,MAE 197,001,528363,Boechler; Nicholas Sebastia,9998,0,9999,1
1713340377651,MATH 197,001,523477,Kedlaya; Kiran S.,9999,0,9999,0
1713340377651,MATH 197,002,563811,Zhang; Danna,9999,0,9999,0
1713340378679,MCWP 40R,A00,518780,Staff,20,0,20,0
1713340378679,MCWP 40R,B00,518781,Staff,19,0,20,1
1713340378679,MCWP 40R,C00,518783,Staff,19,0,20,1
1713340379705,MCWP 50R,A00,518791,Staff,20,0,20,0
1713340379705,MCWP 50R,B00,518792,Staff,17,0,20,3
1713340379705,MCWP 50R,C00,518793,Staff,19,0,20,1
1713340379705,MCWP 50R,D00,518794,Staff,16,0,20,4
1713340379705,MCWP 50R,E00,518795,Staff,16,0,20,4
1713340379705,MCWP 50R,F00,518796,Staff,19,0,20,1
1713340379705,MCWP 50R,G00,518797,Staff,19,0,20,1
1713340380741,MMW 12R,A01,514034,Herbst; Matthew,15,0,16,1
1713340380741,MMW 12R,A02,514035,Herbst; Matthew,16,0,16,0
1713340381771,MMW 13R,A01,514037,Staff,12,0,16,4
1713340381771,MMW 13R,A02,514039,Staff,16,0,16,0
1713340383854,SIO 295LS,A00,523233,Staff,19,0,30,11
1713340384879,SIO 295S,A00,523232,Staff,19,0,30,11
1713340385911,SOCI 117,A01,494376,Staff,1,0,5,4
1713340386940,WES 237B,A00,494380,Staff,19,0,20,1
1713340389014,AESE 279B,A00,494370,Wade; Jon P,33,0,33,0
1713340390041,ANAR 135S,A00,494369,Braswell; Geoffrey E.,0,0,0,0
1713340391073,CAT 124RS,A01,519847,Geibel; William,17,0,20,3
1713340392099,CAT 125RS,A01,515971,Geibel; William,17,0,20,3
1713340393125,CLRE 250,A00,511389,Morris; Sheldon,9996,0,9999,3
1713340394159,CLRE 251,A00,507176,Mehta; Ravindra L.,9996,0,9999,3
1713340394159,CLRE 251,B00,511410,Mehta; Ravindra L.,9998,0,9999,1
1713340395185,CLRE 252,A00,507189,Cuomo; Raphael Eduardo,9998,0,9999,1
1713340396212,CLRE 253,A00,507199,Vaida; Florin,9997,0,9999,2
1713340396212,CLRE 253,B00,507202,Vaida; Florin,9999,0,9999,0
1713340397239,CLRE 259,A00,507211,Patel; Hemal,9996,0,9999,3
1713340398268,CLRE 260,A00,507221,Cuomo; Raphael Eduardo,9999,0,9999,0
1713340399294,CLRE 297,001,507242,Cuomo; Raphael Eduardo,9999,0,9999,0
1713340400321,CSE 191,A00,516875,Minnes Kemp; Mor Mia,9999,0,9999,0
1713340401352,CSS 201S,A01,494383,Staff,35,0,35,0
1713340402378,CSS 202S,A01,494387,Staff,35,0,35,0
1713340403402,EAP 100,A00,516065,Staff,9792,0,9999,207
1713340404433,ECE 45,A01,507414,Staff,51,0,60,9
1713340405461,ECE 100,A01,507416,Baghdadchi; Saharnaz,10,0,20,10
1713340405461,ECE 100,A02,507418,Baghdadchi; Saharnaz,20,0,20,0
1713340406488,ECE 111,A01,507420,Staff,38,0,50,12
1713340407513,ECE 197,001,548057,Sievenpiper; Daniel F.,9998,0,9999,1
1713340408542,EDS 115,A00,507243,Choi; Bailey Miyeon,28,0,28,0
1713340409567,EDS 117,A01,494379,Staff,23,0,25,2
1713340410591,EDS 125,A00,507246,Hopkins; Megan Beth,29,0,30,1
1713340411622,EDS 128A,A01,507264,Fargason; Sharon Gayle,26,0,26,0
1713340412653,EDS 128B,A01,507293,Pappas; Elizabeth,30,0,30,0
1713340413677,EDS 139,A00,507294,Fargason; Sharon Gayle,30,0,30,0
1713340413677,EDS 139,B00,507313,Pappas; Elizabeth,30,0,30,0
1713340414703,EDS 201,A00,507315,Staff,26,0,30,4
1713340415735,EDS 203,A01,507317,Halter; Christopher P.,26,0,30,4
1713340416761,EDS 204R,A01,507319,Halter; Christopher P.,3,0,30,27
1713340416761,EDS 204R,B01,507331,Heinzman; Erica M.,28,0,30,2
1713340417792,EDS 206R,A00,507332,Staff,4,0,30,26
1713340417792,EDS 206R,B00,507343,Staff,28,0,30,2
1713340418818,EDS 250,A00,507344,Hemans; Patricia Ann Benitez,36,0,40,4
1713340419848,EDS 281,A00,507345,Daly; Alan J.,18,0,18,0
1713340420876,EDS 284,A00,507350,Daly; Alan J.,16,0,16,0
1713340421901,EDS 286,A00,507359,Fine; Sarah,18,0,18,0
1713340422926,EDS 289C,A01,507361,Daly; Alan J.,18,0,18,0
1713340423952,EDS 290,A00,507366,Hofstetter; Carolyn,15,0,15,0
1713340424981,LIGM 5A,A00,507421,Fischer-Grunski; Eva K,20,0,20,0
1713340426012,LIGM 5B,A00,507423,Fischer-Grunski; Eva K,20,0,20,0
1713340427041,LIGM 5C,A00,507425,Fischer-Grunski; Eva K,20,0,20,0
1713340428147,LIIT 5AS,A00,507427,Carnelos; Chiara,20,0,20,0
1713340429173,LIIT 5BS,A00,507430,Carnelos; Chiara,20,0,20,0
1713340430255,LIIT 5CS,A00,507432,Carnelos; Chiara,20,0,20,0
1713340431289,LISP 5A,A00,507541,Munoz Sanchez; Alicia,17,0,20,3
1713340432319,LISP 5B,A00,507671,Munoz Sanchez; Alicia,15,0,20,5
1713340433351,LISP 5C,A00,507696,Munoz Sanchez; Alicia,15,0,20,5
1713340434378,MAE 197,001,528363,Boechler; Nicholas Sebastia,9998,0,9999,1
1713340435406,MATH 197,001,523477,Kedlaya; Kiran S.,9999,0,9999,0
1713340435406,MATH 197,002,563811,Zhang; Danna,9999,0,9999,0
1713340436432,MCWP 40R,A00,518780,Staff,20,0,20,0
1713340436432,MCWP 40R,B00,518781,Staff,19,0,20,1
1713340436432,MCWP 40R,C00,518783,Staff,19,0,20,1
1713340437456,MCWP 50R,A00,518791,Staff,20,0,20,0
1713340437456,MCWP 50R,B00,518792,Staff,17,0,20,3
1713340437456,MCWP 50R,C00,518793,Staff,19,0,20,1
1713340437456,MCWP 50R,D00,518794,Staff,16,0,20,4
1713340437456,MCWP 50R,E00,518795,Staff,16,0,20,4
1713340437456,MCWP 50R,F00,518796,Staff,19,0,20,1
1713340437456,MCWP 50R,G00,518797,Staff,19,0,20,1
1713340438481,MMW 12R,A01,514034,Herbst; Matthew,15,0,16,1
1713340438481,MMW 12R,A02,514035,Herbst; Matthew,16,0,16,0
1713340439506,MMW 13R,A01,514037,Staff,12,0,16,4
1713340439506,MMW 13R,A02,514039,Staff,16,0,16,0
1713340441558,SIO 295LS,A00,523233,Staff,19,0,30,11
1713340442588,SIO 295S,A00,523232,Staff,19,0,30,11
1713340443614,SOCI 117,A01,494376,Staff,1,0,5,4
1713340444644,WES 237B,A00,494380,Staff,19,0,20,1
1713340446734,AESE 279B,A00,494370,Wade; Jon P,33,0,33,0
1713340447760,ANAR 135S,A00,494369,Braswell; Geoffrey E.,0,0,0,0
1713340448790,CAT 124RS,A01,519847,Geibel; William,17,0,20,3
1713340449816,CAT 125RS,A01,515971,Geibel; William,17,0,20,3
1713340450843,CLRE 250,A00,511389,Morris; Sheldon,9996,0,9999,3
1713340451871,CLRE 251,A00,507176,Mehta; Ravindra L.,9996,0,9999,3
1713340451871,CLRE 251,B00,511410,Mehta; Ravindra L.,9998,0,9999,1
1713340452898,CLRE 252,A00,507189,Cuomo; Raphael Eduardo,9998,0,9999,1
1713340453922,CLRE 253,A00,507199,Vaida; Florin,9997,0,9999,2
1713340453922,CLRE 253,B00,507202,Vaida; Florin,9999,0,9999,0
1713340454948,CLRE 259,A00,507211,Patel; Hemal,9996,0,9999,3
1713340455975,CLRE 260,A00,507221,Cuomo; Raphael Eduardo,9999,0,9999,0
1713340457001,CLRE 297,001,507242,Cuomo; Raphael Eduardo,9999,0,9999,0
1713340458030,CSE 191,A00,516875,Minnes Kemp; Mor Mia,9999,0,9999,0
1713340459059,CSS 201S,A01,494383,Staff,35,0,35,0
1713340460090,CSS 202S,A01,494387,Staff,35,0,35,0
1713340461197,EAP 100,A00,516065,Staff,9792,0,9999,207
1713340462225,ECE 45,A01,507414,Staff,51,0,60,9
1713340463250,ECE 100,A01,507416,Baghdadchi; Saharnaz,10,0,20,10
1713340463250,ECE 100,A02,507418,Baghdadchi; Saharnaz,20,0,20,0
1713340464276,ECE 111,A01,507420,Staff,38,0,50,12
1713340465303,ECE 197,001,548057,Sievenpiper; Daniel F.,9998,0,9999,1
1713340466334,EDS 115,A00,507243,Choi; Bailey Miyeon,28,0,28,0
1713340467365,EDS 117,A01,494379,Staff,23,0,25,2
1713340468392,EDS 125,A00,507246,Hopkins; Megan Beth,29,0,30,1
1713340469425,EDS 128A,A01,507264,Fargason; Sharon Gayle,26,0,26,0
1713340470454,EDS 128B,A01,507293,Pappas; Elizabeth,30,0,30,0
1713340471483,EDS 139,A00,507294,Fargason; Sharon Gayle,30,0,30,0
1713340471483,EDS 139,B00,507313,Pappas; Elizabeth,30,0,30,0
1713340472508,EDS 201,A00,507315,Staff,26,0,30,4
1713340473533,EDS 203,A01,507317,Halter; Christopher P.,26,0,30,4
1713340474561,EDS 204R,A01,507319,Halter; Christopher P.,3,0,30,27
1713340474561,EDS 204R,B01,507331,Heinzman; Erica M.,28,0,30,2
1713340475591,EDS 206R,A00,507332,Staff,4,0,30,26
1713340475591,EDS 206R,B00,507343,Staff,28,0,30,2
1713340476622,EDS 250,A00,507344,Hemans; Patricia Ann Benitez,36,0,40,4
1713340477652,EDS 281,A00,507345,Daly; Alan J.,18,0,18,0
1713340478679,EDS 284,A00,507350,Daly; Alan J.,16,0,16,0
1713340479708,EDS 286,A00,507359,Fine; Sarah,18,0,18,0
1713340480734,EDS 289C,A01,507361,Daly; Alan J.,18,0,18,0
1713340481760,EDS 290,A00,507366,Hofstetter; Carolyn,15,0,15,0
1713340482792,LIGM 5A,A00,507421,Fischer-Grunski; Eva K,20,0,20,0
1713340483818,LIGM 5B,A00,507423,Fischer-Grunski; Eva K,20,0,20,0
1713340484845,LIGM 5C,A00,507425,Fischer-Grunski; Eva K,20,0,20,0
1713340485872,LIIT 5AS,A00,507427,Carnelos; Chiara,20,0,20,0
1713340486899,LIIT 5BS,A00,507430,Carnelos; Chiara,20,0,20,0
1713340487930,LIIT 5CS,A00,507432,Carnelos; Chiara,20,0,20,0
1713340488956,LISP 5A,A00,507541,Munoz Sanchez; Alicia,17,0,20,3
1713340489988,LISP 5B,A00,507671,Munoz Sanchez; Alicia,15,0,20,5
1713340491015,LISP 5C,A00,507696,Munoz Sanchez; Alicia,15,0,20,5
1713340492044,MAE 197,001,528363,Boechler; Nicholas Sebastia,9998,0,9999,1
1713340493078,MATH 197,001,523477,Kedlaya; Kiran S.,9999,0,9999,0
1713340493078,MATH 197,002,563811,Zhang; Danna,9999,0,9999,0
1713340494104,MCWP 40R,A00,518780,Staff,20,0,20,0
1713340494104,MCWP 40R,B00,518781,Staff,19,0,20,1
1713340494104,MCWP 40R,C00,518783,Staff,19,0,20,1
1713340495135,MCWP 50R,A00,518791,Staff,20,0,20,0
1713340495135,MCWP 50R,B00,518792,Staff,17,0,20,3
1713340495135,MCWP 50R,C00,518793,Staff,19,0,20,1
1713340495135,MCWP 50R,D00,518794,Staff,16,0,20,4
1713340495135,MCWP 50R,E00,518795,Staff,16,0,20,4
1713340495135,MCWP 50R,F00,518796,Staff,19,0,20,1
1713340495135,MCWP 50R,G00,518797,Staff,19,0,20,1
1713340496162,MMW 12R,A01,514034,Herbst; Matthew,15,0,16,1
1713340496162,MMW 12R,A02,514035,Herbst; Matthew,16,0,16,0
1713340497193,MMW 13R,A01,514037,Staff,12,0,16,4
1713340497193,MMW 13R,A02,514039,Staff,16,0,16,0
1713340499250,SIO 295LS,A00,523233,Staff,19,0,30,11
1713340500282,SIO 295S,A00,523232,Staff,19,0,30,11
1713340501310,SOCI 117,A01,494376,Staff,1,0,5,4
1713340502340,WES 237B,A00,494380,Staff,19,0,20,1
1713340504429,AESE 279B,A00,494370,Wade; Jon P,33,0,33,0
1713340505456,ANAR 135S,A00,494369,Braswell; Geoffrey E.,0,0,0,0
1713340506482,CAT 124RS,A01,519847,Geibel; William,17,0,20,3
1713340507512,CAT 125RS,A01,515971,Geibel; William,17,0,20,3
1713340508539,CLRE 250,A00,511389,Morris; Sheldon,9996,0,9999,3
1713340509569,CLRE 251,A00,507176,Mehta; Ravindra L.,9996,0,9999,3
1713340509569,CLRE 251,B00,511410,Mehta; Ravindra L.,9998,0,9999,1
1713340510597,CLRE 252,A00,507189,Cuomo; Raphael Eduardo,9998,0,9999,1
1713340511624,CLRE 253,A00,507199,Vaida; Florin,9997,0,9999,2
1713340511624,CLRE 253,B00,507202,Vaida; Florin,9999,0,9999,0
1713340512655,CLRE 259,A00,507211,Patel; Hemal,9996,0,9999,3
1713340513680,CLRE 260,A00,507221,Cuomo; Raphael Eduardo,9999,0,9999,0
1713340514706,CLRE 297,001,507242,Cuomo; Raphael Eduardo,9999,0,9999,0
1713340515733,CSE 191,A00,516875,Minnes Kemp; Mor Mia,9999,0,9999,0
1713340516765,CSS 201S,A01,494383,Staff,35,0,35,0
1713340517795,CSS 202S,A01,494387,Staff,35,0,35,0
1713340518821,EAP 100,A00,516065,Staff,9792,0,9999,207
1713340519846,ECE 45,A01,507414,Staff,51,0,60,9
1713340520872,ECE 100,A01,507416,Baghdadchi; Saharnaz,10,0,20,10
1713340520872,ECE 100,A02,507418,Baghdadchi; Saharnaz,20,0,20,0
1713340521897,ECE 111,A01,507420,Staff,38,0,50,12
1713340522921,ECE 197,001,548057,Sievenpiper; Daniel F.,9998,0,9999,1
1713340523950,EDS 115,A00,507243,Choi; Bailey Miyeon,28,0,28,0
1713340524980,EDS 117,A01,494379,Staff,23,0,25,2
1713340526008,EDS 125,A00,507246,Hopkins; Megan Beth,29,0,30,1
1713340527034,EDS 128A,A01,507264,Fargason; Sharon Gayle,26,0,26,0
1713340528061,EDS 128B,A01,507293,Pappas; Elizabeth,30,0,30,0
1713340529086,EDS 139,A00,507294,Fargason; Sharon Gayle,30,0,30,0
1713340529086,EDS 139,B00,507313,Pappas; Elizabeth,30,0,30,0
1713340530113,EDS 201,A00,507315,Staff,26,0,30,4
1713340531144,EDS 203,A01,507317,Halter; Christopher P.,26,0,30,4
1713340532177,EDS 204R,A01,507319,Halter; Christopher P.,3,0,30,27
1713340532177,EDS 204R,B01,507331,Heinzman; Erica M.,28,0,30,2
1713340533204,EDS 206R,A00,507332,Staff,4,0,30,26
1713340533204,EDS 206R,B00,507343,Staff,28,0,30,2
1713340534286,EDS 250,A00,507344,Hemans; Patricia Ann Benitez,36,0,40,4
1713340535314,EDS 281,A00,507345,Daly; Alan J.,18,0,18,0
1713340536341,EDS 284,A00,507350,Daly; Alan J.,16,0,16,0
1713340537373,EDS 286,A00,507359,Fine; Sarah,18,0,18,0
1713340538403,EDS 289C,A01,507361,Daly; Alan J.,18,0,18,0
1713340539428,EDS 290,A00,507366,Hofstetter; Carolyn,15,0,15,0
1713340540455,LIGM 5A,A00,507421,Fischer-Grunski; Eva K,20,0,20,0
1713340541481,LIGM 5B,A00,507423,Fischer-Grunski; Eva K,20,0,20,0
1713340542506,LIGM 5C,A00,507425,Fischer-Grunski; Eva K,20,0,20,0
1713340543536,LIIT 5AS,A00,507427,Carnelos; Chiara,20,0,20,0
1713340544568,LIIT 5BS,A00,507430,Carnelos; Chiara,20,0,20,0
1713340545594,LIIT 5CS,A00,507432,Carnelos; Chiara,20,0,20,0
1713340546625,LISP 5A,A00,507541,Munoz Sanchez; Alicia,17,0,20,3
1713340547652,LISP 5B,A00,507671,Munoz Sanchez; Alicia,15,0,20,5
1713340548684,LISP 5C,A00,507696,Munoz Sanchez; Alicia,15,0,20,5
1713340549710,MAE 197,001,528363,Boechler; Nicholas Sebastia,9998,0,9999,1
1713340550738,MATH 197,001,523477,Kedlaya; Kiran S.,9999,0,9999,0
1713340550738,MATH 197,002,563811,Zhang; Danna,9999,0,9999,0
1713340551763,MCWP 40R,A00,518780,Staff,20,0,20,0
1713340551763,MCWP 40R,B00,518781,Staff,19,0,20,1
1713340551763,MCWP 40R,C00,518783,Staff,19,0,20,1
1713340552800,MCWP 50R,A00,518791,Staff,20,0,20,0
1713340552800,MCWP 50R,B00,518792,Staff,17,0,20,3
1713340552800,MCWP 50R,C00,518793,Staff,19,0,20,1
1713340552800,MCWP 50R,D00,518794,Staff,16,0,20,4
1713340552800,MCWP 50R,E00,518795,Staff,16,0,20,4
1713340552800,MCWP 50R,F00,518796,Staff,19,0,20,1
1713340552800,MCWP 50R,G00,518797,Staff,19,0,20,1
1713340553826,MMW 12R,A01,514034,Herbst; Matthew,15,0,16,1
1713340553826,MMW 12R,A02,514035,Herbst; Matthew,16,0,16,0
1713340554852,MMW 13R,A01,514037,Staff,12,0,16,4
1713340554852,MMW 13R,A02,514039,Staff,16,0,16,0
1713340556903,SIO 295LS,A00,523233,Staff,19,0,30,11
1713340557929,SIO 295S,A00,523232,Staff,19,0,30,11
1713340558956,SOCI 117,A01,494376,Staff,1,0,5,4
1713340559982,WES 237B,A00,494380,Staff,19,0,20,1
1713340562057,AESE 279B,A00,494370,Wade; Jon P,33,0,33,0
1713340563084,ANAR 135S,A00,494369,Braswell; Geoffrey E.,0,0,0,0
1713340564110,CAT 124RS,A01,519847,Geibel; William,17,0,20,3
1713340565140,CAT 125RS,A01,515971,Geibel; William,17,0,20,3
1713340566170,CLRE 250,A00,511389,Morris; Sheldon,9996,0,9999,3
1713340567203,CLRE 251,A00,507176,Mehta; Ravindra L.,9996,0,9999,3
1713340567203,CLRE 251,B00,511410,Mehta; Ravindra L.,9998,0,9999,1
1713340568239,CLRE 252,A00,507189,Cuomo; Raphael Eduardo,9998,0,9999,1
1713340569271,CLRE 253,A00,507199,Vaida; Florin,9997,0,9999,2
1713340569271,CLRE 253,B00,507202,Vaida; Florin,9999,0,9999,0
1713340570298,CLRE 259,A00,507211,Patel; Hemal,9996,0,9999,3
1713340571323,CLRE 260,A00,507221,Cuomo; Raphael Eduardo,9999,0,9999,0
1713340572353,CLRE 297,001,507242,Cuomo; Raphael Eduardo,9999,0,9999,0
1713340573379,CSE 191,A00,516875,Minnes Kemp; Mor Mia,9999,0,9999,0
1713340574408,CSS 201S,A01,494383,Staff,35,0,35,0
1713340575437,CSS 202S,A01,494387,Staff,35,0,35,0
1713340576465,EAP 100,A00,516065,Staff,9792,0,9999,207
1713340577494,ECE 45,A01,507414,Staff,51,0,60,9
1713340578523,ECE 100,A01,507416,Baghdadchi; Saharnaz,10,0,20,10
1713340578523,ECE 100,A02,507418,Baghdadchi; Saharnaz,20,0,20,0
1713340579550,ECE 111,A01,507420,Staff,38,0,50,12
1713340580579,ECE 197,001,548057,Sievenpiper; Daniel F.,9998,0,9999,1
1713340581610,EDS 115,A00,507243,Choi; Bailey Miyeon,28,0,28,0
1713340582637,EDS 117,A01,494379,Staff,23,0,25,2
1713340583663,EDS 125,A00,507246,Hopkins; Megan Beth,29,0,30,1
1713340584695,EDS 128A,A01,507264,Fargason; Sharon Gayle,26,0,26,0
1713340585726,EDS 128B,A01,507293,Pappas; Elizabeth,30,0,30,0
1713340586752,EDS 139,A00,507294,Fargason; Sharon Gayle,30,0,30,0
1713340586752,EDS 139,B00,507313,Pappas; Elizabeth,30,0,30,0
1713340587782,EDS 201,A00,507315,Staff,26,0,30,4
1713340588813,EDS 203,A01,507317,Halter; Christopher P.,26,0,30,4
1713340589838,EDS 204R,A01,507319,Halter; Christopher P.,3,0,30,27
1713340589838,EDS 204R,B01,507331,Heinzman; Erica M.,28,0,30,2
1713340590866,EDS 206R,A00,507332,Staff,4,0,30,26
1713340590866,EDS 206R,B00,507343,Staff,28,0,30,2
1713340591895,EDS 250,A00,507344,Hemans; Patricia Ann Benitez,36,0,40,4
1713340592921,EDS 281,A00,507345,Daly; Alan J.,18,0,18,0
1713340593951,EDS 284,A00,507350,Daly; Alan J.,16,0,16,0
1713340594982,EDS 286,A00,507359,Fine; Sarah,18,0,18,0
1713340596010,EDS 289C,A01,507361,Daly; Alan J.,18,0,18,0
1713340597036,EDS 290,A00,507366,Hofstetter; Carolyn,15,0,15,0
1713340598063,LIGM 5A,A00,507421,Fischer-Grunski; Eva K,20,0,20,0
1713340599088,LIGM 5B,A00,507423,Fischer-Grunski; Eva K,20,0,20,0
1713340600114,LIGM 5C,A00,507425,Fischer-Grunski; Eva K,20,0,20,0
1713340601142,LIIT 5AS,A00,507427,Carnelos; Chiara,20,0,20,0
1713340602168,LIIT 5BS,A00,507430,Carnelos; Chiara,20,0,20,0
1713340603192,LIIT 5CS,A00,507432,Carnelos; Chiara,20,0,20,0
1713340604223,LISP 5A,A00,507541,Munoz Sanchez; Alicia,17,0,20,3
1713340605254,LISP 5B,A00,507671,Munoz Sanchez; Alicia,15,0,20,5
1713340606285,LISP 5C,A00,507696,Munoz Sanchez; Alicia,15,0,20,5
1713340607317,MAE 197,001,528363,Boechler; Nicholas Sebastia,9998,0,9999,1
1713340608342,MATH 197,001,523477,Kedlaya; Kiran S.,9999,0,9999,0
1713340608342,MATH 197,002,563811,Zhang; Danna,9999,0,9999,0
1713340609373,MCWP 40R,A00,518780,Staff,20,0,20,0
1713340609373,MCWP 40R,B00,518781,Staff,19,0,20,1
1713340609373,MCWP 40R,C00,518783,Staff,19,0,20,1
1713340610402,MCWP 50R,A00,518791,Staff,20,0,20,0
1713340610402,MCWP 50R,B00,518792,Staff,17,0,20,3
1713340610402,MCWP 50R,C00,518793,Staff,19,0,20,1
1713340610402,MCWP 50R,D00,518794,Staff,16,0,20,4
1713340610402,MCWP 50R,E00,518795,Staff,16,0,20,4
1713340610402,MCWP 50R,F00,518796,Staff,19,0,20,1
1713340610402,MCWP 50R,G00,518797,Staff,19,0,20,1
1713340611432,MMW 12R,A01,514034,Herbst; Matthew,15,0,16,1
1713340611432,MMW 12R,A02,514035,Herbst; Matthew,16,0,16,0
1713340612462,MMW 13R,A01,514037,Staff,12,0,16,4
1713340612462,MMW 13R,A02,514039,Staff,16,0,16,0
1713340614512,SIO 295LS,A00,523233,Staff,19,0,30,11
1713340615541,SIO 295S,A00,523232,Staff,19,0,30,11
1713340616568,SOCI 117,A01,494376,Staff,1,0,5,4
1713340617594,WES 237B,A00,494380,Staff,19,0,20,1
1713340619675,AESE 279B,A00,494370,Wade; Jon P,33,0,33,0
1713340620702,ANAR 135S,A00,494369,Braswell; Geoffrey E.,0,0,0,0
1713340621728,CAT 124RS,A01,519847,Geibel; William,17,0,20,3
1713340622754,CAT 125RS,A01,515971,Geibel; William,17,0,20,3
1713340623784,CLRE 250,A00,511389,Morris; Sheldon,9996,0,9999,3
1713340624811,CLRE 251,A00,507176,Mehta; Ravindra L.,9996,0,9999,3
1713340624811,CLRE 251,B00,511410,Mehta; Ravindra L.,9998,0,9999,1
1713340625842,CLRE 252,A00,507189,Cuomo; Raphael Eduardo,9998,0,9999,1
1713340626875,CLRE 253,A00,507199,Vaida; Florin,9997,0,9999,2
1713340626875,CLRE 253,B00,507202,Vaida; Florin,9999,0,9999,0
1713340627900,CLRE 259,A00,507211,Patel; Hemal,9996,0,9999,3
1713340628926,CLRE 260,A00,507221,Cuomo; Raphael Eduardo,9999,0,9999,0
1713340629954,CLRE 297,001,507242,Cuomo; Raphael Eduardo,9999,0,9999,0
1713340630985,CSE 191,A00,516875,Minnes Kemp; Mor Mia,9999,0,9999,0
1713340632016,CSS 201S,A01,494383,Staff,35,0,35,0
1713340633046,CSS 202S,A01,494387,Staff,35,0,35,0
1713340634072,EAP 100,A00,516065,Staff,9792,0,9999,207
1713340635099,ECE 45,A01,507414,Staff,51,0,60,9
1713340636129,ECE 100,A01,507416,Baghdadchi; Saharnaz,10,0,20,10
1713340636129,ECE 100,A02,507418,Baghdadchi; Saharnaz,20,0,20,0
1713340637155,ECE 111,A01,507420,Staff,38,0,50,12
1713340638240,ECE 197,001,548057,Sievenpiper; Daniel F.,9998,0,9999,1
1713340639267,EDS 115,A00,507243,Choi; Bailey Miyeon,28,0,28,0
1713340640297,EDS 117,A01,494379,Staff,23,0,25,2
1713340641323,EDS 125,A00,507246,Hopkins; Megan Beth,29,0,30,1
1713340642354,EDS 128A,A01,507264,Fargason; Sharon Gayle,26,0,26,0
1713340643379,EDS 128B,A01,507293,Pappas; Elizabeth,30,0,30,0
1713340644405,EDS 139,A00,507294,Fargason; Sharon Gayle,30,0,30,0
1713340644405,EDS 139,B00,507313,Pappas; Elizabeth,30,0,30,0
1713340645433,EDS 201,A00,507315,Staff,26,0,30,4
1713340646459,EDS 203,A01,507317,Halter; Christopher P.,26,0,30,4
1713340647489,EDS 204R,A01,507319,Halter; Christopher P.,3,0,30,27
1713340647489,EDS 204R,B01,507331,Heinzman; Erica M.,28,0,30,2
1713340648515,EDS 206R,A00,507332,Staff,4,0,30,26
1713340648515,EDS 206R,B00,507343,Staff,28,0,30,2
1713340649544,EDS 250,A00,507344,Hemans; Patricia Ann Benitez,36,0,40,4
1713340650572,EDS 281,A00,507345,Daly; Alan J.,18,0,18,0
1713340651598,EDS 284,A00,507350,Daly; Alan J.,16,0,16,0
1713340652624,EDS 286,A00,507359,Fine; Sarah,18,0,18,0
1713340653655,EDS 289C,A01,507361,Daly; Alan J.,18,0,18,0
1713340654683,EDS 290,A00,507366,Hofstetter; Carolyn,15,0,15,0
1713340655717,LIGM 5A,A00,507421,Fischer-Grunski; Eva K,20,0,20,0
1713340656743,LIGM 5B,A00,507423,Fischer-Grunski; Eva K,20,0,20,0
1713340657773,LIGM 5C,A00,507425,Fischer-Grunski; Eva K,20,0,20,0
1713340658799,LIIT 5AS,A00,507427,Carnelos; Chiara,20,0,20,0
1713340659825,LIIT 5BS,A00,507430,Carnelos; Chiara,20,0,20,0
1713340660852,LIIT 5CS,A00,507432,Carnelos; Chiara,20,0,20,0
1713340661879,LISP 5A,A00,507541,Munoz Sanchez; Alicia,17,0,20,3
1713340662904,LISP 5B,A00,507671,Munoz Sanchez; Alicia,15,0,20,5
1713340663930,LISP 5C,A00,507696,Munoz Sanchez; Alicia,15,0,20,5
1713340664958,MAE 197,001,528363,Boechler; Nicholas Sebastia,9998,0,9999,1
1713340665990,MATH 197,001,523477,Kedlaya; Kiran S.,9999,0,9999,0
1713340665990,MATH 197,002,563811,Zhang; Danna,9999,0,9999,0
1713340667017,MCWP 40R,A00,518780,Staff,20,0,20,0
1713340667017,MCWP 40R,B00,518781,Staff,19,0,20,1
1713340667017,MCWP 40R,C00,518783,Staff,19,0,20,1
1713340668043,MCWP 50R,A00,518791,Staff,20,0,20,0
1713340668043,MCWP 50R,B00,518792,Staff,17,0,20,3
1713340668043,MCWP 50R,C00,518793,Staff,19,0,20,1
1713340668043,MCWP 50R,D00,518794,Staff,16,0,20,4
1713340668043,MCWP 50R,E00,518795,Staff,16,0,20,4
1713340668043,MCWP 50R,F00,518796,Staff,19,0,20,1
1713340668043,MCWP 50R,G00,518797,Staff,19,0,20,1
1713340669070,MMW 12R,A01,514034,Herbst; Matthew,15,0,16,1
1713340669070,MMW 12R,A02,514035,Herbst; Matthew,16,0,16,0
1713340670098,MMW 13R,A01,514037,Staff,12,0,16,4
1713340670098,MMW 13R,A02,514039,Staff,16,0,16,0
1713340672151,SIO 295LS,A00,523233,Staff,19,0,30,11
1713340673177,SIO 295S,A00,523232,Staff,19,0,30,11
1713340674207,SOCI 117,A01,494376,Staff,1,0,5,4
1713340675236,WES 237B,A00,494380,Staff,19,0,20,1
1713340677312,AESE 279B,A00,494370,Wade; Jon P,33,0,33,0
1713340678345,ANAR 135S,A00,494369,Braswell; Geoffrey E.,0,0,0,0
1713340679377,CAT 124RS,A01,519847,Geibel; William,17,0,20,3
1713340680408,CAT 125RS,A01,515971,Geibel; William,17,0,20,3
1713340681434,CLRE 250,A00,511389,Morris; Sheldon,9996,0,9999,3
1713340682468,CLRE 251,A00,507176,Mehta; Ravindra L.,9996,0,9999,3
1713340682468,CLRE 251,B00,511410,Mehta; Ravindra L.,9998,0,9999,1
1713340683493,CLRE 252,A00,507189,Cuomo; Raphael Eduardo,9998,0,9999,1
1713340684520,CLRE 253,A00,507199,Vaida; Florin,9997,0,9999,2
1713340684520,CLRE 253,B00,507202,Vaida; Florin,9999,0,9999,0
1713340685547,CLRE 259,A00,507211,Patel; Hemal,9996,0,9999,3
1713340686573,CLRE 260,A00,507221,Cuomo; Raphael Eduardo,9999,0,9999,0
1713340687602,CLRE 297,001,507242,Cuomo; Raphael Eduardo,9999,0,9999,0
1713340688633,CSE 191,A00,516875,Minnes Kemp; Mor Mia,9999,0,9999,0
1713340689664,CSS 201S,A01,494383,Staff,35,0,35,0
1713340690689,CSS 202S,A01,494387,Staff,35,0,35,0
1713340691718,EAP 100,A00,516065,Staff,9792,0,9999,207
1713340692745,ECE 45,A01,507414,Staff,51,0,60,9
1713340693773,ECE 100,A01,507416,Baghdadchi; Saharnaz,10,0,20,10
1713340693773,ECE 100,A02,507418,Baghdadchi; Saharnaz,20,0,20,0
1713340694804,ECE 111,A01,507420,Staff,38,0,50,12
1713340695836,ECE 197,001,548057,Sievenpiper; Daniel F.,9998,0,9999,1
1713340696862,EDS 115,A00,507243,Choi; Bailey Miyeon,28,0,28,0
1713340697891,EDS 117,A01,494379,Staff,23,0,25,2
1713340698917,EDS 125,A00,507246,Hopkins; Megan Beth,29,0,30,1
1713340699945,EDS 128A,A01,507264,Fargason; Sharon Gayle,26,0,26,0
1713340700974,EDS 128B,A01,507293,Pappas; Elizabeth,30,0,30,0
1713340702004,EDS 139,A00,507294,Fargason; Sharon Gayle,30,0,30,0
1713340702004,EDS 139,B00,507313,Pappas; Elizabeth,30,0,30,0
1713340703029,EDS 201,A00,507315,Staff,26,0,30,4
1713340704064,EDS 203,A01,507317,Halter; Christopher P.,26,0,30,4
1713340705090,EDS 204R,A01,507319,Halter; Christopher P.,3,0,30,27
1713340705090,EDS 204R,B01,507331,Heinzman; Erica M.,28,0,30,2
1713340706115,EDS 206R,A00,507332,Staff,4,0,30,26
1713340706115,EDS 206R,B00,507343,Staff,28,0,30,2
1713340707142,EDS 250,A00,507344,Hemans; Patricia Ann Benitez,36,0,40,4
1713340708166,EDS 281,A00,507345,Daly; Alan J.,18,0,18,0
1713340709191,EDS 284,A00,507350,Daly; Alan J.,16,0,16,0
1713340710218,EDS 286,A00,507359,Fine; Sarah,18,0,18,0
1713340711244,EDS 289C,A01,507361,Daly; Alan J.,18,0,18,0
1713340712273,EDS 290,A00,507366,Hofstetter; Carolyn,15,0,15,0
1713340713299,LIGM 5A,A00,507421,Fischer-Grunski; Eva K,20,0,20,0
1713340714326,LIGM 5B,A00,507423,Fischer-Grunski; Eva K,20,0,20,0
1713340715352,LIGM 5C,A00,507425,Fischer-Grunski; Eva K,20,0,20,0
1713340716385,LIIT 5AS,A00,507427,Carnelos; Chiara,20,0,20,0
1713340717410,LIIT 5BS,A00,507430,Carnelos; Chiara,20,0,20,0
1713340718439,LIIT 5CS,A00,507432,Carnelos; Chiara,20,0,20,0
1713340719466,LISP 5A,A00,507541,Munoz Sanchez; Alicia,17,0,20,3
1713340720494,LISP 5B,A00,507671,Munoz Sanchez; Alicia,15,0,20,5
1713340721518,LISP 5C,A00,507696,Munoz Sanchez; Alicia,15,0,20,5
1713340722547,MAE 197,001,528363,Boechler; Nicholas Sebastia,9998,0,9999,1
1713340723581,MATH 197,001,523477,Kedlaya; Kiran S.,9999,0,9999,0
1713340723581,MATH 197,002,563811,Zhang; Danna,9999,0,9999,0
1713340724607,MCWP 40R,A00,518780,Staff,20,0,20,0
1713340724607,MCWP 40R,B00,518781,Staff,19,0,20,1
1713340724607,MCWP 40R,C00,518783,Staff,19,0,20,1
1713340725634,MCWP 50R,A00,518791,Staff,20,0,20,0
1713340725634,MCWP 50R,B00,518792,Staff,17,0,20,3
1713340725634,MCWP 50R,C00,518793,Staff,19,0,20,1
1713340725634,MCWP 50R,D00,518794,Staff,16,0,20,4
1713340725634,MCWP 50R,E00,518795,Staff,16,0,20,4
1713340725634,MCWP 50R,F00,518796,Staff,19,0,20,1
1713340725634,MCWP 50R,G00,518797,Staff,19,0,20,1
1713340726659,MMW 12R,A01,514034,Herbst; Matthew,15,0,16,1
1713340726659,MMW 12R,A02,514035,Herbst; Matthew,16,0,16,0
1713340727688,MMW 13R,A01,514037,Staff,12,0,16,4
1713340727688,MMW 13R,A02,514039,Staff,16,0,16,0
1713340729740,SIO 295LS,A00,523233,Staff,19,0,30,11
1713340730765,SIO 295S,A00,523232,Staff,19,0,30,11
1713340731790,SOCI 117,A01,494376,Staff,1,0,5,4
1713340732816,WES 237B,A00,494380,Staff,19,0,20,1
1713340734883,AESE 279B,A00,494370,Wade; Jon P,33,0,33,0
1713340735913,ANAR 135S,A00,494369,Braswell; Geoffrey E.,0,0,0,0
1713340736938,CAT 124RS,A01,519847,Geibel; William,17,0,20,3
1713340737967,CAT 125RS,A01,515971,Geibel; William,17,0,20,3
1713340739000,CLRE 250,A00,511389,Morris; Sheldon,9996,0,9999,3
1713340740034,CLRE 251,A00,507176,Mehta; Ravindra L.,9996,0,9999,3
1713340740034,CLRE 251,B00,511410,Mehta; Ravindra L.,9998,0,9999,1
1713340741061,CLRE 252,A00,507189,Cuomo; Raphael Eduardo,9998,0,9999,1
1713340742144,CLRE 253,A00,507199,Vaida; Florin,9997,0,9999,2
1713340742144,CLRE 253,B00,507202,Vaida; Florin,9999,0,9999,0
1713340743171,CLRE 259,A00,507211,Patel; Hemal,9996,0,9999,3
1713340744200,CLRE 260,A00,507221,Cuomo; Raphael Eduardo,9999,0,9999,0
1713340745224,CLRE 297,001,507242,Cuomo; Raphael Eduardo,9999,0,9999,0
1713340746250,CSE 191,A00,516875,Minnes Kemp; Mor Mia,9999,0,9999,0
1713340747278,CSS 201S,A01,494383,Staff,35,0,35,0
1713340748305,CSS 202S,A01,494387,Staff,35,0,35,0
1713340749330,EAP 100,A00,516065,Staff,9792,0,9999,207
1713340750360,ECE 45,A01,507414,Staff,51,0,60,9
1713340751391,ECE 100,A01,507416,Baghdadchi; Saharnaz,10,0,20,10
1713340751391,ECE 100,A02,507418,Baghdadchi; Saharnaz,20,0,20,0
1713340752414,ECE 111,A01,507420,Staff,38,0,50,12
1713340753440,ECE 197,001,548057,Sievenpiper; Daniel F.,9998,0,9999,1
1713340754467,EDS 115,A00,507243,Choi; Bailey Miyeon,28,0,28,0
1713340755492,EDS 117,A01,494379,Staff,23,0,25,2
1713340756517,EDS 125,A00,507246,Hopkins; Megan Beth,29,0,30,1
1713340757542,EDS 128A,A01,507264,Fargason; Sharon Gayle,26,0,26,0
1713340758573,EDS 128B,A01,507293,Pappas; Elizabeth,30,0,30,0
1713340759599,EDS 139,A00,507294,Fargason; Sharon Gayle,30,0,30,0
1713340759599,EDS 139,B00,507313,Pappas; Elizabeth,30,0,30,0
1713340760627,EDS 201,A00,507315,Staff,26,0,30,4
1713340761653,EDS 203,A01,507317,Halter; Christopher P.,26,0,30,4
1713340762685,EDS 204R,A01,507319,Halter; Christopher P.,3,0,30,27
1713340762685,EDS 204R,B01,507331,Heinzman; Erica M.,28,0,30,2
1713340763711,EDS 206R,A00,507332,Staff,4,0,30,26
1713340763711,EDS 206R,B00,507343,Staff,28,0,30,2
1713340764739,EDS 250,A00,507344,Hemans; Patricia Ann Benitez,36,0,40,4
1713340765765,EDS 281,A00,507345,Daly; Alan J.,18,0,18,0
1713340766790,EDS 284,A00,507350,Daly; Alan J.,16,0,16,0
1713340767821,EDS 286,A00,507359,Fine; Sarah,18,0,18,0
1713340768848,EDS 289C,A01,507361,Daly; Alan J.,18,0,18,0
1713340769876,EDS 290,A00,507366,Hofstetter; Carolyn,15,0,15,0
1713340770902,LIGM 5A,A00,507421,Fischer-Grunski; Eva K,20,0,20,0
1713340771929,LIGM 5B,A00,507423,Fischer-Grunski; Eva K,20,0,20,0
1713340772955,LIGM 5C,A00,507425,Fischer-Grunski; Eva K,20,0,20,0
1713340773986,LIIT 5AS,A00,507427,Carnelos; Chiara,20,0,20,0
1713340775016,LIIT 5BS,A00,507430,Carnelos; Chiara,20,0,20,0
1713340776048,LIIT 5CS,A00,507432,Carnelos; Chiara,20,0,20,0
1713340777078,LISP 5A,A00,507541,Munoz Sanchez; Alicia,17,0,20,3
1713340778103,LISP 5B,A00,507671,Munoz Sanchez; Alicia,15,0,20,5
1713340779129,LISP 5C,A00,507696,Munoz Sanchez; Alicia,15,0,20,5
1713340780155,MAE 197,001,528363,Boechler; Nicholas Sebastia,9998,0,9999,1
1713340781187,MATH 197,001,523477,Kedlaya; Kiran S.,9999,0,9999,0
1713340781187,MATH 197,002,563811,Zhang; Danna,9999,0,9999,0
1713340782215,MCWP 40R,A00,518780,Staff,20,0,20,0
1713340782215,MCWP 40R,B00,518781,Staff,19,0,20,1
1713340782215,MCWP 40R,C00,518783,Staff,19,0,20,1
1713340783242,MCWP 50R,A00,518791,Staff,20,0,20,0
1713340783242,MCWP 50R,B00,518792,Staff,17,0,20,3
1713340783242,MCWP 50R,C00,518793,Staff,19,0,20,1
1713340783242,MCWP 50R,D00,518794,Staff,16,0,20,4
1713340783242,MCWP 50R,E00,518795,Staff,16,0,20,4
1713340783242,MCWP 50R,F00,518796,Staff,19,0,20,1
1713340783242,MCWP 50R,G00,518797,Staff,19,0,20,1
1713340784268,MMW 12R,A01,514034,Herbst; Matthew,15,0,16,1
1713340784268,MMW 12R,A02,514035,Herbst; Matthew,16,0,16,0
1713340785294,MMW 13R,A01,514037,Staff,12,0,16,4
1713340785294,MMW 13R,A02,514039,Staff,16,0,16,0
1713340787350,SIO 295LS,A00,523233,Staff,19,0,30,11
1713340788380,SIO 295S,A00,523232,Staff,19,0,30,11
1713340789408,SOCI 117,A01,494376,Staff,1,0,5,4
1713340790435,WES 237B,A00,494380,Staff,19,0,20,1
1713340792512,AESE 279B,A00,494370,Wade; Jon P,33,0,33,0
1713340793538,ANAR 135S,A00,494369,Braswell; Geoffrey E.,0,0,0,0
1713340794573,CAT 124RS,A01,519847,Geibel; William,17,0,20,3
1713340795599,CAT 125RS,A01,515971,Geibel; William,17,0,20,3
1713340796627,CLRE 250,A00,511389,Morris; Sheldon,9996,0,9999,3
1713340797659,CLRE 251,A00,507176,Mehta; Ravindra L.,9996,0,9999,3
1713340797659,CLRE 251,B00,511410,Mehta; Ravindra L.,9998,0,9999,1
1713340798686,CLRE 252,A00,507189,Cuomo; Raphael Eduardo,9998,0,9999,1
1713340799718,CLRE 253,A00,507199,Vaida; Florin,9997,0,9999,2
1713340799718,CLRE 253,B00,507202,Vaida; Florin,9999,0,9999,0
1713340800747,CLRE 259,A00,507211,Patel; Hemal,9996,0,9999,3
1713340801772,CLRE 260,A00,507221,Cuomo; Raphael Eduardo,9999,0,9999,0
1713340802803,CLRE 297,001,507242,Cuomo; Raphael Eduardo,9999,0,9999,0
1713340803832,CSE 191,A00,516875,Minnes Kemp; Mor Mia,9999,0,9999,0
1713340804857,CSS 201S,A01,494383,Staff,35,0,35,0
1713340805886,CSS 202S,A01,494387,Staff,35,0,35,0
1713340806910,EAP 100,A00,516065,Staff,9792,0,9999,207
1713340807938,ECE 45,A01,507414,Staff,51,0,60,9
1713340808965,ECE 100,A01,507416,Baghdadchi; Saharnaz,10,0,20,10
1713340808965,ECE 100,A02,507418,Baghdadchi; Saharnaz,20,0,20,0
1713340809991,ECE 111,A01,507420,Staff,38,0,50,12
1713340811022,ECE 197,001,548057,Sievenpiper; Daniel F.,9998,0,9999,1
1713340812054,EDS 115,A00,507243,Choi; Bailey Miyeon,28,0,28,0
1713340813080,EDS 117,A01,494379,Staff,23,0,25,2
1713340814107,EDS 125,A00,507246,Hopkins; Megan Beth,29,0,30,1
1713340815134,EDS 128A,A01,507264,Fargason; Sharon Gayle,26,0,26,0
1713340816161,EDS 128B,A01,507293,Pappas; Elizabeth,30,0,30,0
1713340817190,EDS 139,A00,507294,Fargason; Sharon Gayle,30,0,30,0
1713340817190,EDS 139,B00,507313,Pappas; Elizabeth,30,0,30,0
1713340818216,EDS 201,A00,507315,Staff,26,0,30,4
1713340819244,EDS 203,A01,507317,Halter; Christopher P.,26,0,30,4
1713340820270,EDS 204R,A01,507319,Halter; Christopher P.,3,0,30,27
1713340820270,EDS 204R,B01,507331,Heinzman; Erica M.,28,0,30,2
1713340821300,EDS 206R,A00,507332,Staff,4,0,30,26
1713340821300,EDS 206R,B00,507343,Staff,28,0,30,2
1713340822325,EDS 250,A00,507344,Hemans; Patricia Ann Benitez,36,0,40,4
1713340823352,EDS 281,A00,507345,Daly; Alan J.,18,0,18,0
1713340824378,EDS 284,A00,507350,Daly; Alan J.,16,0,16,0
1713340825414,EDS 286,A00,507359,Fine; Sarah,18,0,18,0
1713340826445,EDS 289C,A01,507361,Daly; Alan J.,18,0,18,0
1713340827470,EDS 290,A00,507366,Hofstetter; Carolyn,15,0,15,0
1713340828497,LIGM 5A,A00,507421,Fischer-Grunski; Eva K,20,0,20,0
1713340829527,LIGM 5B,A00,507423,Fischer-Grunski; Eva K,20,0,20,0
1713340830556,LIGM 5C,A00,507425,Fischer-Grunski; Eva K,20,0,20,0
1713340831591,LIIT 5AS,A00,507427,Carnelos; Chiara,20,0,20,0
1713340832618,LIIT 5BS,A00,507430,Carnelos; Chiara,20,0,20,0
1713340833656,LIIT 5CS,A00,507432,Carnelos; Chiara,20,0,20,0
1713340834682,LISP 5A,A00,507541,Munoz Sanchez; Alicia,17,0,20,3
1713340835711,LISP 5B,A00,507671,Munoz Sanchez; Alicia,15,0,20,5
1713340836736,LISP 5C,A00,507696,Munoz Sanchez; Alicia,15,0,20,5
1713340837767,MAE 197,001,528363,Boechler; Nicholas Sebastia,9998,0,9999,1
1713340838792,MATH 197,001,523477,Kedlaya; Kiran S.,9999,0,9999,0
1713340838792,MATH 197,002,563811,Zhang; Danna,9999,0,9999,0
1713340839828,MCWP 40R,A00,518780,Staff,20,0,20,0
1713340839828,MCWP 40R,B00,518781,Staff,19,0,20,1
1713340839828,MCWP 40R,C00,518783,Staff,19,0,20,1
1713340840858,MCWP 50R,A00,518791,Staff,20,0,20,0
1713340840858,MCWP 50R,B00,518792,Staff,17,0,20,3
1713340840858,MCWP 50R,C00,518793,Staff,19,0,20,1
1713340840858,MCWP 50R,D00,518794,Staff,16,0,20,4
1713340840858,MCWP 50R,E00,518795,Staff,16,0,20,4
1713340840858,MCWP 50R,F00,518796,Staff,19,0,20,1
1713340840858,MCWP 50R,G00,518797,Staff,19,0,20,1
1713340841884,MMW 12R,A01,514034,Herbst; Matthew,15,0,16,1
1713340841884,MMW 12R,A02,514035,Herbst; Matthew,16,0,16,0
1713340842910,MMW 13R,A01,514037,Staff,12,0,16,4
1713340842910,MMW 13R,A02,514039,Staff,16,0,16,0
1713340844962,SIO 295LS,A00,523233,Staff,19,0,30,11
1713340846049,SIO 295S,A00,523232,Staff,19,0,30,11
1713340847589,SOCI 117,A01,494376,Staff,1,0,5,4
1713340848621,WES 237B,A00,494380,Staff,19,0,20,1
1713340850710,AESE 279B,A00,494370,Wade; Jon P,33,0,33,0
1713340851739,ANAR 135S,A00,494369,Braswell; Geoffrey E.,0,0,0,0
1713340852770,CAT 124RS,A01,519847,Geibel; William,17,0,20,3
1713340853795,CAT 125RS,A01,515971,Geibel; William,17,0,20,3
1713340854821,CLRE 250,A00,511389,Morris; Sheldon,9996,0,9999,3
1713340855847,CLRE 251,A00,507176,Mehta; Ravindra L.,9996,0,9999,3
1713340855847,CLRE 251,B00,511410,Mehta; Ravindra L.,9998,0,9999,1
1713340856873,CLRE 252,A00,507189,Cuomo; Raphael Eduardo,9998,0,9999,1
1713340857903,CLRE 253,A00,507199,Vaida; Florin,9997,0,9999,2
1713340857903,CLRE 253,B00,507202,Vaida; Florin,9999,0,9999,0
1713340858927,CLRE 259,A00,507211,Patel; Hemal,9996,0,9999,3
1713340859950,CLRE 260,A00,507221,Cuomo; Raphael Eduardo,9999,0,9999,0
1713340860976,CLRE 297,001,507242,Cuomo; Raphael Eduardo,9999,0,9999,0
1713340862002,CSE 191,A00,516875,Minnes Kemp; Mor Mia,9999,0,9999,0
1713340863026,CSS 201S,A01,494383,Staff,35,0,35,0
1713340864052,CSS 202S,A01,494387,Staff,35,0,35,0
1713340865079,EAP 100,A00,516065,Staff,9792,0,9999,207
1713340866107,ECE 45,A01,507414,Staff,51,0,60,9
1713340867137,ECE 100,A01,507416,Baghdadchi; Saharnaz,10,0,20,10
1713340867137,ECE 100,A02,507418,Baghdadchi; Saharnaz,20,0,20,0
1713340868162,ECE 111,A01,507420,Staff,38,0,50,12
1713340869192,ECE 197,001,548057,Sievenpiper; Daniel F.,9998,0,9999,1
1713340870223,EDS 115,A00,507243,Choi; Bailey Miyeon,28,0,28,0
1713340871253,EDS 117,A01,494379,Staff,23,0,25,2
1713340872278,EDS 125,A00,507246,Hopkins; Megan Beth,29,0,30,1
1713340873308,EDS 128A,A01,507264,Fargason; Sharon Gayle,26,0,26,0
1713340874333,EDS 128B,A01,507293,Pappas; Elizabeth,30,0,30,0
1713340875359,EDS 139,A00,507294,Fargason; Sharon Gayle,30,0,30,0
1713340875359,EDS 139,B00,507313,Pappas; Elizabeth,30,0,30,0
1713340876385,EDS 201,A00,507315,Staff,26,0,30,4
1713340877416,EDS 203,A01,507317,Halter; Christopher P.,26,0,30,4
1713340878446,EDS 204R,A01,507319,Halter; Christopher P.,3,0,30,27
1713340878446,EDS 204R,B01,507331,Heinzman; Erica M.,28,0,30,2
1713340879477,EDS 206R,A00,507332,Staff,4,0,30,26
1713340879477,EDS 206R,B00,507343,Staff,28,0,30,2
1713340880503,EDS 250,A00,507344,Hemans; Patricia Ann Benitez,36,0,40,4
1713340881532,EDS 281,A00,507345,Daly; Alan J.,18,0,18,0
1713340882564,EDS 284,A00,507350,Daly; Alan J.,16,0,16,0
1713340883595,EDS 286,A00,507359,Fine; Sarah,18,0,18,0
1713340884624,EDS 289C,A01,507361,Daly; Alan J.,18,0,18,0
1713340885651,EDS 290,A00,507366,Hofstetter; Carolyn,15,0,15,0
1713340886683,LIGM 5A,A00,507421,Fischer-Grunski; Eva K,20,0,20,0
1713340887713,LIGM 5B,A00,507423,Fischer-Grunski; Eva K,20,0,20,0
1713340888743,LIGM 5C,A00,507425,Fischer-Grunski; Eva K,20,0,20,0
1713340889771,LIIT 5AS,A00,507427,Carnelos; Chiara,20,0,20,0
1713340890801,LIIT 5BS,A00,507430,Carnelos; Chiara,20,0,20,0
1713340891831,LIIT 5CS,A00,507432,Carnelos; Chiara,20,0,20,0
1713340892858,LISP 5A,A00,507541,Munoz Sanchez; Alicia,17,0,20,3
1713340893893,LISP 5B,A00,507671,Munoz Sanchez; Alicia,15,0,20,5
1713340894922,LISP 5C,A00,507696,Munoz Sanchez; Alicia,15,0,20,5
1713340895947,MAE 197,001,528363,Boechler; Nicholas Sebastia,9998,0,9999,1
1713340896972,MATH 197,001,523477,Kedlaya; Kiran S.,9999,0,9999,0
1713340896972,MATH 197,002,563811,Zhang; Danna,9999,0,9999,0
1713340897998,MCWP 40R,A00,518780,Staff,20,0,20,0
1713340897998,MCWP 40R,B00,518781,Staff,19,0,20,1
1713340897998,MCWP 40R,C00,518783,Staff,19,0,20,1
1713340899022,MCWP 50R,A00,518791,Staff,20,0,20,0
1713340899022,MCWP 50R,B00,518792,Staff,17,0,20,3
1713340899022,MCWP 50R,C00,518793,Staff,19,0,20,1
1713340899022,MCWP 50R,D00,518794,Staff,16,0,20,4
1713340899022,MCWP 50R,E00,518795,Staff,16,0,20,4
1713340899022,MCWP 50R,F00,518796,Staff,19,0,20,1
1713340899022,MCWP 50R,G00,518797,Staff,19,0,20,1
1713340900054,MMW 12R,A01,514034,Herbst; Matthew,15,0,16,1
1713340900054,MMW 12R,A02,514035,Herbst; Matthew,16,0,16,0
1713340901080,MMW 13R,A01,514037,Staff,12,0,16,4
1713340901080,MMW 13R,A02,514039,Staff,16,0,16,0
1713340903144,SIO 295LS,A00,523233,Staff,19,0,30,11
1713340904177,SIO 295S,A00,523232,Staff,19,0,30,11
1713340905202,SOCI 117,A01,494376,Staff,1,0,5,4
1713340906229,WES 237B,A00,494380,Staff,19,0,20,1
1713340908312,AESE 279B,A00,494370,Wade; Jon P,33,0,33,0
1713340909337,ANAR 135S,A00,494369,Braswell; Geoffrey E.,0,0,0,0
1713340910370,CAT 124RS,A01,519847,Geibel; William,17,0,20,3
1713340911394,CAT 125RS,A01,515971,Geibel; William,17,0,20,3
1713340912421,CLRE 250,A00,511389,Morris; Sheldon,9996,0,9999,3
1713340913450,CLRE 251,A00,507176,Mehta; Ravindra L.,9996,0,9999,3
1713340913450,CLRE 251,B00,511410,Mehta; Ravindra L.,9998,0,9999,1
1713340914485,CLRE 252,A00,507189,Cuomo; Raphael Eduardo,9998,0,9999,1
1713340915517,CLRE 253,A00,507199,Vaida; Florin,9997,0,9999,2
1713340915517,CLRE 253,B00,507202,Vaida; Florin,9999,0,9999,0
1713340916544,CLRE 259,A00,507211,Patel; Hemal,9996,0,9999,3
1713340917573,CLRE 260,A00,507221,Cuomo; Raphael Eduardo,9999,0,9999,0
1713340918600,CLRE 297,001,507242,Cuomo; Raphael Eduardo,9999,0,9999,0
1713340919631,CSE 191,A00,516875,Minnes Kemp; Mor Mia,9999,0,9999,0
1713340920659,CSS 201S,A01,494383,Staff,35,0,35,0
1713340921686,CSS 202S,A01,494387,Staff,35,0,35,0
1713340922712,EAP 100,A00,516065,Staff,9792,0,9999,207
1713340923739,ECE 45,A01,507414,Staff,51,0,60,9
1713340924766,ECE 100,A01,507416,Baghdadchi; Saharnaz,10,0,20,10
1713340924766,ECE 100,A02,507418,Baghdadchi; Saharnaz,20,0,20,0
1713340925793,ECE 111,A01,507420,Staff,38,0,50,12
1713340926819,ECE 197,001,548057,Sievenpiper; Daniel F.,9998,0,9999,1
1713340927849,EDS 115,A00,507243,Choi; Bailey Miyeon,28,0,28,0
1713340928881,EDS 117,A01,494379,Staff,23,0,25,2
1713340929912,EDS 125,A00,507246,Hopkins; Megan Beth,29,0,30,1
1713340930942,EDS 128A,A01,507264,Fargason; Sharon Gayle,26,0,26,0
1713340931974,EDS 128B,A01,507293,Pappas; Elizabeth,30,0,30,0
1713340933001,EDS 139,A00,507294,Fargason; Sharon Gayle,30,0,30,0
1713340933001,EDS 139,B00,507313,Pappas; Elizabeth,30,0,30,0
1713340934031,EDS 201,A00,507315,Staff,26,0,30,4
1713340935057,EDS 203,A01,507317,Halter; Christopher P.,26,0,30,4
1713340936090,EDS 204R,A01,507319,Halter; Christopher P.,3,0,30,27
1713340936090,EDS 204R,B01,507331,Heinzman; Erica M.,28,0,30,2
1713340937119,EDS 206R,A00,507332,Staff,4,0,30,26
1713340937119,EDS 206R,B00,507343,Staff,28,0,30,2
1713340938146,EDS 250,A00,507344,Hemans; Patricia Ann Benitez,36,0,40,4
1713340939171,EDS 281,A00,507345,Daly; Alan J.,18,0,18,0
1713340940199,EDS 284,A00,507350,Daly; Alan J.,16,0,16,0
1713340941228,EDS 286,A00,507359,Fine; Sarah,18,0,18,0
1713340942256,EDS 289C,A01,507361,Daly; Alan J.,18,0,18,0
1713340943286,EDS 290,A00,507366,Hofstetter; Carolyn,15,0,15,0
1713340944316,LIGM 5A,A00,507421,Fischer-Grunski; Eva K,20,0,20,0
1713340945343,LIGM 5B,A00,507423,Fischer-Grunski; Eva K,20,0,20,0
1713340946369,LIGM 5C,A00,507425,Fischer-Grunski; Eva K,20,0,20,0
1713340947395,LIIT 5AS,A00,507427,Carnelos; Chiara,20,0,20,0
1713340948421,LIIT 5BS,A00,507430,Carnelos; Chiara,20,0,20,0
1713340949447,LIIT 5CS,A00,507432,Carnelos; Chiara,20,0,20,0
1713340950548,LISP 5A,A00,507541,Munoz Sanchez; Alicia,17,0,20,3
1713340951574,LISP 5B,A00,507671,Munoz Sanchez; Alicia,15,0,20,5
1713340952604,LISP 5C,A00,507696,Munoz Sanchez; Alicia,15,0,20,5
1713340953631,MAE 197,001,528363,Boechler; Nicholas Sebastia,9998,0,9999,1
1713340954659,MATH 197,001,523477,Kedlaya; Kiran S.,9999,0,9999,0
1713340954659,MATH 197,002,563811,Zhang; Danna,9999,0,9999,0
1713340955688,MCWP 40R,A00,518780,Staff,20,0,20,0
1713340955688,MCWP 40R,B00,518781,Staff,19,0,20,1
1713340955688,MCWP 40R,C00,518783,Staff,19,0,20,1
1713340956719,MCWP 50R,A00,518791,Staff,20,0,20,0
1713340956719,MCWP 50R,B00,518792,Staff,17,0,20,3
1713340956719,MCWP 50R,C00,518793,Staff,19,0,20,1
1713340956719,MCWP 50R,D00,518794,Staff,16,0,20,4
1713340956719,MCWP 50R,E00,518795,Staff,16,0,20,4
1713340956719,MCWP 50R,F00,518796,Staff,19,0,20,1
1713340956719,MCWP 50R,G00,518797,Staff,19,0,20,1
1713340957747,MMW 12R,A01,514034,Herbst; Matthew,15,0,16,1
1713340957747,MMW 12R,A02,514035,Herbst; Matthew,16,0,16,0
1713340958772,MMW 13R,A01,514037,Staff,12,0,16,4
1713340958772,MMW 13R,A02,514039,Staff,16,0,16,0
1713340960824,SIO 295LS,A00,523233,Staff,19,0,30,11
1713340961850,SIO 295S,A00,523232,Staff,19,0,30,11
1713340962878,SOCI 117,A01,494376,Staff,1,0,5,4
1713340963903,WES 237B,A00,494380,Staff,19,0,20,1
1713340965977,AESE 279B,A00,494370,Wade; Jon P,33,0,33,0
1713340967004,ANAR 135S,A00,494369,Braswell; Geoffrey E.,0,0,0,0
1713340968034,CAT 124RS,A01,519847,Geibel; William,17,0,20,3
1713340969060,CAT 125RS,A01,515971,Geibel; William,17,0,20,3
1713340970086,CLRE 250,A00,511389,Morris; Sheldon,9996,0,9999,3
1713340971113,CLRE 251,A00,507176,Mehta; Ravindra L.,9996,0,9999,3
1713340971113,CLRE 251,B00,511410,Mehta; Ravindra L.,9998,0,9999,1
1713340972142,CLRE 252,A00,507189,Cuomo; Raphael Eduardo,9998,0,9999,1
1713340973172,CLRE 253,A00,507199,Vaida; Florin,9997,0,9999,2
1713340973172,CLRE 253,B00,507202,Vaida; Florin,9999,0,9999,0
1713340974195,CLRE 259,A00,507211,Patel; Hemal,9996,0,9999,3
1713340975225,CLRE 260,A00,507221,Cuomo; Raphael Eduardo,9999,0,9999,0
1713340976251,CLRE 297,001,507242,Cuomo; Raphael Eduardo,9999,0,9999,0
1713340977276,CSE 191,A00,516875,Minnes Kemp; Mor Mia,9999,0,9999,0
1713340978304,CSS 201S,A01,494383,Staff,35,0,35,0
1713340979331,CSS 202S,A01,494387,Staff,35,0,35,0
1713340980360,EAP 100,A00,516065,Staff,9792,0,9999,207
1713340981386,ECE 45,A01,507414,Staff,51,0,60,9
1713340982413,ECE 100,A01,507416,Baghdadchi; Saharnaz,10,0,20,10
1713340982413,ECE 100,A02,507418,Baghdadchi; Saharnaz,20,0,20,0
1713340983439,ECE 111,A01,507420,Staff,38,0,50,12
1713340984467,ECE 197,001,548057,Sievenpiper; Daniel F.,9998,0,9999,1
1713340985497,EDS 115,A00,507243,Choi; Bailey Miyeon,28,0,28,0
1713340986531,EDS 117,A01,494379,Staff,23,0,25,2
1713340987556,EDS 125,A00,507246,Hopkins; Megan Beth,29,0,30,1
1713340988584,EDS 128A,A01,507264,Fargason; Sharon Gayle,26,0,26,0
1713340989609,EDS 128B,A01,507293,Pappas; Elizabeth,30,0,30,0
1713340990638,EDS 139,A00,507294,Fargason; Sharon Gayle,30,0,30,0
1713340990638,EDS 139,B00,507313,Pappas; Elizabeth,30,0,30,0
1713340991669,EDS 201,A00,507315,Staff,26,0,30,4
1713340992693,EDS 203,A01,507317,Halter; Christopher P.,26,0,30,4
1713340993724,EDS 204R,A01,507319,Halter; Christopher P.,3,0,30,27
1713340993724,EDS 204R,B01,507331,Heinzman; Erica M.,28,0,30,2
1713340994756,EDS 206R,A00,507332,Staff,4,0,30,26
1713340994756,EDS 206R,B00,507343,Staff,28,0,30,2
1713340995782,EDS 250,A00,507344,Hemans; Patricia Ann Benitez,36,0,40,4
1713340996808,EDS 281,A00,507345,Daly; Alan J.,18,0,18,0
1713340997837,EDS 284,A00,507350,Daly; Alan J.,16,0,16,0
1713340998862,EDS 286,A00,507359,Fine; Sarah,18,0,18,0
1713340999893,EDS 289C,A01,507361,Daly; Alan J.,18,0,18,0
1713341000919,EDS 290,A00,507366,Hofstetter; Carolyn,15,0,15,0
1713341001949,LIGM 5A,A00,507421,Fischer-Grunski; Eva K,20,0,20,0
1713341002975,LIGM 5B,A00,507423,Fischer-Grunski; Eva K,20,0,20,0
1713341004001,LIGM 5C,A00,507425,Fischer-Grunski; Eva K,20,0,20,0
1713341005030,LIIT 5AS,A00,507427,Carnelos; Chiara,20,0,20,0
1713341006059,LIIT 5BS,A00,507430,Carnelos; Chiara,20,0,20,0
1713341007089,LIIT 5CS,A00,507432,Carnelos; Chiara,20,0,20,0
1713341008121,LISP 5A,A00,507541,Munoz Sanchez; Alicia,17,0,20,3
1713341009144,LISP 5B,A00,507671,Munoz Sanchez; Alicia,15,0,20,5
1713341010169,LISP 5C,A00,507696,Munoz Sanchez; Alicia,15,0,20,5
1713341011255,MAE 197,001,528363,Boechler; Nicholas Sebastia,9998,0,9999,1
1713341012283,MATH 197,001,523477,Kedlaya; Kiran S.,9999,0,9999,0
1713341012283,MATH 197,002,563811,Zhang; Danna,9999,0,9999,0
1713341013311,MCWP 40R,A00,518780,Staff,20,0,20,0
1713341013311,MCWP 40R,B00,518781,Staff,19,0,20,1
1713341013311,MCWP 40R,C00,518783,Staff,19,0,20,1
1713341014342,MCWP 50R,A00,518791,Staff,20,0,20,0
1713341014342,MCWP 50R,B00,518792,Staff,17,0,20,3
1713341014342,MCWP 50R,C00,518793,Staff,19,0,20,1
1713341014342,MCWP 50R,D00,518794,Staff,16,0,20,4
1713341014342,MCWP 50R,E00,518795,Staff,16,0,20,4
1713341014342,MCWP 50R,F00,518796,Staff,19,0,20,1
1713341014342,MCWP 50R,G00,518797,Staff,19,0,20,1
1713341015374,MMW 12R,A01,514034,Herbst; Matthew,15,0,16,1
1713341015374,MMW 12R,A02,514035,Herbst; Matthew,16,0,16,0
1713341016398,MMW 13R,A01,514037,Staff,12,0,16,4
1713341016398,MMW 13R,A02,514039,Staff,16,0,16,0
1713341018454,SIO 295LS,A00,523233,Staff,19,0,30,11
1713341019479,SIO 295S,A00,523232,Staff,19,0,30,11
1713341020505,SOCI 117,A01,494376,Staff,1,0,5,4
1713341021535,WES 237B,A00,494380,Staff,19,0,20,1
1713341023600,AESE 279B,A00,494370,Wade; Jon P,33,0,33,0
1713341024626,ANAR 135S,A00,494369,Braswell; Geoffrey E.,0,0,0,0
1713341025653,CAT 124RS,A01,519847,Geibel; William,17,0,20,3
1713341026678,CAT 125RS,A01,515971,Geibel; William,17,0,20,3
1713341027704,CLRE 250,A00,511389,Morris; Sheldon,9996,0,9999,3
1713341028736,CLRE 251,A00,507176,Mehta; Ravindra L.,9996,0,9999,3
1713341028736,CLRE 251,B00,511410,Mehta; Ravindra L.,9998,0,9999,1
1713341029760,CLRE 252,A00,507189,Cuomo; Raphael Eduardo,9998,0,9999,1
1713341030786,CLRE 253,A00,507199,Vaida; Florin,9997,0,9999,2
1713341030786,CLRE 253,B00,507202,Vaida; Florin,9999,0,9999,0
1713341031817,CLRE 259,A00,507211,Patel; Hemal,9996,0,9999,3
1713341032847,CLRE 260,A00,507221,Cuomo; Raphael Eduardo,9999,0,9999,0
1713341033879,CLRE 297,001,507242,Cuomo; Raphael Eduardo,9999,0,9999,0
1713341034904,CSE 191,A00,516875,Minnes Kemp; Mor Mia,9999,0,9999,0
1713341035937,CSS 201S,A01,494383,Staff,35,0,35,0
1713341036964,CSS 202S,A01,494387,Staff,35,0,35,0
1713341037989,EAP 100,A00,516065,Staff,9792,0,9999,207
1713341039018,ECE 45,A01,507414,Staff,51,0,60,9
1713341040053,ECE 100,A01,507416,Baghdadchi; Saharnaz,10,0,20,10
1713341040053,ECE 100,A02,507418,Baghdadchi; Saharnaz,20,0,20,0
1713341041083,ECE 111,A01,507420,Staff,38,0,50,12
1713341042112,ECE 197,001,548057,Sievenpiper; Daniel F.,9998,0,9999,1
1713341043142,EDS 115,A00,507243,Choi; Bailey Miyeon,28,0,28,0
1713341044168,EDS 117,A01,494379,Staff,23,0,25,2
1713341045193,EDS 125,A00,507246,Hopkins; Megan Beth,29,0,30,1
1713341046219,EDS 128A,A01,507264,Fargason; Sharon Gayle,26,0,26,0
1713341047247,EDS 128B,A01,507293,Pappas; Elizabeth,30,0,30,0
1713341048279,EDS 139,A00,507294,Fargason; Sharon Gayle,30,0,30,0
1713341048279,EDS 139,B00,507313,Pappas; Elizabeth,30,0,30,0
1713341049302,EDS 201,A00,507315,Staff,26,0,30,4
1713341050533,EDS 203,A01,507317,Halter; Christopher P.,26,0,30,4
1713341051562,EDS 204R,A01,507319,Halter; Christopher P.,3,0,30,27
1713341051562,EDS 204R,B01,507331,Heinzman; Erica M.,28,0,30,2
1713341052588,EDS 206R,A00,507332,Staff,4,0,30,26
1713341052588,EDS 206R,B00,507343,Staff,28,0,30,2
1713341053615,EDS 250,A00,507344,Hemans; Patricia Ann Benitez,36,0,40,4
1713341054699,EDS 281,A00,507345,Daly; Alan J.,18,0,18,0
1713341055729,EDS 284,A00,507350,Daly; Alan J.,16,0,16,0
1713341056759,EDS 286,A00,507359,Fine; Sarah,18,0,18,0
1713341057787,EDS 289C,A01,507361,Daly; Alan J.,18,0,18,0
1713341058817,EDS 290,A00,507366,Hofstetter; Carolyn,15,0,15,0
1713341059849,LIGM 5A,A00,507421,Fischer-Grunski; Eva K,20,0,20,0
1713341060875,LIGM 5B,A00,507423,Fischer-Grunski; Eva K,20,0,20,0
1713341061899,LIGM 5C,A00,507425,Fischer-Grunski; Eva K,20,0,20,0
1713341062925,LIIT 5AS,A00,507427,Carnelos; Chiara,20,0,20,0
1713341063952,LIIT 5BS,A00,507430,Carnelos; Chiara,20,0,20,0
1713341064977,LIIT 5CS,A00,507432,Carnelos; Chiara,20,0,20,0
1713341066009,LISP 5A,A00,507541,Munoz Sanchez; Alicia,17,0,20,3
1713341067037,LISP 5B,A00,507671,Munoz Sanchez; Alicia,15,0,20,5
1713341068066,LISP 5C,A00,507696,Munoz Sanchez; Alicia,15,0,20,5
1713341069097,MAE 197,001,528363,Boechler; Nicholas Sebastia,9998,0,9999,1
1713341070126,MATH 197,001,523477,Kedlaya; Kiran S.,9999,0,9999,0
1713341070126,MATH 197,002,563811,Zhang; Danna,9999,0,9999,0
1713341071152,MCWP 40R,A00,518780,Staff,20,0,20,0
1713341071152,MCWP 40R,B00,518781,Staff,19,0,20,1
1713341071152,MCWP 40R,C00,518783,Staff,19,0,20,1
1713341072188,MCWP 50R,A00,518791,Staff,20,0,20,0
1713341072188,MCWP 50R,B00,518792,Staff,17,0,20,3
1713341072188,MCWP 50R,C00,518793,Staff,19,0,20,1
1713341072188,MCWP 50R,D00,518794,Staff,16,0,20,4
1713341072188,MCWP 50R,E00,518795,Staff,16,0,20,4
1713341072188,MCWP 50R,F00,518796,Staff,19,0,20,1
1713341072188,MCWP 50R,G00,518797,Staff,19,0,20,1
1713341073212,MMW 12R,A01,514034,Herbst; Matthew,15,0,16,1
1713341073212,MMW 12R,A02,514035,Herbst; Matthew,16,0,16,0
1713341074242,MMW 13R,A01,514037,Staff,12,0,16,4
1713341074242,MMW 13R,A02,514039,Staff,16,0,16,0
1713341076292,SIO 295LS,A00,523233,Staff,19,0,30,11
1713341077317,SIO 295S,A00,523232,Staff,19,0,30,11
1713341078342,SOCI 117,A01,494376,Staff,1,0,5,4
1713341079371,WES 237B,A00,494380,Staff,19,0,20,1
1713341081445,AESE 279B,A00,494370,Wade; Jon P,33,0,33,0
1713341082469,ANAR 135S,A00,494369,Braswell; Geoffrey E.,0,0,0,0
1713341083495,CAT 124RS,A01,519847,Geibel; William,17,0,20,3
1713341084520,CAT 125RS,A01,515971,Geibel; William,17,0,20,3
1713341085547,CLRE 250,A00,511389,Morris; Sheldon,9996,0,9999,3
1713341086575,CLRE 251,A00,507176,Mehta; Ravindra L.,9996,0,9999,3
1713341086575,CLRE 251,B00,511410,Mehta; Ravindra L.,9998,0,9999,1
1713341087603,CLRE 252,A00,507189,Cuomo; Raphael Eduardo,9998,0,9999,1
1713341088629,CLRE 253,A00,507199,Vaida; Florin,9997,0,9999,2
1713341088629,CLRE 253,B00,507202,Vaida; Florin,9999,0,9999,0
1713341089654,CLRE 259,A00,507211,Patel; Hemal,9996,0,9999,3
1713341090684,CLRE 260,A00,507221,Cuomo; Raphael Eduardo,9999,0,9999,0
1713341091713,CLRE 297,001,507242,Cuomo; Raphael Eduardo,9999,0,9999,0
1713341092739,CSE 191,A00,516875,Minnes Kemp; Mor Mia,9999,0,9999,0
1713341093766,CSS 201S,A01,494383,Staff,35,0,35,0
1713341094792,CSS 202S,A01,494387,Staff,35,0,35,0
1713341095823,EAP 100,A00,516065,Staff,9792,0,9999,207
1713341096850,ECE 45,A01,507414,Staff,51,0,60,9
1713341097876,ECE 100,A01,507416,Baghdadchi; Saharnaz,10,0,20,10
1713341097876,ECE 100,A02,507418,Baghdadchi; Saharnaz,20,0,20,0
1713341098902,ECE 111,A01,507420,Staff,38,0,50,12
1713341099932,ECE 197,001,548057,Sievenpiper; Daniel F.,9998,0,9999,1
1713341100961,EDS 115,A00,507243,Choi; Bailey Miyeon,28,0,28,0
1713341101992,EDS 117,A01,494379,Staff,23,0,25,2
1713341103017,EDS 125,A00,507246,Hopkins; Megan Beth,29,0,30,1
1713341104047,EDS 128A,A01,507264,Fargason; Sharon Gayle,26,0,26,0
1713341105079,EDS 128B,A01,507293,Pappas; Elizabeth,30,0,30,0
1713341106106,EDS 139,A00,507294,Fargason; Sharon Gayle,30,0,30,0
1713341106106,EDS 139,B00,507313,Pappas; Elizabeth,30,0,30,0
1713341107132,EDS 201,A00,507315,Staff,26,0,30,4
1713341108160,EDS 203,A01,507317,Halter; Christopher P.,26,0,30,4
1713341109187,EDS 204R,A01,507319,Halter; Christopher P.,3,0,30,27
1713341109187,EDS 204R,B01,507331,Heinzman; Erica M.,28,0,30,2
1713341110215,EDS 206R,A00,507332,Staff,4,0,30,26
1713341110215,EDS 206R,B00,507343,Staff,28,0,30,2
1713341111241,EDS 250,A00,507344,Hemans; Patricia Ann Benitez,36,0,40,4
1713341112266,EDS 281,A00,507345,Daly; Alan J.,18,0,18,0
1713341113291,EDS 284,A00,507350,Daly; Alan J.,16,0,16,0
1713341114324,EDS 286,A00,507359,Fine; Sarah,18,0,18,0
1713341115350,EDS 289C,A01,507361,Daly; Alan J.,18,0,18,0
1713341116377,EDS 290,A00,507366,Hofstetter; Carolyn,15,0,15,0
1713341117412,LIGM 5A,A00,507421,Fischer-Grunski; Eva K,20,0,20,0
1713341118436,LIGM 5B,A00,507423,Fischer-Grunski; Eva K,20,0,20,0
1713341119463,LIGM 5C,A00,507425,Fischer-Grunski; Eva K,20,0,20,0
1713341120487,LIIT 5AS,A00,507427,Carnelos; Chiara,20,0,20,0
1713341121517,LIIT 5BS,A00,507430,Carnelos; Chiara,20,0,20,0
1713341122549,LIIT 5CS,A00,507432,Carnelos; Chiara,20,0,20,0
1713341123578,LISP 5A,A00,507541,Munoz Sanchez; Alicia,17,0,20,3
1713341124607,LISP 5B,A00,507671,Munoz Sanchez; Alicia,15,0,20,5
1713341125637,LISP 5C,A00,507696,Munoz Sanchez; Alicia,15,0,20,5
1713341126665,MAE 197,001,528363,Boechler; Nicholas Sebastia,9998,0,9999,1
1713341127691,MATH 197,001,523477,Kedlaya; Kiran S.,9999,0,9999,0
1713341127691,MATH 197,002,563811,Zhang; Danna,9999,0,9999,0
1713341128719,MCWP 40R,A00,518780,Staff,20,0,20,0
1713341128719,MCWP 40R,B00,518781,Staff,19,0,20,1
1713341128719,MCWP 40R,C00,518783,Staff,19,0,20,1
1713341129746,MCWP 50R,A00,518791,Staff,20,0,20,0
1713341129746,MCWP 50R,B00,518792,Staff,17,0,20,3
1713341129746,MCWP 50R,C00,518793,Staff,19,0,20,1
1713341129746,MCWP 50R,D00,518794,Staff,16,0,20,4
1713341129746,MCWP 50R,E00,518795,Staff,16,0,20,4
1713341129746,MCWP 50R,F00,518796,Staff,19,0,20,1
1713341129746,MCWP 50R,G00,518797,Staff,19,0,20,1
1713341130876,MMW 12R,A01,514034,Herbst; Matthew,15,0,16,1
1713341130876,MMW 12R,A02,514035,Herbst; Matthew,16,0,16,0
1713341131902,MMW 13R,A01,514037,Staff,12,0,16,4
1713341131902,MMW 13R,A02,514039,Staff,16,0,16,0
1713341133957,SIO 295LS,A00,523233,Staff,19,0,30,11
1713341134982,SIO 295S,A00,523232,Staff,19,0,30,11
1713341136012,SOCI 117,A01,494376,Staff,1,0,5,4
1713341137046,WES 237B,A00,494380,Staff,19,0,20,1
1713341139124,AESE 279B,A00,494370,Wade; Jon P,33,0,33,0
1713341140148,ANAR 135S,A00,494369,Braswell; Geoffrey E.,0,0,0,0
1713341141180,CAT 124RS,A01,519847,Geibel; William,17,0,20,3
1713341142209,CAT 125RS,A01,515971,Geibel; William,17,0,20,3
1713341143242,CLRE 250,A00,511389,Morris; Sheldon,9996,0,9999,3
1713341144277,CLRE 251,A00,507176,Mehta; Ravindra L.,9996,0,9999,3
1713341144277,CLRE 251,B00,511410,Mehta; Ravindra L.,9998,0,9999,1
1713341145305,CLRE 252,A00,507189,Cuomo; Raphael Eduardo,9998,0,9999,1
1713341146334,CLRE 253,A00,507199,Vaida; Florin,9997,0,9999,2
1713341146334,CLRE 253,B00,507202,Vaida; Florin,9999,0,9999,0
1713341147360,CLRE 259,A00,507211,Patel; Hemal,9996,0,9999,3
1713341148387,CLRE 260,A00,507221,Cuomo; Raphael Eduardo,9999,0,9999,0
1713341149411,CLRE 297,001,507242,Cuomo; Raphael Eduardo,9999,0,9999,0
1713341150437,CSE 191,A00,516875,Minnes Kemp; Mor Mia,9999,0,9999,0
1713341151465,CSS 201S,A01,494383,Staff,35,0,35,0
1713341152492,CSS 202S,A01,494387,Staff,35,0,35,0
1713341153517,EAP 100,A00,516065,Staff,9792,0,9999,207
1713341154546,ECE 45,A01,507414,Staff,51,0,60,9
1713341155572,ECE 100,A01,507416,Baghdadchi; Saharnaz,10,0,20,10
1713341155572,ECE 100,A02,507418,Baghdadchi; Saharnaz,20,0,20,0
1713341156600,ECE 111,A01,507420,Staff,38,0,50,12
1713341157628,ECE 197,001,548057,Sievenpiper; Daniel F.,9998,0,9999,1
1713341158710,EDS 115,A00,507243,Choi; Bailey Miyeon,28,0,28,0
1713341159735,EDS 117,A01,494379,Staff,23,0,25,2
1713341160764,EDS 125,A00,507246,Hopkins; Megan Beth,29,0,30,1
1713341161794,EDS 128A,A01,507264,Fargason; Sharon Gayle,26,0,26,0
1713341162819,EDS 128B,A01,507293,Pappas; Elizabeth,30,0,30,0
1713341163843,EDS 139,A00,507294,Fargason; Sharon Gayle,30,0,30,0
1713341163843,EDS 139,B00,507313,Pappas; Elizabeth,30,0,30,0
1713341164872,EDS 201,A00,507315,Staff,26,0,30,4
1713341165901,EDS 203,A01,507317,Halter; Christopher P.,26,0,30,4
1713341166925,EDS 204R,A01,507319,Halter; Christopher P.,3,0,30,27
1713341166925,EDS 204R,B01,507331,Heinzman; Erica M.,28,0,30,2
1713341167949,EDS 206R,A00,507332,Staff,4,0,30,26
1713341167949,EDS 206R,B00,507343,Staff,28,0,30,2
1713341168973,EDS 250,A00,507344,Hemans; Patricia Ann Benitez,36,0,40,4
1713341169997,EDS 281,A00,507345,Daly; Alan J.,18,0,18,0
1713341171022,EDS 284,A00,507350,Daly; Alan J.,16,0,16,0
1713341172049,EDS 286,A00,507359,Fine; Sarah,18,0,18,0
1713341173074,EDS 289C,A01,507361,Daly; Alan J.,18,0,18,0
1713341174099,EDS 290,A00,507366,Hofstetter; Carolyn,15,0,15,0
1713341175125,LIGM 5A,A00,507421,Fischer-Grunski; Eva K,20,0,20,0
1713341176156,LIGM 5B,A00,507423,Fischer-Grunski; Eva K,20,0,20,0
1713341177182,LIGM 5C,A00,507425,Fischer-Grunski; Eva K,20,0,20,0
1713341178209,LIIT 5AS,A00,507427,Carnelos; Chiara,20,0,20,0
1713341179241,LIIT 5BS,A00,507430,Carnelos; Chiara,20,0,20,0
1713341180271,LIIT 5CS,A00,507432,Carnelos; Chiara,20,0,20,0
1713341181295,LISP 5A,A00,507541,Munoz Sanchez; Alicia,17,0,20,3
1713341182329,LISP 5B,A00,507671,Munoz Sanchez; Alicia,15,0,20,5
1713341183357,LISP 5C,A00,507696,Munoz Sanchez; Alicia,15,0,20,5
1713341184381,MAE 197,001,528363,Boechler; Nicholas Sebastia,9998,0,9999,1
1713341185410,MATH 197,001,523477,Kedlaya; Kiran S.,9999,0,9999,0
1713341185410,MATH 197,002,563811,Zhang; Danna,9999,0,9999,0
1713341186436,MCWP 40R,A00,518780,Staff,20,0,20,0
1713341186436,MCWP 40R,B00,518781,Staff,19,0,20,1
1713341186436,MCWP 40R,C00,518783,Staff,19,0,20,1
1713341187463,MCWP 50R,A00,518791,Staff,20,0,20,0
1713341187463,MCWP 50R,B00,518792,Staff,17,0,20,3
1713341187463,MCWP 50R,C00,518793,Staff,19,0,20,1
1713341187463,MCWP 50R,D00,518794,Staff,16,0,20,4
1713341187463,MCWP 50R,E00,518795,Staff,16,0,20,4
1713341187463,MCWP 50R,F00,518796,Staff,19,0,20,1
1713341187463,MCWP 50R,G00,518797,Staff,19,0,20,1
1713341188491,MMW 12R,A01,514034,Herbst; Matthew,15,0,16,1
1713341188491,MMW 12R,A02,514035,Herbst; Matthew,16,0,16,0
1713341189521,MMW 13R,A01,514037,Staff,12,0,16,4
1713341189521,MMW 13R,A02,514039,Staff,16,0,16,0
1713341191571,SIO 295LS,A00,523233,Staff,19,0,30,11
1713341192596,SIO 295S,A00,523232,Staff,19,0,30,11
1713341193622,SOCI 117,A01,494376,Staff,1,0,5,4
1713341194651,WES 237B,A00,494380,Staff,19,0,20,1
1713341196719,AESE 279B,A00,494370,Wade; Jon P,33,0,33,0
1713341197748,ANAR 135S,A00,494369,Braswell; Geoffrey E.,0,0,0,0
1713341198779,CAT 124RS,A01,519847,Geibel; William,17,0,20,3
1713341199807,CAT 125RS,A01,515971,Geibel; William,17,0,20,3
1713341200834,CLRE 250,A00,511389,Morris; Sheldon,9996,0,9999,3
1713341201875,CLRE 251,A00,507176,Mehta; Ravindra L.,9996,0,9999,3
1713341201875,CLRE 251,B00,511410,Mehta; Ravindra L.,9998,0,9999,1
1713341202904,CLRE 252,A00,507189,Cuomo; Raphael Eduardo,9998,0,9999,1
1713341203932,CLRE 253,A00,507199,Vaida; Florin,9997,0,9999,2
1713341203932,CLRE 253,B00,507202,Vaida; Florin,9999,0,9999,0
1713341204956,CLRE 259,A00,507211,Patel; Hemal,9996,0,9999,3
1713341205983,CLRE 260,A00,507221,Cuomo; Raphael Eduardo,9999,0,9999,0
1713341207012,CLRE 297,001,507242,Cuomo; Raphael Eduardo,9999,0,9999,0
1713341208038,CSE 191,A00,516875,Minnes Kemp; Mor Mia,9999,0,9999,0
1713341209065,CSS 201S,A01,494383,Staff,35,0,35,0
1713341210088,CSS 202S,A01,494387,Staff,35,0,35,0
1713341211114,EAP 100,A00,516065,Staff,9792,0,9999,207
1713341212142,ECE 45,A01,507414,Staff,51,0,60,9
1713341213173,ECE 100,A01,507416,Baghdadchi; Saharnaz,10,0,20,10
1713341213173,ECE 100,A02,507418,Baghdadchi; Saharnaz,20,0,20,0
1713341214199,ECE 111,A01,507420,Staff,38,0,50,12
1713341215226,ECE 197,001,548057,Sievenpiper; Daniel F.,9998,0,9999,1
1713341216254,EDS 115,A00,507243,Choi; Bailey Miyeon,28,0,28,0
1713341217280,EDS 117,A01,494379,Staff,23,0,25,2
1713341218309,EDS 125,A00,507246,Hopkins; Megan Beth,29,0,30,1
1713341219337,EDS 128A,A01,507264,Fargason; Sharon Gayle,26,0,26,0
1713341220367,EDS 128B,A01,507293,Pappas; Elizabeth,30,0,30,0
1713341221396,EDS 139,A00,507294,Fargason; Sharon Gayle,30,0,30,0
1713341221396,EDS 139,B00,507313,Pappas; Elizabeth,30,0,30,0
1713341222420,EDS 201,A00,507315,Staff,26,0,30,4
1713341223446,EDS 203,A01,507317,Halter; Christopher P.,26,0,30,4
1713341224476,EDS 204R,A01,507319,Halter; Christopher P.,3,0,30,27
1713341224476,EDS 204R,B01,507331,Heinzman; Erica M.,28,0,30,2
1713341225502,EDS 206R,A00,507332,Staff,4,0,30,26
1713341225502,EDS 206R,B00,507343,Staff,28,0,30,2
1713341226529,EDS 250,A00,507344,Hemans; Patricia Ann Benitez,36,0,40,4
1713341227558,EDS 281,A00,507345,Daly; Alan J.,18,0,18,0
1713341228584,EDS 284,A00,507350,Daly; Alan J.,16,0,16,0
1713341229609,EDS 286,A00,507359,Fine; Sarah,18,0,18,0
1713341230638,EDS 289C,A01,507361,Daly; Alan J.,18,0,18,0
1713341231670,EDS 290,A00,507366,Hofstetter; Carolyn,15,0,15,0
1713341232700,LIGM 5A,A00,507421,Fischer-Grunski; Eva K,20,0,20,0
1713341233724,LIGM 5B,A00,507423,Fischer-Grunski; Eva K,20,0,20,0
1713341234759,LIGM 5C,A00,507425,Fischer-Grunski; Eva K,20,0,20,0
1713341235785,LIIT 5AS,A00,507427,Carnelos; Chiara,20,0,20,0
1713341236810,LIIT 5BS,A00,507430,Carnelos; Chiara,20,0,20,0
1713341237840,LIIT 5CS,A00,507432,Carnelos; Chiara,20,0,20,0
1713341238867,LISP 5A,A00,507541,Munoz Sanchez; Alicia,17,0,20,3
1713341239891,LISP 5B,A00,507671,Munoz Sanchez; Alicia,15,0,20,5
1713341240917,LISP 5C,A00,507696,Munoz Sanchez; Alicia,15,0,20,5
1713341241948,MAE 197,001,528363,Boechler; Nicholas Sebastia,9998,0,9999,1
1713341242978,MATH 197,001,523477,Kedlaya; Kiran S.,9999,0,9999,0
1713341242978,MATH 197,002,563811,Zhang; Danna,9999,0,9999,0
1713341244011,MCWP 40R,A00,518780,Staff,20,0,20,0
1713341244011,MCWP 40R,B00,518781,Staff,19,0,20,1
1713341244011,MCWP 40R,C00,518783,Staff,19,0,20,1
1713341245040,MCWP 50R,A00,518791,Staff,20,0,20,0
1713341245040,MCWP 50R,B00,518792,Staff,17,0,20,3
1713341245040,MCWP 50R,C00,518793,Staff,19,0,20,1
1713341245040,MCWP 50R,D00,518794,Staff,16,0,20,4
1713341245040,MCWP 50R,E00,518795,Staff,16,0,20,4
1713341245040,MCWP 50R,F00,518796,Staff,19,0,20,1
1713341245040,MCWP 50R,G00,518797,Staff,19,0,20,1
1713341246071,MMW 12R,A01,514034,Herbst; Matthew,15,0,16,1
1713341246071,MMW 12R,A02,514035,Herbst; Matthew,16,0,16,0
1713341247097,MMW 13R,A01,514037,Staff,12,0,16,4
1713341247097,MMW 13R,A02,514039,Staff,16,0,16,0
1713341249158,SIO 295LS,A00,523233,Staff,19,0,30,11
1713341250181,SIO 295S,A00,523232,Staff,19,0,30,11
1713341251213,SOCI 117,A01,494376,Staff,1,0,5,4
1713341252237,WES 237B,A00,494380,Staff,19,0,20,1
1713341254313,AESE 279B,A00,494370,Wade; Jon P,33,0,33,0
1713341255340,ANAR 135S,A00,494369,Braswell; Geoffrey E.,0,0,0,0
1713341256369,CAT 124RS,A01,519847,Geibel; William,17,0,20,3
1713341257398,CAT 125RS,A01,515971,Geibel; William,17,0,20,3
1713341258428,CLRE 250,A00,511389,Morris; Sheldon,9996,0,9999,3
1713341259456,CLRE 251,A00,507176,Mehta; Ravindra L.,9996,0,9999,3
1713341259456,CLRE 251,B00,511410,Mehta; Ravindra L.,9998,0,9999,1
1713341260481,CLRE 252,A00,507189,Cuomo; Raphael Eduardo,9998,0,9999,1
1713341261507,CLRE 253,A00,507199,Vaida; Florin,9997,0,9999,2
1713341261507,CLRE 253,B00,507202,Vaida; Florin,9999,0,9999,0
1713341262584,CLRE 259,A00,507211,Patel; Hemal,9996,0,9999,3
1713341263622,CLRE 260,A00,507221,Cuomo; Raphael Eduardo,9999,0,9999,0
1713341264651,CLRE 297,001,507242,Cuomo; Raphael Eduardo,9999,0,9999,0
1713341265675,CSE 191,A00,516875,Minnes Kemp; Mor Mia,9999,0,9999,0
1713341266701,CSS 201S,A01,494383,Staff,35,0,35,0
1713341267726,CSS 202S,A01,494387,Staff,35,0,35,0
1713341268752,EAP 100,A00,516065,Staff,9792,0,9999,207
1713341269784,ECE 45,A01,507414,Staff,51,0,60,9
1713341270810,ECE 100,A01,507416,Baghdadchi; Saharnaz,10,0,20,10
1713341270810,ECE 100,A02,507418,Baghdadchi; Saharnaz,20,0,20,0
1713341271840,ECE 111,A01,507420,Staff,38,0,50,12
1713341272871,ECE 197,001,548057,Sievenpiper; Daniel F.,9998,0,9999,1
1713341273906,EDS 115,A00,507243,Choi; Bailey Miyeon,28,0,28,0
1713341274933,EDS 117,A01,494379,Staff,23,0,25,2
1713341275959,EDS 125,A00,507246,Hopkins; Megan Beth,29,0,30,1
1713341276991,EDS 128A,A01,507264,Fargason; Sharon Gayle,26,0,26,0
1713341278020,EDS 128B,A01,507293,Pappas; Elizabeth,30,0,30,0
1713341279052,EDS 139,A00,507294,Fargason; Sharon Gayle,30,0,30,0
1713341279052,EDS 139,B00,507313,Pappas; Elizabeth,30,0,30,0
1713341280081,EDS 201,A00,507315,Staff,26,0,30,4
1713341281112,EDS 203,A01,507317,Halter; Christopher P.,26,0,30,4
1713341282140,EDS 204R,A01,507319,Halter; Christopher P.,3,0,30,27
1713341282140,EDS 204R,B01,507331,Heinzman; Erica M.,28,0,30,2
1713341283165,EDS 206R,A00,507332,Staff,4,0,30,26
1713341283165,EDS 206R,B00,507343,Staff,28,0,30,2
1713341284191,EDS 250,A00,507344,Hemans; Patricia Ann Benitez,36,0,40,4
1713341285218,EDS 281,A00,507345,Daly; Alan J.,18,0,18,0
1713341286244,EDS 284,A00,507350,Daly; Alan J.,16,0,16,0
1713341287270,EDS 286,A00,507359,Fine; Sarah,18,0,18,0
1713341288296,EDS 289C,A01,507361,Daly; Alan J.,18,0,18,0
1713341289329,EDS 290,A00,507366,Hofstetter; Carolyn,15,0,15,0
1713341290363,LIGM 5A,A00,507421,Fischer-Grunski; Eva K,20,0,20,0
1713341291387,LIGM 5B,A00,507423,Fischer-Grunski; Eva K,20,0,20,0
1713341292413,LIGM 5C,A00,507425,Fischer-Grunski; Eva K,20,0,20,0
1713341293441,LIIT 5AS,A00,507427,Carnelos; Chiara,20,0,20,0
1713341294471,LIIT 5BS,A00,507430,Carnelos; Chiara,20,0,20,0
1713341295497,LIIT 5CS,A00,507432,Carnelos; Chiara,20,0,20,0
1713341296533,LISP 5A,A00,507541,Munoz Sanchez; Alicia,17,0,20,3
1713341297564,LISP 5B,A00,507671,Munoz Sanchez; Alicia,15,0,20,5
1713341298591,LISP 5C,A00,507696,Munoz Sanchez; Alicia,15,0,20,5
1713341299618,MAE 197,001,528363,Boechler; Nicholas Sebastia,9998,0,9999,1
1713341300651,MATH 197,001,523477,Kedlaya; Kiran S.,9999,0,9999,0
1713341300651,MATH 197,002,563811,Zhang; Danna,9999,0,9999,0
1713341301680,MCWP 40R,A00,518780,Staff,20,0,20,0
1713341301680,MCWP 40R,B00,518781,Staff,19,0,20,1
1713341301680,MCWP 40R,C00,518783,Staff,19,0,20,1
1713341302708,MCWP 50R,A00,518791,Staff,20,0,20,0
1713341302708,MCWP 50R,B00,518792,Staff,17,0,20,3
1713341302708,MCWP 50R,C00,518793,Staff,19,0,20,1
1713341302708,MCWP 50R,D00,518794,Staff,16,0,20,4
1713341302708,MCWP 50R,E00,518795,Staff,16,0,20,4
1713341302708,MCWP 50R,F00,518796,Staff,19,0,20,1
1713341302708,MCWP 50R,G00,518797,Staff,19,0,20,1
1713341303739,MMW 12R,A01,514034,Herbst; Matthew,15,0,16,1
1713341303739,MMW 12R,A02,514035,Herbst; Matthew,16,0,16,0
1713341304766,MMW 13R,A01,514037,Staff,12,0,16,4
1713341304766,MMW 13R,A02,514039,Staff,16,0,16,0
1713341306821,SIO 295LS,A00,523233,Staff,18,0,30,12
1713341307849,SIO 295S,A00,523232,Staff,18,0,30,12
1713341308881,SOCI 117,A01,494376,Staff,1,0,5,4
1713341309913,WES 237B,A00,494380,Staff,19,0,20,1
1713341311992,AESE 279B,A00,494370,Wade; Jon P,33,0,33,0
1713341313017,ANAR 135S,A00,494369,Braswell; Geoffrey E.,0,0,0,0
1713341314048,CAT 124RS,A01,519847,Geibel; William,17,0,20,3
1713341315074,CAT 125RS,A01,515971,Geibel; William,17,0,20,3
1713341316098,CLRE 250,A00,511389,Morris; Sheldon,9996,0,9999,3
1713341317125,CLRE 251,A00,507176,Mehta; Ravindra L.,9996,0,9999,3
1713341317125,CLRE 251,B00,511410,Mehta; Ravindra L.,9998,0,9999,1
1713341318151,CLRE 252,A00,507189,Cuomo; Raphael Eduardo,9998,0,9999,1
1713341319183,CLRE 253,A00,507199,Vaida; Florin,9997,0,9999,2
1713341319183,CLRE 253,B00,507202,Vaida; Florin,9999,0,9999,0
1713341320208,CLRE 259,A00,507211,Patel; Hemal,9996,0,9999,3
1713341321236,CLRE 260,A00,507221,Cuomo; Raphael Eduardo,9999,0,9999,0
1713341322263,CLRE 297,001,507242,Cuomo; Raphael Eduardo,9999,0,9999,0
1713341323292,CSE 191,A00,516875,Minnes Kemp; Mor Mia,9999,0,9999,0
1713341324319,CSS 201S,A01,494383,Staff,35,0,35,0
1713341325348,CSS 202S,A01,494387,Staff,35,0,35,0
1713341326374,EAP 100,A00,516065,Staff,9792,0,9999,207
1713341327404,ECE 45,A01,507414,Staff,51,0,60,9
1713341328438,ECE 100,A01,507416,Baghdadchi; Saharnaz,10,0,20,10
1713341328438,ECE 100,A02,507418,Baghdadchi; Saharnaz,20,0,20,0
1713341329462,ECE 111,A01,507420,Staff,38,0,50,12
1713341330491,ECE 197,001,548057,Sievenpiper; Daniel F.,9998,0,9999,1
1713341331518,EDS 115,A00,507243,Choi; Bailey Miyeon,28,0,28,0
1713341332547,EDS 117,A01,494379,Staff,23,0,25,2
1713341333572,EDS 125,A00,507246,Hopkins; Megan Beth,29,0,30,1
1713341334604,EDS 128A,A01,507264,Fargason; Sharon Gayle,26,0,26,0
1713341335630,EDS 128B,A01,507293,Pappas; Elizabeth,30,0,30,0
1713341336660,EDS 139,A00,507294,Fargason; Sharon Gayle,30,0,30,0
1713341336660,EDS 139,B00,507313,Pappas; Elizabeth,30,0,30,0
1713341337688,EDS 201,A00,507315,Staff,26,0,30,4
1713341338714,EDS 203,A01,507317,Halter; Christopher P.,26,0,30,4
1713341339739,EDS 204R,A01,507319,Halter; Christopher P.,3,0,30,27
1713341339739,EDS 204R,B01,507331,Heinzman; Erica M.,28,0,30,2
1713341340768,EDS 206R,A00,507332,Staff,4,0,30,26
1713341340768,EDS 206R,B00,507343,Staff,28,0,30,2
1713341341800,EDS 250,A00,507344,Hemans; Patricia Ann Benitez,36,0,40,4
1713341342827,EDS 281,A00,507345,Daly; Alan J.,18,0,18,0
1713341343852,EDS 284,A00,507350,Daly; Alan J.,16,0,16,0
1713341344878,EDS 286,A00,507359,Fine; Sarah,18,0,18,0
1713341345906,EDS 289C,A01,507361,Daly; Alan J.,18,0,18,0
1713341346932,EDS 290,A00,507366,Hofstetter; Carolyn,15,0,15,0
1713341347961,LIGM 5A,A00,507421,Fischer-Grunski; Eva K,20,0,20,0
1713341348988,LIGM 5B,A00,507423,Fischer-Grunski; Eva K,20,0,20,0
1713341350012,LIGM 5C,A00,507425,Fischer-Grunski; Eva K,20,0,20,0
1713341351037,LIIT 5AS,A00,507427,Carnelos; Chiara,20,0,20,0
1713341352064,LIIT 5BS,A00,507430,Carnelos; Chiara,20,0,20,0
1713341353089,LIIT 5CS,A00,507432,Carnelos; Chiara,20,0,20,0
1713341354115,LISP 5A,A00,507541,Munoz Sanchez; Alicia,17,0,20,3
1713341355145,LISP 5B,A00,507671,Munoz Sanchez; Alicia,15,0,20,5
1713341356171,LISP 5C,A00,507696,Munoz Sanchez; Alicia,15,0,20,5
1713341357200,MAE 197,001,528363,Boechler; Nicholas Sebastia,9998,0,9999,1
1713341358232,MATH 197,001,523477,Kedlaya; Kiran S.,9999,0,9999,0
1713341358232,MATH 197,002,563811,Zhang; Danna,9999,0,9999,0
1713341359262,MCWP 40R,A00,518780,Staff,20,0,20,0
1713341359262,MCWP 40R,B00,518781,Staff,19,0,20,1
1713341359262,MCWP 40R,C00,518783,Staff,19,0,20,1
1713341360292,MCWP 50R,A00,518791,Staff,20,0,20,0
1713341360292,MCWP 50R,B00,518792,Staff,17,0,20,3
1713341360292,MCWP 50R,C00,518793,Staff,19,0,20,1
1713341360292,MCWP 50R,D00,518794,Staff,16,0,20,4
1713341360292,MCWP 50R,E00,518795,Staff,16,0,20,4
1713341360292,MCWP 50R,F00,518796,Staff,19,0,20,1
1713341360292,MCWP 50R,G00,518797,Staff,19,0,20,1
1713341361320,MMW 12R,A01,514034,Herbst; Matthew,15,0,16,1
1713341361320,MMW 12R,A02,514035,Herbst; Matthew,16,0,16,0
1713341362344,MMW 13R,A01,514037,Staff,12,0,16,4
1713341362344,MMW 13R,A02,514039,Staff,16,0,16,0
1713341364402,SIO 295LS,A00,523233,Staff,18,0,30,12
1713341365431,SIO 295S,A00,523232,Staff,18,0,30,12
1713341366509,SOCI 117,A01,494376,Staff,1,0,5,4
1713341367533,WES 237B,A00,494380,Staff,19,0,20,1
1713341369609,AESE 279B,A00,494370,Wade; Jon P,33,0,33,0
1713341370635,ANAR 135S,A00,494369,Braswell; Geoffrey E.,0,0,0,0
1713341371661,CAT 124RS,A01,519847,Geibel; William,17,0,20,3
1713341372689,CAT 125RS,A01,515971,Geibel; William,17,0,20,3
1713341373717,CLRE 250,A00,511389,Morris; Sheldon,9996,0,9999,3
1713341374745,CLRE 251,A00,507176,Mehta; Ravindra L.,9996,0,9999,3
1713341374745,CLRE 251,B00,511410,Mehta; Ravindra L.,9998,0,9999,1
1713341375776,CLRE 252,A00,507189,Cuomo; Raphael Eduardo,9998,0,9999,1
1713341376803,CLRE 253,A00,507199,Vaida; Florin,9997,0,9999,2
1713341376803,CLRE 253,B00,507202,Vaida; Florin,9999,0,9999,0
1713341377834,CLRE 259,A00,507211,Patel; Hemal,9996,0,9999,3
1713341378861,CLRE 260,A00,507221,Cuomo; Raphael Eduardo,9999,0,9999,0
1713341379888,CLRE 297,001,507242,Cuomo; Raphael Eduardo,9999,0,9999,0
1713341380918,CSE 191,A00,516875,Minnes Kemp; Mor Mia,9999,0,9999,0
1713341381950,CSS 201S,A01,494383,Staff,35,0,35,0
1713341382977,CSS 202S,A01,494387,Staff,35,0,35,0
1713341384002,EAP 100,A00,516065,Staff,9792,0,9999,207
1713341385031,ECE 45,A01,507414,Staff,51,0,60,9
1713341386059,ECE 100,A01,507416,Baghdadchi; Saharnaz,10,0,20,10
1713341386059,ECE 100,A02,507418,Baghdadchi; Saharnaz,20,0,20,0
1713341387085,ECE 111,A01,507420,Staff,38,0,50,12
1713341388116,ECE 197,001,548057,Sievenpiper; Daniel F.,9998,0,9999,1
1713341389143,EDS 115,A00,507243,Choi; Bailey Miyeon,28,0,28,0
1713341390176,EDS 117,A01,494379,Staff,23,0,25,2
1713341391200,EDS 125,A00,507246,Hopkins; Megan Beth,29,0,30,1
1713341392227,EDS 128A,A01,507264,Fargason; Sharon Gayle,26,0,26,0
1713341393253,EDS 128B,A01,507293,Pappas; Elizabeth,30,0,30,0
1713341394278,EDS 139,A00,507294,Fargason; Sharon Gayle,30,0,30,0
1713341394278,EDS 139,B00,507313,Pappas; Elizabeth,30,0,30,0
1713341395304,EDS 201,A00,507315,Staff,26,0,30,4
1713341396335,EDS 203,A01,507317,Halter; Christopher P.,26,0,30,4
1713341397365,EDS 204R,A01,507319,Halter; Christopher P.,3,0,30,27
1713341397365,EDS 204R,B01,507331,Heinzman; Erica M.,28,0,30,2
1713341398395,EDS 206R,A00,507332,Staff,4,0,30,26
1713341398395,EDS 206R,B00,507343,Staff,28,0,30,2
1713341399421,EDS 250,A00,507344,Hemans; Patricia Ann Benitez,36,0,40,4
1713341400446,EDS 281,A00,507345,Daly; Alan J.,18,0,18,0
1713341401471,EDS 284,A00,507350,Daly; Alan J.,16,0,16,0
1713341402498,EDS 286,A00,507359,Fine; Sarah,18,0,18,0
1713341403525,EDS 289C,A01,507361,Daly; Alan J.,18,0,18,0
1713341404557,EDS 290,A00,507366,Hofstetter; Carolyn,15,0,15,0
1713341405583,LIGM 5A,A00,507421,Fischer-Grunski; Eva K,20,0,20,0
1713341406613,LIGM 5B,A00,507423,Fischer-Grunski; Eva K,20,0,20,0
1713341407639,LIGM 5C,A00,507425,Fischer-Grunski; Eva K,20,0,20,0
1713341408669,LIIT 5AS,A00,507427,Carnelos; Chiara,20,0,20,0
1713341409696,LIIT 5BS,A00,507430,Carnelos; Chiara,20,0,20,0
1713341410721,LIIT 5CS,A00,507432,Carnelos; Chiara,20,0,20,0
1713341411751,LISP 5A,A00,507541,Munoz Sanchez; Alicia,17,0,20,3
1713341412778,LISP 5B,A00,507671,Munoz Sanchez; Alicia,15,0,20,5
1713341413808,LISP 5C,A00,507696,Munoz Sanchez; Alicia,15,0,20,5
1713341414837,MAE 197,001,528363,Boechler; Nicholas Sebastia,9998,0,9999,1
1713341415862,MATH 197,001,523477,Kedlaya; Kiran S.,9999,0,9999,0
1713341415862,MATH 197,002,563811,Zhang; Danna,9999,0,9999,0
1713341416888,MCWP 40R,A00,518780,Staff,20,0,20,0
1713341416888,MCWP 40R,B00,518781,Staff,19,0,20,1
1713341416888,MCWP 40R,C00,518783,Staff,19,0,20,1
1713341417914,MCWP 50R,A00,518791,Staff,20,0,20,0
1713341417914,MCWP 50R,B00,518792,Staff,17,0,20,3
1713341417914,MCWP 50R,C00,518793,Staff,19,0,20,1
1713341417914,MCWP 50R,D00,518794,Staff,16,0,20,4
1713341417914,MCWP 50R,E00,518795,Staff,16,0,20,4
1713341417914,MCWP 50R,F00,518796,Staff,19,0,20,1
1713341417914,MCWP 50R,G00,518797,Staff,19,0,20,1
1713341418941,MMW 12R,A01,514034,Herbst; Matthew,15,0,16,1
1713341418941,MMW 12R,A02,514035,Herbst; Matthew,16,0,16,0
1713341419964,MMW 13R,A01,514037,Staff,12,0,16,4
1713341419964,MMW 13R,A02,514039,Staff,16,0,16,0
1713341422015,SIO 295LS,A00,523233,Staff,18,0,30,12
1713341423039,SIO 295S,A00,523232,Staff,18,0,30,12
1713341424071,SOCI 117,A01,494376,Staff,1,0,5,4
1713341425097,WES 237B,A00,494380,Staff,19,0,20,1
1713341427182,AESE 279B,A00,494370,Wade; Jon P,33,0,33,0
1713341428219,ANAR 135S,A00,494369,Braswell; Geoffrey E.,0,0,0,0
1713341429250,CAT 124RS,A01,519847,Geibel; William,17,0,20,3
1713341430275,CAT 125RS,A01,515971,Geibel; William,17,0,20,3
1713341431303,CLRE 250,A00,511389,Morris; Sheldon,9996,0,9999,3
1713341432330,CLRE 251,A00,507176,Mehta; Ravindra L.,9996,0,9999,3
1713341432330,CLRE 251,B00,511410,Mehta; Ravindra L.,9998,0,9999,1
1713341433359,CLRE 252,A00,507189,Cuomo; Raphael Eduardo,9998,0,9999,1
1713341434403,CLRE 253,A00,507199,Vaida; Florin,9997,0,9999,2
1713341434403,CLRE 253,B00,507202,Vaida; Florin,9999,0,9999,0
1713341435431,CLRE 259,A00,507211,Patel; Hemal,9996,0,9999,3
1713341436457,CLRE 260,A00,507221,Cuomo; Raphael Eduardo,9999,0,9999,0
1713341437487,CLRE 297,001,507242,Cuomo; Raphael Eduardo,9999,0,9999,0
1713341438512,CSE 191,A00,516875,Minnes Kemp; Mor Mia,9999,0,9999,0
1713341439537,CSS 201S,A01,494383,Staff,35,0,35,0
1713341440563,CSS 202S,A01,494387,Staff,35,0,35,0
1713341441588,EAP 100,A00,516065,Staff,9792,0,9999,207
1713341442625,ECE 45,A01,507414,Staff,51,0,60,9
1713341443656,ECE 100,A01,507416,Baghdadchi; Saharnaz,10,0,20,10
1713341443656,ECE 100,A02,507418,Baghdadchi; Saharnaz,20,0,20,0
1713341444686,ECE 111,A01,507420,Staff,38,0,50,12
1713341445716,ECE 197,001,548057,Sievenpiper; Daniel F.,9998,0,9999,1
1713341446747,EDS 115,A00,507243,Choi; Bailey Miyeon,28,0,28,0
1713341447773,EDS 117,A01,494379,Staff,23,0,25,2
1713341448803,EDS 125,A00,507246,Hopkins; Megan Beth,29,0,30,1
1713341449835,EDS 128A,A01,507264,Fargason; Sharon Gayle,26,0,26,0
1713341450862,EDS 128B,A01,507293,Pappas; Elizabeth,30,0,30,0
1713341451892,EDS 139,A00,507294,Fargason; Sharon Gayle,30,0,30,0
1713341451892,EDS 139,B00,507313,Pappas; Elizabeth,30,0,30,0
1713341452919,EDS 201,A00,507315,Staff,26,0,30,4
1713341454036,EDS 203,A01,507317,Halter; Christopher P.,26,0,30,4
1713341455066,EDS 204R,A01,507319,Halter; Christopher P.,3,0,30,27
1713341455066,EDS 204R,B01,507331,Heinzman; Erica M.,28,0,30,2
1713341456095,EDS 206R,A00,507332,Staff,4,0,30,26
1713341456095,EDS 206R,B00,507343,Staff,28,0,30,2
1713341457119,EDS 250,A00,507344,Hemans; Patricia Ann Benitez,36,0,40,4
1713341458147,EDS 281,A00,507345,Daly; Alan J.,18,0,18,0
1713341459177,EDS 284,A00,507350,Daly; Alan J.,16,0,16,0
1713341460202,EDS 286,A00,507359,Fine; Sarah,18,0,18,0
1713341461226,EDS 289C,A01,507361,Daly; Alan J.,18,0,18,0
1713341462251,EDS 290,A00,507366,Hofstetter; Carolyn,15,0,15,0
1713341463277,LIGM 5A,A00,507421,Fischer-Grunski; Eva K,20,0,20,0
1713341464312,LIGM 5B,A00,507423,Fischer-Grunski; Eva K,20,0,20,0
1713341465340,LIGM 5C,A00,507425,Fischer-Grunski; Eva K,20,0,20,0
1713341466365,LIIT 5AS,A00,507427,Carnelos; Chiara,20,0,20,0
1713341467390,LIIT 5BS,A00,507430,Carnelos; Chiara,20,0,20,0
1713341468416,LIIT 5CS,A00,507432,Carnelos; Chiara,20,0,20,0
1713341469445,LISP 5A,A00,507541,Munoz Sanchez; Alicia,17,0,20,3
1713341470533,LISP 5B,A00,507671,Munoz Sanchez; Alicia,15,0,20,5
1713341471559,LISP 5C,A00,507696,Munoz Sanchez; Alicia,15,0,20,5
1713341472584,MAE 197,001,528363,Boechler; Nicholas Sebastia,9998,0,9999,1
1713341473611,MATH 197,001,523477,Kedlaya; Kiran S.,9999,0,9999,0
1713341473611,MATH 197,002,563811,Zhang; Danna,9999,0,9999,0
1713341474639,MCWP 40R,A00,518780,Staff,20,0,20,0
1713341474639,MCWP 40R,B00,518781,Staff,19,0,20,1
1713341474639,MCWP 40R,C00,518783,Staff,19,0,20,1
1713341475665,MCWP 50R,A00,518791,Staff,20,0,20,0
1713341475665,MCWP 50R,B00,518792,Staff,17,0,20,3
1713341475665,MCWP 50R,C00,518793,Staff,19,0,20,1
1713341475665,MCWP 50R,D00,518794,Staff,16,0,20,4
1713341475665,MCWP 50R,E00,518795,Staff,16,0,20,4
1713341475665,MCWP 50R,F00,518796,Staff,19,0,20,1
1713341475665,MCWP 50R,G00,518797,Staff,19,0,20,1
1713341476695,MMW 12R,A01,514034,Herbst; Matthew,15,0,16,1
1713341476695,MMW 12R,A02,514035,Herbst; Matthew,16,0,16,0
1713341477720,MMW 13R,A01,514037,Staff,12,0,16,4
1713341477720,MMW 13R,A02,514039,Staff,16,0,16,0
1713341479775,SIO 295LS,A00,523233,Staff,18,0,30,12
1713341480805,SIO 295S,A00,523232,Staff,18,0,30,12
1713341481831,SOCI 117,A01,494376,Staff,1,0,5,4
1713341482862,WES 237B,A00,494380,Staff,19,0,20,1
1713341484945,AESE 279B,A00,494370,Wade; Jon P,33,0,33,0
1713341485975,ANAR 135S,A00,494369,Braswell; Geoffrey E.,0,0,0,0
1713341487006,CAT 124RS,A01,519847,Geibel; William,17,0,20,3
1713341488035,CAT 125RS,A01,515971,Geibel; William,17,0,20,3
1713341489067,CLRE 250,A00,511389,Morris; Sheldon,9996,0,9999,3
1713341490106,CLRE 251,A00,507176,Mehta; Ravindra L.,9996,0,9999,3
1713341490106,CLRE 251,B00,511410,Mehta; Ravindra L.,9998,0,9999,1
1713341491131,CLRE 252,A00,507189,Cuomo; Raphael Eduardo,9998,0,9999,1
1713341492162,CLRE 253,A00,507199,Vaida; Florin,9997,0,9999,2
1713341492162,CLRE 253,B00,507202,Vaida; Florin,9999,0,9999,0
1713341493188,CLRE 259,A00,507211,Patel; Hemal,9996,0,9999,3
1713341494217,CLRE 260,A00,507221,Cuomo; Raphael Eduardo,9999,0,9999,0
1713341495245,CLRE 297,001,507242,Cuomo; Raphael Eduardo,9999,0,9999,0
1713341496274,CSE 191,A00,516875,Minnes Kemp; Mor Mia,9999,0,9999,0
1713341497299,CSS 201S,A01,494383,Staff,35,0,35,0
1713341498332,CSS 202S,A01,494387,Staff,35,0,35,0
1713341499359,EAP 100,A00,516065,Staff,9792,0,9999,207
1713341500389,ECE 45,A01,507414,Staff,51,0,60,9
1713341501419,ECE 100,A01,507416,Baghdadchi; Saharnaz,10,0,20,10
1713341501419,ECE 100,A02,507418,Baghdadchi; Saharnaz,20,0,20,0
1713341502447,ECE 111,A01,507420,Staff,38,0,50,12
1713341503474,ECE 197,001,548057,Sievenpiper; Daniel F.,9998,0,9999,1
1713341504500,EDS 115,A00,507243,Choi; Bailey Miyeon,28,0,28,0
1713341505524,EDS 117,A01,494379,Staff,23,0,25,2
1713341506549,EDS 125,A00,507246,Hopkins; Megan Beth,29,0,30,1
1713341507579,EDS 128A,A01,507264,Fargason; Sharon Gayle,26,0,26,0
1713341508607,EDS 128B,A01,507293,Pappas; Elizabeth,30,0,30,0
1713341509636,EDS 139,A00,507294,Fargason; Sharon Gayle,30,0,30,0
1713341509636,EDS 139,B00,507313,Pappas; Elizabeth,30,0,30,0
1713341510660,EDS 201,A00,507315,Staff,26,0,30,4
1713341511688,EDS 203,A01,507317,Halter; Christopher P.,26,0,30,4
1713341512717,EDS 204R,A01,507319,Halter; Christopher P.,3,0,30,27
1713341512717,EDS 204R,B01,507331,Heinzman; Erica M.,28,0,30,2
1713341513743,EDS 206R,A00,507332,Staff,4,0,30,26
1713341513743,EDS 206R,B00,507343,Staff,28,0,30,2
1713341514768,EDS 250,A00,507344,Hemans; Patricia Ann Benitez,36,0,40,4
1713341515799,EDS 281,A00,507345,Daly; Alan J.,18,0,18,0
1713341516823,EDS 284,A00,507350,Daly; Alan J.,16,0,16,0
1713341517854,EDS 286,A00,507359,Fine; Sarah,18,0,18,0
1713341518882,EDS 289C,A01,507361,Daly; Alan J.,18,0,18,0
1713341519907,EDS 290,A00,507366,Hofstetter; Carolyn,15,0,15,0
1713341520942,LIGM 5A,A00,507421,Fischer-Grunski; Eva K,20,0,20,0
1713341521970,LIGM 5B,A00,507423,Fischer-Grunski; Eva K,20,0,20,0
1713341522995,LIGM 5C,A00,507425,Fischer-Grunski; Eva K,20,0,20,0
1713341524021,LIIT 5AS,A00,507427,Carnelos; Chiara,20,0,20,0
1713341525047,LIIT 5BS,A00,507430,Carnelos; Chiara,20,0,20,0
1713341526072,LIIT 5CS,A00,507432,Carnelos; Chiara,20,0,20,0
1713341527098,LISP 5A,A00,507541,Munoz Sanchez; Alicia,17,0,20,3
1713341528123,LISP 5B,A00,507671,Munoz Sanchez; Alicia,15,0,20,5
1713341529150,LISP 5C,A00,507696,Munoz Sanchez; Alicia,15,0,20,5
1713341530175,MAE 197,001,528363,Boechler; Nicholas Sebastia,9998,0,9999,1
1713341531202,MATH 197,001,523477,Kedlaya; Kiran S.,9999,0,9999,0
1713341531202,MATH 197,002,563811,Zhang; Danna,9999,0,9999,0
1713341532229,MCWP 40R,A00,518780,Staff,20,0,20,0
1713341532229,MCWP 40R,B00,518781,Staff,19,0,20,1
1713341532229,MCWP 40R,C00,518783,Staff,19,0,20,1
1713341533255,MCWP 50R,A00,518791,Staff,20,0,20,0
1713341533255,MCWP 50R,B00,518792,Staff,17,0,20,3
1713341533255,MCWP 50R,C00,518793,Staff,19,0,20,1
1713341533255,MCWP 50R,D00,518794,Staff,16,0,20,4
1713341533255,MCWP 50R,E00,518795,Staff,16,0,20,4
1713341533255,MCWP 50R,F00,518796,Staff,19,0,20,1
1713341533255,MCWP 50R,G00,518797,Staff,19,0,20,1
1713341534281,MMW 12R,A01,514034,Herbst; Matthew,15,0,16,1
1713341534281,MMW 12R,A02,514035,Herbst; Matthew,16,0,16,0
1713341535304,MMW 13R,A01,514037,Staff,12,0,16,4
1713341535304,MMW 13R,A02,514039,Staff,16,0,16,0
1713341537356,SIO 295LS,A00,523233,Staff,18,0,30,12
1713341538381,SIO 295S,A00,523232,Staff,18,0,30,12
1713341539405,SOCI 117,A01,494376,Staff,1,0,5,4
1713341540448,WES 237B,A00,494380,Staff,19,0,20,1
1713341542533,AESE 279B,A00,494370,Wade; Jon P,33,0,33,0
1713341543557,ANAR 135S,A00,494369,Braswell; Geoffrey E.,0,0,0,0
1713341544584,CAT 124RS,A01,519847,Geibel; William,17,0,20,3
1713341545615,CAT 125RS,A01,515971,Geibel; William,17,0,20,3
1713341546649,CLRE 250,A00,511389,Morris; Sheldon,9996,0,9999,3
1713341547677,CLRE 251,A00,507176,Mehta; Ravindra L.,9996,0,9999,3
1713341547677,CLRE 251,B00,511410,Mehta; Ravindra L.,9998,0,9999,1
1713341548703,CLRE 252,A00,507189,Cuomo; Raphael Eduardo,9998,0,9999,1
1713341549732,CLRE 253,A00,507199,Vaida; Florin,9997,0,9999,2
1713341549732,CLRE 253,B00,507202,Vaida; Florin,9999,0,9999,0
1713341550757,CLRE 259,A00,507211,Patel; Hemal,9996,0,9999,3
1713341551782,CLRE 260,A00,507221,Cuomo; Raphael Eduardo,9999,0,9999,0
1713341552810,CLRE 297,001,507242,Cuomo; Raphael Eduardo,9999,0,9999,0
1713341553836,CSE 191,A00,516875,Minnes Kemp; Mor Mia,9999,0,9999,0
1713341554862,CSS 201S,A01,494383,Staff,35,0,35,0
1713341555888,CSS 202S,A01,494387,Staff,35,0,35,0
1713341556913,EAP 100,A00,516065,Staff,9792,0,9999,207
1713341557941,ECE 45,A01,507414,Staff,51,0,60,9
1713341558968,ECE 100,A01,507416,Baghdadchi; Saharnaz,10,0,20,10
1713341558968,ECE 100,A02,507418,Baghdadchi; Saharnaz,20,0,20,0
1713341559993,ECE 111,A01,507420,Staff,38,0,50,12
1713341561021,ECE 197,001,548057,Sievenpiper; Daniel F.,9998,0,9999,1
1713341562052,EDS 115,A00,507243,Choi; Bailey Miyeon,28,0,28,0
1713341563084,EDS 117,A01,494379,Staff,23,0,25,2
1713341564109,EDS 125,A00,507246,Hopkins; Megan Beth,29,0,30,1
1713341565135,EDS 128A,A01,507264,Fargason; Sharon Gayle,26,0,26,0
1713341566160,EDS 128B,A01,507293,Pappas; Elizabeth,30,0,30,0
1713341567191,EDS 139,A00,507294,Fargason; Sharon Gayle,30,0,30,0
1713341567191,EDS 139,B00,507313,Pappas; Elizabeth,30,0,30,0
1713341568220,EDS 201,A00,507315,Staff,26,0,30,4
1713341569248,EDS 203,A01,507317,Halter; Christopher P.,26,0,30,4
1713341570275,EDS 204R,A01,507319,Halter; Christopher P.,3,0,30,27
1713341570275,EDS 204R,B01,507331,Heinzman; Erica M.,28,0,30,2
1713341571302,EDS 206R,A00,507332,Staff,4,0,30,26
1713341571302,EDS 206R,B00,507343,Staff,28,0,30,2
1713341572330,EDS 250,A00,507344,Hemans; Patricia Ann Benitez,36,0,40,4
1713341573359,EDS 281,A00,507345,Daly; Alan J.,18,0,18,0
1713341574438,EDS 284,A00,507350,Daly; Alan J.,16,0,16,0
1713341575463,EDS 286,A00,507359,Fine; Sarah,18,0,18,0
1713341576495,EDS 289C,A01,507361,Daly; Alan J.,18,0,18,0
1713341577520,EDS 290,A00,507366,Hofstetter; Carolyn,15,0,15,0
1713341578548,LIGM 5A,A00,507421,Fischer-Grunski; Eva K,20,0,20,0
1713341579576,LIGM 5B,A00,507423,Fischer-Grunski; Eva K,20,0,20,0
1713341580606,LIGM 5C,A00,507425,Fischer-Grunski; Eva K,20,0,20,0
1713341581639,LIIT 5AS,A00,507427,Carnelos; Chiara,20,0,20,0
1713341582669,LIIT 5BS,A00,507430,Carnelos; Chiara,20,0,20,0
1713341583697,LIIT 5CS,A00,507432,Carnelos; Chiara,20,0,20,0
1713341584723,LISP 5A,A00,507541,Munoz Sanchez; Alicia,17,0,20,3
1713341585750,LISP 5B,A00,507671,Munoz Sanchez; Alicia,15,0,20,5
1713341586776,LISP 5C,A00,507696,Munoz Sanchez; Alicia,15,0,20,5
1713341587804,MAE 197,001,528363,Boechler; Nicholas Sebastia,9998,0,9999,1
1713341588831,MATH 197,001,523477,Kedlaya; Kiran S.,9999,0,9999,0
1713341588831,MATH 197,002,563811,Zhang; Danna,9999,0,9999,0
1713341589861,MCWP 40R,A00,518780,Staff,20,0,20,0
1713341589861,MCWP 40R,B00,518781,Staff,19,0,20,1
1713341589861,MCWP 40R,C00,518783,Staff,19,0,20,1
1713341590895,MCWP 50R,A00,518791,Staff,20,0,20,0
1713341590895,MCWP 50R,B00,518792,Staff,17,0,20,3
1713341590895,MCWP 50R,C00,518793,Staff,19,0,20,1
1713341590895,MCWP 50R,D00,518794,Staff,16,0,20,4
1713341590895,MCWP 50R,E00,518795,Staff,16,0,20,4
1713341590895,MCWP 50R,F00,518796,Staff,19,0,20,1
1713341590895,MCWP 50R,G00,518797,Staff,19,0,20,1
1713341591928,MMW 12R,A01,514034,Herbst; Matthew,15,0,16,1
1713341591928,MMW 12R,A02,514035,Herbst; Matthew,16,0,16,0
1713341592954,MMW 13R,A01,514037,Staff,12,0,16,4
1713341592954,MMW 13R,A02,514039,Staff,16,0,16,0
1713341595007,SIO 295LS,A00,523233,Staff,18,0,30,12
1713341596034,SIO 295S,A00,523232,Staff,18,0,30,12
1713341597062,SOCI 117,A01,494376,Staff,1,0,5,4
1713341598089,WES 237B,A00,494380,Staff,19,0,20,1
1713341600173,AESE 279B,A00,494370,Wade; Jon P,33,0,33,0
1713341601199,ANAR 135S,A00,494369,Braswell; Geoffrey E.,0,0,0,0
1713341602226,CAT 124RS,A01,519847,Geibel; William,17,0,20,3
1713341603254,CAT 125RS,A01,515971,Geibel; William,17,0,20,3
1713341604282,CLRE 250,A00,511389,Morris; Sheldon,9996,0,9999,3
1713341605317,CLRE 251,A00,507176,Mehta; Ravindra L.,9996,0,9999,3
1713341605317,CLRE 251,B00,511410,Mehta; Ravindra L.,9998,0,9999,1
1713341606344,CLRE 252,A00,507189,Cuomo; Raphael Eduardo,9998,0,9999,1
1713341607371,CLRE 253,A00,507199,Vaida; Florin,9997,0,9999,2
1713341607371,CLRE 253,B00,507202,Vaida; Florin,9999,0,9999,0
1713341608402,CLRE 259,A00,507211,Patel; Hemal,9996,0,9999,3
1713341609427,CLRE 260,A00,507221,Cuomo; Raphael Eduardo,9999,0,9999,0
1713341610455,CLRE 297,001,507242,Cuomo; Raphael Eduardo,9999,0,9999,0
1713341611481,CSE 191,A00,516875,Minnes Kemp; Mor Mia,9999,0,9999,0
1713341612510,CSS 201S,A01,494383,Staff,35,0,35,0
1713341613539,CSS 202S,A01,494387,Staff,35,0,35,0
1713341614568,EAP 100,A00,516065,Staff,9792,0,9999,207
1713341615601,ECE 45,A01,507414,Staff,51,0,60,9
1713341616627,ECE 100,A01,507416,Baghdadchi; Saharnaz,10,0,20,10
1713341616627,ECE 100,A02,507418,Baghdadchi; Saharnaz,20,0,20,0
1713341617652,ECE 111,A01,507420,Staff,38,0,50,12
1713341618684,ECE 197,001,548057,Sievenpiper; Daniel F.,9998,0,9999,1
1713341619714,EDS 115,A00,507243,Choi; Bailey Miyeon,28,0,28,0
1713341620745,EDS 117,A01,494379,Staff,23,0,25,2
1713341621778,EDS 125,A00,507246,Hopkins; Megan Beth,29,0,30,1
1713341622805,EDS 128A,A01,507264,Fargason; Sharon Gayle,26,0,26,0
1713341623831,EDS 128B,A01,507293,Pappas; Elizabeth,30,0,30,0
1713341624856,EDS 139,A00,507294,Fargason; Sharon Gayle,30,0,30,0
1713341624856,EDS 139,B00,507313,Pappas; Elizabeth,30,0,30,0
1713341625881,EDS 201,A00,507315,Staff,26,0,30,4
1713341626906,EDS 203,A01,507317,Halter; Christopher P.,26,0,30,4
1713341627933,EDS 204R,A01,507319,Halter; Christopher P.,3,0,30,27
1713341627933,EDS 204R,B01,507331,Heinzman; Erica M.,28,0,30,2
1713341628961,EDS 206R,A00,507332,Staff,4,0,30,26
1713341628961,EDS 206R,B00,507343,Staff,28,0,30,2
1713341629987,EDS 250,A00,507344,Hemans; Patricia Ann Benitez,36,0,40,4
1713341631016,EDS 281,A00,507345,Daly; Alan J.,18,0,18,0
1713341632040,EDS 284,A00,507350,Daly; Alan J.,16,0,16,0
1713341633064,EDS 286,A00,507359,Fine; Sarah,18,0,18,0
1713341634102,EDS 289C,A01,507361,Daly; Alan J.,18,0,18,0
1713341635128,EDS 290,A00,507366,Hofstetter; Carolyn,15,0,15,0
1713341636159,LIGM 5A,A00,507421,Fischer-Grunski; Eva K,20,0,20,0
1713341637186,LIGM 5B,A00,507423,Fischer-Grunski; Eva K,20,0,20,0
1713341638212,LIGM 5C,A00,507425,Fischer-Grunski; Eva K,20,0,20,0
1713341639237,LIIT 5AS,A00,507427,Carnelos; Chiara,20,0,20,0
1713341640262,LIIT 5BS,A00,507430,Carnelos; Chiara,20,0,20,0
1713341641286,LIIT 5CS,A00,507432,Carnelos; Chiara,20,0,20,0
1713341642312,LISP 5A,A00,507541,Munoz Sanchez; Alicia,17,0,20,3
1713341643342,LISP 5B,A00,507671,Munoz Sanchez; Alicia,15,0,20,5
1713341644367,LISP 5C,A00,507696,Munoz Sanchez; Alicia,15,0,20,5
1713341645394,MAE 197,001,528363,Boechler; Nicholas Sebastia,9998,0,9999,1
1713341646419,MATH 197,001,523477,Kedlaya; Kiran S.,9999,0,9999,0
1713341646419,MATH 197,002,563811,Zhang; Danna,9999,0,9999,0
1713341647445,MCWP 40R,A00,518780,Staff,20,0,20,0
1713341647445,MCWP 40R,B00,518781,Staff,19,0,20,1
1713341647445,MCWP 40R,C00,518783,Staff,19,0,20,1
1713341648473,MCWP 50R,A00,518791,Staff,20,0,20,0
1713341648473,MCWP 50R,B00,518792,Staff,17,0,20,3
1713341648473,MCWP 50R,C00,518793,Staff,19,0,20,1
1713341648473,MCWP 50R,D00,518794,Staff,16,0,20,4
1713341648473,MCWP 50R,E00,518795,Staff,16,0,20,4
1713341648473,MCWP 50R,F00,518796,Staff,19,0,20,1
1713341648473,MCWP 50R,G00,518797,Staff,19,0,20,1
1713341649499,MMW 12R,A01,514034,Herbst; Matthew,15,0,16,1
1713341649499,MMW 12R,A02,514035,Herbst; Matthew,16,0,16,0
1713341650528,MMW 13R,A01,514037,Staff,12,0,16,4
1713341650528,MMW 13R,A02,514039,Staff,16,0,16,0
1713341652581,SIO 295LS,A00,523233,Staff,18,0,30,12
1713341653605,SIO 295S,A00,523232,Staff,18,0,30,12
1713341654647,SOCI 117,A01,494376,Staff,1,0,5,4
1713341655677,WES 237B,A00,494380,Staff,19,0,20,1
1713341657748,AESE 279B,A00,494370,Wade; Jon P,33,0,33,0
1713341658773,ANAR 135S,A00,494369,Braswell; Geoffrey E.,0,0,0,0
1713341659799,CAT 124RS,A01,519847,Geibel; William,17,0,20,3
1713341660825,CAT 125RS,A01,515971,Geibel; William,17,0,20,3
1713341661855,CLRE 250,A00,511389,Morris; Sheldon,9996,0,9999,3
1713341662885,CLRE 251,A00,507176,Mehta; Ravindra L.,9996,0,9999,3
1713341662885,CLRE 251,B00,511410,Mehta; Ravindra L.,9998,0,9999,1
1713341663911,CLRE 252,A00,507189,Cuomo; Raphael Eduardo,9998,0,9999,1
1713341664936,CLRE 253,A00,507199,Vaida; Florin,9997,0,9999,2
1713341664936,CLRE 253,B00,507202,Vaida; Florin,9999,0,9999,0
1713341665965,CLRE 259,A00,507211,Patel; Hemal,9996,0,9999,3
1713341666998,CLRE 260,A00,507221,Cuomo; Raphael Eduardo,9999,0,9999,0
1713341668022,CLRE 297,001,507242,Cuomo; Raphael Eduardo,9999,0,9999,0
1713341669047,CSE 191,A00,516875,Minnes Kemp; Mor Mia,9999,0,9999,0
1713341670073,CSS 201S,A01,494383,Staff,35,0,35,0
1713341671102,CSS 202S,A01,494387,Staff,35,0,35,0
1713341672130,EAP 100,A00,516065,Staff,9792,0,9999,207
1713341673160,ECE 45,A01,507414,Staff,51,0,60,9
1713341674184,ECE 100,A01,507416,Baghdadchi; Saharnaz,10,0,20,10
1713341674184,ECE 100,A02,507418,Baghdadchi; Saharnaz,20,0,20,0
1713341675209,ECE 111,A01,507420,Staff,38,0,50,12
1713341676236,ECE 197,001,548057,Sievenpiper; Daniel F.,9998,0,9999,1
1713341677263,EDS 115,A00,507243,Choi; Bailey Miyeon,28,0,28,0
1713341678347,EDS 117,A01,494379,Staff,23,0,25,2
1713341679377,EDS 125,A00,507246,Hopkins; Megan Beth,29,0,30,1
1713341680401,EDS 128A,A01,507264,Fargason; Sharon Gayle,26,0,26,0
1713341681432,EDS 128B,A01,507293,Pappas; Elizabeth,30,0,30,0
1713341682456,EDS 139,A00,507294,Fargason; Sharon Gayle,30,0,30,0
1713341682456,EDS 139,B00,507313,Pappas; Elizabeth,30,0,30,0
1713341683486,EDS 201,A00,507315,Staff,26,0,30,4
1713341684515,EDS 203,A01,507317,Halter; Christopher P.,26,0,30,4
1713341685545,EDS 204R,A01,507319,Halter; Christopher P.,3,0,30,27
1713341685545,EDS 204R,B01,507331,Heinzman; Erica M.,28,0,30,2
1713341686570,EDS 206R,A00,507332,Staff,4,0,30,26
1713341686570,EDS 206R,B00,507343,Staff,28,0,30,2
1713341687597,EDS 250,A00,507344,Hemans; Patricia Ann Benitez,36,0,40,4
1713341688622,EDS 281,A00,507345,Daly; Alan J.,18,0,18,0
1713341689649,EDS 284,A00,507350,Daly; Alan J.,16,0,16,0
1713341690675,EDS 286,A00,507359,Fine; Sarah,18,0,18,0
1713341691704,EDS 289C,A01,507361,Daly; Alan J.,18,0,18,0
1713341692734,EDS 290,A00,507366,Hofstetter; Carolyn,15,0,15,0
1713341693760,LIGM 5A,A00,507421,Fischer-Grunski; Eva K,20,0,20,0
1713341694789,LIGM 5B,A00,507423,Fischer-Grunski; Eva K,20,0,20,0
1713341695816,LIGM 5C,A00,507425,Fischer-Grunski; Eva K,20,0,20,0
1713341696847,LIIT 5AS,A00,507427,Carnelos; Chiara,20,0,20,0
1713341697878,LIIT 5BS,A00,507430,Carnelos; Chiara,20,0,20,0
1713341698908,LIIT 5CS,A00,507432,Carnelos; Chiara,20,0,20,0
1713341699937,LISP 5A,A00,507541,Munoz Sanchez; Alicia,17,0,20,3
1713341700970,LISP 5B,A00,507671,Munoz Sanchez; Alicia,15,0,20,5
1713341702000,LISP 5C,A00,507696,Munoz Sanchez; Alicia,15,0,20,5
1713341703026,MAE 197,001,528363,Boechler; Nicholas Sebastia,9998,0,9999,1
1713341704052,MATH 197,001,523477,Kedlaya; Kiran S.,9999,0,9999,0
1713341704052,MATH 197,002,563811,Zhang; Danna,9999,0,9999,0
1713341705077,MCWP 40R,A00,518780,Staff,20,0,20,0
1713341705077,MCWP 40R,B00,518781,Staff,19,0,20,1
1713341705077,MCWP 40R,C00,518783,Staff,19,0,20,1
1713341706104,MCWP 50R,A00,518791,Staff,20,0,20,0
1713341706104,MCWP 50R,B00,518792,Staff,17,0,20,3
1713341706104,MCWP 50R,C00,518793,Staff,19,0,20,1
1713341706104,MCWP 50R,D00,518794,Staff,16,0,20,4
1713341706104,MCWP 50R,E00,518795,Staff,16,0,20,4
1713341706104,MCWP 50R,F00,518796,Staff,19,0,20,1
1713341706104,MCWP 50R,G00,518797,Staff,19,0,20,1
1713341707129,MMW 12R,A01,514034,Herbst; Matthew,15,0,16,1
1713341707129,MMW 12R,A02,514035,Herbst; Matthew,16,0,16,0
1713341708154,MMW 13R,A01,514037,Staff,12,0,16,4
1713341708154,MMW 13R,A02,514039,Staff,16,0,16,0
1713341710319,SIO 295LS,A00,523233,Staff,18,0,30,12
1713341711352,SIO 295S,A00,523232,Staff,18,0,30,12
1713341712383,SOCI 117,A01,494376,Staff,1,0,5,4
1713341713412,WES 237B,A00,494380,Staff,19,0,20,1
1713341715481,AESE 279B,A00,494370,Wade; Jon P,33,0,33,0
1713341716510,ANAR 135S,A00,494369,Braswell; Geoffrey E.,0,0,0,0
1713341717535,CAT 124RS,A01,519847,Geibel; William,17,0,20,3
1713341718561,CAT 125RS,A01,515971,Geibel; William,17,0,20,3
1713341719589,CLRE 250,A00,511389,Morris; Sheldon,9996,0,9999,3
1713341720616,CLRE 251,A00,507176,Mehta; Ravindra L.,9996,0,9999,3
1713341720616,CLRE 251,B00,511410,Mehta; Ravindra L.,9998,0,9999,1
1713341721642,CLRE 252,A00,507189,Cuomo; Raphael Eduardo,9998,0,9999,1
1713341722668,CLRE 253,A00,507199,Vaida; Florin,9997,0,9999,2
1713341722668,CLRE 253,B00,507202,Vaida; Florin,9999,0,9999,0
1713341723700,CLRE 259,A00,507211,Patel; Hemal,9996,0,9999,3
1713341724728,CLRE 260,A00,507221,Cuomo; Raphael Eduardo,9999,0,9999,0
1713341725758,CLRE 297,001,507242,Cuomo; Raphael Eduardo,9999,0,9999,0
1713341726783,CSE 191,A00,516875,Minnes Kemp; Mor Mia,9999,0,9999,0
1713341727811,CSS 201S,A01,494383,Staff,35,0,35,0
1713341728838,CSS 202S,A01,494387,Staff,35,0,35,0
1713341729863,EAP 100,A00,516065,Staff,9792,0,9999,207
1713341730896,ECE 45,A01,507414,Staff,51,0,60,9
1713341731928,ECE 100,A01,507416,Baghdadchi; Saharnaz,10,0,20,10
1713341731928,ECE 100,A02,507418,Baghdadchi; Saharnaz,20,0,20,0
1713341732959,ECE 111,A01,507420,Staff,38,0,50,12
1713341733984,ECE 197,001,548057,Sievenpiper; Daniel F.,9998,0,9999,1
1713341735010,EDS 115,A00,507243,Choi; Bailey Miyeon,28,0,28,0
1713341736036,EDS 117,A01,494379,Staff,23,0,25,2
1713341737067,EDS 125,A00,507246,Hopkins; Megan Beth,29,0,30,1
1713341738093,EDS 128A,A01,507264,Fargason; Sharon Gayle,26,0,26,0
1713341739126,EDS 128B,A01,507293,Pappas; Elizabeth,30,0,30,0
1713341740152,EDS 139,A00,507294,Fargason; Sharon Gayle,30,0,30,0
1713341740152,EDS 139,B00,507313,Pappas; Elizabeth,30,0,30,0
1713341741178,EDS 201,A00,507315,Staff,26,0,30,4
1713341742207,EDS 203,A01,507317,Halter; Christopher P.,26,0,30,4
1713341743232,EDS 204R,A01,507319,Halter; Christopher P.,3,0,30,27
1713341743232,EDS 204R,B01,507331,Heinzman; Erica M.,28,0,30,2
1713341744258,EDS 206R,A00,507332,Staff,4,0,30,26
1713341744258,EDS 206R,B00,507343,Staff,28,0,30,2
1713341745283,EDS 250,A00,507344,Hemans; Patricia Ann Benitez,36,0,40,4
1713341746314,EDS 281,A00,507345,Daly; Alan J.,18,0,18,0
1713341747344,EDS 284,A00,507350,Daly; Alan J.,16,0,16,0
1713341748374,EDS 286,A00,507359,Fine; Sarah,18,0,18,0
1713341749398,EDS 289C,A01,507361,Daly; Alan J.,18,0,18,0
1713341750424,EDS 290,A00,507366,Hofstetter; Carolyn,15,0,15,0
1713341751450,LIGM 5A,A00,507421,Fischer-Grunski; Eva K,20,0,20,0
1713341752476,LIGM 5B,A00,507423,Fischer-Grunski; Eva K,20,0,20,0
1713341753502,LIGM 5C,A00,507425,Fischer-Grunski; Eva K,20,0,20,0
1713341754527,LIIT 5AS,A00,507427,Carnelos; Chiara,20,0,20,0
1713341755559,LIIT 5BS,A00,507430,Carnelos; Chiara,20,0,20,0
1713341756584,LIIT 5CS,A00,507432,Carnelos; Chiara,20,0,20,0
1713341757611,LISP 5A,A00,507541,Munoz Sanchez; Alicia,17,0,20,3
1713341758643,LISP 5B,A00,507671,Munoz Sanchez; Alicia,15,0,20,5
1713341759669,LISP 5C,A00,507696,Munoz Sanchez; Alicia,15,0,20,5
1713341760696,MAE 197,001,528363,Boechler; Nicholas Sebastia,9998,0,9999,1
1713341761727,MATH 197,001,523477,Kedlaya; Kiran S.,9999,0,9999,0
1713341761727,MATH 197,002,563811,Zhang; Danna,9999,0,9999,0
1713341762753,MCWP 40R,A00,518780,Staff,20,0,20,0
1713341762753,MCWP 40R,B00,518781,Staff,19,0,20,1
1713341762753,MCWP 40R,C00,518783,Staff,19,0,20,1
1713341763789,MCWP 50R,A00,518791,Staff,20,0,20,0
1713341763789,MCWP 50R,B00,518792,Staff,17,0,20,3
1713341763789,MCWP 50R,C00,518793,Staff,19,0,20,1
1713341763789,MCWP 50R,D00,518794,Staff,16,0,20,4
1713341763789,MCWP 50R,E00,518795,Staff,16,0,20,4
1713341763789,MCWP 50R,F00,518796,Staff,19,0,20,1
1713341763789,MCWP 50R,G00,518797,Staff,19,0,20,1
1713341764816,MMW 12R,A01,514034,Herbst; Matthew,15,0,16,1
1713341764816,MMW 12R,A02,514035,Herbst; Matthew,16,0,16,0
1713341765842,MMW 13R,A01,514037,Staff,12,0,16,4
1713341765842,MMW 13R,A02,514039,Staff,16,0,16,0
1713341767892,SIO 295LS,A00,523233,Staff,18,0,30,12
1713341768919,SIO 295S,A00,523232,Staff,18,0,30,12
1713341769949,SOCI 117,A01,494376,Staff,1,0,5,4
1713341770974,WES 237B,A00,494380,Staff,19,0,20,1
1713341773045,AESE 279B,A00,494370,Wade; Jon P,33,0,33,0
1713341774071,ANAR 135S,A00,494369,Braswell; Geoffrey E.,0,0,0,0
1713341775097,CAT 124RS,A01,519847,Geibel; William,17,0,20,3
1713341776123,CAT 125RS,A01,515971,Geibel; William,17,0,20,3
1713341777156,CLRE 250,A00,511389,Morris; Sheldon,9996,0,9999,3
1713341778183,CLRE 251,A00,507176,Mehta; Ravindra L.,9996,0,9999,3
1713341778183,CLRE 251,B00,511410,Mehta; Ravindra L.,9998,0,9999,1
1713341779214,CLRE 252,A00,507189,Cuomo; Raphael Eduardo,9998,0,9999,1
1713341780245,CLRE 253,A00,507199,Vaida; Florin,9997,0,9999,2
1713341780245,CLRE 253,B00,507202,Vaida; Florin,9999,0,9999,0
1713341781275,CLRE 259,A00,507211,Patel; Hemal,9996,0,9999,3
1713341782357,CLRE 260,A00,507221,Cuomo; Raphael Eduardo,9999,0,9999,0
1713341783388,CLRE 297,001,507242,Cuomo; Raphael Eduardo,9999,0,9999,0
1713341784412,CSE 191,A00,516875,Minnes Kemp; Mor Mia,9999,0,9999,0
1713341785444,CSS 201S,A01,494383,Staff,35,0,35,0
1713341786470,CSS 202S,A01,494387,Staff,35,0,35,0
1713341787493,EAP 100,A00,516065,Staff,9792,0,9999,207
1713341788521,ECE 45,A01,507414,Staff,51,0,60,9
1713341789546,ECE 100,A01,507416,Baghdadchi; Saharnaz,10,0,20,10
1713341789546,ECE 100,A02,507418,Baghdadchi; Saharnaz,20,0,20,0
1713341790571,ECE 111,A01,507420,Staff,38,0,50,12
1713341791597,ECE 197,001,548057,Sievenpiper; Daniel F.,9998,0,9999,1
1713341792628,EDS 115,A00,507243,Choi; Bailey Miyeon,28,0,28,0
1713341793661,EDS 117,A01,494379,Staff,23,0,25,2
1713341794687,EDS 125,A00,507246,Hopkins; Megan Beth,29,0,30,1
1713341795721,EDS 128A,A01,507264,Fargason; Sharon Gayle,26,0,26,0
1713341796751,EDS 128B,A01,507293,Pappas; Elizabeth,30,0,30,0
1713341797777,EDS 139,A00,507294,Fargason; Sharon Gayle,30,0,30,0
1713341797777,EDS 139,B00,507313,Pappas; Elizabeth,30,0,30,0
1713341798805,EDS 201,A00,507315,Staff,26,0,30,4
1713341799838,EDS 203,A01,507317,Halter; Christopher P.,26,0,30,4
1713341800865,EDS 204R,A01,507319,Halter; Christopher P.,3,0,30,27
1713341800865,EDS 204R,B01,507331,Heinzman; Erica M.,28,0,30,2
1713341801890,EDS 206R,A00,507332,Staff,4,0,30,26
1713341801890,EDS 206R,B00,507343,Staff,28,0,30,2
1713341802916,EDS 250,A00,507344,Hemans; Patricia Ann Benitez,36,0,40,4
1713341803948,EDS 281,A00,507345,Daly; Alan J.,18,0,18,0
1713341804972,EDS 284,A00,507350,Daly; Alan J.,16,0,16,0
1713341805998,EDS 286,A00,507359,Fine; Sarah,18,0,18,0
1713341807024,EDS 289C,A01,507361,Daly; Alan J.,18,0,18,0
1713341808054,EDS 290,A00,507366,Hofstetter; Carolyn,15,0,15,0
1713341809080,LIGM 5A,A00,507421,Fischer-Grunski; Eva K,20,0,20,0
1713341810111,LIGM 5B,A00,507423,Fischer-Grunski; Eva K,20,0,20,0
1713341811137,LIGM 5C,A00,507425,Fischer-Grunski; Eva K,20,0,20,0
1713341812162,LIIT 5AS,A00,507427,Carnelos; Chiara,20,0,20,0
1713341813193,LIIT 5BS,A00,507430,Carnelos; Chiara,20,0,20,0
1713341814224,LIIT 5CS,A00,507432,Carnelos; Chiara,20,0,20,0
1713341815257,LISP 5A,A00,507541,Munoz Sanchez; Alicia,17,0,20,3
1713341816283,LISP 5B,A00,507671,Munoz Sanchez; Alicia,15,0,20,5
1713341817308,LISP 5C,A00,507696,Munoz Sanchez; Alicia,15,0,20,5
1713341818334,MAE 197,001,528363,Boechler; Nicholas Sebastia,9998,0,9999,1
1713341819361,MATH 197,001,523477,Kedlaya; Kiran S.,9999,0,9999,0
1713341819361,MATH 197,002,563811,Zhang; Danna,9999,0,9999,0
1713341820393,MCWP 40R,A00,518780,Staff,20,0,20,0
1713341820393,MCWP 40R,B00,518781,Staff,19,0,20,1
1713341820393,MCWP 40R,C00,518783,Staff,19,0,20,1
1713341821419,MCWP 50R,A00,518791,Staff,20,0,20,0
1713341821419,MCWP 50R,B00,518792,Staff,17,0,20,3
1713341821419,MCWP 50R,C00,518793,Staff,19,0,20,1
1713341821419,MCWP 50R,D00,518794,Staff,16,0,20,4
1713341821419,MCWP 50R,E00,518795,Staff,16,0,20,4
1713341821419,MCWP 50R,F00,518796,Staff,19,0,20,1
1713341821419,MCWP 50R,G00,518797,Staff,19,0,20,1
1713341822447,MMW 12R,A01,514034,Herbst; Matthew,15,0,16,1
1713341822447,MMW 12R,A02,514035,Herbst; Matthew,16,0,16,0
1713341823473,MMW 13R,A01,514037,Staff,12,0,16,4
1713341823473,MMW 13R,A02,514039,Staff,16,0,16,0
1713341825538,SIO 295LS,A00,523233,Staff,18,0,30,12
1713341826568,SIO 295S,A00,523232,Staff,18,0,30,12
1713341827597,SOCI 117,A01,494376,Staff,1,0,5,4
1713341828631,WES 237B,A00,494380,Staff,19,0,20,1
1713341830705,AESE 279B,A00,494370,Wade; Jon P,33,0,33,0
1713341831729,ANAR 135S,A00,494369,Braswell; Geoffrey E.,0,0,0,0
1713341832755,CAT 124RS,A01,519847,Geibel; William,17,0,20,3
1713341833780,CAT 125RS,A01,515971,Geibel; William,17,0,20,3
1713341834808,CLRE 250,A00,511389,Morris; Sheldon,9996,0,9999,3
1713341835834,CLRE 251,A00,507176,Mehta; Ravindra L.,9996,0,9999,3
1713341835834,CLRE 251,B00,511410,Mehta; Ravindra L.,9998,0,9999,1
1713341836864,CLRE 252,A00,507189,Cuomo; Raphael Eduardo,9998,0,9999,1
1713341837899,CLRE 253,A00,507199,Vaida; Florin,9997,0,9999,2
1713341837899,CLRE 253,B00,507202,Vaida; Florin,9999,0,9999,0
1713341838935,CLRE 259,A00,507211,Patel; Hemal,9996,0,9999,3
1713341839966,CLRE 260,A00,507221,Cuomo; Raphael Eduardo,9999,0,9999,0
1713341840992,CLRE 297,001,507242,Cuomo; Raphael Eduardo,9999,0,9999,0
1713341842020,CSE 191,A00,516875,Minnes Kemp; Mor Mia,9999,0,9999,0
1713341843046,CSS 201S,A01,494383,Staff,35,0,35,0
1713341844077,CSS 202S,A01,494387,Staff,35,0,35,0
1713341845103,EAP 100,A00,516065,Staff,9792,0,9999,207
1713341846129,ECE 45,A01,507414,Staff,51,0,60,9
1713341847154,ECE 100,A01,507416,Baghdadchi; Saharnaz,10,0,20,10
1713341847154,ECE 100,A02,507418,Baghdadchi; Saharnaz,20,0,20,0
1713341848178,ECE 111,A01,507420,Staff,38,0,50,12
1713341849205,ECE 197,001,548057,Sievenpiper; Daniel F.,9998,0,9999,1
1713341850237,EDS 115,A00,507243,Choi; Bailey Miyeon,28,0,28,0
1713341851263,EDS 117,A01,494379,Staff,23,0,25,2
1713341852298,EDS 125,A00,507246,Hopkins; Megan Beth,29,0,30,1
1713341853324,EDS 128A,A01,507264,Fargason; Sharon Gayle,26,0,26,0
1713341854353,EDS 128B,A01,507293,Pappas; Elizabeth,30,0,30,0
1713341855379,EDS 139,A00,507294,Fargason; Sharon Gayle,30,0,30,0
1713341855379,EDS 139,B00,507313,Pappas; Elizabeth,30,0,30,0
1713341856404,EDS 201,A00,507315,Staff,26,0,30,4
1713341857431,EDS 203,A01,507317,Halter; Christopher P.,26,0,30,4
1713341858458,EDS 204R,A01,507319,Halter; Christopher P.,3,0,30,27
1713341858458,EDS 204R,B01,507331,Heinzman; Erica M.,28,0,30,2
1713341859482,EDS 206R,A00,507332,Staff,4,0,30,26
1713341859482,EDS 206R,B00,507343,Staff,28,0,30,2
1713341860508,EDS 250,A00,507344,Hemans; Patricia Ann Benitez,36,0,40,4
1713341861538,EDS 281,A00,507345,Daly; Alan J.,18,0,18,0
1713341862563,EDS 284,A00,507350,Daly; Alan J.,16,0,16,0
1713341863588,EDS 286,A00,507359,Fine; Sarah,18,0,18,0
1713341864615,EDS 289C,A01,507361,Daly; Alan J.,18,0,18,0
1713341865664,EDS 290,A00,507366,Hofstetter; Carolyn,15,0,15,0
1713341866692,LIGM 5A,A00,507421,Fischer-Grunski; Eva K,20,0,20,0
1713341867718,LIGM 5B,A00,507423,Fischer-Grunski; Eva K,20,0,20,0
1713341868743,LIGM 5C,A00,507425,Fischer-Grunski; Eva K,20,0,20,0
1713341869769,LIIT 5AS,A00,507427,Carnelos; Chiara,20,0,20,0
1713341870807,LIIT 5BS,A00,507430,Carnelos; Chiara,20,0,20,0
1713341871833,LIIT 5CS,A00,507432,Carnelos; Chiara,20,0,20,0
1713341872865,LISP 5A,A00,507541,Munoz Sanchez; Alicia,17,0,20,3
1713341873904,LISP 5B,A00,507671,Munoz Sanchez; Alicia,15,0,20,5
1713341874934,LISP 5C,A00,507696,Munoz Sanchez; Alicia,15,0,20,5
1713341875959,MAE 197,001,528363,Boechler; Nicholas Sebastia,9998,0,9999,1
1713341876987,MATH 197,001,523477,Kedlaya; Kiran S.,9999,0,9999,0
1713341876987,MATH 197,002,563811,Zhang; Danna,9999,0,9999,0
1713341878012,MCWP 40R,A00,518780,Staff,20,0,20,0
1713341878012,MCWP 40R,B00,518781,Staff,19,0,20,1
1713341878012,MCWP 40R,C00,518783,Staff,19,0,20,1
1713341879037,MCWP 50R,A00,518791,Staff,20,0,20,0
1713341879037,MCWP 50R,B00,518792,Staff,17,0,20,3
1713341879037,MCWP 50R,C00,518793,Staff,19,0,20,1
1713341879037,MCWP 50R,D00,518794,Staff,16,0,20,4
1713341879037,MCWP 50R,E00,518795,Staff,16,0,20,4
1713341879037,MCWP 50R,F00,518796,Staff,19,0,20,1
1713341879037,MCWP 50R,G00,518797,Staff,19,0,20,1
1713341880064,MMW 12R,A01,514034,Herbst; Matthew,15,0,16,1
1713341880064,MMW 12R,A02,514035,Herbst; Matthew,16,0,16,0
1713341881091,MMW 13R,A01,514037,Staff,12,0,16,4
1713341881091,MMW 13R,A02,514039,Staff,16,0,16,0
1713341883140,SIO 295LS,A00,523233,Staff,18,0,30,12
1713341884165,SIO 295S,A00,523232,Staff,18,0,30,12
1713341885195,SOCI 117,A01,494376,Staff,1,0,5,4
1713341886273,WES 237B,A00,494380,Staff,19,0,20,1
1713341888362,AESE 279B,A00,494370,Wade; Jon P,33,0,33,0
1713341889393,ANAR 135S,A00,494369,Braswell; Geoffrey E.,0,0,0,0
1713341890425,CAT 124RS,A01,519847,Geibel; William,17,0,20,3
1713341891451,CAT 125RS,A01,515971,Geibel; William,17,0,20,3
1713341892478,CLRE 250,A00,511389,Morris; Sheldon,9996,0,9999,3
1713341893511,CLRE 251,A00,507176,Mehta; Ravindra L.,9996,0,9999,3
1713341893511,CLRE 251,B00,511410,Mehta; Ravindra L.,9998,0,9999,1
1713341894536,CLRE 252,A00,507189,Cuomo; Raphael Eduardo,9998,0,9999,1
1713341895561,CLRE 253,A00,507199,Vaida; Florin,9997,0,9999,2
1713341895561,CLRE 253,B00,507202,Vaida; Florin,9999,0,9999,0
1713341896592,CLRE 259,A00,507211,Patel; Hemal,9996,0,9999,3
1713341897616,CLRE 260,A00,507221,Cuomo; Raphael Eduardo,9999,0,9999,0
1713341898641,CLRE 297,001,507242,Cuomo; Raphael Eduardo,9999,0,9999,0
1713341899666,CSE 191,A00,516875,Minnes Kemp; Mor Mia,9999,0,9999,0
1713341900692,CSS 201S,A01,494383,Staff,35,0,35,0
1713341901717,CSS 202S,A01,494387,Staff,35,0,35,0
1713341902742,EAP 100,A00,516065,Staff,9792,0,9999,207
1713341903772,ECE 45,A01,507414,Staff,51,0,60,9
1713341904817,ECE 100,A01,507416,Baghdadchi; Saharnaz,10,0,20,10
1713341904817,ECE 100,A02,507418,Baghdadchi; Saharnaz,20,0,20,0
1713341905847,ECE 111,A01,507420,Staff,38,0,50,12
1713341906876,ECE 197,001,548057,Sievenpiper; Daniel F.,9998,0,9999,1
1713341907905,EDS 115,A00,507243,Choi; Bailey Miyeon,28,0,28,0
1713341908935,EDS 117,A01,494379,Staff,23,0,25,2
1713341909961,EDS 125,A00,507246,Hopkins; Megan Beth,29,0,30,1
1713341910987,EDS 128A,A01,507264,Fargason; Sharon Gayle,26,0,26,0
1713341912013,EDS 128B,A01,507293,Pappas; Elizabeth,30,0,30,0
1713341913043,EDS 139,A00,507294,Fargason; Sharon Gayle,30,0,30,0
1713341913043,EDS 139,B00,507313,Pappas; Elizabeth,30,0,30,0
1713341914071,EDS 201,A00,507315,Staff,26,0,30,4
1713341915095,EDS 203,A01,507317,Halter; Christopher P.,26,0,30,4
1713341916121,EDS 204R,A01,507319,Halter; Christopher P.,3,0,30,27
1713341916121,EDS 204R,B01,507331,Heinzman; Erica M.,28,0,30,2
1713341917147,EDS 206R,A00,507332,Staff,4,0,30,26
1713341917147,EDS 206R,B00,507343,Staff,28,0,30,2
1713341918173,EDS 250,A00,507344,Hemans; Patricia Ann Benitez,36,0,40,4
1713341919199,EDS 281,A00,507345,Daly; Alan J.,18,0,18,0
1713341920224,EDS 284,A00,507350,Daly; Alan J.,16,0,16,0
1713341921250,EDS 286,A00,507359,Fine; Sarah,18,0,18,0
1713341922275,EDS 289C,A01,507361,Daly; Alan J.,18,0,18,0
1713341923300,EDS 290,A00,507366,Hofstetter; Carolyn,15,0,15,0
1713341924331,LIGM 5A,A00,507421,Fischer-Grunski; Eva K,20,0,20,0
1713341925358,LIGM 5B,A00,507423,Fischer-Grunski; Eva K,20,0,20,0
1713341926390,LIGM 5C,A00,507425,Fischer-Grunski; Eva K,20,0,20,0
1713341927422,LIIT 5AS,A00,507427,Carnelos; Chiara,20,0,20,0
1713341928446,LIIT 5BS,A00,507430,Carnelos; Chiara,20,0,20,0
1713341929475,LIIT 5CS,A00,507432,Carnelos; Chiara,20,0,20,0
1713341930507,LISP 5A,A00,507541,Munoz Sanchez; Alicia,17,0,20,3
1713341931532,LISP 5B,A00,507671,Munoz Sanchez; Alicia,15,0,20,5
1713341932563,LISP 5C,A00,507696,Munoz Sanchez; Alicia,15,0,20,5
1713341933589,MAE 197,001,528363,Boechler; Nicholas Sebastia,9998,0,9999,1
1713341934623,MATH 197,001,523477,Kedlaya; Kiran S.,9999,0,9999,0
1713341934623,MATH 197,002,563811,Zhang; Danna,9999,0,9999,0
1713341935650,MCWP 40R,A00,518780,Staff,20,0,20,0
1713341935650,MCWP 40R,B00,518781,Staff,19,0,20,1
1713341935650,MCWP 40R,C00,518783,Staff,19,0,20,1
1713341936676,MCWP 50R,A00,518791,Staff,20,0,20,0
1713341936676,MCWP 50R,B00,518792,Staff,17,0,20,3
1713341936676,MCWP 50R,C00,518793,Staff,19,0,20,1
1713341936676,MCWP 50R,D00,518794,Staff,16,0,20,4
1713341936676,MCWP 50R,E00,518795,Staff,16,0,20,4
1713341936676,MCWP 50R,F00,518796,Staff,19,0,20,1
1713341936676,MCWP 50R,G00,518797,Staff,19,0,20,1
1713341937700,MMW 12R,A01,514034,Herbst; Matthew,15,0,16,1
1713341937700,MMW 12R,A02,514035,Herbst; Matthew,16,0,16,0
1713341938728,MMW 13R,A01,514037,Staff,12,0,16,4
1713341938728,MMW 13R,A02,514039,Staff,16,0,16,0
1713341940781,SIO 295LS,A00,523233,Staff,18,0,30,12
1713341941807,SIO 295S,A00,523232,Staff,18,0,30,12
1713341942837,SOCI 117,A01,494376,Staff,1,0,5,4
1713341943869,WES 237B,A00,494380,Staff,19,0,20,1
1713341945946,AESE 279B,A00,494370,Wade; Jon P,33,0,33,0
1713341946970,ANAR 135S,A00,494369,Braswell; Geoffrey E.,0,0,0,0
1713341947995,CAT 124RS,A01,519847,Geibel; William,17,0,20,3
1713341949020,CAT 125RS,A01,515971,Geibel; William,17,0,20,3
1713341950047,CLRE 250,A00,511389,Morris; Sheldon,9996,0,9999,3
1713341951081,CLRE 251,A00,507176,Mehta; Ravindra L.,9996,0,9999,3
1713341951081,CLRE 251,B00,511410,Mehta; Ravindra L.,9998,0,9999,1
1713341952108,CLRE 252,A00,507189,Cuomo; Raphael Eduardo,9998,0,9999,1
1713341953137,CLRE 253,A00,507199,Vaida; Florin,9997,0,9999,2
1713341953137,CLRE 253,B00,507202,Vaida; Florin,9999,0,9999,0
1713341954166,CLRE 259,A00,507211,Patel; Hemal,9996,0,9999,3
1713341955195,CLRE 260,A00,507221,Cuomo; Raphael Eduardo,9999,0,9999,0
1713341956219,CLRE 297,001,507242,Cuomo; Raphael Eduardo,9999,0,9999,0
1713341957252,CSE 191,A00,516875,Minnes Kemp; Mor Mia,9999,0,9999,0
1713341958284,CSS 201S,A01,494383,Staff,35,0,35,0
1713341959314,CSS 202S,A01,494387,Staff,35,0,35,0
1713341960340,EAP 100,A00,516065,Staff,9792,0,9999,207
1713341961367,ECE 45,A01,507414,Staff,51,0,60,9
1713341962391,ECE 100,A01,507416,Baghdadchi; Saharnaz,10,0,20,10
1713341962391,ECE 100,A02,507418,Baghdadchi; Saharnaz,20,0,20,0
1713341963421,ECE 111,A01,507420,Staff,38,0,50,12
1713341964445,ECE 197,001,548057,Sievenpiper; Daniel F.,9998,0,9999,1
1713341965477,EDS 115,A00,507243,Choi; Bailey Miyeon,28,0,28,0
1713341966509,EDS 117,A01,494379,Staff,23,0,25,2
1713341967539,EDS 125,A00,507246,Hopkins; Megan Beth,29,0,30,1
1713341968572,EDS 128A,A01,507264,Fargason; Sharon Gayle,26,0,26,0
1713341969604,EDS 128B,A01,507293,Pappas; Elizabeth,30,0,30,0
1713341970629,EDS 139,A00,507294,Fargason; Sharon Gayle,30,0,30,0
1713341970629,EDS 139,B00,507313,Pappas; Elizabeth,30,0,30,0
1713341971660,EDS 201,A00,507315,Staff,26,0,30,4
1713341972685,EDS 203,A01,507317,Halter; Christopher P.,26,0,30,4
1713341973710,EDS 204R,A01,507319,Halter; Christopher P.,3,0,30,27
1713341973710,EDS 204R,B01,507331,Heinzman; Erica M.,28,0,30,2
1713341974734,EDS 206R,A00,507332,Staff,4,0,30,26
1713341974734,EDS 206R,B00,507343,Staff,28,0,30,2
1713341975761,EDS 250,A00,507344,Hemans; Patricia Ann Benitez,36,0,40,4
1713341976792,EDS 281,A00,507345,Daly; Alan J.,18,0,18,0
1713341977820,EDS 284,A00,507350,Daly; Alan J.,16,0,16,0
1713341978847,EDS 286,A00,507359,Fine; Sarah,18,0,18,0
1713341979871,EDS 289C,A01,507361,Daly; Alan J.,18,0,18,0
1713341980902,EDS 290,A00,507366,Hofstetter; Carolyn,15,0,15,0
1713341981928,LIGM 5A,A00,507421,Fischer-Grunski; Eva K,20,0,20,0
1713341982964,LIGM 5B,A00,507423,Fischer-Grunski; Eva K,20,0,20,0
1713341983991,LIGM 5C,A00,507425,Fischer-Grunski; Eva K,20,0,20,0
1713341985023,LIIT 5AS,A00,507427,Carnelos; Chiara,20,0,20,0
1713341986048,LIIT 5BS,A00,507430,Carnelos; Chiara,20,0,20,0
1713341987074,LIIT 5CS,A00,507432,Carnelos; Chiara,20,0,20,0
1713341988106,LISP 5A,A00,507541,Munoz Sanchez; Alicia,17,0,20,3
1713341989131,LISP 5B,A00,507671,Munoz Sanchez; Alicia,15,0,20,5
1713341990214,LISP 5C,A00,507696,Munoz Sanchez; Alicia,15,0,20,5
1713341991238,MAE 197,001,528363,Boechler; Nicholas Sebastia,9998,0,9999,1
1713341992269,MATH 197,001,523477,Kedlaya; Kiran S.,9999,0,9999,0
1713341992269,MATH 197,002,563811,Zhang; Danna,9999,0,9999,0
1713341993296,MCWP 40R,A00,518780,Staff,20,0,20,0
1713341993296,MCWP 40R,B00,518781,Staff,19,0,20,1
1713341993296,MCWP 40R,C00,518783,Staff,19,0,20,1
1713341994328,MCWP 50R,A00,518791,Staff,20,0,20,0
1713341994328,MCWP 50R,B00,518792,Staff,17,0,20,3
1713341994328,MCWP 50R,C00,518793,Staff,19,0,20,1
1713341994328,MCWP 50R,D00,518794,Staff,16,0,20,4
1713341994328,MCWP 50R,E00,518795,Staff,16,0,20,4
1713341994328,MCWP 50R,F00,518796,Staff,19,0,20,1
1713341994328,MCWP 50R,G00,518797,Staff,19,0,20,1
1713341995360,MMW 12R,A01,514034,Herbst; Matthew,15,0,16,1
1713341995360,MMW 12R,A02,514035,Herbst; Matthew,16,0,16,0
1713341996391,MMW 13R,A01,514037,Staff,12,0,16,4
1713341996391,MMW 13R,A02,514039,Staff,16,0,16,0
1713341998446,SIO 295LS,A00,523233,Staff,18,0,30,12
1713341999472,SIO 295S,A00,523232,Staff,18,0,30,12
1713342000503,SOCI 117,A01,494376,Staff,1,0,5,4
1713342001535,WES 237B,A00,494380,Staff,19,0,20,1
1713342003617,AESE 279B,A00,494370,Wade; Jon P,33,0,33,0
1713342004650,ANAR 135S,A00,494369,Braswell; Geoffrey E.,0,0,0,0
1713342005676,CAT 124RS,A01,519847,Geibel; William,17,0,20,3
1713342006701,CAT 125RS,A01,515971,Geibel; William,17,0,20,3
1713342007727,CLRE 250,A00,511389,Morris; Sheldon,9996,0,9999,3
1713342008758,CLRE 251,A00,507176,Mehta; Ravindra L.,9996,0,9999,3
1713342008758,CLRE 251,B00,511410,Mehta; Ravindra L.,9998,0,9999,1
1713342009785,CLRE 252,A00,507189,Cuomo; Raphael Eduardo,9998,0,9999,1
1713342010811,CLRE 253,A00,507199,Vaida; Florin,9997,0,9999,2
1713342010811,CLRE 253,B00,507202,Vaida; Florin,9999,0,9999,0
1713342011842,CLRE 259,A00,507211,Patel; Hemal,9996,0,9999,3
1713342012869,CLRE 260,A00,507221,Cuomo; Raphael Eduardo,9999,0,9999,0
1713342013895,CLRE 297,001,507242,Cuomo; Raphael Eduardo,9999,0,9999,0
1713342014928,CSE 191,A00,516875,Minnes Kemp; Mor Mia,9999,0,9999,0
1713342015961,CSS 201S,A01,494383,Staff,35,0,35,0
1713342016987,CSS 202S,A01,494387,Staff,35,0,35,0
1713342018015,EAP 100,A00,516065,Staff,9792,0,9999,207
1713342019040,ECE 45,A01,507414,Staff,51,0,60,9
1713342020064,ECE 100,A01,507416,Baghdadchi; Saharnaz,10,0,20,10
1713342020064,ECE 100,A02,507418,Baghdadchi; Saharnaz,20,0,20,0
1713342021089,ECE 111,A01,507420,Staff,38,0,50,12
1713342022116,ECE 197,001,548057,Sievenpiper; Daniel F.,9998,0,9999,1
1713342023147,EDS 115,A00,507243,Choi; Bailey Miyeon,28,0,28,0
1713342024176,EDS 117,A01,494379,Staff,23,0,25,2
1713342025200,EDS 125,A00,507246,Hopkins; Megan Beth,29,0,30,1
1713342026230,EDS 128A,A01,507264,Fargason; Sharon Gayle,26,0,26,0
1713342027255,EDS 128B,A01,507293,Pappas; Elizabeth,30,0,30,0
1713342028280,EDS 139,A00,507294,Fargason; Sharon Gayle,30,0,30,0
1713342028280,EDS 139,B00,507313,Pappas; Elizabeth,30,0,30,0
1713342029309,EDS 201,A00,507315,Staff,26,0,30,4
1713342030335,EDS 203,A01,507317,Halter; Christopher P.,26,0,30,4
1713342031361,EDS 204R,A01,507319,Halter; Christopher P.,3,0,30,27
1713342031361,EDS 204R,B01,507331,Heinzman; Erica M.,28,0,30,2
1713342032391,EDS 206R,A00,507332,Staff,4,0,30,26
1713342032391,EDS 206R,B00,507343,Staff,28,0,30,2
1713342033416,EDS 250,A00,507344,Hemans; Patricia Ann Benitez,36,0,40,4
1713342034441,EDS 281,A00,507345,Daly; Alan J.,18,0,18,0
1713342035471,EDS 284,A00,507350,Daly; Alan J.,16,0,16,0
1713342036503,EDS 286,A00,507359,Fine; Sarah,18,0,18,0
1713342037530,EDS 289C,A01,507361,Daly; Alan J.,18,0,18,0
1713342038555,EDS 290,A00,507366,Hofstetter; Carolyn,15,0,15,0
1713342039582,LIGM 5A,A00,507421,Fischer-Grunski; Eva K,20,0,20,0
1713342040608,LIGM 5B,A00,507423,Fischer-Grunski; Eva K,20,0,20,0
1713342041634,LIGM 5C,A00,507425,Fischer-Grunski; Eva K,20,0,20,0
1713342042665,LIIT 5AS,A00,507427,Carnelos; Chiara,20,0,20,0
1713342043691,LIIT 5BS,A00,507430,Carnelos; Chiara,20,0,20,0
1713342044717,LIIT 5CS,A00,507432,Carnelos; Chiara,20,0,20,0
1713342045750,LISP 5A,A00,507541,Munoz Sanchez; Alicia,17,0,20,3
1713342046779,LISP 5B,A00,507671,Munoz Sanchez; Alicia,15,0,20,5
1713342047804,LISP 5C,A00,507696,Munoz Sanchez; Alicia,15,0,20,5
1713342048834,MAE 197,001,528363,Boechler; Nicholas Sebastia,9998,0,9999,1
1713342049866,MATH 197,001,523477,Kedlaya; Kiran S.,9999,0,9999,0
1713342049866,MATH 197,002,563811,Zhang; Danna,9999,0,9999,0
1713342050892,MCWP 40R,A00,518780,Staff,20,0,20,0
1713342050892,MCWP 40R,B00,518781,Staff,19,0,20,1
1713342050892,MCWP 40R,C00,518783,Staff,19,0,20,1
1713342051922,MCWP 50R,A00,518791,Staff,20,0,20,0
1713342051922,MCWP 50R,B00,518792,Staff,17,0,20,3
1713342051922,MCWP 50R,C00,518793,Staff,19,0,20,1
1713342051922,MCWP 50R,D00,518794,Staff,16,0,20,4
1713342051922,MCWP 50R,E00,518795,Staff,16,0,20,4
1713342051922,MCWP 50R,F00,518796,Staff,19,0,20,1
1713342051922,MCWP 50R,G00,518797,Staff,19,0,20,1
1713342052948,MMW 12R,A01,514034,Herbst; Matthew,15,0,16,1
1713342052948,MMW 12R,A02,514035,Herbst; Matthew,16,0,16,0
1713342053973,MMW 13R,A01,514037,Staff,12,0,16,4
1713342053973,MMW 13R,A02,514039,Staff,16,0,16,0
1713342056029,SIO 295LS,A00,523233,Staff,18,0,30,12
1713342057056,SIO 295S,A00,523232,Staff,18,0,30,12
1713342058083,SOCI 117,A01,494376,Staff,1,0,5,4
1713342059109,WES 237B,A00,494380,Staff,19,0,20,1
1713342061177,AESE 279B,A00,494370,Wade; Jon P,33,0,33,0
1713342062208,ANAR 135S,A00,494369,Braswell; Geoffrey E.,0,0,0,0
1713342063236,CAT 124RS,A01,519847,Geibel; William,17,0,20,3
1713342064261,CAT 125RS,A01,515971,Geibel; William,17,0,20,3
1713342065289,CLRE 250,A00,511389,Morris; Sheldon,9996,0,9999,3
1713342066317,CLRE 251,A00,507176,Mehta; Ravindra L.,9996,0,9999,3
1713342066317,CLRE 251,B00,511410,Mehta; Ravindra L.,9998,0,9999,1
1713342067344,CLRE 252,A00,507189,Cuomo; Raphael Eduardo,9998,0,9999,1
1713342068376,CLRE 253,A00,507199,Vaida; Florin,9997,0,9999,2
1713342068376,CLRE 253,B00,507202,Vaida; Florin,9999,0,9999,0
1713342069405,CLRE 259,A00,507211,Patel; Hemal,9996,0,9999,3
1713342070429,CLRE 260,A00,507221,Cuomo; Raphael Eduardo,9999,0,9999,0
1713342071460,CLRE 297,001,507242,Cuomo; Raphael Eduardo,9999,0,9999,0
1713342072484,CSE 191,A00,516875,Minnes Kemp; Mor Mia,9999,0,9999,0
1713342073508,CSS 201S,A01,494383,Staff,35,0,35,0
1713342074533,CSS 202S,A01,494387,Staff,35,0,35,0
1713342075561,EAP 100,A00,516065,Staff,9792,0,9999,207
1713342076587,ECE 45,A01,507414,Staff,51,0,60,9
1713342077616,ECE 100,A01,507416,Baghdadchi; Saharnaz,10,0,20,10
1713342077616,ECE 100,A02,507418,Baghdadchi; Saharnaz,20,0,20,0
1713342078646,ECE 111,A01,507420,Staff,38,0,50,12
1713342079671,ECE 197,001,548057,Sievenpiper; Daniel F.,9998,0,9999,1
1713342080702,EDS 115,A00,507243,Choi; Bailey Miyeon,28,0,28,0
1713342081739,EDS 117,A01,494379,Staff,23,0,25,2
1713342082765,EDS 125,A00,507246,Hopkins; Megan Beth,29,0,30,1
1713342083799,EDS 128A,A01,507264,Fargason; Sharon Gayle,26,0,26,0
1713342084826,EDS 128B,A01,507293,Pappas; Elizabeth,30,0,30,0
1713342085857,EDS 139,A00,507294,Fargason; Sharon Gayle,30,0,30,0
1713342085857,EDS 139,B00,507313,Pappas; Elizabeth,30,0,30,0
1713342086887,EDS 201,A00,507315,Staff,26,0,30,4
1713342087913,EDS 203,A01,507317,Halter; Christopher P.,26,0,30,4
1713342088939,EDS 204R,A01,507319,Halter; Christopher P.,3,0,30,27
1713342088939,EDS 204R,B01,507331,Heinzman; Erica M.,28,0,30,2
1713342089965,EDS 206R,A00,507332,Staff,4,0,30,26
1713342089965,EDS 206R,B00,507343,Staff,28,0,30,2
1713342090996,EDS 250,A00,507344,Hemans; Patricia Ann Benitez,36,0,40,4
1713342092021,EDS 281,A00,507345,Daly; Alan J.,18,0,18,0
1713342093051,EDS 284,A00,507350,Daly; Alan J.,16,0,16,0
1713342094130,EDS 286,A00,507359,Fine; Sarah,18,0,18,0
1713342095155,EDS 289C,A01,507361,Daly; Alan J.,18,0,18,0
1713342096183,EDS 290,A00,507366,Hofstetter; Carolyn,15,0,15,0
1713342097216,LIGM 5A,A00,507421,Fischer-Grunski; Eva K,20,0,20,0
1713342098242,LIGM 5B,A00,507423,Fischer-Grunski; Eva K,20,0,20,0
1713342099272,LIGM 5C,A00,507425,Fischer-Grunski; Eva K,20,0,20,0
1713342100304,LIIT 5AS,A00,507427,Carnelos; Chiara,20,0,20,0
1713342101331,LIIT 5BS,A00,507430,Carnelos; Chiara,20,0,20,0
1713342102356,LIIT 5CS,A00,507432,Carnelos; Chiara,20,0,20,0
1713342103382,LISP 5A,A00,507541,Munoz Sanchez; Alicia,17,0,20,3
1713342104409,LISP 5B,A00,507671,Munoz Sanchez; Alicia,15,0,20,5
1713342105435,LISP 5C,A00,507696,Munoz Sanchez; Alicia,15,0,20,5
1713342106460,MAE 197,001,528363,Boechler; Nicholas Sebastia,9998,0,9999,1
1713342107487,MATH 197,001,523477,Kedlaya; Kiran S.,9999,0,9999,0
1713342107487,MATH 197,002,563811,Zhang; Danna,9999,0,9999,0
1713342108516,MCWP 40R,A00,518780,Staff,20,0,20,0
1713342108516,MCWP 40R,B00,518781,Staff,19,0,20,1
1713342108516,MCWP 40R,C00,518783,Staff,19,0,20,1
1713342109544,MCWP 50R,A00,518791,Staff,20,0,20,0
1713342109544,MCWP 50R,B00,518792,Staff,17,0,20,3
1713342109544,MCWP 50R,C00,518793,Staff,19,0,20,1
1713342109544,MCWP 50R,D00,518794,Staff,16,0,20,4
1713342109544,MCWP 50R,E00,518795,Staff,16,0,20,4
1713342109544,MCWP 50R,F00,518796,Staff,19,0,20,1
1713342109544,MCWP 50R,G00,518797,Staff,19,0,20,1
1713342110572,MMW 12R,A01,514034,Herbst; Matthew,15,0,16,1
1713342110572,MMW 12R,A02,514035,Herbst; Matthew,16,0,16,0
1713342111597,MMW 13R,A01,514037,Staff,12,0,16,4
1713342111597,MMW 13R,A02,514039,Staff,16,0,16,0
1713342113651,SIO 295LS,A00,523233,Staff,18,0,30,12
1713342114680,SIO 295S,A00,523232,Staff,18,0,30,12
1713342115710,SOCI 117,A01,494376,Staff,1,0,5,4
1713342116739,WES 237B,A00,494380,Staff,19,0,20,1
1713342118806,AESE 279B,A00,494370,Wade; Jon P,33,0,33,0
1713342119834,ANAR 135S,A00,494369,Braswell; Geoffrey E.,0,0,0,0
1713342120862,CAT 124RS,A01,519847,Geibel; William,17,0,20,3
1713342121892,CAT 125RS,A01,515971,Geibel; William,17,0,20,3
1713342122919,CLRE 250,A00,511389,Morris; Sheldon,9996,0,9999,3
1713342123951,CLRE 251,A00,507176,Mehta; Ravindra L.,9996,0,9999,3
1713342123951,CLRE 251,B00,511410,Mehta; Ravindra L.,9998,0,9999,1
1713342124983,CLRE 252,A00,507189,Cuomo; Raphael Eduardo,9998,0,9999,1
1713342126015,CLRE 253,A00,507199,Vaida; Florin,9997,0,9999,2
1713342126015,CLRE 253,B00,507202,Vaida; Florin,9999,0,9999,0
1713342127044,CLRE 259,A00,507211,Patel; Hemal,9996,0,9999,3
1713342128068,CLRE 260,A00,507221,Cuomo; Raphael Eduardo,9999,0,9999,0
1713342129093,CLRE 297,001,507242,Cuomo; Raphael Eduardo,9999,0,9999,0
1713342130121,CSE 191,A00,516875,Minnes Kemp; Mor Mia,9999,0,9999,0
1713342131148,CSS 201S,A01,494383,Staff,35,0,35,0
1713342132173,CSS 202S,A01,494387,Staff,35,0,35,0
1713342133199,EAP 100,A00,516065,Staff,9792,0,9999,207
1713342134226,ECE 45,A01,507414,Staff,51,0,60,9
1713342135258,ECE 100,A01,507416,Baghdadchi; Saharnaz,10,0,20,10
1713342135258,ECE 100,A02,507418,Baghdadchi; Saharnaz,20,0,20,0
1713342136284,ECE 111,A01,507420,Staff,38,0,50,12
1713342137311,ECE 197,001,548057,Sievenpiper; Daniel F.,9998,0,9999,1
1713342138337,EDS 115,A00,507243,Choi; Bailey Miyeon,28,0,28,0
1713342139364,EDS 117,A01,494379,Staff,23,0,25,2
1713342140395,EDS 125,A00,507246,Hopkins; Megan Beth,29,0,30,1
1713342141422,EDS 128A,A01,507264,Fargason; Sharon Gayle,26,0,26,0
1713342142449,EDS 128B,A01,507293,Pappas; Elizabeth,30,0,30,0
1713342143475,EDS 139,A00,507294,Fargason; Sharon Gayle,30,0,30,0
1713342143475,EDS 139,B00,507313,Pappas; Elizabeth,30,0,30,0
1713342144504,EDS 201,A00,507315,Staff,26,0,30,4
1713342145531,EDS 203,A01,507317,Halter; Christopher P.,26,0,30,4
1713342146563,EDS 204R,A01,507319,Halter; Christopher P.,3,0,30,27
1713342146563,EDS 204R,B01,507331,Heinzman; Erica M.,28,0,30,2
1713342147590,EDS 206R,A00,507332,Staff,4,0,30,26
1713342147590,EDS 206R,B00,507343,Staff,28,0,30,2
1713342148616,EDS 250,A00,507344,Hemans; Patricia Ann Benitez,36,0,40,4
1713342149639,EDS 281,A00,507345,Daly; Alan J.,18,0,18,0
1713342150665,EDS 284,A00,507350,Daly; Alan J.,16,0,16,0
1713342151696,EDS 286,A00,507359,Fine; Sarah,18,0,18,0
1713342152724,EDS 289C,A01,507361,Daly; Alan J.,18,0,18,0
1713342153753,EDS 290,A00,507366,Hofstetter; Carolyn,15,0,15,0
1713342154781,LIGM 5A,A00,507421,Fischer-Grunski; Eva K,20,0,20,0
1713342155811,LIGM 5B,A00,507423,Fischer-Grunski; Eva K,20,0,20,0
1713342156839,LIGM 5C,A00,507425,Fischer-Grunski; Eva K,20,0,20,0
1713342157865,LIIT 5AS,A00,507427,Carnelos; Chiara,20,0,20,0
1713342158896,LIIT 5BS,A00,507430,Carnelos; Chiara,20,0,20,0
1713342159922,LIIT 5CS,A00,507432,Carnelos; Chiara,20,0,20,0
1713342160949,LISP 5A,A00,507541,Munoz Sanchez; Alicia,17,0,20,3
1713342161975,LISP 5B,A00,507671,Munoz Sanchez; Alicia,15,0,20,5
1713342163006,LISP 5C,A00,507696,Munoz Sanchez; Alicia,15,0,20,5
1713342164035,MAE 197,001,528363,Boechler; Nicholas Sebastia,9998,0,9999,1
1713342165062,MATH 197,001,523477,Kedlaya; Kiran S.,9999,0,9999,0
1713342165062,MATH 197,002,563811,Zhang; Danna,9999,0,9999,0
1713342166088,MCWP 40R,A00,518780,Staff,20,0,20,0
1713342166088,MCWP 40R,B00,518781,Staff,19,0,20,1
1713342166088,MCWP 40R,C00,518783,Staff,19,0,20,1
1713342167113,MCWP 50R,A00,518791,Staff,20,0,20,0
1713342167113,MCWP 50R,B00,518792,Staff,17,0,20,3
1713342167113,MCWP 50R,C00,518793,Staff,19,0,20,1
1713342167113,MCWP 50R,D00,518794,Staff,16,0,20,4
1713342167113,MCWP 50R,E00,518795,Staff,16,0,20,4
1713342167113,MCWP 50R,F00,518796,Staff,19,0,20,1
1713342167113,MCWP 50R,G00,518797,Staff,19,0,20,1
1713342168141,MMW 12R,A01,514034,Herbst; Matthew,15,0,16,1
1713342168141,MMW 12R,A02,514035,Herbst; Matthew,16,0,16,0
1713342169169,MMW 13R,A01,514037,Staff,12,0,16,4
1713342169169,MMW 13R,A02,514039,Staff,16,0,16,0
1713342171225,SIO 295LS,A00,523233,Staff,18,0,30,12
1713342172254,SIO 295S,A00,523232,Staff,18,0,30,12
1713342173280,SOCI 117,A01,494376,Staff,1,0,5,4
1713342174311,WES 237B,A00,494380,Staff,19,0,20,1
1713342176380,AESE 279B,A00,494370,Wade; Jon P,33,0,33,0
1713342177409,ANAR 135S,A00,494369,Braswell; Geoffrey E.,0,0,0,0
1713342178443,CAT 124RS,A01,519847,Geibel; William,17,0,20,3
1713342179472,CAT 125RS,A01,515971,Geibel; William,17,0,20,3
1713342180503,CLRE 250,A00,511389,Morris; Sheldon,9996,0,9999,3
1713342181534,CLRE 251,A00,507176,Mehta; Ravindra L.,9996,0,9999,3
1713342181534,CLRE 251,B00,511410,Mehta; Ravindra L.,9998,0,9999,1
1713342182559,CLRE 252,A00,507189,Cuomo; Raphael Eduardo,9998,0,9999,1
1713342183586,CLRE 253,A00,507199,Vaida; Florin,9997,0,9999,2
1713342183586,CLRE 253,B00,507202,Vaida; Florin,9999,0,9999,0
1713342184613,CLRE 259,A00,507211,Patel; Hemal,9996,0,9999,3
1713342185639,CLRE 260,A00,507221,Cuomo; Raphael Eduardo,9999,0,9999,0
1713342186664,CLRE 297,001,507242,Cuomo; Raphael Eduardo,9999,0,9999,0
1713342187693,CSE 191,A00,516875,Minnes Kemp; Mor Mia,9999,0,9999,0
1713342188726,CSS 201S,A01,494383,Staff,35,0,35,0
1713342189752,CSS 202S,A01,494387,Staff,35,0,35,0
1713342190777,EAP 100,A00,516065,Staff,9792,0,9999,207
1713342191811,ECE 45,A01,507414,Staff,51,0,60,9
1713342192836,ECE 100,A01,507416,Baghdadchi; Saharnaz,10,0,20,10
1713342192836,ECE 100,A02,507418,Baghdadchi; Saharnaz,20,0,20,0
1713342193862,ECE 111,A01,507420,Staff,38,0,50,12
1713342194894,ECE 197,001,548057,Sievenpiper; Daniel F.,9998,0,9999,1
1713342195921,EDS 115,A00,507243,Choi; Bailey Miyeon,28,0,28,0
1713342196950,EDS 117,A01,494379,Staff,23,0,25,2
1713342198037,EDS 125,A00,507246,Hopkins; Megan Beth,29,0,30,1
1713342199063,EDS 128A,A01,507264,Fargason; Sharon Gayle,26,0,26,0
1713342200090,EDS 128B,A01,507293,Pappas; Elizabeth,30,0,30,0
1713342201115,EDS 139,A00,507294,Fargason; Sharon Gayle,30,0,30,0
1713342201115,EDS 139,B00,507313,Pappas; Elizabeth,30,0,30,0
1713342202140,EDS 201,A00,507315,Staff,26,0,30,4
1713342203172,EDS 203,A01,507317,Halter; Christopher P.,26,0,30,4
1713342204198,EDS 204R,A01,507319,Halter; Christopher P.,3,0,30,27
1713342204198,EDS 204R,B01,507331,Heinzman; Erica M.,28,0,30,2
1713342205227,EDS 206R,A00,507332,Staff,4,0,30,26
1713342205227,EDS 206R,B00,507343,Staff,28,0,30,2
1713342206253,EDS 250,A00,507344,Hemans; Patricia Ann Benitez,36,0,40,4
1713342207284,EDS 281,A00,507345,Daly; Alan J.,18,0,18,0
1713342208308,EDS 284,A00,507350,Daly; Alan J.,16,0,16,0
1713342209338,EDS 286,A00,507359,Fine; Sarah,18,0,18,0
1713342210364,EDS 289C,A01,507361,Daly; Alan J.,18,0,18,0
1713342211390,EDS 290,A00,507366,Hofstetter; Carolyn,15,0,15,0
1713342212416,LIGM 5A,A00,507421,Fischer-Grunski; Eva K,20,0,20,0
1713342213441,LIGM 5B,A00,507423,Fischer-Grunski; Eva K,20,0,20,0
1713342214474,LIGM 5C,A00,507425,Fischer-Grunski; Eva K,20,0,20,0
1713342215507,LIIT 5AS,A00,507427,Carnelos; Chiara,20,0,20,0
1713342216535,LIIT 5BS,A00,507430,Carnelos; Chiara,20,0,20,0
1713342217565,LIIT 5CS,A00,507432,Carnelos; Chiara,20,0,20,0
1713342218597,LISP 5A,A00,507541,Munoz Sanchez; Alicia,17,0,20,3
1713342219624,LISP 5B,A00,507671,Munoz Sanchez; Alicia,15,0,20,5
1713342220656,LISP 5C,A00,507696,Munoz Sanchez; Alicia,15,0,20,5
1713342221688,MAE 197,001,528363,Boechler; Nicholas Sebastia,9998,0,9999,1
1713342222716,MATH 197,001,523477,Kedlaya; Kiran S.,9999,0,9999,0
1713342222716,MATH 197,002,563811,Zhang; Danna,9999,0,9999,0
1713342223743,MCWP 40R,A00,518780,Staff,20,0,20,0
1713342223743,MCWP 40R,B00,518781,Staff,19,0,20,1
1713342223743,MCWP 40R,C00,518783,Staff,19,0,20,1
1713342224769,MCWP 50R,A00,518791,Staff,20,0,20,0
1713342224769,MCWP 50R,B00,518792,Staff,17,0,20,3
1713342224769,MCWP 50R,C00,518793,Staff,19,0,20,1
1713342224769,MCWP 50R,D00,518794,Staff,16,0,20,4
1713342224769,MCWP 50R,E00,518795,Staff,16,0,20,4
1713342224769,MCWP 50R,F00,518796,Staff,19,0,20,1
1713342224769,MCWP 50R,G00,518797,Staff,19,0,20,1
1713342225866,MMW 12R,A01,514034,Herbst; Matthew,15,0,16,1
1713342225866,MMW 12R,A02,514035,Herbst; Matthew,16,0,16,0
1713342226896,MMW 13R,A01,514037,Staff,12,0,16,4
1713342226896,MMW 13R,A02,514039,Staff,16,0,16,0
1713342228957,SIO 295LS,A00,523233,Staff,18,0,30,12
1713342229985,SIO 295S,A00,523232,Staff,18,0,30,12
1713342231017,SOCI 117,A01,494376,Staff,1,0,5,4
1713342232043,WES 237B,A00,494380,Staff,19,0,20,1
1713342234126,AESE 279B,A00,494370,Wade; Jon P,33,0,33,0
1713342235151,ANAR 135S,A00,494369,Braswell; Geoffrey E.,0,0,0,0
1713342236182,CAT 124RS,A01,519847,Geibel; William,17,0,20,3
1713342237207,CAT 125RS,A01,515971,Geibel; William,17,0,20,3
1713342238235,CLRE 250,A00,511389,Morris; Sheldon,9996,0,9999,3
1713342239261,CLRE 251,A00,507176,Mehta; Ravindra L.,9996,0,9999,3
1713342239261,CLRE 251,B00,511410,Mehta; Ravindra L.,9998,0,9999,1
1713342240290,CLRE 252,A00,507189,Cuomo; Raphael Eduardo,9998,0,9999,1
1713342241320,CLRE 253,A00,507199,Vaida; Florin,9997,0,9999,2
1713342241320,CLRE 253,B00,507202,Vaida; Florin,9999,0,9999,0
1713342242374,CLRE 259,A00,507211,Patel; Hemal,9996,0,9999,3
1713342243403,CLRE 260,A00,507221,Cuomo; Raphael Eduardo,9999,0,9999,0
1713342244432,CLRE 297,001,507242,Cuomo; Raphael Eduardo,9999,0,9999,0
1713342245460,CSE 191,A00,516875,Minnes Kemp; Mor Mia,9999,0,9999,0
1713342246486,CSS 201S,A01,494383,Staff,35,0,35,0
1713342247511,CSS 202S,A01,494387,Staff,35,0,35,0
1713342248540,EAP 100,A00,516065,Staff,9792,0,9999,207
1713342249571,ECE 45,A01,507414,Staff,51,0,60,9
1713342250603,ECE 100,A01,507416,Baghdadchi; Saharnaz,10,0,20,10
1713342250603,ECE 100,A02,507418,Baghdadchi; Saharnaz,20,0,20,0
1713342251633,ECE 111,A01,507420,Staff,38,0,50,12
1713342252663,ECE 197,001,548057,Sievenpiper; Daniel F.,9998,0,9999,1
1713342253691,EDS 115,A00,507243,Choi; Bailey Miyeon,28,0,28,0
1713342254717,EDS 117,A01,494379,Staff,23,0,25,2
1713342255749,EDS 125,A00,507246,Hopkins; Megan Beth,29,0,30,1
1713342256776,EDS 128A,A01,507264,Fargason; Sharon Gayle,26,0,26,0
1713342257801,EDS 128B,A01,507293,Pappas; Elizabeth,30,0,30,0
1713342258826,EDS 139,A00,507294,Fargason; Sharon Gayle,30,0,30,0
1713342258826,EDS 139,B00,507313,Pappas; Elizabeth,30,0,30,0
1713342259856,EDS 201,A00,507315,Staff,26,0,30,4
1713342260889,EDS 203,A01,507317,Halter; Christopher P.,26,0,30,4
1713342261916,EDS 204R,A01,507319,Halter; Christopher P.,3,0,30,27
1713342261916,EDS 204R,B01,507331,Heinzman; Erica M.,28,0,30,2
1713342262946,EDS 206R,A00,507332,Staff,4,0,30,26
1713342262946,EDS 206R,B00,507343,Staff,28,0,30,2
1713342263979,EDS 250,A00,507344,Hemans; Patricia Ann Benitez,36,0,40,4
1713342265006,EDS 281,A00,507345,Daly; Alan J.,18,0,18,0
1713342266031,EDS 284,A00,507350,Daly; Alan J.,16,0,16,0
1713342267057,EDS 286,A00,507359,Fine; Sarah,18,0,18,0
1713342268084,EDS 289C,A01,507361,Daly; Alan J.,18,0,18,0
1713342269111,EDS 290,A00,507366,Hofstetter; Carolyn,15,0,15,0
1713342270145,LIGM 5A,A00,507421,Fischer-Grunski; Eva K,20,0,20,0
1713342271172,LIGM 5B,A00,507423,Fischer-Grunski; Eva K,20,0,20,0
1713342272197,LIGM 5C,A00,507425,Fischer-Grunski; Eva K,20,0,20,0
1713342273228,LIIT 5AS,A00,507427,Carnelos; Chiara,20,0,20,0
1713342274258,LIIT 5BS,A00,507430,Carnelos; Chiara,20,0,20,0
1713342275285,LIIT 5CS,A00,507432,Carnelos; Chiara,20,0,20,0
1713342276316,LISP 5A,A00,507541,Munoz Sanchez; Alicia,17,0,20,3
1713342277342,LISP 5B,A00,507671,Munoz Sanchez; Alicia,15,0,20,5
1713342278367,LISP 5C,A00,507696,Munoz Sanchez; Alicia,15,0,20,5
1713342279397,MAE 197,001,528363,Boechler; Nicholas Sebastia,9998,0,9999,1
1713342280425,MATH 197,001,523477,Kedlaya; Kiran S.,9999,0,9999,0
1713342280425,MATH 197,002,563811,Zhang; Danna,9999,0,9999,0
1713342281452,MCWP 40R,A00,518780,Staff,20,0,20,0
1713342281452,MCWP 40R,B00,518781,Staff,19,0,20,1
1713342281452,MCWP 40R,C00,518783,Staff,19,0,20,1
1713342282482,MCWP 50R,A00,518791,Staff,20,0,20,0
1713342282482,MCWP 50R,B00,518792,Staff,17,0,20,3
1713342282482,MCWP 50R,C00,518793,Staff,19,0,20,1
1713342282482,MCWP 50R,D00,518794,Staff,16,0,20,4
1713342282482,MCWP 50R,E00,518795,Staff,16,0,20,4
1713342282482,MCWP 50R,F00,518796,Staff,19,0,20,1
1713342282482,MCWP 50R,G00,518797,Staff,19,0,20,1
1713342283509,MMW 12R,A01,514034,Herbst; Matthew,15,0,16,1
1713342283509,MMW 12R,A02,514035,Herbst; Matthew,16,0,16,0
1713342284534,MMW 13R,A01,514037,Staff,12,0,16,4
1713342284534,MMW 13R,A02,514039,Staff,16,0,16,0
1713342286589,SIO 295LS,A00,523233,Staff,18,0,30,12
1713342287619,SIO 295S,A00,523232,Staff,18,0,30,12
1713342288649,SOCI 117,A01,494376,Staff,1,0,5,4
1713342289677,WES 237B,A00,494380,Staff,19,0,20,1
1713342291746,AESE 279B,A00,494370,Wade; Jon P,33,0,33,0
1713342292779,ANAR 135S,A00,494369,Braswell; Geoffrey E.,0,0,0,0
1713342293804,CAT 124RS,A01,519847,Geibel; William,17,0,20,3
1713342294834,CAT 125RS,A01,515971,Geibel; William,17,0,20,3
1713342295861,CLRE 250,A00,511389,Morris; Sheldon,9996,0,9999,3
1713342296890,CLRE 251,A00,507176,Mehta; Ravindra L.,9996,0,9999,3
1713342296890,CLRE 251,B00,511410,Mehta; Ravindra L.,9998,0,9999,1
1713342297920,CLRE 252,A00,507189,Cuomo; Raphael Eduardo,9998,0,9999,1
1713342298947,CLRE 253,A00,507199,Vaida; Florin,9997,0,9999,2
1713342298947,CLRE 253,B00,507202,Vaida; Florin,9999,0,9999,0
1713342299972,CLRE 259,A00,507211,Patel; Hemal,9996,0,9999,3
1713342301001,CLRE 260,A00,507221,Cuomo; Raphael Eduardo,9999,0,9999,0
1713342302084,CLRE 297,001,507242,Cuomo; Raphael Eduardo,9999,0,9999,0
1713342303286,CSE 191,A00,516875,Minnes Kemp; Mor Mia,9999,0,9999,0
1713342304318,CSS 201S,A01,494383,Staff,35,0,35,0
1713342305349,CSS 202S,A01,494387,Staff,35,0,35,0
1713342306373,EAP 100,A00,516065,Staff,9792,0,9999,207
1713342307406,ECE 45,A01,507414,Staff,51,0,60,9
1713342308437,ECE 100,A01,507416,Baghdadchi; Saharnaz,10,0,20,10
1713342308437,ECE 100,A02,507418,Baghdadchi; Saharnaz,20,0,20,0
1713342309463,ECE 111,A01,507420,Staff,38,0,50,12
1713342310495,ECE 197,001,548057,Sievenpiper; Daniel F.,9998,0,9999,1
1713342311522,EDS 115,A00,507243,Choi; Bailey Miyeon,28,0,28,0
1713342312552,EDS 117,A01,494379,Staff,23,0,25,2
1713342313583,EDS 125,A00,507246,Hopkins; Megan Beth,29,0,30,1
1713342314611,EDS 128A,A01,507264,Fargason; Sharon Gayle,26,0,26,0
1713342315638,EDS 128B,A01,507293,Pappas; Elizabeth,30,0,30,0
1713342316664,EDS 139,A00,507294,Fargason; Sharon Gayle,30,0,30,0
1713342316664,EDS 139,B00,507313,Pappas; Elizabeth,30,0,30,0
1713342317690,EDS 201,A00,507315,Staff,26,0,30,4
1713342318715,EDS 203,A01,507317,Halter; Christopher P.,26,0,30,4
1713342319741,EDS 204R,A01,507319,Halter; Christopher P.,3,0,30,27
1713342319741,EDS 204R,B01,507331,Heinzman; Erica M.,28,0,30,2
1713342320770,EDS 206R,A00,507332,Staff,4,0,30,26
1713342320770,EDS 206R,B00,507343,Staff,28,0,30,2
1713342321794,EDS 250,A00,507344,Hemans; Patricia Ann Benitez,36,0,40,4
1713342322824,EDS 281,A00,507345,Daly; Alan J.,18,0,18,0
1713342323861,EDS 284,A00,507350,Daly; Alan J.,16,0,16,0
1713342324892,EDS 286,A00,507359,Fine; Sarah,18,0,18,0
1713342325918,EDS 289C,A01,507361,Daly; Alan J.,18,0,18,0
1713342326950,EDS 290,A00,507366,Hofstetter; Carolyn,15,0,15,0
1713342327977,LIGM 5A,A00,507421,Fischer-Grunski; Eva K,20,0,20,0
1713342329007,LIGM 5B,A00,507423,Fischer-Grunski; Eva K,20,0,20,0
1713342330042,LIGM 5C,A00,507425,Fischer-Grunski; Eva K,20,0,20,0
1713342331069,LIIT 5AS,A00,507427,Carnelos; Chiara,20,0,20,0
1713342332095,LIIT 5BS,A00,507430,Carnelos; Chiara,20,0,20,0
1713342333121,LIIT 5CS,A00,507432,Carnelos; Chiara,20,0,20,0
1713342334155,LISP 5A,A00,507541,Munoz Sanchez; Alicia,17,0,20,3
1713342335182,LISP 5B,A00,507671,Munoz Sanchez; Alicia,15,0,20,5
1713342336210,LISP 5C,A00,507696,Munoz Sanchez; Alicia,15,0,20,5
1713342337236,MAE 197,001,528363,Boechler; Nicholas Sebastia,9998,0,9999,1
1713342338267,MATH 197,001,523477,Kedlaya; Kiran S.,9999,0,9999,0
1713342338267,MATH 197,002,563811,Zhang; Danna,9999,0,9999,0
1713342339297,MCWP 40R,A00,518780,Staff,20,0,20,0
1713342339297,MCWP 40R,B00,518781,Staff,19,0,20,1
1713342339297,MCWP 40R,C00,518783,Staff,19,0,20,1
1713342340325,MCWP 50R,A00,518791,Staff,20,0,20,0
1713342340325,MCWP 50R,B00,518792,Staff,17,0,20,3
1713342340325,MCWP 50R,C00,518793,Staff,19,0,20,1
1713342340325,MCWP 50R,D00,518794,Staff,16,0,20,4
1713342340325,MCWP 50R,E00,518795,Staff,16,0,20,4
1713342340325,MCWP 50R,F00,518796,Staff,19,0,20,1
1713342340325,MCWP 50R,G00,518797,Staff,19,0,20,1
1713342341358,MMW 12R,A01,514034,Herbst; Matthew,15,0,16,1
1713342341358,MMW 12R,A02,514035,Herbst; Matthew,16,0,16,0
1713342342391,MMW 13R,A01,514037,Staff,12,0,16,4
1713342342391,MMW 13R,A02,514039,Staff,16,0,16,0
1713342344444,SIO 295LS,A00,523233,Staff,18,0,30,12
1713342345476,SIO 295S,A00,523232,Staff,18,0,30,12
1713342346502,SOCI 117,A01,494376,Staff,1,0,5,4
1713342347529,WES 237B,A00,494380,Staff,19,0,20,1
1713342349618,AESE 279B,A00,494370,Wade; Jon P,33,0,33,0
1713342350644,ANAR 135S,A00,494369,Braswell; Geoffrey E.,0,0,0,0
1713342351670,CAT 124RS,A01,519847,Geibel; William,17,0,20,3
1713342352700,CAT 125RS,A01,515971,Geibel; William,17,0,20,3
1713342353726,CLRE 250,A00,511389,Morris; Sheldon,9996,0,9999,3
1713342354762,CLRE 251,A00,507176,Mehta; Ravindra L.,9996,0,9999,3
1713342354762,CLRE 251,B00,511410,Mehta; Ravindra L.,9998,0,9999,1
1713342355788,CLRE 252,A00,507189,Cuomo; Raphael Eduardo,9998,0,9999,1
1713342356815,CLRE 253,A00,507199,Vaida; Florin,9997,0,9999,2
1713342356815,CLRE 253,B00,507202,Vaida; Florin,9999,0,9999,0
1713342357845,CLRE 259,A00,507211,Patel; Hemal,9996,0,9999,3
1713342358874,CLRE 260,A00,507221,Cuomo; Raphael Eduardo,9999,0,9999,0
1713342359901,CLRE 297,001,507242,Cuomo; Raphael Eduardo,9999,0,9999,0
1713342360928,CSE 191,A00,516875,Minnes Kemp; Mor Mia,9999,0,9999,0
1713342361961,CSS 201S,A01,494383,Staff,35,0,35,0
1713342362986,CSS 202S,A01,494387,Staff,35,0,35,0
1713342364012,EAP 100,A00,516065,Staff,9792,0,9999,207
1713342365037,ECE 45,A01,507414,Staff,51,0,60,9
1713342366064,ECE 100,A01,507416,Baghdadchi; Saharnaz,10,0,20,10
1713342366064,ECE 100,A02,507418,Baghdadchi; Saharnaz,20,0,20,0
1713342367094,ECE 111,A01,507420,Staff,38,0,50,12
1713342368126,ECE 197,001,548057,Sievenpiper; Daniel F.,9998,0,9999,1
1713342369151,EDS 115,A00,507243,Choi; Bailey Miyeon,28,0,28,0
1713342370178,EDS 117,A01,494379,Staff,23,0,25,2
1713342371204,EDS 125,A00,507246,Hopkins; Megan Beth,29,0,30,1
1713342372231,EDS 128A,A01,507264,Fargason; Sharon Gayle,26,0,26,0
1713342373256,EDS 128B,A01,507293,Pappas; Elizabeth,30,0,30,0
1713342374288,EDS 139,A00,507294,Fargason; Sharon Gayle,30,0,30,0
1713342374288,EDS 139,B00,507313,Pappas; Elizabeth,30,0,30,0
1713342375314,EDS 201,A00,507315,Staff,26,0,30,4
1713342376340,EDS 203,A01,507317,Halter; Christopher P.,26,0,30,4
1713342377366,EDS 204R,A01,507319,Halter; Christopher P.,3,0,30,27
1713342377366,EDS 204R,B01,507331,Heinzman; Erica M.,28,0,30,2
1713342378391,EDS 206R,A00,507332,Staff,4,0,30,26
1713342378391,EDS 206R,B00,507343,Staff,28,0,30,2
1713342379417,EDS 250,A00,507344,Hemans; Patricia Ann Benitez,36,0,40,4
1713342380449,EDS 281,A00,507345,Daly; Alan J.,18,0,18,0
1713342381474,EDS 284,A00,507350,Daly; Alan J.,16,0,16,0
1713342382499,EDS 286,A00,507359,Fine; Sarah,18,0,18,0
1713342383528,EDS 289C,A01,507361,Daly; Alan J.,18,0,18,0
1713342384554,EDS 290,A00,507366,Hofstetter; Carolyn,15,0,15,0
1713342385581,LIGM 5A,A00,507421,Fischer-Grunski; Eva K,20,0,20,0
1713342386615,LIGM 5B,A00,507423,Fischer-Grunski; Eva K,20,0,20,0
1713342387640,LIGM 5C,A00,507425,Fischer-Grunski; Eva K,20,0,20,0
1713342388667,LIIT 5AS,A00,507427,Carnelos; Chiara,20,0,20,0
1713342389697,LIIT 5BS,A00,507430,Carnelos; Chiara,20,0,20,0
1713342390727,LIIT 5CS,A00,507432,Carnelos; Chiara,20,0,20,0
1713342391752,LISP 5A,A00,507541,Munoz Sanchez; Alicia,17,0,20,3
1713342392778,LISP 5B,A00,507671,Munoz Sanchez; Alicia,15,0,20,5
1713342393804,LISP 5C,A00,507696,Munoz Sanchez; Alicia,15,0,20,5
1713342394833,MAE 197,001,528363,Boechler; Nicholas Sebastia,9998,0,9999,1
1713342395865,MATH 197,001,523477,Kedlaya; Kiran S.,9999,0,9999,0
1713342395865,MATH 197,002,563811,Zhang; Danna,9999,0,9999,0
1713342396892,MCWP 40R,A00,518780,Staff,20,0,20,0
1713342396892,MCWP 40R,B00,518781,Staff,19,0,20,1
1713342396892,MCWP 40R,C00,518783,Staff,19,0,20,1
1713342397918,MCWP 50R,A00,518791,Staff,20,0,20,0
1713342397918,MCWP 50R,B00,518792,Staff,17,0,20,3
1713342397918,MCWP 50R,C00,518793,Staff,19,0,20,1
1713342397918,MCWP 50R,D00,518794,Staff,16,0,20,4
1713342397918,MCWP 50R,E00,518795,Staff,16,0,20,4
1713342397918,MCWP 50R,F00,518796,Staff,19,0,20,1
1713342397918,MCWP 50R,G00,518797,Staff,19,0,20,1
1713342398947,MMW 12R,A01,514034,Herbst; Matthew,15,0,16,1
1713342398947,MMW 12R,A02,514035,Herbst; Matthew,16,0,16,0
1713342399976,MMW 13R,A01,514037,Staff,12,0,16,4
1713342399976,MMW 13R,A02,514039,Staff,16,0,16,0
1713342402035,SIO 295LS,A00,523233,Staff,18,0,30,12
1713342403063,SIO 295S,A00,523232,Staff,18,0,30,12
1713342404090,SOCI 117,A01,494376,Staff,1,0,5,4
1713342405116,WES 237B,A00,494380,Staff,19,0,20,1
1713342407242,AESE 279B,A00,494370,Wade; Jon P,33,0,33,0
1713342408270,ANAR 135S,A00,494369,Braswell; Geoffrey E.,0,0,0,0
1713342409300,CAT 124RS,A01,519847,Geibel; William,17,0,20,3
1713342410327,CAT 125RS,A01,515971,Geibel; William,17,0,20,3
1713342411358,CLRE 250,A00,511389,Morris; Sheldon,9996,0,9999,3
1713342412386,CLRE 251,A00,507176,Mehta; Ravindra L.,9996,0,9999,3
1713342412386,CLRE 251,B00,511410,Mehta; Ravindra L.,9998,0,9999,1
1713342413412,CLRE 252,A00,507189,Cuomo; Raphael Eduardo,9998,0,9999,1
1713342414443,CLRE 253,A00,507199,Vaida; Florin,9997,0,9999,2
1713342414443,CLRE 253,B00,507202,Vaida; Florin,9999,0,9999,0
1713342415469,CLRE 259,A00,507211,Patel; Hemal,9996,0,9999,3
1713342416499,CLRE 260,A00,507221,Cuomo; Raphael Eduardo,9999,0,9999,0
1713342417528,CLRE 297,001,507242,Cuomo; Raphael Eduardo,9999,0,9999,0
1713342418558,CSE 191,A00,516875,Minnes Kemp; Mor Mia,9999,0,9999,0
1713342419584,CSS 201S,A01,494383,Staff,35,0,35,0
1713342420610,CSS 202S,A01,494387,Staff,35,0,35,0
1713342421636,EAP 100,A00,516065,Staff,9792,0,9999,207
1713342422664,ECE 45,A01,507414,Staff,51,0,60,9
1713342423690,ECE 100,A01,507416,Baghdadchi; Saharnaz,10,0,20,10
1713342423690,ECE 100,A02,507418,Baghdadchi; Saharnaz,20,0,20,0
1713342424721,ECE 111,A01,507420,Staff,38,0,50,12
1713342425751,ECE 197,001,548057,Sievenpiper; Daniel F.,9998,0,9999,1
1713342426784,EDS 115,A00,507243,Choi; Bailey Miyeon,28,0,28,0
1713342427813,EDS 117,A01,494379,Staff,23,0,25,2
1713342428844,EDS 125,A00,507246,Hopkins; Megan Beth,29,0,30,1
1713342429871,EDS 128A,A01,507264,Fargason; Sharon Gayle,26,0,26,0
1713342430902,EDS 128B,A01,507293,Pappas; Elizabeth,30,0,30,0
1713342431931,EDS 139,A00,507294,Fargason; Sharon Gayle,30,0,30,0
1713342431931,EDS 139,B00,507313,Pappas; Elizabeth,30,0,30,0
1713342432962,EDS 201,A00,507315,Staff,26,0,30,4
1713342433987,EDS 203,A01,507317,Halter; Christopher P.,26,0,30,4
1713342435020,EDS 204R,A01,507319,Halter; Christopher P.,3,0,30,27
1713342435020,EDS 204R,B01,507331,Heinzman; Erica M.,28,0,30,2
1713342436046,EDS 206R,A00,507332,Staff,4,0,30,26
1713342436046,EDS 206R,B00,507343,Staff,28,0,30,2
1713342437071,EDS 250,A00,507344,Hemans; Patricia Ann Benitez,36,0,40,4
1713342438097,EDS 281,A00,507345,Daly; Alan J.,18,0,18,0
1713342439122,EDS 284,A00,507350,Daly; Alan J.,16,0,16,0
1713342440148,EDS 286,A00,507359,Fine; Sarah,18,0,18,0
1713342441174,EDS 289C,A01,507361,Daly; Alan J.,18,0,18,0
1713342442203,EDS 290,A00,507366,Hofstetter; Carolyn,15,0,15,0
1713342443236,LIGM 5A,A00,507421,Fischer-Grunski; Eva K,20,0,20,0
1713342444264,LIGM 5B,A00,507423,Fischer-Grunski; Eva K,20,0,20,0
1713342445297,LIGM 5C,A00,507425,Fischer-Grunski; Eva K,20,0,20,0
1713342446322,LIIT 5AS,A00,507427,Carnelos; Chiara,20,0,20,0
1713342447347,LIIT 5BS,A00,507430,Carnelos; Chiara,20,0,20,0
1713342448376,LIIT 5CS,A00,507432,Carnelos; Chiara,20,0,20,0
1713342449402,LISP 5A,A00,507541,Munoz Sanchez; Alicia,17,0,20,3
1713342450426,LISP 5B,A00,507671,Munoz Sanchez; Alicia,15,0,20,5
1713342451451,LISP 5C,A00,507696,Munoz Sanchez; Alicia,15,0,20,5
1713342452478,MAE 197,001,528363,Boechler; Nicholas Sebastia,9998,0,9999,1
1713342453509,MATH 197,001,523477,Kedlaya; Kiran S.,9999,0,9999,0
1713342453509,MATH 197,002,563811,Zhang; Danna,9999,0,9999,0
1713342454537,MCWP 40R,A00,518780,Staff,20,0,20,0
1713342454537,MCWP 40R,B00,518781,Staff,19,0,20,1
1713342454537,MCWP 40R,C00,518783,Staff,19,0,20,1
1713342455570,MCWP 50R,A00,518791,Staff,20,0,20,0
1713342455570,MCWP 50R,B00,518792,Staff,17,0,20,3
1713342455570,MCWP 50R,C00,518793,Staff,19,0,20,1
1713342455570,MCWP 50R,D00,518794,Staff,16,0,20,4
1713342455570,MCWP 50R,E00,518795,Staff,16,0,20,4
1713342455570,MCWP 50R,F00,518796,Staff,19,0,20,1
1713342455570,MCWP 50R,G00,518797,Staff,19,0,20,1
1713342456595,MMW 12R,A01,514034,Herbst; Matthew,15,0,16,1
1713342456595,MMW 12R,A02,514035,Herbst; Matthew,16,0,16,0
1713342457621,MMW 13R,A01,514037,Staff,12,0,16,4
1713342457621,MMW 13R,A02,514039,Staff,16,0,16,0
1713342459677,SIO 295LS,A00,523233,Staff,18,0,30,12
1713342460701,SIO 295S,A00,523232,Staff,18,0,30,12
1713342461730,SOCI 117,A01,494376,Staff,1,0,5,4
1713342462760,WES 237B,A00,494380,Staff,19,0,20,1
1713342464832,AESE 279B,A00,494370,Wade; Jon P,33,0,33,0
1713342465857,ANAR 135S,A00,494369,Braswell; Geoffrey E.,0,0,0,0
1713342466887,CAT 124RS,A01,519847,Geibel; William,17,0,20,3
1713342467912,CAT 125RS,A01,515971,Geibel; William,17,0,20,3
1713342468939,CLRE 250,A00,511389,Morris; Sheldon,9996,0,9999,3
1713342469966,CLRE 251,A00,507176,Mehta; Ravindra L.,9996,0,9999,3
1713342469966,CLRE 251,B00,511410,Mehta; Ravindra L.,9998,0,9999,1
1713342470992,CLRE 252,A00,507189,Cuomo; Raphael Eduardo,9998,0,9999,1
1713342472019,CLRE 253,A00,507199,Vaida; Florin,9997,0,9999,2
1713342472019,CLRE 253,B00,507202,Vaida; Florin,9999,0,9999,0
1713342473046,CLRE 259,A00,507211,Patel; Hemal,9996,0,9999,3
1713342474071,CLRE 260,A00,507221,Cuomo; Raphael Eduardo,9999,0,9999,0
1713342475100,CLRE 297,001,507242,Cuomo; Raphael Eduardo,9999,0,9999,0
1713342476129,CSE 191,A00,516875,Minnes Kemp; Mor Mia,9999,0,9999,0
1713342477156,CSS 201S,A01,494383,Staff,35,0,35,0
1713342478180,CSS 202S,A01,494387,Staff,35,0,35,0
1713342479205,EAP 100,A00,516065,Staff,9792,0,9999,207
1713342480234,ECE 45,A01,507414,Staff,51,0,60,9
1713342481258,ECE 100,A01,507416,Baghdadchi; Saharnaz,10,0,20,10
1713342481258,ECE 100,A02,507418,Baghdadchi; Saharnaz,20,0,20,0
1713342482283,ECE 111,A01,507420,Staff,38,0,50,12
1713342483308,ECE 197,001,548057,Sievenpiper; Daniel F.,9998,0,9999,1
1713342484340,EDS 115,A00,507243,Choi; Bailey Miyeon,28,0,28,0
1713342485364,EDS 117,A01,494379,Staff,23,0,25,2
1713342486390,EDS 125,A00,507246,Hopkins; Megan Beth,29,0,30,1
1713342487420,EDS 128A,A01,507264,Fargason; Sharon Gayle,26,0,26,0
1713342488446,EDS 128B,A01,507293,Pappas; Elizabeth,30,0,30,0
1713342489470,EDS 139,A00,507294,Fargason; Sharon Gayle,30,0,30,0
1713342489470,EDS 139,B00,507313,Pappas; Elizabeth,30,0,30,0
1713342490494,EDS 201,A00,507315,Staff,26,0,30,4
1713342491520,EDS 203,A01,507317,Halter; Christopher P.,26,0,30,4
1713342492548,EDS 204R,A01,507319,Halter; Christopher P.,3,0,30,27
1713342492548,EDS 204R,B01,507331,Heinzman; Erica M.,28,0,30,2
1713342493577,EDS 206R,A00,507332,Staff,4,0,30,26
1713342493577,EDS 206R,B00,507343,Staff,28,0,30,2
1713342494602,EDS 250,A00,507344,Hemans; Patricia Ann Benitez,36,0,40,4
1713342495632,EDS 281,A00,507345,Daly; Alan J.,18,0,18,0
1713342496657,EDS 284,A00,507350,Daly; Alan J.,16,0,16,0
1713342497683,EDS 286,A00,507359,Fine; Sarah,18,0,18,0
1713342498707,EDS 289C,A01,507361,Daly; Alan J.,18,0,18,0
1713342499736,EDS 290,A00,507366,Hofstetter; Carolyn,15,0,15,0
1713342500768,LIGM 5A,A00,507421,Fischer-Grunski; Eva K,20,0,20,0
1713342501796,LIGM 5B,A00,507423,Fischer-Grunski; Eva K,20,0,20,0
1713342502822,LIGM 5C,A00,507425,Fischer-Grunski; Eva K,20,0,20,0
1713342503849,LIIT 5AS,A00,507427,Carnelos; Chiara,20,0,20,0
1713342504877,LIIT 5BS,A00,507430,Carnelos; Chiara,20,0,20,0
1713342505906,LIIT 5CS,A00,507432,Carnelos; Chiara,20,0,20,0
1713342506933,LISP 5A,A00,507541,Munoz Sanchez; Alicia,17,0,20,3
1713342507963,LISP 5B,A00,507671,Munoz Sanchez; Alicia,15,0,20,5
1713342508991,LISP 5C,A00,507696,Munoz Sanchez; Alicia,15,0,20,5
1713342510075,MAE 197,001,528363,Boechler; Nicholas Sebastia,9998,0,9999,1
1713342511109,MATH 197,001,523477,Kedlaya; Kiran S.,9999,0,9999,0
1713342511109,MATH 197,002,563811,Zhang; Danna,9999,0,9999,0
1713342512135,MCWP 40R,A00,518780,Staff,20,0,20,0
1713342512135,MCWP 40R,B00,518781,Staff,19,0,20,1
1713342512135,MCWP 40R,C00,518783,Staff,19,0,20,1
1713342513167,MCWP 50R,A00,518791,Staff,20,0,20,0
1713342513167,MCWP 50R,B00,518792,Staff,17,0,20,3
1713342513167,MCWP 50R,C00,518793,Staff,19,0,20,1
1713342513167,MCWP 50R,D00,518794,Staff,16,0,20,4
1713342513167,MCWP 50R,E00,518795,Staff,16,0,20,4
1713342513167,MCWP 50R,F00,518796,Staff,19,0,20,1
1713342513167,MCWP 50R,G00,518797,Staff,19,0,20,1
1713342514194,MMW 12R,A01,514034,Herbst; Matthew,15,0,16,1
1713342514194,MMW 12R,A02,514035,Herbst; Matthew,16,0,16,0
1713342515220,MMW 13R,A01,514037,Staff,12,0,16,4
1713342515220,MMW 13R,A02,514039,Staff,16,0,16,0
1713342517280,SIO 295LS,A00,523233,Staff,18,0,30,12
1713342518305,SIO 295S,A00,523232,Staff,18,0,30,12
1713342519333,SOCI 117,A01,494376,Staff,1,0,5,4
1713342520359,WES 237B,A00,494380,Staff,19,0,20,1
1713342522441,AESE 279B,A00,494370,Wade; Jon P,33,0,33,0
1713342523470,ANAR 135S,A00,494369,Braswell; Geoffrey E.,0,0,0,0
1713342524500,CAT 124RS,A01,519847,Geibel; William,17,0,20,3
1713342525527,CAT 125RS,A01,515971,Geibel; William,17,0,20,3
1713342526554,CLRE 250,A00,511389,Morris; Sheldon,9996,0,9999,3
1713342527582,CLRE 251,A00,507176,Mehta; Ravindra L.,9996,0,9999,3
1713342527582,CLRE 251,B00,511410,Mehta; Ravindra L.,9998,0,9999,1
1713342528614,CLRE 252,A00,507189,Cuomo; Raphael Eduardo,9998,0,9999,1
1713342529645,CLRE 253,A00,507199,Vaida; Florin,9997,0,9999,2
1713342529645,CLRE 253,B00,507202,Vaida; Florin,9999,0,9999,0
1713342530674,CLRE 259,A00,507211,Patel; Hemal,9996,0,9999,3
1713342531700,CLRE 260,A00,507221,Cuomo; Raphael Eduardo,9999,0,9999,0
1713342532728,CLRE 297,001,507242,Cuomo; Raphael Eduardo,9999,0,9999,0
1713342533754,CSE 191,A00,516875,Minnes Kemp; Mor Mia,9999,0,9999,0
1713342534784,CSS 201S,A01,494383,Staff,35,0,35,0
1713342535813,CSS 202S,A01,494387,Staff,35,0,35,0
1713342536839,EAP 100,A00,516065,Staff,9792,0,9999,207
1713342537868,ECE 45,A01,507414,Staff,51,0,60,9
1713342538897,ECE 100,A01,507416,Baghdadchi; Saharnaz,10,0,20,10
1713342538897,ECE 100,A02,507418,Baghdadchi; Saharnaz,20,0,20,0
1713342539924,ECE 111,A01,507420,Staff,38,0,50,12
1713342540951,ECE 197,001,548057,Sievenpiper; Daniel F.,9998,0,9999,1
1713342541977,EDS 115,A00,507243,Choi; Bailey Miyeon,28,0,28,0
1713342543011,EDS 117,A01,494379,Staff,23,0,25,2
1713342544035,EDS 125,A00,507246,Hopkins; Megan Beth,29,0,30,1
1713342545068,EDS 128A,A01,507264,Fargason; Sharon Gayle,26,0,26,0
1713342546098,EDS 128B,A01,507293,Pappas; Elizabeth,30,0,30,0
1713342547126,EDS 139,A00,507294,Fargason; Sharon Gayle,30,0,30,0
1713342547126,EDS 139,B00,507313,Pappas; Elizabeth,30,0,30,0
1713342548152,EDS 201,A00,507315,Staff,26,0,30,4
1713342549178,EDS 203,A01,507317,Halter; Christopher P.,26,0,30,4
1713342550208,EDS 204R,A01,507319,Halter; Christopher P.,3,0,30,27
1713342550208,EDS 204R,B01,507331,Heinzman; Erica M.,28,0,30,2
1713342551237,EDS 206R,A00,507332,Staff,4,0,30,26
1713342551237,EDS 206R,B00,507343,Staff,28,0,30,2
1713342552263,EDS 250,A00,507344,Hemans; Patricia Ann Benitez,36,0,40,4
1713342553288,EDS 281,A00,507345,Daly; Alan J.,18,0,18,0
1713342554313,EDS 284,A00,507350,Daly; Alan J.,16,0,16,0
1713342555343,EDS 286,A00,507359,Fine; Sarah,18,0,18,0
1713342556369,EDS 289C,A01,507361,Daly; Alan J.,18,0,18,0
1713342557399,EDS 290,A00,507366,Hofstetter; Carolyn,15,0,15,0
1713342558425,LIGM 5A,A00,507421,Fischer-Grunski; Eva K,20,0,20,0
1713342559451,LIGM 5B,A00,507423,Fischer-Grunski; Eva K,20,0,20,0
1713342560479,LIGM 5C,A00,507425,Fischer-Grunski; Eva K,20,0,20,0
1713342561509,LIIT 5AS,A00,507427,Carnelos; Chiara,20,0,20,0
1713342562535,LIIT 5BS,A00,507430,Carnelos; Chiara,20,0,20,0
1713342563561,LIIT 5CS,A00,507432,Carnelos; Chiara,20,0,20,0
1713342564595,LISP 5A,A00,507541,Munoz Sanchez; Alicia,17,0,20,3
1713342565626,LISP 5B,A00,507671,Munoz Sanchez; Alicia,15,0,20,5
1713342566657,LISP 5C,A00,507696,Munoz Sanchez; Alicia,15,0,20,5
1713342567686,MAE 197,001,528363,Boechler; Nicholas Sebastia,9998,0,9999,1
1713342568713,MATH 197,001,523477,Kedlaya; Kiran S.,9999,0,9999,0
1713342568713,MATH 197,002,563811,Zhang; Danna,9999,0,9999,0
1713342569740,MCWP 40R,A00,518780,Staff,20,0,20,0
1713342569740,MCWP 40R,B00,518781,Staff,19,0,20,1
1713342569740,MCWP 40R,C00,518783,Staff,19,0,20,1
1713342570768,MCWP 50R,A00,518791,Staff,20,0,20,0
1713342570768,MCWP 50R,B00,518792,Staff,17,0,20,3
1713342570768,MCWP 50R,C00,518793,Staff,19,0,20,1
1713342570768,MCWP 50R,D00,518794,Staff,16,0,20,4
1713342570768,MCWP 50R,E00,518795,Staff,16,0,20,4
1713342570768,MCWP 50R,F00,518796,Staff,19,0,20,1
1713342570768,MCWP 50R,G00,518797,Staff,19,0,20,1
1713342571802,MMW 12R,A01,514034,Herbst; Matthew,15,0,16,1
1713342571802,MMW 12R,A02,514035,Herbst; Matthew,16,0,16,0
1713342572825,MMW 13R,A01,514037,Staff,12,0,16,4
1713342572825,MMW 13R,A02,514039,Staff,16,0,16,0
1713342574890,SIO 295LS,A00,523233,Staff,18,0,30,12
1713342575916,SIO 295S,A00,523232,Staff,18,0,30,12
1713342576945,SOCI 117,A01,494376,Staff,1,0,5,4
1713342577972,WES 237B,A00,494380,Staff,19,0,20,1
1713342580051,AESE 279B,A00,494370,Wade; Jon P,33,0,33,0
1713342581081,ANAR 135S,A00,494369,Braswell; Geoffrey E.,0,0,0,0
1713342582106,CAT 124RS,A01,519847,Geibel; William,17,0,20,3
1713342583134,CAT 125RS,A01,515971,Geibel; William,17,0,20,3
1713342584159,CLRE 250,A00,511389,Morris; Sheldon,9996,0,9999,3
1713342585186,CLRE 251,A00,507176,Mehta; Ravindra L.,9996,0,9999,3
1713342585186,CLRE 251,B00,511410,Mehta; Ravindra L.,9998,0,9999,1
1713342586214,CLRE 252,A00,507189,Cuomo; Raphael Eduardo,9998,0,9999,1
1713342587243,CLRE 253,A00,507199,Vaida; Florin,9997,0,9999,2
1713342587243,CLRE 253,B00,507202,Vaida; Florin,9999,0,9999,0
1713342588266,CLRE 259,A00,507211,Patel; Hemal,9996,0,9999,3
1713342589292,CLRE 260,A00,507221,Cuomo; Raphael Eduardo,9999,0,9999,0
1713342590317,CLRE 297,001,507242,Cuomo; Raphael Eduardo,9999,0,9999,0
1713342591348,CSE 191,A00,516875,Minnes Kemp; Mor Mia,9999,0,9999,0
1713342592375,CSS 201S,A01,494383,Staff,35,0,35,0
1713342593405,CSS 202S,A01,494387,Staff,35,0,35,0
1713342594435,EAP 100,A00,516065,Staff,9792,0,9999,207
1713342595460,ECE 45,A01,507414,Staff,51,0,60,9
1713342596487,ECE 100,A01,507416,Baghdadchi; Saharnaz,10,0,20,10
1713342596487,ECE 100,A02,507418,Baghdadchi; Saharnaz,20,0,20,0
1713342597516,ECE 111,A01,507420,Staff,38,0,50,12
1713342598547,ECE 197,001,548057,Sievenpiper; Daniel F.,9998,0,9999,1
1713342599573,EDS 115,A00,507243,Choi; Bailey Miyeon,28,0,28,0
1713342600604,EDS 117,A01,494379,Staff,23,0,25,2
1713342601638,EDS 125,A00,507246,Hopkins; Megan Beth,29,0,30,1
1713342602674,EDS 128A,A01,507264,Fargason; Sharon Gayle,26,0,26,0
1713342603706,EDS 128B,A01,507293,Pappas; Elizabeth,30,0,30,0
1713342604736,EDS 139,A00,507294,Fargason; Sharon Gayle,30,0,30,0
1713342604736,EDS 139,B00,507313,Pappas; Elizabeth,30,0,30,0
1713342605761,EDS 201,A00,507315,Staff,26,0,30,4
1713342606789,EDS 203,A01,507317,Halter; Christopher P.,26,0,30,4
1713342607814,EDS 204R,A01,507319,Halter; Christopher P.,3,0,30,27
1713342607814,EDS 204R,B01,507331,Heinzman; Erica M.,28,0,30,2
1713342608907,EDS 206R,A00,507332,Staff,4,0,30,26
1713342608907,EDS 206R,B00,507343,Staff,28,0,30,2
1713342609934,EDS 250,A00,507344,Hemans; Patricia Ann Benitez,36,0,40,4
1713342610961,EDS 281,A00,507345,Daly; Alan J.,18,0,18,0
1713342611988,EDS 284,A00,507350,Daly; Alan J.,16,0,16,0
1713342613015,EDS 286,A00,507359,Fine; Sarah,18,0,18,0
1713342614096,EDS 289C,A01,507361,Daly; Alan J.,18,0,18,0
1713342615123,EDS 290,A00,507366,Hofstetter; Carolyn,15,0,15,0
1713342616152,LIGM 5A,A00,507421,Fischer-Grunski; Eva K,20,0,20,0
1713342617180,LIGM 5B,A00,507423,Fischer-Grunski; Eva K,20,0,20,0
1713342618207,LIGM 5C,A00,507425,Fischer-Grunski; Eva K,20,0,20,0
1713342619232,LIIT 5AS,A00,507427,Carnelos; Chiara,20,0,20,0
1713342620261,LIIT 5BS,A00,507430,Carnelos; Chiara,20,0,20,0
1713342621292,LIIT 5CS,A00,507432,Carnelos; Chiara,20,0,20,0
1713342622318,LISP 5A,A00,507541,Munoz Sanchez; Alicia,17,0,20,3
1713342623345,LISP 5B,A00,507671,Munoz Sanchez; Alicia,15,0,20,5
1713342624377,LISP 5C,A00,507696,Munoz Sanchez; Alicia,15,0,20,5
1713342625407,MAE 197,001,528363,Boechler; Nicholas Sebastia,9998,0,9999,1
1713342626436,MATH 197,001,523477,Kedlaya; Kiran S.,9999,0,9999,0
1713342626436,MATH 197,002,563811,Zhang; Danna,9999,0,9999,0
1713342627462,MCWP 40R,A00,518780,Staff,20,0,20,0
1713342627462,MCWP 40R,B00,518781,Staff,19,0,20,1
1713342627462,MCWP 40R,C00,518783,Staff,19,0,20,1
1713342628496,MCWP 50R,A00,518791,Staff,20,0,20,0
1713342628496,MCWP 50R,B00,518792,Staff,17,0,20,3
1713342628496,MCWP 50R,C00,518793,Staff,19,0,20,1
1713342628496,MCWP 50R,D00,518794,Staff,16,0,20,4
1713342628496,MCWP 50R,E00,518795,Staff,16,0,20,4
1713342628496,MCWP 50R,F00,518796,Staff,19,0,20,1
1713342628496,MCWP 50R,G00,518797,Staff,19,0,20,1
1713342629526,MMW 12R,A01,514034,Herbst; Matthew,15,0,16,1
1713342629526,MMW 12R,A02,514035,Herbst; Matthew,16,0,16,0
1713342630551,MMW 13R,A01,514037,Staff,12,0,16,4
1713342630551,MMW 13R,A02,514039,Staff,16,0,16,0
1713342632602,SIO 295LS,A00,523233,Staff,18,0,30,12
1713342633628,SIO 295S,A00,523232,Staff,18,0,30,12
1713342634657,SOCI 117,A01,494376,Staff,1,0,5,4
1713342635687,WES 237B,A00,494380,Staff,19,0,20,1
1713342637760,AESE 279B,A00,494370,Wade; Jon P,33,0,33,0
1713342638786,ANAR 135S,A00,494369,Braswell; Geoffrey E.,0,0,0,0
1713342639811,CAT 124RS,A01,519847,Geibel; William,17,0,20,3
1713342640837,CAT 125RS,A01,515971,Geibel; William,17,0,20,3
1713342641869,CLRE 250,A00,511389,Morris; Sheldon,9996,0,9999,3
1713342642897,CLRE 251,A00,507176,Mehta; Ravindra L.,9996,0,9999,3
1713342642897,CLRE 251,B00,511410,Mehta; Ravindra L.,9998,0,9999,1
1713342643930,CLRE 252,A00,507189,Cuomo; Raphael Eduardo,9998,0,9999,1
1713342644955,CLRE 253,A00,507199,Vaida; Florin,9997,0,9999,2
1713342644955,CLRE 253,B00,507202,Vaida; Florin,9999,0,9999,0
1713342645981,CLRE 259,A00,507211,Patel; Hemal,9996,0,9999,3
1713342647007,CLRE 260,A00,507221,Cuomo; Raphael Eduardo,9999,0,9999,0
1713342648037,CLRE 297,001,507242,Cuomo; Raphael Eduardo,9999,0,9999,0
1713342649061,CSE 191,A00,516875,Minnes Kemp; Mor Mia,9999,0,9999,0
1713342650087,CSS 201S,A01,494383,Staff,35,0,35,0
1713342651115,CSS 202S,A01,494387,Staff,35,0,35,0
1713342652142,EAP 100,A00,516065,Staff,9792,0,9999,207
1713342653172,ECE 45,A01,507414,Staff,51,0,60,9
1713342654197,ECE 100,A01,507416,Baghdadchi; Saharnaz,10,0,20,10
1713342654197,ECE 100,A02,507418,Baghdadchi; Saharnaz,20,0,20,0
1713342655228,ECE 111,A01,507420,Staff,38,0,50,12
1713342656254,ECE 197,001,548057,Sievenpiper; Daniel F.,9998,0,9999,1
1713342657281,EDS 115,A00,507243,Choi; Bailey Miyeon,28,0,28,0
1713342658308,EDS 117,A01,494379,Staff,23,0,25,2
1713342659337,EDS 125,A00,507246,Hopkins; Megan Beth,29,0,30,1
1713342660363,EDS 128A,A01,507264,Fargason; Sharon Gayle,26,0,26,0
1713342661390,EDS 128B,A01,507293,Pappas; Elizabeth,30,0,30,0
1713342662415,EDS 139,A00,507294,Fargason; Sharon Gayle,30,0,30,0
1713342662415,EDS 139,B00,507313,Pappas; Elizabeth,30,0,30,0
1713342663444,EDS 201,A00,507315,Staff,26,0,30,4
1713342664471,EDS 203,A01,507317,Halter; Christopher P.,26,0,30,4
1713342665511,EDS 204R,A01,507319,Halter; Christopher P.,3,0,30,27
1713342665511,EDS 204R,B01,507331,Heinzman; Erica M.,28,0,30,2
1713342666536,EDS 206R,A00,507332,Staff,4,0,30,26
1713342666536,EDS 206R,B00,507343,Staff,28,0,30,2
1713342667563,EDS 250,A00,507344,Hemans; Patricia Ann Benitez,36,0,40,4
1713342668594,EDS 281,A00,507345,Daly; Alan J.,18,0,18,0
1713342669620,EDS 284,A00,507350,Daly; Alan J.,16,0,16,0
1713342670646,EDS 286,A00,507359,Fine; Sarah,18,0,18,0
1713342671672,EDS 289C,A01,507361,Daly; Alan J.,18,0,18,0
1713342672703,EDS 290,A00,507366,Hofstetter; Carolyn,15,0,15,0
1713342673730,LIGM 5A,A00,507421,Fischer-Grunski; Eva K,20,0,20,0
1713342674765,LIGM 5B,A00,507423,Fischer-Grunski; Eva K,20,0,20,0
1713342675798,LIGM 5C,A00,507425,Fischer-Grunski; Eva K,20,0,20,0
1713342676825,LIIT 5AS,A00,507427,Carnelos; Chiara,20,0,20,0
1713342677856,LIIT 5BS,A00,507430,Carnelos; Chiara,20,0,20,0
1713342678884,LIIT 5CS,A00,507432,Carnelos; Chiara,20,0,20,0
1713342679909,LISP 5A,A00,507541,Munoz Sanchez; Alicia,17,0,20,3
1713342680934,LISP 5B,A00,507671,Munoz Sanchez; Alicia,15,0,20,5
1713342681960,LISP 5C,A00,507696,Munoz Sanchez; Alicia,15,0,20,5
1713342682987,MAE 197,001,528363,Boechler; Nicholas Sebastia,9998,0,9999,1
1713342684016,MATH 197,001,523477,Kedlaya; Kiran S.,9999,0,9999,0
1713342684016,MATH 197,002,563811,Zhang; Danna,9999,0,9999,0
1713342685043,MCWP 40R,A00,518780,Staff,20,0,20,0
1713342685043,MCWP 40R,B00,518781,Staff,19,0,20,1
1713342685043,MCWP 40R,C00,518783,Staff,19,0,20,1
1713342686072,MCWP 50R,A00,518791,Staff,20,0,20,0
1713342686072,MCWP 50R,B00,518792,Staff,17,0,20,3
1713342686072,MCWP 50R,C00,518793,Staff,19,0,20,1
1713342686072,MCWP 50R,D00,518794,Staff,16,0,20,4
1713342686072,MCWP 50R,E00,518795,Staff,16,0,20,4
1713342686072,MCWP 50R,F00,518796,Staff,19,0,20,1
1713342686072,MCWP 50R,G00,518797,Staff,19,0,20,1
1713342687099,MMW 12R,A01,514034,Herbst; Matthew,15,0,16,1
1713342687099,MMW 12R,A02,514035,Herbst; Matthew,16,0,16,0
1713342688125,MMW 13R,A01,514037,Staff,12,0,16,4
1713342688125,MMW 13R,A02,514039,Staff,16,0,16,0
1713342690175,SIO 295LS,A00,523233,Staff,18,0,30,12
1713342691200,SIO 295S,A00,523232,Staff,18,0,30,12
1713342692226,SOCI 117,A01,494376,Staff,1,0,5,4
1713342693253,WES 237B,A00,494380,Staff,19,0,20,1
1713342695319,AESE 279B,A00,494370,Wade; Jon P,33,0,33,0
1713342696344,ANAR 135S,A00,494369,Braswell; Geoffrey E.,0,0,0,0
1713342697371,CAT 124RS,A01,519847,Geibel; William,17,0,20,3
1713342698397,CAT 125RS,A01,515971,Geibel; William,17,0,20,3
1713342699421,CLRE 250,A00,511389,Morris; Sheldon,9996,0,9999,3
1713342700447,CLRE 251,A00,507176,Mehta; Ravindra L.,9996,0,9999,3
1713342700447,CLRE 251,B00,511410,Mehta; Ravindra L.,9998,0,9999,1
1713342701474,CLRE 252,A00,507189,Cuomo; Raphael Eduardo,9998,0,9999,1
1713342702503,CLRE 253,A00,507199,Vaida; Florin,9997,0,9999,2
1713342702503,CLRE 253,B00,507202,Vaida; Florin,9999,0,9999,0
1713342703528,CLRE 259,A00,507211,Patel; Hemal,9996,0,9999,3
1713342704557,CLRE 260,A00,507221,Cuomo; Raphael Eduardo,9999,0,9999,0
1713342705583,CLRE 297,001,507242,Cuomo; Raphael Eduardo,9999,0,9999,0
1713342706612,CSE 191,A00,516875,Minnes Kemp; Mor Mia,9999,0,9999,0
1713342707645,CSS 201S,A01,494383,Staff,35,0,35,0
1713342708674,CSS 202S,A01,494387,Staff,35,0,35,0
1713342709700,EAP 100,A00,516065,Staff,9792,0,9999,207
1713342710724,ECE 45,A01,507414,Staff,51,0,60,9
1713342711757,ECE 100,A01,507416,Baghdadchi; Saharnaz,10,0,20,10
1713342711757,ECE 100,A02,507418,Baghdadchi; Saharnaz,20,0,20,0
1713342712784,ECE 111,A01,507420,Staff,38,0,50,12
1713342713808,ECE 197,001,548057,Sievenpiper; Daniel F.,9998,0,9999,1
1713342714836,EDS 115,A00,507243,Choi; Bailey Miyeon,28,0,28,0
1713342715862,EDS 117,A01,494379,Staff,23,0,25,2
1713342716892,EDS 125,A00,507246,Hopkins; Megan Beth,29,0,30,1
1713342717973,EDS 128A,A01,507264,Fargason; Sharon Gayle,26,0,26,0
1713342719001,EDS 128B,A01,507293,Pappas; Elizabeth,30,0,30,0
1713342720028,EDS 139,A00,507294,Fargason; Sharon Gayle,30,0,30,0
1713342720028,EDS 139,B00,507313,Pappas; Elizabeth,30,0,30,0
1713342721054,EDS 201,A00,507315,Staff,26,0,30,4
1713342722081,EDS 203,A01,507317,Halter; Christopher P.,26,0,30,4
1713342723108,EDS 204R,A01,507319,Halter; Christopher P.,3,0,30,27
1713342723108,EDS 204R,B01,507331,Heinzman; Erica M.,28,0,30,2
1713342724134,EDS 206R,A00,507332,Staff,4,0,30,26
1713342724134,EDS 206R,B00,507343,Staff,28,0,30,2
1713342725164,EDS 250,A00,507344,Hemans; Patricia Ann Benitez,36,0,40,4
1713342726188,EDS 281,A00,507345,Daly; Alan J.,18,0,18,0
1713342727213,EDS 284,A00,507350,Daly; Alan J.,16,0,16,0
1713342728243,EDS 286,A00,507359,Fine; Sarah,18,0,18,0
1713342729270,EDS 289C,A01,507361,Daly; Alan J.,18,0,18,0
1713342730297,EDS 290,A00,507366,Hofstetter; Carolyn,15,0,15,0
1713342731325,LIGM 5A,A00,507421,Fischer-Grunski; Eva K,20,0,20,0
1713342732355,LIGM 5B,A00,507423,Fischer-Grunski; Eva K,20,0,20,0
1713342733385,LIGM 5C,A00,507425,Fischer-Grunski; Eva K,20,0,20,0
1713342734410,LIIT 5AS,A00,507427,Carnelos; Chiara,20,0,20,0
1713342735440,LIIT 5BS,A00,507430,Carnelos; Chiara,20,0,20,0
1713342736465,LIIT 5CS,A00,507432,Carnelos; Chiara,20,0,20,0
1713342737492,LISP 5A,A00,507541,Munoz Sanchez; Alicia,17,0,20,3
1713342738517,LISP 5B,A00,507671,Munoz Sanchez; Alicia,15,0,20,5
1713342739543,LISP 5C,A00,507696,Munoz Sanchez; Alicia,15,0,20,5
1713342740569,MAE 197,001,528363,Boechler; Nicholas Sebastia,9998,0,9999,1
1713342741596,MATH 197,001,523477,Kedlaya; Kiran S.,9999,0,9999,0
1713342741596,MATH 197,002,563811,Zhang; Danna,9999,0,9999,0
1713342742622,MCWP 40R,A00,518780,Staff,20,0,20,0
1713342742622,MCWP 40R,B00,518781,Staff,19,0,20,1
1713342742622,MCWP 40R,C00,518783,Staff,19,0,20,1
1713342743653,MCWP 50R,A00,518791,Staff,20,0,20,0
1713342743653,MCWP 50R,B00,518792,Staff,17,0,20,3
1713342743653,MCWP 50R,C00,518793,Staff,19,0,20,1
1713342743653,MCWP 50R,D00,518794,Staff,16,0,20,4
1713342743653,MCWP 50R,E00,518795,Staff,16,0,20,4
1713342743653,MCWP 50R,F00,518796,Staff,19,0,20,1
1713342743653,MCWP 50R,G00,518797,Staff,19,0,20,1
1713342744683,MMW 12R,A01,514034,Herbst; Matthew,15,0,16,1
1713342744683,MMW 12R,A02,514035,Herbst; Matthew,16,0,16,0
1713342745708,MMW 13R,A01,514037,Staff,12,0,16,4
1713342745708,MMW 13R,A02,514039,Staff,16,0,16,0
1713342747764,SIO 295LS,A00,523233,Staff,18,0,30,12
1713342748790,SIO 295S,A00,523232,Staff,18,0,30,12
1713342749819,SOCI 117,A01,494376,Staff,1,0,5,4
1713342750846,WES 237B,A00,494380,Staff,19,0,20,1
1713342752921,AESE 279B,A00,494370,Wade; Jon P,33,0,33,0
1713342753947,ANAR 135S,A00,494369,Braswell; Geoffrey E.,0,0,0,0
1713342754980,CAT 124RS,A01,519847,Geibel; William,17,0,20,3
1713342756005,CAT 125RS,A01,515971,Geibel; William,17,0,20,3
1713342757033,CLRE 250,A00,511389,Morris; Sheldon,9996,0,9999,3
1713342758069,CLRE 251,A00,507176,Mehta; Ravindra L.,9996,0,9999,3
1713342758069,CLRE 251,B00,511410,Mehta; Ravindra L.,9998,0,9999,1
1713342759095,CLRE 252,A00,507189,Cuomo; Raphael Eduardo,9998,0,9999,1
1713342760122,CLRE 253,A00,507199,Vaida; Florin,9997,0,9999,2
1713342760122,CLRE 253,B00,507202,Vaida; Florin,9999,0,9999,0
1713342761148,CLRE 259,A00,507211,Patel; Hemal,9996,0,9999,3
1713342762173,CLRE 260,A00,507221,Cuomo; Raphael Eduardo,9999,0,9999,0
1713342763198,CLRE 297,001,507242,Cuomo; Raphael Eduardo,9999,0,9999,0
1713342764227,CSE 191,A00,516875,Minnes Kemp; Mor Mia,9999,0,9999,0
1713342765254,CSS 201S,A01,494383,Staff,35,0,35,0
1713342766285,CSS 202S,A01,494387,Staff,35,0,35,0
1713342767313,EAP 100,A00,516065,Staff,9792,0,9999,207
1713342768342,ECE 45,A01,507414,Staff,51,0,60,9
1713342769367,ECE 100,A01,507416,Baghdadchi; Saharnaz,10,0,20,10
1713342769367,ECE 100,A02,507418,Baghdadchi; Saharnaz,20,0,20,0
1713342770400,ECE 111,A01,507420,Staff,38,0,50,12
1713342771426,ECE 197,001,548057,Sievenpiper; Daniel F.,9998,0,9999,1
1713342772526,EDS 115,A00,507243,Choi; Bailey Miyeon,28,0,28,0
1713342773557,EDS 117,A01,494379,Staff,23,0,25,2
1713342774585,EDS 125,A00,507246,Hopkins; Megan Beth,29,0,30,1
1713342775620,EDS 128A,A01,507264,Fargason; Sharon Gayle,26,0,26,0
1713342776653,EDS 128B,A01,507293,Pappas; Elizabeth,30,0,30,0
1713342777679,EDS 139,A00,507294,Fargason; Sharon Gayle,30,0,30,0
1713342777679,EDS 139,B00,507313,Pappas; Elizabeth,30,0,30,0
1713342778704,EDS 201,A00,507315,Staff,26,0,30,4
1713342779730,EDS 203,A01,507317,Halter; Christopher P.,26,0,30,4
1713342780758,EDS 204R,A01,507319,Halter; Christopher P.,3,0,30,27
1713342780758,EDS 204R,B01,507331,Heinzman; Erica M.,28,0,30,2
1713342781787,EDS 206R,A00,507332,Staff,4,0,30,26
1713342781787,EDS 206R,B00,507343,Staff,28,0,30,2
1713342782813,EDS 250,A00,507344,Hemans; Patricia Ann Benitez,36,0,40,4
1713342783839,EDS 281,A00,507345,Daly; Alan J.,18,0,18,0
1713342784864,EDS 284,A00,507350,Daly; Alan J.,16,0,16,0
1713342785890,EDS 286,A00,507359,Fine; Sarah,18,0,18,0
1713342786917,EDS 289C,A01,507361,Daly; Alan J.,18,0,18,0
1713342787947,EDS 290,A00,507366,Hofstetter; Carolyn,15,0,15,0
1713342788977,LIGM 5A,A00,507421,Fischer-Grunski; Eva K,20,0,20,0
1713342790002,LIGM 5B,A00,507423,Fischer-Grunski; Eva K,20,0,20,0
1713342791029,LIGM 5C,A00,507425,Fischer-Grunski; Eva K,20,0,20,0
1713342792055,LIIT 5AS,A00,507427,Carnelos; Chiara,20,0,20,0
1713342793080,LIIT 5BS,A00,507430,Carnelos; Chiara,20,0,20,0
1713342794104,LIIT 5CS,A00,507432,Carnelos; Chiara,20,0,20,0
1713342795130,LISP 5A,A00,507541,Munoz Sanchez; Alicia,17,0,20,3
1713342796154,LISP 5B,A00,507671,Munoz Sanchez; Alicia,15,0,20,5
1713342797180,LISP 5C,A00,507696,Munoz Sanchez; Alicia,15,0,20,5
1713342798206,MAE 197,001,528363,Boechler; Nicholas Sebastia,9998,0,9999,1
1713342799232,MATH 197,001,523477,Kedlaya; Kiran S.,9999,0,9999,0
1713342799232,MATH 197,002,563811,Zhang; Danna,9999,0,9999,0
1713342800261,MCWP 40R,A00,518780,Staff,20,0,20,0
1713342800261,MCWP 40R,B00,518781,Staff,19,0,20,1
1713342800261,MCWP 40R,C00,518783,Staff,19,0,20,1
1713342801286,MCWP 50R,A00,518791,Staff,20,0,20,0
1713342801286,MCWP 50R,B00,518792,Staff,17,0,20,3
1713342801286,MCWP 50R,C00,518793,Staff,19,0,20,1
1713342801286,MCWP 50R,D00,518794,Staff,16,0,20,4
1713342801286,MCWP 50R,E00,518795,Staff,16,0,20,4
1713342801286,MCWP 50R,F00,518796,Staff,19,0,20,1
1713342801286,MCWP 50R,G00,518797,Staff,19,0,20,1
1713342802318,MMW 12R,A01,514034,Herbst; Matthew,15,0,16,1
1713342802318,MMW 12R,A02,514035,Herbst; Matthew,16,0,16,0
1713342803342,MMW 13R,A01,514037,Staff,12,0,16,4
1713342803342,MMW 13R,A02,514039,Staff,16,0,16,0
1713342805395,SIO 295LS,A00,523233,Staff,18,0,30,12
1713342806420,SIO 295S,A00,523232,Staff,18,0,30,12
1713342807450,SOCI 117,A01,494376,Staff,1,0,5,4
1713342808479,WES 237B,A00,494380,Staff,19,0,20,1
1713342810543,AESE 279B,A00,494370,Wade; Jon P,33,0,33,0
1713342811574,ANAR 135S,A00,494369,Braswell; Geoffrey E.,0,0,0,0
1713342812600,CAT 124RS,A01,519847,Geibel; William,17,0,20,3
1713342813630,CAT 125RS,A01,515971,Geibel; William,17,0,20,3
1713342814657,CLRE 250,A00,511389,Morris; Sheldon,9996,0,9999,3
1713342815691,CLRE 251,A00,507176,Mehta; Ravindra L.,9996,0,9999,3
1713342815691,CLRE 251,B00,511410,Mehta; Ravindra L.,9998,0,9999,1
1713342816717,CLRE 252,A00,507189,Cuomo; Raphael Eduardo,9998,0,9999,1
1713342817742,CLRE 253,A00,507199,Vaida; Florin,9997,0,9999,2
1713342817742,CLRE 253,B00,507202,Vaida; Florin,9999,0,9999,0
1713342818769,CLRE 259,A00,507211,Patel; Hemal,9996,0,9999,3
1713342819795,CLRE 260,A00,507221,Cuomo; Raphael Eduardo,9999,0,9999,0
1713342820822,CLRE 297,001,507242,Cuomo; Raphael Eduardo,9999,0,9999,0
1713342821906,CSE 191,A00,516875,Minnes Kemp; Mor Mia,9999,0,9999,0
1713342822938,CSS 201S,A01,494383,Staff,35,0,35,0
1713342823965,CSS 202S,A01,494387,Staff,35,0,35,0
1713342824995,EAP 100,A00,516065,Staff,9792,0,9999,207
1713342826025,ECE 45,A01,507414,Staff,51,0,60,9
1713342827058,ECE 100,A01,507416,Baghdadchi; Saharnaz,10,0,20,10
1713342827058,ECE 100,A02,507418,Baghdadchi; Saharnaz,20,0,20,0
1713342828084,ECE 111,A01,507420,Staff,38,0,50,12
1713342829117,ECE 197,001,548057,Sievenpiper; Daniel F.,9998,0,9999,1
1713342830143,EDS 115,A00,507243,Choi; Bailey Miyeon,28,0,28,0
1713342831175,EDS 117,A01,494379,Staff,23,0,25,2
1713342832201,EDS 125,A00,507246,Hopkins; Megan Beth,29,0,30,1
1713342833228,EDS 128A,A01,507264,Fargason; Sharon Gayle,26,0,26,0
1713342834255,EDS 128B,A01,507293,Pappas; Elizabeth,30,0,30,0
1713342835281,EDS 139,A00,507294,Fargason; Sharon Gayle,30,0,30,0
1713342835281,EDS 139,B00,507313,Pappas; Elizabeth,30,0,30,0
1713342836306,EDS 201,A00,507315,Staff,26,0,30,4
1713342837337,EDS 203,A01,507317,Halter; Christopher P.,26,0,30,4
1713342838368,EDS 204R,A01,507319,Halter; Christopher P.,3,0,30,27
1713342838368,EDS 204R,B01,507331,Heinzman; Erica M.,28,0,30,2
1713342839399,EDS 206R,A00,507332,Staff,4,0,30,26
1713342839399,EDS 206R,B00,507343,Staff,28,0,30,2
1713342840430,EDS 250,A00,507344,Hemans; Patricia Ann Benitez,36,0,40,4
1713342841456,EDS 281,A00,507345,Daly; Alan J.,18,0,18,0
1713342842487,EDS 284,A00,507350,Daly; Alan J.,16,0,16,0
1713342843518,EDS 286,A00,507359,Fine; Sarah,18,0,18,0
1713342844544,EDS 289C,A01,507361,Daly; Alan J.,18,0,18,0
1713342845570,EDS 290,A00,507366,Hofstetter; Carolyn,15,0,15,0
1713342846597,LIGM 5A,A00,507421,Fischer-Grunski; Eva K,20,0,20,0
1713342847623,LIGM 5B,A00,507423,Fischer-Grunski; Eva K,20,0,20,0
1713342848649,LIGM 5C,A00,507425,Fischer-Grunski; Eva K,20,0,20,0
1713342849683,LIIT 5AS,A00,507427,Carnelos; Chiara,20,0,20,0
1713342850710,LIIT 5BS,A00,507430,Carnelos; Chiara,20,0,20,0
1713342851737,LIIT 5CS,A00,507432,Carnelos; Chiara,20,0,20,0
1713342852763,LISP 5A,A00,507541,Munoz Sanchez; Alicia,17,0,20,3
1713342853793,LISP 5B,A00,507671,Munoz Sanchez; Alicia,15,0,20,5
1713342854825,LISP 5C,A00,507696,Munoz Sanchez; Alicia,15,0,20,5
1713342855850,MAE 197,001,528363,Boechler; Nicholas Sebastia,9998,0,9999,1
1713342856878,MATH 197,001,523477,Kedlaya; Kiran S.,9999,0,9999,0
1713342856878,MATH 197,002,563811,Zhang; Danna,9999,0,9999,0
1713342857910,MCWP 40R,A00,518780,Staff,20,0,20,0
1713342857910,MCWP 40R,B00,518781,Staff,19,0,20,1
1713342857910,MCWP 40R,C00,518783,Staff,19,0,20,1
1713342858945,MCWP 50R,A00,518791,Staff,20,0,20,0
1713342858945,MCWP 50R,B00,518792,Staff,17,0,20,3
1713342858945,MCWP 50R,C00,518793,Staff,19,0,20,1
1713342858945,MCWP 50R,D00,518794,Staff,16,0,20,4
1713342858945,MCWP 50R,E00,518795,Staff,16,0,20,4
1713342858945,MCWP 50R,F00,518796,Staff,19,0,20,1
1713342858945,MCWP 50R,G00,518797,Staff,19,0,20,1
1713342859976,MMW 12R,A01,514034,Herbst; Matthew,15,0,16,1
1713342859976,MMW 12R,A02,514035,Herbst; Matthew,16,0,16,0
1713342861006,MMW 13R,A01,514037,Staff,12,0,16,4
1713342861006,MMW 13R,A02,514039,Staff,16,0,16,0
1713342863058,SIO 295LS,A00,523233,Staff,18,0,30,12
1713342864087,SIO 295S,A00,523232,Staff,18,0,30,12
1713342865113,SOCI 117,A01,494376,Staff,1,0,5,4
1713342866144,WES 237B,A00,494380,Staff,19,0,20,1
1713342868227,AESE 279B,A00,494370,Wade; Jon P,33,0,33,0
1713342869254,ANAR 135S,A00,494369,Braswell; Geoffrey E.,0,0,0,0
1713342870279,CAT 124RS,A01,519847,Geibel; William,17,0,20,3
1713342871307,CAT 125RS,A01,515971,Geibel; William,17,0,20,3
1713342872336,CLRE 250,A00,511389,Morris; Sheldon,9996,0,9999,3
1713342873369,CLRE 251,A00,507176,Mehta; Ravindra L.,9996,0,9999,3
1713342873369,CLRE 251,B00,511410,Mehta; Ravindra L.,9998,0,9999,1
1713342874397,CLRE 252,A00,507189,Cuomo; Raphael Eduardo,9998,0,9999,1
1713342875423,CLRE 253,A00,507199,Vaida; Florin,9997,0,9999,2
1713342875423,CLRE 253,B00,507202,Vaida; Florin,9999,0,9999,0
1713342876449,CLRE 259,A00,507211,Patel; Hemal,9996,0,9999,3
1713342877480,CLRE 260,A00,507221,Cuomo; Raphael Eduardo,9999,0,9999,0
1713342878505,CLRE 297,001,507242,Cuomo; Raphael Eduardo,9999,0,9999,0
1713342879531,CSE 191,A00,516875,Minnes Kemp; Mor Mia,9999,0,9999,0
1713342880563,CSS 201S,A01,494383,Staff,35,0,35,0
1713342881588,CSS 202S,A01,494387,Staff,35,0,35,0
1713342882618,EAP 100,A00,516065,Staff,9792,0,9999,207
1713342883646,ECE 45,A01,507414,Staff,51,0,60,9
1713342884673,ECE 100,A01,507416,Baghdadchi; Saharnaz,10,0,20,10
1713342884673,ECE 100,A02,507418,Baghdadchi; Saharnaz,20,0,20,0
1713342885703,ECE 111,A01,507420,Staff,38,0,50,12
1713342886733,ECE 197,001,548057,Sievenpiper; Daniel F.,9998,0,9999,1
1713342887759,EDS 115,A00,507243,Choi; Bailey Miyeon,28,0,28,0
1713342888788,EDS 117,A01,494379,Staff,23,0,25,2
1713342889814,EDS 125,A00,507246,Hopkins; Megan Beth,29,0,30,1
1713342890841,EDS 128A,A01,507264,Fargason; Sharon Gayle,26,0,26,0
1713342891872,EDS 128B,A01,507293,Pappas; Elizabeth,30,0,30,0
1713342892902,EDS 139,A00,507294,Fargason; Sharon Gayle,30,0,30,0
1713342892902,EDS 139,B00,507313,Pappas; Elizabeth,30,0,30,0
1713342893937,EDS 201,A00,507315,Staff,26,0,30,4
1713342894962,EDS 203,A01,507317,Halter; Christopher P.,26,0,30,4
1713342895988,EDS 204R,A01,507319,Halter; Christopher P.,3,0,30,27
1713342895988,EDS 204R,B01,507331,Heinzman; Erica M.,28,0,30,2
1713342897011,EDS 206R,A00,507332,Staff,4,0,30,26
1713342897011,EDS 206R,B00,507343,Staff,28,0,30,2
1713342898044,EDS 250,A00,507344,Hemans; Patricia Ann Benitez,36,0,40,4
1713342899069,EDS 281,A00,507345,Daly; Alan J.,18,0,18,0
1713342900097,EDS 284,A00,507350,Daly; Alan J.,16,0,16,0
1713342901127,EDS 286,A00,507359,Fine; Sarah,18,0,18,0
1713342902153,EDS 289C,A01,507361,Daly; Alan J.,18,0,18,0
1713342903189,EDS 290,A00,507366,Hofstetter; Carolyn,15,0,15,0
1713342904216,LIGM 5A,A00,507421,Fischer-Grunski; Eva K,20,0,20,0
1713342905248,LIGM 5B,A00,507423,Fischer-Grunski; Eva K,20,0,20,0
1713342906280,LIGM 5C,A00,507425,Fischer-Grunski; Eva K,20,0,20,0
1713342907305,LIIT 5AS,A00,507427,Carnelos; Chiara,20,0,20,0
1713342908336,LIIT 5BS,A00,507430,Carnelos; Chiara,20,0,20,0
1713342909362,LIIT 5CS,A00,507432,Carnelos; Chiara,20,0,20,0
1713342910389,LISP 5A,A00,507541,Munoz Sanchez; Alicia,17,0,20,3
1713342911415,LISP 5B,A00,507671,Munoz Sanchez; Alicia,15,0,20,5
1713342912440,LISP 5C,A00,507696,Munoz Sanchez; Alicia,15,0,20,5
1713342913467,MAE 197,001,528363,Boechler; Nicholas Sebastia,9998,0,9999,1
1713342914499,MATH 197,001,523477,Kedlaya; Kiran S.,9999,0,9999,0
1713342914499,MATH 197,002,563811,Zhang; Danna,9999,0,9999,0
1713342915525,MCWP 40R,A00,518780,Staff,20,0,20,0
1713342915525,MCWP 40R,B00,518781,Staff,19,0,20,1
1713342915525,MCWP 40R,C00,518783,Staff,19,0,20,1
1713342916550,MCWP 50R,A00,518791,Staff,20,0,20,0
1713342916550,MCWP 50R,B00,518792,Staff,17,0,20,3
1713342916550,MCWP 50R,C00,518793,Staff,19,0,20,1
1713342916550,MCWP 50R,D00,518794,Staff,16,0,20,4
1713342916550,MCWP 50R,E00,518795,Staff,16,0,20,4
1713342916550,MCWP 50R,F00,518796,Staff,19,0,20,1
1713342916550,MCWP 50R,G00,518797,Staff,19,0,20,1
1713342917576,MMW 12R,A01,514034,Herbst; Matthew,15,0,16,1
1713342917576,MMW 12R,A02,514035,Herbst; Matthew,16,0,16,0
1713342918602,MMW 13R,A01,514037,Staff,12,0,16,4
1713342918602,MMW 13R,A02,514039,Staff,16,0,16,0
1713342920658,SIO 295LS,A00,523233,Staff,18,0,30,12
1713342921689,SIO 295S,A00,523232,Staff,18,0,30,12
1713342922719,SOCI 117,A01,494376,Staff,1,0,5,4
1713342923746,WES 237B,A00,494380,Staff,19,0,20,1
1713342925877,AESE 279B,A00,494370,Wade; Jon P,33,0,33,0
1713342926903,ANAR 135S,A00,494369,Braswell; Geoffrey E.,0,0,0,0
1713342927930,CAT 124RS,A01,519847,Geibel; William,17,0,20,3
1713342928959,CAT 125RS,A01,515971,Geibel; William,17,0,20,3
1713342929985,CLRE 250,A00,511389,Morris; Sheldon,9996,0,9999,3
1713342931020,CLRE 251,A00,507176,Mehta; Ravindra L.,9996,0,9999,3
1713342931020,CLRE 251,B00,511410,Mehta; Ravindra L.,9998,0,9999,1
1713342932046,CLRE 252,A00,507189,Cuomo; Raphael Eduardo,9998,0,9999,1
1713342933073,CLRE 253,A00,507199,Vaida; Florin,9997,0,9999,2
1713342933073,CLRE 253,B00,507202,Vaida; Florin,9999,0,9999,0
1713342934099,CLRE 259,A00,507211,Patel; Hemal,9996,0,9999,3
1713342935123,CLRE 260,A00,507221,Cuomo; Raphael Eduardo,9999,0,9999,0
1713342936147,CLRE 297,001,507242,Cuomo; Raphael Eduardo,9999,0,9999,0
1713342937175,CSE 191,A00,516875,Minnes Kemp; Mor Mia,9999,0,9999,0
1713342938201,CSS 201S,A01,494383,Staff,35,0,35,0
1713342939227,CSS 202S,A01,494387,Staff,35,0,35,0
1713342940253,EAP 100,A00,516065,Staff,9792,0,9999,207
1713342941283,ECE 45,A01,507414,Staff,51,0,60,9
1713342942308,ECE 100,A01,507416,Baghdadchi; Saharnaz,10,0,20,10
1713342942308,ECE 100,A02,507418,Baghdadchi; Saharnaz,20,0,20,0
1713342943333,ECE 111,A01,507420,Staff,38,0,50,12
1713342944359,ECE 197,001,548057,Sievenpiper; Daniel F.,9998,0,9999,1
1713342945389,EDS 115,A00,507243,Choi; Bailey Miyeon,28,0,28,0
1713342946414,EDS 117,A01,494379,Staff,23,0,25,2
1713342947439,EDS 125,A00,507246,Hopkins; Megan Beth,29,0,30,1
1713342948464,EDS 128A,A01,507264,Fargason; Sharon Gayle,26,0,26,0
1713342949491,EDS 128B,A01,507293,Pappas; Elizabeth,30,0,30,0
1713342950520,EDS 139,A00,507294,Fargason; Sharon Gayle,30,0,30,0
1713342950520,EDS 139,B00,507313,Pappas; Elizabeth,30,0,30,0
1713342951543,EDS 201,A00,507315,Staff,26,0,30,4
1713342952576,EDS 203,A01,507317,Halter; Christopher P.,26,0,30,4
1713342953607,EDS 204R,A01,507319,Halter; Christopher P.,3,0,30,27
1713342953607,EDS 204R,B01,507331,Heinzman; Erica M.,28,0,30,2
1713342954631,EDS 206R,A00,507332,Staff,4,0,30,26
1713342954631,EDS 206R,B00,507343,Staff,28,0,30,2
1713342955669,EDS 250,A00,507344,Hemans; Patricia Ann Benitez,36,0,40,4
1713342956698,EDS 281,A00,507345,Daly; Alan J.,18,0,18,0
1713342957723,EDS 284,A00,507350,Daly; Alan J.,16,0,16,0
1713342958753,EDS 286,A00,507359,Fine; Sarah,18,0,18,0
1713342959778,EDS 289C,A01,507361,Daly; Alan J.,18,0,18,0
1713342960810,EDS 290,A00,507366,Hofstetter; Carolyn,15,0,15,0
1713342961837,LIGM 5A,A00,507421,Fischer-Grunski; Eva K,20,0,20,0
1713342962863,LIGM 5B,A00,507423,Fischer-Grunski; Eva K,20,0,20,0
1713342963890,LIGM 5C,A00,507425,Fischer-Grunski; Eva K,20,0,20,0
1713342964916,LIIT 5AS,A00,507427,Carnelos; Chiara,20,0,20,0
1713342965947,LIIT 5BS,A00,507430,Carnelos; Chiara,20,0,20,0
1713342966974,LIIT 5CS,A00,507432,Carnelos; Chiara,20,0,20,0
1713342968007,LISP 5A,A00,507541,Munoz Sanchez; Alicia,17,0,20,3
1713342969037,LISP 5B,A00,507671,Munoz Sanchez; Alicia,15,0,20,5
1713342970068,LISP 5C,A00,507696,Munoz Sanchez; Alicia,15,0,20,5
1713342971094,MAE 197,001,528363,Boechler; Nicholas Sebastia,9998,0,9999,1
1713342972121,MATH 197,001,523477,Kedlaya; Kiran S.,9999,0,9999,0
1713342972121,MATH 197,002,563811,Zhang; Danna,9999,0,9999,0
1713342973151,MCWP 40R,A00,518780,Staff,20,0,20,0
1713342973151,MCWP 40R,B00,518781,Staff,19,0,20,1
1713342973151,MCWP 40R,C00,518783,Staff,19,0,20,1
1713342974177,MCWP 50R,A00,518791,Staff,20,0,20,0
1713342974177,MCWP 50R,B00,518792,Staff,17,0,20,3
1713342974177,MCWP 50R,C00,518793,Staff,19,0,20,1
1713342974177,MCWP 50R,D00,518794,Staff,16,0,20,4
1713342974177,MCWP 50R,E00,518795,Staff,16,0,20,4
1713342974177,MCWP 50R,F00,518796,Staff,19,0,20,1
1713342974177,MCWP 50R,G00,518797,Staff,19,0,20,1
1713342975201,MMW 12R,A01,514034,Herbst; Matthew,15,0,16,1
1713342975201,MMW 12R,A02,514035,Herbst; Matthew,16,0,16,0
1713342976227,MMW 13R,A01,514037,Staff,12,0,16,4
1713342976227,MMW 13R,A02,514039,Staff,16,0,16,0
1713342978283,SIO 295LS,A00,523233,Staff,18,0,30,12
1713342979311,SIO 295S,A00,523232,Staff,18,0,30,12
1713342980341,SOCI 117,A01,494376,Staff,1,0,5,4
1713342981372,WES 237B,A00,494380,Staff,19,0,20,1
1713342983454,AESE 279B,A00,494370,Wade; Jon P,33,0,33,0
1713342984480,ANAR 135S,A00,494369,Braswell; Geoffrey E.,0,0,0,0
1713342985507,CAT 124RS,A01,519847,Geibel; William,17,0,20,3
1713342986532,CAT 125RS,A01,515971,Geibel; William,17,0,20,3
1713342987559,CLRE 250,A00,511389,Morris; Sheldon,9996,0,9999,3
1713342988586,CLRE 251,A00,507176,Mehta; Ravindra L.,9996,0,9999,3
1713342988586,CLRE 251,B00,511410,Mehta; Ravindra L.,9998,0,9999,1
1713342989610,CLRE 252,A00,507189,Cuomo; Raphael Eduardo,9998,0,9999,1
1713342990637,CLRE 253,A00,507199,Vaida; Florin,9997,0,9999,2
1713342990637,CLRE 253,B00,507202,Vaida; Florin,9999,0,9999,0
1713342991667,CLRE 259,A00,507211,Patel; Hemal,9996,0,9999,3
1713342992695,CLRE 260,A00,507221,Cuomo; Raphael Eduardo,9999,0,9999,0
1713342993722,CLRE 297,001,507242,Cuomo; Raphael Eduardo,9999,0,9999,0
1713342994748,CSE 191,A00,516875,Minnes Kemp; Mor Mia,9999,0,9999,0
1713342995780,CSS 201S,A01,494383,Staff,35,0,35,0
1713342996810,CSS 202S,A01,494387,Staff,35,0,35,0
1713342997839,EAP 100,A00,516065,Staff,9792,0,9999,207
1713342998866,ECE 45,A01,507414,Staff,51,0,60,9
1713342999892,ECE 100,A01,507416,Baghdadchi; Saharnaz,10,0,20,10
1713342999892,ECE 100,A02,507418,Baghdadchi; Saharnaz,20,0,20,0
1713343000918,ECE 111,A01,507420,Staff,38,0,50,12
1713343001949,ECE 197,001,548057,Sievenpiper; Daniel F.,9998,0,9999,1
1713343002976,EDS 115,A00,507243,Choi; Bailey Miyeon,28,0,28,0
1713343004001,EDS 117,A01,494379,Staff,23,0,25,2
1713343005026,EDS 125,A00,507246,Hopkins; Megan Beth,29,0,30,1
1713343006052,EDS 128A,A01,507264,Fargason; Sharon Gayle,26,0,26,0
1713343007078,EDS 128B,A01,507293,Pappas; Elizabeth,30,0,30,0
1713343008103,EDS 139,A00,507294,Fargason; Sharon Gayle,30,0,30,0
1713343008103,EDS 139,B00,507313,Pappas; Elizabeth,30,0,30,0
1713343009129,EDS 201,A00,507315,Staff,26,0,30,4
1713343010158,EDS 203,A01,507317,Halter; Christopher P.,26,0,30,4
1713343011185,EDS 204R,A01,507319,Halter; Christopher P.,3,0,30,27
1713343011185,EDS 204R,B01,507331,Heinzman; Erica M.,28,0,30,2
1713343012210,EDS 206R,A00,507332,Staff,4,0,30,26
1713343012210,EDS 206R,B00,507343,Staff,28,0,30,2
1713343013235,EDS 250,A00,507344,Hemans; Patricia Ann Benitez,36,0,40,4
1713343014261,EDS 281,A00,507345,Daly; Alan J.,18,0,18,0
1713343015287,EDS 284,A00,507350,Daly; Alan J.,16,0,16,0
1713343016313,EDS 286,A00,507359,Fine; Sarah,18,0,18,0
1713343017339,EDS 289C,A01,507361,Daly; Alan J.,18,0,18,0
1713343018364,EDS 290,A00,507366,Hofstetter; Carolyn,15,0,15,0
1713343019391,LIGM 5A,A00,507421,Fischer-Grunski; Eva K,20,0,20,0
1713343020416,LIGM 5B,A00,507423,Fischer-Grunski; Eva K,20,0,20,0
1713343021442,LIGM 5C,A00,507425,Fischer-Grunski; Eva K,20,0,20,0
1713343022473,LIIT 5AS,A00,507427,Carnelos; Chiara,20,0,20,0
1713343023501,LIIT 5BS,A00,507430,Carnelos; Chiara,20,0,20,0
1713343024531,LIIT 5CS,A00,507432,Carnelos; Chiara,20,0,20,0
1713343025564,LISP 5A,A00,507541,Munoz Sanchez; Alicia,17,0,20,3
1713343026591,LISP 5B,A00,507671,Munoz Sanchez; Alicia,15,0,20,5
1713343027622,LISP 5C,A00,507696,Munoz Sanchez; Alicia,15,0,20,5
1713343028649,MAE 197,001,528363,Boechler; Nicholas Sebastia,9998,0,9999,1
1713343029730,MATH 197,001,523477,Kedlaya; Kiran S.,9999,0,9999,0
1713343029730,MATH 197,002,563811,Zhang; Danna,9999,0,9999,0
1713343030755,MCWP 40R,A00,518780,Staff,20,0,20,0
1713343030755,MCWP 40R,B00,518781,Staff,19,0,20,1
1713343030755,MCWP 40R,C00,518783,Staff,19,0,20,1
1713343031782,MCWP 50R,A00,518791,Staff,20,0,20,0
1713343031782,MCWP 50R,B00,518792,Staff,17,0,20,3
1713343031782,MCWP 50R,C00,518793,Staff,19,0,20,1
1713343031782,MCWP 50R,D00,518794,Staff,16,0,20,4
1713343031782,MCWP 50R,E00,518795,Staff,16,0,20,4
1713343031782,MCWP 50R,F00,518796,Staff,19,0,20,1
1713343031782,MCWP 50R,G00,518797,Staff,19,0,20,1
1713343032812,MMW 12R,A01,514034,Herbst; Matthew,15,0,16,1
1713343032812,MMW 12R,A02,514035,Herbst; Matthew,16,0,16,0
1713343033842,MMW 13R,A01,514037,Staff,12,0,16,4
1713343033842,MMW 13R,A02,514039,Staff,16,0,16,0
1713343035896,SIO 295LS,A00,523233,Staff,18,0,30,12
1713343036922,SIO 295S,A00,523232,Staff,18,0,30,12
1713343037949,SOCI 117,A01,494376,Staff,1,0,5,4
1713343038976,WES 237B,A00,494380,Staff,19,0,20,1
1713343041044,AESE 279B,A00,494370,Wade; Jon P,33,0,33,0
1713343042075,ANAR 135S,A00,494369,Braswell; Geoffrey E.,0,0,0,0
1713343043104,CAT 124RS,A01,519847,Geibel; William,17,0,20,3
1713343044130,CAT 125RS,A01,515971,Geibel; William,17,0,20,3
1713343045160,CLRE 250,A00,511389,Morris; Sheldon,9996,0,9999,3
1713343046188,CLRE 251,A00,507176,Mehta; Ravindra L.,9996,0,9999,3
1713343046188,CLRE 251,B00,511410,Mehta; Ravindra L.,9998,0,9999,1
1713343047218,CLRE 252,A00,507189,Cuomo; Raphael Eduardo,9998,0,9999,1
1713343048247,CLRE 253,A00,507199,Vaida; Florin,9997,0,9999,2
1713343048247,CLRE 253,B00,507202,Vaida; Florin,9999,0,9999,0
1713343049271,CLRE 259,A00,507211,Patel; Hemal,9996,0,9999,3
1713343050298,CLRE 260,A00,507221,Cuomo; Raphael Eduardo,9999,0,9999,0
1713343051326,CLRE 297,001,507242,Cuomo; Raphael Eduardo,9999,0,9999,0
1713343052358,CSE 191,A00,516875,Minnes Kemp; Mor Mia,9999,0,9999,0
1713343053390,CSS 201S,A01,494383,Staff,35,0,35,0
1713343054416,CSS 202S,A01,494387,Staff,35,0,35,0
1713343055441,EAP 100,A00,516065,Staff,9792,0,9999,207
1713343056473,ECE 45,A01,507414,Staff,51,0,60,9
1713343057500,ECE 100,A01,507416,Baghdadchi; Saharnaz,10,0,20,10
1713343057500,ECE 100,A02,507418,Baghdadchi; Saharnaz,20,0,20,0
1713343058532,ECE 111,A01,507420,Staff,38,0,50,12
1713343059557,ECE 197,001,548057,Sievenpiper; Daniel F.,9998,0,9999,1
1713343060583,EDS 115,A00,507243,Choi; Bailey Miyeon,28,0,28,0
1713343061608,EDS 117,A01,494379,Staff,23,0,25,2
1713343062641,EDS 125,A00,507246,Hopkins; Megan Beth,29,0,30,1
1713343063666,EDS 128A,A01,507264,Fargason; Sharon Gayle,26,0,26,0
1713343064692,EDS 128B,A01,507293,Pappas; Elizabeth,30,0,30,0
1713343065772,EDS 139,A00,507294,Fargason; Sharon Gayle,30,0,30,0
1713343065772,EDS 139,B00,507313,Pappas; Elizabeth,30,0,30,0
1713343066800,EDS 201,A00,507315,Staff,26,0,30,4
1713343067828,EDS 203,A01,507317,Halter; Christopher P.,26,0,30,4
1713343068859,EDS 204R,A01,507319,Halter; Christopher P.,3,0,30,27
1713343068859,EDS 204R,B01,507331,Heinzman; Erica M.,28,0,30,2
1713343069885,EDS 206R,A00,507332,Staff,4,0,30,26
1713343069885,EDS 206R,B00,507343,Staff,28,0,30,2
1713343070909,EDS 250,A00,507344,Hemans; Patricia Ann Benitez,36,0,40,4
1713343071936,EDS 281,A00,507345,Daly; Alan J.,18,0,18,0
1713343072964,EDS 284,A00,507350,Daly; Alan J.,16,0,16,0
1713343073990,EDS 286,A00,507359,Fine; Sarah,18,0,18,0
1713343075018,EDS 289C,A01,507361,Daly; Alan J.,18,0,18,0
1713343076049,EDS 290,A00,507366,Hofstetter; Carolyn,15,0,15,0
1713343077077,LIGM 5A,A00,507421,Fischer-Grunski; Eva K,20,0,20,0
1713343078103,LIGM 5B,A00,507423,Fischer-Grunski; Eva K,20,0,20,0
1713343079134,LIGM 5C,A00,507425,Fischer-Grunski; Eva K,20,0,20,0
1713343080159,LIIT 5AS,A00,507427,Carnelos; Chiara,20,0,20,0
1713343081185,LIIT 5BS,A00,507430,Carnelos; Chiara,20,0,20,0
1713343082211,LIIT 5CS,A00,507432,Carnelos; Chiara,20,0,20,0
1713343083242,LISP 5A,A00,507541,Munoz Sanchez; Alicia,17,0,20,3
1713343084271,LISP 5B,A00,507671,Munoz Sanchez; Alicia,15,0,20,5
1713343085302,LISP 5C,A00,507696,Munoz Sanchez; Alicia,15,0,20,5
1713343086328,MAE 197,001,528363,Boechler; Nicholas Sebastia,9998,0,9999,1
1713343087355,MATH 197,001,523477,Kedlaya; Kiran S.,9999,0,9999,0
1713343087355,MATH 197,002,563811,Zhang; Danna,9999,0,9999,0
1713343088380,MCWP 40R,A00,518780,Staff,20,0,20,0
1713343088380,MCWP 40R,B00,518781,Staff,19,0,20,1
1713343088380,MCWP 40R,C00,518783,Staff,19,0,20,1
1713343089409,MCWP 50R,A00,518791,Staff,20,0,20,0
1713343089409,MCWP 50R,B00,518792,Staff,17,0,20,3
1713343089409,MCWP 50R,C00,518793,Staff,19,0,20,1
1713343089409,MCWP 50R,D00,518794,Staff,16,0,20,4
1713343089409,MCWP 50R,E00,518795,Staff,16,0,20,4
1713343089409,MCWP 50R,F00,518796,Staff,19,0,20,1
1713343089409,MCWP 50R,G00,518797,Staff,19,0,20,1
1713343090434,MMW 12R,A01,514034,Herbst; Matthew,15,0,16,1
1713343090434,MMW 12R,A02,514035,Herbst; Matthew,16,0,16,0
1713343091463,MMW 13R,A01,514037,Staff,12,0,16,4
1713343091463,MMW 13R,A02,514039,Staff,16,0,16,0
1713343093515,SIO 295LS,A00,523233,Staff,18,0,30,12
1713343094540,SIO 295S,A00,523232,Staff,18,0,30,12
1713343095565,SOCI 117,A01,494376,Staff,1,0,5,4
1713343096594,WES 237B,A00,494380,Staff,19,0,20,1
1713343098675,AESE 279B,A00,494370,Wade; Jon P,33,0,33,0
1713343099702,ANAR 135S,A00,494369,Braswell; Geoffrey E.,0,0,0,0
1713343100727,CAT 124RS,A01,519847,Geibel; William,17,0,20,3
1713343101755,CAT 125RS,A01,515971,Geibel; William,17,0,20,3
1713343102788,CLRE 250,A00,511389,Morris; Sheldon,9996,0,9999,3
1713343103816,CLRE 251,A00,507176,Mehta; Ravindra L.,9996,0,9999,3
1713343103816,CLRE 251,B00,511410,Mehta; Ravindra L.,9998,0,9999,1
1713343104852,CLRE 252,A00,507189,Cuomo; Raphael Eduardo,9998,0,9999,1
1713343105880,CLRE 253,A00,507199,Vaida; Florin,9997,0,9999,2
1713343105880,CLRE 253,B00,507202,Vaida; Florin,9999,0,9999,0
1713343106907,CLRE 259,A00,507211,Patel; Hemal,9996,0,9999,3
1713343107934,CLRE 260,A00,507221,Cuomo; Raphael Eduardo,9999,0,9999,0
1713343108962,CLRE 297,001,507242,Cuomo; Raphael Eduardo,9999,0,9999,0
1713343109991,CSE 191,A00,516875,Minnes Kemp; Mor Mia,9999,0,9999,0
1713343111018,CSS 201S,A01,494383,Staff,35,0,35,0
1713343112054,CSS 202S,A01,494387,Staff,35,0,35,0
1713343113081,EAP 100,A00,516065,Staff,9792,0,9999,207
1713343114106,ECE 45,A01,507414,Staff,51,0,60,9
1713343115132,ECE 100,A01,507416,Baghdadchi; Saharnaz,10,0,20,10
1713343115132,ECE 100,A02,507418,Baghdadchi; Saharnaz,20,0,20,0
1713343116164,ECE 111,A01,507420,Staff,38,0,50,12
1713343117190,ECE 197,001,548057,Sievenpiper; Daniel F.,9998,0,9999,1
1713343118223,EDS 115,A00,507243,Choi; Bailey Miyeon,28,0,28,0
1713343119248,EDS 117,A01,494379,Staff,23,0,25,2
1713343120272,EDS 125,A00,507246,Hopkins; Megan Beth,29,0,30,1
1713343121305,EDS 128A,A01,507264,Fargason; Sharon Gayle,26,0,26,0
1713343122337,EDS 128B,A01,507293,Pappas; Elizabeth,30,0,30,0
1713343123362,EDS 139,A00,507294,Fargason; Sharon Gayle,30,0,30,0
1713343123362,EDS 139,B00,507313,Pappas; Elizabeth,30,0,30,0
1713343124388,EDS 201,A00,507315,Staff,26,0,30,4
1713343125420,EDS 203,A01,507317,Halter; Christopher P.,26,0,30,4
1713343126452,EDS 204R,A01,507319,Halter; Christopher P.,3,0,30,27
1713343126452,EDS 204R,B01,507331,Heinzman; Erica M.,28,0,30,2
1713343127478,EDS 206R,A00,507332,Staff,4,0,30,26
1713343127478,EDS 206R,B00,507343,Staff,28,0,30,2
1713343128506,EDS 250,A00,507344,Hemans; Patricia Ann Benitez,36,0,40,4
1713343129531,EDS 281,A00,507345,Daly; Alan J.,18,0,18,0
1713343130557,EDS 284,A00,507350,Daly; Alan J.,16,0,16,0
1713343131584,EDS 286,A00,507359,Fine; Sarah,18,0,18,0
1713343132609,EDS 289C,A01,507361,Daly; Alan J.,18,0,18,0
1713343133696,EDS 290,A00,507366,Hofstetter; Carolyn,15,0,15,0
1713343134728,LIGM 5A,A00,507421,Fischer-Grunski; Eva K,20,0,20,0
1713343135753,LIGM 5B,A00,507423,Fischer-Grunski; Eva K,20,0,20,0
1713343136787,LIGM 5C,A00,507425,Fischer-Grunski; Eva K,20,0,20,0
1713343137820,LIIT 5AS,A00,507427,Carnelos; Chiara,20,0,20,0
1713343138850,LIIT 5BS,A00,507430,Carnelos; Chiara,20,0,20,0
1713343139880,LIIT 5CS,A00,507432,Carnelos; Chiara,20,0,20,0
1713343140914,LISP 5A,A00,507541,Munoz Sanchez; Alicia,17,0,20,3
1713343141945,LISP 5B,A00,507671,Munoz Sanchez; Alicia,15,0,20,5
1713343142972,LISP 5C,A00,507696,Munoz Sanchez; Alicia,15,0,20,5
1713343144004,MAE 197,001,528363,Boechler; Nicholas Sebastia,9998,0,9999,1
1713343145037,MATH 197,001,523477,Kedlaya; Kiran S.,9999,0,9999,0
1713343145037,MATH 197,002,563811,Zhang; Danna,9999,0,9999,0
1713343146065,MCWP 40R,A00,518780,Staff,20,0,20,0
1713343146065,MCWP 40R,B00,518781,Staff,19,0,20,1
1713343146065,MCWP 40R,C00,518783,Staff,19,0,20,1
1713343147091,MCWP 50R,A00,518791,Staff,20,0,20,0
1713343147091,MCWP 50R,B00,518792,Staff,17,0,20,3
1713343147091,MCWP 50R,C00,518793,Staff,19,0,20,1
1713343147091,MCWP 50R,D00,518794,Staff,16,0,20,4
1713343147091,MCWP 50R,E00,518795,Staff,16,0,20,4
1713343147091,MCWP 50R,F00,518796,Staff,19,0,20,1
1713343147091,MCWP 50R,G00,518797,Staff,19,0,20,1
1713343148121,MMW 12R,A01,514034,Herbst; Matthew,15,0,16,1
1713343148121,MMW 12R,A02,514035,Herbst; Matthew,16,0,16,0
1713343149147,MMW 13R,A01,514037,Staff,12,0,16,4
1713343149147,MMW 13R,A02,514039,Staff,16,0,16,0
1713343151206,SIO 295LS,A00,523233,Staff,18,0,30,12
1713343152231,SIO 295S,A00,523232,Staff,18,0,30,12
1713343153257,SOCI 117,A01,494376,Staff,1,0,5,4
1713343154283,WES 237B,A00,494380,Staff,19,0,20,1
1713343156368,AESE 279B,A00,494370,Wade; Jon P,33,0,33,0
1713343157421,ANAR 135S,A00,494369,Braswell; Geoffrey E.,0,0,0,0
1713343158453,CAT 124RS,A01,519847,Geibel; William,17,0,20,3
1713343159479,CAT 125RS,A01,515971,Geibel; William,17,0,20,3
1713343160506,CLRE 250,A00,511389,Morris; Sheldon,9996,0,9999,3
1713343161531,CLRE 251,A00,507176,Mehta; Ravindra L.,9996,0,9999,3
1713343161531,CLRE 251,B00,511410,Mehta; Ravindra L.,9998,0,9999,1
1713343162560,CLRE 252,A00,507189,Cuomo; Raphael Eduardo,9998,0,9999,1
1713343163590,CLRE 253,A00,507199,Vaida; Florin,9997,0,9999,2
1713343163590,CLRE 253,B00,507202,Vaida; Florin,9999,0,9999,0
1713343164621,CLRE 259,A00,507211,Patel; Hemal,9996,0,9999,3
1713343165646,CLRE 260,A00,507221,Cuomo; Raphael Eduardo,9999,0,9999,0
1713343166670,CLRE 297,001,507242,Cuomo; Raphael Eduardo,9999,0,9999,0
1713343167696,CSE 191,A00,516875,Minnes Kemp; Mor Mia,9999,0,9999,0
1713343168721,CSS 201S,A01,494383,Staff,35,0,35,0
1713343169750,CSS 202S,A01,494387,Staff,35,0,35,0
1713343170779,EAP 100,A00,516065,Staff,9792,0,9999,207
1713343171807,ECE 45,A01,507414,Staff,51,0,60,9
1713343172840,ECE 100,A01,507416,Baghdadchi; Saharnaz,10,0,20,10
1713343172840,ECE 100,A02,507418,Baghdadchi; Saharnaz,20,0,20,0
1713343173875,ECE 111,A01,507420,Staff,38,0,50,12
1713343174903,ECE 197,001,548057,Sievenpiper; Daniel F.,9998,0,9999,1
1713343175936,EDS 115,A00,507243,Choi; Bailey Miyeon,28,0,28,0
1713343176961,EDS 117,A01,494379,Staff,23,0,25,2
1713343177989,EDS 125,A00,507246,Hopkins; Megan Beth,29,0,30,1
1713343179016,EDS 128A,A01,507264,Fargason; Sharon Gayle,26,0,26,0
1713343180044,EDS 128B,A01,507293,Pappas; Elizabeth,30,0,30,0
1713343181069,EDS 139,A00,507294,Fargason; Sharon Gayle,30,0,30,0
1713343181069,EDS 139,B00,507313,Pappas; Elizabeth,30,0,30,0
1713343182094,EDS 201,A00,507315,Staff,26,0,30,4
1713343183122,EDS 203,A01,507317,Halter; Christopher P.,26,0,30,4
1713343184156,EDS 204R,A01,507319,Halter; Christopher P.,3,0,30,27
1713343184156,EDS 204R,B01,507331,Heinzman; Erica M.,28,0,30,2
1713343185181,EDS 206R,A00,507332,Staff,4,0,30,26
1713343185181,EDS 206R,B00,507343,Staff,28,0,30,2
1713343186212,EDS 250,A00,507344,Hemans; Patricia Ann Benitez,36,0,40,4
1713343187242,EDS 281,A00,507345,Daly; Alan J.,18,0,18,0
1713343188266,EDS 284,A00,507350,Daly; Alan J.,16,0,16,0
1713343189292,EDS 286,A00,507359,Fine; Sarah,18,0,18,0
1713343190324,EDS 289C,A01,507361,Daly; Alan J.,18,0,18,0
1713343191350,EDS 290,A00,507366,Hofstetter; Carolyn,15,0,15,0
1713343192387,LIGM 5A,A00,507421,Fischer-Grunski; Eva K,20,0,20,0
1713343193417,LIGM 5B,A00,507423,Fischer-Grunski; Eva K,20,0,20,0
1713343194442,LIGM 5C,A00,507425,Fischer-Grunski; Eva K,20,0,20,0
1713343195471,LIIT 5AS,A00,507427,Carnelos; Chiara,20,0,20,0
1713343196497,LIIT 5BS,A00,507430,Carnelos; Chiara,20,0,20,0
1713343197526,LIIT 5CS,A00,507432,Carnelos; Chiara,20,0,20,0
1713343198553,LISP 5A,A00,507541,Munoz Sanchez; Alicia,17,0,20,3
1713343199578,LISP 5B,A00,507671,Munoz Sanchez; Alicia,15,0,20,5
1713343200608,LISP 5C,A00,507696,Munoz Sanchez; Alicia,15,0,20,5
1713343201634,MAE 197,001,528363,Boechler; Nicholas Sebastia,9998,0,9999,1
1713343202667,MATH 197,001,523477,Kedlaya; Kiran S.,9999,0,9999,0
1713343202667,MATH 197,002,563811,Zhang; Danna,9999,0,9999,0
1713343203691,MCWP 40R,A00,518780,Staff,20,0,20,0
1713343203691,MCWP 40R,B00,518781,Staff,19,0,20,1
1713343203691,MCWP 40R,C00,518783,Staff,19,0,20,1
1713343204723,MCWP 50R,A00,518791,Staff,20,0,20,0
1713343204723,MCWP 50R,B00,518792,Staff,17,0,20,3
1713343204723,MCWP 50R,C00,518793,Staff,19,0,20,1
1713343204723,MCWP 50R,D00,518794,Staff,16,0,20,4
1713343204723,MCWP 50R,E00,518795,Staff,16,0,20,4
1713343204723,MCWP 50R,F00,518796,Staff,19,0,20,1
1713343204723,MCWP 50R,G00,518797,Staff,19,0,20,1
1713343205749,MMW 12R,A01,514034,Herbst; Matthew,15,0,16,1
1713343205749,MMW 12R,A02,514035,Herbst; Matthew,16,0,16,0
1713343206775,MMW 13R,A01,514037,Staff,12,0,16,4
1713343206775,MMW 13R,A02,514039,Staff,16,0,16,0
1713343208830,SIO 295LS,A00,523233,Staff,18,0,30,12
1713343209859,SIO 295S,A00,523232,Staff,18,0,30,12
1713343210885,SOCI 117,A01,494376,Staff,1,0,5,4
1713343211914,WES 237B,A00,494380,Staff,19,0,20,1
1713343213993,AESE 279B,A00,494370,Wade; Jon P,33,0,33,0
1713343215025,ANAR 135S,A00,494369,Braswell; Geoffrey E.,0,0,0,0
1713343216051,CAT 124RS,A01,519847,Geibel; William,17,0,20,3
1713343217081,CAT 125RS,A01,515971,Geibel; William,17,0,20,3
1713343218109,CLRE 250,A00,511389,Morris; Sheldon,9996,0,9999,3
1713343219137,CLRE 251,A00,507176,Mehta; Ravindra L.,9996,0,9999,3
1713343219137,CLRE 251,B00,511410,Mehta; Ravindra L.,9998,0,9999,1
1713343220164,CLRE 252,A00,507189,Cuomo; Raphael Eduardo,9998,0,9999,1
1713343221195,CLRE 253,A00,507199,Vaida; Florin,9997,0,9999,2
1713343221195,CLRE 253,B00,507202,Vaida; Florin,9999,0,9999,0
1713343222222,CLRE 259,A00,507211,Patel; Hemal,9996,0,9999,3
1713343223247,CLRE 260,A00,507221,Cuomo; Raphael Eduardo,9999,0,9999,0
1713343224272,CLRE 297,001,507242,Cuomo; Raphael Eduardo,9999,0,9999,0
1713343225302,CSE 191,A00,516875,Minnes Kemp; Mor Mia,9999,0,9999,0
1713343226328,CSS 201S,A01,494383,Staff,35,0,35,0
1713343227354,CSS 202S,A01,494387,Staff,35,0,35,0
1713343228382,EAP 100,A00,516065,Staff,9792,0,9999,207
1713343229414,ECE 45,A01,507414,Staff,51,0,60,9
1713343230445,ECE 100,A01,507416,Baghdadchi; Saharnaz,10,0,20,10
1713343230445,ECE 100,A02,507418,Baghdadchi; Saharnaz,20,0,20,0
1713343231473,ECE 111,A01,507420,Staff,38,0,50,12
1713343232500,ECE 197,001,548057,Sievenpiper; Daniel F.,9998,0,9999,1
1713343233531,EDS 115,A00,507243,Choi; Bailey Miyeon,28,0,28,0
1713343234558,EDS 117,A01,494379,Staff,23,0,25,2
1713343235589,EDS 125,A00,507246,Hopkins; Megan Beth,29,0,30,1
1713343236616,EDS 128A,A01,507264,Fargason; Sharon Gayle,26,0,26,0
1713343237695,EDS 128B,A01,507293,Pappas; Elizabeth,30,0,30,0
1713343238721,EDS 139,A00,507294,Fargason; Sharon Gayle,30,0,30,0
1713343238721,EDS 139,B00,507313,Pappas; Elizabeth,30,0,30,0
1713343239749,EDS 201,A00,507315,Staff,26,0,30,4
1713343240781,EDS 203,A01,507317,Halter; Christopher P.,26,0,30,4
1713343241809,EDS 204R,A01,507319,Halter; Christopher P.,3,0,30,27
1713343241809,EDS 204R,B01,507331,Heinzman; Erica M.,28,0,30,2
1713343242839,EDS 206R,A00,507332,Staff,4,0,30,26
1713343242839,EDS 206R,B00,507343,Staff,28,0,30,2
1713343243867,EDS 250,A00,507344,Hemans; Patricia Ann Benitez,36,0,40,4
1713343244894,EDS 281,A00,507345,Daly; Alan J.,18,0,18,0
1713343245920,EDS 284,A00,507350,Daly; Alan J.,16,0,16,0
1713343246945,EDS 286,A00,507359,Fine; Sarah,18,0,18,0
1713343247976,EDS 289C,A01,507361,Daly; Alan J.,18,0,18,0
1713343249011,EDS 290,A00,507366,Hofstetter; Carolyn,15,0,15,0
1713343250037,LIGM 5A,A00,507421,Fischer-Grunski; Eva K,20,0,20,0
1713343251066,LIGM 5B,A00,507423,Fischer-Grunski; Eva K,20,0,20,0
1713343252092,LIGM 5C,A00,507425,Fischer-Grunski; Eva K,20,0,20,0
1713343253123,LIIT 5AS,A00,507427,Carnelos; Chiara,20,0,20,0
1713343254149,LIIT 5BS,A00,507430,Carnelos; Chiara,20,0,20,0
1713343255174,LIIT 5CS,A00,507432,Carnelos; Chiara,20,0,20,0
1713343256200,LISP 5A,A00,507541,Munoz Sanchez; Alicia,17,0,20,3
1713343257224,LISP 5B,A00,507671,Munoz Sanchez; Alicia,15,0,20,5
1713343258248,LISP 5C,A00,507696,Munoz Sanchez; Alicia,15,0,20,5
1713343259275,MAE 197,001,528363,Boechler; Nicholas Sebastia,9998,0,9999,1
1713343260301,MATH 197,001,523477,Kedlaya; Kiran S.,9999,0,9999,0
1713343260301,MATH 197,002,563811,Zhang; Danna,9999,0,9999,0
1713343261332,MCWP 40R,A00,518780,Staff,20,0,20,0
1713343261332,MCWP 40R,B00,518781,Staff,19,0,20,1
1713343261332,MCWP 40R,C00,518783,Staff,19,0,20,1
1713343262362,MCWP 50R,A00,518791,Staff,20,0,20,0
1713343262362,MCWP 50R,B00,518792,Staff,17,0,20,3
1713343262362,MCWP 50R,C00,518793,Staff,19,0,20,1
1713343262362,MCWP 50R,D00,518794,Staff,16,0,20,4
1713343262362,MCWP 50R,E00,518795,Staff,16,0,20,4
1713343262362,MCWP 50R,F00,518796,Staff,19,0,20,1
1713343262362,MCWP 50R,G00,518797,Staff,19,0,20,1
1713343263388,MMW 12R,A01,514034,Herbst; Matthew,15,0,16,1
1713343263388,MMW 12R,A02,514035,Herbst; Matthew,16,0,16,0
1713343264414,MMW 13R,A01,514037,Staff,12,0,16,4
1713343264414,MMW 13R,A02,514039,Staff,16,0,16,0
1713343266468,SIO 295LS,A00,523233,Staff,18,0,30,12
1713343267499,SIO 295S,A00,523232,Staff,18,0,30,12
1713343268526,SOCI 117,A01,494376,Staff,1,0,5,4
1713343269553,WES 237B,A00,494380,Staff,19,0,20,1
1713343271622,AESE 279B,A00,494370,Wade; Jon P,33,0,33,0
1713343272648,ANAR 135S,A00,494369,Braswell; Geoffrey E.,0,0,0,0
1713343273675,CAT 124RS,A01,519847,Geibel; William,17,0,20,3
1713343274701,CAT 125RS,A01,515971,Geibel; William,17,0,20,3
1713343275728,CLRE 250,A00,511389,Morris; Sheldon,9996,0,9999,3
1713343276767,CLRE 251,A00,507176,Mehta; Ravindra L.,9996,0,9999,3
1713343276767,CLRE 251,B00,511410,Mehta; Ravindra L.,9998,0,9999,1
1713343277801,CLRE 252,A00,507189,Cuomo; Raphael Eduardo,9998,0,9999,1
1713343278834,CLRE 253,A00,507199,Vaida; Florin,9997,0,9999,2
1713343278834,CLRE 253,B00,507202,Vaida; Florin,9999,0,9999,0
1713343279860,CLRE 259,A00,507211,Patel; Hemal,9996,0,9999,3
1713343280890,CLRE 260,A00,507221,Cuomo; Raphael Eduardo,9999,0,9999,0
1713343281922,CLRE 297,001,507242,Cuomo; Raphael Eduardo,9999,0,9999,0
1713343282951,CSE 191,A00,516875,Minnes Kemp; Mor Mia,9999,0,9999,0
1713343283979,CSS 201S,A01,494383,Staff,35,0,35,0
1713343285011,CSS 202S,A01,494387,Staff,35,0,35,0
1713343286037,EAP 100,A00,516065,Staff,9792,0,9999,207
1713343287063,ECE 45,A01,507414,Staff,51,0,60,9
1713343288089,ECE 100,A01,507416,Baghdadchi; Saharnaz,10,0,20,10
1713343288089,ECE 100,A02,507418,Baghdadchi; Saharnaz,20,0,20,0
1713343289120,ECE 111,A01,507420,Staff,38,0,50,12
1713343290150,ECE 197,001,548057,Sievenpiper; Daniel F.,9998,0,9999,1
1713343291181,EDS 115,A00,507243,Choi; Bailey Miyeon,28,0,28,0
1713343292212,EDS 117,A01,494379,Staff,23,0,25,2
1713343293239,EDS 125,A00,507246,Hopkins; Megan Beth,29,0,30,1
1713343294265,EDS 128A,A01,507264,Fargason; Sharon Gayle,26,0,26,0
1713343295296,EDS 128B,A01,507293,Pappas; Elizabeth,30,0,30,0
1713343296321,EDS 139,A00,507294,Fargason; Sharon Gayle,30,0,30,0
1713343296321,EDS 139,B00,507313,Pappas; Elizabeth,30,0,30,0
1713343297349,EDS 201,A00,507315,Staff,26,0,30,4
1713343298381,EDS 203,A01,507317,Halter; Christopher P.,26,0,30,4
1713343299406,EDS 204R,A01,507319,Halter; Christopher P.,3,0,30,27
1713343299406,EDS 204R,B01,507331,Heinzman; Erica M.,28,0,30,2
1713343300435,EDS 206R,A00,507332,Staff,4,0,30,26
1713343300435,EDS 206R,B00,507343,Staff,28,0,30,2
1713343301462,EDS 250,A00,507344,Hemans; Patricia Ann Benitez,36,0,40,4
1713343302492,EDS 281,A00,507345,Daly; Alan J.,18,0,18,0
1713343303516,EDS 284,A00,507350,Daly; Alan J.,16,0,16,0
1713343304544,EDS 286,A00,507359,Fine; Sarah,18,0,18,0
1713343305568,EDS 289C,A01,507361,Daly; Alan J.,18,0,18,0
1713343306594,EDS 290,A00,507366,Hofstetter; Carolyn,15,0,15,0
1713343307622,LIGM 5A,A00,507421,Fischer-Grunski; Eva K,20,0,20,0
1713343308647,LIGM 5B,A00,507423,Fischer-Grunski; Eva K,20,0,20,0
1713343309673,LIGM 5C,A00,507425,Fischer-Grunski; Eva K,20,0,20,0
1713343310699,LIIT 5AS,A00,507427,Carnelos; Chiara,20,0,20,0
1713343311731,LIIT 5BS,A00,507430,Carnelos; Chiara,20,0,20,0
1713343312756,LIIT 5CS,A00,507432,Carnelos; Chiara,20,0,20,0
1713343313784,LISP 5A,A00,507541,Munoz Sanchez; Alicia,17,0,20,3
1713343314817,LISP 5B,A00,507671,Munoz Sanchez; Alicia,15,0,20,5
1713343315842,LISP 5C,A00,507696,Munoz Sanchez; Alicia,15,0,20,5
1713343316873,MAE 197,001,528363,Boechler; Nicholas Sebastia,9998,0,9999,1
1713343317900,MATH 197,001,523477,Kedlaya; Kiran S.,9999,0,9999,0
1713343317900,MATH 197,002,563811,Zhang; Danna,9999,0,9999,0
1713343318930,MCWP 40R,A00,518780,Staff,20,0,20,0
1713343318930,MCWP 40R,B00,518781,Staff,19,0,20,1
1713343318930,MCWP 40R,C00,518783,Staff,19,0,20,1
1713343319955,MCWP 50R,A00,518791,Staff,20,0,20,0
1713343319955,MCWP 50R,B00,518792,Staff,17,0,20,3
1713343319955,MCWP 50R,C00,518793,Staff,19,0,20,1
1713343319955,MCWP 50R,D00,518794,Staff,16,0,20,4
1713343319955,MCWP 50R,E00,518795,Staff,16,0,20,4
1713343319955,MCWP 50R,F00,518796,Staff,19,0,20,1
1713343319955,MCWP 50R,G00,518797,Staff,19,0,20,1
1713343320982,MMW 12R,A01,514034,Herbst; Matthew,15,0,16,1
1713343320982,MMW 12R,A02,514035,Herbst; Matthew,16,0,16,0
1713343322008,MMW 13R,A01,514037,Staff,12,0,16,4
1713343322008,MMW 13R,A02,514039,Staff,16,0,16,0
1713343324060,SIO 295LS,A00,523233,Staff,18,0,30,12
1713343325087,SIO 295S,A00,523232,Staff,18,0,30,12
1713343326119,SOCI 117,A01,494376,Staff,1,0,5,4
1713343327144,WES 237B,A00,494380,Staff,19,0,20,1
1713343329222,AESE 279B,A00,494370,Wade; Jon P,33,0,33,0
1713343330247,ANAR 135S,A00,494369,Braswell; Geoffrey E.,0,0,0,0
1713343331279,CAT 124RS,A01,519847,Geibel; William,17,0,20,3
1713343332303,CAT 125RS,A01,515971,Geibel; William,17,0,20,3
1713343333330,CLRE 250,A00,511389,Morris; Sheldon,9996,0,9999,3
1713343334357,CLRE 251,A00,507176,Mehta; Ravindra L.,9996,0,9999,3
1713343334357,CLRE 251,B00,511410,Mehta; Ravindra L.,9998,0,9999,1
1713343335382,CLRE 252,A00,507189,Cuomo; Raphael Eduardo,9998,0,9999,1
1713343336413,CLRE 253,A00,507199,Vaida; Florin,9997,0,9999,2
1713343336413,CLRE 253,B00,507202,Vaida; Florin,9999,0,9999,0
1713343337438,CLRE 259,A00,507211,Patel; Hemal,9996,0,9999,3
1713343338464,CLRE 260,A00,507221,Cuomo; Raphael Eduardo,9999,0,9999,0
1713343339490,CLRE 297,001,507242,Cuomo; Raphael Eduardo,9999,0,9999,0
1713343340516,CSE 191,A00,516875,Minnes Kemp; Mor Mia,9999,0,9999,0
1713343341598,CSS 201S,A01,494383,Staff,35,0,35,0
1713343342629,CSS 202S,A01,494387,Staff,35,0,35,0
1713343343656,EAP 100,A00,516065,Staff,9792,0,9999,207
1713343344682,ECE 45,A01,507414,Staff,51,0,60,9
1713343345713,ECE 100,A01,507416,Baghdadchi; Saharnaz,10,0,20,10
1713343345713,ECE 100,A02,507418,Baghdadchi; Saharnaz,20,0,20,0
1713343346739,ECE 111,A01,507420,Staff,38,0,50,12
1713343347768,ECE 197,001,548057,Sievenpiper; Daniel F.,9998,0,9999,1
1713343348794,EDS 115,A00,507243,Choi; Bailey Miyeon,28,0,28,0
1713343349826,EDS 117,A01,494379,Staff,23,0,25,2
1713343350856,EDS 125,A00,507246,Hopkins; Megan Beth,29,0,30,1
1713343351881,EDS 128A,A01,507264,Fargason; Sharon Gayle,26,0,26,0
1713343352924,EDS 128B,A01,507293,Pappas; Elizabeth,30,0,30,0
1713343353950,EDS 139,A00,507294,Fargason; Sharon Gayle,30,0,30,0
1713343353950,EDS 139,B00,507313,Pappas; Elizabeth,30,0,30,0
1713343354977,EDS 201,A00,507315,Staff,26,0,30,4
1713343356011,EDS 203,A01,507317,Halter; Christopher P.,26,0,30,4
1713343357044,EDS 204R,A01,507319,Halter; Christopher P.,3,0,30,27
1713343357044,EDS 204R,B01,507331,Heinzman; Erica M.,28,0,30,2
1713343358073,EDS 206R,A00,507332,Staff,4,0,30,26
1713343358073,EDS 206R,B00,507343,Staff,28,0,30,2
1713343359098,EDS 250,A00,507344,Hemans; Patricia Ann Benitez,36,0,40,4
1713343360125,EDS 281,A00,507345,Daly; Alan J.,18,0,18,0
1713343361151,EDS 284,A00,507350,Daly; Alan J.,16,0,16,0
1713343362185,EDS 286,A00,507359,Fine; Sarah,18,0,18,0
1713343363215,EDS 289C,A01,507361,Daly; Alan J.,18,0,18,0
1713343364241,EDS 290,A00,507366,Hofstetter; Carolyn,15,0,15,0
1713343365269,LIGM 5A,A00,507421,Fischer-Grunski; Eva K,20,0,20,0
1713343366297,LIGM 5B,A00,507423,Fischer-Grunski; Eva K,20,0,20,0
1713343367327,LIGM 5C,A00,507425,Fischer-Grunski; Eva K,20,0,20,0
1713343368353,LIIT 5AS,A00,507427,Carnelos; Chiara,20,0,20,0
1713343369379,LIIT 5BS,A00,507430,Carnelos; Chiara,20,0,20,0
1713343370405,LIIT 5CS,A00,507432,Carnelos; Chiara,20,0,20,0
1713343371437,LISP 5A,A00,507541,Munoz Sanchez; Alicia,17,0,20,3
1713343372467,LISP 5B,A00,507671,Munoz Sanchez; Alicia,15,0,20,5
1713343373494,LISP 5C,A00,507696,Munoz Sanchez; Alicia,15,0,20,5
1713343374520,MAE 197,001,528363,Boechler; Nicholas Sebastia,9998,0,9999,1
1713343375555,MATH 197,001,523477,Kedlaya; Kiran S.,9999,0,9999,0
1713343375555,MATH 197,002,563811,Zhang; Danna,9999,0,9999,0
1713343376581,MCWP 40R,A00,518780,Staff,20,0,20,0
1713343376581,MCWP 40R,B00,518781,Staff,19,0,20,1
1713343376581,MCWP 40R,C00,518783,Staff,19,0,20,1
1713343377609,MCWP 50R,A00,518791,Staff,20,0,20,0
1713343377609,MCWP 50R,B00,518792,Staff,17,0,20,3
1713343377609,MCWP 50R,C00,518793,Staff,19,0,20,1
1713343377609,MCWP 50R,D00,518794,Staff,16,0,20,4
1713343377609,MCWP 50R,E00,518795,Staff,16,0,20,4
1713343377609,MCWP 50R,F00,518796,Staff,19,0,20,1
1713343377609,MCWP 50R,G00,518797,Staff,19,0,20,1
1713343378640,MMW 12R,A01,514034,Herbst; Matthew,15,0,16,1
1713343378640,MMW 12R,A02,514035,Herbst; Matthew,16,0,16,0
1713343379666,MMW 13R,A01,514037,Staff,12,0,16,4
1713343379666,MMW 13R,A02,514039,Staff,16,0,16,0
1713343381723,SIO 295LS,A00,523233,Staff,18,0,30,12
1713343382754,SIO 295S,A00,523232,Staff,18,0,30,12
1713343383785,SOCI 117,A01,494376,Staff,1,0,5,4
1713343384810,WES 237B,A00,494380,Staff,19,0,20,1
1713343386876,AESE 279B,A00,494370,Wade; Jon P,33,0,33,0
1713343387902,ANAR 135S,A00,494369,Braswell; Geoffrey E.,0,0,0,0
1713343388931,CAT 124RS,A01,519847,Geibel; William,17,0,20,3
1713343389960,CAT 125RS,A01,515971,Geibel; William,17,0,20,3
1713343390987,CLRE 250,A00,511389,Morris; Sheldon,9996,0,9999,3
1713343392014,CLRE 251,A00,507176,Mehta; Ravindra L.,9996,0,9999,3
1713343392014,CLRE 251,B00,511410,Mehta; Ravindra L.,9998,0,9999,1
1713343393041,CLRE 252,A00,507189,Cuomo; Raphael Eduardo,9998,0,9999,1
1713343394067,CLRE 253,A00,507199,Vaida; Florin,9997,0,9999,2
1713343394067,CLRE 253,B00,507202,Vaida; Florin,9999,0,9999,0
1713343395094,CLRE 259,A00,507211,Patel; Hemal,9996,0,9999,3
1713343396118,CLRE 260,A00,507221,Cuomo; Raphael Eduardo,9999,0,9999,0
1713343397148,CLRE 297,001,507242,Cuomo; Raphael Eduardo,9999,0,9999,0
1713343398173,CSE 191,A00,516875,Minnes Kemp; Mor Mia,9999,0,9999,0
1713343399199,CSS 201S,A01,494383,Staff,35,0,35,0
1713343400225,CSS 202S,A01,494387,Staff,35,0,35,0
1713343401255,EAP 100,A00,516065,Staff,9792,0,9999,207
1713343402281,ECE 45,A01,507414,Staff,51,0,60,9
1713343403306,ECE 100,A01,507416,Baghdadchi; Saharnaz,10,0,20,10
1713343403306,ECE 100,A02,507418,Baghdadchi; Saharnaz,20,0,20,0
1713343404336,ECE 111,A01,507420,Staff,38,0,50,12
1713343405362,ECE 197,001,548057,Sievenpiper; Daniel F.,9998,0,9999,1
1713343406388,EDS 115,A00,507243,Choi; Bailey Miyeon,28,0,28,0
1713343407416,EDS 117,A01,494379,Staff,23,0,25,2
1713343408442,EDS 125,A00,507246,Hopkins; Megan Beth,29,0,30,1
1713343409468,EDS 128A,A01,507264,Fargason; Sharon Gayle,26,0,26,0
1713343410494,EDS 128B,A01,507293,Pappas; Elizabeth,30,0,30,0
1713343411523,EDS 139,A00,507294,Fargason; Sharon Gayle,30,0,30,0
1713343411523,EDS 139,B00,507313,Pappas; Elizabeth,30,0,30,0
1713343412551,EDS 201,A00,507315,Staff,26,0,30,4
1713343413578,EDS 203,A01,507317,Halter; Christopher P.,26,0,30,4
1713343414609,EDS 204R,A01,507319,Halter; Christopher P.,3,0,30,27
1713343414609,EDS 204R,B01,507331,Heinzman; Erica M.,28,0,30,2
1713343415632,EDS 206R,A00,507332,Staff,4,0,30,26
1713343415632,EDS 206R,B00,507343,Staff,28,0,30,2
1713343416661,EDS 250,A00,507344,Hemans; Patricia Ann Benitez,36,0,40,4
1713343417692,EDS 281,A00,507345,Daly; Alan J.,18,0,18,0
1713343418715,EDS 284,A00,507350,Daly; Alan J.,16,0,16,0
1713343419741,EDS 286,A00,507359,Fine; Sarah,18,0,18,0
1713343420767,EDS 289C,A01,507361,Daly; Alan J.,18,0,18,0
1713343421795,EDS 290,A00,507366,Hofstetter; Carolyn,15,0,15,0
1713343422828,LIGM 5A,A00,507421,Fischer-Grunski; Eva K,20,0,20,0
1713343423852,LIGM 5B,A00,507423,Fischer-Grunski; Eva K,20,0,20,0
1713343424882,LIGM 5C,A00,507425,Fischer-Grunski; Eva K,20,0,20,0
1713343425906,LIIT 5AS,A00,507427,Carnelos; Chiara,20,0,20,0
1713343426932,LIIT 5BS,A00,507430,Carnelos; Chiara,20,0,20,0
1713343427958,LIIT 5CS,A00,507432,Carnelos; Chiara,20,0,20,0
1713343428989,LISP 5A,A00,507541,Munoz Sanchez; Alicia,17,0,20,3
1713343430017,LISP 5B,A00,507671,Munoz Sanchez; Alicia,15,0,20,5
1713343431042,LISP 5C,A00,507696,Munoz Sanchez; Alicia,15,0,20,5
1713343432072,MAE 197,001,528363,Boechler; Nicholas Sebastia,9998,0,9999,1
1713343433098,MATH 197,001,523477,Kedlaya; Kiran S.,9999,0,9999,0
1713343433098,MATH 197,002,563811,Zhang; Danna,9999,0,9999,0
1713343434128,MCWP 40R,A00,518780,Staff,20,0,20,0
1713343434128,MCWP 40R,B00,518781,Staff,19,0,20,1
1713343434128,MCWP 40R,C00,518783,Staff,19,0,20,1
1713343435154,MCWP 50R,A00,518791,Staff,20,0,20,0
1713343435154,MCWP 50R,B00,518792,Staff,17,0,20,3
1713343435154,MCWP 50R,C00,518793,Staff,19,0,20,1
1713343435154,MCWP 50R,D00,518794,Staff,16,0,20,4
1713343435154,MCWP 50R,E00,518795,Staff,16,0,20,4
1713343435154,MCWP 50R,F00,518796,Staff,19,0,20,1
1713343435154,MCWP 50R,G00,518797,Staff,19,0,20,1
1713343436184,MMW 12R,A01,514034,Herbst; Matthew,15,0,16,1
1713343436184,MMW 12R,A02,514035,Herbst; Matthew,16,0,16,0
1713343437210,MMW 13R,A01,514037,Staff,12,0,16,4
1713343437210,MMW 13R,A02,514039,Staff,16,0,16,0
1713343439265,SIO 295LS,A00,523233,Staff,18,0,30,12
1713343440291,SIO 295S,A00,523232,Staff,18,0,30,12
1713343441318,SOCI 117,A01,494376,Staff,1,0,5,4
1713343442349,WES 237B,A00,494380,Staff,19,0,20,1
1713343444432,AESE 279B,A00,494370,Wade; Jon P,33,0,33,0
1713343445512,ANAR 135S,A00,494369,Braswell; Geoffrey E.,0,0,0,0
1713343446537,CAT 124RS,A01,519847,Geibel; William,17,0,20,3
1713343447564,CAT 125RS,A01,515971,Geibel; William,17,0,20,3
1713343448591,CLRE 250,A00,511389,Morris; Sheldon,9996,0,9999,3
1713343449625,CLRE 251,A00,507176,Mehta; Ravindra L.,9996,0,9999,3
1713343449625,CLRE 251,B00,511410,Mehta; Ravindra L.,9998,0,9999,1
1713343450659,CLRE 252,A00,507189,Cuomo; Raphael Eduardo,9998,0,9999,1
1713343451686,CLRE 253,A00,507199,Vaida; Florin,9997,0,9999,2
1713343451686,CLRE 253,B00,507202,Vaida; Florin,9999,0,9999,0
1713343452711,CLRE 259,A00,507211,Patel; Hemal,9996,0,9999,3
1713343453738,CLRE 260,A00,507221,Cuomo; Raphael Eduardo,9999,0,9999,0
1713343454766,CLRE 297,001,507242,Cuomo; Raphael Eduardo,9999,0,9999,0
1713343455795,CSE 191,A00,516875,Minnes Kemp; Mor Mia,9999,0,9999,0
1713343456826,CSS 201S,A01,494383,Staff,35,0,35,0
1713343457852,CSS 202S,A01,494387,Staff,35,0,35,0
1713343458877,EAP 100,A00,516065,Staff,9792,0,9999,207
1713343459907,ECE 45,A01,507414,Staff,51,0,60,9
1713343460944,ECE 100,A01,507416,Baghdadchi; Saharnaz,10,0,20,10
1713343460944,ECE 100,A02,507418,Baghdadchi; Saharnaz,20,0,20,0
1713343461992,ECE 111,A01,507420,Staff,38,0,50,12
1713343463022,ECE 197,001,548057,Sievenpiper; Daniel F.,9998,0,9999,1
1713343464055,EDS 115,A00,507243,Choi; Bailey Miyeon,28,0,28,0
1713343465086,EDS 117,A01,494379,Staff,23,0,25,2
1713343466120,EDS 125,A00,507246,Hopkins; Megan Beth,29,0,30,1
1713343467147,EDS 128A,A01,507264,Fargason; Sharon Gayle,26,0,26,0
1713343468173,EDS 128B,A01,507293,Pappas; Elizabeth,30,0,30,0
1713343469199,EDS 139,A00,507294,Fargason; Sharon Gayle,30,0,30,0
1713343469199,EDS 139,B00,507313,Pappas; Elizabeth,30,0,30,0
1713343470224,EDS 201,A00,507315,Staff,26,0,30,4
1713343471251,EDS 203,A01,507317,Halter; Christopher P.,26,0,30,4
1713343472282,EDS 204R,A01,507319,Halter; Christopher P.,3,0,30,27
1713343472282,EDS 204R,B01,507331,Heinzman; Erica M.,28,0,30,2
1713343473310,EDS 206R,A00,507332,Staff,4,0,30,26
1713343473310,EDS 206R,B00,507343,Staff,28,0,30,2
1713343474337,EDS 250,A00,507344,Hemans; Patricia Ann Benitez,36,0,40,4
1713343475366,EDS 281,A00,507345,Daly; Alan J.,18,0,18,0
1713343476396,EDS 284,A00,507350,Daly; Alan J.,16,0,16,0
1713343477422,EDS 286,A00,507359,Fine; Sarah,18,0,18,0
1713343478448,EDS 289C,A01,507361,Daly; Alan J.,18,0,18,0
1713343479473,EDS 290,A00,507366,Hofstetter; Carolyn,15,0,15,0
1713343480500,LIGM 5A,A00,507421,Fischer-Grunski; Eva K,20,0,20,0
1713343481530,LIGM 5B,A00,507423,Fischer-Grunski; Eva K,20,0,20,0
1713343482556,LIGM 5C,A00,507425,Fischer-Grunski; Eva K,20,0,20,0
1713343483589,LIIT 5AS,A00,507427,Carnelos; Chiara,20,0,20,0
1713343484620,LIIT 5BS,A00,507430,Carnelos; Chiara,20,0,20,0
1713343485645,LIIT 5CS,A00,507432,Carnelos; Chiara,20,0,20,0
1713343486672,LISP 5A,A00,507541,Munoz Sanchez; Alicia,17,0,20,3
1713343487697,LISP 5B,A00,507671,Munoz Sanchez; Alicia,15,0,20,5
1713343488723,LISP 5C,A00,507696,Munoz Sanchez; Alicia,15,0,20,5
1713343489749,MAE 197,001,528363,Boechler; Nicholas Sebastia,9998,0,9999,1
1713343490775,MATH 197,001,523477,Kedlaya; Kiran S.,9999,0,9999,0
1713343490775,MATH 197,002,563811,Zhang; Danna,9999,0,9999,0
1713343491802,MCWP 40R,A00,518780,Staff,20,0,20,0
1713343491802,MCWP 40R,B00,518781,Staff,19,0,20,1
1713343491802,MCWP 40R,C00,518783,Staff,19,0,20,1
1713343492832,MCWP 50R,A00,518791,Staff,20,0,20,0
1713343492832,MCWP 50R,B00,518792,Staff,17,0,20,3
1713343492832,MCWP 50R,C00,518793,Staff,19,0,20,1
1713343492832,MCWP 50R,D00,518794,Staff,16,0,20,4
1713343492832,MCWP 50R,E00,518795,Staff,16,0,20,4
1713343492832,MCWP 50R,F00,518796,Staff,19,0,20,1
1713343492832,MCWP 50R,G00,518797,Staff,19,0,20,1
1713343493859,MMW 12R,A01,514034,Herbst; Matthew,15,0,16,1
1713343493859,MMW 12R,A02,514035,Herbst; Matthew,16,0,16,0
1713343494888,MMW 13R,A01,514037,Staff,12,0,16,4
1713343494888,MMW 13R,A02,514039,Staff,16,0,16,0
1713343496944,SIO 295LS,A00,523233,Staff,18,0,30,12
1713343497969,SIO 295S,A00,523232,Staff,18,0,30,12
1713343498996,SOCI 117,A01,494376,Staff,1,0,5,4
1713343500023,WES 237B,A00,494380,Staff,19,0,20,1
1713343502088,AESE 279B,A00,494370,Wade; Jon P,33,0,33,0
1713343503113,ANAR 135S,A00,494369,Braswell; Geoffrey E.,0,0,0,0
1713343504144,CAT 124RS,A01,519847,Geibel; William,17,0,20,3
1713343505173,CAT 125RS,A01,515971,Geibel; William,17,0,20,3
1713343506205,CLRE 250,A00,511389,Morris; Sheldon,9996,0,9999,3
1713343507234,CLRE 251,A00,507176,Mehta; Ravindra L.,9996,0,9999,3
1713343507234,CLRE 251,B00,511410,Mehta; Ravindra L.,9998,0,9999,1
1713343508260,CLRE 252,A00,507189,Cuomo; Raphael Eduardo,9998,0,9999,1
1713343509291,CLRE 253,A00,507199,Vaida; Florin,9997,0,9999,2
1713343509291,CLRE 253,B00,507202,Vaida; Florin,9999,0,9999,0
1713343510322,CLRE 259,A00,507211,Patel; Hemal,9996,0,9999,3
1713343511347,CLRE 260,A00,507221,Cuomo; Raphael Eduardo,9999,0,9999,0
1713343512373,CLRE 297,001,507242,Cuomo; Raphael Eduardo,9999,0,9999,0
1713343513399,CSE 191,A00,516875,Minnes Kemp; Mor Mia,9999,0,9999,0
1713343514426,CSS 201S,A01,494383,Staff,35,0,35,0
1713343515452,CSS 202S,A01,494387,Staff,35,0,35,0
1713343516476,EAP 100,A00,516065,Staff,9792,0,9999,207
1713343517502,ECE 45,A01,507414,Staff,51,0,60,9
1713343518533,ECE 100,A01,507416,Baghdadchi; Saharnaz,10,0,20,10
1713343518533,ECE 100,A02,507418,Baghdadchi; Saharnaz,20,0,20,0
1713343519558,ECE 111,A01,507420,Staff,38,0,50,12
1713343520585,ECE 197,001,548057,Sievenpiper; Daniel F.,9998,0,9999,1
1713343521611,EDS 115,A00,507243,Choi; Bailey Miyeon,28,0,28,0
1713343522636,EDS 117,A01,494379,Staff,23,0,25,2
1713343523669,EDS 125,A00,507246,Hopkins; Megan Beth,29,0,30,1
1713343524695,EDS 128A,A01,507264,Fargason; Sharon Gayle,26,0,26,0
1713343525728,EDS 128B,A01,507293,Pappas; Elizabeth,30,0,30,0
1713343526758,EDS 139,A00,507294,Fargason; Sharon Gayle,30,0,30,0
1713343526758,EDS 139,B00,507313,Pappas; Elizabeth,30,0,30,0
1713343527788,EDS 201,A00,507315,Staff,26,0,30,4
1713343528816,EDS 203,A01,507317,Halter; Christopher P.,26,0,30,4
1713343529847,EDS 204R,A01,507319,Halter; Christopher P.,3,0,30,27
1713343529847,EDS 204R,B01,507331,Heinzman; Erica M.,28,0,30,2
1713343530874,EDS 206R,A00,507332,Staff,4,0,30,26
1713343530874,EDS 206R,B00,507343,Staff,28,0,30,2
1713343531901,EDS 250,A00,507344,Hemans; Patricia Ann Benitez,36,0,40,4
1713343532926,EDS 281,A00,507345,Daly; Alan J.,18,0,18,0
1713343533952,EDS 284,A00,507350,Daly; Alan J.,16,0,16,0
1713343534978,EDS 286,A00,507359,Fine; Sarah,18,0,18,0
1713343536004,EDS 289C,A01,507361,Daly; Alan J.,18,0,18,0
1713343537030,EDS 290,A00,507366,Hofstetter; Carolyn,15,0,15,0
1713343538056,LIGM 5A,A00,507421,Fischer-Grunski; Eva K,20,0,20,0
1713343539082,LIGM 5B,A00,507423,Fischer-Grunski; Eva K,20,0,20,0
1713343540108,LIGM 5C,A00,507425,Fischer-Grunski; Eva K,20,0,20,0
1713343541139,LIIT 5AS,A00,507427,Carnelos; Chiara,20,0,20,0
1713343542168,LIIT 5BS,A00,507430,Carnelos; Chiara,20,0,20,0
1713343543194,LIIT 5CS,A00,507432,Carnelos; Chiara,20,0,20,0
1713343544220,LISP 5A,A00,507541,Munoz Sanchez; Alicia,17,0,20,3
1713343545247,LISP 5B,A00,507671,Munoz Sanchez; Alicia,15,0,20,5
1713343546273,LISP 5C,A00,507696,Munoz Sanchez; Alicia,15,0,20,5
1713343547299,MAE 197,001,528363,Boechler; Nicholas Sebastia,9998,0,9999,1
1713343548326,MATH 197,001,523477,Kedlaya; Kiran S.,9999,0,9999,0
1713343548326,MATH 197,002,563811,Zhang; Danna,9999,0,9999,0
1713343549408,MCWP 40R,A00,518780,Staff,20,0,20,0
1713343549408,MCWP 40R,B00,518781,Staff,19,0,20,1
1713343549408,MCWP 40R,C00,518783,Staff,19,0,20,1
1713343550434,MCWP 50R,A00,518791,Staff,20,0,20,0
1713343550434,MCWP 50R,B00,518792,Staff,17,0,20,3
1713343550434,MCWP 50R,C00,518793,Staff,19,0,20,1
1713343550434,MCWP 50R,D00,518794,Staff,16,0,20,4
1713343550434,MCWP 50R,E00,518795,Staff,16,0,20,4
1713343550434,MCWP 50R,F00,518796,Staff,19,0,20,1
1713343550434,MCWP 50R,G00,518797,Staff,19,0,20,1
1713343551460,MMW 12R,A01,514034,Herbst; Matthew,15,0,16,1
1713343551460,MMW 12R,A02,514035,Herbst; Matthew,16,0,16,0
1713343552489,MMW 13R,A01,514037,Staff,12,0,16,4
1713343552489,MMW 13R,A02,514039,Staff,16,0,16,0
1713343554548,SIO 295LS,A00,523233,Staff,18,0,30,12
1713343555574,SIO 295S,A00,523232,Staff,18,0,30,12
1713343556600,SOCI 117,A01,494376,Staff,1,0,5,4
1713343557631,WES 237B,A00,494380,Staff,19,0,20,1
1713343559717,AESE 279B,A00,494370,Wade; Jon P,33,0,33,0
1713343560748,ANAR 135S,A00,494369,Braswell; Geoffrey E.,0,0,0,0
1713343561774,CAT 124RS,A01,519847,Geibel; William,17,0,20,3
1713343562801,CAT 125RS,A01,515971,Geibel; William,17,0,20,3
1713343563832,CLRE 250,A00,511389,Morris; Sheldon,9996,0,9999,3
1713343564860,CLRE 251,A00,507176,Mehta; Ravindra L.,9996,0,9999,3
1713343564860,CLRE 251,B00,511410,Mehta; Ravindra L.,9998,0,9999,1
1713343565892,CLRE 252,A00,507189,Cuomo; Raphael Eduardo,9998,0,9999,1
1713343566918,CLRE 253,A00,507199,Vaida; Florin,9997,0,9999,2
1713343566918,CLRE 253,B00,507202,Vaida; Florin,9999,0,9999,0
1713343567944,CLRE 259,A00,507211,Patel; Hemal,9996,0,9999,3
1713343568969,CLRE 260,A00,507221,Cuomo; Raphael Eduardo,9999,0,9999,0
1713343569995,CLRE 297,001,507242,Cuomo; Raphael Eduardo,9999,0,9999,0
1713343571024,CSE 191,A00,516875,Minnes Kemp; Mor Mia,9999,0,9999,0
1713343572051,CSS 201S,A01,494383,Staff,35,0,35,0
1713343573077,CSS 202S,A01,494387,Staff,35,0,35,0
1713343574107,EAP 100,A00,516065,Staff,9792,0,9999,207
1713343575134,ECE 45,A01,507414,Staff,51,0,60,9
1713343576161,ECE 100,A01,507416,Baghdadchi; Saharnaz,10,0,20,10
1713343576161,ECE 100,A02,507418,Baghdadchi; Saharnaz,20,0,20,0
1713343577187,ECE 111,A01,507420,Staff,38,0,50,12
1713343578219,ECE 197,001,548057,Sievenpiper; Daniel F.,9998,0,9999,1
1713343579245,EDS 115,A00,507243,Choi; Bailey Miyeon,28,0,28,0
1713343580272,EDS 117,A01,494379,Staff,23,0,25,2
1713343581297,EDS 125,A00,507246,Hopkins; Megan Beth,29,0,30,1
1713343582323,EDS 128A,A01,507264,Fargason; Sharon Gayle,26,0,26,0
1713343583349,EDS 128B,A01,507293,Pappas; Elizabeth,30,0,30,0
1713343584375,EDS 139,A00,507294,Fargason; Sharon Gayle,30,0,30,0
1713343584375,EDS 139,B00,507313,Pappas; Elizabeth,30,0,30,0
1713343585404,EDS 201,A00,507315,Staff,26,0,30,4
1713343586429,EDS 203,A01,507317,Halter; Christopher P.,26,0,30,4
1713343587456,EDS 204R,A01,507319,Halter; Christopher P.,3,0,30,27
1713343587456,EDS 204R,B01,507331,Heinzman; Erica M.,28,0,30,2
1713343588481,EDS 206R,A00,507332,Staff,4,0,30,26
1713343588481,EDS 206R,B00,507343,Staff,28,0,30,2
1713343589512,EDS 250,A00,507344,Hemans; Patricia Ann Benitez,36,0,40,4
1713343590536,EDS 281,A00,507345,Daly; Alan J.,18,0,18,0
1713343591561,EDS 284,A00,507350,Daly; Alan J.,16,0,16,0
1713343592595,EDS 286,A00,507359,Fine; Sarah,18,0,18,0
1713343593620,EDS 289C,A01,507361,Daly; Alan J.,18,0,18,0
1713343594652,EDS 290,A00,507366,Hofstetter; Carolyn,15,0,15,0
1713343595687,LIGM 5A,A00,507421,Fischer-Grunski; Eva K,20,0,20,0
1713343596714,LIGM 5B,A00,507423,Fischer-Grunski; Eva K,20,0,20,0
1713343597740,LIGM 5C,A00,507425,Fischer-Grunski; Eva K,20,0,20,0
1713343598768,LIIT 5AS,A00,507427,Carnelos; Chiara,20,0,20,0
1713343599792,LIIT 5BS,A00,507430,Carnelos; Chiara,20,0,20,0
1713343600818,LIIT 5CS,A00,507432,Carnelos; Chiara,20,0,20,0
1713343601845,LISP 5A,A00,507541,Munoz Sanchez; Alicia,17,0,20,3
1713343602869,LISP 5B,A00,507671,Munoz Sanchez; Alicia,15,0,20,5
1713343603912,LISP 5C,A00,507696,Munoz Sanchez; Alicia,15,0,20,5
1713343604942,MAE 197,001,528363,Boechler; Nicholas Sebastia,9998,0,9999,1
1713343605973,MATH 197,001,523477,Kedlaya; Kiran S.,9999,0,9999,0
1713343605973,MATH 197,002,563811,Zhang; Danna,9999,0,9999,0
1713343607002,MCWP 40R,A00,518780,Staff,20,0,20,0
1713343607002,MCWP 40R,B00,518781,Staff,19,0,20,1
1713343607002,MCWP 40R,C00,518783,Staff,19,0,20,1
1713343608034,MCWP 50R,A00,518791,Staff,20,0,20,0
1713343608034,MCWP 50R,B00,518792,Staff,17,0,20,3
1713343608034,MCWP 50R,C00,518793,Staff,19,0,20,1
1713343608034,MCWP 50R,D00,518794,Staff,16,0,20,4
1713343608034,MCWP 50R,E00,518795,Staff,16,0,20,4
1713343608034,MCWP 50R,F00,518796,Staff,19,0,20,1
1713343608034,MCWP 50R,G00,518797,Staff,19,0,20,1
1713343609065,MMW 12R,A01,514034,Herbst; Matthew,15,0,16,1
1713343609065,MMW 12R,A02,514035,Herbst; Matthew,16,0,16,0
1713343610089,MMW 13R,A01,514037,Staff,12,0,16,4
1713343610089,MMW 13R,A02,514039,Staff,16,0,16,0
1713343612142,SIO 295LS,A00,523233,Staff,18,0,30,12
1713343613167,SIO 295S,A00,523232,Staff,18,0,30,12
1713343614198,SOCI 117,A01,494376,Staff,1,0,5,4
1713343615223,WES 237B,A00,494380,Staff,19,0,20,1
1713343617288,AESE 279B,A00,494370,Wade; Jon P,33,0,33,0
1713343618319,ANAR 135S,A00,494369,Braswell; Geoffrey E.,0,0,0,0
1713343619354,CAT 124RS,A01,519847,Geibel; William,17,0,20,3
1713343620378,CAT 125RS,A01,515971,Geibel; William,17,0,20,3
1713343621405,CLRE 250,A00,511389,Morris; Sheldon,9996,0,9999,3
1713343622432,CLRE 251,A00,507176,Mehta; Ravindra L.,9996,0,9999,3
1713343622432,CLRE 251,B00,511410,Mehta; Ravindra L.,9998,0,9999,1
1713343623457,CLRE 252,A00,507189,Cuomo; Raphael Eduardo,9998,0,9999,1
1713343624484,CLRE 253,A00,507199,Vaida; Florin,9997,0,9999,2
1713343624484,CLRE 253,B00,507202,Vaida; Florin,9999,0,9999,0
1713343625511,CLRE 259,A00,507211,Patel; Hemal,9996,0,9999,3
1713343626537,CLRE 260,A00,507221,Cuomo; Raphael Eduardo,9999,0,9999,0
1713343627562,CLRE 297,001,507242,Cuomo; Raphael Eduardo,9999,0,9999,0
1713343628587,CSE 191,A00,516875,Minnes Kemp; Mor Mia,9999,0,9999,0
1713343629614,CSS 201S,A01,494383,Staff,35,0,35,0
1713343630640,CSS 202S,A01,494387,Staff,35,0,35,0
1713343631673,EAP 100,A00,516065,Staff,9792,0,9999,207
1713343632768,ECE 45,A01,507414,Staff,51,0,60,9
1713343633804,ECE 100,A01,507416,Baghdadchi; Saharnaz,10,0,20,10
1713343633804,ECE 100,A02,507418,Baghdadchi; Saharnaz,20,0,20,0
1713343634830,ECE 111,A01,507420,Staff,38,0,50,12
1713343635862,ECE 197,001,548057,Sievenpiper; Daniel F.,9998,0,9999,1
1713343636896,EDS 115,A00,507243,Choi; Bailey Miyeon,28,0,28,0
1713343637926,EDS 117,A01,494379,Staff,23,0,25,2
1713343638961,EDS 125,A00,507246,Hopkins; Megan Beth,29,0,30,1
1713343639990,EDS 128A,A01,507264,Fargason; Sharon Gayle,26,0,26,0
1713343641018,EDS 128B,A01,507293,Pappas; Elizabeth,30,0,30,0
1713343642045,EDS 139,A00,507294,Fargason; Sharon Gayle,30,0,30,0
1713343642045,EDS 139,B00,507313,Pappas; Elizabeth,30,0,30,0
1713343643072,EDS 201,A00,507315,Staff,26,0,30,4
1713343644097,EDS 203,A01,507317,Halter; Christopher P.,26,0,30,4
1713343645124,EDS 204R,A01,507319,Halter; Christopher P.,3,0,30,27
1713343645124,EDS 204R,B01,507331,Heinzman; Erica M.,28,0,30,2
1713343646151,EDS 206R,A00,507332,Staff,4,0,30,26
1713343646151,EDS 206R,B00,507343,Staff,28,0,30,2
1713343647177,EDS 250,A00,507344,Hemans; Patricia Ann Benitez,36,0,40,4
1713343648202,EDS 281,A00,507345,Daly; Alan J.,18,0,18,0
1713343649231,EDS 284,A00,507350,Daly; Alan J.,16,0,16,0
1713343650257,EDS 286,A00,507359,Fine; Sarah,18,0,18,0
1713343651287,EDS 289C,A01,507361,Daly; Alan J.,18,0,18,0
1713343652314,EDS 290,A00,507366,Hofstetter; Carolyn,15,0,15,0
1713343653416,LIGM 5A,A00,507421,Fischer-Grunski; Eva K,20,0,20,0
1713343654446,LIGM 5B,A00,507423,Fischer-Grunski; Eva K,20,0,20,0
1713343655471,LIGM 5C,A00,507425,Fischer-Grunski; Eva K,20,0,20,0
1713343656496,LIIT 5AS,A00,507427,Carnelos; Chiara,20,0,20,0
1713343657527,LIIT 5BS,A00,507430,Carnelos; Chiara,20,0,20,0
1713343658553,LIIT 5CS,A00,507432,Carnelos; Chiara,20,0,20,0
1713343659579,LISP 5A,A00,507541,Munoz Sanchez; Alicia,17,0,20,3
1713343660609,LISP 5B,A00,507671,Munoz Sanchez; Alicia,15,0,20,5
1713343661636,LISP 5C,A00,507696,Munoz Sanchez; Alicia,15,0,20,5
1713343662670,MAE 197,001,528363,Boechler; Nicholas Sebastia,9998,0,9999,1
1713343663704,MATH 197,001,523477,Kedlaya; Kiran S.,9999,0,9999,0
1713343663704,MATH 197,002,563811,Zhang; Danna,9999,0,9999,0
1713343664731,MCWP 40R,A00,518780,Staff,20,0,20,0
1713343664731,MCWP 40R,B00,518781,Staff,19,0,20,1
1713343664731,MCWP 40R,C00,518783,Staff,19,0,20,1
1713343665757,MCWP 50R,A00,518791,Staff,20,0,20,0
1713343665757,MCWP 50R,B00,518792,Staff,17,0,20,3
1713343665757,MCWP 50R,C00,518793,Staff,19,0,20,1
1713343665757,MCWP 50R,D00,518794,Staff,16,0,20,4
1713343665757,MCWP 50R,E00,518795,Staff,16,0,20,4
1713343665757,MCWP 50R,F00,518796,Staff,19,0,20,1
1713343665757,MCWP 50R,G00,518797,Staff,19,0,20,1
1713343666787,MMW 12R,A01,514034,Herbst; Matthew,15,0,16,1
1713343666787,MMW 12R,A02,514035,Herbst; Matthew,16,0,16,0
1713343667817,MMW 13R,A01,514037,Staff,12,0,16,4
1713343667817,MMW 13R,A02,514039,Staff,16,0,16,0
1713343669868,SIO 295LS,A00,523233,Staff,18,0,30,12
1713343670892,SIO 295S,A00,523232,Staff,18,0,30,12
1713343671923,SOCI 117,A01,494376,Staff,1,0,5,4
1713343672955,WES 237B,A00,494380,Staff,19,0,20,1
1713343675038,AESE 279B,A00,494370,Wade; Jon P,33,0,33,0
1713343676063,ANAR 135S,A00,494369,Braswell; Geoffrey E.,0,0,0,0
1713343677089,CAT 124RS,A01,519847,Geibel; William,17,0,20,3
1713343678114,CAT 125RS,A01,515971,Geibel; William,17,0,20,3
1713343679147,CLRE 250,A00,511389,Morris; Sheldon,9996,0,9999,3
1713343680175,CLRE 251,A00,507176,Mehta; Ravindra L.,9996,0,9999,3
1713343680175,CLRE 251,B00,511410,Mehta; Ravindra L.,9998,0,9999,1
1713343681204,CLRE 252,A00,507189,Cuomo; Raphael Eduardo,9998,0,9999,1
1713343682229,CLRE 253,A00,507199,Vaida; Florin,9997,0,9999,2
1713343682229,CLRE 253,B00,507202,Vaida; Florin,9999,0,9999,0
1713343683263,CLRE 259,A00,507211,Patel; Hemal,9996,0,9999,3
1713343684288,CLRE 260,A00,507221,Cuomo; Raphael Eduardo,9999,0,9999,0
1713343685312,CLRE 297,001,507242,Cuomo; Raphael Eduardo,9999,0,9999,0
1713343686343,CSE 191,A00,516875,Minnes Kemp; Mor Mia,9999,0,9999,0
1713343687371,CSS 201S,A01,494383,Staff,35,0,35,0
1713343688400,CSS 202S,A01,494387,Staff,35,0,35,0
1713343689425,EAP 100,A00,516065,Staff,9792,0,9999,207
1713343690456,ECE 45,A01,507414,Staff,51,0,60,9
1713343691487,ECE 100,A01,507416,Baghdadchi; Saharnaz,10,0,20,10
1713343691487,ECE 100,A02,507418,Baghdadchi; Saharnaz,20,0,20,0
1713343692516,ECE 111,A01,507420,Staff,38,0,50,12
1713343693548,ECE 197,001,548057,Sievenpiper; Daniel F.,9998,0,9999,1
1713343694575,EDS 115,A00,507243,Choi; Bailey Miyeon,28,0,28,0
1713343695601,EDS 117,A01,494379,Staff,23,0,25,2
1713343696633,EDS 125,A00,507246,Hopkins; Megan Beth,29,0,30,1
1713343697660,EDS 128A,A01,507264,Fargason; Sharon Gayle,26,0,26,0
1713343698685,EDS 128B,A01,507293,Pappas; Elizabeth,30,0,30,0
1713343699714,EDS 139,A00,507294,Fargason; Sharon Gayle,30,0,30,0
1713343699714,EDS 139,B00,507313,Pappas; Elizabeth,30,0,30,0
1713343700742,EDS 201,A00,507315,Staff,26,0,30,4
1713343701768,EDS 203,A01,507317,Halter; Christopher P.,26,0,30,4
1713343702794,EDS 204R,A01,507319,Halter; Christopher P.,3,0,30,27
1713343702794,EDS 204R,B01,507331,Heinzman; Erica M.,28,0,30,2
1713343703823,EDS 206R,A00,507332,Staff,4,0,30,26
1713343703823,EDS 206R,B00,507343,Staff,28,0,30,2
1713343704848,EDS 250,A00,507344,Hemans; Patricia Ann Benitez,36,0,40,4
1713343705873,EDS 281,A00,507345,Daly; Alan J.,18,0,18,0
1713343706901,EDS 284,A00,507350,Daly; Alan J.,16,0,16,0
1713343707926,EDS 286,A00,507359,Fine; Sarah,18,0,18,0
1713343708950,EDS 289C,A01,507361,Daly; Alan J.,18,0,18,0
1713343709976,EDS 290,A00,507366,Hofstetter; Carolyn,15,0,15,0
1713343711002,LIGM 5A,A00,507421,Fischer-Grunski; Eva K,20,0,20,0
1713343712030,LIGM 5B,A00,507423,Fischer-Grunski; Eva K,20,0,20,0
1713343713058,LIGM 5C,A00,507425,Fischer-Grunski; Eva K,20,0,20,0
1713343714084,LIIT 5AS,A00,507427,Carnelos; Chiara,20,0,20,0
1713343715110,LIIT 5BS,A00,507430,Carnelos; Chiara,20,0,20,0
1713343716140,LIIT 5CS,A00,507432,Carnelos; Chiara,20,0,20,0
1713343717168,LISP 5A,A00,507541,Munoz Sanchez; Alicia,17,0,20,3
1713343718194,LISP 5B,A00,507671,Munoz Sanchez; Alicia,15,0,20,5
1713343719223,LISP 5C,A00,507696,Munoz Sanchez; Alicia,15,0,20,5
1713343720252,MAE 197,001,528363,Boechler; Nicholas Sebastia,9998,0,9999,1
1713343721280,MATH 197,001,523477,Kedlaya; Kiran S.,9999,0,9999,0
1713343721280,MATH 197,002,563811,Zhang; Danna,9999,0,9999,0
1713343722308,MCWP 40R,A00,518780,Staff,20,0,20,0
1713343722308,MCWP 40R,B00,518781,Staff,19,0,20,1
1713343722308,MCWP 40R,C00,518783,Staff,19,0,20,1
1713343723336,MCWP 50R,A00,518791,Staff,20,0,20,0
1713343723336,MCWP 50R,B00,518792,Staff,17,0,20,3
1713343723336,MCWP 50R,C00,518793,Staff,19,0,20,1
1713343723336,MCWP 50R,D00,518794,Staff,16,0,20,4
1713343723336,MCWP 50R,E00,518795,Staff,16,0,20,4
1713343723336,MCWP 50R,F00,518796,Staff,19,0,20,1
1713343723336,MCWP 50R,G00,518797,Staff,19,0,20,1
1713343724361,MMW 12R,A01,514034,Herbst; Matthew,15,0,16,1
1713343724361,MMW 12R,A02,514035,Herbst; Matthew,16,0,16,0
1713343725388,MMW 13R,A01,514037,Staff,12,0,16,4
1713343725388,MMW 13R,A02,514039,Staff,16,0,16,0
1713343727439,SIO 295LS,A00,523233,Staff,18,0,30,12
1713343728465,SIO 295S,A00,523232,Staff,18,0,30,12
1713343729499,SOCI 117,A01,494376,Staff,1,0,5,4
1713343730528,WES 237B,A00,494380,Staff,19,0,20,1
1713343732591,AESE 279B,A00,494370,Wade; Jon P,33,0,33,0
1713343733618,ANAR 135S,A00,494369,Braswell; Geoffrey E.,0,0,0,0
1713343734644,CAT 124RS,A01,519847,Geibel; William,17,0,20,3
1713343735669,CAT 125RS,A01,515971,Geibel; William,17,0,20,3
1713343736696,CLRE 250,A00,511389,Morris; Sheldon,9996,0,9999,3
1713343737722,CLRE 251,A00,507176,Mehta; Ravindra L.,9996,0,9999,3
1713343737722,CLRE 251,B00,511410,Mehta; Ravindra L.,9998,0,9999,1
1713343738747,CLRE 252,A00,507189,Cuomo; Raphael Eduardo,9998,0,9999,1
1713343739780,CLRE 253,A00,507199,Vaida; Florin,9997,0,9999,2
1713343739780,CLRE 253,B00,507202,Vaida; Florin,9999,0,9999,0
1713343740813,CLRE 259,A00,507211,Patel; Hemal,9996,0,9999,3
1713343741839,CLRE 260,A00,507221,Cuomo; Raphael Eduardo,9999,0,9999,0
1713343742865,CLRE 297,001,507242,Cuomo; Raphael Eduardo,9999,0,9999,0
1713343743891,CSE 191,A00,516875,Minnes Kemp; Mor Mia,9999,0,9999,0
1713343744917,CSS 201S,A01,494383,Staff,35,0,35,0
1713343745948,CSS 202S,A01,494387,Staff,35,0,35,0
1713343746979,EAP 100,A00,516065,Staff,9792,0,9999,207
1713343748005,ECE 45,A01,507414,Staff,51,0,60,9
1713343749037,ECE 100,A01,507416,Baghdadchi; Saharnaz,10,0,20,10
1713343749037,ECE 100,A02,507418,Baghdadchi; Saharnaz,20,0,20,0
1713343750062,ECE 111,A01,507420,Staff,38,0,50,12
1713343751088,ECE 197,001,548057,Sievenpiper; Daniel F.,9998,0,9999,1
1713343752116,EDS 115,A00,507243,Choi; Bailey Miyeon,28,0,28,0
1713343753148,EDS 117,A01,494379,Staff,23,0,25,2
1713343754175,EDS 125,A00,507246,Hopkins; Megan Beth,29,0,30,1
1713343755208,EDS 128A,A01,507264,Fargason; Sharon Gayle,26,0,26,0
1713343756237,EDS 128B,A01,507293,Pappas; Elizabeth,30,0,30,0
1713343757318,EDS 139,A00,507294,Fargason; Sharon Gayle,30,0,30,0
1713343757318,EDS 139,B00,507313,Pappas; Elizabeth,30,0,30,0
1713343758342,EDS 201,A00,507315,Staff,26,0,30,4
1713343759374,EDS 203,A01,507317,Halter; Christopher P.,26,0,30,4
1713343760406,EDS 204R,A01,507319,Halter; Christopher P.,3,0,30,27
1713343760406,EDS 204R,B01,507331,Heinzman; Erica M.,28,0,30,2
1713343761435,EDS 206R,A00,507332,Staff,4,0,30,26
1713343761435,EDS 206R,B00,507343,Staff,28,0,30,2
1713343762476,EDS 250,A00,507344,Hemans; Patricia Ann Benitez,36,0,40,4
1713343763508,EDS 281,A00,507345,Daly; Alan J.,18,0,18,0
1713343764533,EDS 284,A00,507350,Daly; Alan J.,16,0,16,0
1713343765560,EDS 286,A00,507359,Fine; Sarah,18,0,18,0
1713343766586,EDS 289C,A01,507361,Daly; Alan J.,18,0,18,0
1713343767613,EDS 290,A00,507366,Hofstetter; Carolyn,15,0,15,0
1713343768641,LIGM 5A,A00,507421,Fischer-Grunski; Eva K,20,0,20,0
1713343769671,LIGM 5B,A00,507423,Fischer-Grunski; Eva K,20,0,20,0
1713343770697,LIGM 5C,A00,507425,Fischer-Grunski; Eva K,20,0,20,0
1713343771724,LIIT 5AS,A00,507427,Carnelos; Chiara,20,0,20,0
1713343772750,LIIT 5BS,A00,507430,Carnelos; Chiara,20,0,20,0
1713343773775,LIIT 5CS,A00,507432,Carnelos; Chiara,20,0,20,0
1713343774803,LISP 5A,A00,507541,Munoz Sanchez; Alicia,17,0,20,3
1713343775833,LISP 5B,A00,507671,Munoz Sanchez; Alicia,15,0,20,5
1713343776859,LISP 5C,A00,507696,Munoz Sanchez; Alicia,15,0,20,5
1713343777893,MAE 197,001,528363,Boechler; Nicholas Sebastia,9998,0,9999,1
1713343778921,MATH 197,001,523477,Kedlaya; Kiran S.,9999,0,9999,0
1713343778921,MATH 197,002,563811,Zhang; Danna,9999,0,9999,0
1713343779947,MCWP 40R,A00,518780,Staff,20,0,20,0
1713343779947,MCWP 40R,B00,518781,Staff,19,0,20,1
1713343779947,MCWP 40R,C00,518783,Staff,19,0,20,1
1713343781054,MCWP 50R,A00,518791,Staff,20,0,20,0
1713343781054,MCWP 50R,B00,518792,Staff,17,0,20,3
1713343781054,MCWP 50R,C00,518793,Staff,19,0,20,1
1713343781054,MCWP 50R,D00,518794,Staff,16,0,20,4
1713343781054,MCWP 50R,E00,518795,Staff,16,0,20,4
1713343781054,MCWP 50R,F00,518796,Staff,19,0,20,1
1713343781054,MCWP 50R,G00,518797,Staff,19,0,20,1
1713343782083,MMW 12R,A01,514034,Herbst; Matthew,15,0,16,1
1713343782083,MMW 12R,A02,514035,Herbst; Matthew,16,0,16,0
1713343783109,MMW 13R,A01,514037,Staff,12,0,16,4
1713343783109,MMW 13R,A02,514039,Staff,16,0,16,0
1713343785163,SIO 295LS,A00,523233,Staff,18,0,30,12
1713343786189,SIO 295S,A00,523232,Staff,18,0,30,12
1713343787219,SOCI 117,A01,494376,Staff,1,0,5,4
1713343788246,WES 237B,A00,494380,Staff,19,0,20,1
1713343790309,AESE 279B,A00,494370,Wade; Jon P,33,0,33,0
1713343791334,ANAR 135S,A00,494369,Braswell; Geoffrey E.,0,0,0,0
1713343792360,CAT 124RS,A01,519847,Geibel; William,17,0,20,3
1713343793386,CAT 125RS,A01,515971,Geibel; William,17,0,20,3
1713343794412,CLRE 250,A00,511389,Morris; Sheldon,9996,0,9999,3
1713343795441,CLRE 251,A00,507176,Mehta; Ravindra L.,9996,0,9999,3
1713343795441,CLRE 251,B00,511410,Mehta; Ravindra L.,9998,0,9999,1
1713343796465,CLRE 252,A00,507189,Cuomo; Raphael Eduardo,9998,0,9999,1
1713343797489,CLRE 253,A00,507199,Vaida; Florin,9997,0,9999,2
1713343797489,CLRE 253,B00,507202,Vaida; Florin,9999,0,9999,0
1713343798515,CLRE 259,A00,507211,Patel; Hemal,9996,0,9999,3
1713343799542,CLRE 260,A00,507221,Cuomo; Raphael Eduardo,9999,0,9999,0
1713343800572,CLRE 297,001,507242,Cuomo; Raphael Eduardo,9999,0,9999,0
1713343801603,CSE 191,A00,516875,Minnes Kemp; Mor Mia,9999,0,9999,0
1713343802631,CSS 201S,A01,494383,Staff,35,0,35,0
1713343803663,CSS 202S,A01,494387,Staff,35,0,35,0
1713343804690,EAP 100,A00,516065,Staff,9792,0,9999,207
1713343805720,ECE 45,A01,507414,Staff,51,0,60,9
1713343806747,ECE 100,A01,507416,Baghdadchi; Saharnaz,10,0,20,10
1713343806747,ECE 100,A02,507418,Baghdadchi; Saharnaz,20,0,20,0
1713343807773,ECE 111,A01,507420,Staff,38,0,50,12
1713343808800,ECE 197,001,548057,Sievenpiper; Daniel F.,9998,0,9999,1
1713343809828,EDS 115,A00,507243,Choi; Bailey Miyeon,28,0,28,0
1713343810862,EDS 117,A01,494379,Staff,23,0,25,2
1713343811888,EDS 125,A00,507246,Hopkins; Megan Beth,29,0,30,1
1713343812914,EDS 128A,A01,507264,Fargason; Sharon Gayle,26,0,26,0
1713343813942,EDS 128B,A01,507293,Pappas; Elizabeth,30,0,30,0
1713343814975,EDS 139,A00,507294,Fargason; Sharon Gayle,30,0,30,0
1713343814975,EDS 139,B00,507313,Pappas; Elizabeth,30,0,30,0
1713343816005,EDS 201,A00,507315,Staff,26,0,30,4
1713343817032,EDS 203,A01,507317,Halter; Christopher P.,26,0,30,4
1713343818058,EDS 204R,A01,507319,Halter; Christopher P.,3,0,30,27
1713343818058,EDS 204R,B01,507331,Heinzman; Erica M.,28,0,30,2
1713343819089,EDS 206R,A00,507332,Staff,4,0,30,26
1713343819089,EDS 206R,B00,507343,Staff,28,0,30,2
1713343820120,EDS 250,A00,507344,Hemans; Patricia Ann Benitez,36,0,40,4
1713343821146,EDS 281,A00,507345,Daly; Alan J.,18,0,18,0
1713343822176,EDS 284,A00,507350,Daly; Alan J.,16,0,16,0
1713343823206,EDS 286,A00,507359,Fine; Sarah,18,0,18,0
1713343824232,EDS 289C,A01,507361,Daly; Alan J.,18,0,18,0
1713343825265,EDS 290,A00,507366,Hofstetter; Carolyn,15,0,15,0
1713343826293,LIGM 5A,A00,507421,Fischer-Grunski; Eva K,20,0,20,0
1713343827322,LIGM 5B,A00,507423,Fischer-Grunski; Eva K,20,0,20,0
1713343828348,LIGM 5C,A00,507425,Fischer-Grunski; Eva K,20,0,20,0
1713343829372,LIIT 5AS,A00,507427,Carnelos; Chiara,20,0,20,0
1713343830405,LIIT 5BS,A00,507430,Carnelos; Chiara,20,0,20,0
1713343831435,LIIT 5CS,A00,507432,Carnelos; Chiara,20,0,20,0
1713343832464,LISP 5A,A00,507541,Munoz Sanchez; Alicia,17,0,20,3
1713343833489,LISP 5B,A00,507671,Munoz Sanchez; Alicia,15,0,20,5
1713343834520,LISP 5C,A00,507696,Munoz Sanchez; Alicia,15,0,20,5
1713343835550,MAE 197,001,528363,Boechler; Nicholas Sebastia,9998,0,9999,1
1713343836578,MATH 197,001,523477,Kedlaya; Kiran S.,9999,0,9999,0
1713343836578,MATH 197,002,563811,Zhang; Danna,9999,0,9999,0
1713343837604,MCWP 40R,A00,518780,Staff,20,0,20,0
1713343837604,MCWP 40R,B00,518781,Staff,19,0,20,1
1713343837604,MCWP 40R,C00,518783,Staff,19,0,20,1
1713343838633,MCWP 50R,A00,518791,Staff,20,0,20,0
1713343838633,MCWP 50R,B00,518792,Staff,17,0,20,3
1713343838633,MCWP 50R,C00,518793,Staff,19,0,20,1
1713343838633,MCWP 50R,D00,518794,Staff,16,0,20,4
1713343838633,MCWP 50R,E00,518795,Staff,16,0,20,4
1713343838633,MCWP 50R,F00,518796,Staff,19,0,20,1
1713343838633,MCWP 50R,G00,518797,Staff,19,0,20,1
1713343839659,MMW 12R,A01,514034,Herbst; Matthew,15,0,16,1
1713343839659,MMW 12R,A02,514035,Herbst; Matthew,16,0,16,0
1713343840685,MMW 13R,A01,514037,Staff,12,0,16,4
1713343840685,MMW 13R,A02,514039,Staff,16,0,16,0
1713343842739,SIO 295LS,A00,523233,Staff,18,0,30,12
1713343843764,SIO 295S,A00,523232,Staff,18,0,30,12
1713343844797,SOCI 117,A01,494376,Staff,1,0,5,4
1713343845823,WES 237B,A00,494380,Staff,19,0,20,1
1713343847902,AESE 279B,A00,494370,Wade; Jon P,33,0,33,0
1713343848933,ANAR 135S,A00,494369,Braswell; Geoffrey E.,0,0,0,0
1713343849960,CAT 124RS,A01,519847,Geibel; William,17,0,20,3
1713343850988,CAT 125RS,A01,515971,Geibel; William,17,0,20,3
1713343852020,CLRE 250,A00,511389,Morris; Sheldon,9996,0,9999,3
1713343853059,CLRE 251,A00,507176,Mehta; Ravindra L.,9996,0,9999,3
1713343853059,CLRE 251,B00,511410,Mehta; Ravindra L.,9998,0,9999,1
1713343854093,CLRE 252,A00,507189,Cuomo; Raphael Eduardo,9998,0,9999,1
1713343855128,CLRE 253,A00,507199,Vaida; Florin,9997,0,9999,2
1713343855128,CLRE 253,B00,507202,Vaida; Florin,9999,0,9999,0
1713343856158,CLRE 259,A00,507211,Patel; Hemal,9996,0,9999,3
1713343857190,CLRE 260,A00,507221,Cuomo; Raphael Eduardo,9999,0,9999,0
1713343858216,CLRE 297,001,507242,Cuomo; Raphael Eduardo,9999,0,9999,0
1713343859245,CSE 191,A00,516875,Minnes Kemp; Mor Mia,9999,0,9999,0
1713343860280,CSS 201S,A01,494383,Staff,35,0,35,0
1713343861362,CSS 202S,A01,494387,Staff,35,0,35,0
1713343862390,EAP 100,A00,516065,Staff,9792,0,9999,207
1713343863416,ECE 45,A01,507414,Staff,51,0,60,9
1713343864449,ECE 100,A01,507416,Baghdadchi; Saharnaz,10,0,20,10
1713343864449,ECE 100,A02,507418,Baghdadchi; Saharnaz,20,0,20,0
1713343865475,ECE 111,A01,507420,Staff,38,0,50,12
1713343866500,ECE 197,001,548057,Sievenpiper; Daniel F.,9998,0,9999,1
1713343867532,EDS 115,A00,507243,Choi; Bailey Miyeon,28,0,28,0
1713343868564,EDS 117,A01,494379,Staff,23,0,25,2
1713343869599,EDS 125,A00,507246,Hopkins; Megan Beth,29,0,30,1
1713343870633,EDS 128A,A01,507264,Fargason; Sharon Gayle,26,0,26,0
1713343871660,EDS 128B,A01,507293,Pappas; Elizabeth,30,0,30,0
1713343872689,EDS 139,A00,507294,Fargason; Sharon Gayle,30,0,30,0
1713343872689,EDS 139,B00,507313,Pappas; Elizabeth,30,0,30,0
1713343873715,EDS 201,A00,507315,Staff,26,0,30,4
1713343874741,EDS 203,A01,507317,Halter; Christopher P.,26,0,30,4
1713343875776,EDS 204R,A01,507319,Halter; Christopher P.,3,0,30,27
1713343875776,EDS 204R,B01,507331,Heinzman; Erica M.,28,0,30,2
1713343876802,EDS 206R,A00,507332,Staff,4,0,30,26
1713343876802,EDS 206R,B00,507343,Staff,28,0,30,2
1713343877829,EDS 250,A00,507344,Hemans; Patricia Ann Benitez,36,0,40,4
1713343878861,EDS 281,A00,507345,Daly; Alan J.,18,0,18,0
1713343879887,EDS 284,A00,507350,Daly; Alan J.,16,0,16,0
1713343880915,EDS 286,A00,507359,Fine; Sarah,18,0,18,0
1713343881940,EDS 289C,A01,507361,Daly; Alan J.,18,0,18,0
1713343882965,EDS 290,A00,507366,Hofstetter; Carolyn,15,0,15,0
1713343883996,LIGM 5A,A00,507421,Fischer-Grunski; Eva K,20,0,20,0
1713343885021,LIGM 5B,A00,507423,Fischer-Grunski; Eva K,20,0,20,0
1713343886051,LIGM 5C,A00,507425,Fischer-Grunski; Eva K,20,0,20,0
1713343887076,LIIT 5AS,A00,507427,Carnelos; Chiara,20,0,20,0
1713343888106,LIIT 5BS,A00,507430,Carnelos; Chiara,20,0,20,0
1713343889132,LIIT 5CS,A00,507432,Carnelos; Chiara,20,0,20,0
1713343890159,LISP 5A,A00,507541,Munoz Sanchez; Alicia,17,0,20,3
1713343891195,LISP 5B,A00,507671,Munoz Sanchez; Alicia,15,0,20,5
1713343892223,LISP 5C,A00,507696,Munoz Sanchez; Alicia,15,0,20,5
1713343893249,MAE 197,001,528363,Boechler; Nicholas Sebastia,9998,0,9999,1
1713343894282,MATH 197,001,523477,Kedlaya; Kiran S.,9999,0,9999,0
1713343894282,MATH 197,002,563811,Zhang; Danna,9999,0,9999,0
1713343895308,MCWP 40R,A00,518780,Staff,20,0,20,0
1713343895308,MCWP 40R,B00,518781,Staff,19,0,20,1
1713343895308,MCWP 40R,C00,518783,Staff,19,0,20,1
1713343896333,MCWP 50R,A00,518791,Staff,20,0,20,0
1713343896333,MCWP 50R,B00,518792,Staff,17,0,20,3
1713343896333,MCWP 50R,C00,518793,Staff,19,0,20,1
1713343896333,MCWP 50R,D00,518794,Staff,16,0,20,4
1713343896333,MCWP 50R,E00,518795,Staff,16,0,20,4
1713343896333,MCWP 50R,F00,518796,Staff,19,0,20,1
1713343896333,MCWP 50R,G00,518797,Staff,19,0,20,1
1713343897363,MMW 12R,A01,514034,Herbst; Matthew,15,0,16,1
1713343897363,MMW 12R,A02,514035,Herbst; Matthew,16,0,16,0
1713343898392,MMW 13R,A01,514037,Staff,12,0,16,4
1713343898392,MMW 13R,A02,514039,Staff,16,0,16,0
1713343900447,SIO 295LS,A00,523233,Staff,18,0,30,12
1713343901473,SIO 295S,A00,523232,Staff,18,0,30,12
1713343902508,SOCI 117,A01,494376,Staff,1,0,5,4
1713343903533,WES 237B,A00,494380,Staff,19,0,20,1
1713343905598,AESE 279B,A00,494370,Wade; Jon P,33,0,33,0
1713343906629,ANAR 135S,A00,494369,Braswell; Geoffrey E.,0,0,0,0
1713343907699,CAT 124RS,A01,519847,Geibel; William,17,0,20,3
1713343908728,CAT 125RS,A01,515971,Geibel; William,17,0,20,3
1713343909754,CLRE 250,A00,511389,Morris; Sheldon,9996,0,9999,3
1713343910795,CLRE 251,A00,507176,Mehta; Ravindra L.,9996,0,9999,3
1713343910795,CLRE 251,B00,511410,Mehta; Ravindra L.,9998,0,9999,1
1713343911823,CLRE 252,A00,507189,Cuomo; Raphael Eduardo,9998,0,9999,1
1713343912847,CLRE 253,A00,507199,Vaida; Florin,9997,0,9999,2
1713343912847,CLRE 253,B00,507202,Vaida; Florin,9999,0,9999,0
1713343913873,CLRE 259,A00,507211,Patel; Hemal,9996,0,9999,3
1713343914902,CLRE 260,A00,507221,Cuomo; Raphael Eduardo,9999,0,9999,0
1713343915927,CLRE 297,001,507242,Cuomo; Raphael Eduardo,9999,0,9999,0
1713343916953,CSE 191,A00,516875,Minnes Kemp; Mor Mia,9999,0,9999,0
1713343917979,CSS 201S,A01,494383,Staff,35,0,35,0
1713343919013,CSS 202S,A01,494387,Staff,35,0,35,0
1713343920038,EAP 100,A00,516065,Staff,9792,0,9999,207
1713343921064,ECE 45,A01,507414,Staff,51,0,60,9
1713343922090,ECE 100,A01,507416,Baghdadchi; Saharnaz,10,0,20,10
1713343922090,ECE 100,A02,507418,Baghdadchi; Saharnaz,20,0,20,0
1713343923117,ECE 111,A01,507420,Staff,38,0,50,12
1713343924149,ECE 197,001,548057,Sievenpiper; Daniel F.,9998,0,9999,1
1713343925176,EDS 115,A00,507243,Choi; Bailey Miyeon,28,0,28,0
1713343926203,EDS 117,A01,494379,Staff,23,0,25,2
1713343927231,EDS 125,A00,507246,Hopkins; Megan Beth,29,0,30,1
1713343928261,EDS 128A,A01,507264,Fargason; Sharon Gayle,26,0,26,0
1713343929286,EDS 128B,A01,507293,Pappas; Elizabeth,30,0,30,0
1713343930313,EDS 139,A00,507294,Fargason; Sharon Gayle,30,0,30,0
1713343930313,EDS 139,B00,507313,Pappas; Elizabeth,30,0,30,0
1713343931338,EDS 201,A00,507315,Staff,26,0,30,4
1713343932364,EDS 203,A01,507317,Halter; Christopher P.,26,0,30,4
1713343933391,EDS 204R,A01,507319,Halter; Christopher P.,3,0,30,27
1713343933391,EDS 204R,B01,507331,Heinzman; Erica M.,28,0,30,2
1713343934416,EDS 206R,A00,507332,Staff,4,0,30,26
1713343934416,EDS 206R,B00,507343,Staff,28,0,30,2
1713343935448,EDS 250,A00,507344,Hemans; Patricia Ann Benitez,36,0,40,4
1713343936474,EDS 281,A00,507345,Daly; Alan J.,18,0,18,0
1713343937501,EDS 284,A00,507350,Daly; Alan J.,16,0,16,0
1713343938527,EDS 286,A00,507359,Fine; Sarah,18,0,18,0
1713343939559,EDS 289C,A01,507361,Daly; Alan J.,18,0,18,0
1713343940585,EDS 290,A00,507366,Hofstetter; Carolyn,15,0,15,0
1713343941613,LIGM 5A,A00,507421,Fischer-Grunski; Eva K,20,0,20,0
1713343942638,LIGM 5B,A00,507423,Fischer-Grunski; Eva K,20,0,20,0
1713343943669,LIGM 5C,A00,507425,Fischer-Grunski; Eva K,20,0,20,0
1713343944701,LIIT 5AS,A00,507427,Carnelos; Chiara,20,0,20,0
1713343945731,LIIT 5BS,A00,507430,Carnelos; Chiara,20,0,20,0
1713343946758,LIIT 5CS,A00,507432,Carnelos; Chiara,20,0,20,0
1713343947784,LISP 5A,A00,507541,Munoz Sanchez; Alicia,17,0,20,3
1713343948810,LISP 5B,A00,507671,Munoz Sanchez; Alicia,15,0,20,5
1713343949836,LISP 5C,A00,507696,Munoz Sanchez; Alicia,15,0,20,5
1713343950862,MAE 197,001,528363,Boechler; Nicholas Sebastia,9998,0,9999,1
1713343951897,MATH 197,001,523477,Kedlaya; Kiran S.,9999,0,9999,0
1713343951897,MATH 197,002,563811,Zhang; Danna,9999,0,9999,0
1713343952926,MCWP 40R,A00,518780,Staff,20,0,20,0
1713343952926,MCWP 40R,B00,518781,Staff,19,0,20,1
1713343952926,MCWP 40R,C00,518783,Staff,19,0,20,1
1713343953953,MCWP 50R,A00,518791,Staff,20,0,20,0
1713343953953,MCWP 50R,B00,518792,Staff,17,0,20,3
1713343953953,MCWP 50R,C00,518793,Staff,19,0,20,1
1713343953953,MCWP 50R,D00,518794,Staff,16,0,20,4
1713343953953,MCWP 50R,E00,518795,Staff,16,0,20,4
1713343953953,MCWP 50R,F00,518796,Staff,19,0,20,1
1713343953953,MCWP 50R,G00,518797,Staff,19,0,20,1
1713343954984,MMW 12R,A01,514034,Herbst; Matthew,15,0,16,1
1713343954984,MMW 12R,A02,514035,Herbst; Matthew,16,0,16,0
1713343956009,MMW 13R,A01,514037,Staff,12,0,16,4
1713343956009,MMW 13R,A02,514039,Staff,16,0,16,0
1713343958065,SIO 295LS,A00,523233,Staff,18,0,30,12
1713343959090,SIO 295S,A00,523232,Staff,18,0,30,12
1713343960115,SOCI 117,A01,494376,Staff,1,0,5,4
1713343961141,WES 237B,A00,494380,Staff,19,0,20,1
1713343963202,AESE 279B,A00,494370,Wade; Jon P,33,0,33,0
1713343964229,ANAR 135S,A00,494369,Braswell; Geoffrey E.,0,0,0,0
1713343965316,CAT 124RS,A01,519847,Geibel; William,17,0,20,3
1713343966345,CAT 125RS,A01,515971,Geibel; William,17,0,20,3
1713343967375,CLRE 250,A00,511389,Morris; Sheldon,9996,0,9999,3
1713343968403,CLRE 251,A00,507176,Mehta; Ravindra L.,9996,0,9999,3
1713343968403,CLRE 251,B00,511410,Mehta; Ravindra L.,9998,0,9999,1
1713343969431,CLRE 252,A00,507189,Cuomo; Raphael Eduardo,9998,0,9999,1
1713343970463,CLRE 253,A00,507199,Vaida; Florin,9997,0,9999,2
1713343970463,CLRE 253,B00,507202,Vaida; Florin,9999,0,9999,0
1713343971488,CLRE 259,A00,507211,Patel; Hemal,9996,0,9999,3
1713343972514,CLRE 260,A00,507221,Cuomo; Raphael Eduardo,9999,0,9999,0
1713343973547,CLRE 297,001,507242,Cuomo; Raphael Eduardo,9999,0,9999,0
1713343974573,CSE 191,A00,516875,Minnes Kemp; Mor Mia,9999,0,9999,0
1713343975599,CSS 201S,A01,494383,Staff,35,0,35,0
1713343976624,CSS 202S,A01,494387,Staff,35,0,35,0
1713343977649,EAP 100,A00,516065,Staff,9792,0,9999,207
1713343978675,ECE 45,A01,507414,Staff,51,0,60,9
1713343979701,ECE 100,A01,507416,Baghdadchi; Saharnaz,10,0,20,10
1713343979701,ECE 100,A02,507418,Baghdadchi; Saharnaz,20,0,20,0
1713343980729,ECE 111,A01,507420,Staff,38,0,50,12
1713343981756,ECE 197,001,548057,Sievenpiper; Daniel F.,9998,0,9999,1
1713343982786,EDS 115,A00,507243,Choi; Bailey Miyeon,28,0,28,0
1713343983861,EDS 117,A01,494379,Staff,23,0,25,2
1713343984895,EDS 125,A00,507246,Hopkins; Megan Beth,29,0,30,1
1713343985922,EDS 128A,A01,507264,Fargason; Sharon Gayle,26,0,26,0
1713343986955,EDS 128B,A01,507293,Pappas; Elizabeth,30,0,30,0
1713343987986,EDS 139,A00,507294,Fargason; Sharon Gayle,30,0,30,0
1713343987986,EDS 139,B00,507313,Pappas; Elizabeth,30,0,30,0
1713343989009,EDS 201,A00,507315,Staff,26,0,30,4
1713343990036,EDS 203,A01,507317,Halter; Christopher P.,26,0,30,4
1713343991064,EDS 204R,A01,507319,Halter; Christopher P.,3,0,30,27
1713343991064,EDS 204R,B01,507331,Heinzman; Erica M.,28,0,30,2
1713343992094,EDS 206R,A00,507332,Staff,4,0,30,26
1713343992094,EDS 206R,B00,507343,Staff,28,0,30,2
1713343993121,EDS 250,A00,507344,Hemans; Patricia Ann Benitez,36,0,40,4
1713343994147,EDS 281,A00,507345,Daly; Alan J.,18,0,18,0
1713343995177,EDS 284,A00,507350,Daly; Alan J.,16,0,16,0
1713343996203,EDS 286,A00,507359,Fine; Sarah,18,0,18,0
1713343997228,EDS 289C,A01,507361,Daly; Alan J.,18,0,18,0
1713343998256,EDS 290,A00,507366,Hofstetter; Carolyn,15,0,15,0
1713343999283,LIGM 5A,A00,507421,Fischer-Grunski; Eva K,20,0,20,0
1713344000314,LIGM 5B,A00,507423,Fischer-Grunski; Eva K,20,0,20,0
1713344001339,LIGM 5C,A00,507425,Fischer-Grunski; Eva K,20,0,20,0
1713344002381,LIIT 5AS,A00,507427,Carnelos; Chiara,20,0,20,0
1713344003408,LIIT 5BS,A00,507430,Carnelos; Chiara,20,0,20,0
1713344004439,LIIT 5CS,A00,507432,Carnelos; Chiara,20,0,20,0
1713344005471,LISP 5A,A00,507541,Munoz Sanchez; Alicia,17,0,20,3
1713344006501,LISP 5B,A00,507671,Munoz Sanchez; Alicia,15,0,20,5
1713344007527,LISP 5C,A00,507696,Munoz Sanchez; Alicia,15,0,20,5
1713344008559,MAE 197,001,528363,Boechler; Nicholas Sebastia,9998,0,9999,1
1713344009584,MATH 197,001,523477,Kedlaya; Kiran S.,9999,0,9999,0
1713344009584,MATH 197,002,563811,Zhang; Danna,9999,0,9999,0
1713344010641,MCWP 40R,A00,518780,Staff,20,0,20,0
1713344010641,MCWP 40R,B00,518781,Staff,19,0,20,1
1713344010641,MCWP 40R,C00,518783,Staff,19,0,20,1
1713344011669,MCWP 50R,A00,518791,Staff,20,0,20,0
1713344011669,MCWP 50R,B00,518792,Staff,17,0,20,3
1713344011669,MCWP 50R,C00,518793,Staff,19,0,20,1
1713344011669,MCWP 50R,D00,518794,Staff,16,0,20,4
1713344011669,MCWP 50R,E00,518795,Staff,16,0,20,4
1713344011669,MCWP 50R,F00,518796,Staff,19,0,20,1
1713344011669,MCWP 50R,G00,518797,Staff,19,0,20,1
1713344012702,MMW 12R,A01,514034,Herbst; Matthew,15,0,16,1
1713344012702,MMW 12R,A02,514035,Herbst; Matthew,16,0,16,0
1713344013736,MMW 13R,A01,514037,Staff,12,0,16,4
1713344013736,MMW 13R,A02,514039,Staff,16,0,16,0
1713344015789,SIO 295LS,A00,523233,Staff,18,0,30,12
1713344016816,SIO 295S,A00,523232,Staff,18,0,30,12
1713344017851,SOCI 117,A01,494376,Staff,1,0,5,4
1713344018884,WES 237B,A00,494380,Staff,19,0,20,1
1713344020956,AESE 279B,A00,494370,Wade; Jon P,33,0,33,0
1713344021982,ANAR 135S,A00,494369,Braswell; Geoffrey E.,0,0,0,0
1713344023015,CAT 124RS,A01,519847,Geibel; William,17,0,20,3
1713344024044,CAT 125RS,A01,515971,Geibel; William,17,0,20,3
1713344025071,CLRE 250,A00,511389,Morris; Sheldon,9996,0,9999,3
1713344026101,CLRE 251,A00,507176,Mehta; Ravindra L.,9996,0,9999,3
1713344026101,CLRE 251,B00,511410,Mehta; Ravindra L.,9998,0,9999,1
1713344027147,CLRE 252,A00,507189,Cuomo; Raphael Eduardo,9998,0,9999,1
1713344028175,CLRE 253,A00,507199,Vaida; Florin,9997,0,9999,2
1713344028175,CLRE 253,B00,507202,Vaida; Florin,9999,0,9999,0
1713344029202,CLRE 259,A00,507211,Patel; Hemal,9996,0,9999,3
1713344030230,CLRE 260,A00,507221,Cuomo; Raphael Eduardo,9999,0,9999,0
1713344031260,CLRE 297,001,507242,Cuomo; Raphael Eduardo,9999,0,9999,0
1713344032299,CSE 191,A00,516875,Minnes Kemp; Mor Mia,9999,0,9999,0
1713344033341,CSS 201S,A01,494383,Staff,35,0,35,0
1713344034393,CSS 202S,A01,494387,Staff,35,0,35,0
1713344035423,EAP 100,A00,516065,Staff,9792,0,9999,207
1713344036456,ECE 45,A01,507414,Staff,51,0,60,9
1713344037489,ECE 100,A01,507416,Baghdadchi; Saharnaz,10,0,20,10
1713344037489,ECE 100,A02,507418,Baghdadchi; Saharnaz,20,0,20,0
1713344038519,ECE 111,A01,507420,Staff,38,0,50,12
1713344039558,ECE 197,001,548057,Sievenpiper; Daniel F.,9998,0,9999,1
1713344040592,EDS 115,A00,507243,Choi; Bailey Miyeon,28,0,28,0
1713344041620,EDS 117,A01,494379,Staff,23,0,25,2
1713344042664,EDS 125,A00,507246,Hopkins; Megan Beth,29,0,30,1
1713344043698,EDS 128A,A01,507264,Fargason; Sharon Gayle,26,0,26,0
1713344044725,EDS 128B,A01,507293,Pappas; Elizabeth,30,0,30,0
1713344045760,EDS 139,A00,507294,Fargason; Sharon Gayle,30,0,30,0
1713344045760,EDS 139,B00,507313,Pappas; Elizabeth,30,0,30,0
1713344046824,EDS 201,A00,507315,Staff,26,0,30,4
1713344047855,EDS 203,A01,507317,Halter; Christopher P.,26,0,30,4
1713344048882,EDS 204R,A01,507319,Halter; Christopher P.,3,0,30,27
1713344048882,EDS 204R,B01,507331,Heinzman; Erica M.,28,0,30,2
1713344049915,EDS 206R,A00,507332,Staff,4,0,30,26
1713344049915,EDS 206R,B00,507343,Staff,28,0,30,2
1713344050941,EDS 250,A00,507344,Hemans; Patricia Ann Benitez,36,0,40,4
1713344051972,EDS 281,A00,507345,Daly; Alan J.,18,0,18,0
1713344052998,EDS 284,A00,507350,Daly; Alan J.,16,0,16,0
1713344054026,EDS 286,A00,507359,Fine; Sarah,18,0,18,0
1713344055058,EDS 289C,A01,507361,Daly; Alan J.,18,0,18,0
1713344056090,EDS 290,A00,507366,Hofstetter; Carolyn,15,0,15,0
1713344057124,LIGM 5A,A00,507421,Fischer-Grunski; Eva K,20,0,20,0
1713344058149,LIGM 5B,A00,507423,Fischer-Grunski; Eva K,20,0,20,0
1713344059177,LIGM 5C,A00,507425,Fischer-Grunski; Eva K,20,0,20,0
1713344060204,LIIT 5AS,A00,507427,Carnelos; Chiara,20,0,20,0
1713344061231,LIIT 5BS,A00,507430,Carnelos; Chiara,20,0,20,0
1713344062258,LIIT 5CS,A00,507432,Carnelos; Chiara,20,0,20,0
1713344063285,LISP 5A,A00,507541,Munoz Sanchez; Alicia,17,0,20,3
1713344064314,LISP 5B,A00,507671,Munoz Sanchez; Alicia,15,0,20,5
1713344065344,LISP 5C,A00,507696,Munoz Sanchez; Alicia,15,0,20,5
1713344066374,MAE 197,001,528363,Boechler; Nicholas Sebastia,9998,0,9999,1
1713344067400,MATH 197,001,523477,Kedlaya; Kiran S.,9999,0,9999,0
1713344067400,MATH 197,002,563811,Zhang; Danna,9999,0,9999,0
1713344068427,MCWP 40R,A00,518780,Staff,20,0,20,0
1713344068427,MCWP 40R,B00,518781,Staff,19,0,20,1
1713344068427,MCWP 40R,C00,518783,Staff,19,0,20,1
1713344069512,MCWP 50R,A00,518791,Staff,20,0,20,0
1713344069512,MCWP 50R,B00,518792,Staff,17,0,20,3
1713344069512,MCWP 50R,C00,518793,Staff,19,0,20,1
1713344069512,MCWP 50R,D00,518794,Staff,16,0,20,4
1713344069512,MCWP 50R,E00,518795,Staff,16,0,20,4
1713344069512,MCWP 50R,F00,518796,Staff,19,0,20,1
1713344069512,MCWP 50R,G00,518797,Staff,19,0,20,1
1713344070538,MMW 12R,A01,514034,Herbst; Matthew,15,0,16,1
1713344070538,MMW 12R,A02,514035,Herbst; Matthew,16,0,16,0
1713344071563,MMW 13R,A01,514037,Staff,12,0,16,4
1713344071563,MMW 13R,A02,514039,Staff,16,0,16,0
1713344073617,SIO 295LS,A00,523233,Staff,18,0,30,12
1713344074642,SIO 295S,A00,523232,Staff,18,0,30,12
1713344075671,SOCI 117,A01,494376,Staff,1,0,5,4
1713344076702,WES 237B,A00,494380,Staff,19,0,20,1
1713344078767,AESE 279B,A00,494370,Wade; Jon P,33,0,33,0
1713344079793,ANAR 135S,A00,494369,Braswell; Geoffrey E.,0,0,0,0
1713344080823,CAT 124RS,A01,519847,Geibel; William,17,0,20,3
1713344081849,CAT 125RS,A01,515971,Geibel; William,17,0,20,3
1713344082880,CLRE 250,A00,511389,Morris; Sheldon,9996,0,9999,3
1713344083907,CLRE 251,A00,507176,Mehta; Ravindra L.,9996,0,9999,3
1713344083907,CLRE 251,B00,511410,Mehta; Ravindra L.,9998,0,9999,1
1713344084933,CLRE 252,A00,507189,Cuomo; Raphael Eduardo,9998,0,9999,1
1713344085964,CLRE 253,A00,507199,Vaida; Florin,9997,0,9999,2
1713344085964,CLRE 253,B00,507202,Vaida; Florin,9999,0,9999,0
1713344086991,CLRE 259,A00,507211,Patel; Hemal,9996,0,9999,3
1713344088018,CLRE 260,A00,507221,Cuomo; Raphael Eduardo,9999,0,9999,0
1713344089043,CLRE 297,001,507242,Cuomo; Raphael Eduardo,9999,0,9999,0
1713344090074,CSE 191,A00,516875,Minnes Kemp; Mor Mia,9999,0,9999,0
1713344091100,CSS 201S,A01,494383,Staff,35,0,35,0
1713344092131,CSS 202S,A01,494387,Staff,35,0,35,0
1713344093156,EAP 100,A00,516065,Staff,9792,0,9999,207
1713344094192,ECE 45,A01,507414,Staff,51,0,60,9
1713344095217,ECE 100,A01,507416,Baghdadchi; Saharnaz,10,0,20,10
1713344095217,ECE 100,A02,507418,Baghdadchi; Saharnaz,20,0,20,0
1713344096246,ECE 111,A01,507420,Staff,38,0,50,12
1713344097277,ECE 197,001,548057,Sievenpiper; Daniel F.,9998,0,9999,1
1713344098304,EDS 115,A00,507243,Choi; Bailey Miyeon,28,0,28,0
1713344099337,EDS 117,A01,494379,Staff,23,0,25,2
1713344100366,EDS 125,A00,507246,Hopkins; Megan Beth,29,0,30,1
1713344101401,EDS 128A,A01,507264,Fargason; Sharon Gayle,26,0,26,0
1713344102431,EDS 128B,A01,507293,Pappas; Elizabeth,30,0,30,0
1713344103468,EDS 139,A00,507294,Fargason; Sharon Gayle,30,0,30,0
1713344103468,EDS 139,B00,507313,Pappas; Elizabeth,30,0,30,0
1713344104501,EDS 201,A00,507315,Staff,26,0,30,4
1713344105541,EDS 203,A01,507317,Halter; Christopher P.,26,0,30,4
1713344106571,EDS 204R,A01,507319,Halter; Christopher P.,3,0,30,27
1713344106571,EDS 204R,B01,507331,Heinzman; Erica M.,28,0,30,2
1713344107605,EDS 206R,A00,507332,Staff,4,0,30,26
1713344107605,EDS 206R,B00,507343,Staff,28,0,30,2
1713344108632,EDS 250,A00,507344,Hemans; Patricia Ann Benitez,36,0,40,4
1713344109660,EDS 281,A00,507345,Daly; Alan J.,18,0,18,0
1713344110688,EDS 284,A00,507350,Daly; Alan J.,16,0,16,0
1713344111722,EDS 286,A00,507359,Fine; Sarah,18,0,18,0
1713344112755,EDS 289C,A01,507361,Daly; Alan J.,18,0,18,0
1713344113782,EDS 290,A00,507366,Hofstetter; Carolyn,15,0,15,0
1713344114813,LIGM 5A,A00,507421,Fischer-Grunski; Eva K,20,0,20,0
1713344115841,LIGM 5B,A00,507423,Fischer-Grunski; Eva K,20,0,20,0
1713344116874,LIGM 5C,A00,507425,Fischer-Grunski; Eva K,20,0,20,0
1713344117906,LIIT 5AS,A00,507427,Carnelos; Chiara,20,0,20,0
1713344118932,LIIT 5BS,A00,507430,Carnelos; Chiara,20,0,20,0
1713344119961,LIIT 5CS,A00,507432,Carnelos; Chiara,20,0,20,0
1713344120987,LISP 5A,A00,507541,Munoz Sanchez; Alicia,17,0,20,3
1713344122013,LISP 5B,A00,507671,Munoz Sanchez; Alicia,15,0,20,5
1713344123037,LISP 5C,A00,507696,Munoz Sanchez; Alicia,15,0,20,5
1713344124065,MAE 197,001,528363,Boechler; Nicholas Sebastia,9998,0,9999,1
1713344125099,MATH 197,001,523477,Kedlaya; Kiran S.,9999,0,9999,0
1713344125099,MATH 197,002,563811,Zhang; Danna,9999,0,9999,0
1713344126125,MCWP 40R,A00,518780,Staff,20,0,20,0
1713344126125,MCWP 40R,B00,518781,Staff,19,0,20,1
1713344126125,MCWP 40R,C00,518783,Staff,19,0,20,1
1713344127150,MCWP 50R,A00,518791,Staff,20,0,20,0
1713344127150,MCWP 50R,B00,518792,Staff,17,0,20,3
1713344127150,MCWP 50R,C00,518793,Staff,19,0,20,1
1713344127150,MCWP 50R,D00,518794,Staff,16,0,20,4
1713344127150,MCWP 50R,E00,518795,Staff,16,0,20,4
1713344127150,MCWP 50R,F00,518796,Staff,19,0,20,1
1713344127150,MCWP 50R,G00,518797,Staff,19,0,20,1
1713344128177,MMW 12R,A01,514034,Herbst; Matthew,15,0,16,1
1713344128177,MMW 12R,A02,514035,Herbst; Matthew,16,0,16,0
1713344129206,MMW 13R,A01,514037,Staff,12,0,16,4
1713344129206,MMW 13R,A02,514039,Staff,16,0,16,0
1713344131261,SIO 295LS,A00,523233,Staff,18,0,30,12
1713344132287,SIO 295S,A00,523232,Staff,18,0,30,12
1713344133312,SOCI 117,A01,494376,Staff,1,0,5,4
1713344134339,WES 237B,A00,494380,Staff,19,0,20,1
1713344136410,AESE 279B,A00,494370,Wade; Jon P,33,0,33,0
1713344137437,ANAR 135S,A00,494369,Braswell; Geoffrey E.,0,0,0,0
1713344138462,CAT 124RS,A01,519847,Geibel; William,17,0,20,3
1713344139489,CAT 125RS,A01,515971,Geibel; William,17,0,20,3
1713344140524,CLRE 250,A00,511389,Morris; Sheldon,9996,0,9999,3
1713344141557,CLRE 251,A00,507176,Mehta; Ravindra L.,9996,0,9999,3
1713344141557,CLRE 251,B00,511410,Mehta; Ravindra L.,9998,0,9999,1
1713344142582,CLRE 252,A00,507189,Cuomo; Raphael Eduardo,9998,0,9999,1
1713344143607,CLRE 253,A00,507199,Vaida; Florin,9997,0,9999,2
1713344143607,CLRE 253,B00,507202,Vaida; Florin,9999,0,9999,0
1713344144638,CLRE 259,A00,507211,Patel; Hemal,9996,0,9999,3
1713344145666,CLRE 260,A00,507221,Cuomo; Raphael Eduardo,9999,0,9999,0
1713344146691,CLRE 297,001,507242,Cuomo; Raphael Eduardo,9999,0,9999,0
1713344147717,CSE 191,A00,516875,Minnes Kemp; Mor Mia,9999,0,9999,0
1713344148742,CSS 201S,A01,494383,Staff,35,0,35,0
1713344149773,CSS 202S,A01,494387,Staff,35,0,35,0
1713344150807,EAP 100,A00,516065,Staff,9792,0,9999,207
1713344151838,ECE 45,A01,507414,Staff,51,0,60,9
1713344152868,ECE 100,A01,507416,Baghdadchi; Saharnaz,10,0,20,10
1713344152868,ECE 100,A02,507418,Baghdadchi; Saharnaz,20,0,20,0
1713344153897,ECE 111,A01,507420,Staff,38,0,50,12
1713344154923,ECE 197,001,548057,Sievenpiper; Daniel F.,9998,0,9999,1
1713344155951,EDS 115,A00,507243,Choi; Bailey Miyeon,28,0,28,0
1713344156976,EDS 117,A01,494379,Staff,23,0,25,2
1713344158001,EDS 125,A00,507246,Hopkins; Megan Beth,29,0,30,1
1713344159027,EDS 128A,A01,507264,Fargason; Sharon Gayle,26,0,26,0
1713344160054,EDS 128B,A01,507293,Pappas; Elizabeth,30,0,30,0
1713344161087,EDS 139,A00,507294,Fargason; Sharon Gayle,30,0,30,0
1713344161087,EDS 139,B00,507313,Pappas; Elizabeth,30,0,30,0
1713344162115,EDS 201,A00,507315,Staff,26,0,30,4
1713344163141,EDS 203,A01,507317,Halter; Christopher P.,26,0,30,4
1713344164167,EDS 204R,A01,507319,Halter; Christopher P.,3,0,30,27
1713344164167,EDS 204R,B01,507331,Heinzman; Erica M.,28,0,30,2
1713344165198,EDS 206R,A00,507332,Staff,4,0,30,26
1713344165198,EDS 206R,B00,507343,Staff,28,0,30,2
1713344166222,EDS 250,A00,507344,Hemans; Patricia Ann Benitez,36,0,40,4
1713344167248,EDS 281,A00,507345,Daly; Alan J.,18,0,18,0
1713344168280,EDS 284,A00,507350,Daly; Alan J.,16,0,16,0
1713344169312,EDS 286,A00,507359,Fine; Sarah,18,0,18,0
1713344170341,EDS 289C,A01,507361,Daly; Alan J.,18,0,18,0
1713344171367,EDS 290,A00,507366,Hofstetter; Carolyn,15,0,15,0
1713344172398,LIGM 5A,A00,507421,Fischer-Grunski; Eva K,20,0,20,0
1713344173482,LIGM 5B,A00,507423,Fischer-Grunski; Eva K,20,0,20,0
1713344174508,LIGM 5C,A00,507425,Fischer-Grunski; Eva K,20,0,20,0
1713344175534,LIIT 5AS,A00,507427,Carnelos; Chiara,20,0,20,0
1713344176560,LIIT 5BS,A00,507430,Carnelos; Chiara,20,0,20,0
1713344177586,LIIT 5CS,A00,507432,Carnelos; Chiara,20,0,20,0
1713344178614,LISP 5A,A00,507541,Munoz Sanchez; Alicia,17,0,20,3
1713344179650,LISP 5B,A00,507671,Munoz Sanchez; Alicia,15,0,20,5
1713344180676,LISP 5C,A00,507696,Munoz Sanchez; Alicia,15,0,20,5
1713344181702,MAE 197,001,528363,Boechler; Nicholas Sebastia,9998,0,9999,1
1713344182737,MATH 197,001,523477,Kedlaya; Kiran S.,9999,0,9999,0
1713344182737,MATH 197,002,563811,Zhang; Danna,9999,0,9999,0
1713344183767,MCWP 40R,A00,518780,Staff,20,0,20,0
1713344183767,MCWP 40R,B00,518781,Staff,19,0,20,1
1713344183767,MCWP 40R,C00,518783,Staff,19,0,20,1
1713344184800,MCWP 50R,A00,518791,Staff,20,0,20,0
1713344184800,MCWP 50R,B00,518792,Staff,17,0,20,3
1713344184800,MCWP 50R,C00,518793,Staff,19,0,20,1
1713344184800,MCWP 50R,D00,518794,Staff,16,0,20,4
1713344184800,MCWP 50R,E00,518795,Staff,16,0,20,4
1713344184800,MCWP 50R,F00,518796,Staff,19,0,20,1
1713344184800,MCWP 50R,G00,518797,Staff,19,0,20,1
1713344185831,MMW 12R,A01,514034,Herbst; Matthew,15,0,16,1
1713344185831,MMW 12R,A02,514035,Herbst; Matthew,16,0,16,0
1713344186856,MMW 13R,A01,514037,Staff,12,0,16,4
1713344186856,MMW 13R,A02,514039,Staff,16,0,16,0
1713344188915,SIO 295LS,A00,523233,Staff,18,0,30,12
1713344189941,SIO 295S,A00,523232,Staff,18,0,30,12
1713344190966,SOCI 117,A01,494376,Staff,1,0,5,4
1713344191992,WES 237B,A00,494380,Staff,19,0,20,1
1713344194064,AESE 279B,A00,494370,Wade; Jon P,33,0,33,0
1713344195089,ANAR 135S,A00,494369,Braswell; Geoffrey E.,0,0,0,0
1713344196120,CAT 124RS,A01,519847,Geibel; William,17,0,20,3
1713344197149,CAT 125RS,A01,515971,Geibel; William,17,0,20,3
1713344198176,CLRE 250,A00,511389,Morris; Sheldon,9996,0,9999,3
1713344199203,CLRE 251,A00,507176,Mehta; Ravindra L.,9996,0,9999,3
1713344199203,CLRE 251,B00,511410,Mehta; Ravindra L.,9998,0,9999,1
1713344200230,CLRE 252,A00,507189,Cuomo; Raphael Eduardo,9998,0,9999,1
1713344201257,CLRE 253,A00,507199,Vaida; Florin,9997,0,9999,2
1713344201257,CLRE 253,B00,507202,Vaida; Florin,9999,0,9999,0
1713344202281,CLRE 259,A00,507211,Patel; Hemal,9996,0,9999,3
1713344203312,CLRE 260,A00,507221,Cuomo; Raphael Eduardo,9999,0,9999,0
1713344204341,CLRE 297,001,507242,Cuomo; Raphael Eduardo,9999,0,9999,0
1713344205386,CSE 191,A00,516875,Minnes Kemp; Mor Mia,9999,0,9999,0
1713344206419,CSS 201S,A01,494383,Staff,35,0,35,0
1713344207450,CSS 202S,A01,494387,Staff,35,0,35,0
1713344208477,EAP 100,A00,516065,Staff,9792,0,9999,207
1713344209503,ECE 45,A01,507414,Staff,51,0,60,9
1713344210530,ECE 100,A01,507416,Baghdadchi; Saharnaz,10,0,20,10
1713344210530,ECE 100,A02,507418,Baghdadchi; Saharnaz,20,0,20,0
1713344211555,ECE 111,A01,507420,Staff,38,0,50,12
1713344212585,ECE 197,001,548057,Sievenpiper; Daniel F.,9998,0,9999,1
1713344213611,EDS 115,A00,507243,Choi; Bailey Miyeon,28,0,28,0
1713344214638,EDS 117,A01,494379,Staff,23,0,25,2
1713344215669,EDS 125,A00,507246,Hopkins; Megan Beth,29,0,30,1
1713344216694,EDS 128A,A01,507264,Fargason; Sharon Gayle,26,0,26,0
1713344217719,EDS 128B,A01,507293,Pappas; Elizabeth,30,0,30,0
1713344218748,EDS 139,A00,507294,Fargason; Sharon Gayle,30,0,30,0
1713344218748,EDS 139,B00,507313,Pappas; Elizabeth,30,0,30,0
1713344219772,EDS 201,A00,507315,Staff,26,0,30,4
1713344220808,EDS 203,A01,507317,Halter; Christopher P.,26,0,30,4
1713344221838,EDS 204R,A01,507319,Halter; Christopher P.,3,0,30,27
1713344221838,EDS 204R,B01,507331,Heinzman; Erica M.,28,0,30,2
1713344222864,EDS 206R,A00,507332,Staff,4,0,30,26
1713344222864,EDS 206R,B00,507343,Staff,28,0,30,2
1713344223893,EDS 250,A00,507344,Hemans; Patricia Ann Benitez,36,0,40,4
1713344224918,EDS 281,A00,507345,Daly; Alan J.,18,0,18,0
1713344225942,EDS 284,A00,507350,Daly; Alan J.,16,0,16,0
1713344226966,EDS 286,A00,507359,Fine; Sarah,18,0,18,0
1713344227991,EDS 289C,A01,507361,Daly; Alan J.,18,0,18,0
1713344229017,EDS 290,A00,507366,Hofstetter; Carolyn,15,0,15,0
1713344230057,LIGM 5A,A00,507421,Fischer-Grunski; Eva K,20,0,20,0
1713344231082,LIGM 5B,A00,507423,Fischer-Grunski; Eva K,20,0,20,0
1713344232108,LIGM 5C,A00,507425,Fischer-Grunski; Eva K,20,0,20,0
1713344233133,LIIT 5AS,A00,507427,Carnelos; Chiara,20,0,20,0
1713344234161,LIIT 5BS,A00,507430,Carnelos; Chiara,20,0,20,0
1713344235194,LIIT 5CS,A00,507432,Carnelos; Chiara,20,0,20,0
1713344236221,LISP 5A,A00,507541,Munoz Sanchez; Alicia,17,0,20,3
1713344237244,LISP 5B,A00,507671,Munoz Sanchez; Alicia,15,0,20,5
1713344238275,LISP 5C,A00,507696,Munoz Sanchez; Alicia,15,0,20,5
1713344239303,MAE 197,001,528363,Boechler; Nicholas Sebastia,9998,0,9999,1
1713344240336,MATH 197,001,523477,Kedlaya; Kiran S.,9999,0,9999,0
1713344240336,MATH 197,002,563811,Zhang; Danna,9999,0,9999,0
1713344241372,MCWP 40R,A00,518780,Staff,20,0,20,0
1713344241372,MCWP 40R,B00,518781,Staff,19,0,20,1
1713344241372,MCWP 40R,C00,518783,Staff,19,0,20,1
1713344242398,MCWP 50R,A00,518791,Staff,20,0,20,0
1713344242398,MCWP 50R,B00,518792,Staff,17,0,20,3
1713344242398,MCWP 50R,C00,518793,Staff,19,0,20,1
1713344242398,MCWP 50R,D00,518794,Staff,16,0,20,4
1713344242398,MCWP 50R,E00,518795,Staff,16,0,20,4
1713344242398,MCWP 50R,F00,518796,Staff,19,0,20,1
1713344242398,MCWP 50R,G00,518797,Staff,19,0,20,1
1713344243423,MMW 12R,A01,514034,Herbst; Matthew,15,0,16,1
1713344243423,MMW 12R,A02,514035,Herbst; Matthew,16,0,16,0
1713344244446,MMW 13R,A01,514037,Staff,12,0,16,4
1713344244446,MMW 13R,A02,514039,Staff,16,0,16,0
1713344246495,SIO 295LS,A00,523233,Staff,18,0,30,12
1713344247519,SIO 295S,A00,523232,Staff,18,0,30,12
1713344248547,SOCI 117,A01,494376,Staff,1,0,5,4
1713344249575,WES 237B,A00,494380,Staff,19,0,20,1
1713344251656,AESE 279B,A00,494370,Wade; Jon P,33,0,33,0
1713344252682,ANAR 135S,A00,494369,Braswell; Geoffrey E.,0,0,0,0
1713344253706,CAT 124RS,A01,519847,Geibel; William,17,0,20,3
1713344254730,CAT 125RS,A01,515971,Geibel; William,17,0,20,3
1713344255766,CLRE 250,A00,511389,Morris; Sheldon,9996,0,9999,3
1713344256792,CLRE 251,A00,507176,Mehta; Ravindra L.,9996,0,9999,3
1713344256792,CLRE 251,B00,511410,Mehta; Ravindra L.,9998,0,9999,1
1713344257817,CLRE 252,A00,507189,Cuomo; Raphael Eduardo,9998,0,9999,1
1713344258841,CLRE 253,A00,507199,Vaida; Florin,9997,0,9999,2
1713344258841,CLRE 253,B00,507202,Vaida; Florin,9999,0,9999,0
1713344259868,CLRE 259,A00,507211,Patel; Hemal,9996,0,9999,3
1713344260892,CLRE 260,A00,507221,Cuomo; Raphael Eduardo,9999,0,9999,0
1713344261921,CLRE 297,001,507242,Cuomo; Raphael Eduardo,9999,0,9999,0
1713344262947,CSE 191,A00,516875,Minnes Kemp; Mor Mia,9999,0,9999,0
1713344263977,CSS 201S,A01,494383,Staff,35,0,35,0
1713344265002,CSS 202S,A01,494387,Staff,35,0,35,0
1713344266031,EAP 100,A00,516065,Staff,9792,0,9999,207
1713344267059,ECE 45,A01,507414,Staff,51,0,60,9
1713344268086,ECE 100,A01,507416,Baghdadchi; Saharnaz,10,0,20,10
1713344268086,ECE 100,A02,507418,Baghdadchi; Saharnaz,20,0,20,0
1713344269113,ECE 111,A01,507420,Staff,38,0,50,12
1713344270148,ECE 197,001,548057,Sievenpiper; Daniel F.,9998,0,9999,1
1713344271174,EDS 115,A00,507243,Choi; Bailey Miyeon,28,0,28,0
1713344272204,EDS 117,A01,494379,Staff,23,0,25,2
1713344273230,EDS 125,A00,507246,Hopkins; Megan Beth,29,0,30,1
1713344274258,EDS 128A,A01,507264,Fargason; Sharon Gayle,26,0,26,0
1713344275285,EDS 128B,A01,507293,Pappas; Elizabeth,30,0,30,0
1713344276319,EDS 139,A00,507294,Fargason; Sharon Gayle,30,0,30,0
1713344276319,EDS 139,B00,507313,Pappas; Elizabeth,30,0,30,0
1713344277400,EDS 201,A00,507315,Staff,26,0,30,4
1713344278426,EDS 203,A01,507317,Halter; Christopher P.,26,0,30,4
1713344279453,EDS 204R,A01,507319,Halter; Christopher P.,3,0,30,27
1713344279453,EDS 204R,B01,507331,Heinzman; Erica M.,28,0,30,2
1713344280478,EDS 206R,A00,507332,Staff,4,0,30,26
1713344280478,EDS 206R,B00,507343,Staff,28,0,30,2
1713344281509,EDS 250,A00,507344,Hemans; Patricia Ann Benitez,36,0,40,4
1713344282537,EDS 281,A00,507345,Daly; Alan J.,18,0,18,0
1713344283566,EDS 284,A00,507350,Daly; Alan J.,16,0,16,0
1713344284592,EDS 286,A00,507359,Fine; Sarah,18,0,18,0
1713344285618,EDS 289C,A01,507361,Daly; Alan J.,18,0,18,0
1713344286648,EDS 290,A00,507366,Hofstetter; Carolyn,15,0,15,0
1713344287676,LIGM 5A,A00,507421,Fischer-Grunski; Eva K,20,0,20,0
1713344288706,LIGM 5B,A00,507423,Fischer-Grunski; Eva K,20,0,20,0
1713344289736,LIGM 5C,A00,507425,Fischer-Grunski; Eva K,20,0,20,0
1713344290764,LIIT 5AS,A00,507427,Carnelos; Chiara,20,0,20,0
1713344291790,LIIT 5BS,A00,507430,Carnelos; Chiara,20,0,20,0
1713344292816,LIIT 5CS,A00,507432,Carnelos; Chiara,20,0,20,0
1713344293840,LISP 5A,A00,507541,Munoz Sanchez; Alicia,17,0,20,3
1713344294865,LISP 5B,A00,507671,Munoz Sanchez; Alicia,15,0,20,5
1713344295891,LISP 5C,A00,507696,Munoz Sanchez; Alicia,15,0,20,5
1713344296917,MAE 197,001,528363,Boechler; Nicholas Sebastia,9998,0,9999,1
1713344297949,MATH 197,001,523477,Kedlaya; Kiran S.,9999,0,9999,0
1713344297949,MATH 197,002,563811,Zhang; Danna,9999,0,9999,0
1713344298973,MCWP 40R,A00,518780,Staff,20,0,20,0
1713344298973,MCWP 40R,B00,518781,Staff,19,0,20,1
1713344298973,MCWP 40R,C00,518783,Staff,19,0,20,1
1713344300001,MCWP 50R,A00,518791,Staff,20,0,20,0
1713344300001,MCWP 50R,B00,518792,Staff,17,0,20,3
1713344300001,MCWP 50R,C00,518793,Staff,19,0,20,1
1713344300001,MCWP 50R,D00,518794,Staff,16,0,20,4
1713344300001,MCWP 50R,E00,518795,Staff,16,0,20,4
1713344300001,MCWP 50R,F00,518796,Staff,19,0,20,1
1713344300001,MCWP 50R,G00,518797,Staff,19,0,20,1
1713344301033,MMW 12R,A01,514034,Herbst; Matthew,15,0,16,1
1713344301033,MMW 12R,A02,514035,Herbst; Matthew,16,0,16,0
1713344302060,MMW 13R,A01,514037,Staff,12,0,16,4
1713344302060,MMW 13R,A02,514039,Staff,16,0,16,0
1713344304115,SIO 295LS,A00,523233,Staff,18,0,30,12
1713344305144,SIO 295S,A00,523232,Staff,18,0,30,12
1713344306170,SOCI 117,A01,494376,Staff,1,0,5,4
1713344307203,WES 237B,A00,494380,Staff,19,0,20,1
1713344309269,AESE 279B,A00,494370,Wade; Jon P,33,0,33,0
1713344310295,ANAR 135S,A00,494369,Braswell; Geoffrey E.,0,0,0,0
1713344311320,CAT 124RS,A01,519847,Geibel; William,17,0,20,3
1713344312344,CAT 125RS,A01,515971,Geibel; William,17,0,20,3
1713344313375,CLRE 250,A00,511389,Morris; Sheldon,9996,0,9999,3
1713344314402,CLRE 251,A00,507176,Mehta; Ravindra L.,9996,0,9999,3
1713344314402,CLRE 251,B00,511410,Mehta; Ravindra L.,9998,0,9999,1
1713344315431,CLRE 252,A00,507189,Cuomo; Raphael Eduardo,9998,0,9999,1
1713344316456,CLRE 253,A00,507199,Vaida; Florin,9997,0,9999,2
1713344316456,CLRE 253,B00,507202,Vaida; Florin,9999,0,9999,0
1713344317480,CLRE 259,A00,507211,Patel; Hemal,9996,0,9999,3
1713344318506,CLRE 260,A00,507221,Cuomo; Raphael Eduardo,9999,0,9999,0
1713344319534,CLRE 297,001,507242,Cuomo; Raphael Eduardo,9999,0,9999,0
1713344320564,CSE 191,A00,516875,Minnes Kemp; Mor Mia,9999,0,9999,0
1713344321596,CSS 201S,A01,494383,Staff,35,0,35,0
1713344322624,CSS 202S,A01,494387,Staff,35,0,35,0
1713344323653,EAP 100,A00,516065,Staff,9792,0,9999,207
1713344324679,ECE 45,A01,507414,Staff,51,0,60,9
1713344325710,ECE 100,A01,507416,Baghdadchi; Saharnaz,10,0,20,10
1713344325710,ECE 100,A02,507418,Baghdadchi; Saharnaz,20,0,20,0
1713344326740,ECE 111,A01,507420,Staff,38,0,50,12
1713344327768,ECE 197,001,548057,Sievenpiper; Daniel F.,9998,0,9999,1
1713344328794,EDS 115,A00,507243,Choi; Bailey Miyeon,28,0,28,0
1713344329820,EDS 117,A01,494379,Staff,23,0,25,2
1713344330851,EDS 125,A00,507246,Hopkins; Megan Beth,29,0,30,1
1713344331881,EDS 128A,A01,507264,Fargason; Sharon Gayle,26,0,26,0
1713344332913,EDS 128B,A01,507293,Pappas; Elizabeth,30,0,30,0
1713344333943,EDS 139,A00,507294,Fargason; Sharon Gayle,30,0,30,0
1713344333943,EDS 139,B00,507313,Pappas; Elizabeth,30,0,30,0
1713344334973,EDS 201,A00,507315,Staff,26,0,30,4
1713344336004,EDS 203,A01,507317,Halter; Christopher P.,26,0,30,4
1713344337030,EDS 204R,A01,507319,Halter; Christopher P.,3,0,30,27
1713344337030,EDS 204R,B01,507331,Heinzman; Erica M.,28,0,30,2
1713344338055,EDS 206R,A00,507332,Staff,4,0,30,26
1713344338055,EDS 206R,B00,507343,Staff,28,0,30,2
1713344339081,EDS 250,A00,507344,Hemans; Patricia Ann Benitez,36,0,40,4
1713344340113,EDS 281,A00,507345,Daly; Alan J.,18,0,18,0
1713344341140,EDS 284,A00,507350,Daly; Alan J.,16,0,16,0
1713344342165,EDS 286,A00,507359,Fine; Sarah,18,0,18,0
1713344343195,EDS 289C,A01,507361,Daly; Alan J.,18,0,18,0
1713344344221,EDS 290,A00,507366,Hofstetter; Carolyn,15,0,15,0
1713344345247,LIGM 5A,A00,507421,Fischer-Grunski; Eva K,20,0,20,0
1713344346273,LIGM 5B,A00,507423,Fischer-Grunski; Eva K,20,0,20,0
1713344347299,LIGM 5C,A00,507425,Fischer-Grunski; Eva K,20,0,20,0
1713344348331,LIIT 5AS,A00,507427,Carnelos; Chiara,20,0,20,0
1713344349356,LIIT 5BS,A00,507430,Carnelos; Chiara,20,0,20,0
1713344350381,LIIT 5CS,A00,507432,Carnelos; Chiara,20,0,20,0
1713344351414,LISP 5A,A00,507541,Munoz Sanchez; Alicia,17,0,20,3
1713344352440,LISP 5B,A00,507671,Munoz Sanchez; Alicia,15,0,20,5
1713344353468,LISP 5C,A00,507696,Munoz Sanchez; Alicia,15,0,20,5
1713344354495,MAE 197,001,528363,Boechler; Nicholas Sebastia,9998,0,9999,1
1713344355523,MATH 197,001,523477,Kedlaya; Kiran S.,9999,0,9999,0
1713344355523,MATH 197,002,563811,Zhang; Danna,9999,0,9999,0
1713344356554,MCWP 40R,A00,518780,Staff,20,0,20,0
1713344356554,MCWP 40R,B00,518781,Staff,19,0,20,1
1713344356554,MCWP 40R,C00,518783,Staff,19,0,20,1
1713344357582,MCWP 50R,A00,518791,Staff,20,0,20,0
1713344357582,MCWP 50R,B00,518792,Staff,17,0,20,3
1713344357582,MCWP 50R,C00,518793,Staff,19,0,20,1
1713344357582,MCWP 50R,D00,518794,Staff,16,0,20,4
1713344357582,MCWP 50R,E00,518795,Staff,16,0,20,4
1713344357582,MCWP 50R,F00,518796,Staff,19,0,20,1
1713344357582,MCWP 50R,G00,518797,Staff,19,0,20,1
1713344358608,MMW 12R,A01,514034,Herbst; Matthew,15,0,16,1
1713344358608,MMW 12R,A02,514035,Herbst; Matthew,16,0,16,0
1713344359639,MMW 13R,A01,514037,Staff,12,0,16,4
1713344359639,MMW 13R,A02,514039,Staff,16,0,16,0
1713344361697,SIO 295LS,A00,523233,Staff,18,0,30,12
1713344362724,SIO 295S,A00,523232,Staff,18,0,30,12
1713344363750,SOCI 117,A01,494376,Staff,1,0,5,4
1713344364780,WES 237B,A00,494380,Staff,19,0,20,1
1713344366857,AESE 279B,A00,494370,Wade; Jon P,33,0,33,0
1713344367883,ANAR 135S,A00,494369,Braswell; Geoffrey E.,0,0,0,0
1713344368910,CAT 124RS,A01,519847,Geibel; William,17,0,20,3
1713344369935,CAT 125RS,A01,515971,Geibel; William,17,0,20,3
1713344370962,CLRE 250,A00,511389,Morris; Sheldon,9996,0,9999,3
1713344371989,CLRE 251,A00,507176,Mehta; Ravindra L.,9996,0,9999,3
1713344371989,CLRE 251,B00,511410,Mehta; Ravindra L.,9998,0,9999,1
1713344373022,CLRE 252,A00,507189,Cuomo; Raphael Eduardo,9998,0,9999,1
1713344374049,CLRE 253,A00,507199,Vaida; Florin,9997,0,9999,2
1713344374049,CLRE 253,B00,507202,Vaida; Florin,9999,0,9999,0
1713344375076,CLRE 259,A00,507211,Patel; Hemal,9996,0,9999,3
1713344376106,CLRE 260,A00,507221,Cuomo; Raphael Eduardo,9999,0,9999,0
1713344377132,CLRE 297,001,507242,Cuomo; Raphael Eduardo,9999,0,9999,0
1713344378159,CSE 191,A00,516875,Minnes Kemp; Mor Mia,9999,0,9999,0
1713344379192,CSS 201S,A01,494383,Staff,35,0,35,0
1713344380219,CSS 202S,A01,494387,Staff,35,0,35,0
1713344381299,EAP 100,A00,516065,Staff,9792,0,9999,207
1713344382325,ECE 45,A01,507414,Staff,51,0,60,9
1713344383351,ECE 100,A01,507416,Baghdadchi; Saharnaz,10,0,20,10
1713344383351,ECE 100,A02,507418,Baghdadchi; Saharnaz,20,0,20,0
1713344384377,ECE 111,A01,507420,Staff,38,0,50,12
1713344385403,ECE 197,001,548057,Sievenpiper; Daniel F.,9998,0,9999,1
1713344386430,EDS 115,A00,507243,Choi; Bailey Miyeon,28,0,28,0
1713344387457,EDS 117,A01,494379,Staff,23,0,25,2
1713344388489,EDS 125,A00,507246,Hopkins; Megan Beth,29,0,30,1
1713344389516,EDS 128A,A01,507264,Fargason; Sharon Gayle,26,0,26,0
1713344390543,EDS 128B,A01,507293,Pappas; Elizabeth,30,0,30,0
1713344391568,EDS 139,A00,507294,Fargason; Sharon Gayle,30,0,30,0
1713344391568,EDS 139,B00,507313,Pappas; Elizabeth,30,0,30,0
1713344392592,EDS 201,A00,507315,Staff,26,0,30,4
1713344393618,EDS 203,A01,507317,Halter; Christopher P.,26,0,30,4
1713344394646,EDS 204R,A01,507319,Halter; Christopher P.,3,0,30,27
1713344394646,EDS 204R,B01,507331,Heinzman; Erica M.,28,0,30,2
1713344395672,EDS 206R,A00,507332,Staff,4,0,30,26
1713344395672,EDS 206R,B00,507343,Staff,28,0,30,2
1713344396698,EDS 250,A00,507344,Hemans; Patricia Ann Benitez,36,0,40,4
1713344397727,EDS 281,A00,507345,Daly; Alan J.,18,0,18,0
1713344398753,EDS 284,A00,507350,Daly; Alan J.,16,0,16,0
1713344399783,EDS 286,A00,507359,Fine; Sarah,18,0,18,0
1713344400814,EDS 289C,A01,507361,Daly; Alan J.,18,0,18,0
1713344401840,EDS 290,A00,507366,Hofstetter; Carolyn,15,0,15,0
1713344402869,LIGM 5A,A00,507421,Fischer-Grunski; Eva K,20,0,20,0
1713344405863,LIGM 5B,A00,507423,Fischer-Grunski; Eva K,20,0,20,0
1713344406887,LIGM 5C,A00,507425,Fischer-Grunski; Eva K,20,0,20,0
1713344407911,LIIT 5AS,A00,507427,Carnelos; Chiara,20,0,20,0
1713344408936,LIIT 5BS,A00,507430,Carnelos; Chiara,20,0,20,0
1713344409970,LIIT 5CS,A00,507432,Carnelos; Chiara,20,0,20,0
1713344411001,LISP 5A,A00,507541,Munoz Sanchez; Alicia,17,0,20,3
1713344412029,LISP 5B,A00,507671,Munoz Sanchez; Alicia,15,0,20,5
1713344413056,LISP 5C,A00,507696,Munoz Sanchez; Alicia,15,0,20,5
1713344414089,MAE 197,001,528363,Boechler; Nicholas Sebastia,9998,0,9999,1
1713344415117,MATH 197,001,523477,Kedlaya; Kiran S.,9999,0,9999,0
1713344415117,MATH 197,002,563811,Zhang; Danna,9999,0,9999,0
1713344416146,MCWP 40R,A00,518780,Staff,20,0,20,0
1713344416146,MCWP 40R,B00,518781,Staff,19,0,20,1
1713344416146,MCWP 40R,C00,518783,Staff,19,0,20,1
1713344417172,MCWP 50R,A00,518791,Staff,20,0,20,0
1713344417172,MCWP 50R,B00,518792,Staff,17,0,20,3
1713344417172,MCWP 50R,C00,518793,Staff,19,0,20,1
1713344417172,MCWP 50R,D00,518794,Staff,16,0,20,4
1713344417172,MCWP 50R,E00,518795,Staff,16,0,20,4
1713344417172,MCWP 50R,F00,518796,Staff,19,0,20,1
1713344417172,MCWP 50R,G00,518797,Staff,19,0,20,1
1713344418200,MMW 12R,A01,514034,Herbst; Matthew,15,0,16,1
1713344418200,MMW 12R,A02,514035,Herbst; Matthew,16,0,16,0
1713344419226,MMW 13R,A01,514037,Staff,12,0,16,4
1713344419226,MMW 13R,A02,514039,Staff,16,0,16,0
1713344421282,SIO 295LS,A00,523233,Staff,18,0,30,12
1713344422312,SIO 295S,A00,523232,Staff,18,0,30,12
1713344423344,SOCI 117,A01,494376,Staff,1,0,5,4
1713344424368,WES 237B,A00,494380,Staff,19,0,20,1
1713344426441,AESE 279B,A00,494370,Wade; Jon P,33,0,33,0
1713344427468,ANAR 135S,A00,494369,Braswell; Geoffrey E.,0,0,0,0
1713344428494,CAT 124RS,A01,519847,Geibel; William,17,0,20,3
1713344429522,CAT 125RS,A01,515971,Geibel; William,17,0,20,3
1713344430548,CLRE 250,A00,511389,Morris; Sheldon,9996,0,9999,3
1713344431581,CLRE 251,A00,507176,Mehta; Ravindra L.,9996,0,9999,3
1713344431581,CLRE 251,B00,511410,Mehta; Ravindra L.,9998,0,9999,1
1713344432606,CLRE 252,A00,507189,Cuomo; Raphael Eduardo,9998,0,9999,1
1713344433632,CLRE 253,A00,507199,Vaida; Florin,9997,0,9999,2
1713344433632,CLRE 253,B00,507202,Vaida; Florin,9999,0,9999,0
1713344434660,CLRE 259,A00,507211,Patel; Hemal,9996,0,9999,3
1713344435684,CLRE 260,A00,507221,Cuomo; Raphael Eduardo,9999,0,9999,0
1713344436710,CLRE 297,001,507242,Cuomo; Raphael Eduardo,9999,0,9999,0
1713344437742,CSE 191,A00,516875,Minnes Kemp; Mor Mia,9999,0,9999,0
1713344438769,CSS 201S,A01,494383,Staff,35,0,35,0
1713344439796,CSS 202S,A01,494387,Staff,35,0,35,0
1713344440823,EAP 100,A00,516065,Staff,9792,0,9999,207
1713344441850,ECE 45,A01,507414,Staff,51,0,60,9
1713344442960,ECE 100,A01,507416,Baghdadchi; Saharnaz,10,0,20,10
1713344442960,ECE 100,A02,507418,Baghdadchi; Saharnaz,20,0,20,0
1713344443987,ECE 111,A01,507420,Staff,38,0,50,12
1713344445013,ECE 197,001,548057,Sievenpiper; Daniel F.,9998,0,9999,1
1713344446041,EDS 115,A00,507243,Choi; Bailey Miyeon,28,0,28,0
1713344447067,EDS 117,A01,494379,Staff,23,0,25,2
1713344448095,EDS 125,A00,507246,Hopkins; Megan Beth,29,0,30,1
1713344449121,EDS 128A,A01,507264,Fargason; Sharon Gayle,26,0,26,0
1713344450157,EDS 128B,A01,507293,Pappas; Elizabeth,30,0,30,0
1713344451183,EDS 139,A00,507294,Fargason; Sharon Gayle,30,0,30,0
1713344451183,EDS 139,B00,507313,Pappas; Elizabeth,30,0,30,0
1713344452213,EDS 201,A00,507315,Staff,26,0,30,4
1713344453237,EDS 203,A01,507317,Halter; Christopher P.,26,0,30,4
1713344454264,EDS 204R,A01,507319,Halter; Christopher P.,3,0,30,27
1713344454264,EDS 204R,B01,507331,Heinzman; Erica M.,28,0,30,2
1713344455289,EDS 206R,A00,507332,Staff,4,0,30,26
1713344455289,EDS 206R,B00,507343,Staff,28,0,30,2
1713344456318,EDS 250,A00,507344,Hemans; Patricia Ann Benitez,36,0,40,4
1713344457347,EDS 281,A00,507345,Daly; Alan J.,18,0,18,0
1713344458371,EDS 284,A00,507350,Daly; Alan J.,16,0,16,0
1713344459399,EDS 286,A00,507359,Fine; Sarah,18,0,18,0
1713344460443,EDS 289C,A01,507361,Daly; Alan J.,18,0,18,0
1713344461468,EDS 290,A00,507366,Hofstetter; Carolyn,15,0,15,0
1713344462496,LIGM 5A,A00,507421,Fischer-Grunski; Eva K,20,0,20,0
1713344463526,LIGM 5B,A00,507423,Fischer-Grunski; Eva K,20,0,20,0
1713344464551,LIGM 5C,A00,507425,Fischer-Grunski; Eva K,20,0,20,0
1713344465580,LIIT 5AS,A00,507427,Carnelos; Chiara,20,0,20,0
1713344466609,LIIT 5BS,A00,507430,Carnelos; Chiara,20,0,20,0
1713344467634,LIIT 5CS,A00,507432,Carnelos; Chiara,20,0,20,0
1713344468660,LISP 5A,A00,507541,Munoz Sanchez; Alicia,17,0,20,3
1713344469687,LISP 5B,A00,507671,Munoz Sanchez; Alicia,15,0,20,5
1713344470714,LISP 5C,A00,507696,Munoz Sanchez; Alicia,15,0,20,5
1713344471738,MAE 197,001,528363,Boechler; Nicholas Sebastia,9998,0,9999,1
1713344472766,MATH 197,001,523477,Kedlaya; Kiran S.,9999,0,9999,0
1713344472766,MATH 197,002,563811,Zhang; Danna,9999,0,9999,0
1713344473795,MCWP 40R,A00,518780,Staff,20,0,20,0
1713344473795,MCWP 40R,B00,518781,Staff,19,0,20,1
1713344473795,MCWP 40R,C00,518783,Staff,19,0,20,1
1713344474822,MCWP 50R,A00,518791,Staff,20,0,20,0
1713344474822,MCWP 50R,B00,518792,Staff,17,0,20,3
1713344474822,MCWP 50R,C00,518793,Staff,19,0,20,1
1713344474822,MCWP 50R,D00,518794,Staff,16,0,20,4
1713344474822,MCWP 50R,E00,518795,Staff,16,0,20,4
1713344474822,MCWP 50R,F00,518796,Staff,19,0,20,1
1713344474822,MCWP 50R,G00,518797,Staff,19,0,20,1
1713344475849,MMW 12R,A01,514034,Herbst; Matthew,15,0,16,1
1713344475849,MMW 12R,A02,514035,Herbst; Matthew,16,0,16,0
1713344476880,MMW 13R,A01,514037,Staff,12,0,16,4
1713344476880,MMW 13R,A02,514039,Staff,16,0,16,0
1713344478946,SIO 295LS,A00,523233,Staff,18,0,30,12
1713344479972,SIO 295S,A00,523232,Staff,18,0,30,12
1713344480999,SOCI 117,A01,494376,Staff,1,0,5,4
1713344482025,WES 237B,A00,494380,Staff,19,0,20,1
1713344484116,AESE 279B,A00,494370,Wade; Jon P,33,0,33,0
1713344485143,ANAR 135S,A00,494369,Braswell; Geoffrey E.,0,0,0,0
1713344486175,CAT 124RS,A01,519847,Geibel; William,17,0,20,3
1713344487260,CAT 125RS,A01,515971,Geibel; William,17,0,20,3
1713344488287,CLRE 250,A00,511389,Morris; Sheldon,9996,0,9999,3
1713344489317,CLRE 251,A00,507176,Mehta; Ravindra L.,9996,0,9999,3
1713344489317,CLRE 251,B00,511410,Mehta; Ravindra L.,9998,0,9999,1
1713344490344,CLRE 252,A00,507189,Cuomo; Raphael Eduardo,9998,0,9999,1
1713344491376,CLRE 253,A00,507199,Vaida; Florin,9997,0,9999,2
1713344491376,CLRE 253,B00,507202,Vaida; Florin,9999,0,9999,0
1713344492402,CLRE 259,A00,507211,Patel; Hemal,9996,0,9999,3
1713344493429,CLRE 260,A00,507221,Cuomo; Raphael Eduardo,9999,0,9999,0
1713344494453,CLRE 297,001,507242,Cuomo; Raphael Eduardo,9999,0,9999,0
1713344495480,CSE 191,A00,516875,Minnes Kemp; Mor Mia,9999,0,9999,0
1713344496512,CSS 201S,A01,494383,Staff,35,0,35,0
1713344497537,CSS 202S,A01,494387,Staff,35,0,35,0
1713344498566,EAP 100,A00,516065,Staff,9792,0,9999,207
1713344499597,ECE 45,A01,507414,Staff,51,0,60,9
1713344500625,ECE 100,A01,507416,Baghdadchi; Saharnaz,10,0,20,10
1713344500625,ECE 100,A02,507418,Baghdadchi; Saharnaz,20,0,20,0
1713344501653,ECE 111,A01,507420,Staff,38,0,50,12
1713344502681,ECE 197,001,548057,Sievenpiper; Daniel F.,9998,0,9999,1
1713344503707,EDS 115,A00,507243,Choi; Bailey Miyeon,28,0,28,0
1713344504733,EDS 117,A01,494379,Staff,23,0,25,2
1713344505761,EDS 125,A00,507246,Hopkins; Megan Beth,29,0,30,1
1713344506838,EDS 128A,A01,507264,Fargason; Sharon Gayle,26,0,26,0
1713344507865,EDS 128B,A01,507293,Pappas; Elizabeth,30,0,30,0
1713344508891,EDS 139,A00,507294,Fargason; Sharon Gayle,30,0,30,0
1713344508891,EDS 139,B00,507313,Pappas; Elizabeth,30,0,30,0
1713344509921,EDS 201,A00,507315,Staff,26,0,30,4
1713344510952,EDS 203,A01,507317,Halter; Christopher P.,26,0,30,4
1713344511981,EDS 204R,A01,507319,Halter; Christopher P.,3,0,30,27
1713344511981,EDS 204R,B01,507331,Heinzman; Erica M.,28,0,30,2
1713344513008,EDS 206R,A00,507332,Staff,4,0,30,26
1713344513008,EDS 206R,B00,507343,Staff,28,0,30,2
1713344514036,EDS 250,A00,507344,Hemans; Patricia Ann Benitez,36,0,40,4
1713344515062,EDS 281,A00,507345,Daly; Alan J.,18,0,18,0
1713344516090,EDS 284,A00,507350,Daly; Alan J.,16,0,16,0
1713344517118,EDS 286,A00,507359,Fine; Sarah,18,0,18,0
1713344518144,EDS 289C,A01,507361,Daly; Alan J.,18,0,18,0
1713344519174,EDS 290,A00,507366,Hofstetter; Carolyn,15,0,15,0
1713344520211,LIGM 5A,A00,507421,Fischer-Grunski; Eva K,20,0,20,0
1713344521238,LIGM 5B,A00,507423,Fischer-Grunski; Eva K,20,0,20,0
1713344522264,LIGM 5C,A00,507425,Fischer-Grunski; Eva K,20,0,20,0
1713344523290,LIIT 5AS,A00,507427,Carnelos; Chiara,20,0,20,0
1713344524323,LIIT 5BS,A00,507430,Carnelos; Chiara,20,0,20,0
1713344525348,LIIT 5CS,A00,507432,Carnelos; Chiara,20,0,20,0
1713344526374,LISP 5A,A00,507541,Munoz Sanchez; Alicia,17,0,20,3
1713344527404,LISP 5B,A00,507671,Munoz Sanchez; Alicia,15,0,20,5
1713344528434,LISP 5C,A00,507696,Munoz Sanchez; Alicia,15,0,20,5
1713344529459,MAE 197,001,528363,Boechler; Nicholas Sebastia,9998,0,9999,1
1713344530488,MATH 197,001,523477,Kedlaya; Kiran S.,9999,0,9999,0
1713344530488,MATH 197,002,563811,Zhang; Danna,9999,0,9999,0
1713344531520,MCWP 40R,A00,518780,Staff,20,0,20,0
1713344531520,MCWP 40R,B00,518781,Staff,19,0,20,1
1713344531520,MCWP 40R,C00,518783,Staff,19,0,20,1
1713344532545,MCWP 50R,A00,518791,Staff,20,0,20,0
1713344532545,MCWP 50R,B00,518792,Staff,17,0,20,3
1713344532545,MCWP 50R,C00,518793,Staff,19,0,20,1
1713344532545,MCWP 50R,D00,518794,Staff,16,0,20,4
1713344532545,MCWP 50R,E00,518795,Staff,16,0,20,4
1713344532545,MCWP 50R,F00,518796,Staff,19,0,20,1
1713344532545,MCWP 50R,G00,518797,Staff,19,0,20,1
1713344533575,MMW 12R,A01,514034,Herbst; Matthew,15,0,16,1
1713344533575,MMW 12R,A02,514035,Herbst; Matthew,16,0,16,0
1713344534604,MMW 13R,A01,514037,Staff,12,0,16,4
1713344534604,MMW 13R,A02,514039,Staff,16,0,16,0
1713344536662,SIO 295LS,A00,523233,Staff,18,0,30,12
1713344537693,SIO 295S,A00,523232,Staff,18,0,30,12
1713344538719,SOCI 117,A01,494376,Staff,1,0,5,4
1713344539745,WES 237B,A00,494380,Staff,19,0,20,1
1713344541824,AESE 279B,A00,494370,Wade; Jon P,33,0,33,0
1713344542849,ANAR 135S,A00,494369,Braswell; Geoffrey E.,0,0,0,0
1713344543875,CAT 124RS,A01,519847,Geibel; William,17,0,20,3
1713344544900,CAT 125RS,A01,515971,Geibel; William,17,0,20,3
1713344545925,CLRE 250,A00,511389,Morris; Sheldon,9996,0,9999,3
1713344546952,CLRE 251,A00,507176,Mehta; Ravindra L.,9996,0,9999,3
1713344546952,CLRE 251,B00,511410,Mehta; Ravindra L.,9998,0,9999,1
1713344547979,CLRE 252,A00,507189,Cuomo; Raphael Eduardo,9998,0,9999,1
1713344549014,CLRE 253,A00,507199,Vaida; Florin,9997,0,9999,2
1713344549014,CLRE 253,B00,507202,Vaida; Florin,9999,0,9999,0
1713344550041,CLRE 259,A00,507211,Patel; Hemal,9996,0,9999,3
1713344551065,CLRE 260,A00,507221,Cuomo; Raphael Eduardo,9999,0,9999,0
1713344552093,CLRE 297,001,507242,Cuomo; Raphael Eduardo,9999,0,9999,0
1713344553125,CSE 191,A00,516875,Minnes Kemp; Mor Mia,9999,0,9999,0
1713344554155,CSS 201S,A01,494383,Staff,35,0,35,0
1713344555183,CSS 202S,A01,494387,Staff,35,0,35,0
1713344556213,EAP 100,A00,516065,Staff,9792,0,9999,207
1713344557244,ECE 45,A01,507414,Staff,51,0,60,9
1713344558274,ECE 100,A01,507416,Baghdadchi; Saharnaz,10,0,20,10
1713344558274,ECE 100,A02,507418,Baghdadchi; Saharnaz,20,0,20,0
1713344559298,ECE 111,A01,507420,Staff,38,0,50,12
1713344560329,ECE 197,001,548057,Sievenpiper; Daniel F.,9998,0,9999,1
1713344561362,EDS 115,A00,507243,Choi; Bailey Miyeon,28,0,28,0
1713344562388,EDS 117,A01,494379,Staff,23,0,25,2
1713344563419,EDS 125,A00,507246,Hopkins; Megan Beth,29,0,30,1
1713344564449,EDS 128A,A01,507264,Fargason; Sharon Gayle,26,0,26,0
1713344565478,EDS 128B,A01,507293,Pappas; Elizabeth,30,0,30,0
1713344566503,EDS 139,A00,507294,Fargason; Sharon Gayle,30,0,30,0
1713344566503,EDS 139,B00,507313,Pappas; Elizabeth,30,0,30,0
1713344567528,EDS 201,A00,507315,Staff,26,0,30,4
1713344568553,EDS 203,A01,507317,Halter; Christopher P.,26,0,30,4
1713344569580,EDS 204R,A01,507319,Halter; Christopher P.,3,0,30,27
1713344569580,EDS 204R,B01,507331,Heinzman; Erica M.,28,0,30,2
1713344570606,EDS 206R,A00,507332,Staff,4,0,30,26
1713344570606,EDS 206R,B00,507343,Staff,28,0,30,2
1713344571637,EDS 250,A00,507344,Hemans; Patricia Ann Benitez,36,0,40,4
1713344572668,EDS 281,A00,507345,Daly; Alan J.,18,0,18,0
1713344573698,EDS 284,A00,507350,Daly; Alan J.,16,0,16,0
1713344574725,EDS 286,A00,507359,Fine; Sarah,18,0,18,0
1713344575755,EDS 289C,A01,507361,Daly; Alan J.,18,0,18,0
1713344576782,EDS 290,A00,507366,Hofstetter; Carolyn,15,0,15,0
1713344577809,LIGM 5A,A00,507421,Fischer-Grunski; Eva K,20,0,20,0
1713344578836,LIGM 5B,A00,507423,Fischer-Grunski; Eva K,20,0,20,0
1713344579870,LIGM 5C,A00,507425,Fischer-Grunski; Eva K,20,0,20,0
1713344580897,LIIT 5AS,A00,507427,Carnelos; Chiara,20,0,20,0
1713344581925,LIIT 5BS,A00,507430,Carnelos; Chiara,20,0,20,0
1713344582952,LIIT 5CS,A00,507432,Carnelos; Chiara,20,0,20,0
1713344583985,LISP 5A,A00,507541,Munoz Sanchez; Alicia,17,0,20,3
1713344585012,LISP 5B,A00,507671,Munoz Sanchez; Alicia,15,0,20,5
1713344586041,LISP 5C,A00,507696,Munoz Sanchez; Alicia,15,0,20,5
1713344587067,MAE 197,001,528363,Boechler; Nicholas Sebastia,9998,0,9999,1
1713344588094,MATH 197,001,523477,Kedlaya; Kiran S.,9999,0,9999,0
1713344588094,MATH 197,002,563811,Zhang; Danna,9999,0,9999,0
1713344589120,MCWP 40R,A00,518780,Staff,20,0,20,0
1713344589120,MCWP 40R,B00,518781,Staff,19,0,20,1
1713344589120,MCWP 40R,C00,518783,Staff,19,0,20,1
1713344590147,MCWP 50R,A00,518791,Staff,20,0,20,0
1713344590147,MCWP 50R,B00,518792,Staff,17,0,20,3
1713344590147,MCWP 50R,C00,518793,Staff,19,0,20,1
1713344590147,MCWP 50R,D00,518794,Staff,16,0,20,4
1713344590147,MCWP 50R,E00,518795,Staff,16,0,20,4
1713344590147,MCWP 50R,F00,518796,Staff,19,0,20,1
1713344590147,MCWP 50R,G00,518797,Staff,19,0,20,1
1713344591225,MMW 12R,A01,514034,Herbst; Matthew,15,0,16,1
1713344591225,MMW 12R,A02,514035,Herbst; Matthew,16,0,16,0
1713344592254,MMW 13R,A01,514037,Staff,12,0,16,4
1713344592254,MMW 13R,A02,514039,Staff,16,0,16,0
1713344594317,SIO 295LS,A00,523233,Staff,18,0,30,12
1713344595343,SIO 295S,A00,523232,Staff,18,0,30,12
1713344596371,SOCI 117,A01,494376,Staff,1,0,5,4
1713344597397,WES 237B,A00,494380,Staff,19,0,20,1
1713344599477,AESE 279B,A00,494370,Wade; Jon P,33,0,33,0
1713344600503,ANAR 135S,A00,494369,Braswell; Geoffrey E.,0,0,0,0
1713344601532,CAT 124RS,A01,519847,Geibel; William,17,0,20,3
1713344602556,CAT 125RS,A01,515971,Geibel; William,17,0,20,3
1713344603588,CLRE 250,A00,511389,Morris; Sheldon,9996,0,9999,3
1713344604615,CLRE 251,A00,507176,Mehta; Ravindra L.,9996,0,9999,3
1713344604615,CLRE 251,B00,511410,Mehta; Ravindra L.,9998,0,9999,1
1713344605646,CLRE 252,A00,507189,Cuomo; Raphael Eduardo,9998,0,9999,1
1713344606679,CLRE 253,A00,507199,Vaida; Florin,9997,0,9999,2
1713344606679,CLRE 253,B00,507202,Vaida; Florin,9999,0,9999,0
1713344607706,CLRE 259,A00,507211,Patel; Hemal,9996,0,9999,3
1713344608735,CLRE 260,A00,507221,Cuomo; Raphael Eduardo,9999,0,9999,0
1713344609759,CLRE 297,001,507242,Cuomo; Raphael Eduardo,9999,0,9999,0
1713344610792,CSE 191,A00,516875,Minnes Kemp; Mor Mia,9999,0,9999,0
1713344611825,CSS 201S,A01,494383,Staff,35,0,35,0
1713344612851,CSS 202S,A01,494387,Staff,35,0,35,0
1713344613877,EAP 100,A00,516065,Staff,9792,0,9999,207
1713344614911,ECE 45,A01,507414,Staff,51,0,60,9
1713344615938,ECE 100,A01,507416,Baghdadchi; Saharnaz,10,0,20,10
1713344615938,ECE 100,A02,507418,Baghdadchi; Saharnaz,20,0,20,0
1713344616968,ECE 111,A01,507420,Staff,38,0,50,12
1713344617995,ECE 197,001,548057,Sievenpiper; Daniel F.,9998,0,9999,1
1713344619027,EDS 115,A00,507243,Choi; Bailey Miyeon,28,0,28,0
1713344620051,EDS 117,A01,494379,Staff,23,0,25,2
1713344621085,EDS 125,A00,507246,Hopkins; Megan Beth,29,0,30,1
1713344622113,EDS 128A,A01,507264,Fargason; Sharon Gayle,26,0,26,0
1713344623144,EDS 128B,A01,507293,Pappas; Elizabeth,30,0,30,0
1713344624169,EDS 139,A00,507294,Fargason; Sharon Gayle,30,0,30,0
1713344624169,EDS 139,B00,507313,Pappas; Elizabeth,30,0,30,0
1713344625193,EDS 201,A00,507315,Staff,26,0,30,4
1713344626226,EDS 203,A01,507317,Halter; Christopher P.,26,0,30,4
1713344627253,EDS 204R,A01,507319,Halter; Christopher P.,3,0,30,27
1713344627253,EDS 204R,B01,507331,Heinzman; Erica M.,28,0,30,2
1713344628280,EDS 206R,A00,507332,Staff,4,0,30,26
1713344628280,EDS 206R,B00,507343,Staff,28,0,30,2
1713344629310,EDS 250,A00,507344,Hemans; Patricia Ann Benitez,36,0,40,4
1713344630336,EDS 281,A00,507345,Daly; Alan J.,18,0,18,0
1713344631365,EDS 284,A00,507350,Daly; Alan J.,16,0,16,0
1713344632396,EDS 286,A00,507359,Fine; Sarah,18,0,18,0
1713344633421,EDS 289C,A01,507361,Daly; Alan J.,18,0,18,0
1713344634449,EDS 290,A00,507366,Hofstetter; Carolyn,15,0,15,0
1713344635475,LIGM 5A,A00,507421,Fischer-Grunski; Eva K,20,0,20,0
1713344636503,LIGM 5B,A00,507423,Fischer-Grunski; Eva K,20,0,20,0
1713344637536,LIGM 5C,A00,507425,Fischer-Grunski; Eva K,20,0,20,0
1713344638562,LIIT 5AS,A00,507427,Carnelos; Chiara,20,0,20,0
1713344639589,LIIT 5BS,A00,507430,Carnelos; Chiara,20,0,20,0
1713344640617,LIIT 5CS,A00,507432,Carnelos; Chiara,20,0,20,0
1713344641650,LISP 5A,A00,507541,Munoz Sanchez; Alicia,17,0,20,3
1713344642676,LISP 5B,A00,507671,Munoz Sanchez; Alicia,15,0,20,5
1713344643706,LISP 5C,A00,507696,Munoz Sanchez; Alicia,15,0,20,5
1713344644736,MAE 197,001,528363,Boechler; Nicholas Sebastia,9998,0,9999,1
1713344645764,MATH 197,001,523477,Kedlaya; Kiran S.,9999,0,9999,0
1713344645764,MATH 197,002,563811,Zhang; Danna,9999,0,9999,0
1713344646789,MCWP 40R,A00,518780,Staff,20,0,20,0
1713344646789,MCWP 40R,B00,518781,Staff,19,0,20,1
1713344646789,MCWP 40R,C00,518783,Staff,19,0,20,1
1713344647818,MCWP 50R,A00,518791,Staff,20,0,20,0
1713344647818,MCWP 50R,B00,518792,Staff,17,0,20,3
1713344647818,MCWP 50R,C00,518793,Staff,19,0,20,1
1713344647818,MCWP 50R,D00,518794,Staff,16,0,20,4
1713344647818,MCWP 50R,E00,518795,Staff,16,0,20,4
1713344647818,MCWP 50R,F00,518796,Staff,19,0,20,1
1713344647818,MCWP 50R,G00,518797,Staff,19,0,20,1
1713344648847,MMW 12R,A01,514034,Herbst; Matthew,15,0,16,1
1713344648847,MMW 12R,A02,514035,Herbst; Matthew,16,0,16,0
1713344649877,MMW 13R,A01,514037,Staff,12,0,16,4
1713344649877,MMW 13R,A02,514039,Staff,16,0,16,0
1713344651933,SIO 295LS,A00,523233,Staff,18,0,30,12
1713344652959,SIO 295S,A00,523232,Staff,18,0,30,12
1713344653986,SOCI 117,A01,494376,Staff,1,0,5,4
1713344655011,WES 237B,A00,494380,Staff,19,0,20,1
1713344657097,AESE 279B,A00,494370,Wade; Jon P,33,0,33,0
1713344658126,ANAR 135S,A00,494369,Braswell; Geoffrey E.,0,0,0,0
1713344659152,CAT 124RS,A01,519847,Geibel; William,17,0,20,3
1713344660183,CAT 125RS,A01,515971,Geibel; William,17,0,20,3
1713344661209,CLRE 250,A00,511389,Morris; Sheldon,9996,0,9999,3
1713344662237,CLRE 251,A00,507176,Mehta; Ravindra L.,9996,0,9999,3
1713344662237,CLRE 251,B00,511410,Mehta; Ravindra L.,9998,0,9999,1
1713344663264,CLRE 252,A00,507189,Cuomo; Raphael Eduardo,9998,0,9999,1
1713344664294,CLRE 253,A00,507199,Vaida; Florin,9997,0,9999,2
1713344664294,CLRE 253,B00,507202,Vaida; Florin,9999,0,9999,0
1713344665319,CLRE 259,A00,507211,Patel; Hemal,9996,0,9999,3
1713344666349,CLRE 260,A00,507221,Cuomo; Raphael Eduardo,9999,0,9999,0
1713344667378,CLRE 297,001,507242,Cuomo; Raphael Eduardo,9999,0,9999,0
1713344668404,CSE 191,A00,516875,Minnes Kemp; Mor Mia,9999,0,9999,0
1713344669436,CSS 201S,A01,494383,Staff,35,0,35,0
1713344670465,CSS 202S,A01,494387,Staff,35,0,35,0
1713344671497,EAP 100,A00,516065,Staff,9792,0,9999,207
1713344672524,ECE 45,A01,507414,Staff,51,0,60,9
1713344673550,ECE 100,A01,507416,Baghdadchi; Saharnaz,10,0,20,10
1713344673550,ECE 100,A02,507418,Baghdadchi; Saharnaz,20,0,20,0
1713344674580,ECE 111,A01,507420,Staff,38,0,50,12
1713344675606,ECE 197,001,548057,Sievenpiper; Daniel F.,9998,0,9999,1
1713344676634,EDS 115,A00,507243,Choi; Bailey Miyeon,28,0,28,0
1713344677661,EDS 117,A01,494379,Staff,23,0,25,2
1713344678688,EDS 125,A00,507246,Hopkins; Megan Beth,29,0,30,1
1713344679714,EDS 128A,A01,507264,Fargason; Sharon Gayle,26,0,26,0
1713344680740,EDS 128B,A01,507293,Pappas; Elizabeth,30,0,30,0
1713344681765,EDS 139,A00,507294,Fargason; Sharon Gayle,30,0,30,0
1713344681765,EDS 139,B00,507313,Pappas; Elizabeth,30,0,30,0
1713344682814,EDS 201,A00,507315,Staff,26,0,30,4
1713344683840,EDS 203,A01,507317,Halter; Christopher P.,26,0,30,4
1713344684873,EDS 204R,A01,507319,Halter; Christopher P.,3,0,30,27
1713344684873,EDS 204R,B01,507331,Heinzman; Erica M.,28,0,30,2
1713344685898,EDS 206R,A00,507332,Staff,4,0,30,26
1713344685898,EDS 206R,B00,507343,Staff,28,0,30,2
1713344686966,EDS 250,A00,507344,Hemans; Patricia Ann Benitez,36,0,40,4
1713344687996,EDS 281,A00,507345,Daly; Alan J.,18,0,18,0
1713344689027,EDS 284,A00,507350,Daly; Alan J.,16,0,16,0
1713344690057,EDS 286,A00,507359,Fine; Sarah,18,0,18,0
1713344691083,EDS 289C,A01,507361,Daly; Alan J.,18,0,18,0
1713344692109,EDS 290,A00,507366,Hofstetter; Carolyn,15,0,15,0
1713344693139,LIGM 5A,A00,507421,Fischer-Grunski; Eva K,20,0,20,0
1713344694165,LIGM 5B,A00,507423,Fischer-Grunski; Eva K,20,0,20,0
1713344695249,LIGM 5C,A00,507425,Fischer-Grunski; Eva K,20,0,20,0
1713344696282,LIIT 5AS,A00,507427,Carnelos; Chiara,20,0,20,0
1713344697306,LIIT 5BS,A00,507430,Carnelos; Chiara,20,0,20,0
1713344698335,LIIT 5CS,A00,507432,Carnelos; Chiara,20,0,20,0
1713344699363,LISP 5A,A00,507541,Munoz Sanchez; Alicia,17,0,20,3
1713344700390,LISP 5B,A00,507671,Munoz Sanchez; Alicia,15,0,20,5
1713344701416,LISP 5C,A00,507696,Munoz Sanchez; Alicia,15,0,20,5
1713344702448,MAE 197,001,528363,Boechler; Nicholas Sebastia,9998,0,9999,1
1713344703486,MATH 197,001,523477,Kedlaya; Kiran S.,9999,0,9999,0
1713344703486,MATH 197,002,563811,Zhang; Danna,9999,0,9999,0
1713344704514,MCWP 40R,A00,518780,Staff,20,0,20,0
1713344704514,MCWP 40R,B00,518781,Staff,19,0,20,1
1713344704514,MCWP 40R,C00,518783,Staff,19,0,20,1
1713344705542,MCWP 50R,A00,518791,Staff,20,0,20,0
1713344705542,MCWP 50R,B00,518792,Staff,17,0,20,3
1713344705542,MCWP 50R,C00,518793,Staff,19,0,20,1
1713344705542,MCWP 50R,D00,518794,Staff,16,0,20,4
1713344705542,MCWP 50R,E00,518795,Staff,16,0,20,4
1713344705542,MCWP 50R,F00,518796,Staff,19,0,20,1
1713344705542,MCWP 50R,G00,518797,Staff,19,0,20,1
1713344706568,MMW 12R,A01,514034,Herbst; Matthew,15,0,16,1
1713344706568,MMW 12R,A02,514035,Herbst; Matthew,16,0,16,0
1713344707597,MMW 13R,A01,514037,Staff,12,0,16,4
1713344707597,MMW 13R,A02,514039,Staff,16,0,16,0
1713344709653,SIO 295LS,A00,523233,Staff,18,0,30,12
1713344710679,SIO 295S,A00,523232,Staff,18,0,30,12
1713344711710,SOCI 117,A01,494376,Staff,1,0,5,4
1713344712738,WES 237B,A00,494380,Staff,19,0,20,1
1713344714822,AESE 279B,A00,494370,Wade; Jon P,33,0,33,0
1713344715847,ANAR 135S,A00,494369,Braswell; Geoffrey E.,0,0,0,0
1713344716874,CAT 124RS,A01,519847,Geibel; William,17,0,20,3
1713344717902,CAT 125RS,A01,515971,Geibel; William,17,0,20,3
1713344718929,CLRE 250,A00,511389,Morris; Sheldon,9996,0,9999,3
1713344719963,CLRE 251,A00,507176,Mehta; Ravindra L.,9996,0,9999,3
1713344719963,CLRE 251,B00,511410,Mehta; Ravindra L.,9998,0,9999,1
1713344720995,CLRE 252,A00,507189,Cuomo; Raphael Eduardo,9998,0,9999,1
1713344722021,CLRE 253,A00,507199,Vaida; Florin,9997,0,9999,2
1713344722021,CLRE 253,B00,507202,Vaida; Florin,9999,0,9999,0
1713344723049,CLRE 259,A00,507211,Patel; Hemal,9996,0,9999,3
1713344724074,CLRE 260,A00,507221,Cuomo; Raphael Eduardo,9999,0,9999,0
1713344725103,CLRE 297,001,507242,Cuomo; Raphael Eduardo,9999,0,9999,0
1713344726129,CSE 191,A00,516875,Minnes Kemp; Mor Mia,9999,0,9999,0
1713344727165,CSS 201S,A01,494383,Staff,35,0,35,0
1713344728190,CSS 202S,A01,494387,Staff,35,0,35,0
1713344729221,EAP 100,A00,516065,Staff,9792,0,9999,207
1713344730248,ECE 45,A01,507414,Staff,51,0,60,9
1713344731274,ECE 100,A01,507416,Baghdadchi; Saharnaz,10,0,20,10
1713344731274,ECE 100,A02,507418,Baghdadchi; Saharnaz,20,0,20,0
1713344732303,ECE 111,A01,507420,Staff,38,0,50,12
1713344733332,ECE 197,001,548057,Sievenpiper; Daniel F.,9998,0,9999,1
1713344734361,EDS 115,A00,507243,Choi; Bailey Miyeon,28,0,28,0
1713344735387,EDS 117,A01,494379,Staff,23,0,25,2
1713344736413,EDS 125,A00,507246,Hopkins; Megan Beth,29,0,30,1
1713344737439,EDS 128A,A01,507264,Fargason; Sharon Gayle,26,0,26,0
1713344738471,EDS 128B,A01,507293,Pappas; Elizabeth,30,0,30,0
1713344739495,EDS 139,A00,507294,Fargason; Sharon Gayle,30,0,30,0
1713344739495,EDS 139,B00,507313,Pappas; Elizabeth,30,0,30,0
1713344740523,EDS 201,A00,507315,Staff,26,0,30,4
1713344741549,EDS 203,A01,507317,Halter; Christopher P.,26,0,30,4
1713344742581,EDS 204R,A01,507319,Halter; Christopher P.,3,0,30,27
1713344742581,EDS 204R,B01,507331,Heinzman; Erica M.,28,0,30,2
1713344743608,EDS 206R,A00,507332,Staff,4,0,30,26
1713344743608,EDS 206R,B00,507343,Staff,28,0,30,2
1713344744637,EDS 250,A00,507344,Hemans; Patricia Ann Benitez,36,0,40,4
1713344745662,EDS 281,A00,507345,Daly; Alan J.,18,0,18,0
1713344746691,EDS 284,A00,507350,Daly; Alan J.,16,0,16,0
1713344747717,EDS 286,A00,507359,Fine; Sarah,18,0,18,0
1713344748748,EDS 289C,A01,507361,Daly; Alan J.,18,0,18,0
1713344749790,EDS 290,A00,507366,Hofstetter; Carolyn,15,0,15,0
1713344750820,LIGM 5A,A00,507421,Fischer-Grunski; Eva K,20,0,20,0
1713344751846,LIGM 5B,A00,507423,Fischer-Grunski; Eva K,20,0,20,0
1713344752870,LIGM 5C,A00,507425,Fischer-Grunski; Eva K,20,0,20,0
1713344753900,LIIT 5AS,A00,507427,Carnelos; Chiara,20,0,20,0
1713344754931,LIIT 5BS,A00,507430,Carnelos; Chiara,20,0,20,0
1713344755960,LIIT 5CS,A00,507432,Carnelos; Chiara,20,0,20,0
1713344756986,LISP 5A,A00,507541,Munoz Sanchez; Alicia,17,0,20,3
1713344758012,LISP 5B,A00,507671,Munoz Sanchez; Alicia,15,0,20,5
1713344759038,LISP 5C,A00,507696,Munoz Sanchez; Alicia,15,0,20,5
1713344760064,MAE 197,001,528363,Boechler; Nicholas Sebastia,9998,0,9999,1
1713344761098,MATH 197,001,523477,Kedlaya; Kiran S.,9999,0,9999,0
1713344761098,MATH 197,002,563811,Zhang; Danna,9999,0,9999,0
1713344762131,MCWP 40R,A00,518780,Staff,20,0,20,0
1713344762131,MCWP 40R,B00,518781,Staff,19,0,20,1
1713344762131,MCWP 40R,C00,518783,Staff,19,0,20,1
1713344763159,MCWP 50R,A00,518791,Staff,20,0,20,0
1713344763159,MCWP 50R,B00,518792,Staff,17,0,20,3
1713344763159,MCWP 50R,C00,518793,Staff,19,0,20,1
1713344763159,MCWP 50R,D00,518794,Staff,16,0,20,4
1713344763159,MCWP 50R,E00,518795,Staff,16,0,20,4
1713344763159,MCWP 50R,F00,518796,Staff,19,0,20,1
1713344763159,MCWP 50R,G00,518797,Staff,19,0,20,1
1713344764184,MMW 12R,A01,514034,Herbst; Matthew,15,0,16,1
1713344764184,MMW 12R,A02,514035,Herbst; Matthew,16,0,16,0
1713344765210,MMW 13R,A01,514037,Staff,12,0,16,4
1713344765210,MMW 13R,A02,514039,Staff,16,0,16,0
1713344767264,SIO 295LS,A00,523233,Staff,18,0,30,12
1713344768289,SIO 295S,A00,523232,Staff,18,0,30,12
1713344769314,SOCI 117,A01,494376,Staff,1,0,5,4
1713344770339,WES 237B,A00,494380,Staff,19,0,20,1
1713344772445,AESE 279B,A00,494370,Wade; Jon P,33,0,33,0
1713344773472,ANAR 135S,A00,494369,Braswell; Geoffrey E.,0,0,0,0
1713344774498,CAT 124RS,A01,519847,Geibel; William,17,0,20,3
1713344775522,CAT 125RS,A01,515971,Geibel; William,17,0,20,3
1713344776549,CLRE 250,A00,511389,Morris; Sheldon,9996,0,9999,3
1713344777583,CLRE 251,A00,507176,Mehta; Ravindra L.,9996,0,9999,3
1713344777583,CLRE 251,B00,511410,Mehta; Ravindra L.,9998,0,9999,1
1713344778610,CLRE 252,A00,507189,Cuomo; Raphael Eduardo,9998,0,9999,1
1713344779640,CLRE 253,A00,507199,Vaida; Florin,9997,0,9999,2
1713344779640,CLRE 253,B00,507202,Vaida; Florin,9999,0,9999,0
1713344780665,CLRE 259,A00,507211,Patel; Hemal,9996,0,9999,3
1713344781691,CLRE 260,A00,507221,Cuomo; Raphael Eduardo,9999,0,9999,0
1713344782717,CLRE 297,001,507242,Cuomo; Raphael Eduardo,9999,0,9999,0
1713344783744,CSE 191,A00,516875,Minnes Kemp; Mor Mia,9999,0,9999,0
1713344784778,CSS 201S,A01,494383,Staff,35,0,35,0
1713344785809,CSS 202S,A01,494387,Staff,35,0,35,0
1713344786839,EAP 100,A00,516065,Staff,9792,0,9999,207
1713344787871,ECE 45,A01,507414,Staff,51,0,60,9
1713344788897,ECE 100,A01,507416,Baghdadchi; Saharnaz,10,0,20,10
1713344788897,ECE 100,A02,507418,Baghdadchi; Saharnaz,20,0,20,0
1713344789927,ECE 111,A01,507420,Staff,38,0,50,12
1713344790954,ECE 197,001,548057,Sievenpiper; Daniel F.,9998,0,9999,1
1713344791980,EDS 115,A00,507243,Choi; Bailey Miyeon,28,0,28,0
1713344793011,EDS 117,A01,494379,Staff,23,0,25,2
1713344794042,EDS 125,A00,507246,Hopkins; Megan Beth,29,0,30,1
1713344795068,EDS 128A,A01,507264,Fargason; Sharon Gayle,26,0,26,0
1713344796096,EDS 128B,A01,507293,Pappas; Elizabeth,30,0,30,0
1713344797121,EDS 139,A00,507294,Fargason; Sharon Gayle,30,0,30,0
1713344797121,EDS 139,B00,507313,Pappas; Elizabeth,30,0,30,0
1713344798146,EDS 201,A00,507315,Staff,26,0,30,4
1713344799230,EDS 203,A01,507317,Halter; Christopher P.,26,0,30,4
1713344800267,EDS 204R,A01,507319,Halter; Christopher P.,3,0,30,27
1713344800267,EDS 204R,B01,507331,Heinzman; Erica M.,28,0,30,2
1713344801295,EDS 206R,A00,507332,Staff,4,0,30,26
1713344801295,EDS 206R,B00,507343,Staff,28,0,30,2
1713344802324,EDS 250,A00,507344,Hemans; Patricia Ann Benitez,36,0,40,4
1713344803350,EDS 281,A00,507345,Daly; Alan J.,18,0,18,0
1713344804380,EDS 284,A00,507350,Daly; Alan J.,16,0,16,0
1713344805406,EDS 286,A00,507359,Fine; Sarah,18,0,18,0
1713344806432,EDS 289C,A01,507361,Daly; Alan J.,18,0,18,0
1713344807458,EDS 290,A00,507366,Hofstetter; Carolyn,15,0,15,0
1713344808484,LIGM 5A,A00,507421,Fischer-Grunski; Eva K,20,0,20,0
1713344809509,LIGM 5B,A00,507423,Fischer-Grunski; Eva K,20,0,20,0
1713344810535,LIGM 5C,A00,507425,Fischer-Grunski; Eva K,20,0,20,0
1713344811566,LIIT 5AS,A00,507427,Carnelos; Chiara,20,0,20,0
1713344812596,LIIT 5BS,A00,507430,Carnelos; Chiara,20,0,20,0
1713344813626,LIIT 5CS,A00,507432,Carnelos; Chiara,20,0,20,0
1713344814652,LISP 5A,A00,507541,Munoz Sanchez; Alicia,17,0,20,3
1713344815677,LISP 5B,A00,507671,Munoz Sanchez; Alicia,15,0,20,5
1713344816710,LISP 5C,A00,507696,Munoz Sanchez; Alicia,15,0,20,5
1713344817738,MAE 197,001,528363,Boechler; Nicholas Sebastia,9998,0,9999,1
1713344818764,MATH 197,001,523477,Kedlaya; Kiran S.,9999,0,9999,0
1713344818764,MATH 197,002,563811,Zhang; Danna,9999,0,9999,0
1713344819790,MCWP 40R,A00,518780,Staff,20,0,20,0
1713344819790,MCWP 40R,B00,518781,Staff,19,0,20,1
1713344819790,MCWP 40R,C00,518783,Staff,19,0,20,1
1713344820823,MCWP 50R,A00,518791,Staff,20,0,20,0
1713344820823,MCWP 50R,B00,518792,Staff,17,0,20,3
1713344820823,MCWP 50R,C00,518793,Staff,19,0,20,1
1713344820823,MCWP 50R,D00,518794,Staff,16,0,20,4
1713344820823,MCWP 50R,E00,518795,Staff,16,0,20,4
1713344820823,MCWP 50R,F00,518796,Staff,19,0,20,1
1713344820823,MCWP 50R,G00,518797,Staff,19,0,20,1
1713344821850,MMW 12R,A01,514034,Herbst; Matthew,15,0,16,1
1713344821850,MMW 12R,A02,514035,Herbst; Matthew,16,0,16,0
1713344822879,MMW 13R,A01,514037,Staff,12,0,16,4
1713344822879,MMW 13R,A02,514039,Staff,16,0,16,0
1713344824936,SIO 295LS,A00,523233,Staff,18,0,30,12
1713344825961,SIO 295S,A00,523232,Staff,18,0,30,12
1713344826990,SOCI 117,A01,494376,Staff,1,0,5,4
1713344828016,WES 237B,A00,494380,Staff,19,0,20,1
1713344830084,AESE 279B,A00,494370,Wade; Jon P,33,0,33,0
1713344831110,ANAR 135S,A00,494369,Braswell; Geoffrey E.,0,0,0,0
1713344832136,CAT 124RS,A01,519847,Geibel; William,17,0,20,3
1713344833161,CAT 125RS,A01,515971,Geibel; William,17,0,20,3
1713344834189,CLRE 250,A00,511389,Morris; Sheldon,9996,0,9999,3
1713344835222,CLRE 251,A00,507176,Mehta; Ravindra L.,9996,0,9999,3
1713344835222,CLRE 251,B00,511410,Mehta; Ravindra L.,9998,0,9999,1
1713344836253,CLRE 252,A00,507189,Cuomo; Raphael Eduardo,9998,0,9999,1
1713344837279,CLRE 253,A00,507199,Vaida; Florin,9997,0,9999,2
1713344837279,CLRE 253,B00,507202,Vaida; Florin,9999,0,9999,0
1713344838307,CLRE 259,A00,507211,Patel; Hemal,9996,0,9999,3
1713344839337,CLRE 260,A00,507221,Cuomo; Raphael Eduardo,9999,0,9999,0
1713344840366,CLRE 297,001,507242,Cuomo; Raphael Eduardo,9999,0,9999,0
1713344841397,CSE 191,A00,516875,Minnes Kemp; Mor Mia,9999,0,9999,0
1713344842425,CSS 201S,A01,494383,Staff,35,0,35,0
1713344843452,CSS 202S,A01,494387,Staff,35,0,35,0
1713344844477,EAP 100,A00,516065,Staff,9792,0,9999,207
1713344845507,ECE 45,A01,507414,Staff,51,0,60,9
1713344846539,ECE 100,A01,507416,Baghdadchi; Saharnaz,10,0,20,10
1713344846539,ECE 100,A02,507418,Baghdadchi; Saharnaz,20,0,20,0
1713344847566,ECE 111,A01,507420,Staff,38,0,50,12
1713344848591,ECE 197,001,548057,Sievenpiper; Daniel F.,9998,0,9999,1
1713344849623,EDS 115,A00,507243,Choi; Bailey Miyeon,28,0,28,0
1713344850648,EDS 117,A01,494379,Staff,23,0,25,2
1713344851674,EDS 125,A00,507246,Hopkins; Megan Beth,29,0,30,1
1713344852699,EDS 128A,A01,507264,Fargason; Sharon Gayle,26,0,26,0
1713344853732,EDS 128B,A01,507293,Pappas; Elizabeth,30,0,30,0
1713344854763,EDS 139,A00,507294,Fargason; Sharon Gayle,30,0,30,0
1713344854763,EDS 139,B00,507313,Pappas; Elizabeth,30,0,30,0
1713344855793,EDS 201,A00,507315,Staff,26,0,30,4
1713344856819,EDS 203,A01,507317,Halter; Christopher P.,26,0,30,4
1713344857845,EDS 204R,A01,507319,Halter; Christopher P.,3,0,30,27
1713344857845,EDS 204R,B01,507331,Heinzman; Erica M.,28,0,30,2
1713344858874,EDS 206R,A00,507332,Staff,4,0,30,26
1713344858874,EDS 206R,B00,507343,Staff,28,0,30,2
1713344859900,EDS 250,A00,507344,Hemans; Patricia Ann Benitez,36,0,40,4
1713344860925,EDS 281,A00,507345,Daly; Alan J.,18,0,18,0
1713344861953,EDS 284,A00,507350,Daly; Alan J.,16,0,16,0
1713344862985,EDS 286,A00,507359,Fine; Sarah,18,0,18,0
1713344864010,EDS 289C,A01,507361,Daly; Alan J.,18,0,18,0
1713344865038,EDS 290,A00,507366,Hofstetter; Carolyn,15,0,15,0
1713344866065,LIGM 5A,A00,507421,Fischer-Grunski; Eva K,20,0,20,0
1713344867089,LIGM 5B,A00,507423,Fischer-Grunski; Eva K,20,0,20,0
1713344868115,LIGM 5C,A00,507425,Fischer-Grunski; Eva K,20,0,20,0
1713344869141,LIIT 5AS,A00,507427,Carnelos; Chiara,20,0,20,0
1713344870171,LIIT 5BS,A00,507430,Carnelos; Chiara,20,0,20,0
1713344871201,LIIT 5CS,A00,507432,Carnelos; Chiara,20,0,20,0
1713344872233,LISP 5A,A00,507541,Munoz Sanchez; Alicia,17,0,20,3
1713344873259,LISP 5B,A00,507671,Munoz Sanchez; Alicia,15,0,20,5
1713344874284,LISP 5C,A00,507696,Munoz Sanchez; Alicia,15,0,20,5
1713344875310,MAE 197,001,528363,Boechler; Nicholas Sebastia,9998,0,9999,1
1713344876344,MATH 197,001,523477,Kedlaya; Kiran S.,9999,0,9999,0
1713344876344,MATH 197,002,563811,Zhang; Danna,9999,0,9999,0
1713344877371,MCWP 40R,A00,518780,Staff,20,0,20,0
1713344877371,MCWP 40R,B00,518781,Staff,19,0,20,1
1713344877371,MCWP 40R,C00,518783,Staff,19,0,20,1
1713344878400,MCWP 50R,A00,518791,Staff,20,0,20,0
1713344878400,MCWP 50R,B00,518792,Staff,17,0,20,3
1713344878400,MCWP 50R,C00,518793,Staff,19,0,20,1
1713344878400,MCWP 50R,D00,518794,Staff,16,0,20,4
1713344878400,MCWP 50R,E00,518795,Staff,16,0,20,4
1713344878400,MCWP 50R,F00,518796,Staff,19,0,20,1
1713344878400,MCWP 50R,G00,518797,Staff,19,0,20,1
1713344879427,MMW 12R,A01,514034,Herbst; Matthew,15,0,16,1
1713344879427,MMW 12R,A02,514035,Herbst; Matthew,16,0,16,0
1713344880451,MMW 13R,A01,514037,Staff,12,0,16,4
1713344880451,MMW 13R,A02,514039,Staff,16,0,16,0
1713344882509,SIO 295LS,A00,523233,Staff,18,0,30,12
1713344883538,SIO 295S,A00,523232,Staff,18,0,30,12
1713344884563,SOCI 117,A01,494376,Staff,1,0,5,4
1713344885591,WES 237B,A00,494380,Staff,19,0,20,1
1713344887679,AESE 279B,A00,494370,Wade; Jon P,33,0,33,0
1713344888704,ANAR 135S,A00,494369,Braswell; Geoffrey E.,0,0,0,0
1713344889731,CAT 124RS,A01,519847,Geibel; William,17,0,20,3
1713344890757,CAT 125RS,A01,515971,Geibel; William,17,0,20,3
1713344891783,CLRE 250,A00,511389,Morris; Sheldon,9996,0,9999,3
1713344892812,CLRE 251,A00,507176,Mehta; Ravindra L.,9996,0,9999,3
1713344892812,CLRE 251,B00,511410,Mehta; Ravindra L.,9998,0,9999,1
1713344893843,CLRE 252,A00,507189,Cuomo; Raphael Eduardo,9998,0,9999,1
1713344894868,CLRE 253,A00,507199,Vaida; Florin,9997,0,9999,2
1713344894868,CLRE 253,B00,507202,Vaida; Florin,9999,0,9999,0
1713344895898,CLRE 259,A00,507211,Patel; Hemal,9996,0,9999,3
1713344896924,CLRE 260,A00,507221,Cuomo; Raphael Eduardo,9999,0,9999,0
1713344897954,CLRE 297,001,507242,Cuomo; Raphael Eduardo,9999,0,9999,0
1713344898979,CSE 191,A00,516875,Minnes Kemp; Mor Mia,9999,0,9999,0
1713344900010,CSS 201S,A01,494383,Staff,35,0,35,0
1713344901036,CSS 202S,A01,494387,Staff,35,0,35,0
1713344902067,EAP 100,A00,516065,Staff,9792,0,9999,207
1713344903151,ECE 45,A01,507414,Staff,51,0,60,9
1713344904181,ECE 100,A01,507416,Baghdadchi; Saharnaz,10,0,20,10
1713344904181,ECE 100,A02,507418,Baghdadchi; Saharnaz,20,0,20,0
1713344905206,ECE 111,A01,507420,Staff,38,0,50,12
1713344906231,ECE 197,001,548057,Sievenpiper; Daniel F.,9998,0,9999,1
1713344907259,EDS 115,A00,507243,Choi; Bailey Miyeon,28,0,28,0
1713344908286,EDS 117,A01,494379,Staff,23,0,25,2
1713344909316,EDS 125,A00,507246,Hopkins; Megan Beth,29,0,30,1
1713344910346,EDS 128A,A01,507264,Fargason; Sharon Gayle,26,0,26,0
1713344911372,EDS 128B,A01,507293,Pappas; Elizabeth,30,0,30,0
1713344912397,EDS 139,A00,507294,Fargason; Sharon Gayle,30,0,30,0
1713344912397,EDS 139,B00,507313,Pappas; Elizabeth,30,0,30,0
1713344913426,EDS 201,A00,507315,Staff,26,0,30,4
1713344914457,EDS 203,A01,507317,Halter; Christopher P.,26,0,30,4
1713344915483,EDS 204R,A01,507319,Halter; Christopher P.,3,0,30,27
1713344915483,EDS 204R,B01,507331,Heinzman; Erica M.,28,0,30,2
1713344916509,EDS 206R,A00,507332,Staff,4,0,30,26
1713344916509,EDS 206R,B00,507343,Staff,28,0,30,2
1713344917536,EDS 250,A00,507344,Hemans; Patricia Ann Benitez,36,0,40,4
1713344918562,EDS 281,A00,507345,Daly; Alan J.,18,0,18,0
1713344919591,EDS 284,A00,507350,Daly; Alan J.,16,0,16,0
1713344920621,EDS 286,A00,507359,Fine; Sarah,18,0,18,0
1713344921648,EDS 289C,A01,507361,Daly; Alan J.,18,0,18,0
1713344922673,EDS 290,A00,507366,Hofstetter; Carolyn,15,0,15,0
1713344923706,LIGM 5A,A00,507421,Fischer-Grunski; Eva K,20,0,20,0
1713344924737,LIGM 5B,A00,507423,Fischer-Grunski; Eva K,20,0,20,0
1713344925765,LIGM 5C,A00,507425,Fischer-Grunski; Eva K,20,0,20,0
1713344926799,LIIT 5AS,A00,507427,Carnelos; Chiara,20,0,20,0
1713344927829,LIIT 5BS,A00,507430,Carnelos; Chiara,20,0,20,0
1713344928860,LIIT 5CS,A00,507432,Carnelos; Chiara,20,0,20,0
1713344929887,LISP 5A,A00,507541,Munoz Sanchez; Alicia,17,0,20,3
1713344930917,LISP 5B,A00,507671,Munoz Sanchez; Alicia,15,0,20,5
1713344931950,LISP 5C,A00,507696,Munoz Sanchez; Alicia,15,0,20,5
1713344932978,MAE 197,001,528363,Boechler; Nicholas Sebastia,9998,0,9999,1
1713344934005,MATH 197,001,523477,Kedlaya; Kiran S.,9999,0,9999,0
1713344934005,MATH 197,002,563811,Zhang; Danna,9999,0,9999,0
1713344935031,MCWP 40R,A00,518780,Staff,20,0,20,0
1713344935031,MCWP 40R,B00,518781,Staff,19,0,20,1
1713344935031,MCWP 40R,C00,518783,Staff,19,0,20,1
1713344936059,MCWP 50R,A00,518791,Staff,20,0,20,0
1713344936059,MCWP 50R,B00,518792,Staff,17,0,20,3
1713344936059,MCWP 50R,C00,518793,Staff,19,0,20,1
1713344936059,MCWP 50R,D00,518794,Staff,16,0,20,4
1713344936059,MCWP 50R,E00,518795,Staff,16,0,20,4
1713344936059,MCWP 50R,F00,518796,Staff,19,0,20,1
1713344936059,MCWP 50R,G00,518797,Staff,19,0,20,1
1713344937089,MMW 12R,A01,514034,Herbst; Matthew,15,0,16,1
1713344937089,MMW 12R,A02,514035,Herbst; Matthew,16,0,16,0
1713344938114,MMW 13R,A01,514037,Staff,12,0,16,4
1713344938114,MMW 13R,A02,514039,Staff,16,0,16,0
1713344940173,SIO 295LS,A00,523233,Staff,18,0,30,12
1713344941203,SIO 295S,A00,523232,Staff,18,0,30,12
1713344942233,SOCI 117,A01,494376,Staff,1,0,5,4
1713344943266,WES 237B,A00,494380,Staff,19,0,20,1
1713344945359,AESE 279B,A00,494370,Wade; Jon P,33,0,33,0
1713344946390,ANAR 135S,A00,494369,Braswell; Geoffrey E.,0,0,0,0
1713344947420,CAT 124RS,A01,519847,Geibel; William,17,0,20,3
1713344948446,CAT 125RS,A01,515971,Geibel; William,17,0,20,3
1713344949471,CLRE 250,A00,511389,Morris; Sheldon,9996,0,9999,3
1713344950498,CLRE 251,A00,507176,Mehta; Ravindra L.,9996,0,9999,3
1713344950498,CLRE 251,B00,511410,Mehta; Ravindra L.,9998,0,9999,1
1713344951530,CLRE 252,A00,507189,Cuomo; Raphael Eduardo,9998,0,9999,1
1713344952556,CLRE 253,A00,507199,Vaida; Florin,9997,0,9999,2
1713344952556,CLRE 253,B00,507202,Vaida; Florin,9999,0,9999,0
1713344953588,CLRE 259,A00,507211,Patel; Hemal,9996,0,9999,3
1713344954617,CLRE 260,A00,507221,Cuomo; Raphael Eduardo,9999,0,9999,0
1713344955643,CLRE 297,001,507242,Cuomo; Raphael Eduardo,9999,0,9999,0
1713344956670,CSE 191,A00,516875,Minnes Kemp; Mor Mia,9999,0,9999,0
1713344957697,CSS 201S,A01,494383,Staff,35,0,35,0
1713344958724,CSS 202S,A01,494387,Staff,35,0,35,0
1713344959752,EAP 100,A00,516065,Staff,9792,0,9999,207
1713344960780,ECE 45,A01,507414,Staff,51,0,60,9
1713344961804,ECE 100,A01,507416,Baghdadchi; Saharnaz,10,0,20,10
1713344961804,ECE 100,A02,507418,Baghdadchi; Saharnaz,20,0,20,0
1713344962830,ECE 111,A01,507420,Staff,38,0,50,12
1713344963862,ECE 197,001,548057,Sievenpiper; Daniel F.,9998,0,9999,1
1713344964889,EDS 115,A00,507243,Choi; Bailey Miyeon,28,0,28,0
1713344965916,EDS 117,A01,494379,Staff,23,0,25,2
1713344966942,EDS 125,A00,507246,Hopkins; Megan Beth,29,0,30,1
1713344967970,EDS 128A,A01,507264,Fargason; Sharon Gayle,26,0,26,0
1713344969001,EDS 128B,A01,507293,Pappas; Elizabeth,30,0,30,0
1713344970029,EDS 139,A00,507294,Fargason; Sharon Gayle,30,0,30,0
1713344970029,EDS 139,B00,507313,Pappas; Elizabeth,30,0,30,0
1713344971054,EDS 201,A00,507315,Staff,26,0,30,4
1713344972081,EDS 203,A01,507317,Halter; Christopher P.,26,0,30,4
1713344973107,EDS 204R,A01,507319,Halter; Christopher P.,3,0,30,27
1713344973107,EDS 204R,B01,507331,Heinzman; Erica M.,28,0,30,2
1713344974132,EDS 206R,A00,507332,Staff,4,0,30,26
1713344974132,EDS 206R,B00,507343,Staff,28,0,30,2
1713344975161,EDS 250,A00,507344,Hemans; Patricia Ann Benitez,36,0,40,4
1713344976185,EDS 281,A00,507345,Daly; Alan J.,18,0,18,0
1713344977214,EDS 284,A00,507350,Daly; Alan J.,16,0,16,0
1713344978240,EDS 286,A00,507359,Fine; Sarah,18,0,18,0
1713344979266,EDS 289C,A01,507361,Daly; Alan J.,18,0,18,0
1713344980296,EDS 290,A00,507366,Hofstetter; Carolyn,15,0,15,0
1713344981331,LIGM 5A,A00,507421,Fischer-Grunski; Eva K,20,0,20,0
1713344982360,LIGM 5B,A00,507423,Fischer-Grunski; Eva K,20,0,20,0
1713344983386,LIGM 5C,A00,507425,Fischer-Grunski; Eva K,20,0,20,0
1713344984417,LIIT 5AS,A00,507427,Carnelos; Chiara,20,0,20,0
1713344985441,LIIT 5BS,A00,507430,Carnelos; Chiara,20,0,20,0
1713344986467,LIIT 5CS,A00,507432,Carnelos; Chiara,20,0,20,0
1713344987498,LISP 5A,A00,507541,Munoz Sanchez; Alicia,17,0,20,3
1713344988524,LISP 5B,A00,507671,Munoz Sanchez; Alicia,15,0,20,5
1713344989549,LISP 5C,A00,507696,Munoz Sanchez; Alicia,15,0,20,5
1713344990575,MAE 197,001,528363,Boechler; Nicholas Sebastia,9998,0,9999,1
1713344991608,MATH 197,001,523477,Kedlaya; Kiran S.,9999,0,9999,0
1713344991608,MATH 197,002,563811,Zhang; Danna,9999,0,9999,0
1713344992632,MCWP 40R,A00,518780,Staff,20,0,20,0
1713344992632,MCWP 40R,B00,518781,Staff,19,0,20,1
1713344992632,MCWP 40R,C00,518783,Staff,19,0,20,1
1713344993659,MCWP 50R,A00,518791,Staff,20,0,20,0
1713344993659,MCWP 50R,B00,518792,Staff,17,0,20,3
1713344993659,MCWP 50R,C00,518793,Staff,19,0,20,1
1713344993659,MCWP 50R,D00,518794,Staff,16,0,20,4
1713344993659,MCWP 50R,E00,518795,Staff,16,0,20,4
1713344993659,MCWP 50R,F00,518796,Staff,19,0,20,1
1713344993659,MCWP 50R,G00,518797,Staff,19,0,20,1
1713344994691,MMW 12R,A01,514034,Herbst; Matthew,15,0,16,1
1713344994691,MMW 12R,A02,514035,Herbst; Matthew,16,0,16,0
1713344995717,MMW 13R,A01,514037,Staff,12,0,16,4
1713344995717,MMW 13R,A02,514039,Staff,16,0,16,0
1713344997772,SIO 295LS,A00,523233,Staff,18,0,30,12
1713344998798,SIO 295S,A00,523232,Staff,18,0,30,12
1713344999825,SOCI 117,A01,494376,Staff,1,0,5,4
1713345000857,WES 237B,A00,494380,Staff,19,0,20,1
1713345002947,AESE 279B,A00,494370,Wade; Jon P,33,0,33,0
1713345003974,ANAR 135S,A00,494369,Braswell; Geoffrey E.,0,0,0,0
1713345005000,CAT 124RS,A01,519847,Geibel; William,17,0,20,3
1713345006027,CAT 125RS,A01,515971,Geibel; William,17,0,20,3
1713345007112,CLRE 250,A00,511389,Morris; Sheldon,9996,0,9999,3
1713345008148,CLRE 251,A00,507176,Mehta; Ravindra L.,9996,0,9999,3
1713345008148,CLRE 251,B00,511410,Mehta; Ravindra L.,9998,0,9999,1
1713345009175,CLRE 252,A00,507189,Cuomo; Raphael Eduardo,9998,0,9999,1
1713345010204,CLRE 253,A00,507199,Vaida; Florin,9997,0,9999,2
1713345010204,CLRE 253,B00,507202,Vaida; Florin,9999,0,9999,0
1713345011228,CLRE 259,A00,507211,Patel; Hemal,9996,0,9999,3
1713345012255,CLRE 260,A00,507221,Cuomo; Raphael Eduardo,9999,0,9999,0
1713345013279,CLRE 297,001,507242,Cuomo; Raphael Eduardo,9999,0,9999,0
1713345014308,CSE 191,A00,516875,Minnes Kemp; Mor Mia,9999,0,9999,0
1713345015335,CSS 201S,A01,494383,Staff,35,0,35,0
1713345016365,CSS 202S,A01,494387,Staff,35,0,35,0
1713345017390,EAP 100,A00,516065,Staff,9792,0,9999,207
1713345018416,ECE 45,A01,507414,Staff,51,0,60,9
1713345019443,ECE 100,A01,507416,Baghdadchi; Saharnaz,10,0,20,10
1713345019443,ECE 100,A02,507418,Baghdadchi; Saharnaz,20,0,20,0
1713345020468,ECE 111,A01,507420,Staff,38,0,50,12
1713345021498,ECE 197,001,548057,Sievenpiper; Daniel F.,9998,0,9999,1
1713345022529,EDS 115,A00,507243,Choi; Bailey Miyeon,28,0,28,0
1713345023555,EDS 117,A01,494379,Staff,23,0,25,2
1713345024586,EDS 125,A00,507246,Hopkins; Megan Beth,29,0,30,1
1713345025611,EDS 128A,A01,507264,Fargason; Sharon Gayle,26,0,26,0
1713345026637,EDS 128B,A01,507293,Pappas; Elizabeth,30,0,30,0
1713345027663,EDS 139,A00,507294,Fargason; Sharon Gayle,30,0,30,0
1713345027663,EDS 139,B00,507313,Pappas; Elizabeth,30,0,30,0
1713345028691,EDS 201,A00,507315,Staff,26,0,30,4
1713345029719,EDS 203,A01,507317,Halter; Christopher P.,26,0,30,4
1713345030745,EDS 204R,A01,507319,Halter; Christopher P.,3,0,30,27
1713345030745,EDS 204R,B01,507331,Heinzman; Erica M.,28,0,30,2
1713345031770,EDS 206R,A00,507332,Staff,4,0,30,26
1713345031770,EDS 206R,B00,507343,Staff,28,0,30,2
1713345032796,EDS 250,A00,507344,Hemans; Patricia Ann Benitez,36,0,40,4
1713345033827,EDS 281,A00,507345,Daly; Alan J.,18,0,18,0
1713345034852,EDS 284,A00,507350,Daly; Alan J.,16,0,16,0
1713345035878,EDS 286,A00,507359,Fine; Sarah,18,0,18,0
1713345036905,EDS 289C,A01,507361,Daly; Alan J.,18,0,18,0
1713345037936,EDS 290,A00,507366,Hofstetter; Carolyn,15,0,15,0
1713345038961,LIGM 5A,A00,507421,Fischer-Grunski; Eva K,20,0,20,0
1713345039987,LIGM 5B,A00,507423,Fischer-Grunski; Eva K,20,0,20,0
1713345041012,LIGM 5C,A00,507425,Fischer-Grunski; Eva K,20,0,20,0
1713345042039,LIIT 5AS,A00,507427,Carnelos; Chiara,20,0,20,0
1713345043070,LIIT 5BS,A00,507430,Carnelos; Chiara,20,0,20,0
1713345044099,LIIT 5CS,A00,507432,Carnelos; Chiara,20,0,20,0
1713345045132,LISP 5A,A00,507541,Munoz Sanchez; Alicia,17,0,20,3
1713345046157,LISP 5B,A00,507671,Munoz Sanchez; Alicia,15,0,20,5
1713345047181,LISP 5C,A00,507696,Munoz Sanchez; Alicia,15,0,20,5
1713345048207,MAE 197,001,528363,Boechler; Nicholas Sebastia,9998,0,9999,1
1713345049235,MATH 197,001,523477,Kedlaya; Kiran S.,9999,0,9999,0
1713345049235,MATH 197,002,563811,Zhang; Danna,9999,0,9999,0
1713345050269,MCWP 40R,A00,518780,Staff,20,0,20,0
1713345050269,MCWP 40R,B00,518781,Staff,19,0,20,1
1713345050269,MCWP 40R,C00,518783,Staff,19,0,20,1
1713345051302,MCWP 50R,A00,518791,Staff,20,0,20,0
1713345051302,MCWP 50R,B00,518792,Staff,17,0,20,3
1713345051302,MCWP 50R,C00,518793,Staff,19,0,20,1
1713345051302,MCWP 50R,D00,518794,Staff,16,0,20,4
1713345051302,MCWP 50R,E00,518795,Staff,16,0,20,4
1713345051302,MCWP 50R,F00,518796,Staff,19,0,20,1
1713345051302,MCWP 50R,G00,518797,Staff,19,0,20,1
1713345052328,MMW 12R,A01,514034,Herbst; Matthew,15,0,16,1
1713345052328,MMW 12R,A02,514035,Herbst; Matthew,16,0,16,0
1713345053355,MMW 13R,A01,514037,Staff,12,0,16,4
1713345053355,MMW 13R,A02,514039,Staff,16,0,16,0
1713345055411,SIO 295LS,A00,523233,Staff,18,0,30,12
1713345056436,SIO 295S,A00,523232,Staff,18,0,30,12
1713345057465,SOCI 117,A01,494376,Staff,1,0,5,4
1713345058494,WES 237B,A00,494380,Staff,19,0,20,1
1713345060579,AESE 279B,A00,494370,Wade; Jon P,33,0,33,0
1713345061613,ANAR 135S,A00,494369,Braswell; Geoffrey E.,0,0,0,0
1713345062640,CAT 124RS,A01,519847,Geibel; William,17,0,20,3
1713345063670,CAT 125RS,A01,515971,Geibel; William,17,0,20,3
1713345064701,CLRE 250,A00,511389,Morris; Sheldon,9996,0,9999,3
1713345065727,CLRE 251,A00,507176,Mehta; Ravindra L.,9996,0,9999,3
1713345065727,CLRE 251,B00,511410,Mehta; Ravindra L.,9998,0,9999,1
1713345066759,CLRE 252,A00,507189,Cuomo; Raphael Eduardo,9998,0,9999,1
1713345067789,CLRE 253,A00,507199,Vaida; Florin,9997,0,9999,2
1713345067789,CLRE 253,B00,507202,Vaida; Florin,9999,0,9999,0
1713345068820,CLRE 259,A00,507211,Patel; Hemal,9996,0,9999,3
1713345069850,CLRE 260,A00,507221,Cuomo; Raphael Eduardo,9999,0,9999,0
1713345070880,CLRE 297,001,507242,Cuomo; Raphael Eduardo,9999,0,9999,0
1713345071910,CSE 191,A00,516875,Minnes Kemp; Mor Mia,9999,0,9999,0
1713345072936,CSS 201S,A01,494383,Staff,35,0,35,0
1713345073963,CSS 202S,A01,494387,Staff,35,0,35,0
1713345074989,EAP 100,A00,516065,Staff,9792,0,9999,207
1713345076015,ECE 45,A01,507414,Staff,51,0,60,9
1713345077043,ECE 100,A01,507416,Baghdadchi; Saharnaz,10,0,20,10
1713345077043,ECE 100,A02,507418,Baghdadchi; Saharnaz,20,0,20,0
1713345078070,ECE 111,A01,507420,Staff,38,0,50,12
1713345079096,ECE 197,001,548057,Sievenpiper; Daniel F.,9998,0,9999,1
1713345080122,EDS 115,A00,507243,Choi; Bailey Miyeon,28,0,28,0
1713345081148,EDS 117,A01,494379,Staff,23,0,25,2
1713345082176,EDS 125,A00,507246,Hopkins; Megan Beth,29,0,30,1
1713345083203,EDS 128A,A01,507264,Fargason; Sharon Gayle,26,0,26,0
1713345084234,EDS 128B,A01,507293,Pappas; Elizabeth,30,0,30,0
1713345085261,EDS 139,A00,507294,Fargason; Sharon Gayle,30,0,30,0
1713345085261,EDS 139,B00,507313,Pappas; Elizabeth,30,0,30,0
1713345086291,EDS 201,A00,507315,Staff,26,0,30,4
1713345087322,EDS 203,A01,507317,Halter; Christopher P.,26,0,30,4
1713345088348,EDS 204R,A01,507319,Halter; Christopher P.,3,0,30,27
1713345088348,EDS 204R,B01,507331,Heinzman; Erica M.,28,0,30,2
1713345089381,EDS 206R,A00,507332,Staff,4,0,30,26
1713345089381,EDS 206R,B00,507343,Staff,28,0,30,2
1713345090407,EDS 250,A00,507344,Hemans; Patricia Ann Benitez,36,0,40,4
1713345091434,EDS 281,A00,507345,Daly; Alan J.,18,0,18,0
1713345092458,EDS 284,A00,507350,Daly; Alan J.,16,0,16,0
1713345093489,EDS 286,A00,507359,Fine; Sarah,18,0,18,0
1713345094515,EDS 289C,A01,507361,Daly; Alan J.,18,0,18,0
1713345095546,EDS 290,A00,507366,Hofstetter; Carolyn,15,0,15,0
1713345096577,LIGM 5A,A00,507421,Fischer-Grunski; Eva K,20,0,20,0
1713345097602,LIGM 5B,A00,507423,Fischer-Grunski; Eva K,20,0,20,0
1713345098633,LIGM 5C,A00,507425,Fischer-Grunski; Eva K,20,0,20,0
1713345099663,LIIT 5AS,A00,507427,Carnelos; Chiara,20,0,20,0
1713345100690,LIIT 5BS,A00,507430,Carnelos; Chiara,20,0,20,0
1713345101720,LIIT 5CS,A00,507432,Carnelos; Chiara,20,0,20,0
1713345102750,LISP 5A,A00,507541,Munoz Sanchez; Alicia,17,0,20,3
1713345103784,LISP 5B,A00,507671,Munoz Sanchez; Alicia,15,0,20,5
1713345104814,LISP 5C,A00,507696,Munoz Sanchez; Alicia,15,0,20,5
1713345105840,MAE 197,001,528363,Boechler; Nicholas Sebastia,9998,0,9999,1
1713345106868,MATH 197,001,523477,Kedlaya; Kiran S.,9999,0,9999,0
1713345106868,MATH 197,002,563811,Zhang; Danna,9999,0,9999,0
1713345107898,MCWP 40R,A00,518780,Staff,20,0,20,0
1713345107898,MCWP 40R,B00,518781,Staff,19,0,20,1
1713345107898,MCWP 40R,C00,518783,Staff,19,0,20,1
1713345108925,MCWP 50R,A00,518791,Staff,20,0,20,0
1713345108925,MCWP 50R,B00,518792,Staff,17,0,20,3
1713345108925,MCWP 50R,C00,518793,Staff,19,0,20,1
1713345108925,MCWP 50R,D00,518794,Staff,16,0,20,4
1713345108925,MCWP 50R,E00,518795,Staff,16,0,20,4
1713345108925,MCWP 50R,F00,518796,Staff,19,0,20,1
1713345108925,MCWP 50R,G00,518797,Staff,19,0,20,1
1713345109956,MMW 12R,A01,514034,Herbst; Matthew,15,0,16,1
1713345109956,MMW 12R,A02,514035,Herbst; Matthew,16,0,16,0
1713345111036,MMW 13R,A01,514037,Staff,12,0,16,4
1713345111036,MMW 13R,A02,514039,Staff,16,0,16,0
1713345113088,SIO 295LS,A00,523233,Staff,18,0,30,12
1713345114113,SIO 295S,A00,523232,Staff,18,0,30,12
1713345115143,SOCI 117,A01,494376,Staff,1,0,5,4
1713345116169,WES 237B,A00,494380,Staff,19,0,20,1
1713345118240,AESE 279B,A00,494370,Wade; Jon P,33,0,33,0
1713345119270,ANAR 135S,A00,494369,Braswell; Geoffrey E.,0,0,0,0
1713345120296,CAT 124RS,A01,519847,Geibel; William,17,0,20,3
1713345121321,CAT 125RS,A01,515971,Geibel; William,17,0,20,3
1713345122349,CLRE 250,A00,511389,Morris; Sheldon,9996,0,9999,3
1713345123384,CLRE 251,A00,507176,Mehta; Ravindra L.,9996,0,9999,3
1713345123384,CLRE 251,B00,511410,Mehta; Ravindra L.,9998,0,9999,1
1713345124411,CLRE 252,A00,507189,Cuomo; Raphael Eduardo,9998,0,9999,1
1713345125442,CLRE 253,A00,507199,Vaida; Florin,9997,0,9999,2
1713345125442,CLRE 253,B00,507202,Vaida; Florin,9999,0,9999,0
1713345126467,CLRE 259,A00,507211,Patel; Hemal,9996,0,9999,3
1713345127498,CLRE 260,A00,507221,Cuomo; Raphael Eduardo,9999,0,9999,0
1713345128525,CLRE 297,001,507242,Cuomo; Raphael Eduardo,9999,0,9999,0
1713345129552,CSE 191,A00,516875,Minnes Kemp; Mor Mia,9999,0,9999,0
1713345130579,CSS 201S,A01,494383,Staff,35,0,35,0
1713345131605,CSS 202S,A01,494387,Staff,35,0,35,0
1713345132630,EAP 100,A00,516065,Staff,9792,0,9999,207
1713345133655,ECE 45,A01,507414,Staff,51,0,60,9
1713345134685,ECE 100,A01,507416,Baghdadchi; Saharnaz,10,0,20,10
1713345134685,ECE 100,A02,507418,Baghdadchi; Saharnaz,20,0,20,0
1713345135711,ECE 111,A01,507420,Staff,38,0,50,12
1713345136738,ECE 197,001,548057,Sievenpiper; Daniel F.,9998,0,9999,1
1713345137768,EDS 115,A00,507243,Choi; Bailey Miyeon,28,0,28,0
1713345138794,EDS 117,A01,494379,Staff,23,0,25,2
1713345139820,EDS 125,A00,507246,Hopkins; Megan Beth,29,0,30,1
1713345140847,EDS 128A,A01,507264,Fargason; Sharon Gayle,26,0,26,0
1713345141874,EDS 128B,A01,507293,Pappas; Elizabeth,30,0,30,0
1713345142900,EDS 139,A00,507294,Fargason; Sharon Gayle,30,0,30,0
1713345142900,EDS 139,B00,507313,Pappas; Elizabeth,30,0,30,0
1713345143924,EDS 201,A00,507315,Staff,26,0,30,4
1713345144951,EDS 203,A01,507317,Halter; Christopher P.,26,0,30,4
1713345145980,EDS 204R,A01,507319,Halter; Christopher P.,3,0,30,27
1713345145980,EDS 204R,B01,507331,Heinzman; Erica M.,28,0,30,2
1713345147005,EDS 206R,A00,507332,Staff,4,0,30,26
1713345147005,EDS 206R,B00,507343,Staff,28,0,30,2
1713345148036,EDS 250,A00,507344,Hemans; Patricia Ann Benitez,36,0,40,4
1713345149064,EDS 281,A00,507345,Daly; Alan J.,18,0,18,0
1713345150093,EDS 284,A00,507350,Daly; Alan J.,16,0,16,0
1713345151121,EDS 286,A00,507359,Fine; Sarah,18,0,18,0
1713345152146,EDS 289C,A01,507361,Daly; Alan J.,18,0,18,0
1713345153172,EDS 290,A00,507366,Hofstetter; Carolyn,15,0,15,0
1713345154200,LIGM 5A,A00,507421,Fischer-Grunski; Eva K,20,0,20,0
1713345155230,LIGM 5B,A00,507423,Fischer-Grunski; Eva K,20,0,20,0
1713345156264,LIGM 5C,A00,507425,Fischer-Grunski; Eva K,20,0,20,0
1713345157304,LIIT 5AS,A00,507427,Carnelos; Chiara,20,0,20,0
1713345158332,LIIT 5BS,A00,507430,Carnelos; Chiara,20,0,20,0
1713345159355,LIIT 5CS,A00,507432,Carnelos; Chiara,20,0,20,0
1713345160383,LISP 5A,A00,507541,Munoz Sanchez; Alicia,17,0,20,3
1713345161408,LISP 5B,A00,507671,Munoz Sanchez; Alicia,15,0,20,5
1713345162433,LISP 5C,A00,507696,Munoz Sanchez; Alicia,15,0,20,5
1713345163462,MAE 197,001,528363,Boechler; Nicholas Sebastia,9998,0,9999,1
1713345164496,MATH 197,001,523477,Kedlaya; Kiran S.,9999,0,9999,0
1713345164496,MATH 197,002,563811,Zhang; Danna,9999,0,9999,0
1713345165521,MCWP 40R,A00,518780,Staff,20,0,20,0
1713345165521,MCWP 40R,B00,518781,Staff,19,0,20,1
1713345165521,MCWP 40R,C00,518783,Staff,19,0,20,1
1713345166549,MCWP 50R,A00,518791,Staff,20,0,20,0
1713345166549,MCWP 50R,B00,518792,Staff,17,0,20,3
1713345166549,MCWP 50R,C00,518793,Staff,19,0,20,1
1713345166549,MCWP 50R,D00,518794,Staff,16,0,20,4
1713345166549,MCWP 50R,E00,518795,Staff,16,0,20,4
1713345166549,MCWP 50R,F00,518796,Staff,19,0,20,1
1713345166549,MCWP 50R,G00,518797,Staff,19,0,20,1
1713345167574,MMW 12R,A01,514034,Herbst; Matthew,15,0,16,1
1713345167574,MMW 12R,A02,514035,Herbst; Matthew,16,0,16,0
1713345168600,MMW 13R,A01,514037,Staff,12,0,16,4
1713345168600,MMW 13R,A02,514039,Staff,16,0,16,0
1713345170654,SIO 295LS,A00,523233,Staff,18,0,30,12
1713345171684,SIO 295S,A00,523232,Staff,18,0,30,12
1713345172714,SOCI 117,A01,494376,Staff,1,0,5,4
1713345173739,WES 237B,A00,494380,Staff,19,0,20,1
1713345175811,AESE 279B,A00,494370,Wade; Jon P,33,0,33,0
1713345176839,ANAR 135S,A00,494369,Braswell; Geoffrey E.,0,0,0,0
1713345177865,CAT 124RS,A01,519847,Geibel; William,17,0,20,3
1713345178891,CAT 125RS,A01,515971,Geibel; William,17,0,20,3
1713345179917,CLRE 250,A00,511389,Morris; Sheldon,9996,0,9999,3
1713345180950,CLRE 251,A00,507176,Mehta; Ravindra L.,9996,0,9999,3
1713345180950,CLRE 251,B00,511410,Mehta; Ravindra L.,9998,0,9999,1
1713345181976,CLRE 252,A00,507189,Cuomo; Raphael Eduardo,9998,0,9999,1
1713345183002,CLRE 253,A00,507199,Vaida; Florin,9997,0,9999,2
1713345183002,CLRE 253,B00,507202,Vaida; Florin,9999,0,9999,0
1713345184028,CLRE 259,A00,507211,Patel; Hemal,9996,0,9999,3
1713345185059,CLRE 260,A00,507221,Cuomo; Raphael Eduardo,9999,0,9999,0
1713345186087,CLRE 297,001,507242,Cuomo; Raphael Eduardo,9999,0,9999,0
1713345187116,CSE 191,A00,516875,Minnes Kemp; Mor Mia,9999,0,9999,0
1713345188147,CSS 201S,A01,494383,Staff,35,0,35,0
1713345189178,CSS 202S,A01,494387,Staff,35,0,35,0
1713345190202,EAP 100,A00,516065,Staff,9792,0,9999,207
1713345191228,ECE 45,A01,507414,Staff,51,0,60,9
1713345192256,ECE 100,A01,507416,Baghdadchi; Saharnaz,10,0,20,10
1713345192256,ECE 100,A02,507418,Baghdadchi; Saharnaz,20,0,20,0
1713345193285,ECE 111,A01,507420,Staff,38,0,50,12
1713345194310,ECE 197,001,548057,Sievenpiper; Daniel F.,9998,0,9999,1
1713345195336,EDS 115,A00,507243,Choi; Bailey Miyeon,28,0,28,0
1713345196366,EDS 117,A01,494379,Staff,23,0,25,2
1713345197393,EDS 125,A00,507246,Hopkins; Megan Beth,29,0,30,1
1713345198420,EDS 128A,A01,507264,Fargason; Sharon Gayle,26,0,26,0
1713345199447,EDS 128B,A01,507293,Pappas; Elizabeth,30,0,30,0
1713345200472,EDS 139,A00,507294,Fargason; Sharon Gayle,30,0,30,0
1713345200472,EDS 139,B00,507313,Pappas; Elizabeth,30,0,30,0
1713345201498,EDS 201,A00,507315,Staff,26,0,30,4
1713345202524,EDS 203,A01,507317,Halter; Christopher P.,26,0,30,4
1713345203555,EDS 204R,A01,507319,Halter; Christopher P.,3,0,30,27
1713345203555,EDS 204R,B01,507331,Heinzman; Erica M.,28,0,30,2
1713345204581,EDS 206R,A00,507332,Staff,4,0,30,26
1713345204581,EDS 206R,B00,507343,Staff,28,0,30,2
1713345205611,EDS 250,A00,507344,Hemans; Patricia Ann Benitez,36,0,40,4
1713345206638,EDS 281,A00,507345,Daly; Alan J.,18,0,18,0
1713345207663,EDS 284,A00,507350,Daly; Alan J.,16,0,16,0
1713345208688,EDS 286,A00,507359,Fine; Sarah,18,0,18,0
1713345209712,EDS 289C,A01,507361,Daly; Alan J.,18,0,18,0
1713345210738,EDS 290,A00,507366,Hofstetter; Carolyn,15,0,15,0
1713345211770,LIGM 5A,A00,507421,Fischer-Grunski; Eva K,20,0,20,0
1713345212796,LIGM 5B,A00,507423,Fischer-Grunski; Eva K,20,0,20,0
1713345213821,LIGM 5C,A00,507425,Fischer-Grunski; Eva K,20,0,20,0
1713345214909,LIIT 5AS,A00,507427,Carnelos; Chiara,20,0,20,0
1713345215939,LIIT 5BS,A00,507430,Carnelos; Chiara,20,0,20,0
1713345216965,LIIT 5CS,A00,507432,Carnelos; Chiara,20,0,20,0
1713345217991,LISP 5A,A00,507541,Munoz Sanchez; Alicia,17,0,20,3
1713345219017,LISP 5B,A00,507671,Munoz Sanchez; Alicia,15,0,20,5
1713345220042,LISP 5C,A00,507696,Munoz Sanchez; Alicia,15,0,20,5
1713345221069,MAE 197,001,528363,Boechler; Nicholas Sebastia,9998,0,9999,1
1713345222106,MATH 197,001,523477,Kedlaya; Kiran S.,9999,0,9999,0
1713345222106,MATH 197,002,563811,Zhang; Danna,9999,0,9999,0
1713345223137,MCWP 40R,A00,518780,Staff,20,0,20,0
1713345223137,MCWP 40R,B00,518781,Staff,19,0,20,1
1713345223137,MCWP 40R,C00,518783,Staff,19,0,20,1
1713345224165,MCWP 50R,A00,518791,Staff,20,0,20,0
1713345224165,MCWP 50R,B00,518792,Staff,17,0,20,3
1713345224165,MCWP 50R,C00,518793,Staff,19,0,20,1
1713345224165,MCWP 50R,D00,518794,Staff,16,0,20,4
1713345224165,MCWP 50R,E00,518795,Staff,16,0,20,4
1713345224165,MCWP 50R,F00,518796,Staff,19,0,20,1
1713345224165,MCWP 50R,G00,518797,Staff,19,0,20,1
1713345225196,MMW 12R,A01,514034,Herbst; Matthew,15,0,16,1
1713345225196,MMW 12R,A02,514035,Herbst; Matthew,16,0,16,0
1713345226225,MMW 13R,A01,514037,Staff,12,0,16,4
1713345226225,MMW 13R,A02,514039,Staff,16,0,16,0
1713345228280,SIO 295LS,A00,523233,Staff,18,0,30,12
1713345229306,SIO 295S,A00,523232,Staff,18,0,30,12
1713345230333,SOCI 117,A01,494376,Staff,1,0,5,4
1713345231361,WES 237B,A00,494380,Staff,19,0,20,1
1713345233452,AESE 279B,A00,494370,Wade; Jon P,33,0,33,0
1713345234477,ANAR 135S,A00,494369,Braswell; Geoffrey E.,0,0,0,0
1713345235505,CAT 124RS,A01,519847,Geibel; William,17,0,20,3
1713345236530,CAT 125RS,A01,515971,Geibel; William,17,0,20,3
1713345237558,CLRE 250,A00,511389,Morris; Sheldon,9996,0,9999,3
1713345238586,CLRE 251,A00,507176,Mehta; Ravindra L.,9996,0,9999,3
1713345238586,CLRE 251,B00,511410,Mehta; Ravindra L.,9998,0,9999,1
1713345239613,CLRE 252,A00,507189,Cuomo; Raphael Eduardo,9998,0,9999,1
1713345240645,CLRE 253,A00,507199,Vaida; Florin,9997,0,9999,2
1713345240645,CLRE 253,B00,507202,Vaida; Florin,9999,0,9999,0
1713345241677,CLRE 259,A00,507211,Patel; Hemal,9996,0,9999,3
1713345242702,CLRE 260,A00,507221,Cuomo; Raphael Eduardo,9999,0,9999,0
1713345243728,CLRE 297,001,507242,Cuomo; Raphael Eduardo,9999,0,9999,0
1713345244755,CSE 191,A00,516875,Minnes Kemp; Mor Mia,9999,0,9999,0
1713345245788,CSS 201S,A01,494383,Staff,35,0,35,0
1713345246815,CSS 202S,A01,494387,Staff,35,0,35,0
1713345247842,EAP 100,A00,516065,Staff,9792,0,9999,207
1713345248868,ECE 45,A01,507414,Staff,51,0,60,9
1713345249900,ECE 100,A01,507416,Baghdadchi; Saharnaz,10,0,20,10
1713345249900,ECE 100,A02,507418,Baghdadchi; Saharnaz,20,0,20,0
1713345250930,ECE 111,A01,507420,Staff,38,0,50,12
1713345251961,ECE 197,001,548057,Sievenpiper; Daniel F.,9998,0,9999,1
1713345252993,EDS 115,A00,507243,Choi; Bailey Miyeon,28,0,28,0
1713345254025,EDS 117,A01,494379,Staff,23,0,25,2
1713345255056,EDS 125,A00,507246,Hopkins; Megan Beth,29,0,30,1
1713345256082,EDS 128A,A01,507264,Fargason; Sharon Gayle,26,0,26,0
1713345257108,EDS 128B,A01,507293,Pappas; Elizabeth,30,0,30,0
1713345258134,EDS 139,A00,507294,Fargason; Sharon Gayle,30,0,30,0
1713345258134,EDS 139,B00,507313,Pappas; Elizabeth,30,0,30,0
1713345259163,EDS 201,A00,507315,Staff,26,0,30,4
1713345260188,EDS 203,A01,507317,Halter; Christopher P.,26,0,30,4
1713345261215,EDS 204R,A01,507319,Halter; Christopher P.,3,0,30,27
1713345261215,EDS 204R,B01,507331,Heinzman; Erica M.,28,0,30,2
1713345262244,EDS 206R,A00,507332,Staff,4,0,30,26
1713345262244,EDS 206R,B00,507343,Staff,28,0,30,2
1713345263270,EDS 250,A00,507344,Hemans; Patricia Ann Benitez,36,0,40,4
1713345264300,EDS 281,A00,507345,Daly; Alan J.,18,0,18,0
1713345265328,EDS 284,A00,507350,Daly; Alan J.,16,0,16,0
1713345266358,EDS 286,A00,507359,Fine; Sarah,18,0,18,0
1713345267411,EDS 289C,A01,507361,Daly; Alan J.,18,0,18,0
1713345268437,EDS 290,A00,507366,Hofstetter; Carolyn,15,0,15,0
1713345269471,LIGM 5A,A00,507421,Fischer-Grunski; Eva K,20,0,20,0
1713345270497,LIGM 5B,A00,507423,Fischer-Grunski; Eva K,20,0,20,0
1713345271524,LIGM 5C,A00,507425,Fischer-Grunski; Eva K,20,0,20,0
1713345272551,LIIT 5AS,A00,507427,Carnelos; Chiara,20,0,20,0
1713345273581,LIIT 5BS,A00,507430,Carnelos; Chiara,20,0,20,0
1713345274607,LIIT 5CS,A00,507432,Carnelos; Chiara,20,0,20,0
1713345275633,LISP 5A,A00,507541,Munoz Sanchez; Alicia,17,0,20,3
1713345276660,LISP 5B,A00,507671,Munoz Sanchez; Alicia,15,0,20,5
1713345277693,LISP 5C,A00,507696,Munoz Sanchez; Alicia,15,0,20,5
1713345278721,MAE 197,001,528363,Boechler; Nicholas Sebastia,9998,0,9999,1
1713345279755,MATH 197,001,523477,Kedlaya; Kiran S.,9999,0,9999,0
1713345279755,MATH 197,002,563811,Zhang; Danna,9999,0,9999,0
1713345280784,MCWP 40R,A00,518780,Staff,20,0,20,0
1713345280784,MCWP 40R,B00,518781,Staff,19,0,20,1
1713345280784,MCWP 40R,C00,518783,Staff,19,0,20,1
1713345281814,MCWP 50R,A00,518791,Staff,20,0,20,0
1713345281814,MCWP 50R,B00,518792,Staff,17,0,20,3
1713345281814,MCWP 50R,C00,518793,Staff,19,0,20,1
1713345281814,MCWP 50R,D00,518794,Staff,16,0,20,4
1713345281814,MCWP 50R,E00,518795,Staff,16,0,20,4
1713345281814,MCWP 50R,F00,518796,Staff,19,0,20,1
1713345281814,MCWP 50R,G00,518797,Staff,19,0,20,1
1713345282840,MMW 12R,A01,514034,Herbst; Matthew,15,0,16,1
1713345282840,MMW 12R,A02,514035,Herbst; Matthew,16,0,16,0
1713345283869,MMW 13R,A01,514037,Staff,12,0,16,4
1713345283869,MMW 13R,A02,514039,Staff,16,0,16,0
1713345285930,SIO 295LS,A00,523233,Staff,18,0,30,12
1713345286961,SIO 295S,A00,523232,Staff,18,0,30,12
1713345287992,SOCI 117,A01,494376,Staff,1,0,5,4
1713345289019,WES 237B,A00,494380,Staff,19,0,20,1
1713345291097,AESE 279B,A00,494370,Wade; Jon P,33,0,33,0
1713345292126,ANAR 135S,A00,494369,Braswell; Geoffrey E.,0,0,0,0
1713345293157,CAT 124RS,A01,519847,Geibel; William,17,0,20,3
1713345294183,CAT 125RS,A01,515971,Geibel; William,17,0,20,3
1713345295209,CLRE 250,A00,511389,Morris; Sheldon,9996,0,9999,3
1713345296237,CLRE 251,A00,507176,Mehta; Ravindra L.,9996,0,9999,3
1713345296237,CLRE 251,B00,511410,Mehta; Ravindra L.,9998,0,9999,1
1713345297269,CLRE 252,A00,507189,Cuomo; Raphael Eduardo,9998,0,9999,1
1713345298296,CLRE 253,A00,507199,Vaida; Florin,9997,0,9999,2
1713345298296,CLRE 253,B00,507202,Vaida; Florin,9999,0,9999,0
1713345299325,CLRE 259,A00,507211,Patel; Hemal,9996,0,9999,3
1713345300351,CLRE 260,A00,507221,Cuomo; Raphael Eduardo,9999,0,9999,0
1713345301379,CLRE 297,001,507242,Cuomo; Raphael Eduardo,9999,0,9999,0
1713345302407,CSE 191,A00,516875,Minnes Kemp; Mor Mia,9999,0,9999,0
1713345303434,CSS 201S,A01,494383,Staff,35,0,35,0
1713345304465,CSS 202S,A01,494387,Staff,35,0,35,0
1713345305489,EAP 100,A00,516065,Staff,9792,0,9999,207
1713345306513,ECE 45,A01,507414,Staff,51,0,60,9
1713345307539,ECE 100,A01,507416,Baghdadchi; Saharnaz,10,0,20,10
1713345307539,ECE 100,A02,507418,Baghdadchi; Saharnaz,20,0,20,0
1713345308571,ECE 111,A01,507420,Staff,38,0,50,12
1713345309596,ECE 197,001,548057,Sievenpiper; Daniel F.,9998,0,9999,1
1713345310623,EDS 115,A00,507243,Choi; Bailey Miyeon,28,0,28,0
1713345311647,EDS 117,A01,494379,Staff,23,0,25,2
1713345312674,EDS 125,A00,507246,Hopkins; Megan Beth,29,0,30,1
1713345313701,EDS 128A,A01,507264,Fargason; Sharon Gayle,26,0,26,0
1713345314726,EDS 128B,A01,507293,Pappas; Elizabeth,30,0,30,0
1713345315752,EDS 139,A00,507294,Fargason; Sharon Gayle,30,0,30,0
1713345315752,EDS 139,B00,507313,Pappas; Elizabeth,30,0,30,0
1713345316780,EDS 201,A00,507315,Staff,26,0,30,4
1713345317806,EDS 203,A01,507317,Halter; Christopher P.,26,0,30,4
1713345318893,EDS 204R,A01,507319,Halter; Christopher P.,3,0,30,27
1713345318893,EDS 204R,B01,507331,Heinzman; Erica M.,28,0,30,2
1713345319918,EDS 206R,A00,507332,Staff,4,0,30,26
1713345319918,EDS 206R,B00,507343,Staff,28,0,30,2
1713345320943,EDS 250,A00,507344,Hemans; Patricia Ann Benitez,36,0,40,4
1713345321974,EDS 281,A00,507345,Daly; Alan J.,18,0,18,0
1713345323004,EDS 284,A00,507350,Daly; Alan J.,16,0,16,0
1713345324035,EDS 286,A00,507359,Fine; Sarah,18,0,18,0
1713345325064,EDS 289C,A01,507361,Daly; Alan J.,18,0,18,0
1713345326095,EDS 290,A00,507366,Hofstetter; Carolyn,15,0,15,0
1713345327121,LIGM 5A,A00,507421,Fischer-Grunski; Eva K,20,0,20,0
1713345328146,LIGM 5B,A00,507423,Fischer-Grunski; Eva K,20,0,20,0
1713345329177,LIGM 5C,A00,507425,Fischer-Grunski; Eva K,20,0,20,0
1713345330207,LIIT 5AS,A00,507427,Carnelos; Chiara,20,0,20,0
1713345331236,LIIT 5BS,A00,507430,Carnelos; Chiara,20,0,20,0
1713345332264,LIIT 5CS,A00,507432,Carnelos; Chiara,20,0,20,0
1713345333295,LISP 5A,A00,507541,Munoz Sanchez; Alicia,17,0,20,3
1713345334326,LISP 5B,A00,507671,Munoz Sanchez; Alicia,15,0,20,5
1713345335356,LISP 5C,A00,507696,Munoz Sanchez; Alicia,15,0,20,5
1713345336381,MAE 197,001,528363,Boechler; Nicholas Sebastia,9998,0,9999,1
1713345337415,MATH 197,001,523477,Kedlaya; Kiran S.,9999,0,9999,0
1713345337415,MATH 197,002,563811,Zhang; Danna,9999,0,9999,0
1713345338448,MCWP 40R,A00,518780,Staff,20,0,20,0
1713345338448,MCWP 40R,B00,518781,Staff,19,0,20,1
1713345338448,MCWP 40R,C00,518783,Staff,19,0,20,1
1713345339475,MCWP 50R,A00,518791,Staff,20,0,20,0
1713345339475,MCWP 50R,B00,518792,Staff,17,0,20,3
1713345339475,MCWP 50R,C00,518793,Staff,19,0,20,1
1713345339475,MCWP 50R,D00,518794,Staff,16,0,20,4
1713345339475,MCWP 50R,E00,518795,Staff,16,0,20,4
1713345339475,MCWP 50R,F00,518796,Staff,19,0,20,1
1713345339475,MCWP 50R,G00,518797,Staff,19,0,20,1
1713345340501,MMW 12R,A01,514034,Herbst; Matthew,15,0,16,1
1713345340501,MMW 12R,A02,514035,Herbst; Matthew,16,0,16,0
1713345341527,MMW 13R,A01,514037,Staff,12,0,16,4
1713345341527,MMW 13R,A02,514039,Staff,16,0,16,0
1713345343579,SIO 295LS,A00,523233,Staff,18,0,30,12
1713345344610,SIO 295S,A00,523232,Staff,18,0,30,12
1713345345638,SOCI 117,A01,494376,Staff,1,0,5,4
1713345346665,WES 237B,A00,494380,Staff,19,0,20,1
1713345348756,AESE 279B,A00,494370,Wade; Jon P,33,0,33,0
1713345349785,ANAR 135S,A00,494369,Braswell; Geoffrey E.,0,0,0,0
1713345350811,CAT 124RS,A01,519847,Geibel; William,17,0,20,3
1713345351837,CAT 125RS,A01,515971,Geibel; William,17,0,20,3
1713345352870,CLRE 250,A00,511389,Morris; Sheldon,9996,0,9999,3
1713345353899,CLRE 251,A00,507176,Mehta; Ravindra L.,9996,0,9999,3
1713345353899,CLRE 251,B00,511410,Mehta; Ravindra L.,9998,0,9999,1
1713345354925,CLRE 252,A00,507189,Cuomo; Raphael Eduardo,9998,0,9999,1
1713345355953,CLRE 253,A00,507199,Vaida; Florin,9997,0,9999,2
1713345355953,CLRE 253,B00,507202,Vaida; Florin,9999,0,9999,0
1713345356982,CLRE 259,A00,507211,Patel; Hemal,9996,0,9999,3
1713345358007,CLRE 260,A00,507221,Cuomo; Raphael Eduardo,9999,0,9999,0
1713345359032,CLRE 297,001,507242,Cuomo; Raphael Eduardo,9999,0,9999,0
1713345360198,CSE 191,A00,516875,Minnes Kemp; Mor Mia,9999,0,9999,0
1713345361229,CSS 201S,A01,494383,Staff,35,0,35,0
1713345362256,CSS 202S,A01,494387,Staff,35,0,35,0
1713345363284,EAP 100,A00,516065,Staff,9792,0,9999,207
1713345364310,ECE 45,A01,507414,Staff,51,0,60,9
1713345365336,ECE 100,A01,507416,Baghdadchi; Saharnaz,10,0,20,10
1713345365336,ECE 100,A02,507418,Baghdadchi; Saharnaz,20,0,20,0
1713345366360,ECE 111,A01,507420,Staff,38,0,50,12
1713345367387,ECE 197,001,548057,Sievenpiper; Daniel F.,9998,0,9999,1
1713345368419,EDS 115,A00,507243,Choi; Bailey Miyeon,28,0,28,0
1713345369445,EDS 117,A01,494379,Staff,23,0,25,2
1713345370477,EDS 125,A00,507246,Hopkins; Megan Beth,29,0,30,1
1713345371503,EDS 128A,A01,507264,Fargason; Sharon Gayle,26,0,26,0
1713345372530,EDS 128B,A01,507293,Pappas; Elizabeth,30,0,30,0
1713345373563,EDS 139,A00,507294,Fargason; Sharon Gayle,30,0,30,0
1713345373563,EDS 139,B00,507313,Pappas; Elizabeth,30,0,30,0
1713345374596,EDS 201,A00,507315,Staff,26,0,30,4
1713345375623,EDS 203,A01,507317,Halter; Christopher P.,26,0,30,4
1713345376657,EDS 204R,A01,507319,Halter; Christopher P.,3,0,30,27
1713345376657,EDS 204R,B01,507331,Heinzman; Erica M.,28,0,30,2
1713345377684,EDS 206R,A00,507332,Staff,4,0,30,26
1713345377684,EDS 206R,B00,507343,Staff,28,0,30,2
1713345378714,EDS 250,A00,507344,Hemans; Patricia Ann Benitez,36,0,40,4
1713345379742,EDS 281,A00,507345,Daly; Alan J.,18,0,18,0
1713345380768,EDS 284,A00,507350,Daly; Alan J.,16,0,16,0
1713345381795,EDS 286,A00,507359,Fine; Sarah,18,0,18,0
1713345382825,EDS 289C,A01,507361,Daly; Alan J.,18,0,18,0
1713345383861,EDS 290,A00,507366,Hofstetter; Carolyn,15,0,15,0
1713345384893,LIGM 5A,A00,507421,Fischer-Grunski; Eva K,20,0,20,0
1713345385926,LIGM 5B,A00,507423,Fischer-Grunski; Eva K,20,0,20,0
1713345386952,LIGM 5C,A00,507425,Fischer-Grunski; Eva K,20,0,20,0
1713345387978,LIIT 5AS,A00,507427,Carnelos; Chiara,20,0,20,0
1713345389004,LIIT 5BS,A00,507430,Carnelos; Chiara,20,0,20,0
1713345390031,LIIT 5CS,A00,507432,Carnelos; Chiara,20,0,20,0
1713345391062,LISP 5A,A00,507541,Munoz Sanchez; Alicia,17,0,20,3
1713345392089,LISP 5B,A00,507671,Munoz Sanchez; Alicia,15,0,20,5
1713345393119,LISP 5C,A00,507696,Munoz Sanchez; Alicia,15,0,20,5
1713345394149,MAE 197,001,528363,Boechler; Nicholas Sebastia,9998,0,9999,1
1713345395177,MATH 197,001,523477,Kedlaya; Kiran S.,9999,0,9999,0
1713345395177,MATH 197,002,563811,Zhang; Danna,9999,0,9999,0
1713345396202,MCWP 40R,A00,518780,Staff,20,0,20,0
1713345396202,MCWP 40R,B00,518781,Staff,19,0,20,1
1713345396202,MCWP 40R,C00,518783,Staff,19,0,20,1
1713345397229,MCWP 50R,A00,518791,Staff,20,0,20,0
1713345397229,MCWP 50R,B00,518792,Staff,17,0,20,3
1713345397229,MCWP 50R,C00,518793,Staff,19,0,20,1
1713345397229,MCWP 50R,D00,518794,Staff,16,0,20,4
1713345397229,MCWP 50R,E00,518795,Staff,16,0,20,4
1713345397229,MCWP 50R,F00,518796,Staff,19,0,20,1
1713345397229,MCWP 50R,G00,518797,Staff,19,0,20,1
1713345398256,MMW 12R,A01,514034,Herbst; Matthew,15,0,16,1
1713345398256,MMW 12R,A02,514035,Herbst; Matthew,16,0,16,0
1713345399282,MMW 13R,A01,514037,Staff,12,0,16,4
1713345399282,MMW 13R,A02,514039,Staff,16,0,16,0
1713345401337,SIO 295LS,A00,523233,Staff,18,0,30,12
1713345402361,SIO 295S,A00,523232,Staff,18,0,30,12
1713345403387,SOCI 117,A01,494376,Staff,1,0,5,4
1713345404412,WES 237B,A00,494380,Staff,19,0,20,1
1713345406485,AESE 279B,A00,494370,Wade; Jon P,33,0,33,0
1713345407516,ANAR 135S,A00,494369,Braswell; Geoffrey E.,0,0,0,0
1713345408541,CAT 124RS,A01,519847,Geibel; William,17,0,20,3
1713345409572,CAT 125RS,A01,515971,Geibel; William,17,0,20,3
1713345410606,CLRE 250,A00,511389,Morris; Sheldon,9996,0,9999,3
1713345411636,CLRE 251,A00,507176,Mehta; Ravindra L.,9996,0,9999,3
1713345411636,CLRE 251,B00,511410,Mehta; Ravindra L.,9998,0,9999,1
1713345412665,CLRE 252,A00,507189,Cuomo; Raphael Eduardo,9998,0,9999,1
1713345413692,CLRE 253,A00,507199,Vaida; Florin,9997,0,9999,2
1713345413692,CLRE 253,B00,507202,Vaida; Florin,9999,0,9999,0
1713345414715,CLRE 259,A00,507211,Patel; Hemal,9996,0,9999,3
1713345415741,CLRE 260,A00,507221,Cuomo; Raphael Eduardo,9999,0,9999,0
1713345416768,CLRE 297,001,507242,Cuomo; Raphael Eduardo,9999,0,9999,0
1713345417793,CSE 191,A00,516875,Minnes Kemp; Mor Mia,9999,0,9999,0
1713345418819,CSS 201S,A01,494383,Staff,35,0,35,0
1713345419845,CSS 202S,A01,494387,Staff,35,0,35,0
1713345420874,EAP 100,A00,516065,Staff,9792,0,9999,207
1713345421907,ECE 45,A01,507414,Staff,51,0,60,9
1713345422995,ECE 100,A01,507416,Baghdadchi; Saharnaz,10,0,20,10
1713345422995,ECE 100,A02,507418,Baghdadchi; Saharnaz,20,0,20,0
1713345424021,ECE 111,A01,507420,Staff,38,0,50,12
1713345425051,ECE 197,001,548057,Sievenpiper; Daniel F.,9998,0,9999,1
1713345426077,EDS 115,A00,507243,Choi; Bailey Miyeon,28,0,28,0
1713345427103,EDS 117,A01,494379,Staff,23,0,25,2
1713345428129,EDS 125,A00,507246,Hopkins; Megan Beth,29,0,30,1
1713345429156,EDS 128A,A01,507264,Fargason; Sharon Gayle,26,0,26,0
1713345430181,EDS 128B,A01,507293,Pappas; Elizabeth,30,0,30,0
1713345431210,EDS 139,A00,507294,Fargason; Sharon Gayle,30,0,30,0
1713345431210,EDS 139,B00,507313,Pappas; Elizabeth,30,0,30,0
1713345432235,EDS 201,A00,507315,Staff,26,0,30,4
1713345433265,EDS 203,A01,507317,Halter; Christopher P.,26,0,30,4
1713345434291,EDS 204R,A01,507319,Halter; Christopher P.,3,0,30,27
1713345434291,EDS 204R,B01,507331,Heinzman; Erica M.,28,0,30,2
1713345435318,EDS 206R,A00,507332,Staff,4,0,30,26
1713345435318,EDS 206R,B00,507343,Staff,28,0,30,2
1713345436345,EDS 250,A00,507344,Hemans; Patricia Ann Benitez,36,0,40,4
1713345437375,EDS 281,A00,507345,Daly; Alan J.,18,0,18,0
1713345438403,EDS 284,A00,507350,Daly; Alan J.,16,0,16,0
1713345439428,EDS 286,A00,507359,Fine; Sarah,18,0,18,0
1713345440457,EDS 289C,A01,507361,Daly; Alan J.,18,0,18,0
1713345441484,EDS 290,A00,507366,Hofstetter; Carolyn,15,0,15,0
1713345442511,LIGM 5A,A00,507421,Fischer-Grunski; Eva K,20,0,20,0
1713345443537,LIGM 5B,A00,507423,Fischer-Grunski; Eva K,20,0,20,0
1713345444561,LIGM 5C,A00,507425,Fischer-Grunski; Eva K,20,0,20,0
1713345445590,LIIT 5AS,A00,507427,Carnelos; Chiara,20,0,20,0
1713345446617,LIIT 5BS,A00,507430,Carnelos; Chiara,20,0,20,0
1713345447647,LIIT 5CS,A00,507432,Carnelos; Chiara,20,0,20,0
1713345448679,LISP 5A,A00,507541,Munoz Sanchez; Alicia,17,0,20,3
1713345449705,LISP 5B,A00,507671,Munoz Sanchez; Alicia,15,0,20,5
1713345450730,LISP 5C,A00,507696,Munoz Sanchez; Alicia,15,0,20,5
1713345451756,MAE 197,001,528363,Boechler; Nicholas Sebastia,9998,0,9999,1
1713345452783,MATH 197,001,523477,Kedlaya; Kiran S.,9999,0,9999,0
1713345452783,MATH 197,002,563811,Zhang; Danna,9999,0,9999,0
1713345453815,MCWP 40R,A00,518780,Staff,20,0,20,0
1713345453815,MCWP 40R,B00,518781,Staff,19,0,20,1
1713345453815,MCWP 40R,C00,518783,Staff,19,0,20,1
1713345454846,MCWP 50R,A00,518791,Staff,20,0,20,0
1713345454846,MCWP 50R,B00,518792,Staff,17,0,20,3
1713345454846,MCWP 50R,C00,518793,Staff,19,0,20,1
1713345454846,MCWP 50R,D00,518794,Staff,16,0,20,4
1713345454846,MCWP 50R,E00,518795,Staff,16,0,20,4
1713345454846,MCWP 50R,F00,518796,Staff,19,0,20,1
1713345454846,MCWP 50R,G00,518797,Staff,19,0,20,1
1713345455873,MMW 12R,A01,514034,Herbst; Matthew,15,0,16,1
1713345455873,MMW 12R,A02,514035,Herbst; Matthew,16,0,16,0
1713345456902,MMW 13R,A01,514037,Staff,12,0,16,4
1713345456902,MMW 13R,A02,514039,Staff,16,0,16,0
1713345458953,SIO 295LS,A00,523233,Staff,18,0,30,12
1713345459979,SIO 295S,A00,523232,Staff,18,0,30,12
1713345461010,SOCI 117,A01,494376,Staff,1,0,5,4
1713345462037,WES 237B,A00,494380,Staff,19,0,20,1
1713345464120,AESE 279B,A00,494370,Wade; Jon P,33,0,33,0
1713345465147,ANAR 135S,A00,494369,Braswell; Geoffrey E.,0,0,0,0
1713345466174,CAT 124RS,A01,519847,Geibel; William,17,0,20,3
1713345467203,CAT 125RS,A01,515971,Geibel; William,17,0,20,3
1713345468234,CLRE 250,A00,511389,Morris; Sheldon,9996,0,9999,3
1713345469265,CLRE 251,A00,507176,Mehta; Ravindra L.,9996,0,9999,3
1713345469265,CLRE 251,B00,511410,Mehta; Ravindra L.,9998,0,9999,1
1713345470291,CLRE 252,A00,507189,Cuomo; Raphael Eduardo,9998,0,9999,1
1713345471318,CLRE 253,A00,507199,Vaida; Florin,9997,0,9999,2
1713345471318,CLRE 253,B00,507202,Vaida; Florin,9999,0,9999,0
1713345472346,CLRE 259,A00,507211,Patel; Hemal,9996,0,9999,3
1713345473373,CLRE 260,A00,507221,Cuomo; Raphael Eduardo,9999,0,9999,0
1713345474402,CLRE 297,001,507242,Cuomo; Raphael Eduardo,9999,0,9999,0
1713345475430,CSE 191,A00,516875,Minnes Kemp; Mor Mia,9999,0,9999,0
1713345476457,CSS 201S,A01,494383,Staff,35,0,35,0
1713345477487,CSS 202S,A01,494387,Staff,35,0,35,0
1713345478515,EAP 100,A00,516065,Staff,9792,0,9999,207
1713345479540,ECE 45,A01,507414,Staff,51,0,60,9
1713345480566,ECE 100,A01,507416,Baghdadchi; Saharnaz,10,0,20,10
1713345480566,ECE 100,A02,507418,Baghdadchi; Saharnaz,20,0,20,0
1713345481596,ECE 111,A01,507420,Staff,38,0,50,12
1713345482620,ECE 197,001,548057,Sievenpiper; Daniel F.,9998,0,9999,1
1713345483647,EDS 115,A00,507243,Choi; Bailey Miyeon,28,0,28,0
1713345484677,EDS 117,A01,494379,Staff,23,0,25,2
1713345485707,EDS 125,A00,507246,Hopkins; Megan Beth,29,0,30,1
1713345486733,EDS 128A,A01,507264,Fargason; Sharon Gayle,26,0,26,0
1713345487760,EDS 128B,A01,507293,Pappas; Elizabeth,30,0,30,0
1713345488787,EDS 139,A00,507294,Fargason; Sharon Gayle,30,0,30,0
1713345488787,EDS 139,B00,507313,Pappas; Elizabeth,30,0,30,0
1713345489813,EDS 201,A00,507315,Staff,26,0,30,4
1713345490843,EDS 203,A01,507317,Halter; Christopher P.,26,0,30,4
1713345491872,EDS 204R,A01,507319,Halter; Christopher P.,3,0,30,27
1713345491872,EDS 204R,B01,507331,Heinzman; Erica M.,28,0,30,2
1713345492897,EDS 206R,A00,507332,Staff,4,0,30,26
1713345492897,EDS 206R,B00,507343,Staff,28,0,30,2
1713345493928,EDS 250,A00,507344,Hemans; Patricia Ann Benitez,36,0,40,4
1713345494959,EDS 281,A00,507345,Daly; Alan J.,18,0,18,0
1713345495988,EDS 284,A00,507350,Daly; Alan J.,16,0,16,0
1713345497016,EDS 286,A00,507359,Fine; Sarah,18,0,18,0
1713345498041,EDS 289C,A01,507361,Daly; Alan J.,18,0,18,0
1713345499066,EDS 290,A00,507366,Hofstetter; Carolyn,15,0,15,0
1713345500094,LIGM 5A,A00,507421,Fischer-Grunski; Eva K,20,0,20,0
1713345501124,LIGM 5B,A00,507423,Fischer-Grunski; Eva K,20,0,20,0
1713345502156,LIGM 5C,A00,507425,Fischer-Grunski; Eva K,20,0,20,0
1713345503182,LIIT 5AS,A00,507427,Carnelos; Chiara,20,0,20,0
1713345504209,LIIT 5BS,A00,507430,Carnelos; Chiara,20,0,20,0
1713345505239,LIIT 5CS,A00,507432,Carnelos; Chiara,20,0,20,0
1713345506266,LISP 5A,A00,507541,Munoz Sanchez; Alicia,17,0,20,3
1713345507297,LISP 5B,A00,507671,Munoz Sanchez; Alicia,15,0,20,5
1713345508323,LISP 5C,A00,507696,Munoz Sanchez; Alicia,15,0,20,5
1713345509349,MAE 197,001,528363,Boechler; Nicholas Sebastia,9998,0,9999,1
1713345510376,MATH 197,001,523477,Kedlaya; Kiran S.,9999,0,9999,0
1713345510376,MATH 197,002,563811,Zhang; Danna,9999,0,9999,0
1713345511401,MCWP 40R,A00,518780,Staff,20,0,20,0
1713345511401,MCWP 40R,B00,518781,Staff,19,0,20,1
1713345511401,MCWP 40R,C00,518783,Staff,19,0,20,1
1713345512433,MCWP 50R,A00,518791,Staff,20,0,20,0
1713345512433,MCWP 50R,B00,518792,Staff,17,0,20,3
1713345512433,MCWP 50R,C00,518793,Staff,19,0,20,1
1713345512433,MCWP 50R,D00,518794,Staff,16,0,20,4
1713345512433,MCWP 50R,E00,518795,Staff,16,0,20,4
1713345512433,MCWP 50R,F00,518796,Staff,19,0,20,1
1713345512433,MCWP 50R,G00,518797,Staff,19,0,20,1
1713345513458,MMW 12R,A01,514034,Herbst; Matthew,15,0,16,1
1713345513458,MMW 12R,A02,514035,Herbst; Matthew,16,0,16,0
1713345514486,MMW 13R,A01,514037,Staff,12,0,16,4
1713345514486,MMW 13R,A02,514039,Staff,16,0,16,0
1713345516546,SIO 295LS,A00,523233,Staff,18,0,30,12
1713345517572,SIO 295S,A00,523232,Staff,18,0,30,12
1713345518603,SOCI 117,A01,494376,Staff,1,0,5,4
1713345519629,WES 237B,A00,494380,Staff,19,0,20,1
1713345521711,AESE 279B,A00,494370,Wade; Jon P,33,0,33,0
1713345522737,ANAR 135S,A00,494369,Braswell; Geoffrey E.,0,0,0,0
1713345523763,CAT 124RS,A01,519847,Geibel; William,17,0,20,3
1713345524793,CAT 125RS,A01,515971,Geibel; William,17,0,20,3
1713345525820,CLRE 250,A00,511389,Morris; Sheldon,9996,0,9999,3
1713345526901,CLRE 251,A00,507176,Mehta; Ravindra L.,9996,0,9999,3
1713345526901,CLRE 251,B00,511410,Mehta; Ravindra L.,9998,0,9999,1
1713345527929,CLRE 252,A00,507189,Cuomo; Raphael Eduardo,9998,0,9999,1
1713345528954,CLRE 253,A00,507199,Vaida; Florin,9997,0,9999,2
1713345528954,CLRE 253,B00,507202,Vaida; Florin,9999,0,9999,0
1713345529984,CLRE 259,A00,507211,Patel; Hemal,9996,0,9999,3
1713345531009,CLRE 260,A00,507221,Cuomo; Raphael Eduardo,9999,0,9999,0
1713345532034,CLRE 297,001,507242,Cuomo; Raphael Eduardo,9999,0,9999,0
1713345533059,CSE 191,A00,516875,Minnes Kemp; Mor Mia,9999,0,9999,0
1713345534090,CSS 201S,A01,494383,Staff,35,0,35,0
1713345535127,CSS 202S,A01,494387,Staff,35,0,35,0
1713345536155,EAP 100,A00,516065,Staff,9792,0,9999,207
1713345537182,ECE 45,A01,507414,Staff,51,0,60,9
1713345538209,ECE 100,A01,507416,Baghdadchi; Saharnaz,10,0,20,10
1713345538209,ECE 100,A02,507418,Baghdadchi; Saharnaz,20,0,20,0
1713345539239,ECE 111,A01,507420,Staff,38,0,50,12
1713345540269,ECE 197,001,548057,Sievenpiper; Daniel F.,9998,0,9999,1
1713345541296,EDS 115,A00,507243,Choi; Bailey Miyeon,28,0,28,0
1713345542322,EDS 117,A01,494379,Staff,23,0,25,2
1713345543354,EDS 125,A00,507246,Hopkins; Megan Beth,29,0,30,1
1713345544379,EDS 128A,A01,507264,Fargason; Sharon Gayle,26,0,26,0
1713345545405,EDS 128B,A01,507293,Pappas; Elizabeth,30,0,30,0
1713345546431,EDS 139,A00,507294,Fargason; Sharon Gayle,30,0,30,0
1713345546431,EDS 139,B00,507313,Pappas; Elizabeth,30,0,30,0
1713345547460,EDS 201,A00,507315,Staff,26,0,30,4
1713345548485,EDS 203,A01,507317,Halter; Christopher P.,26,0,30,4
1713345549518,EDS 204R,A01,507319,Halter; Christopher P.,3,0,30,27
1713345549518,EDS 204R,B01,507331,Heinzman; Erica M.,28,0,30,2
1713345550547,EDS 206R,A00,507332,Staff,4,0,30,26
1713345550547,EDS 206R,B00,507343,Staff,28,0,30,2
1713345551576,EDS 250,A00,507344,Hemans; Patricia Ann Benitez,36,0,40,4
1713345552602,EDS 281,A00,507345,Daly; Alan J.,18,0,18,0
1713345553627,EDS 284,A00,507350,Daly; Alan J.,16,0,16,0
1713345554653,EDS 286,A00,507359,Fine; Sarah,18,0,18,0
1713345555678,EDS 289C,A01,507361,Daly; Alan J.,18,0,18,0
1713345556704,EDS 290,A00,507366,Hofstetter; Carolyn,15,0,15,0
1713345557735,LIGM 5A,A00,507421,Fischer-Grunski; Eva K,20,0,20,0
1713345558762,LIGM 5B,A00,507423,Fischer-Grunski; Eva K,20,0,20,0
1713345559786,LIGM 5C,A00,507425,Fischer-Grunski; Eva K,20,0,20,0
1713345560813,LIIT 5AS,A00,507427,Carnelos; Chiara,20,0,20,0
1713345561842,LIIT 5BS,A00,507430,Carnelos; Chiara,20,0,20,0
1713345562867,LIIT 5CS,A00,507432,Carnelos; Chiara,20,0,20,0
1713345563902,LISP 5A,A00,507541,Munoz Sanchez; Alicia,17,0,20,3
1713345564932,LISP 5B,A00,507671,Munoz Sanchez; Alicia,15,0,20,5
1713345565962,LISP 5C,A00,507696,Munoz Sanchez; Alicia,15,0,20,5
1713345566991,MAE 197,001,528363,Boechler; Nicholas Sebastia,9998,0,9999,1
1713345568027,MATH 197,001,523477,Kedlaya; Kiran S.,9999,0,9999,0
1713345568027,MATH 197,002,563811,Zhang; Danna,9999,0,9999,0
1713345569058,MCWP 40R,A00,518780,Staff,20,0,20,0
1713345569058,MCWP 40R,B00,518781,Staff,19,0,20,1
1713345569058,MCWP 40R,C00,518783,Staff,19,0,20,1
1713345570085,MCWP 50R,A00,518791,Staff,20,0,20,0
1713345570085,MCWP 50R,B00,518792,Staff,17,0,20,3
1713345570085,MCWP 50R,C00,518793,Staff,19,0,20,1
1713345570085,MCWP 50R,D00,518794,Staff,16,0,20,4
1713345570085,MCWP 50R,E00,518795,Staff,16,0,20,4
1713345570085,MCWP 50R,F00,518796,Staff,19,0,20,1
1713345570085,MCWP 50R,G00,518797,Staff,19,0,20,1
1713345571120,MMW 12R,A01,514034,Herbst; Matthew,15,0,16,1
1713345571120,MMW 12R,A02,514035,Herbst; Matthew,16,0,16,0
1713345572146,MMW 13R,A01,514037,Staff,12,0,16,4
1713345572146,MMW 13R,A02,514039,Staff,16,0,16,0
1713345574201,SIO 295LS,A00,523233,Staff,18,0,30,12
1713345575226,SIO 295S,A00,523232,Staff,18,0,30,12
1713345576256,SOCI 117,A01,494376,Staff,1,0,5,4
1713345577281,WES 237B,A00,494380,Staff,19,0,20,1
1713345579354,AESE 279B,A00,494370,Wade; Jon P,33,0,33,0
1713345580379,ANAR 135S,A00,494369,Braswell; Geoffrey E.,0,0,0,0
1713345581406,CAT 124RS,A01,519847,Geibel; William,17,0,20,3
1713345582432,CAT 125RS,A01,515971,Geibel; William,17,0,20,3
1713345583464,CLRE 250,A00,511389,Morris; Sheldon,9996,0,9999,3
1713345584497,CLRE 251,A00,507176,Mehta; Ravindra L.,9996,0,9999,3
1713345584497,CLRE 251,B00,511410,Mehta; Ravindra L.,9998,0,9999,1
1713345585524,CLRE 252,A00,507189,Cuomo; Raphael Eduardo,9998,0,9999,1
1713345586550,CLRE 253,A00,507199,Vaida; Florin,9997,0,9999,2
1713345586550,CLRE 253,B00,507202,Vaida; Florin,9999,0,9999,0
1713345587573,CLRE 259,A00,507211,Patel; Hemal,9996,0,9999,3
1713345588602,CLRE 260,A00,507221,Cuomo; Raphael Eduardo,9999,0,9999,0
1713345589629,CLRE 297,001,507242,Cuomo; Raphael Eduardo,9999,0,9999,0
1713345590661,CSE 191,A00,516875,Minnes Kemp; Mor Mia,9999,0,9999,0
1713345591693,CSS 201S,A01,494383,Staff,35,0,35,0
1713345592723,CSS 202S,A01,494387,Staff,35,0,35,0
1713345593753,EAP 100,A00,516065,Staff,9792,0,9999,207
1713345594779,ECE 45,A01,507414,Staff,51,0,60,9
1713345595809,ECE 100,A01,507416,Baghdadchi; Saharnaz,10,0,20,10
1713345595809,ECE 100,A02,507418,Baghdadchi; Saharnaz,20,0,20,0
1713345596839,ECE 111,A01,507420,Staff,38,0,50,12
1713345597865,ECE 197,001,548057,Sievenpiper; Daniel F.,9998,0,9999,1
1713345598892,EDS 115,A00,507243,Choi; Bailey Miyeon,28,0,28,0
1713345599924,EDS 117,A01,494379,Staff,23,0,25,2
1713345600950,EDS 125,A00,507246,Hopkins; Megan Beth,29,0,30,1
1713345601980,EDS 128A,A01,507264,Fargason; Sharon Gayle,26,0,26,0
1713345603006,EDS 128B,A01,507293,Pappas; Elizabeth,30,0,30,0
1713345604036,EDS 139,A00,507294,Fargason; Sharon Gayle,30,0,30,0
1713345604036,EDS 139,B00,507313,Pappas; Elizabeth,30,0,30,0
1713345605066,EDS 201,A00,507315,Staff,26,0,30,4
1713345606096,EDS 203,A01,507317,Halter; Christopher P.,26,0,30,4
1713345607122,EDS 204R,A01,507319,Halter; Christopher P.,3,0,30,27
1713345607122,EDS 204R,B01,507331,Heinzman; Erica M.,28,0,30,2
1713345608152,EDS 206R,A00,507332,Staff,4,0,30,26
1713345608152,EDS 206R,B00,507343,Staff,28,0,30,2
1713345609181,EDS 250,A00,507344,Hemans; Patricia Ann Benitez,36,0,40,4
1713345610205,EDS 281,A00,507345,Daly; Alan J.,18,0,18,0
1713345611232,EDS 284,A00,507350,Daly; Alan J.,16,0,16,0
1713345612256,EDS 286,A00,507359,Fine; Sarah,18,0,18,0
1713345613284,EDS 289C,A01,507361,Daly; Alan J.,18,0,18,0
1713345614314,EDS 290,A00,507366,Hofstetter; Carolyn,15,0,15,0
1713345615346,LIGM 5A,A00,507421,Fischer-Grunski; Eva K,20,0,20,0
1713345616374,LIGM 5B,A00,507423,Fischer-Grunski; Eva K,20,0,20,0
1713345617399,LIGM 5C,A00,507425,Fischer-Grunski; Eva K,20,0,20,0
1713345618431,LIIT 5AS,A00,507427,Carnelos; Chiara,20,0,20,0
1713345619457,LIIT 5BS,A00,507430,Carnelos; Chiara,20,0,20,0
1713345620483,LIIT 5CS,A00,507432,Carnelos; Chiara,20,0,20,0
1713345621515,LISP 5A,A00,507541,Munoz Sanchez; Alicia,17,0,20,3
1713345622539,LISP 5B,A00,507671,Munoz Sanchez; Alicia,15,0,20,5
1713345623569,LISP 5C,A00,507696,Munoz Sanchez; Alicia,15,0,20,5
1713345624596,MAE 197,001,528363,Boechler; Nicholas Sebastia,9998,0,9999,1
1713345625629,MATH 197,001,523477,Kedlaya; Kiran S.,9999,0,9999,0
1713345625629,MATH 197,002,563811,Zhang; Danna,9999,0,9999,0
1713345626656,MCWP 40R,A00,518780,Staff,20,0,20,0
1713345626656,MCWP 40R,B00,518781,Staff,19,0,20,1
1713345626656,MCWP 40R,C00,518783,Staff,19,0,20,1
1713345627700,MCWP 50R,A00,518791,Staff,20,0,20,0
1713345627700,MCWP 50R,B00,518792,Staff,17,0,20,3
1713345627700,MCWP 50R,C00,518793,Staff,19,0,20,1
1713345627700,MCWP 50R,D00,518794,Staff,16,0,20,4
1713345627700,MCWP 50R,E00,518795,Staff,16,0,20,4
1713345627700,MCWP 50R,F00,518796,Staff,19,0,20,1
1713345627700,MCWP 50R,G00,518797,Staff,19,0,20,1
1713345628730,MMW 12R,A01,514034,Herbst; Matthew,15,0,16,1
1713345628730,MMW 12R,A02,514035,Herbst; Matthew,16,0,16,0
1713345629757,MMW 13R,A01,514037,Staff,12,0,16,4
1713345629757,MMW 13R,A02,514039,Staff,16,0,16,0
1713345631862,SIO 295LS,A00,523233,Staff,18,0,30,12
1713345632891,SIO 295S,A00,523232,Staff,18,0,30,12
1713345633918,SOCI 117,A01,494376,Staff,1,0,5,4
1713345634944,WES 237B,A00,494380,Staff,19,0,20,1
1713345637016,AESE 279B,A00,494370,Wade; Jon P,33,0,33,0
1713345638041,ANAR 135S,A00,494369,Braswell; Geoffrey E.,0,0,0,0
1713345639066,CAT 124RS,A01,519847,Geibel; William,17,0,20,3
1713345640095,CAT 125RS,A01,515971,Geibel; William,17,0,20,3
1713345641127,CLRE 250,A00,511389,Morris; Sheldon,9996,0,9999,3
1713345642156,CLRE 251,A00,507176,Mehta; Ravindra L.,9996,0,9999,3
1713345642156,CLRE 251,B00,511410,Mehta; Ravindra L.,9998,0,9999,1
1713345643182,CLRE 252,A00,507189,Cuomo; Raphael Eduardo,9998,0,9999,1
1713345644209,CLRE 253,A00,507199,Vaida; Florin,9997,0,9999,2
1713345644209,CLRE 253,B00,507202,Vaida; Florin,9999,0,9999,0
1713345645237,CLRE 259,A00,507211,Patel; Hemal,9996,0,9999,3
1713345646266,CLRE 260,A00,507221,Cuomo; Raphael Eduardo,9999,0,9999,0
1713345647292,CLRE 297,001,507242,Cuomo; Raphael Eduardo,9999,0,9999,0
1713345648316,CSE 191,A00,516875,Minnes Kemp; Mor Mia,9999,0,9999,0
1713345649342,CSS 201S,A01,494383,Staff,35,0,35,0
1713345650371,CSS 202S,A01,494387,Staff,35,0,35,0
1713345651396,EAP 100,A00,516065,Staff,9792,0,9999,207
1713345652428,ECE 45,A01,507414,Staff,51,0,60,9
1713345653459,ECE 100,A01,507416,Baghdadchi; Saharnaz,10,0,20,10
1713345653459,ECE 100,A02,507418,Baghdadchi; Saharnaz,20,0,20,0
1713345654483,ECE 111,A01,507420,Staff,38,0,50,12
1713345655509,ECE 197,001,548057,Sievenpiper; Daniel F.,9998,0,9999,1
1713345656536,EDS 115,A00,507243,Choi; Bailey Miyeon,28,0,28,0
1713345657565,EDS 117,A01,494379,Staff,23,0,25,2
1713345658591,EDS 125,A00,507246,Hopkins; Megan Beth,29,0,30,1
1713345659617,EDS 128A,A01,507264,Fargason; Sharon Gayle,26,0,26,0
1713345660643,EDS 128B,A01,507293,Pappas; Elizabeth,30,0,30,0
1713345661672,EDS 139,A00,507294,Fargason; Sharon Gayle,30,0,30,0
1713345661672,EDS 139,B00,507313,Pappas; Elizabeth,30,0,30,0
1713345662698,EDS 201,A00,507315,Staff,26,0,30,4
1713345663732,EDS 203,A01,507317,Halter; Christopher P.,26,0,30,4
1713345664764,EDS 204R,A01,507319,Halter; Christopher P.,3,0,30,27
1713345664764,EDS 204R,B01,507331,Heinzman; Erica M.,28,0,30,2
1713345665795,EDS 206R,A00,507332,Staff,4,0,30,26
1713345665795,EDS 206R,B00,507343,Staff,28,0,30,2
1713345666820,EDS 250,A00,507344,Hemans; Patricia Ann Benitez,36,0,40,4
1713345667847,EDS 281,A00,507345,Daly; Alan J.,18,0,18,0
1713345668872,EDS 284,A00,507350,Daly; Alan J.,16,0,16,0
1713345669903,EDS 286,A00,507359,Fine; Sarah,18,0,18,0
1713345670929,EDS 289C,A01,507361,Daly; Alan J.,18,0,18,0
1713345671955,EDS 290,A00,507366,Hofstetter; Carolyn,15,0,15,0
1713345672988,LIGM 5A,A00,507421,Fischer-Grunski; Eva K,20,0,20,0
1713345674014,LIGM 5B,A00,507423,Fischer-Grunski; Eva K,20,0,20,0
1713345675045,LIGM 5C,A00,507425,Fischer-Grunski; Eva K,20,0,20,0
1713345676072,LIIT 5AS,A00,507427,Carnelos; Chiara,20,0,20,0
1713345677098,LIIT 5BS,A00,507430,Carnelos; Chiara,20,0,20,0
1713345678124,LIIT 5CS,A00,507432,Carnelos; Chiara,20,0,20,0
1713345679151,LISP 5A,A00,507541,Munoz Sanchez; Alicia,17,0,20,3
1713345680181,LISP 5B,A00,507671,Munoz Sanchez; Alicia,15,0,20,5
1713345681209,LISP 5C,A00,507696,Munoz Sanchez; Alicia,15,0,20,5
1713345682235,MAE 197,001,528363,Boechler; Nicholas Sebastia,9998,0,9999,1
1713345683262,MATH 197,001,523477,Kedlaya; Kiran S.,9999,0,9999,0
1713345683262,MATH 197,002,563811,Zhang; Danna,9999,0,9999,0
1713345684288,MCWP 40R,A00,518780,Staff,20,0,20,0
1713345684288,MCWP 40R,B00,518781,Staff,19,0,20,1
1713345684288,MCWP 40R,C00,518783,Staff,19,0,20,1
1713345685316,MCWP 50R,A00,518791,Staff,20,0,20,0
1713345685316,MCWP 50R,B00,518792,Staff,17,0,20,3
1713345685316,MCWP 50R,C00,518793,Staff,19,0,20,1
1713345685316,MCWP 50R,D00,518794,Staff,16,0,20,4
1713345685316,MCWP 50R,E00,518795,Staff,16,0,20,4
1713345685316,MCWP 50R,F00,518796,Staff,19,0,20,1
1713345685316,MCWP 50R,G00,518797,Staff,19,0,20,1
1713345686346,MMW 12R,A01,514034,Herbst; Matthew,15,0,16,1
1713345686346,MMW 12R,A02,514035,Herbst; Matthew,16,0,16,0
1713345687371,MMW 13R,A01,514037,Staff,12,0,16,4
1713345687371,MMW 13R,A02,514039,Staff,16,0,16,0
1713345689427,SIO 295LS,A00,523233,Staff,18,0,30,12
1713345690451,SIO 295S,A00,523232,Staff,18,0,30,12
1713345691478,SOCI 117,A01,494376,Staff,1,0,5,4
1713345692502,WES 237B,A00,494380,Staff,19,0,20,1
1713345694588,AESE 279B,A00,494370,Wade; Jon P,33,0,33,0
1713345695618,ANAR 135S,A00,494369,Braswell; Geoffrey E.,0,0,0,0
1713345696646,CAT 124RS,A01,519847,Geibel; William,17,0,20,3
1713345697672,CAT 125RS,A01,515971,Geibel; William,17,0,20,3
1713345698698,CLRE 250,A00,511389,Morris; Sheldon,9996,0,9999,3
1713345699726,CLRE 251,A00,507176,Mehta; Ravindra L.,9996,0,9999,3
1713345699726,CLRE 251,B00,511410,Mehta; Ravindra L.,9998,0,9999,1
1713345700753,CLRE 252,A00,507189,Cuomo; Raphael Eduardo,9998,0,9999,1
1713345701777,CLRE 253,A00,507199,Vaida; Florin,9997,0,9999,2
1713345701777,CLRE 253,B00,507202,Vaida; Florin,9999,0,9999,0
1713345702803,CLRE 259,A00,507211,Patel; Hemal,9996,0,9999,3
1713345703828,CLRE 260,A00,507221,Cuomo; Raphael Eduardo,9999,0,9999,0
1713345704857,CLRE 297,001,507242,Cuomo; Raphael Eduardo,9999,0,9999,0
1713345705882,CSE 191,A00,516875,Minnes Kemp; Mor Mia,9999,0,9999,0
1713345706913,CSS 201S,A01,494383,Staff,35,0,35,0
1713345707943,CSS 202S,A01,494387,Staff,35,0,35,0
1713345708969,EAP 100,A00,516065,Staff,9792,0,9999,207
1713345709995,ECE 45,A01,507414,Staff,51,0,60,9
1713345711020,ECE 100,A01,507416,Baghdadchi; Saharnaz,10,0,20,10
1713345711020,ECE 100,A02,507418,Baghdadchi; Saharnaz,20,0,20,0
1713345712046,ECE 111,A01,507420,Staff,38,0,50,12
1713345713073,ECE 197,001,548057,Sievenpiper; Daniel F.,9998,0,9999,1
1713345714099,EDS 115,A00,507243,Choi; Bailey Miyeon,28,0,28,0
1713345715126,EDS 117,A01,494379,Staff,23,0,25,2
1713345716153,EDS 125,A00,507246,Hopkins; Megan Beth,29,0,30,1
1713345717184,EDS 128A,A01,507264,Fargason; Sharon Gayle,26,0,26,0
1713345718209,EDS 128B,A01,507293,Pappas; Elizabeth,30,0,30,0
1713345719239,EDS 139,A00,507294,Fargason; Sharon Gayle,30,0,30,0
1713345719239,EDS 139,B00,507313,Pappas; Elizabeth,30,0,30,0
1713345720269,EDS 201,A00,507315,Staff,26,0,30,4
1713345721297,EDS 203,A01,507317,Halter; Christopher P.,26,0,30,4
1713345722328,EDS 204R,A01,507319,Halter; Christopher P.,3,0,30,27
1713345722328,EDS 204R,B01,507331,Heinzman; Erica M.,28,0,30,2
1713345723360,EDS 206R,A00,507332,Staff,4,0,30,26
1713345723360,EDS 206R,B00,507343,Staff,28,0,30,2
1713345724391,EDS 250,A00,507344,Hemans; Patricia Ann Benitez,36,0,40,4
1713345725420,EDS 281,A00,507345,Daly; Alan J.,18,0,18,0
1713345726447,EDS 284,A00,507350,Daly; Alan J.,16,0,16,0
1713345727474,EDS 286,A00,507359,Fine; Sarah,18,0,18,0
1713345728500,EDS 289C,A01,507361,Daly; Alan J.,18,0,18,0
1713345729528,EDS 290,A00,507366,Hofstetter; Carolyn,15,0,15,0
1713345730556,LIGM 5A,A00,507421,Fischer-Grunski; Eva K,20,0,20,0
1713345731582,LIGM 5B,A00,507423,Fischer-Grunski; Eva K,20,0,20,0
1713345732612,LIGM 5C,A00,507425,Fischer-Grunski; Eva K,20,0,20,0
1713345733642,LIIT 5AS,A00,507427,Carnelos; Chiara,20,0,20,0
1713345734721,LIIT 5BS,A00,507430,Carnelos; Chiara,20,0,20,0
1713345735750,LIIT 5CS,A00,507432,Carnelos; Chiara,20,0,20,0
1713345736776,LISP 5A,A00,507541,Munoz Sanchez; Alicia,17,0,20,3
1713345737802,LISP 5B,A00,507671,Munoz Sanchez; Alicia,15,0,20,5
1713345738828,LISP 5C,A00,507696,Munoz Sanchez; Alicia,15,0,20,5
1713345739859,MAE 197,001,528363,Boechler; Nicholas Sebastia,9998,0,9999,1
1713345740891,MATH 197,001,523477,Kedlaya; Kiran S.,9999,0,9999,0
1713345740891,MATH 197,002,563811,Zhang; Danna,9999,0,9999,0
1713345741917,MCWP 40R,A00,518780,Staff,20,0,20,0
1713345741917,MCWP 40R,B00,518781,Staff,19,0,20,1
1713345741917,MCWP 40R,C00,518783,Staff,19,0,20,1
1713345742946,MCWP 50R,A00,518791,Staff,20,0,20,0
1713345742946,MCWP 50R,B00,518792,Staff,17,0,20,3
1713345742946,MCWP 50R,C00,518793,Staff,19,0,20,1
1713345742946,MCWP 50R,D00,518794,Staff,16,0,20,4
1713345742946,MCWP 50R,E00,518795,Staff,16,0,20,4
1713345742946,MCWP 50R,F00,518796,Staff,19,0,20,1
1713345742946,MCWP 50R,G00,518797,Staff,19,0,20,1
1713345743973,MMW 12R,A01,514034,Herbst; Matthew,15,0,16,1
1713345743973,MMW 12R,A02,514035,Herbst; Matthew,16,0,16,0
1713345744998,MMW 13R,A01,514037,Staff,12,0,16,4
1713345744998,MMW 13R,A02,514039,Staff,16,0,16,0
1713345747055,SIO 295LS,A00,523233,Staff,18,0,30,12
1713345748081,SIO 295S,A00,523232,Staff,18,0,30,12
1713345749108,SOCI 117,A01,494376,Staff,1,0,5,4
1713345750138,WES 237B,A00,494380,Staff,19,0,20,1
1713345752214,AESE 279B,A00,494370,Wade; Jon P,33,0,33,0
1713345753245,ANAR 135S,A00,494369,Braswell; Geoffrey E.,0,0,0,0
1713345754278,CAT 124RS,A01,519847,Geibel; William,17,0,20,3
1713345755308,CAT 125RS,A01,515971,Geibel; William,17,0,20,3
1713345756339,CLRE 250,A00,511389,Morris; Sheldon,9996,0,9999,3
1713345757365,CLRE 251,A00,507176,Mehta; Ravindra L.,9996,0,9999,3
1713345757365,CLRE 251,B00,511410,Mehta; Ravindra L.,9998,0,9999,1
1713345758397,CLRE 252,A00,507189,Cuomo; Raphael Eduardo,9998,0,9999,1
1713345759421,CLRE 253,A00,507199,Vaida; Florin,9997,0,9999,2
1713345759421,CLRE 253,B00,507202,Vaida; Florin,9999,0,9999,0
1713345760452,CLRE 259,A00,507211,Patel; Hemal,9996,0,9999,3
1713345761480,CLRE 260,A00,507221,Cuomo; Raphael Eduardo,9999,0,9999,0
1713345762505,CLRE 297,001,507242,Cuomo; Raphael Eduardo,9999,0,9999,0
1713345763537,CSE 191,A00,516875,Minnes Kemp; Mor Mia,9999,0,9999,0
1713345764570,CSS 201S,A01,494383,Staff,35,0,35,0
1713345765600,CSS 202S,A01,494387,Staff,35,0,35,0
1713345766633,EAP 100,A00,516065,Staff,9792,0,9999,207
1713345767663,ECE 45,A01,507414,Staff,51,0,60,9
1713345768697,ECE 100,A01,507416,Baghdadchi; Saharnaz,10,0,20,10
1713345768697,ECE 100,A02,507418,Baghdadchi; Saharnaz,20,0,20,0
1713345769723,ECE 111,A01,507420,Staff,38,0,50,12
1713345770753,ECE 197,001,548057,Sievenpiper; Daniel F.,9998,0,9999,1
1713345771780,EDS 115,A00,507243,Choi; Bailey Miyeon,28,0,28,0
1713345772810,EDS 117,A01,494379,Staff,23,0,25,2
1713345773836,EDS 125,A00,507246,Hopkins; Megan Beth,29,0,30,1
1713345774867,EDS 128A,A01,507264,Fargason; Sharon Gayle,26,0,26,0
1713345775893,EDS 128B,A01,507293,Pappas; Elizabeth,30,0,30,0
1713345776919,EDS 139,A00,507294,Fargason; Sharon Gayle,30,0,30,0
1713345776919,EDS 139,B00,507313,Pappas; Elizabeth,30,0,30,0
1713345777945,EDS 201,A00,507315,Staff,26,0,30,4
1713345778971,EDS 203,A01,507317,Halter; Christopher P.,26,0,30,4
1713345779997,EDS 204R,A01,507319,Halter; Christopher P.,3,0,30,27
1713345779997,EDS 204R,B01,507331,Heinzman; Erica M.,28,0,30,2
1713345781024,EDS 206R,A00,507332,Staff,4,0,30,26
1713345781024,EDS 206R,B00,507343,Staff,28,0,30,2
1713345782049,EDS 250,A00,507344,Hemans; Patricia Ann Benitez,36,0,40,4
1713345783075,EDS 281,A00,507345,Daly; Alan J.,18,0,18,0
1713345784099,EDS 284,A00,507350,Daly; Alan J.,16,0,16,0
1713345785124,EDS 286,A00,507359,Fine; Sarah,18,0,18,0
1713345786155,EDS 289C,A01,507361,Daly; Alan J.,18,0,18,0
1713345787185,EDS 290,A00,507366,Hofstetter; Carolyn,15,0,15,0
1713345788212,LIGM 5A,A00,507421,Fischer-Grunski; Eva K,20,0,20,0
1713345789237,LIGM 5B,A00,507423,Fischer-Grunski; Eva K,20,0,20,0
1713345790263,LIGM 5C,A00,507425,Fischer-Grunski; Eva K,20,0,20,0
1713345791289,LIIT 5AS,A00,507427,Carnelos; Chiara,20,0,20,0
1713345792319,LIIT 5BS,A00,507430,Carnelos; Chiara,20,0,20,0
1713345793346,LIIT 5CS,A00,507432,Carnelos; Chiara,20,0,20,0
1713345794373,LISP 5A,A00,507541,Munoz Sanchez; Alicia,17,0,20,3
1713345795400,LISP 5B,A00,507671,Munoz Sanchez; Alicia,15,0,20,5
1713345796425,LISP 5C,A00,507696,Munoz Sanchez; Alicia,15,0,20,5
1713345797452,MAE 197,001,528363,Boechler; Nicholas Sebastia,9998,0,9999,1
1713345798482,MATH 197,001,523477,Kedlaya; Kiran S.,9999,0,9999,0
1713345798482,MATH 197,002,563811,Zhang; Danna,9999,0,9999,0
1713345799509,MCWP 40R,A00,518780,Staff,20,0,20,0
1713345799509,MCWP 40R,B00,518781,Staff,19,0,20,1
1713345799509,MCWP 40R,C00,518783,Staff,19,0,20,1
1713345800535,MCWP 50R,A00,518791,Staff,20,0,20,0
1713345800535,MCWP 50R,B00,518792,Staff,17,0,20,3
1713345800535,MCWP 50R,C00,518793,Staff,19,0,20,1
1713345800535,MCWP 50R,D00,518794,Staff,16,0,20,4
1713345800535,MCWP 50R,E00,518795,Staff,16,0,20,4
1713345800535,MCWP 50R,F00,518796,Staff,19,0,20,1
1713345800535,MCWP 50R,G00,518797,Staff,19,0,20,1
1713345801566,MMW 12R,A01,514034,Herbst; Matthew,15,0,16,1
1713345801566,MMW 12R,A02,514035,Herbst; Matthew,16,0,16,0
1713345802593,MMW 13R,A01,514037,Staff,12,0,16,4
1713345802593,MMW 13R,A02,514039,Staff,16,0,16,0
1713345804648,SIO 295LS,A00,523233,Staff,18,0,30,12
1713345805676,SIO 295S,A00,523232,Staff,18,0,30,12
1713345806704,SOCI 117,A01,494376,Staff,1,0,5,4
1713345807729,WES 237B,A00,494380,Staff,19,0,20,1
1713345809812,AESE 279B,A00,494370,Wade; Jon P,33,0,33,0
1713345810837,ANAR 135S,A00,494369,Braswell; Geoffrey E.,0,0,0,0
1713345811864,CAT 124RS,A01,519847,Geibel; William,17,0,20,3
1713345812890,CAT 125RS,A01,515971,Geibel; William,17,0,20,3
1713345813916,CLRE 250,A00,511389,Morris; Sheldon,9996,0,9999,3
1713345814944,CLRE 251,A00,507176,Mehta; Ravindra L.,9996,0,9999,3
1713345814944,CLRE 251,B00,511410,Mehta; Ravindra L.,9998,0,9999,1
1713345815970,CLRE 252,A00,507189,Cuomo; Raphael Eduardo,9998,0,9999,1
1713345816997,CLRE 253,A00,507199,Vaida; Florin,9997,0,9999,2
1713345816997,CLRE 253,B00,507202,Vaida; Florin,9999,0,9999,0
1713345818027,CLRE 259,A00,507211,Patel; Hemal,9996,0,9999,3
1713345819051,CLRE 260,A00,507221,Cuomo; Raphael Eduardo,9999,0,9999,0
1713345820078,CLRE 297,001,507242,Cuomo; Raphael Eduardo,9999,0,9999,0
1713345821104,CSE 191,A00,516875,Minnes Kemp; Mor Mia,9999,0,9999,0
1713345822131,CSS 201S,A01,494383,Staff,35,0,35,0
1713345823161,CSS 202S,A01,494387,Staff,35,0,35,0
1713345824189,EAP 100,A00,516065,Staff,9792,0,9999,207
1713345825212,ECE 45,A01,507414,Staff,51,0,60,9
1713345826239,ECE 100,A01,507416,Baghdadchi; Saharnaz,10,0,20,10
1713345826239,ECE 100,A02,507418,Baghdadchi; Saharnaz,20,0,20,0
1713345827268,ECE 111,A01,507420,Staff,38,0,50,12
1713345828291,ECE 197,001,548057,Sievenpiper; Daniel F.,9998,0,9999,1
1713345829319,EDS 115,A00,507243,Choi; Bailey Miyeon,28,0,28,0
1713345830349,EDS 117,A01,494379,Staff,23,0,25,2
1713345831378,EDS 125,A00,507246,Hopkins; Megan Beth,29,0,30,1
1713345832407,EDS 128A,A01,507264,Fargason; Sharon Gayle,26,0,26,0
1713345833436,EDS 128B,A01,507293,Pappas; Elizabeth,30,0,30,0
1713345834465,EDS 139,A00,507294,Fargason; Sharon Gayle,30,0,30,0
1713345834465,EDS 139,B00,507313,Pappas; Elizabeth,30,0,30,0
1713345835494,EDS 201,A00,507315,Staff,26,0,30,4
1713345836524,EDS 203,A01,507317,Halter; Christopher P.,26,0,30,4
1713345837553,EDS 204R,A01,507319,Halter; Christopher P.,3,0,30,27
1713345837553,EDS 204R,B01,507331,Heinzman; Erica M.,28,0,30,2
1713345838634,EDS 206R,A00,507332,Staff,4,0,30,26
1713345838634,EDS 206R,B00,507343,Staff,28,0,30,2
1713345839660,EDS 250,A00,507344,Hemans; Patricia Ann Benitez,36,0,40,4
1713345840684,EDS 281,A00,507345,Daly; Alan J.,18,0,18,0
1713345841712,EDS 284,A00,507350,Daly; Alan J.,16,0,16,0
1713345842739,EDS 286,A00,507359,Fine; Sarah,18,0,18,0
1713345843767,EDS 289C,A01,507361,Daly; Alan J.,18,0,18,0
1713345844793,EDS 290,A00,507366,Hofstetter; Carolyn,15,0,15,0
1713345845826,LIGM 5A,A00,507421,Fischer-Grunski; Eva K,20,0,20,0
1713345846852,LIGM 5B,A00,507423,Fischer-Grunski; Eva K,20,0,20,0
1713345847881,LIGM 5C,A00,507425,Fischer-Grunski; Eva K,20,0,20,0
1713345848912,LIIT 5AS,A00,507427,Carnelos; Chiara,20,0,20,0
1713345849938,LIIT 5BS,A00,507430,Carnelos; Chiara,20,0,20,0
1713345850968,LIIT 5CS,A00,507432,Carnelos; Chiara,20,0,20,0
1713345852000,LISP 5A,A00,507541,Munoz Sanchez; Alicia,17,0,20,3
1713345853030,LISP 5B,A00,507671,Munoz Sanchez; Alicia,15,0,20,5
1713345854057,LISP 5C,A00,507696,Munoz Sanchez; Alicia,15,0,20,5
1713345855083,MAE 197,001,528363,Boechler; Nicholas Sebastia,9998,0,9999,1
1713345856111,MATH 197,001,523477,Kedlaya; Kiran S.,9999,0,9999,0
1713345856111,MATH 197,002,563811,Zhang; Danna,9999,0,9999,0
1713345857139,MCWP 40R,A00,518780,Staff,20,0,20,0
1713345857139,MCWP 40R,B00,518781,Staff,19,0,20,1
1713345857139,MCWP 40R,C00,518783,Staff,19,0,20,1
1713345858165,MCWP 50R,A00,518791,Staff,20,0,20,0
1713345858165,MCWP 50R,B00,518792,Staff,17,0,20,3
1713345858165,MCWP 50R,C00,518793,Staff,19,0,20,1
1713345858165,MCWP 50R,D00,518794,Staff,16,0,20,4
1713345858165,MCWP 50R,E00,518795,Staff,16,0,20,4
1713345858165,MCWP 50R,F00,518796,Staff,19,0,20,1
1713345858165,MCWP 50R,G00,518797,Staff,19,0,20,1
1713345859194,MMW 12R,A01,514034,Herbst; Matthew,15,0,16,1
1713345859194,MMW 12R,A02,514035,Herbst; Matthew,16,0,16,0
1713345860220,MMW 13R,A01,514037,Staff,12,0,16,4
1713345860220,MMW 13R,A02,514039,Staff,16,0,16,0
1713345862277,SIO 295LS,A00,523233,Staff,18,0,30,12
1713345863307,SIO 295S,A00,523232,Staff,18,0,30,12
1713345864337,SOCI 117,A01,494376,Staff,1,0,5,4
1713345865366,WES 237B,A00,494380,Staff,19,0,20,1
1713345867435,AESE 279B,A00,494370,Wade; Jon P,33,0,33,0
1713345868460,ANAR 135S,A00,494369,Braswell; Geoffrey E.,0,0,0,0
1713345869487,CAT 124RS,A01,519847,Geibel; William,17,0,20,3
1713345870514,CAT 125RS,A01,515971,Geibel; William,17,0,20,3
1713345871546,CLRE 250,A00,511389,Morris; Sheldon,9996,0,9999,3
1713345872579,CLRE 251,A00,507176,Mehta; Ravindra L.,9996,0,9999,3
1713345872579,CLRE 251,B00,511410,Mehta; Ravindra L.,9998,0,9999,1
1713345873606,CLRE 252,A00,507189,Cuomo; Raphael Eduardo,9998,0,9999,1
1713345874633,CLRE 253,A00,507199,Vaida; Florin,9997,0,9999,2
1713345874633,CLRE 253,B00,507202,Vaida; Florin,9999,0,9999,0
1713345875659,CLRE 259,A00,507211,Patel; Hemal,9996,0,9999,3
1713345876684,CLRE 260,A00,507221,Cuomo; Raphael Eduardo,9999,0,9999,0
1713345877709,CLRE 297,001,507242,Cuomo; Raphael Eduardo,9999,0,9999,0
1713345878739,CSE 191,A00,516875,Minnes Kemp; Mor Mia,9999,0,9999,0
1713345879766,CSS 201S,A01,494383,Staff,35,0,35,0
1713345880797,CSS 202S,A01,494387,Staff,35,0,35,0
1713345881826,EAP 100,A00,516065,Staff,9792,0,9999,207
1713345882851,ECE 45,A01,507414,Staff,51,0,60,9
1713345883877,ECE 100,A01,507416,Baghdadchi; Saharnaz,10,0,20,10
1713345883877,ECE 100,A02,507418,Baghdadchi; Saharnaz,20,0,20,0
1713345884907,ECE 111,A01,507420,Staff,38,0,50,12
1713345885934,ECE 197,001,548057,Sievenpiper; Daniel F.,9998,0,9999,1
1713345886966,EDS 115,A00,507243,Choi; Bailey Miyeon,28,0,28,0
1713345887996,EDS 117,A01,494379,Staff,23,0,25,2
1713345889025,EDS 125,A00,507246,Hopkins; Megan Beth,29,0,30,1
1713345890056,EDS 128A,A01,507264,Fargason; Sharon Gayle,26,0,26,0
1713345891082,EDS 128B,A01,507293,Pappas; Elizabeth,30,0,30,0
1713345892110,EDS 139,A00,507294,Fargason; Sharon Gayle,30,0,30,0
1713345892110,EDS 139,B00,507313,Pappas; Elizabeth,30,0,30,0
1713345893138,EDS 201,A00,507315,Staff,26,0,30,4
1713345894164,EDS 203,A01,507317,Halter; Christopher P.,26,0,30,4
1713345895191,EDS 204R,A01,507319,Halter; Christopher P.,3,0,30,27
1713345895191,EDS 204R,B01,507331,Heinzman; Erica M.,28,0,30,2
1713345896217,EDS 206R,A00,507332,Staff,4,0,30,26
1713345896217,EDS 206R,B00,507343,Staff,28,0,30,2
1713345897247,EDS 250,A00,507344,Hemans; Patricia Ann Benitez,36,0,40,4
1713345898272,EDS 281,A00,507345,Daly; Alan J.,18,0,18,0
1713345899298,EDS 284,A00,507350,Daly; Alan J.,16,0,16,0
1713345900324,EDS 286,A00,507359,Fine; Sarah,18,0,18,0
1713345901349,EDS 289C,A01,507361,Daly; Alan J.,18,0,18,0
1713345902380,EDS 290,A00,507366,Hofstetter; Carolyn,15,0,15,0
1713345903408,LIGM 5A,A00,507421,Fischer-Grunski; Eva K,20,0,20,0
1713345904435,LIGM 5B,A00,507423,Fischer-Grunski; Eva K,20,0,20,0
1713345905474,LIGM 5C,A00,507425,Fischer-Grunski; Eva K,20,0,20,0
1713345906500,LIIT 5AS,A00,507427,Carnelos; Chiara,20,0,20,0
1713345907527,LIIT 5BS,A00,507430,Carnelos; Chiara,20,0,20,0
1713345908558,LIIT 5CS,A00,507432,Carnelos; Chiara,20,0,20,0
1713345909586,LISP 5A,A00,507541,Munoz Sanchez; Alicia,17,0,20,3
1713345910612,LISP 5B,A00,507671,Munoz Sanchez; Alicia,15,0,20,5
1713345911643,LISP 5C,A00,507696,Munoz Sanchez; Alicia,15,0,20,5
1713345912668,MAE 197,001,528363,Boechler; Nicholas Sebastia,9998,0,9999,1
1713345913695,MATH 197,001,523477,Kedlaya; Kiran S.,9999,0,9999,0
1713345913695,MATH 197,002,563811,Zhang; Danna,9999,0,9999,0
1713345914721,MCWP 40R,A00,518780,Staff,20,0,20,0
1713345914721,MCWP 40R,B00,518781,Staff,19,0,20,1
1713345914721,MCWP 40R,C00,518783,Staff,19,0,20,1
1713345915748,MCWP 50R,A00,518791,Staff,20,0,20,0
1713345915748,MCWP 50R,B00,518792,Staff,17,0,20,3
1713345915748,MCWP 50R,C00,518793,Staff,19,0,20,1
1713345915748,MCWP 50R,D00,518794,Staff,16,0,20,4
1713345915748,MCWP 50R,E00,518795,Staff,16,0,20,4
1713345915748,MCWP 50R,F00,518796,Staff,19,0,20,1
1713345915748,MCWP 50R,G00,518797,Staff,19,0,20,1
1713345916775,MMW 12R,A01,514034,Herbst; Matthew,15,0,16,1
1713345916775,MMW 12R,A02,514035,Herbst; Matthew,16,0,16,0
1713345917801,MMW 13R,A01,514037,Staff,12,0,16,4
1713345917801,MMW 13R,A02,514039,Staff,16,0,16,0
1713345919858,SIO 295LS,A00,523233,Staff,18,0,30,12
1713345920887,SIO 295S,A00,523232,Staff,18,0,30,12
1713345921914,SOCI 117,A01,494376,Staff,1,0,5,4
1713345922939,WES 237B,A00,494380,Staff,19,0,20,1
1713345925021,AESE 279B,A00,494370,Wade; Jon P,33,0,33,0
1713345926051,ANAR 135S,A00,494369,Braswell; Geoffrey E.,0,0,0,0
1713345927078,CAT 124RS,A01,519847,Geibel; William,17,0,20,3
1713345928104,CAT 125RS,A01,515971,Geibel; William,17,0,20,3
1713345929135,CLRE 250,A00,511389,Morris; Sheldon,9996,0,9999,3
1713345930169,CLRE 251,A00,507176,Mehta; Ravindra L.,9996,0,9999,3
1713345930169,CLRE 251,B00,511410,Mehta; Ravindra L.,9998,0,9999,1
1713345931194,CLRE 252,A00,507189,Cuomo; Raphael Eduardo,9998,0,9999,1
1713345932232,CLRE 253,A00,507199,Vaida; Florin,9997,0,9999,2
1713345932232,CLRE 253,B00,507202,Vaida; Florin,9999,0,9999,0
1713345933257,CLRE 259,A00,507211,Patel; Hemal,9996,0,9999,3
1713345934289,CLRE 260,A00,507221,Cuomo; Raphael Eduardo,9999,0,9999,0
1713345935317,CLRE 297,001,507242,Cuomo; Raphael Eduardo,9999,0,9999,0
1713345936341,CSE 191,A00,516875,Minnes Kemp; Mor Mia,9999,0,9999,0
1713345937366,CSS 201S,A01,494383,Staff,35,0,35,0
1713345938391,CSS 202S,A01,494387,Staff,35,0,35,0
1713345939414,EAP 100,A00,516065,Staff,9792,0,9999,207
1713345940447,ECE 45,A01,507414,Staff,51,0,60,9
1713345941477,ECE 100,A01,507416,Baghdadchi; Saharnaz,10,0,20,10
1713345941477,ECE 100,A02,507418,Baghdadchi; Saharnaz,20,0,20,0
1713345942556,ECE 111,A01,507420,Staff,38,0,50,12
1713345943583,ECE 197,001,548057,Sievenpiper; Daniel F.,9998,0,9999,1
1713345944615,EDS 115,A00,507243,Choi; Bailey Miyeon,28,0,28,0
1713345945644,EDS 117,A01,494379,Staff,23,0,25,2
1713345946675,EDS 125,A00,507246,Hopkins; Megan Beth,29,0,30,1
1713345947710,EDS 128A,A01,507264,Fargason; Sharon Gayle,26,0,26,0
1713345948736,EDS 128B,A01,507293,Pappas; Elizabeth,30,0,30,0
1713345949760,EDS 139,A00,507294,Fargason; Sharon Gayle,30,0,30,0
1713345949760,EDS 139,B00,507313,Pappas; Elizabeth,30,0,30,0
1713345950785,EDS 201,A00,507315,Staff,26,0,30,4
1713345951811,EDS 203,A01,507317,Halter; Christopher P.,26,0,30,4
1713345952842,EDS 204R,A01,507319,Halter; Christopher P.,3,0,30,27
1713345952842,EDS 204R,B01,507331,Heinzman; Erica M.,28,0,30,2
1713345953870,EDS 206R,A00,507332,Staff,4,0,30,26
1713345953870,EDS 206R,B00,507343,Staff,28,0,30,2
1713345954897,EDS 250,A00,507344,Hemans; Patricia Ann Benitez,36,0,40,4
1713345955922,EDS 281,A00,507345,Daly; Alan J.,18,0,18,0
1713345956951,EDS 284,A00,507350,Daly; Alan J.,16,0,16,0
1713345957977,EDS 286,A00,507359,Fine; Sarah,18,0,18,0
1713345959005,EDS 289C,A01,507361,Daly; Alan J.,18,0,18,0
1713345960033,EDS 290,A00,507366,Hofstetter; Carolyn,15,0,15,0
1713345961061,LIGM 5A,A00,507421,Fischer-Grunski; Eva K,20,0,20,0
1713345962085,LIGM 5B,A00,507423,Fischer-Grunski; Eva K,20,0,20,0
1713345963111,LIGM 5C,A00,507425,Fischer-Grunski; Eva K,20,0,20,0
1713345964136,LIIT 5AS,A00,507427,Carnelos; Chiara,20,0,20,0
1713345965163,LIIT 5BS,A00,507430,Carnelos; Chiara,20,0,20,0
1713345966187,LIIT 5CS,A00,507432,Carnelos; Chiara,20,0,20,0
1713345967215,LISP 5A,A00,507541,Munoz Sanchez; Alicia,17,0,20,3
1713345968240,LISP 5B,A00,507671,Munoz Sanchez; Alicia,15,0,20,5
1713345969271,LISP 5C,A00,507696,Munoz Sanchez; Alicia,15,0,20,5
1713345970297,MAE 197,001,528363,Boechler; Nicholas Sebastia,9998,0,9999,1
1713345971330,MATH 197,001,523477,Kedlaya; Kiran S.,9999,0,9999,0
1713345971330,MATH 197,002,563811,Zhang; Danna,9999,0,9999,0
1713345972357,MCWP 40R,A00,518780,Staff,20,0,20,0
1713345972357,MCWP 40R,B00,518781,Staff,19,0,20,1
1713345972357,MCWP 40R,C00,518783,Staff,19,0,20,1
1713345973383,MCWP 50R,A00,518791,Staff,20,0,20,0
1713345973383,MCWP 50R,B00,518792,Staff,17,0,20,3
1713345973383,MCWP 50R,C00,518793,Staff,19,0,20,1
1713345973383,MCWP 50R,D00,518794,Staff,16,0,20,4
1713345973383,MCWP 50R,E00,518795,Staff,16,0,20,4
1713345973383,MCWP 50R,F00,518796,Staff,19,0,20,1
1713345973383,MCWP 50R,G00,518797,Staff,19,0,20,1
1713345974414,MMW 12R,A01,514034,Herbst; Matthew,15,0,16,1
1713345974414,MMW 12R,A02,514035,Herbst; Matthew,16,0,16,0
1713345975442,MMW 13R,A01,514037,Staff,12,0,16,4
1713345975442,MMW 13R,A02,514039,Staff,16,0,16,0
1713345977497,SIO 295LS,A00,523233,Staff,18,0,30,12
1713345978525,SIO 295S,A00,523232,Staff,18,0,30,12
1713345979556,SOCI 117,A01,494376,Staff,1,0,5,4
1713345980582,WES 237B,A00,494380,Staff,19,0,20,1
1713345982660,AESE 279B,A00,494370,Wade; Jon P,33,0,33,0
1713345983690,ANAR 135S,A00,494369,Braswell; Geoffrey E.,0,0,0,0
1713345984723,CAT 124RS,A01,519847,Geibel; William,17,0,20,3
1713345985749,CAT 125RS,A01,515971,Geibel; William,17,0,20,3
1713345986775,CLRE 250,A00,511389,Morris; Sheldon,9996,0,9999,3
1713345987807,CLRE 251,A00,507176,Mehta; Ravindra L.,9996,0,9999,3
1713345987807,CLRE 251,B00,511410,Mehta; Ravindra L.,9998,0,9999,1
1713345988833,CLRE 252,A00,507189,Cuomo; Raphael Eduardo,9998,0,9999,1
1713345989863,CLRE 253,A00,507199,Vaida; Florin,9997,0,9999,2
1713345989863,CLRE 253,B00,507202,Vaida; Florin,9999,0,9999,0
1713345990890,CLRE 259,A00,507211,Patel; Hemal,9996,0,9999,3
1713345991916,CLRE 260,A00,507221,Cuomo; Raphael Eduardo,9999,0,9999,0
1713345992945,CLRE 297,001,507242,Cuomo; Raphael Eduardo,9999,0,9999,0
1713345993971,CSE 191,A00,516875,Minnes Kemp; Mor Mia,9999,0,9999,0
1713345995001,CSS 201S,A01,494383,Staff,35,0,35,0
1713345996027,CSS 202S,A01,494387,Staff,35,0,35,0
1713345997052,EAP 100,A00,516065,Staff,9792,0,9999,207
1713345998082,ECE 45,A01,507414,Staff,51,0,60,9
1713345999108,ECE 100,A01,507416,Baghdadchi; Saharnaz,10,0,20,10
1713345999108,ECE 100,A02,507418,Baghdadchi; Saharnaz,20,0,20,0
1713346000138,ECE 111,A01,507420,Staff,38,0,50,12
1713346001164,ECE 197,001,548057,Sievenpiper; Daniel F.,9998,0,9999,1
1713346002191,EDS 115,A00,507243,Choi; Bailey Miyeon,28,0,28,0
1713346003218,EDS 117,A01,494379,Staff,23,0,25,2
1713346004250,EDS 125,A00,507246,Hopkins; Megan Beth,29,0,30,1
1713346005276,EDS 128A,A01,507264,Fargason; Sharon Gayle,26,0,26,0
1713346006306,EDS 128B,A01,507293,Pappas; Elizabeth,30,0,30,0
1713346007336,EDS 139,A00,507294,Fargason; Sharon Gayle,30,0,30,0
1713346007336,EDS 139,B00,507313,Pappas; Elizabeth,30,0,30,0
1713346008362,EDS 201,A00,507315,Staff,26,0,30,4
1713346009390,EDS 203,A01,507317,Halter; Christopher P.,26,0,30,4
1713346010422,EDS 204R,A01,507319,Halter; Christopher P.,3,0,30,27
1713346010422,EDS 204R,B01,507331,Heinzman; Erica M.,28,0,30,2
1713346011452,EDS 206R,A00,507332,Staff,4,0,30,26
1713346011452,EDS 206R,B00,507343,Staff,28,0,30,2
1713346012481,EDS 250,A00,507344,Hemans; Patricia Ann Benitez,36,0,40,4
1713346013507,EDS 281,A00,507345,Daly; Alan J.,18,0,18,0
1713346014530,EDS 284,A00,507350,Daly; Alan J.,16,0,16,0
1713346015556,EDS 286,A00,507359,Fine; Sarah,18,0,18,0
1713346016581,EDS 289C,A01,507361,Daly; Alan J.,18,0,18,0
1713346017608,EDS 290,A00,507366,Hofstetter; Carolyn,15,0,15,0
1713346018634,LIGM 5A,A00,507421,Fischer-Grunski; Eva K,20,0,20,0
1713346019662,LIGM 5B,A00,507423,Fischer-Grunski; Eva K,20,0,20,0
1713346020688,LIGM 5C,A00,507425,Fischer-Grunski; Eva K,20,0,20,0
1713346021715,LIIT 5AS,A00,507427,Carnelos; Chiara,20,0,20,0
1713346022745,LIIT 5BS,A00,507430,Carnelos; Chiara,20,0,20,0
1713346023770,LIIT 5CS,A00,507432,Carnelos; Chiara,20,0,20,0
1713346024804,LISP 5A,A00,507541,Munoz Sanchez; Alicia,17,0,20,3
1713346025833,LISP 5B,A00,507671,Munoz Sanchez; Alicia,15,0,20,5
1713346026859,LISP 5C,A00,507696,Munoz Sanchez; Alicia,15,0,20,5
1713346027892,MAE 197,001,528363,Boechler; Nicholas Sebastia,9998,0,9999,1
1713346028925,MATH 197,001,523477,Kedlaya; Kiran S.,9999,0,9999,0
1713346028925,MATH 197,002,563811,Zhang; Danna,9999,0,9999,0
1713346029957,MCWP 40R,A00,518780,Staff,20,0,20,0
1713346029957,MCWP 40R,B00,518781,Staff,19,0,20,1
1713346029957,MCWP 40R,C00,518783,Staff,19,0,20,1
1713346030982,MCWP 50R,A00,518791,Staff,20,0,20,0
1713346030982,MCWP 50R,B00,518792,Staff,17,0,20,3
1713346030982,MCWP 50R,C00,518793,Staff,19,0,20,1
1713346030982,MCWP 50R,D00,518794,Staff,16,0,20,4
1713346030982,MCWP 50R,E00,518795,Staff,16,0,20,4
1713346030982,MCWP 50R,F00,518796,Staff,19,0,20,1
1713346030982,MCWP 50R,G00,518797,Staff,19,0,20,1
1713346032008,MMW 12R,A01,514034,Herbst; Matthew,15,0,16,1
1713346032008,MMW 12R,A02,514035,Herbst; Matthew,16,0,16,0
1713346033038,MMW 13R,A01,514037,Staff,12,0,16,4
1713346033038,MMW 13R,A02,514039,Staff,16,0,16,0
1713346035089,SIO 295LS,A00,523233,Staff,18,0,30,12
1713346036117,SIO 295S,A00,523232,Staff,18,0,30,12
1713346037143,SOCI 117,A01,494376,Staff,1,0,5,4
1713346038171,WES 237B,A00,494380,Staff,19,0,20,1
1713346040244,AESE 279B,A00,494370,Wade; Jon P,33,0,33,0
1713346041273,ANAR 135S,A00,494369,Braswell; Geoffrey E.,0,0,0,0
1713346042299,CAT 124RS,A01,519847,Geibel; William,17,0,20,3
1713346043324,CAT 125RS,A01,515971,Geibel; William,17,0,20,3
1713346044351,CLRE 250,A00,511389,Morris; Sheldon,9996,0,9999,3
1713346045377,CLRE 251,A00,507176,Mehta; Ravindra L.,9996,0,9999,3
1713346045377,CLRE 251,B00,511410,Mehta; Ravindra L.,9998,0,9999,1
1713346046483,CLRE 252,A00,507189,Cuomo; Raphael Eduardo,9998,0,9999,1
1713346047509,CLRE 253,A00,507199,Vaida; Florin,9997,0,9999,2
1713346047509,CLRE 253,B00,507202,Vaida; Florin,9999,0,9999,0
1713346048538,CLRE 259,A00,507211,Patel; Hemal,9996,0,9999,3
1713346049564,CLRE 260,A00,507221,Cuomo; Raphael Eduardo,9999,0,9999,0
1713346050591,CLRE 297,001,507242,Cuomo; Raphael Eduardo,9999,0,9999,0
1713346051621,CSE 191,A00,516875,Minnes Kemp; Mor Mia,9999,0,9999,0
1713346052653,CSS 201S,A01,494383,Staff,35,0,35,0
1713346053684,CSS 202S,A01,494387,Staff,35,0,35,0
1713346054712,EAP 100,A00,516065,Staff,9792,0,9999,207
1713346055740,ECE 45,A01,507414,Staff,51,0,60,9
1713346056771,ECE 100,A01,507416,Baghdadchi; Saharnaz,10,0,20,10
1713346056771,ECE 100,A02,507418,Baghdadchi; Saharnaz,20,0,20,0
1713346057801,ECE 111,A01,507420,Staff,38,0,50,12
1713346058827,ECE 197,001,548057,Sievenpiper; Daniel F.,9998,0,9999,1
1713346059857,EDS 115,A00,507243,Choi; Bailey Miyeon,28,0,28,0
1713346060884,EDS 117,A01,494379,Staff,23,0,25,2
1713346061912,EDS 125,A00,507246,Hopkins; Megan Beth,29,0,30,1
1713346062937,EDS 128A,A01,507264,Fargason; Sharon Gayle,26,0,26,0
1713346063963,EDS 128B,A01,507293,Pappas; Elizabeth,30,0,30,0
1713346064989,EDS 139,A00,507294,Fargason; Sharon Gayle,30,0,30,0
1713346064989,EDS 139,B00,507313,Pappas; Elizabeth,30,0,30,0
1713346066014,EDS 201,A00,507315,Staff,26,0,30,4
1713346067041,EDS 203,A01,507317,Halter; Christopher P.,26,0,30,4
1713346068072,EDS 204R,A01,507319,Halter; Christopher P.,3,0,30,27
1713346068072,EDS 204R,B01,507331,Heinzman; Erica M.,28,0,30,2
1713346069101,EDS 206R,A00,507332,Staff,4,0,30,26
1713346069101,EDS 206R,B00,507343,Staff,28,0,30,2
1713346070127,EDS 250,A00,507344,Hemans; Patricia Ann Benitez,36,0,40,4
1713346071156,EDS 281,A00,507345,Daly; Alan J.,18,0,18,0
1713346072181,EDS 284,A00,507350,Daly; Alan J.,16,0,16,0
1713346073206,EDS 286,A00,507359,Fine; Sarah,18,0,18,0
1713346074234,EDS 289C,A01,507361,Daly; Alan J.,18,0,18,0
1713346075261,EDS 290,A00,507366,Hofstetter; Carolyn,15,0,15,0
1713346076288,LIGM 5A,A00,507421,Fischer-Grunski; Eva K,20,0,20,0
1713346077313,LIGM 5B,A00,507423,Fischer-Grunski; Eva K,20,0,20,0
1713346078345,LIGM 5C,A00,507425,Fischer-Grunski; Eva K,20,0,20,0
1713346079370,LIIT 5AS,A00,507427,Carnelos; Chiara,20,0,20,0
1713346080395,LIIT 5BS,A00,507430,Carnelos; Chiara,20,0,20,0
1713346081421,LIIT 5CS,A00,507432,Carnelos; Chiara,20,0,20,0
1713346082448,LISP 5A,A00,507541,Munoz Sanchez; Alicia,17,0,20,3
1713346083479,LISP 5B,A00,507671,Munoz Sanchez; Alicia,15,0,20,5
1713346084505,LISP 5C,A00,507696,Munoz Sanchez; Alicia,15,0,20,5
1713346085536,MAE 197,001,528363,Boechler; Nicholas Sebastia,9998,0,9999,1
1713346086569,MATH 197,001,523477,Kedlaya; Kiran S.,9999,0,9999,0
1713346086569,MATH 197,002,563811,Zhang; Danna,9999,0,9999,0
1713346087599,MCWP 40R,A00,518780,Staff,20,0,20,0
1713346087599,MCWP 40R,B00,518781,Staff,19,0,20,1
1713346087599,MCWP 40R,C00,518783,Staff,19,0,20,1
1713346088624,MCWP 50R,A00,518791,Staff,20,0,20,0
1713346088624,MCWP 50R,B00,518792,Staff,17,0,20,3
1713346088624,MCWP 50R,C00,518793,Staff,19,0,20,1
1713346088624,MCWP 50R,D00,518794,Staff,16,0,20,4
1713346088624,MCWP 50R,E00,518795,Staff,16,0,20,4
1713346088624,MCWP 50R,F00,518796,Staff,19,0,20,1
1713346088624,MCWP 50R,G00,518797,Staff,19,0,20,1
1713346089654,MMW 12R,A01,514034,Herbst; Matthew,15,0,16,1
1713346089654,MMW 12R,A02,514035,Herbst; Matthew,16,0,16,0
1713346090680,MMW 13R,A01,514037,Staff,12,0,16,4
1713346090680,MMW 13R,A02,514039,Staff,16,0,16,0
1713346092739,SIO 295LS,A00,523233,Staff,18,0,30,12
1713346093764,SIO 295S,A00,523232,Staff,18,0,30,12
1713346094792,SOCI 117,A01,494376,Staff,1,0,5,4
1713346095822,WES 237B,A00,494380,Staff,19,0,20,1
1713346097893,AESE 279B,A00,494370,Wade; Jon P,33,0,33,0
1713346098919,ANAR 135S,A00,494369,Braswell; Geoffrey E.,0,0,0,0
1713346099945,CAT 124RS,A01,519847,Geibel; William,17,0,20,3
1713346100969,CAT 125RS,A01,515971,Geibel; William,17,0,20,3
1713346101996,CLRE 250,A00,511389,Morris; Sheldon,9996,0,9999,3
1713346103029,CLRE 251,A00,507176,Mehta; Ravindra L.,9996,0,9999,3
1713346103029,CLRE 251,B00,511410,Mehta; Ravindra L.,9998,0,9999,1
1713346104055,CLRE 252,A00,507189,Cuomo; Raphael Eduardo,9998,0,9999,1
1713346105081,CLRE 253,A00,507199,Vaida; Florin,9997,0,9999,2
1713346105081,CLRE 253,B00,507202,Vaida; Florin,9999,0,9999,0
1713346106107,CLRE 259,A00,507211,Patel; Hemal,9996,0,9999,3
1713346107131,CLRE 260,A00,507221,Cuomo; Raphael Eduardo,9999,0,9999,0
1713346108157,CLRE 297,001,507242,Cuomo; Raphael Eduardo,9999,0,9999,0
1713346109184,CSE 191,A00,516875,Minnes Kemp; Mor Mia,9999,0,9999,0
1713346110211,CSS 201S,A01,494383,Staff,35,0,35,0
1713346111242,CSS 202S,A01,494387,Staff,35,0,35,0
1713346112272,EAP 100,A00,516065,Staff,9792,0,9999,207
1713346113304,ECE 45,A01,507414,Staff,51,0,60,9
1713346114334,ECE 100,A01,507416,Baghdadchi; Saharnaz,10,0,20,10
1713346114334,ECE 100,A02,507418,Baghdadchi; Saharnaz,20,0,20,0
1713346115360,ECE 111,A01,507420,Staff,38,0,50,12
1713346116388,ECE 197,001,548057,Sievenpiper; Daniel F.,9998,0,9999,1
1713346117415,EDS 115,A00,507243,Choi; Bailey Miyeon,28,0,28,0
1713346118442,EDS 117,A01,494379,Staff,23,0,25,2
1713346119467,EDS 125,A00,507246,Hopkins; Megan Beth,29,0,30,1
1713346120498,EDS 128A,A01,507264,Fargason; Sharon Gayle,26,0,26,0
1713346121524,EDS 128B,A01,507293,Pappas; Elizabeth,30,0,30,0
1713346122552,EDS 139,A00,507294,Fargason; Sharon Gayle,30,0,30,0
1713346122552,EDS 139,B00,507313,Pappas; Elizabeth,30,0,30,0
1713346123579,EDS 201,A00,507315,Staff,26,0,30,4
1713346124615,EDS 203,A01,507317,Halter; Christopher P.,26,0,30,4
1713346125644,EDS 204R,A01,507319,Halter; Christopher P.,3,0,30,27
1713346125644,EDS 204R,B01,507331,Heinzman; Erica M.,28,0,30,2
1713346126670,EDS 206R,A00,507332,Staff,4,0,30,26
1713346126670,EDS 206R,B00,507343,Staff,28,0,30,2
1713346127701,EDS 250,A00,507344,Hemans; Patricia Ann Benitez,36,0,40,4
1713346128731,EDS 281,A00,507345,Daly; Alan J.,18,0,18,0
1713346129760,EDS 284,A00,507350,Daly; Alan J.,16,0,16,0
1713346130789,EDS 286,A00,507359,Fine; Sarah,18,0,18,0
1713346131815,EDS 289C,A01,507361,Daly; Alan J.,18,0,18,0
1713346132841,EDS 290,A00,507366,Hofstetter; Carolyn,15,0,15,0
1713346133870,LIGM 5A,A00,507421,Fischer-Grunski; Eva K,20,0,20,0
1713346134897,LIGM 5B,A00,507423,Fischer-Grunski; Eva K,20,0,20,0
1713346135923,LIGM 5C,A00,507425,Fischer-Grunski; Eva K,20,0,20,0
1713346136955,LIIT 5AS,A00,507427,Carnelos; Chiara,20,0,20,0
1713346137985,LIIT 5BS,A00,507430,Carnelos; Chiara,20,0,20,0
1713346139011,LIIT 5CS,A00,507432,Carnelos; Chiara,20,0,20,0
1713346140038,LISP 5A,A00,507541,Munoz Sanchez; Alicia,17,0,20,3
1713346141064,LISP 5B,A00,507671,Munoz Sanchez; Alicia,15,0,20,5
1713346142090,LISP 5C,A00,507696,Munoz Sanchez; Alicia,15,0,20,5
1713346143119,MAE 197,001,528363,Boechler; Nicholas Sebastia,9998,0,9999,1
1713346144146,MATH 197,001,523477,Kedlaya; Kiran S.,9999,0,9999,0
1713346144146,MATH 197,002,563811,Zhang; Danna,9999,0,9999,0
1713346145179,MCWP 40R,A00,518780,Staff,20,0,20,0
1713346145179,MCWP 40R,B00,518781,Staff,19,0,20,1
1713346145179,MCWP 40R,C00,518783,Staff,19,0,20,1
1713346146209,MCWP 50R,A00,518791,Staff,20,0,20,0
1713346146209,MCWP 50R,B00,518792,Staff,17,0,20,3
1713346146209,MCWP 50R,C00,518793,Staff,19,0,20,1
1713346146209,MCWP 50R,D00,518794,Staff,16,0,20,4
1713346146209,MCWP 50R,E00,518795,Staff,16,0,20,4
1713346146209,MCWP 50R,F00,518796,Staff,19,0,20,1
1713346146209,MCWP 50R,G00,518797,Staff,19,0,20,1
1713346147235,MMW 12R,A01,514034,Herbst; Matthew,15,0,16,1
1713346147235,MMW 12R,A02,514035,Herbst; Matthew,16,0,16,0
1713346148268,MMW 13R,A01,514037,Staff,12,0,16,4
1713346148268,MMW 13R,A02,514039,Staff,16,0,16,0
1713346150374,SIO 295LS,A00,523233,Staff,18,0,30,12
1713346151404,SIO 295S,A00,523232,Staff,18,0,30,12
1713346152434,SOCI 117,A01,494376,Staff,1,0,5,4
1713346153464,WES 237B,A00,494380,Staff,19,0,20,1
1713346155530,AESE 279B,A00,494370,Wade; Jon P,33,0,33,0
1713346156556,ANAR 135S,A00,494369,Braswell; Geoffrey E.,0,0,0,0
1713346157584,CAT 124RS,A01,519847,Geibel; William,17,0,20,3
1713346158609,CAT 125RS,A01,515971,Geibel; William,17,0,20,3
1713346159638,CLRE 250,A00,511389,Morris; Sheldon,9996,0,9999,3
1713346160665,CLRE 251,A00,507176,Mehta; Ravindra L.,9996,0,9999,3
1713346160665,CLRE 251,B00,511410,Mehta; Ravindra L.,9998,0,9999,1
1713346161694,CLRE 252,A00,507189,Cuomo; Raphael Eduardo,9998,0,9999,1
1713346162720,CLRE 253,A00,507199,Vaida; Florin,9997,0,9999,2
1713346162720,CLRE 253,B00,507202,Vaida; Florin,9999,0,9999,0
1713346163746,CLRE 259,A00,507211,Patel; Hemal,9996,0,9999,3
1713346164772,CLRE 260,A00,507221,Cuomo; Raphael Eduardo,9999,0,9999,0
1713346165798,CLRE 297,001,507242,Cuomo; Raphael Eduardo,9999,0,9999,0
1713346166825,CSE 191,A00,516875,Minnes Kemp; Mor Mia,9999,0,9999,0
1713346167853,CSS 201S,A01,494383,Staff,35,0,35,0
1713346168883,CSS 202S,A01,494387,Staff,35,0,35,0
1713346169911,EAP 100,A00,516065,Staff,9792,0,9999,207
1713346170943,ECE 45,A01,507414,Staff,51,0,60,9
1713346171971,ECE 100,A01,507416,Baghdadchi; Saharnaz,10,0,20,10
1713346171971,ECE 100,A02,507418,Baghdadchi; Saharnaz,20,0,20,0
1713346172996,ECE 111,A01,507420,Staff,38,0,50,12
1713346174022,ECE 197,001,548057,Sievenpiper; Daniel F.,9998,0,9999,1
1713346175050,EDS 115,A00,507243,Choi; Bailey Miyeon,28,0,28,0
1713346176076,EDS 117,A01,494379,Staff,23,0,25,2
1713346177102,EDS 125,A00,507246,Hopkins; Megan Beth,29,0,30,1
1713346178128,EDS 128A,A01,507264,Fargason; Sharon Gayle,26,0,26,0
1713346179159,EDS 128B,A01,507293,Pappas; Elizabeth,30,0,30,0
1713346180188,EDS 139,A00,507294,Fargason; Sharon Gayle,30,0,30,0
1713346180188,EDS 139,B00,507313,Pappas; Elizabeth,30,0,30,0
1713346181214,EDS 201,A00,507315,Staff,26,0,30,4
1713346182246,EDS 203,A01,507317,Halter; Christopher P.,26,0,30,4
1713346183278,EDS 204R,A01,507319,Halter; Christopher P.,3,0,30,27
1713346183278,EDS 204R,B01,507331,Heinzman; Erica M.,28,0,30,2
1713346184305,EDS 206R,A00,507332,Staff,4,0,30,26
1713346184305,EDS 206R,B00,507343,Staff,28,0,30,2
1713346185330,EDS 250,A00,507344,Hemans; Patricia Ann Benitez,36,0,40,4
1713346186359,EDS 281,A00,507345,Daly; Alan J.,18,0,18,0
1713346187384,EDS 284,A00,507350,Daly; Alan J.,16,0,16,0
1713346188411,EDS 286,A00,507359,Fine; Sarah,18,0,18,0
1713346189441,EDS 289C,A01,507361,Daly; Alan J.,18,0,18,0
1713346190466,EDS 290,A00,507366,Hofstetter; Carolyn,15,0,15,0
1713346191500,LIGM 5A,A00,507421,Fischer-Grunski; Eva K,20,0,20,0
1713346192527,LIGM 5B,A00,507423,Fischer-Grunski; Eva K,20,0,20,0
1713346193557,LIGM 5C,A00,507425,Fischer-Grunski; Eva K,20,0,20,0
1713346194585,LIIT 5AS,A00,507427,Carnelos; Chiara,20,0,20,0
1713346195616,LIIT 5BS,A00,507430,Carnelos; Chiara,20,0,20,0
1713346196646,LIIT 5CS,A00,507432,Carnelos; Chiara,20,0,20,0
1713346197676,LISP 5A,A00,507541,Munoz Sanchez; Alicia,17,0,20,3
1713346198702,LISP 5B,A00,507671,Munoz Sanchez; Alicia,15,0,20,5
1713346199727,LISP 5C,A00,507696,Munoz Sanchez; Alicia,15,0,20,5
1713346200755,MAE 197,001,528363,Boechler; Nicholas Sebastia,9998,0,9999,1
1713346201782,MATH 197,001,523477,Kedlaya; Kiran S.,9999,0,9999,0
1713346201782,MATH 197,002,563811,Zhang; Danna,9999,0,9999,0
1713346202810,MCWP 40R,A00,518780,Staff,20,0,20,0
1713346202810,MCWP 40R,B00,518781,Staff,19,0,20,1
1713346202810,MCWP 40R,C00,518783,Staff,19,0,20,1
1713346203842,MCWP 50R,A00,518791,Staff,20,0,20,0
1713346203842,MCWP 50R,B00,518792,Staff,17,0,20,3
1713346203842,MCWP 50R,C00,518793,Staff,19,0,20,1
1713346203842,MCWP 50R,D00,518794,Staff,16,0,20,4
1713346203842,MCWP 50R,E00,518795,Staff,16,0,20,4
1713346203842,MCWP 50R,F00,518796,Staff,19,0,20,1
1713346203842,MCWP 50R,G00,518797,Staff,19,0,20,1
1713346204873,MMW 12R,A01,514034,Herbst; Matthew,15,0,16,1
1713346204873,MMW 12R,A02,514035,Herbst; Matthew,16,0,16,0
1713346205901,MMW 13R,A01,514037,Staff,12,0,16,4
1713346205901,MMW 13R,A02,514039,Staff,16,0,16,0
1713346207956,SIO 295LS,A00,523233,Staff,18,0,30,12
1713346208982,SIO 295S,A00,523232,Staff,18,0,30,12
1713346210008,SOCI 117,A01,494376,Staff,1,0,5,4
1713346211036,WES 237B,A00,494380,Staff,19,0,20,1
1713346213103,AESE 279B,A00,494370,Wade; Jon P,33,0,33,0
1713346214130,ANAR 135S,A00,494369,Braswell; Geoffrey E.,0,0,0,0
1713346215157,CAT 124RS,A01,519847,Geibel; William,17,0,20,3
1713346216185,CAT 125RS,A01,515971,Geibel; William,17,0,20,3
1713346217217,CLRE 250,A00,511389,Morris; Sheldon,9996,0,9999,3
1713346218249,CLRE 251,A00,507176,Mehta; Ravindra L.,9996,0,9999,3
1713346218249,CLRE 251,B00,511410,Mehta; Ravindra L.,9998,0,9999,1
1713346219275,CLRE 252,A00,507189,Cuomo; Raphael Eduardo,9998,0,9999,1
1713346220301,CLRE 253,A00,507199,Vaida; Florin,9997,0,9999,2
1713346220301,CLRE 253,B00,507202,Vaida; Florin,9999,0,9999,0
1713346221326,CLRE 259,A00,507211,Patel; Hemal,9996,0,9999,3
1713346222352,CLRE 260,A00,507221,Cuomo; Raphael Eduardo,9999,0,9999,0
1713346223380,CLRE 297,001,507242,Cuomo; Raphael Eduardo,9999,0,9999,0
1713346224408,CSE 191,A00,516875,Minnes Kemp; Mor Mia,9999,0,9999,0
1713346225436,CSS 201S,A01,494383,Staff,35,0,35,0
1713346226463,CSS 202S,A01,494387,Staff,35,0,35,0
1713346227491,EAP 100,A00,516065,Staff,9792,0,9999,207
1713346228525,ECE 45,A01,507414,Staff,51,0,60,9
1713346229557,ECE 100,A01,507416,Baghdadchi; Saharnaz,10,0,20,10
1713346229557,ECE 100,A02,507418,Baghdadchi; Saharnaz,20,0,20,0
1713346230585,ECE 111,A01,507420,Staff,38,0,50,12
1713346231612,ECE 197,001,548057,Sievenpiper; Daniel F.,9998,0,9999,1
1713346232638,EDS 115,A00,507243,Choi; Bailey Miyeon,28,0,28,0
1713346233663,EDS 117,A01,494379,Staff,23,0,25,2
1713346234689,EDS 125,A00,507246,Hopkins; Megan Beth,29,0,30,1
1713346235716,EDS 128A,A01,507264,Fargason; Sharon Gayle,26,0,26,0
1713346236745,EDS 128B,A01,507293,Pappas; Elizabeth,30,0,30,0
1713346237774,EDS 139,A00,507294,Fargason; Sharon Gayle,30,0,30,0
1713346237774,EDS 139,B00,507313,Pappas; Elizabeth,30,0,30,0
1713346238800,EDS 201,A00,507315,Staff,26,0,30,4
1713346239826,EDS 203,A01,507317,Halter; Christopher P.,26,0,30,4
1713346240856,EDS 204R,A01,507319,Halter; Christopher P.,3,0,30,27
1713346240856,EDS 204R,B01,507331,Heinzman; Erica M.,28,0,30,2
1713346241884,EDS 206R,A00,507332,Staff,4,0,30,26
1713346241884,EDS 206R,B00,507343,Staff,28,0,30,2
1713346242910,EDS 250,A00,507344,Hemans; Patricia Ann Benitez,36,0,40,4
1713346243936,EDS 281,A00,507345,Daly; Alan J.,18,0,18,0
1713346244965,EDS 284,A00,507350,Daly; Alan J.,16,0,16,0
1713346245992,EDS 286,A00,507359,Fine; Sarah,18,0,18,0
1713346247017,EDS 289C,A01,507361,Daly; Alan J.,18,0,18,0
1713346248047,EDS 290,A00,507366,Hofstetter; Carolyn,15,0,15,0
1713346249077,LIGM 5A,A00,507421,Fischer-Grunski; Eva K,20,0,20,0
1713346250106,LIGM 5B,A00,507423,Fischer-Grunski; Eva K,20,0,20,0
1713346251136,LIGM 5C,A00,507425,Fischer-Grunski; Eva K,20,0,20,0
1713346252162,LIIT 5AS,A00,507427,Carnelos; Chiara,20,0,20,0
1713346253187,LIIT 5BS,A00,507430,Carnelos; Chiara,20,0,20,0
1713346254269,LIIT 5CS,A00,507432,Carnelos; Chiara,20,0,20,0
1713346255302,LISP 5A,A00,507541,Munoz Sanchez; Alicia,17,0,20,3
1713346256328,LISP 5B,A00,507671,Munoz Sanchez; Alicia,15,0,20,5
1713346257357,LISP 5C,A00,507696,Munoz Sanchez; Alicia,15,0,20,5
1713346258384,MAE 197,001,528363,Boechler; Nicholas Sebastia,9998,0,9999,1
1713346259418,MATH 197,001,523477,Kedlaya; Kiran S.,9999,0,9999,0
1713346259418,MATH 197,002,563811,Zhang; Danna,9999,0,9999,0
1713346260448,MCWP 40R,A00,518780,Staff,20,0,20,0
1713346260448,MCWP 40R,B00,518781,Staff,19,0,20,1
1713346260448,MCWP 40R,C00,518783,Staff,19,0,20,1
1713346261473,MCWP 50R,A00,518791,Staff,20,0,20,0
1713346261473,MCWP 50R,B00,518792,Staff,17,0,20,3
1713346261473,MCWP 50R,C00,518793,Staff,19,0,20,1
1713346261473,MCWP 50R,D00,518794,Staff,16,0,20,4
1713346261473,MCWP 50R,E00,518795,Staff,16,0,20,4
1713346261473,MCWP 50R,F00,518796,Staff,19,0,20,1
1713346261473,MCWP 50R,G00,518797,Staff,19,0,20,1
1713346262500,MMW 12R,A01,514034,Herbst; Matthew,15,0,16,1
1713346262500,MMW 12R,A02,514035,Herbst; Matthew,16,0,16,0
1713346263524,MMW 13R,A01,514037,Staff,12,0,16,4
1713346263524,MMW 13R,A02,514039,Staff,16,0,16,0
1713346265580,SIO 295LS,A00,523233,Staff,18,0,30,12
1713346266609,SIO 295S,A00,523232,Staff,18,0,30,12
1713346267636,SOCI 117,A01,494376,Staff,1,0,5,4
1713346268662,WES 237B,A00,494380,Staff,19,0,20,1
1713346270730,AESE 279B,A00,494370,Wade; Jon P,33,0,33,0
1713346271760,ANAR 135S,A00,494369,Braswell; Geoffrey E.,0,0,0,0
1713346272785,CAT 124RS,A01,519847,Geibel; William,17,0,20,3
1713346273811,CAT 125RS,A01,515971,Geibel; William,17,0,20,3
1713346274843,CLRE 250,A00,511389,Morris; Sheldon,9996,0,9999,3
1713346275870,CLRE 251,A00,507176,Mehta; Ravindra L.,9996,0,9999,3
1713346275870,CLRE 251,B00,511410,Mehta; Ravindra L.,9998,0,9999,1
1713346276900,CLRE 252,A00,507189,Cuomo; Raphael Eduardo,9998,0,9999,1
1713346277931,CLRE 253,A00,507199,Vaida; Florin,9997,0,9999,2
1713346277931,CLRE 253,B00,507202,Vaida; Florin,9999,0,9999,0
1713346278957,CLRE 259,A00,507211,Patel; Hemal,9996,0,9999,3
1713346279982,CLRE 260,A00,507221,Cuomo; Raphael Eduardo,9999,0,9999,0
1713346281011,CLRE 297,001,507242,Cuomo; Raphael Eduardo,9999,0,9999,0
1713346282039,CSE 191,A00,516875,Minnes Kemp; Mor Mia,9999,0,9999,0
1713346283070,CSS 201S,A01,494383,Staff,35,0,35,0
1713346284096,CSS 202S,A01,494387,Staff,35,0,35,0
1713346285124,EAP 100,A00,516065,Staff,9792,0,9999,207
1713346286157,ECE 45,A01,507414,Staff,51,0,60,9
1713346287183,ECE 100,A01,507416,Baghdadchi; Saharnaz,10,0,20,10
1713346287183,ECE 100,A02,507418,Baghdadchi; Saharnaz,20,0,20,0
1713346288208,ECE 111,A01,507420,Staff,38,0,50,12
1713346289239,ECE 197,001,548057,Sievenpiper; Daniel F.,9998,0,9999,1
1713346290270,EDS 115,A00,507243,Choi; Bailey Miyeon,28,0,28,0
1713346291297,EDS 117,A01,494379,Staff,23,0,25,2
1713346292324,EDS 125,A00,507246,Hopkins; Megan Beth,29,0,30,1
1713346293351,EDS 128A,A01,507264,Fargason; Sharon Gayle,26,0,26,0
1713346294380,EDS 128B,A01,507293,Pappas; Elizabeth,30,0,30,0
1713346295407,EDS 139,A00,507294,Fargason; Sharon Gayle,30,0,30,0
1713346295407,EDS 139,B00,507313,Pappas; Elizabeth,30,0,30,0
1713346296435,EDS 201,A00,507315,Staff,26,0,30,4
1713346297462,EDS 203,A01,507317,Halter; Christopher P.,26,0,30,4
1713346298487,EDS 204R,A01,507319,Halter; Christopher P.,3,0,30,27
1713346298487,EDS 204R,B01,507331,Heinzman; Erica M.,28,0,30,2
1713346299516,EDS 206R,A00,507332,Staff,4,0,30,26
1713346299516,EDS 206R,B00,507343,Staff,28,0,30,2
1713346300542,EDS 250,A00,507344,Hemans; Patricia Ann Benitez,36,0,40,4
1713346301567,EDS 281,A00,507345,Daly; Alan J.,18,0,18,0
1713346302595,EDS 284,A00,507350,Daly; Alan J.,16,0,16,0
1713346303622,EDS 286,A00,507359,Fine; Sarah,18,0,18,0
1713346304653,EDS 289C,A01,507361,Daly; Alan J.,18,0,18,0
1713346305683,EDS 290,A00,507366,Hofstetter; Carolyn,15,0,15,0
1713346306718,LIGM 5A,A00,507421,Fischer-Grunski; Eva K,20,0,20,0
1713346307747,LIGM 5B,A00,507423,Fischer-Grunski; Eva K,20,0,20,0
1713346308774,LIGM 5C,A00,507425,Fischer-Grunski; Eva K,20,0,20,0
1713346309806,LIIT 5AS,A00,507427,Carnelos; Chiara,20,0,20,0
1713346310830,LIIT 5BS,A00,507430,Carnelos; Chiara,20,0,20,0
1713346311856,LIIT 5CS,A00,507432,Carnelos; Chiara,20,0,20,0
1713346312888,LISP 5A,A00,507541,Munoz Sanchez; Alicia,17,0,20,3
1713346313917,LISP 5B,A00,507671,Munoz Sanchez; Alicia,15,0,20,5
1713346314944,LISP 5C,A00,507696,Munoz Sanchez; Alicia,15,0,20,5
1713346315977,MAE 197,001,528363,Boechler; Nicholas Sebastia,9998,0,9999,1
1713346317009,MATH 197,001,523477,Kedlaya; Kiran S.,9999,0,9999,0
1713346317009,MATH 197,002,563811,Zhang; Danna,9999,0,9999,0
1713346318035,MCWP 40R,A00,518780,Staff,20,0,20,0
1713346318035,MCWP 40R,B00,518781,Staff,19,0,20,1
1713346318035,MCWP 40R,C00,518783,Staff,19,0,20,1
1713346319063,MCWP 50R,A00,518791,Staff,20,0,20,0
1713346319063,MCWP 50R,B00,518792,Staff,17,0,20,3
1713346319063,MCWP 50R,C00,518793,Staff,19,0,20,1
1713346319063,MCWP 50R,D00,518794,Staff,16,0,20,4
1713346319063,MCWP 50R,E00,518795,Staff,16,0,20,4
1713346319063,MCWP 50R,F00,518796,Staff,19,0,20,1
1713346319063,MCWP 50R,G00,518797,Staff,19,0,20,1
1713346320088,MMW 12R,A01,514034,Herbst; Matthew,15,0,16,1
1713346320088,MMW 12R,A02,514035,Herbst; Matthew,16,0,16,0
1713346321117,MMW 13R,A01,514037,Staff,12,0,16,4
1713346321117,MMW 13R,A02,514039,Staff,16,0,16,0
1713346323169,SIO 295LS,A00,523233,Staff,18,0,30,12
1713346324196,SIO 295S,A00,523232,Staff,18,0,30,12
1713346325222,SOCI 117,A01,494376,Staff,1,0,5,4
1713346326248,WES 237B,A00,494380,Staff,19,0,20,1
1713346328329,AESE 279B,A00,494370,Wade; Jon P,33,0,33,0
1713346329357,ANAR 135S,A00,494369,Braswell; Geoffrey E.,0,0,0,0
1713346330382,CAT 124RS,A01,519847,Geibel; William,17,0,20,3
1713346331405,CAT 125RS,A01,515971,Geibel; William,17,0,20,3
1713346332438,CLRE 250,A00,511389,Morris; Sheldon,9996,0,9999,3
1713346333471,CLRE 251,A00,507176,Mehta; Ravindra L.,9996,0,9999,3
1713346333471,CLRE 251,B00,511410,Mehta; Ravindra L.,9998,0,9999,1
1713346334498,CLRE 252,A00,507189,Cuomo; Raphael Eduardo,9998,0,9999,1
1713346335530,CLRE 253,A00,507199,Vaida; Florin,9997,0,9999,2
1713346335530,CLRE 253,B00,507202,Vaida; Florin,9999,0,9999,0
1713346336556,CLRE 259,A00,507211,Patel; Hemal,9996,0,9999,3
1713346337584,CLRE 260,A00,507221,Cuomo; Raphael Eduardo,9999,0,9999,0
1713346338616,CLRE 297,001,507242,Cuomo; Raphael Eduardo,9999,0,9999,0
1713346339641,CSE 191,A00,516875,Minnes Kemp; Mor Mia,9999,0,9999,0
1713346340674,CSS 201S,A01,494383,Staff,35,0,35,0
1713346341705,CSS 202S,A01,494387,Staff,35,0,35,0
1713346342733,EAP 100,A00,516065,Staff,9792,0,9999,207
1713346343760,ECE 45,A01,507414,Staff,51,0,60,9
1713346344786,ECE 100,A01,507416,Baghdadchi; Saharnaz,10,0,20,10
1713346344786,ECE 100,A02,507418,Baghdadchi; Saharnaz,20,0,20,0
1713346345816,ECE 111,A01,507420,Staff,38,0,50,12
1713346346842,ECE 197,001,548057,Sievenpiper; Daniel F.,9998,0,9999,1
1713346347873,EDS 115,A00,507243,Choi; Bailey Miyeon,28,0,28,0
1713346348900,EDS 117,A01,494379,Staff,23,0,25,2
1713346349931,EDS 125,A00,507246,Hopkins; Megan Beth,29,0,30,1
1713346350962,EDS 128A,A01,507264,Fargason; Sharon Gayle,26,0,26,0
1713346351987,EDS 128B,A01,507293,Pappas; Elizabeth,30,0,30,0
1713346353014,EDS 139,A00,507294,Fargason; Sharon Gayle,30,0,30,0
1713346353014,EDS 139,B00,507313,Pappas; Elizabeth,30,0,30,0
1713346354040,EDS 201,A00,507315,Staff,26,0,30,4
1713346355066,EDS 203,A01,507317,Halter; Christopher P.,26,0,30,4
1713346356091,EDS 204R,A01,507319,Halter; Christopher P.,3,0,30,27
1713346356091,EDS 204R,B01,507331,Heinzman; Erica M.,28,0,30,2
1713346357120,EDS 206R,A00,507332,Staff,4,0,30,26
1713346357120,EDS 206R,B00,507343,Staff,28,0,30,2
1713346358203,EDS 250,A00,507344,Hemans; Patricia Ann Benitez,36,0,40,4
1713346359231,EDS 281,A00,507345,Daly; Alan J.,18,0,18,0
1713346360261,EDS 284,A00,507350,Daly; Alan J.,16,0,16,0
1713346361291,EDS 286,A00,507359,Fine; Sarah,18,0,18,0
1713346362316,EDS 289C,A01,507361,Daly; Alan J.,18,0,18,0
1713346363342,EDS 290,A00,507366,Hofstetter; Carolyn,15,0,15,0
1713346364370,LIGM 5A,A00,507421,Fischer-Grunski; Eva K,20,0,20,0
1713346365399,LIGM 5B,A00,507423,Fischer-Grunski; Eva K,20,0,20,0
1713346366425,LIGM 5C,A00,507425,Fischer-Grunski; Eva K,20,0,20,0
1713346367452,LIIT 5AS,A00,507427,Carnelos; Chiara,20,0,20,0
1713346368477,LIIT 5BS,A00,507430,Carnelos; Chiara,20,0,20,0
1713346369504,LIIT 5CS,A00,507432,Carnelos; Chiara,20,0,20,0
1713346370529,LISP 5A,A00,507541,Munoz Sanchez; Alicia,17,0,20,3
1713346371559,LISP 5B,A00,507671,Munoz Sanchez; Alicia,15,0,20,5
1713346372585,LISP 5C,A00,507696,Munoz Sanchez; Alicia,15,0,20,5
1713346373609,MAE 197,001,528363,Boechler; Nicholas Sebastia,9998,0,9999,1
1713346374637,MATH 197,001,523477,Kedlaya; Kiran S.,9999,0,9999,0
1713346374637,MATH 197,002,563811,Zhang; Danna,9999,0,9999,0
1713346375667,MCWP 40R,A00,518780,Staff,20,0,20,0
1713346375667,MCWP 40R,B00,518781,Staff,19,0,20,1
1713346375667,MCWP 40R,C00,518783,Staff,19,0,20,1
1713346376696,MCWP 50R,A00,518791,Staff,20,0,20,0
1713346376696,MCWP 50R,B00,518792,Staff,17,0,20,3
1713346376696,MCWP 50R,C00,518793,Staff,19,0,20,1
1713346376696,MCWP 50R,D00,518794,Staff,16,0,20,4
1713346376696,MCWP 50R,E00,518795,Staff,16,0,20,4
1713346376696,MCWP 50R,F00,518796,Staff,19,0,20,1
1713346376696,MCWP 50R,G00,518797,Staff,19,0,20,1
1713346377729,MMW 12R,A01,514034,Herbst; Matthew,15,0,16,1
1713346377729,MMW 12R,A02,514035,Herbst; Matthew,16,0,16,0
1713346378758,MMW 13R,A01,514037,Staff,12,0,16,4
1713346378758,MMW 13R,A02,514039,Staff,16,0,16,0
1713346380809,SIO 295LS,A00,523233,Staff,18,0,30,12
1713346381835,SIO 295S,A00,523232,Staff,18,0,30,12
1713346382866,SOCI 117,A01,494376,Staff,1,0,5,4
1713346383892,WES 237B,A00,494380,Staff,19,0,20,1
1713346385960,AESE 279B,A00,494370,Wade; Jon P,33,0,33,0
1713346386986,ANAR 135S,A00,494369,Braswell; Geoffrey E.,0,0,0,0
1713346388012,CAT 124RS,A01,519847,Geibel; William,17,0,20,3
1713346389036,CAT 125RS,A01,515971,Geibel; William,17,0,20,3
1713346390062,CLRE 250,A00,511389,Morris; Sheldon,9996,0,9999,3
1713346391090,CLRE 251,A00,507176,Mehta; Ravindra L.,9996,0,9999,3
1713346391090,CLRE 251,B00,511410,Mehta; Ravindra L.,9998,0,9999,1
1713346392115,CLRE 252,A00,507189,Cuomo; Raphael Eduardo,9998,0,9999,1
1713346393142,CLRE 253,A00,507199,Vaida; Florin,9997,0,9999,2
1713346393142,CLRE 253,B00,507202,Vaida; Florin,9999,0,9999,0
1713346394172,CLRE 259,A00,507211,Patel; Hemal,9996,0,9999,3
1713346395196,CLRE 260,A00,507221,Cuomo; Raphael Eduardo,9999,0,9999,0
1713346396222,CLRE 297,001,507242,Cuomo; Raphael Eduardo,9999,0,9999,0
1713346397248,CSE 191,A00,516875,Minnes Kemp; Mor Mia,9999,0,9999,0
1713346398274,CSS 201S,A01,494383,Staff,35,0,35,0
1713346399300,CSS 202S,A01,494387,Staff,35,0,35,0
1713346400326,EAP 100,A00,516065,Staff,9792,0,9999,207
1713346401351,ECE 45,A01,507414,Staff,51,0,60,9
1713346402377,ECE 100,A01,507416,Baghdadchi; Saharnaz,10,0,20,10
1713346402377,ECE 100,A02,507418,Baghdadchi; Saharnaz,20,0,20,0
1713346403406,ECE 111,A01,507420,Staff,38,0,50,12
1713346404432,ECE 197,001,548057,Sievenpiper; Daniel F.,9998,0,9999,1
1713346405463,EDS 115,A00,507243,Choi; Bailey Miyeon,28,0,28,0
1713346406486,EDS 117,A01,494379,Staff,23,0,25,2
1713346407511,EDS 125,A00,507246,Hopkins; Megan Beth,29,0,30,1
1713346408537,EDS 128A,A01,507264,Fargason; Sharon Gayle,26,0,26,0
1713346409567,EDS 128B,A01,507293,Pappas; Elizabeth,30,0,30,0
1713346410596,EDS 139,A00,507294,Fargason; Sharon Gayle,30,0,30,0
1713346410596,EDS 139,B00,507313,Pappas; Elizabeth,30,0,30,0
1713346411621,EDS 201,A00,507315,Staff,26,0,30,4
1713346412647,EDS 203,A01,507317,Halter; Christopher P.,26,0,30,4
1713346413673,EDS 204R,A01,507319,Halter; Christopher P.,3,0,30,27
1713346413673,EDS 204R,B01,507331,Heinzman; Erica M.,28,0,30,2
1713346414701,EDS 206R,A00,507332,Staff,4,0,30,26
1713346414701,EDS 206R,B00,507343,Staff,28,0,30,2
1713346415725,EDS 250,A00,507344,Hemans; Patricia Ann Benitez,36,0,40,4
1713346416752,EDS 281,A00,507345,Daly; Alan J.,18,0,18,0
1713346417782,EDS 284,A00,507350,Daly; Alan J.,16,0,16,0
1713346418821,EDS 286,A00,507359,Fine; Sarah,18,0,18,0
1713346419862,EDS 289C,A01,507361,Daly; Alan J.,18,0,18,0
1713346420889,EDS 290,A00,507366,Hofstetter; Carolyn,15,0,15,0
1713346421916,LIGM 5A,A00,507421,Fischer-Grunski; Eva K,20,0,20,0
1713346422943,LIGM 5B,A00,507423,Fischer-Grunski; Eva K,20,0,20,0
1713346423972,LIGM 5C,A00,507425,Fischer-Grunski; Eva K,20,0,20,0
1713346424999,LIIT 5AS,A00,507427,Carnelos; Chiara,20,0,20,0
1713346426026,LIIT 5BS,A00,507430,Carnelos; Chiara,20,0,20,0
1713346427052,LIIT 5CS,A00,507432,Carnelos; Chiara,20,0,20,0
1713346428081,LISP 5A,A00,507541,Munoz Sanchez; Alicia,17,0,20,3
1713346429108,LISP 5B,A00,507671,Munoz Sanchez; Alicia,15,0,20,5
1713346430135,LISP 5C,A00,507696,Munoz Sanchez; Alicia,15,0,20,5
1713346431162,MAE 197,001,528363,Boechler; Nicholas Sebastia,9998,0,9999,1
1713346432195,MATH 197,001,523477,Kedlaya; Kiran S.,9999,0,9999,0
1713346432195,MATH 197,002,563811,Zhang; Danna,9999,0,9999,0
1713346433222,MCWP 40R,A00,518780,Staff,20,0,20,0
1713346433222,MCWP 40R,B00,518781,Staff,19,0,20,1
1713346433222,MCWP 40R,C00,518783,Staff,19,0,20,1
1713346434248,MCWP 50R,A00,518791,Staff,20,0,20,0
1713346434248,MCWP 50R,B00,518792,Staff,17,0,20,3
1713346434248,MCWP 50R,C00,518793,Staff,19,0,20,1
1713346434248,MCWP 50R,D00,518794,Staff,16,0,20,4
1713346434248,MCWP 50R,E00,518795,Staff,16,0,20,4
1713346434248,MCWP 50R,F00,518796,Staff,19,0,20,1
1713346434248,MCWP 50R,G00,518797,Staff,19,0,20,1
1713346435275,MMW 12R,A01,514034,Herbst; Matthew,15,0,16,1
1713346435275,MMW 12R,A02,514035,Herbst; Matthew,16,0,16,0
1713346436301,MMW 13R,A01,514037,Staff,12,0,16,4
1713346436301,MMW 13R,A02,514039,Staff,16,0,16,0
1713346438361,SIO 295LS,A00,523233,Staff,18,0,30,12
1713346439387,SIO 295S,A00,523232,Staff,18,0,30,12
1713346440420,SOCI 117,A01,494376,Staff,1,0,5,4
1713346441447,WES 237B,A00,494380,Staff,19,0,20,1
1713346443518,AESE 279B,A00,494370,Wade; Jon P,33,0,33,0
1713346444545,ANAR 135S,A00,494369,Braswell; Geoffrey E.,0,0,0,0
1713346445570,CAT 124RS,A01,519847,Geibel; William,17,0,20,3
1713346446598,CAT 125RS,A01,515971,Geibel; William,17,0,20,3
1713346447625,CLRE 250,A00,511389,Morris; Sheldon,9996,0,9999,3
1713346448652,CLRE 251,A00,507176,Mehta; Ravindra L.,9996,0,9999,3
1713346448652,CLRE 251,B00,511410,Mehta; Ravindra L.,9998,0,9999,1
1713346449682,CLRE 252,A00,507189,Cuomo; Raphael Eduardo,9998,0,9999,1
1713346450709,CLRE 253,A00,507199,Vaida; Florin,9997,0,9999,2
1713346450709,CLRE 253,B00,507202,Vaida; Florin,9999,0,9999,0
1713346451735,CLRE 259,A00,507211,Patel; Hemal,9996,0,9999,3
1713346452761,CLRE 260,A00,507221,Cuomo; Raphael Eduardo,9999,0,9999,0
1713346453790,CLRE 297,001,507242,Cuomo; Raphael Eduardo,9999,0,9999,0
1713346454818,CSE 191,A00,516875,Minnes Kemp; Mor Mia,9999,0,9999,0
1713346455844,CSS 201S,A01,494383,Staff,35,0,35,0
1713346456874,CSS 202S,A01,494387,Staff,35,0,35,0
1713346457903,EAP 100,A00,516065,Staff,9792,0,9999,207
1713346458931,ECE 45,A01,507414,Staff,51,0,60,9
1713346459957,ECE 100,A01,507416,Baghdadchi; Saharnaz,10,0,20,10
1713346459957,ECE 100,A02,507418,Baghdadchi; Saharnaz,20,0,20,0
1713346460982,ECE 111,A01,507420,Staff,38,0,50,12
1713346462065,ECE 197,001,548057,Sievenpiper; Daniel F.,9998,0,9999,1
1713346463093,EDS 115,A00,507243,Choi; Bailey Miyeon,28,0,28,0
1713346464123,EDS 117,A01,494379,Staff,23,0,25,2
1713346465154,EDS 125,A00,507246,Hopkins; Megan Beth,29,0,30,1
1713346466181,EDS 128A,A01,507264,Fargason; Sharon Gayle,26,0,26,0
1713346467207,EDS 128B,A01,507293,Pappas; Elizabeth,30,0,30,0
1713346468269,EDS 139,A00,507294,Fargason; Sharon Gayle,30,0,30,0
1713346468269,EDS 139,B00,507313,Pappas; Elizabeth,30,0,30,0
1713346469300,EDS 201,A00,507315,Staff,26,0,30,4
1713346470329,EDS 203,A01,507317,Halter; Christopher P.,26,0,30,4
1713346471357,EDS 204R,A01,507319,Halter; Christopher P.,3,0,30,27
1713346471357,EDS 204R,B01,507331,Heinzman; Erica M.,28,0,30,2
1713346472380,EDS 206R,A00,507332,Staff,4,0,30,26
1713346472380,EDS 206R,B00,507343,Staff,28,0,30,2
1713346473409,EDS 250,A00,507344,Hemans; Patricia Ann Benitez,36,0,40,4
1713346474435,EDS 281,A00,507345,Daly; Alan J.,18,0,18,0
1713346475461,EDS 284,A00,507350,Daly; Alan J.,16,0,16,0
1713346476493,EDS 286,A00,507359,Fine; Sarah,18,0,18,0
1713346477520,EDS 289C,A01,507361,Daly; Alan J.,18,0,18,0
1713346478548,EDS 290,A00,507366,Hofstetter; Carolyn,15,0,15,0
1713346479574,LIGM 5A,A00,507421,Fischer-Grunski; Eva K,20,0,20,0
1713346480605,LIGM 5B,A00,507423,Fischer-Grunski; Eva K,20,0,20,0
1713346481637,LIGM 5C,A00,507425,Fischer-Grunski; Eva K,20,0,20,0
1713346482663,LIIT 5AS,A00,507427,Carnelos; Chiara,20,0,20,0
1713346483693,LIIT 5BS,A00,507430,Carnelos; Chiara,20,0,20,0
1713346484719,LIIT 5CS,A00,507432,Carnelos; Chiara,20,0,20,0
1713346485747,LISP 5A,A00,507541,Munoz Sanchez; Alicia,17,0,20,3
1713346486774,LISP 5B,A00,507671,Munoz Sanchez; Alicia,15,0,20,5
1713346487804,LISP 5C,A00,507696,Munoz Sanchez; Alicia,15,0,20,5
1713346488829,MAE 197,001,528363,Boechler; Nicholas Sebastia,9998,0,9999,1
1713346489855,MATH 197,001,523477,Kedlaya; Kiran S.,9999,0,9999,0
1713346489855,MATH 197,002,563811,Zhang; Danna,9999,0,9999,0
1713346490881,MCWP 40R,A00,518780,Staff,20,0,20,0
1713346490881,MCWP 40R,B00,518781,Staff,19,0,20,1
1713346490881,MCWP 40R,C00,518783,Staff,19,0,20,1
1713346491910,MCWP 50R,A00,518791,Staff,20,0,20,0
1713346491910,MCWP 50R,B00,518792,Staff,17,0,20,3
1713346491910,MCWP 50R,C00,518793,Staff,19,0,20,1
1713346491910,MCWP 50R,D00,518794,Staff,16,0,20,4
1713346491910,MCWP 50R,E00,518795,Staff,16,0,20,4
1713346491910,MCWP 50R,F00,518796,Staff,19,0,20,1
1713346491910,MCWP 50R,G00,518797,Staff,19,0,20,1
1713346492937,MMW 12R,A01,514034,Herbst; Matthew,15,0,16,1
1713346492937,MMW 12R,A02,514035,Herbst; Matthew,16,0,16,0
1713346493964,MMW 13R,A01,514037,Staff,12,0,16,4
1713346493964,MMW 13R,A02,514039,Staff,16,0,16,0
1713346496022,SIO 295LS,A00,523233,Staff,18,0,30,12
1713346497049,SIO 295S,A00,523232,Staff,18,0,30,12
1713346498073,SOCI 117,A01,494376,Staff,1,0,5,4
1713346499103,WES 237B,A00,494380,Staff,19,0,20,1
1713346501180,AESE 279B,A00,494370,Wade; Jon P,33,0,33,0
1713346502207,ANAR 135S,A00,494369,Braswell; Geoffrey E.,0,0,0,0
1713346503232,CAT 124RS,A01,519847,Geibel; William,17,0,20,3
1713346504258,CAT 125RS,A01,515971,Geibel; William,17,0,20,3
1713346505285,CLRE 250,A00,511389,Morris; Sheldon,9996,0,9999,3
1713346506321,CLRE 251,A00,507176,Mehta; Ravindra L.,9996,0,9999,3
1713346506321,CLRE 251,B00,511410,Mehta; Ravindra L.,9998,0,9999,1
1713346507346,CLRE 252,A00,507189,Cuomo; Raphael Eduardo,9998,0,9999,1
1713346508371,CLRE 253,A00,507199,Vaida; Florin,9997,0,9999,2
1713346508371,CLRE 253,B00,507202,Vaida; Florin,9999,0,9999,0
1713346509396,CLRE 259,A00,507211,Patel; Hemal,9996,0,9999,3
1713346510421,CLRE 260,A00,507221,Cuomo; Raphael Eduardo,9999,0,9999,0
1713346511447,CLRE 297,001,507242,Cuomo; Raphael Eduardo,9999,0,9999,0
1713346512474,CSE 191,A00,516875,Minnes Kemp; Mor Mia,9999,0,9999,0
1713346513501,CSS 201S,A01,494383,Staff,35,0,35,0
1713346514526,CSS 202S,A01,494387,Staff,35,0,35,0
1713346515556,EAP 100,A00,516065,Staff,9792,0,9999,207
1713346516581,ECE 45,A01,507414,Staff,51,0,60,9
1713346517613,ECE 100,A01,507416,Baghdadchi; Saharnaz,10,0,20,10
1713346517613,ECE 100,A02,507418,Baghdadchi; Saharnaz,20,0,20,0
1713346518639,ECE 111,A01,507420,Staff,38,0,50,12
1713346519664,ECE 197,001,548057,Sievenpiper; Daniel F.,9998,0,9999,1
1713346520691,EDS 115,A00,507243,Choi; Bailey Miyeon,28,0,28,0
1713346521719,EDS 117,A01,494379,Staff,23,0,25,2
1713346522745,EDS 125,A00,507246,Hopkins; Megan Beth,29,0,30,1
1713346523772,EDS 128A,A01,507264,Fargason; Sharon Gayle,26,0,26,0
1713346524798,EDS 128B,A01,507293,Pappas; Elizabeth,30,0,30,0
1713346525822,EDS 139,A00,507294,Fargason; Sharon Gayle,30,0,30,0
1713346525822,EDS 139,B00,507313,Pappas; Elizabeth,30,0,30,0
1713346526852,EDS 201,A00,507315,Staff,26,0,30,4
1713346527883,EDS 203,A01,507317,Halter; Christopher P.,26,0,30,4
1713346528909,EDS 204R,A01,507319,Halter; Christopher P.,3,0,30,27
1713346528909,EDS 204R,B01,507331,Heinzman; Erica M.,28,0,30,2
1713346529934,EDS 206R,A00,507332,Staff,4,0,30,26
1713346529934,EDS 206R,B00,507343,Staff,28,0,30,2
1713346530960,EDS 250,A00,507344,Hemans; Patricia Ann Benitez,36,0,40,4
1713346531992,EDS 281,A00,507345,Daly; Alan J.,18,0,18,0
1713346533018,EDS 284,A00,507350,Daly; Alan J.,16,0,16,0
1713346534043,EDS 286,A00,507359,Fine; Sarah,18,0,18,0
1713346535069,EDS 289C,A01,507361,Daly; Alan J.,18,0,18,0
1713346536118,EDS 290,A00,507366,Hofstetter; Carolyn,15,0,15,0
1713346537144,LIGM 5A,A00,507421,Fischer-Grunski; Eva K,20,0,20,0
1713346538169,LIGM 5B,A00,507423,Fischer-Grunski; Eva K,20,0,20,0
1713346539195,LIGM 5C,A00,507425,Fischer-Grunski; Eva K,20,0,20,0
1713346540222,LIIT 5AS,A00,507427,Carnelos; Chiara,20,0,20,0
1713346541252,LIIT 5BS,A00,507430,Carnelos; Chiara,20,0,20,0
1713346542281,LIIT 5CS,A00,507432,Carnelos; Chiara,20,0,20,0
1713346543313,LISP 5A,A00,507541,Munoz Sanchez; Alicia,17,0,20,3
1713346544343,LISP 5B,A00,507671,Munoz Sanchez; Alicia,15,0,20,5
1713346545374,LISP 5C,A00,507696,Munoz Sanchez; Alicia,15,0,20,5
1713346546400,MAE 197,001,528363,Boechler; Nicholas Sebastia,9998,0,9999,1
1713346547427,MATH 197,001,523477,Kedlaya; Kiran S.,9999,0,9999,0
1713346547427,MATH 197,002,563811,Zhang; Danna,9999,0,9999,0
1713346548453,MCWP 40R,A00,518780,Staff,20,0,20,0
1713346548453,MCWP 40R,B00,518781,Staff,19,0,20,1
1713346548453,MCWP 40R,C00,518783,Staff,19,0,20,1
1713346549487,MCWP 50R,A00,518791,Staff,20,0,20,0
1713346549487,MCWP 50R,B00,518792,Staff,17,0,20,3
1713346549487,MCWP 50R,C00,518793,Staff,19,0,20,1
1713346549487,MCWP 50R,D00,518794,Staff,16,0,20,4
1713346549487,MCWP 50R,E00,518795,Staff,16,0,20,4
1713346549487,MCWP 50R,F00,518796,Staff,19,0,20,1
1713346549487,MCWP 50R,G00,518797,Staff,19,0,20,1
1713346550513,MMW 12R,A01,514034,Herbst; Matthew,15,0,16,1
1713346550513,MMW 12R,A02,514035,Herbst; Matthew,16,0,16,0
1713346551538,MMW 13R,A01,514037,Staff,12,0,16,4
1713346551538,MMW 13R,A02,514039,Staff,16,0,16,0
1713346553596,SIO 295LS,A00,523233,Staff,18,0,30,12
1713346554627,SIO 295S,A00,523232,Staff,18,0,30,12
1713346555658,SOCI 117,A01,494376,Staff,1,0,5,4
1713346556689,WES 237B,A00,494380,Staff,19,0,20,1
1713346558756,AESE 279B,A00,494370,Wade; Jon P,33,0,33,0
1713346559782,ANAR 135S,A00,494369,Braswell; Geoffrey E.,0,0,0,0
1713346560812,CAT 124RS,A01,519847,Geibel; William,17,0,20,3
1713346561838,CAT 125RS,A01,515971,Geibel; William,17,0,20,3
1713346562869,CLRE 250,A00,511389,Morris; Sheldon,9996,0,9999,3
1713346563903,CLRE 251,A00,507176,Mehta; Ravindra L.,9996,0,9999,3
1713346563903,CLRE 251,B00,511410,Mehta; Ravindra L.,9998,0,9999,1
1713346564928,CLRE 252,A00,507189,Cuomo; Raphael Eduardo,9998,0,9999,1
1713346566014,CLRE 253,A00,507199,Vaida; Florin,9997,0,9999,2
1713346566014,CLRE 253,B00,507202,Vaida; Florin,9999,0,9999,0
1713346567043,CLRE 259,A00,507211,Patel; Hemal,9996,0,9999,3
1713346568068,CLRE 260,A00,507221,Cuomo; Raphael Eduardo,9999,0,9999,0
1713346569092,CLRE 297,001,507242,Cuomo; Raphael Eduardo,9999,0,9999,0
1713346570118,CSE 191,A00,516875,Minnes Kemp; Mor Mia,9999,0,9999,0
1713346571149,CSS 201S,A01,494383,Staff,35,0,35,0
1713346572173,CSS 202S,A01,494387,Staff,35,0,35,0
1713346573201,EAP 100,A00,516065,Staff,9792,0,9999,207
1713346574229,ECE 45,A01,507414,Staff,51,0,60,9
1713346575261,ECE 100,A01,507416,Baghdadchi; Saharnaz,10,0,20,10
1713346575261,ECE 100,A02,507418,Baghdadchi; Saharnaz,20,0,20,0
1713346576286,ECE 111,A01,507420,Staff,38,0,50,12
1713346577313,ECE 197,001,548057,Sievenpiper; Daniel F.,9998,0,9999,1
1713346578338,EDS 115,A00,507243,Choi; Bailey Miyeon,28,0,28,0
1713346579370,EDS 117,A01,494379,Staff,23,0,25,2
1713346580398,EDS 125,A00,507246,Hopkins; Megan Beth,29,0,30,1
1713346581424,EDS 128A,A01,507264,Fargason; Sharon Gayle,26,0,26,0
1713346582450,EDS 128B,A01,507293,Pappas; Elizabeth,30,0,30,0
1713346583480,EDS 139,A00,507294,Fargason; Sharon Gayle,30,0,30,0
1713346583480,EDS 139,B00,507313,Pappas; Elizabeth,30,0,30,0
1713346584504,EDS 201,A00,507315,Staff,26,0,30,4
1713346585530,EDS 203,A01,507317,Halter; Christopher P.,26,0,30,4
1713346586557,EDS 204R,A01,507319,Halter; Christopher P.,3,0,30,27
1713346586557,EDS 204R,B01,507331,Heinzman; Erica M.,28,0,30,2
1713346587582,EDS 206R,A00,507332,Staff,4,0,30,26
1713346587582,EDS 206R,B00,507343,Staff,28,0,30,2
1713346588608,EDS 250,A00,507344,Hemans; Patricia Ann Benitez,36,0,40,4
1713346589632,EDS 281,A00,507345,Daly; Alan J.,18,0,18,0
1713346590657,EDS 284,A00,507350,Daly; Alan J.,16,0,16,0
1713346591685,EDS 286,A00,507359,Fine; Sarah,18,0,18,0
1713346592713,EDS 289C,A01,507361,Daly; Alan J.,18,0,18,0
1713346593743,EDS 290,A00,507366,Hofstetter; Carolyn,15,0,15,0
1713346594776,LIGM 5A,A00,507421,Fischer-Grunski; Eva K,20,0,20,0
1713346595804,LIGM 5B,A00,507423,Fischer-Grunski; Eva K,20,0,20,0
1713346596831,LIGM 5C,A00,507425,Fischer-Grunski; Eva K,20,0,20,0
1713346597858,LIIT 5AS,A00,507427,Carnelos; Chiara,20,0,20,0
1713346598884,LIIT 5BS,A00,507430,Carnelos; Chiara,20,0,20,0
1713346599909,LIIT 5CS,A00,507432,Carnelos; Chiara,20,0,20,0
1713346600941,LISP 5A,A00,507541,Munoz Sanchez; Alicia,17,0,20,3
1713346601966,LISP 5B,A00,507671,Munoz Sanchez; Alicia,15,0,20,5
1713346602992,LISP 5C,A00,507696,Munoz Sanchez; Alicia,15,0,20,5
1713346604018,MAE 197,001,528363,Boechler; Nicholas Sebastia,9998,0,9999,1
1713346605047,MATH 197,001,523477,Kedlaya; Kiran S.,9999,0,9999,0
1713346605047,MATH 197,002,563811,Zhang; Danna,9999,0,9999,0
1713346606072,MCWP 40R,A00,518780,Staff,20,0,20,0
1713346606072,MCWP 40R,B00,518781,Staff,19,0,20,1
1713346606072,MCWP 40R,C00,518783,Staff,19,0,20,1
1713346607107,MCWP 50R,A00,518791,Staff,20,0,20,0
1713346607107,MCWP 50R,B00,518792,Staff,17,0,20,3
1713346607107,MCWP 50R,C00,518793,Staff,19,0,20,1
1713346607107,MCWP 50R,D00,518794,Staff,16,0,20,4
1713346607107,MCWP 50R,E00,518795,Staff,16,0,20,4
1713346607107,MCWP 50R,F00,518796,Staff,19,0,20,1
1713346607107,MCWP 50R,G00,518797,Staff,19,0,20,1
1713346608133,MMW 12R,A01,514034,Herbst; Matthew,15,0,16,1
1713346608133,MMW 12R,A02,514035,Herbst; Matthew,16,0,16,0
1713346609158,MMW 13R,A01,514037,Staff,12,0,16,4
1713346609158,MMW 13R,A02,514039,Staff,16,0,16,0
1713346611218,SIO 295LS,A00,523233,Staff,18,0,30,12
1713346612248,SIO 295S,A00,523232,Staff,18,0,30,12
1713346613280,SOCI 117,A01,494376,Staff,1,0,5,4
1713346614307,WES 237B,A00,494380,Staff,19,0,20,1
1713346616375,AESE 279B,A00,494370,Wade; Jon P,33,0,33,0
1713346617401,ANAR 135S,A00,494369,Braswell; Geoffrey E.,0,0,0,0
1713346618430,CAT 124RS,A01,519847,Geibel; William,17,0,20,3
1713346619462,CAT 125RS,A01,515971,Geibel; William,17,0,20,3
1713346620486,CLRE 250,A00,511389,Morris; Sheldon,9996,0,9999,3
1713346621520,CLRE 251,A00,507176,Mehta; Ravindra L.,9996,0,9999,3
1713346621520,CLRE 251,B00,511410,Mehta; Ravindra L.,9998,0,9999,1
1713346622550,CLRE 252,A00,507189,Cuomo; Raphael Eduardo,9998,0,9999,1
1713346623577,CLRE 253,A00,507199,Vaida; Florin,9997,0,9999,2
1713346623577,CLRE 253,B00,507202,Vaida; Florin,9999,0,9999,0
1713346624604,CLRE 259,A00,507211,Patel; Hemal,9996,0,9999,3
1713346625632,CLRE 260,A00,507221,Cuomo; Raphael Eduardo,9999,0,9999,0
1713346626656,CLRE 297,001,507242,Cuomo; Raphael Eduardo,9999,0,9999,0
1713346627683,CSE 191,A00,516875,Minnes Kemp; Mor Mia,9999,0,9999,0
1713346628713,CSS 201S,A01,494383,Staff,35,0,35,0
1713346629740,CSS 202S,A01,494387,Staff,35,0,35,0
1713346630769,EAP 100,A00,516065,Staff,9792,0,9999,207
1713346631797,ECE 45,A01,507414,Staff,51,0,60,9
1713346632824,ECE 100,A01,507416,Baghdadchi; Saharnaz,10,0,20,10
1713346632824,ECE 100,A02,507418,Baghdadchi; Saharnaz,20,0,20,0
1713346633852,ECE 111,A01,507420,Staff,38,0,50,12
1713346634877,ECE 197,001,548057,Sievenpiper; Daniel F.,9998,0,9999,1
1713346635903,EDS 115,A00,507243,Choi; Bailey Miyeon,28,0,28,0
1713346636929,EDS 117,A01,494379,Staff,23,0,25,2
1713346637956,EDS 125,A00,507246,Hopkins; Megan Beth,29,0,30,1
1713346638981,EDS 128A,A01,507264,Fargason; Sharon Gayle,26,0,26,0
1713346640010,EDS 128B,A01,507293,Pappas; Elizabeth,30,0,30,0
1713346641037,EDS 139,A00,507294,Fargason; Sharon Gayle,30,0,30,0
1713346641037,EDS 139,B00,507313,Pappas; Elizabeth,30,0,30,0
1713346642065,EDS 201,A00,507315,Staff,26,0,30,4
1713346643091,EDS 203,A01,507317,Halter; Christopher P.,26,0,30,4
1713346644121,EDS 204R,A01,507319,Halter; Christopher P.,3,0,30,27
1713346644121,EDS 204R,B01,507331,Heinzman; Erica M.,28,0,30,2
1713346645146,EDS 206R,A00,507332,Staff,4,0,30,26
1713346645146,EDS 206R,B00,507343,Staff,28,0,30,2
1713346646174,EDS 250,A00,507344,Hemans; Patricia Ann Benitez,36,0,40,4
1713346647200,EDS 281,A00,507345,Daly; Alan J.,18,0,18,0
1713346648225,EDS 284,A00,507350,Daly; Alan J.,16,0,16,0
1713346649256,EDS 286,A00,507359,Fine; Sarah,18,0,18,0
1713346650285,EDS 289C,A01,507361,Daly; Alan J.,18,0,18,0
1713346651311,EDS 290,A00,507366,Hofstetter; Carolyn,15,0,15,0
1713346652345,LIGM 5A,A00,507421,Fischer-Grunski; Eva K,20,0,20,0
1713346653375,LIGM 5B,A00,507423,Fischer-Grunski; Eva K,20,0,20,0
1713346654401,LIGM 5C,A00,507425,Fischer-Grunski; Eva K,20,0,20,0
1713346655427,LIIT 5AS,A00,507427,Carnelos; Chiara,20,0,20,0
1713346656456,LIIT 5BS,A00,507430,Carnelos; Chiara,20,0,20,0
1713346657487,LIIT 5CS,A00,507432,Carnelos; Chiara,20,0,20,0
1713346658517,LISP 5A,A00,507541,Munoz Sanchez; Alicia,17,0,20,3
1713346659543,LISP 5B,A00,507671,Munoz Sanchez; Alicia,15,0,20,5
1713346660572,LISP 5C,A00,507696,Munoz Sanchez; Alicia,15,0,20,5
1713346661599,MAE 197,001,528363,Boechler; Nicholas Sebastia,9998,0,9999,1
1713346662625,MATH 197,001,523477,Kedlaya; Kiran S.,9999,0,9999,0
1713346662625,MATH 197,002,563811,Zhang; Danna,9999,0,9999,0
1713346663653,MCWP 40R,A00,518780,Staff,20,0,20,0
1713346663653,MCWP 40R,B00,518781,Staff,19,0,20,1
1713346663653,MCWP 40R,C00,518783,Staff,19,0,20,1
1713346664681,MCWP 50R,A00,518791,Staff,20,0,20,0
1713346664681,MCWP 50R,B00,518792,Staff,17,0,20,3
1713346664681,MCWP 50R,C00,518793,Staff,19,0,20,1
1713346664681,MCWP 50R,D00,518794,Staff,16,0,20,4
1713346664681,MCWP 50R,E00,518795,Staff,16,0,20,4
1713346664681,MCWP 50R,F00,518796,Staff,19,0,20,1
1713346664681,MCWP 50R,G00,518797,Staff,19,0,20,1
1713346665706,MMW 12R,A01,514034,Herbst; Matthew,15,0,16,1
1713346665706,MMW 12R,A02,514035,Herbst; Matthew,16,0,16,0
1713346666735,MMW 13R,A01,514037,Staff,12,0,16,4
1713346666735,MMW 13R,A02,514039,Staff,16,0,16,0
1713346668793,SIO 295LS,A00,523233,Staff,18,0,30,12
1713346669874,SIO 295S,A00,523232,Staff,18,0,30,12
1713346670905,SOCI 117,A01,494376,Staff,1,0,5,4
1713346671931,WES 237B,A00,494380,Staff,19,0,20,1
1713346674013,AESE 279B,A00,494370,Wade; Jon P,33,0,33,0
1713346675042,ANAR 135S,A00,494369,Braswell; Geoffrey E.,0,0,0,0
1713346676068,CAT 124RS,A01,519847,Geibel; William,17,0,20,3
1713346677093,CAT 125RS,A01,515971,Geibel; William,17,0,20,3
1713346678119,CLRE 250,A00,511389,Morris; Sheldon,9996,0,9999,3
1713346679157,CLRE 251,A00,507176,Mehta; Ravindra L.,9996,0,9999,3
1713346679157,CLRE 251,B00,511410,Mehta; Ravindra L.,9998,0,9999,1
1713346680187,CLRE 252,A00,507189,Cuomo; Raphael Eduardo,9998,0,9999,1
1713346681218,CLRE 253,A00,507199,Vaida; Florin,9997,0,9999,2
1713346681218,CLRE 253,B00,507202,Vaida; Florin,9999,0,9999,0
1713346682244,CLRE 259,A00,507211,Patel; Hemal,9996,0,9999,3
1713346683269,CLRE 260,A00,507221,Cuomo; Raphael Eduardo,9999,0,9999,0
1713346684296,CLRE 297,001,507242,Cuomo; Raphael Eduardo,9999,0,9999,0
1713346685326,CSE 191,A00,516875,Minnes Kemp; Mor Mia,9999,0,9999,0
1713346686355,CSS 201S,A01,494383,Staff,35,0,35,0
1713346687384,CSS 202S,A01,494387,Staff,35,0,35,0
1713346688411,EAP 100,A00,516065,Staff,9792,0,9999,207
1713346689439,ECE 45,A01,507414,Staff,51,0,60,9
1713346690465,ECE 100,A01,507416,Baghdadchi; Saharnaz,10,0,20,10
1713346690465,ECE 100,A02,507418,Baghdadchi; Saharnaz,20,0,20,0
1713346691491,ECE 111,A01,507420,Staff,38,0,50,12
1713346692516,ECE 197,001,548057,Sievenpiper; Daniel F.,9998,0,9999,1
1713346693542,EDS 115,A00,507243,Choi; Bailey Miyeon,28,0,28,0
1713346694572,EDS 117,A01,494379,Staff,23,0,25,2
1713346695595,EDS 125,A00,507246,Hopkins; Megan Beth,29,0,30,1
1713346696620,EDS 128A,A01,507264,Fargason; Sharon Gayle,26,0,26,0
1713346697650,EDS 128B,A01,507293,Pappas; Elizabeth,30,0,30,0
1713346698677,EDS 139,A00,507294,Fargason; Sharon Gayle,30,0,30,0
1713346698677,EDS 139,B00,507313,Pappas; Elizabeth,30,0,30,0
1713346699706,EDS 201,A00,507315,Staff,26,0,30,4
1713346700732,EDS 203,A01,507317,Halter; Christopher P.,26,0,30,4
1713346701760,EDS 204R,A01,507319,Halter; Christopher P.,3,0,30,27
1713346701760,EDS 204R,B01,507331,Heinzman; Erica M.,28,0,30,2
1713346702784,EDS 206R,A00,507332,Staff,4,0,30,26
1713346702784,EDS 206R,B00,507343,Staff,28,0,30,2
1713346703810,EDS 250,A00,507344,Hemans; Patricia Ann Benitez,36,0,40,4
1713346704835,EDS 281,A00,507345,Daly; Alan J.,18,0,18,0
1713346705863,EDS 284,A00,507350,Daly; Alan J.,16,0,16,0
1713346706895,EDS 286,A00,507359,Fine; Sarah,18,0,18,0
1713346707922,EDS 289C,A01,507361,Daly; Alan J.,18,0,18,0
1713346708949,EDS 290,A00,507366,Hofstetter; Carolyn,15,0,15,0
1713346709980,LIGM 5A,A00,507421,Fischer-Grunski; Eva K,20,0,20,0
1713346711009,LIGM 5B,A00,507423,Fischer-Grunski; Eva K,20,0,20,0
1713346712036,LIGM 5C,A00,507425,Fischer-Grunski; Eva K,20,0,20,0
1713346713068,LIIT 5AS,A00,507427,Carnelos; Chiara,20,0,20,0
1713346714094,LIIT 5BS,A00,507430,Carnelos; Chiara,20,0,20,0
1713346715120,LIIT 5CS,A00,507432,Carnelos; Chiara,20,0,20,0
1713346716147,LISP 5A,A00,507541,Munoz Sanchez; Alicia,17,0,20,3
1713346717179,LISP 5B,A00,507671,Munoz Sanchez; Alicia,15,0,20,5
1713346718204,LISP 5C,A00,507696,Munoz Sanchez; Alicia,15,0,20,5
1713346719229,MAE 197,001,528363,Boechler; Nicholas Sebastia,9998,0,9999,1
1713346720256,MATH 197,001,523477,Kedlaya; Kiran S.,9999,0,9999,0
1713346720256,MATH 197,002,563811,Zhang; Danna,9999,0,9999,0
1713346721285,MCWP 40R,A00,518780,Staff,20,0,20,0
1713346721285,MCWP 40R,B00,518781,Staff,19,0,20,1
1713346721285,MCWP 40R,C00,518783,Staff,19,0,20,1
1713346722312,MCWP 50R,A00,518791,Staff,20,0,20,0
1713346722312,MCWP 50R,B00,518792,Staff,17,0,20,3
1713346722312,MCWP 50R,C00,518793,Staff,19,0,20,1
1713346722312,MCWP 50R,D00,518794,Staff,16,0,20,4
1713346722312,MCWP 50R,E00,518795,Staff,16,0,20,4
1713346722312,MCWP 50R,F00,518796,Staff,19,0,20,1
1713346722312,MCWP 50R,G00,518797,Staff,19,0,20,1
1713346723343,MMW 12R,A01,514034,Herbst; Matthew,15,0,16,1
1713346723343,MMW 12R,A02,514035,Herbst; Matthew,16,0,16,0
1713346724370,MMW 13R,A01,514037,Staff,12,0,16,4
1713346724370,MMW 13R,A02,514039,Staff,16,0,16,0
1713346726427,SIO 295LS,A00,523233,Staff,18,0,30,12
1713346727450,SIO 295S,A00,523232,Staff,18,0,30,12
1713346728481,SOCI 117,A01,494376,Staff,1,0,5,4
1713346729515,WES 237B,A00,494380,Staff,19,0,20,1
1713346731595,AESE 279B,A00,494370,Wade; Jon P,33,0,33,0
1713346732622,ANAR 135S,A00,494369,Braswell; Geoffrey E.,0,0,0,0
1713346733653,CAT 124RS,A01,519847,Geibel; William,17,0,20,3
1713346734678,CAT 125RS,A01,515971,Geibel; William,17,0,20,3
1713346735707,CLRE 250,A00,511389,Morris; Sheldon,9996,0,9999,3
1713346736734,CLRE 251,A00,507176,Mehta; Ravindra L.,9996,0,9999,3
1713346736734,CLRE 251,B00,511410,Mehta; Ravindra L.,9998,0,9999,1
1713346737758,CLRE 252,A00,507189,Cuomo; Raphael Eduardo,9998,0,9999,1
1713346738784,CLRE 253,A00,507199,Vaida; Florin,9997,0,9999,2
1713346738784,CLRE 253,B00,507202,Vaida; Florin,9999,0,9999,0
1713346739813,CLRE 259,A00,507211,Patel; Hemal,9996,0,9999,3
1713346740839,CLRE 260,A00,507221,Cuomo; Raphael Eduardo,9999,0,9999,0
1713346741867,CLRE 297,001,507242,Cuomo; Raphael Eduardo,9999,0,9999,0
1713346742895,CSE 191,A00,516875,Minnes Kemp; Mor Mia,9999,0,9999,0
1713346743921,CSS 201S,A01,494383,Staff,35,0,35,0
1713346744952,CSS 202S,A01,494387,Staff,35,0,35,0
1713346745978,EAP 100,A00,516065,Staff,9792,0,9999,207
1713346747015,ECE 45,A01,507414,Staff,51,0,60,9
1713346748043,ECE 100,A01,507416,Baghdadchi; Saharnaz,10,0,20,10
1713346748043,ECE 100,A02,507418,Baghdadchi; Saharnaz,20,0,20,0
1713346749072,ECE 111,A01,507420,Staff,38,0,50,12
1713346750098,ECE 197,001,548057,Sievenpiper; Daniel F.,9998,0,9999,1
1713346751126,EDS 115,A00,507243,Choi; Bailey Miyeon,28,0,28,0
1713346752157,EDS 117,A01,494379,Staff,23,0,25,2
1713346753184,EDS 125,A00,507246,Hopkins; Megan Beth,29,0,30,1
1713346754214,EDS 128A,A01,507264,Fargason; Sharon Gayle,26,0,26,0
1713346755240,EDS 128B,A01,507293,Pappas; Elizabeth,30,0,30,0
1713346756270,EDS 139,A00,507294,Fargason; Sharon Gayle,30,0,30,0
1713346756270,EDS 139,B00,507313,Pappas; Elizabeth,30,0,30,0
1713346757299,EDS 201,A00,507315,Staff,26,0,30,4
1713346758324,EDS 203,A01,507317,Halter; Christopher P.,26,0,30,4
1713346759350,EDS 204R,A01,507319,Halter; Christopher P.,3,0,30,27
1713346759350,EDS 204R,B01,507331,Heinzman; Erica M.,28,0,30,2
1713346760374,EDS 206R,A00,507332,Staff,4,0,30,26
1713346760374,EDS 206R,B00,507343,Staff,28,0,30,2
1713346761399,EDS 250,A00,507344,Hemans; Patricia Ann Benitez,36,0,40,4
1713346762423,EDS 281,A00,507345,Daly; Alan J.,18,0,18,0
1713346763448,EDS 284,A00,507350,Daly; Alan J.,16,0,16,0
1713346764476,EDS 286,A00,507359,Fine; Sarah,18,0,18,0
1713346765502,EDS 289C,A01,507361,Daly; Alan J.,18,0,18,0
1713346766533,EDS 290,A00,507366,Hofstetter; Carolyn,15,0,15,0
1713346767565,LIGM 5A,A00,507421,Fischer-Grunski; Eva K,20,0,20,0
1713346768588,LIGM 5B,A00,507423,Fischer-Grunski; Eva K,20,0,20,0
1713346769613,LIGM 5C,A00,507425,Fischer-Grunski; Eva K,20,0,20,0
1713346770642,LIIT 5AS,A00,507427,Carnelos; Chiara,20,0,20,0
1713346771671,LIIT 5BS,A00,507430,Carnelos; Chiara,20,0,20,0
1713346772699,LIIT 5CS,A00,507432,Carnelos; Chiara,20,0,20,0
1713346773785,LISP 5A,A00,507541,Munoz Sanchez; Alicia,17,0,20,3
1713346774813,LISP 5B,A00,507671,Munoz Sanchez; Alicia,15,0,20,5
1713346775842,LISP 5C,A00,507696,Munoz Sanchez; Alicia,15,0,20,5
1713346776872,MAE 197,001,528363,Boechler; Nicholas Sebastia,9998,0,9999,1
1713346777903,MATH 197,001,523477,Kedlaya; Kiran S.,9999,0,9999,0
1713346777903,MATH 197,002,563811,Zhang; Danna,9999,0,9999,0
1713346778930,MCWP 40R,A00,518780,Staff,20,0,20,0
1713346778930,MCWP 40R,B00,518781,Staff,19,0,20,1
1713346778930,MCWP 40R,C00,518783,Staff,19,0,20,1
1713346779955,MCWP 50R,A00,518791,Staff,20,0,20,0
1713346779955,MCWP 50R,B00,518792,Staff,17,0,20,3
1713346779955,MCWP 50R,C00,518793,Staff,19,0,20,1
1713346779955,MCWP 50R,D00,518794,Staff,16,0,20,4
1713346779955,MCWP 50R,E00,518795,Staff,16,0,20,4
1713346779955,MCWP 50R,F00,518796,Staff,19,0,20,1
1713346779955,MCWP 50R,G00,518797,Staff,19,0,20,1
1713346780984,MMW 12R,A01,514034,Herbst; Matthew,15,0,16,1
1713346780984,MMW 12R,A02,514035,Herbst; Matthew,16,0,16,0
1713346782011,MMW 13R,A01,514037,Staff,12,0,16,4
1713346782011,MMW 13R,A02,514039,Staff,16,0,16,0
1713346784062,SIO 295LS,A00,523233,Staff,18,0,30,12
1713346785088,SIO 295S,A00,523232,Staff,18,0,30,12
1713346786114,SOCI 117,A01,494376,Staff,1,0,5,4
1713346787140,WES 237B,A00,494380,Staff,19,0,20,1
1713346789215,AESE 279B,A00,494370,Wade; Jon P,33,0,33,0
1713346790241,ANAR 135S,A00,494369,Braswell; Geoffrey E.,0,0,0,0
1713346791270,CAT 124RS,A01,519847,Geibel; William,17,0,20,3
1713346792297,CAT 125RS,A01,515971,Geibel; William,17,0,20,3
1713346793323,CLRE 250,A00,511389,Morris; Sheldon,9996,0,9999,3
1713346794359,CLRE 251,A00,507176,Mehta; Ravindra L.,9996,0,9999,3
1713346794359,CLRE 251,B00,511410,Mehta; Ravindra L.,9998,0,9999,1
1713346795385,CLRE 252,A00,507189,Cuomo; Raphael Eduardo,9998,0,9999,1
1713346796415,CLRE 253,A00,507199,Vaida; Florin,9997,0,9999,2
1713346796415,CLRE 253,B00,507202,Vaida; Florin,9999,0,9999,0
1713346797444,CLRE 259,A00,507211,Patel; Hemal,9996,0,9999,3
1713346798470,CLRE 260,A00,507221,Cuomo; Raphael Eduardo,9999,0,9999,0
1713346799495,CLRE 297,001,507242,Cuomo; Raphael Eduardo,9999,0,9999,0
1713346800521,CSE 191,A00,516875,Minnes Kemp; Mor Mia,9999,0,9999,0
1713346801549,CSS 201S,A01,494383,Staff,35,0,35,0
1713346802578,CSS 202S,A01,494387,Staff,35,0,35,0
1713346803602,EAP 100,A00,516065,Staff,9792,0,9999,207
1713346804632,ECE 45,A01,507414,Staff,51,0,60,9
1713346805658,ECE 100,A01,507416,Baghdadchi; Saharnaz,10,0,20,10
1713346805658,ECE 100,A02,507418,Baghdadchi; Saharnaz,20,0,20,0
1713346806683,ECE 111,A01,507420,Staff,38,0,50,12
1713346807710,ECE 197,001,548057,Sievenpiper; Daniel F.,9998,0,9999,1
1713346808740,EDS 115,A00,507243,Choi; Bailey Miyeon,28,0,28,0
1713346809767,EDS 117,A01,494379,Staff,23,0,25,2
1713346810792,EDS 125,A00,507246,Hopkins; Megan Beth,29,0,30,1
1713346811820,EDS 128A,A01,507264,Fargason; Sharon Gayle,26,0,26,0
1713346812845,EDS 128B,A01,507293,Pappas; Elizabeth,30,0,30,0
1713346813872,EDS 139,A00,507294,Fargason; Sharon Gayle,30,0,30,0
1713346813872,EDS 139,B00,507313,Pappas; Elizabeth,30,0,30,0
1713346814900,EDS 201,A00,507315,Staff,26,0,30,4
1713346815927,EDS 203,A01,507317,Halter; Christopher P.,26,0,30,4
1713346816952,EDS 204R,A01,507319,Halter; Christopher P.,3,0,30,27
1713346816952,EDS 204R,B01,507331,Heinzman; Erica M.,28,0,30,2
1713346817977,EDS 206R,A00,507332,Staff,4,0,30,26
1713346817977,EDS 206R,B00,507343,Staff,28,0,30,2
1713346819004,EDS 250,A00,507344,Hemans; Patricia Ann Benitez,36,0,40,4
1713346820030,EDS 281,A00,507345,Daly; Alan J.,18,0,18,0
1713346821055,EDS 284,A00,507350,Daly; Alan J.,16,0,16,0
1713346822086,EDS 286,A00,507359,Fine; Sarah,18,0,18,0
1713346823115,EDS 289C,A01,507361,Daly; Alan J.,18,0,18,0
1713346824141,EDS 290,A00,507366,Hofstetter; Carolyn,15,0,15,0
1713346825174,LIGM 5A,A00,507421,Fischer-Grunski; Eva K,20,0,20,0
1713346826203,LIGM 5B,A00,507423,Fischer-Grunski; Eva K,20,0,20,0
1713346827231,LIGM 5C,A00,507425,Fischer-Grunski; Eva K,20,0,20,0
1713346828257,LIIT 5AS,A00,507427,Carnelos; Chiara,20,0,20,0
1713346829281,LIIT 5BS,A00,507430,Carnelos; Chiara,20,0,20,0
1713346830310,LIIT 5CS,A00,507432,Carnelos; Chiara,20,0,20,0
1713346831336,LISP 5A,A00,507541,Munoz Sanchez; Alicia,17,0,20,3
1713346832365,LISP 5B,A00,507671,Munoz Sanchez; Alicia,15,0,20,5
1713346833394,LISP 5C,A00,507696,Munoz Sanchez; Alicia,15,0,20,5
1713346834420,MAE 197,001,528363,Boechler; Nicholas Sebastia,9998,0,9999,1
1713346835451,MATH 197,001,523477,Kedlaya; Kiran S.,9999,0,9999,0
1713346835451,MATH 197,002,563811,Zhang; Danna,9999,0,9999,0
1713346836478,MCWP 40R,A00,518780,Staff,20,0,20,0
1713346836478,MCWP 40R,B00,518781,Staff,19,0,20,1
1713346836478,MCWP 40R,C00,518783,Staff,19,0,20,1
1713346837503,MCWP 50R,A00,518791,Staff,20,0,20,0
1713346837503,MCWP 50R,B00,518792,Staff,17,0,20,3
1713346837503,MCWP 50R,C00,518793,Staff,19,0,20,1
1713346837503,MCWP 50R,D00,518794,Staff,16,0,20,4
1713346837503,MCWP 50R,E00,518795,Staff,16,0,20,4
1713346837503,MCWP 50R,F00,518796,Staff,19,0,20,1
1713346837503,MCWP 50R,G00,518797,Staff,19,0,20,1
1713346838534,MMW 12R,A01,514034,Herbst; Matthew,15,0,16,1
1713346838534,MMW 12R,A02,514035,Herbst; Matthew,16,0,16,0
1713346839562,MMW 13R,A01,514037,Staff,12,0,16,4
1713346839562,MMW 13R,A02,514039,Staff,16,0,16,0
1713346841624,SIO 295LS,A00,523233,Staff,18,0,30,12
1713346842649,SIO 295S,A00,523232,Staff,18,0,30,12
1713346843676,SOCI 117,A01,494376,Staff,1,0,5,4
1713346844707,WES 237B,A00,494380,Staff,19,0,20,1
1713346846792,AESE 279B,A00,494370,Wade; Jon P,33,0,33,0
1713346847821,ANAR 135S,A00,494369,Braswell; Geoffrey E.,0,0,0,0
1713346848847,CAT 124RS,A01,519847,Geibel; William,17,0,20,3
1713346849872,CAT 125RS,A01,515971,Geibel; William,17,0,20,3
1713346850899,CLRE 250,A00,511389,Morris; Sheldon,9996,0,9999,3
1713346851927,CLRE 251,A00,507176,Mehta; Ravindra L.,9996,0,9999,3
1713346851927,CLRE 251,B00,511410,Mehta; Ravindra L.,9998,0,9999,1
1713346852952,CLRE 252,A00,507189,Cuomo; Raphael Eduardo,9998,0,9999,1
1713346853980,CLRE 253,A00,507199,Vaida; Florin,9997,0,9999,2
1713346853980,CLRE 253,B00,507202,Vaida; Florin,9999,0,9999,0
1713346855006,CLRE 259,A00,507211,Patel; Hemal,9996,0,9999,3
1713346856095,CLRE 260,A00,507221,Cuomo; Raphael Eduardo,9999,0,9999,0
1713346857123,CLRE 297,001,507242,Cuomo; Raphael Eduardo,9999,0,9999,0
1713346858153,CSE 191,A00,516875,Minnes Kemp; Mor Mia,9999,0,9999,0
1713346859179,CSS 201S,A01,494383,Staff,35,0,35,0
1713346860206,CSS 202S,A01,494387,Staff,35,0,35,0
1713346861231,EAP 100,A00,516065,Staff,9792,0,9999,207
1713346862265,ECE 45,A01,507414,Staff,51,0,60,9
1713346863291,ECE 100,A01,507416,Baghdadchi; Saharnaz,10,0,20,10
1713346863291,ECE 100,A02,507418,Baghdadchi; Saharnaz,20,0,20,0
1713346864325,ECE 111,A01,507420,Staff,38,0,50,12
1713346865352,ECE 197,001,548057,Sievenpiper; Daniel F.,9998,0,9999,1
1713346866376,EDS 115,A00,507243,Choi; Bailey Miyeon,28,0,28,0
1713346867408,EDS 117,A01,494379,Staff,23,0,25,2
1713346868436,EDS 125,A00,507246,Hopkins; Megan Beth,29,0,30,1
1713346869465,EDS 128A,A01,507264,Fargason; Sharon Gayle,26,0,26,0
1713346870495,EDS 128B,A01,507293,Pappas; Elizabeth,30,0,30,0
1713346871521,EDS 139,A00,507294,Fargason; Sharon Gayle,30,0,30,0
1713346871521,EDS 139,B00,507313,Pappas; Elizabeth,30,0,30,0
1713346872547,EDS 201,A00,507315,Staff,26,0,30,4
1713346873572,EDS 203,A01,507317,Halter; Christopher P.,26,0,30,4
1713346874598,EDS 204R,A01,507319,Halter; Christopher P.,3,0,30,27
1713346874598,EDS 204R,B01,507331,Heinzman; Erica M.,28,0,30,2
1713346875624,EDS 206R,A00,507332,Staff,4,0,30,26
1713346875624,EDS 206R,B00,507343,Staff,28,0,30,2
1713346876651,EDS 250,A00,507344,Hemans; Patricia Ann Benitez,36,0,40,4
1713346877732,EDS 281,A00,507345,Daly; Alan J.,18,0,18,0
1713346878757,EDS 284,A00,507350,Daly; Alan J.,16,0,16,0
1713346879782,EDS 286,A00,507359,Fine; Sarah,18,0,18,0
1713346880809,EDS 289C,A01,507361,Daly; Alan J.,18,0,18,0
1713346881834,EDS 290,A00,507366,Hofstetter; Carolyn,15,0,15,0
1713346882860,LIGM 5A,A00,507421,Fischer-Grunski; Eva K,20,0,20,0
1713346883885,LIGM 5B,A00,507423,Fischer-Grunski; Eva K,20,0,20,0
1713346884916,LIGM 5C,A00,507425,Fischer-Grunski; Eva K,20,0,20,0
1713346885942,LIIT 5AS,A00,507427,Carnelos; Chiara,20,0,20,0
1713346886972,LIIT 5BS,A00,507430,Carnelos; Chiara,20,0,20,0
1713346888004,LIIT 5CS,A00,507432,Carnelos; Chiara,20,0,20,0
1713346889035,LISP 5A,A00,507541,Munoz Sanchez; Alicia,17,0,20,3
1713346890065,LISP 5B,A00,507671,Munoz Sanchez; Alicia,15,0,20,5
1713346891091,LISP 5C,A00,507696,Munoz Sanchez; Alicia,15,0,20,5
1713346892117,MAE 197,001,528363,Boechler; Nicholas Sebastia,9998,0,9999,1
1713346893147,MATH 197,001,523477,Kedlaya; Kiran S.,9999,0,9999,0
1713346893147,MATH 197,002,563811,Zhang; Danna,9999,0,9999,0
1713346894175,MCWP 40R,A00,518780,Staff,20,0,20,0
1713346894175,MCWP 40R,B00,518781,Staff,19,0,20,1
1713346894175,MCWP 40R,C00,518783,Staff,19,0,20,1
1713346895203,MCWP 50R,A00,518791,Staff,20,0,20,0
1713346895203,MCWP 50R,B00,518792,Staff,17,0,20,3
1713346895203,MCWP 50R,C00,518793,Staff,19,0,20,1
1713346895203,MCWP 50R,D00,518794,Staff,16,0,20,4
1713346895203,MCWP 50R,E00,518795,Staff,16,0,20,4
1713346895203,MCWP 50R,F00,518796,Staff,19,0,20,1
1713346895203,MCWP 50R,G00,518797,Staff,19,0,20,1
1713346896231,MMW 12R,A01,514034,Herbst; Matthew,15,0,16,1
1713346896231,MMW 12R,A02,514035,Herbst; Matthew,16,0,16,0
1713346897260,MMW 13R,A01,514037,Staff,12,0,16,4
1713346897260,MMW 13R,A02,514039,Staff,16,0,16,0
1713346899318,SIO 295LS,A00,523233,Staff,18,0,30,12
1713346900343,SIO 295S,A00,523232,Staff,18,0,30,12
1713346901374,SOCI 117,A01,494376,Staff,1,0,5,4
1713346902401,WES 237B,A00,494380,Staff,19,0,20,1
1713346904476,AESE 279B,A00,494370,Wade; Jon P,33,0,33,0
1713346905500,ANAR 135S,A00,494369,Braswell; Geoffrey E.,0,0,0,0
1713346906527,CAT 124RS,A01,519847,Geibel; William,17,0,20,3
1713346907553,CAT 125RS,A01,515971,Geibel; William,17,0,20,3
1713346908578,CLRE 250,A00,511389,Morris; Sheldon,9996,0,9999,3
1713346909611,CLRE 251,A00,507176,Mehta; Ravindra L.,9996,0,9999,3
1713346909611,CLRE 251,B00,511410,Mehta; Ravindra L.,9998,0,9999,1
1713346910636,CLRE 252,A00,507189,Cuomo; Raphael Eduardo,9998,0,9999,1
1713346911667,CLRE 253,A00,507199,Vaida; Florin,9997,0,9999,2
1713346911667,CLRE 253,B00,507202,Vaida; Florin,9999,0,9999,0
1713346912694,CLRE 259,A00,507211,Patel; Hemal,9996,0,9999,3
1713346913723,CLRE 260,A00,507221,Cuomo; Raphael Eduardo,9999,0,9999,0
1713346914746,CLRE 297,001,507242,Cuomo; Raphael Eduardo,9999,0,9999,0
1713346915776,CSE 191,A00,516875,Minnes Kemp; Mor Mia,9999,0,9999,0
1713346916804,CSS 201S,A01,494383,Staff,35,0,35,0
1713346917831,CSS 202S,A01,494387,Staff,35,0,35,0
1713346918859,EAP 100,A00,516065,Staff,9792,0,9999,207
1713346919897,ECE 45,A01,507414,Staff,51,0,60,9
1713346920931,ECE 100,A01,507416,Baghdadchi; Saharnaz,10,0,20,10
1713346920931,ECE 100,A02,507418,Baghdadchi; Saharnaz,20,0,20,0
1713346921955,ECE 111,A01,507420,Staff,38,0,50,12
1713346922982,ECE 197,001,548057,Sievenpiper; Daniel F.,9998,0,9999,1
1713346924007,EDS 115,A00,507243,Choi; Bailey Miyeon,28,0,28,0
1713346925038,EDS 117,A01,494379,Staff,23,0,25,2
1713346926064,EDS 125,A00,507246,Hopkins; Megan Beth,29,0,30,1
1713346927095,EDS 128A,A01,507264,Fargason; Sharon Gayle,26,0,26,0
1713346928121,EDS 128B,A01,507293,Pappas; Elizabeth,30,0,30,0
1713346929150,EDS 139,A00,507294,Fargason; Sharon Gayle,30,0,30,0
1713346929150,EDS 139,B00,507313,Pappas; Elizabeth,30,0,30,0
1713346930175,EDS 201,A00,507315,Staff,26,0,30,4
1713346931200,EDS 203,A01,507317,Halter; Christopher P.,26,0,30,4
1713346932223,EDS 204R,A01,507319,Halter; Christopher P.,3,0,30,27
1713346932223,EDS 204R,B01,507331,Heinzman; Erica M.,28,0,30,2
1713346933249,EDS 206R,A00,507332,Staff,4,0,30,26
1713346933249,EDS 206R,B00,507343,Staff,28,0,30,2
1713346934279,EDS 250,A00,507344,Hemans; Patricia Ann Benitez,36,0,40,4
1713346935303,EDS 281,A00,507345,Daly; Alan J.,18,0,18,0
1713346936329,EDS 284,A00,507350,Daly; Alan J.,16,0,16,0
1713346937360,EDS 286,A00,507359,Fine; Sarah,18,0,18,0
1713346938388,EDS 289C,A01,507361,Daly; Alan J.,18,0,18,0
1713346939417,EDS 290,A00,507366,Hofstetter; Carolyn,15,0,15,0
1713346940447,LIGM 5A,A00,507421,Fischer-Grunski; Eva K,20,0,20,0
1713346941478,LIGM 5B,A00,507423,Fischer-Grunski; Eva K,20,0,20,0
1713346942505,LIGM 5C,A00,507425,Fischer-Grunski; Eva K,20,0,20,0
1713346943536,LIIT 5AS,A00,507427,Carnelos; Chiara,20,0,20,0
1713346944562,LIIT 5BS,A00,507430,Carnelos; Chiara,20,0,20,0
1713346945588,LIIT 5CS,A00,507432,Carnelos; Chiara,20,0,20,0
1713346946615,LISP 5A,A00,507541,Munoz Sanchez; Alicia,17,0,20,3
1713346947640,LISP 5B,A00,507671,Munoz Sanchez; Alicia,15,0,20,5
1713346948671,LISP 5C,A00,507696,Munoz Sanchez; Alicia,15,0,20,5
1713346949700,MAE 197,001,528363,Boechler; Nicholas Sebastia,9998,0,9999,1
1713346950728,MATH 197,001,523477,Kedlaya; Kiran S.,9999,0,9999,0
1713346950728,MATH 197,002,563811,Zhang; Danna,9999,0,9999,0
1713346951754,MCWP 40R,A00,518780,Staff,20,0,20,0
1713346951754,MCWP 40R,B00,518781,Staff,19,0,20,1
1713346951754,MCWP 40R,C00,518783,Staff,19,0,20,1
1713346952785,MCWP 50R,A00,518791,Staff,20,0,20,0
1713346952785,MCWP 50R,B00,518792,Staff,17,0,20,3
1713346952785,MCWP 50R,C00,518793,Staff,19,0,20,1
1713346952785,MCWP 50R,D00,518794,Staff,16,0,20,4
1713346952785,MCWP 50R,E00,518795,Staff,16,0,20,4
1713346952785,MCWP 50R,F00,518796,Staff,19,0,20,1
1713346952785,MCWP 50R,G00,518797,Staff,19,0,20,1
1713346953814,MMW 12R,A01,514034,Herbst; Matthew,15,0,16,1
1713346953814,MMW 12R,A02,514035,Herbst; Matthew,16,0,16,0
1713346954840,MMW 13R,A01,514037,Staff,12,0,16,4
1713346954840,MMW 13R,A02,514039,Staff,16,0,16,0
1713346956891,SIO 295LS,A00,523233,Staff,18,0,30,12
1713346957916,SIO 295S,A00,523232,Staff,18,0,30,12
1713346958943,SOCI 117,A01,494376,Staff,1,0,5,4
1713346959969,WES 237B,A00,494380,Staff,19,0,20,1
1713346962056,AESE 279B,A00,494370,Wade; Jon P,33,0,33,0
1713346963086,ANAR 135S,A00,494369,Braswell; Geoffrey E.,0,0,0,0
1713346964113,CAT 124RS,A01,519847,Geibel; William,17,0,20,3
1713346965139,CAT 125RS,A01,515971,Geibel; William,17,0,20,3
1713346966168,CLRE 250,A00,511389,Morris; Sheldon,9996,0,9999,3
1713346967201,CLRE 251,A00,507176,Mehta; Ravindra L.,9996,0,9999,3
1713346967201,CLRE 251,B00,511410,Mehta; Ravindra L.,9998,0,9999,1
1713346968230,CLRE 252,A00,507189,Cuomo; Raphael Eduardo,9998,0,9999,1
1713346969259,CLRE 253,A00,507199,Vaida; Florin,9997,0,9999,2
1713346969259,CLRE 253,B00,507202,Vaida; Florin,9999,0,9999,0
1713346970285,CLRE 259,A00,507211,Patel; Hemal,9996,0,9999,3
1713346971313,CLRE 260,A00,507221,Cuomo; Raphael Eduardo,9999,0,9999,0
1713346972341,CLRE 297,001,507242,Cuomo; Raphael Eduardo,9999,0,9999,0
1713346973371,CSE 191,A00,516875,Minnes Kemp; Mor Mia,9999,0,9999,0
1713346974401,CSS 201S,A01,494383,Staff,35,0,35,0
1713346975432,CSS 202S,A01,494387,Staff,35,0,35,0
1713346976456,EAP 100,A00,516065,Staff,9792,0,9999,207
1713346977485,ECE 45,A01,507414,Staff,51,0,60,9
1713346978533,ECE 100,A01,507416,Baghdadchi; Saharnaz,10,0,20,10
1713346978533,ECE 100,A02,507418,Baghdadchi; Saharnaz,20,0,20,0
1713346979563,ECE 111,A01,507420,Staff,38,0,50,12
1713346980589,ECE 197,001,548057,Sievenpiper; Daniel F.,9998,0,9999,1
1713346981673,EDS 115,A00,507243,Choi; Bailey Miyeon,28,0,28,0
1713346982700,EDS 117,A01,494379,Staff,23,0,25,2
1713346983731,EDS 125,A00,507246,Hopkins; Megan Beth,29,0,30,1
1713346984763,EDS 128A,A01,507264,Fargason; Sharon Gayle,26,0,26,0
1713346985790,EDS 128B,A01,507293,Pappas; Elizabeth,30,0,30,0
1713346986816,EDS 139,A00,507294,Fargason; Sharon Gayle,30,0,30,0
1713346986816,EDS 139,B00,507313,Pappas; Elizabeth,30,0,30,0
1713346987844,EDS 201,A00,507315,Staff,26,0,30,4
1713346988871,EDS 203,A01,507317,Halter; Christopher P.,26,0,30,4
1713346989900,EDS 204R,A01,507319,Halter; Christopher P.,3,0,30,27
1713346989900,EDS 204R,B01,507331,Heinzman; Erica M.,28,0,30,2
1713346990925,EDS 206R,A00,507332,Staff,4,0,30,26
1713346990925,EDS 206R,B00,507343,Staff,28,0,30,2
1713346991950,EDS 250,A00,507344,Hemans; Patricia Ann Benitez,36,0,40,4
1713346992976,EDS 281,A00,507345,Daly; Alan J.,18,0,18,0
1713346994000,EDS 284,A00,507350,Daly; Alan J.,16,0,16,0
1713346995029,EDS 286,A00,507359,Fine; Sarah,18,0,18,0
1713346996054,EDS 289C,A01,507361,Daly; Alan J.,18,0,18,0
1713346997080,EDS 290,A00,507366,Hofstetter; Carolyn,15,0,15,0
1713346998108,LIGM 5A,A00,507421,Fischer-Grunski; Eva K,20,0,20,0
1713346999137,LIGM 5B,A00,507423,Fischer-Grunski; Eva K,20,0,20,0
1713347000165,LIGM 5C,A00,507425,Fischer-Grunski; Eva K,20,0,20,0
1713347001198,LIIT 5AS,A00,507427,Carnelos; Chiara,20,0,20,0
1713347002222,LIIT 5BS,A00,507430,Carnelos; Chiara,20,0,20,0
1713347003248,LIIT 5CS,A00,507432,Carnelos; Chiara,20,0,20,0
1713347004279,LISP 5A,A00,507541,Munoz Sanchez; Alicia,17,0,20,3
1713347005304,LISP 5B,A00,507671,Munoz Sanchez; Alicia,15,0,20,5
1713347006329,LISP 5C,A00,507696,Munoz Sanchez; Alicia,15,0,20,5
1713347007358,MAE 197,001,528363,Boechler; Nicholas Sebastia,9998,0,9999,1
1713347008390,MATH 197,001,523477,Kedlaya; Kiran S.,9999,0,9999,0
1713347008390,MATH 197,002,563811,Zhang; Danna,9999,0,9999,0
1713347009416,MCWP 40R,A00,518780,Staff,20,0,20,0
1713347009416,MCWP 40R,B00,518781,Staff,19,0,20,1
1713347009416,MCWP 40R,C00,518783,Staff,19,0,20,1
1713347010443,MCWP 50R,A00,518791,Staff,20,0,20,0
1713347010443,MCWP 50R,B00,518792,Staff,17,0,20,3
1713347010443,MCWP 50R,C00,518793,Staff,19,0,20,1
1713347010443,MCWP 50R,D00,518794,Staff,16,0,20,4
1713347010443,MCWP 50R,E00,518795,Staff,16,0,20,4
1713347010443,MCWP 50R,F00,518796,Staff,19,0,20,1
1713347010443,MCWP 50R,G00,518797,Staff,19,0,20,1
1713347011470,MMW 12R,A01,514034,Herbst; Matthew,15,0,16,1
1713347011470,MMW 12R,A02,514035,Herbst; Matthew,16,0,16,0
1713347012499,MMW 13R,A01,514037,Staff,12,0,16,4
1713347012499,MMW 13R,A02,514039,Staff,16,0,16,0
1713347014550,SIO 295LS,A00,523233,Staff,18,0,30,12
1713347015576,SIO 295S,A00,523232,Staff,18,0,30,12
1713347016601,SOCI 117,A01,494376,Staff,1,0,5,4
1713347017639,WES 237B,A00,494380,Staff,19,0,20,1
1713347019722,AESE 279B,A00,494370,Wade; Jon P,33,0,33,0
1713347020748,ANAR 135S,A00,494369,Braswell; Geoffrey E.,0,0,0,0
1713347021778,CAT 124RS,A01,519847,Geibel; William,17,0,20,3
1713347022802,CAT 125RS,A01,515971,Geibel; William,17,0,20,3
1713347023829,CLRE 250,A00,511389,Morris; Sheldon,9996,0,9999,3
1713347024856,CLRE 251,A00,507176,Mehta; Ravindra L.,9996,0,9999,3
1713347024856,CLRE 251,B00,511410,Mehta; Ravindra L.,9998,0,9999,1
1713347025882,CLRE 252,A00,507189,Cuomo; Raphael Eduardo,9998,0,9999,1
1713347026908,CLRE 253,A00,507199,Vaida; Florin,9997,0,9999,2
1713347026908,CLRE 253,B00,507202,Vaida; Florin,9999,0,9999,0
1713347027938,CLRE 259,A00,507211,Patel; Hemal,9996,0,9999,3
1713347028967,CLRE 260,A00,507221,Cuomo; Raphael Eduardo,9999,0,9999,0
1713347029992,CLRE 297,001,507242,Cuomo; Raphael Eduardo,9999,0,9999,0
1713347031017,CSE 191,A00,516875,Minnes Kemp; Mor Mia,9999,0,9999,0
1713347032051,CSS 201S,A01,494383,Staff,35,0,35,0
1713347033076,CSS 202S,A01,494387,Staff,35,0,35,0
1713347034100,EAP 100,A00,516065,Staff,9792,0,9999,207
1713347035131,ECE 45,A01,507414,Staff,51,0,60,9
1713347036161,ECE 100,A01,507416,Baghdadchi; Saharnaz,10,0,20,10
1713347036161,ECE 100,A02,507418,Baghdadchi; Saharnaz,20,0,20,0
1713347037185,ECE 111,A01,507420,Staff,38,0,50,12
1713347038214,ECE 197,001,548057,Sievenpiper; Daniel F.,9998,0,9999,1
1713347039243,EDS 115,A00,507243,Choi; Bailey Miyeon,28,0,28,0
1713347040269,EDS 117,A01,494379,Staff,23,0,25,2
1713347041296,EDS 125,A00,507246,Hopkins; Megan Beth,29,0,30,1
1713347042325,EDS 128A,A01,507264,Fargason; Sharon Gayle,26,0,26,0
1713347043408,EDS 128B,A01,507293,Pappas; Elizabeth,30,0,30,0
1713347044436,EDS 139,A00,507294,Fargason; Sharon Gayle,30,0,30,0
1713347044436,EDS 139,B00,507313,Pappas; Elizabeth,30,0,30,0
1713347045461,EDS 201,A00,507315,Staff,26,0,30,4
1713347046486,EDS 203,A01,507317,Halter; Christopher P.,26,0,30,4
1713347047513,EDS 204R,A01,507319,Halter; Christopher P.,3,0,30,27
1713347047513,EDS 204R,B01,507331,Heinzman; Erica M.,28,0,30,2
1713347048551,EDS 206R,A00,507332,Staff,4,0,30,26
1713347048551,EDS 206R,B00,507343,Staff,28,0,30,2
1713347049578,EDS 250,A00,507344,Hemans; Patricia Ann Benitez,36,0,40,4
1713347050607,EDS 281,A00,507345,Daly; Alan J.,18,0,18,0
1713347051631,EDS 284,A00,507350,Daly; Alan J.,16,0,16,0
1713347052660,EDS 286,A00,507359,Fine; Sarah,18,0,18,0
1713347053687,EDS 289C,A01,507361,Daly; Alan J.,18,0,18,0
1713347054713,EDS 290,A00,507366,Hofstetter; Carolyn,15,0,15,0
1713347055745,LIGM 5A,A00,507421,Fischer-Grunski; Eva K,20,0,20,0
1713347056771,LIGM 5B,A00,507423,Fischer-Grunski; Eva K,20,0,20,0
1713347057796,LIGM 5C,A00,507425,Fischer-Grunski; Eva K,20,0,20,0
1713347058826,LIIT 5AS,A00,507427,Carnelos; Chiara,20,0,20,0
1713347059857,LIIT 5BS,A00,507430,Carnelos; Chiara,20,0,20,0
1713347060883,LIIT 5CS,A00,507432,Carnelos; Chiara,20,0,20,0
1713347061910,LISP 5A,A00,507541,Munoz Sanchez; Alicia,17,0,20,3
1713347062939,LISP 5B,A00,507671,Munoz Sanchez; Alicia,15,0,20,5
1713347063971,LISP 5C,A00,507696,Munoz Sanchez; Alicia,15,0,20,5
1713347064999,MAE 197,001,528363,Boechler; Nicholas Sebastia,9998,0,9999,1
1713347066034,MATH 197,001,523477,Kedlaya; Kiran S.,9999,0,9999,0
1713347066034,MATH 197,002,563811,Zhang; Danna,9999,0,9999,0
1713347067059,MCWP 40R,A00,518780,Staff,20,0,20,0
1713347067059,MCWP 40R,B00,518781,Staff,19,0,20,1
1713347067059,MCWP 40R,C00,518783,Staff,19,0,20,1
1713347068086,MCWP 50R,A00,518791,Staff,20,0,20,0
1713347068086,MCWP 50R,B00,518792,Staff,17,0,20,3
1713347068086,MCWP 50R,C00,518793,Staff,19,0,20,1
1713347068086,MCWP 50R,D00,518794,Staff,16,0,20,4
1713347068086,MCWP 50R,E00,518795,Staff,16,0,20,4
1713347068086,MCWP 50R,F00,518796,Staff,19,0,20,1
1713347068086,MCWP 50R,G00,518797,Staff,19,0,20,1
1713347069117,MMW 12R,A01,514034,Herbst; Matthew,15,0,16,1
1713347069117,MMW 12R,A02,514035,Herbst; Matthew,16,0,16,0
1713347070145,MMW 13R,A01,514037,Staff,12,0,16,4
1713347070145,MMW 13R,A02,514039,Staff,16,0,16,0
1713347072197,SIO 295LS,A00,523233,Staff,18,0,30,12
1713347073223,SIO 295S,A00,523232,Staff,18,0,30,12
1713347074252,SOCI 117,A01,494376,Staff,1,0,5,4
1713347075280,WES 237B,A00,494380,Staff,19,0,20,1
1713347077348,AESE 279B,A00,494370,Wade; Jon P,33,0,33,0
1713347078376,ANAR 135S,A00,494369,Braswell; Geoffrey E.,0,0,0,0
1713347079400,CAT 124RS,A01,519847,Geibel; William,17,0,20,3
1713347080427,CAT 125RS,A01,515971,Geibel; William,17,0,20,3
1713347081452,CLRE 250,A00,511389,Morris; Sheldon,9996,0,9999,3
1713347082480,CLRE 251,A00,507176,Mehta; Ravindra L.,9996,0,9999,3
1713347082480,CLRE 251,B00,511410,Mehta; Ravindra L.,9998,0,9999,1
1713347083507,CLRE 252,A00,507189,Cuomo; Raphael Eduardo,9998,0,9999,1
1713347084534,CLRE 253,A00,507199,Vaida; Florin,9997,0,9999,2
1713347084534,CLRE 253,B00,507202,Vaida; Florin,9999,0,9999,0
1713347085616,CLRE 259,A00,507211,Patel; Hemal,9996,0,9999,3
1713347086644,CLRE 260,A00,507221,Cuomo; Raphael Eduardo,9999,0,9999,0
1713347087672,CLRE 297,001,507242,Cuomo; Raphael Eduardo,9999,0,9999,0
1713347088700,CSE 191,A00,516875,Minnes Kemp; Mor Mia,9999,0,9999,0
1713347089731,CSS 201S,A01,494383,Staff,35,0,35,0
1713347090761,CSS 202S,A01,494387,Staff,35,0,35,0
1713347091787,EAP 100,A00,516065,Staff,9792,0,9999,207
1713347092815,ECE 45,A01,507414,Staff,51,0,60,9
1713347093844,ECE 100,A01,507416,Baghdadchi; Saharnaz,10,0,20,10
1713347093844,ECE 100,A02,507418,Baghdadchi; Saharnaz,20,0,20,0
1713347094871,ECE 111,A01,507420,Staff,38,0,50,12
1713347095897,ECE 197,001,548057,Sievenpiper; Daniel F.,9998,0,9999,1
1713347096924,EDS 115,A00,507243,Choi; Bailey Miyeon,28,0,28,0
1713347097955,EDS 117,A01,494379,Staff,23,0,25,2
1713347098984,EDS 125,A00,507246,Hopkins; Megan Beth,29,0,30,1
1713347100012,EDS 128A,A01,507264,Fargason; Sharon Gayle,26,0,26,0
1713347101043,EDS 128B,A01,507293,Pappas; Elizabeth,30,0,30,0
1713347102068,EDS 139,A00,507294,Fargason; Sharon Gayle,30,0,30,0
1713347102068,EDS 139,B00,507313,Pappas; Elizabeth,30,0,30,0
1713347103097,EDS 201,A00,507315,Staff,26,0,30,4
1713347104124,EDS 203,A01,507317,Halter; Christopher P.,26,0,30,4
1713347105149,EDS 204R,A01,507319,Halter; Christopher P.,3,0,30,27
1713347105149,EDS 204R,B01,507331,Heinzman; Erica M.,28,0,30,2
1713347106180,EDS 206R,A00,507332,Staff,4,0,30,26
1713347106180,EDS 206R,B00,507343,Staff,28,0,30,2
1713347107210,EDS 250,A00,507344,Hemans; Patricia Ann Benitez,36,0,40,4
1713347108236,EDS 281,A00,507345,Daly; Alan J.,18,0,18,0
1713347109263,EDS 284,A00,507350,Daly; Alan J.,16,0,16,0
1713347110287,EDS 286,A00,507359,Fine; Sarah,18,0,18,0
1713347111313,EDS 289C,A01,507361,Daly; Alan J.,18,0,18,0
1713347112339,EDS 290,A00,507366,Hofstetter; Carolyn,15,0,15,0
1713347113365,LIGM 5A,A00,507421,Fischer-Grunski; Eva K,20,0,20,0
1713347114391,LIGM 5B,A00,507423,Fischer-Grunski; Eva K,20,0,20,0
1713347115417,LIGM 5C,A00,507425,Fischer-Grunski; Eva K,20,0,20,0
1713347116444,LIIT 5AS,A00,507427,Carnelos; Chiara,20,0,20,0
1713347117470,LIIT 5BS,A00,507430,Carnelos; Chiara,20,0,20,0
1713347118503,LIIT 5CS,A00,507432,Carnelos; Chiara,20,0,20,0
1713347119530,LISP 5A,A00,507541,Munoz Sanchez; Alicia,17,0,20,3
1713347120560,LISP 5B,A00,507671,Munoz Sanchez; Alicia,15,0,20,5
1713347121587,LISP 5C,A00,507696,Munoz Sanchez; Alicia,15,0,20,5
1713347122613,MAE 197,001,528363,Boechler; Nicholas Sebastia,9998,0,9999,1
1713347123644,MATH 197,001,523477,Kedlaya; Kiran S.,9999,0,9999,0
1713347123644,MATH 197,002,563811,Zhang; Danna,9999,0,9999,0
1713347124671,MCWP 40R,A00,518780,Staff,20,0,20,0
1713347124671,MCWP 40R,B00,518781,Staff,19,0,20,1
1713347124671,MCWP 40R,C00,518783,Staff,19,0,20,1
1713347125702,MCWP 50R,A00,518791,Staff,20,0,20,0
1713347125702,MCWP 50R,B00,518792,Staff,17,0,20,3
1713347125702,MCWP 50R,C00,518793,Staff,19,0,20,1
1713347125702,MCWP 50R,D00,518794,Staff,16,0,20,4
1713347125702,MCWP 50R,E00,518795,Staff,16,0,20,4
1713347125702,MCWP 50R,F00,518796,Staff,19,0,20,1
1713347125702,MCWP 50R,G00,518797,Staff,19,0,20,1
1713347126731,MMW 12R,A01,514034,Herbst; Matthew,15,0,16,1
1713347126731,MMW 12R,A02,514035,Herbst; Matthew,16,0,16,0
1713347127761,MMW 13R,A01,514037,Staff,12,0,16,4
1713347127761,MMW 13R,A02,514039,Staff,16,0,16,0
1713347129813,SIO 295LS,A00,523233,Staff,18,0,30,12
1713347130842,SIO 295S,A00,523232,Staff,18,0,30,12
1713347131867,SOCI 117,A01,494376,Staff,1,0,5,4
1713347132896,WES 237B,A00,494380,Staff,19,0,20,1
1713347134981,AESE 279B,A00,494370,Wade; Jon P,33,0,33,0
1713347136010,ANAR 135S,A00,494369,Braswell; Geoffrey E.,0,0,0,0
1713347137035,CAT 124RS,A01,519847,Geibel; William,17,0,20,3
1713347138063,CAT 125RS,A01,515971,Geibel; William,17,0,20,3
1713347139089,CLRE 250,A00,511389,Morris; Sheldon,9996,0,9999,3
1713347140117,CLRE 251,A00,507176,Mehta; Ravindra L.,9996,0,9999,3
1713347140117,CLRE 251,B00,511410,Mehta; Ravindra L.,9998,0,9999,1
1713347141143,CLRE 252,A00,507189,Cuomo; Raphael Eduardo,9998,0,9999,1
1713347142174,CLRE 253,A00,507199,Vaida; Florin,9997,0,9999,2
1713347142174,CLRE 253,B00,507202,Vaida; Florin,9999,0,9999,0
1713347143205,CLRE 259,A00,507211,Patel; Hemal,9996,0,9999,3
1713347144234,CLRE 260,A00,507221,Cuomo; Raphael Eduardo,9999,0,9999,0
1713347145258,CLRE 297,001,507242,Cuomo; Raphael Eduardo,9999,0,9999,0
1713347146286,CSE 191,A00,516875,Minnes Kemp; Mor Mia,9999,0,9999,0
1713347147323,CSS 201S,A01,494383,Staff,35,0,35,0
1713347148348,CSS 202S,A01,494387,Staff,35,0,35,0
1713347149374,EAP 100,A00,516065,Staff,9792,0,9999,207
1713347150403,ECE 45,A01,507414,Staff,51,0,60,9
1713347151432,ECE 100,A01,507416,Baghdadchi; Saharnaz,10,0,20,10
1713347151432,ECE 100,A02,507418,Baghdadchi; Saharnaz,20,0,20,0
1713347152458,ECE 111,A01,507420,Staff,38,0,50,12
1713347153487,ECE 197,001,548057,Sievenpiper; Daniel F.,9998,0,9999,1
1713347154512,EDS 115,A00,507243,Choi; Bailey Miyeon,28,0,28,0
1713347155540,EDS 117,A01,494379,Staff,23,0,25,2
1713347156570,EDS 125,A00,507246,Hopkins; Megan Beth,29,0,30,1
1713347157602,EDS 128A,A01,507264,Fargason; Sharon Gayle,26,0,26,0
1713347158652,EDS 128B,A01,507293,Pappas; Elizabeth,30,0,30,0
1713347159678,EDS 139,A00,507294,Fargason; Sharon Gayle,30,0,30,0
1713347159678,EDS 139,B00,507313,Pappas; Elizabeth,30,0,30,0
1713347160707,EDS 201,A00,507315,Staff,26,0,30,4
1713347161732,EDS 203,A01,507317,Halter; Christopher P.,26,0,30,4
1713347162757,EDS 204R,A01,507319,Halter; Christopher P.,3,0,30,27
1713347162757,EDS 204R,B01,507331,Heinzman; Erica M.,28,0,30,2
1713347163794,EDS 206R,A00,507332,Staff,4,0,30,26
1713347163794,EDS 206R,B00,507343,Staff,28,0,30,2
1713347164820,EDS 250,A00,507344,Hemans; Patricia Ann Benitez,36,0,40,4
1713347165845,EDS 281,A00,507345,Daly; Alan J.,18,0,18,0
1713347166873,EDS 284,A00,507350,Daly; Alan J.,16,0,16,0
1713347167898,EDS 286,A00,507359,Fine; Sarah,18,0,18,0
1713347168923,EDS 289C,A01,507361,Daly; Alan J.,18,0,18,0
1713347169947,EDS 290,A00,507366,Hofstetter; Carolyn,15,0,15,0
1713347170980,LIGM 5A,A00,507421,Fischer-Grunski; Eva K,20,0,20,0
1713347172010,LIGM 5B,A00,507423,Fischer-Grunski; Eva K,20,0,20,0
1713347173104,LIGM 5C,A00,507425,Fischer-Grunski; Eva K,20,0,20,0
1713347174136,LIIT 5AS,A00,507427,Carnelos; Chiara,20,0,20,0
1713347175170,LIIT 5BS,A00,507430,Carnelos; Chiara,20,0,20,0
1713347176196,LIIT 5CS,A00,507432,Carnelos; Chiara,20,0,20,0
1713347177226,LISP 5A,A00,507541,Munoz Sanchez; Alicia,17,0,20,3
1713347178254,LISP 5B,A00,507671,Munoz Sanchez; Alicia,15,0,20,5
1713347179280,LISP 5C,A00,507696,Munoz Sanchez; Alicia,15,0,20,5
1713347180309,MAE 197,001,528363,Boechler; Nicholas Sebastia,9998,0,9999,1
1713347181342,MATH 197,001,523477,Kedlaya; Kiran S.,9999,0,9999,0
1713347181342,MATH 197,002,563811,Zhang; Danna,9999,0,9999,0
1713347182369,MCWP 40R,A00,518780,Staff,20,0,20,0
1713347182369,MCWP 40R,B00,518781,Staff,19,0,20,1
1713347182369,MCWP 40R,C00,518783,Staff,19,0,20,1
1713347183401,MCWP 50R,A00,518791,Staff,20,0,20,0
1713347183401,MCWP 50R,B00,518792,Staff,17,0,20,3
1713347183401,MCWP 50R,C00,518793,Staff,19,0,20,1
1713347183401,MCWP 50R,D00,518794,Staff,16,0,20,4
1713347183401,MCWP 50R,E00,518795,Staff,16,0,20,4
1713347183401,MCWP 50R,F00,518796,Staff,19,0,20,1
1713347183401,MCWP 50R,G00,518797,Staff,19,0,20,1
1713347184430,MMW 12R,A01,514034,Herbst; Matthew,15,0,16,1
1713347184430,MMW 12R,A02,514035,Herbst; Matthew,16,0,16,0
1713347185455,MMW 13R,A01,514037,Staff,12,0,16,4
1713347185455,MMW 13R,A02,514039,Staff,16,0,16,0
1713347187511,SIO 295LS,A00,523233,Staff,18,0,30,12
1713347188536,SIO 295S,A00,523232,Staff,18,0,30,12
1713347189623,SOCI 117,A01,494376,Staff,1,0,5,4
1713347190649,WES 237B,A00,494380,Staff,19,0,20,1
1713347192736,AESE 279B,A00,494370,Wade; Jon P,33,0,33,0
1713347193767,ANAR 135S,A00,494369,Braswell; Geoffrey E.,0,0,0,0
1713347194793,CAT 124RS,A01,519847,Geibel; William,17,0,20,3
1713347195819,CAT 125RS,A01,515971,Geibel; William,17,0,20,3
1713347196846,CLRE 250,A00,511389,Morris; Sheldon,9996,0,9999,3
1713347197879,CLRE 251,A00,507176,Mehta; Ravindra L.,9996,0,9999,3
1713347197879,CLRE 251,B00,511410,Mehta; Ravindra L.,9998,0,9999,1
1713347198904,CLRE 252,A00,507189,Cuomo; Raphael Eduardo,9998,0,9999,1
1713347199930,CLRE 253,A00,507199,Vaida; Florin,9997,0,9999,2
1713347199930,CLRE 253,B00,507202,Vaida; Florin,9999,0,9999,0
1713347200956,CLRE 259,A00,507211,Patel; Hemal,9996,0,9999,3
1713347201984,CLRE 260,A00,507221,Cuomo; Raphael Eduardo,9999,0,9999,0
1713347203015,CLRE 297,001,507242,Cuomo; Raphael Eduardo,9999,0,9999,0
1713347204042,CSE 191,A00,516875,Minnes Kemp; Mor Mia,9999,0,9999,0
1713347205069,CSS 201S,A01,494383,Staff,35,0,35,0
1713347206101,CSS 202S,A01,494387,Staff,35,0,35,0
1713347207124,EAP 100,A00,516065,Staff,9792,0,9999,207
1713347208152,ECE 45,A01,507414,Staff,51,0,60,9
1713347209176,ECE 100,A01,507416,Baghdadchi; Saharnaz,10,0,20,10
1713347209176,ECE 100,A02,507418,Baghdadchi; Saharnaz,20,0,20,0
1713347210202,ECE 111,A01,507420,Staff,38,0,50,12
1713347211232,ECE 197,001,548057,Sievenpiper; Daniel F.,9998,0,9999,1
1713347212260,EDS 115,A00,507243,Choi; Bailey Miyeon,28,0,28,0
1713347213291,EDS 117,A01,494379,Staff,23,0,25,2
1713347214318,EDS 125,A00,507246,Hopkins; Megan Beth,29,0,30,1
1713347215349,EDS 128A,A01,507264,Fargason; Sharon Gayle,26,0,26,0
1713347216375,EDS 128B,A01,507293,Pappas; Elizabeth,30,0,30,0
1713347217402,EDS 139,A00,507294,Fargason; Sharon Gayle,30,0,30,0
1713347217402,EDS 139,B00,507313,Pappas; Elizabeth,30,0,30,0
1713347218432,EDS 201,A00,507315,Staff,26,0,30,4
1713347219461,EDS 203,A01,507317,Halter; Christopher P.,26,0,30,4
1713347220489,EDS 204R,A01,507319,Halter; Christopher P.,3,0,30,27
1713347220489,EDS 204R,B01,507331,Heinzman; Erica M.,28,0,30,2
1713347221514,EDS 206R,A00,507332,Staff,4,0,30,26
1713347221514,EDS 206R,B00,507343,Staff,28,0,30,2
1713347222541,EDS 250,A00,507344,Hemans; Patricia Ann Benitez,36,0,40,4
1713347223569,EDS 281,A00,507345,Daly; Alan J.,18,0,18,0
1713347224594,EDS 284,A00,507350,Daly; Alan J.,16,0,16,0
1713347225624,EDS 286,A00,507359,Fine; Sarah,18,0,18,0
1713347226650,EDS 289C,A01,507361,Daly; Alan J.,18,0,18,0
1713347227681,EDS 290,A00,507366,Hofstetter; Carolyn,15,0,15,0
1713347228708,LIGM 5A,A00,507421,Fischer-Grunski; Eva K,20,0,20,0
1713347229734,LIGM 5B,A00,507423,Fischer-Grunski; Eva K,20,0,20,0
1713347230764,LIGM 5C,A00,507425,Fischer-Grunski; Eva K,20,0,20,0
1713347231790,LIIT 5AS,A00,507427,Carnelos; Chiara,20,0,20,0
1713347232816,LIIT 5BS,A00,507430,Carnelos; Chiara,20,0,20,0
1713347233842,LIIT 5CS,A00,507432,Carnelos; Chiara,20,0,20,0
1713347234875,LISP 5A,A00,507541,Munoz Sanchez; Alicia,17,0,20,3
1713347235900,LISP 5B,A00,507671,Munoz Sanchez; Alicia,15,0,20,5
1713347236925,LISP 5C,A00,507696,Munoz Sanchez; Alicia,15,0,20,5
1713347237952,MAE 197,001,528363,Boechler; Nicholas Sebastia,9998,0,9999,1
1713347238980,MATH 197,001,523477,Kedlaya; Kiran S.,9999,0,9999,0
1713347238980,MATH 197,002,563811,Zhang; Danna,9999,0,9999,0
1713347240006,MCWP 40R,A00,518780,Staff,20,0,20,0
1713347240006,MCWP 40R,B00,518781,Staff,19,0,20,1
1713347240006,MCWP 40R,C00,518783,Staff,19,0,20,1
1713347241039,MCWP 50R,A00,518791,Staff,20,0,20,0
1713347241039,MCWP 50R,B00,518792,Staff,17,0,20,3
1713347241039,MCWP 50R,C00,518793,Staff,19,0,20,1
1713347241039,MCWP 50R,D00,518794,Staff,16,0,20,4
1713347241039,MCWP 50R,E00,518795,Staff,16,0,20,4
1713347241039,MCWP 50R,F00,518796,Staff,19,0,20,1
1713347241039,MCWP 50R,G00,518797,Staff,19,0,20,1
1713347242065,MMW 12R,A01,514034,Herbst; Matthew,15,0,16,1
1713347242065,MMW 12R,A02,514035,Herbst; Matthew,16,0,16,0
1713347243091,MMW 13R,A01,514037,Staff,12,0,16,4
1713347243091,MMW 13R,A02,514039,Staff,16,0,16,0
1713347245150,SIO 295LS,A00,523233,Staff,18,0,30,12
1713347246177,SIO 295S,A00,523232,Staff,18,0,30,12
1713347247206,SOCI 117,A01,494376,Staff,1,0,5,4
1713347248236,WES 237B,A00,494380,Staff,19,0,20,1
1713347250305,AESE 279B,A00,494370,Wade; Jon P,33,0,33,0
1713347251333,ANAR 135S,A00,494369,Braswell; Geoffrey E.,0,0,0,0
1713347252363,CAT 124RS,A01,519847,Geibel; William,17,0,20,3
1713347253387,CAT 125RS,A01,515971,Geibel; William,17,0,20,3
1713347254417,CLRE 250,A00,511389,Morris; Sheldon,9996,0,9999,3
1713347255451,CLRE 251,A00,507176,Mehta; Ravindra L.,9996,0,9999,3
1713347255451,CLRE 251,B00,511410,Mehta; Ravindra L.,9998,0,9999,1
1713347256477,CLRE 252,A00,507189,Cuomo; Raphael Eduardo,9998,0,9999,1
1713347257507,CLRE 253,A00,507199,Vaida; Florin,9997,0,9999,2
1713347257507,CLRE 253,B00,507202,Vaida; Florin,9999,0,9999,0
1713347258533,CLRE 259,A00,507211,Patel; Hemal,9996,0,9999,3
1713347259561,CLRE 260,A00,507221,Cuomo; Raphael Eduardo,9999,0,9999,0
1713347260588,CLRE 297,001,507242,Cuomo; Raphael Eduardo,9999,0,9999,0
1713347261682,CSE 191,A00,516875,Minnes Kemp; Mor Mia,9999,0,9999,0
1713347262707,CSS 201S,A01,494383,Staff,35,0,35,0
1713347263732,CSS 202S,A01,494387,Staff,35,0,35,0
1713347264759,EAP 100,A00,516065,Staff,9792,0,9999,207
1713347265785,ECE 45,A01,507414,Staff,51,0,60,9
1713347266811,ECE 100,A01,507416,Baghdadchi; Saharnaz,10,0,20,10
1713347266811,ECE 100,A02,507418,Baghdadchi; Saharnaz,20,0,20,0
1713347267840,ECE 111,A01,507420,Staff,38,0,50,12
1713347268869,ECE 197,001,548057,Sievenpiper; Daniel F.,9998,0,9999,1
1713347269896,EDS 115,A00,507243,Choi; Bailey Miyeon,28,0,28,0
1713347270924,EDS 117,A01,494379,Staff,23,0,25,2
1713347271951,EDS 125,A00,507246,Hopkins; Megan Beth,29,0,30,1
1713347272977,EDS 128A,A01,507264,Fargason; Sharon Gayle,26,0,26,0
1713347274007,EDS 128B,A01,507293,Pappas; Elizabeth,30,0,30,0
1713347275033,EDS 139,A00,507294,Fargason; Sharon Gayle,30,0,30,0
1713347275033,EDS 139,B00,507313,Pappas; Elizabeth,30,0,30,0
1713347276060,EDS 201,A00,507315,Staff,26,0,30,4
1713347277087,EDS 203,A01,507317,Halter; Christopher P.,26,0,30,4
1713347278114,EDS 204R,A01,507319,Halter; Christopher P.,3,0,30,27
1713347278114,EDS 204R,B01,507331,Heinzman; Erica M.,28,0,30,2
1713347279139,EDS 206R,A00,507332,Staff,4,0,30,26
1713347279139,EDS 206R,B00,507343,Staff,28,0,30,2
1713347280165,EDS 250,A00,507344,Hemans; Patricia Ann Benitez,36,0,40,4
1713347281190,EDS 281,A00,507345,Daly; Alan J.,18,0,18,0
1713347282217,EDS 284,A00,507350,Daly; Alan J.,16,0,16,0
1713347283250,EDS 286,A00,507359,Fine; Sarah,18,0,18,0
1713347284280,EDS 289C,A01,507361,Daly; Alan J.,18,0,18,0
1713347285310,EDS 290,A00,507366,Hofstetter; Carolyn,15,0,15,0
1713347286337,LIGM 5A,A00,507421,Fischer-Grunski; Eva K,20,0,20,0
1713347287363,LIGM 5B,A00,507423,Fischer-Grunski; Eva K,20,0,20,0
1713347288393,LIGM 5C,A00,507425,Fischer-Grunski; Eva K,20,0,20,0
1713347289418,LIIT 5AS,A00,507427,Carnelos; Chiara,20,0,20,0
1713347290444,LIIT 5BS,A00,507430,Carnelos; Chiara,20,0,20,0
1713347291475,LIIT 5CS,A00,507432,Carnelos; Chiara,20,0,20,0
1713347292505,LISP 5A,A00,507541,Munoz Sanchez; Alicia,17,0,20,3
1713347293587,LISP 5B,A00,507671,Munoz Sanchez; Alicia,15,0,20,5
1713347294616,LISP 5C,A00,507696,Munoz Sanchez; Alicia,15,0,20,5
1713347295645,MAE 197,001,528363,Boechler; Nicholas Sebastia,9998,0,9999,1
1713347296672,MATH 197,001,523477,Kedlaya; Kiran S.,9999,0,9999,0
1713347296672,MATH 197,002,563811,Zhang; Danna,9999,0,9999,0
1713347297698,MCWP 40R,A00,518780,Staff,20,0,20,0
1713347297698,MCWP 40R,B00,518781,Staff,19,0,20,1
1713347297698,MCWP 40R,C00,518783,Staff,19,0,20,1
1713347298725,MCWP 50R,A00,518791,Staff,20,0,20,0
1713347298725,MCWP 50R,B00,518792,Staff,17,0,20,3
1713347298725,MCWP 50R,C00,518793,Staff,19,0,20,1
1713347298725,MCWP 50R,D00,518794,Staff,16,0,20,4
1713347298725,MCWP 50R,E00,518795,Staff,16,0,20,4
1713347298725,MCWP 50R,F00,518796,Staff,19,0,20,1
1713347298725,MCWP 50R,G00,518797,Staff,19,0,20,1
1713347299750,MMW 12R,A01,514034,Herbst; Matthew,15,0,16,1
1713347299750,MMW 12R,A02,514035,Herbst; Matthew,16,0,16,0
1713347300776,MMW 13R,A01,514037,Staff,12,0,16,4
1713347300776,MMW 13R,A02,514039,Staff,16,0,16,0
1713347302826,SIO 295LS,A00,523233,Staff,18,0,30,12
1713347303861,SIO 295S,A00,523232,Staff,18,0,30,12
1713347304887,SOCI 117,A01,494376,Staff,1,0,5,4
1713347305912,WES 237B,A00,494380,Staff,19,0,20,1
1713347307996,AESE 279B,A00,494370,Wade; Jon P,33,0,33,0
1713347309027,ANAR 135S,A00,494369,Braswell; Geoffrey E.,0,0,0,0
1713347310053,CAT 124RS,A01,519847,Geibel; William,17,0,20,3
1713347311082,CAT 125RS,A01,515971,Geibel; William,17,0,20,3
1713347312112,CLRE 250,A00,511389,Morris; Sheldon,9996,0,9999,3
1713347313139,CLRE 251,A00,507176,Mehta; Ravindra L.,9996,0,9999,3
1713347313139,CLRE 251,B00,511410,Mehta; Ravindra L.,9998,0,9999,1
1713347314170,CLRE 252,A00,507189,Cuomo; Raphael Eduardo,9998,0,9999,1
1713347315196,CLRE 253,A00,507199,Vaida; Florin,9997,0,9999,2
1713347315196,CLRE 253,B00,507202,Vaida; Florin,9999,0,9999,0
1713347316226,CLRE 259,A00,507211,Patel; Hemal,9996,0,9999,3
1713347317250,CLRE 260,A00,507221,Cuomo; Raphael Eduardo,9999,0,9999,0
1713347318275,CLRE 297,001,507242,Cuomo; Raphael Eduardo,9999,0,9999,0
1713347319306,CSE 191,A00,516875,Minnes Kemp; Mor Mia,9999,0,9999,0
1713347320333,CSS 201S,A01,494383,Staff,35,0,35,0
1713347321359,CSS 202S,A01,494387,Staff,35,0,35,0
1713347322384,EAP 100,A00,516065,Staff,9792,0,9999,207
1713347323413,ECE 45,A01,507414,Staff,51,0,60,9
1713347324443,ECE 100,A01,507416,Baghdadchi; Saharnaz,10,0,20,10
1713347324443,ECE 100,A02,507418,Baghdadchi; Saharnaz,20,0,20,0
1713347325469,ECE 111,A01,507420,Staff,38,0,50,12
1713347326495,ECE 197,001,548057,Sievenpiper; Daniel F.,9998,0,9999,1
1713347327521,EDS 115,A00,507243,Choi; Bailey Miyeon,28,0,28,0
1713347328548,EDS 117,A01,494379,Staff,23,0,25,2
1713347329574,EDS 125,A00,507246,Hopkins; Megan Beth,29,0,30,1
1713347330602,EDS 128A,A01,507264,Fargason; Sharon Gayle,26,0,26,0
1713347331629,EDS 128B,A01,507293,Pappas; Elizabeth,30,0,30,0
1713347332658,EDS 139,A00,507294,Fargason; Sharon Gayle,30,0,30,0
1713347332658,EDS 139,B00,507313,Pappas; Elizabeth,30,0,30,0
1713347333684,EDS 201,A00,507315,Staff,26,0,30,4
1713347334717,EDS 203,A01,507317,Halter; Christopher P.,26,0,30,4
1713347335748,EDS 204R,A01,507319,Halter; Christopher P.,3,0,30,27
1713347335748,EDS 204R,B01,507331,Heinzman; Erica M.,28,0,30,2
1713347336776,EDS 206R,A00,507332,Staff,4,0,30,26
1713347336776,EDS 206R,B00,507343,Staff,28,0,30,2
1713347337807,EDS 250,A00,507344,Hemans; Patricia Ann Benitez,36,0,40,4
1713347338833,EDS 281,A00,507345,Daly; Alan J.,18,0,18,0
1713347339857,EDS 284,A00,507350,Daly; Alan J.,16,0,16,0
1713347340888,EDS 286,A00,507359,Fine; Sarah,18,0,18,0
1713347341915,EDS 289C,A01,507361,Daly; Alan J.,18,0,18,0
1713347342941,EDS 290,A00,507366,Hofstetter; Carolyn,15,0,15,0
1713347343972,LIGM 5A,A00,507421,Fischer-Grunski; Eva K,20,0,20,0
1713347345002,LIGM 5B,A00,507423,Fischer-Grunski; Eva K,20,0,20,0
1713347346034,LIGM 5C,A00,507425,Fischer-Grunski; Eva K,20,0,20,0
1713347347138,LIIT 5AS,A00,507427,Carnelos; Chiara,20,0,20,0
1713347348164,LIIT 5BS,A00,507430,Carnelos; Chiara,20,0,20,0
1713347349191,LIIT 5CS,A00,507432,Carnelos; Chiara,20,0,20,0
1713347350221,LISP 5A,A00,507541,Munoz Sanchez; Alicia,17,0,20,3
1713347351246,LISP 5B,A00,507671,Munoz Sanchez; Alicia,15,0,20,5
1713347352271,LISP 5C,A00,507696,Munoz Sanchez; Alicia,15,0,20,5
1713347353298,MAE 197,001,528363,Boechler; Nicholas Sebastia,9998,0,9999,1
1713347354327,MATH 197,001,523477,Kedlaya; Kiran S.,9999,0,9999,0
1713347354327,MATH 197,002,563811,Zhang; Danna,9999,0,9999,0
1713347355353,MCWP 40R,A00,518780,Staff,20,0,20,0
1713347355353,MCWP 40R,B00,518781,Staff,19,0,20,1
1713347355353,MCWP 40R,C00,518783,Staff,19,0,20,1
1713347356382,MCWP 50R,A00,518791,Staff,20,0,20,0
1713347356382,MCWP 50R,B00,518792,Staff,17,0,20,3
1713347356382,MCWP 50R,C00,518793,Staff,19,0,20,1
1713347356382,MCWP 50R,D00,518794,Staff,16,0,20,4
1713347356382,MCWP 50R,E00,518795,Staff,16,0,20,4
1713347356382,MCWP 50R,F00,518796,Staff,19,0,20,1
1713347356382,MCWP 50R,G00,518797,Staff,19,0,20,1
1713347357413,MMW 12R,A01,514034,Herbst; Matthew,15,0,16,1
1713347357413,MMW 12R,A02,514035,Herbst; Matthew,16,0,16,0
1713347358441,MMW 13R,A01,514037,Staff,12,0,16,4
1713347358441,MMW 13R,A02,514039,Staff,16,0,16,0
1713347360499,SIO 295LS,A00,523233,Staff,18,0,30,12
1713347361523,SIO 295S,A00,523232,Staff,18,0,30,12
1713347362550,SOCI 117,A01,494376,Staff,1,0,5,4
1713347363578,WES 237B,A00,494380,Staff,19,0,20,1
1713347365654,AESE 279B,A00,494370,Wade; Jon P,33,0,33,0
1713347366680,ANAR 135S,A00,494369,Braswell; Geoffrey E.,0,0,0,0
1713347367708,CAT 124RS,A01,519847,Geibel; William,17,0,20,3
1713347368747,CAT 125RS,A01,515971,Geibel; William,17,0,20,3
1713347369779,CLRE 250,A00,511389,Morris; Sheldon,9996,0,9999,3
1713347370806,CLRE 251,A00,507176,Mehta; Ravindra L.,9996,0,9999,3
1713347370806,CLRE 251,B00,511410,Mehta; Ravindra L.,9998,0,9999,1
1713347371831,CLRE 252,A00,507189,Cuomo; Raphael Eduardo,9998,0,9999,1
1713347372858,CLRE 253,A00,507199,Vaida; Florin,9997,0,9999,2
1713347372858,CLRE 253,B00,507202,Vaida; Florin,9999,0,9999,0
1713347373884,CLRE 259,A00,507211,Patel; Hemal,9996,0,9999,3
1713347374914,CLRE 260,A00,507221,Cuomo; Raphael Eduardo,9999,0,9999,0
1713347375944,CLRE 297,001,507242,Cuomo; Raphael Eduardo,9999,0,9999,0
1713347376971,CSE 191,A00,516875,Minnes Kemp; Mor Mia,9999,0,9999,0
1713347377997,CSS 201S,A01,494383,Staff,35,0,35,0
1713347379022,CSS 202S,A01,494387,Staff,35,0,35,0
1713347380049,EAP 100,A00,516065,Staff,9792,0,9999,207
1713347381076,ECE 45,A01,507414,Staff,51,0,60,9
1713347382107,ECE 100,A01,507416,Baghdadchi; Saharnaz,10,0,20,10
1713347382107,ECE 100,A02,507418,Baghdadchi; Saharnaz,20,0,20,0
1713347383136,ECE 111,A01,507420,Staff,38,0,50,12
1713347384162,ECE 197,001,548057,Sievenpiper; Daniel F.,9998,0,9999,1
1713347385189,EDS 115,A00,507243,Choi; Bailey Miyeon,28,0,28,0
1713347386215,EDS 117,A01,494379,Staff,23,0,25,2
1713347387242,EDS 125,A00,507246,Hopkins; Megan Beth,29,0,30,1
1713347388274,EDS 128A,A01,507264,Fargason; Sharon Gayle,26,0,26,0
1713347389304,EDS 128B,A01,507293,Pappas; Elizabeth,30,0,30,0
1713347390333,EDS 139,A00,507294,Fargason; Sharon Gayle,30,0,30,0
1713347390333,EDS 139,B00,507313,Pappas; Elizabeth,30,0,30,0
1713347391361,EDS 201,A00,507315,Staff,26,0,30,4
1713347392388,EDS 203,A01,507317,Halter; Christopher P.,26,0,30,4
1713347393421,EDS 204R,A01,507319,Halter; Christopher P.,3,0,30,27
1713347393421,EDS 204R,B01,507331,Heinzman; Erica M.,28,0,30,2
1713347394450,EDS 206R,A00,507332,Staff,4,0,30,26
1713347394450,EDS 206R,B00,507343,Staff,28,0,30,2
1713347395475,EDS 250,A00,507344,Hemans; Patricia Ann Benitez,36,0,40,4
1713347396507,EDS 281,A00,507345,Daly; Alan J.,18,0,18,0
1713347397591,EDS 284,A00,507350,Daly; Alan J.,16,0,16,0
1713347398619,EDS 286,A00,507359,Fine; Sarah,18,0,18,0
1713347399644,EDS 289C,A01,507361,Daly; Alan J.,18,0,18,0
1713347400670,EDS 290,A00,507366,Hofstetter; Carolyn,15,0,15,0
1713347401698,LIGM 5A,A00,507421,Fischer-Grunski; Eva K,20,0,20,0
1713347402729,LIGM 5B,A00,507423,Fischer-Grunski; Eva K,20,0,20,0
1713347403754,LIGM 5C,A00,507425,Fischer-Grunski; Eva K,20,0,20,0
1713347404782,LIIT 5AS,A00,507427,Carnelos; Chiara,20,0,20,0
1713347405811,LIIT 5BS,A00,507430,Carnelos; Chiara,20,0,20,0
1713347406837,LIIT 5CS,A00,507432,Carnelos; Chiara,20,0,20,0
1713347407863,LISP 5A,A00,507541,Munoz Sanchez; Alicia,17,0,20,3
1713347408889,LISP 5B,A00,507671,Munoz Sanchez; Alicia,15,0,20,5
1713347409916,LISP 5C,A00,507696,Munoz Sanchez; Alicia,15,0,20,5
1713347410945,MAE 197,001,528363,Boechler; Nicholas Sebastia,9998,0,9999,1
1713347411973,MATH 197,001,523477,Kedlaya; Kiran S.,9999,0,9999,0
1713347411973,MATH 197,002,563811,Zhang; Danna,9999,0,9999,0
1713347413000,MCWP 40R,A00,518780,Staff,20,0,20,0
1713347413000,MCWP 40R,B00,518781,Staff,19,0,20,1
1713347413000,MCWP 40R,C00,518783,Staff,19,0,20,1
1713347414027,MCWP 50R,A00,518791,Staff,20,0,20,0
1713347414027,MCWP 50R,B00,518792,Staff,17,0,20,3
1713347414027,MCWP 50R,C00,518793,Staff,19,0,20,1
1713347414027,MCWP 50R,D00,518794,Staff,16,0,20,4
1713347414027,MCWP 50R,E00,518795,Staff,16,0,20,4
1713347414027,MCWP 50R,F00,518796,Staff,19,0,20,1
1713347414027,MCWP 50R,G00,518797,Staff,19,0,20,1
1713347415057,MMW 12R,A01,514034,Herbst; Matthew,15,0,16,1
1713347415057,MMW 12R,A02,514035,Herbst; Matthew,16,0,16,0
1713347416084,MMW 13R,A01,514037,Staff,12,0,16,4
1713347416084,MMW 13R,A02,514039,Staff,16,0,16,0
1713347418135,SIO 295LS,A00,523233,Staff,18,0,30,12
1713347419164,SIO 295S,A00,523232,Staff,18,0,30,12
1713347420193,SOCI 117,A01,494376,Staff,1,0,5,4
1713347421219,WES 237B,A00,494380,Staff,19,0,20,1
1713347423296,AESE 279B,A00,494370,Wade; Jon P,33,0,33,0
1713347424321,ANAR 135S,A00,494369,Braswell; Geoffrey E.,0,0,0,0
1713347425346,CAT 124RS,A01,519847,Geibel; William,17,0,20,3
1713347426374,CAT 125RS,A01,515971,Geibel; William,17,0,20,3
1713347427399,CLRE 250,A00,511389,Morris; Sheldon,9996,0,9999,3
1713347428430,CLRE 251,A00,507176,Mehta; Ravindra L.,9996,0,9999,3
1713347428430,CLRE 251,B00,511410,Mehta; Ravindra L.,9998,0,9999,1
1713347429460,CLRE 252,A00,507189,Cuomo; Raphael Eduardo,9998,0,9999,1
1713347430484,CLRE 253,A00,507199,Vaida; Florin,9997,0,9999,2
1713347430484,CLRE 253,B00,507202,Vaida; Florin,9999,0,9999,0
1713347431513,CLRE 259,A00,507211,Patel; Hemal,9996,0,9999,3
1713347432541,CLRE 260,A00,507221,Cuomo; Raphael Eduardo,9999,0,9999,0
1713347433566,CLRE 297,001,507242,Cuomo; Raphael Eduardo,9999,0,9999,0
1713347434593,CSE 191,A00,516875,Minnes Kemp; Mor Mia,9999,0,9999,0
1713347435623,CSS 201S,A01,494383,Staff,35,0,35,0
1713347436651,CSS 202S,A01,494387,Staff,35,0,35,0
1713347437678,EAP 100,A00,516065,Staff,9792,0,9999,207
1713347438708,ECE 45,A01,507414,Staff,51,0,60,9
1713347439734,ECE 100,A01,507416,Baghdadchi; Saharnaz,10,0,20,10
1713347439734,ECE 100,A02,507418,Baghdadchi; Saharnaz,20,0,20,0
1713347440762,ECE 111,A01,507420,Staff,38,0,50,12
1713347441787,ECE 197,001,548057,Sievenpiper; Daniel F.,9998,0,9999,1
1713347442814,EDS 115,A00,507243,Choi; Bailey Miyeon,28,0,28,0
1713347443840,EDS 117,A01,494379,Staff,23,0,25,2
1713347444868,EDS 125,A00,507246,Hopkins; Megan Beth,29,0,30,1
1713347445895,EDS 128A,A01,507264,Fargason; Sharon Gayle,26,0,26,0
1713347446922,EDS 128B,A01,507293,Pappas; Elizabeth,30,0,30,0
1713347447952,EDS 139,A00,507294,Fargason; Sharon Gayle,30,0,30,0
1713347447952,EDS 139,B00,507313,Pappas; Elizabeth,30,0,30,0
1713347448976,EDS 201,A00,507315,Staff,26,0,30,4
1713347450004,EDS 203,A01,507317,Halter; Christopher P.,26,0,30,4
1713347451035,EDS 204R,A01,507319,Halter; Christopher P.,3,0,30,27
1713347451035,EDS 204R,B01,507331,Heinzman; Erica M.,28,0,30,2
1713347452063,EDS 206R,A00,507332,Staff,4,0,30,26
1713347452063,EDS 206R,B00,507343,Staff,28,0,30,2
1713347453090,EDS 250,A00,507344,Hemans; Patricia Ann Benitez,36,0,40,4
1713347454116,EDS 281,A00,507345,Daly; Alan J.,18,0,18,0
1713347455140,EDS 284,A00,507350,Daly; Alan J.,16,0,16,0
1713347456167,EDS 286,A00,507359,Fine; Sarah,18,0,18,0
1713347457193,EDS 289C,A01,507361,Daly; Alan J.,18,0,18,0
1713347458224,EDS 290,A00,507366,Hofstetter; Carolyn,15,0,15,0
1713347459252,LIGM 5A,A00,507421,Fischer-Grunski; Eva K,20,0,20,0
1713347460279,LIGM 5B,A00,507423,Fischer-Grunski; Eva K,20,0,20,0
1713347461302,LIGM 5C,A00,507425,Fischer-Grunski; Eva K,20,0,20,0
1713347462327,LIIT 5AS,A00,507427,Carnelos; Chiara,20,0,20,0
1713347463351,LIIT 5BS,A00,507430,Carnelos; Chiara,20,0,20,0
1713347464377,LIIT 5CS,A00,507432,Carnelos; Chiara,20,0,20,0
1713347465410,LISP 5A,A00,507541,Munoz Sanchez; Alicia,17,0,20,3
1713347466434,LISP 5B,A00,507671,Munoz Sanchez; Alicia,15,0,20,5
1713347467464,LISP 5C,A00,507696,Munoz Sanchez; Alicia,15,0,20,5
1713347468493,MAE 197,001,528363,Boechler; Nicholas Sebastia,9998,0,9999,1
1713347469520,MATH 197,001,523477,Kedlaya; Kiran S.,9999,0,9999,0
1713347469520,MATH 197,002,563811,Zhang; Danna,9999,0,9999,0
1713347470545,MCWP 40R,A00,518780,Staff,20,0,20,0
1713347470545,MCWP 40R,B00,518781,Staff,19,0,20,1
1713347470545,MCWP 40R,C00,518783,Staff,19,0,20,1
1713347471572,MCWP 50R,A00,518791,Staff,20,0,20,0
1713347471572,MCWP 50R,B00,518792,Staff,17,0,20,3
1713347471572,MCWP 50R,C00,518793,Staff,19,0,20,1
1713347471572,MCWP 50R,D00,518794,Staff,16,0,20,4
1713347471572,MCWP 50R,E00,518795,Staff,16,0,20,4
1713347471572,MCWP 50R,F00,518796,Staff,19,0,20,1
1713347471572,MCWP 50R,G00,518797,Staff,19,0,20,1
1713347472603,MMW 12R,A01,514034,Herbst; Matthew,15,0,16,1
1713347472603,MMW 12R,A02,514035,Herbst; Matthew,16,0,16,0
1713347473631,MMW 13R,A01,514037,Staff,12,0,16,4
1713347473631,MMW 13R,A02,514039,Staff,16,0,16,0
1713347475685,SIO 295LS,A00,523233,Staff,18,0,30,12
1713347476710,SIO 295S,A00,523232,Staff,18,0,30,12
1713347477737,SOCI 117,A01,494376,Staff,1,0,5,4
1713347478774,WES 237B,A00,494380,Staff,19,0,20,1
1713347480847,AESE 279B,A00,494370,Wade; Jon P,33,0,33,0
1713347481872,ANAR 135S,A00,494369,Braswell; Geoffrey E.,0,0,0,0
1713347482898,CAT 124RS,A01,519847,Geibel; William,17,0,20,3
1713347483922,CAT 125RS,A01,515971,Geibel; William,17,0,20,3
1713347484951,CLRE 250,A00,511389,Morris; Sheldon,9996,0,9999,3
1713347485978,CLRE 251,A00,507176,Mehta; Ravindra L.,9996,0,9999,3
1713347485978,CLRE 251,B00,511410,Mehta; Ravindra L.,9998,0,9999,1
1713347487009,CLRE 252,A00,507189,Cuomo; Raphael Eduardo,9998,0,9999,1
1713347488035,CLRE 253,A00,507199,Vaida; Florin,9997,0,9999,2
1713347488035,CLRE 253,B00,507202,Vaida; Florin,9999,0,9999,0
1713347489060,CLRE 259,A00,507211,Patel; Hemal,9996,0,9999,3
1713347490087,CLRE 260,A00,507221,Cuomo; Raphael Eduardo,9999,0,9999,0
1713347491115,CLRE 297,001,507242,Cuomo; Raphael Eduardo,9999,0,9999,0
1713347492140,CSE 191,A00,516875,Minnes Kemp; Mor Mia,9999,0,9999,0
1713347493165,CSS 201S,A01,494383,Staff,35,0,35,0
1713347494193,CSS 202S,A01,494387,Staff,35,0,35,0
1713347495219,EAP 100,A00,516065,Staff,9792,0,9999,207
1713347496244,ECE 45,A01,507414,Staff,51,0,60,9
1713347497276,ECE 100,A01,507416,Baghdadchi; Saharnaz,10,0,20,10
1713347497276,ECE 100,A02,507418,Baghdadchi; Saharnaz,20,0,20,0
1713347498301,ECE 111,A01,507420,Staff,38,0,50,12
1713347499327,ECE 197,001,548057,Sievenpiper; Daniel F.,9998,0,9999,1
1713347500352,EDS 115,A00,507243,Choi; Bailey Miyeon,28,0,28,0
1713347501432,EDS 117,A01,494379,Staff,23,0,25,2
1713347502459,EDS 125,A00,507246,Hopkins; Megan Beth,29,0,30,1
1713347503484,EDS 128A,A01,507264,Fargason; Sharon Gayle,26,0,26,0
1713347504510,EDS 128B,A01,507293,Pappas; Elizabeth,30,0,30,0
1713347505538,EDS 139,A00,507294,Fargason; Sharon Gayle,30,0,30,0
1713347505538,EDS 139,B00,507313,Pappas; Elizabeth,30,0,30,0
1713347506564,EDS 201,A00,507315,Staff,26,0,30,4
1713347507591,EDS 203,A01,507317,Halter; Christopher P.,26,0,30,4
1713347508621,EDS 204R,A01,507319,Halter; Christopher P.,3,0,30,27
1713347508621,EDS 204R,B01,507331,Heinzman; Erica M.,28,0,30,2
1713347509649,EDS 206R,A00,507332,Staff,4,0,30,26
1713347509649,EDS 206R,B00,507343,Staff,28,0,30,2
1713347510674,EDS 250,A00,507344,Hemans; Patricia Ann Benitez,36,0,40,4
1713347511700,EDS 281,A00,507345,Daly; Alan J.,18,0,18,0
1713347512726,EDS 284,A00,507350,Daly; Alan J.,16,0,16,0
1713347513752,EDS 286,A00,507359,Fine; Sarah,18,0,18,0
1713347514781,EDS 289C,A01,507361,Daly; Alan J.,18,0,18,0
1713347515811,EDS 290,A00,507366,Hofstetter; Carolyn,15,0,15,0
1713347516838,LIGM 5A,A00,507421,Fischer-Grunski; Eva K,20,0,20,0
1713347517864,LIGM 5B,A00,507423,Fischer-Grunski; Eva K,20,0,20,0
1713347518891,LIGM 5C,A00,507425,Fischer-Grunski; Eva K,20,0,20,0
1713347519920,LIIT 5AS,A00,507427,Carnelos; Chiara,20,0,20,0
1713347520947,LIIT 5BS,A00,507430,Carnelos; Chiara,20,0,20,0
1713347521973,LIIT 5CS,A00,507432,Carnelos; Chiara,20,0,20,0
1713347523011,LISP 5A,A00,507541,Munoz Sanchez; Alicia,17,0,20,3
1713347524040,LISP 5B,A00,507671,Munoz Sanchez; Alicia,15,0,20,5
1713347525069,LISP 5C,A00,507696,Munoz Sanchez; Alicia,15,0,20,5
1713347526094,MAE 197,001,528363,Boechler; Nicholas Sebastia,9998,0,9999,1
1713347527120,MATH 197,001,523477,Kedlaya; Kiran S.,9999,0,9999,0
1713347527120,MATH 197,002,563811,Zhang; Danna,9999,0,9999,0
1713347528149,MCWP 40R,A00,518780,Staff,20,0,20,0
1713347528149,MCWP 40R,B00,518781,Staff,19,0,20,1
1713347528149,MCWP 40R,C00,518783,Staff,19,0,20,1
1713347529174,MCWP 50R,A00,518791,Staff,20,0,20,0
1713347529174,MCWP 50R,B00,518792,Staff,17,0,20,3
1713347529174,MCWP 50R,C00,518793,Staff,19,0,20,1
1713347529174,MCWP 50R,D00,518794,Staff,16,0,20,4
1713347529174,MCWP 50R,E00,518795,Staff,16,0,20,4
1713347529174,MCWP 50R,F00,518796,Staff,19,0,20,1
1713347529174,MCWP 50R,G00,518797,Staff,19,0,20,1
1713347530203,MMW 12R,A01,514034,Herbst; Matthew,15,0,16,1
1713347530203,MMW 12R,A02,514035,Herbst; Matthew,16,0,16,0
1713347531231,MMW 13R,A01,514037,Staff,12,0,16,4
1713347531231,MMW 13R,A02,514039,Staff,16,0,16,0
1713347533283,SIO 295LS,A00,523233,Staff,18,0,30,12
1713347534312,SIO 295S,A00,523232,Staff,18,0,30,12
1713347535337,SOCI 117,A01,494376,Staff,1,0,5,4
1713347536364,WES 237B,A00,494380,Staff,19,0,20,1
1713347538441,AESE 279B,A00,494370,Wade; Jon P,33,0,33,0
1713347539470,ANAR 135S,A00,494369,Braswell; Geoffrey E.,0,0,0,0
1713347540495,CAT 124RS,A01,519847,Geibel; William,17,0,20,3
1713347541520,CAT 125RS,A01,515971,Geibel; William,17,0,20,3
1713347542551,CLRE 250,A00,511389,Morris; Sheldon,9996,0,9999,3
1713347543578,CLRE 251,A00,507176,Mehta; Ravindra L.,9996,0,9999,3
1713347543578,CLRE 251,B00,511410,Mehta; Ravindra L.,9998,0,9999,1
1713347544604,CLRE 252,A00,507189,Cuomo; Raphael Eduardo,9998,0,9999,1
1713347545633,CLRE 253,A00,507199,Vaida; Florin,9997,0,9999,2
1713347545633,CLRE 253,B00,507202,Vaida; Florin,9999,0,9999,0
1713347546660,CLRE 259,A00,507211,Patel; Hemal,9996,0,9999,3
1713347547685,CLRE 260,A00,507221,Cuomo; Raphael Eduardo,9999,0,9999,0
1713347548712,CLRE 297,001,507242,Cuomo; Raphael Eduardo,9999,0,9999,0
1713347549737,CSE 191,A00,516875,Minnes Kemp; Mor Mia,9999,0,9999,0
1713347550762,CSS 201S,A01,494383,Staff,35,0,35,0
1713347551788,CSS 202S,A01,494387,Staff,35,0,35,0
1713347552816,EAP 100,A00,516065,Staff,9792,0,9999,207
1713347553843,ECE 45,A01,507414,Staff,51,0,60,9
1713347554872,ECE 100,A01,507416,Baghdadchi; Saharnaz,10,0,20,10
1713347554872,ECE 100,A02,507418,Baghdadchi; Saharnaz,20,0,20,0
1713347555900,ECE 111,A01,507420,Staff,38,0,50,12
1713347556926,ECE 197,001,548057,Sievenpiper; Daniel F.,9998,0,9999,1
1713347557951,EDS 115,A00,507243,Choi; Bailey Miyeon,28,0,28,0
1713347558980,EDS 117,A01,494379,Staff,23,0,25,2
1713347560007,EDS 125,A00,507246,Hopkins; Megan Beth,29,0,30,1
1713347561031,EDS 128A,A01,507264,Fargason; Sharon Gayle,26,0,26,0
1713347562057,EDS 128B,A01,507293,Pappas; Elizabeth,30,0,30,0
1713347563082,EDS 139,A00,507294,Fargason; Sharon Gayle,30,0,30,0
1713347563082,EDS 139,B00,507313,Pappas; Elizabeth,30,0,30,0
1713347564108,EDS 201,A00,507315,Staff,26,0,30,4
1713347565133,EDS 203,A01,507317,Halter; Christopher P.,26,0,30,4
1713347566161,EDS 204R,A01,507319,Halter; Christopher P.,3,0,30,27
1713347566161,EDS 204R,B01,507331,Heinzman; Erica M.,28,0,30,2
1713347567186,EDS 206R,A00,507332,Staff,4,0,30,26
1713347567186,EDS 206R,B00,507343,Staff,28,0,30,2
1713347568212,EDS 250,A00,507344,Hemans; Patricia Ann Benitez,36,0,40,4
1713347569237,EDS 281,A00,507345,Daly; Alan J.,18,0,18,0
1713347570262,EDS 284,A00,507350,Daly; Alan J.,16,0,16,0
1713347571288,EDS 286,A00,507359,Fine; Sarah,18,0,18,0
1713347572312,EDS 289C,A01,507361,Daly; Alan J.,18,0,18,0
1713347573340,EDS 290,A00,507366,Hofstetter; Carolyn,15,0,15,0
1713347574367,LIGM 5A,A00,507421,Fischer-Grunski; Eva K,20,0,20,0
1713347575395,LIGM 5B,A00,507423,Fischer-Grunski; Eva K,20,0,20,0
1713347576420,LIGM 5C,A00,507425,Fischer-Grunski; Eva K,20,0,20,0
1713347577446,LIIT 5AS,A00,507427,Carnelos; Chiara,20,0,20,0
1713347578471,LIIT 5BS,A00,507430,Carnelos; Chiara,20,0,20,0
1713347579496,LIIT 5CS,A00,507432,Carnelos; Chiara,20,0,20,0
1713347580526,LISP 5A,A00,507541,Munoz Sanchez; Alicia,17,0,20,3
1713347581555,LISP 5B,A00,507671,Munoz Sanchez; Alicia,15,0,20,5
1713347582580,LISP 5C,A00,507696,Munoz Sanchez; Alicia,15,0,20,5
1713347583606,MAE 197,001,528363,Boechler; Nicholas Sebastia,9998,0,9999,1
1713347584630,MATH 197,001,523477,Kedlaya; Kiran S.,9999,0,9999,0
1713347584630,MATH 197,002,563811,Zhang; Danna,9999,0,9999,0
1713347585659,MCWP 40R,A00,518780,Staff,20,0,20,0
1713347585659,MCWP 40R,B00,518781,Staff,19,0,20,1
1713347585659,MCWP 40R,C00,518783,Staff,19,0,20,1
1713347586684,MCWP 50R,A00,518791,Staff,20,0,20,0
1713347586684,MCWP 50R,B00,518792,Staff,17,0,20,3
1713347586684,MCWP 50R,C00,518793,Staff,19,0,20,1
1713347586684,MCWP 50R,D00,518794,Staff,16,0,20,4
1713347586684,MCWP 50R,E00,518795,Staff,16,0,20,4
1713347586684,MCWP 50R,F00,518796,Staff,19,0,20,1
1713347586684,MCWP 50R,G00,518797,Staff,19,0,20,1
1713347587710,MMW 12R,A01,514034,Herbst; Matthew,15,0,16,1
1713347587710,MMW 12R,A02,514035,Herbst; Matthew,16,0,16,0
1713347588736,MMW 13R,A01,514037,Staff,12,0,16,4
1713347588736,MMW 13R,A02,514039,Staff,16,0,16,0
1713347590788,SIO 295LS,A00,523233,Staff,18,0,30,12
1713347591813,SIO 295S,A00,523232,Staff,18,0,30,12
1713347592842,SOCI 117,A01,494376,Staff,1,0,5,4
1713347593868,WES 237B,A00,494380,Staff,19,0,20,1
1713347595944,AESE 279B,A00,494370,Wade; Jon P,33,0,33,0
1713347596973,ANAR 135S,A00,494369,Braswell; Geoffrey E.,0,0,0,0
1713347597998,CAT 124RS,A01,519847,Geibel; William,17,0,20,3
1713347599024,CAT 125RS,A01,515971,Geibel; William,17,0,20,3
1713347600051,CLRE 250,A00,511389,Morris; Sheldon,9996,0,9999,3
1713347601077,CLRE 251,A00,507176,Mehta; Ravindra L.,9996,0,9999,3
1713347601077,CLRE 251,B00,511410,Mehta; Ravindra L.,9998,0,9999,1
1713347602103,CLRE 252,A00,507189,Cuomo; Raphael Eduardo,9998,0,9999,1
1713347603128,CLRE 253,A00,507199,Vaida; Florin,9997,0,9999,2
1713347603128,CLRE 253,B00,507202,Vaida; Florin,9999,0,9999,0
1713347604153,CLRE 259,A00,507211,Patel; Hemal,9996,0,9999,3
1713347605231,CLRE 260,A00,507221,Cuomo; Raphael Eduardo,9999,0,9999,0
1713347606258,CLRE 297,001,507242,Cuomo; Raphael Eduardo,9999,0,9999,0
1713347607290,CSE 191,A00,516875,Minnes Kemp; Mor Mia,9999,0,9999,0
1713347608316,CSS 201S,A01,494383,Staff,35,0,35,0
1713347609341,CSS 202S,A01,494387,Staff,35,0,35,0
1713347610367,EAP 100,A00,516065,Staff,9792,0,9999,207
1713347611391,ECE 45,A01,507414,Staff,51,0,60,9
1713347612421,ECE 100,A01,507416,Baghdadchi; Saharnaz,10,0,20,10
1713347612421,ECE 100,A02,507418,Baghdadchi; Saharnaz,20,0,20,0
1713347613450,ECE 111,A01,507420,Staff,38,0,50,12
1713347614481,ECE 197,001,548057,Sievenpiper; Daniel F.,9998,0,9999,1
1713347615512,EDS 115,A00,507243,Choi; Bailey Miyeon,28,0,28,0
1713347616537,EDS 117,A01,494379,Staff,23,0,25,2
1713347617563,EDS 125,A00,507246,Hopkins; Megan Beth,29,0,30,1
1713347618594,EDS 128A,A01,507264,Fargason; Sharon Gayle,26,0,26,0
1713347619626,EDS 128B,A01,507293,Pappas; Elizabeth,30,0,30,0
1713347620650,EDS 139,A00,507294,Fargason; Sharon Gayle,30,0,30,0
1713347620650,EDS 139,B00,507313,Pappas; Elizabeth,30,0,30,0
1713347621675,EDS 201,A00,507315,Staff,26,0,30,4
1713347622705,EDS 203,A01,507317,Halter; Christopher P.,26,0,30,4
1713347623731,EDS 204R,A01,507319,Halter; Christopher P.,3,0,30,27
1713347623731,EDS 204R,B01,507331,Heinzman; Erica M.,28,0,30,2
1713347624756,EDS 206R,A00,507332,Staff,4,0,30,26
1713347624756,EDS 206R,B00,507343,Staff,28,0,30,2
1713347625779,EDS 250,A00,507344,Hemans; Patricia Ann Benitez,36,0,40,4
1713347626805,EDS 281,A00,507345,Daly; Alan J.,18,0,18,0
1713347627832,EDS 284,A00,507350,Daly; Alan J.,16,0,16,0
1713347628858,EDS 286,A00,507359,Fine; Sarah,18,0,18,0
1713347629883,EDS 289C,A01,507361,Daly; Alan J.,18,0,18,0
1713347630908,EDS 290,A00,507366,Hofstetter; Carolyn,15,0,15,0
1713347631935,LIGM 5A,A00,507421,Fischer-Grunski; Eva K,20,0,20,0
1713347632964,LIGM 5B,A00,507423,Fischer-Grunski; Eva K,20,0,20,0
1713347633990,LIGM 5C,A00,507425,Fischer-Grunski; Eva K,20,0,20,0
1713347635021,LIIT 5AS,A00,507427,Carnelos; Chiara,20,0,20,0
1713347636051,LIIT 5BS,A00,507430,Carnelos; Chiara,20,0,20,0
1713347637078,LIIT 5CS,A00,507432,Carnelos; Chiara,20,0,20,0
1713347638105,LISP 5A,A00,507541,Munoz Sanchez; Alicia,17,0,20,3
1713347639135,LISP 5B,A00,507671,Munoz Sanchez; Alicia,15,0,20,5
1713347640162,LISP 5C,A00,507696,Munoz Sanchez; Alicia,15,0,20,5
1713347641189,MAE 197,001,528363,Boechler; Nicholas Sebastia,9998,0,9999,1
1713347642216,MATH 197,001,523477,Kedlaya; Kiran S.,9999,0,9999,0
1713347642216,MATH 197,002,563811,Zhang; Danna,9999,0,9999,0
1713347643245,MCWP 40R,A00,518780,Staff,20,0,20,0
1713347643245,MCWP 40R,B00,518781,Staff,19,0,20,1
1713347643245,MCWP 40R,C00,518783,Staff,19,0,20,1
1713347644277,MCWP 50R,A00,518791,Staff,20,0,20,0
1713347644277,MCWP 50R,B00,518792,Staff,17,0,20,3
1713347644277,MCWP 50R,C00,518793,Staff,19,0,20,1
1713347644277,MCWP 50R,D00,518794,Staff,16,0,20,4
1713347644277,MCWP 50R,E00,518795,Staff,16,0,20,4
1713347644277,MCWP 50R,F00,518796,Staff,19,0,20,1
1713347644277,MCWP 50R,G00,518797,Staff,19,0,20,1
1713347645303,MMW 12R,A01,514034,Herbst; Matthew,15,0,16,1
1713347645303,MMW 12R,A02,514035,Herbst; Matthew,16,0,16,0
1713347646329,MMW 13R,A01,514037,Staff,12,0,16,4
1713347646329,MMW 13R,A02,514039,Staff,16,0,16,0
1713347648382,SIO 295LS,A00,523233,Staff,18,0,30,12
1713347649407,SIO 295S,A00,523232,Staff,18,0,30,12
1713347650432,SOCI 117,A01,494376,Staff,1,0,5,4
1713347651459,WES 237B,A00,494380,Staff,19,0,20,1
1713347653534,AESE 279B,A00,494370,Wade; Jon P,33,0,33,0
1713347654560,ANAR 135S,A00,494369,Braswell; Geoffrey E.,0,0,0,0
1713347655586,CAT 124RS,A01,519847,Geibel; William,17,0,20,3
1713347656611,CAT 125RS,A01,515971,Geibel; William,17,0,20,3
1713347657641,CLRE 250,A00,511389,Morris; Sheldon,9996,0,9999,3
1713347658670,CLRE 251,A00,507176,Mehta; Ravindra L.,9996,0,9999,3
1713347658670,CLRE 251,B00,511410,Mehta; Ravindra L.,9998,0,9999,1
1713347659696,CLRE 252,A00,507189,Cuomo; Raphael Eduardo,9998,0,9999,1
1713347660722,CLRE 253,A00,507199,Vaida; Florin,9997,0,9999,2
1713347660722,CLRE 253,B00,507202,Vaida; Florin,9999,0,9999,0
1713347661749,CLRE 259,A00,507211,Patel; Hemal,9996,0,9999,3
1713347662775,CLRE 260,A00,507221,Cuomo; Raphael Eduardo,9999,0,9999,0
1713347663804,CLRE 297,001,507242,Cuomo; Raphael Eduardo,9999,0,9999,0
1713347664832,CSE 191,A00,516875,Minnes Kemp; Mor Mia,9999,0,9999,0
1713347665858,CSS 201S,A01,494383,Staff,35,0,35,0
1713347666884,CSS 202S,A01,494387,Staff,35,0,35,0
1713347667913,EAP 100,A00,516065,Staff,9792,0,9999,207
1713347668939,ECE 45,A01,507414,Staff,51,0,60,9
1713347669975,ECE 100,A01,507416,Baghdadchi; Saharnaz,10,0,20,10
1713347669975,ECE 100,A02,507418,Baghdadchi; Saharnaz,20,0,20,0
1713347671004,ECE 111,A01,507420,Staff,38,0,50,12
1713347672032,ECE 197,001,548057,Sievenpiper; Daniel F.,9998,0,9999,1
1713347673063,EDS 115,A00,507243,Choi; Bailey Miyeon,28,0,28,0
1713347674094,EDS 117,A01,494379,Staff,23,0,25,2
1713347675124,EDS 125,A00,507246,Hopkins; Megan Beth,29,0,30,1
1713347676149,EDS 128A,A01,507264,Fargason; Sharon Gayle,26,0,26,0
1713347677180,EDS 128B,A01,507293,Pappas; Elizabeth,30,0,30,0
1713347678206,EDS 139,A00,507294,Fargason; Sharon Gayle,30,0,30,0
1713347678206,EDS 139,B00,507313,Pappas; Elizabeth,30,0,30,0
1713347679235,EDS 201,A00,507315,Staff,26,0,30,4
1713347680261,EDS 203,A01,507317,Halter; Christopher P.,26,0,30,4
1713347681291,EDS 204R,A01,507319,Halter; Christopher P.,3,0,30,27
1713347681291,EDS 204R,B01,507331,Heinzman; Erica M.,28,0,30,2
1713347682321,EDS 206R,A00,507332,Staff,4,0,30,26
1713347682321,EDS 206R,B00,507343,Staff,28,0,30,2
1713347683346,EDS 250,A00,507344,Hemans; Patricia Ann Benitez,36,0,40,4
1713347684373,EDS 281,A00,507345,Daly; Alan J.,18,0,18,0
1713347685398,EDS 284,A00,507350,Daly; Alan J.,16,0,16,0
1713347686426,EDS 286,A00,507359,Fine; Sarah,18,0,18,0
1713347687451,EDS 289C,A01,507361,Daly; Alan J.,18,0,18,0
1713347688478,EDS 290,A00,507366,Hofstetter; Carolyn,15,0,15,0
1713347689505,LIGM 5A,A00,507421,Fischer-Grunski; Eva K,20,0,20,0
1713347690530,LIGM 5B,A00,507423,Fischer-Grunski; Eva K,20,0,20,0
1713347691556,LIGM 5C,A00,507425,Fischer-Grunski; Eva K,20,0,20,0
1713347692580,LIIT 5AS,A00,507427,Carnelos; Chiara,20,0,20,0
1713347693606,LIIT 5BS,A00,507430,Carnelos; Chiara,20,0,20,0
1713347694631,LIIT 5CS,A00,507432,Carnelos; Chiara,20,0,20,0
1713347695657,LISP 5A,A00,507541,Munoz Sanchez; Alicia,17,0,20,3
1713347696685,LISP 5B,A00,507671,Munoz Sanchez; Alicia,15,0,20,5
1713347697714,LISP 5C,A00,507696,Munoz Sanchez; Alicia,15,0,20,5
1713347698741,MAE 197,001,528363,Boechler; Nicholas Sebastia,9998,0,9999,1
1713347699768,MATH 197,001,523477,Kedlaya; Kiran S.,9999,0,9999,0
1713347699768,MATH 197,002,563811,Zhang; Danna,9999,0,9999,0
1713347700798,MCWP 40R,A00,518780,Staff,20,0,20,0
1713347700798,MCWP 40R,B00,518781,Staff,19,0,20,1
1713347700798,MCWP 40R,C00,518783,Staff,19,0,20,1
1713347701825,MCWP 50R,A00,518791,Staff,20,0,20,0
1713347701825,MCWP 50R,B00,518792,Staff,17,0,20,3
1713347701825,MCWP 50R,C00,518793,Staff,19,0,20,1
1713347701825,MCWP 50R,D00,518794,Staff,16,0,20,4
1713347701825,MCWP 50R,E00,518795,Staff,16,0,20,4
1713347701825,MCWP 50R,F00,518796,Staff,19,0,20,1
1713347701825,MCWP 50R,G00,518797,Staff,19,0,20,1
1713347702852,MMW 12R,A01,514034,Herbst; Matthew,15,0,16,1
1713347702852,MMW 12R,A02,514035,Herbst; Matthew,16,0,16,0
1713347703878,MMW 13R,A01,514037,Staff,12,0,16,4
1713347703878,MMW 13R,A02,514039,Staff,16,0,16,0
1713347705931,SIO 295LS,A00,523233,Staff,18,0,30,12
1713347706961,SIO 295S,A00,523232,Staff,18,0,30,12
1713347707986,SOCI 117,A01,494376,Staff,1,0,5,4
1713347709085,WES 237B,A00,494380,Staff,19,0,20,1
1713347711159,AESE 279B,A00,494370,Wade; Jon P,33,0,33,0
1713347712185,ANAR 135S,A00,494369,Braswell; Geoffrey E.,0,0,0,0
1713347713217,CAT 124RS,A01,519847,Geibel; William,17,0,20,3
1713347714242,CAT 125RS,A01,515971,Geibel; William,17,0,20,3
1713347715270,CLRE 250,A00,511389,Morris; Sheldon,9996,0,9999,3
1713347716301,CLRE 251,A00,507176,Mehta; Ravindra L.,9996,0,9999,3
1713347716301,CLRE 251,B00,511410,Mehta; Ravindra L.,9998,0,9999,1
1713347717331,CLRE 252,A00,507189,Cuomo; Raphael Eduardo,9998,0,9999,1
1713347718357,CLRE 253,A00,507199,Vaida; Florin,9997,0,9999,2
1713347718357,CLRE 253,B00,507202,Vaida; Florin,9999,0,9999,0
1713347719381,CLRE 259,A00,507211,Patel; Hemal,9996,0,9999,3
1713347720406,CLRE 260,A00,507221,Cuomo; Raphael Eduardo,9999,0,9999,0
1713347721433,CLRE 297,001,507242,Cuomo; Raphael Eduardo,9999,0,9999,0
1713347722458,CSE 191,A00,516875,Minnes Kemp; Mor Mia,9999,0,9999,0
1713347723490,CSS 201S,A01,494383,Staff,35,0,35,0
1713347724515,CSS 202S,A01,494387,Staff,35,0,35,0
1713347725540,EAP 100,A00,516065,Staff,9792,0,9999,207
1713347726570,ECE 45,A01,507414,Staff,51,0,60,9
1713347727596,ECE 100,A01,507416,Baghdadchi; Saharnaz,10,0,20,10
1713347727596,ECE 100,A02,507418,Baghdadchi; Saharnaz,20,0,20,0
1713347728626,ECE 111,A01,507420,Staff,38,0,50,12
1713347729650,ECE 197,001,548057,Sievenpiper; Daniel F.,9998,0,9999,1
1713347730678,EDS 115,A00,507243,Choi; Bailey Miyeon,28,0,28,0
1713347731704,EDS 117,A01,494379,Staff,23,0,25,2
1713347732730,EDS 125,A00,507246,Hopkins; Megan Beth,29,0,30,1
1713347733757,EDS 128A,A01,507264,Fargason; Sharon Gayle,26,0,26,0
1713347734784,EDS 128B,A01,507293,Pappas; Elizabeth,30,0,30,0
1713347735811,EDS 139,A00,507294,Fargason; Sharon Gayle,30,0,30,0
1713347735811,EDS 139,B00,507313,Pappas; Elizabeth,30,0,30,0
1713347736840,EDS 201,A00,507315,Staff,26,0,30,4
1713347737867,EDS 203,A01,507317,Halter; Christopher P.,26,0,30,4
1713347738892,EDS 204R,A01,507319,Halter; Christopher P.,3,0,30,27
1713347738892,EDS 204R,B01,507331,Heinzman; Erica M.,28,0,30,2
1713347739916,EDS 206R,A00,507332,Staff,4,0,30,26
1713347739916,EDS 206R,B00,507343,Staff,28,0,30,2
1713347740944,EDS 250,A00,507344,Hemans; Patricia Ann Benitez,36,0,40,4
1713347741970,EDS 281,A00,507345,Daly; Alan J.,18,0,18,0
1713347742998,EDS 284,A00,507350,Daly; Alan J.,16,0,16,0
1713347744023,EDS 286,A00,507359,Fine; Sarah,18,0,18,0
1713347745050,EDS 289C,A01,507361,Daly; Alan J.,18,0,18,0
1713347746080,EDS 290,A00,507366,Hofstetter; Carolyn,15,0,15,0
1713347747110,LIGM 5A,A00,507421,Fischer-Grunski; Eva K,20,0,20,0
1713347748141,LIGM 5B,A00,507423,Fischer-Grunski; Eva K,20,0,20,0
1713347749171,LIGM 5C,A00,507425,Fischer-Grunski; Eva K,20,0,20,0
1713347750196,LIIT 5AS,A00,507427,Carnelos; Chiara,20,0,20,0
1713347751219,LIIT 5BS,A00,507430,Carnelos; Chiara,20,0,20,0
1713347752251,LIIT 5CS,A00,507432,Carnelos; Chiara,20,0,20,0
1713347753284,LISP 5A,A00,507541,Munoz Sanchez; Alicia,17,0,20,3
1713347754310,LISP 5B,A00,507671,Munoz Sanchez; Alicia,15,0,20,5
1713347755340,LISP 5C,A00,507696,Munoz Sanchez; Alicia,15,0,20,5
1713347756365,MAE 197,001,528363,Boechler; Nicholas Sebastia,9998,0,9999,1
1713347757392,MATH 197,001,523477,Kedlaya; Kiran S.,9999,0,9999,0
1713347757392,MATH 197,002,563811,Zhang; Danna,9999,0,9999,0
1713347758423,MCWP 40R,A00,518780,Staff,20,0,20,0
1713347758423,MCWP 40R,B00,518781,Staff,19,0,20,1
1713347758423,MCWP 40R,C00,518783,Staff,19,0,20,1
1713347759453,MCWP 50R,A00,518791,Staff,20,0,20,0
1713347759453,MCWP 50R,B00,518792,Staff,17,0,20,3
1713347759453,MCWP 50R,C00,518793,Staff,19,0,20,1
1713347759453,MCWP 50R,D00,518794,Staff,16,0,20,4
1713347759453,MCWP 50R,E00,518795,Staff,16,0,20,4
1713347759453,MCWP 50R,F00,518796,Staff,19,0,20,1
1713347759453,MCWP 50R,G00,518797,Staff,19,0,20,1
1713347760479,MMW 12R,A01,514034,Herbst; Matthew,15,0,16,1
1713347760479,MMW 12R,A02,514035,Herbst; Matthew,16,0,16,0
1713347761512,MMW 13R,A01,514037,Staff,12,0,16,4
1713347761512,MMW 13R,A02,514039,Staff,16,0,16,0
1713347763566,SIO 295LS,A00,523233,Staff,18,0,30,12
1713347764594,SIO 295S,A00,523232,Staff,18,0,30,12
1713347765623,SOCI 117,A01,494376,Staff,1,0,5,4
1713347766717,WES 237B,A00,494380,Staff,19,0,20,1
1713347768793,AESE 279B,A00,494370,Wade; Jon P,33,0,33,0
1713347769823,ANAR 135S,A00,494369,Braswell; Geoffrey E.,0,0,0,0
1713347770850,CAT 124RS,A01,519847,Geibel; William,17,0,20,3
1713347771877,CAT 125RS,A01,515971,Geibel; William,17,0,20,3
1713347772907,CLRE 250,A00,511389,Morris; Sheldon,9996,0,9999,3
1713347773934,CLRE 251,A00,507176,Mehta; Ravindra L.,9996,0,9999,3
1713347773934,CLRE 251,B00,511410,Mehta; Ravindra L.,9998,0,9999,1
1713347774961,CLRE 252,A00,507189,Cuomo; Raphael Eduardo,9998,0,9999,1
1713347775993,CLRE 253,A00,507199,Vaida; Florin,9997,0,9999,2
1713347775993,CLRE 253,B00,507202,Vaida; Florin,9999,0,9999,0
1713347777017,CLRE 259,A00,507211,Patel; Hemal,9996,0,9999,3
1713347778042,CLRE 260,A00,507221,Cuomo; Raphael Eduardo,9999,0,9999,0
1713347779067,CLRE 297,001,507242,Cuomo; Raphael Eduardo,9999,0,9999,0
1713347780094,CSE 191,A00,516875,Minnes Kemp; Mor Mia,9999,0,9999,0
1713347781120,CSS 201S,A01,494383,Staff,35,0,35,0
1713347782147,CSS 202S,A01,494387,Staff,35,0,35,0
1713347783174,EAP 100,A00,516065,Staff,9792,0,9999,207
1713347784198,ECE 45,A01,507414,Staff,51,0,60,9
1713347785223,ECE 100,A01,507416,Baghdadchi; Saharnaz,10,0,20,10
1713347785223,ECE 100,A02,507418,Baghdadchi; Saharnaz,20,0,20,0
1713347786252,ECE 111,A01,507420,Staff,38,0,50,12
1713347787277,ECE 197,001,548057,Sievenpiper; Daniel F.,9998,0,9999,1
1713347788304,EDS 115,A00,507243,Choi; Bailey Miyeon,28,0,28,0
1713347789331,EDS 117,A01,494379,Staff,23,0,25,2
1713347790360,EDS 125,A00,507246,Hopkins; Megan Beth,29,0,30,1
1713347791387,EDS 128A,A01,507264,Fargason; Sharon Gayle,26,0,26,0
1713347792415,EDS 128B,A01,507293,Pappas; Elizabeth,30,0,30,0
1713347793444,EDS 139,A00,507294,Fargason; Sharon Gayle,30,0,30,0
1713347793444,EDS 139,B00,507313,Pappas; Elizabeth,30,0,30,0
1713347794470,EDS 201,A00,507315,Staff,26,0,30,4
1713347795496,EDS 203,A01,507317,Halter; Christopher P.,26,0,30,4
1713347796522,EDS 204R,A01,507319,Halter; Christopher P.,3,0,30,27
1713347796522,EDS 204R,B01,507331,Heinzman; Erica M.,28,0,30,2
1713347797547,EDS 206R,A00,507332,Staff,4,0,30,26
1713347797547,EDS 206R,B00,507343,Staff,28,0,30,2
1713347798578,EDS 250,A00,507344,Hemans; Patricia Ann Benitez,36,0,40,4
1713347799604,EDS 281,A00,507345,Daly; Alan J.,18,0,18,0
1713347800629,EDS 284,A00,507350,Daly; Alan J.,16,0,16,0
1713347801657,EDS 286,A00,507359,Fine; Sarah,18,0,18,0
1713347802682,EDS 289C,A01,507361,Daly; Alan J.,18,0,18,0
1713347803707,EDS 290,A00,507366,Hofstetter; Carolyn,15,0,15,0
1713347804735,LIGM 5A,A00,507421,Fischer-Grunski; Eva K,20,0,20,0
1713347805765,LIGM 5B,A00,507423,Fischer-Grunski; Eva K,20,0,20,0
1713347806795,LIGM 5C,A00,507425,Fischer-Grunski; Eva K,20,0,20,0
1713347807826,LIIT 5AS,A00,507427,Carnelos; Chiara,20,0,20,0
1713347808851,LIIT 5BS,A00,507430,Carnelos; Chiara,20,0,20,0
1713347809881,LIIT 5CS,A00,507432,Carnelos; Chiara,20,0,20,0
1713347810913,LISP 5A,A00,507541,Munoz Sanchez; Alicia,17,0,20,3
1713347811938,LISP 5B,A00,507671,Munoz Sanchez; Alicia,15,0,20,5
1713347813019,LISP 5C,A00,507696,Munoz Sanchez; Alicia,15,0,20,5
1713347814045,MAE 197,001,528363,Boechler; Nicholas Sebastia,9998,0,9999,1
1713347815075,MATH 197,001,523477,Kedlaya; Kiran S.,9999,0,9999,0
1713347815075,MATH 197,002,563811,Zhang; Danna,9999,0,9999,0
1713347816105,MCWP 40R,A00,518780,Staff,20,0,20,0
1713347816105,MCWP 40R,B00,518781,Staff,19,0,20,1
1713347816105,MCWP 40R,C00,518783,Staff,19,0,20,1
1713347817136,MCWP 50R,A00,518791,Staff,20,0,20,0
1713347817136,MCWP 50R,B00,518792,Staff,17,0,20,3
1713347817136,MCWP 50R,C00,518793,Staff,19,0,20,1
1713347817136,MCWP 50R,D00,518794,Staff,16,0,20,4
1713347817136,MCWP 50R,E00,518795,Staff,16,0,20,4
1713347817136,MCWP 50R,F00,518796,Staff,19,0,20,1
1713347817136,MCWP 50R,G00,518797,Staff,19,0,20,1
1713347818163,MMW 12R,A01,514034,Herbst; Matthew,15,0,16,1
1713347818163,MMW 12R,A02,514035,Herbst; Matthew,16,0,16,0
1713347819192,MMW 13R,A01,514037,Staff,12,0,16,4
1713347819192,MMW 13R,A02,514039,Staff,16,0,16,0
1713347821250,SIO 295LS,A00,523233,Staff,18,0,30,12
1713347822276,SIO 295S,A00,523232,Staff,18,0,30,12
1713347823301,SOCI 117,A01,494376,Staff,1,0,5,4
1713347824327,WES 237B,A00,494380,Staff,19,0,20,1
1713347826407,AESE 279B,A00,494370,Wade; Jon P,33,0,33,0
1713347827433,ANAR 135S,A00,494369,Braswell; Geoffrey E.,0,0,0,0
1713347828464,CAT 124RS,A01,519847,Geibel; William,17,0,20,3
1713347829492,CAT 125RS,A01,515971,Geibel; William,17,0,20,3
1713347830521,CLRE 250,A00,511389,Morris; Sheldon,9996,0,9999,3
1713347831547,CLRE 251,A00,507176,Mehta; Ravindra L.,9996,0,9999,3
1713347831547,CLRE 251,B00,511410,Mehta; Ravindra L.,9998,0,9999,1
1713347832574,CLRE 252,A00,507189,Cuomo; Raphael Eduardo,9998,0,9999,1
1713347833603,CLRE 253,A00,507199,Vaida; Florin,9997,0,9999,2
1713347833603,CLRE 253,B00,507202,Vaida; Florin,9999,0,9999,0
1713347834633,CLRE 259,A00,507211,Patel; Hemal,9996,0,9999,3
1713347835658,CLRE 260,A00,507221,Cuomo; Raphael Eduardo,9999,0,9999,0
1713347836684,CLRE 297,001,507242,Cuomo; Raphael Eduardo,9999,0,9999,0
1713347837711,CSE 191,A00,516875,Minnes Kemp; Mor Mia,9999,0,9999,0
1713347838741,CSS 201S,A01,494383,Staff,35,0,35,0
1713347839771,CSS 202S,A01,494387,Staff,35,0,35,0
1713347840797,EAP 100,A00,516065,Staff,9792,0,9999,207
1713347841825,ECE 45,A01,507414,Staff,51,0,60,9
1713347842856,ECE 100,A01,507416,Baghdadchi; Saharnaz,10,0,20,10
1713347842856,ECE 100,A02,507418,Baghdadchi; Saharnaz,20,0,20,0
1713347843893,ECE 111,A01,507420,Staff,38,0,50,12
1713347844919,ECE 197,001,548057,Sievenpiper; Daniel F.,9998,0,9999,1
1713347845945,EDS 115,A00,507243,Choi; Bailey Miyeon,28,0,28,0
1713347846971,EDS 117,A01,494379,Staff,23,0,25,2
1713347848000,EDS 125,A00,507246,Hopkins; Megan Beth,29,0,30,1
1713347849025,EDS 128A,A01,507264,Fargason; Sharon Gayle,26,0,26,0
1713347850050,EDS 128B,A01,507293,Pappas; Elizabeth,30,0,30,0
1713347851081,EDS 139,A00,507294,Fargason; Sharon Gayle,30,0,30,0
1713347851081,EDS 139,B00,507313,Pappas; Elizabeth,30,0,30,0
1713347852107,EDS 201,A00,507315,Staff,26,0,30,4
1713347853135,EDS 203,A01,507317,Halter; Christopher P.,26,0,30,4
1713347854164,EDS 204R,A01,507319,Halter; Christopher P.,3,0,30,27
1713347854164,EDS 204R,B01,507331,Heinzman; Erica M.,28,0,30,2
1713347855190,EDS 206R,A00,507332,Staff,4,0,30,26
1713347855190,EDS 206R,B00,507343,Staff,28,0,30,2
1713347856218,EDS 250,A00,507344,Hemans; Patricia Ann Benitez,36,0,40,4
1713347857249,EDS 281,A00,507345,Daly; Alan J.,18,0,18,0
1713347858275,EDS 284,A00,507350,Daly; Alan J.,16,0,16,0
1713347859306,EDS 286,A00,507359,Fine; Sarah,18,0,18,0
1713347860332,EDS 289C,A01,507361,Daly; Alan J.,18,0,18,0
1713347861358,EDS 290,A00,507366,Hofstetter; Carolyn,15,0,15,0
1713347862386,LIGM 5A,A00,507421,Fischer-Grunski; Eva K,20,0,20,0
1713347863415,LIGM 5B,A00,507423,Fischer-Grunski; Eva K,20,0,20,0
1713347864445,LIGM 5C,A00,507425,Fischer-Grunski; Eva K,20,0,20,0
1713347865476,LIIT 5AS,A00,507427,Carnelos; Chiara,20,0,20,0
1713347866502,LIIT 5BS,A00,507430,Carnelos; Chiara,20,0,20,0
1713347867529,LIIT 5CS,A00,507432,Carnelos; Chiara,20,0,20,0
1713347868559,LISP 5A,A00,507541,Munoz Sanchez; Alicia,17,0,20,3
1713347869588,LISP 5B,A00,507671,Munoz Sanchez; Alicia,15,0,20,5
1713347870617,LISP 5C,A00,507696,Munoz Sanchez; Alicia,15,0,20,5
1713347871648,MAE 197,001,528363,Boechler; Nicholas Sebastia,9998,0,9999,1
1713347872673,MATH 197,001,523477,Kedlaya; Kiran S.,9999,0,9999,0
1713347872673,MATH 197,002,563811,Zhang; Danna,9999,0,9999,0
1713347873706,MCWP 40R,A00,518780,Staff,20,0,20,0
1713347873706,MCWP 40R,B00,518781,Staff,19,0,20,1
1713347873706,MCWP 40R,C00,518783,Staff,19,0,20,1
1713347874738,MCWP 50R,A00,518791,Staff,20,0,20,0
1713347874738,MCWP 50R,B00,518792,Staff,17,0,20,3
1713347874738,MCWP 50R,C00,518793,Staff,19,0,20,1
1713347874738,MCWP 50R,D00,518794,Staff,16,0,20,4
1713347874738,MCWP 50R,E00,518795,Staff,16,0,20,4
1713347874738,MCWP 50R,F00,518796,Staff,19,0,20,1
1713347874738,MCWP 50R,G00,518797,Staff,19,0,20,1
1713347875766,MMW 12R,A01,514034,Herbst; Matthew,15,0,16,1
1713347875766,MMW 12R,A02,514035,Herbst; Matthew,16,0,16,0
1713347876790,MMW 13R,A01,514037,Staff,12,0,16,4
1713347876790,MMW 13R,A02,514039,Staff,16,0,16,0
1713347878840,SIO 295LS,A00,523233,Staff,18,0,30,12
1713347879865,SIO 295S,A00,523232,Staff,18,0,30,12
1713347880890,SOCI 117,A01,494376,Staff,1,0,5,4
1713347881916,WES 237B,A00,494380,Staff,19,0,20,1
1713347883989,AESE 279B,A00,494370,Wade; Jon P,33,0,33,0
1713347885020,ANAR 135S,A00,494369,Braswell; Geoffrey E.,0,0,0,0
1713347886050,CAT 124RS,A01,519847,Geibel; William,17,0,20,3
1713347887075,CAT 125RS,A01,515971,Geibel; William,17,0,20,3
1713347888104,CLRE 250,A00,511389,Morris; Sheldon,9996,0,9999,3
1713347889136,CLRE 251,A00,507176,Mehta; Ravindra L.,9996,0,9999,3
1713347889136,CLRE 251,B00,511410,Mehta; Ravindra L.,9998,0,9999,1
1713347890164,CLRE 252,A00,507189,Cuomo; Raphael Eduardo,9998,0,9999,1
1713347891193,CLRE 253,A00,507199,Vaida; Florin,9997,0,9999,2
1713347891193,CLRE 253,B00,507202,Vaida; Florin,9999,0,9999,0
1713347892220,CLRE 259,A00,507211,Patel; Hemal,9996,0,9999,3
1713347893247,CLRE 260,A00,507221,Cuomo; Raphael Eduardo,9999,0,9999,0
1713347894274,CLRE 297,001,507242,Cuomo; Raphael Eduardo,9999,0,9999,0
1713347895304,CSE 191,A00,516875,Minnes Kemp; Mor Mia,9999,0,9999,0
1713347896330,CSS 201S,A01,494383,Staff,35,0,35,0
1713347897355,CSS 202S,A01,494387,Staff,35,0,35,0
1713347898383,EAP 100,A00,516065,Staff,9792,0,9999,207
1713347899409,ECE 45,A01,507414,Staff,51,0,60,9
1713347900442,ECE 100,A01,507416,Baghdadchi; Saharnaz,10,0,20,10
1713347900442,ECE 100,A02,507418,Baghdadchi; Saharnaz,20,0,20,0
1713347901468,ECE 111,A01,507420,Staff,38,0,50,12
1713347902497,ECE 197,001,548057,Sievenpiper; Daniel F.,9998,0,9999,1
1713347903528,EDS 115,A00,507243,Choi; Bailey Miyeon,28,0,28,0
1713347904553,EDS 117,A01,494379,Staff,23,0,25,2
1713347905579,EDS 125,A00,507246,Hopkins; Megan Beth,29,0,30,1
1713347906608,EDS 128A,A01,507264,Fargason; Sharon Gayle,26,0,26,0
1713347907634,EDS 128B,A01,507293,Pappas; Elizabeth,30,0,30,0
1713347908659,EDS 139,A00,507294,Fargason; Sharon Gayle,30,0,30,0
1713347908659,EDS 139,B00,507313,Pappas; Elizabeth,30,0,30,0
1713347909684,EDS 201,A00,507315,Staff,26,0,30,4
1713347910714,EDS 203,A01,507317,Halter; Christopher P.,26,0,30,4
1713347911740,EDS 204R,A01,507319,Halter; Christopher P.,3,0,30,27
1713347911740,EDS 204R,B01,507331,Heinzman; Erica M.,28,0,30,2
1713347912767,EDS 206R,A00,507332,Staff,4,0,30,26
1713347912767,EDS 206R,B00,507343,Staff,28,0,30,2
1713347913792,EDS 250,A00,507344,Hemans; Patricia Ann Benitez,36,0,40,4
1713347914822,EDS 281,A00,507345,Daly; Alan J.,18,0,18,0
1713347915847,EDS 284,A00,507350,Daly; Alan J.,16,0,16,0
1713347916940,EDS 286,A00,507359,Fine; Sarah,18,0,18,0
1713347917969,EDS 289C,A01,507361,Daly; Alan J.,18,0,18,0
1713347918999,EDS 290,A00,507366,Hofstetter; Carolyn,15,0,15,0
1713347920031,LIGM 5A,A00,507421,Fischer-Grunski; Eva K,20,0,20,0
1713347921057,LIGM 5B,A00,507423,Fischer-Grunski; Eva K,20,0,20,0
1713347922084,LIGM 5C,A00,507425,Fischer-Grunski; Eva K,20,0,20,0
1713347923110,LIIT 5AS,A00,507427,Carnelos; Chiara,20,0,20,0
1713347924135,LIIT 5BS,A00,507430,Carnelos; Chiara,20,0,20,0
1713347925161,LIIT 5CS,A00,507432,Carnelos; Chiara,20,0,20,0
1713347926191,LISP 5A,A00,507541,Munoz Sanchez; Alicia,17,0,20,3
1713347927222,LISP 5B,A00,507671,Munoz Sanchez; Alicia,15,0,20,5
1713347928248,LISP 5C,A00,507696,Munoz Sanchez; Alicia,15,0,20,5
1713347929273,MAE 197,001,528363,Boechler; Nicholas Sebastia,9998,0,9999,1
1713347930299,MATH 197,001,523477,Kedlaya; Kiran S.,9999,0,9999,0
1713347930299,MATH 197,002,563811,Zhang; Danna,9999,0,9999,0
1713347931325,MCWP 40R,A00,518780,Staff,20,0,20,0
1713347931325,MCWP 40R,B00,518781,Staff,19,0,20,1
1713347931325,MCWP 40R,C00,518783,Staff,19,0,20,1
1713347932355,MCWP 50R,A00,518791,Staff,20,0,20,0
1713347932355,MCWP 50R,B00,518792,Staff,17,0,20,3
1713347932355,MCWP 50R,C00,518793,Staff,19,0,20,1
1713347932355,MCWP 50R,D00,518794,Staff,16,0,20,4
1713347932355,MCWP 50R,E00,518795,Staff,16,0,20,4
1713347932355,MCWP 50R,F00,518796,Staff,19,0,20,1
1713347932355,MCWP 50R,G00,518797,Staff,19,0,20,1
1713347933382,MMW 12R,A01,514034,Herbst; Matthew,15,0,16,1
1713347933382,MMW 12R,A02,514035,Herbst; Matthew,16,0,16,0
1713347934407,MMW 13R,A01,514037,Staff,12,0,16,4
1713347934407,MMW 13R,A02,514039,Staff,16,0,16,0
1713347936458,SIO 295LS,A00,523233,Staff,18,0,30,12
1713347937482,SIO 295S,A00,523232,Staff,18,0,30,12
1713347938508,SOCI 117,A01,494376,Staff,1,0,5,4
1713347939533,WES 237B,A00,494380,Staff,19,0,20,1
1713347941606,AESE 279B,A00,494370,Wade; Jon P,33,0,33,0
1713347942632,ANAR 135S,A00,494369,Braswell; Geoffrey E.,0,0,0,0
1713347943663,CAT 124RS,A01,519847,Geibel; William,17,0,20,3
1713347944692,CAT 125RS,A01,515971,Geibel; William,17,0,20,3
1713347945718,CLRE 250,A00,511389,Morris; Sheldon,9996,0,9999,3
1713347946751,CLRE 251,A00,507176,Mehta; Ravindra L.,9996,0,9999,3
1713347946751,CLRE 251,B00,511410,Mehta; Ravindra L.,9998,0,9999,1
1713347947781,CLRE 252,A00,507189,Cuomo; Raphael Eduardo,9998,0,9999,1
1713347948811,CLRE 253,A00,507199,Vaida; Florin,9997,0,9999,2
1713347948811,CLRE 253,B00,507202,Vaida; Florin,9999,0,9999,0
1713347949836,CLRE 259,A00,507211,Patel; Hemal,9996,0,9999,3
1713347950864,CLRE 260,A00,507221,Cuomo; Raphael Eduardo,9999,0,9999,0
1713347951887,CLRE 297,001,507242,Cuomo; Raphael Eduardo,9999,0,9999,0
1713347952912,CSE 191,A00,516875,Minnes Kemp; Mor Mia,9999,0,9999,0
1713347953938,CSS 201S,A01,494383,Staff,35,0,35,0
1713347954964,CSS 202S,A01,494387,Staff,35,0,35,0
1713347955988,EAP 100,A00,516065,Staff,9792,0,9999,207
1713347957013,ECE 45,A01,507414,Staff,51,0,60,9
1713347958039,ECE 100,A01,507416,Baghdadchi; Saharnaz,10,0,20,10
1713347958039,ECE 100,A02,507418,Baghdadchi; Saharnaz,20,0,20,0
1713347959064,ECE 111,A01,507420,Staff,38,0,50,12
1713347960091,ECE 197,001,548057,Sievenpiper; Daniel F.,9998,0,9999,1
1713347961121,EDS 115,A00,507243,Choi; Bailey Miyeon,28,0,28,0
1713347962146,EDS 117,A01,494379,Staff,23,0,25,2
1713347963175,EDS 125,A00,507246,Hopkins; Megan Beth,29,0,30,1
1713347964206,EDS 128A,A01,507264,Fargason; Sharon Gayle,26,0,26,0
1713347965231,EDS 128B,A01,507293,Pappas; Elizabeth,30,0,30,0
1713347966258,EDS 139,A00,507294,Fargason; Sharon Gayle,30,0,30,0
1713347966258,EDS 139,B00,507313,Pappas; Elizabeth,30,0,30,0
1713347967284,EDS 201,A00,507315,Staff,26,0,30,4
1713347968310,EDS 203,A01,507317,Halter; Christopher P.,26,0,30,4
1713347969340,EDS 204R,A01,507319,Halter; Christopher P.,3,0,30,27
1713347969340,EDS 204R,B01,507331,Heinzman; Erica M.,28,0,30,2
1713347970366,EDS 206R,A00,507332,Staff,4,0,30,26
1713347970366,EDS 206R,B00,507343,Staff,28,0,30,2
1713347971391,EDS 250,A00,507344,Hemans; Patricia Ann Benitez,36,0,40,4
1713347972416,EDS 281,A00,507345,Daly; Alan J.,18,0,18,0
1713347973441,EDS 284,A00,507350,Daly; Alan J.,16,0,16,0
1713347974466,EDS 286,A00,507359,Fine; Sarah,18,0,18,0
1713347975490,EDS 289C,A01,507361,Daly; Alan J.,18,0,18,0
1713347976520,EDS 290,A00,507366,Hofstetter; Carolyn,15,0,15,0
1713347977547,LIGM 5A,A00,507421,Fischer-Grunski; Eva K,20,0,20,0
1713347978572,LIGM 5B,A00,507423,Fischer-Grunski; Eva K,20,0,20,0
1713347979598,LIGM 5C,A00,507425,Fischer-Grunski; Eva K,20,0,20,0
1713347980624,LIIT 5AS,A00,507427,Carnelos; Chiara,20,0,20,0
1713347981653,LIIT 5BS,A00,507430,Carnelos; Chiara,20,0,20,0
1713347982681,LIIT 5CS,A00,507432,Carnelos; Chiara,20,0,20,0
1713347983708,LISP 5A,A00,507541,Munoz Sanchez; Alicia,17,0,20,3
1713347984733,LISP 5B,A00,507671,Munoz Sanchez; Alicia,15,0,20,5
1713347985758,LISP 5C,A00,507696,Munoz Sanchez; Alicia,15,0,20,5
1713347986788,MAE 197,001,528363,Boechler; Nicholas Sebastia,9998,0,9999,1
1713347987820,MATH 197,001,523477,Kedlaya; Kiran S.,9999,0,9999,0
1713347987820,MATH 197,002,563811,Zhang; Danna,9999,0,9999,0
1713347988848,MCWP 40R,A00,518780,Staff,20,0,20,0
1713347988848,MCWP 40R,B00,518781,Staff,19,0,20,1
1713347988848,MCWP 40R,C00,518783,Staff,19,0,20,1
1713347989875,MCWP 50R,A00,518791,Staff,20,0,20,0
1713347989875,MCWP 50R,B00,518792,Staff,17,0,20,3
1713347989875,MCWP 50R,C00,518793,Staff,19,0,20,1
1713347989875,MCWP 50R,D00,518794,Staff,16,0,20,4
1713347989875,MCWP 50R,E00,518795,Staff,16,0,20,4
1713347989875,MCWP 50R,F00,518796,Staff,19,0,20,1
1713347989875,MCWP 50R,G00,518797,Staff,19,0,20,1
1713347990905,MMW 12R,A01,514034,Herbst; Matthew,15,0,16,1
1713347990905,MMW 12R,A02,514035,Herbst; Matthew,16,0,16,0
1713347991930,MMW 13R,A01,514037,Staff,12,0,16,4
1713347991930,MMW 13R,A02,514039,Staff,16,0,16,0
1713347993982,SIO 295LS,A00,523233,Staff,18,0,30,12
1713347995006,SIO 295S,A00,523232,Staff,18,0,30,12
1713347996033,SOCI 117,A01,494376,Staff,1,0,5,4
1713347997065,WES 237B,A00,494380,Staff,19,0,20,1
1713347999145,AESE 279B,A00,494370,Wade; Jon P,33,0,33,0
1713348000176,ANAR 135S,A00,494369,Braswell; Geoffrey E.,0,0,0,0
1713348001209,CAT 124RS,A01,519847,Geibel; William,17,0,20,3
1713348002235,CAT 125RS,A01,515971,Geibel; William,17,0,20,3
1713348003261,CLRE 250,A00,511389,Morris; Sheldon,9996,0,9999,3
1713348004290,CLRE 251,A00,507176,Mehta; Ravindra L.,9996,0,9999,3
1713348004290,CLRE 251,B00,511410,Mehta; Ravindra L.,9998,0,9999,1
1713348005316,CLRE 252,A00,507189,Cuomo; Raphael Eduardo,9998,0,9999,1
1713348006340,CLRE 253,A00,507199,Vaida; Florin,9997,0,9999,2
1713348006340,CLRE 253,B00,507202,Vaida; Florin,9999,0,9999,0
1713348007371,CLRE 259,A00,507211,Patel; Hemal,9996,0,9999,3
1713348008402,CLRE 260,A00,507221,Cuomo; Raphael Eduardo,9999,0,9999,0
1713348009426,CLRE 297,001,507242,Cuomo; Raphael Eduardo,9999,0,9999,0
1713348010453,CSE 191,A00,516875,Minnes Kemp; Mor Mia,9999,0,9999,0
1713348011481,CSS 201S,A01,494383,Staff,35,0,35,0
1713348012505,CSS 202S,A01,494387,Staff,35,0,35,0
1713348013531,EAP 100,A00,516065,Staff,9792,0,9999,207
1713348014559,ECE 45,A01,507414,Staff,51,0,60,9
1713348015584,ECE 100,A01,507416,Baghdadchi; Saharnaz,10,0,20,10
1713348015584,ECE 100,A02,507418,Baghdadchi; Saharnaz,20,0,20,0
1713348016610,ECE 111,A01,507420,Staff,38,0,50,12
1713348017639,ECE 197,001,548057,Sievenpiper; Daniel F.,9998,0,9999,1
1713348018668,EDS 115,A00,507243,Choi; Bailey Miyeon,28,0,28,0
1713348019695,EDS 117,A01,494379,Staff,23,0,25,2
1713348020775,EDS 125,A00,507246,Hopkins; Megan Beth,29,0,30,1
1713348021802,EDS 128A,A01,507264,Fargason; Sharon Gayle,26,0,26,0
1713348022831,EDS 128B,A01,507293,Pappas; Elizabeth,30,0,30,0
1713348023859,EDS 139,A00,507294,Fargason; Sharon Gayle,30,0,30,0
1713348023859,EDS 139,B00,507313,Pappas; Elizabeth,30,0,30,0
1713348024887,EDS 201,A00,507315,Staff,26,0,30,4
1713348025913,EDS 203,A01,507317,Halter; Christopher P.,26,0,30,4
1713348026939,EDS 204R,A01,507319,Halter; Christopher P.,3,0,30,27
1713348026939,EDS 204R,B01,507331,Heinzman; Erica M.,28,0,30,2
1713348027964,EDS 206R,A00,507332,Staff,4,0,30,26
1713348027964,EDS 206R,B00,507343,Staff,28,0,30,2
1713348028991,EDS 250,A00,507344,Hemans; Patricia Ann Benitez,36,0,40,4
1713348030021,EDS 281,A00,507345,Daly; Alan J.,18,0,18,0
1713348031044,EDS 284,A00,507350,Daly; Alan J.,16,0,16,0
1713348032073,EDS 286,A00,507359,Fine; Sarah,18,0,18,0
1713348033097,EDS 289C,A01,507361,Daly; Alan J.,18,0,18,0
1713348034133,EDS 290,A00,507366,Hofstetter; Carolyn,15,0,15,0
1713348035162,LIGM 5A,A00,507421,Fischer-Grunski; Eva K,20,0,20,0
1713348036189,LIGM 5B,A00,507423,Fischer-Grunski; Eva K,20,0,20,0
1713348037214,LIGM 5C,A00,507425,Fischer-Grunski; Eva K,20,0,20,0
1713348038244,LIIT 5AS,A00,507427,Carnelos; Chiara,20,0,20,0
1713348039269,LIIT 5BS,A00,507430,Carnelos; Chiara,20,0,20,0
1713348040295,LIIT 5CS,A00,507432,Carnelos; Chiara,20,0,20,0
1713348041326,LISP 5A,A00,507541,Munoz Sanchez; Alicia,17,0,20,3
1713348042350,LISP 5B,A00,507671,Munoz Sanchez; Alicia,15,0,20,5
1713348043375,LISP 5C,A00,507696,Munoz Sanchez; Alicia,15,0,20,5
1713348044402,MAE 197,001,528363,Boechler; Nicholas Sebastia,9998,0,9999,1
1713348045432,MATH 197,001,523477,Kedlaya; Kiran S.,9999,0,9999,0
1713348045432,MATH 197,002,563811,Zhang; Danna,9999,0,9999,0
1713348046459,MCWP 40R,A00,518780,Staff,20,0,20,0
1713348046459,MCWP 40R,B00,518781,Staff,19,0,20,1
1713348046459,MCWP 40R,C00,518783,Staff,19,0,20,1
1713348047490,MCWP 50R,A00,518791,Staff,20,0,20,0
1713348047490,MCWP 50R,B00,518792,Staff,17,0,20,3
1713348047490,MCWP 50R,C00,518793,Staff,19,0,20,1
1713348047490,MCWP 50R,D00,518794,Staff,16,0,20,4
1713348047490,MCWP 50R,E00,518795,Staff,16,0,20,4
1713348047490,MCWP 50R,F00,518796,Staff,19,0,20,1
1713348047490,MCWP 50R,G00,518797,Staff,19,0,20,1
1713348048515,MMW 12R,A01,514034,Herbst; Matthew,15,0,16,1
1713348048515,MMW 12R,A02,514035,Herbst; Matthew,16,0,16,0
1713348049544,MMW 13R,A01,514037,Staff,12,0,16,4
1713348049544,MMW 13R,A02,514039,Staff,16,0,16,0
1713348051596,SIO 295LS,A00,523233,Staff,18,0,30,12
1713348052623,SIO 295S,A00,523232,Staff,18,0,30,12
1713348053648,SOCI 117,A01,494376,Staff,1,0,5,4
1713348054674,WES 237B,A00,494380,Staff,19,0,20,1
1713348056749,AESE 279B,A00,494370,Wade; Jon P,33,0,33,0
1713348057777,ANAR 135S,A00,494369,Braswell; Geoffrey E.,0,0,0,0
1713348058810,CAT 124RS,A01,519847,Geibel; William,17,0,20,3
1713348059838,CAT 125RS,A01,515971,Geibel; William,17,0,20,3
1713348060871,CLRE 250,A00,511389,Morris; Sheldon,9996,0,9999,3
1713348061905,CLRE 251,A00,507176,Mehta; Ravindra L.,9996,0,9999,3
1713348061905,CLRE 251,B00,511410,Mehta; Ravindra L.,9998,0,9999,1
1713348062932,CLRE 252,A00,507189,Cuomo; Raphael Eduardo,9998,0,9999,1
1713348063959,CLRE 253,A00,507199,Vaida; Florin,9997,0,9999,2
1713348063959,CLRE 253,B00,507202,Vaida; Florin,9999,0,9999,0
1713348064985,CLRE 259,A00,507211,Patel; Hemal,9996,0,9999,3
1713348066013,CLRE 260,A00,507221,Cuomo; Raphael Eduardo,9999,0,9999,0
1713348067039,CLRE 297,001,507242,Cuomo; Raphael Eduardo,9999,0,9999,0
1713348068069,CSE 191,A00,516875,Minnes Kemp; Mor Mia,9999,0,9999,0
1713348069101,CSS 201S,A01,494383,Staff,35,0,35,0
1713348070128,CSS 202S,A01,494387,Staff,35,0,35,0
1713348071157,EAP 100,A00,516065,Staff,9792,0,9999,207
1713348072188,ECE 45,A01,507414,Staff,51,0,60,9
1713348073213,ECE 100,A01,507416,Baghdadchi; Saharnaz,10,0,20,10
1713348073213,ECE 100,A02,507418,Baghdadchi; Saharnaz,20,0,20,0
1713348074243,ECE 111,A01,507420,Staff,38,0,50,12
1713348075271,ECE 197,001,548057,Sievenpiper; Daniel F.,9998,0,9999,1
1713348076299,EDS 115,A00,507243,Choi; Bailey Miyeon,28,0,28,0
1713348077326,EDS 117,A01,494379,Staff,23,0,25,2
1713348078357,EDS 125,A00,507246,Hopkins; Megan Beth,29,0,30,1
1713348079382,EDS 128A,A01,507264,Fargason; Sharon Gayle,26,0,26,0
1713348080412,EDS 128B,A01,507293,Pappas; Elizabeth,30,0,30,0
1713348081437,EDS 139,A00,507294,Fargason; Sharon Gayle,30,0,30,0
1713348081437,EDS 139,B00,507313,Pappas; Elizabeth,30,0,30,0
1713348082463,EDS 201,A00,507315,Staff,26,0,30,4
1713348083494,EDS 203,A01,507317,Halter; Christopher P.,26,0,30,4
1713348084524,EDS 204R,A01,507319,Halter; Christopher P.,3,0,30,27
1713348084524,EDS 204R,B01,507331,Heinzman; Erica M.,28,0,30,2
1713348085549,EDS 206R,A00,507332,Staff,4,0,30,26
1713348085549,EDS 206R,B00,507343,Staff,28,0,30,2
1713348086574,EDS 250,A00,507344,Hemans; Patricia Ann Benitez,36,0,40,4
1713348087603,EDS 281,A00,507345,Daly; Alan J.,18,0,18,0
1713348088627,EDS 284,A00,507350,Daly; Alan J.,16,0,16,0
1713348089659,EDS 286,A00,507359,Fine; Sarah,18,0,18,0
1713348090688,EDS 289C,A01,507361,Daly; Alan J.,18,0,18,0
1713348091716,EDS 290,A00,507366,Hofstetter; Carolyn,15,0,15,0
1713348092746,LIGM 5A,A00,507421,Fischer-Grunski; Eva K,20,0,20,0
1713348093775,LIGM 5B,A00,507423,Fischer-Grunski; Eva K,20,0,20,0
1713348094801,LIGM 5C,A00,507425,Fischer-Grunski; Eva K,20,0,20,0
1713348095832,LIIT 5AS,A00,507427,Carnelos; Chiara,20,0,20,0
1713348096862,LIIT 5BS,A00,507430,Carnelos; Chiara,20,0,20,0
1713348097887,LIIT 5CS,A00,507432,Carnelos; Chiara,20,0,20,0
1713348098913,LISP 5A,A00,507541,Munoz Sanchez; Alicia,17,0,20,3
1713348099939,LISP 5B,A00,507671,Munoz Sanchez; Alicia,15,0,20,5
1713348100965,LISP 5C,A00,507696,Munoz Sanchez; Alicia,15,0,20,5
1713348101991,MAE 197,001,528363,Boechler; Nicholas Sebastia,9998,0,9999,1
1713348103023,MATH 197,001,523477,Kedlaya; Kiran S.,9999,0,9999,0
1713348103023,MATH 197,002,563811,Zhang; Danna,9999,0,9999,0
1713348104054,MCWP 40R,A00,518780,Staff,20,0,20,0
1713348104054,MCWP 40R,B00,518781,Staff,19,0,20,1
1713348104054,MCWP 40R,C00,518783,Staff,19,0,20,1
1713348105079,MCWP 50R,A00,518791,Staff,20,0,20,0
1713348105079,MCWP 50R,B00,518792,Staff,17,0,20,3
1713348105079,MCWP 50R,C00,518793,Staff,19,0,20,1
1713348105079,MCWP 50R,D00,518794,Staff,16,0,20,4
1713348105079,MCWP 50R,E00,518795,Staff,16,0,20,4
1713348105079,MCWP 50R,F00,518796,Staff,19,0,20,1
1713348105079,MCWP 50R,G00,518797,Staff,19,0,20,1
1713348106105,MMW 12R,A01,514034,Herbst; Matthew,15,0,16,1
1713348106105,MMW 12R,A02,514035,Herbst; Matthew,16,0,16,0
1713348107135,MMW 13R,A01,514037,Staff,12,0,16,4
1713348107135,MMW 13R,A02,514039,Staff,16,0,16,0
1713348109185,SIO 295LS,A00,523233,Staff,18,0,30,12
1713348110219,SIO 295S,A00,523232,Staff,18,0,30,12
1713348111243,SOCI 117,A01,494376,Staff,1,0,5,4
1713348112270,WES 237B,A00,494380,Staff,19,0,20,1
1713348114342,AESE 279B,A00,494370,Wade; Jon P,33,0,33,0
1713348115368,ANAR 135S,A00,494369,Braswell; Geoffrey E.,0,0,0,0
1713348116394,CAT 124RS,A01,519847,Geibel; William,17,0,20,3
1713348117419,CAT 125RS,A01,515971,Geibel; William,17,0,20,3
1713348118449,CLRE 250,A00,511389,Morris; Sheldon,9996,0,9999,3
1713348119483,CLRE 251,A00,507176,Mehta; Ravindra L.,9996,0,9999,3
1713348119483,CLRE 251,B00,511410,Mehta; Ravindra L.,9998,0,9999,1
1713348120511,CLRE 252,A00,507189,Cuomo; Raphael Eduardo,9998,0,9999,1
1713348121541,CLRE 253,A00,507199,Vaida; Florin,9997,0,9999,2
1713348121541,CLRE 253,B00,507202,Vaida; Florin,9999,0,9999,0
1713348122568,CLRE 259,A00,507211,Patel; Hemal,9996,0,9999,3
1713348123599,CLRE 260,A00,507221,Cuomo; Raphael Eduardo,9999,0,9999,0
1713348124682,CLRE 297,001,507242,Cuomo; Raphael Eduardo,9999,0,9999,0
1713348125712,CSE 191,A00,516875,Minnes Kemp; Mor Mia,9999,0,9999,0
1713348126737,CSS 201S,A01,494383,Staff,35,0,35,0
1713348127766,CSS 202S,A01,494387,Staff,35,0,35,0
1713348128795,EAP 100,A00,516065,Staff,9792,0,9999,207
1713348129827,ECE 45,A01,507414,Staff,51,0,60,9
1713348130853,ECE 100,A01,507416,Baghdadchi; Saharnaz,10,0,20,10
1713348130853,ECE 100,A02,507418,Baghdadchi; Saharnaz,20,0,20,0
1713348131881,ECE 111,A01,507420,Staff,38,0,50,12
1713348132909,ECE 197,001,548057,Sievenpiper; Daniel F.,9998,0,9999,1
1713348133935,EDS 115,A00,507243,Choi; Bailey Miyeon,28,0,28,0
1713348134968,EDS 117,A01,494379,Staff,23,0,25,2
1713348135999,EDS 125,A00,507246,Hopkins; Megan Beth,29,0,30,1
1713348137025,EDS 128A,A01,507264,Fargason; Sharon Gayle,26,0,26,0
1713348138057,EDS 128B,A01,507293,Pappas; Elizabeth,30,0,30,0
1713348139083,EDS 139,A00,507294,Fargason; Sharon Gayle,30,0,30,0
1713348139083,EDS 139,B00,507313,Pappas; Elizabeth,30,0,30,0
1713348140108,EDS 201,A00,507315,Staff,26,0,30,4
1713348141134,EDS 203,A01,507317,Halter; Christopher P.,26,0,30,4
1713348142166,EDS 204R,A01,507319,Halter; Christopher P.,3,0,30,27
1713348142166,EDS 204R,B01,507331,Heinzman; Erica M.,28,0,30,2
1713348143191,EDS 206R,A00,507332,Staff,4,0,30,26
1713348143191,EDS 206R,B00,507343,Staff,28,0,30,2
1713348144231,EDS 250,A00,507344,Hemans; Patricia Ann Benitez,36,0,40,4
1713348145260,EDS 281,A00,507345,Daly; Alan J.,18,0,18,0
1713348146285,EDS 284,A00,507350,Daly; Alan J.,16,0,16,0
1713348147311,EDS 286,A00,507359,Fine; Sarah,18,0,18,0
1713348148342,EDS 289C,A01,507361,Daly; Alan J.,18,0,18,0
1713348149369,EDS 290,A00,507366,Hofstetter; Carolyn,15,0,15,0
1713348150396,LIGM 5A,A00,507421,Fischer-Grunski; Eva K,20,0,20,0
1713348151421,LIGM 5B,A00,507423,Fischer-Grunski; Eva K,20,0,20,0
1713348152452,LIGM 5C,A00,507425,Fischer-Grunski; Eva K,20,0,20,0
1713348153483,LIIT 5AS,A00,507427,Carnelos; Chiara,20,0,20,0
1713348154509,LIIT 5BS,A00,507430,Carnelos; Chiara,20,0,20,0
1713348155535,LIIT 5CS,A00,507432,Carnelos; Chiara,20,0,20,0
1713348156565,LISP 5A,A00,507541,Munoz Sanchez; Alicia,17,0,20,3
1713348157591,LISP 5B,A00,507671,Munoz Sanchez; Alicia,15,0,20,5
1713348158623,LISP 5C,A00,507696,Munoz Sanchez; Alicia,15,0,20,5
1713348159650,MAE 197,001,528363,Boechler; Nicholas Sebastia,9998,0,9999,1
1713348160677,MATH 197,001,523477,Kedlaya; Kiran S.,9999,0,9999,0
1713348160677,MATH 197,002,563811,Zhang; Danna,9999,0,9999,0
1713348161706,MCWP 40R,A00,518780,Staff,20,0,20,0
1713348161706,MCWP 40R,B00,518781,Staff,19,0,20,1
1713348161706,MCWP 40R,C00,518783,Staff,19,0,20,1
1713348162736,MCWP 50R,A00,518791,Staff,20,0,20,0
1713348162736,MCWP 50R,B00,518792,Staff,17,0,20,3
1713348162736,MCWP 50R,C00,518793,Staff,19,0,20,1
1713348162736,MCWP 50R,D00,518794,Staff,16,0,20,4
1713348162736,MCWP 50R,E00,518795,Staff,16,0,20,4
1713348162736,MCWP 50R,F00,518796,Staff,19,0,20,1
1713348162736,MCWP 50R,G00,518797,Staff,19,0,20,1
1713348163762,MMW 12R,A01,514034,Herbst; Matthew,15,0,16,1
1713348163762,MMW 12R,A02,514035,Herbst; Matthew,16,0,16,0
1713348164789,MMW 13R,A01,514037,Staff,12,0,16,4
1713348164789,MMW 13R,A02,514039,Staff,16,0,16,0
1713348166843,SIO 295LS,A00,523233,Staff,18,0,30,12
1713348167867,SIO 295S,A00,523232,Staff,18,0,30,12
1713348168898,SOCI 117,A01,494376,Staff,1,0,5,4
1713348169923,WES 237B,A00,494380,Staff,19,0,20,1
1713348171997,AESE 279B,A00,494370,Wade; Jon P,33,0,33,0
1713348173025,ANAR 135S,A00,494369,Braswell; Geoffrey E.,0,0,0,0
1713348174052,CAT 124RS,A01,519847,Geibel; William,17,0,20,3
1713348175078,CAT 125RS,A01,515971,Geibel; William,17,0,20,3
1713348176103,CLRE 250,A00,511389,Morris; Sheldon,9996,0,9999,3
1713348177131,CLRE 251,A00,507176,Mehta; Ravindra L.,9996,0,9999,3
1713348177131,CLRE 251,B00,511410,Mehta; Ravindra L.,9998,0,9999,1
1713348178157,CLRE 252,A00,507189,Cuomo; Raphael Eduardo,9998,0,9999,1
1713348179187,CLRE 253,A00,507199,Vaida; Florin,9997,0,9999,2
1713348179187,CLRE 253,B00,507202,Vaida; Florin,9999,0,9999,0
1713348180216,CLRE 259,A00,507211,Patel; Hemal,9996,0,9999,3
1713348181242,CLRE 260,A00,507221,Cuomo; Raphael Eduardo,9999,0,9999,0
1713348182268,CLRE 297,001,507242,Cuomo; Raphael Eduardo,9999,0,9999,0
1713348183299,CSE 191,A00,516875,Minnes Kemp; Mor Mia,9999,0,9999,0
1713348184331,CSS 201S,A01,494383,Staff,35,0,35,0
1713348185355,CSS 202S,A01,494387,Staff,35,0,35,0
1713348186384,EAP 100,A00,516065,Staff,9792,0,9999,207
1713348187415,ECE 45,A01,507414,Staff,51,0,60,9
1713348188441,ECE 100,A01,507416,Baghdadchi; Saharnaz,10,0,20,10
1713348188441,ECE 100,A02,507418,Baghdadchi; Saharnaz,20,0,20,0
1713348189470,ECE 111,A01,507420,Staff,38,0,50,12
1713348190499,ECE 197,001,548057,Sievenpiper; Daniel F.,9998,0,9999,1
1713348191530,EDS 115,A00,507243,Choi; Bailey Miyeon,28,0,28,0
1713348192556,EDS 117,A01,494379,Staff,23,0,25,2
1713348193581,EDS 125,A00,507246,Hopkins; Megan Beth,29,0,30,1
1713348194613,EDS 128A,A01,507264,Fargason; Sharon Gayle,26,0,26,0
1713348195640,EDS 128B,A01,507293,Pappas; Elizabeth,30,0,30,0
1713348196669,EDS 139,A00,507294,Fargason; Sharon Gayle,30,0,30,0
1713348196669,EDS 139,B00,507313,Pappas; Elizabeth,30,0,30,0
1713348197695,EDS 201,A00,507315,Staff,26,0,30,4
1713348198721,EDS 203,A01,507317,Halter; Christopher P.,26,0,30,4
1713348199747,EDS 204R,A01,507319,Halter; Christopher P.,3,0,30,27
1713348199747,EDS 204R,B01,507331,Heinzman; Erica M.,28,0,30,2
1713348200775,EDS 206R,A00,507332,Staff,4,0,30,26
1713348200775,EDS 206R,B00,507343,Staff,28,0,30,2
1713348201801,EDS 250,A00,507344,Hemans; Patricia Ann Benitez,36,0,40,4
1713348202832,EDS 281,A00,507345,Daly; Alan J.,18,0,18,0
1713348203870,EDS 284,A00,507350,Daly; Alan J.,16,0,16,0
1713348204900,EDS 286,A00,507359,Fine; Sarah,18,0,18,0
1713348205924,EDS 289C,A01,507361,Daly; Alan J.,18,0,18,0
1713348206949,EDS 290,A00,507366,Hofstetter; Carolyn,15,0,15,0
1713348207981,LIGM 5A,A00,507421,Fischer-Grunski; Eva K,20,0,20,0
1713348209007,LIGM 5B,A00,507423,Fischer-Grunski; Eva K,20,0,20,0
1713348210034,LIGM 5C,A00,507425,Fischer-Grunski; Eva K,20,0,20,0
1713348211065,LIIT 5AS,A00,507427,Carnelos; Chiara,20,0,20,0
1713348212095,LIIT 5BS,A00,507430,Carnelos; Chiara,20,0,20,0
1713348213120,LIIT 5CS,A00,507432,Carnelos; Chiara,20,0,20,0
1713348214172,LISP 5A,A00,507541,Munoz Sanchez; Alicia,17,0,20,3
1713348215197,LISP 5B,A00,507671,Munoz Sanchez; Alicia,15,0,20,5
1713348216224,LISP 5C,A00,507696,Munoz Sanchez; Alicia,15,0,20,5
1713348217248,MAE 197,001,528363,Boechler; Nicholas Sebastia,9998,0,9999,1
1713348218276,MATH 197,001,523477,Kedlaya; Kiran S.,9999,0,9999,0
1713348218276,MATH 197,002,563811,Zhang; Danna,9999,0,9999,0
1713348219301,MCWP 40R,A00,518780,Staff,20,0,20,0
1713348219301,MCWP 40R,B00,518781,Staff,19,0,20,1
1713348219301,MCWP 40R,C00,518783,Staff,19,0,20,1
1713348220333,MCWP 50R,A00,518791,Staff,20,0,20,0
1713348220333,MCWP 50R,B00,518792,Staff,17,0,20,3
1713348220333,MCWP 50R,C00,518793,Staff,19,0,20,1
1713348220333,MCWP 50R,D00,518794,Staff,16,0,20,4
1713348220333,MCWP 50R,E00,518795,Staff,16,0,20,4
1713348220333,MCWP 50R,F00,518796,Staff,19,0,20,1
1713348220333,MCWP 50R,G00,518797,Staff,19,0,20,1
1713348221359,MMW 12R,A01,514034,Herbst; Matthew,15,0,16,1
1713348221359,MMW 12R,A02,514035,Herbst; Matthew,16,0,16,0
1713348222388,MMW 13R,A01,514037,Staff,12,0,16,4
1713348222388,MMW 13R,A02,514039,Staff,16,0,16,0
1713348224451,SIO 295LS,A00,523233,Staff,18,0,30,12
1713348225476,SIO 295S,A00,523232,Staff,18,0,30,12
1713348226504,SOCI 117,A01,494376,Staff,1,0,5,4
1713348227567,WES 237B,A00,494380,Staff,19,0,20,1
1713348229707,AESE 279B,A00,494370,Wade; Jon P,33,0,33,0
1713348230733,ANAR 135S,A00,494369,Braswell; Geoffrey E.,0,0,0,0
1713348231762,CAT 124RS,A01,519847,Geibel; William,17,0,20,3
1713348232788,CAT 125RS,A01,515971,Geibel; William,17,0,20,3
1713348233819,CLRE 250,A00,511389,Morris; Sheldon,9996,0,9999,3
1713348234876,CLRE 251,A00,507176,Mehta; Ravindra L.,9996,0,9999,3
1713348234876,CLRE 251,B00,511410,Mehta; Ravindra L.,9998,0,9999,1
1713348235903,CLRE 252,A00,507189,Cuomo; Raphael Eduardo,9998,0,9999,1
1713348236928,CLRE 253,A00,507199,Vaida; Florin,9997,0,9999,2
1713348236928,CLRE 253,B00,507202,Vaida; Florin,9999,0,9999,0
1713348237956,CLRE 259,A00,507211,Patel; Hemal,9996,0,9999,3
1713348238986,CLRE 260,A00,507221,Cuomo; Raphael Eduardo,9999,0,9999,0
1713348240013,CLRE 297,001,507242,Cuomo; Raphael Eduardo,9999,0,9999,0
1713348241042,CSE 191,A00,516875,Minnes Kemp; Mor Mia,9999,0,9999,0
1713348242090,CSS 201S,A01,494383,Staff,35,0,35,0
1713348243118,CSS 202S,A01,494387,Staff,35,0,35,0
1713348244143,EAP 100,A00,516065,Staff,9792,0,9999,207
1713348245174,ECE 45,A01,507414,Staff,51,0,60,9
1713348246207,ECE 100,A01,507416,Baghdadchi; Saharnaz,10,0,20,10
1713348246207,ECE 100,A02,507418,Baghdadchi; Saharnaz,20,0,20,0
1713348247236,ECE 111,A01,507420,Staff,38,0,50,12
1713348248263,ECE 197,001,548057,Sievenpiper; Daniel F.,9998,0,9999,1
1713348249288,EDS 115,A00,507243,Choi; Bailey Miyeon,28,0,28,0
1713348250313,EDS 117,A01,494379,Staff,23,0,25,2
1713348251339,EDS 125,A00,507246,Hopkins; Megan Beth,29,0,30,1
1713348252365,EDS 128A,A01,507264,Fargason; Sharon Gayle,26,0,26,0
1713348253393,EDS 128B,A01,507293,Pappas; Elizabeth,30,0,30,0
1713348254419,EDS 139,A00,507294,Fargason; Sharon Gayle,30,0,30,0
1713348254419,EDS 139,B00,507313,Pappas; Elizabeth,30,0,30,0
1713348255447,EDS 201,A00,507315,Staff,26,0,30,4
1713348256477,EDS 203,A01,507317,Halter; Christopher P.,26,0,30,4
1713348257507,EDS 204R,A01,507319,Halter; Christopher P.,3,0,30,27
1713348257507,EDS 204R,B01,507331,Heinzman; Erica M.,28,0,30,2
1713348258535,EDS 206R,A00,507332,Staff,4,0,30,26
1713348258535,EDS 206R,B00,507343,Staff,28,0,30,2
1713348259560,EDS 250,A00,507344,Hemans; Patricia Ann Benitez,36,0,40,4
1713348260585,EDS 281,A00,507345,Daly; Alan J.,18,0,18,0
1713348261610,EDS 284,A00,507350,Daly; Alan J.,16,0,16,0
1713348262635,EDS 286,A00,507359,Fine; Sarah,18,0,18,0
1713348263661,EDS 289C,A01,507361,Daly; Alan J.,18,0,18,0
1713348264687,EDS 290,A00,507366,Hofstetter; Carolyn,15,0,15,0
1713348265714,LIGM 5A,A00,507421,Fischer-Grunski; Eva K,20,0,20,0
1713348266743,LIGM 5B,A00,507423,Fischer-Grunski; Eva K,20,0,20,0
1713348267772,LIGM 5C,A00,507425,Fischer-Grunski; Eva K,20,0,20,0
1713348268799,LIIT 5AS,A00,507427,Carnelos; Chiara,20,0,20,0
1713348269828,LIIT 5BS,A00,507430,Carnelos; Chiara,20,0,20,0
1713348270855,LIIT 5CS,A00,507432,Carnelos; Chiara,20,0,20,0
1713348271922,LISP 5A,A00,507541,Munoz Sanchez; Alicia,17,0,20,3
1713348272953,LISP 5B,A00,507671,Munoz Sanchez; Alicia,15,0,20,5
1713348273984,LISP 5C,A00,507696,Munoz Sanchez; Alicia,15,0,20,5
1713348275013,MAE 197,001,528363,Boechler; Nicholas Sebastia,9998,0,9999,1
1713348276040,MATH 197,001,523477,Kedlaya; Kiran S.,9999,0,9999,0
1713348276040,MATH 197,002,563811,Zhang; Danna,9999,0,9999,0
1713348277074,MCWP 40R,A00,518780,Staff,20,0,20,0
1713348277074,MCWP 40R,B00,518781,Staff,19,0,20,1
1713348277074,MCWP 40R,C00,518783,Staff,19,0,20,1
1713348278102,MCWP 50R,A00,518791,Staff,20,0,20,0
1713348278102,MCWP 50R,B00,518792,Staff,17,0,20,3
1713348278102,MCWP 50R,C00,518793,Staff,19,0,20,1
1713348278102,MCWP 50R,D00,518794,Staff,16,0,20,4
1713348278102,MCWP 50R,E00,518795,Staff,16,0,20,4
1713348278102,MCWP 50R,F00,518796,Staff,19,0,20,1
1713348278102,MCWP 50R,G00,518797,Staff,19,0,20,1
1713348279132,MMW 12R,A01,514034,Herbst; Matthew,15,0,16,1
1713348279132,MMW 12R,A02,514035,Herbst; Matthew,16,0,16,0
1713348280159,MMW 13R,A01,514037,Staff,12,0,16,4
1713348280159,MMW 13R,A02,514039,Staff,16,0,16,0
1713348282212,SIO 295LS,A00,523233,Staff,18,0,30,12
1713348283243,SIO 295S,A00,523232,Staff,18,0,30,12
1713348284276,SOCI 117,A01,494376,Staff,1,0,5,4
1713348285303,WES 237B,A00,494380,Staff,19,0,20,1
1713348287378,AESE 279B,A00,494370,Wade; Jon P,33,0,33,0
1713348288405,ANAR 135S,A00,494369,Braswell; Geoffrey E.,0,0,0,0
1713348289431,CAT 124RS,A01,519847,Geibel; William,17,0,20,3
1713348290456,CAT 125RS,A01,515971,Geibel; William,17,0,20,3
1713348291486,CLRE 250,A00,511389,Morris; Sheldon,9996,0,9999,3
1713348292672,CLRE 251,A00,507176,Mehta; Ravindra L.,9996,0,9999,3
1713348292672,CLRE 251,B00,511410,Mehta; Ravindra L.,9998,0,9999,1
1713348293703,CLRE 252,A00,507189,Cuomo; Raphael Eduardo,9998,0,9999,1
1713348294730,CLRE 253,A00,507199,Vaida; Florin,9997,0,9999,2
1713348294730,CLRE 253,B00,507202,Vaida; Florin,9999,0,9999,0
1713348295760,CLRE 259,A00,507211,Patel; Hemal,9996,0,9999,3
1713348296787,CLRE 260,A00,507221,Cuomo; Raphael Eduardo,9999,0,9999,0
1713348297818,CLRE 297,001,507242,Cuomo; Raphael Eduardo,9999,0,9999,0
1713348298845,CSE 191,A00,516875,Minnes Kemp; Mor Mia,9999,0,9999,0
1713348299873,CSS 201S,A01,494383,Staff,35,0,35,0
1713348300898,CSS 202S,A01,494387,Staff,35,0,35,0
1713348301923,EAP 100,A00,516065,Staff,9792,0,9999,207
1713348302953,ECE 45,A01,507414,Staff,51,0,60,9
1713348303987,ECE 100,A01,507416,Baghdadchi; Saharnaz,10,0,20,10
1713348303987,ECE 100,A02,507418,Baghdadchi; Saharnaz,20,0,20,0
1713348305014,ECE 111,A01,507420,Staff,38,0,50,12
1713348306045,ECE 197,001,548057,Sievenpiper; Daniel F.,9998,0,9999,1
1713348307077,EDS 115,A00,507243,Choi; Bailey Miyeon,28,0,28,0
1713348308103,EDS 117,A01,494379,Staff,23,0,25,2
1713348309129,EDS 125,A00,507246,Hopkins; Megan Beth,29,0,30,1
1713348310155,EDS 128A,A01,507264,Fargason; Sharon Gayle,26,0,26,0
1713348311185,EDS 128B,A01,507293,Pappas; Elizabeth,30,0,30,0
1713348312216,EDS 139,A00,507294,Fargason; Sharon Gayle,30,0,30,0
1713348312216,EDS 139,B00,507313,Pappas; Elizabeth,30,0,30,0
1713348313241,EDS 201,A00,507315,Staff,26,0,30,4
1713348314267,EDS 203,A01,507317,Halter; Christopher P.,26,0,30,4
1713348315293,EDS 204R,A01,507319,Halter; Christopher P.,3,0,30,27
1713348315293,EDS 204R,B01,507331,Heinzman; Erica M.,28,0,30,2
1713348316319,EDS 206R,A00,507332,Staff,4,0,30,26
1713348316319,EDS 206R,B00,507343,Staff,28,0,30,2
1713348317348,EDS 250,A00,507344,Hemans; Patricia Ann Benitez,36,0,40,4
1713348318377,EDS 281,A00,507345,Daly; Alan J.,18,0,18,0
1713348319402,EDS 284,A00,507350,Daly; Alan J.,16,0,16,0
1713348320433,EDS 286,A00,507359,Fine; Sarah,18,0,18,0
1713348321459,EDS 289C,A01,507361,Daly; Alan J.,18,0,18,0
1713348322483,EDS 290,A00,507366,Hofstetter; Carolyn,15,0,15,0
1713348323509,LIGM 5A,A00,507421,Fischer-Grunski; Eva K,20,0,20,0
1713348324537,LIGM 5B,A00,507423,Fischer-Grunski; Eva K,20,0,20,0
1713348325563,LIGM 5C,A00,507425,Fischer-Grunski; Eva K,20,0,20,0
1713348326589,LIIT 5AS,A00,507427,Carnelos; Chiara,20,0,20,0
1713348327619,LIIT 5BS,A00,507430,Carnelos; Chiara,20,0,20,0
1713348328643,LIIT 5CS,A00,507432,Carnelos; Chiara,20,0,20,0
1713348329669,LISP 5A,A00,507541,Munoz Sanchez; Alicia,17,0,20,3
1713348330694,LISP 5B,A00,507671,Munoz Sanchez; Alicia,15,0,20,5
1713348331720,LISP 5C,A00,507696,Munoz Sanchez; Alicia,15,0,20,5
1713348332815,MAE 197,001,528363,Boechler; Nicholas Sebastia,9998,0,9999,1
1713348333843,MATH 197,001,523477,Kedlaya; Kiran S.,9999,0,9999,0
1713348333843,MATH 197,002,563811,Zhang; Danna,9999,0,9999,0
1713348334892,MCWP 40R,A00,518780,Staff,20,0,20,0
1713348334892,MCWP 40R,B00,518781,Staff,19,0,20,1
1713348334892,MCWP 40R,C00,518783,Staff,19,0,20,1
1713348336016,MCWP 50R,A00,518791,Staff,20,0,20,0
1713348336016,MCWP 50R,B00,518792,Staff,17,0,20,3
1713348336016,MCWP 50R,C00,518793,Staff,19,0,20,1
1713348336016,MCWP 50R,D00,518794,Staff,16,0,20,4
1713348336016,MCWP 50R,E00,518795,Staff,16,0,20,4
1713348336016,MCWP 50R,F00,518796,Staff,19,0,20,1
1713348336016,MCWP 50R,G00,518797,Staff,19,0,20,1
1713348337043,MMW 12R,A01,514034,Herbst; Matthew,15,0,16,1
1713348337043,MMW 12R,A02,514035,Herbst; Matthew,16,0,16,0
1713348338067,MMW 13R,A01,514037,Staff,12,0,16,4
1713348338067,MMW 13R,A02,514039,Staff,16,0,16,0
1713348340126,SIO 295LS,A00,523233,Staff,18,0,30,12
1713348341151,SIO 295S,A00,523232,Staff,18,0,30,12
1713348342178,SOCI 117,A01,494376,Staff,1,0,5,4
1713348343204,WES 237B,A00,494380,Staff,19,0,20,1
1713348345275,AESE 279B,A00,494370,Wade; Jon P,33,0,33,0
1713348346300,ANAR 135S,A00,494369,Braswell; Geoffrey E.,0,0,0,0
1713348347324,CAT 124RS,A01,519847,Geibel; William,17,0,20,3
1713348348348,CAT 125RS,A01,515971,Geibel; William,17,0,20,3
1713348349377,CLRE 250,A00,511389,Morris; Sheldon,9996,0,9999,3
1713348350418,CLRE 251,A00,507176,Mehta; Ravindra L.,9996,0,9999,3
1713348350418,CLRE 251,B00,511410,Mehta; Ravindra L.,9998,0,9999,1
1713348351448,CLRE 252,A00,507189,Cuomo; Raphael Eduardo,9998,0,9999,1
1713348352496,CLRE 253,A00,507199,Vaida; Florin,9997,0,9999,2
1713348352496,CLRE 253,B00,507202,Vaida; Florin,9999,0,9999,0
1713348353523,CLRE 259,A00,507211,Patel; Hemal,9996,0,9999,3
1713348354547,CLRE 260,A00,507221,Cuomo; Raphael Eduardo,9999,0,9999,0
1713348355576,CLRE 297,001,507242,Cuomo; Raphael Eduardo,9999,0,9999,0
1713348356604,CSE 191,A00,516875,Minnes Kemp; Mor Mia,9999,0,9999,0
1713348357632,CSS 201S,A01,494383,Staff,35,0,35,0
1713348358656,CSS 202S,A01,494387,Staff,35,0,35,0
1713348359682,EAP 100,A00,516065,Staff,9792,0,9999,207
1713348360707,ECE 45,A01,507414,Staff,51,0,60,9
1713348361733,ECE 100,A01,507416,Baghdadchi; Saharnaz,10,0,20,10
1713348361733,ECE 100,A02,507418,Baghdadchi; Saharnaz,20,0,20,0
1713348362760,ECE 111,A01,507420,Staff,38,0,50,12
1713348363785,ECE 197,001,548057,Sievenpiper; Daniel F.,9998,0,9999,1
1713348364813,EDS 115,A00,507243,Choi; Bailey Miyeon,28,0,28,0
1713348365842,EDS 117,A01,494379,Staff,23,0,25,2
1713348366867,EDS 125,A00,507246,Hopkins; Megan Beth,29,0,30,1
1713348367894,EDS 128A,A01,507264,Fargason; Sharon Gayle,26,0,26,0
1713348368920,EDS 128B,A01,507293,Pappas; Elizabeth,30,0,30,0
1713348369946,EDS 139,A00,507294,Fargason; Sharon Gayle,30,0,30,0
1713348369946,EDS 139,B00,507313,Pappas; Elizabeth,30,0,30,0
1713348370971,EDS 201,A00,507315,Staff,26,0,30,4
1713348372000,EDS 203,A01,507317,Halter; Christopher P.,26,0,30,4
1713348373032,EDS 204R,A01,507319,Halter; Christopher P.,3,0,30,27
1713348373032,EDS 204R,B01,507331,Heinzman; Erica M.,28,0,30,2
1713348374058,EDS 206R,A00,507332,Staff,4,0,30,26
1713348374058,EDS 206R,B00,507343,Staff,28,0,30,2
1713348375085,EDS 250,A00,507344,Hemans; Patricia Ann Benitez,36,0,40,4
1713348376112,EDS 281,A00,507345,Daly; Alan J.,18,0,18,0
1713348377138,EDS 284,A00,507350,Daly; Alan J.,16,0,16,0
1713348378164,EDS 286,A00,507359,Fine; Sarah,18,0,18,0
1713348379189,EDS 289C,A01,507361,Daly; Alan J.,18,0,18,0
1713348380215,EDS 290,A00,507366,Hofstetter; Carolyn,15,0,15,0
1713348381243,LIGM 5A,A00,507421,Fischer-Grunski; Eva K,20,0,20,0
1713348382269,LIGM 5B,A00,507423,Fischer-Grunski; Eva K,20,0,20,0
1713348383296,LIGM 5C,A00,507425,Fischer-Grunski; Eva K,20,0,20,0
1713348384319,LIIT 5AS,A00,507427,Carnelos; Chiara,20,0,20,0
1713348385344,LIIT 5BS,A00,507430,Carnelos; Chiara,20,0,20,0
1713348386375,LIIT 5CS,A00,507432,Carnelos; Chiara,20,0,20,0
1713348387431,LISP 5A,A00,507541,Munoz Sanchez; Alicia,17,0,20,3
1713348388456,LISP 5B,A00,507671,Munoz Sanchez; Alicia,15,0,20,5
1713348389482,LISP 5C,A00,507696,Munoz Sanchez; Alicia,15,0,20,5
1713348390507,MAE 197,001,528363,Boechler; Nicholas Sebastia,9998,0,9999,1
1713348391540,MATH 197,001,523477,Kedlaya; Kiran S.,9999,0,9999,0
1713348391540,MATH 197,002,563811,Zhang; Danna,9999,0,9999,0
1713348392575,MCWP 40R,A00,518780,Staff,20,0,20,0
1713348392575,MCWP 40R,B00,518781,Staff,19,0,20,1
1713348392575,MCWP 40R,C00,518783,Staff,19,0,20,1
1713348393608,MCWP 50R,A00,518791,Staff,20,0,20,0
1713348393608,MCWP 50R,B00,518792,Staff,17,0,20,3
1713348393608,MCWP 50R,C00,518793,Staff,19,0,20,1
1713348393608,MCWP 50R,D00,518794,Staff,16,0,20,4
1713348393608,MCWP 50R,E00,518795,Staff,16,0,20,4
1713348393608,MCWP 50R,F00,518796,Staff,19,0,20,1
1713348393608,MCWP 50R,G00,518797,Staff,19,0,20,1
1713348394635,MMW 12R,A01,514034,Herbst; Matthew,15,0,16,1
1713348394635,MMW 12R,A02,514035,Herbst; Matthew,16,0,16,0
1713348395661,MMW 13R,A01,514037,Staff,12,0,16,4
1713348395661,MMW 13R,A02,514039,Staff,16,0,16,0
1713348397719,SIO 295LS,A00,523233,Staff,18,0,30,12
1713348398749,SIO 295S,A00,523232,Staff,18,0,30,12
1713348399776,SOCI 117,A01,494376,Staff,1,0,5,4
1713348400847,WES 237B,A00,494380,Staff,19,0,20,1
1713348402921,AESE 279B,A00,494370,Wade; Jon P,33,0,33,0
1713348403947,ANAR 135S,A00,494369,Braswell; Geoffrey E.,0,0,0,0
1713348404973,CAT 124RS,A01,519847,Geibel; William,17,0,20,3
1713348406003,CAT 125RS,A01,515971,Geibel; William,17,0,20,3
1713348407089,CLRE 250,A00,511389,Morris; Sheldon,9996,0,9999,3
1713348408117,CLRE 251,A00,507176,Mehta; Ravindra L.,9996,0,9999,3
1713348408117,CLRE 251,B00,511410,Mehta; Ravindra L.,9998,0,9999,1
1713348409141,CLRE 252,A00,507189,Cuomo; Raphael Eduardo,9998,0,9999,1
1713348410172,CLRE 253,A00,507199,Vaida; Florin,9997,0,9999,2
1713348410172,CLRE 253,B00,507202,Vaida; Florin,9999,0,9999,0
1713348411201,CLRE 259,A00,507211,Patel; Hemal,9996,0,9999,3
1713348412227,CLRE 260,A00,507221,Cuomo; Raphael Eduardo,9999,0,9999,0
1713348413252,CLRE 297,001,507242,Cuomo; Raphael Eduardo,9999,0,9999,0
1713348414281,CSE 191,A00,516875,Minnes Kemp; Mor Mia,9999,0,9999,0
1713348415325,CSS 201S,A01,494383,Staff,35,0,35,0
1713348416351,CSS 202S,A01,494387,Staff,35,0,35,0
1713348417379,EAP 100,A00,516065,Staff,9792,0,9999,207
1713348418422,ECE 45,A01,507414,Staff,51,0,60,9
1713348419448,ECE 100,A01,507416,Baghdadchi; Saharnaz,10,0,20,10
1713348419448,ECE 100,A02,507418,Baghdadchi; Saharnaz,20,0,20,0
1713348420476,ECE 111,A01,507420,Staff,38,0,50,12
1713348421508,ECE 197,001,548057,Sievenpiper; Daniel F.,9998,0,9999,1
1713348422533,EDS 115,A00,507243,Choi; Bailey Miyeon,28,0,28,0
1713348423568,EDS 117,A01,494379,Staff,23,0,25,2
1713348424596,EDS 125,A00,507246,Hopkins; Megan Beth,29,0,30,1
1713348425623,EDS 128A,A01,507264,Fargason; Sharon Gayle,26,0,26,0
1713348426654,EDS 128B,A01,507293,Pappas; Elizabeth,30,0,30,0
1713348427679,EDS 139,A00,507294,Fargason; Sharon Gayle,30,0,30,0
1713348427679,EDS 139,B00,507313,Pappas; Elizabeth,30,0,30,0
1713348428708,EDS 201,A00,507315,Staff,26,0,30,4
1713348429733,EDS 203,A01,507317,Halter; Christopher P.,26,0,30,4
1713348430760,EDS 204R,A01,507319,Halter; Christopher P.,3,0,30,27
1713348430760,EDS 204R,B01,507331,Heinzman; Erica M.,28,0,30,2
1713348431785,EDS 206R,A00,507332,Staff,4,0,30,26
1713348431785,EDS 206R,B00,507343,Staff,28,0,30,2
1713348432812,EDS 250,A00,507344,Hemans; Patricia Ann Benitez,36,0,40,4
1713348433841,EDS 281,A00,507345,Daly; Alan J.,18,0,18,0
1713348434868,EDS 284,A00,507350,Daly; Alan J.,16,0,16,0
1713348435895,EDS 286,A00,507359,Fine; Sarah,18,0,18,0
1713348436979,EDS 289C,A01,507361,Daly; Alan J.,18,0,18,0
1713348438008,EDS 290,A00,507366,Hofstetter; Carolyn,15,0,15,0
1713348439035,LIGM 5A,A00,507421,Fischer-Grunski; Eva K,20,0,20,0
1713348440064,LIGM 5B,A00,507423,Fischer-Grunski; Eva K,20,0,20,0
1713348441093,LIGM 5C,A00,507425,Fischer-Grunski; Eva K,20,0,20,0
1713348442119,LIIT 5AS,A00,507427,Carnelos; Chiara,20,0,20,0
1713348443145,LIIT 5BS,A00,507430,Carnelos; Chiara,20,0,20,0
1713348444175,LIIT 5CS,A00,507432,Carnelos; Chiara,20,0,20,0
1713348445201,LISP 5A,A00,507541,Munoz Sanchez; Alicia,17,0,20,3
1713348446226,LISP 5B,A00,507671,Munoz Sanchez; Alicia,15,0,20,5
1713348447256,LISP 5C,A00,507696,Munoz Sanchez; Alicia,15,0,20,5
1713348448283,MAE 197,001,528363,Boechler; Nicholas Sebastia,9998,0,9999,1
1713348449309,MATH 197,001,523477,Kedlaya; Kiran S.,9999,0,9999,0
1713348449309,MATH 197,002,563811,Zhang; Danna,9999,0,9999,0
1713348450336,MCWP 40R,A00,518780,Staff,20,0,20,0
1713348450336,MCWP 40R,B00,518781,Staff,19,0,20,1
1713348450336,MCWP 40R,C00,518783,Staff,19,0,20,1
1713348451360,MCWP 50R,A00,518791,Staff,20,0,20,0
1713348451360,MCWP 50R,B00,518792,Staff,17,0,20,3
1713348451360,MCWP 50R,C00,518793,Staff,19,0,20,1
1713348451360,MCWP 50R,D00,518794,Staff,16,0,20,4
1713348451360,MCWP 50R,E00,518795,Staff,16,0,20,4
1713348451360,MCWP 50R,F00,518796,Staff,19,0,20,1
1713348451360,MCWP 50R,G00,518797,Staff,19,0,20,1
1713348452385,MMW 12R,A01,514034,Herbst; Matthew,15,0,16,1
1713348452385,MMW 12R,A02,514035,Herbst; Matthew,16,0,16,0
1713348453413,MMW 13R,A01,514037,Staff,12,0,16,4
1713348453413,MMW 13R,A02,514039,Staff,16,0,16,0
1713348455469,SIO 295LS,A00,523233,Staff,18,0,30,12
1713348456497,SIO 295S,A00,523232,Staff,18,0,30,12
1713348457538,SOCI 117,A01,494376,Staff,1,0,5,4
1713348458567,WES 237B,A00,494380,Staff,19,0,20,1
1713348460649,AESE 279B,A00,494370,Wade; Jon P,33,0,33,0
1713348461675,ANAR 135S,A00,494369,Braswell; Geoffrey E.,0,0,0,0
1713348462701,CAT 124RS,A01,519847,Geibel; William,17,0,20,3
1713348463727,CAT 125RS,A01,515971,Geibel; William,17,0,20,3
1713348464756,CLRE 250,A00,511389,Morris; Sheldon,9996,0,9999,3
1713348465834,CLRE 251,A00,507176,Mehta; Ravindra L.,9996,0,9999,3
1713348465834,CLRE 251,B00,511410,Mehta; Ravindra L.,9998,0,9999,1
1713348466859,CLRE 252,A00,507189,Cuomo; Raphael Eduardo,9998,0,9999,1
1713348467885,CLRE 253,A00,507199,Vaida; Florin,9997,0,9999,2
1713348467885,CLRE 253,B00,507202,Vaida; Florin,9999,0,9999,0
1713348468913,CLRE 259,A00,507211,Patel; Hemal,9996,0,9999,3
1713348469940,CLRE 260,A00,507221,Cuomo; Raphael Eduardo,9999,0,9999,0
1713348470969,CLRE 297,001,507242,Cuomo; Raphael Eduardo,9999,0,9999,0
1713348471999,CSE 191,A00,516875,Minnes Kemp; Mor Mia,9999,0,9999,0
1713348473029,CSS 201S,A01,494383,Staff,35,0,35,0
1713348474055,CSS 202S,A01,494387,Staff,35,0,35,0
1713348475083,EAP 100,A00,516065,Staff,9792,0,9999,207
1713348476112,ECE 45,A01,507414,Staff,51,0,60,9
1713348477137,ECE 100,A01,507416,Baghdadchi; Saharnaz,10,0,20,10
1713348477137,ECE 100,A02,507418,Baghdadchi; Saharnaz,20,0,20,0
1713348478163,ECE 111,A01,507420,Staff,38,0,50,12
1713348479188,ECE 197,001,548057,Sievenpiper; Daniel F.,9998,0,9999,1
1713348480223,EDS 115,A00,507243,Choi; Bailey Miyeon,28,0,28,0
1713348481249,EDS 117,A01,494379,Staff,23,0,25,2
1713348482280,EDS 125,A00,507246,Hopkins; Megan Beth,29,0,30,1
1713348483310,EDS 128A,A01,507264,Fargason; Sharon Gayle,26,0,26,0
1713348484335,EDS 128B,A01,507293,Pappas; Elizabeth,30,0,30,0
1713348485360,EDS 139,A00,507294,Fargason; Sharon Gayle,30,0,30,0
1713348485360,EDS 139,B00,507313,Pappas; Elizabeth,30,0,30,0
1713348486385,EDS 201,A00,507315,Staff,26,0,30,4
1713348487437,EDS 203,A01,507317,Halter; Christopher P.,26,0,30,4
1713348488467,EDS 204R,A01,507319,Halter; Christopher P.,3,0,30,27
1713348488467,EDS 204R,B01,507331,Heinzman; Erica M.,28,0,30,2
1713348489491,EDS 206R,A00,507332,Staff,4,0,30,26
1713348489491,EDS 206R,B00,507343,Staff,28,0,30,2
1713348490520,EDS 250,A00,507344,Hemans; Patricia Ann Benitez,36,0,40,4
1713348491545,EDS 281,A00,507345,Daly; Alan J.,18,0,18,0
1713348492569,EDS 284,A00,507350,Daly; Alan J.,16,0,16,0
1713348493595,EDS 286,A00,507359,Fine; Sarah,18,0,18,0
1713348494620,EDS 289C,A01,507361,Daly; Alan J.,18,0,18,0
1713348495648,EDS 290,A00,507366,Hofstetter; Carolyn,15,0,15,0
1713348496675,LIGM 5A,A00,507421,Fischer-Grunski; Eva K,20,0,20,0
1713348497704,LIGM 5B,A00,507423,Fischer-Grunski; Eva K,20,0,20,0
1713348498734,LIGM 5C,A00,507425,Fischer-Grunski; Eva K,20,0,20,0
1713348499760,LIIT 5AS,A00,507427,Carnelos; Chiara,20,0,20,0
1713348500787,LIIT 5BS,A00,507430,Carnelos; Chiara,20,0,20,0
1713348501816,LIIT 5CS,A00,507432,Carnelos; Chiara,20,0,20,0
1713348502846,LISP 5A,A00,507541,Munoz Sanchez; Alicia,17,0,20,3
1713348503871,LISP 5B,A00,507671,Munoz Sanchez; Alicia,15,0,20,5
1713348504897,LISP 5C,A00,507696,Munoz Sanchez; Alicia,15,0,20,5
1713348505926,MAE 197,001,528363,Boechler; Nicholas Sebastia,9998,0,9999,1
1713348506953,MATH 197,001,523477,Kedlaya; Kiran S.,9999,0,9999,0
1713348506953,MATH 197,002,563811,Zhang; Danna,9999,0,9999,0
1713348507984,MCWP 40R,A00,518780,Staff,20,0,20,0
1713348507984,MCWP 40R,B00,518781,Staff,19,0,20,1
1713348507984,MCWP 40R,C00,518783,Staff,19,0,20,1
1713348509015,MCWP 50R,A00,518791,Staff,20,0,20,0
1713348509015,MCWP 50R,B00,518792,Staff,17,0,20,3
1713348509015,MCWP 50R,C00,518793,Staff,19,0,20,1
1713348509015,MCWP 50R,D00,518794,Staff,16,0,20,4
1713348509015,MCWP 50R,E00,518795,Staff,16,0,20,4
1713348509015,MCWP 50R,F00,518796,Staff,19,0,20,1
1713348509015,MCWP 50R,G00,518797,Staff,19,0,20,1
1713348510041,MMW 12R,A01,514034,Herbst; Matthew,15,0,16,1
1713348510041,MMW 12R,A02,514035,Herbst; Matthew,16,0,16,0
1713348511064,MMW 13R,A01,514037,Staff,12,0,16,4
1713348511064,MMW 13R,A02,514039,Staff,16,0,16,0
1713348513114,SIO 295LS,A00,523233,Staff,18,0,30,12
1713348514139,SIO 295S,A00,523232,Staff,18,0,30,12
1713348515164,SOCI 117,A01,494376,Staff,1,0,5,4
1713348516193,WES 237B,A00,494380,Staff,19,0,20,1
1713348518259,AESE 279B,A00,494370,Wade; Jon P,33,0,33,0
1713348519289,ANAR 135S,A00,494369,Braswell; Geoffrey E.,0,0,0,0
1713348520320,CAT 124RS,A01,519847,Geibel; William,17,0,20,3
1713348521348,CAT 125RS,A01,515971,Geibel; William,17,0,20,3
1713348522378,CLRE 250,A00,511389,Morris; Sheldon,9996,0,9999,3
1713348523406,CLRE 251,A00,507176,Mehta; Ravindra L.,9996,0,9999,3
1713348523406,CLRE 251,B00,511410,Mehta; Ravindra L.,9998,0,9999,1
1713348524435,CLRE 252,A00,507189,Cuomo; Raphael Eduardo,9998,0,9999,1
1713348525461,CLRE 253,A00,507199,Vaida; Florin,9997,0,9999,2
1713348525461,CLRE 253,B00,507202,Vaida; Florin,9999,0,9999,0
1713348526487,CLRE 259,A00,507211,Patel; Hemal,9996,0,9999,3
1713348527511,CLRE 260,A00,507221,Cuomo; Raphael Eduardo,9999,0,9999,0
1713348528537,CLRE 297,001,507242,Cuomo; Raphael Eduardo,9999,0,9999,0
1713348529564,CSE 191,A00,516875,Minnes Kemp; Mor Mia,9999,0,9999,0
1713348530593,CSS 201S,A01,494383,Staff,35,0,35,0
1713348531622,CSS 202S,A01,494387,Staff,35,0,35,0
1713348532649,EAP 100,A00,516065,Staff,9792,0,9999,207
1713348533680,ECE 45,A01,507414,Staff,51,0,60,9
1713348534707,ECE 100,A01,507416,Baghdadchi; Saharnaz,10,0,20,10
1713348534707,ECE 100,A02,507418,Baghdadchi; Saharnaz,20,0,20,0
1713348535731,ECE 111,A01,507420,Staff,38,0,50,12
1713348536759,ECE 197,001,548057,Sievenpiper; Daniel F.,9998,0,9999,1
1713348537789,EDS 115,A00,507243,Choi; Bailey Miyeon,28,0,28,0
1713348538820,EDS 117,A01,494379,Staff,23,0,25,2
1713348539845,EDS 125,A00,507246,Hopkins; Megan Beth,29,0,30,1
1713348540931,EDS 128A,A01,507264,Fargason; Sharon Gayle,26,0,26,0
1713348541961,EDS 128B,A01,507293,Pappas; Elizabeth,30,0,30,0
1713348542985,EDS 139,A00,507294,Fargason; Sharon Gayle,30,0,30,0
1713348542985,EDS 139,B00,507313,Pappas; Elizabeth,30,0,30,0
1713348544011,EDS 201,A00,507315,Staff,26,0,30,4
1713348545042,EDS 203,A01,507317,Halter; Christopher P.,26,0,30,4
1713348546067,EDS 204R,A01,507319,Halter; Christopher P.,3,0,30,27
1713348546067,EDS 204R,B01,507331,Heinzman; Erica M.,28,0,30,2
1713348547096,EDS 206R,A00,507332,Staff,4,0,30,26
1713348547096,EDS 206R,B00,507343,Staff,28,0,30,2
1713348548125,EDS 250,A00,507344,Hemans; Patricia Ann Benitez,36,0,40,4
1713348549152,EDS 281,A00,507345,Daly; Alan J.,18,0,18,0
1713348550175,EDS 284,A00,507350,Daly; Alan J.,16,0,16,0
1713348551206,EDS 286,A00,507359,Fine; Sarah,18,0,18,0
1713348552231,EDS 289C,A01,507361,Daly; Alan J.,18,0,18,0
1713348553256,EDS 290,A00,507366,Hofstetter; Carolyn,15,0,15,0
1713348554294,LIGM 5A,A00,507421,Fischer-Grunski; Eva K,20,0,20,0
1713348555321,LIGM 5B,A00,507423,Fischer-Grunski; Eva K,20,0,20,0
1713348556351,LIGM 5C,A00,507425,Fischer-Grunski; Eva K,20,0,20,0
1713348557382,LIIT 5AS,A00,507427,Carnelos; Chiara,20,0,20,0
1713348558412,LIIT 5BS,A00,507430,Carnelos; Chiara,20,0,20,0
1713348559439,LIIT 5CS,A00,507432,Carnelos; Chiara,20,0,20,0
1713348560550,LISP 5A,A00,507541,Munoz Sanchez; Alicia,17,0,20,3
1713348561580,LISP 5B,A00,507671,Munoz Sanchez; Alicia,15,0,20,5
1713348562611,LISP 5C,A00,507696,Munoz Sanchez; Alicia,15,0,20,5
1713348563637,MAE 197,001,528363,Boechler; Nicholas Sebastia,9998,0,9999,1
1713348564664,MATH 197,001,523477,Kedlaya; Kiran S.,9999,0,9999,0
1713348564664,MATH 197,002,563811,Zhang; Danna,9999,0,9999,0
1713348565694,MCWP 40R,A00,518780,Staff,20,0,20,0
1713348565694,MCWP 40R,B00,518781,Staff,19,0,20,1
1713348565694,MCWP 40R,C00,518783,Staff,19,0,20,1
1713348566721,MCWP 50R,A00,518791,Staff,20,0,20,0
1713348566721,MCWP 50R,B00,518792,Staff,17,0,20,3
1713348566721,MCWP 50R,C00,518793,Staff,19,0,20,1
1713348566721,MCWP 50R,D00,518794,Staff,16,0,20,4
1713348566721,MCWP 50R,E00,518795,Staff,16,0,20,4
1713348566721,MCWP 50R,F00,518796,Staff,19,0,20,1
1713348566721,MCWP 50R,G00,518797,Staff,19,0,20,1
1713348567751,MMW 12R,A01,514034,Herbst; Matthew,15,0,16,1
1713348567751,MMW 12R,A02,514035,Herbst; Matthew,16,0,16,0
1713348568776,MMW 13R,A01,514037,Staff,12,0,16,4
1713348568776,MMW 13R,A02,514039,Staff,16,0,16,0
1713348570827,SIO 295LS,A00,523233,Staff,18,0,30,12
1713348571852,SIO 295S,A00,523232,Staff,18,0,30,12
1713348572894,SOCI 117,A01,494376,Staff,1,0,5,4
1713348573922,WES 237B,A00,494380,Staff,19,0,20,1
1713348576003,AESE 279B,A00,494370,Wade; Jon P,33,0,33,0
1713348577032,ANAR 135S,A00,494369,Braswell; Geoffrey E.,0,0,0,0
1713348578059,CAT 124RS,A01,519847,Geibel; William,17,0,20,3
1713348579090,CAT 125RS,A01,515971,Geibel; William,17,0,20,3
1713348580116,CLRE 250,A00,511389,Morris; Sheldon,9996,0,9999,3
1713348581148,CLRE 251,A00,507176,Mehta; Ravindra L.,9996,0,9999,3
1713348581148,CLRE 251,B00,511410,Mehta; Ravindra L.,9998,0,9999,1
1713348582174,CLRE 252,A00,507189,Cuomo; Raphael Eduardo,9998,0,9999,1
1713348583208,CLRE 253,A00,507199,Vaida; Florin,9997,0,9999,2
1713348583208,CLRE 253,B00,507202,Vaida; Florin,9999,0,9999,0
1713348584238,CLRE 259,A00,507211,Patel; Hemal,9996,0,9999,3
1713348585263,CLRE 260,A00,507221,Cuomo; Raphael Eduardo,9999,0,9999,0
1713348586289,CLRE 297,001,507242,Cuomo; Raphael Eduardo,9999,0,9999,0
1713348587315,CSE 191,A00,516875,Minnes Kemp; Mor Mia,9999,0,9999,0
1713348588341,CSS 201S,A01,494383,Staff,35,0,35,0
1713348589367,CSS 202S,A01,494387,Staff,35,0,35,0
1713348590391,EAP 100,A00,516065,Staff,9792,0,9999,207
1713348591416,ECE 45,A01,507414,Staff,51,0,60,9
1713348592447,ECE 100,A01,507416,Baghdadchi; Saharnaz,10,0,20,10
1713348592447,ECE 100,A02,507418,Baghdadchi; Saharnaz,20,0,20,0
1713348593472,ECE 111,A01,507420,Staff,38,0,50,12
1713348594501,ECE 197,001,548057,Sievenpiper; Daniel F.,9998,0,9999,1
1713348595531,EDS 115,A00,507243,Choi; Bailey Miyeon,28,0,28,0
1713348596558,EDS 117,A01,494379,Staff,23,0,25,2
1713348597585,EDS 125,A00,507246,Hopkins; Megan Beth,29,0,30,1
1713348598618,EDS 128A,A01,507264,Fargason; Sharon Gayle,26,0,26,0
1713348599644,EDS 128B,A01,507293,Pappas; Elizabeth,30,0,30,0
1713348600669,EDS 139,A00,507294,Fargason; Sharon Gayle,30,0,30,0
1713348600669,EDS 139,B00,507313,Pappas; Elizabeth,30,0,30,0
1713348601697,EDS 201,A00,507315,Staff,26,0,30,4
1713348602722,EDS 203,A01,507317,Halter; Christopher P.,26,0,30,4
1713348603749,EDS 204R,A01,507319,Halter; Christopher P.,3,0,30,27
1713348603749,EDS 204R,B01,507331,Heinzman; Erica M.,28,0,30,2
1713348604775,EDS 206R,A00,507332,Staff,4,0,30,26
1713348604775,EDS 206R,B00,507343,Staff,28,0,30,2
1713348605803,EDS 250,A00,507344,Hemans; Patricia Ann Benitez,36,0,40,4
1713348606827,EDS 281,A00,507345,Daly; Alan J.,18,0,18,0
1713348607853,EDS 284,A00,507350,Daly; Alan J.,16,0,16,0
1713348608881,EDS 286,A00,507359,Fine; Sarah,18,0,18,0
1713348609908,EDS 289C,A01,507361,Daly; Alan J.,18,0,18,0
1713348610936,EDS 290,A00,507366,Hofstetter; Carolyn,15,0,15,0
1713348611961,LIGM 5A,A00,507421,Fischer-Grunski; Eva K,20,0,20,0
1713348612987,LIGM 5B,A00,507423,Fischer-Grunski; Eva K,20,0,20,0
1713348614019,LIGM 5C,A00,507425,Fischer-Grunski; Eva K,20,0,20,0
1713348615046,LIIT 5AS,A00,507427,Carnelos; Chiara,20,0,20,0
1713348616076,LIIT 5BS,A00,507430,Carnelos; Chiara,20,0,20,0
1713348617101,LIIT 5CS,A00,507432,Carnelos; Chiara,20,0,20,0
1713348618127,LISP 5A,A00,507541,Munoz Sanchez; Alicia,17,0,20,3
1713348619153,LISP 5B,A00,507671,Munoz Sanchez; Alicia,15,0,20,5
1713348620179,LISP 5C,A00,507696,Munoz Sanchez; Alicia,15,0,20,5
1713348621203,MAE 197,001,528363,Boechler; Nicholas Sebastia,9998,0,9999,1
1713348622230,MATH 197,001,523477,Kedlaya; Kiran S.,9999,0,9999,0
1713348622230,MATH 197,002,563811,Zhang; Danna,9999,0,9999,0
1713348623255,MCWP 40R,A00,518780,Staff,20,0,20,0
1713348623255,MCWP 40R,B00,518781,Staff,19,0,20,1
1713348623255,MCWP 40R,C00,518783,Staff,19,0,20,1
1713348624281,MCWP 50R,A00,518791,Staff,20,0,20,0
1713348624281,MCWP 50R,B00,518792,Staff,17,0,20,3
1713348624281,MCWP 50R,C00,518793,Staff,19,0,20,1
1713348624281,MCWP 50R,D00,518794,Staff,16,0,20,4
1713348624281,MCWP 50R,E00,518795,Staff,16,0,20,4
1713348624281,MCWP 50R,F00,518796,Staff,19,0,20,1
1713348624281,MCWP 50R,G00,518797,Staff,19,0,20,1
1713348625308,MMW 12R,A01,514034,Herbst; Matthew,15,0,16,1
1713348625308,MMW 12R,A02,514035,Herbst; Matthew,16,0,16,0
1713348626333,MMW 13R,A01,514037,Staff,12,0,16,4
1713348626333,MMW 13R,A02,514039,Staff,16,0,16,0
1713348628384,SIO 295LS,A00,523233,Staff,18,0,30,12
1713348629412,SIO 295S,A00,523232,Staff,18,0,30,12
1713348630444,SOCI 117,A01,494376,Staff,1,0,5,4
1713348631469,WES 237B,A00,494380,Staff,19,0,20,1
1713348633540,AESE 279B,A00,494370,Wade; Jon P,33,0,33,0
1713348634564,ANAR 135S,A00,494369,Braswell; Geoffrey E.,0,0,0,0
1713348635590,CAT 124RS,A01,519847,Geibel; William,17,0,20,3
1713348636615,CAT 125RS,A01,515971,Geibel; William,17,0,20,3
1713348637645,CLRE 250,A00,511389,Morris; Sheldon,9996,0,9999,3
1713348638677,CLRE 251,A00,507176,Mehta; Ravindra L.,9996,0,9999,3
1713348638677,CLRE 251,B00,511410,Mehta; Ravindra L.,9998,0,9999,1
1713348639707,CLRE 252,A00,507189,Cuomo; Raphael Eduardo,9998,0,9999,1
1713348640736,CLRE 253,A00,507199,Vaida; Florin,9997,0,9999,2
1713348640736,CLRE 253,B00,507202,Vaida; Florin,9999,0,9999,0
1713348641762,CLRE 259,A00,507211,Patel; Hemal,9996,0,9999,3
1713348642790,CLRE 260,A00,507221,Cuomo; Raphael Eduardo,9999,0,9999,0
1713348643819,CLRE 297,001,507242,Cuomo; Raphael Eduardo,9999,0,9999,0
1713348644901,CSE 191,A00,516875,Minnes Kemp; Mor Mia,9999,0,9999,0
1713348645929,CSS 201S,A01,494383,Staff,35,0,35,0
1713348646959,CSS 202S,A01,494387,Staff,35,0,35,0
1713348647983,EAP 100,A00,516065,Staff,9792,0,9999,207
1713348649018,ECE 45,A01,507414,Staff,51,0,60,9
1713348650075,ECE 100,A01,507416,Baghdadchi; Saharnaz,10,0,20,10
1713348650075,ECE 100,A02,507418,Baghdadchi; Saharnaz,20,0,20,0
1713348651101,ECE 111,A01,507420,Staff,38,0,50,12
1713348652127,ECE 197,001,548057,Sievenpiper; Daniel F.,9998,0,9999,1
1713348653157,EDS 115,A00,507243,Choi; Bailey Miyeon,28,0,28,0
1713348654188,EDS 117,A01,494379,Staff,23,0,25,2
1713348655214,EDS 125,A00,507246,Hopkins; Megan Beth,29,0,30,1
1713348656244,EDS 128A,A01,507264,Fargason; Sharon Gayle,26,0,26,0
1713348657269,EDS 128B,A01,507293,Pappas; Elizabeth,30,0,30,0
1713348658294,EDS 139,A00,507294,Fargason; Sharon Gayle,30,0,30,0
1713348658294,EDS 139,B00,507313,Pappas; Elizabeth,30,0,30,0
1713348659340,EDS 201,A00,507315,Staff,26,0,30,4
1713348660369,EDS 203,A01,507317,Halter; Christopher P.,26,0,30,4
1713348661396,EDS 204R,A01,507319,Halter; Christopher P.,3,0,30,27
1713348661396,EDS 204R,B01,507331,Heinzman; Erica M.,28,0,30,2
1713348662420,EDS 206R,A00,507332,Staff,4,0,30,26
1713348662420,EDS 206R,B00,507343,Staff,28,0,30,2
1713348663449,EDS 250,A00,507344,Hemans; Patricia Ann Benitez,36,0,40,4
1713348664479,EDS 281,A00,507345,Daly; Alan J.,18,0,18,0
1713348665504,EDS 284,A00,507350,Daly; Alan J.,16,0,16,0
1713348666531,EDS 286,A00,507359,Fine; Sarah,18,0,18,0
1713348667557,EDS 289C,A01,507361,Daly; Alan J.,18,0,18,0
1713348668580,EDS 290,A00,507366,Hofstetter; Carolyn,15,0,15,0
1713348669607,LIGM 5A,A00,507421,Fischer-Grunski; Eva K,20,0,20,0
1713348670637,LIGM 5B,A00,507423,Fischer-Grunski; Eva K,20,0,20,0
1713348671666,LIGM 5C,A00,507425,Fischer-Grunski; Eva K,20,0,20,0
1713348672699,LIIT 5AS,A00,507427,Carnelos; Chiara,20,0,20,0
1713348673725,LIIT 5BS,A00,507430,Carnelos; Chiara,20,0,20,0
1713348674755,LIIT 5CS,A00,507432,Carnelos; Chiara,20,0,20,0
1713348675780,LISP 5A,A00,507541,Munoz Sanchez; Alicia,17,0,20,3
1713348676806,LISP 5B,A00,507671,Munoz Sanchez; Alicia,15,0,20,5
1713348677831,LISP 5C,A00,507696,Munoz Sanchez; Alicia,15,0,20,5
1713348678858,MAE 197,001,528363,Boechler; Nicholas Sebastia,9998,0,9999,1
1713348679887,MATH 197,001,523477,Kedlaya; Kiran S.,9999,0,9999,0
1713348679887,MATH 197,002,563811,Zhang; Danna,9999,0,9999,0
1713348680918,MCWP 40R,A00,518780,Staff,20,0,20,0
1713348680918,MCWP 40R,B00,518781,Staff,19,0,20,1
1713348680918,MCWP 40R,C00,518783,Staff,19,0,20,1
1713348681948,MCWP 50R,A00,518791,Staff,20,0,20,0
1713348681948,MCWP 50R,B00,518792,Staff,17,0,20,3
1713348681948,MCWP 50R,C00,518793,Staff,19,0,20,1
1713348681948,MCWP 50R,D00,518794,Staff,16,0,20,4
1713348681948,MCWP 50R,E00,518795,Staff,16,0,20,4
1713348681948,MCWP 50R,F00,518796,Staff,19,0,20,1
1713348681948,MCWP 50R,G00,518797,Staff,19,0,20,1
1713348682976,MMW 12R,A01,514034,Herbst; Matthew,15,0,16,1
1713348682976,MMW 12R,A02,514035,Herbst; Matthew,16,0,16,0
1713348684001,MMW 13R,A01,514037,Staff,12,0,16,4
1713348684001,MMW 13R,A02,514039,Staff,16,0,16,0
1713348686055,SIO 295LS,A00,523233,Staff,18,0,30,12
1713348687085,SIO 295S,A00,523232,Staff,18,0,30,12
1713348688116,SOCI 117,A01,494376,Staff,1,0,5,4
1713348689143,WES 237B,A00,494380,Staff,19,0,20,1
1713348691219,AESE 279B,A00,494370,Wade; Jon P,33,0,33,0
1713348692245,ANAR 135S,A00,494369,Braswell; Geoffrey E.,0,0,0,0
1713348693269,CAT 124RS,A01,519847,Geibel; William,17,0,20,3
1713348694295,CAT 125RS,A01,515971,Geibel; William,17,0,20,3
1713348695325,CLRE 250,A00,511389,Morris; Sheldon,9996,0,9999,3
1713348696352,CLRE 251,A00,507176,Mehta; Ravindra L.,9996,0,9999,3
1713348696352,CLRE 251,B00,511410,Mehta; Ravindra L.,9998,0,9999,1
1713348697383,CLRE 252,A00,507189,Cuomo; Raphael Eduardo,9998,0,9999,1
1713348698408,CLRE 253,A00,507199,Vaida; Florin,9997,0,9999,2
1713348698408,CLRE 253,B00,507202,Vaida; Florin,9999,0,9999,0
1713348699433,CLRE 259,A00,507211,Patel; Hemal,9996,0,9999,3
1713348700460,CLRE 260,A00,507221,Cuomo; Raphael Eduardo,9999,0,9999,0
1713348701489,CLRE 297,001,507242,Cuomo; Raphael Eduardo,9999,0,9999,0
1713348702519,CSE 191,A00,516875,Minnes Kemp; Mor Mia,9999,0,9999,0
1713348703557,CSS 201S,A01,494383,Staff,35,0,35,0
1713348704588,CSS 202S,A01,494387,Staff,35,0,35,0
1713348705615,EAP 100,A00,516065,Staff,9792,0,9999,207
1713348706641,ECE 45,A01,507414,Staff,51,0,60,9
1713348707669,ECE 100,A01,507416,Baghdadchi; Saharnaz,10,0,20,10
1713348707669,ECE 100,A02,507418,Baghdadchi; Saharnaz,20,0,20,0
1713348708701,ECE 111,A01,507420,Staff,38,0,50,12
1713348709729,ECE 197,001,548057,Sievenpiper; Daniel F.,9998,0,9999,1
1713348710756,EDS 115,A00,507243,Choi; Bailey Miyeon,28,0,28,0
1713348711783,EDS 117,A01,494379,Staff,23,0,25,2
1713348712813,EDS 125,A00,507246,Hopkins; Megan Beth,29,0,30,1
1713348713839,EDS 128A,A01,507264,Fargason; Sharon Gayle,26,0,26,0
1713348714864,EDS 128B,A01,507293,Pappas; Elizabeth,30,0,30,0
1713348715890,EDS 139,A00,507294,Fargason; Sharon Gayle,30,0,30,0
1713348715890,EDS 139,B00,507313,Pappas; Elizabeth,30,0,30,0
1713348716916,EDS 201,A00,507315,Staff,26,0,30,4
1713348717942,EDS 203,A01,507317,Halter; Christopher P.,26,0,30,4
1713348718968,EDS 204R,A01,507319,Halter; Christopher P.,3,0,30,27
1713348718968,EDS 204R,B01,507331,Heinzman; Erica M.,28,0,30,2
1713348719993,EDS 206R,A00,507332,Staff,4,0,30,26
1713348719993,EDS 206R,B00,507343,Staff,28,0,30,2
1713348721022,EDS 250,A00,507344,Hemans; Patricia Ann Benitez,36,0,40,4
1713348722047,EDS 281,A00,507345,Daly; Alan J.,18,0,18,0
1713348723072,EDS 284,A00,507350,Daly; Alan J.,16,0,16,0
1713348724098,EDS 286,A00,507359,Fine; Sarah,18,0,18,0
1713348725124,EDS 289C,A01,507361,Daly; Alan J.,18,0,18,0
1713348726150,EDS 290,A00,507366,Hofstetter; Carolyn,15,0,15,0
1713348727177,LIGM 5A,A00,507421,Fischer-Grunski; Eva K,20,0,20,0
1713348728207,LIGM 5B,A00,507423,Fischer-Grunski; Eva K,20,0,20,0
1713348729237,LIGM 5C,A00,507425,Fischer-Grunski; Eva K,20,0,20,0
1713348730266,LIIT 5AS,A00,507427,Carnelos; Chiara,20,0,20,0
1713348731291,LIIT 5BS,A00,507430,Carnelos; Chiara,20,0,20,0
1713348732325,LIIT 5CS,A00,507432,Carnelos; Chiara,20,0,20,0
1713348733357,LISP 5A,A00,507541,Munoz Sanchez; Alicia,17,0,20,3
1713348734382,LISP 5B,A00,507671,Munoz Sanchez; Alicia,15,0,20,5
1713348735413,LISP 5C,A00,507696,Munoz Sanchez; Alicia,15,0,20,5
1713348736437,MAE 197,001,528363,Boechler; Nicholas Sebastia,9998,0,9999,1
1713348737464,MATH 197,001,523477,Kedlaya; Kiran S.,9999,0,9999,0
1713348737464,MATH 197,002,563811,Zhang; Danna,9999,0,9999,0
1713348738494,MCWP 40R,A00,518780,Staff,20,0,20,0
1713348738494,MCWP 40R,B00,518781,Staff,19,0,20,1
1713348738494,MCWP 40R,C00,518783,Staff,19,0,20,1
1713348739523,MCWP 50R,A00,518791,Staff,20,0,20,0
1713348739523,MCWP 50R,B00,518792,Staff,17,0,20,3
1713348739523,MCWP 50R,C00,518793,Staff,19,0,20,1
1713348739523,MCWP 50R,D00,518794,Staff,16,0,20,4
1713348739523,MCWP 50R,E00,518795,Staff,16,0,20,4
1713348739523,MCWP 50R,F00,518796,Staff,19,0,20,1
1713348739523,MCWP 50R,G00,518797,Staff,19,0,20,1
1713348740549,MMW 12R,A01,514034,Herbst; Matthew,15,0,16,1
1713348740549,MMW 12R,A02,514035,Herbst; Matthew,16,0,16,0
1713348741578,MMW 13R,A01,514037,Staff,12,0,16,4
1713348741578,MMW 13R,A02,514039,Staff,16,0,16,0
1713348743631,SIO 295LS,A00,523233,Staff,18,0,30,12
1713348744658,SIO 295S,A00,523232,Staff,18,0,30,12
1713348745683,SOCI 117,A01,494376,Staff,1,0,5,4
1713348746709,WES 237B,A00,494380,Staff,19,0,20,1
1713348748833,AESE 279B,A00,494370,Wade; Jon P,33,0,33,0
1713348749861,ANAR 135S,A00,494369,Braswell; Geoffrey E.,0,0,0,0
1713348750893,CAT 124RS,A01,519847,Geibel; William,17,0,20,3
1713348751922,CAT 125RS,A01,515971,Geibel; William,17,0,20,3
1713348752951,CLRE 250,A00,511389,Morris; Sheldon,9996,0,9999,3
1713348753978,CLRE 251,A00,507176,Mehta; Ravindra L.,9996,0,9999,3
1713348753978,CLRE 251,B00,511410,Mehta; Ravindra L.,9998,0,9999,1
1713348755009,CLRE 252,A00,507189,Cuomo; Raphael Eduardo,9998,0,9999,1
1713348756035,CLRE 253,A00,507199,Vaida; Florin,9997,0,9999,2
1713348756035,CLRE 253,B00,507202,Vaida; Florin,9999,0,9999,0
1713348757059,CLRE 259,A00,507211,Patel; Hemal,9996,0,9999,3
1713348758087,CLRE 260,A00,507221,Cuomo; Raphael Eduardo,9999,0,9999,0
1713348759116,CLRE 297,001,507242,Cuomo; Raphael Eduardo,9999,0,9999,0
1713348760145,CSE 191,A00,516875,Minnes Kemp; Mor Mia,9999,0,9999,0
1713348761182,CSS 201S,A01,494383,Staff,35,0,35,0
1713348762205,CSS 202S,A01,494387,Staff,35,0,35,0
1713348763231,EAP 100,A00,516065,Staff,9792,0,9999,207
1713348764283,ECE 45,A01,507414,Staff,51,0,60,9
1713348765308,ECE 100,A01,507416,Baghdadchi; Saharnaz,10,0,20,10
1713348765308,ECE 100,A02,507418,Baghdadchi; Saharnaz,20,0,20,0
1713348766333,ECE 111,A01,507420,Staff,38,0,50,12
1713348767358,ECE 197,001,548057,Sievenpiper; Daniel F.,9998,0,9999,1
1713348768392,EDS 115,A00,507243,Choi; Bailey Miyeon,28,0,28,0
1713348769418,EDS 117,A01,494379,Staff,23,0,25,2
1713348770444,EDS 125,A00,507246,Hopkins; Megan Beth,29,0,30,1
1713348771469,EDS 128A,A01,507264,Fargason; Sharon Gayle,26,0,26,0
1713348772499,EDS 128B,A01,507293,Pappas; Elizabeth,30,0,30,0
1713348773527,EDS 139,A00,507294,Fargason; Sharon Gayle,30,0,30,0
1713348773527,EDS 139,B00,507313,Pappas; Elizabeth,30,0,30,0
1713348774551,EDS 201,A00,507315,Staff,26,0,30,4
1713348775575,EDS 203,A01,507317,Halter; Christopher P.,26,0,30,4
1713348776612,EDS 204R,A01,507319,Halter; Christopher P.,3,0,30,27
1713348776612,EDS 204R,B01,507331,Heinzman; Erica M.,28,0,30,2
1713348777637,EDS 206R,A00,507332,Staff,4,0,30,26
1713348777637,EDS 206R,B00,507343,Staff,28,0,30,2
1713348778663,EDS 250,A00,507344,Hemans; Patricia Ann Benitez,36,0,40,4
1713348779688,EDS 281,A00,507345,Daly; Alan J.,18,0,18,0
1713348780713,EDS 284,A00,507350,Daly; Alan J.,16,0,16,0
1713348781742,EDS 286,A00,507359,Fine; Sarah,18,0,18,0
1713348782771,EDS 289C,A01,507361,Daly; Alan J.,18,0,18,0
1713348783804,EDS 290,A00,507366,Hofstetter; Carolyn,15,0,15,0
1713348784834,LIGM 5A,A00,507421,Fischer-Grunski; Eva K,20,0,20,0
1713348785860,LIGM 5B,A00,507423,Fischer-Grunski; Eva K,20,0,20,0
1713348786887,LIGM 5C,A00,507425,Fischer-Grunski; Eva K,20,0,20,0
1713348787916,LIIT 5AS,A00,507427,Carnelos; Chiara,20,0,20,0
1713348788946,LIIT 5BS,A00,507430,Carnelos; Chiara,20,0,20,0
1713348789970,LIIT 5CS,A00,507432,Carnelos; Chiara,20,0,20,0
1713348790999,LISP 5A,A00,507541,Munoz Sanchez; Alicia,17,0,20,3
1713348792029,LISP 5B,A00,507671,Munoz Sanchez; Alicia,15,0,20,5
1713348793057,LISP 5C,A00,507696,Munoz Sanchez; Alicia,15,0,20,5
1713348794086,MAE 197,001,528363,Boechler; Nicholas Sebastia,9998,0,9999,1
1713348795112,MATH 197,001,523477,Kedlaya; Kiran S.,9999,0,9999,0
1713348795112,MATH 197,002,563811,Zhang; Danna,9999,0,9999,0
1713348796136,MCWP 40R,A00,518780,Staff,20,0,20,0
1713348796136,MCWP 40R,B00,518781,Staff,19,0,20,1
1713348796136,MCWP 40R,C00,518783,Staff,19,0,20,1
1713348797161,MCWP 50R,A00,518791,Staff,20,0,20,0
1713348797161,MCWP 50R,B00,518792,Staff,17,0,20,3
1713348797161,MCWP 50R,C00,518793,Staff,19,0,20,1
1713348797161,MCWP 50R,D00,518794,Staff,16,0,20,4
1713348797161,MCWP 50R,E00,518795,Staff,16,0,20,4
1713348797161,MCWP 50R,F00,518796,Staff,19,0,20,1
1713348797161,MCWP 50R,G00,518797,Staff,19,0,20,1
1713348798186,MMW 12R,A01,514034,Herbst; Matthew,15,0,16,1
1713348798186,MMW 12R,A02,514035,Herbst; Matthew,16,0,16,0
1713348799215,MMW 13R,A01,514037,Staff,12,0,16,4
1713348799215,MMW 13R,A02,514039,Staff,16,0,16,0
1713348801264,SIO 295LS,A00,523233,Staff,18,0,30,12
1713348802289,SIO 295S,A00,523232,Staff,18,0,30,12
1713348803316,SOCI 117,A01,494376,Staff,1,0,5,4
1713348804344,WES 237B,A00,494380,Staff,19,0,20,1
1713348806408,AESE 279B,A00,494370,Wade; Jon P,33,0,33,0
1713348807437,ANAR 135S,A00,494369,Braswell; Geoffrey E.,0,0,0,0
1713348808461,CAT 124RS,A01,519847,Geibel; William,17,0,20,3
1713348809487,CAT 125RS,A01,515971,Geibel; William,17,0,20,3
1713348810512,CLRE 250,A00,511389,Morris; Sheldon,9996,0,9999,3
1713348811544,CLRE 251,A00,507176,Mehta; Ravindra L.,9996,0,9999,3
1713348811544,CLRE 251,B00,511410,Mehta; Ravindra L.,9998,0,9999,1
1713348812574,CLRE 252,A00,507189,Cuomo; Raphael Eduardo,9998,0,9999,1
1713348813605,CLRE 253,A00,507199,Vaida; Florin,9997,0,9999,2
1713348813605,CLRE 253,B00,507202,Vaida; Florin,9999,0,9999,0
1713348814633,CLRE 259,A00,507211,Patel; Hemal,9996,0,9999,3
1713348815662,CLRE 260,A00,507221,Cuomo; Raphael Eduardo,9999,0,9999,0
1713348816687,CLRE 297,001,507242,Cuomo; Raphael Eduardo,9999,0,9999,0
1713348817715,CSE 191,A00,516875,Minnes Kemp; Mor Mia,9999,0,9999,0
1713348818741,CSS 201S,A01,494383,Staff,35,0,35,0
1713348819771,CSS 202S,A01,494387,Staff,35,0,35,0
1713348820799,EAP 100,A00,516065,Staff,9792,0,9999,207
1713348821825,ECE 45,A01,507414,Staff,51,0,60,9
1713348822851,ECE 100,A01,507416,Baghdadchi; Saharnaz,10,0,20,10
1713348822851,ECE 100,A02,507418,Baghdadchi; Saharnaz,20,0,20,0
1713348823875,ECE 111,A01,507420,Staff,38,0,50,12
1713348824905,ECE 197,001,548057,Sievenpiper; Daniel F.,9998,0,9999,1
1713348825934,EDS 115,A00,507243,Choi; Bailey Miyeon,28,0,28,0
1713348826960,EDS 117,A01,494379,Staff,23,0,25,2
1713348827988,EDS 125,A00,507246,Hopkins; Megan Beth,29,0,30,1
1713348829014,EDS 128A,A01,507264,Fargason; Sharon Gayle,26,0,26,0
1713348830040,EDS 128B,A01,507293,Pappas; Elizabeth,30,0,30,0
1713348831065,EDS 139,A00,507294,Fargason; Sharon Gayle,30,0,30,0
1713348831065,EDS 139,B00,507313,Pappas; Elizabeth,30,0,30,0
1713348832091,EDS 201,A00,507315,Staff,26,0,30,4
1713348833119,EDS 203,A01,507317,Halter; Christopher P.,26,0,30,4
1713348834145,EDS 204R,A01,507319,Halter; Christopher P.,3,0,30,27
1713348834145,EDS 204R,B01,507331,Heinzman; Erica M.,28,0,30,2
1713348835173,EDS 206R,A00,507332,Staff,4,0,30,26
1713348835173,EDS 206R,B00,507343,Staff,28,0,30,2
1713348836197,EDS 250,A00,507344,Hemans; Patricia Ann Benitez,36,0,40,4
1713348837221,EDS 281,A00,507345,Daly; Alan J.,18,0,18,0
1713348838245,EDS 284,A00,507350,Daly; Alan J.,16,0,16,0
1713348839297,EDS 286,A00,507359,Fine; Sarah,18,0,18,0
1713348840321,EDS 289C,A01,507361,Daly; Alan J.,18,0,18,0
1713348841349,EDS 290,A00,507366,Hofstetter; Carolyn,15,0,15,0
1713348842397,LIGM 5A,A00,507421,Fischer-Grunski; Eva K,20,0,20,0
1713348843423,LIGM 5B,A00,507423,Fischer-Grunski; Eva K,20,0,20,0
1713348844451,LIGM 5C,A00,507425,Fischer-Grunski; Eva K,20,0,20,0
1713348845479,LIIT 5AS,A00,507427,Carnelos; Chiara,20,0,20,0
1713348846504,LIIT 5BS,A00,507430,Carnelos; Chiara,20,0,20,0
1713348847533,LIIT 5CS,A00,507432,Carnelos; Chiara,20,0,20,0
1713348848610,LISP 5A,A00,507541,Munoz Sanchez; Alicia,17,0,20,3
1713348849639,LISP 5B,A00,507671,Munoz Sanchez; Alicia,15,0,20,5
1713348850664,LISP 5C,A00,507696,Munoz Sanchez; Alicia,15,0,20,5
1713348851690,MAE 197,001,528363,Boechler; Nicholas Sebastia,9998,0,9999,1
1713348852775,MATH 197,001,523477,Kedlaya; Kiran S.,9999,0,9999,0
1713348852775,MATH 197,002,563811,Zhang; Danna,9999,0,9999,0
1713348853811,MCWP 40R,A00,518780,Staff,20,0,20,0
1713348853811,MCWP 40R,B00,518781,Staff,19,0,20,1
1713348853811,MCWP 40R,C00,518783,Staff,19,0,20,1
1713348854838,MCWP 50R,A00,518791,Staff,20,0,20,0
1713348854838,MCWP 50R,B00,518792,Staff,17,0,20,3
1713348854838,MCWP 50R,C00,518793,Staff,19,0,20,1
1713348854838,MCWP 50R,D00,518794,Staff,16,0,20,4
1713348854838,MCWP 50R,E00,518795,Staff,16,0,20,4
1713348854838,MCWP 50R,F00,518796,Staff,19,0,20,1
1713348854838,MCWP 50R,G00,518797,Staff,19,0,20,1
1713348855865,MMW 12R,A01,514034,Herbst; Matthew,15,0,16,1
1713348855865,MMW 12R,A02,514035,Herbst; Matthew,16,0,16,0
1713348856888,MMW 13R,A01,514037,Staff,12,0,16,4
1713348856888,MMW 13R,A02,514039,Staff,16,0,16,0
1713348858949,SIO 295LS,A00,523233,Staff,18,0,30,12
1713348859973,SIO 295S,A00,523232,Staff,18,0,30,12
1713348861003,SOCI 117,A01,494376,Staff,1,0,5,4
1713348862031,WES 237B,A00,494380,Staff,19,0,20,1
1713348864097,AESE 279B,A00,494370,Wade; Jon P,33,0,33,0
1713348865121,ANAR 135S,A00,494369,Braswell; Geoffrey E.,0,0,0,0
1713348866147,CAT 124RS,A01,519847,Geibel; William,17,0,20,3
1713348867172,CAT 125RS,A01,515971,Geibel; William,17,0,20,3
1713348868204,CLRE 250,A00,511389,Morris; Sheldon,9996,0,9999,3
1713348869239,CLRE 251,A00,507176,Mehta; Ravindra L.,9996,0,9999,3
1713348869239,CLRE 251,B00,511410,Mehta; Ravindra L.,9998,0,9999,1
1713348870265,CLRE 252,A00,507189,Cuomo; Raphael Eduardo,9998,0,9999,1
1713348871297,CLRE 253,A00,507199,Vaida; Florin,9997,0,9999,2
1713348871297,CLRE 253,B00,507202,Vaida; Florin,9999,0,9999,0
1713348872326,CLRE 259,A00,507211,Patel; Hemal,9996,0,9999,3
1713348873349,CLRE 260,A00,507221,Cuomo; Raphael Eduardo,9999,0,9999,0
1713348874375,CLRE 297,001,507242,Cuomo; Raphael Eduardo,9999,0,9999,0
1713348875401,CSE 191,A00,516875,Minnes Kemp; Mor Mia,9999,0,9999,0
1713348876438,CSS 201S,A01,494383,Staff,35,0,35,0
1713348877464,CSS 202S,A01,494387,Staff,35,0,35,0
1713348878489,EAP 100,A00,516065,Staff,9792,0,9999,207
1713348879513,ECE 45,A01,507414,Staff,51,0,60,9
1713348880537,ECE 100,A01,507416,Baghdadchi; Saharnaz,10,0,20,10
1713348880537,ECE 100,A02,507418,Baghdadchi; Saharnaz,20,0,20,0
1713348881565,ECE 111,A01,507420,Staff,38,0,50,12
1713348882590,ECE 197,001,548057,Sievenpiper; Daniel F.,9998,0,9999,1
1713348883616,EDS 115,A00,507243,Choi; Bailey Miyeon,28,0,28,0
1713348884779,EDS 117,A01,494379,Staff,23,0,25,2
1713348885809,EDS 125,A00,507246,Hopkins; Megan Beth,29,0,30,1
1713348886839,EDS 128A,A01,507264,Fargason; Sharon Gayle,26,0,26,0
1713348887865,EDS 128B,A01,507293,Pappas; Elizabeth,30,0,30,0
1713348888891,EDS 139,A00,507294,Fargason; Sharon Gayle,30,0,30,0
1713348888891,EDS 139,B00,507313,Pappas; Elizabeth,30,0,30,0
1713348889915,EDS 201,A00,507315,Staff,26,0,30,4
1713348890946,EDS 203,A01,507317,Halter; Christopher P.,26,0,30,4
1713348891973,EDS 204R,A01,507319,Halter; Christopher P.,3,0,30,27
1713348891973,EDS 204R,B01,507331,Heinzman; Erica M.,28,0,30,2
1713348893001,EDS 206R,A00,507332,Staff,4,0,30,26
1713348893001,EDS 206R,B00,507343,Staff,28,0,30,2
1713348894026,EDS 250,A00,507344,Hemans; Patricia Ann Benitez,36,0,40,4
1713348895052,EDS 281,A00,507345,Daly; Alan J.,18,0,18,0
1713348896077,EDS 284,A00,507350,Daly; Alan J.,16,0,16,0
1713348897102,EDS 286,A00,507359,Fine; Sarah,18,0,18,0
1713348898128,EDS 289C,A01,507361,Daly; Alan J.,18,0,18,0
1713348899155,EDS 290,A00,507366,Hofstetter; Carolyn,15,0,15,0
1713348900191,LIGM 5A,A00,507421,Fischer-Grunski; Eva K,20,0,20,0
1713348901214,LIGM 5B,A00,507423,Fischer-Grunski; Eva K,20,0,20,0
1713348902244,LIGM 5C,A00,507425,Fischer-Grunski; Eva K,20,0,20,0
1713348903269,LIIT 5AS,A00,507427,Carnelos; Chiara,20,0,20,0
1713348904294,LIIT 5BS,A00,507430,Carnelos; Chiara,20,0,20,0
1713348905323,LIIT 5CS,A00,507432,Carnelos; Chiara,20,0,20,0
1713348906353,LISP 5A,A00,507541,Munoz Sanchez; Alicia,17,0,20,3
1713348907382,LISP 5B,A00,507671,Munoz Sanchez; Alicia,15,0,20,5
1713348908410,LISP 5C,A00,507696,Munoz Sanchez; Alicia,15,0,20,5
1713348909435,MAE 197,001,528363,Boechler; Nicholas Sebastia,9998,0,9999,1
1713348910461,MATH 197,001,523477,Kedlaya; Kiran S.,9999,0,9999,0
1713348910461,MATH 197,002,563811,Zhang; Danna,9999,0,9999,0
1713348911489,MCWP 40R,A00,518780,Staff,20,0,20,0
1713348911489,MCWP 40R,B00,518781,Staff,19,0,20,1
1713348911489,MCWP 40R,C00,518783,Staff,19,0,20,1
1713348912514,MCWP 50R,A00,518791,Staff,20,0,20,0
1713348912514,MCWP 50R,B00,518792,Staff,17,0,20,3
1713348912514,MCWP 50R,C00,518793,Staff,19,0,20,1
1713348912514,MCWP 50R,D00,518794,Staff,16,0,20,4
1713348912514,MCWP 50R,E00,518795,Staff,16,0,20,4
1713348912514,MCWP 50R,F00,518796,Staff,19,0,20,1
1713348912514,MCWP 50R,G00,518797,Staff,19,0,20,1
1713348913540,MMW 12R,A01,514034,Herbst; Matthew,15,0,16,1
1713348913540,MMW 12R,A02,514035,Herbst; Matthew,16,0,16,0
1713348914565,MMW 13R,A01,514037,Staff,12,0,16,4
1713348914565,MMW 13R,A02,514039,Staff,16,0,16,0
1713348916618,SIO 295LS,A00,523233,Staff,18,0,30,12
1713348917643,SIO 295S,A00,523232,Staff,18,0,30,12
1713348918709,SOCI 117,A01,494376,Staff,1,0,5,4
1713348919735,WES 237B,A00,494380,Staff,19,0,20,1
1713348921814,AESE 279B,A00,494370,Wade; Jon P,33,0,33,0
1713348922840,ANAR 135S,A00,494369,Braswell; Geoffrey E.,0,0,0,0
1713348923866,CAT 124RS,A01,519847,Geibel; William,17,0,20,3
1713348924895,CAT 125RS,A01,515971,Geibel; William,17,0,20,3
1713348925920,CLRE 250,A00,511389,Morris; Sheldon,9996,0,9999,3
1713348926953,CLRE 251,A00,507176,Mehta; Ravindra L.,9996,0,9999,3
1713348926953,CLRE 251,B00,511410,Mehta; Ravindra L.,9998,0,9999,1
1713348927981,CLRE 252,A00,507189,Cuomo; Raphael Eduardo,9998,0,9999,1
1713348929007,CLRE 253,A00,507199,Vaida; Florin,9997,0,9999,2
1713348929007,CLRE 253,B00,507202,Vaida; Florin,9999,0,9999,0
1713348930032,CLRE 259,A00,507211,Patel; Hemal,9996,0,9999,3
1713348931058,CLRE 260,A00,507221,Cuomo; Raphael Eduardo,9999,0,9999,0
1713348932084,CLRE 297,001,507242,Cuomo; Raphael Eduardo,9999,0,9999,0
1713348933115,CSE 191,A00,516875,Minnes Kemp; Mor Mia,9999,0,9999,0
1713348934144,CSS 201S,A01,494383,Staff,35,0,35,0
1713348935173,CSS 202S,A01,494387,Staff,35,0,35,0
1713348936202,EAP 100,A00,516065,Staff,9792,0,9999,207
1713348937243,ECE 45,A01,507414,Staff,51,0,60,9
1713348938274,ECE 100,A01,507416,Baghdadchi; Saharnaz,10,0,20,10
1713348938274,ECE 100,A02,507418,Baghdadchi; Saharnaz,20,0,20,0
1713348939303,ECE 111,A01,507420,Staff,38,0,50,12
1713348940331,ECE 197,001,548057,Sievenpiper; Daniel F.,9998,0,9999,1
1713348941363,EDS 115,A00,507243,Choi; Bailey Miyeon,28,0,28,0
1713348942390,EDS 117,A01,494379,Staff,23,0,25,2
1713348943422,EDS 125,A00,507246,Hopkins; Megan Beth,29,0,30,1
1713348944452,EDS 128A,A01,507264,Fargason; Sharon Gayle,26,0,26,0
1713348945480,EDS 128B,A01,507293,Pappas; Elizabeth,30,0,30,0
1713348946505,EDS 139,A00,507294,Fargason; Sharon Gayle,30,0,30,0
1713348946505,EDS 139,B00,507313,Pappas; Elizabeth,30,0,30,0
1713348947529,EDS 201,A00,507315,Staff,26,0,30,4
1713348948557,EDS 203,A01,507317,Halter; Christopher P.,26,0,30,4
1713348949588,EDS 204R,A01,507319,Halter; Christopher P.,3,0,30,27
1713348949588,EDS 204R,B01,507331,Heinzman; Erica M.,28,0,30,2
1713348950616,EDS 206R,A00,507332,Staff,4,0,30,26
1713348950616,EDS 206R,B00,507343,Staff,28,0,30,2
1713348951648,EDS 250,A00,507344,Hemans; Patricia Ann Benitez,36,0,40,4
1713348952673,EDS 281,A00,507345,Daly; Alan J.,18,0,18,0
1713348953698,EDS 284,A00,507350,Daly; Alan J.,16,0,16,0
1713348954723,EDS 286,A00,507359,Fine; Sarah,18,0,18,0
1713348955747,EDS 289C,A01,507361,Daly; Alan J.,18,0,18,0
1713348956832,EDS 290,A00,507366,Hofstetter; Carolyn,15,0,15,0
1713348957864,LIGM 5A,A00,507421,Fischer-Grunski; Eva K,20,0,20,0
1713348958889,LIGM 5B,A00,507423,Fischer-Grunski; Eva K,20,0,20,0
1713348959914,LIGM 5C,A00,507425,Fischer-Grunski; Eva K,20,0,20,0
1713348960939,LIIT 5AS,A00,507427,Carnelos; Chiara,20,0,20,0
1713348961965,LIIT 5BS,A00,507430,Carnelos; Chiara,20,0,20,0
1713348962996,LIIT 5CS,A00,507432,Carnelos; Chiara,20,0,20,0
1713348964022,LISP 5A,A00,507541,Munoz Sanchez; Alicia,17,0,20,3
1713348965067,LISP 5B,A00,507671,Munoz Sanchez; Alicia,15,0,20,5
1713348966097,LISP 5C,A00,507696,Munoz Sanchez; Alicia,15,0,20,5
1713348967128,MAE 197,001,528363,Boechler; Nicholas Sebastia,9998,0,9999,1
1713348968161,MATH 197,001,523477,Kedlaya; Kiran S.,9999,0,9999,0
1713348968161,MATH 197,002,563811,Zhang; Danna,9999,0,9999,0
1713348969190,MCWP 40R,A00,518780,Staff,20,0,20,0
1713348969190,MCWP 40R,B00,518781,Staff,19,0,20,1
1713348969190,MCWP 40R,C00,518783,Staff,19,0,20,1
1713348970221,MCWP 50R,A00,518791,Staff,20,0,20,0
1713348970221,MCWP 50R,B00,518792,Staff,17,0,20,3
1713348970221,MCWP 50R,C00,518793,Staff,19,0,20,1
1713348970221,MCWP 50R,D00,518794,Staff,16,0,20,4
1713348970221,MCWP 50R,E00,518795,Staff,16,0,20,4
1713348970221,MCWP 50R,F00,518796,Staff,19,0,20,1
1713348970221,MCWP 50R,G00,518797,Staff,19,0,20,1
1713348971247,MMW 12R,A01,514034,Herbst; Matthew,15,0,16,1
1713348971247,MMW 12R,A02,514035,Herbst; Matthew,16,0,16,0
1713348972272,MMW 13R,A01,514037,Staff,12,0,16,4
1713348972272,MMW 13R,A02,514039,Staff,16,0,16,0
1713348974325,SIO 295LS,A00,523233,Staff,18,0,30,12
1713348975355,SIO 295S,A00,523232,Staff,18,0,30,12
1713348976382,SOCI 117,A01,494376,Staff,1,0,5,4
1713348977407,WES 237B,A00,494380,Staff,19,0,20,1
1713348979495,AESE 279B,A00,494370,Wade; Jon P,33,0,33,0
1713348980520,ANAR 135S,A00,494369,Braswell; Geoffrey E.,0,0,0,0
1713348981553,CAT 124RS,A01,519847,Geibel; William,17,0,20,3
1713348982579,CAT 125RS,A01,515971,Geibel; William,17,0,20,3
1713348983606,CLRE 250,A00,511389,Morris; Sheldon,9996,0,9999,3
1713348984672,CLRE 251,A00,507176,Mehta; Ravindra L.,9996,0,9999,3
1713348984672,CLRE 251,B00,511410,Mehta; Ravindra L.,9998,0,9999,1
1713348985698,CLRE 252,A00,507189,Cuomo; Raphael Eduardo,9998,0,9999,1
1713348986725,CLRE 253,A00,507199,Vaida; Florin,9997,0,9999,2
1713348986725,CLRE 253,B00,507202,Vaida; Florin,9999,0,9999,0
1713348987753,CLRE 259,A00,507211,Patel; Hemal,9996,0,9999,3
1713348988779,CLRE 260,A00,507221,Cuomo; Raphael Eduardo,9999,0,9999,0
1713348989803,CLRE 297,001,507242,Cuomo; Raphael Eduardo,9999,0,9999,0
1713348990830,CSE 191,A00,516875,Minnes Kemp; Mor Mia,9999,0,9999,0
1713348991857,CSS 201S,A01,494383,Staff,35,0,35,0
1713348992883,CSS 202S,A01,494387,Staff,35,0,35,0
1713348993912,EAP 100,A00,516065,Staff,9792,0,9999,207
1713348994939,ECE 45,A01,507414,Staff,51,0,60,9
1713348995969,ECE 100,A01,507416,Baghdadchi; Saharnaz,10,0,20,10
1713348995969,ECE 100,A02,507418,Baghdadchi; Saharnaz,20,0,20,0
1713348996999,ECE 111,A01,507420,Staff,38,0,50,12
1713348998026,ECE 197,001,548057,Sievenpiper; Daniel F.,9998,0,9999,1
1713348999052,EDS 115,A00,507243,Choi; Bailey Miyeon,28,0,28,0
1713349000077,EDS 117,A01,494379,Staff,23,0,25,2
1713349001107,EDS 125,A00,507246,Hopkins; Megan Beth,29,0,30,1
1713349002133,EDS 128A,A01,507264,Fargason; Sharon Gayle,26,0,26,0
1713349003156,EDS 128B,A01,507293,Pappas; Elizabeth,30,0,30,0
1713349004182,EDS 139,A00,507294,Fargason; Sharon Gayle,30,0,30,0
1713349004182,EDS 139,B00,507313,Pappas; Elizabeth,30,0,30,0
1713349005210,EDS 201,A00,507315,Staff,26,0,30,4
1713349006236,EDS 203,A01,507317,Halter; Christopher P.,26,0,30,4
1713349007263,EDS 204R,A01,507319,Halter; Christopher P.,3,0,30,27
1713349007263,EDS 204R,B01,507331,Heinzman; Erica M.,28,0,30,2
1713349008290,EDS 206R,A00,507332,Staff,4,0,30,26
1713349008290,EDS 206R,B00,507343,Staff,28,0,30,2
1713349009317,EDS 250,A00,507344,Hemans; Patricia Ann Benitez,36,0,40,4
1713349010342,EDS 281,A00,507345,Daly; Alan J.,18,0,18,0
1713349011370,EDS 284,A00,507350,Daly; Alan J.,16,0,16,0
1713349012400,EDS 286,A00,507359,Fine; Sarah,18,0,18,0
1713349013426,EDS 289C,A01,507361,Daly; Alan J.,18,0,18,0
1713349014450,EDS 290,A00,507366,Hofstetter; Carolyn,15,0,15,0
1713349015478,LIGM 5A,A00,507421,Fischer-Grunski; Eva K,20,0,20,0
1713349016503,LIGM 5B,A00,507423,Fischer-Grunski; Eva K,20,0,20,0
1713349017533,LIGM 5C,A00,507425,Fischer-Grunski; Eva K,20,0,20,0
1713349018558,LIIT 5AS,A00,507427,Carnelos; Chiara,20,0,20,0
1713349019585,LIIT 5BS,A00,507430,Carnelos; Chiara,20,0,20,0
1713349020611,LIIT 5CS,A00,507432,Carnelos; Chiara,20,0,20,0
1713349021642,LISP 5A,A00,507541,Munoz Sanchez; Alicia,17,0,20,3
1713349022667,LISP 5B,A00,507671,Munoz Sanchez; Alicia,15,0,20,5
1713349023693,LISP 5C,A00,507696,Munoz Sanchez; Alicia,15,0,20,5
1713349024720,MAE 197,001,528363,Boechler; Nicholas Sebastia,9998,0,9999,1
1713349025750,MATH 197,001,523477,Kedlaya; Kiran S.,9999,0,9999,0
1713349025750,MATH 197,002,563811,Zhang; Danna,9999,0,9999,0
1713349026780,MCWP 40R,A00,518780,Staff,20,0,20,0
1713349026780,MCWP 40R,B00,518781,Staff,19,0,20,1
1713349026780,MCWP 40R,C00,518783,Staff,19,0,20,1
1713349027810,MCWP 50R,A00,518791,Staff,20,0,20,0
1713349027810,MCWP 50R,B00,518792,Staff,17,0,20,3
1713349027810,MCWP 50R,C00,518793,Staff,19,0,20,1
1713349027810,MCWP 50R,D00,518794,Staff,16,0,20,4
1713349027810,MCWP 50R,E00,518795,Staff,16,0,20,4
1713349027810,MCWP 50R,F00,518796,Staff,19,0,20,1
1713349027810,MCWP 50R,G00,518797,Staff,19,0,20,1
1713349028836,MMW 12R,A01,514034,Herbst; Matthew,15,0,16,1
1713349028836,MMW 12R,A02,514035,Herbst; Matthew,16,0,16,0
1713349029861,MMW 13R,A01,514037,Staff,12,0,16,4
1713349029861,MMW 13R,A02,514039,Staff,16,0,16,0
1713349031921,SIO 295LS,A00,523233,Staff,18,0,30,12
1713349032951,SIO 295S,A00,523232,Staff,18,0,30,12
1713349033981,SOCI 117,A01,494376,Staff,1,0,5,4
1713349035008,WES 237B,A00,494380,Staff,19,0,20,1
1713349037075,AESE 279B,A00,494370,Wade; Jon P,33,0,33,0
1713349038105,ANAR 135S,A00,494369,Braswell; Geoffrey E.,0,0,0,0
1713349039132,CAT 124RS,A01,519847,Geibel; William,17,0,20,3
1713349040156,CAT 125RS,A01,515971,Geibel; William,17,0,20,3
1713349041196,CLRE 250,A00,511389,Morris; Sheldon,9996,0,9999,3
1713349042232,CLRE 251,A00,507176,Mehta; Ravindra L.,9996,0,9999,3
1713349042232,CLRE 251,B00,511410,Mehta; Ravindra L.,9998,0,9999,1
1713349043263,CLRE 252,A00,507189,Cuomo; Raphael Eduardo,9998,0,9999,1
1713349044294,CLRE 253,A00,507199,Vaida; Florin,9997,0,9999,2
1713349044294,CLRE 253,B00,507202,Vaida; Florin,9999,0,9999,0
1713349045323,CLRE 259,A00,507211,Patel; Hemal,9996,0,9999,3
1713349046348,CLRE 260,A00,507221,Cuomo; Raphael Eduardo,9999,0,9999,0
1713349047377,CLRE 297,001,507242,Cuomo; Raphael Eduardo,9999,0,9999,0
1713349048408,CSE 191,A00,516875,Minnes Kemp; Mor Mia,9999,0,9999,0
1713349049442,CSS 201S,A01,494383,Staff,35,0,35,0
1713349050468,CSS 202S,A01,494387,Staff,35,0,35,0
1713349051496,EAP 100,A00,516065,Staff,9792,0,9999,207
1713349052524,ECE 45,A01,507414,Staff,51,0,60,9
1713349053550,ECE 100,A01,507416,Baghdadchi; Saharnaz,10,0,20,10
1713349053550,ECE 100,A02,507418,Baghdadchi; Saharnaz,20,0,20,0
1713349054574,ECE 111,A01,507420,Staff,38,0,50,12
1713349055600,ECE 197,001,548057,Sievenpiper; Daniel F.,9998,0,9999,1
1713349056630,EDS 115,A00,507243,Choi; Bailey Miyeon,28,0,28,0
1713349057657,EDS 117,A01,494379,Staff,23,0,25,2
1713349058683,EDS 125,A00,507246,Hopkins; Megan Beth,29,0,30,1
1713349059714,EDS 128A,A01,507264,Fargason; Sharon Gayle,26,0,26,0
1713349060800,EDS 128B,A01,507293,Pappas; Elizabeth,30,0,30,0
1713349061825,EDS 139,A00,507294,Fargason; Sharon Gayle,30,0,30,0
1713349061825,EDS 139,B00,507313,Pappas; Elizabeth,30,0,30,0
1713349062851,EDS 201,A00,507315,Staff,26,0,30,4
1713349063878,EDS 203,A01,507317,Halter; Christopher P.,26,0,30,4
1713349064909,EDS 204R,A01,507319,Halter; Christopher P.,3,0,30,27
1713349064909,EDS 204R,B01,507331,Heinzman; Erica M.,28,0,30,2
1713349065938,EDS 206R,A00,507332,Staff,4,0,30,26
1713349065938,EDS 206R,B00,507343,Staff,28,0,30,2
1713349066963,EDS 250,A00,507344,Hemans; Patricia Ann Benitez,36,0,40,4
1713349067991,EDS 281,A00,507345,Daly; Alan J.,18,0,18,0
1713349069015,EDS 284,A00,507350,Daly; Alan J.,16,0,16,0
1713349070044,EDS 286,A00,507359,Fine; Sarah,18,0,18,0
1713349071070,EDS 289C,A01,507361,Daly; Alan J.,18,0,18,0
1713349072095,EDS 290,A00,507366,Hofstetter; Carolyn,15,0,15,0
1713349073121,LIGM 5A,A00,507421,Fischer-Grunski; Eva K,20,0,20,0
1713349074150,LIGM 5B,A00,507423,Fischer-Grunski; Eva K,20,0,20,0
1713349075175,LIGM 5C,A00,507425,Fischer-Grunski; Eva K,20,0,20,0
1713349076201,LIIT 5AS,A00,507427,Carnelos; Chiara,20,0,20,0
1713349077227,LIIT 5BS,A00,507430,Carnelos; Chiara,20,0,20,0
1713349078253,LIIT 5CS,A00,507432,Carnelos; Chiara,20,0,20,0
1713349079284,LISP 5A,A00,507541,Munoz Sanchez; Alicia,17,0,20,3
1713349080310,LISP 5B,A00,507671,Munoz Sanchez; Alicia,15,0,20,5
1713349081342,LISP 5C,A00,507696,Munoz Sanchez; Alicia,15,0,20,5
1713349082371,MAE 197,001,528363,Boechler; Nicholas Sebastia,9998,0,9999,1
1713349083399,MATH 197,001,523477,Kedlaya; Kiran S.,9999,0,9999,0
1713349083399,MATH 197,002,563811,Zhang; Danna,9999,0,9999,0
1713349084424,MCWP 40R,A00,518780,Staff,20,0,20,0
1713349084424,MCWP 40R,B00,518781,Staff,19,0,20,1
1713349084424,MCWP 40R,C00,518783,Staff,19,0,20,1
1713349085466,MCWP 50R,A00,518791,Staff,20,0,20,0
1713349085466,MCWP 50R,B00,518792,Staff,17,0,20,3
1713349085466,MCWP 50R,C00,518793,Staff,19,0,20,1
1713349085466,MCWP 50R,D00,518794,Staff,16,0,20,4
1713349085466,MCWP 50R,E00,518795,Staff,16,0,20,4
1713349085466,MCWP 50R,F00,518796,Staff,19,0,20,1
1713349085466,MCWP 50R,G00,518797,Staff,19,0,20,1
1713349086497,MMW 12R,A01,514034,Herbst; Matthew,15,0,16,1
1713349086497,MMW 12R,A02,514035,Herbst; Matthew,16,0,16,0
1713349087527,MMW 13R,A01,514037,Staff,12,0,16,4
1713349087527,MMW 13R,A02,514039,Staff,16,0,16,0
1713349089583,SIO 295LS,A00,523233,Staff,18,0,30,12
1713349090613,SIO 295S,A00,523232,Staff,18,0,30,12
1713349091641,SOCI 117,A01,494376,Staff,1,0,5,4
1713349092670,WES 237B,A00,494380,Staff,19,0,20,1
1713349094737,AESE 279B,A00,494370,Wade; Jon P,33,0,33,0
1713349095763,ANAR 135S,A00,494369,Braswell; Geoffrey E.,0,0,0,0
1713349096789,CAT 124RS,A01,519847,Geibel; William,17,0,20,3
1713349097814,CAT 125RS,A01,515971,Geibel; William,17,0,20,3
1713349098848,CLRE 250,A00,511389,Morris; Sheldon,9996,0,9999,3
1713349099874,CLRE 251,A00,507176,Mehta; Ravindra L.,9996,0,9999,3
1713349099874,CLRE 251,B00,511410,Mehta; Ravindra L.,9998,0,9999,1
1713349100905,CLRE 252,A00,507189,Cuomo; Raphael Eduardo,9998,0,9999,1
1713349101937,CLRE 253,A00,507199,Vaida; Florin,9997,0,9999,2
1713349101937,CLRE 253,B00,507202,Vaida; Florin,9999,0,9999,0
1713349102967,CLRE 259,A00,507211,Patel; Hemal,9996,0,9999,3
1713349103992,CLRE 260,A00,507221,Cuomo; Raphael Eduardo,9999,0,9999,0
1713349105019,CLRE 297,001,507242,Cuomo; Raphael Eduardo,9999,0,9999,0
1713349106046,CSE 191,A00,516875,Minnes Kemp; Mor Mia,9999,0,9999,0
1713349107071,CSS 201S,A01,494383,Staff,35,0,35,0
1713349108098,CSS 202S,A01,494387,Staff,35,0,35,0
1713349109125,EAP 100,A00,516065,Staff,9792,0,9999,207
1713349110152,ECE 45,A01,507414,Staff,51,0,60,9
1713349111178,ECE 100,A01,507416,Baghdadchi; Saharnaz,10,0,20,10
1713349111178,ECE 100,A02,507418,Baghdadchi; Saharnaz,20,0,20,0
1713349112203,ECE 111,A01,507420,Staff,38,0,50,12
1713349113232,ECE 197,001,548057,Sievenpiper; Daniel F.,9998,0,9999,1
1713349114263,EDS 115,A00,507243,Choi; Bailey Miyeon,28,0,28,0
1713349115297,EDS 117,A01,494379,Staff,23,0,25,2
1713349116323,EDS 125,A00,507246,Hopkins; Megan Beth,29,0,30,1
1713349117349,EDS 128A,A01,507264,Fargason; Sharon Gayle,26,0,26,0
1713349118379,EDS 128B,A01,507293,Pappas; Elizabeth,30,0,30,0
1713349119407,EDS 139,A00,507294,Fargason; Sharon Gayle,30,0,30,0
1713349119407,EDS 139,B00,507313,Pappas; Elizabeth,30,0,30,0
1713349120436,EDS 201,A00,507315,Staff,26,0,30,4
1713349121461,EDS 203,A01,507317,Halter; Christopher P.,26,0,30,4
1713349122487,EDS 204R,A01,507319,Halter; Christopher P.,3,0,30,27
1713349122487,EDS 204R,B01,507331,Heinzman; Erica M.,28,0,30,2
1713349123515,EDS 206R,A00,507332,Staff,4,0,30,26
1713349123515,EDS 206R,B00,507343,Staff,28,0,30,2
1713349124544,EDS 250,A00,507344,Hemans; Patricia Ann Benitez,36,0,40,4
1713349125569,EDS 281,A00,507345,Daly; Alan J.,18,0,18,0
1713349126595,EDS 284,A00,507350,Daly; Alan J.,16,0,16,0
1713349127622,EDS 286,A00,507359,Fine; Sarah,18,0,18,0
1713349128648,EDS 289C,A01,507361,Daly; Alan J.,18,0,18,0
1713349129679,EDS 290,A00,507366,Hofstetter; Carolyn,15,0,15,0
1713349130719,LIGM 5A,A00,507421,Fischer-Grunski; Eva K,20,0,20,0
1713349131744,LIGM 5B,A00,507423,Fischer-Grunski; Eva K,20,0,20,0
1713349132769,LIGM 5C,A00,507425,Fischer-Grunski; Eva K,20,0,20,0
1713349133796,LIIT 5AS,A00,507427,Carnelos; Chiara,20,0,20,0
1713349134822,LIIT 5BS,A00,507430,Carnelos; Chiara,20,0,20,0
1713349135851,LIIT 5CS,A00,507432,Carnelos; Chiara,20,0,20,0
1713349136882,LISP 5A,A00,507541,Munoz Sanchez; Alicia,17,0,20,3
1713349137908,LISP 5B,A00,507671,Munoz Sanchez; Alicia,15,0,20,5
1713349138933,LISP 5C,A00,507696,Munoz Sanchez; Alicia,15,0,20,5
1713349139965,MAE 197,001,528363,Boechler; Nicholas Sebastia,9998,0,9999,1
1713349140992,MATH 197,001,523477,Kedlaya; Kiran S.,9999,0,9999,0
1713349140992,MATH 197,002,563811,Zhang; Danna,9999,0,9999,0
1713349142019,MCWP 40R,A00,518780,Staff,20,0,20,0
1713349142019,MCWP 40R,B00,518781,Staff,19,0,20,1
1713349142019,MCWP 40R,C00,518783,Staff,19,0,20,1
1713349143051,MCWP 50R,A00,518791,Staff,20,0,20,0
1713349143051,MCWP 50R,B00,518792,Staff,17,0,20,3
1713349143051,MCWP 50R,C00,518793,Staff,19,0,20,1
1713349143051,MCWP 50R,D00,518794,Staff,16,0,20,4
1713349143051,MCWP 50R,E00,518795,Staff,16,0,20,4
1713349143051,MCWP 50R,F00,518796,Staff,19,0,20,1
1713349143051,MCWP 50R,G00,518797,Staff,19,0,20,1
1713349144077,MMW 12R,A01,514034,Herbst; Matthew,15,0,16,1
1713349144077,MMW 12R,A02,514035,Herbst; Matthew,16,0,16,0
1713349145101,MMW 13R,A01,514037,Staff,12,0,16,4
1713349145101,MMW 13R,A02,514039,Staff,16,0,16,0
1713349147160,SIO 295LS,A00,523233,Staff,18,0,30,12
1713349148188,SIO 295S,A00,523232,Staff,18,0,30,12
1713349149215,SOCI 117,A01,494376,Staff,1,0,5,4
1713349150240,WES 237B,A00,494380,Staff,19,0,20,1
1713349152327,AESE 279B,A00,494370,Wade; Jon P,33,0,33,0
1713349153356,ANAR 135S,A00,494369,Braswell; Geoffrey E.,0,0,0,0
1713349154387,CAT 124RS,A01,519847,Geibel; William,17,0,20,3
1713349155413,CAT 125RS,A01,515971,Geibel; William,17,0,20,3
1713349156439,CLRE 250,A00,511389,Morris; Sheldon,9996,0,9999,3
1713349157466,CLRE 251,A00,507176,Mehta; Ravindra L.,9996,0,9999,3
1713349157466,CLRE 251,B00,511410,Mehta; Ravindra L.,9998,0,9999,1
1713349158491,CLRE 252,A00,507189,Cuomo; Raphael Eduardo,9998,0,9999,1
1713349159522,CLRE 253,A00,507199,Vaida; Florin,9997,0,9999,2
1713349159522,CLRE 253,B00,507202,Vaida; Florin,9999,0,9999,0
1713349160552,CLRE 259,A00,507211,Patel; Hemal,9996,0,9999,3
1713349161576,CLRE 260,A00,507221,Cuomo; Raphael Eduardo,9999,0,9999,0
1713349162606,CLRE 297,001,507242,Cuomo; Raphael Eduardo,9999,0,9999,0
1713349163632,CSE 191,A00,516875,Minnes Kemp; Mor Mia,9999,0,9999,0
1713349164719,CSS 201S,A01,494383,Staff,35,0,35,0
1713349165744,CSS 202S,A01,494387,Staff,35,0,35,0
1713349166773,EAP 100,A00,516065,Staff,9792,0,9999,207
1713349167804,ECE 45,A01,507414,Staff,51,0,60,9
1713349168830,ECE 100,A01,507416,Baghdadchi; Saharnaz,10,0,20,10
1713349168830,ECE 100,A02,507418,Baghdadchi; Saharnaz,20,0,20,0
1713349169866,ECE 111,A01,507420,Staff,38,0,50,12
1713349170892,ECE 197,001,548057,Sievenpiper; Daniel F.,9998,0,9999,1
1713349171918,EDS 115,A00,507243,Choi; Bailey Miyeon,28,0,28,0
1713349172954,EDS 117,A01,494379,Staff,23,0,25,2
1713349173981,EDS 125,A00,507246,Hopkins; Megan Beth,29,0,30,1
1713349175012,EDS 128A,A01,507264,Fargason; Sharon Gayle,26,0,26,0
1713349176042,EDS 128B,A01,507293,Pappas; Elizabeth,30,0,30,0
1713349177074,EDS 139,A00,507294,Fargason; Sharon Gayle,30,0,30,0
1713349177074,EDS 139,B00,507313,Pappas; Elizabeth,30,0,30,0
1713349178101,EDS 201,A00,507315,Staff,26,0,30,4
1713349179143,EDS 203,A01,507317,Halter; Christopher P.,26,0,30,4
1713349180169,EDS 204R,A01,507319,Halter; Christopher P.,3,0,30,27
1713349180169,EDS 204R,B01,507331,Heinzman; Erica M.,28,0,30,2
1713349181196,EDS 206R,A00,507332,Staff,4,0,30,26
1713349181196,EDS 206R,B00,507343,Staff,28,0,30,2
1713349182222,EDS 250,A00,507344,Hemans; Patricia Ann Benitez,36,0,40,4
1713349183248,EDS 281,A00,507345,Daly; Alan J.,18,0,18,0
1713349184274,EDS 284,A00,507350,Daly; Alan J.,16,0,16,0
1713349185299,EDS 286,A00,507359,Fine; Sarah,18,0,18,0
1713349186325,EDS 289C,A01,507361,Daly; Alan J.,18,0,18,0
1713349187351,EDS 290,A00,507366,Hofstetter; Carolyn,15,0,15,0
1713349188378,LIGM 5A,A00,507421,Fischer-Grunski; Eva K,20,0,20,0
1713349189404,LIGM 5B,A00,507423,Fischer-Grunski; Eva K,20,0,20,0
1713349190429,LIGM 5C,A00,507425,Fischer-Grunski; Eva K,20,0,20,0
1713349191455,LIIT 5AS,A00,507427,Carnelos; Chiara,20,0,20,0
1713349192481,LIIT 5BS,A00,507430,Carnelos; Chiara,20,0,20,0
1713349194933,LIIT 5CS,A00,507432,Carnelos; Chiara,20,0,20,0
1713349195963,LISP 5A,A00,507541,Munoz Sanchez; Alicia,17,0,20,3
1713349196989,LISP 5B,A00,507671,Munoz Sanchez; Alicia,15,0,20,5
1713349198020,LISP 5C,A00,507696,Munoz Sanchez; Alicia,15,0,20,5
1713349199049,MAE 197,001,528363,Boechler; Nicholas Sebastia,9998,0,9999,1
1713349200079,MATH 197,001,523477,Kedlaya; Kiran S.,9999,0,9999,0
1713349200079,MATH 197,002,563811,Zhang; Danna,9999,0,9999,0
1713349201115,MCWP 40R,A00,518780,Staff,20,0,20,0
1713349201115,MCWP 40R,B00,518781,Staff,19,0,20,1
1713349201115,MCWP 40R,C00,518783,Staff,19,0,20,1
1713349202152,MCWP 50R,A00,518791,Staff,20,0,20,0
1713349202152,MCWP 50R,B00,518792,Staff,17,0,20,3
1713349202152,MCWP 50R,C00,518793,Staff,19,0,20,1
1713349202152,MCWP 50R,D00,518794,Staff,16,0,20,4
1713349202152,MCWP 50R,E00,518795,Staff,16,0,20,4
1713349202152,MCWP 50R,F00,518796,Staff,19,0,20,1
1713349202152,MCWP 50R,G00,518797,Staff,19,0,20,1
1713349203178,MMW 12R,A01,514034,Herbst; Matthew,15,0,16,1
1713349203178,MMW 12R,A02,514035,Herbst; Matthew,16,0,16,0
1713349204205,MMW 13R,A01,514037,Staff,12,0,16,4
1713349204205,MMW 13R,A02,514039,Staff,16,0,16,0
1713349206256,SIO 295LS,A00,523233,Staff,18,0,30,12
1713349207286,SIO 295S,A00,523232,Staff,18,0,30,12
1713349208312,SOCI 117,A01,494376,Staff,1,0,5,4
1713349209337,WES 237B,A00,494380,Staff,19,0,20,1
1713349211404,AESE 279B,A00,494370,Wade; Jon P,33,0,33,0
1713349212430,ANAR 135S,A00,494369,Braswell; Geoffrey E.,0,0,0,0
1713349213456,CAT 124RS,A01,519847,Geibel; William,17,0,20,3
1713349214483,CAT 125RS,A01,515971,Geibel; William,17,0,20,3
1713349215513,CLRE 250,A00,511389,Morris; Sheldon,9996,0,9999,3
1713349216566,CLRE 251,A00,507176,Mehta; Ravindra L.,9996,0,9999,3
1713349216566,CLRE 251,B00,511410,Mehta; Ravindra L.,9998,0,9999,1
1713349217593,CLRE 252,A00,507189,Cuomo; Raphael Eduardo,9998,0,9999,1
1713349218623,CLRE 253,A00,507199,Vaida; Florin,9997,0,9999,2
1713349218623,CLRE 253,B00,507202,Vaida; Florin,9999,0,9999,0
1713349219647,CLRE 259,A00,507211,Patel; Hemal,9996,0,9999,3
1713349220679,CLRE 260,A00,507221,Cuomo; Raphael Eduardo,9999,0,9999,0
1713349221705,CLRE 297,001,507242,Cuomo; Raphael Eduardo,9999,0,9999,0
1713349222729,CSE 191,A00,516875,Minnes Kemp; Mor Mia,9999,0,9999,0
1713349223757,CSS 201S,A01,494383,Staff,35,0,35,0
1713349224783,CSS 202S,A01,494387,Staff,35,0,35,0
1713349225808,EAP 100,A00,516065,Staff,9792,0,9999,207
1713349226838,ECE 45,A01,507414,Staff,51,0,60,9
1713349227867,ECE 100,A01,507416,Baghdadchi; Saharnaz,10,0,20,10
1713349227867,ECE 100,A02,507418,Baghdadchi; Saharnaz,20,0,20,0
1713349228909,ECE 111,A01,507420,Staff,38,0,50,12
1713349229934,ECE 197,001,548057,Sievenpiper; Daniel F.,9998,0,9999,1
1713349230968,EDS 115,A00,507243,Choi; Bailey Miyeon,28,0,28,0
1713349231994,EDS 117,A01,494379,Staff,23,0,25,2
1713349233027,EDS 125,A00,507246,Hopkins; Megan Beth,29,0,30,1
1713349234052,EDS 128A,A01,507264,Fargason; Sharon Gayle,26,0,26,0
1713349235084,EDS 128B,A01,507293,Pappas; Elizabeth,30,0,30,0
1713349236114,EDS 139,A00,507294,Fargason; Sharon Gayle,30,0,30,0
1713349236114,EDS 139,B00,507313,Pappas; Elizabeth,30,0,30,0
1713349237142,EDS 201,A00,507315,Staff,26,0,30,4
1713349238170,EDS 203,A01,507317,Halter; Christopher P.,26,0,30,4
1713349239201,EDS 204R,A01,507319,Halter; Christopher P.,3,0,30,27
1713349239201,EDS 204R,B01,507331,Heinzman; Erica M.,28,0,30,2
1713349240231,EDS 206R,A00,507332,Staff,4,0,30,26
1713349240231,EDS 206R,B00,507343,Staff,28,0,30,2
1713349241258,EDS 250,A00,507344,Hemans; Patricia Ann Benitez,36,0,40,4
1713349242285,EDS 281,A00,507345,Daly; Alan J.,18,0,18,0
1713349243309,EDS 284,A00,507350,Daly; Alan J.,16,0,16,0
1713349244345,EDS 286,A00,507359,Fine; Sarah,18,0,18,0
1713349245375,EDS 289C,A01,507361,Daly; Alan J.,18,0,18,0
1713349246405,EDS 290,A00,507366,Hofstetter; Carolyn,15,0,15,0
1713349247432,LIGM 5A,A00,507421,Fischer-Grunski; Eva K,20,0,20,0
1713349248461,LIGM 5B,A00,507423,Fischer-Grunski; Eva K,20,0,20,0
1713349249490,LIGM 5C,A00,507425,Fischer-Grunski; Eva K,20,0,20,0
1713349250522,LIIT 5AS,A00,507427,Carnelos; Chiara,20,0,20,0
1713349251548,LIIT 5BS,A00,507430,Carnelos; Chiara,20,0,20,0
1713349252578,LIIT 5CS,A00,507432,Carnelos; Chiara,20,0,20,0
1713349253604,LISP 5A,A00,507541,Munoz Sanchez; Alicia,17,0,20,3
1713349254630,LISP 5B,A00,507671,Munoz Sanchez; Alicia,15,0,20,5
1713349255660,LISP 5C,A00,507696,Munoz Sanchez; Alicia,15,0,20,5
1713349256687,MAE 197,001,528363,Boechler; Nicholas Sebastia,9998,0,9999,1
1713349257715,MATH 197,001,523477,Kedlaya; Kiran S.,9999,0,9999,0
1713349257715,MATH 197,002,563811,Zhang; Danna,9999,0,9999,0
1713349258746,MCWP 40R,A00,518780,Staff,20,0,20,0
1713349258746,MCWP 40R,B00,518781,Staff,19,0,20,1
1713349258746,MCWP 40R,C00,518783,Staff,19,0,20,1
1713349259773,MCWP 50R,A00,518791,Staff,20,0,20,0
1713349259773,MCWP 50R,B00,518792,Staff,17,0,20,3
1713349259773,MCWP 50R,C00,518793,Staff,19,0,20,1
1713349259773,MCWP 50R,D00,518794,Staff,16,0,20,4
1713349259773,MCWP 50R,E00,518795,Staff,16,0,20,4
1713349259773,MCWP 50R,F00,518796,Staff,19,0,20,1
1713349259773,MCWP 50R,G00,518797,Staff,19,0,20,1
1713349260804,MMW 12R,A01,514034,Herbst; Matthew,15,0,16,1
1713349260804,MMW 12R,A02,514035,Herbst; Matthew,16,0,16,0
1713349261830,MMW 13R,A01,514037,Staff,12,0,16,4
1713349261830,MMW 13R,A02,514039,Staff,16,0,16,0
1713349263892,SIO 295LS,A00,523233,Staff,18,0,30,12
1713349264918,SIO 295S,A00,523232,Staff,18,0,30,12
1713349265946,SOCI 117,A01,494376,Staff,1,0,5,4
1713349266973,WES 237B,A00,494380,Staff,19,0,20,1
1713349269067,AESE 279B,A00,494370,Wade; Jon P,33,0,33,0
1713349270148,ANAR 135S,A00,494369,Braswell; Geoffrey E.,0,0,0,0
1713349271176,CAT 124RS,A01,519847,Geibel; William,17,0,20,3
1713349272201,CAT 125RS,A01,515971,Geibel; William,17,0,20,3
1713349273226,CLRE 250,A00,511389,Morris; Sheldon,9996,0,9999,3
1713349274266,CLRE 251,A00,507176,Mehta; Ravindra L.,9996,0,9999,3
1713349274266,CLRE 251,B00,511410,Mehta; Ravindra L.,9998,0,9999,1
1713349275293,CLRE 252,A00,507189,Cuomo; Raphael Eduardo,9998,0,9999,1
1713349276319,CLRE 253,A00,507199,Vaida; Florin,9997,0,9999,2
1713349276319,CLRE 253,B00,507202,Vaida; Florin,9999,0,9999,0
1713349277345,CLRE 259,A00,507211,Patel; Hemal,9996,0,9999,3
1713349278371,CLRE 260,A00,507221,Cuomo; Raphael Eduardo,9999,0,9999,0
1713349279396,CLRE 297,001,507242,Cuomo; Raphael Eduardo,9999,0,9999,0
1713349280425,CSE 191,A00,516875,Minnes Kemp; Mor Mia,9999,0,9999,0
1713349281456,CSS 201S,A01,494383,Staff,35,0,35,0
1713349282481,CSS 202S,A01,494387,Staff,35,0,35,0
1713349283511,EAP 100,A00,516065,Staff,9792,0,9999,207
1713349284539,ECE 45,A01,507414,Staff,51,0,60,9
1713349285564,ECE 100,A01,507416,Baghdadchi; Saharnaz,10,0,20,10
1713349285564,ECE 100,A02,507418,Baghdadchi; Saharnaz,20,0,20,0
1713349286590,ECE 111,A01,507420,Staff,38,0,50,12
1713349287616,ECE 197,001,548057,Sievenpiper; Daniel F.,9998,0,9999,1
1713349288643,EDS 115,A00,507243,Choi; Bailey Miyeon,28,0,28,0
1713349289669,EDS 117,A01,494379,Staff,23,0,25,2
1713349290699,EDS 125,A00,507246,Hopkins; Megan Beth,29,0,30,1
1713349291724,EDS 128A,A01,507264,Fargason; Sharon Gayle,26,0,26,0
1713349292749,EDS 128B,A01,507293,Pappas; Elizabeth,30,0,30,0
1713349293775,EDS 139,A00,507294,Fargason; Sharon Gayle,30,0,30,0
1713349293775,EDS 139,B00,507313,Pappas; Elizabeth,30,0,30,0
1713349294804,EDS 201,A00,507315,Staff,26,0,30,4
1713349295836,EDS 203,A01,507317,Halter; Christopher P.,26,0,30,4
1713349296863,EDS 204R,A01,507319,Halter; Christopher P.,3,0,30,27
1713349296863,EDS 204R,B01,507331,Heinzman; Erica M.,28,0,30,2
1713349297887,EDS 206R,A00,507332,Staff,4,0,30,26
1713349297887,EDS 206R,B00,507343,Staff,28,0,30,2
1713349298912,EDS 250,A00,507344,Hemans; Patricia Ann Benitez,36,0,40,4
1713349299941,EDS 281,A00,507345,Daly; Alan J.,18,0,18,0
1713349300965,EDS 284,A00,507350,Daly; Alan J.,16,0,16,0
1713349301993,EDS 286,A00,507359,Fine; Sarah,18,0,18,0
1713349303018,EDS 289C,A01,507361,Daly; Alan J.,18,0,18,0
1713349304044,EDS 290,A00,507366,Hofstetter; Carolyn,15,0,15,0
1713349305073,LIGM 5A,A00,507421,Fischer-Grunski; Eva K,20,0,20,0
1713349306099,LIGM 5B,A00,507423,Fischer-Grunski; Eva K,20,0,20,0
1713349307130,LIGM 5C,A00,507425,Fischer-Grunski; Eva K,20,0,20,0
1713349308155,LIIT 5AS,A00,507427,Carnelos; Chiara,20,0,20,0
1713349309185,LIIT 5BS,A00,507430,Carnelos; Chiara,20,0,20,0
1713349310212,LIIT 5CS,A00,507432,Carnelos; Chiara,20,0,20,0
1713349311240,LISP 5A,A00,507541,Munoz Sanchez; Alicia,17,0,20,3
1713349312266,LISP 5B,A00,507671,Munoz Sanchez; Alicia,15,0,20,5
1713349313297,LISP 5C,A00,507696,Munoz Sanchez; Alicia,15,0,20,5
1713349314323,MAE 197,001,528363,Boechler; Nicholas Sebastia,9998,0,9999,1
1713349315350,MATH 197,001,523477,Kedlaya; Kiran S.,9999,0,9999,0
1713349315350,MATH 197,002,563811,Zhang; Danna,9999,0,9999,0
1713349316380,MCWP 40R,A00,518780,Staff,20,0,20,0
1713349316380,MCWP 40R,B00,518781,Staff,19,0,20,1
1713349316380,MCWP 40R,C00,518783,Staff,19,0,20,1
1713349317406,MCWP 50R,A00,518791,Staff,20,0,20,0
1713349317406,MCWP 50R,B00,518792,Staff,17,0,20,3
1713349317406,MCWP 50R,C00,518793,Staff,19,0,20,1
1713349317406,MCWP 50R,D00,518794,Staff,16,0,20,4
1713349317406,MCWP 50R,E00,518795,Staff,16,0,20,4
1713349317406,MCWP 50R,F00,518796,Staff,19,0,20,1
1713349317406,MCWP 50R,G00,518797,Staff,19,0,20,1
1713349318433,MMW 12R,A01,514034,Herbst; Matthew,15,0,16,1
1713349318433,MMW 12R,A02,514035,Herbst; Matthew,16,0,16,0
1713349319461,MMW 13R,A01,514037,Staff,12,0,16,4
1713349319461,MMW 13R,A02,514039,Staff,16,0,16,0
1713349321511,SIO 295LS,A00,523233,Staff,18,0,30,12
1713349322538,SIO 295S,A00,523232,Staff,18,0,30,12
1713349323567,SOCI 117,A01,494376,Staff,1,0,5,4
1713349324592,WES 237B,A00,494380,Staff,19,0,20,1
1713349326667,AESE 279B,A00,494370,Wade; Jon P,33,0,33,0
1713349327698,ANAR 135S,A00,494369,Braswell; Geoffrey E.,0,0,0,0
1713349328724,CAT 124RS,A01,519847,Geibel; William,17,0,20,3
1713349329754,CAT 125RS,A01,515971,Geibel; William,17,0,20,3
1713349330785,CLRE 250,A00,511389,Morris; Sheldon,9996,0,9999,3
1713349331813,CLRE 251,A00,507176,Mehta; Ravindra L.,9996,0,9999,3
1713349331813,CLRE 251,B00,511410,Mehta; Ravindra L.,9998,0,9999,1
1713349332844,CLRE 252,A00,507189,Cuomo; Raphael Eduardo,9998,0,9999,1
1713349333874,CLRE 253,A00,507199,Vaida; Florin,9997,0,9999,2
1713349333874,CLRE 253,B00,507202,Vaida; Florin,9999,0,9999,0
1713349334903,CLRE 259,A00,507211,Patel; Hemal,9996,0,9999,3
1713349335932,CLRE 260,A00,507221,Cuomo; Raphael Eduardo,9999,0,9999,0
1713349336958,CLRE 297,001,507242,Cuomo; Raphael Eduardo,9999,0,9999,0
1713349337984,CSE 191,A00,516875,Minnes Kemp; Mor Mia,9999,0,9999,0
1713349339016,CSS 201S,A01,494383,Staff,35,0,35,0
1713349340042,CSS 202S,A01,494387,Staff,35,0,35,0
1713349341067,EAP 100,A00,516065,Staff,9792,0,9999,207
1713349342100,ECE 45,A01,507414,Staff,51,0,60,9
1713349343126,ECE 100,A01,507416,Baghdadchi; Saharnaz,10,0,20,10
1713349343126,ECE 100,A02,507418,Baghdadchi; Saharnaz,20,0,20,0
1713349344155,ECE 111,A01,507420,Staff,38,0,50,12
1713349345180,ECE 197,001,548057,Sievenpiper; Daniel F.,9998,0,9999,1
1713349346207,EDS 115,A00,507243,Choi; Bailey Miyeon,28,0,28,0
1713349347238,EDS 117,A01,494379,Staff,23,0,25,2
1713349348263,EDS 125,A00,507246,Hopkins; Megan Beth,29,0,30,1
1713349349289,EDS 128A,A01,507264,Fargason; Sharon Gayle,26,0,26,0
1713349350313,EDS 128B,A01,507293,Pappas; Elizabeth,30,0,30,0
1713349351342,EDS 139,A00,507294,Fargason; Sharon Gayle,30,0,30,0
1713349351342,EDS 139,B00,507313,Pappas; Elizabeth,30,0,30,0
1713349352366,EDS 201,A00,507315,Staff,26,0,30,4
1713349353394,EDS 203,A01,507317,Halter; Christopher P.,26,0,30,4
1713349354420,EDS 204R,A01,507319,Halter; Christopher P.,3,0,30,27
1713349354420,EDS 204R,B01,507331,Heinzman; Erica M.,28,0,30,2
1713349355445,EDS 206R,A00,507332,Staff,4,0,30,26
1713349355445,EDS 206R,B00,507343,Staff,28,0,30,2
1713349356475,EDS 250,A00,507344,Hemans; Patricia Ann Benitez,36,0,40,4
1713349357505,EDS 281,A00,507345,Daly; Alan J.,18,0,18,0
1713349358534,EDS 284,A00,507350,Daly; Alan J.,16,0,16,0
1713349359561,EDS 286,A00,507359,Fine; Sarah,18,0,18,0
1713349360648,EDS 289C,A01,507361,Daly; Alan J.,18,0,18,0
1713349361675,EDS 290,A00,507366,Hofstetter; Carolyn,15,0,15,0
1713349362705,LIGM 5A,A00,507421,Fischer-Grunski; Eva K,20,0,20,0
1713349363733,LIGM 5B,A00,507423,Fischer-Grunski; Eva K,20,0,20,0
1713349364763,LIGM 5C,A00,507425,Fischer-Grunski; Eva K,20,0,20,0
1713349365788,LIIT 5AS,A00,507427,Carnelos; Chiara,20,0,20,0
1713349366817,LIIT 5BS,A00,507430,Carnelos; Chiara,20,0,20,0
1713349367843,LIIT 5CS,A00,507432,Carnelos; Chiara,20,0,20,0
1713349368871,LISP 5A,A00,507541,Munoz Sanchez; Alicia,17,0,20,3
1713349369897,LISP 5B,A00,507671,Munoz Sanchez; Alicia,15,0,20,5
1713349370926,LISP 5C,A00,507696,Munoz Sanchez; Alicia,15,0,20,5
1713349371952,MAE 197,001,528363,Boechler; Nicholas Sebastia,9998,0,9999,1
1713349372979,MATH 197,001,523477,Kedlaya; Kiran S.,9999,0,9999,0
1713349372979,MATH 197,002,563811,Zhang; Danna,9999,0,9999,0
1713349374065,MCWP 40R,A00,518780,Staff,20,0,20,0
1713349374065,MCWP 40R,B00,518781,Staff,19,0,20,1
1713349374065,MCWP 40R,C00,518783,Staff,19,0,20,1
1713349375094,MCWP 50R,A00,518791,Staff,20,0,20,0
1713349375094,MCWP 50R,B00,518792,Staff,17,0,20,3
1713349375094,MCWP 50R,C00,518793,Staff,19,0,20,1
1713349375094,MCWP 50R,D00,518794,Staff,16,0,20,4
1713349375094,MCWP 50R,E00,518795,Staff,16,0,20,4
1713349375094,MCWP 50R,F00,518796,Staff,19,0,20,1
1713349375094,MCWP 50R,G00,518797,Staff,19,0,20,1
1713349376126,MMW 12R,A01,514034,Herbst; Matthew,15,0,16,1
1713349376126,MMW 12R,A02,514035,Herbst; Matthew,16,0,16,0
1713349377156,MMW 13R,A01,514037,Staff,12,0,16,4
1713349377156,MMW 13R,A02,514039,Staff,16,0,16,0
1713349379211,SIO 295LS,A00,523233,Staff,18,0,30,12
1713349380239,SIO 295S,A00,523232,Staff,18,0,30,12
1713349381281,SOCI 117,A01,494376,Staff,1,0,5,4
1713349382309,WES 237B,A00,494380,Staff,19,0,20,1
1713349384380,AESE 279B,A00,494370,Wade; Jon P,33,0,33,0
1713349385407,ANAR 135S,A00,494369,Braswell; Geoffrey E.,0,0,0,0
1713349386435,CAT 124RS,A01,519847,Geibel; William,17,0,20,3
1713349387461,CAT 125RS,A01,515971,Geibel; William,17,0,20,3
1713349388494,CLRE 250,A00,511389,Morris; Sheldon,9996,0,9999,3
1713349389523,CLRE 251,A00,507176,Mehta; Ravindra L.,9996,0,9999,3
1713349389523,CLRE 251,B00,511410,Mehta; Ravindra L.,9998,0,9999,1
1713349390548,CLRE 252,A00,507189,Cuomo; Raphael Eduardo,9998,0,9999,1
1713349391577,CLRE 253,A00,507199,Vaida; Florin,9997,0,9999,2
1713349391577,CLRE 253,B00,507202,Vaida; Florin,9999,0,9999,0
1713349392602,CLRE 259,A00,507211,Patel; Hemal,9996,0,9999,3
1713349393628,CLRE 260,A00,507221,Cuomo; Raphael Eduardo,9999,0,9999,0
1713349394656,CLRE 297,001,507242,Cuomo; Raphael Eduardo,9999,0,9999,0
1713349395682,CSE 191,A00,516875,Minnes Kemp; Mor Mia,9999,0,9999,0
1713349396716,CSS 201S,A01,494383,Staff,35,0,35,0
1713349397742,CSS 202S,A01,494387,Staff,35,0,35,0
1713349398771,EAP 100,A00,516065,Staff,9792,0,9999,207
1713349399807,ECE 45,A01,507414,Staff,51,0,60,9
1713349400836,ECE 100,A01,507416,Baghdadchi; Saharnaz,10,0,20,10
1713349400836,ECE 100,A02,507418,Baghdadchi; Saharnaz,20,0,20,0
1713349401862,ECE 111,A01,507420,Staff,38,0,50,12
1713349402890,ECE 197,001,548057,Sievenpiper; Daniel F.,9998,0,9999,1
1713349403924,EDS 115,A00,507243,Choi; Bailey Miyeon,28,0,28,0
1713349404952,EDS 117,A01,494379,Staff,23,0,25,2
1713349405982,EDS 125,A00,507246,Hopkins; Megan Beth,29,0,30,1
1713349407013,EDS 128A,A01,507264,Fargason; Sharon Gayle,26,0,26,0
1713349408042,EDS 128B,A01,507293,Pappas; Elizabeth,30,0,30,0
1713349409066,EDS 139,A00,507294,Fargason; Sharon Gayle,30,0,30,0
1713349409066,EDS 139,B00,507313,Pappas; Elizabeth,30,0,30,0
1713349410095,EDS 201,A00,507315,Staff,26,0,30,4
1713349411120,EDS 203,A01,507317,Halter; Christopher P.,26,0,30,4
1713349412146,EDS 204R,A01,507319,Halter; Christopher P.,3,0,30,27
1713349412146,EDS 204R,B01,507331,Heinzman; Erica M.,28,0,30,2
1713349413173,EDS 206R,A00,507332,Staff,4,0,30,26
1713349413173,EDS 206R,B00,507343,Staff,28,0,30,2
1713349414201,EDS 250,A00,507344,Hemans; Patricia Ann Benitez,36,0,40,4
1713349415229,EDS 281,A00,507345,Daly; Alan J.,18,0,18,0
1713349416257,EDS 284,A00,507350,Daly; Alan J.,16,0,16,0
1713349417282,EDS 286,A00,507359,Fine; Sarah,18,0,18,0
1713349418308,EDS 289C,A01,507361,Daly; Alan J.,18,0,18,0
1713349419332,EDS 290,A00,507366,Hofstetter; Carolyn,15,0,15,0
1713349420368,LIGM 5A,A00,507421,Fischer-Grunski; Eva K,20,0,20,0
1713349421395,LIGM 5B,A00,507423,Fischer-Grunski; Eva K,20,0,20,0
1713349422423,LIGM 5C,A00,507425,Fischer-Grunski; Eva K,20,0,20,0
1713349423450,LIIT 5AS,A00,507427,Carnelos; Chiara,20,0,20,0
1713349424474,LIIT 5BS,A00,507430,Carnelos; Chiara,20,0,20,0
1713349425498,LIIT 5CS,A00,507432,Carnelos; Chiara,20,0,20,0
1713349426529,LISP 5A,A00,507541,Munoz Sanchez; Alicia,17,0,20,3
1713349427560,LISP 5B,A00,507671,Munoz Sanchez; Alicia,15,0,20,5
1713349428590,LISP 5C,A00,507696,Munoz Sanchez; Alicia,15,0,20,5
1713349429615,MAE 197,001,528363,Boechler; Nicholas Sebastia,9998,0,9999,1
1713349430641,MATH 197,001,523477,Kedlaya; Kiran S.,9999,0,9999,0
1713349430641,MATH 197,002,563811,Zhang; Danna,9999,0,9999,0
1713349431667,MCWP 40R,A00,518780,Staff,20,0,20,0
1713349431667,MCWP 40R,B00,518781,Staff,19,0,20,1
1713349431667,MCWP 40R,C00,518783,Staff,19,0,20,1
1713349432698,MCWP 50R,A00,518791,Staff,20,0,20,0
1713349432698,MCWP 50R,B00,518792,Staff,17,0,20,3
1713349432698,MCWP 50R,C00,518793,Staff,19,0,20,1
1713349432698,MCWP 50R,D00,518794,Staff,16,0,20,4
1713349432698,MCWP 50R,E00,518795,Staff,16,0,20,4
1713349432698,MCWP 50R,F00,518796,Staff,19,0,20,1
1713349432698,MCWP 50R,G00,518797,Staff,19,0,20,1
1713349433723,MMW 12R,A01,514034,Herbst; Matthew,15,0,16,1
1713349433723,MMW 12R,A02,514035,Herbst; Matthew,16,0,16,0
1713349434752,MMW 13R,A01,514037,Staff,12,0,16,4
1713349434752,MMW 13R,A02,514039,Staff,16,0,16,0
1713349436806,SIO 295LS,A00,523233,Staff,18,0,30,12
1713349437836,SIO 295S,A00,523232,Staff,18,0,30,12
1713349438861,SOCI 117,A01,494376,Staff,1,0,5,4
1713349439886,WES 237B,A00,494380,Staff,19,0,20,1
1713349441962,AESE 279B,A00,494370,Wade; Jon P,33,0,33,0
1713349442992,ANAR 135S,A00,494369,Braswell; Geoffrey E.,0,0,0,0
1713349444019,CAT 124RS,A01,519847,Geibel; William,17,0,20,3
1713349445044,CAT 125RS,A01,515971,Geibel; William,17,0,20,3
1713349446081,CLRE 250,A00,511389,Morris; Sheldon,9996,0,9999,3
1713349447108,CLRE 251,A00,507176,Mehta; Ravindra L.,9996,0,9999,3
1713349447108,CLRE 251,B00,511410,Mehta; Ravindra L.,9998,0,9999,1
1713349448566,CLRE 252,A00,507189,Cuomo; Raphael Eduardo,9998,0,9999,1
1713349449598,CLRE 253,A00,507199,Vaida; Florin,9997,0,9999,2
1713349449598,CLRE 253,B00,507202,Vaida; Florin,9999,0,9999,0
1713349450625,CLRE 259,A00,507211,Patel; Hemal,9996,0,9999,3
1713349451659,CLRE 260,A00,507221,Cuomo; Raphael Eduardo,9999,0,9999,0
1713349452688,CLRE 297,001,507242,Cuomo; Raphael Eduardo,9999,0,9999,0
1713349453720,CSE 191,A00,516875,Minnes Kemp; Mor Mia,9999,0,9999,0
1713349454757,CSS 201S,A01,494383,Staff,35,0,35,0
1713349455788,CSS 202S,A01,494387,Staff,35,0,35,0
1713349456814,EAP 100,A00,516065,Staff,9792,0,9999,207
1713349457848,ECE 45,A01,507414,Staff,51,0,60,9
1713349458879,ECE 100,A01,507416,Baghdadchi; Saharnaz,10,0,20,10
1713349458879,ECE 100,A02,507418,Baghdadchi; Saharnaz,20,0,20,0
1713349459903,ECE 111,A01,507420,Staff,38,0,50,12
1713349460932,ECE 197,001,548057,Sievenpiper; Daniel F.,9998,0,9999,1
1713349461959,EDS 115,A00,507243,Choi; Bailey Miyeon,28,0,28,0
1713349462984,EDS 117,A01,494379,Staff,23,0,25,2
1713349464011,EDS 125,A00,507246,Hopkins; Megan Beth,29,0,30,1
1713349465038,EDS 128A,A01,507264,Fargason; Sharon Gayle,26,0,26,0
1713349466064,EDS 128B,A01,507293,Pappas; Elizabeth,30,0,30,0
1713349467089,EDS 139,A00,507294,Fargason; Sharon Gayle,30,0,30,0
1713349467089,EDS 139,B00,507313,Pappas; Elizabeth,30,0,30,0
1713349468114,EDS 201,A00,507315,Staff,26,0,30,4
1713349469146,EDS 203,A01,507317,Halter; Christopher P.,26,0,30,4
1713349470178,EDS 204R,A01,507319,Halter; Christopher P.,3,0,30,27
1713349470178,EDS 204R,B01,507331,Heinzman; Erica M.,28,0,30,2
1713349471205,EDS 206R,A00,507332,Staff,4,0,30,26
1713349471205,EDS 206R,B00,507343,Staff,28,0,30,2
1713349472234,EDS 250,A00,507344,Hemans; Patricia Ann Benitez,36,0,40,4
1713349473263,EDS 281,A00,507345,Daly; Alan J.,18,0,18,0
1713349474291,EDS 284,A00,507350,Daly; Alan J.,16,0,16,0
1713349475322,EDS 286,A00,507359,Fine; Sarah,18,0,18,0
1713349476355,EDS 289C,A01,507361,Daly; Alan J.,18,0,18,0
1713349477381,EDS 290,A00,507366,Hofstetter; Carolyn,15,0,15,0
1713349478462,LIGM 5A,A00,507421,Fischer-Grunski; Eva K,20,0,20,0
1713349479493,LIGM 5B,A00,507423,Fischer-Grunski; Eva K,20,0,20,0
1713349480523,LIGM 5C,A00,507425,Fischer-Grunski; Eva K,20,0,20,0
1713349481552,LIIT 5AS,A00,507427,Carnelos; Chiara,20,0,20,0
1713349482577,LIIT 5BS,A00,507430,Carnelos; Chiara,20,0,20,0
1713349483607,LIIT 5CS,A00,507432,Carnelos; Chiara,20,0,20,0
1713349484631,LISP 5A,A00,507541,Munoz Sanchez; Alicia,17,0,20,3
1713349485657,LISP 5B,A00,507671,Munoz Sanchez; Alicia,15,0,20,5
1713349486681,LISP 5C,A00,507696,Munoz Sanchez; Alicia,15,0,20,5
1713349487709,MAE 197,001,528363,Boechler; Nicholas Sebastia,9998,0,9999,1
1713349488736,MATH 197,001,523477,Kedlaya; Kiran S.,9999,0,9999,0
1713349488736,MATH 197,002,563811,Zhang; Danna,9999,0,9999,0
1713349489759,MCWP 40R,A00,518780,Staff,20,0,20,0
1713349489759,MCWP 40R,B00,518781,Staff,19,0,20,1
1713349489759,MCWP 40R,C00,518783,Staff,19,0,20,1
1713349490790,MCWP 50R,A00,518791,Staff,20,0,20,0
1713349490790,MCWP 50R,B00,518792,Staff,17,0,20,3
1713349490790,MCWP 50R,C00,518793,Staff,19,0,20,1
1713349490790,MCWP 50R,D00,518794,Staff,16,0,20,4
1713349490790,MCWP 50R,E00,518795,Staff,16,0,20,4
1713349490790,MCWP 50R,F00,518796,Staff,19,0,20,1
1713349490790,MCWP 50R,G00,518797,Staff,19,0,20,1
1713349491816,MMW 12R,A01,514034,Herbst; Matthew,15,0,16,1
1713349491816,MMW 12R,A02,514035,Herbst; Matthew,16,0,16,0
1713349492840,MMW 13R,A01,514037,Staff,12,0,16,4
1713349492840,MMW 13R,A02,514039,Staff,16,0,16,0
1713349494893,SIO 295LS,A00,523233,Staff,18,0,30,12
1713349495994,SIO 295S,A00,523232,Staff,18,0,30,12
1713349497022,SOCI 117,A01,494376,Staff,1,0,5,4
1713349498047,WES 237B,A00,494380,Staff,19,0,20,1
1713349500108,AESE 279B,A00,494370,Wade; Jon P,33,0,33,0
1713349501133,ANAR 135S,A00,494369,Braswell; Geoffrey E.,0,0,0,0
1713349502158,CAT 124RS,A01,519847,Geibel; William,17,0,20,3
1713349503186,CAT 125RS,A01,515971,Geibel; William,17,0,20,3
1713349504215,CLRE 250,A00,511389,Morris; Sheldon,9996,0,9999,3
1713349505242,CLRE 251,A00,507176,Mehta; Ravindra L.,9996,0,9999,3
1713349505242,CLRE 251,B00,511410,Mehta; Ravindra L.,9998,0,9999,1
1713349506291,CLRE 252,A00,507189,Cuomo; Raphael Eduardo,9998,0,9999,1
1713349507321,CLRE 253,A00,507199,Vaida; Florin,9997,0,9999,2
1713349507321,CLRE 253,B00,507202,Vaida; Florin,9999,0,9999,0
1713349508346,CLRE 259,A00,507211,Patel; Hemal,9996,0,9999,3
1713349509373,CLRE 260,A00,507221,Cuomo; Raphael Eduardo,9999,0,9999,0
1713349510399,CLRE 297,001,507242,Cuomo; Raphael Eduardo,9999,0,9999,0
1713349511428,CSE 191,A00,516875,Minnes Kemp; Mor Mia,9999,0,9999,0
1713349512457,CSS 201S,A01,494383,Staff,35,0,35,0
1713349513487,CSS 202S,A01,494387,Staff,35,0,35,0
1713349514516,EAP 100,A00,516065,Staff,9792,0,9999,207
1713349515541,ECE 45,A01,507414,Staff,51,0,60,9
1713349516566,ECE 100,A01,507416,Baghdadchi; Saharnaz,10,0,20,10
1713349516566,ECE 100,A02,507418,Baghdadchi; Saharnaz,20,0,20,0
1713349517596,ECE 111,A01,507420,Staff,38,0,50,12
1713349518622,ECE 197,001,548057,Sievenpiper; Daniel F.,9998,0,9999,1
1713349519648,EDS 115,A00,507243,Choi; Bailey Miyeon,28,0,28,0
1713349520678,EDS 117,A01,494379,Staff,23,0,25,2
1713349521706,EDS 125,A00,507246,Hopkins; Megan Beth,29,0,30,1
1713349522736,EDS 128A,A01,507264,Fargason; Sharon Gayle,26,0,26,0
1713349523767,EDS 128B,A01,507293,Pappas; Elizabeth,30,0,30,0
1713349524792,EDS 139,A00,507294,Fargason; Sharon Gayle,30,0,30,0
1713349524792,EDS 139,B00,507313,Pappas; Elizabeth,30,0,30,0
1713349525820,EDS 201,A00,507315,Staff,26,0,30,4
1713349526845,EDS 203,A01,507317,Halter; Christopher P.,26,0,30,4
1713349527871,EDS 204R,A01,507319,Halter; Christopher P.,3,0,30,27
1713349527871,EDS 204R,B01,507331,Heinzman; Erica M.,28,0,30,2
1713349528897,EDS 206R,A00,507332,Staff,4,0,30,26
1713349528897,EDS 206R,B00,507343,Staff,28,0,30,2
1713349529922,EDS 250,A00,507344,Hemans; Patricia Ann Benitez,36,0,40,4
1713349530948,EDS 281,A00,507345,Daly; Alan J.,18,0,18,0
1713349531977,EDS 284,A00,507350,Daly; Alan J.,16,0,16,0
1713349533006,EDS 286,A00,507359,Fine; Sarah,18,0,18,0
1713349534035,EDS 289C,A01,507361,Daly; Alan J.,18,0,18,0
1713349535060,EDS 290,A00,507366,Hofstetter; Carolyn,15,0,15,0
1713349536085,LIGM 5A,A00,507421,Fischer-Grunski; Eva K,20,0,20,0
1713349537111,LIGM 5B,A00,507423,Fischer-Grunski; Eva K,20,0,20,0
1713349538135,LIGM 5C,A00,507425,Fischer-Grunski; Eva K,20,0,20,0
1713349539165,LIIT 5AS,A00,507427,Carnelos; Chiara,20,0,20,0
1713349540191,LIIT 5BS,A00,507430,Carnelos; Chiara,20,0,20,0
1713349541221,LIIT 5CS,A00,507432,Carnelos; Chiara,20,0,20,0
1713349542246,LISP 5A,A00,507541,Munoz Sanchez; Alicia,17,0,20,3
1713349543272,LISP 5B,A00,507671,Munoz Sanchez; Alicia,15,0,20,5
1713349544302,LISP 5C,A00,507696,Munoz Sanchez; Alicia,15,0,20,5
1713349545328,MAE 197,001,528363,Boechler; Nicholas Sebastia,9998,0,9999,1
1713349546358,MATH 197,001,523477,Kedlaya; Kiran S.,9999,0,9999,0
1713349546358,MATH 197,002,563811,Zhang; Danna,9999,0,9999,0
1713349547383,MCWP 40R,A00,518780,Staff,20,0,20,0
1713349547383,MCWP 40R,B00,518781,Staff,19,0,20,1
1713349547383,MCWP 40R,C00,518783,Staff,19,0,20,1
1713349548412,MCWP 50R,A00,518791,Staff,20,0,20,0
1713349548412,MCWP 50R,B00,518792,Staff,17,0,20,3
1713349548412,MCWP 50R,C00,518793,Staff,19,0,20,1
1713349548412,MCWP 50R,D00,518794,Staff,16,0,20,4
1713349548412,MCWP 50R,E00,518795,Staff,16,0,20,4
1713349548412,MCWP 50R,F00,518796,Staff,19,0,20,1
1713349548412,MCWP 50R,G00,518797,Staff,19,0,20,1
1713349549437,MMW 12R,A01,514034,Herbst; Matthew,15,0,16,1
1713349549437,MMW 12R,A02,514035,Herbst; Matthew,16,0,16,0
1713349550463,MMW 13R,A01,514037,Staff,12,0,16,4
1713349550463,MMW 13R,A02,514039,Staff,16,0,16,0
1713349552516,SIO 295LS,A00,523233,Staff,18,0,30,12
1713349553542,SIO 295S,A00,523232,Staff,18,0,30,12
1713349554570,SOCI 117,A01,494376,Staff,1,0,5,4
1713349555599,WES 237B,A00,494380,Staff,19,0,20,1
1713349557658,AESE 279B,A00,494370,Wade; Jon P,33,0,33,0
1713349558683,ANAR 135S,A00,494369,Braswell; Geoffrey E.,0,0,0,0
1713349559708,CAT 124RS,A01,519847,Geibel; William,17,0,20,3
1713349560734,CAT 125RS,A01,515971,Geibel; William,17,0,20,3
1713349561763,CLRE 250,A00,511389,Morris; Sheldon,9996,0,9999,3
1713349562789,CLRE 251,A00,507176,Mehta; Ravindra L.,9996,0,9999,3
1713349562789,CLRE 251,B00,511410,Mehta; Ravindra L.,9998,0,9999,1
1713349563813,CLRE 252,A00,507189,Cuomo; Raphael Eduardo,9998,0,9999,1
1713349564844,CLRE 253,A00,507199,Vaida; Florin,9997,0,9999,2
1713349564844,CLRE 253,B00,507202,Vaida; Florin,9999,0,9999,0
1713349565872,CLRE 259,A00,507211,Patel; Hemal,9996,0,9999,3
1713349566902,CLRE 260,A00,507221,Cuomo; Raphael Eduardo,9999,0,9999,0
1713349567932,CLRE 297,001,507242,Cuomo; Raphael Eduardo,9999,0,9999,0
1713349568957,CSE 191,A00,516875,Minnes Kemp; Mor Mia,9999,0,9999,0
1713349569984,CSS 201S,A01,494383,Staff,35,0,35,0
1713349571011,CSS 202S,A01,494387,Staff,35,0,35,0
1713349572037,EAP 100,A00,516065,Staff,9792,0,9999,207
1713349573064,ECE 45,A01,507414,Staff,51,0,60,9
1713349574094,ECE 100,A01,507416,Baghdadchi; Saharnaz,10,0,20,10
1713349574094,ECE 100,A02,507418,Baghdadchi; Saharnaz,20,0,20,0
1713349575121,ECE 111,A01,507420,Staff,38,0,50,12
1713349576152,ECE 197,001,548057,Sievenpiper; Daniel F.,9998,0,9999,1
1713349577182,EDS 115,A00,507243,Choi; Bailey Miyeon,28,0,28,0
1713349578208,EDS 117,A01,494379,Staff,23,0,25,2
1713349579235,EDS 125,A00,507246,Hopkins; Megan Beth,29,0,30,1
1713349580267,EDS 128A,A01,507264,Fargason; Sharon Gayle,26,0,26,0
1713349581298,EDS 128B,A01,507293,Pappas; Elizabeth,30,0,30,0
1713349582376,EDS 139,A00,507294,Fargason; Sharon Gayle,30,0,30,0
1713349582376,EDS 139,B00,507313,Pappas; Elizabeth,30,0,30,0
1713349583405,EDS 201,A00,507315,Staff,26,0,30,4
1713349584433,EDS 203,A01,507317,Halter; Christopher P.,26,0,30,4
1713349585462,EDS 204R,A01,507319,Halter; Christopher P.,3,0,30,27
1713349585462,EDS 204R,B01,507331,Heinzman; Erica M.,28,0,30,2
1713349586489,EDS 206R,A00,507332,Staff,4,0,30,26
1713349586489,EDS 206R,B00,507343,Staff,28,0,30,2
1713349587512,EDS 250,A00,507344,Hemans; Patricia Ann Benitez,36,0,40,4
1713349588542,EDS 281,A00,507345,Daly; Alan J.,18,0,18,0
1713349589567,EDS 284,A00,507350,Daly; Alan J.,16,0,16,0
1713349590595,EDS 286,A00,507359,Fine; Sarah,18,0,18,0
1713349591620,EDS 289C,A01,507361,Daly; Alan J.,18,0,18,0
1713349592645,EDS 290,A00,507366,Hofstetter; Carolyn,15,0,15,0
1713349593671,LIGM 5A,A00,507421,Fischer-Grunski; Eva K,20,0,20,0
1713349594699,LIGM 5B,A00,507423,Fischer-Grunski; Eva K,20,0,20,0
1713349595728,LIGM 5C,A00,507425,Fischer-Grunski; Eva K,20,0,20,0
1713349596757,LIIT 5AS,A00,507427,Carnelos; Chiara,20,0,20,0
1713349597784,LIIT 5BS,A00,507430,Carnelos; Chiara,20,0,20,0
1713349598810,LIIT 5CS,A00,507432,Carnelos; Chiara,20,0,20,0
1713349599840,LISP 5A,A00,507541,Munoz Sanchez; Alicia,17,0,20,3
1713349600866,LISP 5B,A00,507671,Munoz Sanchez; Alicia,15,0,20,5
1713349601893,LISP 5C,A00,507696,Munoz Sanchez; Alicia,15,0,20,5
1713349602920,MAE 197,001,528363,Boechler; Nicholas Sebastia,9998,0,9999,1
1713349603945,MATH 197,001,523477,Kedlaya; Kiran S.,9999,0,9999,0
1713349603945,MATH 197,002,563811,Zhang; Danna,9999,0,9999,0
1713349604971,MCWP 40R,A00,518780,Staff,20,0,20,0
1713349604971,MCWP 40R,B00,518781,Staff,19,0,20,1
1713349604971,MCWP 40R,C00,518783,Staff,19,0,20,1
1713349606001,MCWP 50R,A00,518791,Staff,20,0,20,0
1713349606001,MCWP 50R,B00,518792,Staff,17,0,20,3
1713349606001,MCWP 50R,C00,518793,Staff,19,0,20,1
1713349606001,MCWP 50R,D00,518794,Staff,16,0,20,4
1713349606001,MCWP 50R,E00,518795,Staff,16,0,20,4
1713349606001,MCWP 50R,F00,518796,Staff,19,0,20,1
1713349606001,MCWP 50R,G00,518797,Staff,19,0,20,1
1713349607028,MMW 12R,A01,514034,Herbst; Matthew,15,0,16,1
1713349607028,MMW 12R,A02,514035,Herbst; Matthew,16,0,16,0
1713349608057,MMW 13R,A01,514037,Staff,12,0,16,4
1713349608057,MMW 13R,A02,514039,Staff,16,0,16,0
1713349610104,SIO 295LS,A00,523233,Staff,18,0,30,12
1713349611133,SIO 295S,A00,523232,Staff,18,0,30,12
1713349612159,SOCI 117,A01,494376,Staff,1,0,5,4
1713349613185,WES 237B,A00,494380,Staff,19,0,20,1
1713349615252,AESE 279B,A00,494370,Wade; Jon P,33,0,33,0
1713349616279,ANAR 135S,A00,494369,Braswell; Geoffrey E.,0,0,0,0
1713349617305,CAT 124RS,A01,519847,Geibel; William,17,0,20,3
1713349618333,CAT 125RS,A01,515971,Geibel; William,17,0,20,3
1713349619361,CLRE 250,A00,511389,Morris; Sheldon,9996,0,9999,3
1713349620390,CLRE 251,A00,507176,Mehta; Ravindra L.,9996,0,9999,3
1713349620390,CLRE 251,B00,511410,Mehta; Ravindra L.,9998,0,9999,1
1713349621415,CLRE 252,A00,507189,Cuomo; Raphael Eduardo,9998,0,9999,1
1713349622441,CLRE 253,A00,507199,Vaida; Florin,9997,0,9999,2
1713349622441,CLRE 253,B00,507202,Vaida; Florin,9999,0,9999,0
1713349623471,CLRE 259,A00,507211,Patel; Hemal,9996,0,9999,3
1713349624496,CLRE 260,A00,507221,Cuomo; Raphael Eduardo,9999,0,9999,0
1713349625528,CLRE 297,001,507242,Cuomo; Raphael Eduardo,9999,0,9999,0
1713349626551,CSE 191,A00,516875,Minnes Kemp; Mor Mia,9999,0,9999,0
1713349627581,CSS 201S,A01,494383,Staff,35,0,35,0
1713349628610,CSS 202S,A01,494387,Staff,35,0,35,0
1713349629635,EAP 100,A00,516065,Staff,9792,0,9999,207
1713349630659,ECE 45,A01,507414,Staff,51,0,60,9
1713349631687,ECE 100,A01,507416,Baghdadchi; Saharnaz,10,0,20,10
1713349631687,ECE 100,A02,507418,Baghdadchi; Saharnaz,20,0,20,0
1713349632712,ECE 111,A01,507420,Staff,38,0,50,12
1713349633737,ECE 197,001,548057,Sievenpiper; Daniel F.,9998,0,9999,1
1713349634770,EDS 115,A00,507243,Choi; Bailey Miyeon,28,0,28,0
1713349635794,EDS 117,A01,494379,Staff,23,0,25,2
1713349636823,EDS 125,A00,507246,Hopkins; Megan Beth,29,0,30,1
1713349637851,EDS 128A,A01,507264,Fargason; Sharon Gayle,26,0,26,0
1713349638877,EDS 128B,A01,507293,Pappas; Elizabeth,30,0,30,0
1713349639904,EDS 139,A00,507294,Fargason; Sharon Gayle,30,0,30,0
1713349639904,EDS 139,B00,507313,Pappas; Elizabeth,30,0,30,0
1713349640933,EDS 201,A00,507315,Staff,26,0,30,4
1713349641965,EDS 203,A01,507317,Halter; Christopher P.,26,0,30,4
1713349642991,EDS 204R,A01,507319,Halter; Christopher P.,3,0,30,27
1713349642991,EDS 204R,B01,507331,Heinzman; Erica M.,28,0,30,2
1713349644017,EDS 206R,A00,507332,Staff,4,0,30,26
1713349644017,EDS 206R,B00,507343,Staff,28,0,30,2
1713349645049,EDS 250,A00,507344,Hemans; Patricia Ann Benitez,36,0,40,4
1713349646074,EDS 281,A00,507345,Daly; Alan J.,18,0,18,0
1713349647099,EDS 284,A00,507350,Daly; Alan J.,16,0,16,0
1713349648126,EDS 286,A00,507359,Fine; Sarah,18,0,18,0
1713349649158,EDS 289C,A01,507361,Daly; Alan J.,18,0,18,0
1713349650185,EDS 290,A00,507366,Hofstetter; Carolyn,15,0,15,0
1713349651214,LIGM 5A,A00,507421,Fischer-Grunski; Eva K,20,0,20,0
1713349652238,LIGM 5B,A00,507423,Fischer-Grunski; Eva K,20,0,20,0
1713349653263,LIGM 5C,A00,507425,Fischer-Grunski; Eva K,20,0,20,0
1713349654290,LIIT 5AS,A00,507427,Carnelos; Chiara,20,0,20,0
1713349655322,LIIT 5BS,A00,507430,Carnelos; Chiara,20,0,20,0
1713349656352,LIIT 5CS,A00,507432,Carnelos; Chiara,20,0,20,0
1713349657382,LISP 5A,A00,507541,Munoz Sanchez; Alicia,17,0,20,3
1713349658410,LISP 5B,A00,507671,Munoz Sanchez; Alicia,14,0,20,6
1713349659492,LISP 5C,A00,507696,Munoz Sanchez; Alicia,15,0,20,5
1713349660521,MAE 197,001,528363,Boechler; Nicholas Sebastia,9998,0,9999,1
1713349661555,MATH 197,001,523477,Kedlaya; Kiran S.,9999,0,9999,0
1713349661555,MATH 197,002,563811,Zhang; Danna,9999,0,9999,0
1713349662583,MCWP 40R,A00,518780,Staff,20,0,20,0
1713349662583,MCWP 40R,B00,518781,Staff,19,0,20,1
1713349662583,MCWP 40R,C00,518783,Staff,19,0,20,1
1713349663611,MCWP 50R,A00,518791,Staff,20,0,20,0
1713349663611,MCWP 50R,B00,518792,Staff,17,0,20,3
1713349663611,MCWP 50R,C00,518793,Staff,19,0,20,1
1713349663611,MCWP 50R,D00,518794,Staff,16,0,20,4
1713349663611,MCWP 50R,E00,518795,Staff,16,0,20,4
1713349663611,MCWP 50R,F00,518796,Staff,19,0,20,1
1713349663611,MCWP 50R,G00,518797,Staff,19,0,20,1
1713349664643,MMW 12R,A01,514034,Herbst; Matthew,15,0,16,1
1713349664643,MMW 12R,A02,514035,Herbst; Matthew,16,0,16,0
1713349665669,MMW 13R,A01,514037,Staff,12,0,16,4
1713349665669,MMW 13R,A02,514039,Staff,16,0,16,0
1713349667726,SIO 295LS,A00,523233,Staff,18,0,30,12
1713349668750,SIO 295S,A00,523232,Staff,18,0,30,12
1713349669780,SOCI 117,A01,494376,Staff,1,0,5,4
1713349670806,WES 237B,A00,494380,Staff,19,0,20,1
1713349672876,AESE 279B,A00,494370,Wade; Jon P,33,0,33,0
1713349673905,ANAR 135S,A00,494369,Braswell; Geoffrey E.,0,0,0,0
1713349674936,CAT 124RS,A01,519847,Geibel; William,17,0,20,3
1713349675965,CAT 125RS,A01,515971,Geibel; William,17,0,20,3
1713349676995,CLRE 250,A00,511389,Morris; Sheldon,9996,0,9999,3
1713349678027,CLRE 251,A00,507176,Mehta; Ravindra L.,9996,0,9999,3
1713349678027,CLRE 251,B00,511410,Mehta; Ravindra L.,9998,0,9999,1
1713349679056,CLRE 252,A00,507189,Cuomo; Raphael Eduardo,9998,0,9999,1
1713349680087,CLRE 253,A00,507199,Vaida; Florin,9997,0,9999,2
1713349680087,CLRE 253,B00,507202,Vaida; Florin,9999,0,9999,0
1713349681117,CLRE 259,A00,507211,Patel; Hemal,9996,0,9999,3
1713349682142,CLRE 260,A00,507221,Cuomo; Raphael Eduardo,9999,0,9999,0
1713349683167,CLRE 297,001,507242,Cuomo; Raphael Eduardo,9999,0,9999,0
1713349684195,CSE 191,A00,516875,Minnes Kemp; Mor Mia,9999,0,9999,0
1713349685225,CSS 201S,A01,494383,Staff,35,0,35,0
1713349686309,CSS 202S,A01,494387,Staff,35,0,35,0
1713349687334,EAP 100,A00,516065,Staff,9792,0,9999,207
1713349688359,ECE 45,A01,507414,Staff,51,0,60,9
1713349689383,ECE 100,A01,507416,Baghdadchi; Saharnaz,10,0,20,10
1713349689383,ECE 100,A02,507418,Baghdadchi; Saharnaz,20,0,20,0
1713349690411,ECE 111,A01,507420,Staff,38,0,50,12
1713349691436,ECE 197,001,548057,Sievenpiper; Daniel F.,9998,0,9999,1
1713349692465,EDS 115,A00,507243,Choi; Bailey Miyeon,28,0,28,0
1713349693488,EDS 117,A01,494379,Staff,23,0,25,2
1713349694514,EDS 125,A00,507246,Hopkins; Megan Beth,29,0,30,1
1713349695540,EDS 128A,A01,507264,Fargason; Sharon Gayle,26,0,26,0
1713349696565,EDS 128B,A01,507293,Pappas; Elizabeth,30,0,30,0
1713349697594,EDS 139,A00,507294,Fargason; Sharon Gayle,30,0,30,0
1713349697594,EDS 139,B00,507313,Pappas; Elizabeth,30,0,30,0
1713349698624,EDS 201,A00,507315,Staff,26,0,30,4
1713349699651,EDS 203,A01,507317,Halter; Christopher P.,26,0,30,4
1713349700680,EDS 204R,A01,507319,Halter; Christopher P.,3,0,30,27
1713349700680,EDS 204R,B01,507331,Heinzman; Erica M.,28,0,30,2
1713349701708,EDS 206R,A00,507332,Staff,4,0,30,26
1713349701708,EDS 206R,B00,507343,Staff,28,0,30,2
1713349702736,EDS 250,A00,507344,Hemans; Patricia Ann Benitez,36,0,40,4
1713349703766,EDS 281,A00,507345,Daly; Alan J.,18,0,18,0
1713349704792,EDS 284,A00,507350,Daly; Alan J.,16,0,16,0
1713349705816,EDS 286,A00,507359,Fine; Sarah,18,0,18,0
1713349706842,EDS 289C,A01,507361,Daly; Alan J.,18,0,18,0
1713349707868,EDS 290,A00,507366,Hofstetter; Carolyn,15,0,15,0
1713349708896,LIGM 5A,A00,507421,Fischer-Grunski; Eva K,20,0,20,0
1713349709925,LIGM 5B,A00,507423,Fischer-Grunski; Eva K,20,0,20,0
1713349710951,LIGM 5C,A00,507425,Fischer-Grunski; Eva K,20,0,20,0
1713349711976,LIIT 5AS,A00,507427,Carnelos; Chiara,20,0,20,0
1713349713001,LIIT 5BS,A00,507430,Carnelos; Chiara,20,0,20,0
1713349714025,LIIT 5CS,A00,507432,Carnelos; Chiara,20,0,20,0
1713349715050,LISP 5A,A00,507541,Munoz Sanchez; Alicia,17,0,20,3
1713349716075,LISP 5B,A00,507671,Munoz Sanchez; Alicia,14,0,20,6
1713349717100,LISP 5C,A00,507696,Munoz Sanchez; Alicia,15,0,20,5
1713349718124,MAE 197,001,528363,Boechler; Nicholas Sebastia,9998,0,9999,1
1713349719151,MATH 197,001,523477,Kedlaya; Kiran S.,9999,0,9999,0
1713349719151,MATH 197,002,563811,Zhang; Danna,9999,0,9999,0
1713349720178,MCWP 40R,A00,518780,Staff,20,0,20,0
1713349720178,MCWP 40R,B00,518781,Staff,19,0,20,1
1713349720178,MCWP 40R,C00,518783,Staff,19,0,20,1
1713349721207,MCWP 50R,A00,518791,Staff,20,0,20,0
1713349721207,MCWP 50R,B00,518792,Staff,17,0,20,3
1713349721207,MCWP 50R,C00,518793,Staff,19,0,20,1
1713349721207,MCWP 50R,D00,518794,Staff,16,0,20,4
1713349721207,MCWP 50R,E00,518795,Staff,16,0,20,4
1713349721207,MCWP 50R,F00,518796,Staff,19,0,20,1
1713349721207,MCWP 50R,G00,518797,Staff,19,0,20,1
1713349722233,MMW 12R,A01,514034,Herbst; Matthew,15,0,16,1
1713349722233,MMW 12R,A02,514035,Herbst; Matthew,16,0,16,0
1713349723259,MMW 13R,A01,514037,Staff,12,0,16,4
1713349723259,MMW 13R,A02,514039,Staff,16,0,16,0
1713349725310,SIO 295LS,A00,523233,Staff,18,0,30,12
1713349726336,SIO 295S,A00,523232,Staff,18,0,30,12
1713349727363,SOCI 117,A01,494376,Staff,1,0,5,4
1713349728387,WES 237B,A00,494380,Staff,19,0,20,1
1713349730460,AESE 279B,A00,494370,Wade; Jon P,33,0,33,0
1713349731489,ANAR 135S,A00,494369,Braswell; Geoffrey E.,0,0,0,0
1713349732515,CAT 124RS,A01,519847,Geibel; William,17,0,20,3
1713349733545,CAT 125RS,A01,515971,Geibel; William,17,0,20,3
1713349734572,CLRE 250,A00,511389,Morris; Sheldon,9996,0,9999,3
1713349735600,CLRE 251,A00,507176,Mehta; Ravindra L.,9996,0,9999,3
1713349735600,CLRE 251,B00,511410,Mehta; Ravindra L.,9998,0,9999,1
1713349736631,CLRE 252,A00,507189,Cuomo; Raphael Eduardo,9998,0,9999,1
1713349737657,CLRE 253,A00,507199,Vaida; Florin,9997,0,9999,2
1713349737657,CLRE 253,B00,507202,Vaida; Florin,9999,0,9999,0
1713349738684,CLRE 259,A00,507211,Patel; Hemal,9996,0,9999,3
1713349739718,CLRE 260,A00,507221,Cuomo; Raphael Eduardo,9999,0,9999,0
1713349740744,CLRE 297,001,507242,Cuomo; Raphael Eduardo,9999,0,9999,0
1713349741771,CSE 191,A00,516875,Minnes Kemp; Mor Mia,9999,0,9999,0
1713349742796,CSS 201S,A01,494383,Staff,35,0,35,0
1713349743826,CSS 202S,A01,494387,Staff,35,0,35,0
1713349744851,EAP 100,A00,516065,Staff,9792,0,9999,207
1713349745879,ECE 45,A01,507414,Staff,51,0,60,9
1713349746904,ECE 100,A01,507416,Baghdadchi; Saharnaz,10,0,20,10
1713349746904,ECE 100,A02,507418,Baghdadchi; Saharnaz,20,0,20,0
1713349747927,ECE 111,A01,507420,Staff,38,0,50,12
1713349748952,ECE 197,001,548057,Sievenpiper; Daniel F.,9998,0,9999,1
1713349749980,EDS 115,A00,507243,Choi; Bailey Miyeon,28,0,28,0
1713349751005,EDS 117,A01,494379,Staff,23,0,25,2
1713349752031,EDS 125,A00,507246,Hopkins; Megan Beth,29,0,30,1
1713349753057,EDS 128A,A01,507264,Fargason; Sharon Gayle,26,0,26,0
1713349754083,EDS 128B,A01,507293,Pappas; Elizabeth,30,0,30,0
1713349755112,EDS 139,A00,507294,Fargason; Sharon Gayle,30,0,30,0
1713349755112,EDS 139,B00,507313,Pappas; Elizabeth,30,0,30,0
1713349756142,EDS 201,A00,507315,Staff,26,0,30,4
1713349757174,EDS 203,A01,507317,Halter; Christopher P.,26,0,30,4
1713349758199,EDS 204R,A01,507319,Halter; Christopher P.,3,0,30,27
1713349758199,EDS 204R,B01,507331,Heinzman; Erica M.,28,0,30,2
1713349759225,EDS 206R,A00,507332,Staff,4,0,30,26
1713349759225,EDS 206R,B00,507343,Staff,28,0,30,2
1713349760253,EDS 250,A00,507344,Hemans; Patricia Ann Benitez,36,0,40,4
1713349761276,EDS 281,A00,507345,Daly; Alan J.,18,0,18,0
1713349762302,EDS 284,A00,507350,Daly; Alan J.,16,0,16,0
1713349763335,EDS 286,A00,507359,Fine; Sarah,18,0,18,0
1713349764360,EDS 289C,A01,507361,Daly; Alan J.,18,0,18,0
1713349765385,EDS 290,A00,507366,Hofstetter; Carolyn,15,0,15,0
1713349766411,LIGM 5A,A00,507421,Fischer-Grunski; Eva K,20,0,20,0
1713349767436,LIGM 5B,A00,507423,Fischer-Grunski; Eva K,20,0,20,0
1713349768466,LIGM 5C,A00,507425,Fischer-Grunski; Eva K,20,0,20,0
1713349769494,LIIT 5AS,A00,507427,Carnelos; Chiara,20,0,20,0
1713349770520,LIIT 5BS,A00,507430,Carnelos; Chiara,20,0,20,0
1713349771547,LIIT 5CS,A00,507432,Carnelos; Chiara,20,0,20,0
1713349772641,LISP 5A,A00,507541,Munoz Sanchez; Alicia,17,0,20,3
1713349773670,LISP 5B,A00,507671,Munoz Sanchez; Alicia,14,0,20,6
1713349774695,LISP 5C,A00,507696,Munoz Sanchez; Alicia,15,0,20,5
1713349775723,MAE 197,001,528363,Boechler; Nicholas Sebastia,9998,0,9999,1
1713349776751,MATH 197,001,523477,Kedlaya; Kiran S.,9999,0,9999,0
1713349776751,MATH 197,002,563811,Zhang; Danna,9999,0,9999,0
1713349777776,MCWP 40R,A00,518780,Staff,20,0,20,0
1713349777776,MCWP 40R,B00,518781,Staff,19,0,20,1
1713349777776,MCWP 40R,C00,518783,Staff,19,0,20,1
1713349778808,MCWP 50R,A00,518791,Staff,20,0,20,0
1713349778808,MCWP 50R,B00,518792,Staff,17,0,20,3
1713349778808,MCWP 50R,C00,518793,Staff,19,0,20,1
1713349778808,MCWP 50R,D00,518794,Staff,16,0,20,4
1713349778808,MCWP 50R,E00,518795,Staff,16,0,20,4
1713349778808,MCWP 50R,F00,518796,Staff,19,0,20,1
1713349778808,MCWP 50R,G00,518797,Staff,19,0,20,1
1713349779835,MMW 12R,A01,514034,Herbst; Matthew,15,0,16,1
1713349779835,MMW 12R,A02,514035,Herbst; Matthew,16,0,16,0
1713349780861,MMW 13R,A01,514037,Staff,12,0,16,4
1713349780861,MMW 13R,A02,514039,Staff,16,0,16,0
1713349782914,SIO 295LS,A00,523233,Staff,18,0,30,12
1713349783943,SIO 295S,A00,523232,Staff,18,0,30,12
1713349784969,SOCI 117,A01,494376,Staff,1,0,5,4
1713349785993,WES 237B,A00,494380,Staff,19,0,20,1
1713349788052,AESE 279B,A00,494370,Wade; Jon P,33,0,33,0
1713349789080,ANAR 135S,A00,494369,Braswell; Geoffrey E.,0,0,0,0
1713349790157,CAT 124RS,A01,519847,Geibel; William,17,0,20,3
1713349791183,CAT 125RS,A01,515971,Geibel; William,17,0,20,3
1713349792209,CLRE 250,A00,511389,Morris; Sheldon,9996,0,9999,3
1713349793238,CLRE 251,A00,507176,Mehta; Ravindra L.,9996,0,9999,3
1713349793238,CLRE 251,B00,511410,Mehta; Ravindra L.,9998,0,9999,1
1713349794265,CLRE 252,A00,507189,Cuomo; Raphael Eduardo,9998,0,9999,1
1713349795294,CLRE 253,A00,507199,Vaida; Florin,9997,0,9999,2
1713349795294,CLRE 253,B00,507202,Vaida; Florin,9999,0,9999,0
1713349796320,CLRE 259,A00,507211,Patel; Hemal,9996,0,9999,3
1713349797348,CLRE 260,A00,507221,Cuomo; Raphael Eduardo,9999,0,9999,0
1713349798375,CLRE 297,001,507242,Cuomo; Raphael Eduardo,9999,0,9999,0
1713349799400,CSE 191,A00,516875,Minnes Kemp; Mor Mia,9999,0,9999,0
1713349800425,CSS 201S,A01,494383,Staff,35,0,35,0
1713349801451,CSS 202S,A01,494387,Staff,35,0,35,0
1713349802477,EAP 100,A00,516065,Staff,9792,0,9999,207
1713349803502,ECE 45,A01,507414,Staff,51,0,60,9
1713349804529,ECE 100,A01,507416,Baghdadchi; Saharnaz,10,0,20,10
1713349804529,ECE 100,A02,507418,Baghdadchi; Saharnaz,20,0,20,0
1713349805563,ECE 111,A01,507420,Staff,38,0,50,12
1713349806590,ECE 197,001,548057,Sievenpiper; Daniel F.,9998,0,9999,1
1713349807617,EDS 115,A00,507243,Choi; Bailey Miyeon,28,0,28,0
1713349808718,EDS 117,A01,494379,Staff,23,0,25,2
1713349809744,EDS 125,A00,507246,Hopkins; Megan Beth,29,0,30,1
1713349810769,EDS 128A,A01,507264,Fargason; Sharon Gayle,26,0,26,0
1713349811793,EDS 128B,A01,507293,Pappas; Elizabeth,30,0,30,0
1713349812823,EDS 139,A00,507294,Fargason; Sharon Gayle,30,0,30,0
1713349812823,EDS 139,B00,507313,Pappas; Elizabeth,30,0,30,0
1713349813851,EDS 201,A00,507315,Staff,26,0,30,4
1713349814881,EDS 203,A01,507317,Halter; Christopher P.,26,0,30,4
1713349815907,EDS 204R,A01,507319,Halter; Christopher P.,3,0,30,27
1713349815907,EDS 204R,B01,507331,Heinzman; Erica M.,28,0,30,2
1713349816932,EDS 206R,A00,507332,Staff,4,0,30,26
1713349816932,EDS 206R,B00,507343,Staff,28,0,30,2
1713349817962,EDS 250,A00,507344,Hemans; Patricia Ann Benitez,36,0,40,4
1713349818989,EDS 281,A00,507345,Daly; Alan J.,18,0,18,0
1713349820014,EDS 284,A00,507350,Daly; Alan J.,16,0,16,0
1713349821042,EDS 286,A00,507359,Fine; Sarah,18,0,18,0
1713349822068,EDS 289C,A01,507361,Daly; Alan J.,18,0,18,0
1713349823096,EDS 290,A00,507366,Hofstetter; Carolyn,15,0,15,0
1713349824120,LIGM 5A,A00,507421,Fischer-Grunski; Eva K,20,0,20,0
1713349825147,LIGM 5B,A00,507423,Fischer-Grunski; Eva K,20,0,20,0
1713349826176,LIGM 5C,A00,507425,Fischer-Grunski; Eva K,20,0,20,0
1713349827206,LIIT 5AS,A00,507427,Carnelos; Chiara,20,0,20,0
1713349828232,LIIT 5BS,A00,507430,Carnelos; Chiara,20,0,20,0
1713349829258,LIIT 5CS,A00,507432,Carnelos; Chiara,20,0,20,0
1713349830284,LISP 5A,A00,507541,Munoz Sanchez; Alicia,17,0,20,3
1713349831311,LISP 5B,A00,507671,Munoz Sanchez; Alicia,14,0,20,6
1713349832336,LISP 5C,A00,507696,Munoz Sanchez; Alicia,15,0,20,5
1713349833361,MAE 197,001,528363,Boechler; Nicholas Sebastia,9998,0,9999,1
1713349834391,MATH 197,001,523477,Kedlaya; Kiran S.,9999,0,9999,0
1713349834391,MATH 197,002,563811,Zhang; Danna,9999,0,9999,0
1713349835419,MCWP 40R,A00,518780,Staff,20,0,20,0
1713349835419,MCWP 40R,B00,518781,Staff,19,0,20,1
1713349835419,MCWP 40R,C00,518783,Staff,19,0,20,1
1713349836444,MCWP 50R,A00,518791,Staff,20,0,20,0
1713349836444,MCWP 50R,B00,518792,Staff,17,0,20,3
1713349836444,MCWP 50R,C00,518793,Staff,19,0,20,1
1713349836444,MCWP 50R,D00,518794,Staff,16,0,20,4
1713349836444,MCWP 50R,E00,518795,Staff,16,0,20,4
1713349836444,MCWP 50R,F00,518796,Staff,19,0,20,1
1713349836444,MCWP 50R,G00,518797,Staff,19,0,20,1
1713349837470,MMW 12R,A01,514034,Herbst; Matthew,15,0,16,1
1713349837470,MMW 12R,A02,514035,Herbst; Matthew,16,0,16,0
1713349838499,MMW 13R,A01,514037,Staff,12,0,16,4
1713349838499,MMW 13R,A02,514039,Staff,16,0,16,0
1713349840556,SIO 295LS,A00,523233,Staff,18,0,30,12
1713349841582,SIO 295S,A00,523232,Staff,18,0,30,12
1713349842612,SOCI 117,A01,494376,Staff,1,0,5,4
1713349843637,WES 237B,A00,494380,Staff,19,0,20,1
1713349845698,AESE 279B,A00,494370,Wade; Jon P,33,0,33,0
1713349846726,ANAR 135S,A00,494369,Braswell; Geoffrey E.,0,0,0,0
1713349847751,CAT 124RS,A01,519847,Geibel; William,17,0,20,3
1713349848776,CAT 125RS,A01,515971,Geibel; William,17,0,20,3
1713349849806,CLRE 250,A00,511389,Morris; Sheldon,9996,0,9999,3
1713349850832,CLRE 251,A00,507176,Mehta; Ravindra L.,9996,0,9999,3
1713349850832,CLRE 251,B00,511410,Mehta; Ravindra L.,9998,0,9999,1
1713349851861,CLRE 252,A00,507189,Cuomo; Raphael Eduardo,9998,0,9999,1
1713349852886,CLRE 253,A00,507199,Vaida; Florin,9997,0,9999,2
1713349852886,CLRE 253,B00,507202,Vaida; Florin,9999,0,9999,0
1713349853911,CLRE 259,A00,507211,Patel; Hemal,9996,0,9999,3
1713349854937,CLRE 260,A00,507221,Cuomo; Raphael Eduardo,9999,0,9999,0
1713349855962,CLRE 297,001,507242,Cuomo; Raphael Eduardo,9999,0,9999,0
1713349856988,CSE 191,A00,516875,Minnes Kemp; Mor Mia,9999,0,9999,0
1713349858013,CSS 201S,A01,494383,Staff,35,0,35,0
1713349859038,CSS 202S,A01,494387,Staff,35,0,35,0
1713349860170,EAP 100,A00,516065,Staff,9792,0,9999,207
1713349861194,ECE 45,A01,507414,Staff,51,0,60,9
1713349862218,ECE 100,A01,507416,Baghdadchi; Saharnaz,10,0,20,10
1713349862218,ECE 100,A02,507418,Baghdadchi; Saharnaz,20,0,20,0
1713349863247,ECE 111,A01,507420,Staff,38,0,50,12
1713349864277,ECE 197,001,548057,Sievenpiper; Daniel F.,9998,0,9999,1
1713349865304,EDS 115,A00,507243,Choi; Bailey Miyeon,28,0,28,0
1713349866329,EDS 117,A01,494379,Staff,23,0,25,2
1713349867355,EDS 125,A00,507246,Hopkins; Megan Beth,29,0,30,1
1713349868380,EDS 128A,A01,507264,Fargason; Sharon Gayle,26,0,26,0
1713349869404,EDS 128B,A01,507293,Pappas; Elizabeth,30,0,30,0
1713349870434,EDS 139,A00,507294,Fargason; Sharon Gayle,30,0,30,0
1713349870434,EDS 139,B00,507313,Pappas; Elizabeth,30,0,30,0
1713349871464,EDS 201,A00,507315,Staff,26,0,30,4
1713349872489,EDS 203,A01,507317,Halter; Christopher P.,26,0,30,4
1713349873519,EDS 204R,A01,507319,Halter; Christopher P.,3,0,30,27
1713349873519,EDS 204R,B01,507331,Heinzman; Erica M.,28,0,30,2
1713349874544,EDS 206R,A00,507332,Staff,4,0,30,26
1713349874544,EDS 206R,B00,507343,Staff,28,0,30,2
1713349875570,EDS 250,A00,507344,Hemans; Patricia Ann Benitez,36,0,40,4
1713349876598,EDS 281,A00,507345,Daly; Alan J.,18,0,18,0
1713349877624,EDS 284,A00,507350,Daly; Alan J.,16,0,16,0
1713349878650,EDS 286,A00,507359,Fine; Sarah,18,0,18,0
1713349879676,EDS 289C,A01,507361,Daly; Alan J.,18,0,18,0
1713349880700,EDS 290,A00,507366,Hofstetter; Carolyn,15,0,15,0
1713349881725,LIGM 5A,A00,507421,Fischer-Grunski; Eva K,20,0,20,0
1713349882754,LIGM 5B,A00,507423,Fischer-Grunski; Eva K,20,0,20,0
1713349883779,LIGM 5C,A00,507425,Fischer-Grunski; Eva K,20,0,20,0
1713349884809,LIIT 5AS,A00,507427,Carnelos; Chiara,20,0,20,0
1713349885835,LIIT 5BS,A00,507430,Carnelos; Chiara,20,0,20,0
1713349886860,LIIT 5CS,A00,507432,Carnelos; Chiara,20,0,20,0
1713349887886,LISP 5A,A00,507541,Munoz Sanchez; Alicia,17,0,20,3
1713349888916,LISP 5B,A00,507671,Munoz Sanchez; Alicia,14,0,20,6
1713349889943,LISP 5C,A00,507696,Munoz Sanchez; Alicia,15,0,20,5
1713349890967,MAE 197,001,528363,Boechler; Nicholas Sebastia,9998,0,9999,1
1713349891997,MATH 197,001,523477,Kedlaya; Kiran S.,9999,0,9999,0
1713349891997,MATH 197,002,563811,Zhang; Danna,9999,0,9999,0
1713349893022,MCWP 40R,A00,518780,Staff,20,0,20,0
1713349893022,MCWP 40R,B00,518781,Staff,19,0,20,1
1713349893022,MCWP 40R,C00,518783,Staff,19,0,20,1
1713349894107,MCWP 50R,A00,518791,Staff,20,0,20,0
1713349894107,MCWP 50R,B00,518792,Staff,17,0,20,3
1713349894107,MCWP 50R,C00,518793,Staff,19,0,20,1
1713349894107,MCWP 50R,D00,518794,Staff,16,0,20,4
1713349894107,MCWP 50R,E00,518795,Staff,16,0,20,4
1713349894107,MCWP 50R,F00,518796,Staff,19,0,20,1
1713349894107,MCWP 50R,G00,518797,Staff,19,0,20,1
1713349895137,MMW 12R,A01,514034,Herbst; Matthew,15,0,16,1
1713349895137,MMW 12R,A02,514035,Herbst; Matthew,16,0,16,0
1713349896166,MMW 13R,A01,514037,Staff,12,0,16,4
1713349896166,MMW 13R,A02,514039,Staff,16,0,16,0
1713349898215,SIO 295LS,A00,523233,Staff,18,0,30,12
1713349899242,SIO 295S,A00,523232,Staff,18,0,30,12
1713349900266,SOCI 117,A01,494376,Staff,1,0,5,4
1713349901295,WES 237B,A00,494380,Staff,19,0,20,1
1713349903355,AESE 279B,A00,494370,Wade; Jon P,33,0,33,0
1713349904380,ANAR 135S,A00,494369,Braswell; Geoffrey E.,0,0,0,0
1713349905405,CAT 124RS,A01,519847,Geibel; William,17,0,20,3
1713349906433,CAT 125RS,A01,515971,Geibel; William,17,0,20,3
1713349907458,CLRE 250,A00,511389,Morris; Sheldon,9996,0,9999,3
1713349908483,CLRE 251,A00,507176,Mehta; Ravindra L.,9996,0,9999,3
1713349908483,CLRE 251,B00,511410,Mehta; Ravindra L.,9998,0,9999,1
1713349909508,CLRE 252,A00,507189,Cuomo; Raphael Eduardo,9998,0,9999,1
1713349910532,CLRE 253,A00,507199,Vaida; Florin,9997,0,9999,2
1713349910532,CLRE 253,B00,507202,Vaida; Florin,9999,0,9999,0
1713349911556,CLRE 259,A00,507211,Patel; Hemal,9996,0,9999,3
1713349912583,CLRE 260,A00,507221,Cuomo; Raphael Eduardo,9999,0,9999,0
1713349913608,CLRE 297,001,507242,Cuomo; Raphael Eduardo,9999,0,9999,0
1713349914637,CSE 191,A00,516875,Minnes Kemp; Mor Mia,9999,0,9999,0
1713349915666,CSS 201S,A01,494383,Staff,35,0,35,0
1713349916692,CSS 202S,A01,494387,Staff,35,0,35,0
1713349917722,EAP 100,A00,516065,Staff,9792,0,9999,207
1713349918750,ECE 45,A01,507414,Staff,51,0,60,9
1713349919773,ECE 100,A01,507416,Baghdadchi; Saharnaz,10,0,20,10
1713349919773,ECE 100,A02,507418,Baghdadchi; Saharnaz,20,0,20,0
1713349920803,ECE 111,A01,507420,Staff,38,0,50,12
1713349921831,ECE 197,001,548057,Sievenpiper; Daniel F.,9998,0,9999,1
1713349922863,EDS 115,A00,507243,Choi; Bailey Miyeon,28,0,28,0
1713349923900,EDS 117,A01,494379,Staff,23,0,25,2
1713349924926,EDS 125,A00,507246,Hopkins; Megan Beth,29,0,30,1
1713349925952,EDS 128A,A01,507264,Fargason; Sharon Gayle,26,0,26,0
1713349926982,EDS 128B,A01,507293,Pappas; Elizabeth,30,0,30,0
1713349928009,EDS 139,A00,507294,Fargason; Sharon Gayle,30,0,30,0
1713349928009,EDS 139,B00,507313,Pappas; Elizabeth,30,0,30,0
1713349929040,EDS 201,A00,507315,Staff,26,0,30,4
1713349930066,EDS 203,A01,507317,Halter; Christopher P.,26,0,30,4
1713349931092,EDS 204R,A01,507319,Halter; Christopher P.,3,0,30,27
1713349931092,EDS 204R,B01,507331,Heinzman; Erica M.,28,0,30,2
1713349932118,EDS 206R,A00,507332,Staff,4,0,30,26
1713349932118,EDS 206R,B00,507343,Staff,28,0,30,2
1713349933143,EDS 250,A00,507344,Hemans; Patricia Ann Benitez,36,0,40,4
1713349934171,EDS 281,A00,507345,Daly; Alan J.,18,0,18,0
1713349935197,EDS 284,A00,507350,Daly; Alan J.,16,0,16,0
1713349936223,EDS 286,A00,507359,Fine; Sarah,18,0,18,0
1713349937252,EDS 289C,A01,507361,Daly; Alan J.,18,0,18,0
1713349938282,EDS 290,A00,507366,Hofstetter; Carolyn,15,0,15,0
1713349939306,LIGM 5A,A00,507421,Fischer-Grunski; Eva K,20,0,20,0
1713349940336,LIGM 5B,A00,507423,Fischer-Grunski; Eva K,20,0,20,0
1713349941362,LIGM 5C,A00,507425,Fischer-Grunski; Eva K,20,0,20,0
1713349942386,LIIT 5AS,A00,507427,Carnelos; Chiara,20,0,20,0
1713349943417,LIIT 5BS,A00,507430,Carnelos; Chiara,20,0,20,0
1713349944446,LIIT 5CS,A00,507432,Carnelos; Chiara,20,0,20,0
1713349945473,LISP 5A,A00,507541,Munoz Sanchez; Alicia,17,0,20,3
1713349946498,LISP 5B,A00,507671,Munoz Sanchez; Alicia,14,0,20,6
1713349947527,LISP 5C,A00,507696,Munoz Sanchez; Alicia,14,0,20,6
1713349948552,MAE 197,001,528363,Boechler; Nicholas Sebastia,9998,0,9999,1
1713349949580,MATH 197,001,523477,Kedlaya; Kiran S.,9999,0,9999,0
1713349949580,MATH 197,002,563811,Zhang; Danna,9999,0,9999,0
1713349950606,MCWP 40R,A00,518780,Staff,20,0,20,0
1713349950606,MCWP 40R,B00,518781,Staff,19,0,20,1
1713349950606,MCWP 40R,C00,518783,Staff,19,0,20,1
1713349951636,MCWP 50R,A00,518791,Staff,20,0,20,0
1713349951636,MCWP 50R,B00,518792,Staff,17,0,20,3
1713349951636,MCWP 50R,C00,518793,Staff,19,0,20,1
1713349951636,MCWP 50R,D00,518794,Staff,16,0,20,4
1713349951636,MCWP 50R,E00,518795,Staff,16,0,20,4
1713349951636,MCWP 50R,F00,518796,Staff,19,0,20,1
1713349951636,MCWP 50R,G00,518797,Staff,19,0,20,1
1713349952660,MMW 12R,A01,514034,Herbst; Matthew,15,0,16,1
1713349952660,MMW 12R,A02,514035,Herbst; Matthew,16,0,16,0
1713349953688,MMW 13R,A01,514037,Staff,12,0,16,4
1713349953688,MMW 13R,A02,514039,Staff,16,0,16,0
1713349955741,SIO 295LS,A00,523233,Staff,18,0,30,12
1713349956772,SIO 295S,A00,523232,Staff,18,0,30,12
1713349957801,SOCI 117,A01,494376,Staff,1,0,5,4
1713349958829,WES 237B,A00,494380,Staff,19,0,20,1
1713349960887,AESE 279B,A00,494370,Wade; Jon P,33,0,33,0
1713349961911,ANAR 135S,A00,494369,Braswell; Geoffrey E.,0,0,0,0
1713349962937,CAT 124RS,A01,519847,Geibel; William,17,0,20,3
1713349963962,CAT 125RS,A01,515971,Geibel; William,17,0,20,3
1713349964988,CLRE 250,A00,511389,Morris; Sheldon,9996,0,9999,3
1713349966018,CLRE 251,A00,507176,Mehta; Ravindra L.,9996,0,9999,3
1713349966018,CLRE 251,B00,511410,Mehta; Ravindra L.,9998,0,9999,1
1713349967044,CLRE 252,A00,507189,Cuomo; Raphael Eduardo,9998,0,9999,1
1713349968072,CLRE 253,A00,507199,Vaida; Florin,9997,0,9999,2
1713349968072,CLRE 253,B00,507202,Vaida; Florin,9999,0,9999,0
1713349969101,CLRE 259,A00,507211,Patel; Hemal,9996,0,9999,3
1713349970127,CLRE 260,A00,507221,Cuomo; Raphael Eduardo,9999,0,9999,0
1713349971153,CLRE 297,001,507242,Cuomo; Raphael Eduardo,9999,0,9999,0
1713349972181,CSE 191,A00,516875,Minnes Kemp; Mor Mia,9999,0,9999,0
1713349973212,CSS 201S,A01,494383,Staff,35,0,35,0
1713349974237,CSS 202S,A01,494387,Staff,35,0,35,0
1713349975263,EAP 100,A00,516065,Staff,9792,0,9999,207
1713349976297,ECE 45,A01,507414,Staff,51,0,60,9
1713349977326,ECE 100,A01,507416,Baghdadchi; Saharnaz,10,0,20,10
1713349977326,ECE 100,A02,507418,Baghdadchi; Saharnaz,20,0,20,0
1713349978351,ECE 111,A01,507420,Staff,38,0,50,12
1713349979376,ECE 197,001,548057,Sievenpiper; Daniel F.,9998,0,9999,1
1713349980403,EDS 115,A00,507243,Choi; Bailey Miyeon,28,0,28,0
1713349981428,EDS 117,A01,494379,Staff,23,0,25,2
1713349982457,EDS 125,A00,507246,Hopkins; Megan Beth,29,0,30,1
1713349983480,EDS 128A,A01,507264,Fargason; Sharon Gayle,26,0,26,0
1713349984506,EDS 128B,A01,507293,Pappas; Elizabeth,30,0,30,0
1713349985535,EDS 139,A00,507294,Fargason; Sharon Gayle,30,0,30,0
1713349985535,EDS 139,B00,507313,Pappas; Elizabeth,30,0,30,0
1713349986560,EDS 201,A00,507315,Staff,26,0,30,4
1713349987586,EDS 203,A01,507317,Halter; Christopher P.,26,0,30,4
1713349988611,EDS 204R,A01,507319,Halter; Christopher P.,3,0,30,27
1713349988611,EDS 204R,B01,507331,Heinzman; Erica M.,28,0,30,2
1713349989638,EDS 206R,A00,507332,Staff,4,0,30,26
1713349989638,EDS 206R,B00,507343,Staff,28,0,30,2
1713349990663,EDS 250,A00,507344,Hemans; Patricia Ann Benitez,36,0,40,4
1713349991689,EDS 281,A00,507345,Daly; Alan J.,18,0,18,0
1713349992715,EDS 284,A00,507350,Daly; Alan J.,16,0,16,0
1713349993746,EDS 286,A00,507359,Fine; Sarah,18,0,18,0
1713349994772,EDS 289C,A01,507361,Daly; Alan J.,18,0,18,0
1713349995798,EDS 290,A00,507366,Hofstetter; Carolyn,15,0,15,0
1713349996829,LIGM 5A,A00,507421,Fischer-Grunski; Eva K,20,0,20,0
1713349997910,LIGM 5B,A00,507423,Fischer-Grunski; Eva K,20,0,20,0
1713349998937,LIGM 5C,A00,507425,Fischer-Grunski; Eva K,20,0,20,0
1713349999963,LIIT 5AS,A00,507427,Carnelos; Chiara,20,0,20,0
1713350000994,LIIT 5BS,A00,507430,Carnelos; Chiara,20,0,20,0
1713350002023,LIIT 5CS,A00,507432,Carnelos; Chiara,20,0,20,0
1713350003047,LISP 5A,A00,507541,Munoz Sanchez; Alicia,17,0,20,3
1713350004073,LISP 5B,A00,507671,Munoz Sanchez; Alicia,14,0,20,6
1713350005103,LISP 5C,A00,507696,Munoz Sanchez; Alicia,14,0,20,6
1713350006130,MAE 197,001,528363,Boechler; Nicholas Sebastia,9998,0,9999,1
1713350007158,MATH 197,001,523477,Kedlaya; Kiran S.,9999,0,9999,0
1713350007158,MATH 197,002,563811,Zhang; Danna,9999,0,9999,0
1713350008184,MCWP 40R,A00,518780,Staff,20,0,20,0
1713350008184,MCWP 40R,B00,518781,Staff,19,0,20,1
1713350008184,MCWP 40R,C00,518783,Staff,19,0,20,1
1713350009211,MCWP 50R,A00,518791,Staff,20,0,20,0
1713350009211,MCWP 50R,B00,518792,Staff,17,0,20,3
1713350009211,MCWP 50R,C00,518793,Staff,19,0,20,1
1713350009211,MCWP 50R,D00,518794,Staff,16,0,20,4
1713350009211,MCWP 50R,E00,518795,Staff,16,0,20,4
1713350009211,MCWP 50R,F00,518796,Staff,19,0,20,1
1713350009211,MCWP 50R,G00,518797,Staff,19,0,20,1
1713350010240,MMW 12R,A01,514034,Herbst; Matthew,15,0,16,1
1713350010240,MMW 12R,A02,514035,Herbst; Matthew,16,0,16,0
1713350011265,MMW 13R,A01,514037,Staff,12,0,16,4
1713350011265,MMW 13R,A02,514039,Staff,16,0,16,0
1713350013317,SIO 295LS,A00,523233,Staff,18,0,30,12
1713350014342,SIO 295S,A00,523232,Staff,18,0,30,12
1713350015369,SOCI 117,A01,494376,Staff,1,0,5,4
1713350016397,WES 237B,A00,494380,Staff,19,0,20,1
1713350018454,AESE 279B,A00,494370,Wade; Jon P,33,0,33,0
1713350019479,ANAR 135S,A00,494369,Braswell; Geoffrey E.,0,0,0,0
1713350020509,CAT 124RS,A01,519847,Geibel; William,17,0,20,3
1713350021534,CAT 125RS,A01,515971,Geibel; William,17,0,20,3
1713350022560,CLRE 250,A00,511389,Morris; Sheldon,9996,0,9999,3
1713350023587,CLRE 251,A00,507176,Mehta; Ravindra L.,9996,0,9999,3
1713350023587,CLRE 251,B00,511410,Mehta; Ravindra L.,9998,0,9999,1
1713350024611,CLRE 252,A00,507189,Cuomo; Raphael Eduardo,9998,0,9999,1
1713350025637,CLRE 253,A00,507199,Vaida; Florin,9997,0,9999,2
1713350025637,CLRE 253,B00,507202,Vaida; Florin,9999,0,9999,0
1713350026664,CLRE 259,A00,507211,Patel; Hemal,9996,0,9999,3
1713350027691,CLRE 260,A00,507221,Cuomo; Raphael Eduardo,9999,0,9999,0
1713350028719,CLRE 297,001,507242,Cuomo; Raphael Eduardo,9999,0,9999,0
1713350029749,CSE 191,A00,516875,Minnes Kemp; Mor Mia,9999,0,9999,0
1713350030773,CSS 201S,A01,494383,Staff,35,0,35,0
1713350031803,CSS 202S,A01,494387,Staff,35,0,35,0
1713350032832,EAP 100,A00,516065,Staff,9792,0,9999,207
1713350033861,ECE 45,A01,507414,Staff,51,0,60,9
1713350034885,ECE 100,A01,507416,Baghdadchi; Saharnaz,10,0,20,10
1713350034885,ECE 100,A02,507418,Baghdadchi; Saharnaz,20,0,20,0
1713350035913,ECE 111,A01,507420,Staff,38,0,50,12
1713350036941,ECE 197,001,548057,Sievenpiper; Daniel F.,9998,0,9999,1
1713350037968,EDS 115,A00,507243,Choi; Bailey Miyeon,28,0,28,0
1713350038996,EDS 117,A01,494379,Staff,23,0,25,2
1713350040027,EDS 125,A00,507246,Hopkins; Megan Beth,29,0,30,1
1713350041053,EDS 128A,A01,507264,Fargason; Sharon Gayle,26,0,26,0
1713350042084,EDS 128B,A01,507293,Pappas; Elizabeth,30,0,30,0
1713350043109,EDS 139,A00,507294,Fargason; Sharon Gayle,30,0,30,0
1713350043109,EDS 139,B00,507313,Pappas; Elizabeth,30,0,30,0
1713350044138,EDS 201,A00,507315,Staff,26,0,30,4
1713350045163,EDS 203,A01,507317,Halter; Christopher P.,26,0,30,4
1713350046193,EDS 204R,A01,507319,Halter; Christopher P.,3,0,30,27
1713350046193,EDS 204R,B01,507331,Heinzman; Erica M.,28,0,30,2
1713350047221,EDS 206R,A00,507332,Staff,4,0,30,26
1713350047221,EDS 206R,B00,507343,Staff,28,0,30,2
1713350048248,EDS 250,A00,507344,Hemans; Patricia Ann Benitez,36,0,40,4
1713350049276,EDS 281,A00,507345,Daly; Alan J.,18,0,18,0
1713350050306,EDS 284,A00,507350,Daly; Alan J.,16,0,16,0
1713350051334,EDS 286,A00,507359,Fine; Sarah,18,0,18,0
1713350052360,EDS 289C,A01,507361,Daly; Alan J.,18,0,18,0
1713350053389,EDS 290,A00,507366,Hofstetter; Carolyn,15,0,15,0
1713350054415,LIGM 5A,A00,507421,Fischer-Grunski; Eva K,20,0,20,0
1713350055440,LIGM 5B,A00,507423,Fischer-Grunski; Eva K,20,0,20,0
1713350056465,LIGM 5C,A00,507425,Fischer-Grunski; Eva K,20,0,20,0
1713350057492,LIIT 5AS,A00,507427,Carnelos; Chiara,20,0,20,0
1713350058522,LIIT 5BS,A00,507430,Carnelos; Chiara,20,0,20,0
1713350059548,LIIT 5CS,A00,507432,Carnelos; Chiara,20,0,20,0
1713350060578,LISP 5A,A00,507541,Munoz Sanchez; Alicia,17,0,20,3
1713350061605,LISP 5B,A00,507671,Munoz Sanchez; Alicia,14,0,20,6
1713350062631,LISP 5C,A00,507696,Munoz Sanchez; Alicia,14,0,20,6
1713350063662,MAE 197,001,528363,Boechler; Nicholas Sebastia,9998,0,9999,1
1713350064687,MATH 197,001,523477,Kedlaya; Kiran S.,9999,0,9999,0
1713350064687,MATH 197,002,563811,Zhang; Danna,9999,0,9999,0
1713350065713,MCWP 40R,A00,518780,Staff,20,0,20,0
1713350065713,MCWP 40R,B00,518781,Staff,19,0,20,1
1713350065713,MCWP 40R,C00,518783,Staff,19,0,20,1
1713350066737,MCWP 50R,A00,518791,Staff,20,0,20,0
1713350066737,MCWP 50R,B00,518792,Staff,17,0,20,3
1713350066737,MCWP 50R,C00,518793,Staff,19,0,20,1
1713350066737,MCWP 50R,D00,518794,Staff,16,0,20,4
1713350066737,MCWP 50R,E00,518795,Staff,16,0,20,4
1713350066737,MCWP 50R,F00,518796,Staff,19,0,20,1
1713350066737,MCWP 50R,G00,518797,Staff,19,0,20,1
1713350067767,MMW 12R,A01,514034,Herbst; Matthew,15,0,16,1
1713350067767,MMW 12R,A02,514035,Herbst; Matthew,16,0,16,0
1713350068797,MMW 13R,A01,514037,Staff,12,0,16,4
1713350068797,MMW 13R,A02,514039,Staff,16,0,16,0
1713350070849,SIO 295LS,A00,523233,Staff,18,0,30,12
1713350071877,SIO 295S,A00,523232,Staff,18,0,30,12
1713350072902,SOCI 117,A01,494376,Staff,1,0,5,4
1713350073926,WES 237B,A00,494380,Staff,19,0,20,1
1713350075997,AESE 279B,A00,494370,Wade; Jon P,33,0,33,0
1713350077023,ANAR 135S,A00,494369,Braswell; Geoffrey E.,0,0,0,0
1713350078050,CAT 124RS,A01,519847,Geibel; William,17,0,20,3
1713350079074,CAT 125RS,A01,515971,Geibel; William,17,0,20,3
1713350080099,CLRE 250,A00,511389,Morris; Sheldon,9996,0,9999,3
1713350081126,CLRE 251,A00,507176,Mehta; Ravindra L.,9996,0,9999,3
1713350081126,CLRE 251,B00,511410,Mehta; Ravindra L.,9998,0,9999,1
1713350082154,CLRE 252,A00,507189,Cuomo; Raphael Eduardo,9998,0,9999,1
1713350083184,CLRE 253,A00,507199,Vaida; Florin,9997,0,9999,2
1713350083184,CLRE 253,B00,507202,Vaida; Florin,9999,0,9999,0
1713350084211,CLRE 259,A00,507211,Patel; Hemal,9996,0,9999,3
1713350085240,CLRE 260,A00,507221,Cuomo; Raphael Eduardo,9999,0,9999,0
1713350086265,CLRE 297,001,507242,Cuomo; Raphael Eduardo,9999,0,9999,0
1713350087294,CSE 191,A00,516875,Minnes Kemp; Mor Mia,9999,0,9999,0
1713350088318,CSS 201S,A01,494383,Staff,35,0,35,0
1713350089349,CSS 202S,A01,494387,Staff,35,0,35,0
1713350090378,EAP 100,A00,516065,Staff,9792,0,9999,207
1713350091404,ECE 45,A01,507414,Staff,51,0,60,9
1713350092429,ECE 100,A01,507416,Baghdadchi; Saharnaz,10,0,20,10
1713350092429,ECE 100,A02,507418,Baghdadchi; Saharnaz,20,0,20,0
1713350093454,ECE 111,A01,507420,Staff,38,0,50,12
1713350094481,ECE 197,001,548057,Sievenpiper; Daniel F.,9998,0,9999,1
1713350095505,EDS 115,A00,507243,Choi; Bailey Miyeon,28,0,28,0
1713350096530,EDS 117,A01,494379,Staff,23,0,25,2
1713350097559,EDS 125,A00,507246,Hopkins; Megan Beth,29,0,30,1
1713350098584,EDS 128A,A01,507264,Fargason; Sharon Gayle,26,0,26,0
1713350099610,EDS 128B,A01,507293,Pappas; Elizabeth,30,0,30,0
1713350100635,EDS 139,A00,507294,Fargason; Sharon Gayle,30,0,30,0
1713350100635,EDS 139,B00,507313,Pappas; Elizabeth,30,0,30,0
1713350101716,EDS 201,A00,507315,Staff,26,0,30,4
1713350102746,EDS 203,A01,507317,Halter; Christopher P.,26,0,30,4
1713350103777,EDS 204R,A01,507319,Halter; Christopher P.,3,0,30,27
1713350103777,EDS 204R,B01,507331,Heinzman; Erica M.,28,0,30,2
1713350104803,EDS 206R,A00,507332,Staff,4,0,30,26
1713350104803,EDS 206R,B00,507343,Staff,28,0,30,2
1713350105828,EDS 250,A00,507344,Hemans; Patricia Ann Benitez,36,0,40,4
1713350106853,EDS 281,A00,507345,Daly; Alan J.,18,0,18,0
1713350107880,EDS 284,A00,507350,Daly; Alan J.,16,0,16,0
1713350108905,EDS 286,A00,507359,Fine; Sarah,18,0,18,0
1713350109970,EDS 289C,A01,507361,Daly; Alan J.,18,0,18,0
1713350110999,EDS 290,A00,507366,Hofstetter; Carolyn,15,0,15,0
1713350112025,LIGM 5A,A00,507421,Fischer-Grunski; Eva K,20,0,20,0
1713350113055,LIGM 5B,A00,507423,Fischer-Grunski; Eva K,20,0,20,0
1713350114080,LIGM 5C,A00,507425,Fischer-Grunski; Eva K,20,0,20,0
1713350115105,LIIT 5AS,A00,507427,Carnelos; Chiara,20,0,20,0
1713350116134,LIIT 5BS,A00,507430,Carnelos; Chiara,20,0,20,0
1713350117160,LIIT 5CS,A00,507432,Carnelos; Chiara,20,0,20,0
1713350118188,LISP 5A,A00,507541,Munoz Sanchez; Alicia,17,0,20,3
1713350119218,LISP 5B,A00,507671,Munoz Sanchez; Alicia,14,0,20,6
1713350120248,LISP 5C,A00,507696,Munoz Sanchez; Alicia,14,0,20,6
1713350121273,MAE 197,001,528363,Boechler; Nicholas Sebastia,9998,0,9999,1
1713350122298,MATH 197,001,523477,Kedlaya; Kiran S.,9999,0,9999,0
1713350122298,MATH 197,002,563811,Zhang; Danna,9999,0,9999,0
1713350123327,MCWP 40R,A00,518780,Staff,20,0,20,0
1713350123327,MCWP 40R,B00,518781,Staff,19,0,20,1
1713350123327,MCWP 40R,C00,518783,Staff,19,0,20,1
1713350124353,MCWP 50R,A00,518791,Staff,20,0,20,0
1713350124353,MCWP 50R,B00,518792,Staff,17,0,20,3
1713350124353,MCWP 50R,C00,518793,Staff,19,0,20,1
1713350124353,MCWP 50R,D00,518794,Staff,16,0,20,4
1713350124353,MCWP 50R,E00,518795,Staff,16,0,20,4
1713350124353,MCWP 50R,F00,518796,Staff,19,0,20,1
1713350124353,MCWP 50R,G00,518797,Staff,19,0,20,1
1713350125379,MMW 12R,A01,514034,Herbst; Matthew,15,0,16,1
1713350125379,MMW 12R,A02,514035,Herbst; Matthew,16,0,16,0
1713350126405,MMW 13R,A01,514037,Staff,12,0,16,4
1713350126405,MMW 13R,A02,514039,Staff,16,0,16,0
1713350128458,SIO 295LS,A00,523233,Staff,18,0,30,12
1713350129486,SIO 295S,A00,523232,Staff,18,0,30,12
1713350130511,SOCI 117,A01,494376,Staff,1,0,5,4
1713350131535,WES 237B,A00,494380,Staff,19,0,20,1
1713350133609,AESE 279B,A00,494370,Wade; Jon P,33,0,33,0
1713350134634,ANAR 135S,A00,494369,Braswell; Geoffrey E.,0,0,0,0
1713350135662,CAT 124RS,A01,519847,Geibel; William,17,0,20,3
1713350136685,CAT 125RS,A01,515971,Geibel; William,17,0,20,3
1713350137711,CLRE 250,A00,511389,Morris; Sheldon,9996,0,9999,3
1713350138740,CLRE 251,A00,507176,Mehta; Ravindra L.,9996,0,9999,3
1713350138740,CLRE 251,B00,511410,Mehta; Ravindra L.,9998,0,9999,1
1713350139769,CLRE 252,A00,507189,Cuomo; Raphael Eduardo,9998,0,9999,1
1713350140792,CLRE 253,A00,507199,Vaida; Florin,9997,0,9999,2
1713350140792,CLRE 253,B00,507202,Vaida; Florin,9999,0,9999,0
1713350141818,CLRE 259,A00,507211,Patel; Hemal,9996,0,9999,3
1713350142843,CLRE 260,A00,507221,Cuomo; Raphael Eduardo,9999,0,9999,0
1713350143868,CLRE 297,001,507242,Cuomo; Raphael Eduardo,9999,0,9999,0
1713350144897,CSE 191,A00,516875,Minnes Kemp; Mor Mia,9999,0,9999,0
1713350145929,CSS 201S,A01,494383,Staff,35,0,35,0
1713350146957,CSS 202S,A01,494387,Staff,35,0,35,0
1713350147985,EAP 100,A00,516065,Staff,9792,0,9999,207
1713350149010,ECE 45,A01,507414,Staff,51,0,60,9
1713350150033,ECE 100,A01,507416,Baghdadchi; Saharnaz,10,0,20,10
1713350150033,ECE 100,A02,507418,Baghdadchi; Saharnaz,20,0,20,0
1713350151060,ECE 111,A01,507420,Staff,38,0,50,12
1713350152085,ECE 197,001,548057,Sievenpiper; Daniel F.,9998,0,9999,1
1713350153110,EDS 115,A00,507243,Choi; Bailey Miyeon,28,0,28,0
1713350154135,EDS 117,A01,494379,Staff,23,0,25,2
1713350155162,EDS 125,A00,507246,Hopkins; Megan Beth,29,0,30,1
1713350156187,EDS 128A,A01,507264,Fargason; Sharon Gayle,26,0,26,0
1713350157215,EDS 128B,A01,507293,Pappas; Elizabeth,30,0,30,0
1713350158241,EDS 139,A00,507294,Fargason; Sharon Gayle,30,0,30,0
1713350158241,EDS 139,B00,507313,Pappas; Elizabeth,30,0,30,0
1713350159266,EDS 201,A00,507315,Staff,26,0,30,4
1713350160292,EDS 203,A01,507317,Halter; Christopher P.,26,0,30,4
1713350161317,EDS 204R,A01,507319,Halter; Christopher P.,3,0,30,27
1713350161317,EDS 204R,B01,507331,Heinzman; Erica M.,28,0,30,2
1713350162343,EDS 206R,A00,507332,Staff,4,0,30,26
1713350162343,EDS 206R,B00,507343,Staff,28,0,30,2
1713350163370,EDS 250,A00,507344,Hemans; Patricia Ann Benitez,36,0,40,4
1713350164395,EDS 281,A00,507345,Daly; Alan J.,18,0,18,0
1713350165419,EDS 284,A00,507350,Daly; Alan J.,16,0,16,0
1713350166443,EDS 286,A00,507359,Fine; Sarah,18,0,18,0
1713350167472,EDS 289C,A01,507361,Daly; Alan J.,18,0,18,0
1713350168502,EDS 290,A00,507366,Hofstetter; Carolyn,15,0,15,0
1713350169526,LIGM 5A,A00,507421,Fischer-Grunski; Eva K,20,0,20,0
1713350170557,LIGM 5B,A00,507423,Fischer-Grunski; Eva K,20,0,20,0
1713350171582,LIGM 5C,A00,507425,Fischer-Grunski; Eva K,20,0,20,0
1713350172607,LIIT 5AS,A00,507427,Carnelos; Chiara,20,0,20,0
1713350173632,LIIT 5BS,A00,507430,Carnelos; Chiara,20,0,20,0
1713350174658,LIIT 5CS,A00,507432,Carnelos; Chiara,20,0,20,0
1713350175683,LISP 5A,A00,507541,Munoz Sanchez; Alicia,17,0,20,3
1713350176708,LISP 5B,A00,507671,Munoz Sanchez; Alicia,14,0,20,6
1713350177734,LISP 5C,A00,507696,Munoz Sanchez; Alicia,14,0,20,6
1713350178764,MAE 197,001,528363,Boechler; Nicholas Sebastia,9998,0,9999,1
1713350179790,MATH 197,001,523477,Kedlaya; Kiran S.,9999,0,9999,0
1713350179790,MATH 197,002,563811,Zhang; Danna,9999,0,9999,0
1713350180821,MCWP 40R,A00,518780,Staff,20,0,20,0
1713350180821,MCWP 40R,B00,518781,Staff,19,0,20,1
1713350180821,MCWP 40R,C00,518783,Staff,19,0,20,1
1713350181850,MCWP 50R,A00,518791,Staff,20,0,20,0
1713350181850,MCWP 50R,B00,518792,Staff,17,0,20,3
1713350181850,MCWP 50R,C00,518793,Staff,19,0,20,1
1713350181850,MCWP 50R,D00,518794,Staff,16,0,20,4
1713350181850,MCWP 50R,E00,518795,Staff,16,0,20,4
1713350181850,MCWP 50R,F00,518796,Staff,19,0,20,1
1713350181850,MCWP 50R,G00,518797,Staff,19,0,20,1
1713350182876,MMW 12R,A01,514034,Herbst; Matthew,15,0,16,1
1713350182876,MMW 12R,A02,514035,Herbst; Matthew,16,0,16,0
1713350183901,MMW 13R,A01,514037,Staff,12,0,16,4
1713350183901,MMW 13R,A02,514039,Staff,16,0,16,0
1713350185954,SIO 295LS,A00,523233,Staff,18,0,30,12
1713350196691,SIO 295S,A00,523232,Staff,18,0,30,12
1713350197720,SOCI 117,A01,494376,Staff,1,0,5,4
1713350198749,WES 237B,A00,494380,Staff,19,0,20,1
1713350200840,AESE 279B,A00,494370,Wade; Jon P,33,0,33,0
1713350201866,ANAR 135S,A00,494369,Braswell; Geoffrey E.,0,0,0,0
1713350202898,CAT 124RS,A01,519847,Geibel; William,17,0,20,3
1713350203923,CAT 125RS,A01,515971,Geibel; William,17,0,20,3
1713350204950,CLRE 250,A00,511389,Morris; Sheldon,9996,0,9999,3
1713350205976,CLRE 251,A00,507176,Mehta; Ravindra L.,9996,0,9999,3
1713350205976,CLRE 251,B00,511410,Mehta; Ravindra L.,9998,0,9999,1
1713350207007,CLRE 252,A00,507189,Cuomo; Raphael Eduardo,9998,0,9999,1
1713350208039,CLRE 253,A00,507199,Vaida; Florin,9997,0,9999,2
1713350208039,CLRE 253,B00,507202,Vaida; Florin,9999,0,9999,0
1713350209066,CLRE 259,A00,507211,Patel; Hemal,9996,0,9999,3
1713350210092,CLRE 260,A00,507221,Cuomo; Raphael Eduardo,9999,0,9999,0
1713350211118,CLRE 297,001,507242,Cuomo; Raphael Eduardo,9999,0,9999,0
1713350212144,CSE 191,A00,516875,Minnes Kemp; Mor Mia,9999,0,9999,0
1713350213175,CSS 201S,A01,494383,Staff,35,0,35,0
1713350214204,CSS 202S,A01,494387,Staff,35,0,35,0
1713350215285,EAP 100,A00,516065,Staff,9792,0,9999,207
1713350216310,ECE 45,A01,507414,Staff,51,0,60,9
1713350217335,ECE 100,A01,507416,Baghdadchi; Saharnaz,10,0,20,10
1713350217335,ECE 100,A02,507418,Baghdadchi; Saharnaz,20,0,20,0
1713350218359,ECE 111,A01,507420,Staff,38,0,50,12
1713350219386,ECE 197,001,548057,Sievenpiper; Daniel F.,9998,0,9999,1
1713350220410,EDS 115,A00,507243,Choi; Bailey Miyeon,28,0,28,0
1713350221435,EDS 117,A01,494379,Staff,23,0,25,2
1713350222463,EDS 125,A00,507246,Hopkins; Megan Beth,29,0,30,1
1713350223487,EDS 128A,A01,507264,Fargason; Sharon Gayle,26,0,26,0
1713350224515,EDS 128B,A01,507293,Pappas; Elizabeth,30,0,30,0
1713350225540,EDS 139,A00,507294,Fargason; Sharon Gayle,30,0,30,0
1713350225540,EDS 139,B00,507313,Pappas; Elizabeth,30,0,30,0
1713350226564,EDS 201,A00,507315,Staff,26,0,30,4
1713350227592,EDS 203,A01,507317,Halter; Christopher P.,26,0,30,4
1713350228621,EDS 204R,A01,507319,Halter; Christopher P.,3,0,30,27
1713350228621,EDS 204R,B01,507331,Heinzman; Erica M.,28,0,30,2
1713350229645,EDS 206R,A00,507332,Staff,4,0,30,26
1713350229645,EDS 206R,B00,507343,Staff,28,0,30,2
1713350230675,EDS 250,A00,507344,Hemans; Patricia Ann Benitez,36,0,40,4
1713350231704,EDS 281,A00,507345,Daly; Alan J.,18,0,18,0
1713350232729,EDS 284,A00,507350,Daly; Alan J.,16,0,16,0
1713350233757,EDS 286,A00,507359,Fine; Sarah,18,0,18,0
1713350234786,EDS 289C,A01,507361,Daly; Alan J.,18,0,18,0
1713350235811,EDS 290,A00,507366,Hofstetter; Carolyn,15,0,15,0
1713350236835,LIGM 5A,A00,507421,Fischer-Grunski; Eva K,20,0,20,0
1713350237860,LIGM 5B,A00,507423,Fischer-Grunski; Eva K,20,0,20,0
1713350238885,LIGM 5C,A00,507425,Fischer-Grunski; Eva K,20,0,20,0
1713350239915,LIIT 5AS,A00,507427,Carnelos; Chiara,20,0,20,0
1713350240942,LIIT 5BS,A00,507430,Carnelos; Chiara,20,0,20,0
1713350241971,LIIT 5CS,A00,507432,Carnelos; Chiara,20,0,20,0
1713350242995,LISP 5A,A00,507541,Munoz Sanchez; Alicia,17,0,20,3
1713350244025,LISP 5B,A00,507671,Munoz Sanchez; Alicia,14,0,20,6
1713350245050,LISP 5C,A00,507696,Munoz Sanchez; Alicia,14,0,20,6
1713350246076,MAE 197,001,528363,Boechler; Nicholas Sebastia,9998,0,9999,1
1713350247108,MATH 197,001,523477,Kedlaya; Kiran S.,9999,0,9999,0
1713350247108,MATH 197,002,563811,Zhang; Danna,9999,0,9999,0
1713350248135,MCWP 40R,A00,518780,Staff,20,0,20,0
1713350248135,MCWP 40R,B00,518781,Staff,19,0,20,1
1713350248135,MCWP 40R,C00,518783,Staff,19,0,20,1
1713350249161,MCWP 50R,A00,518791,Staff,20,0,20,0
1713350249161,MCWP 50R,B00,518792,Staff,17,0,20,3
1713350249161,MCWP 50R,C00,518793,Staff,19,0,20,1
1713350249161,MCWP 50R,D00,518794,Staff,16,0,20,4
1713350249161,MCWP 50R,E00,518795,Staff,16,0,20,4
1713350249161,MCWP 50R,F00,518796,Staff,19,0,20,1
1713350249161,MCWP 50R,G00,518797,Staff,19,0,20,1
1713350250187,MMW 12R,A01,514034,Herbst; Matthew,15,0,16,1
1713350250187,MMW 12R,A02,514035,Herbst; Matthew,16,0,16,0
1713350251215,MMW 13R,A01,514037,Staff,12,0,16,4
1713350251215,MMW 13R,A02,514039,Staff,16,0,16,0
1713350253266,SIO 295LS,A00,523233,Staff,18,0,30,12
1713350254292,SIO 295S,A00,523232,Staff,18,0,30,12
1713350255319,SOCI 117,A01,494376,Staff,1,0,5,4
1713350256344,WES 237B,A00,494380,Staff,19,0,20,1
1713350258421,AESE 279B,A00,494370,Wade; Jon P,33,0,33,0
1713350259446,ANAR 135S,A00,494369,Braswell; Geoffrey E.,0,0,0,0
1713350260471,CAT 124RS,A01,519847,Geibel; William,17,0,20,3
1713350261505,CAT 125RS,A01,515971,Geibel; William,17,0,20,3
1713350262538,CLRE 250,A00,511389,Morris; Sheldon,9996,0,9999,3
1713350263567,CLRE 251,A00,507176,Mehta; Ravindra L.,9996,0,9999,3
1713350263567,CLRE 251,B00,511410,Mehta; Ravindra L.,9998,0,9999,1
1713350264599,CLRE 252,A00,507189,Cuomo; Raphael Eduardo,9998,0,9999,1
1713350265626,CLRE 253,A00,507199,Vaida; Florin,9997,0,9999,2
1713350265626,CLRE 253,B00,507202,Vaida; Florin,9999,0,9999,0
1713350266654,CLRE 259,A00,507211,Patel; Hemal,9996,0,9999,3
1713350267679,CLRE 260,A00,507221,Cuomo; Raphael Eduardo,9999,0,9999,0
1713350268707,CLRE 297,001,507242,Cuomo; Raphael Eduardo,9999,0,9999,0
1713350269733,CSE 191,A00,516875,Minnes Kemp; Mor Mia,9999,0,9999,0
1713350270759,CSS 201S,A01,494383,Staff,35,0,35,0
1713350271794,CSS 202S,A01,494387,Staff,35,0,35,0
1713350272820,EAP 100,A00,516065,Staff,9792,0,9999,207
1713350273846,ECE 45,A01,507414,Staff,51,0,60,9
1713350274872,ECE 100,A01,507416,Baghdadchi; Saharnaz,10,0,20,10
1713350274872,ECE 100,A02,507418,Baghdadchi; Saharnaz,20,0,20,0
1713350275902,ECE 111,A01,507420,Staff,38,0,50,12
1713350276928,ECE 197,001,548057,Sievenpiper; Daniel F.,9998,0,9999,1
1713350277960,EDS 115,A00,507243,Choi; Bailey Miyeon,28,0,28,0
1713350278985,EDS 117,A01,494379,Staff,23,0,25,2
1713350280013,EDS 125,A00,507246,Hopkins; Megan Beth,29,0,30,1
1713350281043,EDS 128A,A01,507264,Fargason; Sharon Gayle,26,0,26,0
1713350282068,EDS 128B,A01,507293,Pappas; Elizabeth,30,0,30,0
1713350283093,EDS 139,A00,507294,Fargason; Sharon Gayle,30,0,30,0
1713350283093,EDS 139,B00,507313,Pappas; Elizabeth,30,0,30,0
1713350284118,EDS 201,A00,507315,Staff,26,0,30,4
1713350285145,EDS 203,A01,507317,Halter; Christopher P.,26,0,30,4
1713350286171,EDS 204R,A01,507319,Halter; Christopher P.,3,0,30,27
1713350286171,EDS 204R,B01,507331,Heinzman; Erica M.,28,0,30,2
1713350287197,EDS 206R,A00,507332,Staff,4,0,30,26
1713350287197,EDS 206R,B00,507343,Staff,28,0,30,2
1713350288223,EDS 250,A00,507344,Hemans; Patricia Ann Benitez,36,0,40,4
1713350289252,EDS 281,A00,507345,Daly; Alan J.,18,0,18,0
1713350290276,EDS 284,A00,507350,Daly; Alan J.,16,0,16,0
1713350291304,EDS 286,A00,507359,Fine; Sarah,18,0,18,0
1713350292329,EDS 289C,A01,507361,Daly; Alan J.,18,0,18,0
1713350293354,EDS 290,A00,507366,Hofstetter; Carolyn,15,0,15,0
1713350294387,LIGM 5A,A00,507421,Fischer-Grunski; Eva K,20,0,20,0
1713350295418,LIGM 5B,A00,507423,Fischer-Grunski; Eva K,20,0,20,0
1713350296448,LIGM 5C,A00,507425,Fischer-Grunski; Eva K,20,0,20,0
1713350297472,LIIT 5AS,A00,507427,Carnelos; Chiara,20,0,20,0
1713350298500,LIIT 5BS,A00,507430,Carnelos; Chiara,20,0,20,0
1713350299525,LIIT 5CS,A00,507432,Carnelos; Chiara,20,0,20,0
1713350300550,LISP 5A,A00,507541,Munoz Sanchez; Alicia,17,0,20,3
1713350301576,LISP 5B,A00,507671,Munoz Sanchez; Alicia,14,0,20,6
1713350302603,LISP 5C,A00,507696,Munoz Sanchez; Alicia,14,0,20,6
1713350303627,MAE 197,001,528363,Boechler; Nicholas Sebastia,9998,0,9999,1
1713350304659,MATH 197,001,523477,Kedlaya; Kiran S.,9999,0,9999,0
1713350304659,MATH 197,002,563811,Zhang; Danna,9999,0,9999,0
1713350305691,MCWP 40R,A00,518780,Staff,20,0,20,0
1713350305691,MCWP 40R,B00,518781,Staff,19,0,20,1
1713350305691,MCWP 40R,C00,518783,Staff,19,0,20,1
1713350306719,MCWP 50R,A00,518791,Staff,20,0,20,0
1713350306719,MCWP 50R,B00,518792,Staff,17,0,20,3
1713350306719,MCWP 50R,C00,518793,Staff,19,0,20,1
1713350306719,MCWP 50R,D00,518794,Staff,16,0,20,4
1713350306719,MCWP 50R,E00,518795,Staff,16,0,20,4
1713350306719,MCWP 50R,F00,518796,Staff,19,0,20,1
1713350306719,MCWP 50R,G00,518797,Staff,19,0,20,1
1713350307744,MMW 12R,A01,514034,Herbst; Matthew,15,0,16,1
1713350307744,MMW 12R,A02,514035,Herbst; Matthew,16,0,16,0
1713350308770,MMW 13R,A01,514037,Staff,12,0,16,4
1713350308770,MMW 13R,A02,514039,Staff,16,0,16,0
1713350310826,SIO 295LS,A00,523233,Staff,18,0,30,12
1713350311857,SIO 295S,A00,523232,Staff,18,0,30,12
1713350312882,SOCI 117,A01,494376,Staff,1,0,5,4
1713350313910,WES 237B,A00,494380,Staff,19,0,20,1
1713350315983,AESE 279B,A00,494370,Wade; Jon P,33,0,33,0
1713350317010,ANAR 135S,A00,494369,Braswell; Geoffrey E.,0,0,0,0
1713350318036,CAT 124RS,A01,519847,Geibel; William,17,0,20,3
1713350319116,CAT 125RS,A01,515971,Geibel; William,17,0,20,3
1713350320142,CLRE 250,A00,511389,Morris; Sheldon,9996,0,9999,3
1713350321172,CLRE 251,A00,507176,Mehta; Ravindra L.,9996,0,9999,3
1713350321172,CLRE 251,B00,511410,Mehta; Ravindra L.,9998,0,9999,1
1713350322200,CLRE 252,A00,507189,Cuomo; Raphael Eduardo,9998,0,9999,1
1713350323225,CLRE 253,A00,507199,Vaida; Florin,9997,0,9999,2
1713350323225,CLRE 253,B00,507202,Vaida; Florin,9999,0,9999,0
1713350324250,CLRE 259,A00,507211,Patel; Hemal,9996,0,9999,3
1713350325280,CLRE 260,A00,507221,Cuomo; Raphael Eduardo,9999,0,9999,0
1713350326308,CLRE 297,001,507242,Cuomo; Raphael Eduardo,9999,0,9999,0
1713350327336,CSE 191,A00,516875,Minnes Kemp; Mor Mia,9999,0,9999,0
1713350328360,CSS 201S,A01,494383,Staff,35,0,35,0
1713350329386,CSS 202S,A01,494387,Staff,35,0,35,0
1713350330411,EAP 100,A00,516065,Staff,9792,0,9999,207
1713350331437,ECE 45,A01,507414,Staff,51,0,60,9
1713350332466,ECE 100,A01,507416,Baghdadchi; Saharnaz,10,0,20,10
1713350332466,ECE 100,A02,507418,Baghdadchi; Saharnaz,20,0,20,0
1713350333494,ECE 111,A01,507420,Staff,38,0,50,12
1713350334522,ECE 197,001,548057,Sievenpiper; Daniel F.,9998,0,9999,1
1713350335549,EDS 115,A00,507243,Choi; Bailey Miyeon,28,0,28,0
1713350336578,EDS 117,A01,494379,Staff,23,0,25,2
1713350337607,EDS 125,A00,507246,Hopkins; Megan Beth,29,0,30,1
1713350338631,EDS 128A,A01,507264,Fargason; Sharon Gayle,26,0,26,0
1713350339657,EDS 128B,A01,507293,Pappas; Elizabeth,30,0,30,0
1713350340682,EDS 139,A00,507294,Fargason; Sharon Gayle,30,0,30,0
1713350340682,EDS 139,B00,507313,Pappas; Elizabeth,30,0,30,0
1713350341708,EDS 201,A00,507315,Staff,26,0,30,4
1713350342736,EDS 203,A01,507317,Halter; Christopher P.,26,0,30,4
1713350343760,EDS 204R,A01,507319,Halter; Christopher P.,3,0,30,27
1713350343760,EDS 204R,B01,507331,Heinzman; Erica M.,28,0,30,2
1713350344790,EDS 206R,A00,507332,Staff,4,0,30,26
1713350344790,EDS 206R,B00,507343,Staff,28,0,30,2
1713350345816,EDS 250,A00,507344,Hemans; Patricia Ann Benitez,36,0,40,4
1713350346844,EDS 281,A00,507345,Daly; Alan J.,18,0,18,0
1713350347870,EDS 284,A00,507350,Daly; Alan J.,16,0,16,0
1713350348900,EDS 286,A00,507359,Fine; Sarah,18,0,18,0
1713350349927,EDS 289C,A01,507361,Daly; Alan J.,18,0,18,0
1713350350956,EDS 290,A00,507366,Hofstetter; Carolyn,15,0,15,0
1713350351984,LIGM 5A,A00,507421,Fischer-Grunski; Eva K,20,0,20,0
1713350353009,LIGM 5B,A00,507423,Fischer-Grunski; Eva K,20,0,20,0
1713350354034,LIGM 5C,A00,507425,Fischer-Grunski; Eva K,20,0,20,0
1713350355063,LIIT 5AS,A00,507427,Carnelos; Chiara,20,0,20,0
1713350356087,LIIT 5BS,A00,507430,Carnelos; Chiara,20,0,20,0
1713350357112,LIIT 5CS,A00,507432,Carnelos; Chiara,20,0,20,0
1713350358142,LISP 5A,A00,507541,Munoz Sanchez; Alicia,17,0,20,3
1713350359165,LISP 5B,A00,507671,Munoz Sanchez; Alicia,14,0,20,6
1713350360190,LISP 5C,A00,507696,Munoz Sanchez; Alicia,14,0,20,6
1713350361217,MAE 197,001,528363,Boechler; Nicholas Sebastia,9998,0,9999,1
1713350362246,MATH 197,001,523477,Kedlaya; Kiran S.,9999,0,9999,0
1713350362246,MATH 197,002,563811,Zhang; Danna,9999,0,9999,0
1713350363274,MCWP 40R,A00,518780,Staff,20,0,20,0
1713350363274,MCWP 40R,B00,518781,Staff,19,0,20,1
1713350363274,MCWP 40R,C00,518783,Staff,19,0,20,1
1713350364300,MCWP 50R,A00,518791,Staff,20,0,20,0
1713350364300,MCWP 50R,B00,518792,Staff,17,0,20,3
1713350364300,MCWP 50R,C00,518793,Staff,19,0,20,1
1713350364300,MCWP 50R,D00,518794,Staff,16,0,20,4
1713350364300,MCWP 50R,E00,518795,Staff,16,0,20,4
1713350364300,MCWP 50R,F00,518796,Staff,19,0,20,1
1713350364300,MCWP 50R,G00,518797,Staff,19,0,20,1
1713350365328,MMW 12R,A01,514034,Herbst; Matthew,15,0,16,1
1713350365328,MMW 12R,A02,514035,Herbst; Matthew,16,0,16,0
1713350366357,MMW 13R,A01,514037,Staff,12,0,16,4
1713350366357,MMW 13R,A02,514039,Staff,16,0,16,0
1713350368408,SIO 295LS,A00,523233,Staff,18,0,30,12
1713350369434,SIO 295S,A00,523232,Staff,18,0,30,12
1713350370457,SOCI 117,A01,494376,Staff,1,0,5,4
1713350371485,WES 237B,A00,494380,Staff,19,0,20,1
1713350373563,AESE 279B,A00,494370,Wade; Jon P,33,0,33,0
1713350374587,ANAR 135S,A00,494369,Braswell; Geoffrey E.,0,0,0,0
1713350375610,CAT 124RS,A01,519847,Geibel; William,17,0,20,3
1713350376654,CAT 125RS,A01,515971,Geibel; William,17,0,20,3
1713350377682,CLRE 250,A00,511389,Morris; Sheldon,9996,0,9999,3
1713350378711,CLRE 251,A00,507176,Mehta; Ravindra L.,9996,0,9999,3
1713350378711,CLRE 251,B00,511410,Mehta; Ravindra L.,9998,0,9999,1
1713350379737,CLRE 252,A00,507189,Cuomo; Raphael Eduardo,9998,0,9999,1
1713350380762,CLRE 253,A00,507199,Vaida; Florin,9997,0,9999,2
1713350380762,CLRE 253,B00,507202,Vaida; Florin,9999,0,9999,0
1713350381788,CLRE 259,A00,507211,Patel; Hemal,9996,0,9999,3
1713350382817,CLRE 260,A00,507221,Cuomo; Raphael Eduardo,9999,0,9999,0
1713350383843,CLRE 297,001,507242,Cuomo; Raphael Eduardo,9999,0,9999,0
1713350384870,CSE 191,A00,516875,Minnes Kemp; Mor Mia,9999,0,9999,0
1713350385896,CSS 201S,A01,494383,Staff,35,0,35,0
1713350386926,CSS 202S,A01,494387,Staff,35,0,35,0
1713350387955,EAP 100,A00,516065,Staff,9792,0,9999,207
1713350388984,ECE 45,A01,507414,Staff,51,0,60,9
1713350390013,ECE 100,A01,507416,Baghdadchi; Saharnaz,10,0,20,10
1713350390013,ECE 100,A02,507418,Baghdadchi; Saharnaz,20,0,20,0
1713350391038,ECE 111,A01,507420,Staff,38,0,50,12
1713350392062,ECE 197,001,548057,Sievenpiper; Daniel F.,9998,0,9999,1
1713350393089,EDS 115,A00,507243,Choi; Bailey Miyeon,28,0,28,0
1713350394115,EDS 117,A01,494379,Staff,23,0,25,2
1713350395143,EDS 125,A00,507246,Hopkins; Megan Beth,29,0,30,1
1713350396175,EDS 128A,A01,507264,Fargason; Sharon Gayle,26,0,26,0
1713350397202,EDS 128B,A01,507293,Pappas; Elizabeth,30,0,30,0
1713350398227,EDS 139,A00,507294,Fargason; Sharon Gayle,30,0,30,0
1713350398227,EDS 139,B00,507313,Pappas; Elizabeth,30,0,30,0
1713350399259,EDS 201,A00,507315,Staff,26,0,30,4
1713350400288,EDS 203,A01,507317,Halter; Christopher P.,26,0,30,4
1713350401319,EDS 204R,A01,507319,Halter; Christopher P.,3,0,30,27
1713350401319,EDS 204R,B01,507331,Heinzman; Erica M.,28,0,30,2
1713350402348,EDS 206R,A00,507332,Staff,4,0,30,26
1713350402348,EDS 206R,B00,507343,Staff,28,0,30,2
1713350403377,EDS 250,A00,507344,Hemans; Patricia Ann Benitez,36,0,40,4
1713350404403,EDS 281,A00,507345,Daly; Alan J.,18,0,18,0
1713350405428,EDS 284,A00,507350,Daly; Alan J.,16,0,16,0
1713350406453,EDS 286,A00,507359,Fine; Sarah,18,0,18,0
1713350407481,EDS 289C,A01,507361,Daly; Alan J.,18,0,18,0
1713350408505,EDS 290,A00,507366,Hofstetter; Carolyn,15,0,15,0
1713350409535,LIGM 5A,A00,507421,Fischer-Grunski; Eva K,20,0,20,0
1713350410565,LIGM 5B,A00,507423,Fischer-Grunski; Eva K,20,0,20,0
1713350411591,LIGM 5C,A00,507425,Fischer-Grunski; Eva K,20,0,20,0
1713350412617,LIIT 5AS,A00,507427,Carnelos; Chiara,20,0,20,0
1713350413643,LIIT 5BS,A00,507430,Carnelos; Chiara,20,0,20,0
1713350414673,LIIT 5CS,A00,507432,Carnelos; Chiara,20,0,20,0
1713350415700,LISP 5A,A00,507541,Munoz Sanchez; Alicia,17,0,20,3
1713350416727,LISP 5B,A00,507671,Munoz Sanchez; Alicia,14,0,20,6
1713350417752,LISP 5C,A00,507696,Munoz Sanchez; Alicia,14,0,20,6
1713350418777,MAE 197,001,528363,Boechler; Nicholas Sebastia,9998,0,9999,1
1713350419804,MATH 197,001,523477,Kedlaya; Kiran S.,9999,0,9999,0
1713350419804,MATH 197,002,563811,Zhang; Danna,9999,0,9999,0
1713350420829,MCWP 40R,A00,518780,Staff,20,0,20,0
1713350420829,MCWP 40R,B00,518781,Staff,19,0,20,1
1713350420829,MCWP 40R,C00,518783,Staff,19,0,20,1
1713350421857,MCWP 50R,A00,518791,Staff,20,0,20,0
1713350421857,MCWP 50R,B00,518792,Staff,17,0,20,3
1713350421857,MCWP 50R,C00,518793,Staff,19,0,20,1
1713350421857,MCWP 50R,D00,518794,Staff,16,0,20,4
1713350421857,MCWP 50R,E00,518795,Staff,16,0,20,4
1713350421857,MCWP 50R,F00,518796,Staff,19,0,20,1
1713350421857,MCWP 50R,G00,518797,Staff,19,0,20,1
1713350422937,MMW 12R,A01,514034,Herbst; Matthew,15,0,16,1
1713350422937,MMW 12R,A02,514035,Herbst; Matthew,16,0,16,0
1713350423966,MMW 13R,A01,514037,Staff,12,0,16,4
1713350423966,MMW 13R,A02,514039,Staff,16,0,16,0
1713350426023,SIO 295LS,A00,523233,Staff,18,0,30,12
1713350427048,SIO 295S,A00,523232,Staff,18,0,30,12
1713350428074,SOCI 117,A01,494376,Staff,1,0,5,4
1713350429099,WES 237B,A00,494380,Staff,19,0,20,1
1713350431168,AESE 279B,A00,494370,Wade; Jon P,33,0,33,0
1713350432197,ANAR 135S,A00,494369,Braswell; Geoffrey E.,0,0,0,0
1713350433222,CAT 124RS,A01,519847,Geibel; William,17,0,20,3
1713350434247,CAT 125RS,A01,515971,Geibel; William,17,0,20,3
1713350435273,CLRE 250,A00,511389,Morris; Sheldon,9996,0,9999,3
1713350436303,CLRE 251,A00,507176,Mehta; Ravindra L.,9996,0,9999,3
1713350436303,CLRE 251,B00,511410,Mehta; Ravindra L.,9998,0,9999,1
1713350437332,CLRE 252,A00,507189,Cuomo; Raphael Eduardo,9998,0,9999,1
1713350438357,CLRE 253,A00,507199,Vaida; Florin,9997,0,9999,2
1713350438357,CLRE 253,B00,507202,Vaida; Florin,9999,0,9999,0
1713350439386,CLRE 259,A00,507211,Patel; Hemal,9996,0,9999,3
1713350440415,CLRE 260,A00,507221,Cuomo; Raphael Eduardo,9999,0,9999,0
1713350441444,CLRE 297,001,507242,Cuomo; Raphael Eduardo,9999,0,9999,0
1713350442472,CSE 191,A00,516875,Minnes Kemp; Mor Mia,9999,0,9999,0
1713350443501,CSS 201S,A01,494383,Staff,35,0,35,0
1713350444531,CSS 202S,A01,494387,Staff,35,0,35,0
1713350445556,EAP 100,A00,516065,Staff,9792,0,9999,207
1713350446582,ECE 45,A01,507414,Staff,51,0,60,9
1713350447607,ECE 100,A01,507416,Baghdadchi; Saharnaz,10,0,20,10
1713350447607,ECE 100,A02,507418,Baghdadchi; Saharnaz,20,0,20,0
1713350448633,ECE 111,A01,507420,Staff,38,0,50,12
1713350449657,ECE 197,001,548057,Sievenpiper; Daniel F.,9998,0,9999,1
1713350450683,EDS 115,A00,507243,Choi; Bailey Miyeon,28,0,28,0
1713350451707,EDS 117,A01,494379,Staff,23,0,25,2
1713350452733,EDS 125,A00,507246,Hopkins; Megan Beth,29,0,30,1
1713350453759,EDS 128A,A01,507264,Fargason; Sharon Gayle,26,0,26,0
1713350454784,EDS 128B,A01,507293,Pappas; Elizabeth,30,0,30,0
1713350455807,EDS 139,A00,507294,Fargason; Sharon Gayle,30,0,30,0
1713350455807,EDS 139,B00,507313,Pappas; Elizabeth,30,0,30,0
1713350456834,EDS 201,A00,507315,Staff,26,0,30,4
1713350457859,EDS 203,A01,507317,Halter; Christopher P.,26,0,30,4
1713350458884,EDS 204R,A01,507319,Halter; Christopher P.,3,0,30,27
1713350458884,EDS 204R,B01,507331,Heinzman; Erica M.,28,0,30,2
1713350459913,EDS 206R,A00,507332,Staff,4,0,30,26
1713350459913,EDS 206R,B00,507343,Staff,28,0,30,2
1713350460942,EDS 250,A00,507344,Hemans; Patricia Ann Benitez,36,0,40,4
1713350461970,EDS 281,A00,507345,Daly; Alan J.,18,0,18,0
1713350462997,EDS 284,A00,507350,Daly; Alan J.,16,0,16,0
1713350464022,EDS 286,A00,507359,Fine; Sarah,18,0,18,0
1713350465046,EDS 289C,A01,507361,Daly; Alan J.,18,0,18,0
1713350466073,EDS 290,A00,507366,Hofstetter; Carolyn,15,0,15,0
1713350467101,LIGM 5A,A00,507421,Fischer-Grunski; Eva K,20,0,20,0
1713350468127,LIGM 5B,A00,507423,Fischer-Grunski; Eva K,20,0,20,0
1713350469156,LIGM 5C,A00,507425,Fischer-Grunski; Eva K,20,0,20,0
1713350470187,LIIT 5AS,A00,507427,Carnelos; Chiara,20,0,20,0
1713350471214,LIIT 5BS,A00,507430,Carnelos; Chiara,20,0,20,0
1713350472243,LIIT 5CS,A00,507432,Carnelos; Chiara,20,0,20,0
1713350473275,LISP 5A,A00,507541,Munoz Sanchez; Alicia,17,0,20,3
1713350474305,LISP 5B,A00,507671,Munoz Sanchez; Alicia,14,0,20,6
1713350475334,LISP 5C,A00,507696,Munoz Sanchez; Alicia,14,0,20,6
1713350476362,MAE 197,001,528363,Boechler; Nicholas Sebastia,9998,0,9999,1
1713350477393,MATH 197,001,523477,Kedlaya; Kiran S.,9999,0,9999,0
1713350477393,MATH 197,002,563811,Zhang; Danna,9999,0,9999,0
1713350478420,MCWP 40R,A00,518780,Staff,20,0,20,0
1713350478420,MCWP 40R,B00,518781,Staff,19,0,20,1
1713350478420,MCWP 40R,C00,518783,Staff,19,0,20,1
1713350479450,MCWP 50R,A00,518791,Staff,20,0,20,0
1713350479450,MCWP 50R,B00,518792,Staff,17,0,20,3
1713350479450,MCWP 50R,C00,518793,Staff,19,0,20,1
1713350479450,MCWP 50R,D00,518794,Staff,16,0,20,4
1713350479450,MCWP 50R,E00,518795,Staff,16,0,20,4
1713350479450,MCWP 50R,F00,518796,Staff,19,0,20,1
1713350479450,MCWP 50R,G00,518797,Staff,19,0,20,1
1713350480481,MMW 12R,A01,514034,Herbst; Matthew,15,0,16,1
1713350480481,MMW 12R,A02,514035,Herbst; Matthew,16,0,16,0
1713350481508,MMW 13R,A01,514037,Staff,12,0,16,4
1713350481508,MMW 13R,A02,514039,Staff,16,0,16,0
1713350483632,SIO 295LS,A00,523233,Staff,18,0,30,12
1713350484664,SIO 295S,A00,523232,Staff,18,0,30,12
1713350485690,SOCI 117,A01,494376,Staff,1,0,5,4
1713350486719,WES 237B,A00,494380,Staff,19,0,20,1
1713350488792,AESE 279B,A00,494370,Wade; Jon P,33,0,33,0
1713350489818,ANAR 135S,A00,494369,Braswell; Geoffrey E.,0,0,0,0
1713350490844,CAT 124RS,A01,519847,Geibel; William,17,0,20,3
1713350491870,CAT 125RS,A01,515971,Geibel; William,17,0,20,3
1713350492898,CLRE 250,A00,511389,Morris; Sheldon,9996,0,9999,3
1713350493928,CLRE 251,A00,507176,Mehta; Ravindra L.,9996,0,9999,3
1713350493928,CLRE 251,B00,511410,Mehta; Ravindra L.,9998,0,9999,1
1713350494956,CLRE 252,A00,507189,Cuomo; Raphael Eduardo,9998,0,9999,1
1713350495980,CLRE 253,A00,507199,Vaida; Florin,9997,0,9999,2
1713350495980,CLRE 253,B00,507202,Vaida; Florin,9999,0,9999,0
1713350497005,CLRE 259,A00,507211,Patel; Hemal,9996,0,9999,3
1713350498031,CLRE 260,A00,507221,Cuomo; Raphael Eduardo,9999,0,9999,0
1713350499057,CLRE 297,001,507242,Cuomo; Raphael Eduardo,9999,0,9999,0
1713350500083,CSE 191,A00,516875,Minnes Kemp; Mor Mia,9999,0,9999,0
1713350501110,CSS 201S,A01,494383,Staff,35,0,35,0
1713350502135,CSS 202S,A01,494387,Staff,35,0,35,0
1713350503161,EAP 100,A00,516065,Staff,9792,0,9999,207
1713350504193,ECE 45,A01,507414,Staff,51,0,60,9
1713350505230,ECE 100,A01,507416,Baghdadchi; Saharnaz,10,0,20,10
1713350505230,ECE 100,A02,507418,Baghdadchi; Saharnaz,20,0,20,0
1713350506253,ECE 111,A01,507420,Staff,38,0,50,12
1713350507282,ECE 197,001,548057,Sievenpiper; Daniel F.,9998,0,9999,1
1713350508313,EDS 115,A00,507243,Choi; Bailey Miyeon,28,0,28,0
1713350509339,EDS 117,A01,494379,Staff,23,0,25,2
1713350510366,EDS 125,A00,507246,Hopkins; Megan Beth,29,0,30,1
1713350511396,EDS 128A,A01,507264,Fargason; Sharon Gayle,26,0,26,0
1713350512423,EDS 128B,A01,507293,Pappas; Elizabeth,30,0,30,0
1713350513450,EDS 139,A00,507294,Fargason; Sharon Gayle,30,0,30,0
1713350513450,EDS 139,B00,507313,Pappas; Elizabeth,30,0,30,0
1713350514477,EDS 201,A00,507315,Staff,26,0,30,4
1713350515503,EDS 203,A01,507317,Halter; Christopher P.,26,0,30,4
1713350516531,EDS 204R,A01,507319,Halter; Christopher P.,3,0,30,27
1713350516531,EDS 204R,B01,507331,Heinzman; Erica M.,28,0,30,2
1713350517558,EDS 206R,A00,507332,Staff,4,0,30,26
1713350517558,EDS 206R,B00,507343,Staff,28,0,30,2
1713350518584,EDS 250,A00,507344,Hemans; Patricia Ann Benitez,36,0,40,4
1713350519609,EDS 281,A00,507345,Daly; Alan J.,18,0,18,0
1713350520635,EDS 284,A00,507350,Daly; Alan J.,16,0,16,0
1713350521663,EDS 286,A00,507359,Fine; Sarah,18,0,18,0
1713350522688,EDS 289C,A01,507361,Daly; Alan J.,18,0,18,0
1713350523715,EDS 290,A00,507366,Hofstetter; Carolyn,15,0,15,0
1713350524741,LIGM 5A,A00,507421,Fischer-Grunski; Eva K,20,0,20,0
1713350525769,LIGM 5B,A00,507423,Fischer-Grunski; Eva K,20,0,20,0
1713350526854,LIGM 5C,A00,507425,Fischer-Grunski; Eva K,20,0,20,0
1713350527881,LIIT 5AS,A00,507427,Carnelos; Chiara,20,0,20,0
1713350528907,LIIT 5BS,A00,507430,Carnelos; Chiara,20,0,20,0
1713350529931,LIIT 5CS,A00,507432,Carnelos; Chiara,20,0,20,0
1713350530963,LISP 5A,A00,507541,Munoz Sanchez; Alicia,17,0,20,3
1713350531994,LISP 5B,A00,507671,Munoz Sanchez; Alicia,14,0,20,6
1713350533019,LISP 5C,A00,507696,Munoz Sanchez; Alicia,14,0,20,6
1713350534052,MAE 197,001,528363,Boechler; Nicholas Sebastia,9998,0,9999,1
1713350535077,MATH 197,001,523477,Kedlaya; Kiran S.,9999,0,9999,0
1713350535077,MATH 197,002,563811,Zhang; Danna,9999,0,9999,0
1713350536107,MCWP 40R,A00,518780,Staff,20,0,20,0
1713350536107,MCWP 40R,B00,518781,Staff,19,0,20,1
1713350536107,MCWP 40R,C00,518783,Staff,19,0,20,1
1713350537132,MCWP 50R,A00,518791,Staff,20,0,20,0
1713350537132,MCWP 50R,B00,518792,Staff,17,0,20,3
1713350537132,MCWP 50R,C00,518793,Staff,19,0,20,1
1713350537132,MCWP 50R,D00,518794,Staff,16,0,20,4
1713350537132,MCWP 50R,E00,518795,Staff,16,0,20,4
1713350537132,MCWP 50R,F00,518796,Staff,19,0,20,1
1713350537132,MCWP 50R,G00,518797,Staff,19,0,20,1
1713350538158,MMW 12R,A01,514034,Herbst; Matthew,15,0,16,1
1713350538158,MMW 12R,A02,514035,Herbst; Matthew,16,0,16,0
1713350539184,MMW 13R,A01,514037,Staff,12,0,16,4
1713350539184,MMW 13R,A02,514039,Staff,16,0,16,0
1713350541281,SIO 295LS,A00,523233,Staff,18,0,30,12
1713350542307,SIO 295S,A00,523232,Staff,18,0,30,12
1713350543336,SOCI 117,A01,494376,Staff,1,0,5,4
1713350544361,WES 237B,A00,494380,Staff,19,0,20,1
1713350546435,AESE 279B,A00,494370,Wade; Jon P,33,0,33,0
1713350547459,ANAR 135S,A00,494369,Braswell; Geoffrey E.,0,0,0,0
1713350548485,CAT 124RS,A01,519847,Geibel; William,17,0,20,3
1713350549513,CAT 125RS,A01,515971,Geibel; William,17,0,20,3
1713350550540,CLRE 250,A00,511389,Morris; Sheldon,9996,0,9999,3
1713350551567,CLRE 251,A00,507176,Mehta; Ravindra L.,9996,0,9999,3
1713350551567,CLRE 251,B00,511410,Mehta; Ravindra L.,9998,0,9999,1
1713350552592,CLRE 252,A00,507189,Cuomo; Raphael Eduardo,9998,0,9999,1
1713350553621,CLRE 253,A00,507199,Vaida; Florin,9997,0,9999,2
1713350553621,CLRE 253,B00,507202,Vaida; Florin,9999,0,9999,0
1713350554647,CLRE 259,A00,507211,Patel; Hemal,9996,0,9999,3
1713350555676,CLRE 260,A00,507221,Cuomo; Raphael Eduardo,9999,0,9999,0
1713350556706,CLRE 297,001,507242,Cuomo; Raphael Eduardo,9999,0,9999,0
1713350557733,CSE 191,A00,516875,Minnes Kemp; Mor Mia,9999,0,9999,0
1713350558757,CSS 201S,A01,494383,Staff,35,0,35,0
1713350559782,CSS 202S,A01,494387,Staff,35,0,35,0
1713350560811,EAP 100,A00,516065,Staff,9792,0,9999,207
1713350561836,ECE 45,A01,507414,Staff,51,0,60,9
1713350562863,ECE 100,A01,507416,Baghdadchi; Saharnaz,10,0,20,10
1713350562863,ECE 100,A02,507418,Baghdadchi; Saharnaz,20,0,20,0
1713350563891,ECE 111,A01,507420,Staff,38,0,50,12
1713350564920,ECE 197,001,548057,Sievenpiper; Daniel F.,9998,0,9999,1
1713350565947,EDS 115,A00,507243,Choi; Bailey Miyeon,28,0,28,0
1713350566977,EDS 117,A01,494379,Staff,23,0,25,2
1713350568006,EDS 125,A00,507246,Hopkins; Megan Beth,29,0,30,1
1713350569034,EDS 128A,A01,507264,Fargason; Sharon Gayle,26,0,26,0
1713350570059,EDS 128B,A01,507293,Pappas; Elizabeth,30,0,30,0
1713350571088,EDS 139,A00,507294,Fargason; Sharon Gayle,30,0,30,0
1713350571088,EDS 139,B00,507313,Pappas; Elizabeth,30,0,30,0
1713350572114,EDS 201,A00,507315,Staff,26,0,30,4
1713350573143,EDS 203,A01,507317,Halter; Christopher P.,26,0,30,4
1713350574168,EDS 204R,A01,507319,Halter; Christopher P.,3,0,30,27
1713350574168,EDS 204R,B01,507331,Heinzman; Erica M.,28,0,30,2
1713350575194,EDS 206R,A00,507332,Staff,4,0,30,26
1713350575194,EDS 206R,B00,507343,Staff,28,0,30,2
1713350576219,EDS 250,A00,507344,Hemans; Patricia Ann Benitez,36,0,40,4
1713350577245,EDS 281,A00,507345,Daly; Alan J.,18,0,18,0
1713350578274,EDS 284,A00,507350,Daly; Alan J.,16,0,16,0
1713350579301,EDS 286,A00,507359,Fine; Sarah,18,0,18,0
1713350580328,EDS 289C,A01,507361,Daly; Alan J.,18,0,18,0
1713350581357,EDS 290,A00,507366,Hofstetter; Carolyn,15,0,15,0
1713350582384,LIGM 5A,A00,507421,Fischer-Grunski; Eva K,20,0,20,0
1713350583416,LIGM 5B,A00,507423,Fischer-Grunski; Eva K,20,0,20,0
1713350584443,LIGM 5C,A00,507425,Fischer-Grunski; Eva K,20,0,20,0
1713350585471,LIIT 5AS,A00,507427,Carnelos; Chiara,20,0,20,0
1713350586495,LIIT 5BS,A00,507430,Carnelos; Chiara,20,0,20,0
1713350587523,LIIT 5CS,A00,507432,Carnelos; Chiara,20,0,20,0
1713350588555,LISP 5A,A00,507541,Munoz Sanchez; Alicia,17,0,20,3
1713350589584,LISP 5B,A00,507671,Munoz Sanchez; Alicia,14,0,20,6
1713350590614,LISP 5C,A00,507696,Munoz Sanchez; Alicia,14,0,20,6
1713350591639,MAE 197,001,528363,Boechler; Nicholas Sebastia,9998,0,9999,1
1713350592666,MATH 197,001,523477,Kedlaya; Kiran S.,9999,0,9999,0
1713350592666,MATH 197,002,563811,Zhang; Danna,9999,0,9999,0
1713350593691,MCWP 40R,A00,518780,Staff,20,0,20,0
1713350593691,MCWP 40R,B00,518781,Staff,19,0,20,1
1713350593691,MCWP 40R,C00,518783,Staff,19,0,20,1
1713350594717,MCWP 50R,A00,518791,Staff,20,0,20,0
1713350594717,MCWP 50R,B00,518792,Staff,17,0,20,3
1713350594717,MCWP 50R,C00,518793,Staff,19,0,20,1
1713350594717,MCWP 50R,D00,518794,Staff,16,0,20,4
1713350594717,MCWP 50R,E00,518795,Staff,16,0,20,4
1713350594717,MCWP 50R,F00,518796,Staff,19,0,20,1
1713350594717,MCWP 50R,G00,518797,Staff,19,0,20,1
1713350595744,MMW 12R,A01,514034,Herbst; Matthew,15,0,16,1
1713350595744,MMW 12R,A02,514035,Herbst; Matthew,16,0,16,0
1713350596772,MMW 13R,A01,514037,Staff,12,0,16,4
1713350596772,MMW 13R,A02,514039,Staff,16,0,16,0
1713350598827,SIO 295LS,A00,523233,Staff,18,0,30,12
1713350599852,SIO 295S,A00,523232,Staff,18,0,30,12
1713350600883,SOCI 117,A01,494376,Staff,1,0,5,4
1713350601912,WES 237B,A00,494380,Staff,19,0,20,1
1713350603977,AESE 279B,A00,494370,Wade; Jon P,33,0,33,0
1713350605003,ANAR 135S,A00,494369,Braswell; Geoffrey E.,0,0,0,0
1713350606040,CAT 124RS,A01,519847,Geibel; William,17,0,20,3
1713350607070,CAT 125RS,A01,515971,Geibel; William,17,0,20,3
1713350608096,CLRE 250,A00,511389,Morris; Sheldon,9996,0,9999,3
1713350609129,CLRE 251,A00,507176,Mehta; Ravindra L.,9996,0,9999,3
1713350609129,CLRE 251,B00,511410,Mehta; Ravindra L.,9998,0,9999,1
1713350610155,CLRE 252,A00,507189,Cuomo; Raphael Eduardo,9998,0,9999,1
1713350611189,CLRE 253,A00,507199,Vaida; Florin,9997,0,9999,2
1713350611189,CLRE 253,B00,507202,Vaida; Florin,9999,0,9999,0
1713350612217,CLRE 259,A00,507211,Patel; Hemal,9996,0,9999,3
1713350613241,CLRE 260,A00,507221,Cuomo; Raphael Eduardo,9999,0,9999,0
1713350614271,CLRE 297,001,507242,Cuomo; Raphael Eduardo,9999,0,9999,0
1713350615295,CSE 191,A00,516875,Minnes Kemp; Mor Mia,9999,0,9999,0
1713350616325,CSS 201S,A01,494383,Staff,35,0,35,0
1713350617355,CSS 202S,A01,494387,Staff,35,0,35,0
1713350618379,EAP 100,A00,516065,Staff,9792,0,9999,207
1713350619405,ECE 45,A01,507414,Staff,51,0,60,9
1713350620431,ECE 100,A01,507416,Baghdadchi; Saharnaz,10,0,20,10
1713350620431,ECE 100,A02,507418,Baghdadchi; Saharnaz,20,0,20,0
1713350621457,ECE 111,A01,507420,Staff,38,0,50,12
1713350622483,ECE 197,001,548057,Sievenpiper; Daniel F.,9998,0,9999,1
1713350623514,EDS 115,A00,507243,Choi; Bailey Miyeon,28,0,28,0
1713350624543,EDS 117,A01,494379,Staff,23,0,25,2
1713350625569,EDS 125,A00,507246,Hopkins; Megan Beth,29,0,30,1
1713350626596,EDS 128A,A01,507264,Fargason; Sharon Gayle,26,0,26,0
1713350627627,EDS 128B,A01,507293,Pappas; Elizabeth,30,0,30,0
1713350628653,EDS 139,A00,507294,Fargason; Sharon Gayle,30,0,30,0
1713350628653,EDS 139,B00,507313,Pappas; Elizabeth,30,0,30,0
1713350629680,EDS 201,A00,507315,Staff,26,0,30,4
1713350630764,EDS 203,A01,507317,Halter; Christopher P.,26,0,30,4
1713350631792,EDS 204R,A01,507319,Halter; Christopher P.,3,0,30,27
1713350631792,EDS 204R,B01,507331,Heinzman; Erica M.,28,0,30,2
1713350632821,EDS 206R,A00,507332,Staff,4,0,30,26
1713350632821,EDS 206R,B00,507343,Staff,28,0,30,2
1713350633846,EDS 250,A00,507344,Hemans; Patricia Ann Benitez,36,0,40,4
1713350634870,EDS 281,A00,507345,Daly; Alan J.,18,0,18,0
1713350635896,EDS 284,A00,507350,Daly; Alan J.,16,0,16,0
1713350636920,EDS 286,A00,507359,Fine; Sarah,18,0,18,0
1713350637948,EDS 289C,A01,507361,Daly; Alan J.,18,0,18,0
1713350638977,EDS 290,A00,507366,Hofstetter; Carolyn,15,0,15,0
1713350640004,LIGM 5A,A00,507421,Fischer-Grunski; Eva K,20,0,20,0
1713350641031,LIGM 5B,A00,507423,Fischer-Grunski; Eva K,20,0,20,0
1713350642061,LIGM 5C,A00,507425,Fischer-Grunski; Eva K,20,0,20,0
1713350643086,LIIT 5AS,A00,507427,Carnelos; Chiara,20,0,20,0
1713350644111,LIIT 5BS,A00,507430,Carnelos; Chiara,20,0,20,0
1713350645136,LIIT 5CS,A00,507432,Carnelos; Chiara,20,0,20,0
1713350646160,LISP 5A,A00,507541,Munoz Sanchez; Alicia,17,0,20,3
1713350647189,LISP 5B,A00,507671,Munoz Sanchez; Alicia,14,0,20,6
1713350648219,LISP 5C,A00,507696,Munoz Sanchez; Alicia,14,0,20,6
1713350649245,MAE 197,001,528363,Boechler; Nicholas Sebastia,9998,0,9999,1
1713350650273,MATH 197,001,523477,Kedlaya; Kiran S.,9999,0,9999,0
1713350650273,MATH 197,002,563811,Zhang; Danna,9999,0,9999,0
1713350651302,MCWP 40R,A00,518780,Staff,20,0,20,0
1713350651302,MCWP 40R,B00,518781,Staff,19,0,20,1
1713350651302,MCWP 40R,C00,518783,Staff,19,0,20,1
1713350652330,MCWP 50R,A00,518791,Staff,20,0,20,0
1713350652330,MCWP 50R,B00,518792,Staff,17,0,20,3
1713350652330,MCWP 50R,C00,518793,Staff,19,0,20,1
1713350652330,MCWP 50R,D00,518794,Staff,16,0,20,4
1713350652330,MCWP 50R,E00,518795,Staff,16,0,20,4
1713350652330,MCWP 50R,F00,518796,Staff,19,0,20,1
1713350652330,MCWP 50R,G00,518797,Staff,19,0,20,1
1713350653355,MMW 12R,A01,514034,Herbst; Matthew,15,0,16,1
1713350653355,MMW 12R,A02,514035,Herbst; Matthew,16,0,16,0
1713350654379,MMW 13R,A01,514037,Staff,12,0,16,4
1713350654379,MMW 13R,A02,514039,Staff,16,0,16,0
1713350656433,SIO 295LS,A00,523233,Staff,18,0,30,12
1713350657458,SIO 295S,A00,523232,Staff,18,0,30,12
1713350658490,SOCI 117,A01,494376,Staff,1,0,5,4
1713350659521,WES 237B,A00,494380,Staff,19,0,20,1
1713350661593,AESE 279B,A00,494370,Wade; Jon P,33,0,33,0
1713350662620,ANAR 135S,A00,494369,Braswell; Geoffrey E.,0,0,0,0
1713350663648,CAT 124RS,A01,519847,Geibel; William,17,0,20,3
1713350664674,CAT 125RS,A01,515971,Geibel; William,17,0,20,3
1713350665700,CLRE 250,A00,511389,Morris; Sheldon,9996,0,9999,3
1713350666729,CLRE 251,A00,507176,Mehta; Ravindra L.,9996,0,9999,3
1713350666729,CLRE 251,B00,511410,Mehta; Ravindra L.,9998,0,9999,1
1713350667759,CLRE 252,A00,507189,Cuomo; Raphael Eduardo,9998,0,9999,1
1713350668791,CLRE 253,A00,507199,Vaida; Florin,9997,0,9999,2
1713350668791,CLRE 253,B00,507202,Vaida; Florin,9999,0,9999,0
1713350669817,CLRE 259,A00,507211,Patel; Hemal,9996,0,9999,3
1713350670846,CLRE 260,A00,507221,Cuomo; Raphael Eduardo,9999,0,9999,0
1713350671875,CLRE 297,001,507242,Cuomo; Raphael Eduardo,9999,0,9999,0
1713350672901,CSE 191,A00,516875,Minnes Kemp; Mor Mia,9999,0,9999,0
1713350673927,CSS 201S,A01,494383,Staff,35,0,35,0
1713350674952,CSS 202S,A01,494387,Staff,35,0,35,0
1713350675978,EAP 100,A00,516065,Staff,9792,0,9999,207
1713350677011,ECE 45,A01,507414,Staff,51,0,60,9
1713350678038,ECE 100,A01,507416,Baghdadchi; Saharnaz,10,0,20,10
1713350678038,ECE 100,A02,507418,Baghdadchi; Saharnaz,20,0,20,0
1713350679064,ECE 111,A01,507420,Staff,38,0,50,12
1713350680294,ECE 197,001,548057,Sievenpiper; Daniel F.,9998,0,9999,1
1713350681320,EDS 115,A00,507243,Choi; Bailey Miyeon,28,0,28,0
1713350682346,EDS 117,A01,494379,Staff,23,0,25,2
1713350683373,EDS 125,A00,507246,Hopkins; Megan Beth,29,0,30,1
1713350684399,EDS 128A,A01,507264,Fargason; Sharon Gayle,26,0,26,0
1713350685428,EDS 128B,A01,507293,Pappas; Elizabeth,30,0,30,0
1713350686453,EDS 139,A00,507294,Fargason; Sharon Gayle,30,0,30,0
1713350686453,EDS 139,B00,507313,Pappas; Elizabeth,30,0,30,0
1713350687481,EDS 201,A00,507315,Staff,26,0,30,4
1713350688505,EDS 203,A01,507317,Halter; Christopher P.,26,0,30,4
1713350689529,EDS 204R,A01,507319,Halter; Christopher P.,3,0,30,27
1713350689529,EDS 204R,B01,507331,Heinzman; Erica M.,28,0,30,2
1713350690555,EDS 206R,A00,507332,Staff,4,0,30,26
1713350690555,EDS 206R,B00,507343,Staff,28,0,30,2
1713350691580,EDS 250,A00,507344,Hemans; Patricia Ann Benitez,36,0,40,4
1713350692604,EDS 281,A00,507345,Daly; Alan J.,18,0,18,0
1713350693631,EDS 284,A00,507350,Daly; Alan J.,16,0,16,0
1713350694659,EDS 286,A00,507359,Fine; Sarah,18,0,18,0
1713350695686,EDS 289C,A01,507361,Daly; Alan J.,18,0,18,0
1713350696715,EDS 290,A00,507366,Hofstetter; Carolyn,15,0,15,0
1713350697740,LIGM 5A,A00,507421,Fischer-Grunski; Eva K,20,0,20,0
1713350698766,LIGM 5B,A00,507423,Fischer-Grunski; Eva K,20,0,20,0
1713350699792,LIGM 5C,A00,507425,Fischer-Grunski; Eva K,20,0,20,0
1713350700818,LIIT 5AS,A00,507427,Carnelos; Chiara,20,0,20,0
1713350701847,LIIT 5BS,A00,507430,Carnelos; Chiara,20,0,20,0
1713350702872,LIIT 5CS,A00,507432,Carnelos; Chiara,20,0,20,0
1713350703901,LISP 5A,A00,507541,Munoz Sanchez; Alicia,17,0,20,3
1713350704928,LISP 5B,A00,507671,Munoz Sanchez; Alicia,14,0,20,6
1713350705954,LISP 5C,A00,507696,Munoz Sanchez; Alicia,14,0,20,6
1713350706976,MAE 197,001,528363,Boechler; Nicholas Sebastia,9998,0,9999,1
1713350708002,MATH 197,001,523477,Kedlaya; Kiran S.,9999,0,9999,0
1713350708002,MATH 197,002,563811,Zhang; Danna,9999,0,9999,0
1713350709028,MCWP 40R,A00,518780,Staff,20,0,20,0
1713350709028,MCWP 40R,B00,518781,Staff,19,0,20,1
1713350709028,MCWP 40R,C00,518783,Staff,19,0,20,1
1713350710054,MCWP 50R,A00,518791,Staff,20,0,20,0
1713350710054,MCWP 50R,B00,518792,Staff,17,0,20,3
1713350710054,MCWP 50R,C00,518793,Staff,19,0,20,1
1713350710054,MCWP 50R,D00,518794,Staff,16,0,20,4
1713350710054,MCWP 50R,E00,518795,Staff,16,0,20,4
1713350710054,MCWP 50R,F00,518796,Staff,19,0,20,1
1713350710054,MCWP 50R,G00,518797,Staff,19,0,20,1
1713350711079,MMW 12R,A01,514034,Herbst; Matthew,15,0,16,1
1713350711079,MMW 12R,A02,514035,Herbst; Matthew,16,0,16,0
1713350712104,MMW 13R,A01,514037,Staff,12,0,16,4
1713350712104,MMW 13R,A02,514039,Staff,16,0,16,0
1713350714156,SIO 295LS,A00,523233,Staff,18,0,30,12
1713350715184,SIO 295S,A00,523232,Staff,18,0,30,12
1713350716215,SOCI 117,A01,494376,Staff,1,0,5,4
1713350717241,WES 237B,A00,494380,Staff,19,0,20,1
1713350719313,AESE 279B,A00,494370,Wade; Jon P,33,0,33,0
1713350720339,ANAR 135S,A00,494369,Braswell; Geoffrey E.,0,0,0,0
1713350721365,CAT 124RS,A01,519847,Geibel; William,17,0,20,3
1713350722389,CAT 125RS,A01,515971,Geibel; William,17,0,20,3
1713350723418,CLRE 250,A00,511389,Morris; Sheldon,9996,0,9999,3
1713350724443,CLRE 251,A00,507176,Mehta; Ravindra L.,9996,0,9999,3
1713350724443,CLRE 251,B00,511410,Mehta; Ravindra L.,9998,0,9999,1
1713350725468,CLRE 252,A00,507189,Cuomo; Raphael Eduardo,9998,0,9999,1
1713350726495,CLRE 253,A00,507199,Vaida; Florin,9997,0,9999,2
1713350726495,CLRE 253,B00,507202,Vaida; Florin,9999,0,9999,0
1713350727519,CLRE 259,A00,507211,Patel; Hemal,9996,0,9999,3
1713350728549,CLRE 260,A00,507221,Cuomo; Raphael Eduardo,9999,0,9999,0
1713350729575,CLRE 297,001,507242,Cuomo; Raphael Eduardo,9999,0,9999,0
1713350730603,CSE 191,A00,516875,Minnes Kemp; Mor Mia,9999,0,9999,0
1713350731631,CSS 201S,A01,494383,Staff,35,0,35,0
1713350732662,CSS 202S,A01,494387,Staff,35,0,35,0
1713350733690,EAP 100,A00,516065,Staff,9792,0,9999,207
1713350734770,ECE 45,A01,507414,Staff,51,0,60,9
1713350735801,ECE 100,A01,507416,Baghdadchi; Saharnaz,10,0,20,10
1713350735801,ECE 100,A02,507418,Baghdadchi; Saharnaz,20,0,20,0
1713350736826,ECE 111,A01,507420,Staff,38,0,50,12
1713350737851,ECE 197,001,548057,Sievenpiper; Daniel F.,9998,0,9999,1
1713350738877,EDS 115,A00,507243,Choi; Bailey Miyeon,28,0,28,0
1713350739905,EDS 117,A01,494379,Staff,23,0,25,2
1713350740931,EDS 125,A00,507246,Hopkins; Megan Beth,29,0,30,1
1713350741959,EDS 128A,A01,507264,Fargason; Sharon Gayle,26,0,26,0
1713350742983,EDS 128B,A01,507293,Pappas; Elizabeth,30,0,30,0
1713350744008,EDS 139,A00,507294,Fargason; Sharon Gayle,30,0,30,0
1713350744008,EDS 139,B00,507313,Pappas; Elizabeth,30,0,30,0
1713350745035,EDS 201,A00,507315,Staff,26,0,30,4
1713350746062,EDS 203,A01,507317,Halter; Christopher P.,26,0,30,4
1713350747087,EDS 204R,A01,507319,Halter; Christopher P.,3,0,30,27
1713350747087,EDS 204R,B01,507331,Heinzman; Erica M.,28,0,30,2
1713350748117,EDS 206R,A00,507332,Staff,4,0,30,26
1713350748117,EDS 206R,B00,507343,Staff,28,0,30,2
1713350749142,EDS 250,A00,507344,Hemans; Patricia Ann Benitez,36,0,40,4
1713350750167,EDS 281,A00,507345,Daly; Alan J.,18,0,18,0
1713350751191,EDS 284,A00,507350,Daly; Alan J.,16,0,16,0
1713350752220,EDS 286,A00,507359,Fine; Sarah,18,0,18,0
1713350753248,EDS 289C,A01,507361,Daly; Alan J.,18,0,18,0
1713350754271,EDS 290,A00,507366,Hofstetter; Carolyn,15,0,15,0
1713350755297,LIGM 5A,A00,507421,Fischer-Grunski; Eva K,20,0,20,0
1713350756322,LIGM 5B,A00,507423,Fischer-Grunski; Eva K,20,0,20,0
1713350757350,LIGM 5C,A00,507425,Fischer-Grunski; Eva K,20,0,20,0
1713350758376,LIIT 5AS,A00,507427,Carnelos; Chiara,20,0,20,0
1713350759401,LIIT 5BS,A00,507430,Carnelos; Chiara,20,0,20,0
1713350760427,LIIT 5CS,A00,507432,Carnelos; Chiara,20,0,20,0
1713350761460,LISP 5A,A00,507541,Munoz Sanchez; Alicia,17,0,20,3
1713350762489,LISP 5B,A00,507671,Munoz Sanchez; Alicia,14,0,20,6
1713350763511,LISP 5C,A00,507696,Munoz Sanchez; Alicia,14,0,20,6
1713350764538,MAE 197,001,528363,Boechler; Nicholas Sebastia,9998,0,9999,1
1713350765565,MATH 197,001,523477,Kedlaya; Kiran S.,9999,0,9999,0
1713350765565,MATH 197,002,563811,Zhang; Danna,9999,0,9999,0
1713350766592,MCWP 40R,A00,518780,Staff,20,0,20,0
1713350766592,MCWP 40R,B00,518781,Staff,19,0,20,1
1713350766592,MCWP 40R,C00,518783,Staff,19,0,20,1
1713350767618,MCWP 50R,A00,518791,Staff,20,0,20,0
1713350767618,MCWP 50R,B00,518792,Staff,17,0,20,3
1713350767618,MCWP 50R,C00,518793,Staff,19,0,20,1
1713350767618,MCWP 50R,D00,518794,Staff,16,0,20,4
1713350767618,MCWP 50R,E00,518795,Staff,16,0,20,4
1713350767618,MCWP 50R,F00,518796,Staff,19,0,20,1
1713350767618,MCWP 50R,G00,518797,Staff,19,0,20,1
1713350768644,MMW 12R,A01,514034,Herbst; Matthew,15,0,16,1
1713350768644,MMW 12R,A02,514035,Herbst; Matthew,16,0,16,0
1713350769669,MMW 13R,A01,514037,Staff,12,0,16,4
1713350769669,MMW 13R,A02,514039,Staff,16,0,16,0
1713350771719,SIO 295LS,A00,523233,Staff,18,0,30,12
1713350772745,SIO 295S,A00,523232,Staff,18,0,30,12
1713350773770,SOCI 117,A01,494376,Staff,1,0,5,4
1713350774798,WES 237B,A00,494380,Staff,19,0,20,1
1713350776854,AESE 279B,A00,494370,Wade; Jon P,33,0,33,0
1713350777879,ANAR 135S,A00,494369,Braswell; Geoffrey E.,0,0,0,0
1713350778905,CAT 124RS,A01,519847,Geibel; William,17,0,20,3
1713350779931,CAT 125RS,A01,515971,Geibel; William,17,0,20,3
1713350780957,CLRE 250,A00,511389,Morris; Sheldon,9996,0,9999,3
1713350781983,CLRE 251,A00,507176,Mehta; Ravindra L.,9996,0,9999,3
1713350781983,CLRE 251,B00,511410,Mehta; Ravindra L.,9998,0,9999,1
1713350783008,CLRE 252,A00,507189,Cuomo; Raphael Eduardo,9998,0,9999,1
1713350784032,CLRE 253,A00,507199,Vaida; Florin,9997,0,9999,2
1713350784032,CLRE 253,B00,507202,Vaida; Florin,9999,0,9999,0
1713350785059,CLRE 259,A00,507211,Patel; Hemal,9996,0,9999,3
1713350786088,CLRE 260,A00,507221,Cuomo; Raphael Eduardo,9999,0,9999,0
1713350787113,CLRE 297,001,507242,Cuomo; Raphael Eduardo,9999,0,9999,0
1713350788142,CSE 191,A00,516875,Minnes Kemp; Mor Mia,9999,0,9999,0
1713350789167,CSS 201S,A01,494383,Staff,35,0,35,0
1713350790198,CSS 202S,A01,494387,Staff,35,0,35,0
1713350791222,EAP 100,A00,516065,Staff,9792,0,9999,207
1713350792248,ECE 45,A01,507414,Staff,51,0,60,9
1713350793276,ECE 100,A01,507416,Baghdadchi; Saharnaz,10,0,20,10
1713350793276,ECE 100,A02,507418,Baghdadchi; Saharnaz,20,0,20,0
1713350794302,ECE 111,A01,507420,Staff,38,0,50,12
1713350795330,ECE 197,001,548057,Sievenpiper; Daniel F.,9998,0,9999,1
1713350796357,EDS 115,A00,507243,Choi; Bailey Miyeon,28,0,28,0
1713350797382,EDS 117,A01,494379,Staff,23,0,25,2
1713350798410,EDS 125,A00,507246,Hopkins; Megan Beth,29,0,30,1
1713350799432,EDS 128A,A01,507264,Fargason; Sharon Gayle,26,0,26,0
1713350800459,EDS 128B,A01,507293,Pappas; Elizabeth,30,0,30,0
1713350801483,EDS 139,A00,507294,Fargason; Sharon Gayle,30,0,30,0
1713350801483,EDS 139,B00,507313,Pappas; Elizabeth,30,0,30,0
1713350802507,EDS 201,A00,507315,Staff,26,0,30,4
1713350803536,EDS 203,A01,507317,Halter; Christopher P.,26,0,30,4
1713350804566,EDS 204R,A01,507319,Halter; Christopher P.,3,0,30,27
1713350804566,EDS 204R,B01,507331,Heinzman; Erica M.,28,0,30,2
1713350805590,EDS 206R,A00,507332,Staff,4,0,30,26
1713350805590,EDS 206R,B00,507343,Staff,28,0,30,2
1713350806615,EDS 250,A00,507344,Hemans; Patricia Ann Benitez,36,0,40,4
1713350807642,EDS 281,A00,507345,Daly; Alan J.,18,0,18,0
1713350808670,EDS 284,A00,507350,Daly; Alan J.,16,0,16,0
1713350809695,EDS 286,A00,507359,Fine; Sarah,18,0,18,0
1713350810723,EDS 289C,A01,507361,Daly; Alan J.,18,0,18,0
1713350811751,EDS 290,A00,507366,Hofstetter; Carolyn,15,0,15,0
1713350812782,LIGM 5A,A00,507421,Fischer-Grunski; Eva K,20,0,20,0
1713350813812,LIGM 5B,A00,507423,Fischer-Grunski; Eva K,20,0,20,0
1713350814839,LIGM 5C,A00,507425,Fischer-Grunski; Eva K,20,0,20,0
1713350815865,LIIT 5AS,A00,507427,Carnelos; Chiara,20,0,20,0
1713350816895,LIIT 5BS,A00,507430,Carnelos; Chiara,20,0,20,0
1713350817921,LIIT 5CS,A00,507432,Carnelos; Chiara,20,0,20,0
1713350818949,LISP 5A,A00,507541,Munoz Sanchez; Alicia,17,0,20,3
1713350819975,LISP 5B,A00,507671,Munoz Sanchez; Alicia,14,0,20,6
1713350821003,LISP 5C,A00,507696,Munoz Sanchez; Alicia,14,0,20,6
1713350822033,MAE 197,001,528363,Boechler; Nicholas Sebastia,9998,0,9999,1
1713350823061,MATH 197,001,523477,Kedlaya; Kiran S.,9999,0,9999,0
1713350823061,MATH 197,002,563811,Zhang; Danna,9999,0,9999,0
1713350824089,MCWP 40R,A00,518780,Staff,20,0,20,0
1713350824089,MCWP 40R,B00,518781,Staff,19,0,20,1
1713350824089,MCWP 40R,C00,518783,Staff,19,0,20,1
1713350825120,MCWP 50R,A00,518791,Staff,20,0,20,0
1713350825120,MCWP 50R,B00,518792,Staff,17,0,20,3
1713350825120,MCWP 50R,C00,518793,Staff,19,0,20,1
1713350825120,MCWP 50R,D00,518794,Staff,16,0,20,4
1713350825120,MCWP 50R,E00,518795,Staff,16,0,20,4
1713350825120,MCWP 50R,F00,518796,Staff,19,0,20,1
1713350825120,MCWP 50R,G00,518797,Staff,19,0,20,1
1713350826146,MMW 12R,A01,514034,Herbst; Matthew,15,0,16,1
1713350826146,MMW 12R,A02,514035,Herbst; Matthew,16,0,16,0
1713350827171,MMW 13R,A01,514037,Staff,12,0,16,4
1713350827171,MMW 13R,A02,514039,Staff,16,0,16,0
1713350829225,SIO 295LS,A00,523233,Staff,18,0,30,12
1713350830254,SIO 295S,A00,523232,Staff,18,0,30,12
1713350831282,SOCI 117,A01,494376,Staff,1,0,5,4
1713350832306,WES 237B,A00,494380,Staff,19,0,20,1
1713350834382,AESE 279B,A00,494370,Wade; Jon P,33,0,33,0
1713350835407,ANAR 135S,A00,494369,Braswell; Geoffrey E.,0,0,0,0
1713350836434,CAT 124RS,A01,519847,Geibel; William,17,0,20,3
1713350837461,CAT 125RS,A01,515971,Geibel; William,17,0,20,3
1713350838544,CLRE 250,A00,511389,Morris; Sheldon,9996,0,9999,3
1713350839571,CLRE 251,A00,507176,Mehta; Ravindra L.,9996,0,9999,3
1713350839571,CLRE 251,B00,511410,Mehta; Ravindra L.,9998,0,9999,1
1713350840600,CLRE 252,A00,507189,Cuomo; Raphael Eduardo,9998,0,9999,1
1713350841629,CLRE 253,A00,507199,Vaida; Florin,9997,0,9999,2
1713350841629,CLRE 253,B00,507202,Vaida; Florin,9999,0,9999,0
1713350842656,CLRE 259,A00,507211,Patel; Hemal,9996,0,9999,3
1713350843683,CLRE 260,A00,507221,Cuomo; Raphael Eduardo,9999,0,9999,0
1713350844710,CLRE 297,001,507242,Cuomo; Raphael Eduardo,9999,0,9999,0
1713350845738,CSE 191,A00,516875,Minnes Kemp; Mor Mia,9999,0,9999,0
1713350846770,CSS 201S,A01,494383,Staff,35,0,35,0
1713350847794,CSS 202S,A01,494387,Staff,35,0,35,0
1713350848819,EAP 100,A00,516065,Staff,9792,0,9999,207
1713350849845,ECE 45,A01,507414,Staff,51,0,60,9
1713350850870,ECE 100,A01,507416,Baghdadchi; Saharnaz,10,0,20,10
1713350850870,ECE 100,A02,507418,Baghdadchi; Saharnaz,20,0,20,0
1713350851896,ECE 111,A01,507420,Staff,38,0,50,12
1713350852922,ECE 197,001,548057,Sievenpiper; Daniel F.,9998,0,9999,1
1713350853952,EDS 115,A00,507243,Choi; Bailey Miyeon,28,0,28,0
1713350854979,EDS 117,A01,494379,Staff,23,0,25,2
1713350856009,EDS 125,A00,507246,Hopkins; Megan Beth,29,0,30,1
1713350857035,EDS 128A,A01,507264,Fargason; Sharon Gayle,26,0,26,0
1713350858063,EDS 128B,A01,507293,Pappas; Elizabeth,30,0,30,0
1713350859087,EDS 139,A00,507294,Fargason; Sharon Gayle,30,0,30,0
1713350859087,EDS 139,B00,507313,Pappas; Elizabeth,30,0,30,0
1713350860113,EDS 201,A00,507315,Staff,26,0,30,4
1713350861146,EDS 203,A01,507317,Halter; Christopher P.,26,0,30,4
1713350862172,EDS 204R,A01,507319,Halter; Christopher P.,3,0,30,27
1713350862172,EDS 204R,B01,507331,Heinzman; Erica M.,28,0,30,2
1713350863207,EDS 206R,A00,507332,Staff,4,0,30,26
1713350863207,EDS 206R,B00,507343,Staff,28,0,30,2
1713350864242,EDS 250,A00,507344,Hemans; Patricia Ann Benitez,36,0,40,4
1713350865267,EDS 281,A00,507345,Daly; Alan J.,18,0,18,0
1713350866298,EDS 284,A00,507350,Daly; Alan J.,16,0,16,0
1713350867326,EDS 286,A00,507359,Fine; Sarah,18,0,18,0
1713350868358,EDS 289C,A01,507361,Daly; Alan J.,18,0,18,0
1713350869382,EDS 290,A00,507366,Hofstetter; Carolyn,15,0,15,0
1713350870409,LIGM 5A,A00,507421,Fischer-Grunski; Eva K,20,0,20,0
1713350871435,LIGM 5B,A00,507423,Fischer-Grunski; Eva K,20,0,20,0
1713350872461,LIGM 5C,A00,507425,Fischer-Grunski; Eva K,20,0,20,0
1713350873488,LIIT 5AS,A00,507427,Carnelos; Chiara,20,0,20,0
1713350874516,LIIT 5BS,A00,507430,Carnelos; Chiara,20,0,20,0
1713350875541,LIIT 5CS,A00,507432,Carnelos; Chiara,20,0,20,0
1713350876567,LISP 5A,A00,507541,Munoz Sanchez; Alicia,17,0,20,3
1713350877602,LISP 5B,A00,507671,Munoz Sanchez; Alicia,14,0,20,6
1713350878626,LISP 5C,A00,507696,Munoz Sanchez; Alicia,14,0,20,6
1713350879652,MAE 197,001,528363,Boechler; Nicholas Sebastia,9998,0,9999,1
1713350880686,MATH 197,001,523477,Kedlaya; Kiran S.,9999,0,9999,0
1713350880686,MATH 197,002,563811,Zhang; Danna,9999,0,9999,0
1713350881717,MCWP 40R,A00,518780,Staff,20,0,20,0
1713350881717,MCWP 40R,B00,518781,Staff,19,0,20,1
1713350881717,MCWP 40R,C00,518783,Staff,19,0,20,1
1713350882740,MCWP 50R,A00,518791,Staff,20,0,20,0
1713350882740,MCWP 50R,B00,518792,Staff,17,0,20,3
1713350882740,MCWP 50R,C00,518793,Staff,19,0,20,1
1713350882740,MCWP 50R,D00,518794,Staff,16,0,20,4
1713350882740,MCWP 50R,E00,518795,Staff,16,0,20,4
1713350882740,MCWP 50R,F00,518796,Staff,19,0,20,1
1713350882740,MCWP 50R,G00,518797,Staff,19,0,20,1
1713350883771,MMW 12R,A01,514034,Herbst; Matthew,15,0,16,1
1713350883771,MMW 12R,A02,514035,Herbst; Matthew,16,0,16,0
1713350884799,MMW 13R,A01,514037,Staff,12,0,16,4
1713350884799,MMW 13R,A02,514039,Staff,16,0,16,0
1713350886851,SIO 295LS,A00,523233,Staff,18,0,30,12
1713350887878,SIO 295S,A00,523232,Staff,18,0,30,12
1713350888907,SOCI 117,A01,494376,Staff,1,0,5,4
1713350889932,WES 237B,A00,494380,Staff,19,0,20,1
1713350891993,AESE 279B,A00,494370,Wade; Jon P,33,0,33,0
1713350893017,ANAR 135S,A00,494369,Braswell; Geoffrey E.,0,0,0,0
1713350894043,CAT 124RS,A01,519847,Geibel; William,17,0,20,3
1713350895074,CAT 125RS,A01,515971,Geibel; William,17,0,20,3
1713350896100,CLRE 250,A00,511389,Morris; Sheldon,9996,0,9999,3
1713350897132,CLRE 251,A00,507176,Mehta; Ravindra L.,9996,0,9999,3
1713350897132,CLRE 251,B00,511410,Mehta; Ravindra L.,9998,0,9999,1
1713350898159,CLRE 252,A00,507189,Cuomo; Raphael Eduardo,9998,0,9999,1
1713350899187,CLRE 253,A00,507199,Vaida; Florin,9997,0,9999,2
1713350899187,CLRE 253,B00,507202,Vaida; Florin,9999,0,9999,0
1713350900215,CLRE 259,A00,507211,Patel; Hemal,9996,0,9999,3
1713350901243,CLRE 260,A00,507221,Cuomo; Raphael Eduardo,9999,0,9999,0
1713350902268,CLRE 297,001,507242,Cuomo; Raphael Eduardo,9999,0,9999,0
1713350903298,CSE 191,A00,516875,Minnes Kemp; Mor Mia,9999,0,9999,0
1713350904326,CSS 201S,A01,494383,Staff,35,0,35,0
1713350905355,CSS 202S,A01,494387,Staff,35,0,35,0
1713350906388,EAP 100,A00,516065,Staff,9792,0,9999,207
1713350907419,ECE 45,A01,507414,Staff,51,0,60,9
1713350908456,ECE 100,A01,507416,Baghdadchi; Saharnaz,10,0,20,10
1713350908456,ECE 100,A02,507418,Baghdadchi; Saharnaz,20,0,20,0
1713350909482,ECE 111,A01,507420,Staff,38,0,50,12
1713350910518,ECE 197,001,548057,Sievenpiper; Daniel F.,9998,0,9999,1
1713350911543,EDS 115,A00,507243,Choi; Bailey Miyeon,28,0,28,0
1713350912580,EDS 117,A01,494379,Staff,23,0,25,2
1713350913609,EDS 125,A00,507246,Hopkins; Megan Beth,29,0,30,1
1713350914642,EDS 128A,A01,507264,Fargason; Sharon Gayle,26,0,26,0
1713350915675,EDS 128B,A01,507293,Pappas; Elizabeth,30,0,30,0
1713350916705,EDS 139,A00,507294,Fargason; Sharon Gayle,30,0,30,0
1713350916705,EDS 139,B00,507313,Pappas; Elizabeth,30,0,30,0
1713350917736,EDS 201,A00,507315,Staff,26,0,30,4
1713350918766,EDS 203,A01,507317,Halter; Christopher P.,26,0,30,4
1713350919799,EDS 204R,A01,507319,Halter; Christopher P.,3,0,30,27
1713350919799,EDS 204R,B01,507331,Heinzman; Erica M.,28,0,30,2
1713350920824,EDS 206R,A00,507332,Staff,4,0,30,26
1713350920824,EDS 206R,B00,507343,Staff,28,0,30,2
1713350921849,EDS 250,A00,507344,Hemans; Patricia Ann Benitez,36,0,40,4
1713350922872,EDS 281,A00,507345,Daly; Alan J.,18,0,18,0
1713350923903,EDS 284,A00,507350,Daly; Alan J.,16,0,16,0
1713350924927,EDS 286,A00,507359,Fine; Sarah,18,0,18,0
1713350925950,EDS 289C,A01,507361,Daly; Alan J.,18,0,18,0
1713350926975,EDS 290,A00,507366,Hofstetter; Carolyn,15,0,15,0
1713350928021,LIGM 5A,A00,507421,Fischer-Grunski; Eva K,20,0,20,0
1713350929047,LIGM 5B,A00,507423,Fischer-Grunski; Eva K,20,0,20,0
1713350930078,LIGM 5C,A00,507425,Fischer-Grunski; Eva K,20,0,20,0
1713350931104,LIIT 5AS,A00,507427,Carnelos; Chiara,20,0,20,0
1713350932130,LIIT 5BS,A00,507430,Carnelos; Chiara,20,0,20,0
1713350933160,LIIT 5CS,A00,507432,Carnelos; Chiara,20,0,20,0
1713350934190,LISP 5A,A00,507541,Munoz Sanchez; Alicia,17,0,20,3
1713350935215,LISP 5B,A00,507671,Munoz Sanchez; Alicia,14,0,20,6
1713350936247,LISP 5C,A00,507696,Munoz Sanchez; Alicia,14,0,20,6
1713350937279,MAE 197,001,528363,Boechler; Nicholas Sebastia,9998,0,9999,1
1713350938315,MATH 197,001,523477,Kedlaya; Kiran S.,9999,0,9999,0
1713350938315,MATH 197,002,563811,Zhang; Danna,9999,0,9999,0
1713350939348,MCWP 40R,A00,518780,Staff,20,0,20,0
1713350939348,MCWP 40R,B00,518781,Staff,19,0,20,1
1713350939348,MCWP 40R,C00,518783,Staff,19,0,20,1
1713350940379,MCWP 50R,A00,518791,Staff,20,0,20,0
1713350940379,MCWP 50R,B00,518792,Staff,17,0,20,3
1713350940379,MCWP 50R,C00,518793,Staff,19,0,20,1
1713350940379,MCWP 50R,D00,518794,Staff,16,0,20,4
1713350940379,MCWP 50R,E00,518795,Staff,16,0,20,4
1713350940379,MCWP 50R,F00,518796,Staff,19,0,20,1
1713350940379,MCWP 50R,G00,518797,Staff,19,0,20,1
1713350941409,MMW 12R,A01,514034,Herbst; Matthew,15,0,16,1
1713350941409,MMW 12R,A02,514035,Herbst; Matthew,16,0,16,0
1713350942490,MMW 13R,A01,514037,Staff,12,0,16,4
1713350942490,MMW 13R,A02,514039,Staff,16,0,16,0
1713350944539,SIO 295LS,A00,523233,Staff,18,0,30,12
1713350945564,SIO 295S,A00,523232,Staff,18,0,30,12
1713350946589,SOCI 117,A01,494376,Staff,1,0,5,4
1713350947636,WES 237B,A00,494380,Staff,19,0,20,1
1713350949717,AESE 279B,A00,494370,Wade; Jon P,33,0,33,0
1713350950745,ANAR 135S,A00,494369,Braswell; Geoffrey E.,0,0,0,0
1713350951775,CAT 124RS,A01,519847,Geibel; William,17,0,20,3
1713350952804,CAT 125RS,A01,515971,Geibel; William,17,0,20,3
1713350953828,CLRE 250,A00,511389,Morris; Sheldon,9996,0,9999,3
1713350954855,CLRE 251,A00,507176,Mehta; Ravindra L.,9996,0,9999,3
1713350954855,CLRE 251,B00,511410,Mehta; Ravindra L.,9998,0,9999,1
1713350955879,CLRE 252,A00,507189,Cuomo; Raphael Eduardo,9998,0,9999,1
1713350956904,CLRE 253,A00,507199,Vaida; Florin,9997,0,9999,2
1713350956904,CLRE 253,B00,507202,Vaida; Florin,9999,0,9999,0
1713350957929,CLRE 259,A00,507211,Patel; Hemal,9996,0,9999,3
1713350958955,CLRE 260,A00,507221,Cuomo; Raphael Eduardo,9999,0,9999,0
1713350959983,CLRE 297,001,507242,Cuomo; Raphael Eduardo,9999,0,9999,0
1713350961013,CSE 191,A00,516875,Minnes Kemp; Mor Mia,9999,0,9999,0
1713350962040,CSS 201S,A01,494383,Staff,35,0,35,0
1713350963072,CSS 202S,A01,494387,Staff,35,0,35,0
1713350964098,EAP 100,A00,516065,Staff,9792,0,9999,207
1713350965125,ECE 45,A01,507414,Staff,51,0,60,9
1713350966155,ECE 100,A01,507416,Baghdadchi; Saharnaz,10,0,20,10
1713350966155,ECE 100,A02,507418,Baghdadchi; Saharnaz,20,0,20,0
1713350967183,ECE 111,A01,507420,Staff,38,0,50,12
1713350968208,ECE 197,001,548057,Sievenpiper; Daniel F.,9998,0,9999,1
1713350969236,EDS 115,A00,507243,Choi; Bailey Miyeon,28,0,28,0
1713350970260,EDS 117,A01,494379,Staff,23,0,25,2
1713350971284,EDS 125,A00,507246,Hopkins; Megan Beth,29,0,30,1
1713350972316,EDS 128A,A01,507264,Fargason; Sharon Gayle,26,0,26,0
1713350973341,EDS 128B,A01,507293,Pappas; Elizabeth,30,0,30,0
1713350974366,EDS 139,A00,507294,Fargason; Sharon Gayle,30,0,30,0
1713350974366,EDS 139,B00,507313,Pappas; Elizabeth,30,0,30,0
1713350975392,EDS 201,A00,507315,Staff,26,0,30,4
1713350976418,EDS 203,A01,507317,Halter; Christopher P.,26,0,30,4
1713350977443,EDS 204R,A01,507319,Halter; Christopher P.,3,0,30,27
1713350977443,EDS 204R,B01,507331,Heinzman; Erica M.,28,0,30,2
1713350978472,EDS 206R,A00,507332,Staff,4,0,30,26
1713350978472,EDS 206R,B00,507343,Staff,28,0,30,2
1713350979497,EDS 250,A00,507344,Hemans; Patricia Ann Benitez,36,0,40,4
1713350980520,EDS 281,A00,507345,Daly; Alan J.,18,0,18,0
1713350981551,EDS 284,A00,507350,Daly; Alan J.,16,0,16,0
1713350982577,EDS 286,A00,507359,Fine; Sarah,18,0,18,0
1713350983605,EDS 289C,A01,507361,Daly; Alan J.,18,0,18,0
1713350984635,EDS 290,A00,507366,Hofstetter; Carolyn,15,0,15,0
1713350985661,LIGM 5A,A00,507421,Fischer-Grunski; Eva K,20,0,20,0
1713350986686,LIGM 5B,A00,507423,Fischer-Grunski; Eva K,20,0,20,0
1713350987723,LIGM 5C,A00,507425,Fischer-Grunski; Eva K,20,0,20,0
1713350988748,LIIT 5AS,A00,507427,Carnelos; Chiara,20,0,20,0
1713350989773,LIIT 5BS,A00,507430,Carnelos; Chiara,20,0,20,0
1713350990799,LIIT 5CS,A00,507432,Carnelos; Chiara,20,0,20,0
1713350991823,LISP 5A,A00,507541,Munoz Sanchez; Alicia,17,0,20,3
1713350992846,LISP 5B,A00,507671,Munoz Sanchez; Alicia,14,0,20,6
1713350993871,LISP 5C,A00,507696,Munoz Sanchez; Alicia,14,0,20,6
1713350994898,MAE 197,001,528363,Boechler; Nicholas Sebastia,9998,0,9999,1
1713350995934,MATH 197,001,523477,Kedlaya; Kiran S.,9999,0,9999,0
1713350995934,MATH 197,002,563811,Zhang; Danna,9999,0,9999,0
1713350996957,MCWP 40R,A00,518780,Staff,20,0,20,0
1713350996957,MCWP 40R,B00,518781,Staff,19,0,20,1
1713350996957,MCWP 40R,C00,518783,Staff,19,0,20,1
1713350997985,MCWP 50R,A00,518791,Staff,20,0,20,0
1713350997985,MCWP 50R,B00,518792,Staff,17,0,20,3
1713350997985,MCWP 50R,C00,518793,Staff,19,0,20,1
1713350997985,MCWP 50R,D00,518794,Staff,16,0,20,4
1713350997985,MCWP 50R,E00,518795,Staff,16,0,20,4
1713350997985,MCWP 50R,F00,518796,Staff,19,0,20,1
1713350997985,MCWP 50R,G00,518797,Staff,19,0,20,1
1713350999009,MMW 12R,A01,514034,Herbst; Matthew,15,0,16,1
1713350999009,MMW 12R,A02,514035,Herbst; Matthew,16,0,16,0
1713351000038,MMW 13R,A01,514037,Staff,12,0,16,4
1713351000038,MMW 13R,A02,514039,Staff,16,0,16,0
1713351002100,SIO 295LS,A00,523233,Staff,18,0,30,12
1713351003153,SIO 295S,A00,523232,Staff,18,0,30,12
1713351004179,SOCI 117,A01,494376,Staff,1,0,5,4
1713351005203,WES 237B,A00,494380,Staff,19,0,20,1
1713351007287,AESE 279B,A00,494370,Wade; Jon P,33,0,33,0
1713351008312,ANAR 135S,A00,494369,Braswell; Geoffrey E.,0,0,0,0
1713351009340,CAT 124RS,A01,519847,Geibel; William,17,0,20,3
1713351010365,CAT 125RS,A01,515971,Geibel; William,17,0,20,3
1713351011395,CLRE 250,A00,511389,Morris; Sheldon,9996,0,9999,3
1713351012426,CLRE 251,A00,507176,Mehta; Ravindra L.,9996,0,9999,3
1713351012426,CLRE 251,B00,511410,Mehta; Ravindra L.,9998,0,9999,1
1713351013451,CLRE 252,A00,507189,Cuomo; Raphael Eduardo,9998,0,9999,1
1713351014475,CLRE 253,A00,507199,Vaida; Florin,9997,0,9999,2
1713351014475,CLRE 253,B00,507202,Vaida; Florin,9999,0,9999,0
1713351015500,CLRE 259,A00,507211,Patel; Hemal,9996,0,9999,3
1713351016527,CLRE 260,A00,507221,Cuomo; Raphael Eduardo,9999,0,9999,0
1713351017555,CLRE 297,001,507242,Cuomo; Raphael Eduardo,9999,0,9999,0
1713351018585,CSE 191,A00,516875,Minnes Kemp; Mor Mia,9999,0,9999,0
1713351019618,CSS 201S,A01,494383,Staff,35,0,35,0
1713351020648,CSS 202S,A01,494387,Staff,35,0,35,0
1713351021673,EAP 100,A00,516065,Staff,9792,0,9999,207
1713351022700,ECE 45,A01,507414,Staff,51,0,60,9
1713351023724,ECE 100,A01,507416,Baghdadchi; Saharnaz,10,0,20,10
1713351023724,ECE 100,A02,507418,Baghdadchi; Saharnaz,20,0,20,0
1713351024749,ECE 111,A01,507420,Staff,38,0,50,12
1713351025776,ECE 197,001,548057,Sievenpiper; Daniel F.,9998,0,9999,1
1713351026811,EDS 115,A00,507243,Choi; Bailey Miyeon,28,0,28,0
1713351027839,EDS 117,A01,494379,Staff,23,0,25,2
1713351028866,EDS 125,A00,507246,Hopkins; Megan Beth,29,0,30,1
1713351029895,EDS 128A,A01,507264,Fargason; Sharon Gayle,26,0,26,0
1713351030925,EDS 128B,A01,507293,Pappas; Elizabeth,30,0,30,0
1713351031951,EDS 139,A00,507294,Fargason; Sharon Gayle,30,0,30,0
1713351031951,EDS 139,B00,507313,Pappas; Elizabeth,30,0,30,0
1713351032978,EDS 201,A00,507315,Staff,26,0,30,4
1713351034004,EDS 203,A01,507317,Halter; Christopher P.,26,0,30,4
1713351035029,EDS 204R,A01,507319,Halter; Christopher P.,3,0,30,27
1713351035029,EDS 204R,B01,507331,Heinzman; Erica M.,28,0,30,2
1713351036057,EDS 206R,A00,507332,Staff,4,0,30,26
1713351036057,EDS 206R,B00,507343,Staff,28,0,30,2
1713351037082,EDS 250,A00,507344,Hemans; Patricia Ann Benitez,36,0,40,4
1713351038107,EDS 281,A00,507345,Daly; Alan J.,18,0,18,0
1713351039132,EDS 284,A00,507350,Daly; Alan J.,16,0,16,0
1713351040158,EDS 286,A00,507359,Fine; Sarah,18,0,18,0
1713351041184,EDS 289C,A01,507361,Daly; Alan J.,18,0,18,0
1713351042208,EDS 290,A00,507366,Hofstetter; Carolyn,15,0,15,0
1713351043238,LIGM 5A,A00,507421,Fischer-Grunski; Eva K,20,0,20,0
1713351044270,LIGM 5B,A00,507423,Fischer-Grunski; Eva K,20,0,20,0
1713351045296,LIGM 5C,A00,507425,Fischer-Grunski; Eva K,20,0,20,0
1713351046379,LIIT 5AS,A00,507427,Carnelos; Chiara,20,0,20,0
1713351047411,LIIT 5BS,A00,507430,Carnelos; Chiara,20,0,20,0
1713351048437,LIIT 5CS,A00,507432,Carnelos; Chiara,20,0,20,0
1713351049462,LISP 5A,A00,507541,Munoz Sanchez; Alicia,17,0,20,3
1713351050492,LISP 5B,A00,507671,Munoz Sanchez; Alicia,14,0,20,6
1713351051522,LISP 5C,A00,507696,Munoz Sanchez; Alicia,14,0,20,6
1713351052547,MAE 197,001,528363,Boechler; Nicholas Sebastia,9998,0,9999,1
1713351053577,MATH 197,001,523477,Kedlaya; Kiran S.,9999,0,9999,0
1713351053577,MATH 197,002,563811,Zhang; Danna,9999,0,9999,0
1713351054603,MCWP 40R,A00,518780,Staff,20,0,20,0
1713351054603,MCWP 40R,B00,518781,Staff,19,0,20,1
1713351054603,MCWP 40R,C00,518783,Staff,19,0,20,1
1713351055632,MCWP 50R,A00,518791,Staff,20,0,20,0
1713351055632,MCWP 50R,B00,518792,Staff,17,0,20,3
1713351055632,MCWP 50R,C00,518793,Staff,19,0,20,1
1713351055632,MCWP 50R,D00,518794,Staff,16,0,20,4
1713351055632,MCWP 50R,E00,518795,Staff,16,0,20,4
1713351055632,MCWP 50R,F00,518796,Staff,19,0,20,1
1713351055632,MCWP 50R,G00,518797,Staff,19,0,20,1
1713351056662,MMW 12R,A01,514034,Herbst; Matthew,15,0,16,1
1713351056662,MMW 12R,A02,514035,Herbst; Matthew,16,0,16,0
1713351057689,MMW 13R,A01,514037,Staff,12,0,16,4
1713351057689,MMW 13R,A02,514039,Staff,16,0,16,0
1713351059748,SIO 295LS,A00,523233,Staff,18,0,30,12
1713351060773,SIO 295S,A00,523232,Staff,18,0,30,12
1713351061799,SOCI 117,A01,494376,Staff,1,0,5,4
1713351062824,WES 237B,A00,494380,Staff,19,0,20,1
1713351064885,AESE 279B,A00,494370,Wade; Jon P,33,0,33,0
1713351065911,ANAR 135S,A00,494369,Braswell; Geoffrey E.,0,0,0,0
1713351066937,CAT 124RS,A01,519847,Geibel; William,17,0,20,3
1713351067961,CAT 125RS,A01,515971,Geibel; William,17,0,20,3
1713351068991,CLRE 250,A00,511389,Morris; Sheldon,9996,0,9999,3
1713351070016,CLRE 251,A00,507176,Mehta; Ravindra L.,9996,0,9999,3
1713351070016,CLRE 251,B00,511410,Mehta; Ravindra L.,9998,0,9999,1
1713351071051,CLRE 252,A00,507189,Cuomo; Raphael Eduardo,9998,0,9999,1
1713351072075,CLRE 253,A00,507199,Vaida; Florin,9997,0,9999,2
1713351072075,CLRE 253,B00,507202,Vaida; Florin,9999,0,9999,0
1713351073100,CLRE 259,A00,507211,Patel; Hemal,9996,0,9999,3
1713351074127,CLRE 260,A00,507221,Cuomo; Raphael Eduardo,9999,0,9999,0
1713351075151,CLRE 297,001,507242,Cuomo; Raphael Eduardo,9999,0,9999,0
1713351076177,CSE 191,A00,516875,Minnes Kemp; Mor Mia,9999,0,9999,0
1713351077203,CSS 201S,A01,494383,Staff,35,0,35,0
1713351078226,CSS 202S,A01,494387,Staff,35,0,35,0
1713351079252,EAP 100,A00,516065,Staff,9792,0,9999,207
1713351080279,ECE 45,A01,507414,Staff,51,0,60,9
1713351081317,ECE 100,A01,507416,Baghdadchi; Saharnaz,10,0,20,10
1713351081317,ECE 100,A02,507418,Baghdadchi; Saharnaz,20,0,20,0
1713351082346,ECE 111,A01,507420,Staff,38,0,50,12
1713351083373,ECE 197,001,548057,Sievenpiper; Daniel F.,9998,0,9999,1
1713351084403,EDS 115,A00,507243,Choi; Bailey Miyeon,28,0,28,0
1713351085429,EDS 117,A01,494379,Staff,23,0,25,2
1713351086455,EDS 125,A00,507246,Hopkins; Megan Beth,29,0,30,1
1713351087484,EDS 128A,A01,507264,Fargason; Sharon Gayle,26,0,26,0
1713351088514,EDS 128B,A01,507293,Pappas; Elizabeth,30,0,30,0
1713351089541,EDS 139,A00,507294,Fargason; Sharon Gayle,30,0,30,0
1713351089541,EDS 139,B00,507313,Pappas; Elizabeth,30,0,30,0
1713351090571,EDS 201,A00,507315,Staff,26,0,30,4
1713351091601,EDS 203,A01,507317,Halter; Christopher P.,26,0,30,4
1713351092628,EDS 204R,A01,507319,Halter; Christopher P.,3,0,30,27
1713351092628,EDS 204R,B01,507331,Heinzman; Erica M.,28,0,30,2
1713351093655,EDS 206R,A00,507332,Staff,4,0,30,26
1713351093655,EDS 206R,B00,507343,Staff,28,0,30,2
1713351094684,EDS 250,A00,507344,Hemans; Patricia Ann Benitez,36,0,40,4
1713351095715,EDS 281,A00,507345,Daly; Alan J.,18,0,18,0
1713351096743,EDS 284,A00,507350,Daly; Alan J.,16,0,16,0
1713351097771,EDS 286,A00,507359,Fine; Sarah,18,0,18,0
1713351098802,EDS 289C,A01,507361,Daly; Alan J.,18,0,18,0
1713351099828,EDS 290,A00,507366,Hofstetter; Carolyn,15,0,15,0
1713351100854,LIGM 5A,A00,507421,Fischer-Grunski; Eva K,20,0,20,0
1713351101886,LIGM 5B,A00,507423,Fischer-Grunski; Eva K,20,0,20,0
1713351102913,LIGM 5C,A00,507425,Fischer-Grunski; Eva K,20,0,20,0
1713351103939,LIIT 5AS,A00,507427,Carnelos; Chiara,20,0,20,0
1713351104966,LIIT 5BS,A00,507430,Carnelos; Chiara,20,0,20,0
1713351105997,LIIT 5CS,A00,507432,Carnelos; Chiara,20,0,20,0
1713351107021,LISP 5A,A00,507541,Munoz Sanchez; Alicia,17,0,20,3
1713351108046,LISP 5B,A00,507671,Munoz Sanchez; Alicia,14,0,20,6
1713351109069,LISP 5C,A00,507696,Munoz Sanchez; Alicia,14,0,20,6
1713351110101,MAE 197,001,528363,Boechler; Nicholas Sebastia,9998,0,9999,1
1713351111135,MATH 197,001,523477,Kedlaya; Kiran S.,9999,0,9999,0
1713351111135,MATH 197,002,563811,Zhang; Danna,9999,0,9999,0
1713351112304,MCWP 40R,A00,518780,Staff,20,0,20,0
1713351112304,MCWP 40R,B00,518781,Staff,19,0,20,1
1713351112304,MCWP 40R,C00,518783,Staff,19,0,20,1
1713351113335,MCWP 50R,A00,518791,Staff,20,0,20,0
1713351113335,MCWP 50R,B00,518792,Staff,17,0,20,3
1713351113335,MCWP 50R,C00,518793,Staff,19,0,20,1
1713351113335,MCWP 50R,D00,518794,Staff,16,0,20,4
1713351113335,MCWP 50R,E00,518795,Staff,16,0,20,4
1713351113335,MCWP 50R,F00,518796,Staff,19,0,20,1
1713351113335,MCWP 50R,G00,518797,Staff,19,0,20,1
1713351114364,MMW 12R,A01,514034,Herbst; Matthew,15,0,16,1
1713351114364,MMW 12R,A02,514035,Herbst; Matthew,16,0,16,0
1713351115394,MMW 13R,A01,514037,Staff,12,0,16,4
1713351115394,MMW 13R,A02,514039,Staff,16,0,16,0
1713351117446,SIO 295LS,A00,523233,Staff,18,0,30,12
1713351118474,SIO 295S,A00,523232,Staff,18,0,30,12
1713351119499,SOCI 117,A01,494376,Staff,1,0,5,4
1713351120594,WES 237B,A00,494380,Staff,19,0,20,1
1713351122654,AESE 279B,A00,494370,Wade; Jon P,33,0,33,0
1713351123681,ANAR 135S,A00,494369,Braswell; Geoffrey E.,0,0,0,0
1713351124707,CAT 124RS,A01,519847,Geibel; William,17,0,20,3
1713351125792,CAT 125RS,A01,515971,Geibel; William,17,0,20,3
1713351126819,CLRE 250,A00,511389,Morris; Sheldon,9996,0,9999,3
1713351127853,CLRE 251,A00,507176,Mehta; Ravindra L.,9996,0,9999,3
1713351127853,CLRE 251,B00,511410,Mehta; Ravindra L.,9998,0,9999,1
1713351128882,CLRE 252,A00,507189,Cuomo; Raphael Eduardo,9998,0,9999,1
1713351129907,CLRE 253,A00,507199,Vaida; Florin,9997,0,9999,2
1713351129907,CLRE 253,B00,507202,Vaida; Florin,9999,0,9999,0
1713351130933,CLRE 259,A00,507211,Patel; Hemal,9996,0,9999,3
1713351131957,CLRE 260,A00,507221,Cuomo; Raphael Eduardo,9999,0,9999,0
1713351132986,CLRE 297,001,507242,Cuomo; Raphael Eduardo,9999,0,9999,0
1713351134010,CSE 191,A00,516875,Minnes Kemp; Mor Mia,9999,0,9999,0
1713351135039,CSS 201S,A01,494383,Staff,35,0,35,0
1713351136064,CSS 202S,A01,494387,Staff,35,0,35,0
1713351137090,EAP 100,A00,516065,Staff,9792,0,9999,207
1713351138116,ECE 45,A01,507414,Staff,51,0,60,9
1713351139196,ECE 100,A01,507416,Baghdadchi; Saharnaz,10,0,20,10
1713351139196,ECE 100,A02,507418,Baghdadchi; Saharnaz,20,0,20,0
1713351140220,ECE 111,A01,507420,Staff,38,0,50,12
1713351141245,ECE 197,001,548057,Sievenpiper; Daniel F.,9998,0,9999,1
1713351142272,EDS 115,A00,507243,Choi; Bailey Miyeon,28,0,28,0
1713351143301,EDS 117,A01,494379,Staff,23,0,25,2
1713351144325,EDS 125,A00,507246,Hopkins; Megan Beth,29,0,30,1
1713351145357,EDS 128A,A01,507264,Fargason; Sharon Gayle,26,0,26,0
1713351146382,EDS 128B,A01,507293,Pappas; Elizabeth,30,0,30,0
1713351147407,EDS 139,A00,507294,Fargason; Sharon Gayle,30,0,30,0
1713351147407,EDS 139,B00,507313,Pappas; Elizabeth,30,0,30,0
1713351148434,EDS 201,A00,507315,Staff,26,0,30,4
1713351149468,EDS 203,A01,507317,Halter; Christopher P.,26,0,30,4
1713351150548,EDS 204R,A01,507319,Halter; Christopher P.,3,0,30,27
1713351150548,EDS 204R,B01,507331,Heinzman; Erica M.,28,0,30,2
1713351151573,EDS 206R,A00,507332,Staff,4,0,30,26
1713351151573,EDS 206R,B00,507343,Staff,28,0,30,2
1713351152598,EDS 250,A00,507344,Hemans; Patricia Ann Benitez,36,0,40,4
1713351153623,EDS 281,A00,507345,Daly; Alan J.,18,0,18,0
1713351154648,EDS 284,A00,507350,Daly; Alan J.,16,0,16,0
1713351155673,EDS 286,A00,507359,Fine; Sarah,18,0,18,0
1713351156700,EDS 289C,A01,507361,Daly; Alan J.,18,0,18,0
1713351157724,EDS 290,A00,507366,Hofstetter; Carolyn,15,0,15,0
1713351158753,LIGM 5A,A00,507421,Fischer-Grunski; Eva K,20,0,20,0
1713351159779,LIGM 5B,A00,507423,Fischer-Grunski; Eva K,20,0,20,0
1713351160804,LIGM 5C,A00,507425,Fischer-Grunski; Eva K,20,0,20,0
1713351161833,LIIT 5AS,A00,507427,Carnelos; Chiara,20,0,20,0
1713351162859,LIIT 5BS,A00,507430,Carnelos; Chiara,20,0,20,0
1713351163905,LIIT 5CS,A00,507432,Carnelos; Chiara,20,0,20,0
1713351164936,LISP 5A,A00,507541,Munoz Sanchez; Alicia,17,0,20,3
1713351165961,LISP 5B,A00,507671,Munoz Sanchez; Alicia,14,0,20,6
1713351166987,LISP 5C,A00,507696,Munoz Sanchez; Alicia,14,0,20,6
1713351168013,MAE 197,001,528363,Boechler; Nicholas Sebastia,9998,0,9999,1
1713351169038,MATH 197,001,523477,Kedlaya; Kiran S.,9999,0,9999,0
1713351169038,MATH 197,002,563811,Zhang; Danna,9999,0,9999,0
1713351170064,MCWP 40R,A00,518780,Staff,20,0,20,0
1713351170064,MCWP 40R,B00,518781,Staff,19,0,20,1
1713351170064,MCWP 40R,C00,518783,Staff,19,0,20,1
1713351171109,MCWP 50R,A00,518791,Staff,20,0,20,0
1713351171109,MCWP 50R,B00,518792,Staff,17,0,20,3
1713351171109,MCWP 50R,C00,518793,Staff,19,0,20,1
1713351171109,MCWP 50R,D00,518794,Staff,16,0,20,4
1713351171109,MCWP 50R,E00,518795,Staff,16,0,20,4
1713351171109,MCWP 50R,F00,518796,Staff,19,0,20,1
1713351171109,MCWP 50R,G00,518797,Staff,19,0,20,1
1713351172133,MMW 12R,A01,514034,Herbst; Matthew,15,0,16,1
1713351172133,MMW 12R,A02,514035,Herbst; Matthew,16,0,16,0
1713351173159,MMW 13R,A01,514037,Staff,12,0,16,4
1713351173159,MMW 13R,A02,514039,Staff,16,0,16,0
1713351175213,SIO 295LS,A00,523233,Staff,18,0,30,12
1713351176245,SIO 295S,A00,523232,Staff,18,0,30,12
1713351177270,SOCI 117,A01,494376,Staff,1,0,5,4
1713351178295,WES 237B,A00,494380,Staff,19,0,20,1
1713351180363,AESE 279B,A00,494370,Wade; Jon P,33,0,33,0
1713351181392,ANAR 135S,A00,494369,Braswell; Geoffrey E.,0,0,0,0
1713351182418,CAT 124RS,A01,519847,Geibel; William,17,0,20,3
1713351183443,CAT 125RS,A01,515971,Geibel; William,17,0,20,3
1713351184476,CLRE 250,A00,511389,Morris; Sheldon,9996,0,9999,3
1713351185501,CLRE 251,A00,507176,Mehta; Ravindra L.,9996,0,9999,3
1713351185501,CLRE 251,B00,511410,Mehta; Ravindra L.,9998,0,9999,1
1713351186526,CLRE 252,A00,507189,Cuomo; Raphael Eduardo,9998,0,9999,1
1713351187552,CLRE 253,A00,507199,Vaida; Florin,9997,0,9999,2
1713351187552,CLRE 253,B00,507202,Vaida; Florin,9999,0,9999,0
1713351188576,CLRE 259,A00,507211,Patel; Hemal,9996,0,9999,3
1713351189606,CLRE 260,A00,507221,Cuomo; Raphael Eduardo,9999,0,9999,0
1713351190632,CLRE 297,001,507242,Cuomo; Raphael Eduardo,9999,0,9999,0
1713351191662,CSE 191,A00,516875,Minnes Kemp; Mor Mia,9999,0,9999,0
1713351192690,CSS 201S,A01,494383,Staff,35,0,35,0
1713351193722,CSS 202S,A01,494387,Staff,35,0,35,0
1713351194746,EAP 100,A00,516065,Staff,9792,0,9999,207
1713351195772,ECE 45,A01,507414,Staff,51,0,60,9
1713351196805,ECE 100,A01,507416,Baghdadchi; Saharnaz,10,0,20,10
1713351196805,ECE 100,A02,507418,Baghdadchi; Saharnaz,20,0,20,0
1713351197831,ECE 111,A01,507420,Staff,38,0,50,12
1713351198860,ECE 197,001,548057,Sievenpiper; Daniel F.,9998,0,9999,1
1713351199885,EDS 115,A00,507243,Choi; Bailey Miyeon,28,0,28,0
1713351200912,EDS 117,A01,494379,Staff,23,0,25,2
1713351201937,EDS 125,A00,507246,Hopkins; Megan Beth,29,0,30,1
1713351202963,EDS 128A,A01,507264,Fargason; Sharon Gayle,26,0,26,0
1713351203988,EDS 128B,A01,507293,Pappas; Elizabeth,30,0,30,0
1713351205014,EDS 139,A00,507294,Fargason; Sharon Gayle,30,0,30,0
1713351205014,EDS 139,B00,507313,Pappas; Elizabeth,30,0,30,0
1713351206050,EDS 201,A00,507315,Staff,26,0,30,4
1713351207089,EDS 203,A01,507317,Halter; Christopher P.,26,0,30,4
1713351208123,EDS 204R,A01,507319,Halter; Christopher P.,3,0,30,27
1713351208123,EDS 204R,B01,507331,Heinzman; Erica M.,28,0,30,2
1713351209148,EDS 206R,A00,507332,Staff,4,0,30,26
1713351209148,EDS 206R,B00,507343,Staff,28,0,30,2
1713351210179,EDS 250,A00,507344,Hemans; Patricia Ann Benitez,36,0,40,4
1713351211205,EDS 281,A00,507345,Daly; Alan J.,18,0,18,0
1713351212231,EDS 284,A00,507350,Daly; Alan J.,16,0,16,0
1713351213257,EDS 286,A00,507359,Fine; Sarah,18,0,18,0
1713351214282,EDS 289C,A01,507361,Daly; Alan J.,18,0,18,0
1713351215306,EDS 290,A00,507366,Hofstetter; Carolyn,15,0,15,0
1713351216331,LIGM 5A,A00,507421,Fischer-Grunski; Eva K,20,0,20,0
1713351217357,LIGM 5B,A00,507423,Fischer-Grunski; Eva K,20,0,20,0
1713351218387,LIGM 5C,A00,507425,Fischer-Grunski; Eva K,20,0,20,0
1713351219411,LIIT 5AS,A00,507427,Carnelos; Chiara,20,0,20,0
1713351220436,LIIT 5BS,A00,507430,Carnelos; Chiara,20,0,20,0
1713351221463,LIIT 5CS,A00,507432,Carnelos; Chiara,20,0,20,0
1713351222486,LISP 5A,A00,507541,Munoz Sanchez; Alicia,17,0,20,3
1713351223517,LISP 5B,A00,507671,Munoz Sanchez; Alicia,14,0,20,6
1713351224598,LISP 5C,A00,507696,Munoz Sanchez; Alicia,14,0,20,6
1713351225623,MAE 197,001,528363,Boechler; Nicholas Sebastia,9998,0,9999,1
1713351226652,MATH 197,001,523477,Kedlaya; Kiran S.,9999,0,9999,0
1713351226652,MATH 197,002,563811,Zhang; Danna,9999,0,9999,0
1713351227677,MCWP 40R,A00,518780,Staff,20,0,20,0
1713351227677,MCWP 40R,B00,518781,Staff,19,0,20,1
1713351227677,MCWP 40R,C00,518783,Staff,19,0,20,1
1713351228705,MCWP 50R,A00,518791,Staff,20,0,20,0
1713351228705,MCWP 50R,B00,518792,Staff,17,0,20,3
1713351228705,MCWP 50R,C00,518793,Staff,19,0,20,1
1713351228705,MCWP 50R,D00,518794,Staff,16,0,20,4
1713351228705,MCWP 50R,E00,518795,Staff,16,0,20,4
1713351228705,MCWP 50R,F00,518796,Staff,19,0,20,1
1713351228705,MCWP 50R,G00,518797,Staff,19,0,20,1
1713351229731,MMW 12R,A01,514034,Herbst; Matthew,15,0,16,1
1713351229731,MMW 12R,A02,514035,Herbst; Matthew,16,0,16,0
1713351230763,MMW 13R,A01,514037,Staff,12,0,16,4
1713351230763,MMW 13R,A02,514039,Staff,16,0,16,0
1713351232817,SIO 295LS,A00,523233,Staff,18,0,30,12
1713351233846,SIO 295S,A00,523232,Staff,18,0,30,12
1713351234881,SOCI 117,A01,494376,Staff,1,0,5,4
1713351235907,WES 237B,A00,494380,Staff,19,0,20,1
1713351237972,AESE 279B,A00,494370,Wade; Jon P,33,0,33,0
1713351238997,ANAR 135S,A00,494369,Braswell; Geoffrey E.,0,0,0,0
1713351240024,CAT 124RS,A01,519847,Geibel; William,17,0,20,3
1713351241050,CAT 125RS,A01,515971,Geibel; William,17,0,20,3
1713351242080,CLRE 250,A00,511389,Morris; Sheldon,9996,0,9999,3
1713351243120,CLRE 251,A00,507176,Mehta; Ravindra L.,9996,0,9999,3
1713351243120,CLRE 251,B00,511410,Mehta; Ravindra L.,9998,0,9999,1
1713351244145,CLRE 252,A00,507189,Cuomo; Raphael Eduardo,9998,0,9999,1
1713351245175,CLRE 253,A00,507199,Vaida; Florin,9997,0,9999,2
1713351245175,CLRE 253,B00,507202,Vaida; Florin,9999,0,9999,0
1713351246198,CLRE 259,A00,507211,Patel; Hemal,9996,0,9999,3
1713351247227,CLRE 260,A00,507221,Cuomo; Raphael Eduardo,9999,0,9999,0
1713351248252,CLRE 297,001,507242,Cuomo; Raphael Eduardo,9999,0,9999,0
1713351249277,CSE 191,A00,516875,Minnes Kemp; Mor Mia,9999,0,9999,0
1713351250306,CSS 201S,A01,494383,Staff,35,0,35,0
1713351251332,CSS 202S,A01,494387,Staff,35,0,35,0
1713351252358,EAP 100,A00,516065,Staff,9792,0,9999,207
1713351253398,ECE 45,A01,507414,Staff,51,0,60,9
1713351254477,ECE 100,A01,507416,Baghdadchi; Saharnaz,10,0,20,10
1713351254477,ECE 100,A02,507418,Baghdadchi; Saharnaz,20,0,20,0
1713351255506,ECE 111,A01,507420,Staff,38,0,50,12
1713351256532,ECE 197,001,548057,Sievenpiper; Daniel F.,9998,0,9999,1
1713351257558,EDS 115,A00,507243,Choi; Bailey Miyeon,28,0,28,0
1713351258585,EDS 117,A01,494379,Staff,23,0,25,2
1713351259611,EDS 125,A00,507246,Hopkins; Megan Beth,29,0,30,1
1713351260640,EDS 128A,A01,507264,Fargason; Sharon Gayle,26,0,26,0
1713351261664,EDS 128B,A01,507293,Pappas; Elizabeth,30,0,30,0
1713351262689,EDS 139,A00,507294,Fargason; Sharon Gayle,30,0,30,0
1713351262689,EDS 139,B00,507313,Pappas; Elizabeth,30,0,30,0
1713351263715,EDS 201,A00,507315,Staff,26,0,30,4
1713351264740,EDS 203,A01,507317,Halter; Christopher P.,26,0,30,4
1713351265765,EDS 204R,A01,507319,Halter; Christopher P.,3,0,30,27
1713351265765,EDS 204R,B01,507331,Heinzman; Erica M.,28,0,30,2
1713351266803,EDS 206R,A00,507332,Staff,4,0,30,26
1713351266803,EDS 206R,B00,507343,Staff,28,0,30,2
1713351267828,EDS 250,A00,507344,Hemans; Patricia Ann Benitez,36,0,40,4
1713351268853,EDS 281,A00,507345,Daly; Alan J.,18,0,18,0
1713351269878,EDS 284,A00,507350,Daly; Alan J.,16,0,16,0
1713351270905,EDS 286,A00,507359,Fine; Sarah,18,0,18,0
1713351271934,EDS 289C,A01,507361,Daly; Alan J.,18,0,18,0
1713351272960,EDS 290,A00,507366,Hofstetter; Carolyn,15,0,15,0
1713351273986,LIGM 5A,A00,507421,Fischer-Grunski; Eva K,20,0,20,0
1713351275009,LIGM 5B,A00,507423,Fischer-Grunski; Eva K,20,0,20,0
1713351276034,LIGM 5C,A00,507425,Fischer-Grunski; Eva K,20,0,20,0
1713351277063,LIIT 5AS,A00,507427,Carnelos; Chiara,20,0,20,0
1713351278089,LIIT 5BS,A00,507430,Carnelos; Chiara,20,0,20,0
1713351279115,LIIT 5CS,A00,507432,Carnelos; Chiara,20,0,20,0
1713351280144,LISP 5A,A00,507541,Munoz Sanchez; Alicia,17,0,20,3
1713351281169,LISP 5B,A00,507671,Munoz Sanchez; Alicia,14,0,20,6
1713351282200,LISP 5C,A00,507696,Munoz Sanchez; Alicia,14,0,20,6
1713351283225,MAE 197,001,528363,Boechler; Nicholas Sebastia,9998,0,9999,1
1713351284252,MATH 197,001,523477,Kedlaya; Kiran S.,9999,0,9999,0
1713351284252,MATH 197,002,563811,Zhang; Danna,9999,0,9999,0
1713351285277,MCWP 40R,A00,518780,Staff,20,0,20,0
1713351285277,MCWP 40R,B00,518781,Staff,19,0,20,1
1713351285277,MCWP 40R,C00,518783,Staff,19,0,20,1
1713351286306,MCWP 50R,A00,518791,Staff,20,0,20,0
1713351286306,MCWP 50R,B00,518792,Staff,17,0,20,3
1713351286306,MCWP 50R,C00,518793,Staff,19,0,20,1
1713351286306,MCWP 50R,D00,518794,Staff,16,0,20,4
1713351286306,MCWP 50R,E00,518795,Staff,16,0,20,4
1713351286306,MCWP 50R,F00,518796,Staff,19,0,20,1
1713351286306,MCWP 50R,G00,518797,Staff,19,0,20,1
1713351287333,MMW 12R,A01,514034,Herbst; Matthew,15,0,16,1
1713351287333,MMW 12R,A02,514035,Herbst; Matthew,16,0,16,0
1713351288362,MMW 13R,A01,514037,Staff,12,0,16,4
1713351288362,MMW 13R,A02,514039,Staff,16,0,16,0
1713351290415,SIO 295LS,A00,523233,Staff,18,0,30,12
1713351291441,SIO 295S,A00,523232,Staff,18,0,30,12
1713351292469,SOCI 117,A01,494376,Staff,1,0,5,4
1713351293494,WES 237B,A00,494380,Staff,19,0,20,1
1713351295566,AESE 279B,A00,494370,Wade; Jon P,33,0,33,0
1713351296590,ANAR 135S,A00,494369,Braswell; Geoffrey E.,0,0,0,0
1713351297614,CAT 124RS,A01,519847,Geibel; William,17,0,20,3
1713351298638,CAT 125RS,A01,515971,Geibel; William,17,0,20,3
1713351299663,CLRE 250,A00,511389,Morris; Sheldon,9996,0,9999,3
1713351300697,CLRE 251,A00,507176,Mehta; Ravindra L.,9996,0,9999,3
1713351300697,CLRE 251,B00,511410,Mehta; Ravindra L.,9998,0,9999,1
1713351301721,CLRE 252,A00,507189,Cuomo; Raphael Eduardo,9998,0,9999,1
1713351302749,CLRE 253,A00,507199,Vaida; Florin,9997,0,9999,2
1713351302749,CLRE 253,B00,507202,Vaida; Florin,9999,0,9999,0
1713351303776,CLRE 259,A00,507211,Patel; Hemal,9996,0,9999,3
1713351304812,CLRE 260,A00,507221,Cuomo; Raphael Eduardo,9999,0,9999,0
1713351305837,CLRE 297,001,507242,Cuomo; Raphael Eduardo,9999,0,9999,0
1713351307137,CSE 191,A00,516875,Minnes Kemp; Mor Mia,9999,0,9999,0
1713351308164,CSS 201S,A01,494383,Staff,35,0,35,0
1713351309189,CSS 202S,A01,494387,Staff,35,0,35,0
1713351310215,EAP 100,A00,516065,Staff,9792,0,9999,207
1713351311252,ECE 45,A01,507414,Staff,51,0,60,9
1713351312278,ECE 100,A01,507416,Baghdadchi; Saharnaz,9,0,20,11
1713351312278,ECE 100,A02,507418,Baghdadchi; Saharnaz,20,0,20,0
1713351313310,ECE 111,A01,507420,Staff,38,0,50,12
1713351314342,ECE 197,001,548057,Sievenpiper; Daniel F.,9998,0,9999,1
1713351315377,EDS 115,A00,507243,Choi; Bailey Miyeon,28,0,28,0
1713351316412,EDS 117,A01,494379,Staff,23,0,25,2
1713351317442,EDS 125,A00,507246,Hopkins; Megan Beth,29,0,30,1
1713351318468,EDS 128A,A01,507264,Fargason; Sharon Gayle,26,0,26,0
1713351319496,EDS 128B,A01,507293,Pappas; Elizabeth,30,0,30,0
1713351320522,EDS 139,A00,507294,Fargason; Sharon Gayle,30,0,30,0
1713351320522,EDS 139,B00,507313,Pappas; Elizabeth,30,0,30,0
1713351321551,EDS 201,A00,507315,Staff,26,0,30,4
1713351322575,EDS 203,A01,507317,Halter; Christopher P.,26,0,30,4
1713351323601,EDS 204R,A01,507319,Halter; Christopher P.,3,0,30,27
1713351323601,EDS 204R,B01,507331,Heinzman; Erica M.,28,0,30,2
1713351324627,EDS 206R,A00,507332,Staff,4,0,30,26
1713351324627,EDS 206R,B00,507343,Staff,28,0,30,2
1713351325653,EDS 250,A00,507344,Hemans; Patricia Ann Benitez,36,0,40,4
1713351326680,EDS 281,A00,507345,Daly; Alan J.,18,0,18,0
1713351327704,EDS 284,A00,507350,Daly; Alan J.,16,0,16,0
1713351328738,EDS 286,A00,507359,Fine; Sarah,18,0,18,0
1713351329767,EDS 289C,A01,507361,Daly; Alan J.,18,0,18,0
1713351330793,EDS 290,A00,507366,Hofstetter; Carolyn,15,0,15,0
1713351331820,LIGM 5A,A00,507421,Fischer-Grunski; Eva K,20,0,20,0
1713351332847,LIGM 5B,A00,507423,Fischer-Grunski; Eva K,20,0,20,0
1713351333873,LIGM 5C,A00,507425,Fischer-Grunski; Eva K,20,0,20,0
1713351334903,LIIT 5AS,A00,507427,Carnelos; Chiara,20,0,20,0
1713351335934,LIIT 5BS,A00,507430,Carnelos; Chiara,20,0,20,0
1713351336957,LIIT 5CS,A00,507432,Carnelos; Chiara,20,0,20,0
1713351337984,LISP 5A,A00,507541,Munoz Sanchez; Alicia,17,0,20,3
1713351339009,LISP 5B,A00,507671,Munoz Sanchez; Alicia,14,0,20,6
1713351340035,LISP 5C,A00,507696,Munoz Sanchez; Alicia,14,0,20,6
1713351341061,MAE 197,001,528363,Boechler; Nicholas Sebastia,9998,0,9999,1
1713351342095,MATH 197,001,523477,Kedlaya; Kiran S.,9999,0,9999,0
1713351342095,MATH 197,002,563811,Zhang; Danna,9999,0,9999,0
1713351343121,MCWP 40R,A00,518780,Staff,20,0,20,0
1713351343121,MCWP 40R,B00,518781,Staff,19,0,20,1
1713351343121,MCWP 40R,C00,518783,Staff,19,0,20,1
1713351344147,MCWP 50R,A00,518791,Staff,20,0,20,0
1713351344147,MCWP 50R,B00,518792,Staff,17,0,20,3
1713351344147,MCWP 50R,C00,518793,Staff,19,0,20,1
1713351344147,MCWP 50R,D00,518794,Staff,16,0,20,4
1713351344147,MCWP 50R,E00,518795,Staff,16,0,20,4
1713351344147,MCWP 50R,F00,518796,Staff,19,0,20,1
1713351344147,MCWP 50R,G00,518797,Staff,19,0,20,1
1713351345174,MMW 12R,A01,514034,Herbst; Matthew,15,0,16,1
1713351345174,MMW 12R,A02,514035,Herbst; Matthew,16,0,16,0
1713351346199,MMW 13R,A01,514037,Staff,12,0,16,4
1713351346199,MMW 13R,A02,514039,Staff,16,0,16,0
1713351348249,SIO 295LS,A00,523233,Staff,18,0,30,12
1713351349275,SIO 295S,A00,523232,Staff,18,0,30,12
1713351350307,SOCI 117,A01,494376,Staff,1,0,5,4
1713351351332,WES 237B,A00,494380,Staff,19,0,20,1
1713351353394,AESE 279B,A00,494370,Wade; Jon P,33,0,33,0
1713351354420,ANAR 135S,A00,494369,Braswell; Geoffrey E.,0,0,0,0
1713351355446,CAT 124RS,A01,519847,Geibel; William,17,0,20,3
1713351356471,CAT 125RS,A01,515971,Geibel; William,17,0,20,3
1713351357497,CLRE 250,A00,511389,Morris; Sheldon,9996,0,9999,3
1713351358591,CLRE 251,A00,507176,Mehta; Ravindra L.,9996,0,9999,3
1713351358591,CLRE 251,B00,511410,Mehta; Ravindra L.,9998,0,9999,1
1713351359617,CLRE 252,A00,507189,Cuomo; Raphael Eduardo,9998,0,9999,1
1713351360644,CLRE 253,A00,507199,Vaida; Florin,9997,0,9999,2
1713351360644,CLRE 253,B00,507202,Vaida; Florin,9999,0,9999,0
1713351361674,CLRE 259,A00,507211,Patel; Hemal,9996,0,9999,3
1713351362699,CLRE 260,A00,507221,Cuomo; Raphael Eduardo,9999,0,9999,0
1713351363725,CLRE 297,001,507242,Cuomo; Raphael Eduardo,9999,0,9999,0
1713351364750,CSE 191,A00,516875,Minnes Kemp; Mor Mia,9999,0,9999,0
1713351365776,CSS 201S,A01,494383,Staff,35,0,35,0
1713351366807,CSS 202S,A01,494387,Staff,35,0,35,0
1713351367833,EAP 100,A00,516065,Staff,9792,0,9999,207
1713351368865,ECE 45,A01,507414,Staff,51,0,60,9
1713351369892,ECE 100,A01,507416,Baghdadchi; Saharnaz,9,0,20,11
1713351369892,ECE 100,A02,507418,Baghdadchi; Saharnaz,20,0,20,0
1713351370932,ECE 111,A01,507420,Staff,38,0,50,12
1713351371958,ECE 197,001,548057,Sievenpiper; Daniel F.,9998,0,9999,1
1713351372991,EDS 115,A00,507243,Choi; Bailey Miyeon,28,0,28,0
1713351374018,EDS 117,A01,494379,Staff,23,0,25,2
1713351375056,EDS 125,A00,507246,Hopkins; Megan Beth,29,0,30,1
1713351376082,EDS 128A,A01,507264,Fargason; Sharon Gayle,26,0,26,0
1713351377111,EDS 128B,A01,507293,Pappas; Elizabeth,30,0,30,0
1713351378136,EDS 139,A00,507294,Fargason; Sharon Gayle,30,0,30,0
1713351378136,EDS 139,B00,507313,Pappas; Elizabeth,30,0,30,0
1713351379167,EDS 201,A00,507315,Staff,26,0,30,4
1713351380196,EDS 203,A01,507317,Halter; Christopher P.,26,0,30,4
1713351381218,EDS 204R,A01,507319,Halter; Christopher P.,3,0,30,27
1713351381218,EDS 204R,B01,507331,Heinzman; Erica M.,28,0,30,2
1713351382249,EDS 206R,A00,507332,Staff,4,0,30,26
1713351382249,EDS 206R,B00,507343,Staff,28,0,30,2
1713351383274,EDS 250,A00,507344,Hemans; Patricia Ann Benitez,36,0,40,4
1713351384304,EDS 281,A00,507345,Daly; Alan J.,18,0,18,0
1713351385329,EDS 284,A00,507350,Daly; Alan J.,16,0,16,0
1713351386354,EDS 286,A00,507359,Fine; Sarah,18,0,18,0
1713351387384,EDS 289C,A01,507361,Daly; Alan J.,18,0,18,0
1713351388409,EDS 290,A00,507366,Hofstetter; Carolyn,15,0,15,0
1713351389436,LIGM 5A,A00,507421,Fischer-Grunski; Eva K,20,0,20,0
1713351390462,LIGM 5B,A00,507423,Fischer-Grunski; Eva K,20,0,20,0
1713351391495,LIGM 5C,A00,507425,Fischer-Grunski; Eva K,20,0,20,0
1713351392520,LIIT 5AS,A00,507427,Carnelos; Chiara,20,0,20,0
1713351393552,LIIT 5BS,A00,507430,Carnelos; Chiara,20,0,20,0
1713351394577,LIIT 5CS,A00,507432,Carnelos; Chiara,20,0,20,0
1713351395603,LISP 5A,A00,507541,Munoz Sanchez; Alicia,17,0,20,3
1713351396629,LISP 5B,A00,507671,Munoz Sanchez; Alicia,14,0,20,6
1713351397654,LISP 5C,A00,507696,Munoz Sanchez; Alicia,14,0,20,6
1713351398681,MAE 197,001,528363,Boechler; Nicholas Sebastia,9998,0,9999,1
1713351399712,MATH 197,001,523477,Kedlaya; Kiran S.,9999,0,9999,0
1713351399712,MATH 197,002,563811,Zhang; Danna,9999,0,9999,0
1713351400737,MCWP 40R,A00,518780,Staff,20,0,20,0
1713351400737,MCWP 40R,B00,518781,Staff,19,0,20,1
1713351400737,MCWP 40R,C00,518783,Staff,19,0,20,1
1713351401761,MCWP 50R,A00,518791,Staff,20,0,20,0
1713351401761,MCWP 50R,B00,518792,Staff,17,0,20,3
1713351401761,MCWP 50R,C00,518793,Staff,19,0,20,1
1713351401761,MCWP 50R,D00,518794,Staff,16,0,20,4
1713351401761,MCWP 50R,E00,518795,Staff,16,0,20,4
1713351401761,MCWP 50R,F00,518796,Staff,19,0,20,1
1713351401761,MCWP 50R,G00,518797,Staff,19,0,20,1
1713351402792,MMW 12R,A01,514034,Herbst; Matthew,15,0,16,1
1713351402792,MMW 12R,A02,514035,Herbst; Matthew,16,0,16,0
1713351403815,MMW 13R,A01,514037,Staff,12,0,16,4
1713351403815,MMW 13R,A02,514039,Staff,16,0,16,0
1713351405867,SIO 295LS,A00,523233,Staff,18,0,30,12
1713351406897,SIO 295S,A00,523232,Staff,18,0,30,12
1713351407924,SOCI 117,A01,494376,Staff,1,0,5,4
1713351408949,WES 237B,A00,494380,Staff,19,0,20,1
1713351411016,AESE 279B,A00,494370,Wade; Jon P,33,0,33,0
1713351412054,ANAR 135S,A00,494369,Braswell; Geoffrey E.,0,0,0,0
1713351413085,CAT 124RS,A01,519847,Geibel; William,17,0,20,3
1713351414111,CAT 125RS,A01,515971,Geibel; William,17,0,20,3
1713351415133,CLRE 250,A00,511389,Morris; Sheldon,9996,0,9999,3
1713351416158,CLRE 251,A00,507176,Mehta; Ravindra L.,9996,0,9999,3
1713351416158,CLRE 251,B00,511410,Mehta; Ravindra L.,9998,0,9999,1
1713351417188,CLRE 252,A00,507189,Cuomo; Raphael Eduardo,9998,0,9999,1
1713351418213,CLRE 253,A00,507199,Vaida; Florin,9997,0,9999,2
1713351418213,CLRE 253,B00,507202,Vaida; Florin,9999,0,9999,0
1713351419239,CLRE 259,A00,507211,Patel; Hemal,9996,0,9999,3
1713351420262,CLRE 260,A00,507221,Cuomo; Raphael Eduardo,9999,0,9999,0
1713351421292,CLRE 297,001,507242,Cuomo; Raphael Eduardo,9999,0,9999,0
1713351422316,CSE 191,A00,516875,Minnes Kemp; Mor Mia,9999,0,9999,0
1713351423342,CSS 201S,A01,494383,Staff,35,0,35,0
1713351424369,CSS 202S,A01,494387,Staff,35,0,35,0
1713351425397,EAP 100,A00,516065,Staff,9792,0,9999,207
1713351426427,ECE 45,A01,507414,Staff,51,0,60,9
1713351427453,ECE 100,A01,507416,Baghdadchi; Saharnaz,9,0,20,11
1713351427453,ECE 100,A02,507418,Baghdadchi; Saharnaz,20,0,20,0
1713351428479,ECE 111,A01,507420,Staff,38,0,50,12
1713351429506,ECE 197,001,548057,Sievenpiper; Daniel F.,9998,0,9999,1
1713351430534,EDS 115,A00,507243,Choi; Bailey Miyeon,28,0,28,0
1713351431562,EDS 117,A01,494379,Staff,23,0,25,2
1713351432587,EDS 125,A00,507246,Hopkins; Megan Beth,29,0,30,1
1713351433612,EDS 128A,A01,507264,Fargason; Sharon Gayle,26,0,26,0
1713351434642,EDS 128B,A01,507293,Pappas; Elizabeth,30,0,30,0
1713351435668,EDS 139,A00,507294,Fargason; Sharon Gayle,30,0,30,0
1713351435668,EDS 139,B00,507313,Pappas; Elizabeth,30,0,30,0
1713351436692,EDS 201,A00,507315,Staff,26,0,30,4
1713351437718,EDS 203,A01,507317,Halter; Christopher P.,26,0,30,4
1713351438751,EDS 204R,A01,507319,Halter; Christopher P.,3,0,30,27
1713351438751,EDS 204R,B01,507331,Heinzman; Erica M.,28,0,30,2
1713351439776,EDS 206R,A00,507332,Staff,4,0,30,26
1713351439776,EDS 206R,B00,507343,Staff,28,0,30,2
1713351440802,EDS 250,A00,507344,Hemans; Patricia Ann Benitez,36,0,40,4
1713351441828,EDS 281,A00,507345,Daly; Alan J.,18,0,18,0
1713351442854,EDS 284,A00,507350,Daly; Alan J.,16,0,16,0
1713351443884,EDS 286,A00,507359,Fine; Sarah,18,0,18,0
1713351444907,EDS 289C,A01,507361,Daly; Alan J.,18,0,18,0
1713351445933,EDS 290,A00,507366,Hofstetter; Carolyn,15,0,15,0
1713351446964,LIGM 5A,A00,507421,Fischer-Grunski; Eva K,20,0,20,0
1713351447989,LIGM 5B,A00,507423,Fischer-Grunski; Eva K,20,0,20,0
1713351449014,LIGM 5C,A00,507425,Fischer-Grunski; Eva K,20,0,20,0
1713351450040,LIIT 5AS,A00,507427,Carnelos; Chiara,20,0,20,0
1713351451086,LIIT 5BS,A00,507430,Carnelos; Chiara,20,0,20,0
1713351452112,LIIT 5CS,A00,507432,Carnelos; Chiara,20,0,20,0
1713351453146,LISP 5A,A00,507541,Munoz Sanchez; Alicia,17,0,20,3
1713351454172,LISP 5B,A00,507671,Munoz Sanchez; Alicia,14,0,20,6
1713351455203,LISP 5C,A00,507696,Munoz Sanchez; Alicia,14,0,20,6
1713351456227,MAE 197,001,528363,Boechler; Nicholas Sebastia,9998,0,9999,1
1713351457261,MATH 197,001,523477,Kedlaya; Kiran S.,9999,0,9999,0
1713351457261,MATH 197,002,563811,Zhang; Danna,9999,0,9999,0
1713351458286,MCWP 40R,A00,518780,Staff,20,0,20,0
1713351458286,MCWP 40R,B00,518781,Staff,19,0,20,1
1713351458286,MCWP 40R,C00,518783,Staff,19,0,20,1
1713351459311,MCWP 50R,A00,518791,Staff,20,0,20,0
1713351459311,MCWP 50R,B00,518792,Staff,17,0,20,3
1713351459311,MCWP 50R,C00,518793,Staff,19,0,20,1
1713351459311,MCWP 50R,D00,518794,Staff,16,0,20,4
1713351459311,MCWP 50R,E00,518795,Staff,16,0,20,4
1713351459311,MCWP 50R,F00,518796,Staff,19,0,20,1
1713351459311,MCWP 50R,G00,518797,Staff,19,0,20,1
1713351460347,MMW 12R,A01,514034,Herbst; Matthew,15,0,16,1
1713351460347,MMW 12R,A02,514035,Herbst; Matthew,16,0,16,0
1713351461375,MMW 13R,A01,514037,Staff,12,0,16,4
1713351461375,MMW 13R,A02,514039,Staff,16,0,16,0
1713351463482,SIO 295LS,A00,523233,Staff,18,0,30,12
1713351464511,SIO 295S,A00,523232,Staff,18,0,30,12
1713351465536,SOCI 117,A01,494376,Staff,1,0,5,4
1713351466575,WES 237B,A00,494380,Staff,19,0,20,1
1713351468631,AESE 279B,A00,494370,Wade; Jon P,33,0,33,0
1713351469655,ANAR 135S,A00,494369,Braswell; Geoffrey E.,0,0,0,0
1713351470684,CAT 124RS,A01,519847,Geibel; William,17,0,20,3
1713351471709,CAT 125RS,A01,515971,Geibel; William,17,0,20,3
1713351472736,CLRE 250,A00,511389,Morris; Sheldon,9996,0,9999,3
1713351473767,CLRE 251,A00,507176,Mehta; Ravindra L.,9996,0,9999,3
1713351473767,CLRE 251,B00,511410,Mehta; Ravindra L.,9998,0,9999,1
1713351474798,CLRE 252,A00,507189,Cuomo; Raphael Eduardo,9998,0,9999,1
1713351475828,CLRE 253,A00,507199,Vaida; Florin,9997,0,9999,2
1713351475828,CLRE 253,B00,507202,Vaida; Florin,9999,0,9999,0
1713351476857,CLRE 259,A00,507211,Patel; Hemal,9996,0,9999,3
1713351477882,CLRE 260,A00,507221,Cuomo; Raphael Eduardo,9999,0,9999,0
1713351478910,CLRE 297,001,507242,Cuomo; Raphael Eduardo,9999,0,9999,0
1713351479937,CSE 191,A00,516875,Minnes Kemp; Mor Mia,9999,0,9999,0
1713351480976,CSS 201S,A01,494383,Staff,35,0,35,0
1713351482003,CSS 202S,A01,494387,Staff,35,0,35,0
1713351483029,EAP 100,A00,516065,Staff,9792,0,9999,207
1713351484055,ECE 45,A01,507414,Staff,51,0,60,9
1713351485086,ECE 100,A01,507416,Baghdadchi; Saharnaz,9,0,20,11
1713351485086,ECE 100,A02,507418,Baghdadchi; Saharnaz,20,0,20,0
1713351486116,ECE 111,A01,507420,Staff,38,0,50,12
1713351487143,ECE 197,001,548057,Sievenpiper; Daniel F.,9998,0,9999,1
1713351488172,EDS 115,A00,507243,Choi; Bailey Miyeon,28,0,28,0
1713351489196,EDS 117,A01,494379,Staff,23,0,25,2
1713351490225,EDS 125,A00,507246,Hopkins; Megan Beth,29,0,30,1
1713351491258,EDS 128A,A01,507264,Fargason; Sharon Gayle,26,0,26,0
1713351492287,EDS 128B,A01,507293,Pappas; Elizabeth,30,0,30,0
1713351493315,EDS 139,A00,507294,Fargason; Sharon Gayle,30,0,30,0
1713351493315,EDS 139,B00,507313,Pappas; Elizabeth,30,0,30,0
1713351494345,EDS 201,A00,507315,Staff,26,0,30,4
1713351495373,EDS 203,A01,507317,Halter; Christopher P.,26,0,30,4
1713351496406,EDS 204R,A01,507319,Halter; Christopher P.,3,0,30,27
1713351496406,EDS 204R,B01,507331,Heinzman; Erica M.,28,0,30,2
1713351497437,EDS 206R,A00,507332,Staff,4,0,30,26
1713351497437,EDS 206R,B00,507343,Staff,28,0,30,2
1713351498463,EDS 250,A00,507344,Hemans; Patricia Ann Benitez,36,0,40,4
1713351499488,EDS 281,A00,507345,Daly; Alan J.,18,0,18,0
1713351500512,EDS 284,A00,507350,Daly; Alan J.,16,0,16,0
1713351501537,EDS 286,A00,507359,Fine; Sarah,18,0,18,0
1713351502562,EDS 289C,A01,507361,Daly; Alan J.,18,0,18,0
1713351503590,EDS 290,A00,507366,Hofstetter; Carolyn,15,0,15,0
1713351504624,LIGM 5A,A00,507421,Fischer-Grunski; Eva K,20,0,20,0
1713351505655,LIGM 5B,A00,507423,Fischer-Grunski; Eva K,20,0,20,0
1713351506679,LIGM 5C,A00,507425,Fischer-Grunski; Eva K,20,0,20,0
1713351507706,LIIT 5AS,A00,507427,Carnelos; Chiara,20,0,20,0
1713351508740,LIIT 5BS,A00,507430,Carnelos; Chiara,20,0,20,0
1713351509770,LIIT 5CS,A00,507432,Carnelos; Chiara,20,0,20,0
1713351510796,LISP 5A,A00,507541,Munoz Sanchez; Alicia,17,0,20,3
1713351511820,LISP 5B,A00,507671,Munoz Sanchez; Alicia,14,0,20,6
1713351512848,LISP 5C,A00,507696,Munoz Sanchez; Alicia,14,0,20,6
1713351513872,MAE 197,001,528363,Boechler; Nicholas Sebastia,9998,0,9999,1
1713351514901,MATH 197,001,523477,Kedlaya; Kiran S.,9999,0,9999,0
1713351514901,MATH 197,002,563811,Zhang; Danna,9999,0,9999,0
1713351515925,MCWP 40R,A00,518780,Staff,20,0,20,0
1713351515925,MCWP 40R,B00,518781,Staff,19,0,20,1
1713351515925,MCWP 40R,C00,518783,Staff,19,0,20,1
1713351516951,MCWP 50R,A00,518791,Staff,20,0,20,0
1713351516951,MCWP 50R,B00,518792,Staff,17,0,20,3
1713351516951,MCWP 50R,C00,518793,Staff,19,0,20,1
1713351516951,MCWP 50R,D00,518794,Staff,16,0,20,4
1713351516951,MCWP 50R,E00,518795,Staff,16,0,20,4
1713351516951,MCWP 50R,F00,518796,Staff,19,0,20,1
1713351516951,MCWP 50R,G00,518797,Staff,19,0,20,1
1713351517980,MMW 12R,A01,514034,Herbst; Matthew,15,0,16,1
1713351517980,MMW 12R,A02,514035,Herbst; Matthew,16,0,16,0
1713351519011,MMW 13R,A01,514037,Staff,12,0,16,4
1713351519011,MMW 13R,A02,514039,Staff,16,0,16,0
1713351521065,SIO 295LS,A00,523233,Staff,18,0,30,12
1713351522093,SIO 295S,A00,523232,Staff,18,0,30,12
1713351523118,SOCI 117,A01,494376,Staff,1,0,5,4
1713351524148,WES 237B,A00,494380,Staff,19,0,20,1
1713351526214,AESE 279B,A00,494370,Wade; Jon P,33,0,33,0
1713351527238,ANAR 135S,A00,494369,Braswell; Geoffrey E.,0,0,0,0
1713351528263,CAT 124RS,A01,519847,Geibel; William,17,0,20,3
1713351529299,CAT 125RS,A01,515971,Geibel; William,17,0,20,3
1713351530325,CLRE 250,A00,511389,Morris; Sheldon,9996,0,9999,3
1713351531350,CLRE 251,A00,507176,Mehta; Ravindra L.,9996,0,9999,3
1713351531350,CLRE 251,B00,511410,Mehta; Ravindra L.,9998,0,9999,1
1713351532374,CLRE 252,A00,507189,Cuomo; Raphael Eduardo,9998,0,9999,1
1713351533401,CLRE 253,A00,507199,Vaida; Florin,9997,0,9999,2
1713351533401,CLRE 253,B00,507202,Vaida; Florin,9999,0,9999,0
1713351534428,CLRE 259,A00,507211,Patel; Hemal,9996,0,9999,3
1713351535454,CLRE 260,A00,507221,Cuomo; Raphael Eduardo,9999,0,9999,0
1713351536480,CLRE 297,001,507242,Cuomo; Raphael Eduardo,9999,0,9999,0
1713351537505,CSE 191,A00,516875,Minnes Kemp; Mor Mia,9999,0,9999,0
1713351538528,CSS 201S,A01,494383,Staff,35,0,35,0
1713351539555,CSS 202S,A01,494387,Staff,35,0,35,0
1713351540592,EAP 100,A00,516065,Staff,9792,0,9999,207
1713351541618,ECE 45,A01,507414,Staff,51,0,60,9
1713351542645,ECE 100,A01,507416,Baghdadchi; Saharnaz,9,0,20,11
1713351542645,ECE 100,A02,507418,Baghdadchi; Saharnaz,20,0,20,0
1713351543670,ECE 111,A01,507420,Staff,38,0,50,12
1713351544693,ECE 197,001,548057,Sievenpiper; Daniel F.,9998,0,9999,1
1713351545722,EDS 115,A00,507243,Choi; Bailey Miyeon,28,0,28,0
1713351546747,EDS 117,A01,494379,Staff,23,0,25,2
1713351547773,EDS 125,A00,507246,Hopkins; Megan Beth,29,0,30,1
1713351548802,EDS 128A,A01,507264,Fargason; Sharon Gayle,26,0,26,0
1713351549829,EDS 128B,A01,507293,Pappas; Elizabeth,30,0,30,0
1713351550854,EDS 139,A00,507294,Fargason; Sharon Gayle,30,0,30,0
1713351550854,EDS 139,B00,507313,Pappas; Elizabeth,30,0,30,0
1713351551878,EDS 201,A00,507315,Staff,26,0,30,4
1713351552906,EDS 203,A01,507317,Halter; Christopher P.,26,0,30,4
1713351553931,EDS 204R,A01,507319,Halter; Christopher P.,3,0,30,27
1713351553931,EDS 204R,B01,507331,Heinzman; Erica M.,28,0,30,2
1713351554957,EDS 206R,A00,507332,Staff,4,0,30,26
1713351554957,EDS 206R,B00,507343,Staff,28,0,30,2
1713351555982,EDS 250,A00,507344,Hemans; Patricia Ann Benitez,36,0,40,4
1713351557005,EDS 281,A00,507345,Daly; Alan J.,18,0,18,0
1713351558029,EDS 284,A00,507350,Daly; Alan J.,16,0,16,0
1713351559055,EDS 286,A00,507359,Fine; Sarah,18,0,18,0
1713351560079,EDS 289C,A01,507361,Daly; Alan J.,18,0,18,0
1713351561112,EDS 290,A00,507366,Hofstetter; Carolyn,15,0,15,0
1713351562137,LIGM 5A,A00,507421,Fischer-Grunski; Eva K,20,0,20,0
1713351563164,LIGM 5B,A00,507423,Fischer-Grunski; Eva K,20,0,20,0
1713351564188,LIGM 5C,A00,507425,Fischer-Grunski; Eva K,20,0,20,0
1713351565223,LIIT 5AS,A00,507427,Carnelos; Chiara,20,0,20,0
1713351566307,LIIT 5BS,A00,507430,Carnelos; Chiara,20,0,20,0
1713351567332,LIIT 5CS,A00,507432,Carnelos; Chiara,20,0,20,0
1713351568360,LISP 5A,A00,507541,Munoz Sanchez; Alicia,17,0,20,3
1713351569389,LISP 5B,A00,507671,Munoz Sanchez; Alicia,14,0,20,6
1713351570419,LISP 5C,A00,507696,Munoz Sanchez; Alicia,14,0,20,6
1713351571444,MAE 197,001,528363,Boechler; Nicholas Sebastia,9998,0,9999,1
1713351572473,MATH 197,001,523477,Kedlaya; Kiran S.,9999,0,9999,0
1713351572473,MATH 197,002,563811,Zhang; Danna,9999,0,9999,0
1713351573497,MCWP 40R,A00,518780,Staff,20,0,20,0
1713351573497,MCWP 40R,B00,518781,Staff,19,0,20,1
1713351573497,MCWP 40R,C00,518783,Staff,19,0,20,1
1713351574523,MCWP 50R,A00,518791,Staff,20,0,20,0
1713351574523,MCWP 50R,B00,518792,Staff,17,0,20,3
1713351574523,MCWP 50R,C00,518793,Staff,19,0,20,1
1713351574523,MCWP 50R,D00,518794,Staff,16,0,20,4
1713351574523,MCWP 50R,E00,518795,Staff,16,0,20,4
1713351574523,MCWP 50R,F00,518796,Staff,19,0,20,1
1713351574523,MCWP 50R,G00,518797,Staff,19,0,20,1
1713351575549,MMW 12R,A01,514034,Herbst; Matthew,15,0,16,1
1713351575549,MMW 12R,A02,514035,Herbst; Matthew,16,0,16,0
1713351576577,MMW 13R,A01,514037,Staff,12,0,16,4
1713351576577,MMW 13R,A02,514039,Staff,16,0,16,0
1713351578630,SIO 295LS,A00,523233,Staff,18,0,30,12
1713351579653,SIO 295S,A00,523232,Staff,18,0,30,12
1713351580680,SOCI 117,A01,494376,Staff,1,0,5,4
1713351581707,WES 237B,A00,494380,Staff,19,0,20,1
1713351583776,AESE 279B,A00,494370,Wade; Jon P,33,0,33,0
1713351584805,ANAR 135S,A00,494369,Braswell; Geoffrey E.,0,0,0,0
1713351585832,CAT 124RS,A01,519847,Geibel; William,17,0,20,3
1713351586860,CAT 125RS,A01,515971,Geibel; William,17,0,20,3
1713351587885,CLRE 250,A00,511389,Morris; Sheldon,9996,0,9999,3
1713351588909,CLRE 251,A00,507176,Mehta; Ravindra L.,9996,0,9999,3
1713351588909,CLRE 251,B00,511410,Mehta; Ravindra L.,9998,0,9999,1
1713351589936,CLRE 252,A00,507189,Cuomo; Raphael Eduardo,9998,0,9999,1
1713351590965,CLRE 253,A00,507199,Vaida; Florin,9997,0,9999,2
1713351590965,CLRE 253,B00,507202,Vaida; Florin,9999,0,9999,0
1713351591991,CLRE 259,A00,507211,Patel; Hemal,9996,0,9999,3
1713351593016,CLRE 260,A00,507221,Cuomo; Raphael Eduardo,9999,0,9999,0
1713351594041,CLRE 297,001,507242,Cuomo; Raphael Eduardo,9999,0,9999,0
1713351595067,CSE 191,A00,516875,Minnes Kemp; Mor Mia,9999,0,9999,0
1713351596092,CSS 201S,A01,494383,Staff,35,0,35,0
1713351597117,CSS 202S,A01,494387,Staff,35,0,35,0
1713351598143,EAP 100,A00,516065,Staff,9792,0,9999,207
1713351599167,ECE 45,A01,507414,Staff,51,0,60,9
1713351600191,ECE 100,A01,507416,Baghdadchi; Saharnaz,9,0,20,11
1713351600191,ECE 100,A02,507418,Baghdadchi; Saharnaz,20,0,20,0
1713351601215,ECE 111,A01,507420,Staff,38,0,50,12
1713351602241,ECE 197,001,548057,Sievenpiper; Daniel F.,9998,0,9999,1
1713351603264,EDS 115,A00,507243,Choi; Bailey Miyeon,28,0,28,0
1713351604289,EDS 117,A01,494379,Staff,23,0,25,2
1713351605317,EDS 125,A00,507246,Hopkins; Megan Beth,29,0,30,1
1713351606390,EDS 128A,A01,507264,Fargason; Sharon Gayle,26,0,26,0
1713351607414,EDS 128B,A01,507293,Pappas; Elizabeth,30,0,30,0
1713351608444,EDS 139,A00,507294,Fargason; Sharon Gayle,30,0,30,0
1713351608444,EDS 139,B00,507313,Pappas; Elizabeth,30,0,30,0
1713351609471,EDS 201,A00,507315,Staff,26,0,30,4
1713351610495,EDS 203,A01,507317,Halter; Christopher P.,26,0,30,4
1713351611519,EDS 204R,A01,507319,Halter; Christopher P.,3,0,30,27
1713351611519,EDS 204R,B01,507331,Heinzman; Erica M.,28,0,30,2
1713351612544,EDS 206R,A00,507332,Staff,4,0,30,26
1713351612544,EDS 206R,B00,507343,Staff,28,0,30,2
1713351613569,EDS 250,A00,507344,Hemans; Patricia Ann Benitez,36,0,40,4
1713351614594,EDS 281,A00,507345,Daly; Alan J.,18,0,18,0
1713351615619,EDS 284,A00,507350,Daly; Alan J.,16,0,16,0
1713351616646,EDS 286,A00,507359,Fine; Sarah,18,0,18,0
1713351617672,EDS 289C,A01,507361,Daly; Alan J.,18,0,18,0
1713351618699,EDS 290,A00,507366,Hofstetter; Carolyn,15,0,15,0
1713351619728,LIGM 5A,A00,507421,Fischer-Grunski; Eva K,20,0,20,0
1713351620758,LIGM 5B,A00,507423,Fischer-Grunski; Eva K,20,0,20,0
1713351621785,LIGM 5C,A00,507425,Fischer-Grunski; Eva K,20,0,20,0
1713351622906,LIIT 5AS,A00,507427,Carnelos; Chiara,20,0,20,0
1713351623944,LIIT 5BS,A00,507430,Carnelos; Chiara,20,0,20,0
1713351624971,LIIT 5CS,A00,507432,Carnelos; Chiara,20,0,20,0
1713351625996,LISP 5A,A00,507541,Munoz Sanchez; Alicia,17,0,20,3
1713351627024,LISP 5B,A00,507671,Munoz Sanchez; Alicia,14,0,20,6
1713351628055,LISP 5C,A00,507696,Munoz Sanchez; Alicia,14,0,20,6
1713351629083,MAE 197,001,528363,Boechler; Nicholas Sebastia,9998,0,9999,1
1713351630114,MATH 197,001,523477,Kedlaya; Kiran S.,9999,0,9999,0
1713351630114,MATH 197,002,563811,Zhang; Danna,9999,0,9999,0
1713351631144,MCWP 40R,A00,518780,Staff,20,0,20,0
1713351631144,MCWP 40R,B00,518781,Staff,19,0,20,1
1713351631144,MCWP 40R,C00,518783,Staff,19,0,20,1
1713351632174,MCWP 50R,A00,518791,Staff,20,0,20,0
1713351632174,MCWP 50R,B00,518792,Staff,17,0,20,3
1713351632174,MCWP 50R,C00,518793,Staff,19,0,20,1
1713351632174,MCWP 50R,D00,518794,Staff,16,0,20,4
1713351632174,MCWP 50R,E00,518795,Staff,16,0,20,4
1713351632174,MCWP 50R,F00,518796,Staff,19,0,20,1
1713351632174,MCWP 50R,G00,518797,Staff,19,0,20,1
1713351633197,MMW 12R,A01,514034,Herbst; Matthew,15,0,16,1
1713351633197,MMW 12R,A02,514035,Herbst; Matthew,16,0,16,0
1713351634225,MMW 13R,A01,514037,Staff,12,0,16,4
1713351634225,MMW 13R,A02,514039,Staff,16,0,16,0
1713351636273,SIO 295LS,A00,523233,Staff,18,0,30,12
1713351637298,SIO 295S,A00,523232,Staff,18,0,30,12
1713351638324,SOCI 117,A01,494376,Staff,1,0,5,4
1713351639347,WES 237B,A00,494380,Staff,19,0,20,1
1713351641400,AESE 279B,A00,494370,Wade; Jon P,33,0,33,0
1713351642427,ANAR 135S,A00,494369,Braswell; Geoffrey E.,0,0,0,0
1713351643455,CAT 124RS,A01,519847,Geibel; William,17,0,20,3
1713351644481,CAT 125RS,A01,515971,Geibel; William,17,0,20,3
1713351645505,CLRE 250,A00,511389,Morris; Sheldon,9996,0,9999,3
1713351646530,CLRE 251,A00,507176,Mehta; Ravindra L.,9996,0,9999,3
1713351646530,CLRE 251,B00,511410,Mehta; Ravindra L.,9998,0,9999,1
1713351647554,CLRE 252,A00,507189,Cuomo; Raphael Eduardo,9998,0,9999,1
1713351648579,CLRE 253,A00,507199,Vaida; Florin,9997,0,9999,2
1713351648579,CLRE 253,B00,507202,Vaida; Florin,9999,0,9999,0
1713351649606,CLRE 259,A00,507211,Patel; Hemal,9996,0,9999,3
1713351650631,CLRE 260,A00,507221,Cuomo; Raphael Eduardo,9999,0,9999,0
1713351651660,CLRE 297,001,507242,Cuomo; Raphael Eduardo,9999,0,9999,0
1713351652697,CSE 191,A00,516875,Minnes Kemp; Mor Mia,9999,0,9999,0
1713351653723,CSS 201S,A01,494383,Staff,35,0,35,0
1713351654747,CSS 202S,A01,494387,Staff,35,0,35,0
1713351655772,EAP 100,A00,516065,Staff,9792,0,9999,207
1713351656801,ECE 45,A01,507414,Staff,51,0,60,9
1713351657826,ECE 100,A01,507416,Baghdadchi; Saharnaz,9,0,20,11
1713351657826,ECE 100,A02,507418,Baghdadchi; Saharnaz,20,0,20,0
1713351658850,ECE 111,A01,507420,Staff,38,0,50,12
1713351659879,ECE 197,001,548057,Sievenpiper; Daniel F.,9998,0,9999,1
1713351660908,EDS 115,A00,507243,Choi; Bailey Miyeon,28,0,28,0
1713351661932,EDS 117,A01,494379,Staff,23,0,25,2
1713351662955,EDS 125,A00,507246,Hopkins; Megan Beth,29,0,30,1
1713351663980,EDS 128A,A01,507264,Fargason; Sharon Gayle,26,0,26,0
1713351665005,EDS 128B,A01,507293,Pappas; Elizabeth,30,0,30,0
1713351666033,EDS 139,A00,507294,Fargason; Sharon Gayle,30,0,30,0
1713351666033,EDS 139,B00,507313,Pappas; Elizabeth,30,0,30,0
1713351667058,EDS 201,A00,507315,Staff,26,0,30,4
1713351668084,EDS 203,A01,507317,Halter; Christopher P.,26,0,30,4
1713351669111,EDS 204R,A01,507319,Halter; Christopher P.,3,0,30,27
1713351669111,EDS 204R,B01,507331,Heinzman; Erica M.,28,0,30,2
1713351670196,EDS 206R,A00,507332,Staff,4,0,30,26
1713351670196,EDS 206R,B00,507343,Staff,28,0,30,2
1713351671221,EDS 250,A00,507344,Hemans; Patricia Ann Benitez,36,0,40,4
1713351672249,EDS 281,A00,507345,Daly; Alan J.,18,0,18,0
1713351673277,EDS 284,A00,507350,Daly; Alan J.,16,0,16,0
1713351674305,EDS 286,A00,507359,Fine; Sarah,18,0,18,0
1713351675329,EDS 289C,A01,507361,Daly; Alan J.,18,0,18,0
1713351676353,EDS 290,A00,507366,Hofstetter; Carolyn,15,0,15,0
1713351677378,LIGM 5A,A00,507421,Fischer-Grunski; Eva K,20,0,20,0
1713351678409,LIGM 5B,A00,507423,Fischer-Grunski; Eva K,20,0,20,0
1713351679438,LIGM 5C,A00,507425,Fischer-Grunski; Eva K,20,0,20,0
1713351680463,LIIT 5AS,A00,507427,Carnelos; Chiara,20,0,20,0
1713351681491,LIIT 5BS,A00,507430,Carnelos; Chiara,20,0,20,0
1713351682522,LIIT 5CS,A00,507432,Carnelos; Chiara,20,0,20,0
1713351683547,LISP 5A,A00,507541,Munoz Sanchez; Alicia,17,0,20,3
1713351684572,LISP 5B,A00,507671,Munoz Sanchez; Alicia,14,0,20,6
1713351685601,LISP 5C,A00,507696,Munoz Sanchez; Alicia,14,0,20,6
1713351686626,MAE 197,001,528363,Boechler; Nicholas Sebastia,9998,0,9999,1
1713351687654,MATH 197,001,523477,Kedlaya; Kiran S.,9999,0,9999,0
1713351687654,MATH 197,002,563811,Zhang; Danna,9999,0,9999,0
1713351688678,MCWP 40R,A00,518780,Staff,20,0,20,0
1713351688678,MCWP 40R,B00,518781,Staff,19,0,20,1
1713351688678,MCWP 40R,C00,518783,Staff,19,0,20,1
1713351689707,MCWP 50R,A00,518791,Staff,20,0,20,0
1713351689707,MCWP 50R,B00,518792,Staff,17,0,20,3
1713351689707,MCWP 50R,C00,518793,Staff,19,0,20,1
1713351689707,MCWP 50R,D00,518794,Staff,16,0,20,4
1713351689707,MCWP 50R,E00,518795,Staff,16,0,20,4
1713351689707,MCWP 50R,F00,518796,Staff,19,0,20,1
1713351689707,MCWP 50R,G00,518797,Staff,19,0,20,1
1713351690731,MMW 12R,A01,514034,Herbst; Matthew,15,0,16,1
1713351690731,MMW 12R,A02,514035,Herbst; Matthew,16,0,16,0
1713351691758,MMW 13R,A01,514037,Staff,12,0,16,4
1713351691758,MMW 13R,A02,514039,Staff,16,0,16,0
1713351693806,SIO 295LS,A00,523233,Staff,18,0,30,12
1713351694830,SIO 295S,A00,523232,Staff,18,0,30,12
1713351695856,SOCI 117,A01,494376,Staff,1,0,5,4
1713351696882,WES 237B,A00,494380,Staff,19,0,20,1
1713351698939,AESE 279B,A00,494370,Wade; Jon P,33,0,33,0
1713351699963,ANAR 135S,A00,494369,Braswell; Geoffrey E.,0,0,0,0
1713351700989,CAT 124RS,A01,519847,Geibel; William,17,0,20,3
1713351702014,CAT 125RS,A01,515971,Geibel; William,17,0,20,3
1713351703039,CLRE 250,A00,511389,Morris; Sheldon,9996,0,9999,3
1713351704069,CLRE 251,A00,507176,Mehta; Ravindra L.,9996,0,9999,3
1713351704069,CLRE 251,B00,511410,Mehta; Ravindra L.,9998,0,9999,1
1713351705094,CLRE 252,A00,507189,Cuomo; Raphael Eduardo,9998,0,9999,1
1713351706126,CLRE 253,A00,507199,Vaida; Florin,9997,0,9999,2
1713351706126,CLRE 253,B00,507202,Vaida; Florin,9999,0,9999,0
1713351707151,CLRE 259,A00,507211,Patel; Hemal,9996,0,9999,3
1713351708175,CLRE 260,A00,507221,Cuomo; Raphael Eduardo,9999,0,9999,0
1713351709202,CLRE 297,001,507242,Cuomo; Raphael Eduardo,9999,0,9999,0
1713351710227,CSE 191,A00,516875,Minnes Kemp; Mor Mia,9999,0,9999,0
1713351711255,CSS 201S,A01,494383,Staff,35,0,35,0
1713351712283,CSS 202S,A01,494387,Staff,35,0,35,0
1713351713307,EAP 100,A00,516065,Staff,9792,0,9999,207
1713351714331,ECE 45,A01,507414,Staff,51,0,60,9
1713351715360,ECE 100,A01,507416,Baghdadchi; Saharnaz,9,0,20,11
1713351715360,ECE 100,A02,507418,Baghdadchi; Saharnaz,20,0,20,0
1713351716391,ECE 111,A01,507420,Staff,38,0,50,12
1713351717415,ECE 197,001,548057,Sievenpiper; Daniel F.,9998,0,9999,1
1713351718443,EDS 115,A00,507243,Choi; Bailey Miyeon,28,0,28,0
1713351719469,EDS 117,A01,494379,Staff,23,0,25,2
1713351720496,EDS 125,A00,507246,Hopkins; Megan Beth,29,0,30,1
1713351721533,EDS 128A,A01,507264,Fargason; Sharon Gayle,26,0,26,0
1713351722560,EDS 128B,A01,507293,Pappas; Elizabeth,30,0,30,0
1713351723590,EDS 139,A00,507294,Fargason; Sharon Gayle,30,0,30,0
1713351723590,EDS 139,B00,507313,Pappas; Elizabeth,30,0,30,0
1713351724613,EDS 201,A00,507315,Staff,26,0,30,4
1713351725638,EDS 203,A01,507317,Halter; Christopher P.,26,0,30,4
1713351726663,EDS 204R,A01,507319,Halter; Christopher P.,3,0,30,27
1713351726663,EDS 204R,B01,507331,Heinzman; Erica M.,28,0,30,2
1713351727691,EDS 206R,A00,507332,Staff,4,0,30,26
1713351727691,EDS 206R,B00,507343,Staff,28,0,30,2
1713351728719,EDS 250,A00,507344,Hemans; Patricia Ann Benitez,36,0,40,4
1713351729747,EDS 281,A00,507345,Daly; Alan J.,18,0,18,0
1713351730771,EDS 284,A00,507350,Daly; Alan J.,16,0,16,0
1713351731801,EDS 286,A00,507359,Fine; Sarah,18,0,18,0
1713351732824,EDS 289C,A01,507361,Daly; Alan J.,18,0,18,0
1713351733860,EDS 290,A00,507366,Hofstetter; Carolyn,15,0,15,0
1713351734887,LIGM 5A,A00,507421,Fischer-Grunski; Eva K,20,0,20,0
1713351735912,LIGM 5B,A00,507423,Fischer-Grunski; Eva K,20,0,20,0
1713351736939,LIGM 5C,A00,507425,Fischer-Grunski; Eva K,20,0,20,0
1713351737963,LIIT 5AS,A00,507427,Carnelos; Chiara,20,0,20,0
1713351738987,LIIT 5BS,A00,507430,Carnelos; Chiara,20,0,20,0
1713351740013,LIIT 5CS,A00,507432,Carnelos; Chiara,20,0,20,0
1713351741038,LISP 5A,A00,507541,Munoz Sanchez; Alicia,17,0,20,3
1713351742065,LISP 5B,A00,507671,Munoz Sanchez; Alicia,14,0,20,6
1713351743097,LISP 5C,A00,507696,Munoz Sanchez; Alicia,14,0,20,6
1713351744121,MAE 197,001,528363,Boechler; Nicholas Sebastia,9998,0,9999,1
1713351745147,MATH 197,001,523477,Kedlaya; Kiran S.,9999,0,9999,0
1713351745147,MATH 197,002,563811,Zhang; Danna,9999,0,9999,0
1713351746173,MCWP 40R,A00,518780,Staff,20,0,20,0
1713351746173,MCWP 40R,B00,518781,Staff,19,0,20,1
1713351746173,MCWP 40R,C00,518783,Staff,19,0,20,1
1713351747204,MCWP 50R,A00,518791,Staff,20,0,20,0
1713351747204,MCWP 50R,B00,518792,Staff,17,0,20,3
1713351747204,MCWP 50R,C00,518793,Staff,19,0,20,1
1713351747204,MCWP 50R,D00,518794,Staff,16,0,20,4
1713351747204,MCWP 50R,E00,518795,Staff,16,0,20,4
1713351747204,MCWP 50R,F00,518796,Staff,19,0,20,1
1713351747204,MCWP 50R,G00,518797,Staff,19,0,20,1
1713351748231,MMW 12R,A01,514034,Herbst; Matthew,15,0,16,1
1713351748231,MMW 12R,A02,514035,Herbst; Matthew,16,0,16,0
1713351749256,MMW 13R,A01,514037,Staff,12,0,16,4
1713351749256,MMW 13R,A02,514039,Staff,16,0,16,0
1713351751308,SIO 295LS,A00,523233,Staff,18,0,30,12
1713351752332,SIO 295S,A00,523232,Staff,18,0,30,12
1713351753358,SOCI 117,A01,494376,Staff,1,0,5,4
1713351754383,WES 237B,A00,494380,Staff,19,0,20,1
1713351756455,AESE 279B,A00,494370,Wade; Jon P,33,0,33,0
1713351757485,ANAR 135S,A00,494369,Braswell; Geoffrey E.,0,0,0,0
1713351758517,CAT 124RS,A01,519847,Geibel; William,17,0,20,3
1713351759542,CAT 125RS,A01,515971,Geibel; William,17,0,20,3
1713351760567,CLRE 250,A00,511389,Morris; Sheldon,9996,0,9999,3
1713351761596,CLRE 251,A00,507176,Mehta; Ravindra L.,9996,0,9999,3
1713351761596,CLRE 251,B00,511410,Mehta; Ravindra L.,9998,0,9999,1
1713351762627,CLRE 252,A00,507189,Cuomo; Raphael Eduardo,9998,0,9999,1
1713351763662,CLRE 253,A00,507199,Vaida; Florin,9997,0,9999,2
1713351763662,CLRE 253,B00,507202,Vaida; Florin,9999,0,9999,0
1713351764689,CLRE 259,A00,507211,Patel; Hemal,9996,0,9999,3
1713351765715,CLRE 260,A00,507221,Cuomo; Raphael Eduardo,9999,0,9999,0
1713351766743,CLRE 297,001,507242,Cuomo; Raphael Eduardo,9999,0,9999,0
1713351767769,CSE 191,A00,516875,Minnes Kemp; Mor Mia,9999,0,9999,0
1713351768802,CSS 201S,A01,494383,Staff,35,0,35,0
1713351769832,CSS 202S,A01,494387,Staff,35,0,35,0
1713351770857,EAP 100,A00,516065,Staff,9792,0,9999,207
1713351771884,ECE 45,A01,507414,Staff,51,0,60,9
1713351772912,ECE 100,A01,507416,Baghdadchi; Saharnaz,9,0,20,11
1713351772912,ECE 100,A02,507418,Baghdadchi; Saharnaz,20,0,20,0
1713351773994,ECE 111,A01,507420,Staff,38,0,50,12
1713351775027,ECE 197,001,548057,Sievenpiper; Daniel F.,9998,0,9999,1
1713351776060,EDS 115,A00,507243,Choi; Bailey Miyeon,28,0,28,0
1713351777091,EDS 117,A01,494379,Staff,23,0,25,2
1713351778116,EDS 125,A00,507246,Hopkins; Megan Beth,29,0,30,1
1713351779143,EDS 128A,A01,507264,Fargason; Sharon Gayle,26,0,26,0
1713351780168,EDS 128B,A01,507293,Pappas; Elizabeth,30,0,30,0
1713351781198,EDS 139,A00,507294,Fargason; Sharon Gayle,30,0,30,0
1713351781198,EDS 139,B00,507313,Pappas; Elizabeth,30,0,30,0
1713351782226,EDS 201,A00,507315,Staff,26,0,30,4
1713351783251,EDS 203,A01,507317,Halter; Christopher P.,26,0,30,4
1713351784276,EDS 204R,A01,507319,Halter; Christopher P.,3,0,30,27
1713351784276,EDS 204R,B01,507331,Heinzman; Erica M.,28,0,30,2
1713351785301,EDS 206R,A00,507332,Staff,4,0,30,26
1713351785301,EDS 206R,B00,507343,Staff,28,0,30,2
1713351786331,EDS 250,A00,507344,Hemans; Patricia Ann Benitez,36,0,40,4
1713351787360,EDS 281,A00,507345,Daly; Alan J.,18,0,18,0
1713351788384,EDS 284,A00,507350,Daly; Alan J.,16,0,16,0
1713351789409,EDS 286,A00,507359,Fine; Sarah,18,0,18,0
1713351790434,EDS 289C,A01,507361,Daly; Alan J.,18,0,18,0
1713351791470,EDS 290,A00,507366,Hofstetter; Carolyn,15,0,15,0
1713351792504,LIGM 5A,A00,507421,Fischer-Grunski; Eva K,20,0,20,0
1713351793531,LIGM 5B,A00,507423,Fischer-Grunski; Eva K,20,0,20,0
1713351794561,LIGM 5C,A00,507425,Fischer-Grunski; Eva K,20,0,20,0
1713351795587,LIIT 5AS,A00,507427,Carnelos; Chiara,20,0,20,0
1713351796612,LIIT 5BS,A00,507430,Carnelos; Chiara,20,0,20,0
1713351797637,LIIT 5CS,A00,507432,Carnelos; Chiara,20,0,20,0
1713351798662,LISP 5A,A00,507541,Munoz Sanchez; Alicia,17,0,20,3
1713351799699,LISP 5B,A00,507671,Munoz Sanchez; Alicia,14,0,20,6
1713351800725,LISP 5C,A00,507696,Munoz Sanchez; Alicia,14,0,20,6
1713351801750,MAE 197,001,528363,Boechler; Nicholas Sebastia,9998,0,9999,1
1713351802782,MATH 197,001,523477,Kedlaya; Kiran S.,9999,0,9999,0
1713351802782,MATH 197,002,563811,Zhang; Danna,9999,0,9999,0
1713351803811,MCWP 40R,A00,518780,Staff,20,0,20,0
1713351803811,MCWP 40R,B00,518781,Staff,19,0,20,1
1713351803811,MCWP 40R,C00,518783,Staff,19,0,20,1
1713351804835,MCWP 50R,A00,518791,Staff,20,0,20,0
1713351804835,MCWP 50R,B00,518792,Staff,17,0,20,3
1713351804835,MCWP 50R,C00,518793,Staff,19,0,20,1
1713351804835,MCWP 50R,D00,518794,Staff,16,0,20,4
1713351804835,MCWP 50R,E00,518795,Staff,16,0,20,4
1713351804835,MCWP 50R,F00,518796,Staff,19,0,20,1
1713351804835,MCWP 50R,G00,518797,Staff,19,0,20,1
1713351805861,MMW 12R,A01,514034,Herbst; Matthew,15,0,16,1
1713351805861,MMW 12R,A02,514035,Herbst; Matthew,16,0,16,0
1713351806889,MMW 13R,A01,514037,Staff,12,0,16,4
1713351806889,MMW 13R,A02,514039,Staff,16,0,16,0
1713351808947,SIO 295LS,A00,523233,Staff,18,0,30,12
1713351809972,SIO 295S,A00,523232,Staff,18,0,30,12
1713351810997,SOCI 117,A01,494376,Staff,1,0,5,4
1713351812029,WES 237B,A00,494380,Staff,19,0,20,1
1713351814108,AESE 279B,A00,494370,Wade; Jon P,33,0,33,0
1713351815133,ANAR 135S,A00,494369,Braswell; Geoffrey E.,0,0,0,0
1713351816165,CAT 124RS,A01,519847,Geibel; William,17,0,20,3
1713351817190,CAT 125RS,A01,515971,Geibel; William,17,0,20,3
1713351818217,CLRE 250,A00,511389,Morris; Sheldon,9996,0,9999,3
1713351819245,CLRE 251,A00,507176,Mehta; Ravindra L.,9996,0,9999,3
1713351819245,CLRE 251,B00,511410,Mehta; Ravindra L.,9998,0,9999,1
1713351820275,CLRE 252,A00,507189,Cuomo; Raphael Eduardo,9998,0,9999,1
1713351821301,CLRE 253,A00,507199,Vaida; Florin,9997,0,9999,2
1713351821301,CLRE 253,B00,507202,Vaida; Florin,9999,0,9999,0
1713351822330,CLRE 259,A00,507211,Patel; Hemal,9996,0,9999,3
1713351823358,CLRE 260,A00,507221,Cuomo; Raphael Eduardo,9999,0,9999,0
1713351824382,CLRE 297,001,507242,Cuomo; Raphael Eduardo,9999,0,9999,0
1713351825407,CSE 191,A00,516875,Minnes Kemp; Mor Mia,9999,0,9999,0
1713351826444,CSS 201S,A01,494383,Staff,35,0,35,0
1713351827470,CSS 202S,A01,494387,Staff,35,0,35,0
1713351828494,EAP 100,A00,516065,Staff,9792,0,9999,207
1713351829527,ECE 45,A01,507414,Staff,51,0,60,9
1713351830552,ECE 100,A01,507416,Baghdadchi; Saharnaz,9,0,20,11
1713351830552,ECE 100,A02,507418,Baghdadchi; Saharnaz,20,0,20,0
1713351831581,ECE 111,A01,507420,Staff,38,0,50,12
1713351832606,ECE 197,001,548057,Sievenpiper; Daniel F.,9998,0,9999,1
1713351833639,EDS 115,A00,507243,Choi; Bailey Miyeon,28,0,28,0
1713351834664,EDS 117,A01,494379,Staff,23,0,25,2
1713351835694,EDS 125,A00,507246,Hopkins; Megan Beth,29,0,30,1
1713351836726,EDS 128A,A01,507264,Fargason; Sharon Gayle,26,0,26,0
1713351837752,EDS 128B,A01,507293,Pappas; Elizabeth,30,0,30,0
1713351838781,EDS 139,A00,507294,Fargason; Sharon Gayle,30,0,30,0
1713351838781,EDS 139,B00,507313,Pappas; Elizabeth,30,0,30,0
1713351839806,EDS 201,A00,507315,Staff,26,0,30,4
1713351840843,EDS 203,A01,507317,Halter; Christopher P.,26,0,30,4
1713351841870,EDS 204R,A01,507319,Halter; Christopher P.,3,0,30,27
1713351841870,EDS 204R,B01,507331,Heinzman; Erica M.,28,0,30,2
1713351842895,EDS 206R,A00,507332,Staff,4,0,30,26
1713351842895,EDS 206R,B00,507343,Staff,28,0,30,2
1713351843921,EDS 250,A00,507344,Hemans; Patricia Ann Benitez,36,0,40,4
1713351844945,EDS 281,A00,507345,Daly; Alan J.,18,0,18,0
1713351845969,EDS 284,A00,507350,Daly; Alan J.,16,0,16,0
1713351847000,EDS 286,A00,507359,Fine; Sarah,18,0,18,0
1713351848025,EDS 289C,A01,507361,Daly; Alan J.,18,0,18,0
1713351849049,EDS 290,A00,507366,Hofstetter; Carolyn,15,0,15,0
1713351850084,LIGM 5A,A00,507421,Fischer-Grunski; Eva K,20,0,20,0
1713351851118,LIGM 5B,A00,507423,Fischer-Grunski; Eva K,20,0,20,0
1713351852143,LIGM 5C,A00,507425,Fischer-Grunski; Eva K,20,0,20,0
1713351853167,LIIT 5AS,A00,507427,Carnelos; Chiara,20,0,20,0
1713351854197,LIIT 5BS,A00,507430,Carnelos; Chiara,20,0,20,0
1713351855221,LIIT 5CS,A00,507432,Carnelos; Chiara,20,0,20,0
1713351856246,LISP 5A,A00,507541,Munoz Sanchez; Alicia,17,0,20,3
1713351857271,LISP 5B,A00,507671,Munoz Sanchez; Alicia,14,0,20,6
1713351858295,LISP 5C,A00,507696,Munoz Sanchez; Alicia,14,0,20,6
1713351859327,MAE 197,001,528363,Boechler; Nicholas Sebastia,9998,0,9999,1
1713351860354,MATH 197,001,523477,Kedlaya; Kiran S.,9999,0,9999,0
1713351860354,MATH 197,002,563811,Zhang; Danna,9999,0,9999,0
1713351861379,MCWP 40R,A00,518780,Staff,20,0,20,0
1713351861379,MCWP 40R,B00,518781,Staff,19,0,20,1
1713351861379,MCWP 40R,C00,518783,Staff,19,0,20,1
1713351862412,MCWP 50R,A00,518791,Staff,20,0,20,0
1713351862412,MCWP 50R,B00,518792,Staff,17,0,20,3
1713351862412,MCWP 50R,C00,518793,Staff,19,0,20,1
1713351862412,MCWP 50R,D00,518794,Staff,16,0,20,4
1713351862412,MCWP 50R,E00,518795,Staff,16,0,20,4
1713351862412,MCWP 50R,F00,518796,Staff,19,0,20,1
1713351862412,MCWP 50R,G00,518797,Staff,19,0,20,1
1713351863442,MMW 12R,A01,514034,Herbst; Matthew,15,0,16,1
1713351863442,MMW 12R,A02,514035,Herbst; Matthew,16,0,16,0
1713351864466,MMW 13R,A01,514037,Staff,12,0,16,4
1713351864466,MMW 13R,A02,514039,Staff,16,0,16,0
1713351866517,SIO 295LS,A00,523233,Staff,18,0,30,12
1713351867542,SIO 295S,A00,523232,Staff,18,0,30,12
1713351868573,SOCI 117,A01,494376,Staff,1,0,5,4
1713351869602,WES 237B,A00,494380,Staff,19,0,20,1
1713351871665,AESE 279B,A00,494370,Wade; Jon P,33,0,33,0
1713351872693,ANAR 135S,A00,494369,Braswell; Geoffrey E.,0,0,0,0
1713351873723,CAT 124RS,A01,519847,Geibel; William,17,0,20,3
1713351874753,CAT 125RS,A01,515971,Geibel; William,17,0,20,3
1713351875780,CLRE 250,A00,511389,Morris; Sheldon,9996,0,9999,3
1713351876814,CLRE 251,A00,507176,Mehta; Ravindra L.,9996,0,9999,3
1713351876814,CLRE 251,B00,511410,Mehta; Ravindra L.,9998,0,9999,1
1713351877893,CLRE 252,A00,507189,Cuomo; Raphael Eduardo,9998,0,9999,1
1713351878927,CLRE 253,A00,507199,Vaida; Florin,9997,0,9999,2
1713351878927,CLRE 253,B00,507202,Vaida; Florin,9999,0,9999,0
1713351879953,CLRE 259,A00,507211,Patel; Hemal,9996,0,9999,3
1713351880979,CLRE 260,A00,507221,Cuomo; Raphael Eduardo,9999,0,9999,0
1713351882004,CLRE 297,001,507242,Cuomo; Raphael Eduardo,9999,0,9999,0
1713351883030,CSE 191,A00,516875,Minnes Kemp; Mor Mia,9999,0,9999,0
1713351884057,CSS 201S,A01,494383,Staff,35,0,35,0
1713351885084,CSS 202S,A01,494387,Staff,35,0,35,0
1713351886113,EAP 100,A00,516065,Staff,9792,0,9999,207
1713351887143,ECE 45,A01,507414,Staff,51,0,60,9
1713351888168,ECE 100,A01,507416,Baghdadchi; Saharnaz,9,0,20,11
1713351888168,ECE 100,A02,507418,Baghdadchi; Saharnaz,20,0,20,0
1713351889194,ECE 111,A01,507420,Staff,38,0,50,12
1713351890225,ECE 197,001,548057,Sievenpiper; Daniel F.,9998,0,9999,1
1713351891257,EDS 115,A00,507243,Choi; Bailey Miyeon,28,0,28,0
1713351892289,EDS 117,A01,494379,Staff,23,0,25,2
1713351893320,EDS 125,A00,507246,Hopkins; Megan Beth,29,0,30,1
1713351894345,EDS 128A,A01,507264,Fargason; Sharon Gayle,26,0,26,0
1713351895372,EDS 128B,A01,507293,Pappas; Elizabeth,30,0,30,0
1713351896396,EDS 139,A00,507294,Fargason; Sharon Gayle,30,0,30,0
1713351896396,EDS 139,B00,507313,Pappas; Elizabeth,30,0,30,0
1713351897420,EDS 201,A00,507315,Staff,26,0,30,4
1713351898445,EDS 203,A01,507317,Halter; Christopher P.,26,0,30,4
1713351899471,EDS 204R,A01,507319,Halter; Christopher P.,3,0,30,27
1713351899471,EDS 204R,B01,507331,Heinzman; Erica M.,28,0,30,2
1713351900510,EDS 206R,A00,507332,Staff,4,0,30,26
1713351900510,EDS 206R,B00,507343,Staff,28,0,30,2
1713351901541,EDS 250,A00,507344,Hemans; Patricia Ann Benitez,36,0,40,4
1713351902567,EDS 281,A00,507345,Daly; Alan J.,18,0,18,0
1713351903596,EDS 284,A00,507350,Daly; Alan J.,16,0,16,0
1713351904626,EDS 286,A00,507359,Fine; Sarah,18,0,18,0
1713351905654,EDS 289C,A01,507361,Daly; Alan J.,18,0,18,0
1713351906681,EDS 290,A00,507366,Hofstetter; Carolyn,15,0,15,0
1713351907707,LIGM 5A,A00,507421,Fischer-Grunski; Eva K,20,0,20,0
1713351908737,LIGM 5B,A00,507423,Fischer-Grunski; Eva K,20,0,20,0
1713351909762,LIGM 5C,A00,507425,Fischer-Grunski; Eva K,20,0,20,0
1713351910788,LIIT 5AS,A00,507427,Carnelos; Chiara,20,0,20,0
1713351911814,LIIT 5BS,A00,507430,Carnelos; Chiara,20,0,20,0
1713351912850,LIIT 5CS,A00,507432,Carnelos; Chiara,20,0,20,0
1713351913875,LISP 5A,A00,507541,Munoz Sanchez; Alicia,17,0,20,3
1713351914907,LISP 5B,A00,507671,Munoz Sanchez; Alicia,14,0,20,6
1713351915933,LISP 5C,A00,507696,Munoz Sanchez; Alicia,14,0,20,6
1713351916963,MAE 197,001,528363,Boechler; Nicholas Sebastia,9998,0,9999,1
1713351917994,MATH 197,001,523477,Kedlaya; Kiran S.,9999,0,9999,0
1713351917994,MATH 197,002,563811,Zhang; Danna,9999,0,9999,0
1713351919025,MCWP 40R,A00,518780,Staff,20,0,20,0
1713351919025,MCWP 40R,B00,518781,Staff,19,0,20,1
1713351919025,MCWP 40R,C00,518783,Staff,19,0,20,1
1713351920054,MCWP 50R,A00,518791,Staff,20,0,20,0
1713351920054,MCWP 50R,B00,518792,Staff,17,0,20,3
1713351920054,MCWP 50R,C00,518793,Staff,19,0,20,1
1713351920054,MCWP 50R,D00,518794,Staff,16,0,20,4
1713351920054,MCWP 50R,E00,518795,Staff,16,0,20,4
1713351920054,MCWP 50R,F00,518796,Staff,19,0,20,1
1713351920054,MCWP 50R,G00,518797,Staff,19,0,20,1
1713351921085,MMW 12R,A01,514034,Herbst; Matthew,15,0,16,1
1713351921085,MMW 12R,A02,514035,Herbst; Matthew,16,0,16,0
1713351922115,MMW 13R,A01,514037,Staff,12,0,16,4
1713351922115,MMW 13R,A02,514039,Staff,16,0,16,0
1713351924170,SIO 295LS,A00,523233,Staff,18,0,30,12
1713351925195,SIO 295S,A00,523232,Staff,18,0,30,12
1713351926224,SOCI 117,A01,494376,Staff,1,0,5,4
1713351927248,WES 237B,A00,494380,Staff,19,0,20,1
1713351929345,AESE 279B,A00,494370,Wade; Jon P,33,0,33,0
1713351930370,ANAR 135S,A00,494369,Braswell; Geoffrey E.,0,0,0,0
1713351931400,CAT 124RS,A01,519847,Geibel; William,17,0,20,3
1713351932427,CAT 125RS,A01,515971,Geibel; William,17,0,20,3
1713351933457,CLRE 250,A00,511389,Morris; Sheldon,9996,0,9999,3
1713351934493,CLRE 251,A00,507176,Mehta; Ravindra L.,9996,0,9999,3
1713351934493,CLRE 251,B00,511410,Mehta; Ravindra L.,9998,0,9999,1
1713351935518,CLRE 252,A00,507189,Cuomo; Raphael Eduardo,9998,0,9999,1
1713351936543,CLRE 253,A00,507199,Vaida; Florin,9997,0,9999,2
1713351936543,CLRE 253,B00,507202,Vaida; Florin,9999,0,9999,0
1713351937572,CLRE 259,A00,507211,Patel; Hemal,9996,0,9999,3
1713351938600,CLRE 260,A00,507221,Cuomo; Raphael Eduardo,9999,0,9999,0
1713351939624,CLRE 297,001,507242,Cuomo; Raphael Eduardo,9999,0,9999,0
1713351940655,CSE 191,A00,516875,Minnes Kemp; Mor Mia,9999,0,9999,0
1713351941688,CSS 201S,A01,494383,Staff,35,0,35,0
1713351942718,CSS 202S,A01,494387,Staff,35,0,35,0
1713351943742,EAP 100,A00,516065,Staff,9792,0,9999,207
1713351944771,ECE 45,A01,507414,Staff,51,0,60,9
1713351945802,ECE 100,A01,507416,Baghdadchi; Saharnaz,9,0,20,11
1713351945802,ECE 100,A02,507418,Baghdadchi; Saharnaz,20,0,20,0
1713351946827,ECE 111,A01,507420,Staff,38,0,50,12
1713351947853,ECE 197,001,548057,Sievenpiper; Daniel F.,9998,0,9999,1
1713351948881,EDS 115,A00,507243,Choi; Bailey Miyeon,28,0,28,0
1713351949906,EDS 117,A01,494379,Staff,23,0,25,2
1713351950942,EDS 125,A00,507246,Hopkins; Megan Beth,29,0,30,1
1713351951974,EDS 128A,A01,507264,Fargason; Sharon Gayle,26,0,26,0
1713351953000,EDS 128B,A01,507293,Pappas; Elizabeth,30,0,30,0
1713351954026,EDS 139,A00,507294,Fargason; Sharon Gayle,30,0,30,0
1713351954026,EDS 139,B00,507313,Pappas; Elizabeth,30,0,30,0
1713351955055,EDS 201,A00,507315,Staff,26,0,30,4
1713351956083,EDS 203,A01,507317,Halter; Christopher P.,26,0,30,4
1713351957114,EDS 204R,A01,507319,Halter; Christopher P.,3,0,30,27
1713351957114,EDS 204R,B01,507331,Heinzman; Erica M.,28,0,30,2
1713351958145,EDS 206R,A00,507332,Staff,4,0,30,26
1713351958145,EDS 206R,B00,507343,Staff,28,0,30,2
1713351959170,EDS 250,A00,507344,Hemans; Patricia Ann Benitez,36,0,40,4
1713351960202,EDS 281,A00,507345,Daly; Alan J.,18,0,18,0
1713351961260,EDS 284,A00,507350,Daly; Alan J.,16,0,16,0
1713351962298,EDS 286,A00,507359,Fine; Sarah,18,0,18,0
1713351963357,EDS 289C,A01,507361,Daly; Alan J.,18,0,18,0
1713351964392,EDS 290,A00,507366,Hofstetter; Carolyn,15,0,15,0
1713351965420,LIGM 5A,A00,507421,Fischer-Grunski; Eva K,20,0,20,0
1713351966445,LIGM 5B,A00,507423,Fischer-Grunski; Eva K,20,0,20,0
1713351967476,LIGM 5C,A00,507425,Fischer-Grunski; Eva K,20,0,20,0
1713351968503,LIIT 5AS,A00,507427,Carnelos; Chiara,20,0,20,0
1713351969536,LIIT 5BS,A00,507430,Carnelos; Chiara,20,0,20,0
1713351970568,LIIT 5CS,A00,507432,Carnelos; Chiara,20,0,20,0
1713351971595,LISP 5A,A00,507541,Munoz Sanchez; Alicia,17,0,20,3
1713351972619,LISP 5B,A00,507671,Munoz Sanchez; Alicia,14,0,20,6
1713351973650,LISP 5C,A00,507696,Munoz Sanchez; Alicia,14,0,20,6
1713351974676,MAE 197,001,528363,Boechler; Nicholas Sebastia,9998,0,9999,1
1713351975709,MATH 197,001,523477,Kedlaya; Kiran S.,9999,0,9999,0
1713351975709,MATH 197,002,563811,Zhang; Danna,9999,0,9999,0
1713351976737,MCWP 40R,A00,518780,Staff,20,0,20,0
1713351976737,MCWP 40R,B00,518781,Staff,19,0,20,1
1713351976737,MCWP 40R,C00,518783,Staff,19,0,20,1
1713351977763,MCWP 50R,A00,518791,Staff,20,0,20,0
1713351977763,MCWP 50R,B00,518792,Staff,17,0,20,3
1713351977763,MCWP 50R,C00,518793,Staff,19,0,20,1
1713351977763,MCWP 50R,D00,518794,Staff,16,0,20,4
1713351977763,MCWP 50R,E00,518795,Staff,16,0,20,4
1713351977763,MCWP 50R,F00,518796,Staff,19,0,20,1
1713351977763,MCWP 50R,G00,518797,Staff,19,0,20,1
1713351978790,MMW 12R,A01,514034,Herbst; Matthew,15,0,16,1
1713351978790,MMW 12R,A02,514035,Herbst; Matthew,16,0,16,0
1713351979818,MMW 13R,A01,514037,Staff,12,0,16,4
1713351979818,MMW 13R,A02,514039,Staff,16,0,16,0
1713351981925,SIO 295LS,A00,523233,Staff,18,0,30,12
1713351982951,SIO 295S,A00,523232,Staff,18,0,30,12
1713351983982,SOCI 117,A01,494376,Staff,1,0,5,4
1713351985013,WES 237B,A00,494380,Staff,19,0,20,1
1713351987108,AESE 279B,A00,494370,Wade; Jon P,33,0,33,0
1713351988134,ANAR 135S,A00,494369,Braswell; Geoffrey E.,0,0,0,0
1713351989164,CAT 124RS,A01,519847,Geibel; William,17,0,20,3
1713351990196,CAT 125RS,A01,515971,Geibel; William,17,0,20,3
1713351991222,CLRE 250,A00,511389,Morris; Sheldon,9996,0,9999,3
1713351992248,CLRE 251,A00,507176,Mehta; Ravindra L.,9996,0,9999,3
1713351992248,CLRE 251,B00,511410,Mehta; Ravindra L.,9998,0,9999,1
1713351993273,CLRE 252,A00,507189,Cuomo; Raphael Eduardo,9998,0,9999,1
1713351994306,CLRE 253,A00,507199,Vaida; Florin,9997,0,9999,2
1713351994306,CLRE 253,B00,507202,Vaida; Florin,9999,0,9999,0
1713351995333,CLRE 259,A00,507211,Patel; Hemal,9996,0,9999,3
1713351996361,CLRE 260,A00,507221,Cuomo; Raphael Eduardo,9999,0,9999,0
1713351997389,CLRE 297,001,507242,Cuomo; Raphael Eduardo,9999,0,9999,0
1713351998421,CSE 191,A00,516875,Minnes Kemp; Mor Mia,9999,0,9999,0
1713351999453,CSS 201S,A01,494383,Staff,35,0,35,0
1713352000479,CSS 202S,A01,494387,Staff,35,0,35,0
1713352001507,EAP 100,A00,516065,Staff,9792,0,9999,207
1713352002533,ECE 45,A01,507414,Staff,51,0,60,9
1713352003558,ECE 100,A01,507416,Baghdadchi; Saharnaz,9,0,20,11
1713352003558,ECE 100,A02,507418,Baghdadchi; Saharnaz,20,0,20,0
1713352004583,ECE 111,A01,507420,Staff,38,0,50,12
1713352005607,ECE 197,001,548057,Sievenpiper; Daniel F.,9998,0,9999,1
1713352006634,EDS 115,A00,507243,Choi; Bailey Miyeon,28,0,28,0
1713352007659,EDS 117,A01,494379,Staff,23,0,25,2
1713352008684,EDS 125,A00,507246,Hopkins; Megan Beth,29,0,30,1
1713352009715,EDS 128A,A01,507264,Fargason; Sharon Gayle,26,0,26,0
1713352010746,EDS 128B,A01,507293,Pappas; Elizabeth,30,0,30,0
1713352011771,EDS 139,A00,507294,Fargason; Sharon Gayle,30,0,30,0
1713352011771,EDS 139,B00,507313,Pappas; Elizabeth,30,0,30,0
1713352012801,EDS 201,A00,507315,Staff,26,0,30,4
1713352013828,EDS 203,A01,507317,Halter; Christopher P.,26,0,30,4
1713352014858,EDS 204R,A01,507319,Halter; Christopher P.,3,0,30,27
1713352014858,EDS 204R,B01,507331,Heinzman; Erica M.,28,0,30,2
1713352015883,EDS 206R,A00,507332,Staff,4,0,30,26
1713352015883,EDS 206R,B00,507343,Staff,28,0,30,2
1713352016908,EDS 250,A00,507344,Hemans; Patricia Ann Benitez,36,0,40,4
1713352017933,EDS 281,A00,507345,Daly; Alan J.,18,0,18,0
1713352018956,EDS 284,A00,507350,Daly; Alan J.,16,0,16,0
1713352019983,EDS 286,A00,507359,Fine; Sarah,18,0,18,0
1713352021010,EDS 289C,A01,507361,Daly; Alan J.,18,0,18,0
1713352022037,EDS 290,A00,507366,Hofstetter; Carolyn,15,0,15,0
1713352023065,LIGM 5A,A00,507421,Fischer-Grunski; Eva K,20,0,20,0
1713352024091,LIGM 5B,A00,507423,Fischer-Grunski; Eva K,20,0,20,0
1713352025122,LIGM 5C,A00,507425,Fischer-Grunski; Eva K,20,0,20,0
1713352026146,LIIT 5AS,A00,507427,Carnelos; Chiara,20,0,20,0
1713352027172,LIIT 5BS,A00,507430,Carnelos; Chiara,20,0,20,0
1713352028198,LIIT 5CS,A00,507432,Carnelos; Chiara,20,0,20,0
1713352029231,LISP 5A,A00,507541,Munoz Sanchez; Alicia,17,0,20,3
1713352030256,LISP 5B,A00,507671,Munoz Sanchez; Alicia,14,0,20,6
1713352031283,LISP 5C,A00,507696,Munoz Sanchez; Alicia,14,0,20,6
1713352032309,MAE 197,001,528363,Boechler; Nicholas Sebastia,9998,0,9999,1
1713352033335,MATH 197,001,523477,Kedlaya; Kiran S.,9999,0,9999,0
1713352033335,MATH 197,002,563811,Zhang; Danna,9999,0,9999,0
1713352034360,MCWP 40R,A00,518780,Staff,20,0,20,0
1713352034360,MCWP 40R,B00,518781,Staff,19,0,20,1
1713352034360,MCWP 40R,C00,518783,Staff,19,0,20,1
1713352035386,MCWP 50R,A00,518791,Staff,20,0,20,0
1713352035386,MCWP 50R,B00,518792,Staff,17,0,20,3
1713352035386,MCWP 50R,C00,518793,Staff,19,0,20,1
1713352035386,MCWP 50R,D00,518794,Staff,16,0,20,4
1713352035386,MCWP 50R,E00,518795,Staff,16,0,20,4
1713352035386,MCWP 50R,F00,518796,Staff,19,0,20,1
1713352035386,MCWP 50R,G00,518797,Staff,19,0,20,1
1713352036418,MMW 12R,A01,514034,Herbst; Matthew,15,0,16,1
1713352036418,MMW 12R,A02,514035,Herbst; Matthew,16,0,16,0
1713352037447,MMW 13R,A01,514037,Staff,12,0,16,4
1713352037447,MMW 13R,A02,514039,Staff,16,0,16,0
1713352039497,SIO 295LS,A00,523233,Staff,18,0,30,12
1713352040521,SIO 295S,A00,523232,Staff,18,0,30,12
1713352041547,SOCI 117,A01,494376,Staff,1,0,5,4
1713352042579,WES 237B,A00,494380,Staff,19,0,20,1
1713352044682,AESE 279B,A00,494370,Wade; Jon P,33,0,33,0
1713352045711,ANAR 135S,A00,494369,Braswell; Geoffrey E.,0,0,0,0
1713352046737,CAT 124RS,A01,519847,Geibel; William,17,0,20,3
1713352047762,CAT 125RS,A01,515971,Geibel; William,17,0,20,3
1713352048793,CLRE 250,A00,511389,Morris; Sheldon,9996,0,9999,3
1713352049823,CLRE 251,A00,507176,Mehta; Ravindra L.,9996,0,9999,3
1713352049823,CLRE 251,B00,511410,Mehta; Ravindra L.,9998,0,9999,1
1713352050854,CLRE 252,A00,507189,Cuomo; Raphael Eduardo,9998,0,9999,1
1713352051882,CLRE 253,A00,507199,Vaida; Florin,9997,0,9999,2
1713352051882,CLRE 253,B00,507202,Vaida; Florin,9999,0,9999,0
1713352052911,CLRE 259,A00,507211,Patel; Hemal,9996,0,9999,3
1713352053937,CLRE 260,A00,507221,Cuomo; Raphael Eduardo,9999,0,9999,0
1713352054962,CLRE 297,001,507242,Cuomo; Raphael Eduardo,9999,0,9999,0
1713352055988,CSE 191,A00,516875,Minnes Kemp; Mor Mia,9999,0,9999,0
1713352057018,CSS 201S,A01,494383,Staff,35,0,35,0
1713352058049,CSS 202S,A01,494387,Staff,35,0,35,0
1713352059079,EAP 100,A00,516065,Staff,9792,0,9999,207
1713352060105,ECE 45,A01,507414,Staff,51,0,60,9
1713352061131,ECE 100,A01,507416,Baghdadchi; Saharnaz,9,0,20,11
1713352061131,ECE 100,A02,507418,Baghdadchi; Saharnaz,20,0,20,0
1713352062158,ECE 111,A01,507420,Staff,38,0,50,12
1713352063184,ECE 197,001,548057,Sievenpiper; Daniel F.,9998,0,9999,1
1713352064214,EDS 115,A00,507243,Choi; Bailey Miyeon,28,0,28,0
1713352065241,EDS 117,A01,494379,Staff,23,0,25,2
1713352066268,EDS 125,A00,507246,Hopkins; Megan Beth,29,0,30,1
1713352067294,EDS 128A,A01,507264,Fargason; Sharon Gayle,26,0,26,0
1713352068319,EDS 128B,A01,507293,Pappas; Elizabeth,30,0,30,0
1713352069344,EDS 139,A00,507294,Fargason; Sharon Gayle,30,0,30,0
1713352069344,EDS 139,B00,507313,Pappas; Elizabeth,30,0,30,0
1713352070370,EDS 201,A00,507315,Staff,26,0,30,4
1713352071395,EDS 203,A01,507317,Halter; Christopher P.,26,0,30,4
1713352072422,EDS 204R,A01,507319,Halter; Christopher P.,3,0,30,27
1713352072422,EDS 204R,B01,507331,Heinzman; Erica M.,28,0,30,2
1713352073448,EDS 206R,A00,507332,Staff,4,0,30,26
1713352073448,EDS 206R,B00,507343,Staff,28,0,30,2
1713352074476,EDS 250,A00,507344,Hemans; Patricia Ann Benitez,36,0,40,4
1713352075502,EDS 281,A00,507345,Daly; Alan J.,18,0,18,0
1713352076530,EDS 284,A00,507350,Daly; Alan J.,16,0,16,0
1713352077556,EDS 286,A00,507359,Fine; Sarah,18,0,18,0
1713352078585,EDS 289C,A01,507361,Daly; Alan J.,18,0,18,0
1713352079611,EDS 290,A00,507366,Hofstetter; Carolyn,15,0,15,0
1713352080638,LIGM 5A,A00,507421,Fischer-Grunski; Eva K,20,0,20,0
1713352081663,LIGM 5B,A00,507423,Fischer-Grunski; Eva K,20,0,20,0
1713352082689,LIGM 5C,A00,507425,Fischer-Grunski; Eva K,20,0,20,0
1713352083714,LIIT 5AS,A00,507427,Carnelos; Chiara,20,0,20,0
1713352084738,LIIT 5BS,A00,507430,Carnelos; Chiara,20,0,20,0
1713352085821,LIIT 5CS,A00,507432,Carnelos; Chiara,20,0,20,0
1713352086852,LISP 5A,A00,507541,Munoz Sanchez; Alicia,17,0,20,3
1713352087881,LISP 5B,A00,507671,Munoz Sanchez; Alicia,14,0,20,6
1713352088904,LISP 5C,A00,507696,Munoz Sanchez; Alicia,14,0,20,6
1713352089933,MAE 197,001,528363,Boechler; Nicholas Sebastia,9998,0,9999,1
1713352090959,MATH 197,001,523477,Kedlaya; Kiran S.,9999,0,9999,0
1713352090959,MATH 197,002,563811,Zhang; Danna,9999,0,9999,0
1713352091989,MCWP 40R,A00,518780,Staff,20,0,20,0
1713352091989,MCWP 40R,B00,518781,Staff,19,0,20,1
1713352091989,MCWP 40R,C00,518783,Staff,19,0,20,1
1713352093018,MCWP 50R,A00,518791,Staff,20,0,20,0
1713352093018,MCWP 50R,B00,518792,Staff,17,0,20,3
1713352093018,MCWP 50R,C00,518793,Staff,19,0,20,1
1713352093018,MCWP 50R,D00,518794,Staff,16,0,20,4
1713352093018,MCWP 50R,E00,518795,Staff,16,0,20,4
1713352093018,MCWP 50R,F00,518796,Staff,19,0,20,1
1713352093018,MCWP 50R,G00,518797,Staff,19,0,20,1
1713352094044,MMW 12R,A01,514034,Herbst; Matthew,15,0,16,1
1713352094044,MMW 12R,A02,514035,Herbst; Matthew,16,0,16,0
1713352095070,MMW 13R,A01,514037,Staff,12,0,16,4
1713352095070,MMW 13R,A02,514039,Staff,16,0,16,0
1713352097121,SIO 295LS,A00,523233,Staff,18,0,30,12
1713352098148,SIO 295S,A00,523232,Staff,18,0,30,12
1713352099172,SOCI 117,A01,494376,Staff,1,0,5,4
1713352100198,WES 237B,A00,494380,Staff,19,0,20,1
1713352102265,AESE 279B,A00,494370,Wade; Jon P,33,0,33,0
1713352103289,ANAR 135S,A00,494369,Braswell; Geoffrey E.,0,0,0,0
1713352104314,CAT 124RS,A01,519847,Geibel; William,17,0,20,3
1713352105338,CAT 125RS,A01,515971,Geibel; William,17,0,20,3
1713352106362,CLRE 250,A00,511389,Morris; Sheldon,9996,0,9999,3
1713352107386,CLRE 251,A00,507176,Mehta; Ravindra L.,9996,0,9999,3
1713352107386,CLRE 251,B00,511410,Mehta; Ravindra L.,9998,0,9999,1
1713352108417,CLRE 252,A00,507189,Cuomo; Raphael Eduardo,9998,0,9999,1
1713352109443,CLRE 253,A00,507199,Vaida; Florin,9997,0,9999,2
1713352109443,CLRE 253,B00,507202,Vaida; Florin,9999,0,9999,0
1713352110468,CLRE 259,A00,507211,Patel; Hemal,9996,0,9999,3
1713352111491,CLRE 260,A00,507221,Cuomo; Raphael Eduardo,9999,0,9999,0
1713352112515,CLRE 297,001,507242,Cuomo; Raphael Eduardo,9999,0,9999,0
1713352113547,CSE 191,A00,516875,Minnes Kemp; Mor Mia,9999,0,9999,0
1713352114578,CSS 201S,A01,494383,Staff,35,0,35,0
1713352115603,CSS 202S,A01,494387,Staff,35,0,35,0
1713352116633,EAP 100,A00,516065,Staff,9792,0,9999,207
1713352117658,ECE 45,A01,507414,Staff,51,0,60,9
1713352118684,ECE 100,A01,507416,Baghdadchi; Saharnaz,9,0,20,11
1713352118684,ECE 100,A02,507418,Baghdadchi; Saharnaz,20,0,20,0
1713352119710,ECE 111,A01,507420,Staff,38,0,50,12
1713352120736,ECE 197,001,548057,Sievenpiper; Daniel F.,9998,0,9999,1
1713352121763,EDS 115,A00,507243,Choi; Bailey Miyeon,28,0,28,0
1713352122791,EDS 117,A01,494379,Staff,23,0,25,2
1713352123821,EDS 125,A00,507246,Hopkins; Megan Beth,29,0,30,1
1713352124847,EDS 128A,A01,507264,Fargason; Sharon Gayle,26,0,26,0
1713352125875,EDS 128B,A01,507293,Pappas; Elizabeth,30,0,30,0
1713352126902,EDS 139,A00,507294,Fargason; Sharon Gayle,30,0,30,0
1713352126902,EDS 139,B00,507313,Pappas; Elizabeth,30,0,30,0
1713352127927,EDS 201,A00,507315,Staff,26,0,30,4
1713352128953,EDS 203,A01,507317,Halter; Christopher P.,26,0,30,4
1713352130590,EDS 204R,A01,507319,Halter; Christopher P.,3,0,30,27
1713352130590,EDS 204R,B01,507331,Heinzman; Erica M.,28,0,30,2
1713352131615,EDS 206R,A00,507332,Staff,4,0,30,26
1713352131615,EDS 206R,B00,507343,Staff,28,0,30,2
1713352132646,EDS 250,A00,507344,Hemans; Patricia Ann Benitez,36,0,40,4
1713352134172,EDS 281,A00,507345,Daly; Alan J.,18,0,18,0
1713352135202,EDS 284,A00,507350,Daly; Alan J.,16,0,16,0
1713352136230,EDS 286,A00,507359,Fine; Sarah,18,0,18,0
1713352137260,EDS 289C,A01,507361,Daly; Alan J.,18,0,18,0
1713352138286,EDS 290,A00,507366,Hofstetter; Carolyn,15,0,15,0
1713352139762,LIGM 5A,A00,507421,Fischer-Grunski; Eva K,20,0,20,0
1713352140807,LIGM 5B,A00,507423,Fischer-Grunski; Eva K,20,0,20,0
1713352141835,LIGM 5C,A00,507425,Fischer-Grunski; Eva K,20,0,20,0
1713352143047,LIIT 5AS,A00,507427,Carnelos; Chiara,20,0,20,0
1713352144073,LIIT 5BS,A00,507430,Carnelos; Chiara,20,0,20,0
1713352145099,LIIT 5CS,A00,507432,Carnelos; Chiara,20,0,20,0
1713352146128,LISP 5A,A00,507541,Munoz Sanchez; Alicia,17,0,20,3
1713352147157,LISP 5B,A00,507671,Munoz Sanchez; Alicia,14,0,20,6
1713352148180,LISP 5C,A00,507696,Munoz Sanchez; Alicia,14,0,20,6
1713352149206,MAE 197,001,528363,Boechler; Nicholas Sebastia,9998,0,9999,1
1713352150231,MATH 197,001,523477,Kedlaya; Kiran S.,9999,0,9999,0
1713352150231,MATH 197,002,563811,Zhang; Danna,9999,0,9999,0
1713352151260,MCWP 40R,A00,518780,Staff,20,0,20,0
1713352151260,MCWP 40R,B00,518781,Staff,19,0,20,1
1713352151260,MCWP 40R,C00,518783,Staff,19,0,20,1
1713352152563,MCWP 50R,A00,518791,Staff,20,0,20,0
1713352152563,MCWP 50R,B00,518792,Staff,17,0,20,3
1713352152563,MCWP 50R,C00,518793,Staff,19,0,20,1
1713352152563,MCWP 50R,D00,518794,Staff,16,0,20,4
1713352152563,MCWP 50R,E00,518795,Staff,16,0,20,4
1713352152563,MCWP 50R,F00,518796,Staff,19,0,20,1
1713352152563,MCWP 50R,G00,518797,Staff,19,0,20,1
1713352153590,MMW 12R,A01,514034,Herbst; Matthew,15,0,16,1
1713352153590,MMW 12R,A02,514035,Herbst; Matthew,16,0,16,0
1713352154618,MMW 13R,A01,514037,Staff,12,0,16,4
1713352154618,MMW 13R,A02,514039,Staff,16,0,16,0
1713352156671,SIO 295LS,A00,523233,Staff,18,0,30,12
1713352157693,SIO 295S,A00,523232,Staff,18,0,30,12
1713352158719,SOCI 117,A01,494376,Staff,1,0,5,4
1713352159744,WES 237B,A00,494380,Staff,19,0,20,1
1713352161828,AESE 279B,A00,494370,Wade; Jon P,33,0,33,0
1713352162857,ANAR 135S,A00,494369,Braswell; Geoffrey E.,0,0,0,0
1713352163893,CAT 124RS,A01,519847,Geibel; William,17,0,20,3
1713352164922,CAT 125RS,A01,515971,Geibel; William,17,0,20,3
1713352165946,CLRE 250,A00,511389,Morris; Sheldon,9996,0,9999,3
1713352167234,CLRE 251,A00,507176,Mehta; Ravindra L.,9996,0,9999,3
1713352167234,CLRE 251,B00,511410,Mehta; Ravindra L.,9998,0,9999,1
1713352168258,CLRE 252,A00,507189,Cuomo; Raphael Eduardo,9998,0,9999,1
1713352169287,CLRE 253,A00,507199,Vaida; Florin,9997,0,9999,2
1713352169287,CLRE 253,B00,507202,Vaida; Florin,9999,0,9999,0
1713352170313,CLRE 259,A00,507211,Patel; Hemal,9996,0,9999,3
1713352171338,CLRE 260,A00,507221,Cuomo; Raphael Eduardo,9999,0,9999,0
1713352172367,CLRE 297,001,507242,Cuomo; Raphael Eduardo,9999,0,9999,0
1713352173396,CSE 191,A00,516875,Minnes Kemp; Mor Mia,9999,0,9999,0
1713352174534,CSS 201S,A01,494383,Staff,35,0,35,0
1713352175560,CSS 202S,A01,494387,Staff,35,0,35,0
1713352176587,EAP 100,A00,516065,Staff,9792,0,9999,207
1713352177619,ECE 45,A01,507414,Staff,51,0,60,9
1713352178644,ECE 100,A01,507416,Baghdadchi; Saharnaz,9,0,20,11
1713352178644,ECE 100,A02,507418,Baghdadchi; Saharnaz,20,0,20,0
1713352179668,ECE 111,A01,507420,Staff,38,0,50,12
1713352180696,ECE 197,001,548057,Sievenpiper; Daniel F.,9998,0,9999,1
1713352181727,EDS 115,A00,507243,Choi; Bailey Miyeon,28,0,28,0
1713352182753,EDS 117,A01,494379,Staff,23,0,25,2
1713352183779,EDS 125,A00,507246,Hopkins; Megan Beth,29,0,30,1
1713352184811,EDS 128A,A01,507264,Fargason; Sharon Gayle,26,0,26,0
1713352185836,EDS 128B,A01,507293,Pappas; Elizabeth,30,0,30,0
1713352186862,EDS 139,A00,507294,Fargason; Sharon Gayle,30,0,30,0
1713352186862,EDS 139,B00,507313,Pappas; Elizabeth,30,0,30,0
1713352187890,EDS 201,A00,507315,Staff,26,0,30,4
1713352188916,EDS 203,A01,507317,Halter; Christopher P.,26,0,30,4
1713352189999,EDS 204R,A01,507319,Halter; Christopher P.,3,0,30,27
1713352189999,EDS 204R,B01,507331,Heinzman; Erica M.,28,0,30,2
1713352191029,EDS 206R,A00,507332,Staff,4,0,30,26
1713352191029,EDS 206R,B00,507343,Staff,28,0,30,2
1713352192109,EDS 250,A00,507344,Hemans; Patricia Ann Benitez,36,0,40,4
1713352193137,EDS 281,A00,507345,Daly; Alan J.,18,0,18,0
1713352194162,EDS 284,A00,507350,Daly; Alan J.,16,0,16,0
1713352195188,EDS 286,A00,507359,Fine; Sarah,18,0,18,0
1713352196215,EDS 289C,A01,507361,Daly; Alan J.,18,0,18,0
1713352197239,EDS 290,A00,507366,Hofstetter; Carolyn,15,0,15,0
1713352198263,LIGM 5A,A00,507421,Fischer-Grunski; Eva K,20,0,20,0
1713352199289,LIGM 5B,A00,507423,Fischer-Grunski; Eva K,20,0,20,0
1713352200314,LIGM 5C,A00,507425,Fischer-Grunski; Eva K,20,0,20,0
1713352201344,LIIT 5AS,A00,507427,Carnelos; Chiara,20,0,20,0
1713352202369,LIIT 5BS,A00,507430,Carnelos; Chiara,20,0,20,0
1713352203394,LIIT 5CS,A00,507432,Carnelos; Chiara,20,0,20,0
1713352204418,LISP 5A,A00,507541,Munoz Sanchez; Alicia,17,0,20,3
1713352205444,LISP 5B,A00,507671,Munoz Sanchez; Alicia,14,0,20,6
1713352206473,LISP 5C,A00,507696,Munoz Sanchez; Alicia,14,0,20,6
1713352207498,MAE 197,001,528363,Boechler; Nicholas Sebastia,9998,0,9999,1
1713352208525,MATH 197,001,523477,Kedlaya; Kiran S.,9999,0,9999,0
1713352208525,MATH 197,002,563811,Zhang; Danna,9999,0,9999,0
1713352209549,MCWP 40R,A00,518780,Staff,20,0,20,0
1713352209549,MCWP 40R,B00,518781,Staff,19,0,20,1
1713352209549,MCWP 40R,C00,518783,Staff,19,0,20,1
1713352210578,MCWP 50R,A00,518791,Staff,20,0,20,0
1713352210578,MCWP 50R,B00,518792,Staff,17,0,20,3
1713352210578,MCWP 50R,C00,518793,Staff,19,0,20,1
1713352210578,MCWP 50R,D00,518794,Staff,16,0,20,4
1713352210578,MCWP 50R,E00,518795,Staff,16,0,20,4
1713352210578,MCWP 50R,F00,518796,Staff,19,0,20,1
1713352210578,MCWP 50R,G00,518797,Staff,19,0,20,1
1713352211610,MMW 12R,A01,514034,Herbst; Matthew,15,0,16,1
1713352211610,MMW 12R,A02,514035,Herbst; Matthew,16,0,16,0
1713352212639,MMW 13R,A01,514037,Staff,12,0,16,4
1713352212639,MMW 13R,A02,514039,Staff,16,0,16,0
1713352214690,SIO 295LS,A00,523233,Staff,18,0,30,12
1713352215719,SIO 295S,A00,523232,Staff,18,0,30,12
1713352216744,SOCI 117,A01,494376,Staff,1,0,5,4
1713352217774,WES 237B,A00,494380,Staff,19,0,20,1
1713352219853,AESE 279B,A00,494370,Wade; Jon P,33,0,33,0
1713352220883,ANAR 135S,A00,494369,Braswell; Geoffrey E.,0,0,0,0
1713352221910,CAT 124RS,A01,519847,Geibel; William,17,0,20,3
1713352222938,CAT 125RS,A01,515971,Geibel; William,17,0,20,3
1713352223969,CLRE 250,A00,511389,Morris; Sheldon,9996,0,9999,3
1713352224999,CLRE 251,A00,507176,Mehta; Ravindra L.,9996,0,9999,3
1713352224999,CLRE 251,B00,511410,Mehta; Ravindra L.,9998,0,9999,1
1713352226025,CLRE 252,A00,507189,Cuomo; Raphael Eduardo,9998,0,9999,1
1713352227058,CLRE 253,A00,507199,Vaida; Florin,9997,0,9999,2
1713352227058,CLRE 253,B00,507202,Vaida; Florin,9999,0,9999,0
1713352228083,CLRE 259,A00,507211,Patel; Hemal,9996,0,9999,3
1713352229111,CLRE 260,A00,507221,Cuomo; Raphael Eduardo,9999,0,9999,0
1713352230138,CLRE 297,001,507242,Cuomo; Raphael Eduardo,9999,0,9999,0
1713352231165,CSE 191,A00,516875,Minnes Kemp; Mor Mia,9999,0,9999,0
1713352232194,CSS 201S,A01,494383,Staff,35,0,35,0
1713352233421,CSS 202S,A01,494387,Staff,35,0,35,0
1713352234447,EAP 100,A00,516065,Staff,9792,0,9999,207
1713352235478,ECE 45,A01,507414,Staff,51,0,60,9
1713352236507,ECE 100,A01,507416,Baghdadchi; Saharnaz,9,0,20,11
1713352236507,ECE 100,A02,507418,Baghdadchi; Saharnaz,20,0,20,0
1713352237531,ECE 111,A01,507420,Staff,38,0,50,12
1713352238561,ECE 197,001,548057,Sievenpiper; Daniel F.,9998,0,9999,1
1713352239586,EDS 115,A00,507243,Choi; Bailey Miyeon,28,0,28,0
1713352240612,EDS 117,A01,494379,Staff,23,0,25,2
1713352241636,EDS 125,A00,507246,Hopkins; Megan Beth,29,0,30,1
1713352242669,EDS 128A,A01,507264,Fargason; Sharon Gayle,26,0,26,0
1713352243696,EDS 128B,A01,507293,Pappas; Elizabeth,30,0,30,0
1713352244729,EDS 139,A00,507294,Fargason; Sharon Gayle,30,0,30,0
1713352244729,EDS 139,B00,507313,Pappas; Elizabeth,30,0,30,0
1713352245752,EDS 201,A00,507315,Staff,26,0,30,4
1713352246783,EDS 203,A01,507317,Halter; Christopher P.,26,0,30,4
1713352247815,EDS 204R,A01,507319,Halter; Christopher P.,3,0,30,27
1713352247815,EDS 204R,B01,507331,Heinzman; Erica M.,28,0,30,2
1713352248847,EDS 206R,A00,507332,Staff,4,0,30,26
1713352248847,EDS 206R,B00,507343,Staff,28,0,30,2
1713352249884,EDS 250,A00,507344,Hemans; Patricia Ann Benitez,36,0,40,4
1713352250912,EDS 281,A00,507345,Daly; Alan J.,18,0,18,0
1713352251939,EDS 284,A00,507350,Daly; Alan J.,16,0,16,0
1713352252968,EDS 286,A00,507359,Fine; Sarah,18,0,18,0
1713352253993,EDS 289C,A01,507361,Daly; Alan J.,18,0,18,0
1713352255017,EDS 290,A00,507366,Hofstetter; Carolyn,15,0,15,0
1713352256070,LIGM 5A,A00,507421,Fischer-Grunski; Eva K,20,0,20,0
1713352257096,LIGM 5B,A00,507423,Fischer-Grunski; Eva K,20,0,20,0
1713352258125,LIGM 5C,A00,507425,Fischer-Grunski; Eva K,20,0,20,0
1713352259255,LIIT 5AS,A00,507427,Carnelos; Chiara,20,0,20,0
1713352260280,LIIT 5BS,A00,507430,Carnelos; Chiara,20,0,20,0
1713352261307,LIIT 5CS,A00,507432,Carnelos; Chiara,20,0,20,0
1713352262337,LISP 5A,A00,507541,Munoz Sanchez; Alicia,17,0,20,3
1713352263362,LISP 5B,A00,507671,Munoz Sanchez; Alicia,14,0,20,6
1713352264389,LISP 5C,A00,507696,Munoz Sanchez; Alicia,14,0,20,6
1713352265414,MAE 197,001,528363,Boechler; Nicholas Sebastia,9998,0,9999,1
1713352266449,MATH 197,001,523477,Kedlaya; Kiran S.,9999,0,9999,0
1713352266449,MATH 197,002,563811,Zhang; Danna,9999,0,9999,0
1713352267479,MCWP 40R,A00,518780,Staff,20,0,20,0
1713352267479,MCWP 40R,B00,518781,Staff,19,0,20,1
1713352267479,MCWP 40R,C00,518783,Staff,19,0,20,1
1713352268505,MCWP 50R,A00,518791,Staff,20,0,20,0
1713352268505,MCWP 50R,B00,518792,Staff,17,0,20,3
1713352268505,MCWP 50R,C00,518793,Staff,19,0,20,1
1713352268505,MCWP 50R,D00,518794,Staff,16,0,20,4
1713352268505,MCWP 50R,E00,518795,Staff,16,0,20,4
1713352268505,MCWP 50R,F00,518796,Staff,19,0,20,1
1713352268505,MCWP 50R,G00,518797,Staff,19,0,20,1
1713352269534,MMW 12R,A01,514034,Herbst; Matthew,15,0,16,1
1713352269534,MMW 12R,A02,514035,Herbst; Matthew,16,0,16,0
1713352270559,MMW 13R,A01,514037,Staff,12,0,16,4
1713352270559,MMW 13R,A02,514039,Staff,16,0,16,0
1713352272611,SIO 295LS,A00,523233,Staff,18,0,30,12
1713352273640,SIO 295S,A00,523232,Staff,18,0,30,12
1713352274666,SOCI 117,A01,494376,Staff,1,0,5,4
1713352276049,WES 237B,A00,494380,Staff,19,0,20,1
1713352278248,AESE 279B,A00,494370,Wade; Jon P,33,0,33,0
1713352279279,ANAR 135S,A00,494369,Braswell; Geoffrey E.,0,0,0,0
1713352280309,CAT 124RS,A01,519847,Geibel; William,17,0,20,3
1713352281333,CAT 125RS,A01,515971,Geibel; William,17,0,20,3
1713352282361,CLRE 250,A00,511389,Morris; Sheldon,9996,0,9999,3
1713352283389,CLRE 251,A00,507176,Mehta; Ravindra L.,9996,0,9999,3
1713352283389,CLRE 251,B00,511410,Mehta; Ravindra L.,9998,0,9999,1
1713352284415,CLRE 252,A00,507189,Cuomo; Raphael Eduardo,9998,0,9999,1
1713352285444,CLRE 253,A00,507199,Vaida; Florin,9997,0,9999,2
1713352285444,CLRE 253,B00,507202,Vaida; Florin,9999,0,9999,0
1713352286468,CLRE 259,A00,507211,Patel; Hemal,9996,0,9999,3
1713352287491,CLRE 260,A00,507221,Cuomo; Raphael Eduardo,9999,0,9999,0
1713352288519,CLRE 297,001,507242,Cuomo; Raphael Eduardo,9999,0,9999,0
1713352289546,CSE 191,A00,516875,Minnes Kemp; Mor Mia,9999,0,9999,0
1713352290591,CSS 201S,A01,494383,Staff,35,0,35,0
1713352291619,CSS 202S,A01,494387,Staff,35,0,35,0
1713352292646,EAP 100,A00,516065,Staff,9792,0,9999,207
1713352293674,ECE 45,A01,507414,Staff,51,0,60,9
1713352294700,ECE 100,A01,507416,Baghdadchi; Saharnaz,9,0,20,11
1713352294700,ECE 100,A02,507418,Baghdadchi; Saharnaz,20,0,20,0
1713352295727,ECE 111,A01,507420,Staff,38,0,50,12
1713352296806,ECE 197,001,548057,Sievenpiper; Daniel F.,9998,0,9999,1
1713352297832,EDS 115,A00,507243,Choi; Bailey Miyeon,28,0,28,0
1713352298857,EDS 117,A01,494379,Staff,23,0,25,2
1713352299886,EDS 125,A00,507246,Hopkins; Megan Beth,29,0,30,1
1713352300911,EDS 128A,A01,507264,Fargason; Sharon Gayle,26,0,26,0
1713352301940,EDS 128B,A01,507293,Pappas; Elizabeth,30,0,30,0
1713352302965,EDS 139,A00,507294,Fargason; Sharon Gayle,30,0,30,0
1713352302965,EDS 139,B00,507313,Pappas; Elizabeth,30,0,30,0
1713352303994,EDS 201,A00,507315,Staff,26,0,30,4
1713352305022,EDS 203,A01,507317,Halter; Christopher P.,26,0,30,4
1713352306050,EDS 204R,A01,507319,Halter; Christopher P.,3,0,30,27
1713352306050,EDS 204R,B01,507331,Heinzman; Erica M.,28,0,30,2
1713352307078,EDS 206R,A00,507332,Staff,4,0,30,26
1713352307078,EDS 206R,B00,507343,Staff,28,0,30,2
1713352308106,EDS 250,A00,507344,Hemans; Patricia Ann Benitez,36,0,40,4
1713352309131,EDS 281,A00,507345,Daly; Alan J.,18,0,18,0
1713352310160,EDS 284,A00,507350,Daly; Alan J.,16,0,16,0
1713352311183,EDS 286,A00,507359,Fine; Sarah,18,0,18,0
1713352312208,EDS 289C,A01,507361,Daly; Alan J.,18,0,18,0
1713352313248,EDS 290,A00,507366,Hofstetter; Carolyn,15,0,15,0
1713352314273,LIGM 5A,A00,507421,Fischer-Grunski; Eva K,20,0,20,0
1713352315305,LIGM 5B,A00,507423,Fischer-Grunski; Eva K,20,0,20,0
1713352316329,LIGM 5C,A00,507425,Fischer-Grunski; Eva K,20,0,20,0
1713352317358,LIIT 5AS,A00,507427,Carnelos; Chiara,20,0,20,0
1713352318387,LIIT 5BS,A00,507430,Carnelos; Chiara,20,0,20,0
1713352319413,LIIT 5CS,A00,507432,Carnelos; Chiara,20,0,20,0
1713352320438,LISP 5A,A00,507541,Munoz Sanchez; Alicia,17,0,20,3
1713352321462,LISP 5B,A00,507671,Munoz Sanchez; Alicia,14,0,20,6
1713352322488,LISP 5C,A00,507696,Munoz Sanchez; Alicia,14,0,20,6
1713352323518,MAE 197,001,528363,Boechler; Nicholas Sebastia,9998,0,9999,1
1713352324551,MATH 197,001,523477,Kedlaya; Kiran S.,9999,0,9999,0
1713352324551,MATH 197,002,563811,Zhang; Danna,9999,0,9999,0
1713352325579,MCWP 40R,A00,518780,Staff,20,0,20,0
1713352325579,MCWP 40R,B00,518781,Staff,19,0,20,1
1713352325579,MCWP 40R,C00,518783,Staff,19,0,20,1
1713352326613,MCWP 50R,A00,518791,Staff,20,0,20,0
1713352326613,MCWP 50R,B00,518792,Staff,17,0,20,3
1713352326613,MCWP 50R,C00,518793,Staff,19,0,20,1
1713352326613,MCWP 50R,D00,518794,Staff,16,0,20,4
1713352326613,MCWP 50R,E00,518795,Staff,16,0,20,4
1713352326613,MCWP 50R,F00,518796,Staff,19,0,20,1
1713352326613,MCWP 50R,G00,518797,Staff,19,0,20,1
1713352327641,MMW 12R,A01,514034,Herbst; Matthew,15,0,16,1
1713352327641,MMW 12R,A02,514035,Herbst; Matthew,16,0,16,0
1713352328674,MMW 13R,A01,514037,Staff,12,0,16,4
1713352328674,MMW 13R,A02,514039,Staff,16,0,16,0
1713352330728,SIO 295LS,A00,523233,Staff,18,0,30,12
1713352331753,SIO 295S,A00,523232,Staff,18,0,30,12
1713352332779,SOCI 117,A01,494376,Staff,1,0,5,4
1713352333804,WES 237B,A00,494380,Staff,19,0,20,1
1713352335870,AESE 279B,A00,494370,Wade; Jon P,33,0,33,0
1713352336895,ANAR 135S,A00,494369,Braswell; Geoffrey E.,0,0,0,0
1713352337922,CAT 124RS,A01,519847,Geibel; William,17,0,20,3
1713352338948,CAT 125RS,A01,515971,Geibel; William,17,0,20,3
1713352339975,CLRE 250,A00,511389,Morris; Sheldon,9996,0,9999,3
1713352341067,CLRE 251,A00,507176,Mehta; Ravindra L.,9996,0,9999,3
1713352341067,CLRE 251,B00,511410,Mehta; Ravindra L.,9998,0,9999,1
1713352342136,CLRE 252,A00,507189,Cuomo; Raphael Eduardo,9998,0,9999,1
1713352343169,CLRE 253,A00,507199,Vaida; Florin,9997,0,9999,2
1713352343169,CLRE 253,B00,507202,Vaida; Florin,9999,0,9999,0
1713352344195,CLRE 259,A00,507211,Patel; Hemal,9996,0,9999,3
1713352345220,CLRE 260,A00,507221,Cuomo; Raphael Eduardo,9999,0,9999,0
1713352346246,CLRE 297,001,507242,Cuomo; Raphael Eduardo,9999,0,9999,0
1713352347272,CSE 191,A00,516875,Minnes Kemp; Mor Mia,9999,0,9999,0
1713352348300,CSS 201S,A01,494383,Staff,35,0,35,0
1713352349325,CSS 202S,A01,494387,Staff,35,0,35,0
1713352350349,EAP 100,A00,516065,Staff,9792,0,9999,207
1713352351377,ECE 45,A01,507414,Staff,51,0,60,9
1713352352407,ECE 100,A01,507416,Baghdadchi; Saharnaz,9,0,20,11
1713352352407,ECE 100,A02,507418,Baghdadchi; Saharnaz,20,0,20,0
1713352353431,ECE 111,A01,507420,Staff,38,0,50,12
1713352354457,ECE 197,001,548057,Sievenpiper; Daniel F.,9998,0,9999,1
1713352355487,EDS 115,A00,507243,Choi; Bailey Miyeon,28,0,28,0
1713352356515,EDS 117,A01,494379,Staff,23,0,25,2
1713352357544,EDS 125,A00,507246,Hopkins; Megan Beth,29,0,30,1
1713352358568,EDS 128A,A01,507264,Fargason; Sharon Gayle,26,0,26,0
1713352359595,EDS 128B,A01,507293,Pappas; Elizabeth,30,0,30,0
1713352360622,EDS 139,A00,507294,Fargason; Sharon Gayle,30,0,30,0
1713352360622,EDS 139,B00,507313,Pappas; Elizabeth,30,0,30,0
1713352361650,EDS 201,A00,507315,Staff,26,0,30,4
1713352362681,EDS 203,A01,507317,Halter; Christopher P.,26,0,30,4
1713352363739,EDS 204R,A01,507319,Halter; Christopher P.,3,0,30,27
1713352363739,EDS 204R,B01,507331,Heinzman; Erica M.,28,0,30,2
1713352364768,EDS 206R,A00,507332,Staff,4,0,30,26
1713352364768,EDS 206R,B00,507343,Staff,28,0,30,2
1713352365793,EDS 250,A00,507344,Hemans; Patricia Ann Benitez,36,0,40,4
1713352366818,EDS 281,A00,507345,Daly; Alan J.,18,0,18,0
1713352367843,EDS 284,A00,507350,Daly; Alan J.,16,0,16,0
1713352368867,EDS 286,A00,507359,Fine; Sarah,18,0,18,0
1713352369894,EDS 289C,A01,507361,Daly; Alan J.,18,0,18,0
1713352370922,EDS 290,A00,507366,Hofstetter; Carolyn,15,0,15,0
1713352371945,LIGM 5A,A00,507421,Fischer-Grunski; Eva K,20,0,20,0
1713352372974,LIGM 5B,A00,507423,Fischer-Grunski; Eva K,20,0,20,0
1713352374005,LIGM 5C,A00,507425,Fischer-Grunski; Eva K,20,0,20,0
1713352375032,LIIT 5AS,A00,507427,Carnelos; Chiara,20,0,20,0
1713352376063,LIIT 5BS,A00,507430,Carnelos; Chiara,20,0,20,0
1713352377088,LIIT 5CS,A00,507432,Carnelos; Chiara,20,0,20,0
1713352378114,LISP 5A,A00,507541,Munoz Sanchez; Alicia,17,0,20,3
1713352379140,LISP 5B,A00,507671,Munoz Sanchez; Alicia,14,0,20,6
1713352380173,LISP 5C,A00,507696,Munoz Sanchez; Alicia,14,0,20,6
1713352381198,MAE 197,001,528363,Boechler; Nicholas Sebastia,9998,0,9999,1
1713352382225,MATH 197,001,523477,Kedlaya; Kiran S.,9999,0,9999,0
1713352382225,MATH 197,002,563811,Zhang; Danna,9999,0,9999,0
1713352383259,MCWP 40R,A00,518780,Staff,20,0,20,0
1713352383259,MCWP 40R,B00,518781,Staff,19,0,20,1
1713352383259,MCWP 40R,C00,518783,Staff,19,0,20,1
1713352384289,MCWP 50R,A00,518791,Staff,20,0,20,0
1713352384289,MCWP 50R,B00,518792,Staff,17,0,20,3
1713352384289,MCWP 50R,C00,518793,Staff,19,0,20,1
1713352384289,MCWP 50R,D00,518794,Staff,16,0,20,4
1713352384289,MCWP 50R,E00,518795,Staff,16,0,20,4
1713352384289,MCWP 50R,F00,518796,Staff,19,0,20,1
1713352384289,MCWP 50R,G00,518797,Staff,19,0,20,1
1713352385312,MMW 12R,A01,514034,Herbst; Matthew,15,0,16,1
1713352385312,MMW 12R,A02,514035,Herbst; Matthew,16,0,16,0
1713352386336,MMW 13R,A01,514037,Staff,12,0,16,4
1713352386336,MMW 13R,A02,514039,Staff,16,0,16,0
1713352388388,SIO 295LS,A00,523233,Staff,18,0,30,12
1713352389415,SIO 295S,A00,523232,Staff,18,0,30,12
1713352390439,SOCI 117,A01,494376,Staff,1,0,5,4
1713352391466,WES 237B,A00,494380,Staff,19,0,20,1
1713352393521,AESE 279B,A00,494370,Wade; Jon P,33,0,33,0
1713352394549,ANAR 135S,A00,494369,Braswell; Geoffrey E.,0,0,0,0
1713352395577,CAT 124RS,A01,519847,Geibel; William,17,0,20,3
1713352396602,CAT 125RS,A01,515971,Geibel; William,17,0,20,3
1713352397627,CLRE 250,A00,511389,Morris; Sheldon,9996,0,9999,3
1713352398657,CLRE 251,A00,507176,Mehta; Ravindra L.,9996,0,9999,3
1713352398657,CLRE 251,B00,511410,Mehta; Ravindra L.,9998,0,9999,1
1713352399682,CLRE 252,A00,507189,Cuomo; Raphael Eduardo,9998,0,9999,1
1713352400767,CLRE 253,A00,507199,Vaida; Florin,9997,0,9999,2
1713352400767,CLRE 253,B00,507202,Vaida; Florin,9999,0,9999,0
1713352401791,CLRE 259,A00,507211,Patel; Hemal,9996,0,9999,3
1713352402817,CLRE 260,A00,507221,Cuomo; Raphael Eduardo,9999,0,9999,0
1713352403844,CLRE 297,001,507242,Cuomo; Raphael Eduardo,9999,0,9999,0
1713352404868,CSE 191,A00,516875,Minnes Kemp; Mor Mia,9999,0,9999,0
1713352405893,CSS 201S,A01,494383,Staff,35,0,35,0
1713352406916,CSS 202S,A01,494387,Staff,35,0,35,0
1713352407940,EAP 100,A00,516065,Staff,9792,0,9999,207
1713352408966,ECE 45,A01,507414,Staff,51,0,60,9
1713352409991,ECE 100,A01,507416,Baghdadchi; Saharnaz,9,0,20,11
1713352409991,ECE 100,A02,507418,Baghdadchi; Saharnaz,20,0,20,0
1713352411017,ECE 111,A01,507420,Staff,38,0,50,12
1713352412043,ECE 197,001,548057,Sievenpiper; Daniel F.,9998,0,9999,1
1713352413068,EDS 115,A00,507243,Choi; Bailey Miyeon,28,0,28,0
1713352414096,EDS 117,A01,494379,Staff,23,0,25,2
1713352415121,EDS 125,A00,507246,Hopkins; Megan Beth,29,0,30,1
1713352416145,EDS 128A,A01,507264,Fargason; Sharon Gayle,26,0,26,0
1713352417172,EDS 128B,A01,507293,Pappas; Elizabeth,30,0,30,0
1713352418195,EDS 139,A00,507294,Fargason; Sharon Gayle,30,0,30,0
1713352418195,EDS 139,B00,507313,Pappas; Elizabeth,30,0,30,0
1713352419221,EDS 201,A00,507315,Staff,26,0,30,4
1713352420246,EDS 203,A01,507317,Halter; Christopher P.,26,0,30,4
1713352421277,EDS 204R,A01,507319,Halter; Christopher P.,3,0,30,27
1713352421277,EDS 204R,B01,507331,Heinzman; Erica M.,28,0,30,2
1713352422304,EDS 206R,A00,507332,Staff,4,0,30,26
1713352422304,EDS 206R,B00,507343,Staff,28,0,30,2
1713352423329,EDS 250,A00,507344,Hemans; Patricia Ann Benitez,36,0,40,4
1713352424357,EDS 281,A00,507345,Daly; Alan J.,18,0,18,0
1713352425382,EDS 284,A00,507350,Daly; Alan J.,16,0,16,0
1713352426416,EDS 286,A00,507359,Fine; Sarah,18,0,18,0
1713352427441,EDS 289C,A01,507361,Daly; Alan J.,18,0,18,0
1713352428466,EDS 290,A00,507366,Hofstetter; Carolyn,15,0,15,0
1713352429491,LIGM 5A,A00,507421,Fischer-Grunski; Eva K,20,0,20,0
1713352430517,LIGM 5B,A00,507423,Fischer-Grunski; Eva K,20,0,20,0
1713352431541,LIGM 5C,A00,507425,Fischer-Grunski; Eva K,20,0,20,0
1713352432575,LIIT 5AS,A00,507427,Carnelos; Chiara,20,0,20,0
1713352433600,LIIT 5BS,A00,507430,Carnelos; Chiara,20,0,20,0
1713352434625,LIIT 5CS,A00,507432,Carnelos; Chiara,20,0,20,0
1713352435650,LISP 5A,A00,507541,Munoz Sanchez; Alicia,17,0,20,3
1713352436675,LISP 5B,A00,507671,Munoz Sanchez; Alicia,14,0,20,6
1713352437707,LISP 5C,A00,507696,Munoz Sanchez; Alicia,14,0,20,6
1713352438733,MAE 197,001,528363,Boechler; Nicholas Sebastia,9998,0,9999,1
1713352439760,MATH 197,001,523477,Kedlaya; Kiran S.,9999,0,9999,0
1713352439760,MATH 197,002,563811,Zhang; Danna,9999,0,9999,0
1713352440785,MCWP 40R,A00,518780,Staff,20,0,20,0
1713352440785,MCWP 40R,B00,518781,Staff,19,0,20,1
1713352440785,MCWP 40R,C00,518783,Staff,19,0,20,1
1713352441817,MCWP 50R,A00,518791,Staff,20,0,20,0
1713352441817,MCWP 50R,B00,518792,Staff,17,0,20,3
1713352441817,MCWP 50R,C00,518793,Staff,19,0,20,1
1713352441817,MCWP 50R,D00,518794,Staff,16,0,20,4
1713352441817,MCWP 50R,E00,518795,Staff,16,0,20,4
1713352441817,MCWP 50R,F00,518796,Staff,19,0,20,1
1713352441817,MCWP 50R,G00,518797,Staff,19,0,20,1
1713352442843,MMW 12R,A01,514034,Herbst; Matthew,15,0,16,1
1713352442843,MMW 12R,A02,514035,Herbst; Matthew,16,0,16,0
1713352443872,MMW 13R,A01,514037,Staff,12,0,16,4
1713352443872,MMW 13R,A02,514039,Staff,16,0,16,0
1713352446050,SIO 295LS,A00,523233,Staff,18,0,30,12
1713352447077,SIO 295S,A00,523232,Staff,18,0,30,12
1713352448103,SOCI 117,A01,494376,Staff,1,0,5,4
1713352449133,WES 237B,A00,494380,Staff,19,0,20,1
1713352451207,AESE 279B,A00,494370,Wade; Jon P,33,0,33,0
1713352452242,ANAR 135S,A00,494369,Braswell; Geoffrey E.,0,0,0,0
1713352453284,CAT 124RS,A01,519847,Geibel; William,17,0,20,3
1713352454310,CAT 125RS,A01,515971,Geibel; William,17,0,20,3
1713352455334,CLRE 250,A00,511389,Morris; Sheldon,9996,0,9999,3
1713352456365,CLRE 251,A00,507176,Mehta; Ravindra L.,9996,0,9999,3
1713352456365,CLRE 251,B00,511410,Mehta; Ravindra L.,9998,0,9999,1
1713352457396,CLRE 252,A00,507189,Cuomo; Raphael Eduardo,9998,0,9999,1
1713352458420,CLRE 253,A00,507199,Vaida; Florin,9997,0,9999,2
1713352458420,CLRE 253,B00,507202,Vaida; Florin,9999,0,9999,0
1713352459449,CLRE 259,A00,507211,Patel; Hemal,9996,0,9999,3
1713352460475,CLRE 260,A00,507221,Cuomo; Raphael Eduardo,9999,0,9999,0
1713352461499,CLRE 297,001,507242,Cuomo; Raphael Eduardo,9999,0,9999,0
1713352462523,CSE 191,A00,516875,Minnes Kemp; Mor Mia,9999,0,9999,0
1713352463549,CSS 201S,A01,494383,Staff,35,0,35,0
1713352464581,CSS 202S,A01,494387,Staff,35,0,35,0
1713352465605,EAP 100,A00,516065,Staff,9792,0,9999,207
1713352466631,ECE 45,A01,507414,Staff,51,0,60,9
1713352467658,ECE 100,A01,507416,Baghdadchi; Saharnaz,9,0,20,11
1713352467658,ECE 100,A02,507418,Baghdadchi; Saharnaz,20,0,20,0
1713352468684,ECE 111,A01,507420,Staff,38,0,50,12
1713352469711,ECE 197,001,548057,Sievenpiper; Daniel F.,9998,0,9999,1
1713352470749,EDS 115,A00,507243,Choi; Bailey Miyeon,28,0,28,0
1713352471775,EDS 117,A01,494379,Staff,23,0,25,2
1713352472801,EDS 125,A00,507246,Hopkins; Megan Beth,29,0,30,1
1713352473832,EDS 128A,A01,507264,Fargason; Sharon Gayle,26,0,26,0
1713352474860,EDS 128B,A01,507293,Pappas; Elizabeth,30,0,30,0
1713352475886,EDS 139,A00,507294,Fargason; Sharon Gayle,30,0,30,0
1713352475886,EDS 139,B00,507313,Pappas; Elizabeth,30,0,30,0
1713352476915,EDS 201,A00,507315,Staff,26,0,30,4
1713352477946,EDS 203,A01,507317,Halter; Christopher P.,26,0,30,4
1713352478973,EDS 204R,A01,507319,Halter; Christopher P.,3,0,30,27
1713352478973,EDS 204R,B01,507331,Heinzman; Erica M.,28,0,30,2
1713352479998,EDS 206R,A00,507332,Staff,4,0,30,26
1713352479998,EDS 206R,B00,507343,Staff,28,0,30,2
1713352481026,EDS 250,A00,507344,Hemans; Patricia Ann Benitez,36,0,40,4
1713352482053,EDS 281,A00,507345,Daly; Alan J.,18,0,18,0
1713352483281,EDS 284,A00,507350,Daly; Alan J.,16,0,16,0
1713352484309,EDS 286,A00,507359,Fine; Sarah,18,0,18,0
1713352485334,EDS 289C,A01,507361,Daly; Alan J.,18,0,18,0
1713352486361,EDS 290,A00,507366,Hofstetter; Carolyn,15,0,15,0
1713352487388,LIGM 5A,A00,507421,Fischer-Grunski; Eva K,20,0,20,0
1713352488416,LIGM 5B,A00,507423,Fischer-Grunski; Eva K,20,0,20,0
1713352489446,LIGM 5C,A00,507425,Fischer-Grunski; Eva K,20,0,20,0
1713352490471,LIIT 5AS,A00,507427,Carnelos; Chiara,20,0,20,0
1713352491502,LIIT 5BS,A00,507430,Carnelos; Chiara,20,0,20,0
1713352492526,LIIT 5CS,A00,507432,Carnelos; Chiara,20,0,20,0
1713352493552,LISP 5A,A00,507541,Munoz Sanchez; Alicia,17,0,20,3
1713352494582,LISP 5B,A00,507671,Munoz Sanchez; Alicia,14,0,20,6
1713352495611,LISP 5C,A00,507696,Munoz Sanchez; Alicia,14,0,20,6
1713352496640,MAE 197,001,528363,Boechler; Nicholas Sebastia,9998,0,9999,1
1713352497665,MATH 197,001,523477,Kedlaya; Kiran S.,9999,0,9999,0
1713352497665,MATH 197,002,563811,Zhang; Danna,9999,0,9999,0
1713352498690,MCWP 40R,A00,518780,Staff,20,0,20,0
1713352498690,MCWP 40R,B00,518781,Staff,19,0,20,1
1713352498690,MCWP 40R,C00,518783,Staff,19,0,20,1
1713352499721,MCWP 50R,A00,518791,Staff,20,0,20,0
1713352499721,MCWP 50R,B00,518792,Staff,17,0,20,3
1713352499721,MCWP 50R,C00,518793,Staff,19,0,20,1
1713352499721,MCWP 50R,D00,518794,Staff,16,0,20,4
1713352499721,MCWP 50R,E00,518795,Staff,16,0,20,4
1713352499721,MCWP 50R,F00,518796,Staff,19,0,20,1
1713352499721,MCWP 50R,G00,518797,Staff,19,0,20,1
1713352500749,MMW 12R,A01,514034,Herbst; Matthew,15,0,16,1
1713352500749,MMW 12R,A02,514035,Herbst; Matthew,16,0,16,0
1713352501850,MMW 13R,A01,514037,Staff,12,0,16,4
1713352501850,MMW 13R,A02,514039,Staff,16,0,16,0
1713352503901,SIO 295LS,A00,523233,Staff,18,0,30,12
1713352504981,SIO 295S,A00,523232,Staff,18,0,30,12
1713352506008,SOCI 117,A01,494376,Staff,1,0,5,4
1713352507034,WES 237B,A00,494380,Staff,19,0,20,1
1713352509089,AESE 279B,A00,494370,Wade; Jon P,33,0,33,0
1713352510115,ANAR 135S,A00,494369,Braswell; Geoffrey E.,0,0,0,0
1713352511140,CAT 124RS,A01,519847,Geibel; William,17,0,20,3
1713352512165,CAT 125RS,A01,515971,Geibel; William,17,0,20,3
1713352513191,CLRE 250,A00,511389,Morris; Sheldon,9996,0,9999,3
