time,subj_course_id,sec_code,sec_id,prof,available,waitlist,total,enrolled_ct
1714202710482,AESE 279B,A00,494370,Wade; Jon P,0,0,33,33
1714202711522,AIP 197,001,627712,Vespa; Emanuel Ignacio,9998,0,9999,1
1714202712552,ANAR 135S,A00,494369,Braswell; Geoffrey E.,0,0,0,0
1714202713579,BENG 196,001,628496,Engler; Adam J.,9998,0,9999,1
1714202714620,CAT 124RS,A01,519847,Geibel; William,0,0,20,20
1714202715649,CAT 125RS,A01,515971,Geibel; William,0,0,20,20
1714202716677,CLRE 250,A00,511389,Morris; Sheldon,9993,0,9999,6
1714202717706,CLRE 251,A00,507176,Mehta; Ravindra L.,9993,0,9999,6
1714202717706,CLRE 251,B00,511410,Mehta; Ravindra L.,9998,0,9999,1
1714202718731,CLRE 252,A00,507189,Cuomo; Raphael Eduardo,9995,0,9999,4
1714202719758,CLRE 253,A00,507199,Vaida; Florin,9994,0,9999,5
1714202719758,CLRE 253,B00,507202,Vaida; Florin,9999,0,9999,0
1714202720787,CLRE 259,A00,507211,Patel; Hemal,9996,0,9999,3
1714202721860,CLRE 260,A00,507221,Cuomo; Raphael Eduardo,9999,0,9999,0
1714202722888,CLRE 297,001,507242,Cuomo; Raphael Eduardo,9999,0,9999,0
1714202723921,COGS 197,001,638244,Voytek; Bradley Thomas,9999,0,9999,0
1714202724947,CSE 191,A00,516875,Minnes Kemp; Mor Mia,9993,0,9999,6
1714202725994,CSE 197,001,637388,Minnes Kemp; Mor Mia,9998,0,9999,1
1714202727031,CSS 201S,A01,494383,Staff,35,0,35,0
1714202728069,CSS 202S,A01,494387,Staff,35,0,35,0
1714202729104,DSC 197,001,628532,Eldridge; Justin Matthew,9996,0,9999,3
1714202730144,EAP 100,A00,516065,Staff,9797,0,9999,202
1714202731174,ECE 45,A01,507414,Staff,33,0,60,27
1714202733227,ECE 111,A01,507420,Staff,21,0,50,29
1714202734258,ECE 197,001,548057,Sievenpiper; Daniel F.,9994,0,9999,5
1714202735284,EDS 115,A00,507243,Choi; Bailey Miyeon,12,0,28,16
1714202736313,EDS 117,A01,494379,Staff,0,1,30,30
1714202737340,EDS 125,A00,507246,Hopkins; Megan Beth,12,0,30,18
1714202738367,EDS 128A,A01,507264,Fargason; Sharon Gayle,14,0,26,12
1714202739399,EDS 128B,A01,507293,Pappas; Elizabeth,18,0,30,12
1714202740431,EDS 139,A00,507294,Fargason; Sharon Gayle,18,0,30,12
1714202740431,EDS 139,B00,507313,Pappas; Elizabeth,15,0,30,15
1714202741460,EDS 201,A00,507315,Staff,13,0,30,17
1714202742503,EDS 203,A01,507317,Halter; Christopher P.,12,0,30,18
1714202743532,EDS 204R,A01,507319,Halter; Christopher P.,0,3,30,30
1714202743532,EDS 204R,B01,507331,Heinzman; Erica M.,17,0,30,13
1714202744564,EDS 206R,A00,507332,Staff,0,4,30,30
1714202744564,EDS 206R,B00,507343,Staff,18,0,30,12
1714202745591,EDS 250,A00,507344,Hemans; Patricia Ann Benitez,22,0,40,18
1714202746616,EDS 281,A00,507345,Daly; Alan J.,18,0,18,0
1714202747645,EDS 284,A00,507350,Daly; Alan J.,16,0,16,0
1714202748671,EDS 286,A00,507359,Fine; Sarah,18,0,18,0
1714202749700,EDS 289C,A01,507361,Daly; Alan J.,18,0,18,0
1714202750727,EDS 290,A00,507366,Hofstetter; Carolyn,15,0,15,0
1714202751753,LIGM 5A,A00,507421,Fischer-Grunski; Eva K,18,0,20,2
1714202752785,LIGM 5B,A00,507423,Fischer-Grunski; Eva K,19,0,20,1
1714202753811,LIGM 5C,A00,507425,Fischer-Grunski; Eva K,19,0,20,1
1714202754844,LIIT 5AS,A00,507427,Carnelos; Chiara,20,0,20,0
1714202755869,LIIT 5BS,A00,507430,Carnelos; Chiara,20,0,20,0
1714202756896,LIIT 5CS,A00,507432,Carnelos; Chiara,20,0,20,0
1714202757924,LISP 5A,A00,507541,Munoz Sanchez; Alicia,11,0,20,9
1714202758955,LISP 5B,A00,507671,Munoz Sanchez; Alicia,9,0,20,11
1714202759983,LISP 5C,A00,507696,Munoz Sanchez; Alicia,9,0,20,11
1714202761019,MAE 197,001,528363,Boechler; Nicholas Sebastia,9998,0,9999,1
1714202762048,MATH 197,001,523477,Kedlaya; Kiran S.,9996,0,9999,3
1714202762048,MATH 197,002,563811,Zhang; Danna,9995,0,9999,4
1714202762048,MATH 197,003,628552,Dumitriu; Ioana,9998,0,9999,1
1714202763111,MCWP 40R,A00,518780,Staff,5,0,20,15
1714202763111,MCWP 40R,B00,518781,Staff,7,0,20,13
1714202763111,MCWP 40R,C00,518783,Staff,5,0,20,15
1714202764183,MCWP 50R,A00,518791,Staff,0,0,20,20
1714202764183,MCWP 50R,B00,518792,Staff,0,1,20,20
1714202764183,MCWP 50R,C00,518793,Staff,0,1,20,20
1714202764183,MCWP 50R,D00,518794,Staff,0,0,20,20
1714202764183,MCWP 50R,E00,518795,Staff,0,1,20,20
1714202764183,MCWP 50R,F00,518796,Staff,0,0,20,20
1714202764183,MCWP 50R,G00,518797,Staff,0,1,20,20
1714202765215,MMW 12R,A01,514034,Herbst; Matthew,0,1,16,16
1714202765215,MMW 12R,A02,514035,Herbst; Matthew,2,0,16,14
1714202766266,MMW 13R,A01,514037,Staff,0,4,16,16
1714202766266,MMW 13R,A02,514039,Staff,0,2,16,16
1714202766266,MMW 13R,A03,628519,Staff,0,2,16,16
1714202768320,SIO 295LS,A00,523233,Staff,13,0,30,17
1714202769369,SIO 295S,A00,523232,Staff,13,0,30,17
1714202770401,SIOC 290S,A01,637330,Merrifield; Mark A,28,0,30,2
1714202771469,SIOC 291S,A01,637333,Gabriel; Corey John,28,0,30,2
1714202772547,SOCI 117,A01,494376,Staff,0,2,5,5
1714202773586,WES 237B,A00,494380,Staff,9,0,20,11
1714202775786,AESE 279B,A00,494370,Wade; Jon P,0,0,33,33
1714202776849,AIP 197,001,627712,Vespa; Emanuel Ignacio,9998,0,9999,1
1714202777936,ANAR 135S,A00,494369,Braswell; Geoffrey E.,0,0,0,0
1714202778966,BENG 196,001,628496,Engler; Adam J.,9998,0,9999,1
1714202780005,CAT 124RS,A01,519847,Geibel; William,0,0,20,20
1714202781036,CAT 125RS,A01,515971,Geibel; William,0,0,20,20
1714202782065,CLRE 250,A00,511389,Morris; Sheldon,9993,0,9999,6
1714202783100,CLRE 251,A00,507176,Mehta; Ravindra L.,9993,0,9999,6
1714202783100,CLRE 251,B00,511410,Mehta; Ravindra L.,9998,0,9999,1
1714202784141,CLRE 252,A00,507189,Cuomo; Raphael Eduardo,9995,0,9999,4
1714202785169,CLRE 253,A00,507199,Vaida; Florin,9994,0,9999,5
1714202785169,CLRE 253,B00,507202,Vaida; Florin,9999,0,9999,0
1714202786200,CLRE 259,A00,507211,Patel; Hemal,9996,0,9999,3
1714202787236,CLRE 260,A00,507221,Cuomo; Raphael Eduardo,9999,0,9999,0
1714202788277,CLRE 297,001,507242,Cuomo; Raphael Eduardo,9999,0,9999,0
1714202789308,COGS 197,001,638244,Voytek; Bradley Thomas,9999,0,9999,0
1714202790354,CSE 191,A00,516875,Minnes Kemp; Mor Mia,9993,0,9999,6
1714202791417,CSE 197,001,637388,Minnes Kemp; Mor Mia,9998,0,9999,1
1714202792449,CSS 201S,A01,494383,Staff,35,0,35,0
1714202793477,CSS 202S,A01,494387,Staff,35,0,35,0
1714202794527,DSC 197,001,628532,Eldridge; Justin Matthew,9996,0,9999,3
1714202795553,EAP 100,A00,516065,Staff,9797,0,9999,202
1714202796609,ECE 45,A01,507414,Staff,33,0,60,27
1714202798664,ECE 111,A01,507420,Staff,21,0,50,29
1714202799698,ECE 197,001,548057,Sievenpiper; Daniel F.,9994,0,9999,5
1714202800731,EDS 115,A00,507243,Choi; Bailey Miyeon,12,0,28,16
1714202801810,EDS 117,A01,494379,Staff,0,1,30,30
1714202802836,EDS 125,A00,507246,Hopkins; Megan Beth,12,0,30,18
1714202803872,EDS 128A,A01,507264,Fargason; Sharon Gayle,14,0,26,12
1714202804901,EDS 128B,A01,507293,Pappas; Elizabeth,18,0,30,12
1714202805927,EDS 139,A00,507294,Fargason; Sharon Gayle,18,0,30,12
1714202805927,EDS 139,B00,507313,Pappas; Elizabeth,15,0,30,15
1714202806963,EDS 201,A00,507315,Staff,13,0,30,17
1714202807990,EDS 203,A01,507317,Halter; Christopher P.,12,0,30,18
1714202809017,EDS 204R,A01,507319,Halter; Christopher P.,0,3,30,30
1714202809017,EDS 204R,B01,507331,Heinzman; Erica M.,17,0,30,13
1714202810044,EDS 206R,A00,507332,Staff,0,4,30,30
1714202810044,EDS 206R,B00,507343,Staff,18,0,30,12
1714202811070,EDS 250,A00,507344,Hemans; Patricia Ann Benitez,22,0,40,18
1714202812099,EDS 281,A00,507345,Daly; Alan J.,18,0,18,0
1714202813126,EDS 284,A00,507350,Daly; Alan J.,16,0,16,0
1714202814156,EDS 286,A00,507359,Fine; Sarah,18,0,18,0
1714202815188,EDS 289C,A01,507361,Daly; Alan J.,18,0,18,0
1714202816214,EDS 290,A00,507366,Hofstetter; Carolyn,15,0,15,0
1714202817240,LIGM 5A,A00,507421,Fischer-Grunski; Eva K,18,0,20,2
1714202818266,LIGM 5B,A00,507423,Fischer-Grunski; Eva K,19,0,20,1
1714202819297,LIGM 5C,A00,507425,Fischer-Grunski; Eva K,19,0,20,1
1714202820329,LIIT 5AS,A00,507427,Carnelos; Chiara,20,0,20,0
1714202821359,LIIT 5BS,A00,507430,Carnelos; Chiara,20,0,20,0
1714202822390,LIIT 5CS,A00,507432,Carnelos; Chiara,20,0,20,0
1714202823424,LISP 5A,A00,507541,Munoz Sanchez; Alicia,11,0,20,9
1714202824450,LISP 5B,A00,507671,Munoz Sanchez; Alicia,9,0,20,11
1714202825477,LISP 5C,A00,507696,Munoz Sanchez; Alicia,9,0,20,11
1714202826510,MAE 197,001,528363,Boechler; Nicholas Sebastia,9998,0,9999,1
1714202827545,MATH 197,001,523477,Kedlaya; Kiran S.,9996,0,9999,3
1714202827545,MATH 197,002,563811,Zhang; Danna,9995,0,9999,4
1714202827545,MATH 197,003,628552,Dumitriu; Ioana,9998,0,9999,1
1714202828573,MCWP 40R,A00,518780,Staff,5,0,20,15
1714202828573,MCWP 40R,B00,518781,Staff,7,0,20,13
1714202828573,MCWP 40R,C00,518783,Staff,5,0,20,15
1714202829600,MCWP 50R,A00,518791,Staff,0,0,20,20
1714202829600,MCWP 50R,B00,518792,Staff,0,1,20,20
1714202829600,MCWP 50R,C00,518793,Staff,0,1,20,20
1714202829600,MCWP 50R,D00,518794,Staff,0,0,20,20
1714202829600,MCWP 50R,E00,518795,Staff,0,1,20,20
1714202829600,MCWP 50R,F00,518796,Staff,0,0,20,20
1714202829600,MCWP 50R,G00,518797,Staff,0,1,20,20
1714202830627,MMW 12R,A01,514034,Herbst; Matthew,0,1,16,16
1714202830627,MMW 12R,A02,514035,Herbst; Matthew,2,0,16,14
1714202831652,MMW 13R,A01,514037,Staff,0,4,16,16
1714202831652,MMW 13R,A02,514039,Staff,0,2,16,16
1714202831652,MMW 13R,A03,628519,Staff,0,2,16,16
1714202833706,SIO 295LS,A00,523233,Staff,13,0,30,17
1714202834732,SIO 295S,A00,523232,Staff,13,0,30,17
1714202835760,SIOC 290S,A01,637330,Merrifield; Mark A,28,0,30,2
1714202836786,SIOC 291S,A01,637333,Gabriel; Corey John,28,0,30,2
1714202837812,SOCI 117,A01,494376,Staff,0,2,5,5
1714202838837,WES 237B,A00,494380,Staff,9,0,20,11
1714202840910,AESE 279B,A00,494370,Wade; Jon P,0,0,33,33
1714202841936,AIP 197,001,627712,Vespa; Emanuel Ignacio,9998,0,9999,1
1714202842962,ANAR 135S,A00,494369,Braswell; Geoffrey E.,0,0,0,0
1714202843989,BENG 196,001,628496,Engler; Adam J.,9998,0,9999,1
1714202845018,CAT 124RS,A01,519847,Geibel; William,0,0,20,20
1714202846049,CAT 125RS,A01,515971,Geibel; William,0,0,20,20
1714202847079,CLRE 250,A00,511389,Morris; Sheldon,9993,0,9999,6
1714202848107,CLRE 251,A00,507176,Mehta; Ravindra L.,9993,0,9999,6
1714202848107,CLRE 251,B00,511410,Mehta; Ravindra L.,9998,0,9999,1
1714202849133,CLRE 252,A00,507189,Cuomo; Raphael Eduardo,9995,0,9999,4
1714202850161,CLRE 253,A00,507199,Vaida; Florin,9994,0,9999,5
1714202850161,CLRE 253,B00,507202,Vaida; Florin,9999,0,9999,0
1714202851186,CLRE 259,A00,507211,Patel; Hemal,9996,0,9999,3
1714202852218,CLRE 260,A00,507221,Cuomo; Raphael Eduardo,9999,0,9999,0
1714202853250,CLRE 297,001,507242,Cuomo; Raphael Eduardo,9999,0,9999,0
1714202854281,COGS 197,001,638244,Voytek; Bradley Thomas,9999,0,9999,0
1714202855307,CSE 191,A00,516875,Minnes Kemp; Mor Mia,9993,0,9999,6
1714202856332,CSE 197,001,637388,Minnes Kemp; Mor Mia,9998,0,9999,1
1714202857359,CSS 201S,A01,494383,Staff,35,0,35,0
1714202858390,CSS 202S,A01,494387,Staff,35,0,35,0
1714202859416,DSC 197,001,628532,Eldridge; Justin Matthew,9996,0,9999,3
1714202860443,EAP 100,A00,516065,Staff,9797,0,9999,202
1714202861468,ECE 45,A01,507414,Staff,33,0,60,27
1714202863528,ECE 111,A01,507420,Staff,21,0,50,29
1714202864554,ECE 197,001,548057,Sievenpiper; Daniel F.,9994,0,9999,5
1714202865581,EDS 115,A00,507243,Choi; Bailey Miyeon,12,0,28,16
1714202866609,EDS 117,A01,494379,Staff,0,1,30,30
1714202867640,EDS 125,A00,507246,Hopkins; Megan Beth,12,0,30,18
1714202868671,EDS 128A,A01,507264,Fargason; Sharon Gayle,14,0,26,12
1714202869700,EDS 128B,A01,507293,Pappas; Elizabeth,18,0,30,12
1714202870729,EDS 139,A00,507294,Fargason; Sharon Gayle,18,0,30,12
1714202870729,EDS 139,B00,507313,Pappas; Elizabeth,15,0,30,15
1714202871756,EDS 201,A00,507315,Staff,13,0,30,17
1714202872783,EDS 203,A01,507317,Halter; Christopher P.,12,0,30,18
1714202873810,EDS 204R,A01,507319,Halter; Christopher P.,0,3,30,30
1714202873810,EDS 204R,B01,507331,Heinzman; Erica M.,17,0,30,13
1714202874837,EDS 206R,A00,507332,Staff,0,4,30,30
1714202874837,EDS 206R,B00,507343,Staff,18,0,30,12
1714202875864,EDS 250,A00,507344,Hemans; Patricia Ann Benitez,22,0,40,18
1714202876892,EDS 281,A00,507345,Daly; Alan J.,18,0,18,0
1714202877919,EDS 284,A00,507350,Daly; Alan J.,16,0,16,0
1714202878949,EDS 286,A00,507359,Fine; Sarah,18,0,18,0
1714202879979,EDS 289C,A01,507361,Daly; Alan J.,18,0,18,0
1714202881015,EDS 290,A00,507366,Hofstetter; Carolyn,15,0,15,0
1714202882042,LIGM 5A,A00,507421,Fischer-Grunski; Eva K,18,0,20,2
1714202883079,LIGM 5B,A00,507423,Fischer-Grunski; Eva K,19,0,20,1
1714202884110,LIGM 5C,A00,507425,Fischer-Grunski; Eva K,19,0,20,1
1714202885137,LIIT 5AS,A00,507427,Carnelos; Chiara,20,0,20,0
1714202886162,LIIT 5BS,A00,507430,Carnelos; Chiara,20,0,20,0
1714202887198,LIIT 5CS,A00,507432,Carnelos; Chiara,20,0,20,0
1714202888230,LISP 5A,A00,507541,Munoz Sanchez; Alicia,11,0,20,9
1714202889257,LISP 5B,A00,507671,Munoz Sanchez; Alicia,9,0,20,11
1714202890288,LISP 5C,A00,507696,Munoz Sanchez; Alicia,9,0,20,11
1714202891317,MAE 197,001,528363,Boechler; Nicholas Sebastia,9998,0,9999,1
1714202892347,MATH 197,001,523477,Kedlaya; Kiran S.,9996,0,9999,3
1714202892347,MATH 197,002,563811,Zhang; Danna,9995,0,9999,4
1714202892347,MATH 197,003,628552,Dumitriu; Ioana,9998,0,9999,1
1714202893375,MCWP 40R,A00,518780,Staff,5,0,20,15
1714202893375,MCWP 40R,B00,518781,Staff,7,0,20,13
1714202893375,MCWP 40R,C00,518783,Staff,5,0,20,15
1714202894407,MCWP 50R,A00,518791,Staff,0,0,20,20
1714202894407,MCWP 50R,B00,518792,Staff,0,1,20,20
1714202894407,MCWP 50R,C00,518793,Staff,0,1,20,20
1714202894407,MCWP 50R,D00,518794,Staff,0,0,20,20
1714202894407,MCWP 50R,E00,518795,Staff,0,1,20,20
1714202894407,MCWP 50R,F00,518796,Staff,0,0,20,20
1714202894407,MCWP 50R,G00,518797,Staff,0,1,20,20
1714202895433,MMW 12R,A01,514034,Herbst; Matthew,0,1,16,16
1714202895433,MMW 12R,A02,514035,Herbst; Matthew,2,0,16,14
1714202896459,MMW 13R,A01,514037,Staff,0,4,16,16
1714202896459,MMW 13R,A02,514039,Staff,0,2,16,16
1714202896459,MMW 13R,A03,628519,Staff,0,2,16,16
1714202898510,SIO 295LS,A00,523233,Staff,13,0,30,17
1714202899537,SIO 295S,A00,523232,Staff,13,0,30,17
1714202900567,SIOC 290S,A01,637330,Merrifield; Mark A,28,0,30,2
1714202901593,SIOC 291S,A01,637333,Gabriel; Corey John,28,0,30,2
1714202902621,SOCI 117,A01,494376,Staff,0,2,5,5
1714202903651,WES 237B,A00,494380,Staff,9,0,20,11
1714202905792,AESE 279B,A00,494370,Wade; Jon P,0,0,33,33
1714202906823,AIP 197,001,627712,Vespa; Emanuel Ignacio,9998,0,9999,1
1714202907854,ANAR 135S,A00,494369,Braswell; Geoffrey E.,0,0,0,0
1714202908882,BENG 196,001,628496,Engler; Adam J.,9998,0,9999,1
1714202909910,CAT 124RS,A01,519847,Geibel; William,0,0,20,20
1714202910944,CAT 125RS,A01,515971,Geibel; William,0,0,20,20
1714202911978,CLRE 250,A00,511389,Morris; Sheldon,9993,0,9999,6
1714202913007,CLRE 251,A00,507176,Mehta; Ravindra L.,9993,0,9999,6
1714202913007,CLRE 251,B00,511410,Mehta; Ravindra L.,9998,0,9999,1
1714202914038,CLRE 252,A00,507189,Cuomo; Raphael Eduardo,9995,0,9999,4
1714202915067,CLRE 253,A00,507199,Vaida; Florin,9994,0,9999,5
1714202915067,CLRE 253,B00,507202,Vaida; Florin,9999,0,9999,0
1714202916092,CLRE 259,A00,507211,Patel; Hemal,9996,0,9999,3
1714202917119,CLRE 260,A00,507221,Cuomo; Raphael Eduardo,9999,0,9999,0
1714202918151,CLRE 297,001,507242,Cuomo; Raphael Eduardo,9999,0,9999,0
1714202919182,COGS 197,001,638244,Voytek; Bradley Thomas,9999,0,9999,0
1714202920208,CSE 191,A00,516875,Minnes Kemp; Mor Mia,9993,0,9999,6
1714202921240,CSE 197,001,637388,Minnes Kemp; Mor Mia,9998,0,9999,1
1714202922275,CSS 201S,A01,494383,Staff,35,0,35,0
1714202923302,CSS 202S,A01,494387,Staff,35,0,35,0
1714202924330,DSC 197,001,628532,Eldridge; Justin Matthew,9996,0,9999,3
1714202925363,EAP 100,A00,516065,Staff,9797,0,9999,202
1714202926396,ECE 45,A01,507414,Staff,33,0,60,27
1714202928456,ECE 111,A01,507420,Staff,21,0,50,29
1714202929486,ECE 197,001,548057,Sievenpiper; Daniel F.,9994,0,9999,5
1714202930512,EDS 115,A00,507243,Choi; Bailey Miyeon,12,0,28,16
1714202931544,EDS 117,A01,494379,Staff,0,1,30,30
1714202932581,EDS 125,A00,507246,Hopkins; Megan Beth,12,0,30,18
1714202933612,EDS 128A,A01,507264,Fargason; Sharon Gayle,14,0,26,12
1714202934637,EDS 128B,A01,507293,Pappas; Elizabeth,18,0,30,12
1714202935664,EDS 139,A00,507294,Fargason; Sharon Gayle,18,0,30,12
1714202935664,EDS 139,B00,507313,Pappas; Elizabeth,15,0,30,15
1714202936691,EDS 201,A00,507315,Staff,13,0,30,17
1714202937722,EDS 203,A01,507317,Halter; Christopher P.,12,0,30,18
1714202938755,EDS 204R,A01,507319,Halter; Christopher P.,0,3,30,30
1714202938755,EDS 204R,B01,507331,Heinzman; Erica M.,17,0,30,13
1714202939787,EDS 206R,A00,507332,Staff,0,4,30,30
1714202939787,EDS 206R,B00,507343,Staff,18,0,30,12
1714202940821,EDS 250,A00,507344,Hemans; Patricia Ann Benitez,22,0,40,18
1714202941857,EDS 281,A00,507345,Daly; Alan J.,18,0,18,0
1714202942884,EDS 284,A00,507350,Daly; Alan J.,16,0,16,0
1714202943914,EDS 286,A00,507359,Fine; Sarah,18,0,18,0
1714202944941,EDS 289C,A01,507361,Daly; Alan J.,18,0,18,0
1714202945966,EDS 290,A00,507366,Hofstetter; Carolyn,15,0,15,0
1714202946996,LIGM 5A,A00,507421,Fischer-Grunski; Eva K,18,0,20,2
1714202948025,LIGM 5B,A00,507423,Fischer-Grunski; Eva K,19,0,20,1
1714202949051,LIGM 5C,A00,507425,Fischer-Grunski; Eva K,19,0,20,1
1714202950078,LIIT 5AS,A00,507427,Carnelos; Chiara,20,0,20,0
1714202951106,LIIT 5BS,A00,507430,Carnelos; Chiara,20,0,20,0
1714202952135,LIIT 5CS,A00,507432,Carnelos; Chiara,20,0,20,0
1714202953168,LISP 5A,A00,507541,Munoz Sanchez; Alicia,11,0,20,9
1714202954196,LISP 5B,A00,507671,Munoz Sanchez; Alicia,9,0,20,11
1714202955224,LISP 5C,A00,507696,Munoz Sanchez; Alicia,9,0,20,11
1714202956261,MAE 197,001,528363,Boechler; Nicholas Sebastia,9998,0,9999,1
1714202957294,MATH 197,001,523477,Kedlaya; Kiran S.,9996,0,9999,3
1714202957294,MATH 197,002,563811,Zhang; Danna,9995,0,9999,4
1714202957294,MATH 197,003,628552,Dumitriu; Ioana,9998,0,9999,1
1714202958323,MCWP 40R,A00,518780,Staff,5,0,20,15
1714202958323,MCWP 40R,B00,518781,Staff,7,0,20,13
1714202958323,MCWP 40R,C00,518783,Staff,5,0,20,15
1714202959350,MCWP 50R,A00,518791,Staff,0,0,20,20
1714202959350,MCWP 50R,B00,518792,Staff,0,1,20,20
1714202959350,MCWP 50R,C00,518793,Staff,0,1,20,20
1714202959350,MCWP 50R,D00,518794,Staff,0,0,20,20
1714202959350,MCWP 50R,E00,518795,Staff,0,1,20,20
1714202959350,MCWP 50R,F00,518796,Staff,0,0,20,20
1714202959350,MCWP 50R,G00,518797,Staff,0,1,20,20
1714202960379,MMW 12R,A01,514034,Herbst; Matthew,0,1,16,16
1714202960379,MMW 12R,A02,514035,Herbst; Matthew,2,0,16,14
1714202961409,MMW 13R,A01,514037,Staff,0,4,16,16
1714202961409,MMW 13R,A02,514039,Staff,0,2,16,16
1714202961409,MMW 13R,A03,628519,Staff,0,2,16,16
1714202963462,SIO 295LS,A00,523233,Staff,13,0,30,17
1714202964492,SIO 295S,A00,523232,Staff,13,0,30,17
1714202965529,SIOC 290S,A01,637330,Merrifield; Mark A,28,0,30,2
1714202966563,SIOC 291S,A01,637333,Gabriel; Corey John,28,0,30,2
1714202967591,SOCI 117,A01,494376,Staff,0,2,5,5
1714202968620,WES 237B,A00,494380,Staff,9,0,20,11
1714202970696,AESE 279B,A00,494370,Wade; Jon P,0,0,33,33
1714202971725,AIP 197,001,627712,Vespa; Emanuel Ignacio,9998,0,9999,1
1714202972752,ANAR 135S,A00,494369,Braswell; Geoffrey E.,0,0,0,0
1714202973787,BENG 196,001,628496,Engler; Adam J.,9998,0,9999,1
1714202974815,CAT 124RS,A01,519847,Geibel; William,0,0,20,20
1714202975845,CAT 125RS,A01,515971,Geibel; William,0,0,20,20
1714202976876,CLRE 250,A00,511389,Morris; Sheldon,9993,0,9999,6
1714202977907,CLRE 251,A00,507176,Mehta; Ravindra L.,9993,0,9999,6
1714202977907,CLRE 251,B00,511410,Mehta; Ravindra L.,9998,0,9999,1
1714202978934,CLRE 252,A00,507189,Cuomo; Raphael Eduardo,9995,0,9999,4
1714202979960,CLRE 253,A00,507199,Vaida; Florin,9994,0,9999,5
1714202979960,CLRE 253,B00,507202,Vaida; Florin,9999,0,9999,0
1714202980989,CLRE 259,A00,507211,Patel; Hemal,9996,0,9999,3
1714202982017,CLRE 260,A00,507221,Cuomo; Raphael Eduardo,9999,0,9999,0
1714202983043,CLRE 297,001,507242,Cuomo; Raphael Eduardo,9999,0,9999,0
1714202984069,COGS 197,001,638244,Voytek; Bradley Thomas,9999,0,9999,0
1714202985095,CSE 191,A00,516875,Minnes Kemp; Mor Mia,9993,0,9999,6
1714202986124,CSE 197,001,637388,Minnes Kemp; Mor Mia,9998,0,9999,1
1714202987157,CSS 201S,A01,494383,Staff,35,0,35,0
1714202988187,CSS 202S,A01,494387,Staff,35,0,35,0
1714202989218,DSC 197,001,628532,Eldridge; Justin Matthew,9996,0,9999,3
1714202990246,EAP 100,A00,516065,Staff,9797,0,9999,202
1714202991290,ECE 45,A01,507414,Staff,33,0,60,27
1714202993347,ECE 111,A01,507420,Staff,21,0,50,29
1714202994379,ECE 197,001,548057,Sievenpiper; Daniel F.,9994,0,9999,5
1714202995406,EDS 115,A00,507243,Choi; Bailey Miyeon,12,0,28,16
1714202996439,EDS 117,A01,494379,Staff,0,1,30,30
1714202997472,EDS 125,A00,507246,Hopkins; Megan Beth,12,0,30,18
1714202998504,EDS 128A,A01,507264,Fargason; Sharon Gayle,14,0,26,12
1714202999530,EDS 128B,A01,507293,Pappas; Elizabeth,18,0,30,12
1714203000560,EDS 139,A00,507294,Fargason; Sharon Gayle,18,0,30,12
1714203000560,EDS 139,B00,507313,Pappas; Elizabeth,15,0,30,15
1714203001587,EDS 201,A00,507315,Staff,13,0,30,17
1714203002614,EDS 203,A01,507317,Halter; Christopher P.,12,0,30,18
1714203003640,EDS 204R,A01,507319,Halter; Christopher P.,0,3,30,30
1714203003640,EDS 204R,B01,507331,Heinzman; Erica M.,17,0,30,13
1714203004669,EDS 206R,A00,507332,Staff,0,4,30,30
1714203004669,EDS 206R,B00,507343,Staff,18,0,30,12
1714203005700,EDS 250,A00,507344,Hemans; Patricia Ann Benitez,22,0,40,18
1714203006724,EDS 281,A00,507345,Daly; Alan J.,18,0,18,0
1714203007748,EDS 284,A00,507350,Daly; Alan J.,16,0,16,0
1714203008777,EDS 286,A00,507359,Fine; Sarah,18,0,18,0
1714203009858,EDS 289C,A01,507361,Daly; Alan J.,18,0,18,0
1714203010888,EDS 290,A00,507366,Hofstetter; Carolyn,15,0,15,0
1714203011916,LIGM 5A,A00,507421,Fischer-Grunski; Eva K,18,0,20,2
1714203012943,LIGM 5B,A00,507423,Fischer-Grunski; Eva K,19,0,20,1
1714203013968,LIGM 5C,A00,507425,Fischer-Grunski; Eva K,19,0,20,1
1714203014994,LIIT 5AS,A00,507427,Carnelos; Chiara,20,0,20,0
1714203016024,LIIT 5BS,A00,507430,Carnelos; Chiara,20,0,20,0
1714203017050,LIIT 5CS,A00,507432,Carnelos; Chiara,20,0,20,0
1714203018078,LISP 5A,A00,507541,Munoz Sanchez; Alicia,11,0,20,9
1714203019107,LISP 5B,A00,507671,Munoz Sanchez; Alicia,9,0,20,11
1714203020134,LISP 5C,A00,507696,Munoz Sanchez; Alicia,9,0,20,11
1714203021163,MAE 197,001,528363,Boechler; Nicholas Sebastia,9998,0,9999,1
1714203022192,MATH 197,001,523477,Kedlaya; Kiran S.,9996,0,9999,3
1714203022192,MATH 197,002,563811,Zhang; Danna,9995,0,9999,4
1714203022192,MATH 197,003,628552,Dumitriu; Ioana,9998,0,9999,1
1714203023218,MCWP 40R,A00,518780,Staff,5,0,20,15
1714203023218,MCWP 40R,B00,518781,Staff,7,0,20,13
1714203023218,MCWP 40R,C00,518783,Staff,5,0,20,15
1714203024249,MCWP 50R,A00,518791,Staff,0,0,20,20
1714203024249,MCWP 50R,B00,518792,Staff,0,1,20,20
1714203024249,MCWP 50R,C00,518793,Staff,0,1,20,20
1714203024249,MCWP 50R,D00,518794,Staff,0,0,20,20
1714203024249,MCWP 50R,E00,518795,Staff,0,1,20,20
1714203024249,MCWP 50R,F00,518796,Staff,0,0,20,20
1714203024249,MCWP 50R,G00,518797,Staff,0,1,20,20
1714203025277,MMW 12R,A01,514034,Herbst; Matthew,0,1,16,16
1714203025277,MMW 12R,A02,514035,Herbst; Matthew,2,0,16,14
1714203026305,MMW 13R,A01,514037,Staff,0,4,16,16
1714203026305,MMW 13R,A02,514039,Staff,0,2,16,16
1714203026305,MMW 13R,A03,628519,Staff,0,2,16,16
1714203028359,SIO 295LS,A00,523233,Staff,13,0,30,17
1714203029387,SIO 295S,A00,523232,Staff,13,0,30,17
1714203030420,SIOC 290S,A01,637330,Merrifield; Mark A,28,0,30,2
1714203031447,SIOC 291S,A01,637333,Gabriel; Corey John,28,0,30,2
1714203032474,SOCI 117,A01,494376,Staff,0,2,5,5
1714203033498,WES 237B,A00,494380,Staff,9,0,20,11
1714203035581,AESE 279B,A00,494370,Wade; Jon P,0,0,33,33
1714203036607,AIP 197,001,627712,Vespa; Emanuel Ignacio,9998,0,9999,1
1714203037637,ANAR 135S,A00,494369,Braswell; Geoffrey E.,0,0,0,0
1714203038663,BENG 196,001,628496,Engler; Adam J.,9998,0,9999,1
1714203039694,CAT 124RS,A01,519847,Geibel; William,0,0,20,20
1714203040726,CAT 125RS,A01,515971,Geibel; William,0,0,20,20
1714203041757,CLRE 250,A00,511389,Morris; Sheldon,9993,0,9999,6
1714203042784,CLRE 251,A00,507176,Mehta; Ravindra L.,9993,0,9999,6
1714203042784,CLRE 251,B00,511410,Mehta; Ravindra L.,9998,0,9999,1
1714203043810,CLRE 252,A00,507189,Cuomo; Raphael Eduardo,9995,0,9999,4
1714203044841,CLRE 253,A00,507199,Vaida; Florin,9994,0,9999,5
1714203044841,CLRE 253,B00,507202,Vaida; Florin,9999,0,9999,0
1714203045868,CLRE 259,A00,507211,Patel; Hemal,9996,0,9999,3
1714203046896,CLRE 260,A00,507221,Cuomo; Raphael Eduardo,9999,0,9999,0
1714203047928,CLRE 297,001,507242,Cuomo; Raphael Eduardo,9999,0,9999,0
1714203048957,COGS 197,001,638244,Voytek; Bradley Thomas,9999,0,9999,0
1714203049986,CSE 191,A00,516875,Minnes Kemp; Mor Mia,9993,0,9999,6
1714203051010,CSE 197,001,637388,Minnes Kemp; Mor Mia,9998,0,9999,1
1714203052041,CSS 201S,A01,494383,Staff,35,0,35,0
1714203053073,CSS 202S,A01,494387,Staff,35,0,35,0
1714203054100,DSC 197,001,628532,Eldridge; Justin Matthew,9996,0,9999,3
1714203055130,EAP 100,A00,516065,Staff,9797,0,9999,202
1714203056154,ECE 45,A01,507414,Staff,33,0,60,27
1714203058208,ECE 111,A01,507420,Staff,21,0,50,29
1714203059234,ECE 197,001,548057,Sievenpiper; Daniel F.,9994,0,9999,5
1714203060289,EDS 115,A00,507243,Choi; Bailey Miyeon,12,0,28,16
1714203061323,EDS 117,A01,494379,Staff,0,1,30,30
1714203062351,EDS 125,A00,507246,Hopkins; Megan Beth,12,0,30,18
1714203063378,EDS 128A,A01,507264,Fargason; Sharon Gayle,14,0,26,12
1714203064407,EDS 128B,A01,507293,Pappas; Elizabeth,18,0,30,12
1714203065439,EDS 139,A00,507294,Fargason; Sharon Gayle,18,0,30,12
1714203065439,EDS 139,B00,507313,Pappas; Elizabeth,15,0,30,15
1714203066466,EDS 201,A00,507315,Staff,13,0,30,17
1714203067493,EDS 203,A01,507317,Halter; Christopher P.,12,0,30,18
1714203068529,EDS 204R,A01,507319,Halter; Christopher P.,0,3,30,30
1714203068529,EDS 204R,B01,507331,Heinzman; Erica M.,17,0,30,13
1714203069557,EDS 206R,A00,507332,Staff,0,4,30,30
1714203069557,EDS 206R,B00,507343,Staff,18,0,30,12
1714203070588,EDS 250,A00,507344,Hemans; Patricia Ann Benitez,22,0,40,18
1714203071615,EDS 281,A00,507345,Daly; Alan J.,18,0,18,0
1714203072639,EDS 284,A00,507350,Daly; Alan J.,16,0,16,0
1714203073664,EDS 286,A00,507359,Fine; Sarah,18,0,18,0
1714203074690,EDS 289C,A01,507361,Daly; Alan J.,18,0,18,0
1714203075721,EDS 290,A00,507366,Hofstetter; Carolyn,15,0,15,0
1714203076747,LIGM 5A,A00,507421,Fischer-Grunski; Eva K,18,0,20,2
1714203077772,LIGM 5B,A00,507423,Fischer-Grunski; Eva K,19,0,20,1
1714203078803,LIGM 5C,A00,507425,Fischer-Grunski; Eva K,19,0,20,1
1714203079830,LIIT 5AS,A00,507427,Carnelos; Chiara,20,0,20,0
1714203080856,LIIT 5BS,A00,507430,Carnelos; Chiara,20,0,20,0
1714203081882,LIIT 5CS,A00,507432,Carnelos; Chiara,20,0,20,0
1714203082912,LISP 5A,A00,507541,Munoz Sanchez; Alicia,11,0,20,9
1714203083942,LISP 5B,A00,507671,Munoz Sanchez; Alicia,9,0,20,11
1714203084974,LISP 5C,A00,507696,Munoz Sanchez; Alicia,9,0,20,11
1714203086008,MAE 197,001,528363,Boechler; Nicholas Sebastia,9998,0,9999,1
1714203087041,MATH 197,001,523477,Kedlaya; Kiran S.,9996,0,9999,3
1714203087041,MATH 197,002,563811,Zhang; Danna,9995,0,9999,4
1714203087041,MATH 197,003,628552,Dumitriu; Ioana,9998,0,9999,1
1714203088073,MCWP 40R,A00,518780,Staff,5,0,20,15
1714203088073,MCWP 40R,B00,518781,Staff,7,0,20,13
1714203088073,MCWP 40R,C00,518783,Staff,5,0,20,15
1714203089099,MCWP 50R,A00,518791,Staff,0,0,20,20
1714203089099,MCWP 50R,B00,518792,Staff,0,1,20,20
1714203089099,MCWP 50R,C00,518793,Staff,0,1,20,20
1714203089099,MCWP 50R,D00,518794,Staff,0,0,20,20
1714203089099,MCWP 50R,E00,518795,Staff,0,1,20,20
1714203089099,MCWP 50R,F00,518796,Staff,0,0,20,20
1714203089099,MCWP 50R,G00,518797,Staff,0,1,20,20
1714203090128,MMW 12R,A01,514034,Herbst; Matthew,0,1,16,16
1714203090128,MMW 12R,A02,514035,Herbst; Matthew,2,0,16,14
1714203091154,MMW 13R,A01,514037,Staff,0,4,16,16
1714203091154,MMW 13R,A02,514039,Staff,0,2,16,16
1714203091154,MMW 13R,A03,628519,Staff,0,2,16,16
1714203093209,SIO 295LS,A00,523233,Staff,13,0,30,17
1714203094235,SIO 295S,A00,523232,Staff,13,0,30,17
1714203095261,SIOC 290S,A01,637330,Merrifield; Mark A,28,0,30,2
1714203096286,SIOC 291S,A01,637333,Gabriel; Corey John,28,0,30,2
1714203097310,SOCI 117,A01,494376,Staff,0,2,5,5
1714203098337,WES 237B,A00,494380,Staff,9,0,20,11
1714203100402,AESE 279B,A00,494370,Wade; Jon P,0,0,33,33
1714203101429,AIP 197,001,627712,Vespa; Emanuel Ignacio,9998,0,9999,1
1714203102453,ANAR 135S,A00,494369,Braswell; Geoffrey E.,0,0,0,0
1714203103483,BENG 196,001,628496,Engler; Adam J.,9998,0,9999,1
1714203104509,CAT 124RS,A01,519847,Geibel; William,0,0,20,20
1714203105535,CAT 125RS,A01,515971,Geibel; William,0,0,20,20
1714203106566,CLRE 250,A00,511389,Morris; Sheldon,9993,0,9999,6
1714203107600,CLRE 251,A00,507176,Mehta; Ravindra L.,9993,0,9999,6
1714203107600,CLRE 251,B00,511410,Mehta; Ravindra L.,9998,0,9999,1
1714203108629,CLRE 252,A00,507189,Cuomo; Raphael Eduardo,9995,0,9999,4
1714203109655,CLRE 253,A00,507199,Vaida; Florin,9994,0,9999,5
1714203109655,CLRE 253,B00,507202,Vaida; Florin,9999,0,9999,0
1714203110686,CLRE 259,A00,507211,Patel; Hemal,9996,0,9999,3
1714203111716,CLRE 260,A00,507221,Cuomo; Raphael Eduardo,9999,0,9999,0
1714203112748,CLRE 297,001,507242,Cuomo; Raphael Eduardo,9999,0,9999,0
1714203113828,COGS 197,001,638244,Voytek; Bradley Thomas,9999,0,9999,0
1714203114858,CSE 191,A00,516875,Minnes Kemp; Mor Mia,9993,0,9999,6
1714203115885,CSE 197,001,637388,Minnes Kemp; Mor Mia,9998,0,9999,1
1714203116921,CSS 201S,A01,494383,Staff,35,0,35,0
1714203117948,CSS 202S,A01,494387,Staff,35,0,35,0
1714203118975,DSC 197,001,628532,Eldridge; Justin Matthew,9996,0,9999,3
1714203120000,EAP 100,A00,516065,Staff,9797,0,9999,202
1714203121032,ECE 45,A01,507414,Staff,33,0,60,27
1714203123087,ECE 111,A01,507420,Staff,21,0,50,29
1714203124117,ECE 197,001,548057,Sievenpiper; Daniel F.,9994,0,9999,5
1714203125147,EDS 115,A00,507243,Choi; Bailey Miyeon,12,0,28,16
1714203126174,EDS 117,A01,494379,Staff,0,1,30,30
1714203127199,EDS 125,A00,507246,Hopkins; Megan Beth,12,0,30,18
1714203128225,EDS 128A,A01,507264,Fargason; Sharon Gayle,14,0,26,12
1714203129250,EDS 128B,A01,507293,Pappas; Elizabeth,18,0,30,12
1714203130284,EDS 139,A00,507294,Fargason; Sharon Gayle,18,0,30,12
1714203130284,EDS 139,B00,507313,Pappas; Elizabeth,15,0,30,15
1714203131315,EDS 201,A00,507315,Staff,13,0,30,17
1714203132343,EDS 203,A01,507317,Halter; Christopher P.,12,0,30,18
1714203133371,EDS 204R,A01,507319,Halter; Christopher P.,0,3,30,30
1714203133371,EDS 204R,B01,507331,Heinzman; Erica M.,17,0,30,13
1714203134401,EDS 206R,A00,507332,Staff,0,4,30,30
1714203134401,EDS 206R,B00,507343,Staff,18,0,30,12
1714203135433,EDS 250,A00,507344,Hemans; Patricia Ann Benitez,22,0,40,18
1714203136462,EDS 281,A00,507345,Daly; Alan J.,18,0,18,0
1714203137491,EDS 284,A00,507350,Daly; Alan J.,16,0,16,0
1714203138521,EDS 286,A00,507359,Fine; Sarah,18,0,18,0
1714203139547,EDS 289C,A01,507361,Daly; Alan J.,18,0,18,0
1714203140574,EDS 290,A00,507366,Hofstetter; Carolyn,15,0,15,0
1714203141598,LIGM 5A,A00,507421,Fischer-Grunski; Eva K,18,0,20,2
1714203142625,LIGM 5B,A00,507423,Fischer-Grunski; Eva K,19,0,20,1
1714203143651,LIGM 5C,A00,507425,Fischer-Grunski; Eva K,19,0,20,1
1714203144679,LIIT 5AS,A00,507427,Carnelos; Chiara,20,0,20,0
1714203145711,LIIT 5BS,A00,507430,Carnelos; Chiara,20,0,20,0
1714203146738,LIIT 5CS,A00,507432,Carnelos; Chiara,20,0,20,0
1714203147808,LISP 5A,A00,507541,Munoz Sanchez; Alicia,11,0,20,9
1714203148840,LISP 5B,A00,507671,Munoz Sanchez; Alicia,9,0,20,11
1714203149866,LISP 5C,A00,507696,Munoz Sanchez; Alicia,9,0,20,11
1714203150893,MAE 197,001,528363,Boechler; Nicholas Sebastia,9998,0,9999,1
1714203151926,MATH 197,001,523477,Kedlaya; Kiran S.,9996,0,9999,3
1714203151926,MATH 197,002,563811,Zhang; Danna,9995,0,9999,4
1714203151926,MATH 197,003,628552,Dumitriu; Ioana,9998,0,9999,1
1714203152952,MCWP 40R,A00,518780,Staff,5,0,20,15
1714203152952,MCWP 40R,B00,518781,Staff,7,0,20,13
1714203152952,MCWP 40R,C00,518783,Staff,5,0,20,15
1714203153982,MCWP 50R,A00,518791,Staff,0,0,20,20
1714203153982,MCWP 50R,B00,518792,Staff,0,1,20,20
1714203153982,MCWP 50R,C00,518793,Staff,0,1,20,20
1714203153982,MCWP 50R,D00,518794,Staff,0,0,20,20
1714203153982,MCWP 50R,E00,518795,Staff,0,1,20,20
1714203153982,MCWP 50R,F00,518796,Staff,0,0,20,20
1714203153982,MCWP 50R,G00,518797,Staff,0,1,20,20
1714203155012,MMW 12R,A01,514034,Herbst; Matthew,0,1,16,16
1714203155012,MMW 12R,A02,514035,Herbst; Matthew,2,0,16,14
1714203156042,MMW 13R,A01,514037,Staff,0,4,16,16
1714203156042,MMW 13R,A02,514039,Staff,0,2,16,16
1714203156042,MMW 13R,A03,628519,Staff,0,2,16,16
1714203158099,SIO 295LS,A00,523233,Staff,13,0,30,17
1714203159127,SIO 295S,A00,523232,Staff,13,0,30,17
1714203160157,SIOC 290S,A01,637330,Merrifield; Mark A,28,0,30,2
1714203161184,SIOC 291S,A01,637333,Gabriel; Corey John,28,0,30,2
1714203162241,SOCI 117,A01,494376,Staff,0,2,5,5
1714203163270,WES 237B,A00,494380,Staff,9,0,20,11
1714203165363,AESE 279B,A00,494370,Wade; Jon P,0,0,33,33
1714203166389,AIP 197,001,627712,Vespa; Emanuel Ignacio,9998,0,9999,1
1714203167418,ANAR 135S,A00,494369,Braswell; Geoffrey E.,0,0,0,0
1714203168446,BENG 196,001,628496,Engler; Adam J.,9998,0,9999,1
1714203169472,CAT 124RS,A01,519847,Geibel; William,0,0,20,20
1714203170496,CAT 125RS,A01,515971,Geibel; William,0,0,20,20
1714203171523,CLRE 250,A00,511389,Morris; Sheldon,9993,0,9999,6
1714203172551,CLRE 251,A00,507176,Mehta; Ravindra L.,9993,0,9999,6
1714203172551,CLRE 251,B00,511410,Mehta; Ravindra L.,9998,0,9999,1
1714203173577,CLRE 252,A00,507189,Cuomo; Raphael Eduardo,9995,0,9999,4
1714203174608,CLRE 253,A00,507199,Vaida; Florin,9994,0,9999,5
1714203174608,CLRE 253,B00,507202,Vaida; Florin,9999,0,9999,0
1714203175638,CLRE 259,A00,507211,Patel; Hemal,9996,0,9999,3
1714203176664,CLRE 260,A00,507221,Cuomo; Raphael Eduardo,9999,0,9999,0
1714203177689,CLRE 297,001,507242,Cuomo; Raphael Eduardo,9999,0,9999,0
1714203178715,COGS 197,001,638244,Voytek; Bradley Thomas,9999,0,9999,0
1714203179741,CSE 191,A00,516875,Minnes Kemp; Mor Mia,9993,0,9999,6
1714203180770,CSE 197,001,637388,Minnes Kemp; Mor Mia,9998,0,9999,1
1714203181797,CSS 201S,A01,494383,Staff,35,0,35,0
1714203182827,CSS 202S,A01,494387,Staff,35,0,35,0
1714203183853,DSC 197,001,628532,Eldridge; Justin Matthew,9996,0,9999,3
1714203184879,EAP 100,A00,516065,Staff,9797,0,9999,202
1714203185907,ECE 45,A01,507414,Staff,33,0,60,27
1714203187964,ECE 111,A01,507420,Staff,21,0,50,29
1714203188989,ECE 197,001,548057,Sievenpiper; Daniel F.,9994,0,9999,5
1714203190016,EDS 115,A00,507243,Choi; Bailey Miyeon,12,0,28,16
1714203191045,EDS 117,A01,494379,Staff,0,1,30,30
1714203192074,EDS 125,A00,507246,Hopkins; Megan Beth,12,0,30,18
1714203193101,EDS 128A,A01,507264,Fargason; Sharon Gayle,14,0,26,12
1714203194131,EDS 128B,A01,507293,Pappas; Elizabeth,18,0,30,12
1714203195161,EDS 139,A00,507294,Fargason; Sharon Gayle,18,0,30,12
1714203195161,EDS 139,B00,507313,Pappas; Elizabeth,15,0,30,15
1714203196193,EDS 201,A00,507315,Staff,13,0,30,17
1714203197218,EDS 203,A01,507317,Halter; Christopher P.,12,0,30,18
1714203198244,EDS 204R,A01,507319,Halter; Christopher P.,0,3,30,30
1714203198244,EDS 204R,B01,507331,Heinzman; Erica M.,17,0,30,13
1714203199271,EDS 206R,A00,507332,Staff,0,4,30,30
1714203199271,EDS 206R,B00,507343,Staff,18,0,30,12
1714203200296,EDS 250,A00,507344,Hemans; Patricia Ann Benitez,22,0,40,18
1714203201325,EDS 281,A00,507345,Daly; Alan J.,18,0,18,0
1714203202351,EDS 284,A00,507350,Daly; Alan J.,16,0,16,0
1714203203381,EDS 286,A00,507359,Fine; Sarah,18,0,18,0
1714203204406,EDS 289C,A01,507361,Daly; Alan J.,18,0,18,0
1714203205433,EDS 290,A00,507366,Hofstetter; Carolyn,15,0,15,0
1714203206463,LIGM 5A,A00,507421,Fischer-Grunski; Eva K,18,0,20,2
1714203207490,LIGM 5B,A00,507423,Fischer-Grunski; Eva K,19,0,20,1
1714203208518,LIGM 5C,A00,507425,Fischer-Grunski; Eva K,19,0,20,1
1714203209547,LIIT 5AS,A00,507427,Carnelos; Chiara,20,0,20,0
1714203210576,LIIT 5BS,A00,507430,Carnelos; Chiara,20,0,20,0
1714203211602,LIIT 5CS,A00,507432,Carnelos; Chiara,20,0,20,0
1714203212630,LISP 5A,A00,507541,Munoz Sanchez; Alicia,11,0,20,9
1714203213656,LISP 5B,A00,507671,Munoz Sanchez; Alicia,9,0,20,11
1714203214685,LISP 5C,A00,507696,Munoz Sanchez; Alicia,9,0,20,11
1714203215716,MAE 197,001,528363,Boechler; Nicholas Sebastia,9998,0,9999,1
1714203216744,MATH 197,001,523477,Kedlaya; Kiran S.,9996,0,9999,3
1714203216744,MATH 197,002,563811,Zhang; Danna,9995,0,9999,4
1714203216744,MATH 197,003,628552,Dumitriu; Ioana,9998,0,9999,1
1714203217825,MCWP 40R,A00,518780,Staff,5,0,20,15
1714203217825,MCWP 40R,B00,518781,Staff,7,0,20,13
1714203217825,MCWP 40R,C00,518783,Staff,5,0,20,15
1714203218852,MCWP 50R,A00,518791,Staff,0,0,20,20
1714203218852,MCWP 50R,B00,518792,Staff,0,1,20,20
1714203218852,MCWP 50R,C00,518793,Staff,0,1,20,20
1714203218852,MCWP 50R,D00,518794,Staff,0,0,20,20
1714203218852,MCWP 50R,E00,518795,Staff,0,1,20,20
1714203218852,MCWP 50R,F00,518796,Staff,0,0,20,20
1714203218852,MCWP 50R,G00,518797,Staff,0,1,20,20
1714203219877,MMW 12R,A01,514034,Herbst; Matthew,0,1,16,16
1714203219877,MMW 12R,A02,514035,Herbst; Matthew,2,0,16,14
1714203220904,MMW 13R,A01,514037,Staff,0,4,16,16
1714203220904,MMW 13R,A02,514039,Staff,0,2,16,16
1714203220904,MMW 13R,A03,628519,Staff,0,2,16,16
1714203222959,SIO 295LS,A00,523233,Staff,13,0,30,17
1714203223989,SIO 295S,A00,523232,Staff,13,0,30,17
1714203225020,SIOC 290S,A01,637330,Merrifield; Mark A,28,0,30,2
1714203226047,SIOC 291S,A01,637333,Gabriel; Corey John,28,0,30,2
1714203227072,SOCI 117,A01,494376,Staff,0,2,5,5
1714203228097,WES 237B,A00,494380,Staff,9,0,20,11
1714203230184,AESE 279B,A00,494370,Wade; Jon P,0,0,33,33
1714203231209,AIP 197,001,627712,Vespa; Emanuel Ignacio,9998,0,9999,1
1714203232236,ANAR 135S,A00,494369,Braswell; Geoffrey E.,0,0,0,0
1714203233260,BENG 196,001,628496,Engler; Adam J.,9998,0,9999,1
1714203234285,CAT 124RS,A01,519847,Geibel; William,0,0,20,20
1714203235312,CAT 125RS,A01,515971,Geibel; William,0,0,20,20
1714203236341,CLRE 250,A00,511389,Morris; Sheldon,9993,0,9999,6
1714203237366,CLRE 251,A00,507176,Mehta; Ravindra L.,9993,0,9999,6
1714203237366,CLRE 251,B00,511410,Mehta; Ravindra L.,9998,0,9999,1
1714203238391,CLRE 252,A00,507189,Cuomo; Raphael Eduardo,9995,0,9999,4
1714203239420,CLRE 253,A00,507199,Vaida; Florin,9994,0,9999,5
1714203239420,CLRE 253,B00,507202,Vaida; Florin,9999,0,9999,0
1714203240446,CLRE 259,A00,507211,Patel; Hemal,9996,0,9999,3
1714203241473,CLRE 260,A00,507221,Cuomo; Raphael Eduardo,9999,0,9999,0
1714203242501,CLRE 297,001,507242,Cuomo; Raphael Eduardo,9999,0,9999,0
1714203243530,COGS 197,001,638244,Voytek; Bradley Thomas,9999,0,9999,0
1714203244556,CSE 191,A00,516875,Minnes Kemp; Mor Mia,9993,0,9999,6
1714203245580,CSE 197,001,637388,Minnes Kemp; Mor Mia,9998,0,9999,1
1714203246607,CSS 201S,A01,494383,Staff,35,0,35,0
1714203247633,CSS 202S,A01,494387,Staff,35,0,35,0
1714203248663,DSC 197,001,628532,Eldridge; Justin Matthew,9996,0,9999,3
1714203249690,EAP 100,A00,516065,Staff,9797,0,9999,202
1714203250717,ECE 45,A01,507414,Staff,33,0,60,27
1714203252778,ECE 111,A01,507420,Staff,21,0,50,29
1714203253804,ECE 197,001,548057,Sievenpiper; Daniel F.,9994,0,9999,5
1714203254836,EDS 115,A00,507243,Choi; Bailey Miyeon,12,0,28,16
1714203255865,EDS 117,A01,494379,Staff,0,1,30,30
1714203256895,EDS 125,A00,507246,Hopkins; Megan Beth,12,0,30,18
1714203257921,EDS 128A,A01,507264,Fargason; Sharon Gayle,14,0,26,12
1714203258952,EDS 128B,A01,507293,Pappas; Elizabeth,18,0,30,12
1714203259982,EDS 139,A00,507294,Fargason; Sharon Gayle,18,0,30,12
1714203259982,EDS 139,B00,507313,Pappas; Elizabeth,15,0,30,15
1714203261008,EDS 201,A00,507315,Staff,13,0,30,17
1714203262034,EDS 203,A01,507317,Halter; Christopher P.,12,0,30,18
1714203263061,EDS 204R,A01,507319,Halter; Christopher P.,0,3,30,30
1714203263061,EDS 204R,B01,507331,Heinzman; Erica M.,17,0,30,13
1714203264086,EDS 206R,A00,507332,Staff,0,4,30,30
1714203264086,EDS 206R,B00,507343,Staff,18,0,30,12
1714203265115,EDS 250,A00,507344,Hemans; Patricia Ann Benitez,22,0,40,18
1714203266141,EDS 281,A00,507345,Daly; Alan J.,18,0,18,0
1714203267166,EDS 284,A00,507350,Daly; Alan J.,16,0,16,0
1714203268195,EDS 286,A00,507359,Fine; Sarah,18,0,18,0
1714203269221,EDS 289C,A01,507361,Daly; Alan J.,18,0,18,0
1714203270250,EDS 290,A00,507366,Hofstetter; Carolyn,15,0,15,0
1714203271277,LIGM 5A,A00,507421,Fischer-Grunski; Eva K,18,0,20,2
1714203272307,LIGM 5B,A00,507423,Fischer-Grunski; Eva K,19,0,20,1
1714203273332,LIGM 5C,A00,507425,Fischer-Grunski; Eva K,19,0,20,1
1714203274361,LIIT 5AS,A00,507427,Carnelos; Chiara,20,0,20,0
1714203275386,LIIT 5BS,A00,507430,Carnelos; Chiara,20,0,20,0
1714203276417,LIIT 5CS,A00,507432,Carnelos; Chiara,20,0,20,0
1714203277452,LISP 5A,A00,507541,Munoz Sanchez; Alicia,11,0,20,9
1714203278478,LISP 5B,A00,507671,Munoz Sanchez; Alicia,9,0,20,11
1714203279504,LISP 5C,A00,507696,Munoz Sanchez; Alicia,9,0,20,11
1714203280534,MAE 197,001,528363,Boechler; Nicholas Sebastia,9998,0,9999,1
1714203281563,MATH 197,001,523477,Kedlaya; Kiran S.,9996,0,9999,3
1714203281563,MATH 197,002,563811,Zhang; Danna,9995,0,9999,4
1714203281563,MATH 197,003,628552,Dumitriu; Ioana,9998,0,9999,1
1714203282590,MCWP 40R,A00,518780,Staff,5,0,20,15
1714203282590,MCWP 40R,B00,518781,Staff,7,0,20,13
1714203282590,MCWP 40R,C00,518783,Staff,5,0,20,15
1714203283616,MCWP 50R,A00,518791,Staff,0,0,20,20
1714203283616,MCWP 50R,B00,518792,Staff,0,1,20,20
1714203283616,MCWP 50R,C00,518793,Staff,0,1,20,20
1714203283616,MCWP 50R,D00,518794,Staff,0,0,20,20
1714203283616,MCWP 50R,E00,518795,Staff,0,1,20,20
1714203283616,MCWP 50R,F00,518796,Staff,0,0,20,20
1714203283616,MCWP 50R,G00,518797,Staff,0,1,20,20
1714203284643,MMW 12R,A01,514034,Herbst; Matthew,0,1,16,16
1714203284643,MMW 12R,A02,514035,Herbst; Matthew,2,0,16,14
1714203285670,MMW 13R,A01,514037,Staff,0,4,16,16
1714203285670,MMW 13R,A02,514039,Staff,0,2,16,16
1714203285670,MMW 13R,A03,628519,Staff,0,2,16,16
1714203287724,SIO 295LS,A00,523233,Staff,13,0,30,17
1714203288750,SIO 295S,A00,523232,Staff,13,0,30,17
1714203289779,SIOC 290S,A01,637330,Merrifield; Mark A,28,0,30,2
1714203290806,SIOC 291S,A01,637333,Gabriel; Corey John,28,0,30,2
1714203291835,SOCI 117,A01,494376,Staff,0,2,5,5
1714203292861,WES 237B,A00,494380,Staff,9,0,20,11
1714203294960,AESE 279B,A00,494370,Wade; Jon P,0,0,33,33
1714203295987,AIP 197,001,627712,Vespa; Emanuel Ignacio,9998,0,9999,1
1714203297018,ANAR 135S,A00,494369,Braswell; Geoffrey E.,0,0,0,0
1714203298047,BENG 196,001,628496,Engler; Adam J.,9998,0,9999,1
1714203299077,CAT 124RS,A01,519847,Geibel; William,0,0,20,20
1714203300115,CAT 125RS,A01,515971,Geibel; William,0,0,20,20
1714203301141,CLRE 250,A00,511389,Morris; Sheldon,9993,0,9999,6
1714203302173,CLRE 251,A00,507176,Mehta; Ravindra L.,9993,0,9999,6
1714203302173,CLRE 251,B00,511410,Mehta; Ravindra L.,9998,0,9999,1
1714203303200,CLRE 252,A00,507189,Cuomo; Raphael Eduardo,9995,0,9999,4
1714203304230,CLRE 253,A00,507199,Vaida; Florin,9994,0,9999,5
1714203304230,CLRE 253,B00,507202,Vaida; Florin,9999,0,9999,0
1714203305258,CLRE 259,A00,507211,Patel; Hemal,9996,0,9999,3
1714203306287,CLRE 260,A00,507221,Cuomo; Raphael Eduardo,9999,0,9999,0
1714203307319,CLRE 297,001,507242,Cuomo; Raphael Eduardo,9999,0,9999,0
1714203308348,COGS 197,001,638244,Voytek; Bradley Thomas,9999,0,9999,0
1714203309377,CSE 191,A00,516875,Minnes Kemp; Mor Mia,9993,0,9999,6
1714203310404,CSE 197,001,637388,Minnes Kemp; Mor Mia,9998,0,9999,1
1714203311430,CSS 201S,A01,494383,Staff,35,0,35,0
1714203312457,CSS 202S,A01,494387,Staff,35,0,35,0
1714203313484,DSC 197,001,628532,Eldridge; Justin Matthew,9996,0,9999,3
1714203314511,EAP 100,A00,516065,Staff,9797,0,9999,202
1714203315538,ECE 45,A01,507414,Staff,33,0,60,27
1714203317599,ECE 111,A01,507420,Staff,21,0,50,29
1714203318630,ECE 197,001,548057,Sievenpiper; Daniel F.,9994,0,9999,5
1714203319662,EDS 115,A00,507243,Choi; Bailey Miyeon,12,0,28,16
1714203320693,EDS 117,A01,494379,Staff,0,1,30,30
1714203321776,EDS 125,A00,507246,Hopkins; Megan Beth,12,0,30,18
1714203322803,EDS 128A,A01,507264,Fargason; Sharon Gayle,14,0,26,12
1714203323831,EDS 128B,A01,507293,Pappas; Elizabeth,18,0,30,12
1714203324859,EDS 139,A00,507294,Fargason; Sharon Gayle,18,0,30,12
1714203324859,EDS 139,B00,507313,Pappas; Elizabeth,15,0,30,15
1714203325889,EDS 201,A00,507315,Staff,13,0,30,17
1714203326922,EDS 203,A01,507317,Halter; Christopher P.,12,0,30,18
1714203327949,EDS 204R,A01,507319,Halter; Christopher P.,0,3,30,30
1714203327949,EDS 204R,B01,507331,Heinzman; Erica M.,17,0,30,13
1714203328976,EDS 206R,A00,507332,Staff,0,4,30,30
1714203328976,EDS 206R,B00,507343,Staff,18,0,30,12
1714203330006,EDS 250,A00,507344,Hemans; Patricia Ann Benitez,22,0,40,18
1714203331032,EDS 281,A00,507345,Daly; Alan J.,18,0,18,0
1714203332058,EDS 284,A00,507350,Daly; Alan J.,16,0,16,0
1714203333083,EDS 286,A00,507359,Fine; Sarah,18,0,18,0
1714203334110,EDS 289C,A01,507361,Daly; Alan J.,18,0,18,0
1714203335137,EDS 290,A00,507366,Hofstetter; Carolyn,15,0,15,0
1714203336167,LIGM 5A,A00,507421,Fischer-Grunski; Eva K,18,0,20,2
1714203337197,LIGM 5B,A00,507423,Fischer-Grunski; Eva K,19,0,20,1
1714203338225,LIGM 5C,A00,507425,Fischer-Grunski; Eva K,19,0,20,1
1714203339254,LIIT 5AS,A00,507427,Carnelos; Chiara,20,0,20,0
1714203340280,LIIT 5BS,A00,507430,Carnelos; Chiara,20,0,20,0
1714203341307,LIIT 5CS,A00,507432,Carnelos; Chiara,20,0,20,0
1714203342331,LISP 5A,A00,507541,Munoz Sanchez; Alicia,11,0,20,9
1714203343358,LISP 5B,A00,507671,Munoz Sanchez; Alicia,9,0,20,11
1714203344387,LISP 5C,A00,507696,Munoz Sanchez; Alicia,9,0,20,11
1714203345417,MAE 197,001,528363,Boechler; Nicholas Sebastia,9998,0,9999,1
1714203346452,MATH 197,001,523477,Kedlaya; Kiran S.,9996,0,9999,3
1714203346452,MATH 197,002,563811,Zhang; Danna,9995,0,9999,4
1714203346452,MATH 197,003,628552,Dumitriu; Ioana,9998,0,9999,1
1714203347481,MCWP 40R,A00,518780,Staff,5,0,20,15
1714203347481,MCWP 40R,B00,518781,Staff,7,0,20,13
1714203347481,MCWP 40R,C00,518783,Staff,5,0,20,15
1714203348715,MCWP 50R,A00,518791,Staff,0,0,20,20
1714203348715,MCWP 50R,B00,518792,Staff,0,1,20,20
1714203348715,MCWP 50R,C00,518793,Staff,0,1,20,20
1714203348715,MCWP 50R,D00,518794,Staff,0,0,20,20
1714203348715,MCWP 50R,E00,518795,Staff,0,1,20,20
1714203348715,MCWP 50R,F00,518796,Staff,0,0,20,20
1714203348715,MCWP 50R,G00,518797,Staff,0,1,20,20
1714203349743,MMW 12R,A01,514034,Herbst; Matthew,0,1,16,16
1714203349743,MMW 12R,A02,514035,Herbst; Matthew,2,0,16,14
1714203350769,MMW 13R,A01,514037,Staff,0,4,16,16
1714203350769,MMW 13R,A02,514039,Staff,0,2,16,16
1714203350769,MMW 13R,A03,628519,Staff,0,2,16,16
1714203352825,SIO 295LS,A00,523233,Staff,13,0,30,17
1714203353864,SIO 295S,A00,523232,Staff,13,0,30,17
1714203354896,SIOC 290S,A01,637330,Merrifield; Mark A,28,0,30,2
1714203355928,SIOC 291S,A01,637333,Gabriel; Corey John,28,0,30,2
1714203356956,SOCI 117,A01,494376,Staff,0,2,5,5
1714203357982,WES 237B,A00,494380,Staff,9,0,20,11
1714203360059,AESE 279B,A00,494370,Wade; Jon P,0,0,33,33
1714203361086,AIP 197,001,627712,Vespa; Emanuel Ignacio,9998,0,9999,1
1714203362115,ANAR 135S,A00,494369,Braswell; Geoffrey E.,0,0,0,0
1714203363145,BENG 196,001,628496,Engler; Adam J.,9998,0,9999,1
1714203364174,CAT 124RS,A01,519847,Geibel; William,0,0,20,20
1714203365200,CAT 125RS,A01,515971,Geibel; William,0,0,20,20
1714203366283,CLRE 250,A00,511389,Morris; Sheldon,9993,0,9999,6
1714203367317,CLRE 251,A00,507176,Mehta; Ravindra L.,9993,0,9999,6
1714203367317,CLRE 251,B00,511410,Mehta; Ravindra L.,9998,0,9999,1
1714203368348,CLRE 252,A00,507189,Cuomo; Raphael Eduardo,9995,0,9999,4
1714203369379,CLRE 253,A00,507199,Vaida; Florin,9994,0,9999,5
1714203369379,CLRE 253,B00,507202,Vaida; Florin,9999,0,9999,0
1714203370406,CLRE 259,A00,507211,Patel; Hemal,9996,0,9999,3
1714203371436,CLRE 260,A00,507221,Cuomo; Raphael Eduardo,9999,0,9999,0
1714203372461,CLRE 297,001,507242,Cuomo; Raphael Eduardo,9999,0,9999,0
1714203373486,COGS 197,001,638244,Voytek; Bradley Thomas,9999,0,9999,0
1714203374517,CSE 191,A00,516875,Minnes Kemp; Mor Mia,9993,0,9999,6
1714203375549,CSE 197,001,637388,Minnes Kemp; Mor Mia,9998,0,9999,1
1714203376577,CSS 201S,A01,494383,Staff,35,0,35,0
1714203377605,CSS 202S,A01,494387,Staff,35,0,35,0
1714203378632,DSC 197,001,628532,Eldridge; Justin Matthew,9996,0,9999,3
1714203379657,EAP 100,A00,516065,Staff,9797,0,9999,202
1714203380687,ECE 45,A01,507414,Staff,33,0,60,27
1714203382743,ECE 111,A01,507420,Staff,21,0,50,29
1714203383773,ECE 197,001,548057,Sievenpiper; Daniel F.,9994,0,9999,5
1714203384803,EDS 115,A00,507243,Choi; Bailey Miyeon,12,0,28,16
1714203385831,EDS 117,A01,494379,Staff,0,1,30,30
1714203386856,EDS 125,A00,507246,Hopkins; Megan Beth,12,0,30,18
1714203387885,EDS 128A,A01,507264,Fargason; Sharon Gayle,14,0,26,12
1714203388910,EDS 128B,A01,507293,Pappas; Elizabeth,18,0,30,12
1714203389935,EDS 139,A00,507294,Fargason; Sharon Gayle,18,0,30,12
1714203389935,EDS 139,B00,507313,Pappas; Elizabeth,15,0,30,15
1714203390961,EDS 201,A00,507315,Staff,13,0,30,17
1714203391988,EDS 203,A01,507317,Halter; Christopher P.,12,0,30,18
1714203393015,EDS 204R,A01,507319,Halter; Christopher P.,0,3,30,30
1714203393015,EDS 204R,B01,507331,Heinzman; Erica M.,17,0,30,13
1714203394049,EDS 206R,A00,507332,Staff,0,4,30,30
1714203394049,EDS 206R,B00,507343,Staff,18,0,30,12
1714203395074,EDS 250,A00,507344,Hemans; Patricia Ann Benitez,22,0,40,18
1714203396100,EDS 281,A00,507345,Daly; Alan J.,18,0,18,0
1714203397129,EDS 284,A00,507350,Daly; Alan J.,16,0,16,0
1714203398157,EDS 286,A00,507359,Fine; Sarah,18,0,18,0
1714203399184,EDS 289C,A01,507361,Daly; Alan J.,18,0,18,0
1714203400212,EDS 290,A00,507366,Hofstetter; Carolyn,15,0,15,0
1714203401243,LIGM 5A,A00,507421,Fischer-Grunski; Eva K,18,0,20,2
1714203402272,LIGM 5B,A00,507423,Fischer-Grunski; Eva K,19,0,20,1
1714203403298,LIGM 5C,A00,507425,Fischer-Grunski; Eva K,19,0,20,1
1714203404323,LIIT 5AS,A00,507427,Carnelos; Chiara,20,0,20,0
1714203405352,LIIT 5BS,A00,507430,Carnelos; Chiara,20,0,20,0
1714203406382,LIIT 5CS,A00,507432,Carnelos; Chiara,20,0,20,0
1714203407413,LISP 5A,A00,507541,Munoz Sanchez; Alicia,11,0,20,9
1714203408439,LISP 5B,A00,507671,Munoz Sanchez; Alicia,9,0,20,11
1714203409466,LISP 5C,A00,507696,Munoz Sanchez; Alicia,9,0,20,11
1714203410493,MAE 197,001,528363,Boechler; Nicholas Sebastia,9998,0,9999,1
1714203411518,MATH 197,001,523477,Kedlaya; Kiran S.,9996,0,9999,3
1714203411518,MATH 197,002,563811,Zhang; Danna,9995,0,9999,4
1714203411518,MATH 197,003,628552,Dumitriu; Ioana,9998,0,9999,1
1714203412545,MCWP 40R,A00,518780,Staff,5,0,20,15
1714203412545,MCWP 40R,B00,518781,Staff,7,0,20,13
1714203412545,MCWP 40R,C00,518783,Staff,5,0,20,15
1714203413571,MCWP 50R,A00,518791,Staff,0,0,20,20
1714203413571,MCWP 50R,B00,518792,Staff,0,1,20,20
1714203413571,MCWP 50R,C00,518793,Staff,0,1,20,20
1714203413571,MCWP 50R,D00,518794,Staff,0,0,20,20
1714203413571,MCWP 50R,E00,518795,Staff,0,1,20,20
1714203413571,MCWP 50R,F00,518796,Staff,0,0,20,20
1714203413571,MCWP 50R,G00,518797,Staff,0,1,20,20
1714203414601,MMW 12R,A01,514034,Herbst; Matthew,0,1,16,16
1714203414601,MMW 12R,A02,514035,Herbst; Matthew,2,0,16,14
1714203415630,MMW 13R,A01,514037,Staff,0,4,16,16
1714203415630,MMW 13R,A02,514039,Staff,0,2,16,16
1714203415630,MMW 13R,A03,628519,Staff,0,2,16,16
1714203417685,SIO 295LS,A00,523233,Staff,13,0,30,17
1714203418713,SIO 295S,A00,523232,Staff,13,0,30,17
1714203419742,SIOC 290S,A01,637330,Merrifield; Mark A,28,0,30,2
1714203420773,SIOC 291S,A01,637333,Gabriel; Corey John,28,0,30,2
1714203421800,SOCI 117,A01,494376,Staff,0,2,5,5
1714203422826,WES 237B,A00,494380,Staff,9,0,20,11
1714203424898,AESE 279B,A00,494370,Wade; Jon P,0,0,33,33
1714203425985,AIP 197,001,627712,Vespa; Emanuel Ignacio,9998,0,9999,1
1714203427014,ANAR 135S,A00,494369,Braswell; Geoffrey E.,0,0,0,0
1714203428041,BENG 196,001,628496,Engler; Adam J.,9998,0,9999,1
1714203429069,CAT 124RS,A01,519847,Geibel; William,0,0,20,20
1714203430098,CAT 125RS,A01,515971,Geibel; William,0,0,20,20
1714203431125,CLRE 250,A00,511389,Morris; Sheldon,9993,0,9999,6
1714203432156,CLRE 251,A00,507176,Mehta; Ravindra L.,9993,0,9999,6
1714203432156,CLRE 251,B00,511410,Mehta; Ravindra L.,9998,0,9999,1
1714203433187,CLRE 252,A00,507189,Cuomo; Raphael Eduardo,9995,0,9999,4
1714203434216,CLRE 253,A00,507199,Vaida; Florin,9994,0,9999,5
1714203434216,CLRE 253,B00,507202,Vaida; Florin,9999,0,9999,0
1714203435246,CLRE 259,A00,507211,Patel; Hemal,9996,0,9999,3
1714203436275,CLRE 260,A00,507221,Cuomo; Raphael Eduardo,9999,0,9999,0
1714203437300,CLRE 297,001,507242,Cuomo; Raphael Eduardo,9999,0,9999,0
1714203438326,COGS 197,001,638244,Voytek; Bradley Thomas,9999,0,9999,0
1714203439353,CSE 191,A00,516875,Minnes Kemp; Mor Mia,9993,0,9999,6
1714203440380,CSE 197,001,637388,Minnes Kemp; Mor Mia,9998,0,9999,1
1714203441420,CSS 201S,A01,494383,Staff,35,0,35,0
1714203442447,CSS 202S,A01,494387,Staff,35,0,35,0
1714203443477,DSC 197,001,628532,Eldridge; Justin Matthew,9996,0,9999,3
1714203444525,EAP 100,A00,516065,Staff,9797,0,9999,202
1714203445566,ECE 45,A01,507414,Staff,33,0,60,27
1714203447747,ECE 111,A01,507420,Staff,21,0,50,29
1714203448812,ECE 197,001,548057,Sievenpiper; Daniel F.,9994,0,9999,5
1714203449874,EDS 115,A00,507243,Choi; Bailey Miyeon,12,0,28,16
1714203450931,EDS 117,A01,494379,Staff,0,1,30,30
1714203451984,EDS 125,A00,507246,Hopkins; Megan Beth,12,0,30,18
1714203453040,EDS 128A,A01,507264,Fargason; Sharon Gayle,14,0,26,12
1714203454107,EDS 128B,A01,507293,Pappas; Elizabeth,18,0,30,12
1714203455173,EDS 139,A00,507294,Fargason; Sharon Gayle,18,0,30,12
1714203455173,EDS 139,B00,507313,Pappas; Elizabeth,15,0,30,15
1714203456197,EDS 201,A00,507315,Staff,13,0,30,17
1714203457224,EDS 203,A01,507317,Halter; Christopher P.,12,0,30,18
1714203458254,EDS 204R,A01,507319,Halter; Christopher P.,0,3,30,30
1714203458254,EDS 204R,B01,507331,Heinzman; Erica M.,17,0,30,13
1714203459288,EDS 206R,A00,507332,Staff,0,4,30,30
1714203459288,EDS 206R,B00,507343,Staff,18,0,30,12
1714203460317,EDS 250,A00,507344,Hemans; Patricia Ann Benitez,22,0,40,18
1714203461344,EDS 281,A00,507345,Daly; Alan J.,18,0,18,0
1714203462368,EDS 284,A00,507350,Daly; Alan J.,16,0,16,0
1714203463398,EDS 286,A00,507359,Fine; Sarah,18,0,18,0
1714203464427,EDS 289C,A01,507361,Daly; Alan J.,18,0,18,0
1714203465454,EDS 290,A00,507366,Hofstetter; Carolyn,15,0,15,0
1714203466484,LIGM 5A,A00,507421,Fischer-Grunski; Eva K,18,0,20,2
1714203467509,LIGM 5B,A00,507423,Fischer-Grunski; Eva K,19,0,20,1
1714203468535,LIGM 5C,A00,507425,Fischer-Grunski; Eva K,19,0,20,1
1714203469564,LIIT 5AS,A00,507427,Carnelos; Chiara,20,0,20,0
1714203470590,LIIT 5BS,A00,507430,Carnelos; Chiara,20,0,20,0
1714203471620,LIIT 5CS,A00,507432,Carnelos; Chiara,20,0,20,0
1714203472647,LISP 5A,A00,507541,Munoz Sanchez; Alicia,11,0,20,9
1714203473677,LISP 5B,A00,507671,Munoz Sanchez; Alicia,9,0,20,11
1714203474706,LISP 5C,A00,507696,Munoz Sanchez; Alicia,9,0,20,11
1714203475735,MAE 197,001,528363,Boechler; Nicholas Sebastia,9998,0,9999,1
1714203476761,MATH 197,001,523477,Kedlaya; Kiran S.,9996,0,9999,3
1714203476761,MATH 197,002,563811,Zhang; Danna,9995,0,9999,4
1714203476761,MATH 197,003,628552,Dumitriu; Ioana,9998,0,9999,1
1714203477790,MCWP 40R,A00,518780,Staff,5,0,20,15
1714203477790,MCWP 40R,B00,518781,Staff,7,0,20,13
1714203477790,MCWP 40R,C00,518783,Staff,5,0,20,15
1714203478823,MCWP 50R,A00,518791,Staff,0,0,20,20
1714203478823,MCWP 50R,B00,518792,Staff,0,1,20,20
1714203478823,MCWP 50R,C00,518793,Staff,0,1,20,20
1714203478823,MCWP 50R,D00,518794,Staff,0,0,20,20
1714203478823,MCWP 50R,E00,518795,Staff,0,1,20,20
1714203478823,MCWP 50R,F00,518796,Staff,0,0,20,20
1714203478823,MCWP 50R,G00,518797,Staff,0,1,20,20
1714203479851,MMW 12R,A01,514034,Herbst; Matthew,0,1,16,16
1714203479851,MMW 12R,A02,514035,Herbst; Matthew,2,0,16,14
1714203480877,MMW 13R,A01,514037,Staff,0,4,16,16
1714203480877,MMW 13R,A02,514039,Staff,0,2,16,16
1714203480877,MMW 13R,A03,628519,Staff,0,2,16,16
1714203482929,SIO 295LS,A00,523233,Staff,13,0,30,17
1714203483959,SIO 295S,A00,523232,Staff,13,0,30,17
1714203484992,SIOC 290S,A01,637330,Merrifield; Mark A,28,0,30,2
1714203486023,SIOC 291S,A01,637333,Gabriel; Corey John,28,0,30,2
1714203487053,SOCI 117,A01,494376,Staff,0,2,5,5
1714203488081,WES 237B,A00,494380,Staff,9,0,20,11
1714203490160,AESE 279B,A00,494370,Wade; Jon P,0,0,33,33
1714203491188,AIP 197,001,627712,Vespa; Emanuel Ignacio,9998,0,9999,1
1714203492214,ANAR 135S,A00,494369,Braswell; Geoffrey E.,0,0,0,0
1714203493243,BENG 196,001,628496,Engler; Adam J.,9998,0,9999,1
1714203494268,CAT 124RS,A01,519847,Geibel; William,0,0,20,20
1714203495294,CAT 125RS,A01,515971,Geibel; William,0,0,20,20
1714203496319,CLRE 250,A00,511389,Morris; Sheldon,9993,0,9999,6
1714203497351,CLRE 251,A00,507176,Mehta; Ravindra L.,9993,0,9999,6
1714203497351,CLRE 251,B00,511410,Mehta; Ravindra L.,9998,0,9999,1
1714203498379,CLRE 252,A00,507189,Cuomo; Raphael Eduardo,9995,0,9999,4
1714203499405,CLRE 253,A00,507199,Vaida; Florin,9994,0,9999,5
1714203499405,CLRE 253,B00,507202,Vaida; Florin,9999,0,9999,0
1714203500435,CLRE 259,A00,507211,Patel; Hemal,9996,0,9999,3
1714203501460,CLRE 260,A00,507221,Cuomo; Raphael Eduardo,9999,0,9999,0
1714203502486,CLRE 297,001,507242,Cuomo; Raphael Eduardo,9999,0,9999,0
1714203503511,COGS 197,001,638244,Voytek; Bradley Thomas,9999,0,9999,0
1714203504540,CSE 191,A00,516875,Minnes Kemp; Mor Mia,9993,0,9999,6
1714203505568,CSE 197,001,637388,Minnes Kemp; Mor Mia,9998,0,9999,1
1714203506599,CSS 201S,A01,494383,Staff,35,0,35,0
1714203507629,CSS 202S,A01,494387,Staff,35,0,35,0
1714203508658,DSC 197,001,628532,Eldridge; Justin Matthew,9996,0,9999,3
1714203509687,EAP 100,A00,516065,Staff,9797,0,9999,202
1714203510720,ECE 45,A01,507414,Staff,33,0,60,27
1714203512773,ECE 111,A01,507420,Staff,21,0,50,29
1714203513802,ECE 197,001,548057,Sievenpiper; Daniel F.,9994,0,9999,5
1714203514833,EDS 115,A00,507243,Choi; Bailey Miyeon,12,0,28,16
1714203515862,EDS 117,A01,494379,Staff,0,1,30,30
1714203516889,EDS 125,A00,507246,Hopkins; Megan Beth,12,0,30,18
1714203517919,EDS 128A,A01,507264,Fargason; Sharon Gayle,14,0,26,12
1714203518971,EDS 128B,A01,507293,Pappas; Elizabeth,18,0,30,12
1714203520002,EDS 139,A00,507294,Fargason; Sharon Gayle,18,0,30,12
1714203520002,EDS 139,B00,507313,Pappas; Elizabeth,15,0,30,15
1714203521033,EDS 201,A00,507315,Staff,13,0,30,17
1714203522063,EDS 203,A01,507317,Halter; Christopher P.,12,0,30,18
1714203523094,EDS 204R,A01,507319,Halter; Christopher P.,0,3,30,30
1714203523094,EDS 204R,B01,507331,Heinzman; Erica M.,17,0,30,13
1714203524124,EDS 206R,A00,507332,Staff,0,4,30,30
1714203524124,EDS 206R,B00,507343,Staff,18,0,30,12
1714203525152,EDS 250,A00,507344,Hemans; Patricia Ann Benitez,22,0,40,18
1714203526179,EDS 281,A00,507345,Daly; Alan J.,18,0,18,0
1714203527204,EDS 284,A00,507350,Daly; Alan J.,16,0,16,0
1714203528234,EDS 286,A00,507359,Fine; Sarah,18,0,18,0
1714203529260,EDS 289C,A01,507361,Daly; Alan J.,18,0,18,0
1714203530344,EDS 290,A00,507366,Hofstetter; Carolyn,15,0,15,0
1714203531371,LIGM 5A,A00,507421,Fischer-Grunski; Eva K,18,0,20,2
1714203532396,LIGM 5B,A00,507423,Fischer-Grunski; Eva K,19,0,20,1
1714203533427,LIGM 5C,A00,507425,Fischer-Grunski; Eva K,19,0,20,1
1714203534455,LIIT 5AS,A00,507427,Carnelos; Chiara,20,0,20,0
1714203535481,LIIT 5BS,A00,507430,Carnelos; Chiara,20,0,20,0
1714203536512,LIIT 5CS,A00,507432,Carnelos; Chiara,20,0,20,0
1714203537540,LISP 5A,A00,507541,Munoz Sanchez; Alicia,11,0,20,9
1714203538576,LISP 5B,A00,507671,Munoz Sanchez; Alicia,9,0,20,11
1714203539602,LISP 5C,A00,507696,Munoz Sanchez; Alicia,9,0,20,11
1714203540630,MAE 197,001,528363,Boechler; Nicholas Sebastia,9998,0,9999,1
1714203541662,MATH 197,001,523477,Kedlaya; Kiran S.,9996,0,9999,3
1714203541662,MATH 197,002,563811,Zhang; Danna,9995,0,9999,4
1714203541662,MATH 197,003,628552,Dumitriu; Ioana,9998,0,9999,1
1714203542691,MCWP 40R,A00,518780,Staff,5,0,20,15
1714203542691,MCWP 40R,B00,518781,Staff,7,0,20,13
1714203542691,MCWP 40R,C00,518783,Staff,5,0,20,15
1714203543718,MCWP 50R,A00,518791,Staff,0,0,20,20
1714203543718,MCWP 50R,B00,518792,Staff,0,1,20,20
1714203543718,MCWP 50R,C00,518793,Staff,0,1,20,20
1714203543718,MCWP 50R,D00,518794,Staff,0,0,20,20
1714203543718,MCWP 50R,E00,518795,Staff,0,1,20,20
1714203543718,MCWP 50R,F00,518796,Staff,0,0,20,20
1714203543718,MCWP 50R,G00,518797,Staff,0,1,20,20
1714203544744,MMW 12R,A01,514034,Herbst; Matthew,0,1,16,16
1714203544744,MMW 12R,A02,514035,Herbst; Matthew,2,0,16,14
1714203545771,MMW 13R,A01,514037,Staff,0,4,16,16
1714203545771,MMW 13R,A02,514039,Staff,0,2,16,16
1714203545771,MMW 13R,A03,628519,Staff,0,2,16,16
1714203547826,SIO 295LS,A00,523233,Staff,13,0,30,17
1714203548853,SIO 295S,A00,523232,Staff,13,0,30,17
1714203549883,SIOC 290S,A01,637330,Merrifield; Mark A,28,0,30,2
1714203550914,SIOC 291S,A01,637333,Gabriel; Corey John,28,0,30,2
1714203551942,SOCI 117,A01,494376,Staff,0,2,5,5
1714203552969,WES 237B,A00,494380,Staff,9,0,20,11
1714203555058,AESE 279B,A00,494370,Wade; Jon P,0,0,33,33
1714203556084,AIP 197,001,627712,Vespa; Emanuel Ignacio,9998,0,9999,1
1714203557111,ANAR 135S,A00,494369,Braswell; Geoffrey E.,0,0,0,0
1714203558139,BENG 196,001,628496,Engler; Adam J.,9998,0,9999,1
1714203559164,CAT 124RS,A01,519847,Geibel; William,0,0,20,20
1714203560190,CAT 125RS,A01,515971,Geibel; William,0,0,20,20
1714203561220,CLRE 250,A00,511389,Morris; Sheldon,9993,0,9999,6
1714203562248,CLRE 251,A00,507176,Mehta; Ravindra L.,9993,0,9999,6
1714203562248,CLRE 251,B00,511410,Mehta; Ravindra L.,9998,0,9999,1
1714203563277,CLRE 252,A00,507189,Cuomo; Raphael Eduardo,9995,0,9999,4
1714203564303,CLRE 253,A00,507199,Vaida; Florin,9994,0,9999,5
1714203564303,CLRE 253,B00,507202,Vaida; Florin,9999,0,9999,0
1714203565336,CLRE 259,A00,507211,Patel; Hemal,9996,0,9999,3
1714203566363,CLRE 260,A00,507221,Cuomo; Raphael Eduardo,9999,0,9999,0
1714203567390,CLRE 297,001,507242,Cuomo; Raphael Eduardo,9999,0,9999,0
1714203568416,COGS 197,001,638244,Voytek; Bradley Thomas,9999,0,9999,0
1714203569443,CSE 191,A00,516875,Minnes Kemp; Mor Mia,9993,0,9999,6
1714203570472,CSE 197,001,637388,Minnes Kemp; Mor Mia,9998,0,9999,1
1714203571503,CSS 201S,A01,494383,Staff,35,0,35,0
1714203572529,CSS 202S,A01,494387,Staff,35,0,35,0
1714203573556,DSC 197,001,628532,Eldridge; Justin Matthew,9996,0,9999,3
1714203574586,EAP 100,A00,516065,Staff,9797,0,9999,202
1714203575616,ECE 45,A01,507414,Staff,33,0,60,27
1714203577748,ECE 111,A01,507420,Staff,21,0,50,29
1714203578775,ECE 197,001,548057,Sievenpiper; Daniel F.,9994,0,9999,5
1714203579803,EDS 115,A00,507243,Choi; Bailey Miyeon,12,0,28,16
1714203580831,EDS 117,A01,494379,Staff,0,1,30,30
1714203581861,EDS 125,A00,507246,Hopkins; Megan Beth,12,0,30,18
1714203582892,EDS 128A,A01,507264,Fargason; Sharon Gayle,14,0,26,12
1714203583919,EDS 128B,A01,507293,Pappas; Elizabeth,18,0,30,12
1714203584950,EDS 139,A00,507294,Fargason; Sharon Gayle,18,0,30,12
1714203584950,EDS 139,B00,507313,Pappas; Elizabeth,15,0,30,15
1714203585978,EDS 201,A00,507315,Staff,13,0,30,17
1714203587009,EDS 203,A01,507317,Halter; Christopher P.,12,0,30,18
1714203588036,EDS 204R,A01,507319,Halter; Christopher P.,0,3,30,30
1714203588036,EDS 204R,B01,507331,Heinzman; Erica M.,17,0,30,13
1714203589066,EDS 206R,A00,507332,Staff,0,4,30,30
1714203589066,EDS 206R,B00,507343,Staff,18,0,30,12
1714203590095,EDS 250,A00,507344,Hemans; Patricia Ann Benitez,22,0,40,18
1714203591122,EDS 281,A00,507345,Daly; Alan J.,18,0,18,0
1714203592149,EDS 284,A00,507350,Daly; Alan J.,16,0,16,0
1714203593174,EDS 286,A00,507359,Fine; Sarah,18,0,18,0
1714203594200,EDS 289C,A01,507361,Daly; Alan J.,18,0,18,0
1714203595227,EDS 290,A00,507366,Hofstetter; Carolyn,15,0,15,0
1714203596257,LIGM 5A,A00,507421,Fischer-Grunski; Eva K,18,0,20,2
1714203597285,LIGM 5B,A00,507423,Fischer-Grunski; Eva K,19,0,20,1
1714203598312,LIGM 5C,A00,507425,Fischer-Grunski; Eva K,19,0,20,1
1714203599341,LIIT 5AS,A00,507427,Carnelos; Chiara,20,0,20,0
1714203600372,LIIT 5BS,A00,507430,Carnelos; Chiara,20,0,20,0
1714203601402,LIIT 5CS,A00,507432,Carnelos; Chiara,20,0,20,0
1714203602428,LISP 5A,A00,507541,Munoz Sanchez; Alicia,11,0,20,9
1714203603460,LISP 5B,A00,507671,Munoz Sanchez; Alicia,9,0,20,11
1714203604490,LISP 5C,A00,507696,Munoz Sanchez; Alicia,9,0,20,11
1714203605517,MAE 197,001,528363,Boechler; Nicholas Sebastia,9998,0,9999,1
1714203606543,MATH 197,001,523477,Kedlaya; Kiran S.,9996,0,9999,3
1714203606543,MATH 197,002,563811,Zhang; Danna,9995,0,9999,4
1714203606543,MATH 197,003,628552,Dumitriu; Ioana,9998,0,9999,1
1714203607570,MCWP 40R,A00,518780,Staff,5,0,20,15
1714203607570,MCWP 40R,B00,518781,Staff,7,0,20,13
1714203607570,MCWP 40R,C00,518783,Staff,5,0,20,15
1714203608598,MCWP 50R,A00,518791,Staff,0,0,20,20
1714203608598,MCWP 50R,B00,518792,Staff,0,1,20,20
1714203608598,MCWP 50R,C00,518793,Staff,0,1,20,20
1714203608598,MCWP 50R,D00,518794,Staff,0,0,20,20
1714203608598,MCWP 50R,E00,518795,Staff,0,1,20,20
1714203608598,MCWP 50R,F00,518796,Staff,0,0,20,20
1714203608598,MCWP 50R,G00,518797,Staff,0,1,20,20
1714203609623,MMW 12R,A01,514034,Herbst; Matthew,0,1,16,16
1714203609623,MMW 12R,A02,514035,Herbst; Matthew,2,0,16,14
1714203610652,MMW 13R,A01,514037,Staff,0,4,16,16
1714203610652,MMW 13R,A02,514039,Staff,0,2,16,16
1714203610652,MMW 13R,A03,628519,Staff,0,2,16,16
1714203612707,SIO 295LS,A00,523233,Staff,13,0,30,17
1714203613732,SIO 295S,A00,523232,Staff,13,0,30,17
1714203614759,SIOC 290S,A01,637330,Merrifield; Mark A,28,0,30,2
1714203615784,SIOC 291S,A01,637333,Gabriel; Corey John,28,0,30,2
1714203616810,SOCI 117,A01,494376,Staff,0,2,5,5
1714203617836,WES 237B,A00,494380,Staff,9,0,20,11
1714203619926,AESE 279B,A00,494370,Wade; Jon P,0,0,33,33
1714203620952,AIP 197,001,627712,Vespa; Emanuel Ignacio,9998,0,9999,1
1714203621979,ANAR 135S,A00,494369,Braswell; Geoffrey E.,0,0,0,0
1714203623005,BENG 196,001,628496,Engler; Adam J.,9998,0,9999,1
1714203624035,CAT 124RS,A01,519847,Geibel; William,0,0,20,20
1714203625061,CAT 125RS,A01,515971,Geibel; William,0,0,20,20
1714203626090,CLRE 250,A00,511389,Morris; Sheldon,9993,0,9999,6
1714203627116,CLRE 251,A00,507176,Mehta; Ravindra L.,9993,0,9999,6
1714203627116,CLRE 251,B00,511410,Mehta; Ravindra L.,9998,0,9999,1
1714203628142,CLRE 252,A00,507189,Cuomo; Raphael Eduardo,9995,0,9999,4
1714203629170,CLRE 253,A00,507199,Vaida; Florin,9994,0,9999,5
1714203629170,CLRE 253,B00,507202,Vaida; Florin,9999,0,9999,0
1714203630196,CLRE 259,A00,507211,Patel; Hemal,9996,0,9999,3
1714203631222,CLRE 260,A00,507221,Cuomo; Raphael Eduardo,9999,0,9999,0
1714203632251,CLRE 297,001,507242,Cuomo; Raphael Eduardo,9999,0,9999,0
1714203633283,COGS 197,001,638244,Voytek; Bradley Thomas,9999,0,9999,0
1714203634364,CSE 191,A00,516875,Minnes Kemp; Mor Mia,9993,0,9999,6
1714203635389,CSE 197,001,637388,Minnes Kemp; Mor Mia,9998,0,9999,1
1714203636422,CSS 201S,A01,494383,Staff,35,0,35,0
1714203637451,CSS 202S,A01,494387,Staff,35,0,35,0
1714203638478,DSC 197,001,628532,Eldridge; Justin Matthew,9996,0,9999,3
1714203639504,EAP 100,A00,516065,Staff,9797,0,9999,202
1714203640531,ECE 45,A01,507414,Staff,33,0,60,27
1714203642585,ECE 111,A01,507420,Staff,21,0,50,29
1714203643617,ECE 197,001,548057,Sievenpiper; Daniel F.,9994,0,9999,5
1714203644642,EDS 115,A00,507243,Choi; Bailey Miyeon,12,0,28,16
1714203645671,EDS 117,A01,494379,Staff,0,1,30,30
1714203646701,EDS 125,A00,507246,Hopkins; Megan Beth,12,0,30,18
1714203647727,EDS 128A,A01,507264,Fargason; Sharon Gayle,14,0,26,12
1714203648755,EDS 128B,A01,507293,Pappas; Elizabeth,18,0,30,12
1714203649783,EDS 139,A00,507294,Fargason; Sharon Gayle,18,0,30,12
1714203649783,EDS 139,B00,507313,Pappas; Elizabeth,15,0,30,15
1714203650809,EDS 201,A00,507315,Staff,13,0,30,17
1714203651842,EDS 203,A01,507317,Halter; Christopher P.,12,0,30,18
1714203652869,EDS 204R,A01,507319,Halter; Christopher P.,0,3,30,30
1714203652869,EDS 204R,B01,507331,Heinzman; Erica M.,17,0,30,13
1714203653896,EDS 206R,A00,507332,Staff,0,4,30,30
1714203653896,EDS 206R,B00,507343,Staff,18,0,30,12
1714203654924,EDS 250,A00,507344,Hemans; Patricia Ann Benitez,22,0,40,18
1714203655951,EDS 281,A00,507345,Daly; Alan J.,18,0,18,0
1714203656978,EDS 284,A00,507350,Daly; Alan J.,16,0,16,0
1714203658008,EDS 286,A00,507359,Fine; Sarah,18,0,18,0
1714203659034,EDS 289C,A01,507361,Daly; Alan J.,18,0,18,0
1714203660064,EDS 290,A00,507366,Hofstetter; Carolyn,15,0,15,0
1714203661096,LIGM 5A,A00,507421,Fischer-Grunski; Eva K,18,0,20,2
1714203662122,LIGM 5B,A00,507423,Fischer-Grunski; Eva K,19,0,20,1
1714203663146,LIGM 5C,A00,507425,Fischer-Grunski; Eva K,19,0,20,1
1714203664173,LIIT 5AS,A00,507427,Carnelos; Chiara,20,0,20,0
1714203665198,LIIT 5BS,A00,507430,Carnelos; Chiara,20,0,20,0
1714203666222,LIIT 5CS,A00,507432,Carnelos; Chiara,20,0,20,0
1714203667249,LISP 5A,A00,507541,Munoz Sanchez; Alicia,11,0,20,9
1714203668280,LISP 5B,A00,507671,Munoz Sanchez; Alicia,9,0,20,11
1714203669306,LISP 5C,A00,507696,Munoz Sanchez; Alicia,9,0,20,11
1714203670337,MAE 197,001,528363,Boechler; Nicholas Sebastia,9998,0,9999,1
1714203671363,MATH 197,001,523477,Kedlaya; Kiran S.,9996,0,9999,3
1714203671363,MATH 197,002,563811,Zhang; Danna,9995,0,9999,4
1714203671363,MATH 197,003,628552,Dumitriu; Ioana,9998,0,9999,1
1714203672392,MCWP 40R,A00,518780,Staff,5,0,20,15
1714203672392,MCWP 40R,B00,518781,Staff,7,0,20,13
1714203672392,MCWP 40R,C00,518783,Staff,5,0,20,15
1714203673419,MCWP 50R,A00,518791,Staff,0,0,20,20
1714203673419,MCWP 50R,B00,518792,Staff,0,1,20,20
1714203673419,MCWP 50R,C00,518793,Staff,0,1,20,20
1714203673419,MCWP 50R,D00,518794,Staff,0,0,20,20
1714203673419,MCWP 50R,E00,518795,Staff,0,1,20,20
1714203673419,MCWP 50R,F00,518796,Staff,0,0,20,20
1714203673419,MCWP 50R,G00,518797,Staff,0,1,20,20
1714203674445,MMW 12R,A01,514034,Herbst; Matthew,0,1,16,16
1714203674445,MMW 12R,A02,514035,Herbst; Matthew,2,0,16,14
1714203675474,MMW 13R,A01,514037,Staff,0,4,16,16
1714203675474,MMW 13R,A02,514039,Staff,0,2,16,16
1714203675474,MMW 13R,A03,628519,Staff,0,2,16,16
1714203677531,SIO 295LS,A00,523233,Staff,13,0,30,17
1714203678560,SIO 295S,A00,523232,Staff,13,0,30,17
1714203679590,SIOC 290S,A01,637330,Merrifield; Mark A,28,0,30,2
1714203680619,SIOC 291S,A01,637333,Gabriel; Corey John,28,0,30,2
1714203681648,SOCI 117,A01,494376,Staff,0,2,5,5
1714203682677,WES 237B,A00,494380,Staff,9,0,20,11
1714203684763,AESE 279B,A00,494370,Wade; Jon P,0,0,33,33
1714203685789,AIP 197,001,627712,Vespa; Emanuel Ignacio,9998,0,9999,1
1714203686815,ANAR 135S,A00,494369,Braswell; Geoffrey E.,0,0,0,0
1714203687841,BENG 196,001,628496,Engler; Adam J.,9998,0,9999,1
1714203688868,CAT 124RS,A01,519847,Geibel; William,0,0,20,20
1714203689895,CAT 125RS,A01,515971,Geibel; William,0,0,20,20
1714203690925,CLRE 250,A00,511389,Morris; Sheldon,9993,0,9999,6
1714203691956,CLRE 251,A00,507176,Mehta; Ravindra L.,9993,0,9999,6
1714203691956,CLRE 251,B00,511410,Mehta; Ravindra L.,9998,0,9999,1
1714203692984,CLRE 252,A00,507189,Cuomo; Raphael Eduardo,9995,0,9999,4
1714203694010,CLRE 253,A00,507199,Vaida; Florin,9994,0,9999,5
1714203694010,CLRE 253,B00,507202,Vaida; Florin,9999,0,9999,0
1714203695041,CLRE 259,A00,507211,Patel; Hemal,9996,0,9999,3
1714203696066,CLRE 260,A00,507221,Cuomo; Raphael Eduardo,9999,0,9999,0
1714203697094,CLRE 297,001,507242,Cuomo; Raphael Eduardo,9999,0,9999,0
1714203698120,COGS 197,001,638244,Voytek; Bradley Thomas,9999,0,9999,0
1714203699148,CSE 191,A00,516875,Minnes Kemp; Mor Mia,9993,0,9999,6
1714203700175,CSE 197,001,637388,Minnes Kemp; Mor Mia,9998,0,9999,1
1714203701200,CSS 201S,A01,494383,Staff,35,0,35,0
1714203702224,CSS 202S,A01,494387,Staff,35,0,35,0
1714203703253,DSC 197,001,628532,Eldridge; Justin Matthew,9996,0,9999,3
1714203704281,EAP 100,A00,516065,Staff,9797,0,9999,202
1714203705308,ECE 45,A01,507414,Staff,33,0,60,27
1714203707364,ECE 111,A01,507420,Staff,21,0,50,29
1714203708390,ECE 197,001,548057,Sievenpiper; Daniel F.,9994,0,9999,5
1714203709419,EDS 115,A00,507243,Choi; Bailey Miyeon,12,0,28,16
1714203710446,EDS 117,A01,494379,Staff,0,1,30,30
1714203711482,EDS 125,A00,507246,Hopkins; Megan Beth,12,0,30,18
1714203712512,EDS 128A,A01,507264,Fargason; Sharon Gayle,14,0,26,12
1714203713537,EDS 128B,A01,507293,Pappas; Elizabeth,18,0,30,12
1714203714565,EDS 139,A00,507294,Fargason; Sharon Gayle,18,0,30,12
1714203714565,EDS 139,B00,507313,Pappas; Elizabeth,15,0,30,15
1714203715590,EDS 201,A00,507315,Staff,13,0,30,17
1714203716617,EDS 203,A01,507317,Halter; Christopher P.,12,0,30,18
1714203717647,EDS 204R,A01,507319,Halter; Christopher P.,0,3,30,30
1714203717647,EDS 204R,B01,507331,Heinzman; Erica M.,17,0,30,13
1714203718674,EDS 206R,A00,507332,Staff,0,4,30,30
1714203718674,EDS 206R,B00,507343,Staff,18,0,30,12
1714203719705,EDS 250,A00,507344,Hemans; Patricia Ann Benitez,22,0,40,18
1714203720732,EDS 281,A00,507345,Daly; Alan J.,18,0,18,0
1714203721759,EDS 284,A00,507350,Daly; Alan J.,16,0,16,0
1714203722785,EDS 286,A00,507359,Fine; Sarah,18,0,18,0
1714203723812,EDS 289C,A01,507361,Daly; Alan J.,18,0,18,0
1714203724842,EDS 290,A00,507366,Hofstetter; Carolyn,15,0,15,0
1714203725867,LIGM 5A,A00,507421,Fischer-Grunski; Eva K,18,0,20,2
1714203726893,LIGM 5B,A00,507423,Fischer-Grunski; Eva K,19,0,20,1
1714203727920,LIGM 5C,A00,507425,Fischer-Grunski; Eva K,19,0,20,1
1714203728945,LIIT 5AS,A00,507427,Carnelos; Chiara,20,0,20,0
1714203729984,LIIT 5BS,A00,507430,Carnelos; Chiara,20,0,20,0
1714203731010,LIIT 5CS,A00,507432,Carnelos; Chiara,20,0,20,0
1714203732036,LISP 5A,A00,507541,Munoz Sanchez; Alicia,11,0,20,9
1714203733067,LISP 5B,A00,507671,Munoz Sanchez; Alicia,9,0,20,11
1714203734143,LISP 5C,A00,507696,Munoz Sanchez; Alicia,9,0,20,11
1714203735174,MAE 197,001,528363,Boechler; Nicholas Sebastia,9998,0,9999,1
1714203736202,MATH 197,001,523477,Kedlaya; Kiran S.,9996,0,9999,3
1714203736202,MATH 197,002,563811,Zhang; Danna,9995,0,9999,4
1714203736202,MATH 197,003,628552,Dumitriu; Ioana,9998,0,9999,1
1714203737228,MCWP 40R,A00,518780,Staff,5,0,20,15
1714203737228,MCWP 40R,B00,518781,Staff,7,0,20,13
1714203737228,MCWP 40R,C00,518783,Staff,5,0,20,15
1714203738320,MCWP 50R,A00,518791,Staff,0,0,20,20
1714203738320,MCWP 50R,B00,518792,Staff,0,1,20,20
1714203738320,MCWP 50R,C00,518793,Staff,0,1,20,20
1714203738320,MCWP 50R,D00,518794,Staff,0,0,20,20
1714203738320,MCWP 50R,E00,518795,Staff,0,1,20,20
1714203738320,MCWP 50R,F00,518796,Staff,0,0,20,20
1714203738320,MCWP 50R,G00,518797,Staff,0,1,20,20
1714203739350,MMW 12R,A01,514034,Herbst; Matthew,0,1,16,16
1714203739350,MMW 12R,A02,514035,Herbst; Matthew,2,0,16,14
1714203740375,MMW 13R,A01,514037,Staff,0,4,16,16
1714203740375,MMW 13R,A02,514039,Staff,0,2,16,16
1714203740375,MMW 13R,A03,628519,Staff,0,2,16,16
1714203742428,SIO 295LS,A00,523233,Staff,13,0,30,17
1714203743454,SIO 295S,A00,523232,Staff,13,0,30,17
1714203744480,SIOC 290S,A01,637330,Merrifield; Mark A,28,0,30,2
1714203745506,SIOC 291S,A01,637333,Gabriel; Corey John,28,0,30,2
1714203746532,SOCI 117,A01,494376,Staff,0,2,5,5
1714203747559,WES 237B,A00,494380,Staff,9,0,20,11
1714203749634,AESE 279B,A00,494370,Wade; Jon P,0,0,33,33
1714203750663,AIP 197,001,627712,Vespa; Emanuel Ignacio,9998,0,9999,1
1714203751690,ANAR 135S,A00,494369,Braswell; Geoffrey E.,0,0,0,0
1714203752719,BENG 196,001,628496,Engler; Adam J.,9998,0,9999,1
1714203753748,CAT 124RS,A01,519847,Geibel; William,0,0,20,20
1714203754778,CAT 125RS,A01,515971,Geibel; William,0,0,20,20
1714203755804,CLRE 250,A00,511389,Morris; Sheldon,9993,0,9999,6
1714203756836,CLRE 251,A00,507176,Mehta; Ravindra L.,9993,0,9999,6
1714203756836,CLRE 251,B00,511410,Mehta; Ravindra L.,9998,0,9999,1
1714203757862,CLRE 252,A00,507189,Cuomo; Raphael Eduardo,9995,0,9999,4
1714203758887,CLRE 253,A00,507199,Vaida; Florin,9994,0,9999,5
1714203758887,CLRE 253,B00,507202,Vaida; Florin,9999,0,9999,0
1714203759917,CLRE 259,A00,507211,Patel; Hemal,9996,0,9999,3
1714203760948,CLRE 260,A00,507221,Cuomo; Raphael Eduardo,9999,0,9999,0
1714203761976,CLRE 297,001,507242,Cuomo; Raphael Eduardo,9999,0,9999,0
1714203763002,COGS 197,001,638244,Voytek; Bradley Thomas,9999,0,9999,0
1714203764028,CSE 191,A00,516875,Minnes Kemp; Mor Mia,9993,0,9999,6
1714203765057,CSE 197,001,637388,Minnes Kemp; Mor Mia,9998,0,9999,1
1714203766082,CSS 201S,A01,494383,Staff,35,0,35,0
1714203767108,CSS 202S,A01,494387,Staff,35,0,35,0
1714203768135,DSC 197,001,628532,Eldridge; Justin Matthew,9996,0,9999,3
1714203769162,EAP 100,A00,516065,Staff,9797,0,9999,202
1714203770191,ECE 45,A01,507414,Staff,33,0,60,27
1714203772245,ECE 111,A01,507420,Staff,21,0,50,29
1714203773273,ECE 197,001,548057,Sievenpiper; Daniel F.,9994,0,9999,5
1714203774299,EDS 115,A00,507243,Choi; Bailey Miyeon,12,0,28,16
1714203775325,EDS 117,A01,494379,Staff,0,1,30,30
1714203776351,EDS 125,A00,507246,Hopkins; Megan Beth,12,0,30,18
1714203777383,EDS 128A,A01,507264,Fargason; Sharon Gayle,14,0,26,12
1714203778414,EDS 128B,A01,507293,Pappas; Elizabeth,18,0,30,12
1714203779445,EDS 139,A00,507294,Fargason; Sharon Gayle,18,0,30,12
1714203779445,EDS 139,B00,507313,Pappas; Elizabeth,15,0,30,15
1714203780473,EDS 201,A00,507315,Staff,13,0,30,17
1714203781499,EDS 203,A01,507317,Halter; Christopher P.,12,0,30,18
1714203782524,EDS 204R,A01,507319,Halter; Christopher P.,0,3,30,30
1714203782524,EDS 204R,B01,507331,Heinzman; Erica M.,17,0,30,13
1714203783552,EDS 206R,A00,507332,Staff,0,4,30,30
1714203783552,EDS 206R,B00,507343,Staff,18,0,30,12
1714203784582,EDS 250,A00,507344,Hemans; Patricia Ann Benitez,22,0,40,18
1714203785610,EDS 281,A00,507345,Daly; Alan J.,18,0,18,0
1714203786636,EDS 284,A00,507350,Daly; Alan J.,16,0,16,0
1714203787667,EDS 286,A00,507359,Fine; Sarah,18,0,18,0
1714203788694,EDS 289C,A01,507361,Daly; Alan J.,18,0,18,0
1714203789719,EDS 290,A00,507366,Hofstetter; Carolyn,15,0,15,0
1714203790751,LIGM 5A,A00,507421,Fischer-Grunski; Eva K,18,0,20,2
1714203791778,LIGM 5B,A00,507423,Fischer-Grunski; Eva K,19,0,20,1
1714203792804,LIGM 5C,A00,507425,Fischer-Grunski; Eva K,19,0,20,1
1714203793831,LIIT 5AS,A00,507427,Carnelos; Chiara,20,0,20,0
1714203794858,LIIT 5BS,A00,507430,Carnelos; Chiara,20,0,20,0
1714203795887,LIIT 5CS,A00,507432,Carnelos; Chiara,20,0,20,0
1714203796920,LISP 5A,A00,507541,Munoz Sanchez; Alicia,11,0,20,9
1714203797944,LISP 5B,A00,507671,Munoz Sanchez; Alicia,9,0,20,11
1714203798979,LISP 5C,A00,507696,Munoz Sanchez; Alicia,9,0,20,11
1714203800003,MAE 197,001,528363,Boechler; Nicholas Sebastia,9998,0,9999,1
1714203801030,MATH 197,001,523477,Kedlaya; Kiran S.,9996,0,9999,3
1714203801030,MATH 197,002,563811,Zhang; Danna,9995,0,9999,4
1714203801030,MATH 197,003,628552,Dumitriu; Ioana,9998,0,9999,1
1714203802055,MCWP 40R,A00,518780,Staff,5,0,20,15
1714203802055,MCWP 40R,B00,518781,Staff,7,0,20,13
1714203802055,MCWP 40R,C00,518783,Staff,5,0,20,15
1714203803082,MCWP 50R,A00,518791,Staff,0,0,20,20
1714203803082,MCWP 50R,B00,518792,Staff,0,1,20,20
1714203803082,MCWP 50R,C00,518793,Staff,0,1,20,20
1714203803082,MCWP 50R,D00,518794,Staff,0,0,20,20
1714203803082,MCWP 50R,E00,518795,Staff,0,1,20,20
1714203803082,MCWP 50R,F00,518796,Staff,0,0,20,20
1714203803082,MCWP 50R,G00,518797,Staff,0,1,20,20
1714203804112,MMW 12R,A01,514034,Herbst; Matthew,0,1,16,16
1714203804112,MMW 12R,A02,514035,Herbst; Matthew,2,0,16,14
1714203805139,MMW 13R,A01,514037,Staff,0,4,16,16
1714203805139,MMW 13R,A02,514039,Staff,0,2,16,16
1714203805139,MMW 13R,A03,628519,Staff,0,2,16,16
1714203807191,SIO 295LS,A00,523233,Staff,13,0,30,17
1714203808218,SIO 295S,A00,523232,Staff,13,0,30,17
1714203809245,SIOC 290S,A01,637330,Merrifield; Mark A,28,0,30,2
1714203810274,SIOC 291S,A01,637333,Gabriel; Corey John,28,0,30,2
1714203811299,SOCI 117,A01,494376,Staff,0,2,5,5
1714203812325,WES 237B,A00,494380,Staff,9,0,20,11
1714203814393,AESE 279B,A00,494370,Wade; Jon P,0,0,33,33
1714203815424,AIP 197,001,627712,Vespa; Emanuel Ignacio,9998,0,9999,1
1714203816453,ANAR 135S,A00,494369,Braswell; Geoffrey E.,0,0,0,0
1714203817479,BENG 196,001,628496,Engler; Adam J.,9998,0,9999,1
1714203818508,CAT 124RS,A01,519847,Geibel; William,0,0,20,20
1714203819533,CAT 125RS,A01,515971,Geibel; William,0,0,20,20
1714203820560,CLRE 250,A00,511389,Morris; Sheldon,9993,0,9999,6
1714203821590,CLRE 251,A00,507176,Mehta; Ravindra L.,9993,0,9999,6
1714203821590,CLRE 251,B00,511410,Mehta; Ravindra L.,9998,0,9999,1
1714203822621,CLRE 252,A00,507189,Cuomo; Raphael Eduardo,9995,0,9999,4
1714203823647,CLRE 253,A00,507199,Vaida; Florin,9994,0,9999,5
1714203823647,CLRE 253,B00,507202,Vaida; Florin,9999,0,9999,0
1714203824676,CLRE 259,A00,507211,Patel; Hemal,9996,0,9999,3
1714203825704,CLRE 260,A00,507221,Cuomo; Raphael Eduardo,9999,0,9999,0
1714203826741,CLRE 297,001,507242,Cuomo; Raphael Eduardo,9999,0,9999,0
1714203827766,COGS 197,001,638244,Voytek; Bradley Thomas,9999,0,9999,0
1714203828795,CSE 191,A00,516875,Minnes Kemp; Mor Mia,9993,0,9999,6
1714203829821,CSE 197,001,637388,Minnes Kemp; Mor Mia,9998,0,9999,1
1714203830848,CSS 201S,A01,494383,Staff,35,0,35,0
1714203831877,CSS 202S,A01,494387,Staff,35,0,35,0
1714203832906,DSC 197,001,628532,Eldridge; Justin Matthew,9996,0,9999,3
1714203833931,EAP 100,A00,516065,Staff,9797,0,9999,202
1714203834959,ECE 45,A01,507414,Staff,33,0,60,27
1714203837010,ECE 111,A01,507420,Staff,21,0,50,29
1714203838036,ECE 197,001,548057,Sievenpiper; Daniel F.,9994,0,9999,5
1714203839062,EDS 115,A00,507243,Choi; Bailey Miyeon,12,0,28,16
1714203840088,EDS 117,A01,494379,Staff,0,1,30,30
1714203841116,EDS 125,A00,507246,Hopkins; Megan Beth,12,0,30,18
1714203842214,EDS 128A,A01,507264,Fargason; Sharon Gayle,14,0,26,12
1714203843241,EDS 128B,A01,507293,Pappas; Elizabeth,18,0,30,12
1714203844268,EDS 139,A00,507294,Fargason; Sharon Gayle,18,0,30,12
1714203844268,EDS 139,B00,507313,Pappas; Elizabeth,15,0,30,15
1714203845293,EDS 201,A00,507315,Staff,13,0,30,17
1714203846322,EDS 203,A01,507317,Halter; Christopher P.,12,0,30,18
1714203847352,EDS 204R,A01,507319,Halter; Christopher P.,0,3,30,30
1714203847352,EDS 204R,B01,507331,Heinzman; Erica M.,17,0,30,13
1714203848381,EDS 206R,A00,507332,Staff,0,4,30,30
1714203848381,EDS 206R,B00,507343,Staff,18,0,30,12
1714203849410,EDS 250,A00,507344,Hemans; Patricia Ann Benitez,22,0,40,18
1714203850437,EDS 281,A00,507345,Daly; Alan J.,18,0,18,0
1714203851467,EDS 284,A00,507350,Daly; Alan J.,16,0,16,0
1714203852494,EDS 286,A00,507359,Fine; Sarah,18,0,18,0
1714203853523,EDS 289C,A01,507361,Daly; Alan J.,18,0,18,0
1714203854550,EDS 290,A00,507366,Hofstetter; Carolyn,15,0,15,0
1714203855575,LIGM 5A,A00,507421,Fischer-Grunski; Eva K,18,0,20,2
1714203856599,LIGM 5B,A00,507423,Fischer-Grunski; Eva K,19,0,20,1
1714203857632,LIGM 5C,A00,507425,Fischer-Grunski; Eva K,19,0,20,1
1714203858663,LIIT 5AS,A00,507427,Carnelos; Chiara,20,0,20,0
1714203859695,LIIT 5BS,A00,507430,Carnelos; Chiara,20,0,20,0
1714203860721,LIIT 5CS,A00,507432,Carnelos; Chiara,20,0,20,0
1714203861751,LISP 5A,A00,507541,Munoz Sanchez; Alicia,11,0,20,9
1714203862778,LISP 5B,A00,507671,Munoz Sanchez; Alicia,9,0,20,11
1714203863804,LISP 5C,A00,507696,Munoz Sanchez; Alicia,9,0,20,11
1714203864831,MAE 197,001,528363,Boechler; Nicholas Sebastia,9998,0,9999,1
1714203865859,MATH 197,001,523477,Kedlaya; Kiran S.,9996,0,9999,3
1714203865859,MATH 197,002,563811,Zhang; Danna,9995,0,9999,4
1714203865859,MATH 197,003,628552,Dumitriu; Ioana,9998,0,9999,1
1714203866886,MCWP 40R,A00,518780,Staff,5,0,20,15
1714203866886,MCWP 40R,B00,518781,Staff,7,0,20,13
1714203866886,MCWP 40R,C00,518783,Staff,5,0,20,15
1714203867913,MCWP 50R,A00,518791,Staff,0,0,20,20
1714203867913,MCWP 50R,B00,518792,Staff,0,1,20,20
1714203867913,MCWP 50R,C00,518793,Staff,0,1,20,20
1714203867913,MCWP 50R,D00,518794,Staff,0,0,20,20
1714203867913,MCWP 50R,E00,518795,Staff,0,1,20,20
1714203867913,MCWP 50R,F00,518796,Staff,0,0,20,20
1714203867913,MCWP 50R,G00,518797,Staff,0,1,20,20
1714203868941,MMW 12R,A01,514034,Herbst; Matthew,0,1,16,16
1714203868941,MMW 12R,A02,514035,Herbst; Matthew,2,0,16,14
1714203869967,MMW 13R,A01,514037,Staff,0,4,16,16
1714203869967,MMW 13R,A02,514039,Staff,0,2,16,16
1714203869967,MMW 13R,A03,628519,Staff,0,2,16,16
1714203872023,SIO 295LS,A00,523233,Staff,13,0,30,17
1714203873053,SIO 295S,A00,523232,Staff,13,0,30,17
1714203874106,SIOC 290S,A01,637330,Merrifield; Mark A,28,0,30,2
1714203875137,SIOC 291S,A01,637333,Gabriel; Corey John,28,0,30,2
1714203876164,SOCI 117,A01,494376,Staff,0,2,5,5
1714203877192,WES 237B,A00,494380,Staff,9,0,20,11
1714203879258,AESE 279B,A00,494370,Wade; Jon P,0,0,33,33
1714203880285,AIP 197,001,627712,Vespa; Emanuel Ignacio,9998,0,9999,1
1714203881310,ANAR 135S,A00,494369,Braswell; Geoffrey E.,0,0,0,0
1714203882339,BENG 196,001,628496,Engler; Adam J.,9998,0,9999,1
1714203883365,CAT 124RS,A01,519847,Geibel; William,0,0,20,20
1714203884391,CAT 125RS,A01,515971,Geibel; William,0,0,20,20
1714203885442,CLRE 250,A00,511389,Morris; Sheldon,9993,0,9999,6
1714203886476,CLRE 251,A00,507176,Mehta; Ravindra L.,9993,0,9999,6
1714203886476,CLRE 251,B00,511410,Mehta; Ravindra L.,9998,0,9999,1
1714203887506,CLRE 252,A00,507189,Cuomo; Raphael Eduardo,9995,0,9999,4
1714203888534,CLRE 253,A00,507199,Vaida; Florin,9994,0,9999,5
1714203888534,CLRE 253,B00,507202,Vaida; Florin,9999,0,9999,0
1714203889564,CLRE 259,A00,507211,Patel; Hemal,9996,0,9999,3
1714203890590,CLRE 260,A00,507221,Cuomo; Raphael Eduardo,9999,0,9999,0
1714203891617,CLRE 297,001,507242,Cuomo; Raphael Eduardo,9999,0,9999,0
1714203892642,COGS 197,001,638244,Voytek; Bradley Thomas,9999,0,9999,0
1714203893668,CSE 191,A00,516875,Minnes Kemp; Mor Mia,9993,0,9999,6
1714203894694,CSE 197,001,637388,Minnes Kemp; Mor Mia,9998,0,9999,1
1714203895725,CSS 201S,A01,494383,Staff,35,0,35,0
1714203896760,CSS 202S,A01,494387,Staff,35,0,35,0
1714203897786,DSC 197,001,628532,Eldridge; Justin Matthew,9996,0,9999,3
1714203898812,EAP 100,A00,516065,Staff,9797,0,9999,202
1714203899840,ECE 45,A01,507414,Staff,33,0,60,27
1714203901933,ECE 111,A01,507420,Staff,21,0,50,29
1714203902962,ECE 197,001,548057,Sievenpiper; Daniel F.,9994,0,9999,5
1714203903987,EDS 115,A00,507243,Choi; Bailey Miyeon,12,0,28,16
1714203905017,EDS 117,A01,494379,Staff,0,1,30,30
1714203906042,EDS 125,A00,507246,Hopkins; Megan Beth,12,0,30,18
1714203907072,EDS 128A,A01,507264,Fargason; Sharon Gayle,14,0,26,12
1714203908100,EDS 128B,A01,507293,Pappas; Elizabeth,18,0,30,12
1714203909130,EDS 139,A00,507294,Fargason; Sharon Gayle,18,0,30,12
1714203909130,EDS 139,B00,507313,Pappas; Elizabeth,15,0,30,15
1714203910157,EDS 201,A00,507315,Staff,13,0,30,17
1714203911183,EDS 203,A01,507317,Halter; Christopher P.,12,0,30,18
1714203912209,EDS 204R,A01,507319,Halter; Christopher P.,0,3,30,30
1714203912209,EDS 204R,B01,507331,Heinzman; Erica M.,17,0,30,13
1714203913240,EDS 206R,A00,507332,Staff,0,4,30,30
1714203913240,EDS 206R,B00,507343,Staff,18,0,30,12
1714203914265,EDS 250,A00,507344,Hemans; Patricia Ann Benitez,22,0,40,18
1714203915290,EDS 281,A00,507345,Daly; Alan J.,18,0,18,0
1714203916318,EDS 284,A00,507350,Daly; Alan J.,16,0,16,0
1714203917345,EDS 286,A00,507359,Fine; Sarah,18,0,18,0
1714203918373,EDS 289C,A01,507361,Daly; Alan J.,18,0,18,0
1714203919401,EDS 290,A00,507366,Hofstetter; Carolyn,15,0,15,0
1714203920432,LIGM 5A,A00,507421,Fischer-Grunski; Eva K,18,0,20,2
1714203921462,LIGM 5B,A00,507423,Fischer-Grunski; Eva K,19,0,20,1
1714203922489,LIGM 5C,A00,507425,Fischer-Grunski; Eva K,19,0,20,1
1714203923517,LIIT 5AS,A00,507427,Carnelos; Chiara,20,0,20,0
1714203924544,LIIT 5BS,A00,507430,Carnelos; Chiara,20,0,20,0
1714203925570,LIIT 5CS,A00,507432,Carnelos; Chiara,20,0,20,0
1714203926598,LISP 5A,A00,507541,Munoz Sanchez; Alicia,11,0,20,9
1714203927626,LISP 5B,A00,507671,Munoz Sanchez; Alicia,9,0,20,11
1714203928657,LISP 5C,A00,507696,Munoz Sanchez; Alicia,9,0,20,11
1714203929686,MAE 197,001,528363,Boechler; Nicholas Sebastia,9998,0,9999,1
1714203930712,MATH 197,001,523477,Kedlaya; Kiran S.,9996,0,9999,3
1714203930712,MATH 197,002,563811,Zhang; Danna,9995,0,9999,4
1714203930712,MATH 197,003,628552,Dumitriu; Ioana,9998,0,9999,1
1714203931739,MCWP 40R,A00,518780,Staff,5,0,20,15
1714203931739,MCWP 40R,B00,518781,Staff,7,0,20,13
1714203931739,MCWP 40R,C00,518783,Staff,5,0,20,15
1714203932766,MCWP 50R,A00,518791,Staff,0,0,20,20
1714203932766,MCWP 50R,B00,518792,Staff,0,1,20,20
1714203932766,MCWP 50R,C00,518793,Staff,0,1,20,20
1714203932766,MCWP 50R,D00,518794,Staff,0,0,20,20
1714203932766,MCWP 50R,E00,518795,Staff,0,1,20,20
1714203932766,MCWP 50R,F00,518796,Staff,0,0,20,20
1714203932766,MCWP 50R,G00,518797,Staff,0,1,20,20
1714203933795,MMW 12R,A01,514034,Herbst; Matthew,0,1,16,16
1714203933795,MMW 12R,A02,514035,Herbst; Matthew,2,0,16,14
1714203934824,MMW 13R,A01,514037,Staff,0,4,16,16
1714203934824,MMW 13R,A02,514039,Staff,0,2,16,16
1714203934824,MMW 13R,A03,628519,Staff,0,2,16,16
1714203936879,SIO 295LS,A00,523233,Staff,13,0,30,17
1714203937905,SIO 295S,A00,523232,Staff,13,0,30,17
1714203938936,SIOC 290S,A01,637330,Merrifield; Mark A,28,0,30,2
1714203939962,SIOC 291S,A01,637333,Gabriel; Corey John,28,0,30,2
1714203940989,SOCI 117,A01,494376,Staff,0,2,5,5
1714203942014,WES 237B,A00,494380,Staff,9,0,20,11
1714203944096,AESE 279B,A00,494370,Wade; Jon P,0,0,33,33
1714203945121,AIP 197,001,627712,Vespa; Emanuel Ignacio,9998,0,9999,1
1714203946206,ANAR 135S,A00,494369,Braswell; Geoffrey E.,0,0,0,0
1714203947232,BENG 196,001,628496,Engler; Adam J.,9998,0,9999,1
1714203948258,CAT 124RS,A01,519847,Geibel; William,0,0,20,20
1714203949285,CAT 125RS,A01,515971,Geibel; William,0,0,20,20
1714203950315,CLRE 250,A00,511389,Morris; Sheldon,9993,0,9999,6
1714203951500,CLRE 251,A00,507176,Mehta; Ravindra L.,9993,0,9999,6
1714203951500,CLRE 251,B00,511410,Mehta; Ravindra L.,9998,0,9999,1
1714203952529,CLRE 252,A00,507189,Cuomo; Raphael Eduardo,9995,0,9999,4
1714203953560,CLRE 253,A00,507199,Vaida; Florin,9994,0,9999,5
1714203953560,CLRE 253,B00,507202,Vaida; Florin,9999,0,9999,0
1714203954586,CLRE 259,A00,507211,Patel; Hemal,9996,0,9999,3
1714203955617,CLRE 260,A00,507221,Cuomo; Raphael Eduardo,9999,0,9999,0
1714203956645,CLRE 297,001,507242,Cuomo; Raphael Eduardo,9999,0,9999,0
1714203957674,COGS 197,001,638244,Voytek; Bradley Thomas,9999,0,9999,0
1714203958703,CSE 191,A00,516875,Minnes Kemp; Mor Mia,9993,0,9999,6
1714203959734,CSE 197,001,637388,Minnes Kemp; Mor Mia,9998,0,9999,1
1714203960761,CSS 201S,A01,494383,Staff,35,0,35,0
1714203961788,CSS 202S,A01,494387,Staff,35,0,35,0
1714203962817,DSC 197,001,628532,Eldridge; Justin Matthew,9996,0,9999,3
1714203963846,EAP 100,A00,516065,Staff,9797,0,9999,202
1714203964875,ECE 45,A01,507414,Staff,33,0,60,27
1714203966930,ECE 111,A01,507420,Staff,21,0,50,29
1714203967960,ECE 197,001,548057,Sievenpiper; Daniel F.,9994,0,9999,5
1714203968987,EDS 115,A00,507243,Choi; Bailey Miyeon,12,0,28,16
1714203970014,EDS 117,A01,494379,Staff,0,1,30,30
1714203971040,EDS 125,A00,507246,Hopkins; Megan Beth,12,0,30,18
1714203972069,EDS 128A,A01,507264,Fargason; Sharon Gayle,14,0,26,12
1714203973101,EDS 128B,A01,507293,Pappas; Elizabeth,18,0,30,12
1714203974127,EDS 139,A00,507294,Fargason; Sharon Gayle,18,0,30,12
1714203974127,EDS 139,B00,507313,Pappas; Elizabeth,15,0,30,15
1714203975155,EDS 201,A00,507315,Staff,13,0,30,17
1714203976182,EDS 203,A01,507317,Halter; Christopher P.,12,0,30,18
1714203977209,EDS 204R,A01,507319,Halter; Christopher P.,0,3,30,30
1714203977209,EDS 204R,B01,507331,Heinzman; Erica M.,17,0,30,13
1714203978236,EDS 206R,A00,507332,Staff,0,4,30,30
1714203978236,EDS 206R,B00,507343,Staff,18,0,30,12
1714203979262,EDS 250,A00,507344,Hemans; Patricia Ann Benitez,22,0,40,18
1714203980287,EDS 281,A00,507345,Daly; Alan J.,18,0,18,0
1714203981312,EDS 284,A00,507350,Daly; Alan J.,16,0,16,0
1714203982337,EDS 286,A00,507359,Fine; Sarah,18,0,18,0
1714203983361,EDS 289C,A01,507361,Daly; Alan J.,18,0,18,0
1714203984387,EDS 290,A00,507366,Hofstetter; Carolyn,15,0,15,0
1714203985414,LIGM 5A,A00,507421,Fischer-Grunski; Eva K,18,0,20,2
1714203986438,LIGM 5B,A00,507423,Fischer-Grunski; Eva K,19,0,20,1
1714203987467,LIGM 5C,A00,507425,Fischer-Grunski; Eva K,19,0,20,1
1714203988504,LIIT 5AS,A00,507427,Carnelos; Chiara,20,0,20,0
1714203989535,LIIT 5BS,A00,507430,Carnelos; Chiara,20,0,20,0
1714203990571,LIIT 5CS,A00,507432,Carnelos; Chiara,20,0,20,0
1714203991598,LISP 5A,A00,507541,Munoz Sanchez; Alicia,11,0,20,9
1714203992627,LISP 5B,A00,507671,Munoz Sanchez; Alicia,9,0,20,11
1714203993657,LISP 5C,A00,507696,Munoz Sanchez; Alicia,9,0,20,11
1714203994682,MAE 197,001,528363,Boechler; Nicholas Sebastia,9998,0,9999,1
1714203995708,MATH 197,001,523477,Kedlaya; Kiran S.,9996,0,9999,3
1714203995708,MATH 197,002,563811,Zhang; Danna,9995,0,9999,4
1714203995708,MATH 197,003,628552,Dumitriu; Ioana,9998,0,9999,1
1714203996733,MCWP 40R,A00,518780,Staff,5,0,20,15
1714203996733,MCWP 40R,B00,518781,Staff,7,0,20,13
1714203996733,MCWP 40R,C00,518783,Staff,5,0,20,15
1714203997758,MCWP 50R,A00,518791,Staff,0,0,20,20
1714203997758,MCWP 50R,B00,518792,Staff,0,1,20,20
1714203997758,MCWP 50R,C00,518793,Staff,0,1,20,20
1714203997758,MCWP 50R,D00,518794,Staff,0,0,20,20
1714203997758,MCWP 50R,E00,518795,Staff,0,1,20,20
1714203997758,MCWP 50R,F00,518796,Staff,0,0,20,20
1714203997758,MCWP 50R,G00,518797,Staff,0,1,20,20
1714203998787,MMW 12R,A01,514034,Herbst; Matthew,0,1,16,16
1714203998787,MMW 12R,A02,514035,Herbst; Matthew,2,0,16,14
1714203999812,MMW 13R,A01,514037,Staff,0,4,16,16
1714203999812,MMW 13R,A02,514039,Staff,0,2,16,16
1714203999812,MMW 13R,A03,628519,Staff,0,2,16,16
1714204001872,SIO 295LS,A00,523233,Staff,13,0,30,17
1714204002900,SIO 295S,A00,523232,Staff,13,0,30,17
1714204003925,SIOC 290S,A01,637330,Merrifield; Mark A,28,0,30,2
1714204004961,SIOC 291S,A01,637333,Gabriel; Corey John,28,0,30,2
1714204005987,SOCI 117,A01,494376,Staff,0,2,5,5
1714204007014,WES 237B,A00,494380,Staff,9,0,20,11
1714204009077,AESE 279B,A00,494370,Wade; Jon P,0,0,33,33
1714204010103,AIP 197,001,627712,Vespa; Emanuel Ignacio,9998,0,9999,1
1714204011130,ANAR 135S,A00,494369,Braswell; Geoffrey E.,0,0,0,0
1714204012156,BENG 196,001,628496,Engler; Adam J.,9998,0,9999,1
1714204013181,CAT 124RS,A01,519847,Geibel; William,0,0,20,20
1714204014206,CAT 125RS,A01,515971,Geibel; William,0,0,20,20
1714204015231,CLRE 250,A00,511389,Morris; Sheldon,9993,0,9999,6
1714204016260,CLRE 251,A00,507176,Mehta; Ravindra L.,9993,0,9999,6
1714204016260,CLRE 251,B00,511410,Mehta; Ravindra L.,9998,0,9999,1
1714204017284,CLRE 252,A00,507189,Cuomo; Raphael Eduardo,9995,0,9999,4
1714204018310,CLRE 253,A00,507199,Vaida; Florin,9994,0,9999,5
1714204018310,CLRE 253,B00,507202,Vaida; Florin,9999,0,9999,0
1714204019335,CLRE 259,A00,507211,Patel; Hemal,9996,0,9999,3
1714204020363,CLRE 260,A00,507221,Cuomo; Raphael Eduardo,9999,0,9999,0
1714204021388,CLRE 297,001,507242,Cuomo; Raphael Eduardo,9999,0,9999,0
1714204022415,COGS 197,001,638244,Voytek; Bradley Thomas,9999,0,9999,0
1714204023441,CSE 191,A00,516875,Minnes Kemp; Mor Mia,9993,0,9999,6
1714204024469,CSE 197,001,637388,Minnes Kemp; Mor Mia,9998,0,9999,1
1714204025500,CSS 201S,A01,494383,Staff,35,0,35,0
1714204026530,CSS 202S,A01,494387,Staff,35,0,35,0
1714204027560,DSC 197,001,628532,Eldridge; Justin Matthew,9996,0,9999,3
1714204028588,EAP 100,A00,516065,Staff,9797,0,9999,202
1714204029619,ECE 45,A01,507414,Staff,33,0,60,27
1714204031676,ECE 111,A01,507420,Staff,21,0,50,29
1714204032702,ECE 197,001,548057,Sievenpiper; Daniel F.,9994,0,9999,5
1714204033730,EDS 115,A00,507243,Choi; Bailey Miyeon,12,0,28,16
1714204034756,EDS 117,A01,494379,Staff,0,1,30,30
1714204035788,EDS 125,A00,507246,Hopkins; Megan Beth,12,0,30,18
1714204036819,EDS 128A,A01,507264,Fargason; Sharon Gayle,14,0,26,12
1714204037845,EDS 128B,A01,507293,Pappas; Elizabeth,18,0,30,12
1714204038873,EDS 139,A00,507294,Fargason; Sharon Gayle,18,0,30,12
1714204038873,EDS 139,B00,507313,Pappas; Elizabeth,15,0,30,15
1714204039901,EDS 201,A00,507315,Staff,13,0,30,17
1714204040927,EDS 203,A01,507317,Halter; Christopher P.,12,0,30,18
1714204041958,EDS 204R,A01,507319,Halter; Christopher P.,0,3,30,30
1714204041958,EDS 204R,B01,507331,Heinzman; Erica M.,17,0,30,13
1714204042987,EDS 206R,A00,507332,Staff,0,4,30,30
1714204042987,EDS 206R,B00,507343,Staff,18,0,30,12
1714204044015,EDS 250,A00,507344,Hemans; Patricia Ann Benitez,22,0,40,18
1714204045041,EDS 281,A00,507345,Daly; Alan J.,18,0,18,0
1714204046066,EDS 284,A00,507350,Daly; Alan J.,16,0,16,0
1714204047092,EDS 286,A00,507359,Fine; Sarah,18,0,18,0
1714204048118,EDS 289C,A01,507361,Daly; Alan J.,18,0,18,0
1714204049144,EDS 290,A00,507366,Hofstetter; Carolyn,15,0,15,0
1714204050245,LIGM 5A,A00,507421,Fischer-Grunski; Eva K,18,0,20,2
1714204051271,LIGM 5B,A00,507423,Fischer-Grunski; Eva K,19,0,20,1
1714204052298,LIGM 5C,A00,507425,Fischer-Grunski; Eva K,19,0,20,1
1714204053323,LIIT 5AS,A00,507427,Carnelos; Chiara,20,0,20,0
1714204054350,LIIT 5BS,A00,507430,Carnelos; Chiara,20,0,20,0
1714204055379,LIIT 5CS,A00,507432,Carnelos; Chiara,20,0,20,0
1714204056410,LISP 5A,A00,507541,Munoz Sanchez; Alicia,11,0,20,9
1714204057435,LISP 5B,A00,507671,Munoz Sanchez; Alicia,9,0,20,11
1714204058479,LISP 5C,A00,507696,Munoz Sanchez; Alicia,9,0,20,11
1714204059509,MAE 197,001,528363,Boechler; Nicholas Sebastia,9998,0,9999,1
1714204060536,MATH 197,001,523477,Kedlaya; Kiran S.,9996,0,9999,3
1714204060536,MATH 197,002,563811,Zhang; Danna,9995,0,9999,4
1714204060536,MATH 197,003,628552,Dumitriu; Ioana,9998,0,9999,1
1714204061564,MCWP 40R,A00,518780,Staff,5,0,20,15
1714204061564,MCWP 40R,B00,518781,Staff,7,0,20,13
1714204061564,MCWP 40R,C00,518783,Staff,5,0,20,15
1714204062591,MCWP 50R,A00,518791,Staff,0,0,20,20
1714204062591,MCWP 50R,B00,518792,Staff,0,1,20,20
1714204062591,MCWP 50R,C00,518793,Staff,0,1,20,20
1714204062591,MCWP 50R,D00,518794,Staff,0,0,20,20
1714204062591,MCWP 50R,E00,518795,Staff,0,1,20,20
1714204062591,MCWP 50R,F00,518796,Staff,0,0,20,20
1714204062591,MCWP 50R,G00,518797,Staff,0,1,20,20
1714204063618,MMW 12R,A01,514034,Herbst; Matthew,0,1,16,16
1714204063618,MMW 12R,A02,514035,Herbst; Matthew,2,0,16,14
1714204064646,MMW 13R,A01,514037,Staff,0,4,16,16
1714204064646,MMW 13R,A02,514039,Staff,0,2,16,16
1714204064646,MMW 13R,A03,628519,Staff,0,2,16,16
1714204066698,SIO 295LS,A00,523233,Staff,13,0,30,17
1714204067724,SIO 295S,A00,523232,Staff,13,0,30,17
1714204068752,SIOC 290S,A01,637330,Merrifield; Mark A,28,0,30,2
1714204069777,SIOC 291S,A01,637333,Gabriel; Corey John,28,0,30,2
1714204070807,SOCI 117,A01,494376,Staff,0,2,5,5
1714204071834,WES 237B,A00,494380,Staff,9,0,20,11
1714204073911,AESE 279B,A00,494370,Wade; Jon P,0,0,33,33
1714204074938,AIP 197,001,627712,Vespa; Emanuel Ignacio,9998,0,9999,1
1714204075965,ANAR 135S,A00,494369,Braswell; Geoffrey E.,0,0,0,0
1714204076991,BENG 196,001,628496,Engler; Adam J.,9998,0,9999,1
1714204078022,CAT 124RS,A01,519847,Geibel; William,0,0,20,20
1714204079048,CAT 125RS,A01,515971,Geibel; William,0,0,20,20
1714204080074,CLRE 250,A00,511389,Morris; Sheldon,9993,0,9999,6
1714204081104,CLRE 251,A00,507176,Mehta; Ravindra L.,9993,0,9999,6
1714204081104,CLRE 251,B00,511410,Mehta; Ravindra L.,9998,0,9999,1
1714204082129,CLRE 252,A00,507189,Cuomo; Raphael Eduardo,9995,0,9999,4
1714204083156,CLRE 253,A00,507199,Vaida; Florin,9994,0,9999,5
1714204083156,CLRE 253,B00,507202,Vaida; Florin,9999,0,9999,0
1714204084183,CLRE 259,A00,507211,Patel; Hemal,9996,0,9999,3
1714204085212,CLRE 260,A00,507221,Cuomo; Raphael Eduardo,9999,0,9999,0
1714204086236,CLRE 297,001,507242,Cuomo; Raphael Eduardo,9999,0,9999,0
1714204087264,COGS 197,001,638244,Voytek; Bradley Thomas,9999,0,9999,0
1714204088291,CSE 191,A00,516875,Minnes Kemp; Mor Mia,9993,0,9999,6
1714204089321,CSE 197,001,637388,Minnes Kemp; Mor Mia,9998,0,9999,1
1714204090349,CSS 201S,A01,494383,Staff,35,0,35,0
1714204091400,CSS 202S,A01,494387,Staff,35,0,35,0
1714204092428,DSC 197,001,628532,Eldridge; Justin Matthew,9996,0,9999,3
1714204093456,EAP 100,A00,516065,Staff,9797,0,9999,202
1714204094483,ECE 45,A01,507414,Staff,33,0,60,27
1714204096534,ECE 111,A01,507420,Staff,21,0,50,29
1714204097559,ECE 197,001,548057,Sievenpiper; Daniel F.,9994,0,9999,5
1714204098588,EDS 115,A00,507243,Choi; Bailey Miyeon,12,0,28,16
1714204099615,EDS 117,A01,494379,Staff,0,1,30,30
1714204100640,EDS 125,A00,507246,Hopkins; Megan Beth,12,0,30,18
1714204101667,EDS 128A,A01,507264,Fargason; Sharon Gayle,14,0,26,12
1714204102696,EDS 128B,A01,507293,Pappas; Elizabeth,18,0,30,12
1714204103725,EDS 139,A00,507294,Fargason; Sharon Gayle,18,0,30,12
1714204103725,EDS 139,B00,507313,Pappas; Elizabeth,15,0,30,15
1714204104755,EDS 201,A00,507315,Staff,13,0,30,17
1714204105782,EDS 203,A01,507317,Halter; Christopher P.,12,0,30,18
1714204106812,EDS 204R,A01,507319,Halter; Christopher P.,0,3,30,30
1714204106812,EDS 204R,B01,507331,Heinzman; Erica M.,17,0,30,13
1714204107838,EDS 206R,A00,507332,Staff,0,4,30,30
1714204107838,EDS 206R,B00,507343,Staff,18,0,30,12
1714204108864,EDS 250,A00,507344,Hemans; Patricia Ann Benitez,22,0,40,18
1714204109890,EDS 281,A00,507345,Daly; Alan J.,18,0,18,0
1714204110916,EDS 284,A00,507350,Daly; Alan J.,16,0,16,0
1714204111943,EDS 286,A00,507359,Fine; Sarah,18,0,18,0
1714204112968,EDS 289C,A01,507361,Daly; Alan J.,18,0,18,0
1714204113996,EDS 290,A00,507366,Hofstetter; Carolyn,15,0,15,0
1714204115022,LIGM 5A,A00,507421,Fischer-Grunski; Eva K,18,0,20,2
1714204116048,LIGM 5B,A00,507423,Fischer-Grunski; Eva K,19,0,20,1
1714204117078,LIGM 5C,A00,507425,Fischer-Grunski; Eva K,19,0,20,1
1714204118105,LIIT 5AS,A00,507427,Carnelos; Chiara,20,0,20,0
1714204119134,LIIT 5BS,A00,507430,Carnelos; Chiara,20,0,20,0
1714204120161,LIIT 5CS,A00,507432,Carnelos; Chiara,20,0,20,0
1714204121187,LISP 5A,A00,507541,Munoz Sanchez; Alicia,11,0,20,9
1714204122213,LISP 5B,A00,507671,Munoz Sanchez; Alicia,9,0,20,11
1714204123239,LISP 5C,A00,507696,Munoz Sanchez; Alicia,9,0,20,11
1714204124267,MAE 197,001,528363,Boechler; Nicholas Sebastia,9998,0,9999,1
1714204125299,MATH 197,001,523477,Kedlaya; Kiran S.,9996,0,9999,3
1714204125299,MATH 197,002,563811,Zhang; Danna,9995,0,9999,4
1714204125299,MATH 197,003,628552,Dumitriu; Ioana,9998,0,9999,1
1714204126325,MCWP 40R,A00,518780,Staff,5,0,20,15
1714204126325,MCWP 40R,B00,518781,Staff,7,0,20,13
1714204126325,MCWP 40R,C00,518783,Staff,5,0,20,15
1714204127356,MCWP 50R,A00,518791,Staff,0,0,20,20
1714204127356,MCWP 50R,B00,518792,Staff,0,1,20,20
1714204127356,MCWP 50R,C00,518793,Staff,0,1,20,20
1714204127356,MCWP 50R,D00,518794,Staff,0,0,20,20
1714204127356,MCWP 50R,E00,518795,Staff,0,1,20,20
1714204127356,MCWP 50R,F00,518796,Staff,0,0,20,20
1714204127356,MCWP 50R,G00,518797,Staff,0,1,20,20
1714204128386,MMW 12R,A01,514034,Herbst; Matthew,0,1,16,16
1714204128386,MMW 12R,A02,514035,Herbst; Matthew,2,0,16,14
1714204129412,MMW 13R,A01,514037,Staff,0,4,16,16
1714204129412,MMW 13R,A02,514039,Staff,0,2,16,16
1714204129412,MMW 13R,A03,628519,Staff,0,2,16,16
1714204131465,SIO 295LS,A00,523233,Staff,13,0,30,17
1714204132494,SIO 295S,A00,523232,Staff,13,0,30,17
1714204133521,SIOC 290S,A01,637330,Merrifield; Mark A,28,0,30,2
1714204134547,SIOC 291S,A01,637333,Gabriel; Corey John,28,0,30,2
1714204135573,SOCI 117,A01,494376,Staff,0,2,5,5
1714204136600,WES 237B,A00,494380,Staff,9,0,20,11
1714204138685,AESE 279B,A00,494370,Wade; Jon P,0,0,33,33
1714204139713,AIP 197,001,627712,Vespa; Emanuel Ignacio,9998,0,9999,1
1714204140743,ANAR 135S,A00,494369,Braswell; Geoffrey E.,0,0,0,0
1714204141767,BENG 196,001,628496,Engler; Adam J.,9998,0,9999,1
1714204142792,CAT 124RS,A01,519847,Geibel; William,0,0,20,20
1714204143819,CAT 125RS,A01,515971,Geibel; William,0,0,20,20
1714204144848,CLRE 250,A00,511389,Morris; Sheldon,9993,0,9999,6
1714204145875,CLRE 251,A00,507176,Mehta; Ravindra L.,9993,0,9999,6
1714204145875,CLRE 251,B00,511410,Mehta; Ravindra L.,9998,0,9999,1
1714204146905,CLRE 252,A00,507189,Cuomo; Raphael Eduardo,9995,0,9999,4
1714204147935,CLRE 253,A00,507199,Vaida; Florin,9994,0,9999,5
1714204147935,CLRE 253,B00,507202,Vaida; Florin,9999,0,9999,0
1714204148961,CLRE 259,A00,507211,Patel; Hemal,9996,0,9999,3
1714204149988,CLRE 260,A00,507221,Cuomo; Raphael Eduardo,9999,0,9999,0
1714204151016,CLRE 297,001,507242,Cuomo; Raphael Eduardo,9999,0,9999,0
1714204152042,COGS 197,001,638244,Voytek; Bradley Thomas,9999,0,9999,0
1714204153073,CSE 191,A00,516875,Minnes Kemp; Mor Mia,9993,0,9999,6
1714204154152,CSE 197,001,637388,Minnes Kemp; Mor Mia,9998,0,9999,1
1714204155182,CSS 201S,A01,494383,Staff,35,0,35,0
1714204156231,CSS 202S,A01,494387,Staff,35,0,35,0
1714204157256,DSC 197,001,628532,Eldridge; Justin Matthew,9996,0,9999,3
1714204158282,EAP 100,A00,516065,Staff,9797,0,9999,202
1714204159309,ECE 45,A01,507414,Staff,33,0,60,27
1714204161365,ECE 111,A01,507420,Staff,21,0,50,29
1714204162394,ECE 197,001,548057,Sievenpiper; Daniel F.,9994,0,9999,5
1714204163423,EDS 115,A00,507243,Choi; Bailey Miyeon,12,0,28,16
1714204164453,EDS 117,A01,494379,Staff,0,1,30,30
1714204165483,EDS 125,A00,507246,Hopkins; Megan Beth,12,0,30,18
1714204166509,EDS 128A,A01,507264,Fargason; Sharon Gayle,14,0,26,12
1714204167539,EDS 128B,A01,507293,Pappas; Elizabeth,18,0,30,12
1714204168565,EDS 139,A00,507294,Fargason; Sharon Gayle,18,0,30,12
1714204168565,EDS 139,B00,507313,Pappas; Elizabeth,15,0,30,15
1714204169593,EDS 201,A00,507315,Staff,13,0,30,17
1714204170622,EDS 203,A01,507317,Halter; Christopher P.,12,0,30,18
1714204171651,EDS 204R,A01,507319,Halter; Christopher P.,0,3,30,30
1714204171651,EDS 204R,B01,507331,Heinzman; Erica M.,17,0,30,13
1714204172677,EDS 206R,A00,507332,Staff,0,4,30,30
1714204172677,EDS 206R,B00,507343,Staff,18,0,30,12
1714204173709,EDS 250,A00,507344,Hemans; Patricia Ann Benitez,22,0,40,18
1714204174735,EDS 281,A00,507345,Daly; Alan J.,18,0,18,0
1714204175765,EDS 284,A00,507350,Daly; Alan J.,16,0,16,0
1714204176794,EDS 286,A00,507359,Fine; Sarah,18,0,18,0
1714204177820,EDS 289C,A01,507361,Daly; Alan J.,18,0,18,0
1714204178847,EDS 290,A00,507366,Hofstetter; Carolyn,15,0,15,0
1714204179873,LIGM 5A,A00,507421,Fischer-Grunski; Eva K,18,0,20,2
1714204180901,LIGM 5B,A00,507423,Fischer-Grunski; Eva K,19,0,20,1
1714204181931,LIGM 5C,A00,507425,Fischer-Grunski; Eva K,19,0,20,1
1714204182961,LIIT 5AS,A00,507427,Carnelos; Chiara,20,0,20,0
1714204183988,LIIT 5BS,A00,507430,Carnelos; Chiara,20,0,20,0
1714204185015,LIIT 5CS,A00,507432,Carnelos; Chiara,20,0,20,0
1714204186044,LISP 5A,A00,507541,Munoz Sanchez; Alicia,11,0,20,9
1714204187073,LISP 5B,A00,507671,Munoz Sanchez; Alicia,9,0,20,11
1714204188100,LISP 5C,A00,507696,Munoz Sanchez; Alicia,9,0,20,11
1714204189128,MAE 197,001,528363,Boechler; Nicholas Sebastia,9998,0,9999,1
1714204190159,MATH 197,001,523477,Kedlaya; Kiran S.,9996,0,9999,3
1714204190159,MATH 197,002,563811,Zhang; Danna,9995,0,9999,4
1714204190159,MATH 197,003,628552,Dumitriu; Ioana,9998,0,9999,1
1714204191185,MCWP 40R,A00,518780,Staff,5,0,20,15
1714204191185,MCWP 40R,B00,518781,Staff,7,0,20,13
1714204191185,MCWP 40R,C00,518783,Staff,5,0,20,15
1714204192217,MCWP 50R,A00,518791,Staff,0,0,20,20
1714204192217,MCWP 50R,B00,518792,Staff,0,1,20,20
1714204192217,MCWP 50R,C00,518793,Staff,0,1,20,20
1714204192217,MCWP 50R,D00,518794,Staff,0,0,20,20
1714204192217,MCWP 50R,E00,518795,Staff,0,1,20,20
1714204192217,MCWP 50R,F00,518796,Staff,0,0,20,20
1714204192217,MCWP 50R,G00,518797,Staff,0,1,20,20
1714204193244,MMW 12R,A01,514034,Herbst; Matthew,0,1,16,16
1714204193244,MMW 12R,A02,514035,Herbst; Matthew,2,0,16,14
1714204194273,MMW 13R,A01,514037,Staff,0,4,16,16
1714204194273,MMW 13R,A02,514039,Staff,0,2,16,16
1714204194273,MMW 13R,A03,628519,Staff,0,2,16,16
1714204196322,SIO 295LS,A00,523233,Staff,13,0,30,17
1714204197348,SIO 295S,A00,523232,Staff,13,0,30,17
1714204198374,SIOC 290S,A01,637330,Merrifield; Mark A,28,0,30,2
1714204199404,SIOC 291S,A01,637333,Gabriel; Corey John,28,0,30,2
1714204200430,SOCI 117,A01,494376,Staff,0,2,5,5
1714204201457,WES 237B,A00,494380,Staff,9,0,20,11
1714204203531,AESE 279B,A00,494370,Wade; Jon P,0,0,33,33
1714204204558,AIP 197,001,627712,Vespa; Emanuel Ignacio,9998,0,9999,1
1714204205584,ANAR 135S,A00,494369,Braswell; Geoffrey E.,0,0,0,0
1714204206612,BENG 196,001,628496,Engler; Adam J.,9998,0,9999,1
1714204207639,CAT 124RS,A01,519847,Geibel; William,0,0,20,20
1714204208667,CAT 125RS,A01,515971,Geibel; William,0,0,20,20
1714204209695,CLRE 250,A00,511389,Morris; Sheldon,9993,0,9999,6
1714204210722,CLRE 251,A00,507176,Mehta; Ravindra L.,9993,0,9999,6
1714204210722,CLRE 251,B00,511410,Mehta; Ravindra L.,9998,0,9999,1
1714204211747,CLRE 252,A00,507189,Cuomo; Raphael Eduardo,9995,0,9999,4
1714204212773,CLRE 253,A00,507199,Vaida; Florin,9994,0,9999,5
1714204212773,CLRE 253,B00,507202,Vaida; Florin,9999,0,9999,0
1714204213799,CLRE 259,A00,507211,Patel; Hemal,9996,0,9999,3
1714204214828,CLRE 260,A00,507221,Cuomo; Raphael Eduardo,9999,0,9999,0
1714204215856,CLRE 297,001,507242,Cuomo; Raphael Eduardo,9999,0,9999,0
1714204216882,COGS 197,001,638244,Voytek; Bradley Thomas,9999,0,9999,0
1714204217910,CSE 191,A00,516875,Minnes Kemp; Mor Mia,9993,0,9999,6
1714204218935,CSE 197,001,637388,Minnes Kemp; Mor Mia,9998,0,9999,1
1714204219961,CSS 201S,A01,494383,Staff,35,0,35,0
1714204220986,CSS 202S,A01,494387,Staff,35,0,35,0
1714204222014,DSC 197,001,628532,Eldridge; Justin Matthew,9996,0,9999,3
1714204223043,EAP 100,A00,516065,Staff,9797,0,9999,202
1714204224068,ECE 45,A01,507414,Staff,33,0,60,27
1714204226123,ECE 111,A01,507420,Staff,21,0,50,29
1714204227147,ECE 197,001,548057,Sievenpiper; Daniel F.,9994,0,9999,5
1714204228176,EDS 115,A00,507243,Choi; Bailey Miyeon,12,0,28,16
1714204229201,EDS 117,A01,494379,Staff,0,1,30,30
1714204230228,EDS 125,A00,507246,Hopkins; Megan Beth,12,0,30,18
1714204231255,EDS 128A,A01,507264,Fargason; Sharon Gayle,14,0,26,12
1714204232281,EDS 128B,A01,507293,Pappas; Elizabeth,18,0,30,12
1714204233306,EDS 139,A00,507294,Fargason; Sharon Gayle,18,0,30,12
1714204233306,EDS 139,B00,507313,Pappas; Elizabeth,15,0,30,15
1714204234335,EDS 201,A00,507315,Staff,13,0,30,17
1714204235362,EDS 203,A01,507317,Halter; Christopher P.,12,0,30,18
1714204236387,EDS 204R,A01,507319,Halter; Christopher P.,0,3,30,30
1714204236387,EDS 204R,B01,507331,Heinzman; Erica M.,17,0,30,13
1714204237412,EDS 206R,A00,507332,Staff,0,4,30,30
1714204237412,EDS 206R,B00,507343,Staff,18,0,30,12
1714204238438,EDS 250,A00,507344,Hemans; Patricia Ann Benitez,22,0,40,18
1714204239464,EDS 281,A00,507345,Daly; Alan J.,18,0,18,0
1714204240492,EDS 284,A00,507350,Daly; Alan J.,16,0,16,0
1714204241521,EDS 286,A00,507359,Fine; Sarah,18,0,18,0
1714204242547,EDS 289C,A01,507361,Daly; Alan J.,18,0,18,0
1714204243572,EDS 290,A00,507366,Hofstetter; Carolyn,15,0,15,0
1714204244599,LIGM 5A,A00,507421,Fischer-Grunski; Eva K,18,0,20,2
1714204245629,LIGM 5B,A00,507423,Fischer-Grunski; Eva K,19,0,20,1
1714204246655,LIGM 5C,A00,507425,Fischer-Grunski; Eva K,19,0,20,1
1714204247684,LIIT 5AS,A00,507427,Carnelos; Chiara,20,0,20,0
1714204248712,LIIT 5BS,A00,507430,Carnelos; Chiara,20,0,20,0
1714204249766,LIIT 5CS,A00,507432,Carnelos; Chiara,20,0,20,0
1714204250793,LISP 5A,A00,507541,Munoz Sanchez; Alicia,11,0,20,9
1714204251823,LISP 5B,A00,507671,Munoz Sanchez; Alicia,9,0,20,11
1714204252849,LISP 5C,A00,507696,Munoz Sanchez; Alicia,9,0,20,11
1714204253874,MAE 197,001,528363,Boechler; Nicholas Sebastia,9998,0,9999,1
1714204254904,MATH 197,001,523477,Kedlaya; Kiran S.,9996,0,9999,3
1714204254904,MATH 197,002,563811,Zhang; Danna,9995,0,9999,4
1714204254904,MATH 197,003,628552,Dumitriu; Ioana,9998,0,9999,1
1714204255933,MCWP 40R,A00,518780,Staff,5,0,20,15
1714204255933,MCWP 40R,B00,518781,Staff,7,0,20,13
1714204255933,MCWP 40R,C00,518783,Staff,5,0,20,15
1714204256970,MCWP 50R,A00,518791,Staff,0,0,20,20
1714204256970,MCWP 50R,B00,518792,Staff,0,1,20,20
1714204256970,MCWP 50R,C00,518793,Staff,0,1,20,20
1714204256970,MCWP 50R,D00,518794,Staff,0,0,20,20
1714204256970,MCWP 50R,E00,518795,Staff,0,1,20,20
1714204256970,MCWP 50R,F00,518796,Staff,0,0,20,20
1714204256970,MCWP 50R,G00,518797,Staff,0,1,20,20
1714204258051,MMW 12R,A01,514034,Herbst; Matthew,0,1,16,16
1714204258051,MMW 12R,A02,514035,Herbst; Matthew,2,0,16,14
1714204259079,MMW 13R,A01,514037,Staff,0,4,16,16
1714204259079,MMW 13R,A02,514039,Staff,0,2,16,16
1714204259079,MMW 13R,A03,628519,Staff,0,2,16,16
1714204261131,SIO 295LS,A00,523233,Staff,13,0,30,17
1714204262157,SIO 295S,A00,523232,Staff,13,0,30,17
1714204263183,SIOC 290S,A01,637330,Merrifield; Mark A,28,0,30,2
1714204264213,SIOC 291S,A01,637333,Gabriel; Corey John,28,0,30,2
1714204265239,SOCI 117,A01,494376,Staff,0,2,5,5
1714204266265,WES 237B,A00,494380,Staff,9,0,20,11
1714204268331,AESE 279B,A00,494370,Wade; Jon P,0,0,33,33
1714204269362,AIP 197,001,627712,Vespa; Emanuel Ignacio,9998,0,9999,1
1714204270391,ANAR 135S,A00,494369,Braswell; Geoffrey E.,0,0,0,0
1714204271420,BENG 196,001,628496,Engler; Adam J.,9998,0,9999,1
1714204272445,CAT 124RS,A01,519847,Geibel; William,0,0,20,20
1714204273471,CAT 125RS,A01,515971,Geibel; William,0,0,20,20
1714204274501,CLRE 250,A00,511389,Morris; Sheldon,9993,0,9999,6
1714204275529,CLRE 251,A00,507176,Mehta; Ravindra L.,9993,0,9999,6
1714204275529,CLRE 251,B00,511410,Mehta; Ravindra L.,9998,0,9999,1
1714204276558,CLRE 252,A00,507189,Cuomo; Raphael Eduardo,9995,0,9999,4
1714204277588,CLRE 253,A00,507199,Vaida; Florin,9994,0,9999,5
1714204277588,CLRE 253,B00,507202,Vaida; Florin,9999,0,9999,0
1714204278617,CLRE 259,A00,507211,Patel; Hemal,9996,0,9999,3
1714204279644,CLRE 260,A00,507221,Cuomo; Raphael Eduardo,9999,0,9999,0
1714204280670,CLRE 297,001,507242,Cuomo; Raphael Eduardo,9999,0,9999,0
1714204281694,COGS 197,001,638244,Voytek; Bradley Thomas,9999,0,9999,0
1714204282720,CSE 191,A00,516875,Minnes Kemp; Mor Mia,9993,0,9999,6
1714204283745,CSE 197,001,637388,Minnes Kemp; Mor Mia,9998,0,9999,1
1714204284776,CSS 201S,A01,494383,Staff,35,0,35,0
1714204285806,CSS 202S,A01,494387,Staff,35,0,35,0
1714204286831,DSC 197,001,628532,Eldridge; Justin Matthew,9996,0,9999,3
1714204287857,EAP 100,A00,516065,Staff,9797,0,9999,202
1714204288883,ECE 45,A01,507414,Staff,33,0,60,27
1714204290935,ECE 111,A01,507420,Staff,21,0,50,29
1714204291959,ECE 197,001,548057,Sievenpiper; Daniel F.,9994,0,9999,5
1714204292988,EDS 115,A00,507243,Choi; Bailey Miyeon,12,0,28,16
1714204294015,EDS 117,A01,494379,Staff,0,1,30,30
1714204295043,EDS 125,A00,507246,Hopkins; Megan Beth,12,0,30,18
1714204296071,EDS 128A,A01,507264,Fargason; Sharon Gayle,14,0,26,12
1714204297101,EDS 128B,A01,507293,Pappas; Elizabeth,18,0,30,12
1714204298130,EDS 139,A00,507294,Fargason; Sharon Gayle,18,0,30,12
1714204298130,EDS 139,B00,507313,Pappas; Elizabeth,15,0,30,15
1714204299154,EDS 201,A00,507315,Staff,13,0,30,17
1714204300192,EDS 203,A01,507317,Halter; Christopher P.,12,0,30,18
1714204301221,EDS 204R,A01,507319,Halter; Christopher P.,0,3,30,30
1714204301221,EDS 204R,B01,507331,Heinzman; Erica M.,17,0,30,13
1714204302246,EDS 206R,A00,507332,Staff,0,4,30,30
1714204302246,EDS 206R,B00,507343,Staff,18,0,30,12
1714204303276,EDS 250,A00,507344,Hemans; Patricia Ann Benitez,22,0,40,18
1714204304304,EDS 281,A00,507345,Daly; Alan J.,18,0,18,0
1714204305328,EDS 284,A00,507350,Daly; Alan J.,16,0,16,0
1714204306354,EDS 286,A00,507359,Fine; Sarah,18,0,18,0
1714204307382,EDS 289C,A01,507361,Daly; Alan J.,18,0,18,0
1714204308408,EDS 290,A00,507366,Hofstetter; Carolyn,15,0,15,0
1714204309434,LIGM 5A,A00,507421,Fischer-Grunski; Eva K,18,0,20,2
1714204310459,LIGM 5B,A00,507423,Fischer-Grunski; Eva K,19,0,20,1
1714204311490,LIGM 5C,A00,507425,Fischer-Grunski; Eva K,19,0,20,1
1714204312519,LIIT 5AS,A00,507427,Carnelos; Chiara,20,0,20,0
1714204313549,LIIT 5BS,A00,507430,Carnelos; Chiara,20,0,20,0
1714204314576,LIIT 5CS,A00,507432,Carnelos; Chiara,20,0,20,0
1714204315606,LISP 5A,A00,507541,Munoz Sanchez; Alicia,11,0,20,9
1714204316634,LISP 5B,A00,507671,Munoz Sanchez; Alicia,9,0,20,11
1714204317663,LISP 5C,A00,507696,Munoz Sanchez; Alicia,9,0,20,11
1714204318689,MAE 197,001,528363,Boechler; Nicholas Sebastia,9998,0,9999,1
1714204319720,MATH 197,001,523477,Kedlaya; Kiran S.,9996,0,9999,3
1714204319720,MATH 197,002,563811,Zhang; Danna,9995,0,9999,4
1714204319720,MATH 197,003,628552,Dumitriu; Ioana,9998,0,9999,1
1714204320754,MCWP 40R,A00,518780,Staff,5,0,20,15
1714204320754,MCWP 40R,B00,518781,Staff,7,0,20,13
1714204320754,MCWP 40R,C00,518783,Staff,5,0,20,15
1714204321781,MCWP 50R,A00,518791,Staff,0,0,20,20
1714204321781,MCWP 50R,B00,518792,Staff,0,1,20,20
1714204321781,MCWP 50R,C00,518793,Staff,0,1,20,20
1714204321781,MCWP 50R,D00,518794,Staff,0,0,20,20
1714204321781,MCWP 50R,E00,518795,Staff,0,1,20,20
1714204321781,MCWP 50R,F00,518796,Staff,0,0,20,20
1714204321781,MCWP 50R,G00,518797,Staff,0,1,20,20
1714204322808,MMW 12R,A01,514034,Herbst; Matthew,0,1,16,16
1714204322808,MMW 12R,A02,514035,Herbst; Matthew,2,0,16,14
1714204323838,MMW 13R,A01,514037,Staff,0,4,16,16
1714204323838,MMW 13R,A02,514039,Staff,0,2,16,16
1714204323838,MMW 13R,A03,628519,Staff,0,2,16,16
1714204325890,SIO 295LS,A00,523233,Staff,13,0,30,17
1714204326916,SIO 295S,A00,523232,Staff,13,0,30,17
1714204327947,SIOC 290S,A01,637330,Merrifield; Mark A,28,0,30,2
1714204328972,SIOC 291S,A01,637333,Gabriel; Corey John,28,0,30,2
1714204330002,SOCI 117,A01,494376,Staff,0,2,5,5
1714204331028,WES 237B,A00,494380,Staff,9,0,20,11
1714204333095,AESE 279B,A00,494370,Wade; Jon P,0,0,33,33
1714204334120,AIP 197,001,627712,Vespa; Emanuel Ignacio,9998,0,9999,1
1714204335149,ANAR 135S,A00,494369,Braswell; Geoffrey E.,0,0,0,0
1714204336175,BENG 196,001,628496,Engler; Adam J.,9998,0,9999,1
1714204337200,CAT 124RS,A01,519847,Geibel; William,0,0,20,20
1714204338227,CAT 125RS,A01,515971,Geibel; William,0,0,20,20
1714204339251,CLRE 250,A00,511389,Morris; Sheldon,9993,0,9999,6
1714204340276,CLRE 251,A00,507176,Mehta; Ravindra L.,9993,0,9999,6
1714204340276,CLRE 251,B00,511410,Mehta; Ravindra L.,9998,0,9999,1
1714204341308,CLRE 252,A00,507189,Cuomo; Raphael Eduardo,9995,0,9999,4
1714204342333,CLRE 253,A00,507199,Vaida; Florin,9994,0,9999,5
1714204342333,CLRE 253,B00,507202,Vaida; Florin,9999,0,9999,0
1714204343364,CLRE 259,A00,507211,Patel; Hemal,9996,0,9999,3
1714204344397,CLRE 260,A00,507221,Cuomo; Raphael Eduardo,9999,0,9999,0
1714204345423,CLRE 297,001,507242,Cuomo; Raphael Eduardo,9999,0,9999,0
1714204346450,COGS 197,001,638244,Voytek; Bradley Thomas,9999,0,9999,0
1714204347476,CSE 191,A00,516875,Minnes Kemp; Mor Mia,9993,0,9999,6
1714204348502,CSE 197,001,637388,Minnes Kemp; Mor Mia,9998,0,9999,1
1714204349531,CSS 201S,A01,494383,Staff,35,0,35,0
1714204350561,CSS 202S,A01,494387,Staff,35,0,35,0
1714204351591,DSC 197,001,628532,Eldridge; Justin Matthew,9996,0,9999,3
1714204352620,EAP 100,A00,516065,Staff,9797,0,9999,202
1714204353645,ECE 45,A01,507414,Staff,33,0,60,27
1714204355700,ECE 111,A01,507420,Staff,21,0,50,29
1714204356726,ECE 197,001,548057,Sievenpiper; Daniel F.,9994,0,9999,5
1714204357752,EDS 115,A00,507243,Choi; Bailey Miyeon,12,0,28,16
1714204358784,EDS 117,A01,494379,Staff,0,1,30,30
1714204359813,EDS 125,A00,507246,Hopkins; Megan Beth,12,0,30,18
1714204360841,EDS 128A,A01,507264,Fargason; Sharon Gayle,14,0,26,12
1714204361920,EDS 128B,A01,507293,Pappas; Elizabeth,18,0,30,12
1714204362952,EDS 139,A00,507294,Fargason; Sharon Gayle,18,0,30,12
1714204362952,EDS 139,B00,507313,Pappas; Elizabeth,15,0,30,15
1714204363978,EDS 201,A00,507315,Staff,13,0,30,17
1714204365005,EDS 203,A01,507317,Halter; Christopher P.,12,0,30,18
1714204366030,EDS 204R,A01,507319,Halter; Christopher P.,0,3,30,30
1714204366030,EDS 204R,B01,507331,Heinzman; Erica M.,17,0,30,13
1714204367058,EDS 206R,A00,507332,Staff,0,4,30,30
1714204367058,EDS 206R,B00,507343,Staff,18,0,30,12
1714204368085,EDS 250,A00,507344,Hemans; Patricia Ann Benitez,22,0,40,18
1714204369113,EDS 281,A00,507345,Daly; Alan J.,18,0,18,0
1714204370140,EDS 284,A00,507350,Daly; Alan J.,16,0,16,0
1714204371169,EDS 286,A00,507359,Fine; Sarah,18,0,18,0
1714204372222,EDS 289C,A01,507361,Daly; Alan J.,18,0,18,0
1714204373248,EDS 290,A00,507366,Hofstetter; Carolyn,15,0,15,0
1714204374278,LIGM 5A,A00,507421,Fischer-Grunski; Eva K,18,0,20,2
1714204375304,LIGM 5B,A00,507423,Fischer-Grunski; Eva K,19,0,20,1
1714204376331,LIGM 5C,A00,507425,Fischer-Grunski; Eva K,19,0,20,1
1714204377357,LIIT 5AS,A00,507427,Carnelos; Chiara,20,0,20,0
1714204378382,LIIT 5BS,A00,507430,Carnelos; Chiara,20,0,20,0
1714204379409,LIIT 5CS,A00,507432,Carnelos; Chiara,20,0,20,0
1714204380446,LISP 5A,A00,507541,Munoz Sanchez; Alicia,11,0,20,9
1714204381475,LISP 5B,A00,507671,Munoz Sanchez; Alicia,9,0,20,11
1714204382501,LISP 5C,A00,507696,Munoz Sanchez; Alicia,9,0,20,11
1714204383527,MAE 197,001,528363,Boechler; Nicholas Sebastia,9998,0,9999,1
1714204384558,MATH 197,001,523477,Kedlaya; Kiran S.,9996,0,9999,3
1714204384558,MATH 197,002,563811,Zhang; Danna,9995,0,9999,4
1714204384558,MATH 197,003,628552,Dumitriu; Ioana,9998,0,9999,1
1714204385583,MCWP 40R,A00,518780,Staff,5,0,20,15
1714204385583,MCWP 40R,B00,518781,Staff,7,0,20,13
1714204385583,MCWP 40R,C00,518783,Staff,5,0,20,15
1714204386612,MCWP 50R,A00,518791,Staff,0,0,20,20
1714204386612,MCWP 50R,B00,518792,Staff,0,1,20,20
1714204386612,MCWP 50R,C00,518793,Staff,0,1,20,20
1714204386612,MCWP 50R,D00,518794,Staff,0,0,20,20
1714204386612,MCWP 50R,E00,518795,Staff,0,1,20,20
1714204386612,MCWP 50R,F00,518796,Staff,0,0,20,20
1714204386612,MCWP 50R,G00,518797,Staff,0,1,20,20
1714204387641,MMW 12R,A01,514034,Herbst; Matthew,0,1,16,16
1714204387641,MMW 12R,A02,514035,Herbst; Matthew,2,0,16,14
1714204388667,MMW 13R,A01,514037,Staff,0,4,16,16
1714204388667,MMW 13R,A02,514039,Staff,0,2,16,16
1714204388667,MMW 13R,A03,628519,Staff,0,2,16,16
1714204390721,SIO 295LS,A00,523233,Staff,13,0,30,17
1714204391751,SIO 295S,A00,523232,Staff,13,0,30,17
1714204392778,SIOC 290S,A01,637330,Merrifield; Mark A,28,0,30,2
1714204393810,SIOC 291S,A01,637333,Gabriel; Corey John,28,0,30,2
1714204394834,SOCI 117,A01,494376,Staff,0,2,5,5
1714204395861,WES 237B,A00,494380,Staff,9,0,20,11
1714204397945,AESE 279B,A00,494370,Wade; Jon P,0,0,33,33
1714204398974,AIP 197,001,627712,Vespa; Emanuel Ignacio,9998,0,9999,1
1714204400000,ANAR 135S,A00,494369,Braswell; Geoffrey E.,0,0,0,0
1714204401027,BENG 196,001,628496,Engler; Adam J.,9998,0,9999,1
1714204402057,CAT 124RS,A01,519847,Geibel; William,0,0,20,20
1714204403086,CAT 125RS,A01,515971,Geibel; William,0,0,20,20
1714204404113,CLRE 250,A00,511389,Morris; Sheldon,9993,0,9999,6
1714204405140,CLRE 251,A00,507176,Mehta; Ravindra L.,9993,0,9999,6
1714204405140,CLRE 251,B00,511410,Mehta; Ravindra L.,9998,0,9999,1
1714204406166,CLRE 252,A00,507189,Cuomo; Raphael Eduardo,9995,0,9999,4
1714204407194,CLRE 253,A00,507199,Vaida; Florin,9994,0,9999,5
1714204407194,CLRE 253,B00,507202,Vaida; Florin,9999,0,9999,0
1714204408222,CLRE 259,A00,507211,Patel; Hemal,9996,0,9999,3
1714204409248,CLRE 260,A00,507221,Cuomo; Raphael Eduardo,9999,0,9999,0
1714204410277,CLRE 297,001,507242,Cuomo; Raphael Eduardo,9999,0,9999,0
1714204411306,COGS 197,001,638244,Voytek; Bradley Thomas,9999,0,9999,0
1714204412331,CSE 191,A00,516875,Minnes Kemp; Mor Mia,9993,0,9999,6
1714204413361,CSE 197,001,637388,Minnes Kemp; Mor Mia,9998,0,9999,1
1714204414391,CSS 201S,A01,494383,Staff,35,0,35,0
1714204415417,CSS 202S,A01,494387,Staff,35,0,35,0
1714204416447,DSC 197,001,628532,Eldridge; Justin Matthew,9996,0,9999,3
1714204417475,EAP 100,A00,516065,Staff,9797,0,9999,202
1714204418500,ECE 45,A01,507414,Staff,33,0,60,27
1714204420558,ECE 111,A01,507420,Staff,21,0,50,29
1714204421587,ECE 197,001,548057,Sievenpiper; Daniel F.,9994,0,9999,5
1714204422611,EDS 115,A00,507243,Choi; Bailey Miyeon,12,0,28,16
1714204423638,EDS 117,A01,494379,Staff,0,1,30,30
1714204424669,EDS 125,A00,507246,Hopkins; Megan Beth,12,0,30,18
1714204425725,EDS 128A,A01,507264,Fargason; Sharon Gayle,14,0,26,12
1714204426751,EDS 128B,A01,507293,Pappas; Elizabeth,18,0,30,12
1714204427779,EDS 139,A00,507294,Fargason; Sharon Gayle,18,0,30,12
1714204427779,EDS 139,B00,507313,Pappas; Elizabeth,15,0,30,15
1714204428809,EDS 201,A00,507315,Staff,13,0,30,17
1714204429839,EDS 203,A01,507317,Halter; Christopher P.,12,0,30,18
1714204430864,EDS 204R,A01,507319,Halter; Christopher P.,0,3,30,30
1714204430864,EDS 204R,B01,507331,Heinzman; Erica M.,17,0,30,13
1714204431892,EDS 206R,A00,507332,Staff,0,4,30,30
1714204431892,EDS 206R,B00,507343,Staff,18,0,30,12
1714204432918,EDS 250,A00,507344,Hemans; Patricia Ann Benitez,22,0,40,18
1714204433943,EDS 281,A00,507345,Daly; Alan J.,18,0,18,0
1714204434968,EDS 284,A00,507350,Daly; Alan J.,16,0,16,0
1714204435996,EDS 286,A00,507359,Fine; Sarah,18,0,18,0
1714204437021,EDS 289C,A01,507361,Daly; Alan J.,18,0,18,0
1714204438047,EDS 290,A00,507366,Hofstetter; Carolyn,15,0,15,0
1714204439072,LIGM 5A,A00,507421,Fischer-Grunski; Eva K,18,0,20,2
1714204440100,LIGM 5B,A00,507423,Fischer-Grunski; Eva K,19,0,20,1
1714204441127,LIGM 5C,A00,507425,Fischer-Grunski; Eva K,19,0,20,1
1714204442152,LIIT 5AS,A00,507427,Carnelos; Chiara,20,0,20,0
1714204443178,LIIT 5BS,A00,507430,Carnelos; Chiara,20,0,20,0
1714204444206,LIIT 5CS,A00,507432,Carnelos; Chiara,20,0,20,0
1714204445237,LISP 5A,A00,507541,Munoz Sanchez; Alicia,11,0,20,9
1714204446264,LISP 5B,A00,507671,Munoz Sanchez; Alicia,9,0,20,11
1714204447294,LISP 5C,A00,507696,Munoz Sanchez; Alicia,9,0,20,11
1714204448323,MAE 197,001,528363,Boechler; Nicholas Sebastia,9998,0,9999,1
1714204449352,MATH 197,001,523477,Kedlaya; Kiran S.,9996,0,9999,3
1714204449352,MATH 197,002,563811,Zhang; Danna,9995,0,9999,4
1714204449352,MATH 197,003,628552,Dumitriu; Ioana,9998,0,9999,1
1714204450379,MCWP 40R,A00,518780,Staff,5,0,20,15
1714204450379,MCWP 40R,B00,518781,Staff,7,0,20,13
1714204450379,MCWP 40R,C00,518783,Staff,5,0,20,15
1714204451411,MCWP 50R,A00,518791,Staff,0,0,20,20
1714204451411,MCWP 50R,B00,518792,Staff,0,1,20,20
1714204451411,MCWP 50R,C00,518793,Staff,0,1,20,20
1714204451411,MCWP 50R,D00,518794,Staff,0,0,20,20
1714204451411,MCWP 50R,E00,518795,Staff,0,1,20,20
1714204451411,MCWP 50R,F00,518796,Staff,0,0,20,20
1714204451411,MCWP 50R,G00,518797,Staff,0,1,20,20
1714204452436,MMW 12R,A01,514034,Herbst; Matthew,0,1,16,16
1714204452436,MMW 12R,A02,514035,Herbst; Matthew,2,0,16,14
1714204453467,MMW 13R,A01,514037,Staff,0,4,16,16
1714204453467,MMW 13R,A02,514039,Staff,0,2,16,16
1714204453467,MMW 13R,A03,628519,Staff,0,2,16,16
1714204455518,SIO 295LS,A00,523233,Staff,13,0,30,17
1714204456547,SIO 295S,A00,523232,Staff,13,0,30,17
1714204457574,SIOC 290S,A01,637330,Merrifield; Mark A,28,0,30,2
1714204458600,SIOC 291S,A01,637333,Gabriel; Corey John,28,0,30,2
1714204459627,SOCI 117,A01,494376,Staff,0,2,5,5
1714204460653,WES 237B,A00,494380,Staff,9,0,20,11
1714204462721,AESE 279B,A00,494370,Wade; Jon P,0,0,33,33
1714204463748,AIP 197,001,627712,Vespa; Emanuel Ignacio,9998,0,9999,1
1714204464775,ANAR 135S,A00,494369,Braswell; Geoffrey E.,0,0,0,0
1714204465856,BENG 196,001,628496,Engler; Adam J.,9998,0,9999,1
1714204466883,CAT 124RS,A01,519847,Geibel; William,0,0,20,20
1714204467911,CAT 125RS,A01,515971,Geibel; William,0,0,20,20
1714204468936,CLRE 250,A00,511389,Morris; Sheldon,9993,0,9999,6
1714204469964,CLRE 251,A00,507176,Mehta; Ravindra L.,9993,0,9999,6
1714204469964,CLRE 251,B00,511410,Mehta; Ravindra L.,9998,0,9999,1
1714204470989,CLRE 252,A00,507189,Cuomo; Raphael Eduardo,9995,0,9999,4
1714204472017,CLRE 253,A00,507199,Vaida; Florin,9994,0,9999,5
1714204472017,CLRE 253,B00,507202,Vaida; Florin,9999,0,9999,0
1714204473043,CLRE 259,A00,507211,Patel; Hemal,9996,0,9999,3
1714204474067,CLRE 260,A00,507221,Cuomo; Raphael Eduardo,9999,0,9999,0
1714204475096,CLRE 297,001,507242,Cuomo; Raphael Eduardo,9999,0,9999,0
1714204476122,COGS 197,001,638244,Voytek; Bradley Thomas,9999,0,9999,0
1714204477150,CSE 191,A00,516875,Minnes Kemp; Mor Mia,9993,0,9999,6
1714204478177,CSE 197,001,637388,Minnes Kemp; Mor Mia,9998,0,9999,1
1714204479205,CSS 201S,A01,494383,Staff,35,0,35,0
1714204480234,CSS 202S,A01,494387,Staff,35,0,35,0
1714204481262,DSC 197,001,628532,Eldridge; Justin Matthew,9996,0,9999,3
1714204482298,EAP 100,A00,516065,Staff,9797,0,9999,202
1714204483325,ECE 45,A01,507414,Staff,33,0,60,27
1714204485383,ECE 111,A01,507420,Staff,21,0,50,29
1714204486409,ECE 197,001,548057,Sievenpiper; Daniel F.,9994,0,9999,5
1714204487497,EDS 115,A00,507243,Choi; Bailey Miyeon,12,0,28,16
1714204488523,EDS 117,A01,494379,Staff,0,1,30,30
1714204489553,EDS 125,A00,507246,Hopkins; Megan Beth,12,0,30,18
1714204490578,EDS 128A,A01,507264,Fargason; Sharon Gayle,14,0,26,12
1714204491605,EDS 128B,A01,507293,Pappas; Elizabeth,18,0,30,12
1714204492633,EDS 139,A00,507294,Fargason; Sharon Gayle,18,0,30,12
1714204492633,EDS 139,B00,507313,Pappas; Elizabeth,15,0,30,15
1714204493662,EDS 201,A00,507315,Staff,13,0,30,17
1714204494690,EDS 203,A01,507317,Halter; Christopher P.,12,0,30,18
1714204495719,EDS 204R,A01,507319,Halter; Christopher P.,0,3,30,30
1714204495719,EDS 204R,B01,507331,Heinzman; Erica M.,17,0,30,13
1714204496746,EDS 206R,A00,507332,Staff,0,4,30,30
1714204496746,EDS 206R,B00,507343,Staff,18,0,30,12
1714204497773,EDS 250,A00,507344,Hemans; Patricia Ann Benitez,22,0,40,18
1714204498799,EDS 281,A00,507345,Daly; Alan J.,18,0,18,0
1714204499826,EDS 284,A00,507350,Daly; Alan J.,16,0,16,0
1714204500852,EDS 286,A00,507359,Fine; Sarah,18,0,18,0
1714204501879,EDS 289C,A01,507361,Daly; Alan J.,18,0,18,0
1714204502905,EDS 290,A00,507366,Hofstetter; Carolyn,15,0,15,0
1714204503932,LIGM 5A,A00,507421,Fischer-Grunski; Eva K,18,0,20,2
1714204504958,LIGM 5B,A00,507423,Fischer-Grunski; Eva K,19,0,20,1
1714204505984,LIGM 5C,A00,507425,Fischer-Grunski; Eva K,19,0,20,1
1714204507009,LIIT 5AS,A00,507427,Carnelos; Chiara,20,0,20,0
1714204508035,LIIT 5BS,A00,507430,Carnelos; Chiara,20,0,20,0
1714204509065,LIIT 5CS,A00,507432,Carnelos; Chiara,20,0,20,0
1714204510091,LISP 5A,A00,507541,Munoz Sanchez; Alicia,11,0,20,9
1714204511118,LISP 5B,A00,507671,Munoz Sanchez; Alicia,9,0,20,11
1714204512144,LISP 5C,A00,507696,Munoz Sanchez; Alicia,9,0,20,11
1714204513170,MAE 197,001,528363,Boechler; Nicholas Sebastia,9998,0,9999,1
1714204514196,MATH 197,001,523477,Kedlaya; Kiran S.,9996,0,9999,3
1714204514196,MATH 197,002,563811,Zhang; Danna,9995,0,9999,4
1714204514196,MATH 197,003,628552,Dumitriu; Ioana,9998,0,9999,1
1714204515228,MCWP 40R,A00,518780,Staff,5,0,20,15
1714204515228,MCWP 40R,B00,518781,Staff,7,0,20,13
1714204515228,MCWP 40R,C00,518783,Staff,5,0,20,15
1714204516259,MCWP 50R,A00,518791,Staff,0,0,20,20
1714204516259,MCWP 50R,B00,518792,Staff,0,1,20,20
1714204516259,MCWP 50R,C00,518793,Staff,0,1,20,20
1714204516259,MCWP 50R,D00,518794,Staff,0,0,20,20
1714204516259,MCWP 50R,E00,518795,Staff,0,1,20,20
1714204516259,MCWP 50R,F00,518796,Staff,0,0,20,20
1714204516259,MCWP 50R,G00,518797,Staff,0,1,20,20
1714204517286,MMW 12R,A01,514034,Herbst; Matthew,0,1,16,16
1714204517286,MMW 12R,A02,514035,Herbst; Matthew,2,0,16,14
1714204518314,MMW 13R,A01,514037,Staff,0,4,16,16
1714204518314,MMW 13R,A02,514039,Staff,0,2,16,16
1714204518314,MMW 13R,A03,628519,Staff,0,2,16,16
1714204520376,SIO 295LS,A00,523233,Staff,13,0,30,17
1714204521402,SIO 295S,A00,523232,Staff,13,0,30,17
1714204522427,SIOC 290S,A01,637330,Merrifield; Mark A,28,0,30,2
1714204523451,SIOC 291S,A01,637333,Gabriel; Corey John,28,0,30,2
1714204524477,SOCI 117,A01,494376,Staff,0,2,5,5
1714204525503,WES 237B,A00,494380,Staff,9,0,20,11
1714204527568,AESE 279B,A00,494370,Wade; Jon P,0,0,33,33
1714204528592,AIP 197,001,627712,Vespa; Emanuel Ignacio,9998,0,9999,1
1714204529618,ANAR 135S,A00,494369,Braswell; Geoffrey E.,0,0,0,0
1714204530645,BENG 196,001,628496,Engler; Adam J.,9998,0,9999,1
1714204531670,CAT 124RS,A01,519847,Geibel; William,0,0,20,20
1714204532696,CAT 125RS,A01,515971,Geibel; William,0,0,20,20
1714204533722,CLRE 250,A00,511389,Morris; Sheldon,9993,0,9999,6
1714204534749,CLRE 251,A00,507176,Mehta; Ravindra L.,9993,0,9999,6
1714204534749,CLRE 251,B00,511410,Mehta; Ravindra L.,9998,0,9999,1
1714204535774,CLRE 252,A00,507189,Cuomo; Raphael Eduardo,9995,0,9999,4
1714204536800,CLRE 253,A00,507199,Vaida; Florin,9994,0,9999,5
1714204536800,CLRE 253,B00,507202,Vaida; Florin,9999,0,9999,0
1714204537825,CLRE 259,A00,507211,Patel; Hemal,9996,0,9999,3
1714204538851,CLRE 260,A00,507221,Cuomo; Raphael Eduardo,9999,0,9999,0
1714204539876,CLRE 297,001,507242,Cuomo; Raphael Eduardo,9999,0,9999,0
1714204540904,COGS 197,001,638244,Voytek; Bradley Thomas,9999,0,9999,0
1714204541932,CSE 191,A00,516875,Minnes Kemp; Mor Mia,9993,0,9999,6
1714204542957,CSE 197,001,637388,Minnes Kemp; Mor Mia,9998,0,9999,1
1714204543986,CSS 201S,A01,494383,Staff,35,0,35,0
1714204545012,CSS 202S,A01,494387,Staff,35,0,35,0
1714204546037,DSC 197,001,628532,Eldridge; Justin Matthew,9996,0,9999,3
1714204547066,EAP 100,A00,516065,Staff,9797,0,9999,202
1714204548095,ECE 45,A01,507414,Staff,33,0,60,27
1714204550149,ECE 111,A01,507420,Staff,21,0,50,29
1714204551174,ECE 197,001,548057,Sievenpiper; Daniel F.,9994,0,9999,5
1714204552200,EDS 115,A00,507243,Choi; Bailey Miyeon,12,0,28,16
1714204553226,EDS 117,A01,494379,Staff,0,1,30,30
1714204554251,EDS 125,A00,507246,Hopkins; Megan Beth,12,0,30,18
1714204555275,EDS 128A,A01,507264,Fargason; Sharon Gayle,14,0,26,12
1714204556305,EDS 128B,A01,507293,Pappas; Elizabeth,18,0,30,12
1714204557333,EDS 139,A00,507294,Fargason; Sharon Gayle,18,0,30,12
1714204557333,EDS 139,B00,507313,Pappas; Elizabeth,15,0,30,15
1714204558361,EDS 201,A00,507315,Staff,13,0,30,17
1714204559390,EDS 203,A01,507317,Halter; Christopher P.,12,0,30,18
1714204560416,EDS 204R,A01,507319,Halter; Christopher P.,0,3,30,30
1714204560416,EDS 204R,B01,507331,Heinzman; Erica M.,17,0,30,13
1714204561443,EDS 206R,A00,507332,Staff,0,4,30,30
1714204561443,EDS 206R,B00,507343,Staff,18,0,30,12
1714204562473,EDS 250,A00,507344,Hemans; Patricia Ann Benitez,22,0,40,18
1714204563501,EDS 281,A00,507345,Daly; Alan J.,18,0,18,0
1714204564529,EDS 284,A00,507350,Daly; Alan J.,16,0,16,0
1714204565557,EDS 286,A00,507359,Fine; Sarah,18,0,18,0
1714204566583,EDS 289C,A01,507361,Daly; Alan J.,18,0,18,0
1714204567610,EDS 290,A00,507366,Hofstetter; Carolyn,15,0,15,0
1714204568640,LIGM 5A,A00,507421,Fischer-Grunski; Eva K,18,0,20,2
1714204569724,LIGM 5B,A00,507423,Fischer-Grunski; Eva K,19,0,20,1
1714204570750,LIGM 5C,A00,507425,Fischer-Grunski; Eva K,19,0,20,1
1714204571778,LIIT 5AS,A00,507427,Carnelos; Chiara,20,0,20,0
1714204572804,LIIT 5BS,A00,507430,Carnelos; Chiara,20,0,20,0
1714204573829,LIIT 5CS,A00,507432,Carnelos; Chiara,20,0,20,0
1714204574859,LISP 5A,A00,507541,Munoz Sanchez; Alicia,11,0,20,9
1714204575886,LISP 5B,A00,507671,Munoz Sanchez; Alicia,9,0,20,11
1714204576914,LISP 5C,A00,507696,Munoz Sanchez; Alicia,9,0,20,11
1714204577939,MAE 197,001,528363,Boechler; Nicholas Sebastia,9998,0,9999,1
1714204578972,MATH 197,001,523477,Kedlaya; Kiran S.,9996,0,9999,3
1714204578972,MATH 197,002,563811,Zhang; Danna,9995,0,9999,4
1714204578972,MATH 197,003,628552,Dumitriu; Ioana,9998,0,9999,1
1714204580000,MCWP 40R,A00,518780,Staff,5,0,20,15
1714204580000,MCWP 40R,B00,518781,Staff,7,0,20,13
1714204580000,MCWP 40R,C00,518783,Staff,5,0,20,15
1714204581029,MCWP 50R,A00,518791,Staff,0,0,20,20
1714204581029,MCWP 50R,B00,518792,Staff,0,1,20,20
1714204581029,MCWP 50R,C00,518793,Staff,0,1,20,20
1714204581029,MCWP 50R,D00,518794,Staff,0,0,20,20
1714204581029,MCWP 50R,E00,518795,Staff,0,1,20,20
1714204581029,MCWP 50R,F00,518796,Staff,0,0,20,20
1714204581029,MCWP 50R,G00,518797,Staff,0,1,20,20
1714204582061,MMW 12R,A01,514034,Herbst; Matthew,0,1,16,16
1714204582061,MMW 12R,A02,514035,Herbst; Matthew,2,0,16,14
1714204583089,MMW 13R,A01,514037,Staff,0,4,16,16
1714204583089,MMW 13R,A02,514039,Staff,0,2,16,16
1714204583089,MMW 13R,A03,628519,Staff,0,2,16,16
1714204585139,SIO 295LS,A00,523233,Staff,13,0,30,17
1714204586164,SIO 295S,A00,523232,Staff,13,0,30,17
1714204587190,SIOC 290S,A01,637330,Merrifield; Mark A,28,0,30,2
1714204588218,SIOC 291S,A01,637333,Gabriel; Corey John,28,0,30,2
1714204589246,SOCI 117,A01,494376,Staff,0,2,5,5
1714204590274,WES 237B,A00,494380,Staff,9,0,20,11
1714204592347,AESE 279B,A00,494370,Wade; Jon P,0,0,33,33
1714204593374,AIP 197,001,627712,Vespa; Emanuel Ignacio,9998,0,9999,1
1714204594401,ANAR 135S,A00,494369,Braswell; Geoffrey E.,0,0,0,0
1714204595432,BENG 196,001,628496,Engler; Adam J.,9998,0,9999,1
1714204596465,CAT 124RS,A01,519847,Geibel; William,0,0,20,20
1714204597490,CAT 125RS,A01,515971,Geibel; William,0,0,20,20
1714204598515,CLRE 250,A00,511389,Morris; Sheldon,9993,0,9999,6
1714204599542,CLRE 251,A00,507176,Mehta; Ravindra L.,9993,0,9999,6
1714204599542,CLRE 251,B00,511410,Mehta; Ravindra L.,9998,0,9999,1
1714204600575,CLRE 252,A00,507189,Cuomo; Raphael Eduardo,9995,0,9999,4
1714204601600,CLRE 253,A00,507199,Vaida; Florin,9994,0,9999,5
1714204601600,CLRE 253,B00,507202,Vaida; Florin,9999,0,9999,0
1714204602626,CLRE 259,A00,507211,Patel; Hemal,9996,0,9999,3
1714204603655,CLRE 260,A00,507221,Cuomo; Raphael Eduardo,9999,0,9999,0
1714204604682,CLRE 297,001,507242,Cuomo; Raphael Eduardo,9999,0,9999,0
1714204605708,COGS 197,001,638244,Voytek; Bradley Thomas,9999,0,9999,0
1714204606737,CSE 191,A00,516875,Minnes Kemp; Mor Mia,9993,0,9999,6
1714204607762,CSE 197,001,637388,Minnes Kemp; Mor Mia,9998,0,9999,1
1714204608791,CSS 201S,A01,494383,Staff,35,0,35,0
1714204609818,CSS 202S,A01,494387,Staff,35,0,35,0
1714204610843,DSC 197,001,628532,Eldridge; Justin Matthew,9996,0,9999,3
1714204611872,EAP 100,A00,516065,Staff,9797,0,9999,202
1714204612900,ECE 45,A01,507414,Staff,33,0,60,27
1714204614954,ECE 111,A01,507420,Staff,21,0,50,29
1714204615980,ECE 197,001,548057,Sievenpiper; Daniel F.,9994,0,9999,5
1714204617007,EDS 115,A00,507243,Choi; Bailey Miyeon,12,0,28,16
1714204618031,EDS 117,A01,494379,Staff,0,1,30,30
1714204619058,EDS 125,A00,507246,Hopkins; Megan Beth,12,0,30,18
1714204620088,EDS 128A,A01,507264,Fargason; Sharon Gayle,14,0,26,12
1714204621117,EDS 128B,A01,507293,Pappas; Elizabeth,18,0,30,12
1714204622142,EDS 139,A00,507294,Fargason; Sharon Gayle,18,0,30,12
1714204622142,EDS 139,B00,507313,Pappas; Elizabeth,15,0,30,15
1714204623167,EDS 201,A00,507315,Staff,13,0,30,17
1714204624193,EDS 203,A01,507317,Halter; Christopher P.,12,0,30,18
1714204625220,EDS 204R,A01,507319,Halter; Christopher P.,0,3,30,30
1714204625220,EDS 204R,B01,507331,Heinzman; Erica M.,17,0,30,13
1714204626245,EDS 206R,A00,507332,Staff,0,4,30,30
1714204626245,EDS 206R,B00,507343,Staff,18,0,30,12
1714204627271,EDS 250,A00,507344,Hemans; Patricia Ann Benitez,22,0,40,18
1714204628299,EDS 281,A00,507345,Daly; Alan J.,18,0,18,0
1714204629328,EDS 284,A00,507350,Daly; Alan J.,16,0,16,0
1714204630354,EDS 286,A00,507359,Fine; Sarah,18,0,18,0
1714204631384,EDS 289C,A01,507361,Daly; Alan J.,18,0,18,0
1714204632412,EDS 290,A00,507366,Hofstetter; Carolyn,15,0,15,0
1714204633439,LIGM 5A,A00,507421,Fischer-Grunski; Eva K,18,0,20,2
1714204634465,LIGM 5B,A00,507423,Fischer-Grunski; Eva K,19,0,20,1
1714204635491,LIGM 5C,A00,507425,Fischer-Grunski; Eva K,19,0,20,1
1714204636521,LIIT 5AS,A00,507427,Carnelos; Chiara,20,0,20,0
1714204637548,LIIT 5BS,A00,507430,Carnelos; Chiara,20,0,20,0
1714204638573,LIIT 5CS,A00,507432,Carnelos; Chiara,20,0,20,0
1714204639600,LISP 5A,A00,507541,Munoz Sanchez; Alicia,11,0,20,9
1714204640629,LISP 5B,A00,507671,Munoz Sanchez; Alicia,9,0,20,11
1714204641654,LISP 5C,A00,507696,Munoz Sanchez; Alicia,9,0,20,11
1714204642680,MAE 197,001,528363,Boechler; Nicholas Sebastia,9998,0,9999,1
1714204643707,MATH 197,001,523477,Kedlaya; Kiran S.,9996,0,9999,3
1714204643707,MATH 197,002,563811,Zhang; Danna,9995,0,9999,4
1714204643707,MATH 197,003,628552,Dumitriu; Ioana,9998,0,9999,1
1714204644734,MCWP 40R,A00,518780,Staff,5,0,20,15
1714204644734,MCWP 40R,B00,518781,Staff,7,0,20,13
1714204644734,MCWP 40R,C00,518783,Staff,5,0,20,15
1714204645765,MCWP 50R,A00,518791,Staff,0,0,20,20
1714204645765,MCWP 50R,B00,518792,Staff,0,1,20,20
1714204645765,MCWP 50R,C00,518793,Staff,0,1,20,20
1714204645765,MCWP 50R,D00,518794,Staff,0,0,20,20
1714204645765,MCWP 50R,E00,518795,Staff,0,1,20,20
1714204645765,MCWP 50R,F00,518796,Staff,0,0,20,20
1714204645765,MCWP 50R,G00,518797,Staff,0,1,20,20
1714204646794,MMW 12R,A01,514034,Herbst; Matthew,0,1,16,16
1714204646794,MMW 12R,A02,514035,Herbst; Matthew,2,0,16,14
1714204647819,MMW 13R,A01,514037,Staff,0,4,16,16
1714204647819,MMW 13R,A02,514039,Staff,0,2,16,16
1714204647819,MMW 13R,A03,628519,Staff,0,2,16,16
1714204649873,SIO 295LS,A00,523233,Staff,13,0,30,17
1714204650898,SIO 295S,A00,523232,Staff,13,0,30,17
1714204651924,SIOC 290S,A01,637330,Merrifield; Mark A,28,0,30,2
1714204652954,SIOC 291S,A01,637333,Gabriel; Corey John,28,0,30,2
1714204653980,SOCI 117,A01,494376,Staff,0,2,5,5
1714204655008,WES 237B,A00,494380,Staff,9,0,20,11
1714204657069,AESE 279B,A00,494370,Wade; Jon P,0,0,33,33
1714204658095,AIP 197,001,627712,Vespa; Emanuel Ignacio,9998,0,9999,1
1714204659121,ANAR 135S,A00,494369,Braswell; Geoffrey E.,0,0,0,0
1714204660150,BENG 196,001,628496,Engler; Adam J.,9998,0,9999,1
1714204661177,CAT 124RS,A01,519847,Geibel; William,0,0,20,20
1714204662202,CAT 125RS,A01,515971,Geibel; William,0,0,20,20
1714204663227,CLRE 250,A00,511389,Morris; Sheldon,9993,0,9999,6
1714204664254,CLRE 251,A00,507176,Mehta; Ravindra L.,9993,0,9999,6
1714204664254,CLRE 251,B00,511410,Mehta; Ravindra L.,9998,0,9999,1
1714204665281,CLRE 252,A00,507189,Cuomo; Raphael Eduardo,9995,0,9999,4
1714204666310,CLRE 253,A00,507199,Vaida; Florin,9994,0,9999,5
1714204666310,CLRE 253,B00,507202,Vaida; Florin,9999,0,9999,0
1714204667336,CLRE 259,A00,507211,Patel; Hemal,9996,0,9999,3
1714204668363,CLRE 260,A00,507221,Cuomo; Raphael Eduardo,9999,0,9999,0
1714204669388,CLRE 297,001,507242,Cuomo; Raphael Eduardo,9999,0,9999,0
1714204670417,COGS 197,001,638244,Voytek; Bradley Thomas,9999,0,9999,0
1714204671441,CSE 191,A00,516875,Minnes Kemp; Mor Mia,9993,0,9999,6
1714204672469,CSE 197,001,637388,Minnes Kemp; Mor Mia,9998,0,9999,1
1714204673551,CSS 201S,A01,494383,Staff,35,0,35,0
1714204674579,CSS 202S,A01,494387,Staff,35,0,35,0
1714204675607,DSC 197,001,628532,Eldridge; Justin Matthew,9996,0,9999,3
1714204676632,EAP 100,A00,516065,Staff,9797,0,9999,202
1714204677659,ECE 45,A01,507414,Staff,33,0,60,27
1714204679711,ECE 111,A01,507420,Staff,21,0,50,29
1714204680736,ECE 197,001,548057,Sievenpiper; Daniel F.,9994,0,9999,5
1714204681765,EDS 115,A00,507243,Choi; Bailey Miyeon,12,0,28,16
1714204682791,EDS 117,A01,494379,Staff,0,1,30,30
1714204683836,EDS 125,A00,507246,Hopkins; Megan Beth,12,0,30,18
1714204684861,EDS 128A,A01,507264,Fargason; Sharon Gayle,14,0,26,12
1714204685885,EDS 128B,A01,507293,Pappas; Elizabeth,18,0,30,12
1714204686910,EDS 139,A00,507294,Fargason; Sharon Gayle,18,0,30,12
1714204686910,EDS 139,B00,507313,Pappas; Elizabeth,15,0,30,15
1714204687936,EDS 201,A00,507315,Staff,13,0,30,17
1714204688964,EDS 203,A01,507317,Halter; Christopher P.,12,0,30,18
1714204689990,EDS 204R,A01,507319,Halter; Christopher P.,0,3,30,30
1714204689990,EDS 204R,B01,507331,Heinzman; Erica M.,17,0,30,13
1714204691018,EDS 206R,A00,507332,Staff,0,4,30,30
1714204691018,EDS 206R,B00,507343,Staff,18,0,30,12
1714204692042,EDS 250,A00,507344,Hemans; Patricia Ann Benitez,22,0,40,18
1714204693067,EDS 281,A00,507345,Daly; Alan J.,18,0,18,0
1714204694092,EDS 284,A00,507350,Daly; Alan J.,16,0,16,0
1714204695116,EDS 286,A00,507359,Fine; Sarah,18,0,18,0
1714204696142,EDS 289C,A01,507361,Daly; Alan J.,18,0,18,0
1714204697171,EDS 290,A00,507366,Hofstetter; Carolyn,15,0,15,0
1714204698201,LIGM 5A,A00,507421,Fischer-Grunski; Eva K,18,0,20,2
1714204699229,LIGM 5B,A00,507423,Fischer-Grunski; Eva K,19,0,20,1
1714204700257,LIGM 5C,A00,507425,Fischer-Grunski; Eva K,19,0,20,1
1714204701284,LIIT 5AS,A00,507427,Carnelos; Chiara,20,0,20,0
1714204702310,LIIT 5BS,A00,507430,Carnelos; Chiara,20,0,20,0
1714204703336,LIIT 5CS,A00,507432,Carnelos; Chiara,20,0,20,0
1714204704366,LISP 5A,A00,507541,Munoz Sanchez; Alicia,11,0,20,9
1714204705394,LISP 5B,A00,507671,Munoz Sanchez; Alicia,9,0,20,11
1714204706420,LISP 5C,A00,507696,Munoz Sanchez; Alicia,9,0,20,11
1714204707446,MAE 197,001,528363,Boechler; Nicholas Sebastia,9998,0,9999,1
1714204708475,MATH 197,001,523477,Kedlaya; Kiran S.,9996,0,9999,3
1714204708475,MATH 197,002,563811,Zhang; Danna,9995,0,9999,4
1714204708475,MATH 197,003,628552,Dumitriu; Ioana,9998,0,9999,1
1714204709500,MCWP 40R,A00,518780,Staff,5,0,20,15
1714204709500,MCWP 40R,B00,518781,Staff,7,0,20,13
1714204709500,MCWP 40R,C00,518783,Staff,5,0,20,15
1714204710529,MCWP 50R,A00,518791,Staff,0,0,20,20
1714204710529,MCWP 50R,B00,518792,Staff,0,1,20,20
1714204710529,MCWP 50R,C00,518793,Staff,0,1,20,20
1714204710529,MCWP 50R,D00,518794,Staff,0,0,20,20
1714204710529,MCWP 50R,E00,518795,Staff,0,1,20,20
1714204710529,MCWP 50R,F00,518796,Staff,0,0,20,20
1714204710529,MCWP 50R,G00,518797,Staff,0,1,20,20
1714204711556,MMW 12R,A01,514034,Herbst; Matthew,0,1,16,16
1714204711556,MMW 12R,A02,514035,Herbst; Matthew,2,0,16,14
1714204712585,MMW 13R,A01,514037,Staff,0,4,16,16
1714204712585,MMW 13R,A02,514039,Staff,0,2,16,16
1714204712585,MMW 13R,A03,628519,Staff,0,2,16,16
1714204714636,SIO 295LS,A00,523233,Staff,13,0,30,17
1714204715661,SIO 295S,A00,523232,Staff,13,0,30,17
1714204716688,SIOC 290S,A01,637330,Merrifield; Mark A,28,0,30,2
1714204717723,SIOC 291S,A01,637333,Gabriel; Corey John,28,0,30,2
1714204718753,SOCI 117,A01,494376,Staff,0,2,5,5
1714204719778,WES 237B,A00,494380,Staff,9,0,20,11
1714204721847,AESE 279B,A00,494370,Wade; Jon P,0,0,33,33
1714204722872,AIP 197,001,627712,Vespa; Emanuel Ignacio,9998,0,9999,1
1714204723897,ANAR 135S,A00,494369,Braswell; Geoffrey E.,0,0,0,0
1714204724923,BENG 196,001,628496,Engler; Adam J.,9998,0,9999,1
1714204725949,CAT 124RS,A01,519847,Geibel; William,0,0,20,20
1714204726972,CAT 125RS,A01,515971,Geibel; William,0,0,20,20
1714204727996,CLRE 250,A00,511389,Morris; Sheldon,9993,0,9999,6
1714204729026,CLRE 251,A00,507176,Mehta; Ravindra L.,9993,0,9999,6
1714204729026,CLRE 251,B00,511410,Mehta; Ravindra L.,9998,0,9999,1
1714204730051,CLRE 252,A00,507189,Cuomo; Raphael Eduardo,9995,0,9999,4
1714204731078,CLRE 253,A00,507199,Vaida; Florin,9994,0,9999,5
1714204731078,CLRE 253,B00,507202,Vaida; Florin,9999,0,9999,0
1714204732107,CLRE 259,A00,507211,Patel; Hemal,9996,0,9999,3
1714204733132,CLRE 260,A00,507221,Cuomo; Raphael Eduardo,9999,0,9999,0
1714204734156,CLRE 297,001,507242,Cuomo; Raphael Eduardo,9999,0,9999,0
1714204735185,COGS 197,001,638244,Voytek; Bradley Thomas,9999,0,9999,0
1714204736212,CSE 191,A00,516875,Minnes Kemp; Mor Mia,9993,0,9999,6
1714204737235,CSE 197,001,637388,Minnes Kemp; Mor Mia,9998,0,9999,1
1714204738265,CSS 201S,A01,494383,Staff,35,0,35,0
1714204739290,CSS 202S,A01,494387,Staff,35,0,35,0
1714204740316,DSC 197,001,628532,Eldridge; Justin Matthew,9996,0,9999,3
1714204741340,EAP 100,A00,516065,Staff,9797,0,9999,202
1714204742370,ECE 45,A01,507414,Staff,33,0,60,27
1714204744426,ECE 111,A01,507420,Staff,21,0,50,29
1714204745451,ECE 197,001,548057,Sievenpiper; Daniel F.,9994,0,9999,5
1714204746476,EDS 115,A00,507243,Choi; Bailey Miyeon,12,0,28,16
1714204747503,EDS 117,A01,494379,Staff,0,1,30,30
1714204748529,EDS 125,A00,507246,Hopkins; Megan Beth,12,0,30,18
1714204749554,EDS 128A,A01,507264,Fargason; Sharon Gayle,14,0,26,12
1714204750580,EDS 128B,A01,507293,Pappas; Elizabeth,18,0,30,12
1714204751605,EDS 139,A00,507294,Fargason; Sharon Gayle,18,0,30,12
1714204751605,EDS 139,B00,507313,Pappas; Elizabeth,15,0,30,15
1714204752631,EDS 201,A00,507315,Staff,13,0,30,17
1714204753657,EDS 203,A01,507317,Halter; Christopher P.,12,0,30,18
1714204754685,EDS 204R,A01,507319,Halter; Christopher P.,0,3,30,30
1714204754685,EDS 204R,B01,507331,Heinzman; Erica M.,17,0,30,13
1714204755713,EDS 206R,A00,507332,Staff,0,4,30,30
1714204755713,EDS 206R,B00,507343,Staff,18,0,30,12
1714204756742,EDS 250,A00,507344,Hemans; Patricia Ann Benitez,22,0,40,18
1714204757770,EDS 281,A00,507345,Daly; Alan J.,18,0,18,0
1714204758797,EDS 284,A00,507350,Daly; Alan J.,16,0,16,0
1714204759826,EDS 286,A00,507359,Fine; Sarah,18,0,18,0
1714204760851,EDS 289C,A01,507361,Daly; Alan J.,18,0,18,0
1714204761881,EDS 290,A00,507366,Hofstetter; Carolyn,15,0,15,0
1714204762907,LIGM 5A,A00,507421,Fischer-Grunski; Eva K,18,0,20,2
1714204763933,LIGM 5B,A00,507423,Fischer-Grunski; Eva K,19,0,20,1
1714204764958,LIGM 5C,A00,507425,Fischer-Grunski; Eva K,19,0,20,1
1714204765984,LIIT 5AS,A00,507427,Carnelos; Chiara,20,0,20,0
1714204767010,LIIT 5BS,A00,507430,Carnelos; Chiara,20,0,20,0
1714204768036,LIIT 5CS,A00,507432,Carnelos; Chiara,20,0,20,0
1714204769062,LISP 5A,A00,507541,Munoz Sanchez; Alicia,11,0,20,9
1714204770088,LISP 5B,A00,507671,Munoz Sanchez; Alicia,9,0,20,11
1714204771114,LISP 5C,A00,507696,Munoz Sanchez; Alicia,9,0,20,11
1714204772142,MAE 197,001,528363,Boechler; Nicholas Sebastia,9998,0,9999,1
1714204773167,MATH 197,001,523477,Kedlaya; Kiran S.,9996,0,9999,3
1714204773167,MATH 197,002,563811,Zhang; Danna,9995,0,9999,4
1714204773167,MATH 197,003,628552,Dumitriu; Ioana,9998,0,9999,1
1714204774197,MCWP 40R,A00,518780,Staff,5,0,20,15
1714204774197,MCWP 40R,B00,518781,Staff,7,0,20,13
1714204774197,MCWP 40R,C00,518783,Staff,5,0,20,15
1714204775224,MCWP 50R,A00,518791,Staff,0,0,20,20
1714204775224,MCWP 50R,B00,518792,Staff,0,1,20,20
1714204775224,MCWP 50R,C00,518793,Staff,0,1,20,20
1714204775224,MCWP 50R,D00,518794,Staff,0,0,20,20
1714204775224,MCWP 50R,E00,518795,Staff,0,1,20,20
1714204775224,MCWP 50R,F00,518796,Staff,0,0,20,20
1714204775224,MCWP 50R,G00,518797,Staff,0,1,20,20
1714204776251,MMW 12R,A01,514034,Herbst; Matthew,0,1,16,16
1714204776251,MMW 12R,A02,514035,Herbst; Matthew,2,0,16,14
1714204777332,MMW 13R,A01,514037,Staff,0,4,16,16
1714204777332,MMW 13R,A02,514039,Staff,0,2,16,16
1714204777332,MMW 13R,A03,628519,Staff,0,2,16,16
1714204779387,SIO 295LS,A00,523233,Staff,13,0,30,17
1714204780415,SIO 295S,A00,523232,Staff,13,0,30,17
1714204781444,SIOC 290S,A01,637330,Merrifield; Mark A,28,0,30,2
1714204782477,SIOC 291S,A01,637333,Gabriel; Corey John,28,0,30,2
1714204783502,SOCI 117,A01,494376,Staff,0,2,5,5
1714204784528,WES 237B,A00,494380,Staff,9,0,20,11
1714204786592,AESE 279B,A00,494370,Wade; Jon P,0,0,33,33
1714204787621,AIP 197,001,627712,Vespa; Emanuel Ignacio,9998,0,9999,1
1714204788648,ANAR 135S,A00,494369,Braswell; Geoffrey E.,0,0,0,0
1714204789874,BENG 196,001,628496,Engler; Adam J.,9998,0,9999,1
1714204790904,CAT 124RS,A01,519847,Geibel; William,0,0,20,20
1714204791931,CAT 125RS,A01,515971,Geibel; William,0,0,20,20
1714204792958,CLRE 250,A00,511389,Morris; Sheldon,9993,0,9999,6
1714204793987,CLRE 251,A00,507176,Mehta; Ravindra L.,9993,0,9999,6
1714204793987,CLRE 251,B00,511410,Mehta; Ravindra L.,9998,0,9999,1
1714204795013,CLRE 252,A00,507189,Cuomo; Raphael Eduardo,9995,0,9999,4
1714204796043,CLRE 253,A00,507199,Vaida; Florin,9994,0,9999,5
1714204796043,CLRE 253,B00,507202,Vaida; Florin,9999,0,9999,0
1714204797071,CLRE 259,A00,507211,Patel; Hemal,9996,0,9999,3
1714204798096,CLRE 260,A00,507221,Cuomo; Raphael Eduardo,9999,0,9999,0
1714204799124,CLRE 297,001,507242,Cuomo; Raphael Eduardo,9999,0,9999,0
1714204800149,COGS 197,001,638244,Voytek; Bradley Thomas,9999,0,9999,0
1714204801173,CSE 191,A00,516875,Minnes Kemp; Mor Mia,9993,0,9999,6
1714204802199,CSE 197,001,637388,Minnes Kemp; Mor Mia,9998,0,9999,1
1714204803223,CSS 201S,A01,494383,Staff,35,0,35,0
1714204804248,CSS 202S,A01,494387,Staff,35,0,35,0
1714204805278,DSC 197,001,628532,Eldridge; Justin Matthew,9996,0,9999,3
1714204806302,EAP 100,A00,516065,Staff,9797,0,9999,202
1714204807329,ECE 45,A01,507414,Staff,33,0,60,27
1714204809381,ECE 111,A01,507420,Staff,21,0,50,29
1714204810407,ECE 197,001,548057,Sievenpiper; Daniel F.,9994,0,9999,5
1714204811435,EDS 115,A00,507243,Choi; Bailey Miyeon,12,0,28,16
1714204812464,EDS 117,A01,494379,Staff,0,1,30,30
1714204813489,EDS 125,A00,507246,Hopkins; Megan Beth,12,0,30,18
1714204814514,EDS 128A,A01,507264,Fargason; Sharon Gayle,14,0,26,12
1714204815543,EDS 128B,A01,507293,Pappas; Elizabeth,18,0,30,12
1714204816572,EDS 139,A00,507294,Fargason; Sharon Gayle,18,0,30,12
1714204816572,EDS 139,B00,507313,Pappas; Elizabeth,15,0,30,15
1714204817600,EDS 201,A00,507315,Staff,13,0,30,17
1714204818625,EDS 203,A01,507317,Halter; Christopher P.,12,0,30,18
1714204819650,EDS 204R,A01,507319,Halter; Christopher P.,0,3,30,30
1714204819650,EDS 204R,B01,507331,Heinzman; Erica M.,17,0,30,13
1714204820676,EDS 206R,A00,507332,Staff,0,4,30,30
1714204820676,EDS 206R,B00,507343,Staff,18,0,30,12
1714204821703,EDS 250,A00,507344,Hemans; Patricia Ann Benitez,22,0,40,18
1714204822729,EDS 281,A00,507345,Daly; Alan J.,18,0,18,0
1714204823754,EDS 284,A00,507350,Daly; Alan J.,16,0,16,0
1714204824786,EDS 286,A00,507359,Fine; Sarah,18,0,18,0
1714204825811,EDS 289C,A01,507361,Daly; Alan J.,18,0,18,0
1714204826835,EDS 290,A00,507366,Hofstetter; Carolyn,15,0,15,0
1714204827864,LIGM 5A,A00,507421,Fischer-Grunski; Eva K,18,0,20,2
1714204828893,LIGM 5B,A00,507423,Fischer-Grunski; Eva K,19,0,20,1
1714204829927,LIGM 5C,A00,507425,Fischer-Grunski; Eva K,19,0,20,1
1714204830956,LIIT 5AS,A00,507427,Carnelos; Chiara,20,0,20,0
1714204831981,LIIT 5BS,A00,507430,Carnelos; Chiara,20,0,20,0
1714204833017,LIIT 5CS,A00,507432,Carnelos; Chiara,20,0,20,0
1714204834044,LISP 5A,A00,507541,Munoz Sanchez; Alicia,11,0,20,9
1714204835070,LISP 5B,A00,507671,Munoz Sanchez; Alicia,9,0,20,11
1714204836096,LISP 5C,A00,507696,Munoz Sanchez; Alicia,9,0,20,11
1714204837121,MAE 197,001,528363,Boechler; Nicholas Sebastia,9998,0,9999,1
1714204838151,MATH 197,001,523477,Kedlaya; Kiran S.,9996,0,9999,3
1714204838151,MATH 197,002,563811,Zhang; Danna,9995,0,9999,4
1714204838151,MATH 197,003,628552,Dumitriu; Ioana,9998,0,9999,1
1714204839177,MCWP 40R,A00,518780,Staff,5,0,20,15
1714204839177,MCWP 40R,B00,518781,Staff,7,0,20,13
1714204839177,MCWP 40R,C00,518783,Staff,5,0,20,15
1714204840203,MCWP 50R,A00,518791,Staff,0,0,20,20
1714204840203,MCWP 50R,B00,518792,Staff,0,1,20,20
1714204840203,MCWP 50R,C00,518793,Staff,0,1,20,20
1714204840203,MCWP 50R,D00,518794,Staff,0,0,20,20
1714204840203,MCWP 50R,E00,518795,Staff,0,1,20,20
1714204840203,MCWP 50R,F00,518796,Staff,0,0,20,20
1714204840203,MCWP 50R,G00,518797,Staff,0,1,20,20
1714204841233,MMW 12R,A01,514034,Herbst; Matthew,0,1,16,16
1714204841233,MMW 12R,A02,514035,Herbst; Matthew,2,0,16,14
1714204842261,MMW 13R,A01,514037,Staff,0,4,16,16
1714204842261,MMW 13R,A02,514039,Staff,0,2,16,16
1714204842261,MMW 13R,A03,628519,Staff,0,2,16,16
1714204844311,SIO 295LS,A00,523233,Staff,13,0,30,17
1714204845336,SIO 295S,A00,523232,Staff,13,0,30,17
1714204846371,SIOC 290S,A01,637330,Merrifield; Mark A,28,0,30,2
1714204847398,SIOC 291S,A01,637333,Gabriel; Corey John,28,0,30,2
1714204848425,SOCI 117,A01,494376,Staff,0,2,5,5
1714204849451,WES 237B,A00,494380,Staff,9,0,20,11
1714204851534,AESE 279B,A00,494370,Wade; Jon P,0,0,33,33
1714204852559,AIP 197,001,627712,Vespa; Emanuel Ignacio,9998,0,9999,1
1714204853589,ANAR 135S,A00,494369,Braswell; Geoffrey E.,0,0,0,0
1714204854615,BENG 196,001,628496,Engler; Adam J.,9998,0,9999,1
1714204855642,CAT 124RS,A01,519847,Geibel; William,0,0,20,20
1714204856669,CAT 125RS,A01,515971,Geibel; William,0,0,20,20
1714204857695,CLRE 250,A00,511389,Morris; Sheldon,9993,0,9999,6
1714204858721,CLRE 251,A00,507176,Mehta; Ravindra L.,9993,0,9999,6
1714204858721,CLRE 251,B00,511410,Mehta; Ravindra L.,9998,0,9999,1
1714204859746,CLRE 252,A00,507189,Cuomo; Raphael Eduardo,9995,0,9999,4
1714204860773,CLRE 253,A00,507199,Vaida; Florin,9994,0,9999,5
1714204860773,CLRE 253,B00,507202,Vaida; Florin,9999,0,9999,0
1714204861800,CLRE 259,A00,507211,Patel; Hemal,9996,0,9999,3
1714204862829,CLRE 260,A00,507221,Cuomo; Raphael Eduardo,9999,0,9999,0
1714204863855,CLRE 297,001,507242,Cuomo; Raphael Eduardo,9999,0,9999,0
1714204864881,COGS 197,001,638244,Voytek; Bradley Thomas,9999,0,9999,0
1714204865910,CSE 191,A00,516875,Minnes Kemp; Mor Mia,9993,0,9999,6
1714204866935,CSE 197,001,637388,Minnes Kemp; Mor Mia,9998,0,9999,1
1714204867961,CSS 201S,A01,494383,Staff,35,0,35,0
1714204868985,CSS 202S,A01,494387,Staff,35,0,35,0
1714204870010,DSC 197,001,628532,Eldridge; Justin Matthew,9996,0,9999,3
1714204871036,EAP 100,A00,516065,Staff,9797,0,9999,202
1714204872062,ECE 45,A01,507414,Staff,33,0,60,27
1714204874123,ECE 111,A01,507420,Staff,21,0,50,29
1714204875148,ECE 197,001,548057,Sievenpiper; Daniel F.,9994,0,9999,5
1714204876177,EDS 115,A00,507243,Choi; Bailey Miyeon,12,0,28,16
1714204877204,EDS 117,A01,494379,Staff,0,1,30,30
1714204878231,EDS 125,A00,507246,Hopkins; Megan Beth,12,0,30,18
1714204879254,EDS 128A,A01,507264,Fargason; Sharon Gayle,14,0,26,12
1714204880284,EDS 128B,A01,507293,Pappas; Elizabeth,18,0,30,12
1714204881363,EDS 139,A00,507294,Fargason; Sharon Gayle,18,0,30,12
1714204881363,EDS 139,B00,507313,Pappas; Elizabeth,15,0,30,15
1714204882389,EDS 201,A00,507315,Staff,13,0,30,17
1714204883415,EDS 203,A01,507317,Halter; Christopher P.,12,0,30,18
1714204884440,EDS 204R,A01,507319,Halter; Christopher P.,0,3,30,30
1714204884440,EDS 204R,B01,507331,Heinzman; Erica M.,17,0,30,13
1714204885467,EDS 206R,A00,507332,Staff,0,4,30,30
1714204885467,EDS 206R,B00,507343,Staff,18,0,30,12
1714204886494,EDS 250,A00,507344,Hemans; Patricia Ann Benitez,22,0,40,18
1714204887520,EDS 281,A00,507345,Daly; Alan J.,18,0,18,0
1714204888548,EDS 284,A00,507350,Daly; Alan J.,16,0,16,0
1714204889574,EDS 286,A00,507359,Fine; Sarah,18,0,18,0
1714204890599,EDS 289C,A01,507361,Daly; Alan J.,18,0,18,0
1714204891624,EDS 290,A00,507366,Hofstetter; Carolyn,15,0,15,0
1714204892654,LIGM 5A,A00,507421,Fischer-Grunski; Eva K,18,0,20,2
1714204893679,LIGM 5B,A00,507423,Fischer-Grunski; Eva K,19,0,20,1
1714204894706,LIGM 5C,A00,507425,Fischer-Grunski; Eva K,19,0,20,1
1714204895732,LIIT 5AS,A00,507427,Carnelos; Chiara,20,0,20,0
1714204896759,LIIT 5BS,A00,507430,Carnelos; Chiara,20,0,20,0
1714204897787,LIIT 5CS,A00,507432,Carnelos; Chiara,20,0,20,0
1714204898818,LISP 5A,A00,507541,Munoz Sanchez; Alicia,11,0,20,9
1714204899846,LISP 5B,A00,507671,Munoz Sanchez; Alicia,9,0,20,11
1714204900870,LISP 5C,A00,507696,Munoz Sanchez; Alicia,9,0,20,11
1714204901897,MAE 197,001,528363,Boechler; Nicholas Sebastia,9998,0,9999,1
1714204902923,MATH 197,001,523477,Kedlaya; Kiran S.,9996,0,9999,3
1714204902923,MATH 197,002,563811,Zhang; Danna,9995,0,9999,4
1714204902923,MATH 197,003,628552,Dumitriu; Ioana,9998,0,9999,1
1714204903949,MCWP 40R,A00,518780,Staff,5,0,20,15
1714204903949,MCWP 40R,B00,518781,Staff,7,0,20,13
1714204903949,MCWP 40R,C00,518783,Staff,5,0,20,15
1714204904976,MCWP 50R,A00,518791,Staff,0,0,20,20
1714204904976,MCWP 50R,B00,518792,Staff,0,1,20,20
1714204904976,MCWP 50R,C00,518793,Staff,0,1,20,20
1714204904976,MCWP 50R,D00,518794,Staff,0,0,20,20
1714204904976,MCWP 50R,E00,518795,Staff,0,1,20,20
1714204904976,MCWP 50R,F00,518796,Staff,0,0,20,20
1714204904976,MCWP 50R,G00,518797,Staff,0,1,20,20
1714204906004,MMW 12R,A01,514034,Herbst; Matthew,0,1,16,16
1714204906004,MMW 12R,A02,514035,Herbst; Matthew,2,0,16,14
1714204907032,MMW 13R,A01,514037,Staff,0,4,16,16
1714204907032,MMW 13R,A02,514039,Staff,0,2,16,16
1714204907032,MMW 13R,A03,628519,Staff,0,2,16,16
1714204909086,SIO 295LS,A00,523233,Staff,13,0,30,17
1714204910112,SIO 295S,A00,523232,Staff,13,0,30,17
1714204911137,SIOC 290S,A01,637330,Merrifield; Mark A,28,0,30,2
1714204912162,SIOC 291S,A01,637333,Gabriel; Corey John,28,0,30,2
1714204913191,SOCI 117,A01,494376,Staff,0,2,5,5
1714204914216,WES 237B,A00,494380,Staff,9,0,20,11
1714204916291,AESE 279B,A00,494370,Wade; Jon P,0,0,33,33
1714204917315,AIP 197,001,627712,Vespa; Emanuel Ignacio,9998,0,9999,1
1714204918341,ANAR 135S,A00,494369,Braswell; Geoffrey E.,0,0,0,0
1714204919368,BENG 196,001,628496,Engler; Adam J.,9998,0,9999,1
1714204920393,CAT 124RS,A01,519847,Geibel; William,0,0,20,20
1714204921421,CAT 125RS,A01,515971,Geibel; William,0,0,20,20
1714204922446,CLRE 250,A00,511389,Morris; Sheldon,9993,0,9999,6
1714204923476,CLRE 251,A00,507176,Mehta; Ravindra L.,9993,0,9999,6
1714204923476,CLRE 251,B00,511410,Mehta; Ravindra L.,9998,0,9999,1
1714204924501,CLRE 252,A00,507189,Cuomo; Raphael Eduardo,9995,0,9999,4
1714204925527,CLRE 253,A00,507199,Vaida; Florin,9994,0,9999,5
1714204925527,CLRE 253,B00,507202,Vaida; Florin,9999,0,9999,0
1714204926553,CLRE 259,A00,507211,Patel; Hemal,9996,0,9999,3
1714204927579,CLRE 260,A00,507221,Cuomo; Raphael Eduardo,9999,0,9999,0
1714204928604,CLRE 297,001,507242,Cuomo; Raphael Eduardo,9999,0,9999,0
1714204929629,COGS 197,001,638244,Voytek; Bradley Thomas,9999,0,9999,0
1714204930657,CSE 191,A00,516875,Minnes Kemp; Mor Mia,9993,0,9999,6
1714204931683,CSE 197,001,637388,Minnes Kemp; Mor Mia,9998,0,9999,1
1714204932712,CSS 201S,A01,494383,Staff,35,0,35,0
1714204933739,CSS 202S,A01,494387,Staff,35,0,35,0
1714204934767,DSC 197,001,628532,Eldridge; Justin Matthew,9996,0,9999,3
1714204935797,EAP 100,A00,516065,Staff,9797,0,9999,202
1714204936830,ECE 45,A01,507414,Staff,33,0,60,27
1714204938884,ECE 111,A01,507420,Staff,21,0,50,29
1714204939909,ECE 197,001,548057,Sievenpiper; Daniel F.,9994,0,9999,5
1714204940933,EDS 115,A00,507243,Choi; Bailey Miyeon,12,0,28,16
1714204941960,EDS 117,A01,494379,Staff,0,1,30,30
1714204942984,EDS 125,A00,507246,Hopkins; Megan Beth,12,0,30,18
1714204944011,EDS 128A,A01,507264,Fargason; Sharon Gayle,14,0,26,12
1714204945037,EDS 128B,A01,507293,Pappas; Elizabeth,18,0,30,12
1714204946064,EDS 139,A00,507294,Fargason; Sharon Gayle,18,0,30,12
1714204946064,EDS 139,B00,507313,Pappas; Elizabeth,15,0,30,15
1714204947092,EDS 201,A00,507315,Staff,13,0,30,17
1714204948118,EDS 203,A01,507317,Halter; Christopher P.,12,0,30,18
1714204949147,EDS 204R,A01,507319,Halter; Christopher P.,0,3,30,30
1714204949147,EDS 204R,B01,507331,Heinzman; Erica M.,17,0,30,13
1714204950171,EDS 206R,A00,507332,Staff,0,4,30,30
1714204950171,EDS 206R,B00,507343,Staff,18,0,30,12
1714204951196,EDS 250,A00,507344,Hemans; Patricia Ann Benitez,22,0,40,18
1714204952221,EDS 281,A00,507345,Daly; Alan J.,18,0,18,0
1714204953249,EDS 284,A00,507350,Daly; Alan J.,16,0,16,0
1714204954273,EDS 286,A00,507359,Fine; Sarah,18,0,18,0
1714204955300,EDS 289C,A01,507361,Daly; Alan J.,18,0,18,0
1714204956328,EDS 290,A00,507366,Hofstetter; Carolyn,15,0,15,0
1714204957355,LIGM 5A,A00,507421,Fischer-Grunski; Eva K,18,0,20,2
1714204958380,LIGM 5B,A00,507423,Fischer-Grunski; Eva K,19,0,20,1
1714204959408,LIGM 5C,A00,507425,Fischer-Grunski; Eva K,19,0,20,1
1714204960437,LIIT 5AS,A00,507427,Carnelos; Chiara,20,0,20,0
1714204961463,LIIT 5BS,A00,507430,Carnelos; Chiara,20,0,20,0
1714204962489,LIIT 5CS,A00,507432,Carnelos; Chiara,20,0,20,0
1714204963521,LISP 5A,A00,507541,Munoz Sanchez; Alicia,11,0,20,9
1714204964545,LISP 5B,A00,507671,Munoz Sanchez; Alicia,9,0,20,11
1714204965572,LISP 5C,A00,507696,Munoz Sanchez; Alicia,9,0,20,11
1714204966600,MAE 197,001,528363,Boechler; Nicholas Sebastia,9998,0,9999,1
1714204967625,MATH 197,001,523477,Kedlaya; Kiran S.,9996,0,9999,3
1714204967625,MATH 197,002,563811,Zhang; Danna,9995,0,9999,4
1714204967625,MATH 197,003,628552,Dumitriu; Ioana,9998,0,9999,1
1714204968650,MCWP 40R,A00,518780,Staff,5,0,20,15
1714204968650,MCWP 40R,B00,518781,Staff,7,0,20,13
1714204968650,MCWP 40R,C00,518783,Staff,5,0,20,15
1714204969677,MCWP 50R,A00,518791,Staff,0,0,20,20
1714204969677,MCWP 50R,B00,518792,Staff,0,1,20,20
1714204969677,MCWP 50R,C00,518793,Staff,0,1,20,20
1714204969677,MCWP 50R,D00,518794,Staff,0,0,20,20
1714204969677,MCWP 50R,E00,518795,Staff,0,1,20,20
1714204969677,MCWP 50R,F00,518796,Staff,0,0,20,20
1714204969677,MCWP 50R,G00,518797,Staff,0,1,20,20
1714204970702,MMW 12R,A01,514034,Herbst; Matthew,0,1,16,16
1714204970702,MMW 12R,A02,514035,Herbst; Matthew,2,0,16,14
1714204971730,MMW 13R,A01,514037,Staff,0,4,16,16
1714204971730,MMW 13R,A02,514039,Staff,0,2,16,16
1714204971730,MMW 13R,A03,628519,Staff,0,2,16,16
1714204973781,SIO 295LS,A00,523233,Staff,13,0,30,17
1714204974808,SIO 295S,A00,523232,Staff,13,0,30,17
1714204975834,SIOC 290S,A01,637330,Merrifield; Mark A,28,0,30,2
1714204976865,SIOC 291S,A01,637333,Gabriel; Corey John,28,0,30,2
1714204977894,SOCI 117,A01,494376,Staff,0,2,5,5
1714204978922,WES 237B,A00,494380,Staff,9,0,20,11
1714204980994,AESE 279B,A00,494370,Wade; Jon P,0,0,33,33
1714204982019,AIP 197,001,627712,Vespa; Emanuel Ignacio,9998,0,9999,1
1714204983047,ANAR 135S,A00,494369,Braswell; Geoffrey E.,0,0,0,0
1714204984073,BENG 196,001,628496,Engler; Adam J.,9998,0,9999,1
1714204985154,CAT 124RS,A01,519847,Geibel; William,0,0,20,20
1714204986178,CAT 125RS,A01,515971,Geibel; William,0,0,20,20
1714204987205,CLRE 250,A00,511389,Morris; Sheldon,9993,0,9999,6
1714204988232,CLRE 251,A00,507176,Mehta; Ravindra L.,9993,0,9999,6
1714204988232,CLRE 251,B00,511410,Mehta; Ravindra L.,9998,0,9999,1
1714204989259,CLRE 252,A00,507189,Cuomo; Raphael Eduardo,9995,0,9999,4
1714204990286,CLRE 253,A00,507199,Vaida; Florin,9994,0,9999,5
1714204990286,CLRE 253,B00,507202,Vaida; Florin,9999,0,9999,0
1714204991311,CLRE 259,A00,507211,Patel; Hemal,9996,0,9999,3
1714204992337,CLRE 260,A00,507221,Cuomo; Raphael Eduardo,9999,0,9999,0
1714204993363,CLRE 297,001,507242,Cuomo; Raphael Eduardo,9999,0,9999,0
1714204994388,COGS 197,001,638244,Voytek; Bradley Thomas,9999,0,9999,0
1714204995413,CSE 191,A00,516875,Minnes Kemp; Mor Mia,9993,0,9999,6
1714204996439,CSE 197,001,637388,Minnes Kemp; Mor Mia,9998,0,9999,1
1714204997465,CSS 201S,A01,494383,Staff,35,0,35,0
1714204998494,CSS 202S,A01,494387,Staff,35,0,35,0
1714204999518,DSC 197,001,628532,Eldridge; Justin Matthew,9996,0,9999,3
1714205000546,EAP 100,A00,516065,Staff,9797,0,9999,202
1714205001571,ECE 45,A01,507414,Staff,33,0,60,27
1714205003658,ECE 111,A01,507420,Staff,21,0,50,29
1714205004683,ECE 197,001,548057,Sievenpiper; Daniel F.,9994,0,9999,5
1714205005708,EDS 115,A00,507243,Choi; Bailey Miyeon,12,0,28,16
1714205006735,EDS 117,A01,494379,Staff,0,1,30,30
1714205007763,EDS 125,A00,507246,Hopkins; Megan Beth,12,0,30,18
1714205008788,EDS 128A,A01,507264,Fargason; Sharon Gayle,14,0,26,12
1714205009812,EDS 128B,A01,507293,Pappas; Elizabeth,18,0,30,12
1714205010838,EDS 139,A00,507294,Fargason; Sharon Gayle,18,0,30,12
1714205010838,EDS 139,B00,507313,Pappas; Elizabeth,15,0,30,15
1714205011863,EDS 201,A00,507315,Staff,13,0,30,17
1714205012892,EDS 203,A01,507317,Halter; Christopher P.,12,0,30,18
1714205013918,EDS 204R,A01,507319,Halter; Christopher P.,0,3,30,30
1714205013918,EDS 204R,B01,507331,Heinzman; Erica M.,17,0,30,13
1714205014945,EDS 206R,A00,507332,Staff,0,4,30,30
1714205014945,EDS 206R,B00,507343,Staff,18,0,30,12
1714205015971,EDS 250,A00,507344,Hemans; Patricia Ann Benitez,22,0,40,18
1714205016996,EDS 281,A00,507345,Daly; Alan J.,18,0,18,0
1714205018021,EDS 284,A00,507350,Daly; Alan J.,16,0,16,0
1714205019046,EDS 286,A00,507359,Fine; Sarah,18,0,18,0
1714205020070,EDS 289C,A01,507361,Daly; Alan J.,18,0,18,0
1714205021096,EDS 290,A00,507366,Hofstetter; Carolyn,15,0,15,0
1714205022120,LIGM 5A,A00,507421,Fischer-Grunski; Eva K,18,0,20,2
1714205023144,LIGM 5B,A00,507423,Fischer-Grunski; Eva K,19,0,20,1
1714205024173,LIGM 5C,A00,507425,Fischer-Grunski; Eva K,19,0,20,1
1714205025201,LIIT 5AS,A00,507427,Carnelos; Chiara,20,0,20,0
1714205026229,LIIT 5BS,A00,507430,Carnelos; Chiara,20,0,20,0
1714205027255,LIIT 5CS,A00,507432,Carnelos; Chiara,20,0,20,0
1714205028292,LISP 5A,A00,507541,Munoz Sanchez; Alicia,11,0,20,9
1714205029317,LISP 5B,A00,507671,Munoz Sanchez; Alicia,9,0,20,11
1714205030341,LISP 5C,A00,507696,Munoz Sanchez; Alicia,9,0,20,11
1714205031365,MAE 197,001,528363,Boechler; Nicholas Sebastia,9998,0,9999,1
1714205032390,MATH 197,001,523477,Kedlaya; Kiran S.,9996,0,9999,3
1714205032390,MATH 197,002,563811,Zhang; Danna,9995,0,9999,4
1714205032390,MATH 197,003,628552,Dumitriu; Ioana,9998,0,9999,1
1714205033416,MCWP 40R,A00,518780,Staff,5,0,20,15
1714205033416,MCWP 40R,B00,518781,Staff,7,0,20,13
1714205033416,MCWP 40R,C00,518783,Staff,5,0,20,15
1714205034442,MCWP 50R,A00,518791,Staff,0,0,20,20
1714205034442,MCWP 50R,B00,518792,Staff,0,1,20,20
1714205034442,MCWP 50R,C00,518793,Staff,0,1,20,20
1714205034442,MCWP 50R,D00,518794,Staff,0,0,20,20
1714205034442,MCWP 50R,E00,518795,Staff,0,1,20,20
1714205034442,MCWP 50R,F00,518796,Staff,0,0,20,20
1714205034442,MCWP 50R,G00,518797,Staff,0,1,20,20
1714205035469,MMW 12R,A01,514034,Herbst; Matthew,0,1,16,16
1714205035469,MMW 12R,A02,514035,Herbst; Matthew,2,0,16,14
1714205036497,MMW 13R,A01,514037,Staff,0,4,16,16
1714205036497,MMW 13R,A02,514039,Staff,0,2,16,16
1714205036497,MMW 13R,A03,628519,Staff,0,2,16,16
1714205038549,SIO 295LS,A00,523233,Staff,13,0,30,17
1714205039573,SIO 295S,A00,523232,Staff,13,0,30,17
1714205040605,SIOC 290S,A01,637330,Merrifield; Mark A,28,0,30,2
1714205041634,SIOC 291S,A01,637333,Gabriel; Corey John,28,0,30,2
1714205042659,SOCI 117,A01,494376,Staff,0,2,5,5
1714205043687,WES 237B,A00,494380,Staff,9,0,20,11
1714205045755,AESE 279B,A00,494370,Wade; Jon P,0,0,33,33
1714205046780,AIP 197,001,627712,Vespa; Emanuel Ignacio,9998,0,9999,1
1714205047806,ANAR 135S,A00,494369,Braswell; Geoffrey E.,0,0,0,0
1714205048834,BENG 196,001,628496,Engler; Adam J.,9998,0,9999,1
1714205049862,CAT 124RS,A01,519847,Geibel; William,0,0,20,20
1714205050889,CAT 125RS,A01,515971,Geibel; William,0,0,20,20
1714205051918,CLRE 250,A00,511389,Morris; Sheldon,9993,0,9999,6
1714205052943,CLRE 251,A00,507176,Mehta; Ravindra L.,9993,0,9999,6
1714205052943,CLRE 251,B00,511410,Mehta; Ravindra L.,9998,0,9999,1
1714205053968,CLRE 252,A00,507189,Cuomo; Raphael Eduardo,9995,0,9999,4
1714205054994,CLRE 253,A00,507199,Vaida; Florin,9994,0,9999,5
1714205054994,CLRE 253,B00,507202,Vaida; Florin,9999,0,9999,0
1714205056024,CLRE 259,A00,507211,Patel; Hemal,9996,0,9999,3
1714205057051,CLRE 260,A00,507221,Cuomo; Raphael Eduardo,9999,0,9999,0
1714205058077,CLRE 297,001,507242,Cuomo; Raphael Eduardo,9999,0,9999,0
1714205059105,COGS 197,001,638244,Voytek; Bradley Thomas,9999,0,9999,0
1714205060131,CSE 191,A00,516875,Minnes Kemp; Mor Mia,9993,0,9999,6
1714205061159,CSE 197,001,637388,Minnes Kemp; Mor Mia,9998,0,9999,1
1714205062186,CSS 201S,A01,494383,Staff,35,0,35,0
1714205063215,CSS 202S,A01,494387,Staff,35,0,35,0
1714205064241,DSC 197,001,628532,Eldridge; Justin Matthew,9996,0,9999,3
1714205065265,EAP 100,A00,516065,Staff,9797,0,9999,202
1714205066292,ECE 45,A01,507414,Staff,33,0,60,27
1714205068345,ECE 111,A01,507420,Staff,21,0,50,29
1714205069372,ECE 197,001,548057,Sievenpiper; Daniel F.,9994,0,9999,5
1714205070401,EDS 115,A00,507243,Choi; Bailey Miyeon,12,0,28,16
1714205071428,EDS 117,A01,494379,Staff,0,1,30,30
1714205072454,EDS 125,A00,507246,Hopkins; Megan Beth,12,0,30,18
1714205073479,EDS 128A,A01,507264,Fargason; Sharon Gayle,14,0,26,12
1714205074510,EDS 128B,A01,507293,Pappas; Elizabeth,18,0,30,12
1714205075539,EDS 139,A00,507294,Fargason; Sharon Gayle,18,0,30,12
1714205075539,EDS 139,B00,507313,Pappas; Elizabeth,15,0,30,15
1714205076565,EDS 201,A00,507315,Staff,13,0,30,17
1714205077590,EDS 203,A01,507317,Halter; Christopher P.,12,0,30,18
1714205078618,EDS 204R,A01,507319,Halter; Christopher P.,0,3,30,30
1714205078618,EDS 204R,B01,507331,Heinzman; Erica M.,17,0,30,13
1714205079644,EDS 206R,A00,507332,Staff,0,4,30,30
1714205079644,EDS 206R,B00,507343,Staff,18,0,30,12
1714205080673,EDS 250,A00,507344,Hemans; Patricia Ann Benitez,22,0,40,18
1714205081700,EDS 281,A00,507345,Daly; Alan J.,18,0,18,0
1714205082727,EDS 284,A00,507350,Daly; Alan J.,16,0,16,0
1714205083755,EDS 286,A00,507359,Fine; Sarah,18,0,18,0
1714205084783,EDS 289C,A01,507361,Daly; Alan J.,18,0,18,0
1714205085808,EDS 290,A00,507366,Hofstetter; Carolyn,15,0,15,0
1714205086837,LIGM 5A,A00,507421,Fischer-Grunski; Eva K,18,0,20,2
1714205087867,LIGM 5B,A00,507423,Fischer-Grunski; Eva K,19,0,20,1
1714205088946,LIGM 5C,A00,507425,Fischer-Grunski; Eva K,19,0,20,1
1714205089971,LIIT 5AS,A00,507427,Carnelos; Chiara,20,0,20,0
1714205090995,LIIT 5BS,A00,507430,Carnelos; Chiara,20,0,20,0
1714205092024,LIIT 5CS,A00,507432,Carnelos; Chiara,20,0,20,0
1714205093049,LISP 5A,A00,507541,Munoz Sanchez; Alicia,11,0,20,9
1714205094075,LISP 5B,A00,507671,Munoz Sanchez; Alicia,9,0,20,11
1714205095105,LISP 5C,A00,507696,Munoz Sanchez; Alicia,9,0,20,11
1714205096129,MAE 197,001,528363,Boechler; Nicholas Sebastia,9998,0,9999,1
1714205097158,MATH 197,001,523477,Kedlaya; Kiran S.,9996,0,9999,3
1714205097158,MATH 197,002,563811,Zhang; Danna,9995,0,9999,4
1714205097158,MATH 197,003,628552,Dumitriu; Ioana,9998,0,9999,1
1714205098184,MCWP 40R,A00,518780,Staff,5,0,20,15
1714205098184,MCWP 40R,B00,518781,Staff,7,0,20,13
1714205098184,MCWP 40R,C00,518783,Staff,5,0,20,15
1714205099210,MCWP 50R,A00,518791,Staff,0,0,20,20
1714205099210,MCWP 50R,B00,518792,Staff,0,1,20,20
1714205099210,MCWP 50R,C00,518793,Staff,0,1,20,20
1714205099210,MCWP 50R,D00,518794,Staff,0,0,20,20
1714205099210,MCWP 50R,E00,518795,Staff,0,1,20,20
1714205099210,MCWP 50R,F00,518796,Staff,0,0,20,20
1714205099210,MCWP 50R,G00,518797,Staff,0,1,20,20
1714205100239,MMW 12R,A01,514034,Herbst; Matthew,0,1,16,16
1714205100239,MMW 12R,A02,514035,Herbst; Matthew,2,0,16,14
1714205101268,MMW 13R,A01,514037,Staff,0,4,16,16
1714205101268,MMW 13R,A02,514039,Staff,0,2,16,16
1714205101268,MMW 13R,A03,628519,Staff,0,2,16,16
1714205103326,SIO 295LS,A00,523233,Staff,13,0,30,17
1714205104354,SIO 295S,A00,523232,Staff,13,0,30,17
1714205105384,SIOC 290S,A01,637330,Merrifield; Mark A,28,0,30,2
1714205106410,SIOC 291S,A01,637333,Gabriel; Corey John,28,0,30,2
1714205107437,SOCI 117,A01,494376,Staff,0,2,5,5
1714205108464,WES 237B,A00,494380,Staff,9,0,20,11
1714205110531,AESE 279B,A00,494370,Wade; Jon P,0,0,33,33
1714205111556,AIP 197,001,627712,Vespa; Emanuel Ignacio,9998,0,9999,1
1714205112582,ANAR 135S,A00,494369,Braswell; Geoffrey E.,0,0,0,0
1714205113608,BENG 196,001,628496,Engler; Adam J.,9998,0,9999,1
1714205114635,CAT 124RS,A01,519847,Geibel; William,0,0,20,20
1714205115661,CAT 125RS,A01,515971,Geibel; William,0,0,20,20
1714205116690,CLRE 250,A00,511389,Morris; Sheldon,9993,0,9999,6
1714205117717,CLRE 251,A00,507176,Mehta; Ravindra L.,9993,0,9999,6
1714205117717,CLRE 251,B00,511410,Mehta; Ravindra L.,9998,0,9999,1
1714205118744,CLRE 252,A00,507189,Cuomo; Raphael Eduardo,9995,0,9999,4
1714205119771,CLRE 253,A00,507199,Vaida; Florin,9994,0,9999,5
1714205119771,CLRE 253,B00,507202,Vaida; Florin,9999,0,9999,0
1714205120796,CLRE 259,A00,507211,Patel; Hemal,9996,0,9999,3
1714205121823,CLRE 260,A00,507221,Cuomo; Raphael Eduardo,9999,0,9999,0
1714205122849,CLRE 297,001,507242,Cuomo; Raphael Eduardo,9999,0,9999,0
1714205123873,COGS 197,001,638244,Voytek; Bradley Thomas,9999,0,9999,0
1714205124898,CSE 191,A00,516875,Minnes Kemp; Mor Mia,9993,0,9999,6
1714205125924,CSE 197,001,637388,Minnes Kemp; Mor Mia,9998,0,9999,1
1714205126952,CSS 201S,A01,494383,Staff,35,0,35,0
1714205127981,CSS 202S,A01,494387,Staff,35,0,35,0
1714205129007,DSC 197,001,628532,Eldridge; Justin Matthew,9996,0,9999,3
1714205130037,EAP 100,A00,516065,Staff,9797,0,9999,202
1714205131061,ECE 45,A01,507414,Staff,33,0,60,27
1714205133111,ECE 111,A01,507420,Staff,21,0,50,29
1714205134135,ECE 197,001,548057,Sievenpiper; Daniel F.,9994,0,9999,5
1714205135160,EDS 115,A00,507243,Choi; Bailey Miyeon,12,0,28,16
1714205136184,EDS 117,A01,494379,Staff,0,1,30,30
1714205137213,EDS 125,A00,507246,Hopkins; Megan Beth,12,0,30,18
1714205138238,EDS 128A,A01,507264,Fargason; Sharon Gayle,14,0,26,12
1714205139264,EDS 128B,A01,507293,Pappas; Elizabeth,18,0,30,12
1714205140289,EDS 139,A00,507294,Fargason; Sharon Gayle,18,0,30,12
1714205140289,EDS 139,B00,507313,Pappas; Elizabeth,15,0,30,15
1714205141314,EDS 201,A00,507315,Staff,13,0,30,17
1714205142338,EDS 203,A01,507317,Halter; Christopher P.,12,0,30,18
1714205143364,EDS 204R,A01,507319,Halter; Christopher P.,0,3,30,30
1714205143364,EDS 204R,B01,507331,Heinzman; Erica M.,17,0,30,13
1714205144388,EDS 206R,A00,507332,Staff,0,4,30,30
1714205144388,EDS 206R,B00,507343,Staff,18,0,30,12
1714205145414,EDS 250,A00,507344,Hemans; Patricia Ann Benitez,22,0,40,18
1714205146442,EDS 281,A00,507345,Daly; Alan J.,18,0,18,0
1714205147469,EDS 284,A00,507350,Daly; Alan J.,16,0,16,0
1714205148496,EDS 286,A00,507359,Fine; Sarah,18,0,18,0
1714205149525,EDS 289C,A01,507361,Daly; Alan J.,18,0,18,0
1714205150551,EDS 290,A00,507366,Hofstetter; Carolyn,15,0,15,0
1714205151577,LIGM 5A,A00,507421,Fischer-Grunski; Eva K,18,0,20,2
1714205152606,LIGM 5B,A00,507423,Fischer-Grunski; Eva K,19,0,20,1
1714205153635,LIGM 5C,A00,507425,Fischer-Grunski; Eva K,19,0,20,1
1714205154663,LIIT 5AS,A00,507427,Carnelos; Chiara,20,0,20,0
1714205155693,LIIT 5BS,A00,507430,Carnelos; Chiara,20,0,20,0
1714205156720,LIIT 5CS,A00,507432,Carnelos; Chiara,20,0,20,0
1714205157746,LISP 5A,A00,507541,Munoz Sanchez; Alicia,11,0,20,9
1714205158770,LISP 5B,A00,507671,Munoz Sanchez; Alicia,9,0,20,11
1714205159796,LISP 5C,A00,507696,Munoz Sanchez; Alicia,9,0,20,11
1714205160821,MAE 197,001,528363,Boechler; Nicholas Sebastia,9998,0,9999,1
1714205161848,MATH 197,001,523477,Kedlaya; Kiran S.,9996,0,9999,3
1714205161848,MATH 197,002,563811,Zhang; Danna,9995,0,9999,4
1714205161848,MATH 197,003,628552,Dumitriu; Ioana,9998,0,9999,1
1714205162875,MCWP 40R,A00,518780,Staff,5,0,20,15
1714205162875,MCWP 40R,B00,518781,Staff,7,0,20,13
1714205162875,MCWP 40R,C00,518783,Staff,5,0,20,15
1714205163907,MCWP 50R,A00,518791,Staff,0,0,20,20
1714205163907,MCWP 50R,B00,518792,Staff,0,1,20,20
1714205163907,MCWP 50R,C00,518793,Staff,0,1,20,20
1714205163907,MCWP 50R,D00,518794,Staff,0,0,20,20
1714205163907,MCWP 50R,E00,518795,Staff,0,1,20,20
1714205163907,MCWP 50R,F00,518796,Staff,0,0,20,20
1714205163907,MCWP 50R,G00,518797,Staff,0,1,20,20
1714205164933,MMW 12R,A01,514034,Herbst; Matthew,0,1,16,16
1714205164933,MMW 12R,A02,514035,Herbst; Matthew,2,0,16,14
1714205165960,MMW 13R,A01,514037,Staff,0,4,16,16
1714205165960,MMW 13R,A02,514039,Staff,0,2,16,16
1714205165960,MMW 13R,A03,628519,Staff,0,2,16,16
1714205168011,SIO 295LS,A00,523233,Staff,13,0,30,17
1714205169038,SIO 295S,A00,523232,Staff,13,0,30,17
1714205170063,SIOC 290S,A01,637330,Merrifield; Mark A,28,0,30,2
1714205171093,SIOC 291S,A01,637333,Gabriel; Corey John,28,0,30,2
1714205172123,SOCI 117,A01,494376,Staff,0,2,5,5
1714205173151,WES 237B,A00,494380,Staff,9,0,20,11
1714205175222,AESE 279B,A00,494370,Wade; Jon P,0,0,33,33
1714205176250,AIP 197,001,627712,Vespa; Emanuel Ignacio,9998,0,9999,1
1714205177275,ANAR 135S,A00,494369,Braswell; Geoffrey E.,0,0,0,0
1714205178299,BENG 196,001,628496,Engler; Adam J.,9998,0,9999,1
1714205179326,CAT 124RS,A01,519847,Geibel; William,0,0,20,20
1714205180351,CAT 125RS,A01,515971,Geibel; William,0,0,20,20
1714205181379,CLRE 250,A00,511389,Morris; Sheldon,9993,0,9999,6
1714205182406,CLRE 251,A00,507176,Mehta; Ravindra L.,9993,0,9999,6
1714205182406,CLRE 251,B00,511410,Mehta; Ravindra L.,9998,0,9999,1
1714205183431,CLRE 252,A00,507189,Cuomo; Raphael Eduardo,9995,0,9999,4
1714205184458,CLRE 253,A00,507199,Vaida; Florin,9994,0,9999,5
1714205184458,CLRE 253,B00,507202,Vaida; Florin,9999,0,9999,0
1714205185483,CLRE 259,A00,507211,Patel; Hemal,9996,0,9999,3
1714205186509,CLRE 260,A00,507221,Cuomo; Raphael Eduardo,9999,0,9999,0
1714205187534,CLRE 297,001,507242,Cuomo; Raphael Eduardo,9999,0,9999,0
1714205188562,COGS 197,001,638244,Voytek; Bradley Thomas,9999,0,9999,0
1714205189586,CSE 191,A00,516875,Minnes Kemp; Mor Mia,9993,0,9999,6
1714205190612,CSE 197,001,637388,Minnes Kemp; Mor Mia,9998,0,9999,1
1714205191642,CSS 201S,A01,494383,Staff,35,0,35,0
1714205192722,CSS 202S,A01,494387,Staff,35,0,35,0
1714205193750,DSC 197,001,628532,Eldridge; Justin Matthew,9996,0,9999,3
1714205194775,EAP 100,A00,516065,Staff,9797,0,9999,202
1714205195803,ECE 45,A01,507414,Staff,33,0,60,27
1714205197855,ECE 111,A01,507420,Staff,21,0,50,29
1714205198878,ECE 197,001,548057,Sievenpiper; Daniel F.,9994,0,9999,5
1714205199902,EDS 115,A00,507243,Choi; Bailey Miyeon,12,0,28,16
1714205200931,EDS 117,A01,494379,Staff,0,1,30,30
1714205201960,EDS 125,A00,507246,Hopkins; Megan Beth,12,0,30,18
1714205202985,EDS 128A,A01,507264,Fargason; Sharon Gayle,14,0,26,12
1714205204011,EDS 128B,A01,507293,Pappas; Elizabeth,18,0,30,12
1714205205036,EDS 139,A00,507294,Fargason; Sharon Gayle,18,0,30,12
1714205205036,EDS 139,B00,507313,Pappas; Elizabeth,15,0,30,15
1714205206060,EDS 201,A00,507315,Staff,13,0,30,17
1714205207091,EDS 203,A01,507317,Halter; Christopher P.,12,0,30,18
1714205208116,EDS 204R,A01,507319,Halter; Christopher P.,0,3,30,30
1714205208116,EDS 204R,B01,507331,Heinzman; Erica M.,17,0,30,13
1714205209141,EDS 206R,A00,507332,Staff,0,4,30,30
1714205209141,EDS 206R,B00,507343,Staff,18,0,30,12
1714205210167,EDS 250,A00,507344,Hemans; Patricia Ann Benitez,22,0,40,18
1714205211191,EDS 281,A00,507345,Daly; Alan J.,18,0,18,0
1714205212219,EDS 284,A00,507350,Daly; Alan J.,16,0,16,0
1714205213248,EDS 286,A00,507359,Fine; Sarah,18,0,18,0
1714205214275,EDS 289C,A01,507361,Daly; Alan J.,18,0,18,0
1714205215301,EDS 290,A00,507366,Hofstetter; Carolyn,15,0,15,0
1714205216330,LIGM 5A,A00,507421,Fischer-Grunski; Eva K,18,0,20,2
1714205217357,LIGM 5B,A00,507423,Fischer-Grunski; Eva K,19,0,20,1
1714205218383,LIGM 5C,A00,507425,Fischer-Grunski; Eva K,19,0,20,1
1714205219409,LIIT 5AS,A00,507427,Carnelos; Chiara,20,0,20,0
1714205220435,LIIT 5BS,A00,507430,Carnelos; Chiara,20,0,20,0
1714205221460,LIIT 5CS,A00,507432,Carnelos; Chiara,20,0,20,0
1714205222486,LISP 5A,A00,507541,Munoz Sanchez; Alicia,11,0,20,9
1714205223512,LISP 5B,A00,507671,Munoz Sanchez; Alicia,9,0,20,11
1714205224536,LISP 5C,A00,507696,Munoz Sanchez; Alicia,9,0,20,11
1714205225565,MAE 197,001,528363,Boechler; Nicholas Sebastia,9998,0,9999,1
1714205226592,MATH 197,001,523477,Kedlaya; Kiran S.,9996,0,9999,3
1714205226592,MATH 197,002,563811,Zhang; Danna,9995,0,9999,4
1714205226592,MATH 197,003,628552,Dumitriu; Ioana,9998,0,9999,1
1714205227616,MCWP 40R,A00,518780,Staff,5,0,20,15
1714205227616,MCWP 40R,B00,518781,Staff,7,0,20,13
1714205227616,MCWP 40R,C00,518783,Staff,5,0,20,15
1714205228642,MCWP 50R,A00,518791,Staff,0,0,20,20
1714205228642,MCWP 50R,B00,518792,Staff,0,1,20,20
1714205228642,MCWP 50R,C00,518793,Staff,0,1,20,20
1714205228642,MCWP 50R,D00,518794,Staff,0,0,20,20
1714205228642,MCWP 50R,E00,518795,Staff,0,1,20,20
1714205228642,MCWP 50R,F00,518796,Staff,0,0,20,20
1714205228642,MCWP 50R,G00,518797,Staff,0,1,20,20
1714205229669,MMW 12R,A01,514034,Herbst; Matthew,0,1,16,16
1714205229669,MMW 12R,A02,514035,Herbst; Matthew,2,0,16,14
1714205230695,MMW 13R,A01,514037,Staff,0,4,16,16
1714205230695,MMW 13R,A02,514039,Staff,0,2,16,16
1714205230695,MMW 13R,A03,628519,Staff,0,2,16,16
1714205232750,SIO 295LS,A00,523233,Staff,13,0,30,17
1714205233775,SIO 295S,A00,523232,Staff,13,0,30,17
1714205234804,SIOC 290S,A01,637330,Merrifield; Mark A,28,0,30,2
1714205235830,SIOC 291S,A01,637333,Gabriel; Corey John,28,0,30,2
1714205236856,SOCI 117,A01,494376,Staff,0,2,5,5
1714205237885,WES 237B,A00,494380,Staff,9,0,20,11
1714205239965,AESE 279B,A00,494370,Wade; Jon P,0,0,33,33
1714205240988,AIP 197,001,627712,Vespa; Emanuel Ignacio,9998,0,9999,1
1714205242023,ANAR 135S,A00,494369,Braswell; Geoffrey E.,0,0,0,0
1714205243050,BENG 196,001,628496,Engler; Adam J.,9998,0,9999,1
1714205244077,CAT 124RS,A01,519847,Geibel; William,0,0,20,20
1714205245112,CAT 125RS,A01,515971,Geibel; William,0,0,20,20
1714205246142,CLRE 250,A00,511389,Morris; Sheldon,9993,0,9999,6
1714205247169,CLRE 251,A00,507176,Mehta; Ravindra L.,9993,0,9999,6
1714205247169,CLRE 251,B00,511410,Mehta; Ravindra L.,9998,0,9999,1
1714205248195,CLRE 252,A00,507189,Cuomo; Raphael Eduardo,9995,0,9999,4
1714205249222,CLRE 253,A00,507199,Vaida; Florin,9994,0,9999,5
1714205249222,CLRE 253,B00,507202,Vaida; Florin,9999,0,9999,0
1714205250251,CLRE 259,A00,507211,Patel; Hemal,9996,0,9999,3
1714205251277,CLRE 260,A00,507221,Cuomo; Raphael Eduardo,9999,0,9999,0
1714205252302,CLRE 297,001,507242,Cuomo; Raphael Eduardo,9999,0,9999,0
1714205253325,COGS 197,001,638244,Voytek; Bradley Thomas,9999,0,9999,0
1714205254351,CSE 191,A00,516875,Minnes Kemp; Mor Mia,9993,0,9999,6
1714205255377,CSE 197,001,637388,Minnes Kemp; Mor Mia,9998,0,9999,1
1714205256402,CSS 201S,A01,494383,Staff,35,0,35,0
1714205257429,CSS 202S,A01,494387,Staff,35,0,35,0
1714205258455,DSC 197,001,628532,Eldridge; Justin Matthew,9996,0,9999,3
1714205259480,EAP 100,A00,516065,Staff,9797,0,9999,202
1714205260507,ECE 45,A01,507414,Staff,33,0,60,27
1714205262557,ECE 111,A01,507420,Staff,21,0,50,29
1714205263584,ECE 197,001,548057,Sievenpiper; Daniel F.,9994,0,9999,5
1714205264609,EDS 115,A00,507243,Choi; Bailey Miyeon,12,0,28,16
1714205265633,EDS 117,A01,494379,Staff,0,1,30,30
1714205266665,EDS 125,A00,507246,Hopkins; Megan Beth,12,0,30,18
1714205267691,EDS 128A,A01,507264,Fargason; Sharon Gayle,14,0,26,12
1714205268717,EDS 128B,A01,507293,Pappas; Elizabeth,18,0,30,12
1714205269745,EDS 139,A00,507294,Fargason; Sharon Gayle,18,0,30,12
1714205269745,EDS 139,B00,507313,Pappas; Elizabeth,15,0,30,15
1714205270774,EDS 201,A00,507315,Staff,13,0,30,17
1714205271804,EDS 203,A01,507317,Halter; Christopher P.,12,0,30,18
1714205272830,EDS 204R,A01,507319,Halter; Christopher P.,0,3,30,30
1714205272830,EDS 204R,B01,507331,Heinzman; Erica M.,17,0,30,13
1714205273855,EDS 206R,A00,507332,Staff,0,4,30,30
1714205273855,EDS 206R,B00,507343,Staff,18,0,30,12
1714205274885,EDS 250,A00,507344,Hemans; Patricia Ann Benitez,22,0,40,18
1714205275915,EDS 281,A00,507345,Daly; Alan J.,18,0,18,0
1714205276940,EDS 284,A00,507350,Daly; Alan J.,16,0,16,0
1714205277965,EDS 286,A00,507359,Fine; Sarah,18,0,18,0
1714205278990,EDS 289C,A01,507361,Daly; Alan J.,18,0,18,0
1714205280014,EDS 290,A00,507366,Hofstetter; Carolyn,15,0,15,0
1714205281039,LIGM 5A,A00,507421,Fischer-Grunski; Eva K,18,0,20,2
1714205282066,LIGM 5B,A00,507423,Fischer-Grunski; Eva K,19,0,20,1
1714205283092,LIGM 5C,A00,507425,Fischer-Grunski; Eva K,19,0,20,1
1714205284123,LIIT 5AS,A00,507427,Carnelos; Chiara,20,0,20,0
1714205285154,LIIT 5BS,A00,507430,Carnelos; Chiara,20,0,20,0
1714205286181,LIIT 5CS,A00,507432,Carnelos; Chiara,20,0,20,0
1714205287208,LISP 5A,A00,507541,Munoz Sanchez; Alicia,11,0,20,9
1714205288239,LISP 5B,A00,507671,Munoz Sanchez; Alicia,9,0,20,11
1714205289265,LISP 5C,A00,507696,Munoz Sanchez; Alicia,9,0,20,11
1714205290294,MAE 197,001,528363,Boechler; Nicholas Sebastia,9998,0,9999,1
1714205291319,MATH 197,001,523477,Kedlaya; Kiran S.,9996,0,9999,3
1714205291319,MATH 197,002,563811,Zhang; Danna,9995,0,9999,4
1714205291319,MATH 197,003,628552,Dumitriu; Ioana,9998,0,9999,1
1714205292344,MCWP 40R,A00,518780,Staff,5,0,20,15
1714205292344,MCWP 40R,B00,518781,Staff,7,0,20,13
1714205292344,MCWP 40R,C00,518783,Staff,5,0,20,15
1714205293371,MCWP 50R,A00,518791,Staff,0,0,20,20
1714205293371,MCWP 50R,B00,518792,Staff,0,1,20,20
1714205293371,MCWP 50R,C00,518793,Staff,0,1,20,20
1714205293371,MCWP 50R,D00,518794,Staff,0,0,20,20
1714205293371,MCWP 50R,E00,518795,Staff,0,1,20,20
1714205293371,MCWP 50R,F00,518796,Staff,0,0,20,20
1714205293371,MCWP 50R,G00,518797,Staff,0,1,20,20
1714205294400,MMW 12R,A01,514034,Herbst; Matthew,0,1,16,16
1714205294400,MMW 12R,A02,514035,Herbst; Matthew,2,0,16,14
1714205295426,MMW 13R,A01,514037,Staff,0,4,16,16
1714205295426,MMW 13R,A02,514039,Staff,0,2,16,16
1714205295426,MMW 13R,A03,628519,Staff,0,2,16,16
1714205297534,SIO 295LS,A00,523233,Staff,13,0,30,17
1714205298563,SIO 295S,A00,523232,Staff,13,0,30,17
1714205299589,SIOC 290S,A01,637330,Merrifield; Mark A,28,0,30,2
1714205300614,SIOC 291S,A01,637333,Gabriel; Corey John,28,0,30,2
1714205301640,SOCI 117,A01,494376,Staff,0,2,5,5
1714205302667,WES 237B,A00,494380,Staff,9,0,20,11
1714205304739,AESE 279B,A00,494370,Wade; Jon P,0,0,33,33
1714205305768,AIP 197,001,627712,Vespa; Emanuel Ignacio,9998,0,9999,1
1714205306793,ANAR 135S,A00,494369,Braswell; Geoffrey E.,0,0,0,0
1714205307820,BENG 196,001,628496,Engler; Adam J.,9998,0,9999,1
1714205308847,CAT 124RS,A01,519847,Geibel; William,0,0,20,20
1714205309876,CAT 125RS,A01,515971,Geibel; William,0,0,20,20
1714205310901,CLRE 250,A00,511389,Morris; Sheldon,9993,0,9999,6
1714205311927,CLRE 251,A00,507176,Mehta; Ravindra L.,9993,0,9999,6
1714205311927,CLRE 251,B00,511410,Mehta; Ravindra L.,9998,0,9999,1
1714205312954,CLRE 252,A00,507189,Cuomo; Raphael Eduardo,9995,0,9999,4
1714205313980,CLRE 253,A00,507199,Vaida; Florin,9994,0,9999,5
1714205313980,CLRE 253,B00,507202,Vaida; Florin,9999,0,9999,0
1714205315006,CLRE 259,A00,507211,Patel; Hemal,9996,0,9999,3
1714205316032,CLRE 260,A00,507221,Cuomo; Raphael Eduardo,9999,0,9999,0
1714205317058,CLRE 297,001,507242,Cuomo; Raphael Eduardo,9999,0,9999,0
1714205318083,COGS 197,001,638244,Voytek; Bradley Thomas,9999,0,9999,0
1714205319108,CSE 191,A00,516875,Minnes Kemp; Mor Mia,9993,0,9999,6
1714205320133,CSE 197,001,637388,Minnes Kemp; Mor Mia,9998,0,9999,1
1714205321158,CSS 201S,A01,494383,Staff,35,0,35,0
1714205322184,CSS 202S,A01,494387,Staff,35,0,35,0
1714205323210,DSC 197,001,628532,Eldridge; Justin Matthew,9996,0,9999,3
1714205324235,EAP 100,A00,516065,Staff,9797,0,9999,202
1714205325268,ECE 45,A01,507414,Staff,33,0,60,27
1714205327321,ECE 111,A01,507420,Staff,21,0,50,29
1714205328349,ECE 197,001,548057,Sievenpiper; Daniel F.,9994,0,9999,5
1714205329378,EDS 115,A00,507243,Choi; Bailey Miyeon,12,0,28,16
1714205330403,EDS 117,A01,494379,Staff,0,1,30,30
1714205331429,EDS 125,A00,507246,Hopkins; Megan Beth,12,0,30,18
1714205332456,EDS 128A,A01,507264,Fargason; Sharon Gayle,14,0,26,12
1714205333481,EDS 128B,A01,507293,Pappas; Elizabeth,18,0,30,12
1714205334511,EDS 139,A00,507294,Fargason; Sharon Gayle,18,0,30,12
1714205334511,EDS 139,B00,507313,Pappas; Elizabeth,15,0,30,15
1714205335538,EDS 201,A00,507315,Staff,13,0,30,17
1714205336565,EDS 203,A01,507317,Halter; Christopher P.,12,0,30,18
1714205337589,EDS 204R,A01,507319,Halter; Christopher P.,0,3,30,30
1714205337589,EDS 204R,B01,507331,Heinzman; Erica M.,17,0,30,13
1714205338616,EDS 206R,A00,507332,Staff,0,4,30,30
1714205338616,EDS 206R,B00,507343,Staff,18,0,30,12
1714205339645,EDS 250,A00,507344,Hemans; Patricia Ann Benitez,22,0,40,18
1714205340674,EDS 281,A00,507345,Daly; Alan J.,18,0,18,0
1714205341702,EDS 284,A00,507350,Daly; Alan J.,16,0,16,0
1714205342728,EDS 286,A00,507359,Fine; Sarah,18,0,18,0
1714205343756,EDS 289C,A01,507361,Daly; Alan J.,18,0,18,0
1714205344779,EDS 290,A00,507366,Hofstetter; Carolyn,15,0,15,0
1714205345808,LIGM 5A,A00,507421,Fischer-Grunski; Eva K,18,0,20,2
1714205346833,LIGM 5B,A00,507423,Fischer-Grunski; Eva K,19,0,20,1
1714205347863,LIGM 5C,A00,507425,Fischer-Grunski; Eva K,19,0,20,1
1714205348889,LIIT 5AS,A00,507427,Carnelos; Chiara,20,0,20,0
1714205349915,LIIT 5BS,A00,507430,Carnelos; Chiara,20,0,20,0
1714205350945,LIIT 5CS,A00,507432,Carnelos; Chiara,20,0,20,0
1714205351972,LISP 5A,A00,507541,Munoz Sanchez; Alicia,11,0,20,9
1714205353001,LISP 5B,A00,507671,Munoz Sanchez; Alicia,9,0,20,11
1714205354030,LISP 5C,A00,507696,Munoz Sanchez; Alicia,9,0,20,11
1714205355059,MAE 197,001,528363,Boechler; Nicholas Sebastia,9998,0,9999,1
1714205356086,MATH 197,001,523477,Kedlaya; Kiran S.,9996,0,9999,3
1714205356086,MATH 197,002,563811,Zhang; Danna,9995,0,9999,4
1714205356086,MATH 197,003,628552,Dumitriu; Ioana,9998,0,9999,1
1714205357113,MCWP 40R,A00,518780,Staff,5,0,20,15
1714205357113,MCWP 40R,B00,518781,Staff,7,0,20,13
1714205357113,MCWP 40R,C00,518783,Staff,5,0,20,15
1714205358142,MCWP 50R,A00,518791,Staff,0,0,20,20
1714205358142,MCWP 50R,B00,518792,Staff,0,1,20,20
1714205358142,MCWP 50R,C00,518793,Staff,0,1,20,20
1714205358142,MCWP 50R,D00,518794,Staff,0,0,20,20
1714205358142,MCWP 50R,E00,518795,Staff,0,1,20,20
1714205358142,MCWP 50R,F00,518796,Staff,0,0,20,20
1714205358142,MCWP 50R,G00,518797,Staff,0,1,20,20
1714205359167,MMW 12R,A01,514034,Herbst; Matthew,0,1,16,16
1714205359167,MMW 12R,A02,514035,Herbst; Matthew,2,0,16,14
1714205360197,MMW 13R,A01,514037,Staff,0,4,16,16
1714205360197,MMW 13R,A02,514039,Staff,0,2,16,16
1714205360197,MMW 13R,A03,628519,Staff,0,2,16,16
1714205362255,SIO 295LS,A00,523233,Staff,13,0,30,17
1714205363280,SIO 295S,A00,523232,Staff,13,0,30,17
1714205364303,SIOC 290S,A01,637330,Merrifield; Mark A,28,0,30,2
1714205365332,SIOC 291S,A01,637333,Gabriel; Corey John,28,0,30,2
1714205366360,SOCI 117,A01,494376,Staff,0,2,5,5
1714205367388,WES 237B,A00,494380,Staff,9,0,20,11
1714205369443,AESE 279B,A00,494370,Wade; Jon P,0,0,33,33
1714205370469,AIP 197,001,627712,Vespa; Emanuel Ignacio,9998,0,9999,1
1714205371499,ANAR 135S,A00,494369,Braswell; Geoffrey E.,0,0,0,0
1714205372523,BENG 196,001,628496,Engler; Adam J.,9998,0,9999,1
1714205373549,CAT 124RS,A01,519847,Geibel; William,0,0,20,20
1714205374575,CAT 125RS,A01,515971,Geibel; William,0,0,20,20
1714205375603,CLRE 250,A00,511389,Morris; Sheldon,9993,0,9999,6
1714205376629,CLRE 251,A00,507176,Mehta; Ravindra L.,9993,0,9999,6
1714205376629,CLRE 251,B00,511410,Mehta; Ravindra L.,9998,0,9999,1
1714205377659,CLRE 252,A00,507189,Cuomo; Raphael Eduardo,9995,0,9999,4
1714205378685,CLRE 253,A00,507199,Vaida; Florin,9994,0,9999,5
1714205378685,CLRE 253,B00,507202,Vaida; Florin,9999,0,9999,0
1714205379710,CLRE 259,A00,507211,Patel; Hemal,9996,0,9999,3
1714205380739,CLRE 260,A00,507221,Cuomo; Raphael Eduardo,9999,0,9999,0
1714205381765,CLRE 297,001,507242,Cuomo; Raphael Eduardo,9999,0,9999,0
1714205382799,COGS 197,001,638244,Voytek; Bradley Thomas,9999,0,9999,0
1714205383827,CSE 191,A00,516875,Minnes Kemp; Mor Mia,9993,0,9999,6
1714205384857,CSE 197,001,637388,Minnes Kemp; Mor Mia,9998,0,9999,1
1714205385883,CSS 201S,A01,494383,Staff,35,0,35,0
1714205386907,CSS 202S,A01,494387,Staff,35,0,35,0
1714205387936,DSC 197,001,628532,Eldridge; Justin Matthew,9996,0,9999,3
1714205388964,EAP 100,A00,516065,Staff,9797,0,9999,202
1714205389994,ECE 45,A01,507414,Staff,33,0,60,27
1714205392047,ECE 111,A01,507420,Staff,21,0,50,29
1714205393073,ECE 197,001,548057,Sievenpiper; Daniel F.,9994,0,9999,5
1714205394103,EDS 115,A00,507243,Choi; Bailey Miyeon,12,0,28,16
1714205395134,EDS 117,A01,494379,Staff,0,1,30,30
1714205396164,EDS 125,A00,507246,Hopkins; Megan Beth,12,0,30,18
1714205397190,EDS 128A,A01,507264,Fargason; Sharon Gayle,14,0,26,12
1714205398217,EDS 128B,A01,507293,Pappas; Elizabeth,18,0,30,12
1714205399246,EDS 139,A00,507294,Fargason; Sharon Gayle,18,0,30,12
1714205399246,EDS 139,B00,507313,Pappas; Elizabeth,15,0,30,15
1714205400324,EDS 201,A00,507315,Staff,13,0,30,17
1714205401350,EDS 203,A01,507317,Halter; Christopher P.,12,0,30,18
1714205402381,EDS 204R,A01,507319,Halter; Christopher P.,0,3,30,30
1714205402381,EDS 204R,B01,507331,Heinzman; Erica M.,17,0,30,13
1714205403406,EDS 206R,A00,507332,Staff,0,4,30,30
1714205403406,EDS 206R,B00,507343,Staff,18,0,30,12
1714205404433,EDS 250,A00,507344,Hemans; Patricia Ann Benitez,22,0,40,18
1714205405458,EDS 281,A00,507345,Daly; Alan J.,18,0,18,0
1714205406486,EDS 284,A00,507350,Daly; Alan J.,16,0,16,0
1714205407516,EDS 286,A00,507359,Fine; Sarah,18,0,18,0
1714205408542,EDS 289C,A01,507361,Daly; Alan J.,18,0,18,0
1714205409567,EDS 290,A00,507366,Hofstetter; Carolyn,15,0,15,0
1714205410594,LIGM 5A,A00,507421,Fischer-Grunski; Eva K,18,0,20,2
1714205411624,LIGM 5B,A00,507423,Fischer-Grunski; Eva K,19,0,20,1
1714205412655,LIGM 5C,A00,507425,Fischer-Grunski; Eva K,19,0,20,1
1714205413685,LIIT 5AS,A00,507427,Carnelos; Chiara,20,0,20,0
1714205414713,LIIT 5BS,A00,507430,Carnelos; Chiara,20,0,20,0
1714205415739,LIIT 5CS,A00,507432,Carnelos; Chiara,20,0,20,0
1714205416765,LISP 5A,A00,507541,Munoz Sanchez; Alicia,11,0,20,9
1714205417791,LISP 5B,A00,507671,Munoz Sanchez; Alicia,9,0,20,11
1714205418816,LISP 5C,A00,507696,Munoz Sanchez; Alicia,9,0,20,11
1714205419841,MAE 197,001,528363,Boechler; Nicholas Sebastia,9998,0,9999,1
1714205420872,MATH 197,001,523477,Kedlaya; Kiran S.,9996,0,9999,3
1714205420872,MATH 197,002,563811,Zhang; Danna,9995,0,9999,4
1714205420872,MATH 197,003,628552,Dumitriu; Ioana,9998,0,9999,1
1714205421899,MCWP 40R,A00,518780,Staff,5,0,20,15
1714205421899,MCWP 40R,B00,518781,Staff,7,0,20,13
1714205421899,MCWP 40R,C00,518783,Staff,5,0,20,15
1714205422925,MCWP 50R,A00,518791,Staff,0,0,20,20
1714205422925,MCWP 50R,B00,518792,Staff,0,1,20,20
1714205422925,MCWP 50R,C00,518793,Staff,0,1,20,20
1714205422925,MCWP 50R,D00,518794,Staff,0,0,20,20
1714205422925,MCWP 50R,E00,518795,Staff,0,1,20,20
1714205422925,MCWP 50R,F00,518796,Staff,0,0,20,20
1714205422925,MCWP 50R,G00,518797,Staff,0,1,20,20
1714205423951,MMW 12R,A01,514034,Herbst; Matthew,0,1,16,16
1714205423951,MMW 12R,A02,514035,Herbst; Matthew,2,0,16,14
1714205424977,MMW 13R,A01,514037,Staff,0,4,16,16
1714205424977,MMW 13R,A02,514039,Staff,0,2,16,16
1714205424977,MMW 13R,A03,628519,Staff,0,2,16,16
1714205427032,SIO 295LS,A00,523233,Staff,13,0,30,17
1714205428058,SIO 295S,A00,523232,Staff,13,0,30,17
1714205429084,SIOC 290S,A01,637330,Merrifield; Mark A,28,0,30,2
1714205430114,SIOC 291S,A01,637333,Gabriel; Corey John,28,0,30,2
1714205431139,SOCI 117,A01,494376,Staff,0,2,5,5
1714205432164,WES 237B,A00,494380,Staff,9,0,20,11
1714205434231,AESE 279B,A00,494370,Wade; Jon P,0,0,33,33
1714205435256,AIP 197,001,627712,Vespa; Emanuel Ignacio,9998,0,9999,1
1714205436283,ANAR 135S,A00,494369,Braswell; Geoffrey E.,0,0,0,0
1714205437309,BENG 196,001,628496,Engler; Adam J.,9998,0,9999,1
1714205438340,CAT 124RS,A01,519847,Geibel; William,0,0,20,20
1714205439370,CAT 125RS,A01,515971,Geibel; William,0,0,20,20
1714205440399,CLRE 250,A00,511389,Morris; Sheldon,9993,0,9999,6
1714205441430,CLRE 251,A00,507176,Mehta; Ravindra L.,9993,0,9999,6
1714205441430,CLRE 251,B00,511410,Mehta; Ravindra L.,9998,0,9999,1
1714205442457,CLRE 252,A00,507189,Cuomo; Raphael Eduardo,9995,0,9999,4
1714205443483,CLRE 253,A00,507199,Vaida; Florin,9994,0,9999,5
1714205443483,CLRE 253,B00,507202,Vaida; Florin,9999,0,9999,0
1714205444508,CLRE 259,A00,507211,Patel; Hemal,9996,0,9999,3
1714205445533,CLRE 260,A00,507221,Cuomo; Raphael Eduardo,9999,0,9999,0
1714205446559,CLRE 297,001,507242,Cuomo; Raphael Eduardo,9999,0,9999,0
1714205447584,COGS 197,001,638244,Voytek; Bradley Thomas,9999,0,9999,0
1714205448613,CSE 191,A00,516875,Minnes Kemp; Mor Mia,9993,0,9999,6
1714205449640,CSE 197,001,637388,Minnes Kemp; Mor Mia,9998,0,9999,1
1714205450667,CSS 201S,A01,494383,Staff,35,0,35,0
1714205451691,CSS 202S,A01,494387,Staff,35,0,35,0
1714205452717,DSC 197,001,628532,Eldridge; Justin Matthew,9996,0,9999,3
1714205453744,EAP 100,A00,516065,Staff,9797,0,9999,202
1714205454770,ECE 45,A01,507414,Staff,33,0,60,27
1714205456826,ECE 111,A01,507420,Staff,21,0,50,29
1714205457852,ECE 197,001,548057,Sievenpiper; Daniel F.,9994,0,9999,5
1714205458882,EDS 115,A00,507243,Choi; Bailey Miyeon,12,0,28,16
1714205459908,EDS 117,A01,494379,Staff,0,1,30,30
1714205460934,EDS 125,A00,507246,Hopkins; Megan Beth,12,0,30,18
1714205461963,EDS 128A,A01,507264,Fargason; Sharon Gayle,14,0,26,12
1714205462989,EDS 128B,A01,507293,Pappas; Elizabeth,18,0,30,12
1714205464015,EDS 139,A00,507294,Fargason; Sharon Gayle,18,0,30,12
1714205464015,EDS 139,B00,507313,Pappas; Elizabeth,15,0,30,15
1714205465041,EDS 201,A00,507315,Staff,13,0,30,17
1714205466070,EDS 203,A01,507317,Halter; Christopher P.,12,0,30,18
1714205467097,EDS 204R,A01,507319,Halter; Christopher P.,0,3,30,30
1714205467097,EDS 204R,B01,507331,Heinzman; Erica M.,17,0,30,13
1714205468126,EDS 206R,A00,507332,Staff,0,4,30,30
1714205468126,EDS 206R,B00,507343,Staff,18,0,30,12
1714205469152,EDS 250,A00,507344,Hemans; Patricia Ann Benitez,22,0,40,18
1714205470179,EDS 281,A00,507345,Daly; Alan J.,18,0,18,0
1714205471206,EDS 284,A00,507350,Daly; Alan J.,16,0,16,0
1714205472233,EDS 286,A00,507359,Fine; Sarah,18,0,18,0
1714205473259,EDS 289C,A01,507361,Daly; Alan J.,18,0,18,0
1714205474286,EDS 290,A00,507366,Hofstetter; Carolyn,15,0,15,0
1714205475316,LIGM 5A,A00,507421,Fischer-Grunski; Eva K,18,0,20,2
1714205476344,LIGM 5B,A00,507423,Fischer-Grunski; Eva K,19,0,20,1
1714205477373,LIGM 5C,A00,507425,Fischer-Grunski; Eva K,19,0,20,1
1714205478398,LIIT 5AS,A00,507427,Carnelos; Chiara,20,0,20,0
1714205479423,LIIT 5BS,A00,507430,Carnelos; Chiara,20,0,20,0
1714205480451,LIIT 5CS,A00,507432,Carnelos; Chiara,20,0,20,0
1714205481477,LISP 5A,A00,507541,Munoz Sanchez; Alicia,11,0,20,9
1714205482507,LISP 5B,A00,507671,Munoz Sanchez; Alicia,9,0,20,11
1714205483533,LISP 5C,A00,507696,Munoz Sanchez; Alicia,9,0,20,11
1714205484559,MAE 197,001,528363,Boechler; Nicholas Sebastia,9998,0,9999,1
1714205485586,MATH 197,001,523477,Kedlaya; Kiran S.,9996,0,9999,3
1714205485586,MATH 197,002,563811,Zhang; Danna,9995,0,9999,4
1714205485586,MATH 197,003,628552,Dumitriu; Ioana,9998,0,9999,1
1714205486613,MCWP 40R,A00,518780,Staff,5,0,20,15
1714205486613,MCWP 40R,B00,518781,Staff,7,0,20,13
1714205486613,MCWP 40R,C00,518783,Staff,5,0,20,15
1714205487639,MCWP 50R,A00,518791,Staff,0,0,20,20
1714205487639,MCWP 50R,B00,518792,Staff,0,1,20,20
1714205487639,MCWP 50R,C00,518793,Staff,0,1,20,20
1714205487639,MCWP 50R,D00,518794,Staff,0,0,20,20
1714205487639,MCWP 50R,E00,518795,Staff,0,1,20,20
1714205487639,MCWP 50R,F00,518796,Staff,0,0,20,20
1714205487639,MCWP 50R,G00,518797,Staff,0,1,20,20
1714205488667,MMW 12R,A01,514034,Herbst; Matthew,0,1,16,16
1714205488667,MMW 12R,A02,514035,Herbst; Matthew,2,0,16,14
1714205489693,MMW 13R,A01,514037,Staff,0,4,16,16
1714205489693,MMW 13R,A02,514039,Staff,0,2,16,16
1714205489693,MMW 13R,A03,628519,Staff,0,2,16,16
1714205491745,SIO 295LS,A00,523233,Staff,13,0,30,17
1714205492770,SIO 295S,A00,523232,Staff,13,0,30,17
1714205493796,SIOC 290S,A01,637330,Merrifield; Mark A,28,0,30,2
1714205494822,SIOC 291S,A01,637333,Gabriel; Corey John,28,0,30,2
1714205495847,SOCI 117,A01,494376,Staff,0,2,5,5
1714205496874,WES 237B,A00,494380,Staff,9,0,20,11
1714205498946,AESE 279B,A00,494370,Wade; Jon P,0,0,33,33
1714205499974,AIP 197,001,627712,Vespa; Emanuel Ignacio,9998,0,9999,1
1714205501005,ANAR 135S,A00,494369,Braswell; Geoffrey E.,0,0,0,0
1714205502036,BENG 196,001,628496,Engler; Adam J.,9998,0,9999,1
1714205503079,CAT 124RS,A01,519847,Geibel; William,0,0,20,20
1714205504159,CAT 125RS,A01,515971,Geibel; William,0,0,20,20
1714205505186,CLRE 250,A00,511389,Morris; Sheldon,9993,0,9999,6
1714205506215,CLRE 251,A00,507176,Mehta; Ravindra L.,9993,0,9999,6
1714205506215,CLRE 251,B00,511410,Mehta; Ravindra L.,9998,0,9999,1
1714205507263,CLRE 252,A00,507189,Cuomo; Raphael Eduardo,9995,0,9999,4
1714205508290,CLRE 253,A00,507199,Vaida; Florin,9994,0,9999,5
1714205508290,CLRE 253,B00,507202,Vaida; Florin,9999,0,9999,0
1714205509316,CLRE 259,A00,507211,Patel; Hemal,9996,0,9999,3
1714205510345,CLRE 260,A00,507221,Cuomo; Raphael Eduardo,9999,0,9999,0
1714205511393,CLRE 297,001,507242,Cuomo; Raphael Eduardo,9999,0,9999,0
1714205512420,COGS 197,001,638244,Voytek; Bradley Thomas,9999,0,9999,0
1714205513451,CSE 191,A00,516875,Minnes Kemp; Mor Mia,9993,0,9999,6
1714205514476,CSE 197,001,637388,Minnes Kemp; Mor Mia,9998,0,9999,1
1714205515502,CSS 201S,A01,494383,Staff,35,0,35,0
1714205516528,CSS 202S,A01,494387,Staff,35,0,35,0
1714205517553,DSC 197,001,628532,Eldridge; Justin Matthew,9996,0,9999,3
1714205518578,EAP 100,A00,516065,Staff,9797,0,9999,202
1714205519607,ECE 45,A01,507414,Staff,33,0,60,27
1714205521659,ECE 111,A01,507420,Staff,21,0,50,29
1714205522686,ECE 197,001,548057,Sievenpiper; Daniel F.,9994,0,9999,5
1714205523712,EDS 115,A00,507243,Choi; Bailey Miyeon,12,0,28,16
1714205524737,EDS 117,A01,494379,Staff,0,1,30,30
1714205525763,EDS 125,A00,507246,Hopkins; Megan Beth,12,0,30,18
1714205526789,EDS 128A,A01,507264,Fargason; Sharon Gayle,14,0,26,12
1714205527815,EDS 128B,A01,507293,Pappas; Elizabeth,18,0,30,12
1714205528840,EDS 139,A00,507294,Fargason; Sharon Gayle,18,0,30,12
1714205528840,EDS 139,B00,507313,Pappas; Elizabeth,15,0,30,15
1714205529869,EDS 201,A00,507315,Staff,13,0,30,17
1714205530896,EDS 203,A01,507317,Halter; Christopher P.,12,0,30,18
1714205531923,EDS 204R,A01,507319,Halter; Christopher P.,0,3,30,30
1714205531923,EDS 204R,B01,507331,Heinzman; Erica M.,17,0,30,13
1714205532953,EDS 206R,A00,507332,Staff,0,4,30,30
1714205532953,EDS 206R,B00,507343,Staff,18,0,30,12
1714205533983,EDS 250,A00,507344,Hemans; Patricia Ann Benitez,22,0,40,18
1714205535012,EDS 281,A00,507345,Daly; Alan J.,18,0,18,0
1714205536041,EDS 284,A00,507350,Daly; Alan J.,16,0,16,0
1714205537067,EDS 286,A00,507359,Fine; Sarah,18,0,18,0
1714205538094,EDS 289C,A01,507361,Daly; Alan J.,18,0,18,0
1714205539120,EDS 290,A00,507366,Hofstetter; Carolyn,15,0,15,0
1714205540147,LIGM 5A,A00,507421,Fischer-Grunski; Eva K,18,0,20,2
1714205541175,LIGM 5B,A00,507423,Fischer-Grunski; Eva K,19,0,20,1
1714205542201,LIGM 5C,A00,507425,Fischer-Grunski; Eva K,19,0,20,1
1714205543228,LIIT 5AS,A00,507427,Carnelos; Chiara,20,0,20,0
1714205544257,LIIT 5BS,A00,507430,Carnelos; Chiara,20,0,20,0
1714205545287,LIIT 5CS,A00,507432,Carnelos; Chiara,20,0,20,0
1714205546317,LISP 5A,A00,507541,Munoz Sanchez; Alicia,11,0,20,9
1714205547345,LISP 5B,A00,507671,Munoz Sanchez; Alicia,9,0,20,11
1714205548371,LISP 5C,A00,507696,Munoz Sanchez; Alicia,9,0,20,11
1714205549395,MAE 197,001,528363,Boechler; Nicholas Sebastia,9998,0,9999,1
1714205550422,MATH 197,001,523477,Kedlaya; Kiran S.,9996,0,9999,3
1714205550422,MATH 197,002,563811,Zhang; Danna,9995,0,9999,4
1714205550422,MATH 197,003,628552,Dumitriu; Ioana,9998,0,9999,1
1714205551451,MCWP 40R,A00,518780,Staff,5,0,20,15
1714205551451,MCWP 40R,B00,518781,Staff,7,0,20,13
1714205551451,MCWP 40R,C00,518783,Staff,5,0,20,15
1714205552478,MCWP 50R,A00,518791,Staff,0,0,20,20
1714205552478,MCWP 50R,B00,518792,Staff,0,1,20,20
1714205552478,MCWP 50R,C00,518793,Staff,0,1,20,20
1714205552478,MCWP 50R,D00,518794,Staff,0,0,20,20
1714205552478,MCWP 50R,E00,518795,Staff,0,1,20,20
1714205552478,MCWP 50R,F00,518796,Staff,0,0,20,20
1714205552478,MCWP 50R,G00,518797,Staff,0,1,20,20
1714205553504,MMW 12R,A01,514034,Herbst; Matthew,0,1,16,16
1714205553504,MMW 12R,A02,514035,Herbst; Matthew,2,0,16,14
1714205554533,MMW 13R,A01,514037,Staff,0,4,16,16
1714205554533,MMW 13R,A02,514039,Staff,0,2,16,16
1714205554533,MMW 13R,A03,628519,Staff,0,2,16,16
1714205556591,SIO 295LS,A00,523233,Staff,13,0,30,17
1714205557622,SIO 295S,A00,523232,Staff,13,0,30,17
1714205558649,SIOC 290S,A01,637330,Merrifield; Mark A,28,0,30,2
1714205559679,SIOC 291S,A01,637333,Gabriel; Corey John,28,0,30,2
1714205560708,SOCI 117,A01,494376,Staff,0,2,5,5
1714205561734,WES 237B,A00,494380,Staff,9,0,20,11
1714205563806,AESE 279B,A00,494370,Wade; Jon P,0,0,33,33
1714205564835,AIP 197,001,627712,Vespa; Emanuel Ignacio,9998,0,9999,1
1714205565863,ANAR 135S,A00,494369,Braswell; Geoffrey E.,0,0,0,0
1714205566890,BENG 196,001,628496,Engler; Adam J.,9998,0,9999,1
1714205567917,CAT 124RS,A01,519847,Geibel; William,0,0,20,20
1714205568945,CAT 125RS,A01,515971,Geibel; William,0,0,20,20
1714205569973,CLRE 250,A00,511389,Morris; Sheldon,9993,0,9999,6
1714205570999,CLRE 251,A00,507176,Mehta; Ravindra L.,9993,0,9999,6
1714205570999,CLRE 251,B00,511410,Mehta; Ravindra L.,9998,0,9999,1
1714205572030,CLRE 252,A00,507189,Cuomo; Raphael Eduardo,9995,0,9999,4
1714205573057,CLRE 253,A00,507199,Vaida; Florin,9994,0,9999,5
1714205573057,CLRE 253,B00,507202,Vaida; Florin,9999,0,9999,0
1714205574082,CLRE 259,A00,507211,Patel; Hemal,9996,0,9999,3
1714205575109,CLRE 260,A00,507221,Cuomo; Raphael Eduardo,9999,0,9999,0
1714205576135,CLRE 297,001,507242,Cuomo; Raphael Eduardo,9999,0,9999,0
1714205577161,COGS 197,001,638244,Voytek; Bradley Thomas,9999,0,9999,0
1714205578191,CSE 191,A00,516875,Minnes Kemp; Mor Mia,9993,0,9999,6
1714205579219,CSE 197,001,637388,Minnes Kemp; Mor Mia,9998,0,9999,1
1714205580245,CSS 201S,A01,494383,Staff,35,0,35,0
1714205581272,CSS 202S,A01,494387,Staff,35,0,35,0
1714205582301,DSC 197,001,628532,Eldridge; Justin Matthew,9996,0,9999,3
1714205583328,EAP 100,A00,516065,Staff,9797,0,9999,202
1714205584358,ECE 45,A01,507414,Staff,33,0,60,27
1714205586415,ECE 111,A01,507420,Staff,21,0,50,29
1714205587442,ECE 197,001,548057,Sievenpiper; Daniel F.,9994,0,9999,5
1714205588469,EDS 115,A00,507243,Choi; Bailey Miyeon,12,0,28,16
1714205589499,EDS 117,A01,494379,Staff,0,1,30,30
1714205590525,EDS 125,A00,507246,Hopkins; Megan Beth,12,0,30,18
1714205591551,EDS 128A,A01,507264,Fargason; Sharon Gayle,14,0,26,12
1714205592575,EDS 128B,A01,507293,Pappas; Elizabeth,18,0,30,12
1714205593601,EDS 139,A00,507294,Fargason; Sharon Gayle,18,0,30,12
1714205593601,EDS 139,B00,507313,Pappas; Elizabeth,15,0,30,15
1714205594626,EDS 201,A00,507315,Staff,13,0,30,17
1714205595654,EDS 203,A01,507317,Halter; Christopher P.,12,0,30,18
1714205596680,EDS 204R,A01,507319,Halter; Christopher P.,0,3,30,30
1714205596680,EDS 204R,B01,507331,Heinzman; Erica M.,17,0,30,13
1714205597710,EDS 206R,A00,507332,Staff,0,4,30,30
1714205597710,EDS 206R,B00,507343,Staff,18,0,30,12
1714205598738,EDS 250,A00,507344,Hemans; Patricia Ann Benitez,22,0,40,18
1714205599767,EDS 281,A00,507345,Daly; Alan J.,18,0,18,0
1714205600795,EDS 284,A00,507350,Daly; Alan J.,16,0,16,0
1714205601824,EDS 286,A00,507359,Fine; Sarah,18,0,18,0
1714205602853,EDS 289C,A01,507361,Daly; Alan J.,18,0,18,0
1714205603879,EDS 290,A00,507366,Hofstetter; Carolyn,15,0,15,0
1714205604904,LIGM 5A,A00,507421,Fischer-Grunski; Eva K,18,0,20,2
1714205605932,LIGM 5B,A00,507423,Fischer-Grunski; Eva K,19,0,20,1
1714205606957,LIGM 5C,A00,507425,Fischer-Grunski; Eva K,19,0,20,1
1714205608038,LIIT 5AS,A00,507427,Carnelos; Chiara,20,0,20,0
1714205609063,LIIT 5BS,A00,507430,Carnelos; Chiara,20,0,20,0
1714205610089,LIIT 5CS,A00,507432,Carnelos; Chiara,20,0,20,0
1714205611116,LISP 5A,A00,507541,Munoz Sanchez; Alicia,11,0,20,9
1714205612141,LISP 5B,A00,507671,Munoz Sanchez; Alicia,9,0,20,11
1714205613165,LISP 5C,A00,507696,Munoz Sanchez; Alicia,9,0,20,11
1714205614192,MAE 197,001,528363,Boechler; Nicholas Sebastia,9998,0,9999,1
1714205615220,MATH 197,001,523477,Kedlaya; Kiran S.,9996,0,9999,3
1714205615220,MATH 197,002,563811,Zhang; Danna,9995,0,9999,4
1714205615220,MATH 197,003,628552,Dumitriu; Ioana,9998,0,9999,1
1714205616249,MCWP 40R,A00,518780,Staff,5,0,20,15
1714205616249,MCWP 40R,B00,518781,Staff,7,0,20,13
1714205616249,MCWP 40R,C00,518783,Staff,5,0,20,15
1714205617276,MCWP 50R,A00,518791,Staff,0,0,20,20
1714205617276,MCWP 50R,B00,518792,Staff,0,1,20,20
1714205617276,MCWP 50R,C00,518793,Staff,0,1,20,20
1714205617276,MCWP 50R,D00,518794,Staff,0,0,20,20
1714205617276,MCWP 50R,E00,518795,Staff,0,1,20,20
1714205617276,MCWP 50R,F00,518796,Staff,0,0,20,20
1714205617276,MCWP 50R,G00,518797,Staff,0,1,20,20
1714205618306,MMW 12R,A01,514034,Herbst; Matthew,0,1,16,16
1714205618306,MMW 12R,A02,514035,Herbst; Matthew,2,0,16,14
1714205619335,MMW 13R,A01,514037,Staff,0,4,16,16
1714205619335,MMW 13R,A02,514039,Staff,0,2,16,16
1714205619335,MMW 13R,A03,628519,Staff,0,2,16,16
1714205621388,SIO 295LS,A00,523233,Staff,13,0,30,17
1714205622416,SIO 295S,A00,523232,Staff,13,0,30,17
1714205623442,SIOC 290S,A01,637330,Merrifield; Mark A,28,0,30,2
1714205624473,SIOC 291S,A01,637333,Gabriel; Corey John,28,0,30,2
1714205625500,SOCI 117,A01,494376,Staff,0,2,5,5
1714205626531,WES 237B,A00,494380,Staff,9,0,20,11
1714205628594,AESE 279B,A00,494370,Wade; Jon P,0,0,33,33
1714205629618,AIP 197,001,627712,Vespa; Emanuel Ignacio,9998,0,9999,1
1714205630644,ANAR 135S,A00,494369,Braswell; Geoffrey E.,0,0,0,0
1714205631672,BENG 196,001,628496,Engler; Adam J.,9998,0,9999,1
1714205632699,CAT 124RS,A01,519847,Geibel; William,0,0,20,20
1714205633724,CAT 125RS,A01,515971,Geibel; William,0,0,20,20
1714205634759,CLRE 250,A00,511389,Morris; Sheldon,9993,0,9999,6
1714205635785,CLRE 251,A00,507176,Mehta; Ravindra L.,9993,0,9999,6
1714205635785,CLRE 251,B00,511410,Mehta; Ravindra L.,9998,0,9999,1
1714205636815,CLRE 252,A00,507189,Cuomo; Raphael Eduardo,9995,0,9999,4
1714205637840,CLRE 253,A00,507199,Vaida; Florin,9994,0,9999,5
1714205637840,CLRE 253,B00,507202,Vaida; Florin,9999,0,9999,0
1714205638866,CLRE 259,A00,507211,Patel; Hemal,9996,0,9999,3
1714205639895,CLRE 260,A00,507221,Cuomo; Raphael Eduardo,9999,0,9999,0
1714205640922,CLRE 297,001,507242,Cuomo; Raphael Eduardo,9999,0,9999,0
1714205641951,COGS 197,001,638244,Voytek; Bradley Thomas,9999,0,9999,0
1714205642981,CSE 191,A00,516875,Minnes Kemp; Mor Mia,9993,0,9999,6
1714205644006,CSE 197,001,637388,Minnes Kemp; Mor Mia,9998,0,9999,1
1714205645032,CSS 201S,A01,494383,Staff,35,0,35,0
1714205646057,CSS 202S,A01,494387,Staff,35,0,35,0
1714205647085,DSC 197,001,628532,Eldridge; Justin Matthew,9996,0,9999,3
1714205648111,EAP 100,A00,516065,Staff,9797,0,9999,202
1714205649138,ECE 45,A01,507414,Staff,33,0,60,27
1714205651193,ECE 111,A01,507420,Staff,21,0,50,29
1714205652220,ECE 197,001,548057,Sievenpiper; Daniel F.,9994,0,9999,5
1714205653247,EDS 115,A00,507243,Choi; Bailey Miyeon,12,0,28,16
1714205654276,EDS 117,A01,494379,Staff,0,1,30,30
1714205655300,EDS 125,A00,507246,Hopkins; Megan Beth,12,0,30,18
1714205656325,EDS 128A,A01,507264,Fargason; Sharon Gayle,14,0,26,12
1714205657352,EDS 128B,A01,507293,Pappas; Elizabeth,18,0,30,12
1714205658377,EDS 139,A00,507294,Fargason; Sharon Gayle,18,0,30,12
1714205658377,EDS 139,B00,507313,Pappas; Elizabeth,15,0,30,15
1714205659401,EDS 201,A00,507315,Staff,13,0,30,17
1714205660429,EDS 203,A01,507317,Halter; Christopher P.,12,0,30,18
1714205661455,EDS 204R,A01,507319,Halter; Christopher P.,0,3,30,30
1714205661455,EDS 204R,B01,507331,Heinzman; Erica M.,17,0,30,13
1714205662482,EDS 206R,A00,507332,Staff,0,4,30,30
1714205662482,EDS 206R,B00,507343,Staff,18,0,30,12
1714205663509,EDS 250,A00,507344,Hemans; Patricia Ann Benitez,22,0,40,18
1714205664539,EDS 281,A00,507345,Daly; Alan J.,18,0,18,0
1714205665566,EDS 284,A00,507350,Daly; Alan J.,16,0,16,0
1714205666593,EDS 286,A00,507359,Fine; Sarah,18,0,18,0
1714205667619,EDS 289C,A01,507361,Daly; Alan J.,18,0,18,0
1714205668644,EDS 290,A00,507366,Hofstetter; Carolyn,15,0,15,0
1714205669671,LIGM 5A,A00,507421,Fischer-Grunski; Eva K,18,0,20,2
1714205670697,LIGM 5B,A00,507423,Fischer-Grunski; Eva K,19,0,20,1
1714205671726,LIGM 5C,A00,507425,Fischer-Grunski; Eva K,19,0,20,1
1714205672752,LIIT 5AS,A00,507427,Carnelos; Chiara,20,0,20,0
1714205673778,LIIT 5BS,A00,507430,Carnelos; Chiara,20,0,20,0
1714205674805,LIIT 5CS,A00,507432,Carnelos; Chiara,20,0,20,0
1714205675837,LISP 5A,A00,507541,Munoz Sanchez; Alicia,11,0,20,9
1714205676868,LISP 5B,A00,507671,Munoz Sanchez; Alicia,9,0,20,11
1714205677894,LISP 5C,A00,507696,Munoz Sanchez; Alicia,9,0,20,11
1714205678921,MAE 197,001,528363,Boechler; Nicholas Sebastia,9998,0,9999,1
1714205679949,MATH 197,001,523477,Kedlaya; Kiran S.,9996,0,9999,3
1714205679949,MATH 197,002,563811,Zhang; Danna,9995,0,9999,4
1714205679949,MATH 197,003,628552,Dumitriu; Ioana,9998,0,9999,1
1714205680976,MCWP 40R,A00,518780,Staff,5,0,20,15
1714205680976,MCWP 40R,B00,518781,Staff,7,0,20,13
1714205680976,MCWP 40R,C00,518783,Staff,5,0,20,15
1714205682002,MCWP 50R,A00,518791,Staff,0,0,20,20
1714205682002,MCWP 50R,B00,518792,Staff,0,1,20,20
1714205682002,MCWP 50R,C00,518793,Staff,0,1,20,20
1714205682002,MCWP 50R,D00,518794,Staff,0,0,20,20
1714205682002,MCWP 50R,E00,518795,Staff,0,1,20,20
1714205682002,MCWP 50R,F00,518796,Staff,0,0,20,20
1714205682002,MCWP 50R,G00,518797,Staff,0,1,20,20
1714205683027,MMW 12R,A01,514034,Herbst; Matthew,0,1,16,16
1714205683027,MMW 12R,A02,514035,Herbst; Matthew,2,0,16,14
1714205684054,MMW 13R,A01,514037,Staff,0,4,16,16
1714205684054,MMW 13R,A02,514039,Staff,0,2,16,16
1714205684054,MMW 13R,A03,628519,Staff,0,2,16,16
1714205686101,SIO 295LS,A00,523233,Staff,13,0,30,17
1714205687127,SIO 295S,A00,523232,Staff,13,0,30,17
1714205688153,SIOC 290S,A01,637330,Merrifield; Mark A,28,0,30,2
1714205689180,SIOC 291S,A01,637333,Gabriel; Corey John,28,0,30,2
1714205690208,SOCI 117,A01,494376,Staff,0,2,5,5
1714205691237,WES 237B,A00,494380,Staff,9,0,20,11
1714205693315,AESE 279B,A00,494370,Wade; Jon P,0,0,33,33
1714205694343,AIP 197,001,627712,Vespa; Emanuel Ignacio,9998,0,9999,1
1714205695372,ANAR 135S,A00,494369,Braswell; Geoffrey E.,0,0,0,0
1714205696401,BENG 196,001,628496,Engler; Adam J.,9998,0,9999,1
1714205697426,CAT 124RS,A01,519847,Geibel; William,0,0,20,20
1714205698454,CAT 125RS,A01,515971,Geibel; William,0,0,20,20
1714205699480,CLRE 250,A00,511389,Morris; Sheldon,9993,0,9999,6
1714205700512,CLRE 251,A00,507176,Mehta; Ravindra L.,9993,0,9999,6
1714205700512,CLRE 251,B00,511410,Mehta; Ravindra L.,9998,0,9999,1
1714205701538,CLRE 252,A00,507189,Cuomo; Raphael Eduardo,9995,0,9999,4
1714205702567,CLRE 253,A00,507199,Vaida; Florin,9994,0,9999,5
1714205702567,CLRE 253,B00,507202,Vaida; Florin,9999,0,9999,0
1714205703591,CLRE 259,A00,507211,Patel; Hemal,9996,0,9999,3
1714205704617,CLRE 260,A00,507221,Cuomo; Raphael Eduardo,9999,0,9999,0
1714205705644,CLRE 297,001,507242,Cuomo; Raphael Eduardo,9999,0,9999,0
1714205706670,COGS 197,001,638244,Voytek; Bradley Thomas,9999,0,9999,0
1714205707695,CSE 191,A00,516875,Minnes Kemp; Mor Mia,9993,0,9999,6
1714205708723,CSE 197,001,637388,Minnes Kemp; Mor Mia,9998,0,9999,1
1714205709750,CSS 201S,A01,494383,Staff,35,0,35,0
1714205710779,CSS 202S,A01,494387,Staff,35,0,35,0
1714205711861,DSC 197,001,628532,Eldridge; Justin Matthew,9996,0,9999,3
1714205712888,EAP 100,A00,516065,Staff,9797,0,9999,202
1714205713915,ECE 45,A01,507414,Staff,33,0,60,27
1714205715968,ECE 111,A01,507420,Staff,21,0,50,29
1714205716996,ECE 197,001,548057,Sievenpiper; Daniel F.,9994,0,9999,5
1714205718022,EDS 115,A00,507243,Choi; Bailey Miyeon,12,0,28,16
1714205719050,EDS 117,A01,494379,Staff,0,1,30,30
1714205720079,EDS 125,A00,507246,Hopkins; Megan Beth,12,0,30,18
1714205721107,EDS 128A,A01,507264,Fargason; Sharon Gayle,14,0,26,12
1714205722136,EDS 128B,A01,507293,Pappas; Elizabeth,18,0,30,12
1714205723163,EDS 139,A00,507294,Fargason; Sharon Gayle,18,0,30,12
1714205723163,EDS 139,B00,507313,Pappas; Elizabeth,15,0,30,15
1714205724191,EDS 201,A00,507315,Staff,13,0,30,17
1714205725216,EDS 203,A01,507317,Halter; Christopher P.,12,0,30,18
1714205726242,EDS 204R,A01,507319,Halter; Christopher P.,0,3,30,30
1714205726242,EDS 204R,B01,507331,Heinzman; Erica M.,17,0,30,13
1714205727268,EDS 206R,A00,507332,Staff,0,4,30,30
1714205727268,EDS 206R,B00,507343,Staff,18,0,30,12
1714205728292,EDS 250,A00,507344,Hemans; Patricia Ann Benitez,22,0,40,18
1714205729320,EDS 281,A00,507345,Daly; Alan J.,18,0,18,0
1714205730349,EDS 284,A00,507350,Daly; Alan J.,16,0,16,0
1714205731377,EDS 286,A00,507359,Fine; Sarah,18,0,18,0
1714205732406,EDS 289C,A01,507361,Daly; Alan J.,18,0,18,0
1714205733430,EDS 290,A00,507366,Hofstetter; Carolyn,15,0,15,0
1714205734455,LIGM 5A,A00,507421,Fischer-Grunski; Eva K,18,0,20,2
1714205735484,LIGM 5B,A00,507423,Fischer-Grunski; Eva K,19,0,20,1
1714205736513,LIGM 5C,A00,507425,Fischer-Grunski; Eva K,19,0,20,1
1714205737538,LIIT 5AS,A00,507427,Carnelos; Chiara,20,0,20,0
1714205738567,LIIT 5BS,A00,507430,Carnelos; Chiara,20,0,20,0
1714205739594,LIIT 5CS,A00,507432,Carnelos; Chiara,20,0,20,0
1714205740620,LISP 5A,A00,507541,Munoz Sanchez; Alicia,11,0,20,9
1714205741645,LISP 5B,A00,507671,Munoz Sanchez; Alicia,9,0,20,11
1714205742671,LISP 5C,A00,507696,Munoz Sanchez; Alicia,9,0,20,11
1714205743700,MAE 197,001,528363,Boechler; Nicholas Sebastia,9998,0,9999,1
1714205744729,MATH 197,001,523477,Kedlaya; Kiran S.,9996,0,9999,3
1714205744729,MATH 197,002,563811,Zhang; Danna,9995,0,9999,4
1714205744729,MATH 197,003,628552,Dumitriu; Ioana,9998,0,9999,1
1714205745757,MCWP 40R,A00,518780,Staff,5,0,20,15
1714205745757,MCWP 40R,B00,518781,Staff,7,0,20,13
1714205745757,MCWP 40R,C00,518783,Staff,5,0,20,15
1714205746784,MCWP 50R,A00,518791,Staff,0,0,20,20
1714205746784,MCWP 50R,B00,518792,Staff,0,1,20,20
1714205746784,MCWP 50R,C00,518793,Staff,0,1,20,20
1714205746784,MCWP 50R,D00,518794,Staff,0,0,20,20
1714205746784,MCWP 50R,E00,518795,Staff,0,1,20,20
1714205746784,MCWP 50R,F00,518796,Staff,0,0,20,20
1714205746784,MCWP 50R,G00,518797,Staff,0,1,20,20
1714205747813,MMW 12R,A01,514034,Herbst; Matthew,0,1,16,16
1714205747813,MMW 12R,A02,514035,Herbst; Matthew,2,0,16,14
1714205748839,MMW 13R,A01,514037,Staff,0,4,16,16
1714205748839,MMW 13R,A02,514039,Staff,0,2,16,16
1714205748839,MMW 13R,A03,628519,Staff,0,2,16,16
1714205750890,SIO 295LS,A00,523233,Staff,13,0,30,17
1714205751916,SIO 295S,A00,523232,Staff,13,0,30,17
1714205752946,SIOC 290S,A01,637330,Merrifield; Mark A,28,0,30,2
1714205753974,SIOC 291S,A01,637333,Gabriel; Corey John,28,0,30,2
1714205755000,SOCI 117,A01,494376,Staff,0,2,5,5
1714205756030,WES 237B,A00,494380,Staff,9,0,20,11
1714205758101,AESE 279B,A00,494370,Wade; Jon P,0,0,33,33
1714205759129,AIP 197,001,627712,Vespa; Emanuel Ignacio,9998,0,9999,1
1714205760155,ANAR 135S,A00,494369,Braswell; Geoffrey E.,0,0,0,0
1714205761179,BENG 196,001,628496,Engler; Adam J.,9998,0,9999,1
1714205762210,CAT 124RS,A01,519847,Geibel; William,0,0,20,20
1714205763238,CAT 125RS,A01,515971,Geibel; William,0,0,20,20
1714205764266,CLRE 250,A00,511389,Morris; Sheldon,9993,0,9999,6
1714205765292,CLRE 251,A00,507176,Mehta; Ravindra L.,9993,0,9999,6
1714205765292,CLRE 251,B00,511410,Mehta; Ravindra L.,9998,0,9999,1
1714205766317,CLRE 252,A00,507189,Cuomo; Raphael Eduardo,9995,0,9999,4
1714205767343,CLRE 253,A00,507199,Vaida; Florin,9994,0,9999,5
1714205767343,CLRE 253,B00,507202,Vaida; Florin,9999,0,9999,0
1714205768375,CLRE 259,A00,507211,Patel; Hemal,9996,0,9999,3
1714205769402,CLRE 260,A00,507221,Cuomo; Raphael Eduardo,9999,0,9999,0
1714205770430,CLRE 297,001,507242,Cuomo; Raphael Eduardo,9999,0,9999,0
1714205771458,COGS 197,001,638244,Voytek; Bradley Thomas,9999,0,9999,0
1714205772504,CSE 191,A00,516875,Minnes Kemp; Mor Mia,9993,0,9999,6
1714205773530,CSE 197,001,637388,Minnes Kemp; Mor Mia,9998,0,9999,1
1714205774558,CSS 201S,A01,494383,Staff,35,0,35,0
1714205775584,CSS 202S,A01,494387,Staff,35,0,35,0
1714205776610,DSC 197,001,628532,Eldridge; Justin Matthew,9996,0,9999,3
1714205777634,EAP 100,A00,516065,Staff,9797,0,9999,202
1714205778661,ECE 45,A01,507414,Staff,33,0,60,27
1714205780713,ECE 111,A01,507420,Staff,21,0,50,29
1714205781740,ECE 197,001,548057,Sievenpiper; Daniel F.,9994,0,9999,5
1714205782767,EDS 115,A00,507243,Choi; Bailey Miyeon,12,0,28,16
1714205783797,EDS 117,A01,494379,Staff,0,1,30,30
1714205784828,EDS 125,A00,507246,Hopkins; Megan Beth,12,0,30,18
1714205785853,EDS 128A,A01,507264,Fargason; Sharon Gayle,14,0,26,12
1714205786879,EDS 128B,A01,507293,Pappas; Elizabeth,18,0,30,12
1714205787907,EDS 139,A00,507294,Fargason; Sharon Gayle,18,0,30,12
1714205787907,EDS 139,B00,507313,Pappas; Elizabeth,15,0,30,15
1714205788936,EDS 201,A00,507315,Staff,13,0,30,17
1714205789961,EDS 203,A01,507317,Halter; Christopher P.,12,0,30,18
1714205790988,EDS 204R,A01,507319,Halter; Christopher P.,0,3,30,30
1714205790988,EDS 204R,B01,507331,Heinzman; Erica M.,17,0,30,13
1714205792014,EDS 206R,A00,507332,Staff,0,4,30,30
1714205792014,EDS 206R,B00,507343,Staff,18,0,30,12
1714205793039,EDS 250,A00,507344,Hemans; Patricia Ann Benitez,22,0,40,18
1714205794066,EDS 281,A00,507345,Daly; Alan J.,18,0,18,0
1714205795090,EDS 284,A00,507350,Daly; Alan J.,16,0,16,0
1714205796112,EDS 286,A00,507359,Fine; Sarah,18,0,18,0
1714205797140,EDS 289C,A01,507361,Daly; Alan J.,18,0,18,0
1714205798614,EDS 290,A00,507366,Hofstetter; Carolyn,15,0,15,0
1714205799640,LIGM 5A,A00,507421,Fischer-Grunski; Eva K,18,0,20,2
1714205800670,LIGM 5B,A00,507423,Fischer-Grunski; Eva K,19,0,20,1
1714205801694,LIGM 5C,A00,507425,Fischer-Grunski; Eva K,19,0,20,1
1714205802720,LIIT 5AS,A00,507427,Carnelos; Chiara,20,0,20,0
1714205803744,LIIT 5BS,A00,507430,Carnelos; Chiara,20,0,20,0
1714205804770,LIIT 5CS,A00,507432,Carnelos; Chiara,20,0,20,0
1714205805798,LISP 5A,A00,507541,Munoz Sanchez; Alicia,11,0,20,9
1714205806827,LISP 5B,A00,507671,Munoz Sanchez; Alicia,9,0,20,11
1714205807857,LISP 5C,A00,507696,Munoz Sanchez; Alicia,9,0,20,11
1714205808886,MAE 197,001,528363,Boechler; Nicholas Sebastia,9998,0,9999,1
1714205809918,MATH 197,001,523477,Kedlaya; Kiran S.,9996,0,9999,3
1714205809918,MATH 197,002,563811,Zhang; Danna,9995,0,9999,4
1714205809918,MATH 197,003,628552,Dumitriu; Ioana,9998,0,9999,1
1714205810949,MCWP 40R,A00,518780,Staff,5,0,20,15
1714205810949,MCWP 40R,B00,518781,Staff,7,0,20,13
1714205810949,MCWP 40R,C00,518783,Staff,5,0,20,15
1714205811980,MCWP 50R,A00,518791,Staff,0,0,20,20
1714205811980,MCWP 50R,B00,518792,Staff,0,1,20,20
1714205811980,MCWP 50R,C00,518793,Staff,0,1,20,20
1714205811980,MCWP 50R,D00,518794,Staff,0,0,20,20
1714205811980,MCWP 50R,E00,518795,Staff,0,1,20,20
1714205811980,MCWP 50R,F00,518796,Staff,0,0,20,20
1714205811980,MCWP 50R,G00,518797,Staff,0,1,20,20
1714205813009,MMW 12R,A01,514034,Herbst; Matthew,0,1,16,16
1714205813009,MMW 12R,A02,514035,Herbst; Matthew,2,0,16,14
1714205814036,MMW 13R,A01,514037,Staff,0,4,16,16
1714205814036,MMW 13R,A02,514039,Staff,0,2,16,16
1714205814036,MMW 13R,A03,628519,Staff,0,2,16,16
1714205816142,SIO 295LS,A00,523233,Staff,13,0,30,17
1714205817167,SIO 295S,A00,523232,Staff,13,0,30,17
1714205818192,SIOC 290S,A01,637330,Merrifield; Mark A,28,0,30,2
1714205819217,SIOC 291S,A01,637333,Gabriel; Corey John,28,0,30,2
1714205820246,SOCI 117,A01,494376,Staff,0,2,5,5
1714205821270,WES 237B,A00,494380,Staff,9,0,20,11
1714205823330,AESE 279B,A00,494370,Wade; Jon P,0,0,33,33
1714205824360,AIP 197,001,627712,Vespa; Emanuel Ignacio,9998,0,9999,1
1714205825389,ANAR 135S,A00,494369,Braswell; Geoffrey E.,0,0,0,0
1714205826416,BENG 196,001,628496,Engler; Adam J.,9998,0,9999,1
1714205827442,CAT 124RS,A01,519847,Geibel; William,0,0,20,20
1714205828467,CAT 125RS,A01,515971,Geibel; William,0,0,20,20
1714205829491,CLRE 250,A00,511389,Morris; Sheldon,9993,0,9999,6
1714205830524,CLRE 251,A00,507176,Mehta; Ravindra L.,9993,0,9999,6
1714205830524,CLRE 251,B00,511410,Mehta; Ravindra L.,9998,0,9999,1
1714205831550,CLRE 252,A00,507189,Cuomo; Raphael Eduardo,9995,0,9999,4
1714205832576,CLRE 253,A00,507199,Vaida; Florin,9994,0,9999,5
1714205832576,CLRE 253,B00,507202,Vaida; Florin,9999,0,9999,0
1714205833601,CLRE 259,A00,507211,Patel; Hemal,9996,0,9999,3
1714205834626,CLRE 260,A00,507221,Cuomo; Raphael Eduardo,9999,0,9999,0
1714205835653,CLRE 297,001,507242,Cuomo; Raphael Eduardo,9999,0,9999,0
1714205836680,COGS 197,001,638244,Voytek; Bradley Thomas,9999,0,9999,0
1714205837704,CSE 191,A00,516875,Minnes Kemp; Mor Mia,9993,0,9999,6
1714205838733,CSE 197,001,637388,Minnes Kemp; Mor Mia,9998,0,9999,1
1714205839760,CSS 201S,A01,494383,Staff,35,0,35,0
1714205840787,CSS 202S,A01,494387,Staff,35,0,35,0
1714205841814,DSC 197,001,628532,Eldridge; Justin Matthew,9996,0,9999,3
1714205842841,EAP 100,A00,516065,Staff,9797,0,9999,202
1714205843867,ECE 45,A01,507414,Staff,33,0,60,27
1714205845922,ECE 111,A01,507420,Staff,21,0,50,29
1714205846952,ECE 197,001,548057,Sievenpiper; Daniel F.,9994,0,9999,5
1714205847981,EDS 115,A00,507243,Choi; Bailey Miyeon,12,0,28,16
1714205849011,EDS 117,A01,494379,Staff,0,1,30,30
1714205850036,EDS 125,A00,507246,Hopkins; Megan Beth,12,0,30,18
1714205851063,EDS 128A,A01,507264,Fargason; Sharon Gayle,14,0,26,12
1714205852094,EDS 128B,A01,507293,Pappas; Elizabeth,18,0,30,12
1714205853119,EDS 139,A00,507294,Fargason; Sharon Gayle,18,0,30,12
1714205853119,EDS 139,B00,507313,Pappas; Elizabeth,15,0,30,15
1714205854144,EDS 201,A00,507315,Staff,13,0,30,17
1714205855170,EDS 203,A01,507317,Halter; Christopher P.,12,0,30,18
1714205856195,EDS 204R,A01,507319,Halter; Christopher P.,0,3,30,30
1714205856195,EDS 204R,B01,507331,Heinzman; Erica M.,17,0,30,13
1714205857222,EDS 206R,A00,507332,Staff,0,4,30,30
1714205857222,EDS 206R,B00,507343,Staff,18,0,30,12
1714205858247,EDS 250,A00,507344,Hemans; Patricia Ann Benitez,22,0,40,18
1714205859273,EDS 281,A00,507345,Daly; Alan J.,18,0,18,0
1714205860300,EDS 284,A00,507350,Daly; Alan J.,16,0,16,0
1714205861328,EDS 286,A00,507359,Fine; Sarah,18,0,18,0
1714205862352,EDS 289C,A01,507361,Daly; Alan J.,18,0,18,0
1714205863378,EDS 290,A00,507366,Hofstetter; Carolyn,15,0,15,0
1714205864408,LIGM 5A,A00,507421,Fischer-Grunski; Eva K,18,0,20,2
1714205865434,LIGM 5B,A00,507423,Fischer-Grunski; Eva K,19,0,20,1
1714205866459,LIGM 5C,A00,507425,Fischer-Grunski; Eva K,19,0,20,1
1714205867485,LIIT 5AS,A00,507427,Carnelos; Chiara,20,0,20,0
1714205868510,LIIT 5BS,A00,507430,Carnelos; Chiara,20,0,20,0
1714205869542,LIIT 5CS,A00,507432,Carnelos; Chiara,20,0,20,0
1714205870571,LISP 5A,A00,507541,Munoz Sanchez; Alicia,11,0,20,9
1714205871600,LISP 5B,A00,507671,Munoz Sanchez; Alicia,9,0,20,11
1714205872628,LISP 5C,A00,507696,Munoz Sanchez; Alicia,9,0,20,11
1714205873657,MAE 197,001,528363,Boechler; Nicholas Sebastia,9998,0,9999,1
1714205874689,MATH 197,001,523477,Kedlaya; Kiran S.,9996,0,9999,3
1714205874689,MATH 197,002,563811,Zhang; Danna,9995,0,9999,4
1714205874689,MATH 197,003,628552,Dumitriu; Ioana,9998,0,9999,1
1714205875719,MCWP 40R,A00,518780,Staff,5,0,20,15
1714205875719,MCWP 40R,B00,518781,Staff,7,0,20,13
1714205875719,MCWP 40R,C00,518783,Staff,5,0,20,15
1714205876745,MCWP 50R,A00,518791,Staff,0,0,20,20
1714205876745,MCWP 50R,B00,518792,Staff,0,1,20,20
1714205876745,MCWP 50R,C00,518793,Staff,0,1,20,20
1714205876745,MCWP 50R,D00,518794,Staff,0,0,20,20
1714205876745,MCWP 50R,E00,518795,Staff,0,1,20,20
1714205876745,MCWP 50R,F00,518796,Staff,0,0,20,20
1714205876745,MCWP 50R,G00,518797,Staff,0,1,20,20
1714205877775,MMW 12R,A01,514034,Herbst; Matthew,0,1,16,16
1714205877775,MMW 12R,A02,514035,Herbst; Matthew,2,0,16,14
1714205878800,MMW 13R,A01,514037,Staff,0,4,16,16
1714205878800,MMW 13R,A02,514039,Staff,0,2,16,16
1714205878800,MMW 13R,A03,628519,Staff,0,2,16,16
1714205880850,SIO 295LS,A00,523233,Staff,13,0,30,17
1714205881876,SIO 295S,A00,523232,Staff,13,0,30,17
1714205882904,SIOC 290S,A01,637330,Merrifield; Mark A,28,0,30,2
1714205883930,SIOC 291S,A01,637333,Gabriel; Corey John,28,0,30,2
1714205884958,SOCI 117,A01,494376,Staff,0,2,5,5
1714205885981,WES 237B,A00,494380,Staff,9,0,20,11
1714205888044,AESE 279B,A00,494370,Wade; Jon P,0,0,33,33
1714205889071,AIP 197,001,627712,Vespa; Emanuel Ignacio,9998,0,9999,1
1714205890100,ANAR 135S,A00,494369,Braswell; Geoffrey E.,0,0,0,0
1714205891128,BENG 196,001,628496,Engler; Adam J.,9998,0,9999,1
1714205892154,CAT 124RS,A01,519847,Geibel; William,0,0,20,20
1714205893181,CAT 125RS,A01,515971,Geibel; William,0,0,20,20
1714205894210,CLRE 250,A00,511389,Morris; Sheldon,9993,0,9999,6
1714205895238,CLRE 251,A00,507176,Mehta; Ravindra L.,9993,0,9999,6
1714205895238,CLRE 251,B00,511410,Mehta; Ravindra L.,9998,0,9999,1
1714205896263,CLRE 252,A00,507189,Cuomo; Raphael Eduardo,9995,0,9999,4
1714205897293,CLRE 253,A00,507199,Vaida; Florin,9994,0,9999,5
1714205897293,CLRE 253,B00,507202,Vaida; Florin,9999,0,9999,0
1714205898319,CLRE 259,A00,507211,Patel; Hemal,9996,0,9999,3
1714205899377,CLRE 260,A00,507221,Cuomo; Raphael Eduardo,9999,0,9999,0
1714205900403,CLRE 297,001,507242,Cuomo; Raphael Eduardo,9999,0,9999,0
1714205901432,COGS 197,001,638244,Voytek; Bradley Thomas,9999,0,9999,0
1714205902462,CSE 191,A00,516875,Minnes Kemp; Mor Mia,9993,0,9999,6
1714205903489,CSE 197,001,637388,Minnes Kemp; Mor Mia,9998,0,9999,1
1714205904513,CSS 201S,A01,494383,Staff,35,0,35,0
1714205905542,CSS 202S,A01,494387,Staff,35,0,35,0
1714205906566,DSC 197,001,628532,Eldridge; Justin Matthew,9996,0,9999,3
1714205907593,EAP 100,A00,516065,Staff,9797,0,9999,202
1714205908617,ECE 45,A01,507414,Staff,33,0,60,27
1714205910673,ECE 111,A01,507420,Staff,21,0,50,29
1714205911698,ECE 197,001,548057,Sievenpiper; Daniel F.,9994,0,9999,5
1714205912728,EDS 115,A00,507243,Choi; Bailey Miyeon,12,0,28,16
1714205913753,EDS 117,A01,494379,Staff,0,1,30,30
1714205914784,EDS 125,A00,507246,Hopkins; Megan Beth,12,0,30,18
1714205915812,EDS 128A,A01,507264,Fargason; Sharon Gayle,14,0,26,12
1714205916837,EDS 128B,A01,507293,Pappas; Elizabeth,18,0,30,12
1714205917865,EDS 139,A00,507294,Fargason; Sharon Gayle,18,0,30,12
1714205917865,EDS 139,B00,507313,Pappas; Elizabeth,15,0,30,15
1714205918891,EDS 201,A00,507315,Staff,13,0,30,17
1714205919986,EDS 203,A01,507317,Halter; Christopher P.,12,0,30,18
1714205921012,EDS 204R,A01,507319,Halter; Christopher P.,0,3,30,30
1714205921012,EDS 204R,B01,507331,Heinzman; Erica M.,17,0,30,13
1714205922038,EDS 206R,A00,507332,Staff,0,4,30,30
1714205922038,EDS 206R,B00,507343,Staff,18,0,30,12
1714205923063,EDS 250,A00,507344,Hemans; Patricia Ann Benitez,22,0,40,18
1714205924089,EDS 281,A00,507345,Daly; Alan J.,18,0,18,0
1714205925116,EDS 284,A00,507350,Daly; Alan J.,16,0,16,0
1714205926142,EDS 286,A00,507359,Fine; Sarah,18,0,18,0
1714205927167,EDS 289C,A01,507361,Daly; Alan J.,18,0,18,0
1714205928191,EDS 290,A00,507366,Hofstetter; Carolyn,15,0,15,0
1714205929217,LIGM 5A,A00,507421,Fischer-Grunski; Eva K,18,0,20,2
1714205930243,LIGM 5B,A00,507423,Fischer-Grunski; Eva K,19,0,20,1
1714205931272,LIGM 5C,A00,507425,Fischer-Grunski; Eva K,19,0,20,1
1714205932303,LIIT 5AS,A00,507427,Carnelos; Chiara,20,0,20,0
1714205933332,LIIT 5BS,A00,507430,Carnelos; Chiara,20,0,20,0
1714205934357,LIIT 5CS,A00,507432,Carnelos; Chiara,20,0,20,0
1714205935387,LISP 5A,A00,507541,Munoz Sanchez; Alicia,11,0,20,9
1714205936417,LISP 5B,A00,507671,Munoz Sanchez; Alicia,9,0,20,11
1714205937447,LISP 5C,A00,507696,Munoz Sanchez; Alicia,9,0,20,11
1714205938472,MAE 197,001,528363,Boechler; Nicholas Sebastia,9998,0,9999,1
1714205939501,MATH 197,001,523477,Kedlaya; Kiran S.,9996,0,9999,3
1714205939501,MATH 197,002,563811,Zhang; Danna,9995,0,9999,4
1714205939501,MATH 197,003,628552,Dumitriu; Ioana,9998,0,9999,1
1714205940530,MCWP 40R,A00,518780,Staff,5,0,20,15
1714205940530,MCWP 40R,B00,518781,Staff,7,0,20,13
1714205940530,MCWP 40R,C00,518783,Staff,5,0,20,15
1714205941559,MCWP 50R,A00,518791,Staff,0,0,20,20
1714205941559,MCWP 50R,B00,518792,Staff,0,1,20,20
1714205941559,MCWP 50R,C00,518793,Staff,0,1,20,20
1714205941559,MCWP 50R,D00,518794,Staff,0,0,20,20
1714205941559,MCWP 50R,E00,518795,Staff,0,1,20,20
1714205941559,MCWP 50R,F00,518796,Staff,0,0,20,20
1714205941559,MCWP 50R,G00,518797,Staff,0,1,20,20
1714205942585,MMW 12R,A01,514034,Herbst; Matthew,0,1,16,16
1714205942585,MMW 12R,A02,514035,Herbst; Matthew,2,0,16,14
1714205943613,MMW 13R,A01,514037,Staff,0,4,16,16
1714205943613,MMW 13R,A02,514039,Staff,0,2,16,16
1714205943613,MMW 13R,A03,628519,Staff,0,2,16,16
1714205945661,SIO 295LS,A00,523233,Staff,13,0,30,17
1714205946688,SIO 295S,A00,523232,Staff,13,0,30,17
1714205947719,SIOC 290S,A01,637330,Merrifield; Mark A,28,0,30,2
1714205948749,SIOC 291S,A01,637333,Gabriel; Corey John,28,0,30,2
1714205949774,SOCI 117,A01,494376,Staff,0,2,5,5
1714205950799,WES 237B,A00,494380,Staff,9,0,20,11
1714205952867,AESE 279B,A00,494370,Wade; Jon P,0,0,33,33
1714205953894,AIP 197,001,627712,Vespa; Emanuel Ignacio,9998,0,9999,1
1714205954921,ANAR 135S,A00,494369,Braswell; Geoffrey E.,0,0,0,0
1714205955947,BENG 196,001,628496,Engler; Adam J.,9998,0,9999,1
1714205956972,CAT 124RS,A01,519847,Geibel; William,0,0,20,20
1714205957998,CAT 125RS,A01,515971,Geibel; William,0,0,20,20
1714205959023,CLRE 250,A00,511389,Morris; Sheldon,9993,0,9999,6
1714205960054,CLRE 251,A00,507176,Mehta; Ravindra L.,9993,0,9999,6
1714205960054,CLRE 251,B00,511410,Mehta; Ravindra L.,9998,0,9999,1
1714205961079,CLRE 252,A00,507189,Cuomo; Raphael Eduardo,9995,0,9999,4
1714205962108,CLRE 253,A00,507199,Vaida; Florin,9994,0,9999,5
1714205962108,CLRE 253,B00,507202,Vaida; Florin,9999,0,9999,0
1714205963133,CLRE 259,A00,507211,Patel; Hemal,9996,0,9999,3
1714205964160,CLRE 260,A00,507221,Cuomo; Raphael Eduardo,9999,0,9999,0
1714205965185,CLRE 297,001,507242,Cuomo; Raphael Eduardo,9999,0,9999,0
1714205966210,COGS 197,001,638244,Voytek; Bradley Thomas,9999,0,9999,0
1714205967236,CSE 191,A00,516875,Minnes Kemp; Mor Mia,9993,0,9999,6
1714205968262,CSE 197,001,637388,Minnes Kemp; Mor Mia,9998,0,9999,1
1714205969287,CSS 201S,A01,494383,Staff,35,0,35,0
1714205970317,CSS 202S,A01,494387,Staff,35,0,35,0
1714205971345,DSC 197,001,628532,Eldridge; Justin Matthew,9996,0,9999,3
1714205972373,EAP 100,A00,516065,Staff,9797,0,9999,202
1714205973403,ECE 45,A01,507414,Staff,33,0,60,27
1714205975458,ECE 111,A01,507420,Staff,21,0,50,29
1714205976483,ECE 197,001,548057,Sievenpiper; Daniel F.,9994,0,9999,5
1714205977509,EDS 115,A00,507243,Choi; Bailey Miyeon,12,0,28,16
1714205978534,EDS 117,A01,494379,Staff,0,1,30,30
1714205979558,EDS 125,A00,507246,Hopkins; Megan Beth,12,0,30,18
1714205980583,EDS 128A,A01,507264,Fargason; Sharon Gayle,14,0,26,12
1714205981612,EDS 128B,A01,507293,Pappas; Elizabeth,18,0,30,12
1714205982637,EDS 139,A00,507294,Fargason; Sharon Gayle,18,0,30,12
1714205982637,EDS 139,B00,507313,Pappas; Elizabeth,15,0,30,15
1714205983663,EDS 201,A00,507315,Staff,13,0,30,17
1714205984692,EDS 203,A01,507317,Halter; Christopher P.,12,0,30,18
1714205985718,EDS 204R,A01,507319,Halter; Christopher P.,0,3,30,30
1714205985718,EDS 204R,B01,507331,Heinzman; Erica M.,17,0,30,13
1714205986747,EDS 206R,A00,507332,Staff,0,4,30,30
1714205986747,EDS 206R,B00,507343,Staff,18,0,30,12
1714205987775,EDS 250,A00,507344,Hemans; Patricia Ann Benitez,22,0,40,18
1714205988802,EDS 281,A00,507345,Daly; Alan J.,18,0,18,0
1714205989827,EDS 284,A00,507350,Daly; Alan J.,16,0,16,0
1714205990852,EDS 286,A00,507359,Fine; Sarah,18,0,18,0
1714205991877,EDS 289C,A01,507361,Daly; Alan J.,18,0,18,0
1714205992905,EDS 290,A00,507366,Hofstetter; Carolyn,15,0,15,0
1714205993931,LIGM 5A,A00,507421,Fischer-Grunski; Eva K,18,0,20,2
1714205994957,LIGM 5B,A00,507423,Fischer-Grunski; Eva K,19,0,20,1
1714205995986,LIGM 5C,A00,507425,Fischer-Grunski; Eva K,19,0,20,1
1714205997010,LIIT 5AS,A00,507427,Carnelos; Chiara,20,0,20,0
1714205998037,LIIT 5BS,A00,507430,Carnelos; Chiara,20,0,20,0
1714205999063,LIIT 5CS,A00,507432,Carnelos; Chiara,20,0,20,0
1714206000088,LISP 5A,A00,507541,Munoz Sanchez; Alicia,11,0,20,9
1714206001114,LISP 5B,A00,507671,Munoz Sanchez; Alicia,9,0,20,11
1714206002140,LISP 5C,A00,507696,Munoz Sanchez; Alicia,9,0,20,11
1714206003165,MAE 197,001,528363,Boechler; Nicholas Sebastia,9998,0,9999,1
1714206004191,MATH 197,001,523477,Kedlaya; Kiran S.,9996,0,9999,3
1714206004191,MATH 197,002,563811,Zhang; Danna,9995,0,9999,4
1714206004191,MATH 197,003,628552,Dumitriu; Ioana,9998,0,9999,1
1714206005222,MCWP 40R,A00,518780,Staff,5,0,20,15
1714206005222,MCWP 40R,B00,518781,Staff,7,0,20,13
1714206005222,MCWP 40R,C00,518783,Staff,5,0,20,15
1714206006248,MCWP 50R,A00,518791,Staff,0,0,20,20
1714206006248,MCWP 50R,B00,518792,Staff,0,1,20,20
1714206006248,MCWP 50R,C00,518793,Staff,0,1,20,20
1714206006248,MCWP 50R,D00,518794,Staff,0,0,20,20
1714206006248,MCWP 50R,E00,518795,Staff,0,1,20,20
1714206006248,MCWP 50R,F00,518796,Staff,0,0,20,20
1714206006248,MCWP 50R,G00,518797,Staff,0,1,20,20
1714206007278,MMW 12R,A01,514034,Herbst; Matthew,0,1,16,16
1714206007278,MMW 12R,A02,514035,Herbst; Matthew,2,0,16,14
1714206008305,MMW 13R,A01,514037,Staff,0,4,16,16
1714206008305,MMW 13R,A02,514039,Staff,0,2,16,16
1714206008305,MMW 13R,A03,628519,Staff,0,2,16,16
1714206010355,SIO 295LS,A00,523233,Staff,13,0,30,17
1714206011380,SIO 295S,A00,523232,Staff,13,0,30,17
1714206012410,SIOC 290S,A01,637330,Merrifield; Mark A,28,0,30,2
1714206013438,SIOC 291S,A01,637333,Gabriel; Corey John,28,0,30,2
1714206014468,SOCI 117,A01,494376,Staff,0,2,5,5
1714206015495,WES 237B,A00,494380,Staff,9,0,20,11
1714206017568,AESE 279B,A00,494370,Wade; Jon P,0,0,33,33
1714206018596,AIP 197,001,627712,Vespa; Emanuel Ignacio,9998,0,9999,1
1714206019622,ANAR 135S,A00,494369,Braswell; Geoffrey E.,0,0,0,0
1714206020647,BENG 196,001,628496,Engler; Adam J.,9998,0,9999,1
1714206021672,CAT 124RS,A01,519847,Geibel; William,0,0,20,20
1714206022700,CAT 125RS,A01,515971,Geibel; William,0,0,20,20
1714206023777,CLRE 250,A00,511389,Morris; Sheldon,9993,0,9999,6
1714206024805,CLRE 251,A00,507176,Mehta; Ravindra L.,9993,0,9999,6
1714206024805,CLRE 251,B00,511410,Mehta; Ravindra L.,9998,0,9999,1
1714206025834,CLRE 252,A00,507189,Cuomo; Raphael Eduardo,9995,0,9999,4
1714206026860,CLRE 253,A00,507199,Vaida; Florin,9994,0,9999,5
1714206026860,CLRE 253,B00,507202,Vaida; Florin,9999,0,9999,0
1714206027884,CLRE 259,A00,507211,Patel; Hemal,9996,0,9999,3
1714206028913,CLRE 260,A00,507221,Cuomo; Raphael Eduardo,9999,0,9999,0
1714206029939,CLRE 297,001,507242,Cuomo; Raphael Eduardo,9999,0,9999,0
1714206030965,COGS 197,001,638244,Voytek; Bradley Thomas,9999,0,9999,0
1714206031990,CSE 191,A00,516875,Minnes Kemp; Mor Mia,9993,0,9999,6
1714206033014,CSE 197,001,637388,Minnes Kemp; Mor Mia,9998,0,9999,1
1714206034040,CSS 201S,A01,494383,Staff,35,0,35,0
1714206035068,CSS 202S,A01,494387,Staff,35,0,35,0
1714206036094,DSC 197,001,628532,Eldridge; Justin Matthew,9996,0,9999,3
1714206037119,EAP 100,A00,516065,Staff,9797,0,9999,202
1714206038147,ECE 45,A01,507414,Staff,33,0,60,27
1714206040203,ECE 111,A01,507420,Staff,21,0,50,29
1714206041228,ECE 197,001,548057,Sievenpiper; Daniel F.,9994,0,9999,5
1714206042254,EDS 115,A00,507243,Choi; Bailey Miyeon,12,0,28,16
1714206043297,EDS 117,A01,494379,Staff,0,1,30,30
1714206044322,EDS 125,A00,507246,Hopkins; Megan Beth,12,0,30,18
1714206045349,EDS 128A,A01,507264,Fargason; Sharon Gayle,14,0,26,12
1714206046375,EDS 128B,A01,507293,Pappas; Elizabeth,18,0,30,12
1714206047403,EDS 139,A00,507294,Fargason; Sharon Gayle,18,0,30,12
1714206047403,EDS 139,B00,507313,Pappas; Elizabeth,15,0,30,15
1714206048431,EDS 201,A00,507315,Staff,13,0,30,17
1714206049456,EDS 203,A01,507317,Halter; Christopher P.,12,0,30,18
1714206050483,EDS 204R,A01,507319,Halter; Christopher P.,0,3,30,30
1714206050483,EDS 204R,B01,507331,Heinzman; Erica M.,17,0,30,13
1714206051509,EDS 206R,A00,507332,Staff,0,4,30,30
1714206051509,EDS 206R,B00,507343,Staff,18,0,30,12
1714206052534,EDS 250,A00,507344,Hemans; Patricia Ann Benitez,22,0,40,18
1714206053564,EDS 281,A00,507345,Daly; Alan J.,18,0,18,0
1714206054595,EDS 284,A00,507350,Daly; Alan J.,16,0,16,0
1714206055620,EDS 286,A00,507359,Fine; Sarah,18,0,18,0
1714206056646,EDS 289C,A01,507361,Daly; Alan J.,18,0,18,0
1714206057672,EDS 290,A00,507366,Hofstetter; Carolyn,15,0,15,0
1714206058698,LIGM 5A,A00,507421,Fischer-Grunski; Eva K,18,0,20,2
1714206059727,LIGM 5B,A00,507423,Fischer-Grunski; Eva K,19,0,20,1
1714206060759,LIGM 5C,A00,507425,Fischer-Grunski; Eva K,19,0,20,1
1714206061786,LIIT 5AS,A00,507427,Carnelos; Chiara,20,0,20,0
1714206062816,LIIT 5BS,A00,507430,Carnelos; Chiara,20,0,20,0
1714206063842,LIIT 5CS,A00,507432,Carnelos; Chiara,20,0,20,0
1714206064867,LISP 5A,A00,507541,Munoz Sanchez; Alicia,11,0,20,9
1714206065892,LISP 5B,A00,507671,Munoz Sanchez; Alicia,9,0,20,11
1714206066918,LISP 5C,A00,507696,Munoz Sanchez; Alicia,9,0,20,11
1714206067942,MAE 197,001,528363,Boechler; Nicholas Sebastia,9998,0,9999,1
1714206068968,MATH 197,001,523477,Kedlaya; Kiran S.,9996,0,9999,3
1714206068968,MATH 197,002,563811,Zhang; Danna,9995,0,9999,4
1714206068968,MATH 197,003,628552,Dumitriu; Ioana,9998,0,9999,1
1714206069992,MCWP 40R,A00,518780,Staff,5,0,20,15
1714206069992,MCWP 40R,B00,518781,Staff,7,0,20,13
1714206069992,MCWP 40R,C00,518783,Staff,5,0,20,15
1714206071017,MCWP 50R,A00,518791,Staff,0,0,20,20
1714206071017,MCWP 50R,B00,518792,Staff,0,1,20,20
1714206071017,MCWP 50R,C00,518793,Staff,0,1,20,20
1714206071017,MCWP 50R,D00,518794,Staff,0,0,20,20
1714206071017,MCWP 50R,E00,518795,Staff,0,1,20,20
1714206071017,MCWP 50R,F00,518796,Staff,0,0,20,20
1714206071017,MCWP 50R,G00,518797,Staff,0,1,20,20
1714206072042,MMW 12R,A01,514034,Herbst; Matthew,0,1,16,16
1714206072042,MMW 12R,A02,514035,Herbst; Matthew,2,0,16,14
1714206073067,MMW 13R,A01,514037,Staff,0,4,16,16
1714206073067,MMW 13R,A02,514039,Staff,0,2,16,16
1714206073067,MMW 13R,A03,628519,Staff,0,2,16,16
1714206075118,SIO 295LS,A00,523233,Staff,13,0,30,17
1714206076144,SIO 295S,A00,523232,Staff,13,0,30,17
1714206077168,SIOC 290S,A01,637330,Merrifield; Mark A,28,0,30,2
1714206078195,SIOC 291S,A01,637333,Gabriel; Corey John,28,0,30,2
1714206079224,SOCI 117,A01,494376,Staff,0,2,5,5
1714206080254,WES 237B,A00,494380,Staff,9,0,20,11
1714206082329,AESE 279B,A00,494370,Wade; Jon P,0,0,33,33
1714206083356,AIP 197,001,627712,Vespa; Emanuel Ignacio,9998,0,9999,1
1714206084381,ANAR 135S,A00,494369,Braswell; Geoffrey E.,0,0,0,0
1714206085408,BENG 196,001,628496,Engler; Adam J.,9998,0,9999,1
1714206086437,CAT 124RS,A01,519847,Geibel; William,0,0,20,20
1714206087462,CAT 125RS,A01,515971,Geibel; William,0,0,20,20
1714206088490,CLRE 250,A00,511389,Morris; Sheldon,9993,0,9999,6
1714206089520,CLRE 251,A00,507176,Mehta; Ravindra L.,9993,0,9999,6
1714206089520,CLRE 251,B00,511410,Mehta; Ravindra L.,9998,0,9999,1
1714206090546,CLRE 252,A00,507189,Cuomo; Raphael Eduardo,9995,0,9999,4
1714206091573,CLRE 253,A00,507199,Vaida; Florin,9994,0,9999,5
1714206091573,CLRE 253,B00,507202,Vaida; Florin,9999,0,9999,0
1714206092598,CLRE 259,A00,507211,Patel; Hemal,9996,0,9999,3
1714206093625,CLRE 260,A00,507221,Cuomo; Raphael Eduardo,9999,0,9999,0
1714206094649,CLRE 297,001,507242,Cuomo; Raphael Eduardo,9999,0,9999,0
1714206095674,COGS 197,001,638244,Voytek; Bradley Thomas,9999,0,9999,0
1714206096698,CSE 191,A00,516875,Minnes Kemp; Mor Mia,9993,0,9999,6
1714206097726,CSE 197,001,637388,Minnes Kemp; Mor Mia,9998,0,9999,1
1714206098751,CSS 201S,A01,494383,Staff,35,0,35,0
1714206099776,CSS 202S,A01,494387,Staff,35,0,35,0
1714206100803,DSC 197,001,628532,Eldridge; Justin Matthew,9996,0,9999,3
1714206101830,EAP 100,A00,516065,Staff,9797,0,9999,202
1714206102857,ECE 45,A01,507414,Staff,33,0,60,27
1714206104907,ECE 111,A01,507420,Staff,21,0,50,29
1714206105932,ECE 197,001,548057,Sievenpiper; Daniel F.,9994,0,9999,5
1714206106957,EDS 115,A00,507243,Choi; Bailey Miyeon,12,0,28,16
1714206107982,EDS 117,A01,494379,Staff,0,1,30,30
1714206109011,EDS 125,A00,507246,Hopkins; Megan Beth,12,0,30,18
1714206110036,EDS 128A,A01,507264,Fargason; Sharon Gayle,14,0,26,12
1714206111062,EDS 128B,A01,507293,Pappas; Elizabeth,18,0,30,12
1714206112088,EDS 139,A00,507294,Fargason; Sharon Gayle,18,0,30,12
1714206112088,EDS 139,B00,507313,Pappas; Elizabeth,15,0,30,15
1714206113113,EDS 201,A00,507315,Staff,13,0,30,17
1714206114140,EDS 203,A01,507317,Halter; Christopher P.,12,0,30,18
1714206115168,EDS 204R,A01,507319,Halter; Christopher P.,0,3,30,30
1714206115168,EDS 204R,B01,507331,Heinzman; Erica M.,17,0,30,13
1714206116196,EDS 206R,A00,507332,Staff,0,4,30,30
1714206116196,EDS 206R,B00,507343,Staff,18,0,30,12
1714206117226,EDS 250,A00,507344,Hemans; Patricia Ann Benitez,22,0,40,18
1714206118252,EDS 281,A00,507345,Daly; Alan J.,18,0,18,0
1714206119279,EDS 284,A00,507350,Daly; Alan J.,16,0,16,0
1714206120309,EDS 286,A00,507359,Fine; Sarah,18,0,18,0
1714206121335,EDS 289C,A01,507361,Daly; Alan J.,18,0,18,0
1714206122364,EDS 290,A00,507366,Hofstetter; Carolyn,15,0,15,0
1714206123390,LIGM 5A,A00,507421,Fischer-Grunski; Eva K,18,0,20,2
1714206124416,LIGM 5B,A00,507423,Fischer-Grunski; Eva K,19,0,20,1
1714206125446,LIGM 5C,A00,507425,Fischer-Grunski; Eva K,19,0,20,1
1714206126471,LIIT 5AS,A00,507427,Carnelos; Chiara,20,0,20,0
1714206127553,LIIT 5BS,A00,507430,Carnelos; Chiara,20,0,20,0
1714206128582,LIIT 5CS,A00,507432,Carnelos; Chiara,20,0,20,0
1714206129608,LISP 5A,A00,507541,Munoz Sanchez; Alicia,11,0,20,9
1714206130635,LISP 5B,A00,507671,Munoz Sanchez; Alicia,9,0,20,11
1714206131663,LISP 5C,A00,507696,Munoz Sanchez; Alicia,9,0,20,11
1714206132689,MAE 197,001,528363,Boechler; Nicholas Sebastia,9998,0,9999,1
1714206133716,MATH 197,001,523477,Kedlaya; Kiran S.,9996,0,9999,3
1714206133716,MATH 197,002,563811,Zhang; Danna,9995,0,9999,4
1714206133716,MATH 197,003,628552,Dumitriu; Ioana,9998,0,9999,1
1714206134742,MCWP 40R,A00,518780,Staff,5,0,20,15
1714206134742,MCWP 40R,B00,518781,Staff,7,0,20,13
1714206134742,MCWP 40R,C00,518783,Staff,5,0,20,15
1714206135769,MCWP 50R,A00,518791,Staff,0,0,20,20
1714206135769,MCWP 50R,B00,518792,Staff,0,1,20,20
1714206135769,MCWP 50R,C00,518793,Staff,0,1,20,20
1714206135769,MCWP 50R,D00,518794,Staff,0,0,20,20
1714206135769,MCWP 50R,E00,518795,Staff,0,1,20,20
1714206135769,MCWP 50R,F00,518796,Staff,0,0,20,20
1714206135769,MCWP 50R,G00,518797,Staff,0,1,20,20
1714206136794,MMW 12R,A01,514034,Herbst; Matthew,0,1,16,16
1714206136794,MMW 12R,A02,514035,Herbst; Matthew,2,0,16,14
1714206137820,MMW 13R,A01,514037,Staff,0,4,16,16
1714206137820,MMW 13R,A02,514039,Staff,0,2,16,16
1714206137820,MMW 13R,A03,628519,Staff,0,2,16,16
1714206139874,SIO 295LS,A00,523233,Staff,13,0,30,17
1714206140901,SIO 295S,A00,523232,Staff,13,0,30,17
1714206141928,SIOC 290S,A01,637330,Merrifield; Mark A,28,0,30,2
1714206142959,SIOC 291S,A01,637333,Gabriel; Corey John,28,0,30,2
1714206143983,SOCI 117,A01,494376,Staff,0,2,5,5
1714206145010,WES 237B,A00,494380,Staff,9,0,20,11
1714206147072,AESE 279B,A00,494370,Wade; Jon P,0,0,33,33
1714206148099,AIP 197,001,627712,Vespa; Emanuel Ignacio,9998,0,9999,1
1714206149128,ANAR 135S,A00,494369,Braswell; Geoffrey E.,0,0,0,0
1714206150154,BENG 196,001,628496,Engler; Adam J.,9998,0,9999,1
1714206151184,CAT 124RS,A01,519847,Geibel; William,0,0,20,20
1714206152210,CAT 125RS,A01,515971,Geibel; William,0,0,20,20
1714206153238,CLRE 250,A00,511389,Morris; Sheldon,9993,0,9999,6
1714206154271,CLRE 251,A00,507176,Mehta; Ravindra L.,9993,0,9999,6
1714206154271,CLRE 251,B00,511410,Mehta; Ravindra L.,9998,0,9999,1
1714206155297,CLRE 252,A00,507189,Cuomo; Raphael Eduardo,9995,0,9999,4
1714206156322,CLRE 253,A00,507199,Vaida; Florin,9994,0,9999,5
1714206156322,CLRE 253,B00,507202,Vaida; Florin,9999,0,9999,0
1714206157349,CLRE 259,A00,507211,Patel; Hemal,9996,0,9999,3
1714206158378,CLRE 260,A00,507221,Cuomo; Raphael Eduardo,9999,0,9999,0
1714206159404,CLRE 297,001,507242,Cuomo; Raphael Eduardo,9999,0,9999,0
1714206160429,COGS 197,001,638244,Voytek; Bradley Thomas,9999,0,9999,0
1714206161455,CSE 191,A00,516875,Minnes Kemp; Mor Mia,9993,0,9999,6
1714206162484,CSE 197,001,637388,Minnes Kemp; Mor Mia,9998,0,9999,1
1714206163509,CSS 201S,A01,494383,Staff,35,0,35,0
1714206164535,CSS 202S,A01,494387,Staff,35,0,35,0
1714206165562,DSC 197,001,628532,Eldridge; Justin Matthew,9996,0,9999,3
1714206166591,EAP 100,A00,516065,Staff,9797,0,9999,202
1714206167619,ECE 45,A01,507414,Staff,33,0,60,27
1714206169674,ECE 111,A01,507420,Staff,21,0,50,29
1714206170699,ECE 197,001,548057,Sievenpiper; Daniel F.,9994,0,9999,5
1714206171725,EDS 115,A00,507243,Choi; Bailey Miyeon,12,0,28,16
1714206172751,EDS 117,A01,494379,Staff,0,1,30,30
1714206173777,EDS 125,A00,507246,Hopkins; Megan Beth,12,0,30,18
1714206174804,EDS 128A,A01,507264,Fargason; Sharon Gayle,14,0,26,12
1714206175829,EDS 128B,A01,507293,Pappas; Elizabeth,18,0,30,12
1714206176856,EDS 139,A00,507294,Fargason; Sharon Gayle,18,0,30,12
1714206176856,EDS 139,B00,507313,Pappas; Elizabeth,15,0,30,15
1714206177881,EDS 201,A00,507315,Staff,13,0,30,17
1714206178906,EDS 203,A01,507317,Halter; Christopher P.,12,0,30,18
1714206179933,EDS 204R,A01,507319,Halter; Christopher P.,0,3,30,30
1714206179933,EDS 204R,B01,507331,Heinzman; Erica M.,17,0,30,13
1714206180962,EDS 206R,A00,507332,Staff,0,4,30,30
1714206180962,EDS 206R,B00,507343,Staff,18,0,30,12
1714206181988,EDS 250,A00,507344,Hemans; Patricia Ann Benitez,22,0,40,18
1714206183012,EDS 281,A00,507345,Daly; Alan J.,18,0,18,0
1714206184037,EDS 284,A00,507350,Daly; Alan J.,16,0,16,0
1714206185064,EDS 286,A00,507359,Fine; Sarah,18,0,18,0
1714206186089,EDS 289C,A01,507361,Daly; Alan J.,18,0,18,0
1714206187116,EDS 290,A00,507366,Hofstetter; Carolyn,15,0,15,0
1714206188141,LIGM 5A,A00,507421,Fischer-Grunski; Eva K,18,0,20,2
1714206189168,LIGM 5B,A00,507423,Fischer-Grunski; Eva K,19,0,20,1
1714206190193,LIGM 5C,A00,507425,Fischer-Grunski; Eva K,19,0,20,1
1714206191221,LIIT 5AS,A00,507427,Carnelos; Chiara,20,0,20,0
1714206192247,LIIT 5BS,A00,507430,Carnelos; Chiara,20,0,20,0
1714206193277,LIIT 5CS,A00,507432,Carnelos; Chiara,20,0,20,0
1714206194303,LISP 5A,A00,507541,Munoz Sanchez; Alicia,11,0,20,9
1714206195328,LISP 5B,A00,507671,Munoz Sanchez; Alicia,9,0,20,11
1714206196354,LISP 5C,A00,507696,Munoz Sanchez; Alicia,9,0,20,11
1714206197380,MAE 197,001,528363,Boechler; Nicholas Sebastia,9998,0,9999,1
1714206198411,MATH 197,001,523477,Kedlaya; Kiran S.,9996,0,9999,3
1714206198411,MATH 197,002,563811,Zhang; Danna,9995,0,9999,4
1714206198411,MATH 197,003,628552,Dumitriu; Ioana,9998,0,9999,1
1714206199437,MCWP 40R,A00,518780,Staff,5,0,20,15
1714206199437,MCWP 40R,B00,518781,Staff,7,0,20,13
1714206199437,MCWP 40R,C00,518783,Staff,5,0,20,15
1714206200463,MCWP 50R,A00,518791,Staff,0,0,20,20
1714206200463,MCWP 50R,B00,518792,Staff,0,1,20,20
1714206200463,MCWP 50R,C00,518793,Staff,0,1,20,20
1714206200463,MCWP 50R,D00,518794,Staff,0,0,20,20
1714206200463,MCWP 50R,E00,518795,Staff,0,1,20,20
1714206200463,MCWP 50R,F00,518796,Staff,0,0,20,20
1714206200463,MCWP 50R,G00,518797,Staff,0,1,20,20
1714206201488,MMW 12R,A01,514034,Herbst; Matthew,0,1,16,16
1714206201488,MMW 12R,A02,514035,Herbst; Matthew,2,0,16,14
1714206202513,MMW 13R,A01,514037,Staff,0,4,16,16
1714206202513,MMW 13R,A02,514039,Staff,0,2,16,16
1714206202513,MMW 13R,A03,628519,Staff,0,2,16,16
1714206204579,SIO 295LS,A00,523233,Staff,13,0,30,17
1714206205607,SIO 295S,A00,523232,Staff,13,0,30,17
1714206206632,SIOC 290S,A01,637330,Merrifield; Mark A,28,0,30,2
1714206207661,SIOC 291S,A01,637333,Gabriel; Corey John,28,0,30,2
1714206208690,SOCI 117,A01,494376,Staff,0,2,5,5
1714206209716,WES 237B,A00,494380,Staff,9,0,20,11
1714206211779,AESE 279B,A00,494370,Wade; Jon P,0,0,33,33
1714206212805,AIP 197,001,627712,Vespa; Emanuel Ignacio,9998,0,9999,1
1714206213832,ANAR 135S,A00,494369,Braswell; Geoffrey E.,0,0,0,0
1714206214860,BENG 196,001,628496,Engler; Adam J.,9998,0,9999,1
1714206215885,CAT 124RS,A01,519847,Geibel; William,0,0,20,20
1714206216913,CAT 125RS,A01,515971,Geibel; William,0,0,20,20
1714206217942,CLRE 250,A00,511389,Morris; Sheldon,9993,0,9999,6
1714206218969,CLRE 251,A00,507176,Mehta; Ravindra L.,9993,0,9999,6
1714206218969,CLRE 251,B00,511410,Mehta; Ravindra L.,9998,0,9999,1
1714206219994,CLRE 252,A00,507189,Cuomo; Raphael Eduardo,9995,0,9999,4
1714206221020,CLRE 253,A00,507199,Vaida; Florin,9994,0,9999,5
1714206221020,CLRE 253,B00,507202,Vaida; Florin,9999,0,9999,0
1714206222044,CLRE 259,A00,507211,Patel; Hemal,9996,0,9999,3
1714206223069,CLRE 260,A00,507221,Cuomo; Raphael Eduardo,9999,0,9999,0
1714206224095,CLRE 297,001,507242,Cuomo; Raphael Eduardo,9999,0,9999,0
1714206225121,COGS 197,001,638244,Voytek; Bradley Thomas,9999,0,9999,0
1714206226146,CSE 191,A00,516875,Minnes Kemp; Mor Mia,9993,0,9999,6
1714206227176,CSE 197,001,637388,Minnes Kemp; Mor Mia,9998,0,9999,1
1714206228206,CSS 201S,A01,494383,Staff,35,0,35,0
1714206229236,CSS 202S,A01,494387,Staff,35,0,35,0
1714206230262,DSC 197,001,628532,Eldridge; Justin Matthew,9996,0,9999,3
1714206231341,EAP 100,A00,516065,Staff,9797,0,9999,202
1714206232368,ECE 45,A01,507414,Staff,33,0,60,27
1714206234418,ECE 111,A01,507420,Staff,21,0,50,29
1714206235448,ECE 197,001,548057,Sievenpiper; Daniel F.,9994,0,9999,5
1714206236474,EDS 115,A00,507243,Choi; Bailey Miyeon,12,0,28,16
1714206237498,EDS 117,A01,494379,Staff,0,1,30,30
1714206238523,EDS 125,A00,507246,Hopkins; Megan Beth,12,0,30,18
1714206239551,EDS 128A,A01,507264,Fargason; Sharon Gayle,14,0,26,12
1714206240577,EDS 128B,A01,507293,Pappas; Elizabeth,18,0,30,12
1714206241606,EDS 139,A00,507294,Fargason; Sharon Gayle,18,0,30,12
1714206241606,EDS 139,B00,507313,Pappas; Elizabeth,15,0,30,15
1714206242632,EDS 201,A00,507315,Staff,13,0,30,17
1714206243657,EDS 203,A01,507317,Halter; Christopher P.,12,0,30,18
1714206244683,EDS 204R,A01,507319,Halter; Christopher P.,0,3,30,30
1714206244683,EDS 204R,B01,507331,Heinzman; Erica M.,17,0,30,13
1714206245707,EDS 206R,A00,507332,Staff,0,4,30,30
1714206245707,EDS 206R,B00,507343,Staff,18,0,30,12
1714206246735,EDS 250,A00,507344,Hemans; Patricia Ann Benitez,22,0,40,18
1714206247761,EDS 281,A00,507345,Daly; Alan J.,18,0,18,0
1714206248787,EDS 284,A00,507350,Daly; Alan J.,16,0,16,0
1714206249816,EDS 286,A00,507359,Fine; Sarah,18,0,18,0
1714206250842,EDS 289C,A01,507361,Daly; Alan J.,18,0,18,0
1714206251868,EDS 290,A00,507366,Hofstetter; Carolyn,15,0,15,0
1714206252894,LIGM 5A,A00,507421,Fischer-Grunski; Eva K,18,0,20,2
1714206253924,LIGM 5B,A00,507423,Fischer-Grunski; Eva K,19,0,20,1
1714206254953,LIGM 5C,A00,507425,Fischer-Grunski; Eva K,19,0,20,1
1714206255981,LIIT 5AS,A00,507427,Carnelos; Chiara,20,0,20,0
1714206257009,LIIT 5BS,A00,507430,Carnelos; Chiara,20,0,20,0
1714206258034,LIIT 5CS,A00,507432,Carnelos; Chiara,20,0,20,0
1714206259064,LISP 5A,A00,507541,Munoz Sanchez; Alicia,11,0,20,9
1714206260090,LISP 5B,A00,507671,Munoz Sanchez; Alicia,9,0,20,11
1714206261120,LISP 5C,A00,507696,Munoz Sanchez; Alicia,9,0,20,11
1714206262144,MAE 197,001,528363,Boechler; Nicholas Sebastia,9998,0,9999,1
1714206263173,MATH 197,001,523477,Kedlaya; Kiran S.,9996,0,9999,3
1714206263173,MATH 197,002,563811,Zhang; Danna,9995,0,9999,4
1714206263173,MATH 197,003,628552,Dumitriu; Ioana,9998,0,9999,1
1714206264201,MCWP 40R,A00,518780,Staff,5,0,20,15
1714206264201,MCWP 40R,B00,518781,Staff,7,0,20,13
1714206264201,MCWP 40R,C00,518783,Staff,5,0,20,15
1714206265229,MCWP 50R,A00,518791,Staff,0,0,20,20
1714206265229,MCWP 50R,B00,518792,Staff,0,1,20,20
1714206265229,MCWP 50R,C00,518793,Staff,0,1,20,20
1714206265229,MCWP 50R,D00,518794,Staff,0,0,20,20
1714206265229,MCWP 50R,E00,518795,Staff,0,1,20,20
1714206265229,MCWP 50R,F00,518796,Staff,0,0,20,20
1714206265229,MCWP 50R,G00,518797,Staff,0,1,20,20
1714206266255,MMW 12R,A01,514034,Herbst; Matthew,0,1,16,16
1714206266255,MMW 12R,A02,514035,Herbst; Matthew,2,0,16,14
1714206267281,MMW 13R,A01,514037,Staff,0,4,16,16
1714206267281,MMW 13R,A02,514039,Staff,0,2,16,16
1714206267281,MMW 13R,A03,628519,Staff,0,2,16,16
1714206269339,SIO 295LS,A00,523233,Staff,13,0,30,17
1714206270368,SIO 295S,A00,523232,Staff,13,0,30,17
1714206271391,SIOC 290S,A01,637330,Merrifield; Mark A,28,0,30,2
1714206272421,SIOC 291S,A01,637333,Gabriel; Corey John,28,0,30,2
1714206273447,SOCI 117,A01,494376,Staff,0,2,5,5
1714206274476,WES 237B,A00,494380,Staff,9,0,20,11
1714206276562,AESE 279B,A00,494370,Wade; Jon P,0,0,33,33
1714206277591,AIP 197,001,627712,Vespa; Emanuel Ignacio,9998,0,9999,1
1714206278616,ANAR 135S,A00,494369,Braswell; Geoffrey E.,0,0,0,0
1714206279642,BENG 196,001,628496,Engler; Adam J.,9998,0,9999,1
1714206280670,CAT 124RS,A01,519847,Geibel; William,0,0,20,20
1714206281696,CAT 125RS,A01,515971,Geibel; William,0,0,20,20
1714206282725,CLRE 250,A00,511389,Morris; Sheldon,9993,0,9999,6
1714206283754,CLRE 251,A00,507176,Mehta; Ravindra L.,9993,0,9999,6
1714206283754,CLRE 251,B00,511410,Mehta; Ravindra L.,9998,0,9999,1
1714206284782,CLRE 252,A00,507189,Cuomo; Raphael Eduardo,9995,0,9999,4
1714206285808,CLRE 253,A00,507199,Vaida; Florin,9994,0,9999,5
1714206285808,CLRE 253,B00,507202,Vaida; Florin,9999,0,9999,0
1714206286837,CLRE 259,A00,507211,Patel; Hemal,9996,0,9999,3
1714206287866,CLRE 260,A00,507221,Cuomo; Raphael Eduardo,9999,0,9999,0
1714206288894,CLRE 297,001,507242,Cuomo; Raphael Eduardo,9999,0,9999,0
1714206289920,COGS 197,001,638244,Voytek; Bradley Thomas,9999,0,9999,0
1714206290949,CSE 191,A00,516875,Minnes Kemp; Mor Mia,9993,0,9999,6
1714206291976,CSE 197,001,637388,Minnes Kemp; Mor Mia,9998,0,9999,1
1714206293002,CSS 201S,A01,494383,Staff,35,0,35,0
1714206294032,CSS 202S,A01,494387,Staff,35,0,35,0
1714206295063,DSC 197,001,628532,Eldridge; Justin Matthew,9996,0,9999,3
1714206296089,EAP 100,A00,516065,Staff,9797,0,9999,202
1714206297114,ECE 45,A01,507414,Staff,33,0,60,27
1714206299163,ECE 111,A01,507420,Staff,21,0,50,29
1714206300189,ECE 197,001,548057,Sievenpiper; Daniel F.,9994,0,9999,5
1714206301216,EDS 115,A00,507243,Choi; Bailey Miyeon,12,0,28,16
1714206302242,EDS 117,A01,494379,Staff,0,1,30,30
1714206303269,EDS 125,A00,507246,Hopkins; Megan Beth,12,0,30,18
1714206304295,EDS 128A,A01,507264,Fargason; Sharon Gayle,14,0,26,12
1714206305321,EDS 128B,A01,507293,Pappas; Elizabeth,18,0,30,12
1714206306350,EDS 139,A00,507294,Fargason; Sharon Gayle,18,0,30,12
1714206306350,EDS 139,B00,507313,Pappas; Elizabeth,15,0,30,15
1714206307378,EDS 201,A00,507315,Staff,13,0,30,17
1714206308409,EDS 203,A01,507317,Halter; Christopher P.,12,0,30,18
1714206309435,EDS 204R,A01,507319,Halter; Christopher P.,0,3,30,30
1714206309435,EDS 204R,B01,507331,Heinzman; Erica M.,17,0,30,13
1714206310460,EDS 206R,A00,507332,Staff,0,4,30,30
1714206310460,EDS 206R,B00,507343,Staff,18,0,30,12
1714206311484,EDS 250,A00,507344,Hemans; Patricia Ann Benitez,22,0,40,18
1714206312514,EDS 281,A00,507345,Daly; Alan J.,18,0,18,0
1714206313542,EDS 284,A00,507350,Daly; Alan J.,16,0,16,0
1714206314566,EDS 286,A00,507359,Fine; Sarah,18,0,18,0
1714206315591,EDS 289C,A01,507361,Daly; Alan J.,18,0,18,0
1714206316616,EDS 290,A00,507366,Hofstetter; Carolyn,15,0,15,0
1714206317642,LIGM 5A,A00,507421,Fischer-Grunski; Eva K,18,0,20,2
1714206318668,LIGM 5B,A00,507423,Fischer-Grunski; Eva K,19,0,20,1
1714206319695,LIGM 5C,A00,507425,Fischer-Grunski; Eva K,19,0,20,1
1714206320722,LIIT 5AS,A00,507427,Carnelos; Chiara,20,0,20,0
1714206321748,LIIT 5BS,A00,507430,Carnelos; Chiara,20,0,20,0
1714206322778,LIIT 5CS,A00,507432,Carnelos; Chiara,20,0,20,0
1714206323806,LISP 5A,A00,507541,Munoz Sanchez; Alicia,11,0,20,9
1714206324833,LISP 5B,A00,507671,Munoz Sanchez; Alicia,9,0,20,11
1714206325857,LISP 5C,A00,507696,Munoz Sanchez; Alicia,9,0,20,11
1714206326884,MAE 197,001,528363,Boechler; Nicholas Sebastia,9998,0,9999,1
1714206327913,MATH 197,001,523477,Kedlaya; Kiran S.,9996,0,9999,3
1714206327913,MATH 197,002,563811,Zhang; Danna,9995,0,9999,4
1714206327913,MATH 197,003,628552,Dumitriu; Ioana,9998,0,9999,1
1714206328944,MCWP 40R,A00,518780,Staff,5,0,20,15
1714206328944,MCWP 40R,B00,518781,Staff,7,0,20,13
1714206328944,MCWP 40R,C00,518783,Staff,5,0,20,15
1714206329968,MCWP 50R,A00,518791,Staff,0,0,20,20
1714206329968,MCWP 50R,B00,518792,Staff,0,1,20,20
1714206329968,MCWP 50R,C00,518793,Staff,0,1,20,20
1714206329968,MCWP 50R,D00,518794,Staff,0,0,20,20
1714206329968,MCWP 50R,E00,518795,Staff,0,1,20,20
1714206329968,MCWP 50R,F00,518796,Staff,0,0,20,20
1714206329968,MCWP 50R,G00,518797,Staff,0,1,20,20
1714206330992,MMW 12R,A01,514034,Herbst; Matthew,0,1,16,16
1714206330992,MMW 12R,A02,514035,Herbst; Matthew,2,0,16,14
1714206332019,MMW 13R,A01,514037,Staff,0,4,16,16
1714206332019,MMW 13R,A02,514039,Staff,0,2,16,16
1714206332019,MMW 13R,A03,628519,Staff,0,2,16,16
1714206334072,SIO 295LS,A00,523233,Staff,13,0,30,17
1714206335150,SIO 295S,A00,523232,Staff,13,0,30,17
1714206336177,SIOC 290S,A01,637330,Merrifield; Mark A,28,0,30,2
1714206337203,SIOC 291S,A01,637333,Gabriel; Corey John,28,0,30,2
1714206338228,SOCI 117,A01,494376,Staff,0,2,5,5
1714206339253,WES 237B,A00,494380,Staff,9,0,20,11
1714206341319,AESE 279B,A00,494370,Wade; Jon P,0,0,33,33
1714206342343,AIP 197,001,627712,Vespa; Emanuel Ignacio,9998,0,9999,1
1714206343371,ANAR 135S,A00,494369,Braswell; Geoffrey E.,0,0,0,0
1714206344397,BENG 196,001,628496,Engler; Adam J.,9998,0,9999,1
1714206345428,CAT 124RS,A01,519847,Geibel; William,0,0,20,20
1714206346456,CAT 125RS,A01,515971,Geibel; William,0,0,20,20
1714206347485,CLRE 250,A00,511389,Morris; Sheldon,9993,0,9999,6
1714206348511,CLRE 251,A00,507176,Mehta; Ravindra L.,9993,0,9999,6
1714206348511,CLRE 251,B00,511410,Mehta; Ravindra L.,9998,0,9999,1
1714206349536,CLRE 252,A00,507189,Cuomo; Raphael Eduardo,9995,0,9999,4
1714206350565,CLRE 253,A00,507199,Vaida; Florin,9994,0,9999,5
1714206350565,CLRE 253,B00,507202,Vaida; Florin,9999,0,9999,0
1714206351593,CLRE 259,A00,507211,Patel; Hemal,9996,0,9999,3
1714206352622,CLRE 260,A00,507221,Cuomo; Raphael Eduardo,9999,0,9999,0
1714206353651,CLRE 297,001,507242,Cuomo; Raphael Eduardo,9999,0,9999,0
1714206354680,COGS 197,001,638244,Voytek; Bradley Thomas,9999,0,9999,0
1714206355706,CSE 191,A00,516875,Minnes Kemp; Mor Mia,9993,0,9999,6
1714206356731,CSE 197,001,637388,Minnes Kemp; Mor Mia,9998,0,9999,1
1714206357757,CSS 201S,A01,494383,Staff,35,0,35,0
1714206358783,CSS 202S,A01,494387,Staff,35,0,35,0
1714206359810,DSC 197,001,628532,Eldridge; Justin Matthew,9996,0,9999,3
1714206360835,EAP 100,A00,516065,Staff,9797,0,9999,202
1714206361861,ECE 45,A01,507414,Staff,33,0,60,27
1714206363918,ECE 111,A01,507420,Staff,21,0,50,29
1714206364944,ECE 197,001,548057,Sievenpiper; Daniel F.,9994,0,9999,5
1714206365973,EDS 115,A00,507243,Choi; Bailey Miyeon,12,0,28,16
1714206366999,EDS 117,A01,494379,Staff,0,1,30,30
1714206368025,EDS 125,A00,507246,Hopkins; Megan Beth,12,0,30,18
1714206369053,EDS 128A,A01,507264,Fargason; Sharon Gayle,14,0,26,12
1714206370078,EDS 128B,A01,507293,Pappas; Elizabeth,18,0,30,12
1714206371103,EDS 139,A00,507294,Fargason; Sharon Gayle,18,0,30,12
1714206371103,EDS 139,B00,507313,Pappas; Elizabeth,15,0,30,15
1714206372129,EDS 201,A00,507315,Staff,13,0,30,17
1714206373158,EDS 203,A01,507317,Halter; Christopher P.,12,0,30,18
1714206374182,EDS 204R,A01,507319,Halter; Christopher P.,0,3,30,30
1714206374182,EDS 204R,B01,507331,Heinzman; Erica M.,17,0,30,13
1714206375210,EDS 206R,A00,507332,Staff,0,4,30,30
1714206375210,EDS 206R,B00,507343,Staff,18,0,30,12
1714206376236,EDS 250,A00,507344,Hemans; Patricia Ann Benitez,22,0,40,18
1714206377261,EDS 281,A00,507345,Daly; Alan J.,18,0,18,0
1714206378285,EDS 284,A00,507350,Daly; Alan J.,16,0,16,0
1714206379311,EDS 286,A00,507359,Fine; Sarah,18,0,18,0
1714206380338,EDS 289C,A01,507361,Daly; Alan J.,18,0,18,0
1714206381366,EDS 290,A00,507366,Hofstetter; Carolyn,15,0,15,0
1714206382396,LIGM 5A,A00,507421,Fischer-Grunski; Eva K,18,0,20,2
1714206383422,LIGM 5B,A00,507423,Fischer-Grunski; Eva K,19,0,20,1
1714206384449,LIGM 5C,A00,507425,Fischer-Grunski; Eva K,19,0,20,1
1714206385475,LIIT 5AS,A00,507427,Carnelos; Chiara,20,0,20,0
1714206386504,LIIT 5BS,A00,507430,Carnelos; Chiara,20,0,20,0
1714206387533,LIIT 5CS,A00,507432,Carnelos; Chiara,20,0,20,0
1714206388561,LISP 5A,A00,507541,Munoz Sanchez; Alicia,11,0,20,9
1714206389590,LISP 5B,A00,507671,Munoz Sanchez; Alicia,9,0,20,11
1714206390618,LISP 5C,A00,507696,Munoz Sanchez; Alicia,9,0,20,11
1714206391644,MAE 197,001,528363,Boechler; Nicholas Sebastia,9998,0,9999,1
1714206392672,MATH 197,001,523477,Kedlaya; Kiran S.,9996,0,9999,3
1714206392672,MATH 197,002,563811,Zhang; Danna,9995,0,9999,4
1714206392672,MATH 197,003,628552,Dumitriu; Ioana,9998,0,9999,1
1714206393698,MCWP 40R,A00,518780,Staff,5,0,20,15
1714206393698,MCWP 40R,B00,518781,Staff,7,0,20,13
1714206393698,MCWP 40R,C00,518783,Staff,5,0,20,15
1714206394725,MCWP 50R,A00,518791,Staff,0,0,20,20
1714206394725,MCWP 50R,B00,518792,Staff,0,1,20,20
1714206394725,MCWP 50R,C00,518793,Staff,0,1,20,20
1714206394725,MCWP 50R,D00,518794,Staff,0,0,20,20
1714206394725,MCWP 50R,E00,518795,Staff,0,1,20,20
1714206394725,MCWP 50R,F00,518796,Staff,0,0,20,20
1714206394725,MCWP 50R,G00,518797,Staff,0,1,20,20
1714206395751,MMW 12R,A01,514034,Herbst; Matthew,0,1,16,16
1714206395751,MMW 12R,A02,514035,Herbst; Matthew,2,0,16,14
1714206396776,MMW 13R,A01,514037,Staff,0,4,16,16
1714206396776,MMW 13R,A02,514039,Staff,0,2,16,16
1714206396776,MMW 13R,A03,628519,Staff,0,2,16,16
1714206398827,SIO 295LS,A00,523233,Staff,13,0,30,17
1714206399856,SIO 295S,A00,523232,Staff,13,0,30,17
1714206400885,SIOC 290S,A01,637330,Merrifield; Mark A,28,0,30,2
1714206401912,SIOC 291S,A01,637333,Gabriel; Corey John,28,0,30,2
1714206402938,SOCI 117,A01,494376,Staff,0,2,5,5
1714206403968,WES 237B,A00,494380,Staff,9,0,20,11
1714206406037,AESE 279B,A00,494370,Wade; Jon P,0,0,33,33
1714206407062,AIP 197,001,627712,Vespa; Emanuel Ignacio,9998,0,9999,1
1714206408088,ANAR 135S,A00,494369,Braswell; Geoffrey E.,0,0,0,0
1714206409113,BENG 196,001,628496,Engler; Adam J.,9998,0,9999,1
1714206410143,CAT 124RS,A01,519847,Geibel; William,0,0,20,20
1714206411169,CAT 125RS,A01,515971,Geibel; William,0,0,20,20
1714206412195,CLRE 250,A00,511389,Morris; Sheldon,9993,0,9999,6
1714206413226,CLRE 251,A00,507176,Mehta; Ravindra L.,9993,0,9999,6
1714206413226,CLRE 251,B00,511410,Mehta; Ravindra L.,9998,0,9999,1
1714206414254,CLRE 252,A00,507189,Cuomo; Raphael Eduardo,9995,0,9999,4
1714206415281,CLRE 253,A00,507199,Vaida; Florin,9994,0,9999,5
1714206415281,CLRE 253,B00,507202,Vaida; Florin,9999,0,9999,0
1714206416306,CLRE 259,A00,507211,Patel; Hemal,9996,0,9999,3
1714206417329,CLRE 260,A00,507221,Cuomo; Raphael Eduardo,9999,0,9999,0
1714206418355,CLRE 297,001,507242,Cuomo; Raphael Eduardo,9999,0,9999,0
1714206419384,COGS 197,001,638244,Voytek; Bradley Thomas,9999,0,9999,0
1714206420411,CSE 191,A00,516875,Minnes Kemp; Mor Mia,9993,0,9999,6
1714206421441,CSE 197,001,637388,Minnes Kemp; Mor Mia,9998,0,9999,1
1714206422468,CSS 201S,A01,494383,Staff,35,0,35,0
1714206423515,CSS 202S,A01,494387,Staff,35,0,35,0
1714206424543,DSC 197,001,628532,Eldridge; Justin Matthew,9996,0,9999,3
1714206425568,EAP 100,A00,516065,Staff,9797,0,9999,202
1714206426598,ECE 45,A01,507414,Staff,33,0,60,27
1714206428649,ECE 111,A01,507420,Staff,21,0,50,29
1714206429675,ECE 197,001,548057,Sievenpiper; Daniel F.,9994,0,9999,5
1714206430700,EDS 115,A00,507243,Choi; Bailey Miyeon,12,0,28,16
1714206431725,EDS 117,A01,494379,Staff,0,1,30,30
1714206432751,EDS 125,A00,507246,Hopkins; Megan Beth,12,0,30,18
1714206433781,EDS 128A,A01,507264,Fargason; Sharon Gayle,14,0,26,12
1714206434807,EDS 128B,A01,507293,Pappas; Elizabeth,18,0,30,12
1714206435836,EDS 139,A00,507294,Fargason; Sharon Gayle,18,0,30,12
1714206435836,EDS 139,B00,507313,Pappas; Elizabeth,15,0,30,15
1714206436865,EDS 201,A00,507315,Staff,13,0,30,17
1714206437894,EDS 203,A01,507317,Halter; Christopher P.,12,0,30,18
1714206438976,EDS 204R,A01,507319,Halter; Christopher P.,0,3,30,30
1714206438976,EDS 204R,B01,507331,Heinzman; Erica M.,17,0,30,13
1714206440006,EDS 206R,A00,507332,Staff,0,4,30,30
1714206440006,EDS 206R,B00,507343,Staff,18,0,30,12
1714206441032,EDS 250,A00,507344,Hemans; Patricia Ann Benitez,22,0,40,18
1714206442058,EDS 281,A00,507345,Daly; Alan J.,18,0,18,0
1714206443084,EDS 284,A00,507350,Daly; Alan J.,16,0,16,0
1714206444113,EDS 286,A00,507359,Fine; Sarah,18,0,18,0
1714206445139,EDS 289C,A01,507361,Daly; Alan J.,18,0,18,0
1714206446165,EDS 290,A00,507366,Hofstetter; Carolyn,15,0,15,0
1714206447195,LIGM 5A,A00,507421,Fischer-Grunski; Eva K,18,0,20,2
1714206448220,LIGM 5B,A00,507423,Fischer-Grunski; Eva K,19,0,20,1
1714206449245,LIGM 5C,A00,507425,Fischer-Grunski; Eva K,19,0,20,1
1714206450270,LIIT 5AS,A00,507427,Carnelos; Chiara,20,0,20,0
1714206451300,LIIT 5BS,A00,507430,Carnelos; Chiara,20,0,20,0
1714206452326,LIIT 5CS,A00,507432,Carnelos; Chiara,20,0,20,0
1714206453355,LISP 5A,A00,507541,Munoz Sanchez; Alicia,11,0,20,9
1714206454385,LISP 5B,A00,507671,Munoz Sanchez; Alicia,9,0,20,11
1714206455411,LISP 5C,A00,507696,Munoz Sanchez; Alicia,9,0,20,11
1714206456439,MAE 197,001,528363,Boechler; Nicholas Sebastia,9998,0,9999,1
1714206457466,MATH 197,001,523477,Kedlaya; Kiran S.,9996,0,9999,3
1714206457466,MATH 197,002,563811,Zhang; Danna,9995,0,9999,4
1714206457466,MATH 197,003,628552,Dumitriu; Ioana,9998,0,9999,1
1714206458493,MCWP 40R,A00,518780,Staff,5,0,20,15
1714206458493,MCWP 40R,B00,518781,Staff,7,0,20,13
1714206458493,MCWP 40R,C00,518783,Staff,5,0,20,15
1714206459519,MCWP 50R,A00,518791,Staff,0,0,20,20
1714206459519,MCWP 50R,B00,518792,Staff,0,1,20,20
1714206459519,MCWP 50R,C00,518793,Staff,0,1,20,20
1714206459519,MCWP 50R,D00,518794,Staff,0,0,20,20
1714206459519,MCWP 50R,E00,518795,Staff,0,1,20,20
1714206459519,MCWP 50R,F00,518796,Staff,0,0,20,20
1714206459519,MCWP 50R,G00,518797,Staff,0,1,20,20
1714206460550,MMW 12R,A01,514034,Herbst; Matthew,0,1,16,16
1714206460550,MMW 12R,A02,514035,Herbst; Matthew,2,0,16,14
1714206461579,MMW 13R,A01,514037,Staff,0,4,16,16
1714206461579,MMW 13R,A02,514039,Staff,0,2,16,16
1714206461579,MMW 13R,A03,628519,Staff,0,2,16,16
1714206463639,SIO 295LS,A00,523233,Staff,13,0,30,17
1714206464664,SIO 295S,A00,523232,Staff,13,0,30,17
1714206465690,SIOC 290S,A01,637330,Merrifield; Mark A,28,0,30,2
1714206466717,SIOC 291S,A01,637333,Gabriel; Corey John,28,0,30,2
1714206467746,SOCI 117,A01,494376,Staff,0,2,5,5
1714206468771,WES 237B,A00,494380,Staff,9,0,20,11
1714206470827,AESE 279B,A00,494370,Wade; Jon P,0,0,33,33
1714206471855,AIP 197,001,627712,Vespa; Emanuel Ignacio,9998,0,9999,1
1714206472885,ANAR 135S,A00,494369,Braswell; Geoffrey E.,0,0,0,0
1714206473914,BENG 196,001,628496,Engler; Adam J.,9998,0,9999,1
1714206474942,CAT 124RS,A01,519847,Geibel; William,0,0,20,20
1714206475998,CAT 125RS,A01,515971,Geibel; William,0,0,20,20
1714206477029,CLRE 250,A00,511389,Morris; Sheldon,9993,0,9999,6
1714206478057,CLRE 251,A00,507176,Mehta; Ravindra L.,9993,0,9999,6
1714206478057,CLRE 251,B00,511410,Mehta; Ravindra L.,9998,0,9999,1
1714206479083,CLRE 252,A00,507189,Cuomo; Raphael Eduardo,9995,0,9999,4
1714206480108,CLRE 253,A00,507199,Vaida; Florin,9994,0,9999,5
1714206480108,CLRE 253,B00,507202,Vaida; Florin,9999,0,9999,0
1714206481134,CLRE 259,A00,507211,Patel; Hemal,9996,0,9999,3
1714206482158,CLRE 260,A00,507221,Cuomo; Raphael Eduardo,9999,0,9999,0
1714206483183,CLRE 297,001,507242,Cuomo; Raphael Eduardo,9999,0,9999,0
1714206484214,COGS 197,001,638244,Voytek; Bradley Thomas,9999,0,9999,0
1714206485240,CSE 191,A00,516875,Minnes Kemp; Mor Mia,9993,0,9999,6
1714206486268,CSE 197,001,637388,Minnes Kemp; Mor Mia,9998,0,9999,1
1714206487300,CSS 201S,A01,494383,Staff,35,0,35,0
1714206488326,CSS 202S,A01,494387,Staff,35,0,35,0
1714206489357,DSC 197,001,628532,Eldridge; Justin Matthew,9996,0,9999,3
1714206490386,EAP 100,A00,516065,Staff,9797,0,9999,202
1714206491411,ECE 45,A01,507414,Staff,33,0,60,27
1714206493466,ECE 111,A01,507420,Staff,21,0,50,29
1714206494492,ECE 197,001,548057,Sievenpiper; Daniel F.,9994,0,9999,5
1714206495518,EDS 115,A00,507243,Choi; Bailey Miyeon,12,0,28,16
1714206496548,EDS 117,A01,494379,Staff,0,1,30,30
1714206497573,EDS 125,A00,507246,Hopkins; Megan Beth,12,0,30,18
1714206498603,EDS 128A,A01,507264,Fargason; Sharon Gayle,14,0,26,12
1714206499629,EDS 128B,A01,507293,Pappas; Elizabeth,18,0,30,12
1714206500654,EDS 139,A00,507294,Fargason; Sharon Gayle,18,0,30,12
1714206500654,EDS 139,B00,507313,Pappas; Elizabeth,15,0,30,15
1714206501684,EDS 201,A00,507315,Staff,13,0,30,17
1714206502710,EDS 203,A01,507317,Halter; Christopher P.,12,0,30,18
1714206503739,EDS 204R,A01,507319,Halter; Christopher P.,0,3,30,30
1714206503739,EDS 204R,B01,507331,Heinzman; Erica M.,17,0,30,13
1714206504767,EDS 206R,A00,507332,Staff,0,4,30,30
1714206504767,EDS 206R,B00,507343,Staff,18,0,30,12
1714206505796,EDS 250,A00,507344,Hemans; Patricia Ann Benitez,22,0,40,18
1714206506822,EDS 281,A00,507345,Daly; Alan J.,18,0,18,0
1714206507848,EDS 284,A00,507350,Daly; Alan J.,16,0,16,0
1714206508872,EDS 286,A00,507359,Fine; Sarah,18,0,18,0
1714206509898,EDS 289C,A01,507361,Daly; Alan J.,18,0,18,0
1714206510922,EDS 290,A00,507366,Hofstetter; Carolyn,15,0,15,0
1714206511950,LIGM 5A,A00,507421,Fischer-Grunski; Eva K,18,0,20,2
1714206512976,LIGM 5B,A00,507423,Fischer-Grunski; Eva K,19,0,20,1
1714206514005,LIGM 5C,A00,507425,Fischer-Grunski; Eva K,19,0,20,1
1714206515035,LIIT 5AS,A00,507427,Carnelos; Chiara,20,0,20,0
1714206516059,LIIT 5BS,A00,507430,Carnelos; Chiara,20,0,20,0
1714206517085,LIIT 5CS,A00,507432,Carnelos; Chiara,20,0,20,0
1714206518112,LISP 5A,A00,507541,Munoz Sanchez; Alicia,11,0,20,9
1714206519136,LISP 5B,A00,507671,Munoz Sanchez; Alicia,9,0,20,11
1714206520162,LISP 5C,A00,507696,Munoz Sanchez; Alicia,9,0,20,11
1714206521195,MAE 197,001,528363,Boechler; Nicholas Sebastia,9998,0,9999,1
1714206522220,MATH 197,001,523477,Kedlaya; Kiran S.,9996,0,9999,3
1714206522220,MATH 197,002,563811,Zhang; Danna,9995,0,9999,4
1714206522220,MATH 197,003,628552,Dumitriu; Ioana,9998,0,9999,1
1714206523246,MCWP 40R,A00,518780,Staff,5,0,20,15
1714206523246,MCWP 40R,B00,518781,Staff,7,0,20,13
1714206523246,MCWP 40R,C00,518783,Staff,5,0,20,15
1714206524275,MCWP 50R,A00,518791,Staff,0,0,20,20
1714206524275,MCWP 50R,B00,518792,Staff,0,1,20,20
1714206524275,MCWP 50R,C00,518793,Staff,0,1,20,20
1714206524275,MCWP 50R,D00,518794,Staff,0,0,20,20
1714206524275,MCWP 50R,E00,518795,Staff,0,1,20,20
1714206524275,MCWP 50R,F00,518796,Staff,0,0,20,20
1714206524275,MCWP 50R,G00,518797,Staff,0,1,20,20
1714206525305,MMW 12R,A01,514034,Herbst; Matthew,0,1,16,16
1714206525305,MMW 12R,A02,514035,Herbst; Matthew,2,0,16,14
1714206526333,MMW 13R,A01,514037,Staff,0,4,16,16
1714206526333,MMW 13R,A02,514039,Staff,0,2,16,16
1714206526333,MMW 13R,A03,628519,Staff,0,2,16,16
1714206528383,SIO 295LS,A00,523233,Staff,13,0,30,17
1714206529413,SIO 295S,A00,523232,Staff,13,0,30,17
1714206530438,SIOC 290S,A01,637330,Merrifield; Mark A,28,0,30,2
1714206531464,SIOC 291S,A01,637333,Gabriel; Corey John,28,0,30,2
1714206532488,SOCI 117,A01,494376,Staff,0,2,5,5
1714206533517,WES 237B,A00,494380,Staff,9,0,20,11
1714206535584,AESE 279B,A00,494370,Wade; Jon P,0,0,33,33
1714206536609,AIP 197,001,627712,Vespa; Emanuel Ignacio,9998,0,9999,1
1714206537638,ANAR 135S,A00,494369,Braswell; Geoffrey E.,0,0,0,0
1714206538664,BENG 196,001,628496,Engler; Adam J.,9998,0,9999,1
1714206539689,CAT 124RS,A01,519847,Geibel; William,0,0,20,20
1714206540718,CAT 125RS,A01,515971,Geibel; William,0,0,20,20
1714206541748,CLRE 250,A00,511389,Morris; Sheldon,9993,0,9999,6
1714206542830,CLRE 251,A00,507176,Mehta; Ravindra L.,9993,0,9999,6
1714206542830,CLRE 251,B00,511410,Mehta; Ravindra L.,9998,0,9999,1
1714206543864,CLRE 252,A00,507189,Cuomo; Raphael Eduardo,9995,0,9999,4
1714206544893,CLRE 253,A00,507199,Vaida; Florin,9994,0,9999,5
1714206544893,CLRE 253,B00,507202,Vaida; Florin,9999,0,9999,0
1714206545919,CLRE 259,A00,507211,Patel; Hemal,9996,0,9999,3
1714206546944,CLRE 260,A00,507221,Cuomo; Raphael Eduardo,9999,0,9999,0
1714206547969,CLRE 297,001,507242,Cuomo; Raphael Eduardo,9999,0,9999,0
1714206549000,COGS 197,001,638244,Voytek; Bradley Thomas,9999,0,9999,0
1714206550026,CSE 191,A00,516875,Minnes Kemp; Mor Mia,9993,0,9999,6
1714206551052,CSE 197,001,637388,Minnes Kemp; Mor Mia,9998,0,9999,1
1714206552077,CSS 201S,A01,494383,Staff,35,0,35,0
1714206553103,CSS 202S,A01,494387,Staff,35,0,35,0
1714206554129,DSC 197,001,628532,Eldridge; Justin Matthew,9996,0,9999,3
1714206555154,EAP 100,A00,516065,Staff,9797,0,9999,202
1714206556185,ECE 45,A01,507414,Staff,33,0,60,27
1714206558238,ECE 111,A01,507420,Staff,21,0,50,29
1714206559264,ECE 197,001,548057,Sievenpiper; Daniel F.,9994,0,9999,5
1714206560295,EDS 115,A00,507243,Choi; Bailey Miyeon,12,0,28,16
1714206561320,EDS 117,A01,494379,Staff,0,1,30,30
1714206562350,EDS 125,A00,507246,Hopkins; Megan Beth,12,0,30,18
1714206563379,EDS 128A,A01,507264,Fargason; Sharon Gayle,14,0,26,12
1714206564408,EDS 128B,A01,507293,Pappas; Elizabeth,18,0,30,12
1714206565433,EDS 139,A00,507294,Fargason; Sharon Gayle,18,0,30,12
1714206565433,EDS 139,B00,507313,Pappas; Elizabeth,15,0,30,15
1714206566464,EDS 201,A00,507315,Staff,13,0,30,17
1714206567491,EDS 203,A01,507317,Halter; Christopher P.,12,0,30,18
1714206568516,EDS 204R,A01,507319,Halter; Christopher P.,0,3,30,30
1714206568516,EDS 204R,B01,507331,Heinzman; Erica M.,17,0,30,13
1714206569544,EDS 206R,A00,507332,Staff,0,4,30,30
1714206569544,EDS 206R,B00,507343,Staff,18,0,30,12
1714206570570,EDS 250,A00,507344,Hemans; Patricia Ann Benitez,22,0,40,18
1714206571599,EDS 281,A00,507345,Daly; Alan J.,18,0,18,0
1714206572624,EDS 284,A00,507350,Daly; Alan J.,16,0,16,0
1714206573649,EDS 286,A00,507359,Fine; Sarah,18,0,18,0
1714206574674,EDS 289C,A01,507361,Daly; Alan J.,18,0,18,0
1714206575700,EDS 290,A00,507366,Hofstetter; Carolyn,15,0,15,0
1714206576730,LIGM 5A,A00,507421,Fischer-Grunski; Eva K,18,0,20,2
1714206577756,LIGM 5B,A00,507423,Fischer-Grunski; Eva K,19,0,20,1
1714206578782,LIGM 5C,A00,507425,Fischer-Grunski; Eva K,19,0,20,1
1714206579814,LIIT 5AS,A00,507427,Carnelos; Chiara,20,0,20,0
1714206580840,LIIT 5BS,A00,507430,Carnelos; Chiara,20,0,20,0
1714206581870,LIIT 5CS,A00,507432,Carnelos; Chiara,20,0,20,0
1714206582900,LISP 5A,A00,507541,Munoz Sanchez; Alicia,11,0,20,9
1714206583925,LISP 5B,A00,507671,Munoz Sanchez; Alicia,9,0,20,11
1714206584952,LISP 5C,A00,507696,Munoz Sanchez; Alicia,9,0,20,11
1714206585981,MAE 197,001,528363,Boechler; Nicholas Sebastia,9998,0,9999,1
1714206587007,MATH 197,001,523477,Kedlaya; Kiran S.,9996,0,9999,3
1714206587007,MATH 197,002,563811,Zhang; Danna,9995,0,9999,4
1714206587007,MATH 197,003,628552,Dumitriu; Ioana,9998,0,9999,1
1714206588037,MCWP 40R,A00,518780,Staff,5,0,20,15
1714206588037,MCWP 40R,B00,518781,Staff,7,0,20,13
1714206588037,MCWP 40R,C00,518783,Staff,5,0,20,15
1714206589064,MCWP 50R,A00,518791,Staff,0,0,20,20
1714206589064,MCWP 50R,B00,518792,Staff,0,1,20,20
1714206589064,MCWP 50R,C00,518793,Staff,0,1,20,20
1714206589064,MCWP 50R,D00,518794,Staff,0,0,20,20
1714206589064,MCWP 50R,E00,518795,Staff,0,1,20,20
1714206589064,MCWP 50R,F00,518796,Staff,0,0,20,20
1714206589064,MCWP 50R,G00,518797,Staff,0,1,20,20
1714206590093,MMW 12R,A01,514034,Herbst; Matthew,0,1,16,16
1714206590093,MMW 12R,A02,514035,Herbst; Matthew,2,0,16,14
1714206591122,MMW 13R,A01,514037,Staff,0,4,16,16
1714206591122,MMW 13R,A02,514039,Staff,0,2,16,16
1714206591122,MMW 13R,A03,628519,Staff,0,2,16,16
1714206593175,SIO 295LS,A00,523233,Staff,13,0,30,17
1714206594204,SIO 295S,A00,523232,Staff,13,0,30,17
1714206595233,SIOC 290S,A01,637330,Merrifield; Mark A,28,0,30,2
1714206596262,SIOC 291S,A01,637333,Gabriel; Corey John,28,0,30,2
1714206597287,SOCI 117,A01,494376,Staff,0,2,5,5
1714206598315,WES 237B,A00,494380,Staff,9,0,20,11
1714206600388,AESE 279B,A00,494370,Wade; Jon P,0,0,33,33
1714206601418,AIP 197,001,627712,Vespa; Emanuel Ignacio,9998,0,9999,1
1714206602444,ANAR 135S,A00,494369,Braswell; Geoffrey E.,0,0,0,0
1714206603469,BENG 196,001,628496,Engler; Adam J.,9998,0,9999,1
1714206604494,CAT 124RS,A01,519847,Geibel; William,0,0,20,20
1714206605523,CAT 125RS,A01,515971,Geibel; William,0,0,20,20
1714206606547,CLRE 250,A00,511389,Morris; Sheldon,9993,0,9999,6
1714206607576,CLRE 251,A00,507176,Mehta; Ravindra L.,9993,0,9999,6
1714206607576,CLRE 251,B00,511410,Mehta; Ravindra L.,9998,0,9999,1
1714206608602,CLRE 252,A00,507189,Cuomo; Raphael Eduardo,9995,0,9999,4
1714206609628,CLRE 253,A00,507199,Vaida; Florin,9994,0,9999,5
1714206609628,CLRE 253,B00,507202,Vaida; Florin,9999,0,9999,0
1714206610655,CLRE 259,A00,507211,Patel; Hemal,9996,0,9999,3
1714206611680,CLRE 260,A00,507221,Cuomo; Raphael Eduardo,9999,0,9999,0
1714206612709,CLRE 297,001,507242,Cuomo; Raphael Eduardo,9999,0,9999,0
1714206613736,COGS 197,001,638244,Voytek; Bradley Thomas,9999,0,9999,0
1714206614762,CSE 191,A00,516875,Minnes Kemp; Mor Mia,9993,0,9999,6
1714206615788,CSE 197,001,637388,Minnes Kemp; Mor Mia,9998,0,9999,1
1714206616815,CSS 201S,A01,494383,Staff,35,0,35,0
1714206617842,CSS 202S,A01,494387,Staff,35,0,35,0
1714206618868,DSC 197,001,628532,Eldridge; Justin Matthew,9996,0,9999,3
1714206619896,EAP 100,A00,516065,Staff,9797,0,9999,202
1714206620921,ECE 45,A01,507414,Staff,33,0,60,27
1714206622977,ECE 111,A01,507420,Staff,21,0,50,29
1714206624007,ECE 197,001,548057,Sievenpiper; Daniel F.,9994,0,9999,5
1714206625032,EDS 115,A00,507243,Choi; Bailey Miyeon,12,0,28,16
1714206626061,EDS 117,A01,494379,Staff,0,1,30,30
1714206627090,EDS 125,A00,507246,Hopkins; Megan Beth,12,0,30,18
1714206628115,EDS 128A,A01,507264,Fargason; Sharon Gayle,14,0,26,12
1714206629140,EDS 128B,A01,507293,Pappas; Elizabeth,18,0,30,12
1714206630168,EDS 139,A00,507294,Fargason; Sharon Gayle,18,0,30,12
1714206630168,EDS 139,B00,507313,Pappas; Elizabeth,15,0,30,15
1714206631193,EDS 201,A00,507315,Staff,13,0,30,17
1714206632221,EDS 203,A01,507317,Halter; Christopher P.,12,0,30,18
1714206633251,EDS 204R,A01,507319,Halter; Christopher P.,0,3,30,30
1714206633251,EDS 204R,B01,507331,Heinzman; Erica M.,17,0,30,13
1714206634279,EDS 206R,A00,507332,Staff,0,4,30,30
1714206634279,EDS 206R,B00,507343,Staff,18,0,30,12
1714206635305,EDS 250,A00,507344,Hemans; Patricia Ann Benitez,22,0,40,18
1714206636331,EDS 281,A00,507345,Daly; Alan J.,18,0,18,0
1714206637358,EDS 284,A00,507350,Daly; Alan J.,16,0,16,0
1714206638384,EDS 286,A00,507359,Fine; Sarah,18,0,18,0
1714206639409,EDS 289C,A01,507361,Daly; Alan J.,18,0,18,0
1714206640437,EDS 290,A00,507366,Hofstetter; Carolyn,15,0,15,0
1714206641463,LIGM 5A,A00,507421,Fischer-Grunski; Eva K,18,0,20,2
1714206642491,LIGM 5B,A00,507423,Fischer-Grunski; Eva K,19,0,20,1
1714206643518,LIGM 5C,A00,507425,Fischer-Grunski; Eva K,19,0,20,1
1714206644546,LIIT 5AS,A00,507427,Carnelos; Chiara,20,0,20,0
1714206645576,LIIT 5BS,A00,507430,Carnelos; Chiara,20,0,20,0
1714206646657,LIIT 5CS,A00,507432,Carnelos; Chiara,20,0,20,0
1714206647684,LISP 5A,A00,507541,Munoz Sanchez; Alicia,11,0,20,9
1714206648711,LISP 5B,A00,507671,Munoz Sanchez; Alicia,9,0,20,11
1714206649740,LISP 5C,A00,507696,Munoz Sanchez; Alicia,9,0,20,11
1714206650767,MAE 197,001,528363,Boechler; Nicholas Sebastia,9998,0,9999,1
1714206651794,MATH 197,001,523477,Kedlaya; Kiran S.,9996,0,9999,3
1714206651794,MATH 197,002,563811,Zhang; Danna,9995,0,9999,4
1714206651794,MATH 197,003,628552,Dumitriu; Ioana,9998,0,9999,1
1714206652823,MCWP 40R,A00,518780,Staff,5,0,20,15
1714206652823,MCWP 40R,B00,518781,Staff,7,0,20,13
1714206652823,MCWP 40R,C00,518783,Staff,5,0,20,15
1714206653864,MCWP 50R,A00,518791,Staff,0,0,20,20
1714206653864,MCWP 50R,B00,518792,Staff,0,1,20,20
1714206653864,MCWP 50R,C00,518793,Staff,0,1,20,20
1714206653864,MCWP 50R,D00,518794,Staff,0,0,20,20
1714206653864,MCWP 50R,E00,518795,Staff,0,1,20,20
1714206653864,MCWP 50R,F00,518796,Staff,0,0,20,20
1714206653864,MCWP 50R,G00,518797,Staff,0,1,20,20
1714206654891,MMW 12R,A01,514034,Herbst; Matthew,0,1,16,16
1714206654891,MMW 12R,A02,514035,Herbst; Matthew,2,0,16,14
1714206655918,MMW 13R,A01,514037,Staff,0,4,16,16
1714206655918,MMW 13R,A02,514039,Staff,0,2,16,16
1714206655918,MMW 13R,A03,628519,Staff,0,2,16,16
1714206657973,SIO 295LS,A00,523233,Staff,13,0,30,17
1714206659002,SIO 295S,A00,523232,Staff,13,0,30,17
1714206660255,SIOC 290S,A01,637330,Merrifield; Mark A,28,0,30,2
1714206661283,SIOC 291S,A01,637333,Gabriel; Corey John,28,0,30,2
1714206662308,SOCI 117,A01,494376,Staff,0,2,5,5
1714206663334,WES 237B,A00,494380,Staff,9,0,20,11
1714206665398,AESE 279B,A00,494370,Wade; Jon P,0,0,33,33
1714206666424,AIP 197,001,627712,Vespa; Emanuel Ignacio,9998,0,9999,1
1714206667453,ANAR 135S,A00,494369,Braswell; Geoffrey E.,0,0,0,0
1714206668482,BENG 196,001,628496,Engler; Adam J.,9998,0,9999,1
1714206669513,CAT 124RS,A01,519847,Geibel; William,0,0,20,20
1714206670541,CAT 125RS,A01,515971,Geibel; William,0,0,20,20
1714206671573,CLRE 250,A00,511389,Morris; Sheldon,9993,0,9999,6
1714206672605,CLRE 251,A00,507176,Mehta; Ravindra L.,9993,0,9999,6
1714206672605,CLRE 251,B00,511410,Mehta; Ravindra L.,9998,0,9999,1
1714206673631,CLRE 252,A00,507189,Cuomo; Raphael Eduardo,9995,0,9999,4
1714206674660,CLRE 253,A00,507199,Vaida; Florin,9994,0,9999,5
1714206674660,CLRE 253,B00,507202,Vaida; Florin,9999,0,9999,0
1714206675688,CLRE 259,A00,507211,Patel; Hemal,9996,0,9999,3
1714206676715,CLRE 260,A00,507221,Cuomo; Raphael Eduardo,9999,0,9999,0
1714206677743,CLRE 297,001,507242,Cuomo; Raphael Eduardo,9999,0,9999,0
1714206678770,COGS 197,001,638244,Voytek; Bradley Thomas,9999,0,9999,0
1714206679795,CSE 191,A00,516875,Minnes Kemp; Mor Mia,9993,0,9999,6
1714206680819,CSE 197,001,637388,Minnes Kemp; Mor Mia,9998,0,9999,1
1714206681844,CSS 201S,A01,494383,Staff,35,0,35,0
1714206682875,CSS 202S,A01,494387,Staff,35,0,35,0
1714206683903,DSC 197,001,628532,Eldridge; Justin Matthew,9996,0,9999,3
1714206684926,EAP 100,A00,516065,Staff,9797,0,9999,202
1714206685950,ECE 45,A01,507414,Staff,33,0,60,27
1714206688005,ECE 111,A01,507420,Staff,21,0,50,29
1714206689035,ECE 197,001,548057,Sievenpiper; Daniel F.,9994,0,9999,5
1714206690061,EDS 115,A00,507243,Choi; Bailey Miyeon,12,0,28,16
1714206691087,EDS 117,A01,494379,Staff,0,1,30,30
1714206692112,EDS 125,A00,507246,Hopkins; Megan Beth,12,0,30,18
1714206693140,EDS 128A,A01,507264,Fargason; Sharon Gayle,14,0,26,12
1714206694165,EDS 128B,A01,507293,Pappas; Elizabeth,18,0,30,12
1714206695191,EDS 139,A00,507294,Fargason; Sharon Gayle,18,0,30,12
1714206695191,EDS 139,B00,507313,Pappas; Elizabeth,15,0,30,15
1714206696217,EDS 201,A00,507315,Staff,13,0,30,17
1714206697248,EDS 203,A01,507317,Halter; Christopher P.,12,0,30,18
1714206698279,EDS 204R,A01,507319,Halter; Christopher P.,0,3,30,30
1714206698279,EDS 204R,B01,507331,Heinzman; Erica M.,17,0,30,13
1714206699305,EDS 206R,A00,507332,Staff,0,4,30,30
1714206699305,EDS 206R,B00,507343,Staff,18,0,30,12
1714206700334,EDS 250,A00,507344,Hemans; Patricia Ann Benitez,22,0,40,18
1714206701360,EDS 281,A00,507345,Daly; Alan J.,18,0,18,0
1714206702387,EDS 284,A00,507350,Daly; Alan J.,16,0,16,0
1714206703412,EDS 286,A00,507359,Fine; Sarah,18,0,18,0
1714206704439,EDS 289C,A01,507361,Daly; Alan J.,18,0,18,0
1714206705667,EDS 290,A00,507366,Hofstetter; Carolyn,15,0,15,0
1714206706696,LIGM 5A,A00,507421,Fischer-Grunski; Eva K,18,0,20,2
1714206707727,LIGM 5B,A00,507423,Fischer-Grunski; Eva K,19,0,20,1
1714206708754,LIGM 5C,A00,507425,Fischer-Grunski; Eva K,19,0,20,1
1714206709780,LIIT 5AS,A00,507427,Carnelos; Chiara,20,0,20,0
1714206710810,LIIT 5BS,A00,507430,Carnelos; Chiara,20,0,20,0
1714206711836,LIIT 5CS,A00,507432,Carnelos; Chiara,20,0,20,0
1714206712862,LISP 5A,A00,507541,Munoz Sanchez; Alicia,11,0,20,9
1714206713888,LISP 5B,A00,507671,Munoz Sanchez; Alicia,9,0,20,11
1714206714914,LISP 5C,A00,507696,Munoz Sanchez; Alicia,9,0,20,11
1714206715944,MAE 197,001,528363,Boechler; Nicholas Sebastia,9998,0,9999,1
1714206716975,MATH 197,001,523477,Kedlaya; Kiran S.,9996,0,9999,3
1714206716975,MATH 197,002,563811,Zhang; Danna,9995,0,9999,4
1714206716975,MATH 197,003,628552,Dumitriu; Ioana,9998,0,9999,1
1714206718002,MCWP 40R,A00,518780,Staff,5,0,20,15
1714206718002,MCWP 40R,B00,518781,Staff,7,0,20,13
1714206718002,MCWP 40R,C00,518783,Staff,5,0,20,15
1714206719035,MCWP 50R,A00,518791,Staff,0,0,20,20
1714206719035,MCWP 50R,B00,518792,Staff,0,1,20,20
1714206719035,MCWP 50R,C00,518793,Staff,0,1,20,20
1714206719035,MCWP 50R,D00,518794,Staff,0,0,20,20
1714206719035,MCWP 50R,E00,518795,Staff,0,1,20,20
1714206719035,MCWP 50R,F00,518796,Staff,0,0,20,20
1714206719035,MCWP 50R,G00,518797,Staff,0,1,20,20
1714206720061,MMW 12R,A01,514034,Herbst; Matthew,0,1,16,16
1714206720061,MMW 12R,A02,514035,Herbst; Matthew,2,0,16,14
1714206721088,MMW 13R,A01,514037,Staff,0,4,16,16
1714206721088,MMW 13R,A02,514039,Staff,0,2,16,16
1714206721088,MMW 13R,A03,628519,Staff,0,2,16,16
1714206723139,SIO 295LS,A00,523233,Staff,13,0,30,17
1714206724165,SIO 295S,A00,523232,Staff,13,0,30,17
1714206725191,SIOC 290S,A01,637330,Merrifield; Mark A,28,0,30,2
1714206726218,SIOC 291S,A01,637333,Gabriel; Corey John,28,0,30,2
1714206727248,SOCI 117,A01,494376,Staff,0,2,5,5
1714206728274,WES 237B,A00,494380,Staff,9,0,20,11
1714206730347,AESE 279B,A00,494370,Wade; Jon P,0,0,33,33
1714206731377,AIP 197,001,627712,Vespa; Emanuel Ignacio,9998,0,9999,1
1714206732403,ANAR 135S,A00,494369,Braswell; Geoffrey E.,0,0,0,0
1714206733433,BENG 196,001,628496,Engler; Adam J.,9998,0,9999,1
1714206734459,CAT 124RS,A01,519847,Geibel; William,0,0,20,20
1714206735484,CAT 125RS,A01,515971,Geibel; William,0,0,20,20
1714206736510,CLRE 250,A00,511389,Morris; Sheldon,9993,0,9999,6
1714206737545,CLRE 251,A00,507176,Mehta; Ravindra L.,9993,0,9999,6
1714206737545,CLRE 251,B00,511410,Mehta; Ravindra L.,9998,0,9999,1
1714206738572,CLRE 252,A00,507189,Cuomo; Raphael Eduardo,9995,0,9999,4
1714206739596,CLRE 253,A00,507199,Vaida; Florin,9994,0,9999,5
1714206739596,CLRE 253,B00,507202,Vaida; Florin,9999,0,9999,0
1714206740625,CLRE 259,A00,507211,Patel; Hemal,9996,0,9999,3
1714206741655,CLRE 260,A00,507221,Cuomo; Raphael Eduardo,9999,0,9999,0
1714206742685,CLRE 297,001,507242,Cuomo; Raphael Eduardo,9999,0,9999,0
1714206743710,COGS 197,001,638244,Voytek; Bradley Thomas,9999,0,9999,0
1714206744735,CSE 191,A00,516875,Minnes Kemp; Mor Mia,9993,0,9999,6
1714206745761,CSE 197,001,637388,Minnes Kemp; Mor Mia,9998,0,9999,1
1714206746788,CSS 201S,A01,494383,Staff,35,0,35,0
1714206747814,CSS 202S,A01,494387,Staff,35,0,35,0
1714206748841,DSC 197,001,628532,Eldridge; Justin Matthew,9996,0,9999,3
1714206749865,EAP 100,A00,516065,Staff,9797,0,9999,202
1714206750952,ECE 45,A01,507414,Staff,33,0,60,27
1714206753013,ECE 111,A01,507420,Staff,21,0,50,29
1714206754037,ECE 197,001,548057,Sievenpiper; Daniel F.,9994,0,9999,5
1714206755065,EDS 115,A00,507243,Choi; Bailey Miyeon,12,0,28,16
1714206756091,EDS 117,A01,494379,Staff,0,1,30,30
1714206757117,EDS 125,A00,507246,Hopkins; Megan Beth,12,0,30,18
1714206758142,EDS 128A,A01,507264,Fargason; Sharon Gayle,14,0,26,12
1714206759167,EDS 128B,A01,507293,Pappas; Elizabeth,18,0,30,12
1714206760191,EDS 139,A00,507294,Fargason; Sharon Gayle,18,0,30,12
1714206760191,EDS 139,B00,507313,Pappas; Elizabeth,15,0,30,15
1714206761218,EDS 201,A00,507315,Staff,13,0,30,17
1714206762245,EDS 203,A01,507317,Halter; Christopher P.,12,0,30,18
1714206763276,EDS 204R,A01,507319,Halter; Christopher P.,0,3,30,30
1714206763276,EDS 204R,B01,507331,Heinzman; Erica M.,17,0,30,13
1714206764302,EDS 206R,A00,507332,Staff,0,4,30,30
1714206764302,EDS 206R,B00,507343,Staff,18,0,30,12
1714206765327,EDS 250,A00,507344,Hemans; Patricia Ann Benitez,22,0,40,18
1714206766352,EDS 281,A00,507345,Daly; Alan J.,18,0,18,0
1714206767378,EDS 284,A00,507350,Daly; Alan J.,16,0,16,0
1714206768404,EDS 286,A00,507359,Fine; Sarah,18,0,18,0
1714206769432,EDS 289C,A01,507361,Daly; Alan J.,18,0,18,0
1714206770454,EDS 290,A00,507366,Hofstetter; Carolyn,15,0,15,0
1714206771481,LIGM 5A,A00,507421,Fischer-Grunski; Eva K,18,0,20,2
1714206772507,LIGM 5B,A00,507423,Fischer-Grunski; Eva K,19,0,20,1
1714206773536,LIGM 5C,A00,507425,Fischer-Grunski; Eva K,19,0,20,1
1714206774561,LIIT 5AS,A00,507427,Carnelos; Chiara,20,0,20,0
1714206775585,LIIT 5BS,A00,507430,Carnelos; Chiara,20,0,20,0
1714206776613,LIIT 5CS,A00,507432,Carnelos; Chiara,20,0,20,0
1714206777640,LISP 5A,A00,507541,Munoz Sanchez; Alicia,11,0,20,9
1714206778667,LISP 5B,A00,507671,Munoz Sanchez; Alicia,9,0,20,11
1714206779692,LISP 5C,A00,507696,Munoz Sanchez; Alicia,9,0,20,11
1714206780717,MAE 197,001,528363,Boechler; Nicholas Sebastia,9998,0,9999,1
1714206781744,MATH 197,001,523477,Kedlaya; Kiran S.,9996,0,9999,3
1714206781744,MATH 197,002,563811,Zhang; Danna,9995,0,9999,4
1714206781744,MATH 197,003,628552,Dumitriu; Ioana,9998,0,9999,1
1714206782774,MCWP 40R,A00,518780,Staff,5,0,20,15
1714206782774,MCWP 40R,B00,518781,Staff,7,0,20,13
1714206782774,MCWP 40R,C00,518783,Staff,5,0,20,15
1714206783800,MCWP 50R,A00,518791,Staff,0,0,20,20
1714206783800,MCWP 50R,B00,518792,Staff,0,1,20,20
1714206783800,MCWP 50R,C00,518793,Staff,0,1,20,20
1714206783800,MCWP 50R,D00,518794,Staff,0,0,20,20
1714206783800,MCWP 50R,E00,518795,Staff,0,1,20,20
1714206783800,MCWP 50R,F00,518796,Staff,0,0,20,20
1714206783800,MCWP 50R,G00,518797,Staff,0,1,20,20
1714206784831,MMW 12R,A01,514034,Herbst; Matthew,0,1,16,16
1714206784831,MMW 12R,A02,514035,Herbst; Matthew,2,0,16,14
1714206785859,MMW 13R,A01,514037,Staff,0,4,16,16
1714206785859,MMW 13R,A02,514039,Staff,0,2,16,16
1714206785859,MMW 13R,A03,628519,Staff,0,2,16,16
1714206787912,SIO 295LS,A00,523233,Staff,13,0,30,17
1714206788938,SIO 295S,A00,523232,Staff,13,0,30,17
1714206789965,SIOC 290S,A01,637330,Merrifield; Mark A,28,0,30,2
1714206790993,SIOC 291S,A01,637333,Gabriel; Corey John,28,0,30,2
1714206792020,SOCI 117,A01,494376,Staff,0,2,5,5
1714206793046,WES 237B,A00,494380,Staff,9,0,20,11
1714206795115,AESE 279B,A00,494370,Wade; Jon P,0,0,33,33
1714206796143,AIP 197,001,627712,Vespa; Emanuel Ignacio,9998,0,9999,1
1714206797171,ANAR 135S,A00,494369,Braswell; Geoffrey E.,0,0,0,0
1714206798198,BENG 196,001,628496,Engler; Adam J.,9998,0,9999,1
1714206799224,CAT 124RS,A01,519847,Geibel; William,0,0,20,20
1714206800249,CAT 125RS,A01,515971,Geibel; William,0,0,20,20
1714206801280,CLRE 250,A00,511389,Morris; Sheldon,9993,0,9999,6
1714206802307,CLRE 251,A00,507176,Mehta; Ravindra L.,9993,0,9999,6
1714206802307,CLRE 251,B00,511410,Mehta; Ravindra L.,9998,0,9999,1
1714206803332,CLRE 252,A00,507189,Cuomo; Raphael Eduardo,9995,0,9999,4
1714206804358,CLRE 253,A00,507199,Vaida; Florin,9994,0,9999,5
1714206804358,CLRE 253,B00,507202,Vaida; Florin,9999,0,9999,0
1714206805383,CLRE 259,A00,507211,Patel; Hemal,9996,0,9999,3
1714206806411,CLRE 260,A00,507221,Cuomo; Raphael Eduardo,9999,0,9999,0
1714206807439,CLRE 297,001,507242,Cuomo; Raphael Eduardo,9999,0,9999,0
1714206808466,COGS 197,001,638244,Voytek; Bradley Thomas,9999,0,9999,0
1714206809492,CSE 191,A00,516875,Minnes Kemp; Mor Mia,9993,0,9999,6
1714206810518,CSE 197,001,637388,Minnes Kemp; Mor Mia,9998,0,9999,1
1714206811541,CSS 201S,A01,494383,Staff,35,0,35,0
1714206812567,CSS 202S,A01,494387,Staff,35,0,35,0
1714206813594,DSC 197,001,628532,Eldridge; Justin Matthew,9996,0,9999,3
1714206814620,EAP 100,A00,516065,Staff,9797,0,9999,202
1714206815649,ECE 45,A01,507414,Staff,33,0,60,27
1714206817702,ECE 111,A01,507420,Staff,21,0,50,29
1714206818728,ECE 197,001,548057,Sievenpiper; Daniel F.,9994,0,9999,5
1714206819755,EDS 115,A00,507243,Choi; Bailey Miyeon,12,0,28,16
1714206820783,EDS 117,A01,494379,Staff,0,1,30,30
1714206821810,EDS 125,A00,507246,Hopkins; Megan Beth,12,0,30,18
1714206822839,EDS 128A,A01,507264,Fargason; Sharon Gayle,14,0,26,12
1714206823876,EDS 128B,A01,507293,Pappas; Elizabeth,18,0,30,12
1714206824902,EDS 139,A00,507294,Fargason; Sharon Gayle,18,0,30,12
1714206824902,EDS 139,B00,507313,Pappas; Elizabeth,15,0,30,15
1714206825928,EDS 201,A00,507315,Staff,13,0,30,17
1714206826954,EDS 203,A01,507317,Halter; Christopher P.,12,0,30,18
1714206827983,EDS 204R,A01,507319,Halter; Christopher P.,0,3,30,30
1714206827983,EDS 204R,B01,507331,Heinzman; Erica M.,17,0,30,13
1714206829012,EDS 206R,A00,507332,Staff,0,4,30,30
1714206829012,EDS 206R,B00,507343,Staff,18,0,30,12
1714206830042,EDS 250,A00,507344,Hemans; Patricia Ann Benitez,22,0,40,18
1714206831070,EDS 281,A00,507345,Daly; Alan J.,18,0,18,0
1714206832098,EDS 284,A00,507350,Daly; Alan J.,16,0,16,0
1714206833123,EDS 286,A00,507359,Fine; Sarah,18,0,18,0
1714206834150,EDS 289C,A01,507361,Daly; Alan J.,18,0,18,0
1714206835176,EDS 290,A00,507366,Hofstetter; Carolyn,15,0,15,0
1714206836204,LIGM 5A,A00,507421,Fischer-Grunski; Eva K,18,0,20,2
1714206837229,LIGM 5B,A00,507423,Fischer-Grunski; Eva K,19,0,20,1
1714206838253,LIGM 5C,A00,507425,Fischer-Grunski; Eva K,19,0,20,1
1714206839278,LIIT 5AS,A00,507427,Carnelos; Chiara,20,0,20,0
1714206840303,LIIT 5BS,A00,507430,Carnelos; Chiara,20,0,20,0
1714206841333,LIIT 5CS,A00,507432,Carnelos; Chiara,20,0,20,0
1714206842363,LISP 5A,A00,507541,Munoz Sanchez; Alicia,11,0,20,9
1714206843392,LISP 5B,A00,507671,Munoz Sanchez; Alicia,9,0,20,11
1714206844418,LISP 5C,A00,507696,Munoz Sanchez; Alicia,9,0,20,11
1714206845447,MAE 197,001,528363,Boechler; Nicholas Sebastia,9998,0,9999,1
1714206846473,MATH 197,001,523477,Kedlaya; Kiran S.,9996,0,9999,3
1714206846473,MATH 197,002,563811,Zhang; Danna,9995,0,9999,4
1714206846473,MATH 197,003,628552,Dumitriu; Ioana,9998,0,9999,1
1714206847503,MCWP 40R,A00,518780,Staff,5,0,20,15
1714206847503,MCWP 40R,B00,518781,Staff,7,0,20,13
1714206847503,MCWP 40R,C00,518783,Staff,5,0,20,15
1714206848531,MCWP 50R,A00,518791,Staff,0,0,20,20
1714206848531,MCWP 50R,B00,518792,Staff,0,1,20,20
1714206848531,MCWP 50R,C00,518793,Staff,0,1,20,20
1714206848531,MCWP 50R,D00,518794,Staff,0,0,20,20
1714206848531,MCWP 50R,E00,518795,Staff,0,1,20,20
1714206848531,MCWP 50R,F00,518796,Staff,0,0,20,20
1714206848531,MCWP 50R,G00,518797,Staff,0,1,20,20
1714206849560,MMW 12R,A01,514034,Herbst; Matthew,0,1,16,16
1714206849560,MMW 12R,A02,514035,Herbst; Matthew,2,0,16,14
1714206850586,MMW 13R,A01,514037,Staff,0,4,16,16
1714206850586,MMW 13R,A02,514039,Staff,0,2,16,16
1714206850586,MMW 13R,A03,628519,Staff,0,2,16,16
1714206852637,SIO 295LS,A00,523233,Staff,13,0,30,17
1714206853665,SIO 295S,A00,523232,Staff,13,0,30,17
1714206854750,SIOC 290S,A01,637330,Merrifield; Mark A,28,0,30,2
1714206855781,SIOC 291S,A01,637333,Gabriel; Corey John,28,0,30,2
1714206856806,SOCI 117,A01,494376,Staff,0,2,5,5
1714206857835,WES 237B,A00,494380,Staff,9,0,20,11
1714206859898,AESE 279B,A00,494370,Wade; Jon P,0,0,33,33
1714206860923,AIP 197,001,627712,Vespa; Emanuel Ignacio,9998,0,9999,1
1714206861949,ANAR 135S,A00,494369,Braswell; Geoffrey E.,0,0,0,0
1714206862975,BENG 196,001,628496,Engler; Adam J.,9998,0,9999,1
1714206864001,CAT 124RS,A01,519847,Geibel; William,0,0,20,20
1714206865027,CAT 125RS,A01,515971,Geibel; William,0,0,20,20
1714206866053,CLRE 250,A00,511389,Morris; Sheldon,9993,0,9999,6
1714206867081,CLRE 251,A00,507176,Mehta; Ravindra L.,9993,0,9999,6
1714206867081,CLRE 251,B00,511410,Mehta; Ravindra L.,9998,0,9999,1
1714206868108,CLRE 252,A00,507189,Cuomo; Raphael Eduardo,9995,0,9999,4
1714206869135,CLRE 253,A00,507199,Vaida; Florin,9994,0,9999,5
1714206869135,CLRE 253,B00,507202,Vaida; Florin,9999,0,9999,0
1714206870162,CLRE 259,A00,507211,Patel; Hemal,9996,0,9999,3
1714206871188,CLRE 260,A00,507221,Cuomo; Raphael Eduardo,9999,0,9999,0
1714206872212,CLRE 297,001,507242,Cuomo; Raphael Eduardo,9999,0,9999,0
1714206873238,COGS 197,001,638244,Voytek; Bradley Thomas,9999,0,9999,0
1714206874269,CSE 191,A00,516875,Minnes Kemp; Mor Mia,9993,0,9999,6
1714206875300,CSE 197,001,637388,Minnes Kemp; Mor Mia,9998,0,9999,1
1714206876329,CSS 201S,A01,494383,Staff,35,0,35,0
1714206877355,CSS 202S,A01,494387,Staff,35,0,35,0
1714206878385,DSC 197,001,628532,Eldridge; Justin Matthew,9996,0,9999,3
1714206879411,EAP 100,A00,516065,Staff,9797,0,9999,202
1714206880439,ECE 45,A01,507414,Staff,33,0,60,27
1714206882497,ECE 111,A01,507420,Staff,21,0,50,29
1714206883530,ECE 197,001,548057,Sievenpiper; Daniel F.,9994,0,9999,5
1714206884561,EDS 115,A00,507243,Choi; Bailey Miyeon,12,0,28,16
1714206885588,EDS 117,A01,494379,Staff,0,1,30,30
1714206886617,EDS 125,A00,507246,Hopkins; Megan Beth,12,0,30,18
1714206887643,EDS 128A,A01,507264,Fargason; Sharon Gayle,14,0,26,12
1714206888668,EDS 128B,A01,507293,Pappas; Elizabeth,18,0,30,12
1714206889697,EDS 139,A00,507294,Fargason; Sharon Gayle,18,0,30,12
1714206889697,EDS 139,B00,507313,Pappas; Elizabeth,15,0,30,15
1714206890725,EDS 201,A00,507315,Staff,13,0,30,17
1714206891753,EDS 203,A01,507317,Halter; Christopher P.,12,0,30,18
1714206892785,EDS 204R,A01,507319,Halter; Christopher P.,0,3,30,30
1714206892785,EDS 204R,B01,507331,Heinzman; Erica M.,17,0,30,13
1714206893815,EDS 206R,A00,507332,Staff,0,4,30,30
1714206893815,EDS 206R,B00,507343,Staff,18,0,30,12
1714206894841,EDS 250,A00,507344,Hemans; Patricia Ann Benitez,22,0,40,18
1714206895867,EDS 281,A00,507345,Daly; Alan J.,18,0,18,0
1714206896894,EDS 284,A00,507350,Daly; Alan J.,16,0,16,0
1714206897923,EDS 286,A00,507359,Fine; Sarah,18,0,18,0
1714206898955,EDS 289C,A01,507361,Daly; Alan J.,18,0,18,0
1714206899981,EDS 290,A00,507366,Hofstetter; Carolyn,15,0,15,0
1714206901013,LIGM 5A,A00,507421,Fischer-Grunski; Eva K,18,0,20,2
1714206902038,LIGM 5B,A00,507423,Fischer-Grunski; Eva K,19,0,20,1
1714206903070,LIGM 5C,A00,507425,Fischer-Grunski; Eva K,19,0,20,1
1714206904097,LIIT 5AS,A00,507427,Carnelos; Chiara,20,0,20,0
1714206905124,LIIT 5BS,A00,507430,Carnelos; Chiara,20,0,20,0
1714206906149,LIIT 5CS,A00,507432,Carnelos; Chiara,20,0,20,0
1714206907175,LISP 5A,A00,507541,Munoz Sanchez; Alicia,11,0,20,9
1714206908200,LISP 5B,A00,507671,Munoz Sanchez; Alicia,9,0,20,11
1714206909225,LISP 5C,A00,507696,Munoz Sanchez; Alicia,9,0,20,11
1714206910251,MAE 197,001,528363,Boechler; Nicholas Sebastia,9998,0,9999,1
1714206911278,MATH 197,001,523477,Kedlaya; Kiran S.,9996,0,9999,3
1714206911278,MATH 197,002,563811,Zhang; Danna,9995,0,9999,4
1714206911278,MATH 197,003,628552,Dumitriu; Ioana,9998,0,9999,1
1714206912303,MCWP 40R,A00,518780,Staff,5,0,20,15
1714206912303,MCWP 40R,B00,518781,Staff,7,0,20,13
1714206912303,MCWP 40R,C00,518783,Staff,5,0,20,15
1714206913330,MCWP 50R,A00,518791,Staff,0,0,20,20
1714206913330,MCWP 50R,B00,518792,Staff,0,1,20,20
1714206913330,MCWP 50R,C00,518793,Staff,0,1,20,20
1714206913330,MCWP 50R,D00,518794,Staff,0,0,20,20
1714206913330,MCWP 50R,E00,518795,Staff,0,1,20,20
1714206913330,MCWP 50R,F00,518796,Staff,0,0,20,20
1714206913330,MCWP 50R,G00,518797,Staff,0,1,20,20
1714206914357,MMW 12R,A01,514034,Herbst; Matthew,0,1,16,16
1714206914357,MMW 12R,A02,514035,Herbst; Matthew,2,0,16,14
1714206915383,MMW 13R,A01,514037,Staff,0,4,16,16
1714206915383,MMW 13R,A02,514039,Staff,0,2,16,16
1714206915383,MMW 13R,A03,628519,Staff,0,2,16,16
1714206917438,SIO 295LS,A00,523233,Staff,13,0,30,17
1714206918463,SIO 295S,A00,523232,Staff,13,0,30,17
1714206919489,SIOC 290S,A01,637330,Merrifield; Mark A,28,0,30,2
1714206920515,SIOC 291S,A01,637333,Gabriel; Corey John,28,0,30,2
1714206921544,SOCI 117,A01,494376,Staff,0,2,5,5
1714206922573,WES 237B,A00,494380,Staff,9,0,20,11
1714206924645,AESE 279B,A00,494370,Wade; Jon P,0,0,33,33
1714206925672,AIP 197,001,627712,Vespa; Emanuel Ignacio,9998,0,9999,1
1714206926702,ANAR 135S,A00,494369,Braswell; Geoffrey E.,0,0,0,0
1714206927728,BENG 196,001,628496,Engler; Adam J.,9998,0,9999,1
1714206928754,CAT 124RS,A01,519847,Geibel; William,0,0,20,20
1714206929779,CAT 125RS,A01,515971,Geibel; William,0,0,20,20
1714206930807,CLRE 250,A00,511389,Morris; Sheldon,9993,0,9999,6
1714206931840,CLRE 251,A00,507176,Mehta; Ravindra L.,9993,0,9999,6
1714206931840,CLRE 251,B00,511410,Mehta; Ravindra L.,9998,0,9999,1
1714206932866,CLRE 252,A00,507189,Cuomo; Raphael Eduardo,9995,0,9999,4
1714206933900,CLRE 253,A00,507199,Vaida; Florin,9994,0,9999,5
1714206933900,CLRE 253,B00,507202,Vaida; Florin,9999,0,9999,0
1714206934927,CLRE 259,A00,507211,Patel; Hemal,9996,0,9999,3
1714206935953,CLRE 260,A00,507221,Cuomo; Raphael Eduardo,9999,0,9999,0
1714206936977,CLRE 297,001,507242,Cuomo; Raphael Eduardo,9999,0,9999,0
1714206938005,COGS 197,001,638244,Voytek; Bradley Thomas,9999,0,9999,0
1714206939034,CSE 191,A00,516875,Minnes Kemp; Mor Mia,9993,0,9999,6
1714206940060,CSE 197,001,637388,Minnes Kemp; Mor Mia,9998,0,9999,1
1714206941088,CSS 201S,A01,494383,Staff,35,0,35,0
1714206942117,CSS 202S,A01,494387,Staff,35,0,35,0
1714206943148,DSC 197,001,628532,Eldridge; Justin Matthew,9996,0,9999,3
1714206944172,EAP 100,A00,516065,Staff,9797,0,9999,202
1714206945206,ECE 45,A01,507414,Staff,33,0,60,27
1714206947262,ECE 111,A01,507420,Staff,21,0,50,29
1714206948291,ECE 197,001,548057,Sievenpiper; Daniel F.,9994,0,9999,5
1714206949318,EDS 115,A00,507243,Choi; Bailey Miyeon,12,0,28,16
1714206950350,EDS 117,A01,494379,Staff,0,1,30,30
1714206951379,EDS 125,A00,507246,Hopkins; Megan Beth,12,0,30,18
1714206952408,EDS 128A,A01,507264,Fargason; Sharon Gayle,14,0,26,12
1714206953432,EDS 128B,A01,507293,Pappas; Elizabeth,18,0,30,12
1714206954457,EDS 139,A00,507294,Fargason; Sharon Gayle,18,0,30,12
1714206954457,EDS 139,B00,507313,Pappas; Elizabeth,15,0,30,15
1714206955486,EDS 201,A00,507315,Staff,13,0,30,17
1714206956512,EDS 203,A01,507317,Halter; Christopher P.,12,0,30,18
1714206957538,EDS 204R,A01,507319,Halter; Christopher P.,0,3,30,30
1714206957538,EDS 204R,B01,507331,Heinzman; Erica M.,17,0,30,13
1714206958621,EDS 206R,A00,507332,Staff,0,4,30,30
1714206958621,EDS 206R,B00,507343,Staff,18,0,30,12
1714206959648,EDS 250,A00,507344,Hemans; Patricia Ann Benitez,22,0,40,18
1714206960674,EDS 281,A00,507345,Daly; Alan J.,18,0,18,0
1714206961701,EDS 284,A00,507350,Daly; Alan J.,16,0,16,0
1714206962729,EDS 286,A00,507359,Fine; Sarah,18,0,18,0
1714206963755,EDS 289C,A01,507361,Daly; Alan J.,18,0,18,0
1714206964781,EDS 290,A00,507366,Hofstetter; Carolyn,15,0,15,0
1714206965808,LIGM 5A,A00,507421,Fischer-Grunski; Eva K,18,0,20,2
1714206966833,LIGM 5B,A00,507423,Fischer-Grunski; Eva K,19,0,20,1
1714206967859,LIGM 5C,A00,507425,Fischer-Grunski; Eva K,19,0,20,1
1714206968885,LIIT 5AS,A00,507427,Carnelos; Chiara,20,0,20,0
1714206969916,LIIT 5BS,A00,507430,Carnelos; Chiara,20,0,20,0
1714206970942,LIIT 5CS,A00,507432,Carnelos; Chiara,20,0,20,0
1714206971967,LISP 5A,A00,507541,Munoz Sanchez; Alicia,11,0,20,9
1714206972993,LISP 5B,A00,507671,Munoz Sanchez; Alicia,9,0,20,11
1714206974018,LISP 5C,A00,507696,Munoz Sanchez; Alicia,9,0,20,11
1714206975044,MAE 197,001,528363,Boechler; Nicholas Sebastia,9998,0,9999,1
1714206976076,MATH 197,001,523477,Kedlaya; Kiran S.,9996,0,9999,3
1714206976076,MATH 197,002,563811,Zhang; Danna,9995,0,9999,4
1714206976076,MATH 197,003,628552,Dumitriu; Ioana,9998,0,9999,1
1714206977108,MCWP 40R,A00,518780,Staff,5,0,20,15
1714206977108,MCWP 40R,B00,518781,Staff,7,0,20,13
1714206977108,MCWP 40R,C00,518783,Staff,5,0,20,15
1714206978133,MCWP 50R,A00,518791,Staff,0,0,20,20
1714206978133,MCWP 50R,B00,518792,Staff,0,1,20,20
1714206978133,MCWP 50R,C00,518793,Staff,0,1,20,20
1714206978133,MCWP 50R,D00,518794,Staff,0,0,20,20
1714206978133,MCWP 50R,E00,518795,Staff,0,1,20,20
1714206978133,MCWP 50R,F00,518796,Staff,0,0,20,20
1714206978133,MCWP 50R,G00,518797,Staff,0,1,20,20
1714206979162,MMW 12R,A01,514034,Herbst; Matthew,0,1,16,16
1714206979162,MMW 12R,A02,514035,Herbst; Matthew,2,0,16,14
1714206980191,MMW 13R,A01,514037,Staff,0,4,16,16
1714206980191,MMW 13R,A02,514039,Staff,0,2,16,16
1714206980191,MMW 13R,A03,628519,Staff,0,2,16,16
1714206982245,SIO 295LS,A00,523233,Staff,13,0,30,17
1714206983274,SIO 295S,A00,523232,Staff,13,0,30,17
1714206984299,SIOC 290S,A01,637330,Merrifield; Mark A,28,0,30,2
1714206985329,SIOC 291S,A01,637333,Gabriel; Corey John,28,0,30,2
1714206986354,SOCI 117,A01,494376,Staff,0,2,5,5
1714206987378,WES 237B,A00,494380,Staff,9,0,20,11
1714206989441,AESE 279B,A00,494370,Wade; Jon P,0,0,33,33
1714206990469,AIP 197,001,627712,Vespa; Emanuel Ignacio,9998,0,9999,1
1714206991494,ANAR 135S,A00,494369,Braswell; Geoffrey E.,0,0,0,0
1714206992519,BENG 196,001,628496,Engler; Adam J.,9998,0,9999,1
1714206993545,CAT 124RS,A01,519847,Geibel; William,0,0,20,20
1714206994571,CAT 125RS,A01,515971,Geibel; William,0,0,20,20
1714206995597,CLRE 250,A00,511389,Morris; Sheldon,9993,0,9999,6
1714206996627,CLRE 251,A00,507176,Mehta; Ravindra L.,9993,0,9999,6
1714206996627,CLRE 251,B00,511410,Mehta; Ravindra L.,9998,0,9999,1
1714206997657,CLRE 252,A00,507189,Cuomo; Raphael Eduardo,9995,0,9999,4
1714206998688,CLRE 253,A00,507199,Vaida; Florin,9994,0,9999,5
1714206998688,CLRE 253,B00,507202,Vaida; Florin,9999,0,9999,0
1714206999716,CLRE 259,A00,507211,Patel; Hemal,9996,0,9999,3
1714207000745,CLRE 260,A00,507221,Cuomo; Raphael Eduardo,9999,0,9999,0
1714207001774,CLRE 297,001,507242,Cuomo; Raphael Eduardo,9999,0,9999,0
1714207002798,COGS 197,001,638244,Voytek; Bradley Thomas,9999,0,9999,0
1714207003827,CSE 191,A00,516875,Minnes Kemp; Mor Mia,9993,0,9999,6
1714207004855,CSE 197,001,637388,Minnes Kemp; Mor Mia,9998,0,9999,1
1714207005886,CSS 201S,A01,494383,Staff,35,0,35,0
1714207006913,CSS 202S,A01,494387,Staff,35,0,35,0
1714207007942,DSC 197,001,628532,Eldridge; Justin Matthew,9996,0,9999,3
1714207008969,EAP 100,A00,516065,Staff,9797,0,9999,202
1714207009995,ECE 45,A01,507414,Staff,33,0,60,27
1714207012047,ECE 111,A01,507420,Staff,21,0,50,29
1714207013075,ECE 197,001,548057,Sievenpiper; Daniel F.,9994,0,9999,5
1714207014101,EDS 115,A00,507243,Choi; Bailey Miyeon,12,0,28,16
1714207015129,EDS 117,A01,494379,Staff,0,1,30,30
1714207016159,EDS 125,A00,507246,Hopkins; Megan Beth,12,0,30,18
1714207017185,EDS 128A,A01,507264,Fargason; Sharon Gayle,14,0,26,12
1714207018211,EDS 128B,A01,507293,Pappas; Elizabeth,18,0,30,12
1714207019239,EDS 139,A00,507294,Fargason; Sharon Gayle,18,0,30,12
1714207019239,EDS 139,B00,507313,Pappas; Elizabeth,15,0,30,15
1714207020264,EDS 201,A00,507315,Staff,13,0,30,17
1714207021293,EDS 203,A01,507317,Halter; Christopher P.,12,0,30,18
1714207022320,EDS 204R,A01,507319,Halter; Christopher P.,0,3,30,30
1714207022320,EDS 204R,B01,507331,Heinzman; Erica M.,17,0,30,13
1714207023348,EDS 206R,A00,507332,Staff,0,4,30,30
1714207023348,EDS 206R,B00,507343,Staff,18,0,30,12
1714207024374,EDS 250,A00,507344,Hemans; Patricia Ann Benitez,22,0,40,18
1714207025401,EDS 281,A00,507345,Daly; Alan J.,18,0,18,0
1714207026429,EDS 284,A00,507350,Daly; Alan J.,16,0,16,0
1714207027457,EDS 286,A00,507359,Fine; Sarah,18,0,18,0
1714207028486,EDS 289C,A01,507361,Daly; Alan J.,18,0,18,0
1714207029514,EDS 290,A00,507366,Hofstetter; Carolyn,15,0,15,0
1714207030544,LIGM 5A,A00,507421,Fischer-Grunski; Eva K,18,0,20,2
1714207031574,LIGM 5B,A00,507423,Fischer-Grunski; Eva K,19,0,20,1
1714207032602,LIGM 5C,A00,507425,Fischer-Grunski; Eva K,19,0,20,1
1714207033628,LIIT 5AS,A00,507427,Carnelos; Chiara,20,0,20,0
1714207034653,LIIT 5BS,A00,507430,Carnelos; Chiara,20,0,20,0
1714207035682,LIIT 5CS,A00,507432,Carnelos; Chiara,20,0,20,0
1714207036713,LISP 5A,A00,507541,Munoz Sanchez; Alicia,11,0,20,9
1714207037739,LISP 5B,A00,507671,Munoz Sanchez; Alicia,9,0,20,11
1714207038766,LISP 5C,A00,507696,Munoz Sanchez; Alicia,9,0,20,11
1714207039792,MAE 197,001,528363,Boechler; Nicholas Sebastia,9998,0,9999,1
1714207040819,MATH 197,001,523477,Kedlaya; Kiran S.,9996,0,9999,3
1714207040819,MATH 197,002,563811,Zhang; Danna,9995,0,9999,4
1714207040819,MATH 197,003,628552,Dumitriu; Ioana,9998,0,9999,1
1714207041846,MCWP 40R,A00,518780,Staff,5,0,20,15
1714207041846,MCWP 40R,B00,518781,Staff,7,0,20,13
1714207041846,MCWP 40R,C00,518783,Staff,5,0,20,15
1714207042871,MCWP 50R,A00,518791,Staff,0,0,20,20
1714207042871,MCWP 50R,B00,518792,Staff,0,1,20,20
1714207042871,MCWP 50R,C00,518793,Staff,0,1,20,20
1714207042871,MCWP 50R,D00,518794,Staff,0,0,20,20
1714207042871,MCWP 50R,E00,518795,Staff,0,1,20,20
1714207042871,MCWP 50R,F00,518796,Staff,0,0,20,20
1714207042871,MCWP 50R,G00,518797,Staff,0,1,20,20
1714207043902,MMW 12R,A01,514034,Herbst; Matthew,0,1,16,16
1714207043902,MMW 12R,A02,514035,Herbst; Matthew,2,0,16,14
1714207044929,MMW 13R,A01,514037,Staff,0,4,16,16
1714207044929,MMW 13R,A02,514039,Staff,0,2,16,16
1714207044929,MMW 13R,A03,628519,Staff,0,2,16,16
1714207046985,SIO 295LS,A00,523233,Staff,13,0,30,17
1714207048015,SIO 295S,A00,523232,Staff,13,0,30,17
1714207049042,SIOC 290S,A01,637330,Merrifield; Mark A,28,0,30,2
1714207050071,SIOC 291S,A01,637333,Gabriel; Corey John,28,0,30,2
1714207051097,SOCI 117,A01,494376,Staff,0,2,5,5
1714207052123,WES 237B,A00,494380,Staff,9,0,20,11
1714207054190,AESE 279B,A00,494370,Wade; Jon P,0,0,33,33
1714207055217,AIP 197,001,627712,Vespa; Emanuel Ignacio,9998,0,9999,1
1714207056240,ANAR 135S,A00,494369,Braswell; Geoffrey E.,0,0,0,0
1714207057266,BENG 196,001,628496,Engler; Adam J.,9998,0,9999,1
1714207058291,CAT 124RS,A01,519847,Geibel; William,0,0,20,20
1714207059319,CAT 125RS,A01,515971,Geibel; William,0,0,20,20
1714207060348,CLRE 250,A00,511389,Morris; Sheldon,9993,0,9999,6
1714207061379,CLRE 251,A00,507176,Mehta; Ravindra L.,9993,0,9999,6
1714207061379,CLRE 251,B00,511410,Mehta; Ravindra L.,9998,0,9999,1
1714207062459,CLRE 252,A00,507189,Cuomo; Raphael Eduardo,9995,0,9999,4
1714207063489,CLRE 253,A00,507199,Vaida; Florin,9994,0,9999,5
1714207063489,CLRE 253,B00,507202,Vaida; Florin,9999,0,9999,0
1714207064515,CLRE 259,A00,507211,Patel; Hemal,9996,0,9999,3
1714207065542,CLRE 260,A00,507221,Cuomo; Raphael Eduardo,9999,0,9999,0
1714207066568,CLRE 297,001,507242,Cuomo; Raphael Eduardo,9999,0,9999,0
1714207067593,COGS 197,001,638244,Voytek; Bradley Thomas,9999,0,9999,0
1714207068623,CSE 191,A00,516875,Minnes Kemp; Mor Mia,9993,0,9999,6
1714207069648,CSE 197,001,637388,Minnes Kemp; Mor Mia,9998,0,9999,1
1714207070673,CSS 201S,A01,494383,Staff,35,0,35,0
1714207071703,CSS 202S,A01,494387,Staff,35,0,35,0
1714207072729,DSC 197,001,628532,Eldridge; Justin Matthew,9996,0,9999,3
1714207073754,EAP 100,A00,516065,Staff,9797,0,9999,202
1714207074782,ECE 45,A01,507414,Staff,33,0,60,27
1714207076836,ECE 111,A01,507420,Staff,21,0,50,29
1714207077861,ECE 197,001,548057,Sievenpiper; Daniel F.,9994,0,9999,5
1714207078887,EDS 115,A00,507243,Choi; Bailey Miyeon,12,0,28,16
1714207079913,EDS 117,A01,494379,Staff,0,1,30,30
1714207080939,EDS 125,A00,507246,Hopkins; Megan Beth,12,0,30,18
1714207081965,EDS 128A,A01,507264,Fargason; Sharon Gayle,14,0,26,12
1714207082991,EDS 128B,A01,507293,Pappas; Elizabeth,18,0,30,12
1714207084017,EDS 139,A00,507294,Fargason; Sharon Gayle,18,0,30,12
1714207084017,EDS 139,B00,507313,Pappas; Elizabeth,15,0,30,15
1714207085045,EDS 201,A00,507315,Staff,13,0,30,17
1714207086070,EDS 203,A01,507317,Halter; Christopher P.,12,0,30,18
1714207087096,EDS 204R,A01,507319,Halter; Christopher P.,0,3,30,30
1714207087096,EDS 204R,B01,507331,Heinzman; Erica M.,17,0,30,13
1714207088121,EDS 206R,A00,507332,Staff,0,4,30,30
1714207088121,EDS 206R,B00,507343,Staff,18,0,30,12
1714207089146,EDS 250,A00,507344,Hemans; Patricia Ann Benitez,22,0,40,18
1714207090174,EDS 281,A00,507345,Daly; Alan J.,18,0,18,0
1714207091199,EDS 284,A00,507350,Daly; Alan J.,16,0,16,0
1714207092224,EDS 286,A00,507359,Fine; Sarah,18,0,18,0
1714207093252,EDS 289C,A01,507361,Daly; Alan J.,18,0,18,0
1714207094277,EDS 290,A00,507366,Hofstetter; Carolyn,15,0,15,0
1714207095304,LIGM 5A,A00,507421,Fischer-Grunski; Eva K,18,0,20,2
1714207096333,LIGM 5B,A00,507423,Fischer-Grunski; Eva K,19,0,20,1
1714207097360,LIGM 5C,A00,507425,Fischer-Grunski; Eva K,19,0,20,1
1714207098389,LIIT 5AS,A00,507427,Carnelos; Chiara,20,0,20,0
1714207099415,LIIT 5BS,A00,507430,Carnelos; Chiara,20,0,20,0
1714207100441,LIIT 5CS,A00,507432,Carnelos; Chiara,20,0,20,0
1714207101467,LISP 5A,A00,507541,Munoz Sanchez; Alicia,11,0,20,9
1714207102495,LISP 5B,A00,507671,Munoz Sanchez; Alicia,9,0,20,11
1714207103521,LISP 5C,A00,507696,Munoz Sanchez; Alicia,9,0,20,11
1714207104547,MAE 197,001,528363,Boechler; Nicholas Sebastia,9998,0,9999,1
1714207105573,MATH 197,001,523477,Kedlaya; Kiran S.,9996,0,9999,3
1714207105573,MATH 197,002,563811,Zhang; Danna,9995,0,9999,4
1714207105573,MATH 197,003,628552,Dumitriu; Ioana,9998,0,9999,1
1714207106599,MCWP 40R,A00,518780,Staff,5,0,20,15
1714207106599,MCWP 40R,B00,518781,Staff,7,0,20,13
1714207106599,MCWP 40R,C00,518783,Staff,5,0,20,15
1714207107624,MCWP 50R,A00,518791,Staff,0,0,20,20
1714207107624,MCWP 50R,B00,518792,Staff,0,1,20,20
1714207107624,MCWP 50R,C00,518793,Staff,0,1,20,20
1714207107624,MCWP 50R,D00,518794,Staff,0,0,20,20
1714207107624,MCWP 50R,E00,518795,Staff,0,1,20,20
1714207107624,MCWP 50R,F00,518796,Staff,0,0,20,20
1714207107624,MCWP 50R,G00,518797,Staff,0,1,20,20
1714207108651,MMW 12R,A01,514034,Herbst; Matthew,0,1,16,16
1714207108651,MMW 12R,A02,514035,Herbst; Matthew,2,0,16,14
1714207109676,MMW 13R,A01,514037,Staff,0,4,16,16
1714207109676,MMW 13R,A02,514039,Staff,0,2,16,16
1714207109676,MMW 13R,A03,628519,Staff,0,2,16,16
1714207111729,SIO 295LS,A00,523233,Staff,13,0,30,17
1714207112755,SIO 295S,A00,523232,Staff,13,0,30,17
1714207113781,SIOC 290S,A01,637330,Merrifield; Mark A,28,0,30,2
1714207114811,SIOC 291S,A01,637333,Gabriel; Corey John,28,0,30,2
1714207115839,SOCI 117,A01,494376,Staff,0,2,5,5
1714207116864,WES 237B,A00,494380,Staff,9,0,20,11
1714207118929,AESE 279B,A00,494370,Wade; Jon P,0,0,33,33
1714207119959,AIP 197,001,627712,Vespa; Emanuel Ignacio,9998,0,9999,1
1714207120984,ANAR 135S,A00,494369,Braswell; Geoffrey E.,0,0,0,0
1714207122007,BENG 196,001,628496,Engler; Adam J.,9998,0,9999,1
1714207123035,CAT 124RS,A01,519847,Geibel; William,0,0,20,20
1714207124060,CAT 125RS,A01,515971,Geibel; William,0,0,20,20
1714207125085,CLRE 250,A00,511389,Morris; Sheldon,9993,0,9999,6
1714207126111,CLRE 251,A00,507176,Mehta; Ravindra L.,9993,0,9999,6
1714207126111,CLRE 251,B00,511410,Mehta; Ravindra L.,9998,0,9999,1
1714207127140,CLRE 252,A00,507189,Cuomo; Raphael Eduardo,9995,0,9999,4
1714207128165,CLRE 253,A00,507199,Vaida; Florin,9994,0,9999,5
1714207128165,CLRE 253,B00,507202,Vaida; Florin,9999,0,9999,0
1714207129193,CLRE 259,A00,507211,Patel; Hemal,9996,0,9999,3
1714207130218,CLRE 260,A00,507221,Cuomo; Raphael Eduardo,9999,0,9999,0
1714207131242,CLRE 297,001,507242,Cuomo; Raphael Eduardo,9999,0,9999,0
1714207132270,COGS 197,001,638244,Voytek; Bradley Thomas,9999,0,9999,0
1714207133294,CSE 191,A00,516875,Minnes Kemp; Mor Mia,9993,0,9999,6
1714207134319,CSE 197,001,637388,Minnes Kemp; Mor Mia,9998,0,9999,1
1714207135345,CSS 201S,A01,494383,Staff,35,0,35,0
1714207136370,CSS 202S,A01,494387,Staff,35,0,35,0
1714207137399,DSC 197,001,628532,Eldridge; Justin Matthew,9996,0,9999,3
1714207138423,EAP 100,A00,516065,Staff,9797,0,9999,202
1714207139454,ECE 45,A01,507414,Staff,33,0,60,27
1714207141503,ECE 111,A01,507420,Staff,21,0,50,29
1714207142533,ECE 197,001,548057,Sievenpiper; Daniel F.,9994,0,9999,5
1714207143562,EDS 115,A00,507243,Choi; Bailey Miyeon,12,0,28,16
1714207144586,EDS 117,A01,494379,Staff,0,1,30,30
1714207145612,EDS 125,A00,507246,Hopkins; Megan Beth,12,0,30,18
1714207146638,EDS 128A,A01,507264,Fargason; Sharon Gayle,14,0,26,12
1714207147664,EDS 128B,A01,507293,Pappas; Elizabeth,18,0,30,12
1714207148691,EDS 139,A00,507294,Fargason; Sharon Gayle,18,0,30,12
1714207148691,EDS 139,B00,507313,Pappas; Elizabeth,15,0,30,15
1714207149719,EDS 201,A00,507315,Staff,13,0,30,17
1714207150746,EDS 203,A01,507317,Halter; Christopher P.,12,0,30,18
1714207151777,EDS 204R,A01,507319,Halter; Christopher P.,0,3,30,30
1714207151777,EDS 204R,B01,507331,Heinzman; Erica M.,17,0,30,13
1714207152805,EDS 206R,A00,507332,Staff,0,4,30,30
1714207152805,EDS 206R,B00,507343,Staff,18,0,30,12
1714207153834,EDS 250,A00,507344,Hemans; Patricia Ann Benitez,22,0,40,18
1714207154860,EDS 281,A00,507345,Daly; Alan J.,18,0,18,0
1714207155884,EDS 284,A00,507350,Daly; Alan J.,16,0,16,0
1714207156910,EDS 286,A00,507359,Fine; Sarah,18,0,18,0
1714207157936,EDS 289C,A01,507361,Daly; Alan J.,18,0,18,0
1714207158966,EDS 290,A00,507366,Hofstetter; Carolyn,15,0,15,0
1714207159993,LIGM 5A,A00,507421,Fischer-Grunski; Eva K,18,0,20,2
1714207161018,LIGM 5B,A00,507423,Fischer-Grunski; Eva K,19,0,20,1
1714207162105,LIGM 5C,A00,507425,Fischer-Grunski; Eva K,19,0,20,1
1714207163131,LIIT 5AS,A00,507427,Carnelos; Chiara,20,0,20,0
1714207164156,LIIT 5BS,A00,507430,Carnelos; Chiara,20,0,20,0
1714207165185,LIIT 5CS,A00,507432,Carnelos; Chiara,20,0,20,0
1714207166268,LISP 5A,A00,507541,Munoz Sanchez; Alicia,11,0,20,9
1714207167298,LISP 5B,A00,507671,Munoz Sanchez; Alicia,9,0,20,11
1714207168323,LISP 5C,A00,507696,Munoz Sanchez; Alicia,9,0,20,11
1714207169350,MAE 197,001,528363,Boechler; Nicholas Sebastia,9998,0,9999,1
1714207170380,MATH 197,001,523477,Kedlaya; Kiran S.,9996,0,9999,3
1714207170380,MATH 197,002,563811,Zhang; Danna,9995,0,9999,4
1714207170380,MATH 197,003,628552,Dumitriu; Ioana,9998,0,9999,1
1714207171405,MCWP 40R,A00,518780,Staff,5,0,20,15
1714207171405,MCWP 40R,B00,518781,Staff,7,0,20,13
1714207171405,MCWP 40R,C00,518783,Staff,5,0,20,15
1714207172433,MCWP 50R,A00,518791,Staff,0,0,20,20
1714207172433,MCWP 50R,B00,518792,Staff,0,1,20,20
1714207172433,MCWP 50R,C00,518793,Staff,0,1,20,20
1714207172433,MCWP 50R,D00,518794,Staff,0,0,20,20
1714207172433,MCWP 50R,E00,518795,Staff,0,1,20,20
1714207172433,MCWP 50R,F00,518796,Staff,0,0,20,20
1714207172433,MCWP 50R,G00,518797,Staff,0,1,20,20
1714207173459,MMW 12R,A01,514034,Herbst; Matthew,0,1,16,16
1714207173459,MMW 12R,A02,514035,Herbst; Matthew,2,0,16,14
1714207174485,MMW 13R,A01,514037,Staff,0,4,16,16
1714207174485,MMW 13R,A02,514039,Staff,0,2,16,16
1714207174485,MMW 13R,A03,628519,Staff,0,2,16,16
1714207176543,SIO 295LS,A00,523233,Staff,13,0,30,17
1714207177569,SIO 295S,A00,523232,Staff,13,0,30,17
1714207178599,SIOC 290S,A01,637330,Merrifield; Mark A,28,0,30,2
1714207179625,SIOC 291S,A01,637333,Gabriel; Corey John,28,0,30,2
1714207180652,SOCI 117,A01,494376,Staff,0,2,5,5
1714207181679,WES 237B,A00,494380,Staff,9,0,20,11
1714207183751,AESE 279B,A00,494370,Wade; Jon P,0,0,33,33
1714207184776,AIP 197,001,627712,Vespa; Emanuel Ignacio,9998,0,9999,1
1714207185802,ANAR 135S,A00,494369,Braswell; Geoffrey E.,0,0,0,0
1714207186828,BENG 196,001,628496,Engler; Adam J.,9998,0,9999,1
1714207187853,CAT 124RS,A01,519847,Geibel; William,0,0,20,20
1714207188881,CAT 125RS,A01,515971,Geibel; William,0,0,20,20
1714207189910,CLRE 250,A00,511389,Morris; Sheldon,9993,0,9999,6
1714207190937,CLRE 251,A00,507176,Mehta; Ravindra L.,9993,0,9999,6
1714207190937,CLRE 251,B00,511410,Mehta; Ravindra L.,9998,0,9999,1
1714207191964,CLRE 252,A00,507189,Cuomo; Raphael Eduardo,9995,0,9999,4
1714207192994,CLRE 253,A00,507199,Vaida; Florin,9994,0,9999,5
1714207192994,CLRE 253,B00,507202,Vaida; Florin,9999,0,9999,0
1714207194018,CLRE 259,A00,507211,Patel; Hemal,9996,0,9999,3
1714207195049,CLRE 260,A00,507221,Cuomo; Raphael Eduardo,9999,0,9999,0
1714207196075,CLRE 297,001,507242,Cuomo; Raphael Eduardo,9999,0,9999,0
1714207197100,COGS 197,001,638244,Voytek; Bradley Thomas,9999,0,9999,0
1714207198126,CSE 191,A00,516875,Minnes Kemp; Mor Mia,9993,0,9999,6
1714207199150,CSE 197,001,637388,Minnes Kemp; Mor Mia,9998,0,9999,1
1714207200176,CSS 201S,A01,494383,Staff,35,0,35,0
1714207201200,CSS 202S,A01,494387,Staff,35,0,35,0
1714207202226,DSC 197,001,628532,Eldridge; Justin Matthew,9996,0,9999,3
1714207203252,EAP 100,A00,516065,Staff,9797,0,9999,202
1714207204281,ECE 45,A01,507414,Staff,33,0,60,27
1714207206334,ECE 111,A01,507420,Staff,21,0,50,29
1714207207360,ECE 197,001,548057,Sievenpiper; Daniel F.,9994,0,9999,5
1714207208388,EDS 115,A00,507243,Choi; Bailey Miyeon,12,0,28,16
1714207209415,EDS 117,A01,494379,Staff,0,1,30,30
1714207210446,EDS 125,A00,507246,Hopkins; Megan Beth,12,0,30,18
1714207211473,EDS 128A,A01,507264,Fargason; Sharon Gayle,14,0,26,12
1714207212502,EDS 128B,A01,507293,Pappas; Elizabeth,18,0,30,12
1714207213530,EDS 139,A00,507294,Fargason; Sharon Gayle,18,0,30,12
1714207213530,EDS 139,B00,507313,Pappas; Elizabeth,15,0,30,15
1714207214556,EDS 201,A00,507315,Staff,13,0,30,17
1714207215586,EDS 203,A01,507317,Halter; Christopher P.,12,0,30,18
1714207216614,EDS 204R,A01,507319,Halter; Christopher P.,0,3,30,30
1714207216614,EDS 204R,B01,507331,Heinzman; Erica M.,17,0,30,13
1714207217642,EDS 206R,A00,507332,Staff,0,4,30,30
1714207217642,EDS 206R,B00,507343,Staff,18,0,30,12
1714207218667,EDS 250,A00,507344,Hemans; Patricia Ann Benitez,22,0,40,18
1714207219691,EDS 281,A00,507345,Daly; Alan J.,18,0,18,0
1714207220720,EDS 284,A00,507350,Daly; Alan J.,16,0,16,0
1714207221749,EDS 286,A00,507359,Fine; Sarah,18,0,18,0
1714207222777,EDS 289C,A01,507361,Daly; Alan J.,18,0,18,0
1714207223803,EDS 290,A00,507366,Hofstetter; Carolyn,15,0,15,0
1714207224835,LIGM 5A,A00,507421,Fischer-Grunski; Eva K,18,0,20,2
1714207225861,LIGM 5B,A00,507423,Fischer-Grunski; Eva K,19,0,20,1
1714207226889,LIGM 5C,A00,507425,Fischer-Grunski; Eva K,19,0,20,1
1714207227914,LIIT 5AS,A00,507427,Carnelos; Chiara,20,0,20,0
1714207228940,LIIT 5BS,A00,507430,Carnelos; Chiara,20,0,20,0
1714207229965,LIIT 5CS,A00,507432,Carnelos; Chiara,20,0,20,0
1714207230995,LISP 5A,A00,507541,Munoz Sanchez; Alicia,11,0,20,9
1714207232021,LISP 5B,A00,507671,Munoz Sanchez; Alicia,9,0,20,11
1714207233047,LISP 5C,A00,507696,Munoz Sanchez; Alicia,9,0,20,11
1714207234072,MAE 197,001,528363,Boechler; Nicholas Sebastia,9998,0,9999,1
1714207235098,MATH 197,001,523477,Kedlaya; Kiran S.,9996,0,9999,3
1714207235098,MATH 197,002,563811,Zhang; Danna,9995,0,9999,4
1714207235098,MATH 197,003,628552,Dumitriu; Ioana,9998,0,9999,1
1714207236122,MCWP 40R,A00,518780,Staff,5,0,20,15
1714207236122,MCWP 40R,B00,518781,Staff,7,0,20,13
1714207236122,MCWP 40R,C00,518783,Staff,5,0,20,15
1714207237149,MCWP 50R,A00,518791,Staff,0,0,20,20
1714207237149,MCWP 50R,B00,518792,Staff,0,1,20,20
1714207237149,MCWP 50R,C00,518793,Staff,0,1,20,20
1714207237149,MCWP 50R,D00,518794,Staff,0,0,20,20
1714207237149,MCWP 50R,E00,518795,Staff,0,1,20,20
1714207237149,MCWP 50R,F00,518796,Staff,0,0,20,20
1714207237149,MCWP 50R,G00,518797,Staff,0,1,20,20
1714207238177,MMW 12R,A01,514034,Herbst; Matthew,0,1,16,16
1714207238177,MMW 12R,A02,514035,Herbst; Matthew,2,0,16,14
1714207239205,MMW 13R,A01,514037,Staff,0,4,16,16
1714207239205,MMW 13R,A02,514039,Staff,0,2,16,16
1714207239205,MMW 13R,A03,628519,Staff,0,2,16,16
1714207241261,SIO 295LS,A00,523233,Staff,13,0,30,17
1714207242289,SIO 295S,A00,523232,Staff,13,0,30,17
1714207243314,SIOC 290S,A01,637330,Merrifield; Mark A,28,0,30,2
1714207244339,SIOC 291S,A01,637333,Gabriel; Corey John,28,0,30,2
1714207245365,SOCI 117,A01,494376,Staff,0,2,5,5
1714207246393,WES 237B,A00,494380,Staff,9,0,20,11
1714207248458,AESE 279B,A00,494370,Wade; Jon P,0,0,33,33
1714207249485,AIP 197,001,627712,Vespa; Emanuel Ignacio,9998,0,9999,1
1714207250510,ANAR 135S,A00,494369,Braswell; Geoffrey E.,0,0,0,0
1714207251537,BENG 196,001,628496,Engler; Adam J.,9998,0,9999,1
1714207252567,CAT 124RS,A01,519847,Geibel; William,0,0,20,20
1714207253592,CAT 125RS,A01,515971,Geibel; William,0,0,20,20
1714207254621,CLRE 250,A00,511389,Morris; Sheldon,9993,0,9999,6
1714207255654,CLRE 251,A00,507176,Mehta; Ravindra L.,9993,0,9999,6
1714207255654,CLRE 251,B00,511410,Mehta; Ravindra L.,9998,0,9999,1
1714207256678,CLRE 252,A00,507189,Cuomo; Raphael Eduardo,9995,0,9999,4
1714207257708,CLRE 253,A00,507199,Vaida; Florin,9994,0,9999,5
1714207257708,CLRE 253,B00,507202,Vaida; Florin,9999,0,9999,0
1714207258738,CLRE 259,A00,507211,Patel; Hemal,9996,0,9999,3
1714207259762,CLRE 260,A00,507221,Cuomo; Raphael Eduardo,9999,0,9999,0
1714207260788,CLRE 297,001,507242,Cuomo; Raphael Eduardo,9999,0,9999,0
1714207261817,COGS 197,001,638244,Voytek; Bradley Thomas,9999,0,9999,0
1714207262843,CSE 191,A00,516875,Minnes Kemp; Mor Mia,9993,0,9999,6
1714207263875,CSE 197,001,637388,Minnes Kemp; Mor Mia,9998,0,9999,1
1714207264919,CSS 201S,A01,494383,Staff,35,0,35,0
1714207265947,CSS 202S,A01,494387,Staff,35,0,35,0
1714207266972,DSC 197,001,628532,Eldridge; Justin Matthew,9996,0,9999,3
1714207267998,EAP 100,A00,516065,Staff,9797,0,9999,202
1714207269023,ECE 45,A01,507414,Staff,33,0,60,27
1714207271132,ECE 111,A01,507420,Staff,21,0,50,29
1714207272160,ECE 197,001,548057,Sievenpiper; Daniel F.,9994,0,9999,5
1714207273188,EDS 115,A00,507243,Choi; Bailey Miyeon,12,0,28,16
1714207274216,EDS 117,A01,494379,Staff,0,1,30,30
1714207275258,EDS 125,A00,507246,Hopkins; Megan Beth,12,0,30,18
1714207276284,EDS 128A,A01,507264,Fargason; Sharon Gayle,14,0,26,12
1714207277316,EDS 128B,A01,507293,Pappas; Elizabeth,18,0,30,12
1714207278345,EDS 139,A00,507294,Fargason; Sharon Gayle,18,0,30,12
1714207278345,EDS 139,B00,507313,Pappas; Elizabeth,15,0,30,15
1714207279370,EDS 201,A00,507315,Staff,13,0,30,17
1714207280402,EDS 203,A01,507317,Halter; Christopher P.,12,0,30,18
1714207281428,EDS 204R,A01,507319,Halter; Christopher P.,0,3,30,30
1714207281428,EDS 204R,B01,507331,Heinzman; Erica M.,17,0,30,13
1714207282452,EDS 206R,A00,507332,Staff,0,4,30,30
1714207282452,EDS 206R,B00,507343,Staff,18,0,30,12
1714207283478,EDS 250,A00,507344,Hemans; Patricia Ann Benitez,22,0,40,18
1714207284504,EDS 281,A00,507345,Daly; Alan J.,18,0,18,0
1714207285529,EDS 284,A00,507350,Daly; Alan J.,16,0,16,0
1714207286557,EDS 286,A00,507359,Fine; Sarah,18,0,18,0
1714207287584,EDS 289C,A01,507361,Daly; Alan J.,18,0,18,0
1714207288609,EDS 290,A00,507366,Hofstetter; Carolyn,15,0,15,0
1714207289634,LIGM 5A,A00,507421,Fischer-Grunski; Eva K,18,0,20,2
1714207290660,LIGM 5B,A00,507423,Fischer-Grunski; Eva K,19,0,20,1
1714207291694,LIGM 5C,A00,507425,Fischer-Grunski; Eva K,19,0,20,1
1714207292723,LIIT 5AS,A00,507427,Carnelos; Chiara,20,0,20,0
1714207293748,LIIT 5BS,A00,507430,Carnelos; Chiara,20,0,20,0
1714207294777,LIIT 5CS,A00,507432,Carnelos; Chiara,20,0,20,0
1714207295802,LISP 5A,A00,507541,Munoz Sanchez; Alicia,11,0,20,9
1714207296827,LISP 5B,A00,507671,Munoz Sanchez; Alicia,9,0,20,11
1714207297858,LISP 5C,A00,507696,Munoz Sanchez; Alicia,9,0,20,11
1714207298884,MAE 197,001,528363,Boechler; Nicholas Sebastia,9998,0,9999,1
1714207299911,MATH 197,001,523477,Kedlaya; Kiran S.,9996,0,9999,3
1714207299911,MATH 197,002,563811,Zhang; Danna,9995,0,9999,4
1714207299911,MATH 197,003,628552,Dumitriu; Ioana,9998,0,9999,1
1714207300939,MCWP 40R,A00,518780,Staff,5,0,20,15
1714207300939,MCWP 40R,B00,518781,Staff,7,0,20,13
1714207300939,MCWP 40R,C00,518783,Staff,5,0,20,15
1714207301964,MCWP 50R,A00,518791,Staff,0,0,20,20
1714207301964,MCWP 50R,B00,518792,Staff,0,1,20,20
1714207301964,MCWP 50R,C00,518793,Staff,0,1,20,20
1714207301964,MCWP 50R,D00,518794,Staff,0,0,20,20
1714207301964,MCWP 50R,E00,518795,Staff,0,1,20,20
1714207301964,MCWP 50R,F00,518796,Staff,0,0,20,20
1714207301964,MCWP 50R,G00,518797,Staff,0,1,20,20
1714207302991,MMW 12R,A01,514034,Herbst; Matthew,0,1,16,16
1714207302991,MMW 12R,A02,514035,Herbst; Matthew,2,0,16,14
1714207304017,MMW 13R,A01,514037,Staff,0,4,16,16
1714207304017,MMW 13R,A02,514039,Staff,0,2,16,16
1714207304017,MMW 13R,A03,628519,Staff,0,2,16,16
1714207306070,SIO 295LS,A00,523233,Staff,13,0,30,17
1714207307100,SIO 295S,A00,523232,Staff,13,0,30,17
1714207308126,SIOC 290S,A01,637330,Merrifield; Mark A,28,0,30,2
1714207309156,SIOC 291S,A01,637333,Gabriel; Corey John,28,0,30,2
1714207310185,SOCI 117,A01,494376,Staff,0,2,5,5
1714207311214,WES 237B,A00,494380,Staff,9,0,20,11
1714207313291,AESE 279B,A00,494370,Wade; Jon P,0,0,33,33
1714207314319,AIP 197,001,627712,Vespa; Emanuel Ignacio,9998,0,9999,1
1714207315348,ANAR 135S,A00,494369,Braswell; Geoffrey E.,0,0,0,0
1714207316377,BENG 196,001,628496,Engler; Adam J.,9998,0,9999,1
1714207317403,CAT 124RS,A01,519847,Geibel; William,0,0,20,20
1714207318428,CAT 125RS,A01,515971,Geibel; William,0,0,20,20
1714207319454,CLRE 250,A00,511389,Morris; Sheldon,9993,0,9999,6
1714207320481,CLRE 251,A00,507176,Mehta; Ravindra L.,9993,0,9999,6
1714207320481,CLRE 251,B00,511410,Mehta; Ravindra L.,9998,0,9999,1
1714207321505,CLRE 252,A00,507189,Cuomo; Raphael Eduardo,9995,0,9999,4
1714207322531,CLRE 253,A00,507199,Vaida; Florin,9994,0,9999,5
1714207322531,CLRE 253,B00,507202,Vaida; Florin,9999,0,9999,0
1714207323563,CLRE 259,A00,507211,Patel; Hemal,9996,0,9999,3
1714207324588,CLRE 260,A00,507221,Cuomo; Raphael Eduardo,9999,0,9999,0
1714207325614,CLRE 297,001,507242,Cuomo; Raphael Eduardo,9999,0,9999,0
1714207326643,COGS 197,001,638244,Voytek; Bradley Thomas,9999,0,9999,0
1714207327671,CSE 191,A00,516875,Minnes Kemp; Mor Mia,9993,0,9999,6
1714207328700,CSE 197,001,637388,Minnes Kemp; Mor Mia,9998,0,9999,1
1714207329728,CSS 201S,A01,494383,Staff,35,0,35,0
1714207330759,CSS 202S,A01,494387,Staff,35,0,35,0
1714207331787,DSC 197,001,628532,Eldridge; Justin Matthew,9996,0,9999,3
1714207332814,EAP 100,A00,516065,Staff,9797,0,9999,202
1714207333842,ECE 45,A01,507414,Staff,33,0,60,27
1714207335900,ECE 111,A01,507420,Staff,21,0,50,29
1714207336930,ECE 197,001,548057,Sievenpiper; Daniel F.,9994,0,9999,5
1714207337956,EDS 115,A00,507243,Choi; Bailey Miyeon,12,0,28,16
1714207338982,EDS 117,A01,494379,Staff,0,1,30,30
1714207340008,EDS 125,A00,507246,Hopkins; Megan Beth,12,0,30,18
1714207341034,EDS 128A,A01,507264,Fargason; Sharon Gayle,14,0,26,12
1714207342060,EDS 128B,A01,507293,Pappas; Elizabeth,18,0,30,12
1714207343089,EDS 139,A00,507294,Fargason; Sharon Gayle,18,0,30,12
1714207343089,EDS 139,B00,507313,Pappas; Elizabeth,15,0,30,15
1714207344117,EDS 201,A00,507315,Staff,13,0,30,17
1714207345142,EDS 203,A01,507317,Halter; Christopher P.,12,0,30,18
1714207346172,EDS 204R,A01,507319,Halter; Christopher P.,0,3,30,30
1714207346172,EDS 204R,B01,507331,Heinzman; Erica M.,17,0,30,13
1714207347200,EDS 206R,A00,507332,Staff,0,4,30,30
1714207347200,EDS 206R,B00,507343,Staff,18,0,30,12
1714207348226,EDS 250,A00,507344,Hemans; Patricia Ann Benitez,22,0,40,18
1714207349254,EDS 281,A00,507345,Daly; Alan J.,18,0,18,0
1714207350280,EDS 284,A00,507350,Daly; Alan J.,16,0,16,0
1714207351306,EDS 286,A00,507359,Fine; Sarah,18,0,18,0
1714207352332,EDS 289C,A01,507361,Daly; Alan J.,18,0,18,0
1714207353359,EDS 290,A00,507366,Hofstetter; Carolyn,15,0,15,0
1714207354386,LIGM 5A,A00,507421,Fischer-Grunski; Eva K,18,0,20,2
1714207355413,LIGM 5B,A00,507423,Fischer-Grunski; Eva K,19,0,20,1
1714207356439,LIGM 5C,A00,507425,Fischer-Grunski; Eva K,19,0,20,1
1714207357463,LIIT 5AS,A00,507427,Carnelos; Chiara,20,0,20,0
1714207358489,LIIT 5BS,A00,507430,Carnelos; Chiara,20,0,20,0
1714207359515,LIIT 5CS,A00,507432,Carnelos; Chiara,20,0,20,0
1714207360540,LISP 5A,A00,507541,Munoz Sanchez; Alicia,11,0,20,9
1714207361564,LISP 5B,A00,507671,Munoz Sanchez; Alicia,9,0,20,11
1714207362595,LISP 5C,A00,507696,Munoz Sanchez; Alicia,9,0,20,11
1714207363621,MAE 197,001,528363,Boechler; Nicholas Sebastia,9998,0,9999,1
1714207364649,MATH 197,001,523477,Kedlaya; Kiran S.,9996,0,9999,3
1714207364649,MATH 197,002,563811,Zhang; Danna,9995,0,9999,4
1714207364649,MATH 197,003,628552,Dumitriu; Ioana,9998,0,9999,1
1714207365675,MCWP 40R,A00,518780,Staff,5,0,20,15
1714207365675,MCWP 40R,B00,518781,Staff,7,0,20,13
1714207365675,MCWP 40R,C00,518783,Staff,5,0,20,15
1714207366701,MCWP 50R,A00,518791,Staff,0,0,20,20
1714207366701,MCWP 50R,B00,518792,Staff,0,1,20,20
1714207366701,MCWP 50R,C00,518793,Staff,0,1,20,20
1714207366701,MCWP 50R,D00,518794,Staff,0,0,20,20
1714207366701,MCWP 50R,E00,518795,Staff,0,1,20,20
1714207366701,MCWP 50R,F00,518796,Staff,0,0,20,20
1714207366701,MCWP 50R,G00,518797,Staff,0,1,20,20
1714207367726,MMW 12R,A01,514034,Herbst; Matthew,0,1,16,16
1714207367726,MMW 12R,A02,514035,Herbst; Matthew,2,0,16,14
1714207368751,MMW 13R,A01,514037,Staff,0,4,16,16
1714207368751,MMW 13R,A02,514039,Staff,0,2,16,16
1714207368751,MMW 13R,A03,628519,Staff,0,2,16,16
1714207370809,SIO 295LS,A00,523233,Staff,13,0,30,17
1714207371834,SIO 295S,A00,523232,Staff,13,0,30,17
1714207372862,SIOC 290S,A01,637330,Merrifield; Mark A,28,0,30,2
1714207373946,SIOC 291S,A01,637333,Gabriel; Corey John,28,0,30,2
1714207374971,SOCI 117,A01,494376,Staff,0,2,5,5
1714207375998,WES 237B,A00,494380,Staff,9,0,20,11
1714207378071,AESE 279B,A00,494370,Wade; Jon P,0,0,33,33
1714207379099,AIP 197,001,627712,Vespa; Emanuel Ignacio,9998,0,9999,1
1714207380124,ANAR 135S,A00,494369,Braswell; Geoffrey E.,0,0,0,0
1714207381150,BENG 196,001,628496,Engler; Adam J.,9998,0,9999,1
1714207382176,CAT 124RS,A01,519847,Geibel; William,0,0,20,20
1714207383203,CAT 125RS,A01,515971,Geibel; William,0,0,20,20
1714207384269,CLRE 250,A00,511389,Morris; Sheldon,9993,0,9999,6
1714207385295,CLRE 251,A00,507176,Mehta; Ravindra L.,9993,0,9999,6
1714207385295,CLRE 251,B00,511410,Mehta; Ravindra L.,9998,0,9999,1
1714207386321,CLRE 252,A00,507189,Cuomo; Raphael Eduardo,9995,0,9999,4
1714207387345,CLRE 253,A00,507199,Vaida; Florin,9994,0,9999,5
1714207387345,CLRE 253,B00,507202,Vaida; Florin,9999,0,9999,0
1714207388375,CLRE 259,A00,507211,Patel; Hemal,9996,0,9999,3
1714207389404,CLRE 260,A00,507221,Cuomo; Raphael Eduardo,9999,0,9999,0
1714207390432,CLRE 297,001,507242,Cuomo; Raphael Eduardo,9999,0,9999,0
1714207391461,COGS 197,001,638244,Voytek; Bradley Thomas,9999,0,9999,0
1714207392490,CSE 191,A00,516875,Minnes Kemp; Mor Mia,9993,0,9999,6
1714207393516,CSE 197,001,637388,Minnes Kemp; Mor Mia,9998,0,9999,1
1714207394545,CSS 201S,A01,494383,Staff,35,0,35,0
1714207395575,CSS 202S,A01,494387,Staff,35,0,35,0
1714207396598,DSC 197,001,628532,Eldridge; Justin Matthew,9996,0,9999,3
1714207397625,EAP 100,A00,516065,Staff,9797,0,9999,202
1714207398651,ECE 45,A01,507414,Staff,33,0,60,27
1714207400703,ECE 111,A01,507420,Staff,21,0,50,29
1714207401732,ECE 197,001,548057,Sievenpiper; Daniel F.,9994,0,9999,5
1714207402760,EDS 115,A00,507243,Choi; Bailey Miyeon,12,0,28,16
1714207403792,EDS 117,A01,494379,Staff,0,1,30,30
1714207404819,EDS 125,A00,507246,Hopkins; Megan Beth,12,0,30,18
1714207405844,EDS 128A,A01,507264,Fargason; Sharon Gayle,14,0,26,12
1714207406870,EDS 128B,A01,507293,Pappas; Elizabeth,18,0,30,12
1714207407895,EDS 139,A00,507294,Fargason; Sharon Gayle,18,0,30,12
1714207407895,EDS 139,B00,507313,Pappas; Elizabeth,15,0,30,15
1714207408923,EDS 201,A00,507315,Staff,13,0,30,17
1714207409952,EDS 203,A01,507317,Halter; Christopher P.,12,0,30,18
1714207410982,EDS 204R,A01,507319,Halter; Christopher P.,0,3,30,30
1714207410982,EDS 204R,B01,507331,Heinzman; Erica M.,17,0,30,13
1714207412011,EDS 206R,A00,507332,Staff,0,4,30,30
1714207412011,EDS 206R,B00,507343,Staff,18,0,30,12
1714207413037,EDS 250,A00,507344,Hemans; Patricia Ann Benitez,22,0,40,18
1714207414062,EDS 281,A00,507345,Daly; Alan J.,18,0,18,0
1714207415087,EDS 284,A00,507350,Daly; Alan J.,16,0,16,0
1714207416112,EDS 286,A00,507359,Fine; Sarah,18,0,18,0
1714207417137,EDS 289C,A01,507361,Daly; Alan J.,18,0,18,0
1714207418167,EDS 290,A00,507366,Hofstetter; Carolyn,15,0,15,0
1714207419197,LIGM 5A,A00,507421,Fischer-Grunski; Eva K,18,0,20,2
1714207420223,LIGM 5B,A00,507423,Fischer-Grunski; Eva K,19,0,20,1
1714207421247,LIGM 5C,A00,507425,Fischer-Grunski; Eva K,19,0,20,1
1714207422277,LIIT 5AS,A00,507427,Carnelos; Chiara,20,0,20,0
1714207423308,LIIT 5BS,A00,507430,Carnelos; Chiara,20,0,20,0
1714207424335,LIIT 5CS,A00,507432,Carnelos; Chiara,20,0,20,0
1714207425362,LISP 5A,A00,507541,Munoz Sanchez; Alicia,11,0,20,9
1714207426394,LISP 5B,A00,507671,Munoz Sanchez; Alicia,9,0,20,11
1714207427424,LISP 5C,A00,507696,Munoz Sanchez; Alicia,9,0,20,11
1714207428454,MAE 197,001,528363,Boechler; Nicholas Sebastia,9998,0,9999,1
1714207429482,MATH 197,001,523477,Kedlaya; Kiran S.,9996,0,9999,3
1714207429482,MATH 197,002,563811,Zhang; Danna,9995,0,9999,4
1714207429482,MATH 197,003,628552,Dumitriu; Ioana,9998,0,9999,1
1714207430508,MCWP 40R,A00,518780,Staff,5,0,20,15
1714207430508,MCWP 40R,B00,518781,Staff,7,0,20,13
1714207430508,MCWP 40R,C00,518783,Staff,5,0,20,15
1714207431539,MCWP 50R,A00,518791,Staff,0,0,20,20
1714207431539,MCWP 50R,B00,518792,Staff,0,1,20,20
1714207431539,MCWP 50R,C00,518793,Staff,0,1,20,20
1714207431539,MCWP 50R,D00,518794,Staff,0,0,20,20
1714207431539,MCWP 50R,E00,518795,Staff,0,1,20,20
1714207431539,MCWP 50R,F00,518796,Staff,0,0,20,20
1714207431539,MCWP 50R,G00,518797,Staff,0,1,20,20
1714207432566,MMW 12R,A01,514034,Herbst; Matthew,0,1,16,16
1714207432566,MMW 12R,A02,514035,Herbst; Matthew,2,0,16,14
1714207433593,MMW 13R,A01,514037,Staff,0,4,16,16
1714207433593,MMW 13R,A02,514039,Staff,0,2,16,16
1714207433593,MMW 13R,A03,628519,Staff,0,2,16,16
1714207435644,SIO 295LS,A00,523233,Staff,13,0,30,17
1714207436670,SIO 295S,A00,523232,Staff,13,0,30,17
1714207437701,SIOC 290S,A01,637330,Merrifield; Mark A,28,0,30,2
1714207438730,SIOC 291S,A01,637333,Gabriel; Corey John,28,0,30,2
1714207439755,SOCI 117,A01,494376,Staff,0,2,5,5
1714207440786,WES 237B,A00,494380,Staff,9,0,20,11
1714207442879,AESE 279B,A00,494370,Wade; Jon P,0,0,33,33
1714207443905,AIP 197,001,627712,Vespa; Emanuel Ignacio,9998,0,9999,1
1714207444931,ANAR 135S,A00,494369,Braswell; Geoffrey E.,0,0,0,0
1714207445956,BENG 196,001,628496,Engler; Adam J.,9998,0,9999,1
1714207446983,CAT 124RS,A01,519847,Geibel; William,0,0,20,20
1714207448010,CAT 125RS,A01,515971,Geibel; William,0,0,20,20
1714207449039,CLRE 250,A00,511389,Morris; Sheldon,9993,0,9999,6
1714207450073,CLRE 251,A00,507176,Mehta; Ravindra L.,9993,0,9999,6
1714207450073,CLRE 251,B00,511410,Mehta; Ravindra L.,9998,0,9999,1
1714207451099,CLRE 252,A00,507189,Cuomo; Raphael Eduardo,9995,0,9999,4
1714207452124,CLRE 253,A00,507199,Vaida; Florin,9994,0,9999,5
1714207452124,CLRE 253,B00,507202,Vaida; Florin,9999,0,9999,0
1714207453150,CLRE 259,A00,507211,Patel; Hemal,9996,0,9999,3
1714207454175,CLRE 260,A00,507221,Cuomo; Raphael Eduardo,9999,0,9999,0
1714207455203,CLRE 297,001,507242,Cuomo; Raphael Eduardo,9999,0,9999,0
1714207456230,COGS 197,001,638244,Voytek; Bradley Thomas,9999,0,9999,0
1714207457257,CSE 191,A00,516875,Minnes Kemp; Mor Mia,9993,0,9999,6
1714207458282,CSE 197,001,637388,Minnes Kemp; Mor Mia,9998,0,9999,1
1714207459310,CSS 201S,A01,494383,Staff,35,0,35,0
1714207460337,CSS 202S,A01,494387,Staff,35,0,35,0
1714207461362,DSC 197,001,628532,Eldridge; Justin Matthew,9996,0,9999,3
1714207462391,EAP 100,A00,516065,Staff,9797,0,9999,202
1714207463423,ECE 45,A01,507414,Staff,33,0,60,27
1714207465483,ECE 111,A01,507420,Staff,21,0,50,29
1714207466508,ECE 197,001,548057,Sievenpiper; Daniel F.,9994,0,9999,5
1714207467540,EDS 115,A00,507243,Choi; Bailey Miyeon,12,0,28,16
1714207468567,EDS 117,A01,494379,Staff,0,1,30,30
1714207469595,EDS 125,A00,507246,Hopkins; Megan Beth,12,0,30,18
1714207470620,EDS 128A,A01,507264,Fargason; Sharon Gayle,14,0,26,12
1714207471650,EDS 128B,A01,507293,Pappas; Elizabeth,18,0,30,12
1714207472676,EDS 139,A00,507294,Fargason; Sharon Gayle,18,0,30,12
1714207472676,EDS 139,B00,507313,Pappas; Elizabeth,15,0,30,15
1714207473701,EDS 201,A00,507315,Staff,13,0,30,17
1714207474729,EDS 203,A01,507317,Halter; Christopher P.,12,0,30,18
1714207475759,EDS 204R,A01,507319,Halter; Christopher P.,0,3,30,30
1714207475759,EDS 204R,B01,507331,Heinzman; Erica M.,17,0,30,13
1714207476786,EDS 206R,A00,507332,Staff,0,4,30,30
1714207476786,EDS 206R,B00,507343,Staff,18,0,30,12
1714207477870,EDS 250,A00,507344,Hemans; Patricia Ann Benitez,22,0,40,18
1714207478897,EDS 281,A00,507345,Daly; Alan J.,18,0,18,0
1714207479922,EDS 284,A00,507350,Daly; Alan J.,16,0,16,0
1714207480950,EDS 286,A00,507359,Fine; Sarah,18,0,18,0
1714207481978,EDS 289C,A01,507361,Daly; Alan J.,18,0,18,0
1714207483005,EDS 290,A00,507366,Hofstetter; Carolyn,15,0,15,0
1714207484033,LIGM 5A,A00,507421,Fischer-Grunski; Eva K,18,0,20,2
1714207485059,LIGM 5B,A00,507423,Fischer-Grunski; Eva K,19,0,20,1
1714207486087,LIGM 5C,A00,507425,Fischer-Grunski; Eva K,19,0,20,1
1714207487114,LIIT 5AS,A00,507427,Carnelos; Chiara,20,0,20,0
1714207488140,LIIT 5BS,A00,507430,Carnelos; Chiara,20,0,20,0
1714207489165,LIIT 5CS,A00,507432,Carnelos; Chiara,20,0,20,0
1714207490195,LISP 5A,A00,507541,Munoz Sanchez; Alicia,11,0,20,9
1714207491224,LISP 5B,A00,507671,Munoz Sanchez; Alicia,9,0,20,11
1714207492250,LISP 5C,A00,507696,Munoz Sanchez; Alicia,9,0,20,11
1714207493276,MAE 197,001,528363,Boechler; Nicholas Sebastia,9998,0,9999,1
1714207494305,MATH 197,001,523477,Kedlaya; Kiran S.,9996,0,9999,3
1714207494305,MATH 197,002,563811,Zhang; Danna,9995,0,9999,4
1714207494305,MATH 197,003,628552,Dumitriu; Ioana,9998,0,9999,1
1714207495332,MCWP 40R,A00,518780,Staff,5,0,20,15
1714207495332,MCWP 40R,B00,518781,Staff,7,0,20,13
1714207495332,MCWP 40R,C00,518783,Staff,5,0,20,15
1714207496359,MCWP 50R,A00,518791,Staff,0,0,20,20
1714207496359,MCWP 50R,B00,518792,Staff,0,1,20,20
1714207496359,MCWP 50R,C00,518793,Staff,0,1,20,20
1714207496359,MCWP 50R,D00,518794,Staff,0,0,20,20
1714207496359,MCWP 50R,E00,518795,Staff,0,1,20,20
1714207496359,MCWP 50R,F00,518796,Staff,0,0,20,20
1714207496359,MCWP 50R,G00,518797,Staff,0,1,20,20
1714207497390,MMW 12R,A01,514034,Herbst; Matthew,0,1,16,16
1714207497390,MMW 12R,A02,514035,Herbst; Matthew,2,0,16,14
1714207498416,MMW 13R,A01,514037,Staff,0,4,16,16
1714207498416,MMW 13R,A02,514039,Staff,0,2,16,16
1714207498416,MMW 13R,A03,628519,Staff,0,2,16,16
1714207500471,SIO 295LS,A00,523233,Staff,13,0,30,17
1714207501497,SIO 295S,A00,523232,Staff,13,0,30,17
1714207502528,SIOC 290S,A01,637330,Merrifield; Mark A,28,0,30,2
1714207503556,SIOC 291S,A01,637333,Gabriel; Corey John,28,0,30,2
1714207504583,SOCI 117,A01,494376,Staff,0,2,5,5
1714207505608,WES 237B,A00,494380,Staff,9,0,20,11
1714207507685,AESE 279B,A00,494370,Wade; Jon P,0,0,33,33
1714207508714,AIP 197,001,627712,Vespa; Emanuel Ignacio,9998,0,9999,1
1714207509739,ANAR 135S,A00,494369,Braswell; Geoffrey E.,0,0,0,0
1714207510765,BENG 196,001,628496,Engler; Adam J.,9998,0,9999,1
1714207511791,CAT 124RS,A01,519847,Geibel; William,0,0,20,20
1714207512819,CAT 125RS,A01,515971,Geibel; William,0,0,20,20
1714207513849,CLRE 250,A00,511389,Morris; Sheldon,9993,0,9999,6
1714207514876,CLRE 251,A00,507176,Mehta; Ravindra L.,9993,0,9999,6
1714207514876,CLRE 251,B00,511410,Mehta; Ravindra L.,9998,0,9999,1
1714207515907,CLRE 252,A00,507189,Cuomo; Raphael Eduardo,9995,0,9999,4
1714207516931,CLRE 253,A00,507199,Vaida; Florin,9994,0,9999,5
1714207516931,CLRE 253,B00,507202,Vaida; Florin,9999,0,9999,0
1714207517962,CLRE 259,A00,507211,Patel; Hemal,9996,0,9999,3
1714207518991,CLRE 260,A00,507221,Cuomo; Raphael Eduardo,9999,0,9999,0
1714207520018,CLRE 297,001,507242,Cuomo; Raphael Eduardo,9999,0,9999,0
1714207521043,COGS 197,001,638244,Voytek; Bradley Thomas,9999,0,9999,0
1714207522069,CSE 191,A00,516875,Minnes Kemp; Mor Mia,9993,0,9999,6
1714207523097,CSE 197,001,637388,Minnes Kemp; Mor Mia,9998,0,9999,1
1714207524123,CSS 201S,A01,494383,Staff,35,0,35,0
1714207525152,CSS 202S,A01,494387,Staff,35,0,35,0
1714207526178,DSC 197,001,628532,Eldridge; Justin Matthew,9996,0,9999,3
1714207527206,EAP 100,A00,516065,Staff,9797,0,9999,202
1714207528234,ECE 45,A01,507414,Staff,33,0,60,27
1714207530286,ECE 111,A01,507420,Staff,21,0,50,29
1714207531524,ECE 197,001,548057,Sievenpiper; Daniel F.,9994,0,9999,5
1714207532555,EDS 115,A00,507243,Choi; Bailey Miyeon,12,0,28,16
1714207533586,EDS 117,A01,494379,Staff,0,1,30,30
1714207534613,EDS 125,A00,507246,Hopkins; Megan Beth,12,0,30,18
1714207535642,EDS 128A,A01,507264,Fargason; Sharon Gayle,14,0,26,12
1714207536668,EDS 128B,A01,507293,Pappas; Elizabeth,18,0,30,12
1714207537694,EDS 139,A00,507294,Fargason; Sharon Gayle,18,0,30,12
1714207537694,EDS 139,B00,507313,Pappas; Elizabeth,15,0,30,15
1714207538718,EDS 201,A00,507315,Staff,13,0,30,17
1714207539748,EDS 203,A01,507317,Halter; Christopher P.,12,0,30,18
1714207540773,EDS 204R,A01,507319,Halter; Christopher P.,0,3,30,30
1714207540773,EDS 204R,B01,507331,Heinzman; Erica M.,17,0,30,13
1714207541801,EDS 206R,A00,507332,Staff,0,4,30,30
1714207541801,EDS 206R,B00,507343,Staff,18,0,30,12
1714207542829,EDS 250,A00,507344,Hemans; Patricia Ann Benitez,22,0,40,18
1714207543865,EDS 281,A00,507345,Daly; Alan J.,18,0,18,0
1714207544893,EDS 284,A00,507350,Daly; Alan J.,16,0,16,0
1714207545925,EDS 286,A00,507359,Fine; Sarah,18,0,18,0
1714207546953,EDS 289C,A01,507361,Daly; Alan J.,18,0,18,0
1714207547983,EDS 290,A00,507366,Hofstetter; Carolyn,15,0,15,0
1714207549016,LIGM 5A,A00,507421,Fischer-Grunski; Eva K,18,0,20,2
1714207550043,LIGM 5B,A00,507423,Fischer-Grunski; Eva K,19,0,20,1
1714207551070,LIGM 5C,A00,507425,Fischer-Grunski; Eva K,19,0,20,1
1714207552100,LIIT 5AS,A00,507427,Carnelos; Chiara,20,0,20,0
1714207553130,LIIT 5BS,A00,507430,Carnelos; Chiara,20,0,20,0
1714207554155,LIIT 5CS,A00,507432,Carnelos; Chiara,20,0,20,0
1714207555182,LISP 5A,A00,507541,Munoz Sanchez; Alicia,11,0,20,9
1714207556213,LISP 5B,A00,507671,Munoz Sanchez; Alicia,9,0,20,11
1714207557237,LISP 5C,A00,507696,Munoz Sanchez; Alicia,9,0,20,11
1714207558269,MAE 197,001,528363,Boechler; Nicholas Sebastia,9998,0,9999,1
1714207559298,MATH 197,001,523477,Kedlaya; Kiran S.,9996,0,9999,3
1714207559298,MATH 197,002,563811,Zhang; Danna,9995,0,9999,4
1714207559298,MATH 197,003,628552,Dumitriu; Ioana,9998,0,9999,1
1714207560327,MCWP 40R,A00,518780,Staff,5,0,20,15
1714207560327,MCWP 40R,B00,518781,Staff,7,0,20,13
1714207560327,MCWP 40R,C00,518783,Staff,5,0,20,15
1714207561359,MCWP 50R,A00,518791,Staff,0,0,20,20
1714207561359,MCWP 50R,B00,518792,Staff,0,1,20,20
1714207561359,MCWP 50R,C00,518793,Staff,0,1,20,20
1714207561359,MCWP 50R,D00,518794,Staff,0,0,20,20
1714207561359,MCWP 50R,E00,518795,Staff,0,1,20,20
1714207561359,MCWP 50R,F00,518796,Staff,0,0,20,20
1714207561359,MCWP 50R,G00,518797,Staff,0,1,20,20
1714207562387,MMW 12R,A01,514034,Herbst; Matthew,0,1,16,16
1714207562387,MMW 12R,A02,514035,Herbst; Matthew,2,0,16,14
1714207563418,MMW 13R,A01,514037,Staff,0,4,16,16
1714207563418,MMW 13R,A02,514039,Staff,0,2,16,16
1714207563418,MMW 13R,A03,628519,Staff,0,2,16,16
1714207565473,SIO 295LS,A00,523233,Staff,13,0,30,17
1714207566499,SIO 295S,A00,523232,Staff,13,0,30,17
1714207567532,SIOC 290S,A01,637330,Merrifield; Mark A,28,0,30,2
1714207568559,SIOC 291S,A01,637333,Gabriel; Corey John,28,0,30,2
1714207569584,SOCI 117,A01,494376,Staff,0,2,5,5
1714207570610,WES 237B,A00,494380,Staff,9,0,20,11
1714207572698,AESE 279B,A00,494370,Wade; Jon P,0,0,33,33
1714207573723,AIP 197,001,627712,Vespa; Emanuel Ignacio,9998,0,9999,1
1714207574750,ANAR 135S,A00,494369,Braswell; Geoffrey E.,0,0,0,0
1714207575780,BENG 196,001,628496,Engler; Adam J.,9998,0,9999,1
1714207576811,CAT 124RS,A01,519847,Geibel; William,0,0,20,20
1714207577836,CAT 125RS,A01,515971,Geibel; William,0,0,20,20
1714207578865,CLRE 250,A00,511389,Morris; Sheldon,9993,0,9999,6
1714207579895,CLRE 251,A00,507176,Mehta; Ravindra L.,9993,0,9999,6
1714207579895,CLRE 251,B00,511410,Mehta; Ravindra L.,9998,0,9999,1
1714207580926,CLRE 252,A00,507189,Cuomo; Raphael Eduardo,9995,0,9999,4
1714207582010,CLRE 253,A00,507199,Vaida; Florin,9994,0,9999,5
1714207582010,CLRE 253,B00,507202,Vaida; Florin,9999,0,9999,0
1714207583038,CLRE 259,A00,507211,Patel; Hemal,9996,0,9999,3
1714207584065,CLRE 260,A00,507221,Cuomo; Raphael Eduardo,9999,0,9999,0
1714207585090,CLRE 297,001,507242,Cuomo; Raphael Eduardo,9999,0,9999,0
1714207586117,COGS 197,001,638244,Voytek; Bradley Thomas,9999,0,9999,0
1714207587146,CSE 191,A00,516875,Minnes Kemp; Mor Mia,9993,0,9999,6
1714207588175,CSE 197,001,637388,Minnes Kemp; Mor Mia,9998,0,9999,1
1714207589206,CSS 201S,A01,494383,Staff,35,0,35,0
1714207590236,CSS 202S,A01,494387,Staff,35,0,35,0
1714207591265,DSC 197,001,628532,Eldridge; Justin Matthew,9996,0,9999,3
1714207592294,EAP 100,A00,516065,Staff,9797,0,9999,202
1714207593323,ECE 45,A01,507414,Staff,33,0,60,27
1714207595378,ECE 111,A01,507420,Staff,21,0,50,29
1714207596407,ECE 197,001,548057,Sievenpiper; Daniel F.,9994,0,9999,5
1714207597435,EDS 115,A00,507243,Choi; Bailey Miyeon,12,0,28,16
1714207598465,EDS 117,A01,494379,Staff,0,1,30,30
1714207599494,EDS 125,A00,507246,Hopkins; Megan Beth,12,0,30,18
1714207600521,EDS 128A,A01,507264,Fargason; Sharon Gayle,14,0,26,12
1714207601547,EDS 128B,A01,507293,Pappas; Elizabeth,18,0,30,12
1714207602572,EDS 139,A00,507294,Fargason; Sharon Gayle,18,0,30,12
1714207602572,EDS 139,B00,507313,Pappas; Elizabeth,15,0,30,15
1714207603602,EDS 201,A00,507315,Staff,13,0,30,17
1714207604634,EDS 203,A01,507317,Halter; Christopher P.,12,0,30,18
1714207605663,EDS 204R,A01,507319,Halter; Christopher P.,0,3,30,30
1714207605663,EDS 204R,B01,507331,Heinzman; Erica M.,17,0,30,13
1714207606688,EDS 206R,A00,507332,Staff,0,4,30,30
1714207606688,EDS 206R,B00,507343,Staff,18,0,30,12
1714207607716,EDS 250,A00,507344,Hemans; Patricia Ann Benitez,22,0,40,18
1714207608742,EDS 281,A00,507345,Daly; Alan J.,18,0,18,0
1714207609771,EDS 284,A00,507350,Daly; Alan J.,16,0,16,0
1714207610800,EDS 286,A00,507359,Fine; Sarah,18,0,18,0
1714207611825,EDS 289C,A01,507361,Daly; Alan J.,18,0,18,0
1714207612855,EDS 290,A00,507366,Hofstetter; Carolyn,15,0,15,0
1714207613887,LIGM 5A,A00,507421,Fischer-Grunski; Eva K,18,0,20,2
1714207614917,LIGM 5B,A00,507423,Fischer-Grunski; Eva K,19,0,20,1
1714207615948,LIGM 5C,A00,507425,Fischer-Grunski; Eva K,19,0,20,1
1714207616978,LIIT 5AS,A00,507427,Carnelos; Chiara,20,0,20,0
1714207618003,LIIT 5BS,A00,507430,Carnelos; Chiara,20,0,20,0
1714207619032,LIIT 5CS,A00,507432,Carnelos; Chiara,20,0,20,0
1714207620064,LISP 5A,A00,507541,Munoz Sanchez; Alicia,11,0,20,9
1714207621092,LISP 5B,A00,507671,Munoz Sanchez; Alicia,9,0,20,11
1714207622118,LISP 5C,A00,507696,Munoz Sanchez; Alicia,9,0,20,11
1714207623144,MAE 197,001,528363,Boechler; Nicholas Sebastia,9998,0,9999,1
1714207624177,MATH 197,001,523477,Kedlaya; Kiran S.,9996,0,9999,3
1714207624177,MATH 197,002,563811,Zhang; Danna,9995,0,9999,4
1714207624177,MATH 197,003,628552,Dumitriu; Ioana,9998,0,9999,1
1714207625206,MCWP 40R,A00,518780,Staff,5,0,20,15
1714207625206,MCWP 40R,B00,518781,Staff,7,0,20,13
1714207625206,MCWP 40R,C00,518783,Staff,5,0,20,15
1714207626231,MCWP 50R,A00,518791,Staff,0,0,20,20
1714207626231,MCWP 50R,B00,518792,Staff,0,1,20,20
1714207626231,MCWP 50R,C00,518793,Staff,0,1,20,20
1714207626231,MCWP 50R,D00,518794,Staff,0,0,20,20
1714207626231,MCWP 50R,E00,518795,Staff,0,1,20,20
1714207626231,MCWP 50R,F00,518796,Staff,0,0,20,20
1714207626231,MCWP 50R,G00,518797,Staff,0,1,20,20
1714207627261,MMW 12R,A01,514034,Herbst; Matthew,0,1,16,16
1714207627261,MMW 12R,A02,514035,Herbst; Matthew,2,0,16,14
1714207628287,MMW 13R,A01,514037,Staff,0,4,16,16
1714207628287,MMW 13R,A02,514039,Staff,0,2,16,16
1714207628287,MMW 13R,A03,628519,Staff,0,2,16,16
1714207630339,SIO 295LS,A00,523233,Staff,13,0,30,17
1714207631364,SIO 295S,A00,523232,Staff,13,0,30,17
1714207632391,SIOC 290S,A01,637330,Merrifield; Mark A,28,0,30,2
1714207633422,SIOC 291S,A01,637333,Gabriel; Corey John,28,0,30,2
1714207634447,SOCI 117,A01,494376,Staff,0,2,5,5
1714207635471,WES 237B,A00,494380,Staff,9,0,20,11
1714207637549,AESE 279B,A00,494370,Wade; Jon P,0,0,33,33
1714207638576,AIP 197,001,627712,Vespa; Emanuel Ignacio,9998,0,9999,1
1714207639605,ANAR 135S,A00,494369,Braswell; Geoffrey E.,0,0,0,0
1714207640633,BENG 196,001,628496,Engler; Adam J.,9998,0,9999,1
1714207641661,CAT 124RS,A01,519847,Geibel; William,0,0,20,20
1714207642690,CAT 125RS,A01,515971,Geibel; William,0,0,20,20
1714207643720,CLRE 250,A00,511389,Morris; Sheldon,9993,0,9999,6
1714207644748,CLRE 251,A00,507176,Mehta; Ravindra L.,9993,0,9999,6
1714207644748,CLRE 251,B00,511410,Mehta; Ravindra L.,9998,0,9999,1
1714207645774,CLRE 252,A00,507189,Cuomo; Raphael Eduardo,9995,0,9999,4
1714207646799,CLRE 253,A00,507199,Vaida; Florin,9994,0,9999,5
1714207646799,CLRE 253,B00,507202,Vaida; Florin,9999,0,9999,0
1714207647825,CLRE 259,A00,507211,Patel; Hemal,9996,0,9999,3
1714207648854,CLRE 260,A00,507221,Cuomo; Raphael Eduardo,9999,0,9999,0
1714207649879,CLRE 297,001,507242,Cuomo; Raphael Eduardo,9999,0,9999,0
1714207650906,COGS 197,001,638244,Voytek; Bradley Thomas,9999,0,9999,0
1714207651931,CSE 191,A00,516875,Minnes Kemp; Mor Mia,9993,0,9999,6
1714207652958,CSE 197,001,637388,Minnes Kemp; Mor Mia,9998,0,9999,1
1714207653986,CSS 201S,A01,494383,Staff,35,0,35,0
1714207655012,CSS 202S,A01,494387,Staff,35,0,35,0
1714207656042,DSC 197,001,628532,Eldridge; Justin Matthew,9996,0,9999,3
1714207657067,EAP 100,A00,516065,Staff,9797,0,9999,202
1714207658096,ECE 45,A01,507414,Staff,33,0,60,27
1714207660149,ECE 111,A01,507420,Staff,21,0,50,29
1714207661173,ECE 197,001,548057,Sievenpiper; Daniel F.,9994,0,9999,5
1714207662200,EDS 115,A00,507243,Choi; Bailey Miyeon,12,0,28,16
1714207663231,EDS 117,A01,494379,Staff,0,1,30,30
1714207664256,EDS 125,A00,507246,Hopkins; Megan Beth,12,0,30,18
1714207665280,EDS 128A,A01,507264,Fargason; Sharon Gayle,14,0,26,12
1714207666306,EDS 128B,A01,507293,Pappas; Elizabeth,18,0,30,12
1714207667330,EDS 139,A00,507294,Fargason; Sharon Gayle,18,0,30,12
1714207667330,EDS 139,B00,507313,Pappas; Elizabeth,15,0,30,15
1714207668355,EDS 201,A00,507315,Staff,13,0,30,17
1714207669382,EDS 203,A01,507317,Halter; Christopher P.,12,0,30,18
1714207670414,EDS 204R,A01,507319,Halter; Christopher P.,0,3,30,30
1714207670414,EDS 204R,B01,507331,Heinzman; Erica M.,17,0,30,13
1714207671440,EDS 206R,A00,507332,Staff,0,4,30,30
1714207671440,EDS 206R,B00,507343,Staff,18,0,30,12
1714207672467,EDS 250,A00,507344,Hemans; Patricia Ann Benitez,22,0,40,18
1714207673492,EDS 281,A00,507345,Daly; Alan J.,18,0,18,0
1714207674521,EDS 284,A00,507350,Daly; Alan J.,16,0,16,0
1714207675547,EDS 286,A00,507359,Fine; Sarah,18,0,18,0
1714207676576,EDS 289C,A01,507361,Daly; Alan J.,18,0,18,0
1714207677607,EDS 290,A00,507366,Hofstetter; Carolyn,15,0,15,0
1714207678639,LIGM 5A,A00,507421,Fischer-Grunski; Eva K,18,0,20,2
1714207679668,LIGM 5B,A00,507423,Fischer-Grunski; Eva K,19,0,20,1
1714207680705,LIGM 5C,A00,507425,Fischer-Grunski; Eva K,19,0,20,1
1714207681729,LIIT 5AS,A00,507427,Carnelos; Chiara,20,0,20,0
1714207682754,LIIT 5BS,A00,507430,Carnelos; Chiara,20,0,20,0
1714207683785,LIIT 5CS,A00,507432,Carnelos; Chiara,20,0,20,0
1714207684810,LISP 5A,A00,507541,Munoz Sanchez; Alicia,11,0,20,9
1714207685906,LISP 5B,A00,507671,Munoz Sanchez; Alicia,9,0,20,11
1714207686932,LISP 5C,A00,507696,Munoz Sanchez; Alicia,9,0,20,11
1714207687961,MAE 197,001,528363,Boechler; Nicholas Sebastia,9998,0,9999,1
1714207688988,MATH 197,001,523477,Kedlaya; Kiran S.,9996,0,9999,3
1714207688988,MATH 197,002,563811,Zhang; Danna,9995,0,9999,4
1714207688988,MATH 197,003,628552,Dumitriu; Ioana,9998,0,9999,1
1714207690012,MCWP 40R,A00,518780,Staff,5,0,20,15
1714207690012,MCWP 40R,B00,518781,Staff,7,0,20,13
1714207690012,MCWP 40R,C00,518783,Staff,5,0,20,15
1714207691042,MCWP 50R,A00,518791,Staff,0,0,20,20
1714207691042,MCWP 50R,B00,518792,Staff,0,1,20,20
1714207691042,MCWP 50R,C00,518793,Staff,0,1,20,20
1714207691042,MCWP 50R,D00,518794,Staff,0,0,20,20
1714207691042,MCWP 50R,E00,518795,Staff,0,1,20,20
1714207691042,MCWP 50R,F00,518796,Staff,0,0,20,20
1714207691042,MCWP 50R,G00,518797,Staff,0,1,20,20
1714207692068,MMW 12R,A01,514034,Herbst; Matthew,0,1,16,16
1714207692068,MMW 12R,A02,514035,Herbst; Matthew,2,0,16,14
1714207693096,MMW 13R,A01,514037,Staff,0,4,16,16
1714207693096,MMW 13R,A02,514039,Staff,0,2,16,16
1714207693096,MMW 13R,A03,628519,Staff,0,2,16,16
1714207695148,SIO 295LS,A00,523233,Staff,13,0,30,17
1714207696174,SIO 295S,A00,523232,Staff,13,0,30,17
1714207697200,SIOC 290S,A01,637330,Merrifield; Mark A,28,0,30,2
1714207698230,SIOC 291S,A01,637333,Gabriel; Corey John,28,0,30,2
1714207699259,SOCI 117,A01,494376,Staff,0,2,5,5
1714207700285,WES 237B,A00,494380,Staff,9,0,20,11
1714207702365,AESE 279B,A00,494370,Wade; Jon P,0,0,33,33
1714207703390,AIP 197,001,627712,Vespa; Emanuel Ignacio,9998,0,9999,1
1714207704415,ANAR 135S,A00,494369,Braswell; Geoffrey E.,0,0,0,0
1714207705440,BENG 196,001,628496,Engler; Adam J.,9998,0,9999,1
1714207706469,CAT 124RS,A01,519847,Geibel; William,0,0,20,20
1714207707494,CAT 125RS,A01,515971,Geibel; William,0,0,20,20
1714207708520,CLRE 250,A00,511389,Morris; Sheldon,9993,0,9999,6
1714207709546,CLRE 251,A00,507176,Mehta; Ravindra L.,9993,0,9999,6
1714207709546,CLRE 251,B00,511410,Mehta; Ravindra L.,9998,0,9999,1
1714207710577,CLRE 252,A00,507189,Cuomo; Raphael Eduardo,9995,0,9999,4
1714207711606,CLRE 253,A00,507199,Vaida; Florin,9994,0,9999,5
1714207711606,CLRE 253,B00,507202,Vaida; Florin,9999,0,9999,0
1714207712631,CLRE 259,A00,507211,Patel; Hemal,9996,0,9999,3
1714207713658,CLRE 260,A00,507221,Cuomo; Raphael Eduardo,9999,0,9999,0
1714207714683,CLRE 297,001,507242,Cuomo; Raphael Eduardo,9999,0,9999,0
1714207715713,COGS 197,001,638244,Voytek; Bradley Thomas,9999,0,9999,0
1714207716738,CSE 191,A00,516875,Minnes Kemp; Mor Mia,9993,0,9999,6
1714207717763,CSE 197,001,637388,Minnes Kemp; Mor Mia,9998,0,9999,1
1714207718790,CSS 201S,A01,494383,Staff,35,0,35,0
1714207719820,CSS 202S,A01,494387,Staff,35,0,35,0
1714207720850,DSC 197,001,628532,Eldridge; Justin Matthew,9996,0,9999,3
1714207721876,EAP 100,A00,516065,Staff,9797,0,9999,202
1714207722901,ECE 45,A01,507414,Staff,33,0,60,27
1714207724956,ECE 111,A01,507420,Staff,21,0,50,29
1714207725983,ECE 197,001,548057,Sievenpiper; Daniel F.,9994,0,9999,5
1714207727009,EDS 115,A00,507243,Choi; Bailey Miyeon,12,0,28,16
1714207728041,EDS 117,A01,494379,Staff,0,1,30,30
1714207729069,EDS 125,A00,507246,Hopkins; Megan Beth,12,0,30,18
1714207730096,EDS 128A,A01,507264,Fargason; Sharon Gayle,14,0,26,12
1714207731125,EDS 128B,A01,507293,Pappas; Elizabeth,18,0,30,12
1714207732149,EDS 139,A00,507294,Fargason; Sharon Gayle,18,0,30,12
1714207732149,EDS 139,B00,507313,Pappas; Elizabeth,15,0,30,15
1714207733173,EDS 201,A00,507315,Staff,13,0,30,17
1714207734204,EDS 203,A01,507317,Halter; Christopher P.,12,0,30,18
1714207735229,EDS 204R,A01,507319,Halter; Christopher P.,0,3,30,30
1714207735229,EDS 204R,B01,507331,Heinzman; Erica M.,17,0,30,13
1714207736254,EDS 206R,A00,507332,Staff,0,4,30,30
1714207736254,EDS 206R,B00,507343,Staff,18,0,30,12
1714207737280,EDS 250,A00,507344,Hemans; Patricia Ann Benitez,22,0,40,18
1714207738309,EDS 281,A00,507345,Daly; Alan J.,18,0,18,0
1714207739337,EDS 284,A00,507350,Daly; Alan J.,16,0,16,0
1714207740361,EDS 286,A00,507359,Fine; Sarah,18,0,18,0
1714207741386,EDS 289C,A01,507361,Daly; Alan J.,18,0,18,0
1714207742411,EDS 290,A00,507366,Hofstetter; Carolyn,15,0,15,0
1714207743441,LIGM 5A,A00,507421,Fischer-Grunski; Eva K,18,0,20,2
1714207744511,LIGM 5B,A00,507423,Fischer-Grunski; Eva K,19,0,20,1
1714207745540,LIGM 5C,A00,507425,Fischer-Grunski; Eva K,19,0,20,1
1714207746570,LIIT 5AS,A00,507427,Carnelos; Chiara,20,0,20,0
1714207747595,LIIT 5BS,A00,507430,Carnelos; Chiara,20,0,20,0
1714207748620,LIIT 5CS,A00,507432,Carnelos; Chiara,20,0,20,0
1714207749649,LISP 5A,A00,507541,Munoz Sanchez; Alicia,11,0,20,9
1714207750676,LISP 5B,A00,507671,Munoz Sanchez; Alicia,9,0,20,11
1714207751703,LISP 5C,A00,507696,Munoz Sanchez; Alicia,9,0,20,11
1714207752732,MAE 197,001,528363,Boechler; Nicholas Sebastia,9998,0,9999,1
1714207753762,MATH 197,001,523477,Kedlaya; Kiran S.,9996,0,9999,3
1714207753762,MATH 197,002,563811,Zhang; Danna,9995,0,9999,4
1714207753762,MATH 197,003,628552,Dumitriu; Ioana,9998,0,9999,1
1714207754793,MCWP 40R,A00,518780,Staff,5,0,20,15
1714207754793,MCWP 40R,B00,518781,Staff,7,0,20,13
1714207754793,MCWP 40R,C00,518783,Staff,5,0,20,15
1714207755823,MCWP 50R,A00,518791,Staff,0,0,20,20
1714207755823,MCWP 50R,B00,518792,Staff,0,1,20,20
1714207755823,MCWP 50R,C00,518793,Staff,0,1,20,20
1714207755823,MCWP 50R,D00,518794,Staff,0,0,20,20
1714207755823,MCWP 50R,E00,518795,Staff,0,1,20,20
1714207755823,MCWP 50R,F00,518796,Staff,0,0,20,20
1714207755823,MCWP 50R,G00,518797,Staff,0,1,20,20
1714207756848,MMW 12R,A01,514034,Herbst; Matthew,0,1,16,16
1714207756848,MMW 12R,A02,514035,Herbst; Matthew,2,0,16,14
1714207757875,MMW 13R,A01,514037,Staff,0,4,16,16
1714207757875,MMW 13R,A02,514039,Staff,0,2,16,16
1714207757875,MMW 13R,A03,628519,Staff,0,2,16,16
1714207759930,SIO 295LS,A00,523233,Staff,13,0,30,17
1714207760956,SIO 295S,A00,523232,Staff,13,0,30,17
1714207761984,SIOC 290S,A01,637330,Merrifield; Mark A,28,0,30,2
1714207763010,SIOC 291S,A01,637333,Gabriel; Corey John,28,0,30,2
1714207764043,SOCI 117,A01,494376,Staff,0,2,5,5
1714207765074,WES 237B,A00,494380,Staff,9,0,20,11
1714207767148,AESE 279B,A00,494370,Wade; Jon P,0,0,33,33
1714207768174,AIP 197,001,627712,Vespa; Emanuel Ignacio,9998,0,9999,1
1714207769197,ANAR 135S,A00,494369,Braswell; Geoffrey E.,0,0,0,0
1714207770223,BENG 196,001,628496,Engler; Adam J.,9998,0,9999,1
1714207771250,CAT 124RS,A01,519847,Geibel; William,0,0,20,20
1714207772274,CAT 125RS,A01,515971,Geibel; William,0,0,20,20
1714207773300,CLRE 250,A00,511389,Morris; Sheldon,9993,0,9999,6
1714207774328,CLRE 251,A00,507176,Mehta; Ravindra L.,9993,0,9999,6
1714207774328,CLRE 251,B00,511410,Mehta; Ravindra L.,9998,0,9999,1
1714207775355,CLRE 252,A00,507189,Cuomo; Raphael Eduardo,9995,0,9999,4
1714207776386,CLRE 253,A00,507199,Vaida; Florin,9994,0,9999,5
1714207776386,CLRE 253,B00,507202,Vaida; Florin,9999,0,9999,0
1714207777413,CLRE 259,A00,507211,Patel; Hemal,9996,0,9999,3
1714207778439,CLRE 260,A00,507221,Cuomo; Raphael Eduardo,9999,0,9999,0
1714207779467,CLRE 297,001,507242,Cuomo; Raphael Eduardo,9999,0,9999,0
1714207780494,COGS 197,001,638244,Voytek; Bradley Thomas,9999,0,9999,0
1714207781519,CSE 191,A00,516875,Minnes Kemp; Mor Mia,9993,0,9999,6
1714207782545,CSE 197,001,637388,Minnes Kemp; Mor Mia,9998,0,9999,1
1714207783576,CSS 201S,A01,494383,Staff,35,0,35,0
1714207784602,CSS 202S,A01,494387,Staff,35,0,35,0
1714207785628,DSC 197,001,628532,Eldridge; Justin Matthew,9996,0,9999,3
1714207786654,EAP 100,A00,516065,Staff,9797,0,9999,202
1714207787684,ECE 45,A01,507414,Staff,33,0,60,27
1714207789794,ECE 111,A01,507420,Staff,21,0,50,29
1714207790821,ECE 197,001,548057,Sievenpiper; Daniel F.,9994,0,9999,5
1714207791854,EDS 115,A00,507243,Choi; Bailey Miyeon,12,0,28,16
1714207792880,EDS 117,A01,494379,Staff,0,1,30,30
1714207793910,EDS 125,A00,507246,Hopkins; Megan Beth,12,0,30,18
1714207794938,EDS 128A,A01,507264,Fargason; Sharon Gayle,14,0,26,12
1714207795966,EDS 128B,A01,507293,Pappas; Elizabeth,18,0,30,12
1714207796994,EDS 139,A00,507294,Fargason; Sharon Gayle,18,0,30,12
1714207796994,EDS 139,B00,507313,Pappas; Elizabeth,15,0,30,15
1714207798025,EDS 201,A00,507315,Staff,13,0,30,17
1714207799051,EDS 203,A01,507317,Halter; Christopher P.,12,0,30,18
1714207800076,EDS 204R,A01,507319,Halter; Christopher P.,0,3,30,30
1714207800076,EDS 204R,B01,507331,Heinzman; Erica M.,17,0,30,13
1714207801104,EDS 206R,A00,507332,Staff,0,4,30,30
1714207801104,EDS 206R,B00,507343,Staff,18,0,30,12
1714207802132,EDS 250,A00,507344,Hemans; Patricia Ann Benitez,22,0,40,18
1714207803163,EDS 281,A00,507345,Daly; Alan J.,18,0,18,0
1714207804189,EDS 284,A00,507350,Daly; Alan J.,16,0,16,0
1714207805218,EDS 286,A00,507359,Fine; Sarah,18,0,18,0
1714207806245,EDS 289C,A01,507361,Daly; Alan J.,18,0,18,0
1714207807277,EDS 290,A00,507366,Hofstetter; Carolyn,15,0,15,0
1714207808304,LIGM 5A,A00,507421,Fischer-Grunski; Eva K,18,0,20,2
1714207809333,LIGM 5B,A00,507423,Fischer-Grunski; Eva K,19,0,20,1
1714207810359,LIGM 5C,A00,507425,Fischer-Grunski; Eva K,19,0,20,1
1714207811390,LIIT 5AS,A00,507427,Carnelos; Chiara,20,0,20,0
1714207812416,LIIT 5BS,A00,507430,Carnelos; Chiara,20,0,20,0
1714207813443,LIIT 5CS,A00,507432,Carnelos; Chiara,20,0,20,0
1714207814470,LISP 5A,A00,507541,Munoz Sanchez; Alicia,11,0,20,9
1714207815495,LISP 5B,A00,507671,Munoz Sanchez; Alicia,9,0,20,11
1714207816525,LISP 5C,A00,507696,Munoz Sanchez; Alicia,9,0,20,11
1714207817554,MAE 197,001,528363,Boechler; Nicholas Sebastia,9998,0,9999,1
1714207818581,MATH 197,001,523477,Kedlaya; Kiran S.,9996,0,9999,3
1714207818581,MATH 197,002,563811,Zhang; Danna,9995,0,9999,4
1714207818581,MATH 197,003,628552,Dumitriu; Ioana,9998,0,9999,1
1714207819607,MCWP 40R,A00,518780,Staff,5,0,20,15
1714207819607,MCWP 40R,B00,518781,Staff,7,0,20,13
1714207819607,MCWP 40R,C00,518783,Staff,5,0,20,15
1714207820640,MCWP 50R,A00,518791,Staff,0,0,20,20
1714207820640,MCWP 50R,B00,518792,Staff,0,1,20,20
1714207820640,MCWP 50R,C00,518793,Staff,0,1,20,20
1714207820640,MCWP 50R,D00,518794,Staff,0,0,20,20
1714207820640,MCWP 50R,E00,518795,Staff,0,1,20,20
1714207820640,MCWP 50R,F00,518796,Staff,0,0,20,20
1714207820640,MCWP 50R,G00,518797,Staff,0,1,20,20
1714207821669,MMW 12R,A01,514034,Herbst; Matthew,0,1,16,16
1714207821669,MMW 12R,A02,514035,Herbst; Matthew,2,0,16,14
1714207822694,MMW 13R,A01,514037,Staff,0,4,16,16
1714207822694,MMW 13R,A02,514039,Staff,0,2,16,16
1714207822694,MMW 13R,A03,628519,Staff,0,2,16,16
1714207824749,SIO 295LS,A00,523233,Staff,13,0,30,17
1714207825777,SIO 295S,A00,523232,Staff,13,0,30,17
1714207826804,SIOC 290S,A01,637330,Merrifield; Mark A,28,0,30,2
1714207827831,SIOC 291S,A01,637333,Gabriel; Corey John,28,0,30,2
1714207828860,SOCI 117,A01,494376,Staff,0,2,5,5
1714207829885,WES 237B,A00,494380,Staff,9,0,20,11
1714207831957,AESE 279B,A00,494370,Wade; Jon P,0,0,33,33
1714207832987,AIP 197,001,627712,Vespa; Emanuel Ignacio,9998,0,9999,1
1714207834012,ANAR 135S,A00,494369,Braswell; Geoffrey E.,0,0,0,0
1714207835038,BENG 196,001,628496,Engler; Adam J.,9998,0,9999,1
1714207836067,CAT 124RS,A01,519847,Geibel; William,0,0,20,20
1714207837092,CAT 125RS,A01,515971,Geibel; William,0,0,20,20
1714207838120,CLRE 250,A00,511389,Morris; Sheldon,9993,0,9999,6
1714207839147,CLRE 251,A00,507176,Mehta; Ravindra L.,9993,0,9999,6
1714207839147,CLRE 251,B00,511410,Mehta; Ravindra L.,9998,0,9999,1
1714207840174,CLRE 252,A00,507189,Cuomo; Raphael Eduardo,9995,0,9999,4
1714207841205,CLRE 253,A00,507199,Vaida; Florin,9994,0,9999,5
1714207841205,CLRE 253,B00,507202,Vaida; Florin,9999,0,9999,0
1714207842236,CLRE 259,A00,507211,Patel; Hemal,9996,0,9999,3
1714207843261,CLRE 260,A00,507221,Cuomo; Raphael Eduardo,9999,0,9999,0
1714207844286,CLRE 297,001,507242,Cuomo; Raphael Eduardo,9999,0,9999,0
1714207845312,COGS 197,001,638244,Voytek; Bradley Thomas,9999,0,9999,0
1714207846341,CSE 191,A00,516875,Minnes Kemp; Mor Mia,9993,0,9999,6
1714207847368,CSE 197,001,637388,Minnes Kemp; Mor Mia,9998,0,9999,1
1714207848408,CSS 201S,A01,494383,Staff,35,0,35,0
1714207849434,CSS 202S,A01,494387,Staff,35,0,35,0
1714207850464,DSC 197,001,628532,Eldridge; Justin Matthew,9996,0,9999,3
1714207851490,EAP 100,A00,516065,Staff,9797,0,9999,202
1714207852516,ECE 45,A01,507414,Staff,33,0,60,27
1714207854569,ECE 111,A01,507420,Staff,21,0,50,29
1714207855599,ECE 197,001,548057,Sievenpiper; Daniel F.,9994,0,9999,5
1714207856627,EDS 115,A00,507243,Choi; Bailey Miyeon,12,0,28,16
1714207857660,EDS 117,A01,494379,Staff,0,1,30,30
1714207858688,EDS 125,A00,507246,Hopkins; Megan Beth,12,0,30,18
1714207859714,EDS 128A,A01,507264,Fargason; Sharon Gayle,14,0,26,12
1714207860741,EDS 128B,A01,507293,Pappas; Elizabeth,18,0,30,12
1714207861771,EDS 139,A00,507294,Fargason; Sharon Gayle,18,0,30,12
1714207861771,EDS 139,B00,507313,Pappas; Elizabeth,15,0,30,15
1714207862800,EDS 201,A00,507315,Staff,13,0,30,17
1714207863830,EDS 203,A01,507317,Halter; Christopher P.,12,0,30,18
1714207864860,EDS 204R,A01,507319,Halter; Christopher P.,0,3,30,30
1714207864860,EDS 204R,B01,507331,Heinzman; Erica M.,17,0,30,13
1714207865891,EDS 206R,A00,507332,Staff,0,4,30,30
1714207865891,EDS 206R,B00,507343,Staff,18,0,30,12
1714207866918,EDS 250,A00,507344,Hemans; Patricia Ann Benitez,22,0,40,18
1714207867945,EDS 281,A00,507345,Daly; Alan J.,18,0,18,0
1714207868973,EDS 284,A00,507350,Daly; Alan J.,16,0,16,0
1714207870002,EDS 286,A00,507359,Fine; Sarah,18,0,18,0
1714207871028,EDS 289C,A01,507361,Daly; Alan J.,18,0,18,0
1714207872053,EDS 290,A00,507366,Hofstetter; Carolyn,15,0,15,0
1714207873084,LIGM 5A,A00,507421,Fischer-Grunski; Eva K,18,0,20,2
1714207874114,LIGM 5B,A00,507423,Fischer-Grunski; Eva K,19,0,20,1
1714207875140,LIGM 5C,A00,507425,Fischer-Grunski; Eva K,19,0,20,1
1714207876172,LIIT 5AS,A00,507427,Carnelos; Chiara,20,0,20,0
1714207877202,LIIT 5BS,A00,507430,Carnelos; Chiara,20,0,20,0
1714207878228,LIIT 5CS,A00,507432,Carnelos; Chiara,20,0,20,0
1714207879259,LISP 5A,A00,507541,Munoz Sanchez; Alicia,11,0,20,9
1714207880288,LISP 5B,A00,507671,Munoz Sanchez; Alicia,9,0,20,11
1714207881317,LISP 5C,A00,507696,Munoz Sanchez; Alicia,9,0,20,11
1714207882346,MAE 197,001,528363,Boechler; Nicholas Sebastia,9998,0,9999,1
1714207883373,MATH 197,001,523477,Kedlaya; Kiran S.,9996,0,9999,3
1714207883373,MATH 197,002,563811,Zhang; Danna,9995,0,9999,4
1714207883373,MATH 197,003,628552,Dumitriu; Ioana,9998,0,9999,1
1714207884400,MCWP 40R,A00,518780,Staff,5,0,20,15
1714207884400,MCWP 40R,B00,518781,Staff,7,0,20,13
1714207884400,MCWP 40R,C00,518783,Staff,5,0,20,15
1714207885428,MCWP 50R,A00,518791,Staff,0,0,20,20
1714207885428,MCWP 50R,B00,518792,Staff,0,1,20,20
1714207885428,MCWP 50R,C00,518793,Staff,0,1,20,20
1714207885428,MCWP 50R,D00,518794,Staff,0,0,20,20
1714207885428,MCWP 50R,E00,518795,Staff,0,1,20,20
1714207885428,MCWP 50R,F00,518796,Staff,0,0,20,20
1714207885428,MCWP 50R,G00,518797,Staff,0,1,20,20
1714207886459,MMW 12R,A01,514034,Herbst; Matthew,0,1,16,16
1714207886459,MMW 12R,A02,514035,Herbst; Matthew,2,0,16,14
1714207887489,MMW 13R,A01,514037,Staff,0,4,16,16
1714207887489,MMW 13R,A02,514039,Staff,0,2,16,16
1714207887489,MMW 13R,A03,628519,Staff,0,2,16,16
1714207889542,SIO 295LS,A00,523233,Staff,13,0,30,17
1714207890567,SIO 295S,A00,523232,Staff,13,0,30,17
1714207891593,SIOC 290S,A01,637330,Merrifield; Mark A,28,0,30,2
1714207892623,SIOC 291S,A01,637333,Gabriel; Corey John,28,0,30,2
1714207893705,SOCI 117,A01,494376,Staff,0,2,5,5
1714207894735,WES 237B,A00,494380,Staff,9,0,20,11
1714207896810,AESE 279B,A00,494370,Wade; Jon P,0,0,33,33
1714207897836,AIP 197,001,627712,Vespa; Emanuel Ignacio,9998,0,9999,1
1714207898863,ANAR 135S,A00,494369,Braswell; Geoffrey E.,0,0,0,0
1714207899891,BENG 196,001,628496,Engler; Adam J.,9998,0,9999,1
1714207900917,CAT 124RS,A01,519847,Geibel; William,0,0,20,20
1714207901942,CAT 125RS,A01,515971,Geibel; William,0,0,20,20
1714207902973,CLRE 250,A00,511389,Morris; Sheldon,9993,0,9999,6
1714207904005,CLRE 251,A00,507176,Mehta; Ravindra L.,9993,0,9999,6
1714207904005,CLRE 251,B00,511410,Mehta; Ravindra L.,9998,0,9999,1
1714207905030,CLRE 252,A00,507189,Cuomo; Raphael Eduardo,9995,0,9999,4
1714207906056,CLRE 253,A00,507199,Vaida; Florin,9994,0,9999,5
1714207906056,CLRE 253,B00,507202,Vaida; Florin,9999,0,9999,0
1714207907083,CLRE 259,A00,507211,Patel; Hemal,9996,0,9999,3
1714207908108,CLRE 260,A00,507221,Cuomo; Raphael Eduardo,9999,0,9999,0
1714207909133,CLRE 297,001,507242,Cuomo; Raphael Eduardo,9999,0,9999,0
1714207910159,COGS 197,001,638244,Voytek; Bradley Thomas,9999,0,9999,0
1714207911188,CSE 191,A00,516875,Minnes Kemp; Mor Mia,9993,0,9999,6
1714207912217,CSE 197,001,637388,Minnes Kemp; Mor Mia,9998,0,9999,1
1714207913246,CSS 201S,A01,494383,Staff,35,0,35,0
1714207914275,CSS 202S,A01,494387,Staff,35,0,35,0
1714207915300,DSC 197,001,628532,Eldridge; Justin Matthew,9996,0,9999,3
1714207916326,EAP 100,A00,516065,Staff,9797,0,9999,202
1714207917350,ECE 45,A01,507414,Staff,33,0,60,27
1714207919410,ECE 111,A01,507420,Staff,21,0,50,29
1714207920436,ECE 197,001,548057,Sievenpiper; Daniel F.,9994,0,9999,5
1714207921467,EDS 115,A00,507243,Choi; Bailey Miyeon,12,0,28,16
1714207922497,EDS 117,A01,494379,Staff,0,1,30,30
1714207923529,EDS 125,A00,507246,Hopkins; Megan Beth,12,0,30,18
1714207924561,EDS 128A,A01,507264,Fargason; Sharon Gayle,14,0,26,12
1714207925590,EDS 128B,A01,507293,Pappas; Elizabeth,18,0,30,12
1714207926614,EDS 139,A00,507294,Fargason; Sharon Gayle,18,0,30,12
1714207926614,EDS 139,B00,507313,Pappas; Elizabeth,15,0,30,15
1714207927640,EDS 201,A00,507315,Staff,13,0,30,17
1714207928671,EDS 203,A01,507317,Halter; Christopher P.,12,0,30,18
1714207929697,EDS 204R,A01,507319,Halter; Christopher P.,0,3,30,30
1714207929697,EDS 204R,B01,507331,Heinzman; Erica M.,17,0,30,13
1714207930725,EDS 206R,A00,507332,Staff,0,4,30,30
1714207930725,EDS 206R,B00,507343,Staff,18,0,30,12
1714207931752,EDS 250,A00,507344,Hemans; Patricia Ann Benitez,22,0,40,18
1714207932778,EDS 281,A00,507345,Daly; Alan J.,18,0,18,0
1714207933802,EDS 284,A00,507350,Daly; Alan J.,16,0,16,0
1714207934831,EDS 286,A00,507359,Fine; Sarah,18,0,18,0
1714207935857,EDS 289C,A01,507361,Daly; Alan J.,18,0,18,0
1714207936890,EDS 290,A00,507366,Hofstetter; Carolyn,15,0,15,0
1714207937917,LIGM 5A,A00,507421,Fischer-Grunski; Eva K,18,0,20,2
1714207938946,LIGM 5B,A00,507423,Fischer-Grunski; Eva K,19,0,20,1
1714207939972,LIGM 5C,A00,507425,Fischer-Grunski; Eva K,19,0,20,1
1714207940998,LIIT 5AS,A00,507427,Carnelos; Chiara,20,0,20,0
1714207942029,LIIT 5BS,A00,507430,Carnelos; Chiara,20,0,20,0
1714207943056,LIIT 5CS,A00,507432,Carnelos; Chiara,20,0,20,0
1714207944087,LISP 5A,A00,507541,Munoz Sanchez; Alicia,11,0,20,9
1714207945113,LISP 5B,A00,507671,Munoz Sanchez; Alicia,9,0,20,11
1714207946140,LISP 5C,A00,507696,Munoz Sanchez; Alicia,9,0,20,11
1714207947170,MAE 197,001,528363,Boechler; Nicholas Sebastia,9998,0,9999,1
1714207948198,MATH 197,001,523477,Kedlaya; Kiran S.,9996,0,9999,3
1714207948198,MATH 197,002,563811,Zhang; Danna,9995,0,9999,4
1714207948198,MATH 197,003,628552,Dumitriu; Ioana,9998,0,9999,1
1714207949227,MCWP 40R,A00,518780,Staff,5,0,20,15
1714207949227,MCWP 40R,B00,518781,Staff,7,0,20,13
1714207949227,MCWP 40R,C00,518783,Staff,5,0,20,15
1714207950254,MCWP 50R,A00,518791,Staff,0,0,20,20
1714207950254,MCWP 50R,B00,518792,Staff,0,1,20,20
1714207950254,MCWP 50R,C00,518793,Staff,0,1,20,20
1714207950254,MCWP 50R,D00,518794,Staff,0,0,20,20
1714207950254,MCWP 50R,E00,518795,Staff,0,1,20,20
1714207950254,MCWP 50R,F00,518796,Staff,0,0,20,20
1714207950254,MCWP 50R,G00,518797,Staff,0,1,20,20
1714207951285,MMW 12R,A01,514034,Herbst; Matthew,0,1,16,16
1714207951285,MMW 12R,A02,514035,Herbst; Matthew,2,0,16,14
1714207952310,MMW 13R,A01,514037,Staff,0,4,16,16
1714207952310,MMW 13R,A02,514039,Staff,0,2,16,16
1714207952310,MMW 13R,A03,628519,Staff,0,2,16,16
1714207954364,SIO 295LS,A00,523233,Staff,13,0,30,17
1714207955391,SIO 295S,A00,523232,Staff,13,0,30,17
1714207956422,SIOC 290S,A01,637330,Merrifield; Mark A,28,0,30,2
1714207957448,SIOC 291S,A01,637333,Gabriel; Corey John,28,0,30,2
1714207958478,SOCI 117,A01,494376,Staff,0,2,5,5
1714207959505,WES 237B,A00,494380,Staff,9,0,20,11
1714207961576,AESE 279B,A00,494370,Wade; Jon P,0,0,33,33
1714207962602,AIP 197,001,627712,Vespa; Emanuel Ignacio,9998,0,9999,1
1714207963628,ANAR 135S,A00,494369,Braswell; Geoffrey E.,0,0,0,0
1714207964654,BENG 196,001,628496,Engler; Adam J.,9998,0,9999,1
1714207965685,CAT 124RS,A01,519847,Geibel; William,0,0,20,20
1714207966711,CAT 125RS,A01,515971,Geibel; William,0,0,20,20
1714207967737,CLRE 250,A00,511389,Morris; Sheldon,9993,0,9999,6
1714207968764,CLRE 251,A00,507176,Mehta; Ravindra L.,9993,0,9999,6
1714207968764,CLRE 251,B00,511410,Mehta; Ravindra L.,9998,0,9999,1
1714207969794,CLRE 252,A00,507189,Cuomo; Raphael Eduardo,9995,0,9999,4
1714207970825,CLRE 253,A00,507199,Vaida; Florin,9994,0,9999,5
1714207970825,CLRE 253,B00,507202,Vaida; Florin,9999,0,9999,0
1714207971851,CLRE 259,A00,507211,Patel; Hemal,9996,0,9999,3
1714207972882,CLRE 260,A00,507221,Cuomo; Raphael Eduardo,9999,0,9999,0
1714207973910,CLRE 297,001,507242,Cuomo; Raphael Eduardo,9999,0,9999,0
1714207974937,COGS 197,001,638244,Voytek; Bradley Thomas,9999,0,9999,0
1714207975965,CSE 191,A00,516875,Minnes Kemp; Mor Mia,9993,0,9999,6
1714207976993,CSE 197,001,637388,Minnes Kemp; Mor Mia,9998,0,9999,1
1714207978026,CSS 201S,A01,494383,Staff,35,0,35,0
1714207979053,CSS 202S,A01,494387,Staff,35,0,35,0
1714207980079,DSC 197,001,628532,Eldridge; Justin Matthew,9996,0,9999,3
1714207981108,EAP 100,A00,516065,Staff,9797,0,9999,202
1714207982134,ECE 45,A01,507414,Staff,33,0,60,27
1714207984188,ECE 111,A01,507420,Staff,21,0,50,29
1714207985217,ECE 197,001,548057,Sievenpiper; Daniel F.,9994,0,9999,5
1714207986246,EDS 115,A00,507243,Choi; Bailey Miyeon,12,0,28,16
1714207987273,EDS 117,A01,494379,Staff,0,1,30,30
1714207988301,EDS 125,A00,507246,Hopkins; Megan Beth,12,0,30,18
1714207989331,EDS 128A,A01,507264,Fargason; Sharon Gayle,14,0,26,12
1714207990356,EDS 128B,A01,507293,Pappas; Elizabeth,18,0,30,12
1714207991383,EDS 139,A00,507294,Fargason; Sharon Gayle,18,0,30,12
1714207991383,EDS 139,B00,507313,Pappas; Elizabeth,15,0,30,15
1714207992411,EDS 201,A00,507315,Staff,13,0,30,17
1714207993442,EDS 203,A01,507317,Halter; Christopher P.,12,0,30,18
1714207994469,EDS 204R,A01,507319,Halter; Christopher P.,0,3,30,30
1714207994469,EDS 204R,B01,507331,Heinzman; Erica M.,17,0,30,13
1714207995494,EDS 206R,A00,507332,Staff,0,4,30,30
1714207995494,EDS 206R,B00,507343,Staff,18,0,30,12
1714207996524,EDS 250,A00,507344,Hemans; Patricia Ann Benitez,22,0,40,18
1714207997602,EDS 281,A00,507345,Daly; Alan J.,18,0,18,0
1714207998627,EDS 284,A00,507350,Daly; Alan J.,16,0,16,0
1714207999656,EDS 286,A00,507359,Fine; Sarah,18,0,18,0
1714208000682,EDS 289C,A01,507361,Daly; Alan J.,18,0,18,0
1714208001711,EDS 290,A00,507366,Hofstetter; Carolyn,15,0,15,0
1714208002744,LIGM 5A,A00,507421,Fischer-Grunski; Eva K,18,0,20,2
1714208003769,LIGM 5B,A00,507423,Fischer-Grunski; Eva K,19,0,20,1
1714208004795,LIGM 5C,A00,507425,Fischer-Grunski; Eva K,19,0,20,1
1714208005821,LIIT 5AS,A00,507427,Carnelos; Chiara,20,0,20,0
1714208006846,LIIT 5BS,A00,507430,Carnelos; Chiara,20,0,20,0
1714208007871,LIIT 5CS,A00,507432,Carnelos; Chiara,20,0,20,0
1714208008897,LISP 5A,A00,507541,Munoz Sanchez; Alicia,11,0,20,9
1714208009927,LISP 5B,A00,507671,Munoz Sanchez; Alicia,9,0,20,11
1714208010952,LISP 5C,A00,507696,Munoz Sanchez; Alicia,9,0,20,11
1714208011982,MAE 197,001,528363,Boechler; Nicholas Sebastia,9998,0,9999,1
1714208013008,MATH 197,001,523477,Kedlaya; Kiran S.,9996,0,9999,3
1714208013008,MATH 197,002,563811,Zhang; Danna,9995,0,9999,4
1714208013008,MATH 197,003,628552,Dumitriu; Ioana,9998,0,9999,1
1714208014037,MCWP 40R,A00,518780,Staff,5,0,20,15
1714208014037,MCWP 40R,B00,518781,Staff,7,0,20,13
1714208014037,MCWP 40R,C00,518783,Staff,5,0,20,15
1714208015068,MCWP 50R,A00,518791,Staff,0,0,20,20
1714208015068,MCWP 50R,B00,518792,Staff,0,1,20,20
1714208015068,MCWP 50R,C00,518793,Staff,0,1,20,20
1714208015068,MCWP 50R,D00,518794,Staff,0,0,20,20
1714208015068,MCWP 50R,E00,518795,Staff,0,1,20,20
1714208015068,MCWP 50R,F00,518796,Staff,0,0,20,20
1714208015068,MCWP 50R,G00,518797,Staff,0,1,20,20
1714208016094,MMW 12R,A01,514034,Herbst; Matthew,0,1,16,16
1714208016094,MMW 12R,A02,514035,Herbst; Matthew,2,0,16,14
1714208017121,MMW 13R,A01,514037,Staff,0,4,16,16
1714208017121,MMW 13R,A02,514039,Staff,0,2,16,16
1714208017121,MMW 13R,A03,628519,Staff,0,2,16,16
1714208019176,SIO 295LS,A00,523233,Staff,13,0,30,17
1714208020202,SIO 295S,A00,523232,Staff,13,0,30,17
1714208021229,SIOC 290S,A01,637330,Merrifield; Mark A,28,0,30,2
1714208022255,SIOC 291S,A01,637333,Gabriel; Corey John,28,0,30,2
1714208023283,SOCI 117,A01,494376,Staff,0,2,5,5
1714208024308,WES 237B,A00,494380,Staff,9,0,20,11
1714208026383,AESE 279B,A00,494370,Wade; Jon P,0,0,33,33
1714208027412,AIP 197,001,627712,Vespa; Emanuel Ignacio,9998,0,9999,1
1714208028437,ANAR 135S,A00,494369,Braswell; Geoffrey E.,0,0,0,0
1714208029464,BENG 196,001,628496,Engler; Adam J.,9998,0,9999,1
1714208030489,CAT 124RS,A01,519847,Geibel; William,0,0,20,20
1714208031517,CAT 125RS,A01,515971,Geibel; William,0,0,20,20
1714208032546,CLRE 250,A00,511389,Morris; Sheldon,9993,0,9999,6
1714208033574,CLRE 251,A00,507176,Mehta; Ravindra L.,9993,0,9999,6
1714208033574,CLRE 251,B00,511410,Mehta; Ravindra L.,9998,0,9999,1
1714208034602,CLRE 252,A00,507189,Cuomo; Raphael Eduardo,9995,0,9999,4
1714208035629,CLRE 253,A00,507199,Vaida; Florin,9994,0,9999,5
1714208035629,CLRE 253,B00,507202,Vaida; Florin,9999,0,9999,0
1714208036657,CLRE 259,A00,507211,Patel; Hemal,9996,0,9999,3
1714208037686,CLRE 260,A00,507221,Cuomo; Raphael Eduardo,9999,0,9999,0
1714208038711,CLRE 297,001,507242,Cuomo; Raphael Eduardo,9999,0,9999,0
1714208039737,COGS 197,001,638244,Voytek; Bradley Thomas,9999,0,9999,0
1714208040762,CSE 191,A00,516875,Minnes Kemp; Mor Mia,9993,0,9999,6
1714208041787,CSE 197,001,637388,Minnes Kemp; Mor Mia,9998,0,9999,1
1714208042816,CSS 201S,A01,494383,Staff,35,0,35,0
1714208043841,CSS 202S,A01,494387,Staff,35,0,35,0
1714208044871,DSC 197,001,628532,Eldridge; Justin Matthew,9996,0,9999,3
1714208045896,EAP 100,A00,516065,Staff,9797,0,9999,202
1714208046926,ECE 45,A01,507414,Staff,33,0,60,27
1714208048984,ECE 111,A01,507420,Staff,21,0,50,29
1714208050013,ECE 197,001,548057,Sievenpiper; Daniel F.,9994,0,9999,5
1714208051041,EDS 115,A00,507243,Choi; Bailey Miyeon,12,0,28,16
1714208052070,EDS 117,A01,494379,Staff,0,1,30,30
1714208053098,EDS 125,A00,507246,Hopkins; Megan Beth,12,0,30,18
1714208054125,EDS 128A,A01,507264,Fargason; Sharon Gayle,14,0,26,12
1714208055152,EDS 128B,A01,507293,Pappas; Elizabeth,18,0,30,12
1714208056178,EDS 139,A00,507294,Fargason; Sharon Gayle,18,0,30,12
1714208056178,EDS 139,B00,507313,Pappas; Elizabeth,15,0,30,15
1714208057206,EDS 201,A00,507315,Staff,13,0,30,17
1714208058235,EDS 203,A01,507317,Halter; Christopher P.,12,0,30,18
1714208059264,EDS 204R,A01,507319,Halter; Christopher P.,0,3,30,30
1714208059264,EDS 204R,B01,507331,Heinzman; Erica M.,17,0,30,13
1714208060288,EDS 206R,A00,507332,Staff,0,4,30,30
1714208060288,EDS 206R,B00,507343,Staff,18,0,30,12
1714208061313,EDS 250,A00,507344,Hemans; Patricia Ann Benitez,22,0,40,18
1714208062340,EDS 281,A00,507345,Daly; Alan J.,18,0,18,0
1714208063365,EDS 284,A00,507350,Daly; Alan J.,16,0,16,0
1714208064394,EDS 286,A00,507359,Fine; Sarah,18,0,18,0
1714208065420,EDS 289C,A01,507361,Daly; Alan J.,18,0,18,0
1714208066449,EDS 290,A00,507366,Hofstetter; Carolyn,15,0,15,0
1714208067487,LIGM 5A,A00,507421,Fischer-Grunski; Eva K,18,0,20,2
1714208068511,LIGM 5B,A00,507423,Fischer-Grunski; Eva K,19,0,20,1
1714208069543,LIGM 5C,A00,507425,Fischer-Grunski; Eva K,19,0,20,1
1714208070569,LIIT 5AS,A00,507427,Carnelos; Chiara,20,0,20,0
1714208071598,LIIT 5BS,A00,507430,Carnelos; Chiara,20,0,20,0
1714208072623,LIIT 5CS,A00,507432,Carnelos; Chiara,20,0,20,0
1714208073654,LISP 5A,A00,507541,Munoz Sanchez; Alicia,11,0,20,9
1714208074680,LISP 5B,A00,507671,Munoz Sanchez; Alicia,9,0,20,11
1714208075709,LISP 5C,A00,507696,Munoz Sanchez; Alicia,9,0,20,11
1714208076738,MAE 197,001,528363,Boechler; Nicholas Sebastia,9998,0,9999,1
1714208077764,MATH 197,001,523477,Kedlaya; Kiran S.,9996,0,9999,3
1714208077764,MATH 197,002,563811,Zhang; Danna,9995,0,9999,4
1714208077764,MATH 197,003,628552,Dumitriu; Ioana,9998,0,9999,1
1714208078796,MCWP 40R,A00,518780,Staff,5,0,20,15
1714208078796,MCWP 40R,B00,518781,Staff,7,0,20,13
1714208078796,MCWP 40R,C00,518783,Staff,5,0,20,15
1714208079824,MCWP 50R,A00,518791,Staff,0,0,20,20
1714208079824,MCWP 50R,B00,518792,Staff,0,1,20,20
1714208079824,MCWP 50R,C00,518793,Staff,0,1,20,20
1714208079824,MCWP 50R,D00,518794,Staff,0,0,20,20
1714208079824,MCWP 50R,E00,518795,Staff,0,1,20,20
1714208079824,MCWP 50R,F00,518796,Staff,0,0,20,20
1714208079824,MCWP 50R,G00,518797,Staff,0,1,20,20
1714208080850,MMW 12R,A01,514034,Herbst; Matthew,0,1,16,16
1714208080850,MMW 12R,A02,514035,Herbst; Matthew,2,0,16,14
1714208081878,MMW 13R,A01,514037,Staff,0,4,16,16
1714208081878,MMW 13R,A02,514039,Staff,0,2,16,16
1714208081878,MMW 13R,A03,628519,Staff,0,2,16,16
1714208083933,SIO 295LS,A00,523233,Staff,13,0,30,17
1714208084960,SIO 295S,A00,523232,Staff,13,0,30,17
1714208085990,SIOC 290S,A01,637330,Merrifield; Mark A,28,0,30,2
1714208087017,SIOC 291S,A01,637333,Gabriel; Corey John,28,0,30,2
1714208088043,SOCI 117,A01,494376,Staff,0,2,5,5
1714208089070,WES 237B,A00,494380,Staff,9,0,20,11
1714208091162,AESE 279B,A00,494370,Wade; Jon P,0,0,33,33
1714208092194,AIP 197,001,627712,Vespa; Emanuel Ignacio,9998,0,9999,1
1714208093223,ANAR 135S,A00,494369,Braswell; Geoffrey E.,0,0,0,0
1714208094249,BENG 196,001,628496,Engler; Adam J.,9998,0,9999,1
1714208095276,CAT 124RS,A01,519847,Geibel; William,0,0,20,20
1714208096303,CAT 125RS,A01,515971,Geibel; William,0,0,20,20
1714208097330,CLRE 250,A00,511389,Morris; Sheldon,9993,0,9999,6
1714208098364,CLRE 251,A00,507176,Mehta; Ravindra L.,9993,0,9999,6
1714208098364,CLRE 251,B00,511410,Mehta; Ravindra L.,9998,0,9999,1
1714208099394,CLRE 252,A00,507189,Cuomo; Raphael Eduardo,9995,0,9999,4
1714208100419,CLRE 253,A00,507199,Vaida; Florin,9994,0,9999,5
1714208100419,CLRE 253,B00,507202,Vaida; Florin,9999,0,9999,0
1714208101499,CLRE 259,A00,507211,Patel; Hemal,9996,0,9999,3
1714208102522,CLRE 260,A00,507221,Cuomo; Raphael Eduardo,9999,0,9999,0
1714208103548,CLRE 297,001,507242,Cuomo; Raphael Eduardo,9999,0,9999,0
1714208104576,COGS 197,001,638244,Voytek; Bradley Thomas,9999,0,9999,0
1714208105602,CSE 191,A00,516875,Minnes Kemp; Mor Mia,9993,0,9999,6
1714208106628,CSE 197,001,637388,Minnes Kemp; Mor Mia,9998,0,9999,1
1714208107656,CSS 201S,A01,494383,Staff,35,0,35,0
1714208108685,CSS 202S,A01,494387,Staff,35,0,35,0
1714208109715,DSC 197,001,628532,Eldridge; Justin Matthew,9996,0,9999,3
1714208110742,EAP 100,A00,516065,Staff,9797,0,9999,202
1714208111769,ECE 45,A01,507414,Staff,33,0,60,27
1714208113821,ECE 111,A01,507420,Staff,21,0,50,29
1714208114847,ECE 197,001,548057,Sievenpiper; Daniel F.,9994,0,9999,5
1714208115873,EDS 115,A00,507243,Choi; Bailey Miyeon,12,0,28,16
1714208116904,EDS 117,A01,494379,Staff,0,1,30,30
1714208117929,EDS 125,A00,507246,Hopkins; Megan Beth,12,0,30,18
1714208118960,EDS 128A,A01,507264,Fargason; Sharon Gayle,14,0,26,12
1714208119987,EDS 128B,A01,507293,Pappas; Elizabeth,18,0,30,12
1714208121014,EDS 139,A00,507294,Fargason; Sharon Gayle,18,0,30,12
1714208121014,EDS 139,B00,507313,Pappas; Elizabeth,15,0,30,15
1714208122041,EDS 201,A00,507315,Staff,13,0,30,17
1714208123067,EDS 203,A01,507317,Halter; Christopher P.,12,0,30,18
1714208124097,EDS 204R,A01,507319,Halter; Christopher P.,0,3,30,30
1714208124097,EDS 204R,B01,507331,Heinzman; Erica M.,17,0,30,13
1714208125124,EDS 206R,A00,507332,Staff,0,4,30,30
1714208125124,EDS 206R,B00,507343,Staff,18,0,30,12
1714208126149,EDS 250,A00,507344,Hemans; Patricia Ann Benitez,22,0,40,18
1714208127175,EDS 281,A00,507345,Daly; Alan J.,18,0,18,0
1714208128201,EDS 284,A00,507350,Daly; Alan J.,16,0,16,0
1714208129227,EDS 286,A00,507359,Fine; Sarah,18,0,18,0
1714208130256,EDS 289C,A01,507361,Daly; Alan J.,18,0,18,0
1714208131281,EDS 290,A00,507366,Hofstetter; Carolyn,15,0,15,0
1714208132313,LIGM 5A,A00,507421,Fischer-Grunski; Eva K,18,0,20,2
1714208133342,LIGM 5B,A00,507423,Fischer-Grunski; Eva K,19,0,20,1
1714208134370,LIGM 5C,A00,507425,Fischer-Grunski; Eva K,19,0,20,1
1714208135396,LIIT 5AS,A00,507427,Carnelos; Chiara,20,0,20,0
1714208136423,LIIT 5BS,A00,507430,Carnelos; Chiara,20,0,20,0
1714208137449,LIIT 5CS,A00,507432,Carnelos; Chiara,20,0,20,0
1714208138480,LISP 5A,A00,507541,Munoz Sanchez; Alicia,11,0,20,9
1714208139505,LISP 5B,A00,507671,Munoz Sanchez; Alicia,9,0,20,11
1714208140537,LISP 5C,A00,507696,Munoz Sanchez; Alicia,9,0,20,11
1714208141563,MAE 197,001,528363,Boechler; Nicholas Sebastia,9998,0,9999,1
1714208142596,MATH 197,001,523477,Kedlaya; Kiran S.,9996,0,9999,3
1714208142596,MATH 197,002,563811,Zhang; Danna,9995,0,9999,4
1714208142596,MATH 197,003,628552,Dumitriu; Ioana,9998,0,9999,1
1714208143622,MCWP 40R,A00,518780,Staff,5,0,20,15
1714208143622,MCWP 40R,B00,518781,Staff,7,0,20,13
1714208143622,MCWP 40R,C00,518783,Staff,5,0,20,15
1714208144648,MCWP 50R,A00,518791,Staff,0,0,20,20
1714208144648,MCWP 50R,B00,518792,Staff,0,1,20,20
1714208144648,MCWP 50R,C00,518793,Staff,0,1,20,20
1714208144648,MCWP 50R,D00,518794,Staff,0,0,20,20
1714208144648,MCWP 50R,E00,518795,Staff,0,1,20,20
1714208144648,MCWP 50R,F00,518796,Staff,0,0,20,20
1714208144648,MCWP 50R,G00,518797,Staff,0,1,20,20
1714208145685,MMW 12R,A01,514034,Herbst; Matthew,0,1,16,16
1714208145685,MMW 12R,A02,514035,Herbst; Matthew,2,0,16,14
1714208146714,MMW 13R,A01,514037,Staff,0,4,16,16
1714208146714,MMW 13R,A02,514039,Staff,0,2,16,16
1714208146714,MMW 13R,A03,628519,Staff,0,2,16,16
1714208148768,SIO 295LS,A00,523233,Staff,13,0,30,17
1714208149798,SIO 295S,A00,523232,Staff,13,0,30,17
1714208150826,SIOC 290S,A01,637330,Merrifield; Mark A,28,0,30,2
1714208151852,SIOC 291S,A01,637333,Gabriel; Corey John,28,0,30,2
1714208152884,SOCI 117,A01,494376,Staff,0,2,5,5
1714208153910,WES 237B,A00,494380,Staff,9,0,20,11
1714208156007,AESE 279B,A00,494370,Wade; Jon P,0,0,33,33
1714208157041,AIP 197,001,627712,Vespa; Emanuel Ignacio,9998,0,9999,1
1714208158068,ANAR 135S,A00,494369,Braswell; Geoffrey E.,0,0,0,0
1714208159093,BENG 196,001,628496,Engler; Adam J.,9998,0,9999,1
1714208160127,CAT 124RS,A01,519847,Geibel; William,0,0,20,20
1714208161152,CAT 125RS,A01,515971,Geibel; William,0,0,20,20
1714208162185,CLRE 250,A00,511389,Morris; Sheldon,9993,0,9999,6
1714208163219,CLRE 251,A00,507176,Mehta; Ravindra L.,9993,0,9999,6
1714208163219,CLRE 251,B00,511410,Mehta; Ravindra L.,9998,0,9999,1
1714208164246,CLRE 252,A00,507189,Cuomo; Raphael Eduardo,9995,0,9999,4
1714208165274,CLRE 253,A00,507199,Vaida; Florin,9994,0,9999,5
1714208165274,CLRE 253,B00,507202,Vaida; Florin,9999,0,9999,0
1714208166300,CLRE 259,A00,507211,Patel; Hemal,9996,0,9999,3
1714208167326,CLRE 260,A00,507221,Cuomo; Raphael Eduardo,9999,0,9999,0
1714208168356,CLRE 297,001,507242,Cuomo; Raphael Eduardo,9999,0,9999,0
1714208169388,COGS 197,001,638244,Voytek; Bradley Thomas,9999,0,9999,0
1714208170416,CSE 191,A00,516875,Minnes Kemp; Mor Mia,9993,0,9999,6
1714208171442,CSE 197,001,637388,Minnes Kemp; Mor Mia,9998,0,9999,1
1714208172476,CSS 201S,A01,494383,Staff,35,0,35,0
1714208173501,CSS 202S,A01,494387,Staff,35,0,35,0
1714208174528,DSC 197,001,628532,Eldridge; Justin Matthew,9996,0,9999,3
1714208175556,EAP 100,A00,516065,Staff,9797,0,9999,202
1714208176582,ECE 45,A01,507414,Staff,33,0,60,27
1714208178633,ECE 111,A01,507420,Staff,21,0,50,29
1714208179659,ECE 197,001,548057,Sievenpiper; Daniel F.,9994,0,9999,5
1714208180690,EDS 115,A00,507243,Choi; Bailey Miyeon,12,0,28,16
1714208181718,EDS 117,A01,494379,Staff,0,1,30,30
1714208182748,EDS 125,A00,507246,Hopkins; Megan Beth,12,0,30,18
1714208183775,EDS 128A,A01,507264,Fargason; Sharon Gayle,14,0,26,12
1714208184801,EDS 128B,A01,507293,Pappas; Elizabeth,18,0,30,12
1714208185825,EDS 139,A00,507294,Fargason; Sharon Gayle,18,0,30,12
1714208185825,EDS 139,B00,507313,Pappas; Elizabeth,15,0,30,15
1714208186852,EDS 201,A00,507315,Staff,13,0,30,17
1714208187879,EDS 203,A01,507317,Halter; Christopher P.,12,0,30,18
1714208188904,EDS 204R,A01,507319,Halter; Christopher P.,0,3,30,30
1714208188904,EDS 204R,B01,507331,Heinzman; Erica M.,17,0,30,13
1714208189930,EDS 206R,A00,507332,Staff,0,4,30,30
1714208189930,EDS 206R,B00,507343,Staff,18,0,30,12
1714208190956,EDS 250,A00,507344,Hemans; Patricia Ann Benitez,22,0,40,18
1714208191984,EDS 281,A00,507345,Daly; Alan J.,18,0,18,0
1714208193011,EDS 284,A00,507350,Daly; Alan J.,16,0,16,0
1714208194036,EDS 286,A00,507359,Fine; Sarah,18,0,18,0
1714208195060,EDS 289C,A01,507361,Daly; Alan J.,18,0,18,0
1714208196090,EDS 290,A00,507366,Hofstetter; Carolyn,15,0,15,0
1714208197121,LIGM 5A,A00,507421,Fischer-Grunski; Eva K,18,0,20,2
1714208198145,LIGM 5B,A00,507423,Fischer-Grunski; Eva K,19,0,20,1
1714208199172,LIGM 5C,A00,507425,Fischer-Grunski; Eva K,19,0,20,1
1714208200197,LIIT 5AS,A00,507427,Carnelos; Chiara,20,0,20,0
1714208201221,LIIT 5BS,A00,507430,Carnelos; Chiara,20,0,20,0
1714208202246,LIIT 5CS,A00,507432,Carnelos; Chiara,20,0,20,0
1714208203280,LISP 5A,A00,507541,Munoz Sanchez; Alicia,11,0,20,9
1714208204306,LISP 5B,A00,507671,Munoz Sanchez; Alicia,9,0,20,11
1714208205385,LISP 5C,A00,507696,Munoz Sanchez; Alicia,9,0,20,11
1714208206415,MAE 197,001,528363,Boechler; Nicholas Sebastia,9998,0,9999,1
1714208207450,MATH 197,001,523477,Kedlaya; Kiran S.,9996,0,9999,3
1714208207450,MATH 197,002,563811,Zhang; Danna,9995,0,9999,4
1714208207450,MATH 197,003,628552,Dumitriu; Ioana,9998,0,9999,1
1714208208475,MCWP 40R,A00,518780,Staff,5,0,20,15
1714208208475,MCWP 40R,B00,518781,Staff,7,0,20,13
1714208208475,MCWP 40R,C00,518783,Staff,5,0,20,15
1714208209506,MCWP 50R,A00,518791,Staff,0,0,20,20
1714208209506,MCWP 50R,B00,518792,Staff,0,1,20,20
1714208209506,MCWP 50R,C00,518793,Staff,0,1,20,20
1714208209506,MCWP 50R,D00,518794,Staff,0,0,20,20
1714208209506,MCWP 50R,E00,518795,Staff,0,1,20,20
1714208209506,MCWP 50R,F00,518796,Staff,0,0,20,20
1714208209506,MCWP 50R,G00,518797,Staff,0,1,20,20
1714208210539,MMW 12R,A01,514034,Herbst; Matthew,0,1,16,16
1714208210539,MMW 12R,A02,514035,Herbst; Matthew,2,0,16,14
1714208211568,MMW 13R,A01,514037,Staff,0,4,16,16
1714208211568,MMW 13R,A02,514039,Staff,0,2,16,16
1714208211568,MMW 13R,A03,628519,Staff,0,2,16,16
1714208213619,SIO 295LS,A00,523233,Staff,13,0,30,17
1714208214644,SIO 295S,A00,523232,Staff,13,0,30,17
1714208215674,SIOC 290S,A01,637330,Merrifield; Mark A,28,0,30,2
1714208216702,SIOC 291S,A01,637333,Gabriel; Corey John,28,0,30,2
1714208217732,SOCI 117,A01,494376,Staff,0,2,5,5
1714208218761,WES 237B,A00,494380,Staff,9,0,20,11
1714208220835,AESE 279B,A00,494370,Wade; Jon P,0,0,33,33
1714208221860,AIP 197,001,627712,Vespa; Emanuel Ignacio,9998,0,9999,1
1714208222886,ANAR 135S,A00,494369,Braswell; Geoffrey E.,0,0,0,0
1714208223912,BENG 196,001,628496,Engler; Adam J.,9998,0,9999,1
1714208224937,CAT 124RS,A01,519847,Geibel; William,0,0,20,20
1714208225964,CAT 125RS,A01,515971,Geibel; William,0,0,20,20
1714208226993,CLRE 250,A00,511389,Morris; Sheldon,9993,0,9999,6
1714208228026,CLRE 251,A00,507176,Mehta; Ravindra L.,9993,0,9999,6
1714208228026,CLRE 251,B00,511410,Mehta; Ravindra L.,9998,0,9999,1
1714208229050,CLRE 252,A00,507189,Cuomo; Raphael Eduardo,9995,0,9999,4
1714208230075,CLRE 253,A00,507199,Vaida; Florin,9994,0,9999,5
1714208230075,CLRE 253,B00,507202,Vaida; Florin,9999,0,9999,0
1714208231100,CLRE 259,A00,507211,Patel; Hemal,9996,0,9999,3
1714208232125,CLRE 260,A00,507221,Cuomo; Raphael Eduardo,9999,0,9999,0
1714208233153,CLRE 297,001,507242,Cuomo; Raphael Eduardo,9999,0,9999,0
1714208234182,COGS 197,001,638244,Voytek; Bradley Thomas,9999,0,9999,0
1714208235211,CSE 191,A00,516875,Minnes Kemp; Mor Mia,9993,0,9999,6
1714208236237,CSE 197,001,637388,Minnes Kemp; Mor Mia,9998,0,9999,1
1714208237268,CSS 201S,A01,494383,Staff,35,0,35,0
1714208238293,CSS 202S,A01,494387,Staff,35,0,35,0
1714208239319,DSC 197,001,628532,Eldridge; Justin Matthew,9996,0,9999,3
1714208240345,EAP 100,A00,516065,Staff,9797,0,9999,202
1714208241375,ECE 45,A01,507414,Staff,33,0,60,27
1714208243434,ECE 111,A01,507420,Staff,21,0,50,29
1714208244458,ECE 197,001,548057,Sievenpiper; Daniel F.,9994,0,9999,5
1714208245487,EDS 115,A00,507243,Choi; Bailey Miyeon,12,0,28,16
1714208246522,EDS 117,A01,494379,Staff,0,1,30,30
1714208247551,EDS 125,A00,507246,Hopkins; Megan Beth,12,0,30,18
1714208248579,EDS 128A,A01,507264,Fargason; Sharon Gayle,14,0,26,12
1714208249605,EDS 128B,A01,507293,Pappas; Elizabeth,18,0,30,12
1714208250633,EDS 139,A00,507294,Fargason; Sharon Gayle,18,0,30,12
1714208250633,EDS 139,B00,507313,Pappas; Elizabeth,15,0,30,15
1714208251661,EDS 201,A00,507315,Staff,13,0,30,17
1714208252685,EDS 203,A01,507317,Halter; Christopher P.,12,0,30,18
1714208253713,EDS 204R,A01,507319,Halter; Christopher P.,0,3,30,30
1714208253713,EDS 204R,B01,507331,Heinzman; Erica M.,17,0,30,13
1714208254741,EDS 206R,A00,507332,Staff,0,4,30,30
1714208254741,EDS 206R,B00,507343,Staff,18,0,30,12
1714208255768,EDS 250,A00,507344,Hemans; Patricia Ann Benitez,22,0,40,18
1714208256797,EDS 281,A00,507345,Daly; Alan J.,18,0,18,0
1714208257822,EDS 284,A00,507350,Daly; Alan J.,16,0,16,0
1714208258853,EDS 286,A00,507359,Fine; Sarah,18,0,18,0
1714208259879,EDS 289C,A01,507361,Daly; Alan J.,18,0,18,0
1714208260906,EDS 290,A00,507366,Hofstetter; Carolyn,15,0,15,0
1714208261938,LIGM 5A,A00,507421,Fischer-Grunski; Eva K,18,0,20,2
1714208262964,LIGM 5B,A00,507423,Fischer-Grunski; Eva K,19,0,20,1
1714208263992,LIGM 5C,A00,507425,Fischer-Grunski; Eva K,19,0,20,1
1714208265020,LIIT 5AS,A00,507427,Carnelos; Chiara,20,0,20,0
1714208266044,LIIT 5BS,A00,507430,Carnelos; Chiara,20,0,20,0
1714208267070,LIIT 5CS,A00,507432,Carnelos; Chiara,20,0,20,0
1714208268096,LISP 5A,A00,507541,Munoz Sanchez; Alicia,11,0,20,9
1714208269123,LISP 5B,A00,507671,Munoz Sanchez; Alicia,9,0,20,11
1714208270152,LISP 5C,A00,507696,Munoz Sanchez; Alicia,9,0,20,11
1714208271178,MAE 197,001,528363,Boechler; Nicholas Sebastia,9998,0,9999,1
1714208272217,MATH 197,001,523477,Kedlaya; Kiran S.,9996,0,9999,3
1714208272217,MATH 197,002,563811,Zhang; Danna,9995,0,9999,4
1714208272217,MATH 197,003,628552,Dumitriu; Ioana,9998,0,9999,1
1714208273243,MCWP 40R,A00,518780,Staff,5,0,20,15
1714208273243,MCWP 40R,B00,518781,Staff,7,0,20,13
1714208273243,MCWP 40R,C00,518783,Staff,5,0,20,15
1714208274276,MCWP 50R,A00,518791,Staff,0,0,20,20
1714208274276,MCWP 50R,B00,518792,Staff,0,1,20,20
1714208274276,MCWP 50R,C00,518793,Staff,0,1,20,20
1714208274276,MCWP 50R,D00,518794,Staff,0,0,20,20
1714208274276,MCWP 50R,E00,518795,Staff,0,1,20,20
1714208274276,MCWP 50R,F00,518796,Staff,0,0,20,20
1714208274276,MCWP 50R,G00,518797,Staff,0,1,20,20
1714208275301,MMW 12R,A01,514034,Herbst; Matthew,0,1,16,16
1714208275301,MMW 12R,A02,514035,Herbst; Matthew,2,0,16,14
1714208276329,MMW 13R,A01,514037,Staff,0,4,16,16
1714208276329,MMW 13R,A02,514039,Staff,0,2,16,16
1714208276329,MMW 13R,A03,628519,Staff,0,2,16,16
1714208278380,SIO 295LS,A00,523233,Staff,13,0,30,17
1714208279405,SIO 295S,A00,523232,Staff,13,0,30,17
1714208280437,SIOC 290S,A01,637330,Merrifield; Mark A,28,0,30,2
1714208281466,SIOC 291S,A01,637333,Gabriel; Corey John,28,0,30,2
1714208282491,SOCI 117,A01,494376,Staff,0,2,5,5
1714208283521,WES 237B,A00,494380,Staff,9,0,20,11
1714208285606,AESE 279B,A00,494370,Wade; Jon P,0,0,33,33
1714208286632,AIP 197,001,627712,Vespa; Emanuel Ignacio,9998,0,9999,1
1714208287661,ANAR 135S,A00,494369,Braswell; Geoffrey E.,0,0,0,0
1714208288687,BENG 196,001,628496,Engler; Adam J.,9998,0,9999,1
1714208289713,CAT 124RS,A01,519847,Geibel; William,0,0,20,20
1714208290737,CAT 125RS,A01,515971,Geibel; William,0,0,20,20
1714208291764,CLRE 250,A00,511389,Morris; Sheldon,9993,0,9999,6
1714208292790,CLRE 251,A00,507176,Mehta; Ravindra L.,9993,0,9999,6
1714208292790,CLRE 251,B00,511410,Mehta; Ravindra L.,9998,0,9999,1
1714208293817,CLRE 252,A00,507189,Cuomo; Raphael Eduardo,9995,0,9999,4
1714208294842,CLRE 253,A00,507199,Vaida; Florin,9994,0,9999,5
1714208294842,CLRE 253,B00,507202,Vaida; Florin,9999,0,9999,0
1714208295871,CLRE 259,A00,507211,Patel; Hemal,9996,0,9999,3
1714208296897,CLRE 260,A00,507221,Cuomo; Raphael Eduardo,9999,0,9999,0
1714208297923,CLRE 297,001,507242,Cuomo; Raphael Eduardo,9999,0,9999,0
1714208298952,COGS 197,001,638244,Voytek; Bradley Thomas,9999,0,9999,0
1714208299978,CSE 191,A00,516875,Minnes Kemp; Mor Mia,9993,0,9999,6
1714208301006,CSE 197,001,637388,Minnes Kemp; Mor Mia,9998,0,9999,1
1714208302033,CSS 201S,A01,494383,Staff,35,0,35,0
1714208303059,CSS 202S,A01,494387,Staff,35,0,35,0
1714208304087,DSC 197,001,628532,Eldridge; Justin Matthew,9996,0,9999,3
1714208305114,EAP 100,A00,516065,Staff,9797,0,9999,202
1714208306140,ECE 45,A01,507414,Staff,33,0,60,27
1714208308192,ECE 111,A01,507420,Staff,21,0,50,29
1714208309273,ECE 197,001,548057,Sievenpiper; Daniel F.,9994,0,9999,5
1714208310302,EDS 115,A00,507243,Choi; Bailey Miyeon,12,0,28,16
1714208311337,EDS 117,A01,494379,Staff,0,1,30,30
1714208312368,EDS 125,A00,507246,Hopkins; Megan Beth,12,0,30,18
1714208313395,EDS 128A,A01,507264,Fargason; Sharon Gayle,14,0,26,12
1714208314424,EDS 128B,A01,507293,Pappas; Elizabeth,18,0,30,12
1714208315449,EDS 139,A00,507294,Fargason; Sharon Gayle,18,0,30,12
1714208315449,EDS 139,B00,507313,Pappas; Elizabeth,15,0,30,15
1714208316475,EDS 201,A00,507315,Staff,13,0,30,17
1714208317500,EDS 203,A01,507317,Halter; Christopher P.,12,0,30,18
1714208318528,EDS 204R,A01,507319,Halter; Christopher P.,0,3,30,30
1714208318528,EDS 204R,B01,507331,Heinzman; Erica M.,17,0,30,13
1714208319553,EDS 206R,A00,507332,Staff,0,4,30,30
1714208319553,EDS 206R,B00,507343,Staff,18,0,30,12
1714208320583,EDS 250,A00,507344,Hemans; Patricia Ann Benitez,22,0,40,18
1714208321611,EDS 281,A00,507345,Daly; Alan J.,18,0,18,0
1714208322640,EDS 284,A00,507350,Daly; Alan J.,16,0,16,0
1714208323670,EDS 286,A00,507359,Fine; Sarah,18,0,18,0
1714208324696,EDS 289C,A01,507361,Daly; Alan J.,18,0,18,0
1714208325725,EDS 290,A00,507366,Hofstetter; Carolyn,15,0,15,0
1714208326755,LIGM 5A,A00,507421,Fischer-Grunski; Eva K,18,0,20,2
1714208327779,LIGM 5B,A00,507423,Fischer-Grunski; Eva K,19,0,20,1
1714208328807,LIGM 5C,A00,507425,Fischer-Grunski; Eva K,19,0,20,1
1714208329836,LIIT 5AS,A00,507427,Carnelos; Chiara,20,0,20,0
1714208330864,LIIT 5BS,A00,507430,Carnelos; Chiara,20,0,20,0
1714208331894,LIIT 5CS,A00,507432,Carnelos; Chiara,20,0,20,0
1714208332919,LISP 5A,A00,507541,Munoz Sanchez; Alicia,11,0,20,9
1714208333945,LISP 5B,A00,507671,Munoz Sanchez; Alicia,9,0,20,11
1714208334972,LISP 5C,A00,507696,Munoz Sanchez; Alicia,9,0,20,11
1714208336000,MAE 197,001,528363,Boechler; Nicholas Sebastia,9998,0,9999,1
1714208337036,MATH 197,001,523477,Kedlaya; Kiran S.,9996,0,9999,3
1714208337036,MATH 197,002,563811,Zhang; Danna,9995,0,9999,4
1714208337036,MATH 197,003,628552,Dumitriu; Ioana,9998,0,9999,1
1714208338063,MCWP 40R,A00,518780,Staff,5,0,20,15
1714208338063,MCWP 40R,B00,518781,Staff,7,0,20,13
1714208338063,MCWP 40R,C00,518783,Staff,5,0,20,15
1714208339089,MCWP 50R,A00,518791,Staff,0,0,20,20
1714208339089,MCWP 50R,B00,518792,Staff,0,1,20,20
1714208339089,MCWP 50R,C00,518793,Staff,0,1,20,20
1714208339089,MCWP 50R,D00,518794,Staff,0,0,20,20
1714208339089,MCWP 50R,E00,518795,Staff,0,1,20,20
1714208339089,MCWP 50R,F00,518796,Staff,0,0,20,20
1714208339089,MCWP 50R,G00,518797,Staff,0,1,20,20
1714208340114,MMW 12R,A01,514034,Herbst; Matthew,0,1,16,16
1714208340114,MMW 12R,A02,514035,Herbst; Matthew,2,0,16,14
1714208341142,MMW 13R,A01,514037,Staff,0,4,16,16
1714208341142,MMW 13R,A02,514039,Staff,0,2,16,16
1714208341142,MMW 13R,A03,628519,Staff,0,2,16,16
1714208343194,SIO 295LS,A00,523233,Staff,13,0,30,17
1714208344218,SIO 295S,A00,523232,Staff,13,0,30,17
1714208345249,SIOC 290S,A01,637330,Merrifield; Mark A,28,0,30,2
1714208346273,SIOC 291S,A01,637333,Gabriel; Corey John,28,0,30,2
1714208347300,SOCI 117,A01,494376,Staff,0,2,5,5
1714208348328,WES 237B,A00,494380,Staff,9,0,20,11
1714208350405,AESE 279B,A00,494370,Wade; Jon P,0,0,33,33
1714208351432,AIP 197,001,627712,Vespa; Emanuel Ignacio,9998,0,9999,1
1714208352459,ANAR 135S,A00,494369,Braswell; Geoffrey E.,0,0,0,0
1714208353484,BENG 196,001,628496,Engler; Adam J.,9998,0,9999,1
1714208354512,CAT 124RS,A01,519847,Geibel; William,0,0,20,20
1714208355538,CAT 125RS,A01,515971,Geibel; William,0,0,20,20
1714208356568,CLRE 250,A00,511389,Morris; Sheldon,9993,0,9999,6
1714208357602,CLRE 251,A00,507176,Mehta; Ravindra L.,9993,0,9999,6
1714208357602,CLRE 251,B00,511410,Mehta; Ravindra L.,9998,0,9999,1
1714208358633,CLRE 252,A00,507189,Cuomo; Raphael Eduardo,9995,0,9999,4
1714208359658,CLRE 253,A00,507199,Vaida; Florin,9994,0,9999,5
1714208359658,CLRE 253,B00,507202,Vaida; Florin,9999,0,9999,0
1714208360685,CLRE 259,A00,507211,Patel; Hemal,9996,0,9999,3
1714208361711,CLRE 260,A00,507221,Cuomo; Raphael Eduardo,9999,0,9999,0
1714208362736,CLRE 297,001,507242,Cuomo; Raphael Eduardo,9999,0,9999,0
1714208363766,COGS 197,001,638244,Voytek; Bradley Thomas,9999,0,9999,0
1714208364792,CSE 191,A00,516875,Minnes Kemp; Mor Mia,9993,0,9999,6
1714208365819,CSE 197,001,637388,Minnes Kemp; Mor Mia,9998,0,9999,1
1714208366847,CSS 201S,A01,494383,Staff,35,0,35,0
1714208367872,CSS 202S,A01,494387,Staff,35,0,35,0
1714208368899,DSC 197,001,628532,Eldridge; Justin Matthew,9996,0,9999,3
1714208369926,EAP 100,A00,516065,Staff,9797,0,9999,202
1714208370955,ECE 45,A01,507414,Staff,33,0,60,27
1714208373012,ECE 111,A01,507420,Staff,21,0,50,29
1714208374040,ECE 197,001,548057,Sievenpiper; Daniel F.,9994,0,9999,5
1714208375068,EDS 115,A00,507243,Choi; Bailey Miyeon,12,0,28,16
1714208376093,EDS 117,A01,494379,Staff,0,1,30,30
1714208377132,EDS 125,A00,507246,Hopkins; Megan Beth,12,0,30,18
1714208378157,EDS 128A,A01,507264,Fargason; Sharon Gayle,14,0,26,12
1714208379182,EDS 128B,A01,507293,Pappas; Elizabeth,18,0,30,12
1714208380208,EDS 139,A00,507294,Fargason; Sharon Gayle,18,0,30,12
1714208380208,EDS 139,B00,507313,Pappas; Elizabeth,15,0,30,15
1714208381233,EDS 201,A00,507315,Staff,13,0,30,17
1714208382264,EDS 203,A01,507317,Halter; Christopher P.,12,0,30,18
1714208383291,EDS 204R,A01,507319,Halter; Christopher P.,0,3,30,30
1714208383291,EDS 204R,B01,507331,Heinzman; Erica M.,17,0,30,13
1714208384317,EDS 206R,A00,507332,Staff,0,4,30,30
1714208384317,EDS 206R,B00,507343,Staff,18,0,30,12
1714208385342,EDS 250,A00,507344,Hemans; Patricia Ann Benitez,22,0,40,18
1714208386372,EDS 281,A00,507345,Daly; Alan J.,18,0,18,0
1714208387397,EDS 284,A00,507350,Daly; Alan J.,16,0,16,0
1714208388423,EDS 286,A00,507359,Fine; Sarah,18,0,18,0
1714208389449,EDS 289C,A01,507361,Daly; Alan J.,18,0,18,0
1714208390477,EDS 290,A00,507366,Hofstetter; Carolyn,15,0,15,0
1714208391505,LIGM 5A,A00,507421,Fischer-Grunski; Eva K,18,0,20,2
1714208392531,LIGM 5B,A00,507423,Fischer-Grunski; Eva K,19,0,20,1
1714208393561,LIGM 5C,A00,507425,Fischer-Grunski; Eva K,19,0,20,1
1714208394588,LIIT 5AS,A00,507427,Carnelos; Chiara,20,0,20,0
1714208395612,LIIT 5BS,A00,507430,Carnelos; Chiara,20,0,20,0
1714208396637,LIIT 5CS,A00,507432,Carnelos; Chiara,20,0,20,0
1714208397668,LISP 5A,A00,507541,Munoz Sanchez; Alicia,11,0,20,9
1714208398693,LISP 5B,A00,507671,Munoz Sanchez; Alicia,9,0,20,11
1714208399722,LISP 5C,A00,507696,Munoz Sanchez; Alicia,9,0,20,11
1714208400759,MAE 197,001,528363,Boechler; Nicholas Sebastia,9998,0,9999,1
1714208401790,MATH 197,001,523477,Kedlaya; Kiran S.,9996,0,9999,3
1714208401790,MATH 197,002,563811,Zhang; Danna,9995,0,9999,4
1714208401790,MATH 197,003,628552,Dumitriu; Ioana,9998,0,9999,1
1714208402817,MCWP 40R,A00,518780,Staff,5,0,20,15
1714208402817,MCWP 40R,B00,518781,Staff,7,0,20,13
1714208402817,MCWP 40R,C00,518783,Staff,5,0,20,15
1714208403844,MCWP 50R,A00,518791,Staff,0,0,20,20
1714208403844,MCWP 50R,B00,518792,Staff,0,1,20,20
1714208403844,MCWP 50R,C00,518793,Staff,0,1,20,20
1714208403844,MCWP 50R,D00,518794,Staff,0,0,20,20
1714208403844,MCWP 50R,E00,518795,Staff,0,1,20,20
1714208403844,MCWP 50R,F00,518796,Staff,0,0,20,20
1714208403844,MCWP 50R,G00,518797,Staff,0,1,20,20
1714208404872,MMW 12R,A01,514034,Herbst; Matthew,0,1,16,16
1714208404872,MMW 12R,A02,514035,Herbst; Matthew,2,0,16,14
1714208405900,MMW 13R,A01,514037,Staff,0,4,16,16
1714208405900,MMW 13R,A02,514039,Staff,0,2,16,16
1714208405900,MMW 13R,A03,628519,Staff,0,2,16,16
1714208407957,SIO 295LS,A00,523233,Staff,13,0,30,17
1714208408983,SIO 295S,A00,523232,Staff,13,0,30,17
1714208410009,SIOC 290S,A01,637330,Merrifield; Mark A,28,0,30,2
1714208411035,SIOC 291S,A01,637333,Gabriel; Corey John,28,0,30,2
1714208412061,SOCI 117,A01,494376,Staff,0,2,5,5
1714208413144,WES 237B,A00,494380,Staff,9,0,20,11
1714208415215,AESE 279B,A00,494370,Wade; Jon P,0,0,33,33
1714208416246,AIP 197,001,627712,Vespa; Emanuel Ignacio,9998,0,9999,1
1714208417272,ANAR 135S,A00,494369,Braswell; Geoffrey E.,0,0,0,0
1714208418301,BENG 196,001,628496,Engler; Adam J.,9998,0,9999,1
1714208419327,CAT 124RS,A01,519847,Geibel; William,0,0,20,20
1714208420352,CAT 125RS,A01,515971,Geibel; William,0,0,20,20
1714208421379,CLRE 250,A00,511389,Morris; Sheldon,9993,0,9999,6
1714208422406,CLRE 251,A00,507176,Mehta; Ravindra L.,9993,0,9999,6
1714208422406,CLRE 251,B00,511410,Mehta; Ravindra L.,9998,0,9999,1
1714208423432,CLRE 252,A00,507189,Cuomo; Raphael Eduardo,9995,0,9999,4
1714208424462,CLRE 253,A00,507199,Vaida; Florin,9994,0,9999,5
1714208424462,CLRE 253,B00,507202,Vaida; Florin,9999,0,9999,0
1714208425487,CLRE 259,A00,507211,Patel; Hemal,9996,0,9999,3
1714208426511,CLRE 260,A00,507221,Cuomo; Raphael Eduardo,9999,0,9999,0
1714208427536,CLRE 297,001,507242,Cuomo; Raphael Eduardo,9999,0,9999,0
1714208428566,COGS 197,001,638244,Voytek; Bradley Thomas,9999,0,9999,0
1714208429592,CSE 191,A00,516875,Minnes Kemp; Mor Mia,9993,0,9999,6
1714208430627,CSE 197,001,637388,Minnes Kemp; Mor Mia,9998,0,9999,1
1714208431653,CSS 201S,A01,494383,Staff,35,0,35,0
1714208432679,CSS 202S,A01,494387,Staff,35,0,35,0
1714208433707,DSC 197,001,628532,Eldridge; Justin Matthew,9996,0,9999,3
1714208434732,EAP 100,A00,516065,Staff,9797,0,9999,202
1714208435758,ECE 45,A01,507414,Staff,33,0,60,27
1714208437812,ECE 111,A01,507420,Staff,21,0,50,29
1714208438842,ECE 197,001,548057,Sievenpiper; Daniel F.,9994,0,9999,5
1714208439876,EDS 115,A00,507243,Choi; Bailey Miyeon,12,0,28,16
1714208440902,EDS 117,A01,494379,Staff,0,1,30,30
1714208441928,EDS 125,A00,507246,Hopkins; Megan Beth,12,0,30,18
1714208442955,EDS 128A,A01,507264,Fargason; Sharon Gayle,14,0,26,12
1714208443980,EDS 128B,A01,507293,Pappas; Elizabeth,18,0,30,12
1714208445005,EDS 139,A00,507294,Fargason; Sharon Gayle,18,0,30,12
1714208445005,EDS 139,B00,507313,Pappas; Elizabeth,15,0,30,15
1714208446032,EDS 201,A00,507315,Staff,13,0,30,17
1714208447058,EDS 203,A01,507317,Halter; Christopher P.,12,0,30,18
1714208448088,EDS 204R,A01,507319,Halter; Christopher P.,0,3,30,30
1714208448088,EDS 204R,B01,507331,Heinzman; Erica M.,17,0,30,13
1714208449116,EDS 206R,A00,507332,Staff,0,4,30,30
1714208449116,EDS 206R,B00,507343,Staff,18,0,30,12
1714208450147,EDS 250,A00,507344,Hemans; Patricia Ann Benitez,22,0,40,18
1714208451174,EDS 281,A00,507345,Daly; Alan J.,18,0,18,0
1714208452202,EDS 284,A00,507350,Daly; Alan J.,16,0,16,0
1714208453234,EDS 286,A00,507359,Fine; Sarah,18,0,18,0
1714208454259,EDS 289C,A01,507361,Daly; Alan J.,18,0,18,0
1714208455285,EDS 290,A00,507366,Hofstetter; Carolyn,15,0,15,0
1714208456312,LIGM 5A,A00,507421,Fischer-Grunski; Eva K,18,0,20,2
1714208457337,LIGM 5B,A00,507423,Fischer-Grunski; Eva K,19,0,20,1
1714208458366,LIGM 5C,A00,507425,Fischer-Grunski; Eva K,19,0,20,1
1714208459391,LIIT 5AS,A00,507427,Carnelos; Chiara,20,0,20,0
1714208460421,LIIT 5BS,A00,507430,Carnelos; Chiara,20,0,20,0
1714208461450,LIIT 5CS,A00,507432,Carnelos; Chiara,20,0,20,0
1714208462477,LISP 5A,A00,507541,Munoz Sanchez; Alicia,11,0,20,9
1714208463507,LISP 5B,A00,507671,Munoz Sanchez; Alicia,9,0,20,11
1714208464534,LISP 5C,A00,507696,Munoz Sanchez; Alicia,9,0,20,11
1714208465560,MAE 197,001,528363,Boechler; Nicholas Sebastia,9998,0,9999,1
1714208466587,MATH 197,001,523477,Kedlaya; Kiran S.,9996,0,9999,3
1714208466587,MATH 197,002,563811,Zhang; Danna,9995,0,9999,4
1714208466587,MATH 197,003,628552,Dumitriu; Ioana,9998,0,9999,1
1714208467614,MCWP 40R,A00,518780,Staff,5,0,20,15
1714208467614,MCWP 40R,B00,518781,Staff,7,0,20,13
1714208467614,MCWP 40R,C00,518783,Staff,5,0,20,15
1714208468645,MCWP 50R,A00,518791,Staff,0,0,20,20
1714208468645,MCWP 50R,B00,518792,Staff,0,1,20,20
1714208468645,MCWP 50R,C00,518793,Staff,0,1,20,20
1714208468645,MCWP 50R,D00,518794,Staff,0,0,20,20
1714208468645,MCWP 50R,E00,518795,Staff,0,1,20,20
1714208468645,MCWP 50R,F00,518796,Staff,0,0,20,20
1714208468645,MCWP 50R,G00,518797,Staff,0,1,20,20
1714208469676,MMW 12R,A01,514034,Herbst; Matthew,0,1,16,16
1714208469676,MMW 12R,A02,514035,Herbst; Matthew,2,0,16,14
1714208470701,MMW 13R,A01,514037,Staff,0,4,16,16
1714208470701,MMW 13R,A02,514039,Staff,0,2,16,16
1714208470701,MMW 13R,A03,628519,Staff,0,2,16,16
1714208472756,SIO 295LS,A00,523233,Staff,13,0,30,17
1714208473781,SIO 295S,A00,523232,Staff,13,0,30,17
1714208474814,SIOC 290S,A01,637330,Merrifield; Mark A,28,0,30,2
1714208475844,SIOC 291S,A01,637333,Gabriel; Corey John,28,0,30,2
1714208476874,SOCI 117,A01,494376,Staff,0,2,5,5
1714208477901,WES 237B,A00,494380,Staff,9,0,20,11
1714208479995,AESE 279B,A00,494370,Wade; Jon P,0,0,33,33
1714208481021,AIP 197,001,627712,Vespa; Emanuel Ignacio,9998,0,9999,1
1714208482048,ANAR 135S,A00,494369,Braswell; Geoffrey E.,0,0,0,0
1714208483073,BENG 196,001,628496,Engler; Adam J.,9998,0,9999,1
1714208484102,CAT 124RS,A01,519847,Geibel; William,0,0,20,20
1714208485132,CAT 125RS,A01,515971,Geibel; William,0,0,20,20
1714208486158,CLRE 250,A00,511389,Morris; Sheldon,9993,0,9999,6
1714208487193,CLRE 251,A00,507176,Mehta; Ravindra L.,9993,0,9999,6
1714208487193,CLRE 251,B00,511410,Mehta; Ravindra L.,9998,0,9999,1
1714208488223,CLRE 252,A00,507189,Cuomo; Raphael Eduardo,9995,0,9999,4
1714208489247,CLRE 253,A00,507199,Vaida; Florin,9994,0,9999,5
1714208489247,CLRE 253,B00,507202,Vaida; Florin,9999,0,9999,0
1714208490273,CLRE 259,A00,507211,Patel; Hemal,9996,0,9999,3
1714208491299,CLRE 260,A00,507221,Cuomo; Raphael Eduardo,9999,0,9999,0
1714208492323,CLRE 297,001,507242,Cuomo; Raphael Eduardo,9999,0,9999,0
1714208493353,COGS 197,001,638244,Voytek; Bradley Thomas,9999,0,9999,0
1714208494379,CSE 191,A00,516875,Minnes Kemp; Mor Mia,9993,0,9999,6
1714208495408,CSE 197,001,637388,Minnes Kemp; Mor Mia,9998,0,9999,1
1714208496439,CSS 201S,A01,494383,Staff,35,0,35,0
1714208497469,CSS 202S,A01,494387,Staff,35,0,35,0
1714208498499,DSC 197,001,628532,Eldridge; Justin Matthew,9996,0,9999,3
1714208499524,EAP 100,A00,516065,Staff,9797,0,9999,202
1714208500551,ECE 45,A01,507414,Staff,33,0,60,27
1714208502605,ECE 111,A01,507420,Staff,21,0,50,29
1714208503632,ECE 197,001,548057,Sievenpiper; Daniel F.,9994,0,9999,5
1714208504661,EDS 115,A00,507243,Choi; Bailey Miyeon,12,0,28,16
1714208505693,EDS 117,A01,494379,Staff,0,1,30,30
1714208506723,EDS 125,A00,507246,Hopkins; Megan Beth,12,0,30,18
1714208507750,EDS 128A,A01,507264,Fargason; Sharon Gayle,14,0,26,12
1714208508780,EDS 128B,A01,507293,Pappas; Elizabeth,18,0,30,12
1714208509805,EDS 139,A00,507294,Fargason; Sharon Gayle,18,0,30,12
1714208509805,EDS 139,B00,507313,Pappas; Elizabeth,15,0,30,15
1714208510831,EDS 201,A00,507315,Staff,13,0,30,17
1714208511864,EDS 203,A01,507317,Halter; Christopher P.,12,0,30,18
1714208512890,EDS 204R,A01,507319,Halter; Christopher P.,0,3,30,30
1714208512890,EDS 204R,B01,507331,Heinzman; Erica M.,17,0,30,13
1714208513919,EDS 206R,A00,507332,Staff,0,4,30,30
1714208513919,EDS 206R,B00,507343,Staff,18,0,30,12
1714208514945,EDS 250,A00,507344,Hemans; Patricia Ann Benitez,22,0,40,18
1714208515974,EDS 281,A00,507345,Daly; Alan J.,18,0,18,0
1714208517054,EDS 284,A00,507350,Daly; Alan J.,16,0,16,0
1714208518084,EDS 286,A00,507359,Fine; Sarah,18,0,18,0
1714208519112,EDS 289C,A01,507361,Daly; Alan J.,18,0,18,0
1714208520139,EDS 290,A00,507366,Hofstetter; Carolyn,15,0,15,0
1714208521172,LIGM 5A,A00,507421,Fischer-Grunski; Eva K,18,0,20,2
1714208522201,LIGM 5B,A00,507423,Fischer-Grunski; Eva K,19,0,20,1
1714208523230,LIGM 5C,A00,507425,Fischer-Grunski; Eva K,19,0,20,1
1714208524257,LIIT 5AS,A00,507427,Carnelos; Chiara,20,0,20,0
1714208525283,LIIT 5BS,A00,507430,Carnelos; Chiara,20,0,20,0
1714208526309,LIIT 5CS,A00,507432,Carnelos; Chiara,20,0,20,0
1714208527337,LISP 5A,A00,507541,Munoz Sanchez; Alicia,11,0,20,9
1714208528364,LISP 5B,A00,507671,Munoz Sanchez; Alicia,9,0,20,11
1714208529392,LISP 5C,A00,507696,Munoz Sanchez; Alicia,9,0,20,11
1714208530418,MAE 197,001,528363,Boechler; Nicholas Sebastia,9998,0,9999,1
1714208531447,MATH 197,001,523477,Kedlaya; Kiran S.,9996,0,9999,3
1714208531447,MATH 197,002,563811,Zhang; Danna,9995,0,9999,4
1714208531447,MATH 197,003,628552,Dumitriu; Ioana,9998,0,9999,1
1714208532474,MCWP 40R,A00,518780,Staff,5,0,20,15
1714208532474,MCWP 40R,B00,518781,Staff,7,0,20,13
1714208532474,MCWP 40R,C00,518783,Staff,5,0,20,15
1714208533501,MCWP 50R,A00,518791,Staff,0,0,20,20
1714208533501,MCWP 50R,B00,518792,Staff,0,1,20,20
1714208533501,MCWP 50R,C00,518793,Staff,0,1,20,20
1714208533501,MCWP 50R,D00,518794,Staff,0,0,20,20
1714208533501,MCWP 50R,E00,518795,Staff,0,1,20,20
1714208533501,MCWP 50R,F00,518796,Staff,0,0,20,20
1714208533501,MCWP 50R,G00,518797,Staff,0,1,20,20
1714208534527,MMW 12R,A01,514034,Herbst; Matthew,0,1,16,16
1714208534527,MMW 12R,A02,514035,Herbst; Matthew,2,0,16,14
1714208535554,MMW 13R,A01,514037,Staff,0,4,16,16
1714208535554,MMW 13R,A02,514039,Staff,0,2,16,16
1714208535554,MMW 13R,A03,628519,Staff,0,2,16,16
1714208537610,SIO 295LS,A00,523233,Staff,13,0,30,17
1714208538636,SIO 295S,A00,523232,Staff,13,0,30,17
1714208539668,SIOC 290S,A01,637330,Merrifield; Mark A,28,0,30,2
1714208540693,SIOC 291S,A01,637333,Gabriel; Corey John,28,0,30,2
1714208541722,SOCI 117,A01,494376,Staff,0,2,5,5
1714208542749,WES 237B,A00,494380,Staff,9,0,20,11
1714208544822,AESE 279B,A00,494370,Wade; Jon P,0,0,33,33
1714208545851,AIP 197,001,627712,Vespa; Emanuel Ignacio,9998,0,9999,1
1714208546880,ANAR 135S,A00,494369,Braswell; Geoffrey E.,0,0,0,0
1714208547907,BENG 196,001,628496,Engler; Adam J.,9998,0,9999,1
1714208548933,CAT 124RS,A01,519847,Geibel; William,0,0,20,20
1714208549958,CAT 125RS,A01,515971,Geibel; William,0,0,20,20
1714208550989,CLRE 250,A00,511389,Morris; Sheldon,9993,0,9999,6
1714208552019,CLRE 251,A00,507176,Mehta; Ravindra L.,9993,0,9999,6
1714208552019,CLRE 251,B00,511410,Mehta; Ravindra L.,9998,0,9999,1
1714208553050,CLRE 252,A00,507189,Cuomo; Raphael Eduardo,9995,0,9999,4
1714208554083,CLRE 253,A00,507199,Vaida; Florin,9994,0,9999,5
1714208554083,CLRE 253,B00,507202,Vaida; Florin,9999,0,9999,0
1714208555108,CLRE 259,A00,507211,Patel; Hemal,9996,0,9999,3
1714208556134,CLRE 260,A00,507221,Cuomo; Raphael Eduardo,9999,0,9999,0
1714208557162,CLRE 297,001,507242,Cuomo; Raphael Eduardo,9999,0,9999,0
1714208558188,COGS 197,001,638244,Voytek; Bradley Thomas,9999,0,9999,0
1714208559216,CSE 191,A00,516875,Minnes Kemp; Mor Mia,9993,0,9999,6
1714208560242,CSE 197,001,637388,Minnes Kemp; Mor Mia,9998,0,9999,1
1714208561276,CSS 201S,A01,494383,Staff,35,0,35,0
1714208562301,CSS 202S,A01,494387,Staff,35,0,35,0
1714208563326,DSC 197,001,628532,Eldridge; Justin Matthew,9996,0,9999,3
1714208564353,EAP 100,A00,516065,Staff,9797,0,9999,202
1714208565380,ECE 45,A01,507414,Staff,33,0,60,27
1714208567434,ECE 111,A01,507420,Staff,21,0,50,29
1714208568460,ECE 197,001,548057,Sievenpiper; Daniel F.,9994,0,9999,5
1714208569488,EDS 115,A00,507243,Choi; Bailey Miyeon,12,0,28,16
1714208570516,EDS 117,A01,494379,Staff,0,1,30,30
1714208571543,EDS 125,A00,507246,Hopkins; Megan Beth,12,0,30,18
1714208572568,EDS 128A,A01,507264,Fargason; Sharon Gayle,14,0,26,12
1714208573593,EDS 128B,A01,507293,Pappas; Elizabeth,18,0,30,12
1714208574621,EDS 139,A00,507294,Fargason; Sharon Gayle,18,0,30,12
1714208574621,EDS 139,B00,507313,Pappas; Elizabeth,15,0,30,15
1714208575645,EDS 201,A00,507315,Staff,13,0,30,17
1714208576674,EDS 203,A01,507317,Halter; Christopher P.,12,0,30,18
1714208577699,EDS 204R,A01,507319,Halter; Christopher P.,0,3,30,30
1714208577699,EDS 204R,B01,507331,Heinzman; Erica M.,17,0,30,13
1714208578728,EDS 206R,A00,507332,Staff,0,4,30,30
1714208578728,EDS 206R,B00,507343,Staff,18,0,30,12
1714208579753,EDS 250,A00,507344,Hemans; Patricia Ann Benitez,22,0,40,18
1714208580784,EDS 281,A00,507345,Daly; Alan J.,18,0,18,0
1714208581812,EDS 284,A00,507350,Daly; Alan J.,16,0,16,0
1714208582841,EDS 286,A00,507359,Fine; Sarah,18,0,18,0
1714208583866,EDS 289C,A01,507361,Daly; Alan J.,18,0,18,0
1714208584896,EDS 290,A00,507366,Hofstetter; Carolyn,15,0,15,0
1714208585922,LIGM 5A,A00,507421,Fischer-Grunski; Eva K,18,0,20,2
1714208586947,LIGM 5B,A00,507423,Fischer-Grunski; Eva K,19,0,20,1
1714208587973,LIGM 5C,A00,507425,Fischer-Grunski; Eva K,19,0,20,1
1714208589004,LIIT 5AS,A00,507427,Carnelos; Chiara,20,0,20,0
1714208590032,LIIT 5BS,A00,507430,Carnelos; Chiara,20,0,20,0
1714208591061,LIIT 5CS,A00,507432,Carnelos; Chiara,20,0,20,0
1714208592087,LISP 5A,A00,507541,Munoz Sanchez; Alicia,11,0,20,9
1714208593112,LISP 5B,A00,507671,Munoz Sanchez; Alicia,9,0,20,11
1714208594142,LISP 5C,A00,507696,Munoz Sanchez; Alicia,9,0,20,11
1714208595171,MAE 197,001,528363,Boechler; Nicholas Sebastia,9998,0,9999,1
1714208596198,MATH 197,001,523477,Kedlaya; Kiran S.,9996,0,9999,3
1714208596198,MATH 197,002,563811,Zhang; Danna,9995,0,9999,4
1714208596198,MATH 197,003,628552,Dumitriu; Ioana,9998,0,9999,1
1714208597226,MCWP 40R,A00,518780,Staff,5,0,20,15
1714208597226,MCWP 40R,B00,518781,Staff,7,0,20,13
1714208597226,MCWP 40R,C00,518783,Staff,5,0,20,15
1714208598252,MCWP 50R,A00,518791,Staff,0,0,20,20
1714208598252,MCWP 50R,B00,518792,Staff,0,1,20,20
1714208598252,MCWP 50R,C00,518793,Staff,0,1,20,20
1714208598252,MCWP 50R,D00,518794,Staff,0,0,20,20
1714208598252,MCWP 50R,E00,518795,Staff,0,1,20,20
1714208598252,MCWP 50R,F00,518796,Staff,0,0,20,20
1714208598252,MCWP 50R,G00,518797,Staff,0,1,20,20
1714208599279,MMW 12R,A01,514034,Herbst; Matthew,0,1,16,16
1714208599279,MMW 12R,A02,514035,Herbst; Matthew,2,0,16,14
1714208600309,MMW 13R,A01,514037,Staff,0,4,16,16
1714208600309,MMW 13R,A02,514039,Staff,0,2,16,16
1714208600309,MMW 13R,A03,628519,Staff,0,2,16,16
1714208602362,SIO 295LS,A00,523233,Staff,13,0,30,17
1714208603392,SIO 295S,A00,523232,Staff,13,0,30,17
1714208604417,SIOC 290S,A01,637330,Merrifield; Mark A,28,0,30,2
1714208605443,SIOC 291S,A01,637333,Gabriel; Corey John,28,0,30,2
1714208606470,SOCI 117,A01,494376,Staff,0,2,5,5
1714208607496,WES 237B,A00,494380,Staff,9,0,20,11
1714208609586,AESE 279B,A00,494370,Wade; Jon P,0,0,33,33
1714208610611,AIP 197,001,627712,Vespa; Emanuel Ignacio,9998,0,9999,1
1714208611637,ANAR 135S,A00,494369,Braswell; Geoffrey E.,0,0,0,0
1714208612665,BENG 196,001,628496,Engler; Adam J.,9998,0,9999,1
1714208613691,CAT 124RS,A01,519847,Geibel; William,0,0,20,20
1714208614718,CAT 125RS,A01,515971,Geibel; William,0,0,20,20
1714208615748,CLRE 250,A00,511389,Morris; Sheldon,9993,0,9999,6
1714208616776,CLRE 251,A00,507176,Mehta; Ravindra L.,9993,0,9999,6
1714208616776,CLRE 251,B00,511410,Mehta; Ravindra L.,9998,0,9999,1
1714208617806,CLRE 252,A00,507189,Cuomo; Raphael Eduardo,9995,0,9999,4
1714208618836,CLRE 253,A00,507199,Vaida; Florin,9994,0,9999,5
1714208618836,CLRE 253,B00,507202,Vaida; Florin,9999,0,9999,0
1714208619862,CLRE 259,A00,507211,Patel; Hemal,9996,0,9999,3
1714208620941,CLRE 260,A00,507221,Cuomo; Raphael Eduardo,9999,0,9999,0
1714208621967,CLRE 297,001,507242,Cuomo; Raphael Eduardo,9999,0,9999,0
1714208622998,COGS 197,001,638244,Voytek; Bradley Thomas,9999,0,9999,0
1714208624026,CSE 191,A00,516875,Minnes Kemp; Mor Mia,9993,0,9999,6
1714208625072,CSE 197,001,637388,Minnes Kemp; Mor Mia,9998,0,9999,1
1714208626100,CSS 201S,A01,494383,Staff,35,0,35,0
1714208627126,CSS 202S,A01,494387,Staff,35,0,35,0
1714208628156,DSC 197,001,628532,Eldridge; Justin Matthew,9996,0,9999,3
1714208629184,EAP 100,A00,516065,Staff,9797,0,9999,202
1714208630216,ECE 45,A01,507414,Staff,33,0,60,27
1714208632268,ECE 111,A01,507420,Staff,21,0,50,29
1714208633295,ECE 197,001,548057,Sievenpiper; Daniel F.,9994,0,9999,5
1714208634324,EDS 115,A00,507243,Choi; Bailey Miyeon,12,0,28,16
1714208635351,EDS 117,A01,494379,Staff,0,1,30,30
1714208636376,EDS 125,A00,507246,Hopkins; Megan Beth,12,0,30,18
1714208637401,EDS 128A,A01,507264,Fargason; Sharon Gayle,14,0,26,12
1714208638430,EDS 128B,A01,507293,Pappas; Elizabeth,18,0,30,12
1714208639458,EDS 139,A00,507294,Fargason; Sharon Gayle,18,0,30,12
1714208639458,EDS 139,B00,507313,Pappas; Elizabeth,15,0,30,15
1714208640483,EDS 201,A00,507315,Staff,13,0,30,17
1714208641510,EDS 203,A01,507317,Halter; Christopher P.,12,0,30,18
1714208642538,EDS 204R,A01,507319,Halter; Christopher P.,0,3,30,30
1714208642538,EDS 204R,B01,507331,Heinzman; Erica M.,17,0,30,13
1714208643564,EDS 206R,A00,507332,Staff,0,4,30,30
1714208643564,EDS 206R,B00,507343,Staff,18,0,30,12
1714208644589,EDS 250,A00,507344,Hemans; Patricia Ann Benitez,22,0,40,18
1714208645614,EDS 281,A00,507345,Daly; Alan J.,18,0,18,0
1714208646642,EDS 284,A00,507350,Daly; Alan J.,16,0,16,0
1714208647674,EDS 286,A00,507359,Fine; Sarah,18,0,18,0
1714208648701,EDS 289C,A01,507361,Daly; Alan J.,18,0,18,0
1714208649730,EDS 290,A00,507366,Hofstetter; Carolyn,15,0,15,0
1714208650763,LIGM 5A,A00,507421,Fischer-Grunski; Eva K,18,0,20,2
1714208651790,LIGM 5B,A00,507423,Fischer-Grunski; Eva K,19,0,20,1
1714208652815,LIGM 5C,A00,507425,Fischer-Grunski; Eva K,19,0,20,1
1714208653841,LIIT 5AS,A00,507427,Carnelos; Chiara,20,0,20,0
1714208654866,LIIT 5BS,A00,507430,Carnelos; Chiara,20,0,20,0
1714208655892,LIIT 5CS,A00,507432,Carnelos; Chiara,20,0,20,0
1714208656917,LISP 5A,A00,507541,Munoz Sanchez; Alicia,11,0,20,9
1714208657944,LISP 5B,A00,507671,Munoz Sanchez; Alicia,9,0,20,11
1714208658974,LISP 5C,A00,507696,Munoz Sanchez; Alicia,9,0,20,11
1714208660003,MAE 197,001,528363,Boechler; Nicholas Sebastia,9998,0,9999,1
1714208661031,MATH 197,001,523477,Kedlaya; Kiran S.,9996,0,9999,3
1714208661031,MATH 197,002,563811,Zhang; Danna,9995,0,9999,4
1714208661031,MATH 197,003,628552,Dumitriu; Ioana,9998,0,9999,1
1714208662063,MCWP 40R,A00,518780,Staff,5,0,20,15
1714208662063,MCWP 40R,B00,518781,Staff,7,0,20,13
1714208662063,MCWP 40R,C00,518783,Staff,5,0,20,15
1714208663095,MCWP 50R,A00,518791,Staff,0,0,20,20
1714208663095,MCWP 50R,B00,518792,Staff,0,1,20,20
1714208663095,MCWP 50R,C00,518793,Staff,0,1,20,20
1714208663095,MCWP 50R,D00,518794,Staff,0,0,20,20
1714208663095,MCWP 50R,E00,518795,Staff,0,1,20,20
1714208663095,MCWP 50R,F00,518796,Staff,0,0,20,20
1714208663095,MCWP 50R,G00,518797,Staff,0,1,20,20
1714208664125,MMW 12R,A01,514034,Herbst; Matthew,0,1,16,16
1714208664125,MMW 12R,A02,514035,Herbst; Matthew,2,0,16,14
1714208665155,MMW 13R,A01,514037,Staff,0,4,16,16
1714208665155,MMW 13R,A02,514039,Staff,0,2,16,16
1714208665155,MMW 13R,A03,628519,Staff,0,2,16,16
1714208667209,SIO 295LS,A00,523233,Staff,13,0,30,17
1714208668236,SIO 295S,A00,523232,Staff,13,0,30,17
1714208669268,SIOC 290S,A01,637330,Merrifield; Mark A,28,0,30,2
1714208670295,SIOC 291S,A01,637333,Gabriel; Corey John,28,0,30,2
1714208671325,SOCI 117,A01,494376,Staff,0,2,5,5
1714208672354,WES 237B,A00,494380,Staff,9,0,20,11
1714208674429,AESE 279B,A00,494370,Wade; Jon P,0,0,33,33
1714208675454,AIP 197,001,627712,Vespa; Emanuel Ignacio,9998,0,9999,1
1714208676481,ANAR 135S,A00,494369,Braswell; Geoffrey E.,0,0,0,0
1714208677508,BENG 196,001,628496,Engler; Adam J.,9998,0,9999,1
1714208678538,CAT 124RS,A01,519847,Geibel; William,0,0,20,20
1714208679564,CAT 125RS,A01,515971,Geibel; William,0,0,20,20
1714208680596,CLRE 250,A00,511389,Morris; Sheldon,9993,0,9999,6
1714208681624,CLRE 251,A00,507176,Mehta; Ravindra L.,9993,0,9999,6
1714208681624,CLRE 251,B00,511410,Mehta; Ravindra L.,9998,0,9999,1
1714208682655,CLRE 252,A00,507189,Cuomo; Raphael Eduardo,9995,0,9999,4
1714208683681,CLRE 253,A00,507199,Vaida; Florin,9994,0,9999,5
1714208683681,CLRE 253,B00,507202,Vaida; Florin,9999,0,9999,0
1714208684707,CLRE 259,A00,507211,Patel; Hemal,9996,0,9999,3
1714208685733,CLRE 260,A00,507221,Cuomo; Raphael Eduardo,9999,0,9999,0
1714208686759,CLRE 297,001,507242,Cuomo; Raphael Eduardo,9999,0,9999,0
1714208687785,COGS 197,001,638244,Voytek; Bradley Thomas,9999,0,9999,0
1714208688812,CSE 191,A00,516875,Minnes Kemp; Mor Mia,9993,0,9999,6
1714208689837,CSE 197,001,637388,Minnes Kemp; Mor Mia,9998,0,9999,1
1714208690863,CSS 201S,A01,494383,Staff,35,0,35,0
1714208691891,CSS 202S,A01,494387,Staff,35,0,35,0
1714208692923,DSC 197,001,628532,Eldridge; Justin Matthew,9996,0,9999,3
1714208693948,EAP 100,A00,516065,Staff,9797,0,9999,202
1714208694977,ECE 45,A01,507414,Staff,33,0,60,27
1714208697028,ECE 111,A01,507420,Staff,21,0,50,29
1714208698054,ECE 197,001,548057,Sievenpiper; Daniel F.,9994,0,9999,5
1714208699086,EDS 115,A00,507243,Choi; Bailey Miyeon,12,0,28,16
1714208700111,EDS 117,A01,494379,Staff,0,1,30,30
1714208701141,EDS 125,A00,507246,Hopkins; Megan Beth,12,0,30,18
1714208702166,EDS 128A,A01,507264,Fargason; Sharon Gayle,14,0,26,12
1714208703193,EDS 128B,A01,507293,Pappas; Elizabeth,18,0,30,12
1714208704218,EDS 139,A00,507294,Fargason; Sharon Gayle,18,0,30,12
1714208704218,EDS 139,B00,507313,Pappas; Elizabeth,15,0,30,15
1714208705243,EDS 201,A00,507315,Staff,13,0,30,17
1714208706267,EDS 203,A01,507317,Halter; Christopher P.,12,0,30,18
1714208707293,EDS 204R,A01,507319,Halter; Christopher P.,0,3,30,30
1714208707293,EDS 204R,B01,507331,Heinzman; Erica M.,17,0,30,13
1714208708319,EDS 206R,A00,507332,Staff,0,4,30,30
1714208708319,EDS 206R,B00,507343,Staff,18,0,30,12
1714208709345,EDS 250,A00,507344,Hemans; Patricia Ann Benitez,22,0,40,18
1714208710373,EDS 281,A00,507345,Daly; Alan J.,18,0,18,0
1714208711396,EDS 284,A00,507350,Daly; Alan J.,16,0,16,0
1714208712426,EDS 286,A00,507359,Fine; Sarah,18,0,18,0
1714208713451,EDS 289C,A01,507361,Daly; Alan J.,18,0,18,0
1714208714480,EDS 290,A00,507366,Hofstetter; Carolyn,15,0,15,0
1714208715509,LIGM 5A,A00,507421,Fischer-Grunski; Eva K,18,0,20,2
1714208716536,LIGM 5B,A00,507423,Fischer-Grunski; Eva K,19,0,20,1
1714208717565,LIGM 5C,A00,507425,Fischer-Grunski; Eva K,19,0,20,1
1714208718593,LIIT 5AS,A00,507427,Carnelos; Chiara,20,0,20,0
1714208719618,LIIT 5BS,A00,507430,Carnelos; Chiara,20,0,20,0
1714208720643,LIIT 5CS,A00,507432,Carnelos; Chiara,20,0,20,0
1714208721672,LISP 5A,A00,507541,Munoz Sanchez; Alicia,11,0,20,9
1714208722697,LISP 5B,A00,507671,Munoz Sanchez; Alicia,9,0,20,11
1714208723723,LISP 5C,A00,507696,Munoz Sanchez; Alicia,9,0,20,11
1714208724805,MAE 197,001,528363,Boechler; Nicholas Sebastia,9998,0,9999,1
1714208725832,MATH 197,001,523477,Kedlaya; Kiran S.,9996,0,9999,3
1714208725832,MATH 197,002,563811,Zhang; Danna,9995,0,9999,4
1714208725832,MATH 197,003,628552,Dumitriu; Ioana,9998,0,9999,1
1714208726861,MCWP 40R,A00,518780,Staff,5,0,20,15
1714208726861,MCWP 40R,B00,518781,Staff,7,0,20,13
1714208726861,MCWP 40R,C00,518783,Staff,5,0,20,15
1714208727887,MCWP 50R,A00,518791,Staff,0,0,20,20
1714208727887,MCWP 50R,B00,518792,Staff,0,1,20,20
1714208727887,MCWP 50R,C00,518793,Staff,0,1,20,20
1714208727887,MCWP 50R,D00,518794,Staff,0,0,20,20
1714208727887,MCWP 50R,E00,518795,Staff,0,1,20,20
1714208727887,MCWP 50R,F00,518796,Staff,0,0,20,20
1714208727887,MCWP 50R,G00,518797,Staff,0,1,20,20
1714208728916,MMW 12R,A01,514034,Herbst; Matthew,0,1,16,16
1714208728916,MMW 12R,A02,514035,Herbst; Matthew,2,0,16,14
1714208729941,MMW 13R,A01,514037,Staff,0,4,16,16
1714208729941,MMW 13R,A02,514039,Staff,0,2,16,16
1714208729941,MMW 13R,A03,628519,Staff,0,2,16,16
1714208731993,SIO 295LS,A00,523233,Staff,13,0,30,17
1714208733017,SIO 295S,A00,523232,Staff,13,0,30,17
1714208734049,SIOC 290S,A01,637330,Merrifield; Mark A,28,0,30,2
1714208735079,SIOC 291S,A01,637333,Gabriel; Corey John,28,0,30,2
1714208736104,SOCI 117,A01,494376,Staff,0,2,5,5
1714208737130,WES 237B,A00,494380,Staff,9,0,20,11
1714208739210,AESE 279B,A00,494370,Wade; Jon P,0,0,33,33
1714208740235,AIP 197,001,627712,Vespa; Emanuel Ignacio,9998,0,9999,1
1714208741261,ANAR 135S,A00,494369,Braswell; Geoffrey E.,0,0,0,0
1714208742286,BENG 196,001,628496,Engler; Adam J.,9998,0,9999,1
1714208743313,CAT 124RS,A01,519847,Geibel; William,0,0,20,20
1714208744343,CAT 125RS,A01,515971,Geibel; William,0,0,20,20
1714208745368,CLRE 250,A00,511389,Morris; Sheldon,9993,0,9999,6
1714208746398,CLRE 251,A00,507176,Mehta; Ravindra L.,9993,0,9999,6
1714208746398,CLRE 251,B00,511410,Mehta; Ravindra L.,9998,0,9999,1
1714208747428,CLRE 252,A00,507189,Cuomo; Raphael Eduardo,9995,0,9999,4
1714208748458,CLRE 253,A00,507199,Vaida; Florin,9994,0,9999,5
1714208748458,CLRE 253,B00,507202,Vaida; Florin,9999,0,9999,0
1714208749487,CLRE 259,A00,507211,Patel; Hemal,9996,0,9999,3
1714208750518,CLRE 260,A00,507221,Cuomo; Raphael Eduardo,9999,0,9999,0
1714208751546,CLRE 297,001,507242,Cuomo; Raphael Eduardo,9999,0,9999,0
1714208752576,COGS 197,001,638244,Voytek; Bradley Thomas,9999,0,9999,0
1714208753602,CSE 191,A00,516875,Minnes Kemp; Mor Mia,9993,0,9999,6
1714208754627,CSE 197,001,637388,Minnes Kemp; Mor Mia,9998,0,9999,1
1714208755654,CSS 201S,A01,494383,Staff,35,0,35,0
1714208756682,CSS 202S,A01,494387,Staff,35,0,35,0
1714208757708,DSC 197,001,628532,Eldridge; Justin Matthew,9996,0,9999,3
1714208758737,EAP 100,A00,516065,Staff,9797,0,9999,202
1714208759767,ECE 45,A01,507414,Staff,33,0,60,27
1714208761821,ECE 111,A01,507420,Staff,21,0,50,29
1714208762852,ECE 197,001,548057,Sievenpiper; Daniel F.,9994,0,9999,5
1714208763883,EDS 115,A00,507243,Choi; Bailey Miyeon,12,0,28,16
1714208764910,EDS 117,A01,494379,Staff,0,1,30,30
1714208765935,EDS 125,A00,507246,Hopkins; Megan Beth,12,0,30,18
1714208766967,EDS 128A,A01,507264,Fargason; Sharon Gayle,14,0,26,12
1714208767993,EDS 128B,A01,507293,Pappas; Elizabeth,18,0,30,12
1714208769017,EDS 139,A00,507294,Fargason; Sharon Gayle,18,0,30,12
1714208769017,EDS 139,B00,507313,Pappas; Elizabeth,15,0,30,15
1714208770043,EDS 201,A00,507315,Staff,13,0,30,17
1714208771073,EDS 203,A01,507317,Halter; Christopher P.,12,0,30,18
1714208772098,EDS 204R,A01,507319,Halter; Christopher P.,0,3,30,30
1714208772098,EDS 204R,B01,507331,Heinzman; Erica M.,17,0,30,13
1714208773127,EDS 206R,A00,507332,Staff,0,4,30,30
1714208773127,EDS 206R,B00,507343,Staff,18,0,30,12
1714208774152,EDS 250,A00,507344,Hemans; Patricia Ann Benitez,22,0,40,18
1714208775178,EDS 281,A00,507345,Daly; Alan J.,18,0,18,0
1714208776203,EDS 284,A00,507350,Daly; Alan J.,16,0,16,0
1714208777236,EDS 286,A00,507359,Fine; Sarah,18,0,18,0
1714208778261,EDS 289C,A01,507361,Daly; Alan J.,18,0,18,0
1714208779289,EDS 290,A00,507366,Hofstetter; Carolyn,15,0,15,0
1714208780320,LIGM 5A,A00,507421,Fischer-Grunski; Eva K,18,0,20,2
1714208781345,LIGM 5B,A00,507423,Fischer-Grunski; Eva K,19,0,20,1
1714208782375,LIGM 5C,A00,507425,Fischer-Grunski; Eva K,19,0,20,1
1714208783401,LIIT 5AS,A00,507427,Carnelos; Chiara,20,0,20,0
1714208784429,LIIT 5BS,A00,507430,Carnelos; Chiara,20,0,20,0
1714208785454,LIIT 5CS,A00,507432,Carnelos; Chiara,20,0,20,0
1714208786480,LISP 5A,A00,507541,Munoz Sanchez; Alicia,11,0,20,9
1714208787506,LISP 5B,A00,507671,Munoz Sanchez; Alicia,9,0,20,11
1714208788530,LISP 5C,A00,507696,Munoz Sanchez; Alicia,9,0,20,11
1714208789555,MAE 197,001,528363,Boechler; Nicholas Sebastia,9998,0,9999,1
1714208790584,MATH 197,001,523477,Kedlaya; Kiran S.,9996,0,9999,3
1714208790584,MATH 197,002,563811,Zhang; Danna,9995,0,9999,4
1714208790584,MATH 197,003,628552,Dumitriu; Ioana,9998,0,9999,1
1714208791610,MCWP 40R,A00,518780,Staff,5,0,20,15
1714208791610,MCWP 40R,B00,518781,Staff,7,0,20,13
1714208791610,MCWP 40R,C00,518783,Staff,5,0,20,15
1714208792636,MCWP 50R,A00,518791,Staff,0,0,20,20
1714208792636,MCWP 50R,B00,518792,Staff,0,1,20,20
1714208792636,MCWP 50R,C00,518793,Staff,0,1,20,20
1714208792636,MCWP 50R,D00,518794,Staff,0,0,20,20
1714208792636,MCWP 50R,E00,518795,Staff,0,1,20,20
1714208792636,MCWP 50R,F00,518796,Staff,0,0,20,20
1714208792636,MCWP 50R,G00,518797,Staff,0,1,20,20
1714208793661,MMW 12R,A01,514034,Herbst; Matthew,0,1,16,16
1714208793661,MMW 12R,A02,514035,Herbst; Matthew,2,0,16,14
1714208794690,MMW 13R,A01,514037,Staff,0,4,16,16
1714208794690,MMW 13R,A02,514039,Staff,0,2,16,16
1714208794690,MMW 13R,A03,628519,Staff,0,2,16,16
1714208796741,SIO 295LS,A00,523233,Staff,13,0,30,17
1714208797770,SIO 295S,A00,523232,Staff,13,0,30,17
1714208798796,SIOC 290S,A01,637330,Merrifield; Mark A,28,0,30,2
1714208799827,SIOC 291S,A01,637333,Gabriel; Corey John,28,0,30,2
1714208800853,SOCI 117,A01,494376,Staff,0,2,5,5
1714208801878,WES 237B,A00,494380,Staff,9,0,20,11
1714208803948,AESE 279B,A00,494370,Wade; Jon P,0,0,33,33
1714208804974,AIP 197,001,627712,Vespa; Emanuel Ignacio,9998,0,9999,1
1714208806004,ANAR 135S,A00,494369,Braswell; Geoffrey E.,0,0,0,0
1714208807030,BENG 196,001,628496,Engler; Adam J.,9998,0,9999,1
1714208808060,CAT 124RS,A01,519847,Geibel; William,0,0,20,20
1714208809087,CAT 125RS,A01,515971,Geibel; William,0,0,20,20
1714208810117,CLRE 250,A00,511389,Morris; Sheldon,9993,0,9999,6
1714208811145,CLRE 251,A00,507176,Mehta; Ravindra L.,9993,0,9999,6
1714208811145,CLRE 251,B00,511410,Mehta; Ravindra L.,9998,0,9999,1
1714208812177,CLRE 252,A00,507189,Cuomo; Raphael Eduardo,9995,0,9999,4
1714208813204,CLRE 253,A00,507199,Vaida; Florin,9994,0,9999,5
1714208813204,CLRE 253,B00,507202,Vaida; Florin,9999,0,9999,0
1714208814234,CLRE 259,A00,507211,Patel; Hemal,9996,0,9999,3
1714208815259,CLRE 260,A00,507221,Cuomo; Raphael Eduardo,9999,0,9999,0
1714208816287,CLRE 297,001,507242,Cuomo; Raphael Eduardo,9999,0,9999,0
1714208817315,COGS 197,001,638244,Voytek; Bradley Thomas,9999,0,9999,0
1714208818344,CSE 191,A00,516875,Minnes Kemp; Mor Mia,9993,0,9999,6
1714208819369,CSE 197,001,637388,Minnes Kemp; Mor Mia,9998,0,9999,1
1714208820397,CSS 201S,A01,494383,Staff,35,0,35,0
1714208821424,CSS 202S,A01,494387,Staff,35,0,35,0
1714208822449,DSC 197,001,628532,Eldridge; Justin Matthew,9996,0,9999,3
1714208823479,EAP 100,A00,516065,Staff,9797,0,9999,202
1714208824506,ECE 45,A01,507414,Staff,33,0,60,27
1714208826556,ECE 111,A01,507420,Staff,21,0,50,29
1714208827583,ECE 197,001,548057,Sievenpiper; Daniel F.,9994,0,9999,5
1714208828664,EDS 115,A00,507243,Choi; Bailey Miyeon,12,0,28,16
1714208829699,EDS 117,A01,494379,Staff,0,1,30,30
1714208830728,EDS 125,A00,507246,Hopkins; Megan Beth,12,0,30,18
1714208831759,EDS 128A,A01,507264,Fargason; Sharon Gayle,14,0,26,12
1714208832786,EDS 128B,A01,507293,Pappas; Elizabeth,18,0,30,12
1714208833813,EDS 139,A00,507294,Fargason; Sharon Gayle,18,0,30,12
1714208833813,EDS 139,B00,507313,Pappas; Elizabeth,15,0,30,15
1714208834838,EDS 201,A00,507315,Staff,13,0,30,17
1714208835871,EDS 203,A01,507317,Halter; Christopher P.,12,0,30,18
1714208836897,EDS 204R,A01,507319,Halter; Christopher P.,0,3,30,30
1714208836897,EDS 204R,B01,507331,Heinzman; Erica M.,17,0,30,13
1714208837928,EDS 206R,A00,507332,Staff,0,4,30,30
1714208837928,EDS 206R,B00,507343,Staff,18,0,30,12
1714208838957,EDS 250,A00,507344,Hemans; Patricia Ann Benitez,22,0,40,18
1714208839988,EDS 281,A00,507345,Daly; Alan J.,18,0,18,0
1714208841014,EDS 284,A00,507350,Daly; Alan J.,16,0,16,0
1714208842040,EDS 286,A00,507359,Fine; Sarah,18,0,18,0
1714208843066,EDS 289C,A01,507361,Daly; Alan J.,18,0,18,0
1714208844096,EDS 290,A00,507366,Hofstetter; Carolyn,15,0,15,0
1714208845122,LIGM 5A,A00,507421,Fischer-Grunski; Eva K,18,0,20,2
1714208846149,LIGM 5B,A00,507423,Fischer-Grunski; Eva K,19,0,20,1
1714208847175,LIGM 5C,A00,507425,Fischer-Grunski; Eva K,19,0,20,1
1714208848206,LIIT 5AS,A00,507427,Carnelos; Chiara,20,0,20,0
1714208849232,LIIT 5BS,A00,507430,Carnelos; Chiara,20,0,20,0
1714208850262,LIIT 5CS,A00,507432,Carnelos; Chiara,20,0,20,0
1714208851290,LISP 5A,A00,507541,Munoz Sanchez; Alicia,11,0,20,9
1714208852318,LISP 5B,A00,507671,Munoz Sanchez; Alicia,9,0,20,11
1714208853347,LISP 5C,A00,507696,Munoz Sanchez; Alicia,9,0,20,11
1714208854373,MAE 197,001,528363,Boechler; Nicholas Sebastia,9998,0,9999,1
1714208855401,MATH 197,001,523477,Kedlaya; Kiran S.,9996,0,9999,3
1714208855401,MATH 197,002,563811,Zhang; Danna,9995,0,9999,4
1714208855401,MATH 197,003,628552,Dumitriu; Ioana,9998,0,9999,1
1714208856430,MCWP 40R,A00,518780,Staff,5,0,20,15
1714208856430,MCWP 40R,B00,518781,Staff,7,0,20,13
1714208856430,MCWP 40R,C00,518783,Staff,5,0,20,15
1714208857460,MCWP 50R,A00,518791,Staff,0,0,20,20
1714208857460,MCWP 50R,B00,518792,Staff,0,1,20,20
1714208857460,MCWP 50R,C00,518793,Staff,0,1,20,20
1714208857460,MCWP 50R,D00,518794,Staff,0,0,20,20
1714208857460,MCWP 50R,E00,518795,Staff,0,1,20,20
1714208857460,MCWP 50R,F00,518796,Staff,0,0,20,20
1714208857460,MCWP 50R,G00,518797,Staff,0,1,20,20
1714208858489,MMW 12R,A01,514034,Herbst; Matthew,0,1,16,16
1714208858489,MMW 12R,A02,514035,Herbst; Matthew,2,0,16,14
1714208859519,MMW 13R,A01,514037,Staff,0,4,16,16
1714208859519,MMW 13R,A02,514039,Staff,0,2,16,16
1714208859519,MMW 13R,A03,628519,Staff,0,2,16,16
1714208861572,SIO 295LS,A00,523233,Staff,13,0,30,17
1714208862600,SIO 295S,A00,523232,Staff,13,0,30,17
1714208863630,SIOC 290S,A01,637330,Merrifield; Mark A,28,0,30,2
1714208864657,SIOC 291S,A01,637333,Gabriel; Corey John,28,0,30,2
1714208865685,SOCI 117,A01,494376,Staff,0,2,5,5
1714208866712,WES 237B,A00,494380,Staff,9,0,20,11
1714208868801,AESE 279B,A00,494370,Wade; Jon P,0,0,33,33
1714208869827,AIP 197,001,627712,Vespa; Emanuel Ignacio,9998,0,9999,1
1714208870852,ANAR 135S,A00,494369,Braswell; Geoffrey E.,0,0,0,0
1714208871880,BENG 196,001,628496,Engler; Adam J.,9998,0,9999,1
1714208872905,CAT 124RS,A01,519847,Geibel; William,0,0,20,20
1714208873933,CAT 125RS,A01,515971,Geibel; William,0,0,20,20
1714208874962,CLRE 250,A00,511389,Morris; Sheldon,9993,0,9999,6
1714208875990,CLRE 251,A00,507176,Mehta; Ravindra L.,9993,0,9999,6
1714208875990,CLRE 251,B00,511410,Mehta; Ravindra L.,9998,0,9999,1
1714208877021,CLRE 252,A00,507189,Cuomo; Raphael Eduardo,9995,0,9999,4
1714208878048,CLRE 253,A00,507199,Vaida; Florin,9994,0,9999,5
1714208878048,CLRE 253,B00,507202,Vaida; Florin,9999,0,9999,0
1714208879075,CLRE 259,A00,507211,Patel; Hemal,9996,0,9999,3
1714208880101,CLRE 260,A00,507221,Cuomo; Raphael Eduardo,9999,0,9999,0
1714208881126,CLRE 297,001,507242,Cuomo; Raphael Eduardo,9999,0,9999,0
1714208882153,COGS 197,001,638244,Voytek; Bradley Thomas,9999,0,9999,0
1714208883186,CSE 191,A00,516875,Minnes Kemp; Mor Mia,9993,0,9999,6
1714208884211,CSE 197,001,637388,Minnes Kemp; Mor Mia,9998,0,9999,1
1714208885237,CSS 201S,A01,494383,Staff,35,0,35,0
1714208886261,CSS 202S,A01,494387,Staff,35,0,35,0
1714208887290,DSC 197,001,628532,Eldridge; Justin Matthew,9996,0,9999,3
1714208888318,EAP 100,A00,516065,Staff,9797,0,9999,202
1714208889345,ECE 45,A01,507414,Staff,33,0,60,27
1714208891400,ECE 111,A01,507420,Staff,21,0,50,29
1714208892427,ECE 197,001,548057,Sievenpiper; Daniel F.,9994,0,9999,5
1714208893453,EDS 115,A00,507243,Choi; Bailey Miyeon,12,0,28,16
1714208894484,EDS 117,A01,494379,Staff,0,1,30,30
1714208895514,EDS 125,A00,507246,Hopkins; Megan Beth,12,0,30,18
1714208896543,EDS 128A,A01,507264,Fargason; Sharon Gayle,14,0,26,12
1714208897569,EDS 128B,A01,507293,Pappas; Elizabeth,18,0,30,12
1714208898595,EDS 139,A00,507294,Fargason; Sharon Gayle,18,0,30,12
1714208898595,EDS 139,B00,507313,Pappas; Elizabeth,15,0,30,15
1714208899620,EDS 201,A00,507315,Staff,13,0,30,17
1714208900646,EDS 203,A01,507317,Halter; Christopher P.,12,0,30,18
1714208901677,EDS 204R,A01,507319,Halter; Christopher P.,0,3,30,30
1714208901677,EDS 204R,B01,507331,Heinzman; Erica M.,17,0,30,13
1714208902702,EDS 206R,A00,507332,Staff,0,4,30,30
1714208902702,EDS 206R,B00,507343,Staff,18,0,30,12
1714208903732,EDS 250,A00,507344,Hemans; Patricia Ann Benitez,22,0,40,18
1714208904758,EDS 281,A00,507345,Daly; Alan J.,18,0,18,0
1714208905783,EDS 284,A00,507350,Daly; Alan J.,16,0,16,0
1714208906808,EDS 286,A00,507359,Fine; Sarah,18,0,18,0
1714208907836,EDS 289C,A01,507361,Daly; Alan J.,18,0,18,0
1714208908861,EDS 290,A00,507366,Hofstetter; Carolyn,15,0,15,0
1714208909889,LIGM 5A,A00,507421,Fischer-Grunski; Eva K,18,0,20,2
1714208910918,LIGM 5B,A00,507423,Fischer-Grunski; Eva K,19,0,20,1
1714208911947,LIGM 5C,A00,507425,Fischer-Grunski; Eva K,19,0,20,1
1714208912978,LIIT 5AS,A00,507427,Carnelos; Chiara,20,0,20,0
1714208914005,LIIT 5BS,A00,507430,Carnelos; Chiara,20,0,20,0
1714208915036,LIIT 5CS,A00,507432,Carnelos; Chiara,20,0,20,0
1714208916062,LISP 5A,A00,507541,Munoz Sanchez; Alicia,11,0,20,9
1714208917091,LISP 5B,A00,507671,Munoz Sanchez; Alicia,9,0,20,11
1714208918120,LISP 5C,A00,507696,Munoz Sanchez; Alicia,9,0,20,11
1714208919145,MAE 197,001,528363,Boechler; Nicholas Sebastia,9998,0,9999,1
1714208920177,MATH 197,001,523477,Kedlaya; Kiran S.,9996,0,9999,3
1714208920177,MATH 197,002,563811,Zhang; Danna,9995,0,9999,4
1714208920177,MATH 197,003,628552,Dumitriu; Ioana,9998,0,9999,1
1714208921203,MCWP 40R,A00,518780,Staff,5,0,20,15
1714208921203,MCWP 40R,B00,518781,Staff,7,0,20,13
1714208921203,MCWP 40R,C00,518783,Staff,5,0,20,15
1714208922231,MCWP 50R,A00,518791,Staff,0,0,20,20
1714208922231,MCWP 50R,B00,518792,Staff,0,1,20,20
1714208922231,MCWP 50R,C00,518793,Staff,0,1,20,20
1714208922231,MCWP 50R,D00,518794,Staff,0,0,20,20
1714208922231,MCWP 50R,E00,518795,Staff,0,1,20,20
1714208922231,MCWP 50R,F00,518796,Staff,0,0,20,20
1714208922231,MCWP 50R,G00,518797,Staff,0,1,20,20
1714208923261,MMW 12R,A01,514034,Herbst; Matthew,0,1,16,16
1714208923261,MMW 12R,A02,514035,Herbst; Matthew,2,0,16,14
1714208924289,MMW 13R,A01,514037,Staff,0,4,16,16
1714208924289,MMW 13R,A02,514039,Staff,0,2,16,16
1714208924289,MMW 13R,A03,628519,Staff,0,2,16,16
1714208926341,SIO 295LS,A00,523233,Staff,13,0,30,17
1714208927366,SIO 295S,A00,523232,Staff,13,0,30,17
1714208928397,SIOC 290S,A01,637330,Merrifield; Mark A,28,0,30,2
1714208929425,SIOC 291S,A01,637333,Gabriel; Corey John,28,0,30,2
1714208930452,SOCI 117,A01,494376,Staff,0,2,5,5
1714208931481,WES 237B,A00,494380,Staff,9,0,20,11
1714208933620,AESE 279B,A00,494370,Wade; Jon P,0,0,33,33
1714208934649,AIP 197,001,627712,Vespa; Emanuel Ignacio,9998,0,9999,1
1714208935675,ANAR 135S,A00,494369,Braswell; Geoffrey E.,0,0,0,0
1714208936703,BENG 196,001,628496,Engler; Adam J.,9998,0,9999,1
1714208937730,CAT 124RS,A01,519847,Geibel; William,0,0,20,20
1714208938754,CAT 125RS,A01,515971,Geibel; William,0,0,20,20
1714208939781,CLRE 250,A00,511389,Morris; Sheldon,9993,0,9999,6
1714208940814,CLRE 251,A00,507176,Mehta; Ravindra L.,9993,0,9999,6
1714208940814,CLRE 251,B00,511410,Mehta; Ravindra L.,9998,0,9999,1
1714208941839,CLRE 252,A00,507189,Cuomo; Raphael Eduardo,9995,0,9999,4
1714208942865,CLRE 253,A00,507199,Vaida; Florin,9994,0,9999,5
1714208942865,CLRE 253,B00,507202,Vaida; Florin,9999,0,9999,0
1714208943901,CLRE 259,A00,507211,Patel; Hemal,9996,0,9999,3
1714208944926,CLRE 260,A00,507221,Cuomo; Raphael Eduardo,9999,0,9999,0
1714208945955,CLRE 297,001,507242,Cuomo; Raphael Eduardo,9999,0,9999,0
1714208946979,COGS 197,001,638244,Voytek; Bradley Thomas,9999,0,9999,0
1714208948005,CSE 191,A00,516875,Minnes Kemp; Mor Mia,9993,0,9999,6
1714208949031,CSE 197,001,637388,Minnes Kemp; Mor Mia,9998,0,9999,1
1714208950056,CSS 201S,A01,494383,Staff,35,0,35,0
1714208951085,CSS 202S,A01,494387,Staff,35,0,35,0
1714208952110,DSC 197,001,628532,Eldridge; Justin Matthew,9996,0,9999,3
1714208953134,EAP 100,A00,516065,Staff,9797,0,9999,202
1714208954161,ECE 45,A01,507414,Staff,33,0,60,27
1714208956212,ECE 111,A01,507420,Staff,21,0,50,29
1714208957238,ECE 197,001,548057,Sievenpiper; Daniel F.,9994,0,9999,5
1714208958264,EDS 115,A00,507243,Choi; Bailey Miyeon,12,0,28,16
1714208959291,EDS 117,A01,494379,Staff,0,1,30,30
1714208960318,EDS 125,A00,507246,Hopkins; Megan Beth,12,0,30,18
1714208961349,EDS 128A,A01,507264,Fargason; Sharon Gayle,14,0,26,12
1714208962374,EDS 128B,A01,507293,Pappas; Elizabeth,18,0,30,12
1714208963399,EDS 139,A00,507294,Fargason; Sharon Gayle,18,0,30,12
1714208963399,EDS 139,B00,507313,Pappas; Elizabeth,15,0,30,15
1714208964424,EDS 201,A00,507315,Staff,13,0,30,17
1714208965448,EDS 203,A01,507317,Halter; Christopher P.,12,0,30,18
1714208966474,EDS 204R,A01,507319,Halter; Christopher P.,0,3,30,30
1714208966474,EDS 204R,B01,507331,Heinzman; Erica M.,17,0,30,13
1714208967499,EDS 206R,A00,507332,Staff,0,4,30,30
1714208967499,EDS 206R,B00,507343,Staff,18,0,30,12
1714208968529,EDS 250,A00,507344,Hemans; Patricia Ann Benitez,22,0,40,18
1714208969558,EDS 281,A00,507345,Daly; Alan J.,18,0,18,0
1714208970582,EDS 284,A00,507350,Daly; Alan J.,16,0,16,0
1714208971609,EDS 286,A00,507359,Fine; Sarah,18,0,18,0
1714208972634,EDS 289C,A01,507361,Daly; Alan J.,18,0,18,0
1714208973661,EDS 290,A00,507366,Hofstetter; Carolyn,15,0,15,0
1714208974689,LIGM 5A,A00,507421,Fischer-Grunski; Eva K,18,0,20,2
1714208975714,LIGM 5B,A00,507423,Fischer-Grunski; Eva K,19,0,20,1
1714208976740,LIGM 5C,A00,507425,Fischer-Grunski; Eva K,19,0,20,1
1714208977767,LIIT 5AS,A00,507427,Carnelos; Chiara,20,0,20,0
1714208978792,LIIT 5BS,A00,507430,Carnelos; Chiara,20,0,20,0
1714208979818,LIIT 5CS,A00,507432,Carnelos; Chiara,20,0,20,0
1714208980845,LISP 5A,A00,507541,Munoz Sanchez; Alicia,11,0,20,9
1714208981874,LISP 5B,A00,507671,Munoz Sanchez; Alicia,9,0,20,11
1714208982904,LISP 5C,A00,507696,Munoz Sanchez; Alicia,9,0,20,11
1714208983931,MAE 197,001,528363,Boechler; Nicholas Sebastia,9998,0,9999,1
1714208984964,MATH 197,001,523477,Kedlaya; Kiran S.,9996,0,9999,3
1714208984964,MATH 197,002,563811,Zhang; Danna,9995,0,9999,4
1714208984964,MATH 197,003,628552,Dumitriu; Ioana,9998,0,9999,1
1714208985990,MCWP 40R,A00,518780,Staff,5,0,20,15
1714208985990,MCWP 40R,B00,518781,Staff,7,0,20,13
1714208985990,MCWP 40R,C00,518783,Staff,5,0,20,15
1714208987022,MCWP 50R,A00,518791,Staff,0,0,20,20
1714208987022,MCWP 50R,B00,518792,Staff,0,1,20,20
1714208987022,MCWP 50R,C00,518793,Staff,0,1,20,20
1714208987022,MCWP 50R,D00,518794,Staff,0,0,20,20
1714208987022,MCWP 50R,E00,518795,Staff,0,1,20,20
1714208987022,MCWP 50R,F00,518796,Staff,0,0,20,20
1714208987022,MCWP 50R,G00,518797,Staff,0,1,20,20
1714208988048,MMW 12R,A01,514034,Herbst; Matthew,0,1,16,16
1714208988048,MMW 12R,A02,514035,Herbst; Matthew,2,0,16,14
1714208989078,MMW 13R,A01,514037,Staff,0,4,16,16
1714208989078,MMW 13R,A02,514039,Staff,0,2,16,16
1714208989078,MMW 13R,A03,628519,Staff,0,2,16,16
1714208991134,SIO 295LS,A00,523233,Staff,13,0,30,17
1714208992159,SIO 295S,A00,523232,Staff,13,0,30,17
1714208993190,SIOC 290S,A01,637330,Merrifield; Mark A,28,0,30,2
1714208994217,SIOC 291S,A01,637333,Gabriel; Corey John,28,0,30,2
1714208995244,SOCI 117,A01,494376,Staff,0,2,5,5
1714208996273,WES 237B,A00,494380,Staff,9,0,20,11
1714208998346,AESE 279B,A00,494370,Wade; Jon P,0,0,33,33
1714208999372,AIP 197,001,627712,Vespa; Emanuel Ignacio,9998,0,9999,1
1714209000398,ANAR 135S,A00,494369,Braswell; Geoffrey E.,0,0,0,0
1714209001426,BENG 196,001,628496,Engler; Adam J.,9998,0,9999,1
1714209002456,CAT 124RS,A01,519847,Geibel; William,0,0,20,20
1714209003486,CAT 125RS,A01,515971,Geibel; William,0,0,20,20
1714209004514,CLRE 250,A00,511389,Morris; Sheldon,9993,0,9999,6
1714209005541,CLRE 251,A00,507176,Mehta; Ravindra L.,9993,0,9999,6
1714209005541,CLRE 251,B00,511410,Mehta; Ravindra L.,9998,0,9999,1
1714209006570,CLRE 252,A00,507189,Cuomo; Raphael Eduardo,9995,0,9999,4
1714209007599,CLRE 253,A00,507199,Vaida; Florin,9994,0,9999,5
1714209007599,CLRE 253,B00,507202,Vaida; Florin,9999,0,9999,0
1714209008624,CLRE 259,A00,507211,Patel; Hemal,9996,0,9999,3
1714209009653,CLRE 260,A00,507221,Cuomo; Raphael Eduardo,9999,0,9999,0
1714209010678,CLRE 297,001,507242,Cuomo; Raphael Eduardo,9999,0,9999,0
1714209011703,COGS 197,001,638244,Voytek; Bradley Thomas,9999,0,9999,0
1714209012729,CSE 191,A00,516875,Minnes Kemp; Mor Mia,9993,0,9999,6
1714209013756,CSE 197,001,637388,Minnes Kemp; Mor Mia,9998,0,9999,1
1714209014783,CSS 201S,A01,494383,Staff,35,0,35,0
1714209015808,CSS 202S,A01,494387,Staff,35,0,35,0
1714209016838,DSC 197,001,628532,Eldridge; Justin Matthew,9996,0,9999,3
1714209017863,EAP 100,A00,516065,Staff,9797,0,9999,202
1714209018888,ECE 45,A01,507414,Staff,33,0,60,27
1714209020944,ECE 111,A01,507420,Staff,21,0,50,29
1714209021975,ECE 197,001,548057,Sievenpiper; Daniel F.,9994,0,9999,5
1714209023001,EDS 115,A00,507243,Choi; Bailey Miyeon,12,0,28,16
1714209024027,EDS 117,A01,494379,Staff,0,1,30,30
1714209025056,EDS 125,A00,507246,Hopkins; Megan Beth,12,0,30,18
1714209026081,EDS 128A,A01,507264,Fargason; Sharon Gayle,14,0,26,12
1714209027107,EDS 128B,A01,507293,Pappas; Elizabeth,18,0,30,12
1714209028133,EDS 139,A00,507294,Fargason; Sharon Gayle,18,0,30,12
1714209028133,EDS 139,B00,507313,Pappas; Elizabeth,15,0,30,15
1714209029157,EDS 201,A00,507315,Staff,13,0,30,17
1714209030183,EDS 203,A01,507317,Halter; Christopher P.,12,0,30,18
1714209031208,EDS 204R,A01,507319,Halter; Christopher P.,0,3,30,30
1714209031208,EDS 204R,B01,507331,Heinzman; Erica M.,17,0,30,13
1714209032233,EDS 206R,A00,507332,Staff,0,4,30,30
1714209032233,EDS 206R,B00,507343,Staff,18,0,30,12
1714209033259,EDS 250,A00,507344,Hemans; Patricia Ann Benitez,22,0,40,18
1714209034284,EDS 281,A00,507345,Daly; Alan J.,18,0,18,0
1714209035310,EDS 284,A00,507350,Daly; Alan J.,16,0,16,0
1714209036391,EDS 286,A00,507359,Fine; Sarah,18,0,18,0
1714209037417,EDS 289C,A01,507361,Daly; Alan J.,18,0,18,0
1714209038442,EDS 290,A00,507366,Hofstetter; Carolyn,15,0,15,0
1714209039468,LIGM 5A,A00,507421,Fischer-Grunski; Eva K,18,0,20,2
1714209040494,LIGM 5B,A00,507423,Fischer-Grunski; Eva K,19,0,20,1
1714209041523,LIGM 5C,A00,507425,Fischer-Grunski; Eva K,19,0,20,1
1714209042553,LIIT 5AS,A00,507427,Carnelos; Chiara,20,0,20,0
1714209043580,LIIT 5BS,A00,507430,Carnelos; Chiara,20,0,20,0
1714209044606,LIIT 5CS,A00,507432,Carnelos; Chiara,20,0,20,0
1714209045631,LISP 5A,A00,507541,Munoz Sanchez; Alicia,11,0,20,9
1714209046657,LISP 5B,A00,507671,Munoz Sanchez; Alicia,9,0,20,11
1714209047683,LISP 5C,A00,507696,Munoz Sanchez; Alicia,9,0,20,11
1714209048709,MAE 197,001,528363,Boechler; Nicholas Sebastia,9998,0,9999,1
1714209049737,MATH 197,001,523477,Kedlaya; Kiran S.,9996,0,9999,3
1714209049737,MATH 197,002,563811,Zhang; Danna,9995,0,9999,4
1714209049737,MATH 197,003,628552,Dumitriu; Ioana,9998,0,9999,1
1714209050763,MCWP 40R,A00,518780,Staff,5,0,20,15
1714209050763,MCWP 40R,B00,518781,Staff,7,0,20,13
1714209050763,MCWP 40R,C00,518783,Staff,5,0,20,15
1714209051790,MCWP 50R,A00,518791,Staff,0,0,20,20
1714209051790,MCWP 50R,B00,518792,Staff,0,1,20,20
1714209051790,MCWP 50R,C00,518793,Staff,0,1,20,20
1714209051790,MCWP 50R,D00,518794,Staff,0,0,20,20
1714209051790,MCWP 50R,E00,518795,Staff,0,1,20,20
1714209051790,MCWP 50R,F00,518796,Staff,0,0,20,20
1714209051790,MCWP 50R,G00,518797,Staff,0,1,20,20
1714209052821,MMW 12R,A01,514034,Herbst; Matthew,0,1,16,16
1714209052821,MMW 12R,A02,514035,Herbst; Matthew,2,0,16,14
1714209053848,MMW 13R,A01,514037,Staff,0,4,16,16
1714209053848,MMW 13R,A02,514039,Staff,0,2,16,16
1714209053848,MMW 13R,A03,628519,Staff,0,2,16,16
1714209055909,SIO 295LS,A00,523233,Staff,13,0,30,17
1714209056937,SIO 295S,A00,523232,Staff,13,0,30,17
1714209057964,SIOC 290S,A01,637330,Merrifield; Mark A,28,0,30,2
1714209058990,SIOC 291S,A01,637333,Gabriel; Corey John,28,0,30,2
1714209060017,SOCI 117,A01,494376,Staff,0,2,5,5
1714209061044,WES 237B,A00,494380,Staff,9,0,20,11
1714209063123,AESE 279B,A00,494370,Wade; Jon P,0,0,33,33
1714209064154,AIP 197,001,627712,Vespa; Emanuel Ignacio,9998,0,9999,1
1714209065181,ANAR 135S,A00,494369,Braswell; Geoffrey E.,0,0,0,0
1714209066205,BENG 196,001,628496,Engler; Adam J.,9998,0,9999,1
1714209067230,CAT 124RS,A01,519847,Geibel; William,0,0,20,20
1714209068256,CAT 125RS,A01,515971,Geibel; William,0,0,20,20
1714209069281,CLRE 250,A00,511389,Morris; Sheldon,9993,0,9999,6
1714209070308,CLRE 251,A00,507176,Mehta; Ravindra L.,9993,0,9999,6
1714209070308,CLRE 251,B00,511410,Mehta; Ravindra L.,9998,0,9999,1
1714209071334,CLRE 252,A00,507189,Cuomo; Raphael Eduardo,9995,0,9999,4
1714209072360,CLRE 253,A00,507199,Vaida; Florin,9994,0,9999,5
1714209072360,CLRE 253,B00,507202,Vaida; Florin,9999,0,9999,0
1714209073386,CLRE 259,A00,507211,Patel; Hemal,9996,0,9999,3
1714209074412,CLRE 260,A00,507221,Cuomo; Raphael Eduardo,9999,0,9999,0
1714209075438,CLRE 297,001,507242,Cuomo; Raphael Eduardo,9999,0,9999,0
1714209076468,COGS 197,001,638244,Voytek; Bradley Thomas,9999,0,9999,0
1714209077494,CSE 191,A00,516875,Minnes Kemp; Mor Mia,9993,0,9999,6
1714209078520,CSE 197,001,637388,Minnes Kemp; Mor Mia,9998,0,9999,1
1714209079551,CSS 201S,A01,494383,Staff,35,0,35,0
1714209080578,CSS 202S,A01,494387,Staff,35,0,35,0
1714209081606,DSC 197,001,628532,Eldridge; Justin Matthew,9996,0,9999,3
1714209082635,EAP 100,A00,516065,Staff,9797,0,9999,202
1714209083662,ECE 45,A01,507414,Staff,33,0,60,27
1714209085713,ECE 111,A01,507420,Staff,21,0,50,29
1714209086743,ECE 197,001,548057,Sievenpiper; Daniel F.,9994,0,9999,5
1714209087774,EDS 115,A00,507243,Choi; Bailey Miyeon,12,0,28,16
1714209088803,EDS 117,A01,494379,Staff,0,1,30,30
1714209089831,EDS 125,A00,507246,Hopkins; Megan Beth,12,0,30,18
1714209090856,EDS 128A,A01,507264,Fargason; Sharon Gayle,14,0,26,12
1714209091881,EDS 128B,A01,507293,Pappas; Elizabeth,18,0,30,12
1714209092909,EDS 139,A00,507294,Fargason; Sharon Gayle,18,0,30,12
1714209092909,EDS 139,B00,507313,Pappas; Elizabeth,15,0,30,15
1714209093941,EDS 201,A00,507315,Staff,13,0,30,17
1714209094967,EDS 203,A01,507317,Halter; Christopher P.,12,0,30,18
1714209095992,EDS 204R,A01,507319,Halter; Christopher P.,0,3,30,30
1714209095992,EDS 204R,B01,507331,Heinzman; Erica M.,17,0,30,13
1714209097018,EDS 206R,A00,507332,Staff,0,4,30,30
1714209097018,EDS 206R,B00,507343,Staff,18,0,30,12
1714209098045,EDS 250,A00,507344,Hemans; Patricia Ann Benitez,22,0,40,18
1714209099076,EDS 281,A00,507345,Daly; Alan J.,18,0,18,0
1714209100101,EDS 284,A00,507350,Daly; Alan J.,16,0,16,0
1714209101127,EDS 286,A00,507359,Fine; Sarah,18,0,18,0
1714209102154,EDS 289C,A01,507361,Daly; Alan J.,18,0,18,0
1714209103179,EDS 290,A00,507366,Hofstetter; Carolyn,15,0,15,0
1714209104210,LIGM 5A,A00,507421,Fischer-Grunski; Eva K,18,0,20,2
1714209105236,LIGM 5B,A00,507423,Fischer-Grunski; Eva K,19,0,20,1
1714209106267,LIGM 5C,A00,507425,Fischer-Grunski; Eva K,19,0,20,1
1714209107293,LIIT 5AS,A00,507427,Carnelos; Chiara,20,0,20,0
1714209108323,LIIT 5BS,A00,507430,Carnelos; Chiara,20,0,20,0
1714209109352,LIIT 5CS,A00,507432,Carnelos; Chiara,20,0,20,0
1714209110383,LISP 5A,A00,507541,Munoz Sanchez; Alicia,11,0,20,9
1714209111410,LISP 5B,A00,507671,Munoz Sanchez; Alicia,9,0,20,11
1714209112435,LISP 5C,A00,507696,Munoz Sanchez; Alicia,9,0,20,11
1714209113461,MAE 197,001,528363,Boechler; Nicholas Sebastia,9998,0,9999,1
1714209114489,MATH 197,001,523477,Kedlaya; Kiran S.,9996,0,9999,3
1714209114489,MATH 197,002,563811,Zhang; Danna,9995,0,9999,4
1714209114489,MATH 197,003,628552,Dumitriu; Ioana,9998,0,9999,1
1714209115516,MCWP 40R,A00,518780,Staff,5,0,20,15
1714209115516,MCWP 40R,B00,518781,Staff,7,0,20,13
1714209115516,MCWP 40R,C00,518783,Staff,5,0,20,15
1714209116542,MCWP 50R,A00,518791,Staff,0,0,20,20
1714209116542,MCWP 50R,B00,518792,Staff,0,1,20,20
1714209116542,MCWP 50R,C00,518793,Staff,0,1,20,20
1714209116542,MCWP 50R,D00,518794,Staff,0,0,20,20
1714209116542,MCWP 50R,E00,518795,Staff,0,1,20,20
1714209116542,MCWP 50R,F00,518796,Staff,0,0,20,20
1714209116542,MCWP 50R,G00,518797,Staff,0,1,20,20
1714209117568,MMW 12R,A01,514034,Herbst; Matthew,0,1,16,16
1714209117568,MMW 12R,A02,514035,Herbst; Matthew,2,0,16,14
1714209118595,MMW 13R,A01,514037,Staff,0,4,16,16
1714209118595,MMW 13R,A02,514039,Staff,0,2,16,16
1714209118595,MMW 13R,A03,628519,Staff,0,2,16,16
1714209120650,SIO 295LS,A00,523233,Staff,13,0,30,17
1714209121675,SIO 295S,A00,523232,Staff,13,0,30,17
1714209122702,SIOC 290S,A01,637330,Merrifield; Mark A,28,0,30,2
1714209123728,SIOC 291S,A01,637333,Gabriel; Corey John,28,0,30,2
1714209124754,SOCI 117,A01,494376,Staff,0,2,5,5
1714209125780,WES 237B,A00,494380,Staff,9,0,20,11
1714209127875,AESE 279B,A00,494370,Wade; Jon P,0,0,33,33
1714209128901,AIP 197,001,627712,Vespa; Emanuel Ignacio,9998,0,9999,1
1714209129926,ANAR 135S,A00,494369,Braswell; Geoffrey E.,0,0,0,0
1714209130954,BENG 196,001,628496,Engler; Adam J.,9998,0,9999,1
1714209131981,CAT 124RS,A01,519847,Geibel; William,0,0,20,20
1714209133006,CAT 125RS,A01,515971,Geibel; William,0,0,20,20
1714209134033,CLRE 250,A00,511389,Morris; Sheldon,9993,0,9999,6
1714209135060,CLRE 251,A00,507176,Mehta; Ravindra L.,9993,0,9999,6
1714209135060,CLRE 251,B00,511410,Mehta; Ravindra L.,9998,0,9999,1
1714209136087,CLRE 252,A00,507189,Cuomo; Raphael Eduardo,9995,0,9999,4
1714209137112,CLRE 253,A00,507199,Vaida; Florin,9994,0,9999,5
1714209137112,CLRE 253,B00,507202,Vaida; Florin,9999,0,9999,0
1714209138138,CLRE 259,A00,507211,Patel; Hemal,9996,0,9999,3
1714209139169,CLRE 260,A00,507221,Cuomo; Raphael Eduardo,9999,0,9999,0
1714209140246,CLRE 297,001,507242,Cuomo; Raphael Eduardo,9999,0,9999,0
1714209141279,COGS 197,001,638244,Voytek; Bradley Thomas,9999,0,9999,0
1714209142313,CSE 191,A00,516875,Minnes Kemp; Mor Mia,9993,0,9999,6
1714209143339,CSE 197,001,637388,Minnes Kemp; Mor Mia,9998,0,9999,1
1714209144370,CSS 201S,A01,494383,Staff,35,0,35,0
1714209145397,CSS 202S,A01,494387,Staff,35,0,35,0
1714209146426,DSC 197,001,628532,Eldridge; Justin Matthew,9996,0,9999,3
1714209147454,EAP 100,A00,516065,Staff,9797,0,9999,202
1714209148483,ECE 45,A01,507414,Staff,33,0,60,27
1714209150538,ECE 111,A01,507420,Staff,21,0,50,29
1714209151563,ECE 197,001,548057,Sievenpiper; Daniel F.,9994,0,9999,5
1714209152591,EDS 115,A00,507243,Choi; Bailey Miyeon,12,0,28,16
1714209153621,EDS 117,A01,494379,Staff,0,1,30,30
1714209154656,EDS 125,A00,507246,Hopkins; Megan Beth,12,0,30,18
1714209155682,EDS 128A,A01,507264,Fargason; Sharon Gayle,14,0,26,12
1714209156711,EDS 128B,A01,507293,Pappas; Elizabeth,18,0,30,12
1714209157740,EDS 139,A00,507294,Fargason; Sharon Gayle,18,0,30,12
1714209157740,EDS 139,B00,507313,Pappas; Elizabeth,15,0,30,15
1714209158766,EDS 201,A00,507315,Staff,13,0,30,17
1714209159793,EDS 203,A01,507317,Halter; Christopher P.,12,0,30,18
1714209160824,EDS 204R,A01,507319,Halter; Christopher P.,0,3,30,30
1714209160824,EDS 204R,B01,507331,Heinzman; Erica M.,17,0,30,13
1714209161850,EDS 206R,A00,507332,Staff,0,4,30,30
1714209161850,EDS 206R,B00,507343,Staff,18,0,30,12
1714209162874,EDS 250,A00,507344,Hemans; Patricia Ann Benitez,22,0,40,18
1714209163903,EDS 281,A00,507345,Daly; Alan J.,18,0,18,0
1714209164928,EDS 284,A00,507350,Daly; Alan J.,16,0,16,0
1714209165957,EDS 286,A00,507359,Fine; Sarah,18,0,18,0
1714209166982,EDS 289C,A01,507361,Daly; Alan J.,18,0,18,0
1714209168011,EDS 290,A00,507366,Hofstetter; Carolyn,15,0,15,0
1714209169038,LIGM 5A,A00,507421,Fischer-Grunski; Eva K,18,0,20,2
1714209170062,LIGM 5B,A00,507423,Fischer-Grunski; Eva K,19,0,20,1
1714209171095,LIGM 5C,A00,507425,Fischer-Grunski; Eva K,19,0,20,1
1714209172125,LIIT 5AS,A00,507427,Carnelos; Chiara,20,0,20,0
1714209173151,LIIT 5BS,A00,507430,Carnelos; Chiara,20,0,20,0
1714209174176,LIIT 5CS,A00,507432,Carnelos; Chiara,20,0,20,0
1714209175202,LISP 5A,A00,507541,Munoz Sanchez; Alicia,11,0,20,9
1714209176231,LISP 5B,A00,507671,Munoz Sanchez; Alicia,9,0,20,11
1714209177262,LISP 5C,A00,507696,Munoz Sanchez; Alicia,9,0,20,11
1714209178287,MAE 197,001,528363,Boechler; Nicholas Sebastia,9998,0,9999,1
1714209179320,MATH 197,001,523477,Kedlaya; Kiran S.,9996,0,9999,3
1714209179320,MATH 197,002,563811,Zhang; Danna,9995,0,9999,4
1714209179320,MATH 197,003,628552,Dumitriu; Ioana,9998,0,9999,1
1714209180347,MCWP 40R,A00,518780,Staff,5,0,20,15
1714209180347,MCWP 40R,B00,518781,Staff,7,0,20,13
1714209180347,MCWP 40R,C00,518783,Staff,5,0,20,15
1714209181374,MCWP 50R,A00,518791,Staff,0,0,20,20
1714209181374,MCWP 50R,B00,518792,Staff,0,1,20,20
1714209181374,MCWP 50R,C00,518793,Staff,0,1,20,20
1714209181374,MCWP 50R,D00,518794,Staff,0,0,20,20
1714209181374,MCWP 50R,E00,518795,Staff,0,1,20,20
1714209181374,MCWP 50R,F00,518796,Staff,0,0,20,20
1714209181374,MCWP 50R,G00,518797,Staff,0,1,20,20
1714209182404,MMW 12R,A01,514034,Herbst; Matthew,0,1,16,16
1714209182404,MMW 12R,A02,514035,Herbst; Matthew,2,0,16,14
1714209183434,MMW 13R,A01,514037,Staff,0,4,16,16
1714209183434,MMW 13R,A02,514039,Staff,0,2,16,16
1714209183434,MMW 13R,A03,628519,Staff,0,2,16,16
1714209185488,SIO 295LS,A00,523233,Staff,13,0,30,17
1714209186513,SIO 295S,A00,523232,Staff,13,0,30,17
1714209187544,SIOC 290S,A01,637330,Merrifield; Mark A,28,0,30,2
1714209188573,SIOC 291S,A01,637333,Gabriel; Corey John,28,0,30,2
1714209189598,SOCI 117,A01,494376,Staff,0,2,5,5
1714209190623,WES 237B,A00,494380,Staff,9,0,20,11
1714209192711,AESE 279B,A00,494370,Wade; Jon P,0,0,33,33
1714209193739,AIP 197,001,627712,Vespa; Emanuel Ignacio,9998,0,9999,1
1714209194766,ANAR 135S,A00,494369,Braswell; Geoffrey E.,0,0,0,0
1714209195792,BENG 196,001,628496,Engler; Adam J.,9998,0,9999,1
1714209196821,CAT 124RS,A01,519847,Geibel; William,0,0,20,20
1714209197846,CAT 125RS,A01,515971,Geibel; William,0,0,20,20
1714209198873,CLRE 250,A00,511389,Morris; Sheldon,9993,0,9999,6
1714209199903,CLRE 251,A00,507176,Mehta; Ravindra L.,9993,0,9999,6
1714209199903,CLRE 251,B00,511410,Mehta; Ravindra L.,9998,0,9999,1
1714209200929,CLRE 252,A00,507189,Cuomo; Raphael Eduardo,9995,0,9999,4
1714209201955,CLRE 253,A00,507199,Vaida; Florin,9994,0,9999,5
1714209201955,CLRE 253,B00,507202,Vaida; Florin,9999,0,9999,0
1714209202983,CLRE 259,A00,507211,Patel; Hemal,9996,0,9999,3
1714209204009,CLRE 260,A00,507221,Cuomo; Raphael Eduardo,9999,0,9999,0
1714209205035,CLRE 297,001,507242,Cuomo; Raphael Eduardo,9999,0,9999,0
1714209206061,COGS 197,001,638244,Voytek; Bradley Thomas,9999,0,9999,0
1714209207089,CSE 191,A00,516875,Minnes Kemp; Mor Mia,9993,0,9999,6
1714209208117,CSE 197,001,637388,Minnes Kemp; Mor Mia,9998,0,9999,1
1714209209144,CSS 201S,A01,494383,Staff,35,0,35,0
1714209210169,CSS 202S,A01,494387,Staff,35,0,35,0
1714209211195,DSC 197,001,628532,Eldridge; Justin Matthew,9996,0,9999,3
1714209212223,EAP 100,A00,516065,Staff,9797,0,9999,202
1714209213252,ECE 45,A01,507414,Staff,33,0,60,27
1714209215308,ECE 111,A01,507420,Staff,21,0,50,29
1714209216333,ECE 197,001,548057,Sievenpiper; Daniel F.,9994,0,9999,5
1714209217360,EDS 115,A00,507243,Choi; Bailey Miyeon,12,0,28,16
1714209218390,EDS 117,A01,494379,Staff,0,1,30,30
1714209219416,EDS 125,A00,507246,Hopkins; Megan Beth,12,0,30,18
1714209220445,EDS 128A,A01,507264,Fargason; Sharon Gayle,14,0,26,12
1714209221469,EDS 128B,A01,507293,Pappas; Elizabeth,18,0,30,12
1714209222495,EDS 139,A00,507294,Fargason; Sharon Gayle,18,0,30,12
1714209222495,EDS 139,B00,507313,Pappas; Elizabeth,15,0,30,15
1714209223525,EDS 201,A00,507315,Staff,13,0,30,17
1714209224553,EDS 203,A01,507317,Halter; Christopher P.,12,0,30,18
1714209225579,EDS 204R,A01,507319,Halter; Christopher P.,0,3,30,30
1714209225579,EDS 204R,B01,507331,Heinzman; Erica M.,17,0,30,13
1714209226605,EDS 206R,A00,507332,Staff,0,4,30,30
1714209226605,EDS 206R,B00,507343,Staff,18,0,30,12
1714209227632,EDS 250,A00,507344,Hemans; Patricia Ann Benitez,22,0,40,18
1714209228658,EDS 281,A00,507345,Daly; Alan J.,18,0,18,0
1714209229684,EDS 284,A00,507350,Daly; Alan J.,16,0,16,0
1714209230714,EDS 286,A00,507359,Fine; Sarah,18,0,18,0
1714209231742,EDS 289C,A01,507361,Daly; Alan J.,18,0,18,0
1714209232767,EDS 290,A00,507366,Hofstetter; Carolyn,15,0,15,0
1714209233794,LIGM 5A,A00,507421,Fischer-Grunski; Eva K,18,0,20,2
1714209234824,LIGM 5B,A00,507423,Fischer-Grunski; Eva K,19,0,20,1
1714209235851,LIGM 5C,A00,507425,Fischer-Grunski; Eva K,19,0,20,1
1714209236877,LIIT 5AS,A00,507427,Carnelos; Chiara,20,0,20,0
1714209237902,LIIT 5BS,A00,507430,Carnelos; Chiara,20,0,20,0
1714209238927,LIIT 5CS,A00,507432,Carnelos; Chiara,20,0,20,0
1714209239960,LISP 5A,A00,507541,Munoz Sanchez; Alicia,11,0,20,9
1714209240985,LISP 5B,A00,507671,Munoz Sanchez; Alicia,9,0,20,11
1714209242015,LISP 5C,A00,507696,Munoz Sanchez; Alicia,9,0,20,11
1714209243047,MAE 197,001,528363,Boechler; Nicholas Sebastia,9998,0,9999,1
1714209244129,MATH 197,001,523477,Kedlaya; Kiran S.,9996,0,9999,3
1714209244129,MATH 197,002,563811,Zhang; Danna,9995,0,9999,4
1714209244129,MATH 197,003,628552,Dumitriu; Ioana,9998,0,9999,1
1714209245159,MCWP 40R,A00,518780,Staff,5,0,20,15
1714209245159,MCWP 40R,B00,518781,Staff,7,0,20,13
1714209245159,MCWP 40R,C00,518783,Staff,5,0,20,15
1714209246184,MCWP 50R,A00,518791,Staff,0,0,20,20
1714209246184,MCWP 50R,B00,518792,Staff,0,1,20,20
1714209246184,MCWP 50R,C00,518793,Staff,0,1,20,20
1714209246184,MCWP 50R,D00,518794,Staff,0,0,20,20
1714209246184,MCWP 50R,E00,518795,Staff,0,1,20,20
1714209246184,MCWP 50R,F00,518796,Staff,0,0,20,20
1714209246184,MCWP 50R,G00,518797,Staff,0,1,20,20
1714209247210,MMW 12R,A01,514034,Herbst; Matthew,0,1,16,16
1714209247210,MMW 12R,A02,514035,Herbst; Matthew,2,0,16,14
1714209248239,MMW 13R,A01,514037,Staff,0,4,16,16
1714209248239,MMW 13R,A02,514039,Staff,0,2,16,16
1714209248239,MMW 13R,A03,628519,Staff,0,2,16,16
1714209250291,SIO 295LS,A00,523233,Staff,13,0,30,17
1714209251318,SIO 295S,A00,523232,Staff,13,0,30,17
1714209252344,SIOC 290S,A01,637330,Merrifield; Mark A,28,0,30,2
1714209253371,SIOC 291S,A01,637333,Gabriel; Corey John,28,0,30,2
1714209254401,SOCI 117,A01,494376,Staff,0,2,5,5
1714209255427,WES 237B,A00,494380,Staff,9,0,20,11
1714209257520,AESE 279B,A00,494370,Wade; Jon P,0,0,33,33
1714209258550,AIP 197,001,627712,Vespa; Emanuel Ignacio,9998,0,9999,1
1714209259578,ANAR 135S,A00,494369,Braswell; Geoffrey E.,0,0,0,0
1714209260604,BENG 196,001,628496,Engler; Adam J.,9998,0,9999,1
1714209261631,CAT 124RS,A01,519847,Geibel; William,0,0,20,20
1714209262656,CAT 125RS,A01,515971,Geibel; William,0,0,20,20
1714209263685,CLRE 250,A00,511389,Morris; Sheldon,9993,0,9999,6
1714209264713,CLRE 251,A00,507176,Mehta; Ravindra L.,9993,0,9999,6
1714209264713,CLRE 251,B00,511410,Mehta; Ravindra L.,9998,0,9999,1
1714209265737,CLRE 252,A00,507189,Cuomo; Raphael Eduardo,9995,0,9999,4
1714209266764,CLRE 253,A00,507199,Vaida; Florin,9994,0,9999,5
1714209266764,CLRE 253,B00,507202,Vaida; Florin,9999,0,9999,0
1714209267790,CLRE 259,A00,507211,Patel; Hemal,9996,0,9999,3
1714209268819,CLRE 260,A00,507221,Cuomo; Raphael Eduardo,9999,0,9999,0
1714209269845,CLRE 297,001,507242,Cuomo; Raphael Eduardo,9999,0,9999,0
1714209270871,COGS 197,001,638244,Voytek; Bradley Thomas,9999,0,9999,0
1714209271897,CSE 191,A00,516875,Minnes Kemp; Mor Mia,9993,0,9999,6
1714209272922,CSE 197,001,637388,Minnes Kemp; Mor Mia,9998,0,9999,1
1714209273948,CSS 201S,A01,494383,Staff,35,0,35,0
1714209274978,CSS 202S,A01,494387,Staff,35,0,35,0
1714209276005,DSC 197,001,628532,Eldridge; Justin Matthew,9996,0,9999,3
1714209277033,EAP 100,A00,516065,Staff,9797,0,9999,202
1714209278060,ECE 45,A01,507414,Staff,33,0,60,27
1714209280112,ECE 111,A01,507420,Staff,21,0,50,29
1714209281140,ECE 197,001,548057,Sievenpiper; Daniel F.,9994,0,9999,5
1714209282171,EDS 115,A00,507243,Choi; Bailey Miyeon,12,0,28,16
1714209283202,EDS 117,A01,494379,Staff,0,1,30,30
1714209284229,EDS 125,A00,507246,Hopkins; Megan Beth,12,0,30,18
1714209285254,EDS 128A,A01,507264,Fargason; Sharon Gayle,14,0,26,12
1714209286281,EDS 128B,A01,507293,Pappas; Elizabeth,18,0,30,12
1714209287307,EDS 139,A00,507294,Fargason; Sharon Gayle,18,0,30,12
1714209287307,EDS 139,B00,507313,Pappas; Elizabeth,15,0,30,15
1714209288332,EDS 201,A00,507315,Staff,13,0,30,17
1714209289359,EDS 203,A01,507317,Halter; Christopher P.,12,0,30,18
1714209290385,EDS 204R,A01,507319,Halter; Christopher P.,0,3,30,30
1714209290385,EDS 204R,B01,507331,Heinzman; Erica M.,17,0,30,13
1714209291409,EDS 206R,A00,507332,Staff,0,4,30,30
1714209291409,EDS 206R,B00,507343,Staff,18,0,30,12
1714209292438,EDS 250,A00,507344,Hemans; Patricia Ann Benitez,22,0,40,18
1714209293465,EDS 281,A00,507345,Daly; Alan J.,18,0,18,0
1714209294490,EDS 284,A00,507350,Daly; Alan J.,16,0,16,0
1714209295521,EDS 286,A00,507359,Fine; Sarah,18,0,18,0
1714209296549,EDS 289C,A01,507361,Daly; Alan J.,18,0,18,0
1714209297578,EDS 290,A00,507366,Hofstetter; Carolyn,15,0,15,0
1714209298610,LIGM 5A,A00,507421,Fischer-Grunski; Eva K,18,0,20,2
1714209299639,LIGM 5B,A00,507423,Fischer-Grunski; Eva K,19,0,20,1
1714209300668,LIGM 5C,A00,507425,Fischer-Grunski; Eva K,19,0,20,1
1714209301697,LIIT 5AS,A00,507427,Carnelos; Chiara,20,0,20,0
1714209302726,LIIT 5BS,A00,507430,Carnelos; Chiara,20,0,20,0
1714209303755,LIIT 5CS,A00,507432,Carnelos; Chiara,20,0,20,0
1714209304787,LISP 5A,A00,507541,Munoz Sanchez; Alicia,11,0,20,9
1714209305815,LISP 5B,A00,507671,Munoz Sanchez; Alicia,9,0,20,11
1714209306842,LISP 5C,A00,507696,Munoz Sanchez; Alicia,9,0,20,11
1714209307871,MAE 197,001,528363,Boechler; Nicholas Sebastia,9998,0,9999,1
1714209308905,MATH 197,001,523477,Kedlaya; Kiran S.,9996,0,9999,3
1714209308905,MATH 197,002,563811,Zhang; Danna,9995,0,9999,4
1714209308905,MATH 197,003,628552,Dumitriu; Ioana,9998,0,9999,1
1714209309930,MCWP 40R,A00,518780,Staff,5,0,20,15
1714209309930,MCWP 40R,B00,518781,Staff,7,0,20,13
1714209309930,MCWP 40R,C00,518783,Staff,5,0,20,15
1714209310957,MCWP 50R,A00,518791,Staff,0,0,20,20
1714209310957,MCWP 50R,B00,518792,Staff,0,1,20,20
1714209310957,MCWP 50R,C00,518793,Staff,0,1,20,20
1714209310957,MCWP 50R,D00,518794,Staff,0,0,20,20
1714209310957,MCWP 50R,E00,518795,Staff,0,1,20,20
1714209310957,MCWP 50R,F00,518796,Staff,0,0,20,20
1714209310957,MCWP 50R,G00,518797,Staff,0,1,20,20
1714209311987,MMW 12R,A01,514034,Herbst; Matthew,0,1,16,16
1714209311987,MMW 12R,A02,514035,Herbst; Matthew,2,0,16,14
1714209313016,MMW 13R,A01,514037,Staff,0,4,16,16
1714209313016,MMW 13R,A02,514039,Staff,0,2,16,16
1714209313016,MMW 13R,A03,628519,Staff,0,2,16,16
1714209315068,SIO 295LS,A00,523233,Staff,13,0,30,17
1714209316093,SIO 295S,A00,523232,Staff,13,0,30,17
1714209317124,SIOC 290S,A01,637330,Merrifield; Mark A,28,0,30,2
1714209318150,SIOC 291S,A01,637333,Gabriel; Corey John,28,0,30,2
1714209319175,SOCI 117,A01,494376,Staff,0,2,5,5
1714209320206,WES 237B,A00,494380,Staff,9,0,20,11
1714209322286,AESE 279B,A00,494370,Wade; Jon P,0,0,33,33
1714209323315,AIP 197,001,627712,Vespa; Emanuel Ignacio,9998,0,9999,1
1714209324350,ANAR 135S,A00,494369,Braswell; Geoffrey E.,0,0,0,0
1714209325380,BENG 196,001,628496,Engler; Adam J.,9998,0,9999,1
1714209326407,CAT 124RS,A01,519847,Geibel; William,0,0,20,20
1714209327433,CAT 125RS,A01,515971,Geibel; William,0,0,20,20
1714209328463,CLRE 250,A00,511389,Morris; Sheldon,9993,0,9999,6
1714209329491,CLRE 251,A00,507176,Mehta; Ravindra L.,9993,0,9999,6
1714209329491,CLRE 251,B00,511410,Mehta; Ravindra L.,9998,0,9999,1
1714209330517,CLRE 252,A00,507189,Cuomo; Raphael Eduardo,9995,0,9999,4
1714209331543,CLRE 253,A00,507199,Vaida; Florin,9994,0,9999,5
1714209331543,CLRE 253,B00,507202,Vaida; Florin,9999,0,9999,0
1714209332568,CLRE 259,A00,507211,Patel; Hemal,9996,0,9999,3
1714209333597,CLRE 260,A00,507221,Cuomo; Raphael Eduardo,9999,0,9999,0
1714209334625,CLRE 297,001,507242,Cuomo; Raphael Eduardo,9999,0,9999,0
1714209335652,COGS 197,001,638244,Voytek; Bradley Thomas,9999,0,9999,0
1714209336679,CSE 191,A00,516875,Minnes Kemp; Mor Mia,9993,0,9999,6
1714209337703,CSE 197,001,637388,Minnes Kemp; Mor Mia,9998,0,9999,1
1714209338737,CSS 201S,A01,494383,Staff,35,0,35,0
1714209339767,CSS 202S,A01,494387,Staff,35,0,35,0
1714209340794,DSC 197,001,628532,Eldridge; Justin Matthew,9996,0,9999,3
1714209341819,EAP 100,A00,516065,Staff,9797,0,9999,202
1714209342850,ECE 45,A01,507414,Staff,33,0,60,27
1714209344906,ECE 111,A01,507420,Staff,21,0,50,29
1714209345933,ECE 197,001,548057,Sievenpiper; Daniel F.,9994,0,9999,5
1714209346965,EDS 115,A00,507243,Choi; Bailey Miyeon,12,0,28,16
1714209348048,EDS 117,A01,494379,Staff,0,1,30,30
1714209349074,EDS 125,A00,507246,Hopkins; Megan Beth,12,0,30,18
1714209350103,EDS 128A,A01,507264,Fargason; Sharon Gayle,14,0,26,12
1714209351131,EDS 128B,A01,507293,Pappas; Elizabeth,18,0,30,12
1714209352159,EDS 139,A00,507294,Fargason; Sharon Gayle,18,0,30,12
1714209352159,EDS 139,B00,507313,Pappas; Elizabeth,15,0,30,15
1714209353186,EDS 201,A00,507315,Staff,13,0,30,17
1714209354211,EDS 203,A01,507317,Halter; Christopher P.,12,0,30,18
1714209355237,EDS 204R,A01,507319,Halter; Christopher P.,0,3,30,30
1714209355237,EDS 204R,B01,507331,Heinzman; Erica M.,17,0,30,13
1714209356265,EDS 206R,A00,507332,Staff,0,4,30,30
1714209356265,EDS 206R,B00,507343,Staff,18,0,30,12
1714209357295,EDS 250,A00,507344,Hemans; Patricia Ann Benitez,22,0,40,18
1714209358323,EDS 281,A00,507345,Daly; Alan J.,18,0,18,0
1714209359348,EDS 284,A00,507350,Daly; Alan J.,16,0,16,0
1714209360375,EDS 286,A00,507359,Fine; Sarah,18,0,18,0
1714209361404,EDS 289C,A01,507361,Daly; Alan J.,18,0,18,0
1714209362428,EDS 290,A00,507366,Hofstetter; Carolyn,15,0,15,0
1714209363459,LIGM 5A,A00,507421,Fischer-Grunski; Eva K,18,0,20,2
1714209364486,LIGM 5B,A00,507423,Fischer-Grunski; Eva K,19,0,20,1
1714209365512,LIGM 5C,A00,507425,Fischer-Grunski; Eva K,19,0,20,1
1714209366542,LIIT 5AS,A00,507427,Carnelos; Chiara,20,0,20,0
1714209367566,LIIT 5BS,A00,507430,Carnelos; Chiara,20,0,20,0
1714209368593,LIIT 5CS,A00,507432,Carnelos; Chiara,20,0,20,0
1714209369617,LISP 5A,A00,507541,Munoz Sanchez; Alicia,11,0,20,9
1714209370645,LISP 5B,A00,507671,Munoz Sanchez; Alicia,9,0,20,11
1714209371677,LISP 5C,A00,507696,Munoz Sanchez; Alicia,9,0,20,11
1714209372704,MAE 197,001,528363,Boechler; Nicholas Sebastia,9998,0,9999,1
1714209373730,MATH 197,001,523477,Kedlaya; Kiran S.,9996,0,9999,3
1714209373730,MATH 197,002,563811,Zhang; Danna,9995,0,9999,4
1714209373730,MATH 197,003,628552,Dumitriu; Ioana,9998,0,9999,1
1714209374760,MCWP 40R,A00,518780,Staff,5,0,20,15
1714209374760,MCWP 40R,B00,518781,Staff,7,0,20,13
1714209374760,MCWP 40R,C00,518783,Staff,5,0,20,15
1714209375788,MCWP 50R,A00,518791,Staff,0,0,20,20
1714209375788,MCWP 50R,B00,518792,Staff,0,1,20,20
1714209375788,MCWP 50R,C00,518793,Staff,0,1,20,20
1714209375788,MCWP 50R,D00,518794,Staff,0,0,20,20
1714209375788,MCWP 50R,E00,518795,Staff,0,1,20,20
1714209375788,MCWP 50R,F00,518796,Staff,0,0,20,20
1714209375788,MCWP 50R,G00,518797,Staff,0,1,20,20
1714209376819,MMW 12R,A01,514034,Herbst; Matthew,0,1,16,16
1714209376819,MMW 12R,A02,514035,Herbst; Matthew,2,0,16,14
1714209377846,MMW 13R,A01,514037,Staff,0,4,16,16
1714209377846,MMW 13R,A02,514039,Staff,0,2,16,16
1714209377846,MMW 13R,A03,628519,Staff,0,2,16,16
1714209379904,SIO 295LS,A00,523233,Staff,13,0,30,17
1714209380945,SIO 295S,A00,523232,Staff,13,0,30,17
1714209381979,SIOC 290S,A01,637330,Merrifield; Mark A,28,0,30,2
1714209383006,SIOC 291S,A01,637333,Gabriel; Corey John,28,0,30,2
1714209384038,SOCI 117,A01,494376,Staff,0,2,5,5
1714209385069,WES 237B,A00,494380,Staff,9,0,20,11
1714209387152,AESE 279B,A00,494370,Wade; Jon P,0,0,33,33
1714209388184,AIP 197,001,627712,Vespa; Emanuel Ignacio,9998,0,9999,1
1714209389210,ANAR 135S,A00,494369,Braswell; Geoffrey E.,0,0,0,0
1714209390237,BENG 196,001,628496,Engler; Adam J.,9998,0,9999,1
1714209391264,CAT 124RS,A01,519847,Geibel; William,0,0,20,20
1714209392289,CAT 125RS,A01,515971,Geibel; William,0,0,20,20
1714209393315,CLRE 250,A00,511389,Morris; Sheldon,9993,0,9999,6
1714209394346,CLRE 251,A00,507176,Mehta; Ravindra L.,9993,0,9999,6
1714209394346,CLRE 251,B00,511410,Mehta; Ravindra L.,9998,0,9999,1
1714209395371,CLRE 252,A00,507189,Cuomo; Raphael Eduardo,9995,0,9999,4
1714209396402,CLRE 253,A00,507199,Vaida; Florin,9994,0,9999,5
1714209396402,CLRE 253,B00,507202,Vaida; Florin,9999,0,9999,0
1714209397427,CLRE 259,A00,507211,Patel; Hemal,9996,0,9999,3
1714209398454,CLRE 260,A00,507221,Cuomo; Raphael Eduardo,9999,0,9999,0
1714209399484,CLRE 297,001,507242,Cuomo; Raphael Eduardo,9999,0,9999,0
1714209400509,COGS 197,001,638244,Voytek; Bradley Thomas,9999,0,9999,0
1714209401535,CSE 191,A00,516875,Minnes Kemp; Mor Mia,9993,0,9999,6
1714209402561,CSE 197,001,637388,Minnes Kemp; Mor Mia,9998,0,9999,1
1714209403589,CSS 201S,A01,494383,Staff,35,0,35,0
1714209404616,CSS 202S,A01,494387,Staff,35,0,35,0
1714209405643,DSC 197,001,628532,Eldridge; Justin Matthew,9996,0,9999,3
1714209406672,EAP 100,A00,516065,Staff,9797,0,9999,202
1714209407702,ECE 45,A01,507414,Staff,33,0,60,27
1714209409757,ECE 111,A01,507420,Staff,21,0,50,29
1714209410782,ECE 197,001,548057,Sievenpiper; Daniel F.,9994,0,9999,5
1714209411808,EDS 115,A00,507243,Choi; Bailey Miyeon,12,0,28,16
1714209412834,EDS 117,A01,494379,Staff,0,1,30,30
1714209413871,EDS 125,A00,507246,Hopkins; Megan Beth,12,0,30,18
1714209414895,EDS 128A,A01,507264,Fargason; Sharon Gayle,14,0,26,12
1714209415923,EDS 128B,A01,507293,Pappas; Elizabeth,18,0,30,12
1714209416950,EDS 139,A00,507294,Fargason; Sharon Gayle,18,0,30,12
1714209416950,EDS 139,B00,507313,Pappas; Elizabeth,15,0,30,15
1714209417975,EDS 201,A00,507315,Staff,13,0,30,17
1714209419000,EDS 203,A01,507317,Halter; Christopher P.,12,0,30,18
1714209420027,EDS 204R,A01,507319,Halter; Christopher P.,0,3,30,30
1714209420027,EDS 204R,B01,507331,Heinzman; Erica M.,17,0,30,13
1714209421053,EDS 206R,A00,507332,Staff,0,4,30,30
1714209421053,EDS 206R,B00,507343,Staff,18,0,30,12
1714209422081,EDS 250,A00,507344,Hemans; Patricia Ann Benitez,22,0,40,18
1714209423107,EDS 281,A00,507345,Daly; Alan J.,18,0,18,0
1714209424130,EDS 284,A00,507350,Daly; Alan J.,16,0,16,0
1714209425159,EDS 286,A00,507359,Fine; Sarah,18,0,18,0
1714209426183,EDS 289C,A01,507361,Daly; Alan J.,18,0,18,0
1714209427212,EDS 290,A00,507366,Hofstetter; Carolyn,15,0,15,0
1714209428239,LIGM 5A,A00,507421,Fischer-Grunski; Eva K,18,0,20,2
1714209429266,LIGM 5B,A00,507423,Fischer-Grunski; Eva K,19,0,20,1
1714209430293,LIGM 5C,A00,507425,Fischer-Grunski; Eva K,19,0,20,1
1714209431319,LIIT 5AS,A00,507427,Carnelos; Chiara,20,0,20,0
1714209432345,LIIT 5BS,A00,507430,Carnelos; Chiara,20,0,20,0
1714209433371,LIIT 5CS,A00,507432,Carnelos; Chiara,20,0,20,0
1714209434399,LISP 5A,A00,507541,Munoz Sanchez; Alicia,11,0,20,9
1714209435425,LISP 5B,A00,507671,Munoz Sanchez; Alicia,9,0,20,11
1714209436451,LISP 5C,A00,507696,Munoz Sanchez; Alicia,9,0,20,11
1714209437481,MAE 197,001,528363,Boechler; Nicholas Sebastia,9998,0,9999,1
1714209438516,MATH 197,001,523477,Kedlaya; Kiran S.,9996,0,9999,3
1714209438516,MATH 197,002,563811,Zhang; Danna,9995,0,9999,4
1714209438516,MATH 197,003,628552,Dumitriu; Ioana,9998,0,9999,1
1714209439546,MCWP 40R,A00,518780,Staff,5,0,20,15
1714209439546,MCWP 40R,B00,518781,Staff,7,0,20,13
1714209439546,MCWP 40R,C00,518783,Staff,5,0,20,15
1714209440574,MCWP 50R,A00,518791,Staff,0,0,20,20
1714209440574,MCWP 50R,B00,518792,Staff,0,1,20,20
1714209440574,MCWP 50R,C00,518793,Staff,0,1,20,20
1714209440574,MCWP 50R,D00,518794,Staff,0,0,20,20
1714209440574,MCWP 50R,E00,518795,Staff,0,1,20,20
1714209440574,MCWP 50R,F00,518796,Staff,0,0,20,20
1714209440574,MCWP 50R,G00,518797,Staff,0,1,20,20
1714209441600,MMW 12R,A01,514034,Herbst; Matthew,0,1,16,16
1714209441600,MMW 12R,A02,514035,Herbst; Matthew,2,0,16,14
1714209442630,MMW 13R,A01,514037,Staff,0,4,16,16
1714209442630,MMW 13R,A02,514039,Staff,0,2,16,16
1714209442630,MMW 13R,A03,628519,Staff,0,2,16,16
1714209444681,SIO 295LS,A00,523233,Staff,13,0,30,17
1714209445707,SIO 295S,A00,523232,Staff,13,0,30,17
1714209446739,SIOC 290S,A01,637330,Merrifield; Mark A,28,0,30,2
1714209447765,SIOC 291S,A01,637333,Gabriel; Corey John,28,0,30,2
1714209448791,SOCI 117,A01,494376,Staff,0,2,5,5
1714209449817,WES 237B,A00,494380,Staff,9,0,20,11
1714209451943,AESE 279B,A00,494370,Wade; Jon P,0,0,33,33
1714209452969,AIP 197,001,627712,Vespa; Emanuel Ignacio,9998,0,9999,1
1714209453995,ANAR 135S,A00,494369,Braswell; Geoffrey E.,0,0,0,0
1714209455025,BENG 196,001,628496,Engler; Adam J.,9998,0,9999,1
1714209456053,CAT 124RS,A01,519847,Geibel; William,0,0,20,20
1714209457078,CAT 125RS,A01,515971,Geibel; William,0,0,20,20
1714209458107,CLRE 250,A00,511389,Morris; Sheldon,9993,0,9999,6
1714209459139,CLRE 251,A00,507176,Mehta; Ravindra L.,9993,0,9999,6
1714209459139,CLRE 251,B00,511410,Mehta; Ravindra L.,9998,0,9999,1
1714209460169,CLRE 252,A00,507189,Cuomo; Raphael Eduardo,9995,0,9999,4
1714209461194,CLRE 253,A00,507199,Vaida; Florin,9994,0,9999,5
1714209461194,CLRE 253,B00,507202,Vaida; Florin,9999,0,9999,0
1714209462221,CLRE 259,A00,507211,Patel; Hemal,9996,0,9999,3
1714209463248,CLRE 260,A00,507221,Cuomo; Raphael Eduardo,9999,0,9999,0
1714209464274,CLRE 297,001,507242,Cuomo; Raphael Eduardo,9999,0,9999,0
1714209465302,COGS 197,001,638244,Voytek; Bradley Thomas,9999,0,9999,0
1714209466332,CSE 191,A00,516875,Minnes Kemp; Mor Mia,9993,0,9999,6
1714209467357,CSE 197,001,637388,Minnes Kemp; Mor Mia,9998,0,9999,1
1714209468389,CSS 201S,A01,494383,Staff,35,0,35,0
1714209469419,CSS 202S,A01,494387,Staff,35,0,35,0
1714209470449,DSC 197,001,628532,Eldridge; Justin Matthew,9996,0,9999,3
1714209471474,EAP 100,A00,516065,Staff,9797,0,9999,202
1714209472500,ECE 45,A01,507414,Staff,33,0,60,27
1714209474557,ECE 111,A01,507420,Staff,21,0,50,29
1714209475584,ECE 197,001,548057,Sievenpiper; Daniel F.,9994,0,9999,5
1714209476613,EDS 115,A00,507243,Choi; Bailey Miyeon,12,0,28,16
1714209477641,EDS 117,A01,494379,Staff,0,1,30,30
1714209478667,EDS 125,A00,507246,Hopkins; Megan Beth,12,0,30,18
1714209479697,EDS 128A,A01,507264,Fargason; Sharon Gayle,14,0,26,12
1714209480729,EDS 128B,A01,507293,Pappas; Elizabeth,18,0,30,12
1714209481758,EDS 139,A00,507294,Fargason; Sharon Gayle,18,0,30,12
1714209481758,EDS 139,B00,507313,Pappas; Elizabeth,15,0,30,15
1714209482785,EDS 201,A00,507315,Staff,13,0,30,17
1714209483816,EDS 203,A01,507317,Halter; Christopher P.,12,0,30,18
1714209484848,EDS 204R,A01,507319,Halter; Christopher P.,0,3,30,30
1714209484848,EDS 204R,B01,507331,Heinzman; Erica M.,17,0,30,13
1714209485875,EDS 206R,A00,507332,Staff,0,4,30,30
1714209485875,EDS 206R,B00,507343,Staff,18,0,30,12
1714209486905,EDS 250,A00,507344,Hemans; Patricia Ann Benitez,22,0,40,18
1714209487934,EDS 281,A00,507345,Daly; Alan J.,18,0,18,0
1714209488963,EDS 284,A00,507350,Daly; Alan J.,16,0,16,0
1714209489993,EDS 286,A00,507359,Fine; Sarah,18,0,18,0
1714209491021,EDS 289C,A01,507361,Daly; Alan J.,18,0,18,0
1714209492050,EDS 290,A00,507366,Hofstetter; Carolyn,15,0,15,0
1714209493078,LIGM 5A,A00,507421,Fischer-Grunski; Eva K,18,0,20,2
1714209494106,LIGM 5B,A00,507423,Fischer-Grunski; Eva K,19,0,20,1
1714209495130,LIGM 5C,A00,507425,Fischer-Grunski; Eva K,19,0,20,1
1714209496155,LIIT 5AS,A00,507427,Carnelos; Chiara,20,0,20,0
1714209497179,LIIT 5BS,A00,507430,Carnelos; Chiara,20,0,20,0
1714209498205,LIIT 5CS,A00,507432,Carnelos; Chiara,20,0,20,0
1714209499236,LISP 5A,A00,507541,Munoz Sanchez; Alicia,11,0,20,9
1714209500261,LISP 5B,A00,507671,Munoz Sanchez; Alicia,9,0,20,11
1714209501290,LISP 5C,A00,507696,Munoz Sanchez; Alicia,9,0,20,11
1714209502316,MAE 197,001,528363,Boechler; Nicholas Sebastia,9998,0,9999,1
1714209503344,MATH 197,001,523477,Kedlaya; Kiran S.,9996,0,9999,3
1714209503344,MATH 197,002,563811,Zhang; Danna,9995,0,9999,4
1714209503344,MATH 197,003,628552,Dumitriu; Ioana,9998,0,9999,1
1714209504369,MCWP 40R,A00,518780,Staff,5,0,20,15
1714209504369,MCWP 40R,B00,518781,Staff,7,0,20,13
1714209504369,MCWP 40R,C00,518783,Staff,5,0,20,15
1714209505394,MCWP 50R,A00,518791,Staff,0,0,20,20
1714209505394,MCWP 50R,B00,518792,Staff,0,1,20,20
1714209505394,MCWP 50R,C00,518793,Staff,0,1,20,20
1714209505394,MCWP 50R,D00,518794,Staff,0,0,20,20
1714209505394,MCWP 50R,E00,518795,Staff,0,1,20,20
1714209505394,MCWP 50R,F00,518796,Staff,0,0,20,20
1714209505394,MCWP 50R,G00,518797,Staff,0,1,20,20
1714209506424,MMW 12R,A01,514034,Herbst; Matthew,0,1,16,16
1714209506424,MMW 12R,A02,514035,Herbst; Matthew,2,0,16,14
1714209507453,MMW 13R,A01,514037,Staff,0,4,16,16
1714209507453,MMW 13R,A02,514039,Staff,0,2,16,16
1714209507453,MMW 13R,A03,628519,Staff,0,2,16,16
1714209509511,SIO 295LS,A00,523233,Staff,13,0,30,17
1714209510540,SIO 295S,A00,523232,Staff,13,0,30,17
1714209511567,SIOC 290S,A01,637330,Merrifield; Mark A,28,0,30,2
1714209512593,SIOC 291S,A01,637333,Gabriel; Corey John,28,0,30,2
1714209513622,SOCI 117,A01,494376,Staff,0,2,5,5
1714209514647,WES 237B,A00,494380,Staff,9,0,20,11
1714209516725,AESE 279B,A00,494370,Wade; Jon P,0,0,33,33
1714209517753,AIP 197,001,627712,Vespa; Emanuel Ignacio,9998,0,9999,1
1714209518782,ANAR 135S,A00,494369,Braswell; Geoffrey E.,0,0,0,0
1714209519808,BENG 196,001,628496,Engler; Adam J.,9998,0,9999,1
1714209520834,CAT 124RS,A01,519847,Geibel; William,0,0,20,20
1714209521860,CAT 125RS,A01,515971,Geibel; William,0,0,20,20
1714209522886,CLRE 250,A00,511389,Morris; Sheldon,9993,0,9999,6
1714209523914,CLRE 251,A00,507176,Mehta; Ravindra L.,9993,0,9999,6
1714209523914,CLRE 251,B00,511410,Mehta; Ravindra L.,9998,0,9999,1
1714209524943,CLRE 252,A00,507189,Cuomo; Raphael Eduardo,9995,0,9999,4
1714209525973,CLRE 253,A00,507199,Vaida; Florin,9994,0,9999,5
1714209525973,CLRE 253,B00,507202,Vaida; Florin,9999,0,9999,0
1714209527000,CLRE 259,A00,507211,Patel; Hemal,9996,0,9999,3
1714209528026,CLRE 260,A00,507221,Cuomo; Raphael Eduardo,9999,0,9999,0
1714209529052,CLRE 297,001,507242,Cuomo; Raphael Eduardo,9999,0,9999,0
1714209530086,COGS 197,001,638244,Voytek; Bradley Thomas,9999,0,9999,0
1714209531114,CSE 191,A00,516875,Minnes Kemp; Mor Mia,9993,0,9999,6
1714209532139,CSE 197,001,637388,Minnes Kemp; Mor Mia,9998,0,9999,1
1714209533163,CSS 201S,A01,494383,Staff,35,0,35,0
1714209534199,CSS 202S,A01,494387,Staff,35,0,35,0
1714209535225,DSC 197,001,628532,Eldridge; Justin Matthew,9996,0,9999,3
1714209536253,EAP 100,A00,516065,Staff,9797,0,9999,202
1714209537280,ECE 45,A01,507414,Staff,33,0,60,27
1714209539332,ECE 111,A01,507420,Staff,21,0,50,29
1714209540360,ECE 197,001,548057,Sievenpiper; Daniel F.,9994,0,9999,5
1714209541386,EDS 115,A00,507243,Choi; Bailey Miyeon,12,0,28,16
1714209542412,EDS 117,A01,494379,Staff,0,1,30,30
1714209543437,EDS 125,A00,507246,Hopkins; Megan Beth,12,0,30,18
1714209544465,EDS 128A,A01,507264,Fargason; Sharon Gayle,14,0,26,12
1714209545495,EDS 128B,A01,507293,Pappas; Elizabeth,18,0,30,12
1714209546521,EDS 139,A00,507294,Fargason; Sharon Gayle,18,0,30,12
1714209546521,EDS 139,B00,507313,Pappas; Elizabeth,15,0,30,15
1714209547547,EDS 201,A00,507315,Staff,13,0,30,17
1714209548579,EDS 203,A01,507317,Halter; Christopher P.,12,0,30,18
1714209549606,EDS 204R,A01,507319,Halter; Christopher P.,0,3,30,30
1714209549606,EDS 204R,B01,507331,Heinzman; Erica M.,17,0,30,13
1714209550632,EDS 206R,A00,507332,Staff,0,4,30,30
1714209550632,EDS 206R,B00,507343,Staff,18,0,30,12
1714209551661,EDS 250,A00,507344,Hemans; Patricia Ann Benitez,22,0,40,18
1714209552688,EDS 281,A00,507345,Daly; Alan J.,18,0,18,0
1714209553716,EDS 284,A00,507350,Daly; Alan J.,16,0,16,0
1714209554744,EDS 286,A00,507359,Fine; Sarah,18,0,18,0
1714209555821,EDS 289C,A01,507361,Daly; Alan J.,18,0,18,0
1714209556846,EDS 290,A00,507366,Hofstetter; Carolyn,15,0,15,0
1714209557873,LIGM 5A,A00,507421,Fischer-Grunski; Eva K,18,0,20,2
1714209558899,LIGM 5B,A00,507423,Fischer-Grunski; Eva K,19,0,20,1
1714209559929,LIGM 5C,A00,507425,Fischer-Grunski; Eva K,19,0,20,1
1714209560959,LIIT 5AS,A00,507427,Carnelos; Chiara,20,0,20,0
1714209561988,LIIT 5BS,A00,507430,Carnelos; Chiara,20,0,20,0
1714209563014,LIIT 5CS,A00,507432,Carnelos; Chiara,20,0,20,0
1714209564043,LISP 5A,A00,507541,Munoz Sanchez; Alicia,11,0,20,9
1714209565069,LISP 5B,A00,507671,Munoz Sanchez; Alicia,9,0,20,11
1714209566093,LISP 5C,A00,507696,Munoz Sanchez; Alicia,9,0,20,11
1714209567118,MAE 197,001,528363,Boechler; Nicholas Sebastia,9998,0,9999,1
1714209568151,MATH 197,001,523477,Kedlaya; Kiran S.,9996,0,9999,3
1714209568151,MATH 197,002,563811,Zhang; Danna,9995,0,9999,4
1714209568151,MATH 197,003,628552,Dumitriu; Ioana,9998,0,9999,1
1714209569179,MCWP 40R,A00,518780,Staff,5,0,20,15
1714209569179,MCWP 40R,B00,518781,Staff,7,0,20,13
1714209569179,MCWP 40R,C00,518783,Staff,5,0,20,15
1714209570209,MCWP 50R,A00,518791,Staff,0,0,20,20
1714209570209,MCWP 50R,B00,518792,Staff,0,1,20,20
1714209570209,MCWP 50R,C00,518793,Staff,0,1,20,20
1714209570209,MCWP 50R,D00,518794,Staff,0,0,20,20
1714209570209,MCWP 50R,E00,518795,Staff,0,1,20,20
1714209570209,MCWP 50R,F00,518796,Staff,0,0,20,20
1714209570209,MCWP 50R,G00,518797,Staff,0,1,20,20
1714209571236,MMW 12R,A01,514034,Herbst; Matthew,0,1,16,16
1714209571236,MMW 12R,A02,514035,Herbst; Matthew,2,0,16,14
1714209572260,MMW 13R,A01,514037,Staff,0,4,16,16
1714209572260,MMW 13R,A02,514039,Staff,0,2,16,16
1714209572260,MMW 13R,A03,628519,Staff,0,2,16,16
1714209574313,SIO 295LS,A00,523233,Staff,13,0,30,17
1714209575337,SIO 295S,A00,523232,Staff,13,0,30,17
1714209576367,SIOC 290S,A01,637330,Merrifield; Mark A,28,0,30,2
1714209577395,SIOC 291S,A01,637333,Gabriel; Corey John,28,0,30,2
1714209578425,SOCI 117,A01,494376,Staff,0,2,5,5
1714209579451,WES 237B,A00,494380,Staff,9,0,20,11
1714209581529,AESE 279B,A00,494370,Wade; Jon P,0,0,33,33
1714209582558,AIP 197,001,627712,Vespa; Emanuel Ignacio,9998,0,9999,1
1714209583587,ANAR 135S,A00,494369,Braswell; Geoffrey E.,0,0,0,0
1714209584612,BENG 196,001,628496,Engler; Adam J.,9998,0,9999,1
1714209585638,CAT 124RS,A01,519847,Geibel; William,0,0,20,20
1714209586664,CAT 125RS,A01,515971,Geibel; William,0,0,20,20
1714209587691,CLRE 250,A00,511389,Morris; Sheldon,9993,0,9999,6
1714209588725,CLRE 251,A00,507176,Mehta; Ravindra L.,9993,0,9999,6
1714209588725,CLRE 251,B00,511410,Mehta; Ravindra L.,9998,0,9999,1
1714209589754,CLRE 252,A00,507189,Cuomo; Raphael Eduardo,9995,0,9999,4
1714209590781,CLRE 253,A00,507199,Vaida; Florin,9994,0,9999,5
1714209590781,CLRE 253,B00,507202,Vaida; Florin,9999,0,9999,0
1714209591810,CLRE 259,A00,507211,Patel; Hemal,9996,0,9999,3
1714209592836,CLRE 260,A00,507221,Cuomo; Raphael Eduardo,9999,0,9999,0
1714209593861,CLRE 297,001,507242,Cuomo; Raphael Eduardo,9999,0,9999,0
1714209594887,COGS 197,001,638244,Voytek; Bradley Thomas,9999,0,9999,0
1714209595912,CSE 191,A00,516875,Minnes Kemp; Mor Mia,9993,0,9999,6
1714209596938,CSE 197,001,637388,Minnes Kemp; Mor Mia,9998,0,9999,1
1714209597965,CSS 201S,A01,494383,Staff,35,0,35,0
1714209598995,CSS 202S,A01,494387,Staff,35,0,35,0
1714209600023,DSC 197,001,628532,Eldridge; Justin Matthew,9996,0,9999,3
1714209601047,EAP 100,A00,516065,Staff,9797,0,9999,202
1714209602074,ECE 45,A01,507414,Staff,33,0,60,27
1714209604135,ECE 111,A01,507420,Staff,21,0,50,29
1714209605163,ECE 197,001,548057,Sievenpiper; Daniel F.,9994,0,9999,5
1714209606189,EDS 115,A00,507243,Choi; Bailey Miyeon,12,0,28,16
1714209607218,EDS 117,A01,494379,Staff,0,1,30,30
1714209608247,EDS 125,A00,507246,Hopkins; Megan Beth,12,0,30,18
1714209609271,EDS 128A,A01,507264,Fargason; Sharon Gayle,14,0,26,12
1714209610300,EDS 128B,A01,507293,Pappas; Elizabeth,18,0,30,12
1714209611326,EDS 139,A00,507294,Fargason; Sharon Gayle,18,0,30,12
1714209611326,EDS 139,B00,507313,Pappas; Elizabeth,15,0,30,15
1714209612352,EDS 201,A00,507315,Staff,13,0,30,17
1714209613377,EDS 203,A01,507317,Halter; Christopher P.,12,0,30,18
1714209614407,EDS 204R,A01,507319,Halter; Christopher P.,0,3,30,30
1714209614407,EDS 204R,B01,507331,Heinzman; Erica M.,17,0,30,13
1714209615435,EDS 206R,A00,507332,Staff,0,4,30,30
1714209615435,EDS 206R,B00,507343,Staff,18,0,30,12
1714209616461,EDS 250,A00,507344,Hemans; Patricia Ann Benitez,22,0,40,18
1714209617488,EDS 281,A00,507345,Daly; Alan J.,18,0,18,0
1714209618512,EDS 284,A00,507350,Daly; Alan J.,16,0,16,0
1714209619543,EDS 286,A00,507359,Fine; Sarah,18,0,18,0
1714209620568,EDS 289C,A01,507361,Daly; Alan J.,18,0,18,0
1714209621597,EDS 290,A00,507366,Hofstetter; Carolyn,15,0,15,0
1714209622623,LIGM 5A,A00,507421,Fischer-Grunski; Eva K,18,0,20,2
1714209623647,LIGM 5B,A00,507423,Fischer-Grunski; Eva K,19,0,20,1
1714209624674,LIGM 5C,A00,507425,Fischer-Grunski; Eva K,19,0,20,1
1714209625703,LIIT 5AS,A00,507427,Carnelos; Chiara,20,0,20,0
1714209626728,LIIT 5BS,A00,507430,Carnelos; Chiara,20,0,20,0
1714209627758,LIIT 5CS,A00,507432,Carnelos; Chiara,20,0,20,0
1714209628788,LISP 5A,A00,507541,Munoz Sanchez; Alicia,11,0,20,9
1714209629814,LISP 5B,A00,507671,Munoz Sanchez; Alicia,9,0,20,11
1714209630843,LISP 5C,A00,507696,Munoz Sanchez; Alicia,9,0,20,11
1714209631870,MAE 197,001,528363,Boechler; Nicholas Sebastia,9998,0,9999,1
1714209632900,MATH 197,001,523477,Kedlaya; Kiran S.,9996,0,9999,3
1714209632900,MATH 197,002,563811,Zhang; Danna,9995,0,9999,4
1714209632900,MATH 197,003,628552,Dumitriu; Ioana,9998,0,9999,1
1714209633927,MCWP 40R,A00,518780,Staff,5,0,20,15
1714209633927,MCWP 40R,B00,518781,Staff,7,0,20,13
1714209633927,MCWP 40R,C00,518783,Staff,5,0,20,15
1714209634953,MCWP 50R,A00,518791,Staff,0,0,20,20
1714209634953,MCWP 50R,B00,518792,Staff,0,1,20,20
1714209634953,MCWP 50R,C00,518793,Staff,0,1,20,20
1714209634953,MCWP 50R,D00,518794,Staff,0,0,20,20
1714209634953,MCWP 50R,E00,518795,Staff,0,1,20,20
1714209634953,MCWP 50R,F00,518796,Staff,0,0,20,20
1714209634953,MCWP 50R,G00,518797,Staff,0,1,20,20
1714209635985,MMW 12R,A01,514034,Herbst; Matthew,0,1,16,16
1714209635985,MMW 12R,A02,514035,Herbst; Matthew,2,0,16,14
1714209637014,MMW 13R,A01,514037,Staff,0,4,16,16
1714209637014,MMW 13R,A02,514039,Staff,0,2,16,16
1714209637014,MMW 13R,A03,628519,Staff,0,2,16,16
1714209639070,SIO 295LS,A00,523233,Staff,13,0,30,17
1714209640098,SIO 295S,A00,523232,Staff,13,0,30,17
1714209641130,SIOC 290S,A01,637330,Merrifield; Mark A,28,0,30,2
1714209642161,SIOC 291S,A01,637333,Gabriel; Corey John,28,0,30,2
1714209643187,SOCI 117,A01,494376,Staff,0,2,5,5
1714209644215,WES 237B,A00,494380,Staff,9,0,20,11
1714209646285,AESE 279B,A00,494370,Wade; Jon P,0,0,33,33
1714209647312,AIP 197,001,627712,Vespa; Emanuel Ignacio,9998,0,9999,1
1714209648337,ANAR 135S,A00,494369,Braswell; Geoffrey E.,0,0,0,0
1714209649367,BENG 196,001,628496,Engler; Adam J.,9998,0,9999,1
1714209650397,CAT 124RS,A01,519847,Geibel; William,0,0,20,20
1714209651424,CAT 125RS,A01,515971,Geibel; William,0,0,20,20
1714209652454,CLRE 250,A00,511389,Morris; Sheldon,9993,0,9999,6
1714209653483,CLRE 251,A00,507176,Mehta; Ravindra L.,9993,0,9999,6
1714209653483,CLRE 251,B00,511410,Mehta; Ravindra L.,9998,0,9999,1
1714209654513,CLRE 252,A00,507189,Cuomo; Raphael Eduardo,9995,0,9999,4
1714209655540,CLRE 253,A00,507199,Vaida; Florin,9994,0,9999,5
1714209655540,CLRE 253,B00,507202,Vaida; Florin,9999,0,9999,0
1714209656569,CLRE 259,A00,507211,Patel; Hemal,9996,0,9999,3
1714209657599,CLRE 260,A00,507221,Cuomo; Raphael Eduardo,9999,0,9999,0
1714209658628,CLRE 297,001,507242,Cuomo; Raphael Eduardo,9999,0,9999,0
1714209659708,COGS 197,001,638244,Voytek; Bradley Thomas,9999,0,9999,0
1714209660738,CSE 191,A00,516875,Minnes Kemp; Mor Mia,9993,0,9999,6
1714209661764,CSE 197,001,637388,Minnes Kemp; Mor Mia,9998,0,9999,1
1714209662801,CSS 201S,A01,494383,Staff,35,0,35,0
1714209663828,CSS 202S,A01,494387,Staff,35,0,35,0
1714209664854,DSC 197,001,628532,Eldridge; Justin Matthew,9996,0,9999,3
1714209665883,EAP 100,A00,516065,Staff,9797,0,9999,202
1714209666910,ECE 45,A01,507414,Staff,33,0,60,27
1714209668964,ECE 111,A01,507420,Staff,21,0,50,29
1714209669993,ECE 197,001,548057,Sievenpiper; Daniel F.,9994,0,9999,5
1714209671026,EDS 115,A00,507243,Choi; Bailey Miyeon,12,0,28,16
1714209672053,EDS 117,A01,494379,Staff,0,1,30,30
1714209673080,EDS 125,A00,507246,Hopkins; Megan Beth,12,0,30,18
1714209674107,EDS 128A,A01,507264,Fargason; Sharon Gayle,14,0,26,12
1714209675134,EDS 128B,A01,507293,Pappas; Elizabeth,18,0,30,12
1714209676160,EDS 139,A00,507294,Fargason; Sharon Gayle,18,0,30,12
1714209676160,EDS 139,B00,507313,Pappas; Elizabeth,15,0,30,15
1714209677185,EDS 201,A00,507315,Staff,13,0,30,17
1714209678212,EDS 203,A01,507317,Halter; Christopher P.,12,0,30,18
1714209679241,EDS 204R,A01,507319,Halter; Christopher P.,0,3,30,30
1714209679241,EDS 204R,B01,507331,Heinzman; Erica M.,17,0,30,13
1714209680265,EDS 206R,A00,507332,Staff,0,4,30,30
1714209680265,EDS 206R,B00,507343,Staff,18,0,30,12
1714209681294,EDS 250,A00,507344,Hemans; Patricia Ann Benitez,22,0,40,18
1714209682320,EDS 281,A00,507345,Daly; Alan J.,18,0,18,0
1714209683348,EDS 284,A00,507350,Daly; Alan J.,16,0,16,0
1714209684375,EDS 286,A00,507359,Fine; Sarah,18,0,18,0
1714209685399,EDS 289C,A01,507361,Daly; Alan J.,18,0,18,0
1714209686429,EDS 290,A00,507366,Hofstetter; Carolyn,15,0,15,0
1714209687456,LIGM 5A,A00,507421,Fischer-Grunski; Eva K,18,0,20,2
1714209688486,LIGM 5B,A00,507423,Fischer-Grunski; Eva K,19,0,20,1
1714209689515,LIGM 5C,A00,507425,Fischer-Grunski; Eva K,19,0,20,1
1714209690541,LIIT 5AS,A00,507427,Carnelos; Chiara,20,0,20,0
1714209691565,LIIT 5BS,A00,507430,Carnelos; Chiara,20,0,20,0
1714209692590,LIIT 5CS,A00,507432,Carnelos; Chiara,20,0,20,0
1714209693617,LISP 5A,A00,507541,Munoz Sanchez; Alicia,11,0,20,9
1714209694643,LISP 5B,A00,507671,Munoz Sanchez; Alicia,9,0,20,11
1714209695667,LISP 5C,A00,507696,Munoz Sanchez; Alicia,9,0,20,11
1714209696692,MAE 197,001,528363,Boechler; Nicholas Sebastia,9998,0,9999,1
1714209697722,MATH 197,001,523477,Kedlaya; Kiran S.,9996,0,9999,3
1714209697722,MATH 197,002,563811,Zhang; Danna,9995,0,9999,4
1714209697722,MATH 197,003,628552,Dumitriu; Ioana,9998,0,9999,1
1714209698751,MCWP 40R,A00,518780,Staff,5,0,20,15
1714209698751,MCWP 40R,B00,518781,Staff,7,0,20,13
1714209698751,MCWP 40R,C00,518783,Staff,5,0,20,15
1714209699778,MCWP 50R,A00,518791,Staff,0,0,20,20
1714209699778,MCWP 50R,B00,518792,Staff,0,1,20,20
1714209699778,MCWP 50R,C00,518793,Staff,0,1,20,20
1714209699778,MCWP 50R,D00,518794,Staff,0,0,20,20
1714209699778,MCWP 50R,E00,518795,Staff,0,1,20,20
1714209699778,MCWP 50R,F00,518796,Staff,0,0,20,20
1714209699778,MCWP 50R,G00,518797,Staff,0,1,20,20
1714209700804,MMW 12R,A01,514034,Herbst; Matthew,0,1,16,16
1714209700804,MMW 12R,A02,514035,Herbst; Matthew,2,0,16,14
1714209701829,MMW 13R,A01,514037,Staff,0,4,16,16
1714209701829,MMW 13R,A02,514039,Staff,0,2,16,16
1714209701829,MMW 13R,A03,628519,Staff,0,2,16,16
1714209703882,SIO 295LS,A00,523233,Staff,13,0,30,17
1714209704907,SIO 295S,A00,523232,Staff,13,0,30,17
1714209705939,SIOC 290S,A01,637330,Merrifield; Mark A,28,0,30,2
1714209706965,SIOC 291S,A01,637333,Gabriel; Corey John,28,0,30,2
1714209707994,SOCI 117,A01,494376,Staff,0,2,5,5
1714209709019,WES 237B,A00,494380,Staff,9,0,20,11
1714209711102,AESE 279B,A00,494370,Wade; Jon P,0,0,33,33
1714209712130,AIP 197,001,627712,Vespa; Emanuel Ignacio,9998,0,9999,1
1714209713156,ANAR 135S,A00,494369,Braswell; Geoffrey E.,0,0,0,0
1714209714184,BENG 196,001,628496,Engler; Adam J.,9998,0,9999,1
1714209715212,CAT 124RS,A01,519847,Geibel; William,0,0,20,20
1714209716242,CAT 125RS,A01,515971,Geibel; William,0,0,20,20
1714209717267,CLRE 250,A00,511389,Morris; Sheldon,9993,0,9999,6
1714209718296,CLRE 251,A00,507176,Mehta; Ravindra L.,9993,0,9999,6
1714209718296,CLRE 251,B00,511410,Mehta; Ravindra L.,9998,0,9999,1
1714209719323,CLRE 252,A00,507189,Cuomo; Raphael Eduardo,9995,0,9999,4
1714209720352,CLRE 253,A00,507199,Vaida; Florin,9994,0,9999,5
1714209720352,CLRE 253,B00,507202,Vaida; Florin,9999,0,9999,0
1714209721379,CLRE 259,A00,507211,Patel; Hemal,9996,0,9999,3
1714209722405,CLRE 260,A00,507221,Cuomo; Raphael Eduardo,9999,0,9999,0
1714209723431,CLRE 297,001,507242,Cuomo; Raphael Eduardo,9999,0,9999,0
1714209724455,COGS 197,001,638244,Voytek; Bradley Thomas,9999,0,9999,0
1714209725482,CSE 191,A00,516875,Minnes Kemp; Mor Mia,9993,0,9999,6
1714209726508,CSE 197,001,637388,Minnes Kemp; Mor Mia,9998,0,9999,1
1714209727535,CSS 201S,A01,494383,Staff,35,0,35,0
1714209728562,CSS 202S,A01,494387,Staff,35,0,35,0
1714209729589,DSC 197,001,628532,Eldridge; Justin Matthew,9996,0,9999,3
1714209730617,EAP 100,A00,516065,Staff,9797,0,9999,202
1714209731649,ECE 45,A01,507414,Staff,33,0,60,27
1714209733698,ECE 111,A01,507420,Staff,21,0,50,29
1714209734727,ECE 197,001,548057,Sievenpiper; Daniel F.,9994,0,9999,5
1714209735754,EDS 115,A00,507243,Choi; Bailey Miyeon,12,0,28,16
1714209736781,EDS 117,A01,494379,Staff,0,1,30,30
1714209737808,EDS 125,A00,507246,Hopkins; Megan Beth,12,0,30,18
1714209738839,EDS 128A,A01,507264,Fargason; Sharon Gayle,14,0,26,12
1714209739865,EDS 128B,A01,507293,Pappas; Elizabeth,18,0,30,12
1714209740889,EDS 139,A00,507294,Fargason; Sharon Gayle,18,0,30,12
1714209740889,EDS 139,B00,507313,Pappas; Elizabeth,15,0,30,15
1714209741915,EDS 201,A00,507315,Staff,13,0,30,17
1714209742941,EDS 203,A01,507317,Halter; Christopher P.,12,0,30,18
1714209743975,EDS 204R,A01,507319,Halter; Christopher P.,0,3,30,30
1714209743975,EDS 204R,B01,507331,Heinzman; Erica M.,17,0,30,13
1714209745000,EDS 206R,A00,507332,Staff,0,4,30,30
1714209745000,EDS 206R,B00,507343,Staff,18,0,30,12
1714209746027,EDS 250,A00,507344,Hemans; Patricia Ann Benitez,22,0,40,18
1714209747053,EDS 281,A00,507345,Daly; Alan J.,18,0,18,0
1714209748081,EDS 284,A00,507350,Daly; Alan J.,16,0,16,0
1714209749106,EDS 286,A00,507359,Fine; Sarah,18,0,18,0
1714209750131,EDS 289C,A01,507361,Daly; Alan J.,18,0,18,0
1714209751159,EDS 290,A00,507366,Hofstetter; Carolyn,15,0,15,0
1714209752190,LIGM 5A,A00,507421,Fischer-Grunski; Eva K,18,0,20,2
1714209753216,LIGM 5B,A00,507423,Fischer-Grunski; Eva K,19,0,20,1
1714209754242,LIGM 5C,A00,507425,Fischer-Grunski; Eva K,19,0,20,1
1714209755269,LIIT 5AS,A00,507427,Carnelos; Chiara,20,0,20,0
1714209756295,LIIT 5BS,A00,507430,Carnelos; Chiara,20,0,20,0
1714209757323,LIIT 5CS,A00,507432,Carnelos; Chiara,20,0,20,0
1714209758348,LISP 5A,A00,507541,Munoz Sanchez; Alicia,11,0,20,9
1714209759372,LISP 5B,A00,507671,Munoz Sanchez; Alicia,9,0,20,11
1714209760399,LISP 5C,A00,507696,Munoz Sanchez; Alicia,9,0,20,11
1714209761425,MAE 197,001,528363,Boechler; Nicholas Sebastia,9998,0,9999,1
1714209762452,MATH 197,001,523477,Kedlaya; Kiran S.,9996,0,9999,3
1714209762452,MATH 197,002,563811,Zhang; Danna,9995,0,9999,4
1714209762452,MATH 197,003,628552,Dumitriu; Ioana,9998,0,9999,1
1714209763530,MCWP 40R,A00,518780,Staff,5,0,20,15
1714209763530,MCWP 40R,B00,518781,Staff,7,0,20,13
1714209763530,MCWP 40R,C00,518783,Staff,5,0,20,15
1714209764555,MCWP 50R,A00,518791,Staff,0,0,20,20
1714209764555,MCWP 50R,B00,518792,Staff,0,1,20,20
1714209764555,MCWP 50R,C00,518793,Staff,0,1,20,20
1714209764555,MCWP 50R,D00,518794,Staff,0,0,20,20
1714209764555,MCWP 50R,E00,518795,Staff,0,1,20,20
1714209764555,MCWP 50R,F00,518796,Staff,0,0,20,20
1714209764555,MCWP 50R,G00,518797,Staff,0,1,20,20
1714209765581,MMW 12R,A01,514034,Herbst; Matthew,0,1,16,16
1714209765581,MMW 12R,A02,514035,Herbst; Matthew,2,0,16,14
1714209766610,MMW 13R,A01,514037,Staff,0,4,16,16
1714209766610,MMW 13R,A02,514039,Staff,0,2,16,16
1714209766610,MMW 13R,A03,628519,Staff,0,2,16,16
1714209768664,SIO 295LS,A00,523233,Staff,13,0,30,17
1714209769693,SIO 295S,A00,523232,Staff,13,0,30,17
1714209770722,SIOC 290S,A01,637330,Merrifield; Mark A,28,0,30,2
1714209771753,SIOC 291S,A01,637333,Gabriel; Corey John,28,0,30,2
1714209772780,SOCI 117,A01,494376,Staff,0,2,5,5
1714209773806,WES 237B,A00,494380,Staff,9,0,20,11
1714209775892,AESE 279B,A00,494370,Wade; Jon P,0,0,33,33
1714209776918,AIP 197,001,627712,Vespa; Emanuel Ignacio,9998,0,9999,1
1714209777944,ANAR 135S,A00,494369,Braswell; Geoffrey E.,0,0,0,0
1714209778976,BENG 196,001,628496,Engler; Adam J.,9998,0,9999,1
1714209780001,CAT 124RS,A01,519847,Geibel; William,0,0,20,20
1714209781027,CAT 125RS,A01,515971,Geibel; William,0,0,20,20
1714209782057,CLRE 250,A00,511389,Morris; Sheldon,9993,0,9999,6
1714209783092,CLRE 251,A00,507176,Mehta; Ravindra L.,9993,0,9999,6
1714209783092,CLRE 251,B00,511410,Mehta; Ravindra L.,9998,0,9999,1
1714209784118,CLRE 252,A00,507189,Cuomo; Raphael Eduardo,9995,0,9999,4
1714209785144,CLRE 253,A00,507199,Vaida; Florin,9994,0,9999,5
1714209785144,CLRE 253,B00,507202,Vaida; Florin,9999,0,9999,0
1714209786171,CLRE 259,A00,507211,Patel; Hemal,9996,0,9999,3
1714209787199,CLRE 260,A00,507221,Cuomo; Raphael Eduardo,9999,0,9999,0
1714209788224,CLRE 297,001,507242,Cuomo; Raphael Eduardo,9999,0,9999,0
1714209789252,COGS 197,001,638244,Voytek; Bradley Thomas,9999,0,9999,0
1714209790279,CSE 191,A00,516875,Minnes Kemp; Mor Mia,9993,0,9999,6
1714209791306,CSE 197,001,637388,Minnes Kemp; Mor Mia,9998,0,9999,1
1714209792332,CSS 201S,A01,494383,Staff,35,0,35,0
1714209793361,CSS 202S,A01,494387,Staff,35,0,35,0
1714209794388,DSC 197,001,628532,Eldridge; Justin Matthew,9996,0,9999,3
1714209795412,EAP 100,A00,516065,Staff,9797,0,9999,202
1714209796438,ECE 45,A01,507414,Staff,33,0,60,27
1714209798492,ECE 111,A01,507420,Staff,21,0,50,29
1714209799521,ECE 197,001,548057,Sievenpiper; Daniel F.,9994,0,9999,5
1714209800548,EDS 115,A00,507243,Choi; Bailey Miyeon,12,0,28,16
1714209801573,EDS 117,A01,494379,Staff,0,1,30,30
1714209802602,EDS 125,A00,507246,Hopkins; Megan Beth,12,0,30,18
1714209803628,EDS 128A,A01,507264,Fargason; Sharon Gayle,14,0,26,12
1714209804658,EDS 128B,A01,507293,Pappas; Elizabeth,18,0,30,12
1714209805684,EDS 139,A00,507294,Fargason; Sharon Gayle,18,0,30,12
1714209805684,EDS 139,B00,507313,Pappas; Elizabeth,15,0,30,15
1714209806710,EDS 201,A00,507315,Staff,13,0,30,17
1714209807735,EDS 203,A01,507317,Halter; Christopher P.,12,0,30,18
1714209808765,EDS 204R,A01,507319,Halter; Christopher P.,0,3,30,30
1714209808765,EDS 204R,B01,507331,Heinzman; Erica M.,17,0,30,13
1714209809792,EDS 206R,A00,507332,Staff,0,4,30,30
1714209809792,EDS 206R,B00,507343,Staff,18,0,30,12
1714209810818,EDS 250,A00,507344,Hemans; Patricia Ann Benitez,22,0,40,18
1714209811844,EDS 281,A00,507345,Daly; Alan J.,18,0,18,0
1714209812869,EDS 284,A00,507350,Daly; Alan J.,16,0,16,0
1714209813895,EDS 286,A00,507359,Fine; Sarah,18,0,18,0
1714209814921,EDS 289C,A01,507361,Daly; Alan J.,18,0,18,0
1714209815947,EDS 290,A00,507366,Hofstetter; Carolyn,15,0,15,0
1714209816979,LIGM 5A,A00,507421,Fischer-Grunski; Eva K,18,0,20,2
1714209818004,LIGM 5B,A00,507423,Fischer-Grunski; Eva K,19,0,20,1
1714209819029,LIGM 5C,A00,507425,Fischer-Grunski; Eva K,19,0,20,1
1714209820055,LIIT 5AS,A00,507427,Carnelos; Chiara,20,0,20,0
1714209821082,LIIT 5BS,A00,507430,Carnelos; Chiara,20,0,20,0
1714209822107,LIIT 5CS,A00,507432,Carnelos; Chiara,20,0,20,0
1714209823133,LISP 5A,A00,507541,Munoz Sanchez; Alicia,11,0,20,9
1714209824158,LISP 5B,A00,507671,Munoz Sanchez; Alicia,9,0,20,11
1714209825184,LISP 5C,A00,507696,Munoz Sanchez; Alicia,9,0,20,11
1714209826209,MAE 197,001,528363,Boechler; Nicholas Sebastia,9998,0,9999,1
1714209827237,MATH 197,001,523477,Kedlaya; Kiran S.,9996,0,9999,3
1714209827237,MATH 197,002,563811,Zhang; Danna,9995,0,9999,4
1714209827237,MATH 197,003,628552,Dumitriu; Ioana,9998,0,9999,1
1714209828263,MCWP 40R,A00,518780,Staff,5,0,20,15
1714209828263,MCWP 40R,B00,518781,Staff,7,0,20,13
1714209828263,MCWP 40R,C00,518783,Staff,5,0,20,15
1714209829295,MCWP 50R,A00,518791,Staff,0,0,20,20
1714209829295,MCWP 50R,B00,518792,Staff,0,1,20,20
1714209829295,MCWP 50R,C00,518793,Staff,0,1,20,20
1714209829295,MCWP 50R,D00,518794,Staff,0,0,20,20
1714209829295,MCWP 50R,E00,518795,Staff,0,1,20,20
1714209829295,MCWP 50R,F00,518796,Staff,0,0,20,20
1714209829295,MCWP 50R,G00,518797,Staff,0,1,20,20
1714209830321,MMW 12R,A01,514034,Herbst; Matthew,0,1,16,16
1714209830321,MMW 12R,A02,514035,Herbst; Matthew,2,0,16,14
1714209831345,MMW 13R,A01,514037,Staff,0,4,16,16
1714209831345,MMW 13R,A02,514039,Staff,0,2,16,16
1714209831345,MMW 13R,A03,628519,Staff,0,2,16,16
1714209833394,SIO 295LS,A00,523233,Staff,13,0,30,17
1714209834422,SIO 295S,A00,523232,Staff,13,0,30,17
1714209835451,SIOC 290S,A01,637330,Merrifield; Mark A,28,0,30,2
1714209836478,SIOC 291S,A01,637333,Gabriel; Corey John,28,0,30,2
1714209837503,SOCI 117,A01,494376,Staff,0,2,5,5
1714209838531,WES 237B,A00,494380,Staff,9,0,20,11
1714209840608,AESE 279B,A00,494370,Wade; Jon P,0,0,33,33
1714209841638,AIP 197,001,627712,Vespa; Emanuel Ignacio,9998,0,9999,1
1714209842666,ANAR 135S,A00,494369,Braswell; Geoffrey E.,0,0,0,0
1714209843696,BENG 196,001,628496,Engler; Adam J.,9998,0,9999,1
1714209844725,CAT 124RS,A01,519847,Geibel; William,0,0,20,20
1714209845752,CAT 125RS,A01,515971,Geibel; William,0,0,20,20
1714209846779,CLRE 250,A00,511389,Morris; Sheldon,9993,0,9999,6
1714209847806,CLRE 251,A00,507176,Mehta; Ravindra L.,9993,0,9999,6
1714209847806,CLRE 251,B00,511410,Mehta; Ravindra L.,9998,0,9999,1
1714209848834,CLRE 252,A00,507189,Cuomo; Raphael Eduardo,9995,0,9999,4
1714209849868,CLRE 253,A00,507199,Vaida; Florin,9994,0,9999,5
1714209849868,CLRE 253,B00,507202,Vaida; Florin,9999,0,9999,0
1714209850898,CLRE 259,A00,507211,Patel; Hemal,9996,0,9999,3
1714209851930,CLRE 260,A00,507221,Cuomo; Raphael Eduardo,9999,0,9999,0
1714209852956,CLRE 297,001,507242,Cuomo; Raphael Eduardo,9999,0,9999,0
1714209853984,COGS 197,001,638244,Voytek; Bradley Thomas,9999,0,9999,0
1714209855009,CSE 191,A00,516875,Minnes Kemp; Mor Mia,9993,0,9999,6
1714209856035,CSE 197,001,637388,Minnes Kemp; Mor Mia,9998,0,9999,1
1714209857061,CSS 201S,A01,494383,Staff,35,0,35,0
1714209858088,CSS 202S,A01,494387,Staff,35,0,35,0
1714209859114,DSC 197,001,628532,Eldridge; Justin Matthew,9996,0,9999,3
1714209860143,EAP 100,A00,516065,Staff,9797,0,9999,202
1714209861168,ECE 45,A01,507414,Staff,33,0,60,27
1714209863223,ECE 111,A01,507420,Staff,21,0,50,29
1714209864249,ECE 197,001,548057,Sievenpiper; Daniel F.,9994,0,9999,5
1714209865274,EDS 115,A00,507243,Choi; Bailey Miyeon,12,0,28,16
1714209866301,EDS 117,A01,494379,Staff,0,1,30,30
1714209867383,EDS 125,A00,507246,Hopkins; Megan Beth,12,0,30,18
1714209868410,EDS 128A,A01,507264,Fargason; Sharon Gayle,14,0,26,12
1714209869435,EDS 128B,A01,507293,Pappas; Elizabeth,18,0,30,12
1714209870461,EDS 139,A00,507294,Fargason; Sharon Gayle,18,0,30,12
1714209870461,EDS 139,B00,507313,Pappas; Elizabeth,15,0,30,15
1714209871489,EDS 201,A00,507315,Staff,13,0,30,17
1714209872519,EDS 203,A01,507317,Halter; Christopher P.,12,0,30,18
1714209873545,EDS 204R,A01,507319,Halter; Christopher P.,0,3,30,30
1714209873545,EDS 204R,B01,507331,Heinzman; Erica M.,17,0,30,13
1714209874570,EDS 206R,A00,507332,Staff,0,4,30,30
1714209874570,EDS 206R,B00,507343,Staff,18,0,30,12
1714209875599,EDS 250,A00,507344,Hemans; Patricia Ann Benitez,22,0,40,18
1714209876624,EDS 281,A00,507345,Daly; Alan J.,18,0,18,0
1714209877649,EDS 284,A00,507350,Daly; Alan J.,16,0,16,0
1714209878675,EDS 286,A00,507359,Fine; Sarah,18,0,18,0
1714209879701,EDS 289C,A01,507361,Daly; Alan J.,18,0,18,0
1714209880734,EDS 290,A00,507366,Hofstetter; Carolyn,15,0,15,0
1714209881761,LIGM 5A,A00,507421,Fischer-Grunski; Eva K,18,0,20,2
1714209882792,LIGM 5B,A00,507423,Fischer-Grunski; Eva K,19,0,20,1
1714209883818,LIGM 5C,A00,507425,Fischer-Grunski; Eva K,19,0,20,1
1714209884848,LIIT 5AS,A00,507427,Carnelos; Chiara,20,0,20,0
1714209885898,LIIT 5BS,A00,507430,Carnelos; Chiara,20,0,20,0
1714209886925,LIIT 5CS,A00,507432,Carnelos; Chiara,20,0,20,0
1714209887950,LISP 5A,A00,507541,Munoz Sanchez; Alicia,11,0,20,9
1714209888975,LISP 5B,A00,507671,Munoz Sanchez; Alicia,9,0,20,11
1714209890001,LISP 5C,A00,507696,Munoz Sanchez; Alicia,9,0,20,11
1714209891028,MAE 197,001,528363,Boechler; Nicholas Sebastia,9998,0,9999,1
1714209892057,MATH 197,001,523477,Kedlaya; Kiran S.,9996,0,9999,3
1714209892057,MATH 197,002,563811,Zhang; Danna,9995,0,9999,4
1714209892057,MATH 197,003,628552,Dumitriu; Ioana,9998,0,9999,1
1714209893083,MCWP 40R,A00,518780,Staff,5,0,20,15
1714209893083,MCWP 40R,B00,518781,Staff,7,0,20,13
1714209893083,MCWP 40R,C00,518783,Staff,5,0,20,15
1714209894108,MCWP 50R,A00,518791,Staff,0,0,20,20
1714209894108,MCWP 50R,B00,518792,Staff,0,1,20,20
1714209894108,MCWP 50R,C00,518793,Staff,0,1,20,20
1714209894108,MCWP 50R,D00,518794,Staff,0,0,20,20
1714209894108,MCWP 50R,E00,518795,Staff,0,1,20,20
1714209894108,MCWP 50R,F00,518796,Staff,0,0,20,20
1714209894108,MCWP 50R,G00,518797,Staff,0,1,20,20
1714209895140,MMW 12R,A01,514034,Herbst; Matthew,0,1,16,16
1714209895140,MMW 12R,A02,514035,Herbst; Matthew,2,0,16,14
1714209896166,MMW 13R,A01,514037,Staff,0,4,16,16
1714209896166,MMW 13R,A02,514039,Staff,0,2,16,16
1714209896166,MMW 13R,A03,628519,Staff,0,2,16,16
1714209898219,SIO 295LS,A00,523233,Staff,13,0,30,17
1714209899248,SIO 295S,A00,523232,Staff,13,0,30,17
1714209900276,SIOC 290S,A01,637330,Merrifield; Mark A,28,0,30,2
1714209901306,SIOC 291S,A01,637333,Gabriel; Corey John,28,0,30,2
1714209902336,SOCI 117,A01,494376,Staff,0,2,5,5
1714209903364,WES 237B,A00,494380,Staff,9,0,20,11
1714209905437,AESE 279B,A00,494370,Wade; Jon P,0,0,33,33
1714209906465,AIP 197,001,627712,Vespa; Emanuel Ignacio,9998,0,9999,1
1714209907492,ANAR 135S,A00,494369,Braswell; Geoffrey E.,0,0,0,0
1714209908521,BENG 196,001,628496,Engler; Adam J.,9998,0,9999,1
1714209909549,CAT 124RS,A01,519847,Geibel; William,0,0,20,20
1714209910575,CAT 125RS,A01,515971,Geibel; William,0,0,20,20
1714209911605,CLRE 250,A00,511389,Morris; Sheldon,9993,0,9999,6
1714209912635,CLRE 251,A00,507176,Mehta; Ravindra L.,9993,0,9999,6
1714209912635,CLRE 251,B00,511410,Mehta; Ravindra L.,9998,0,9999,1
1714209913661,CLRE 252,A00,507189,Cuomo; Raphael Eduardo,9995,0,9999,4
1714209914689,CLRE 253,A00,507199,Vaida; Florin,9994,0,9999,5
1714209914689,CLRE 253,B00,507202,Vaida; Florin,9999,0,9999,0
1714209915715,CLRE 259,A00,507211,Patel; Hemal,9996,0,9999,3
1714209916740,CLRE 260,A00,507221,Cuomo; Raphael Eduardo,9999,0,9999,0
1714209917768,CLRE 297,001,507242,Cuomo; Raphael Eduardo,9999,0,9999,0
1714209918794,COGS 197,001,638244,Voytek; Bradley Thomas,9999,0,9999,0
1714209919822,CSE 191,A00,516875,Minnes Kemp; Mor Mia,9993,0,9999,6
1714209920846,CSE 197,001,637388,Minnes Kemp; Mor Mia,9998,0,9999,1
1714209921871,CSS 201S,A01,494383,Staff,35,0,35,0
1714209922900,CSS 202S,A01,494387,Staff,35,0,35,0
1714209923929,DSC 197,001,628532,Eldridge; Justin Matthew,9996,0,9999,3
1714209924957,EAP 100,A00,516065,Staff,9797,0,9999,202
1714209925985,ECE 45,A01,507414,Staff,33,0,60,27
1714209928037,ECE 111,A01,507420,Staff,21,0,50,29
1714209929062,ECE 197,001,548057,Sievenpiper; Daniel F.,9994,0,9999,5
1714209930093,EDS 115,A00,507243,Choi; Bailey Miyeon,12,0,28,16
1714209931119,EDS 117,A01,494379,Staff,0,1,30,30
1714209932147,EDS 125,A00,507246,Hopkins; Megan Beth,12,0,30,18
1714209933172,EDS 128A,A01,507264,Fargason; Sharon Gayle,14,0,26,12
1714209934199,EDS 128B,A01,507293,Pappas; Elizabeth,18,0,30,12
1714209935223,EDS 139,A00,507294,Fargason; Sharon Gayle,18,0,30,12
1714209935223,EDS 139,B00,507313,Pappas; Elizabeth,15,0,30,15
1714209936247,EDS 201,A00,507315,Staff,13,0,30,17
1714209937277,EDS 203,A01,507317,Halter; Christopher P.,12,0,30,18
1714209938304,EDS 204R,A01,507319,Halter; Christopher P.,0,3,30,30
1714209938304,EDS 204R,B01,507331,Heinzman; Erica M.,17,0,30,13
1714209939327,EDS 206R,A00,507332,Staff,0,4,30,30
1714209939327,EDS 206R,B00,507343,Staff,18,0,30,12
1714209940357,EDS 250,A00,507344,Hemans; Patricia Ann Benitez,22,0,40,18
1714209941383,EDS 281,A00,507345,Daly; Alan J.,18,0,18,0
1714209942409,EDS 284,A00,507350,Daly; Alan J.,16,0,16,0
1714209943434,EDS 286,A00,507359,Fine; Sarah,18,0,18,0
1714209944460,EDS 289C,A01,507361,Daly; Alan J.,18,0,18,0
1714209945492,EDS 290,A00,507366,Hofstetter; Carolyn,15,0,15,0
1714209946524,LIGM 5A,A00,507421,Fischer-Grunski; Eva K,18,0,20,2
1714209947550,LIGM 5B,A00,507423,Fischer-Grunski; Eva K,19,0,20,1
1714209948580,LIGM 5C,A00,507425,Fischer-Grunski; Eva K,19,0,20,1
1714209949608,LIIT 5AS,A00,507427,Carnelos; Chiara,20,0,20,0
1714209950633,LIIT 5BS,A00,507430,Carnelos; Chiara,20,0,20,0
1714209951660,LIIT 5CS,A00,507432,Carnelos; Chiara,20,0,20,0
1714209952685,LISP 5A,A00,507541,Munoz Sanchez; Alicia,11,0,20,9
1714209953714,LISP 5B,A00,507671,Munoz Sanchez; Alicia,9,0,20,11
1714209954740,LISP 5C,A00,507696,Munoz Sanchez; Alicia,9,0,20,11
1714209955767,MAE 197,001,528363,Boechler; Nicholas Sebastia,9998,0,9999,1
1714209956796,MATH 197,001,523477,Kedlaya; Kiran S.,9996,0,9999,3
1714209956796,MATH 197,002,563811,Zhang; Danna,9995,0,9999,4
1714209956796,MATH 197,003,628552,Dumitriu; Ioana,9998,0,9999,1
1714209957823,MCWP 40R,A00,518780,Staff,5,0,20,15
1714209957823,MCWP 40R,B00,518781,Staff,7,0,20,13
1714209957823,MCWP 40R,C00,518783,Staff,5,0,20,15
1714209958853,MCWP 50R,A00,518791,Staff,0,0,20,20
1714209958853,MCWP 50R,B00,518792,Staff,0,1,20,20
1714209958853,MCWP 50R,C00,518793,Staff,0,1,20,20
1714209958853,MCWP 50R,D00,518794,Staff,0,0,20,20
1714209958853,MCWP 50R,E00,518795,Staff,0,1,20,20
1714209958853,MCWP 50R,F00,518796,Staff,0,0,20,20
1714209958853,MCWP 50R,G00,518797,Staff,0,1,20,20
1714209959878,MMW 12R,A01,514034,Herbst; Matthew,0,1,16,16
1714209959878,MMW 12R,A02,514035,Herbst; Matthew,2,0,16,14
1714209960909,MMW 13R,A01,514037,Staff,0,4,16,16
1714209960909,MMW 13R,A02,514039,Staff,0,2,16,16
1714209960909,MMW 13R,A03,628519,Staff,0,2,16,16
1714209962963,SIO 295LS,A00,523233,Staff,13,0,30,17
1714209963990,SIO 295S,A00,523232,Staff,13,0,30,17
1714209965016,SIOC 290S,A01,637330,Merrifield; Mark A,28,0,30,2
1714209966040,SIOC 291S,A01,637333,Gabriel; Corey John,28,0,30,2
1714209967065,SOCI 117,A01,494376,Staff,0,2,5,5
1714209968090,WES 237B,A00,494380,Staff,9,0,20,11
1714209970169,AESE 279B,A00,494370,Wade; Jon P,0,0,33,33
1714209971249,AIP 197,001,627712,Vespa; Emanuel Ignacio,9998,0,9999,1
1714209972274,ANAR 135S,A00,494369,Braswell; Geoffrey E.,0,0,0,0
1714209973301,BENG 196,001,628496,Engler; Adam J.,9998,0,9999,1
1714209974326,CAT 124RS,A01,519847,Geibel; William,0,0,20,20
1714209975351,CAT 125RS,A01,515971,Geibel; William,0,0,20,20
1714209976374,CLRE 250,A00,511389,Morris; Sheldon,9993,0,9999,6
1714209977401,CLRE 251,A00,507176,Mehta; Ravindra L.,9993,0,9999,6
1714209977401,CLRE 251,B00,511410,Mehta; Ravindra L.,9998,0,9999,1
1714209978431,CLRE 252,A00,507189,Cuomo; Raphael Eduardo,9995,0,9999,4
1714209979455,CLRE 253,A00,507199,Vaida; Florin,9994,0,9999,5
1714209979455,CLRE 253,B00,507202,Vaida; Florin,9999,0,9999,0
1714209980481,CLRE 259,A00,507211,Patel; Hemal,9996,0,9999,3
1714209981504,CLRE 260,A00,507221,Cuomo; Raphael Eduardo,9999,0,9999,0
1714209982528,CLRE 297,001,507242,Cuomo; Raphael Eduardo,9999,0,9999,0
1714209983552,COGS 197,001,638244,Voytek; Bradley Thomas,9999,0,9999,0
1714209984577,CSE 191,A00,516875,Minnes Kemp; Mor Mia,9993,0,9999,6
1714209985605,CSE 197,001,637388,Minnes Kemp; Mor Mia,9998,0,9999,1
1714209986632,CSS 201S,A01,494383,Staff,35,0,35,0
1714209987657,CSS 202S,A01,494387,Staff,35,0,35,0
1714209988684,DSC 197,001,628532,Eldridge; Justin Matthew,9996,0,9999,3
1714209989711,EAP 100,A00,516065,Staff,9797,0,9999,202
1714209990736,ECE 45,A01,507414,Staff,33,0,60,27
1714209992785,ECE 111,A01,507420,Staff,21,0,50,29
1714209993810,ECE 197,001,548057,Sievenpiper; Daniel F.,9994,0,9999,5
1714209994835,EDS 115,A00,507243,Choi; Bailey Miyeon,12,0,28,16
1714209995860,EDS 117,A01,494379,Staff,0,1,30,30
1714209996885,EDS 125,A00,507246,Hopkins; Megan Beth,12,0,30,18
1714209997910,EDS 128A,A01,507264,Fargason; Sharon Gayle,14,0,26,12
1714209998935,EDS 128B,A01,507293,Pappas; Elizabeth,18,0,30,12
1714209999962,EDS 139,A00,507294,Fargason; Sharon Gayle,18,0,30,12
1714209999962,EDS 139,B00,507313,Pappas; Elizabeth,15,0,30,15
1714210000991,EDS 201,A00,507315,Staff,13,0,30,17
1714210002015,EDS 203,A01,507317,Halter; Christopher P.,12,0,30,18
1714210003046,EDS 204R,A01,507319,Halter; Christopher P.,0,3,30,30
1714210003046,EDS 204R,B01,507331,Heinzman; Erica M.,17,0,30,13
1714210004072,EDS 206R,A00,507332,Staff,0,4,30,30
1714210004072,EDS 206R,B00,507343,Staff,18,0,30,12
1714210005100,EDS 250,A00,507344,Hemans; Patricia Ann Benitez,22,0,40,18
1714210006127,EDS 281,A00,507345,Daly; Alan J.,18,0,18,0
1714210007156,EDS 284,A00,507350,Daly; Alan J.,16,0,16,0
1714210008182,EDS 286,A00,507359,Fine; Sarah,18,0,18,0
1714210009210,EDS 289C,A01,507361,Daly; Alan J.,18,0,18,0
1714210010238,EDS 290,A00,507366,Hofstetter; Carolyn,15,0,15,0
1714210011264,LIGM 5A,A00,507421,Fischer-Grunski; Eva K,18,0,20,2
1714210012293,LIGM 5B,A00,507423,Fischer-Grunski; Eva K,19,0,20,1
1714210013318,LIGM 5C,A00,507425,Fischer-Grunski; Eva K,19,0,20,1
1714210014349,LIIT 5AS,A00,507427,Carnelos; Chiara,20,0,20,0
1714210015378,LIIT 5BS,A00,507430,Carnelos; Chiara,20,0,20,0
1714210016406,LIIT 5CS,A00,507432,Carnelos; Chiara,20,0,20,0
1714210017433,LISP 5A,A00,507541,Munoz Sanchez; Alicia,11,0,20,9
1714210018462,LISP 5B,A00,507671,Munoz Sanchez; Alicia,9,0,20,11
1714210019489,LISP 5C,A00,507696,Munoz Sanchez; Alicia,9,0,20,11
1714210020519,MAE 197,001,528363,Boechler; Nicholas Sebastia,9998,0,9999,1
1714210021547,MATH 197,001,523477,Kedlaya; Kiran S.,9996,0,9999,3
1714210021547,MATH 197,002,563811,Zhang; Danna,9995,0,9999,4
1714210021547,MATH 197,003,628552,Dumitriu; Ioana,9998,0,9999,1
1714210022577,MCWP 40R,A00,518780,Staff,5,0,20,15
1714210022577,MCWP 40R,B00,518781,Staff,7,0,20,13
1714210022577,MCWP 40R,C00,518783,Staff,5,0,20,15
1714210023604,MCWP 50R,A00,518791,Staff,0,0,20,20
1714210023604,MCWP 50R,B00,518792,Staff,0,1,20,20
1714210023604,MCWP 50R,C00,518793,Staff,0,1,20,20
1714210023604,MCWP 50R,D00,518794,Staff,0,0,20,20
1714210023604,MCWP 50R,E00,518795,Staff,0,1,20,20
1714210023604,MCWP 50R,F00,518796,Staff,0,0,20,20
1714210023604,MCWP 50R,G00,518797,Staff,0,1,20,20
1714210024631,MMW 12R,A01,514034,Herbst; Matthew,0,1,16,16
1714210024631,MMW 12R,A02,514035,Herbst; Matthew,2,0,16,14
1714210025657,MMW 13R,A01,514037,Staff,0,4,16,16
1714210025657,MMW 13R,A02,514039,Staff,0,2,16,16
1714210025657,MMW 13R,A03,628519,Staff,0,2,16,16
1714210027711,SIO 295LS,A00,523233,Staff,13,0,30,17
1714210028739,SIO 295S,A00,523232,Staff,13,0,30,17
1714210029768,SIOC 290S,A01,637330,Merrifield; Mark A,28,0,30,2
1714210030796,SIOC 291S,A01,637333,Gabriel; Corey John,28,0,30,2
1714210031822,SOCI 117,A01,494376,Staff,0,2,5,5
1714210032848,WES 237B,A00,494380,Staff,9,0,20,11
1714210034923,AESE 279B,A00,494370,Wade; Jon P,0,0,33,33
1714210035970,AIP 197,001,627712,Vespa; Emanuel Ignacio,9998,0,9999,1
1714210036994,ANAR 135S,A00,494369,Braswell; Geoffrey E.,0,0,0,0
1714210038023,BENG 196,001,628496,Engler; Adam J.,9998,0,9999,1
1714210039051,CAT 124RS,A01,519847,Geibel; William,0,0,20,20
1714210040077,CAT 125RS,A01,515971,Geibel; William,0,0,20,20
1714210041105,CLRE 250,A00,511389,Morris; Sheldon,9993,0,9999,6
1714210042133,CLRE 251,A00,507176,Mehta; Ravindra L.,9993,0,9999,6
1714210042133,CLRE 251,B00,511410,Mehta; Ravindra L.,9998,0,9999,1
1714210043161,CLRE 252,A00,507189,Cuomo; Raphael Eduardo,9995,0,9999,4
1714210044191,CLRE 253,A00,507199,Vaida; Florin,9994,0,9999,5
1714210044191,CLRE 253,B00,507202,Vaida; Florin,9999,0,9999,0
1714210045221,CLRE 259,A00,507211,Patel; Hemal,9996,0,9999,3
1714210046247,CLRE 260,A00,507221,Cuomo; Raphael Eduardo,9999,0,9999,0
1714210047276,CLRE 297,001,507242,Cuomo; Raphael Eduardo,9999,0,9999,0
1714210048303,COGS 197,001,638244,Voytek; Bradley Thomas,9999,0,9999,0
1714210049329,CSE 191,A00,516875,Minnes Kemp; Mor Mia,9993,0,9999,6
1714210050355,CSE 197,001,637388,Minnes Kemp; Mor Mia,9998,0,9999,1
1714210051386,CSS 201S,A01,494383,Staff,35,0,35,0
1714210052410,CSS 202S,A01,494387,Staff,35,0,35,0
1714210053436,DSC 197,001,628532,Eldridge; Justin Matthew,9996,0,9999,3
1714210054461,EAP 100,A00,516065,Staff,9797,0,9999,202
1714210055487,ECE 45,A01,507414,Staff,33,0,60,27
1714210057538,ECE 111,A01,507420,Staff,21,0,50,29
1714210058564,ECE 197,001,548057,Sievenpiper; Daniel F.,9994,0,9999,5
1714210059591,EDS 115,A00,507243,Choi; Bailey Miyeon,12,0,28,16
1714210060622,EDS 117,A01,494379,Staff,0,1,30,30
1714210061650,EDS 125,A00,507246,Hopkins; Megan Beth,12,0,30,18
1714210062677,EDS 128A,A01,507264,Fargason; Sharon Gayle,14,0,26,12
1714210063703,EDS 128B,A01,507293,Pappas; Elizabeth,18,0,30,12
1714210064729,EDS 139,A00,507294,Fargason; Sharon Gayle,18,0,30,12
1714210064729,EDS 139,B00,507313,Pappas; Elizabeth,15,0,30,15
1714210065756,EDS 201,A00,507315,Staff,13,0,30,17
1714210066786,EDS 203,A01,507317,Halter; Christopher P.,12,0,30,18
1714210067811,EDS 204R,A01,507319,Halter; Christopher P.,0,3,30,30
1714210067811,EDS 204R,B01,507331,Heinzman; Erica M.,17,0,30,13
1714210068837,EDS 206R,A00,507332,Staff,0,4,30,30
1714210068837,EDS 206R,B00,507343,Staff,18,0,30,12
1714210069862,EDS 250,A00,507344,Hemans; Patricia Ann Benitez,22,0,40,18
1714210070890,EDS 281,A00,507345,Daly; Alan J.,18,0,18,0
1714210071915,EDS 284,A00,507350,Daly; Alan J.,16,0,16,0
1714210072941,EDS 286,A00,507359,Fine; Sarah,18,0,18,0
1714210073968,EDS 289C,A01,507361,Daly; Alan J.,18,0,18,0
1714210075063,EDS 290,A00,507366,Hofstetter; Carolyn,15,0,15,0
1714210076092,LIGM 5A,A00,507421,Fischer-Grunski; Eva K,18,0,20,2
1714210077122,LIGM 5B,A00,507423,Fischer-Grunski; Eva K,19,0,20,1
1714210078147,LIGM 5C,A00,507425,Fischer-Grunski; Eva K,19,0,20,1
1714210079173,LIIT 5AS,A00,507427,Carnelos; Chiara,20,0,20,0
1714210080197,LIIT 5BS,A00,507430,Carnelos; Chiara,20,0,20,0
1714210081226,LIIT 5CS,A00,507432,Carnelos; Chiara,20,0,20,0
1714210082252,LISP 5A,A00,507541,Munoz Sanchez; Alicia,11,0,20,9
1714210083277,LISP 5B,A00,507671,Munoz Sanchez; Alicia,9,0,20,11
1714210084303,LISP 5C,A00,507696,Munoz Sanchez; Alicia,9,0,20,11
1714210085328,MAE 197,001,528363,Boechler; Nicholas Sebastia,9998,0,9999,1
1714210086352,MATH 197,001,523477,Kedlaya; Kiran S.,9996,0,9999,3
1714210086352,MATH 197,002,563811,Zhang; Danna,9995,0,9999,4
1714210086352,MATH 197,003,628552,Dumitriu; Ioana,9998,0,9999,1
1714210087378,MCWP 40R,A00,518780,Staff,5,0,20,15
1714210087378,MCWP 40R,B00,518781,Staff,7,0,20,13
1714210087378,MCWP 40R,C00,518783,Staff,5,0,20,15
1714210088404,MCWP 50R,A00,518791,Staff,0,0,20,20
1714210088404,MCWP 50R,B00,518792,Staff,0,1,20,20
1714210088404,MCWP 50R,C00,518793,Staff,0,1,20,20
1714210088404,MCWP 50R,D00,518794,Staff,0,0,20,20
1714210088404,MCWP 50R,E00,518795,Staff,0,1,20,20
1714210088404,MCWP 50R,F00,518796,Staff,0,0,20,20
1714210088404,MCWP 50R,G00,518797,Staff,0,1,20,20
1714210089430,MMW 12R,A01,514034,Herbst; Matthew,0,1,16,16
1714210089430,MMW 12R,A02,514035,Herbst; Matthew,2,0,16,14
1714210090457,MMW 13R,A01,514037,Staff,0,4,16,16
1714210090457,MMW 13R,A02,514039,Staff,0,2,16,16
1714210090457,MMW 13R,A03,628519,Staff,0,2,16,16
1714210092509,SIO 295LS,A00,523233,Staff,13,0,30,17
1714210093533,SIO 295S,A00,523232,Staff,13,0,30,17
1714210094558,SIOC 290S,A01,637330,Merrifield; Mark A,28,0,30,2
1714210095587,SIOC 291S,A01,637333,Gabriel; Corey John,28,0,30,2
1714210096616,SOCI 117,A01,494376,Staff,0,2,5,5
1714210097641,WES 237B,A00,494380,Staff,9,0,20,11
1714210099703,AESE 279B,A00,494370,Wade; Jon P,0,0,33,33
1714210100730,AIP 197,001,627712,Vespa; Emanuel Ignacio,9998,0,9999,1
1714210101755,ANAR 135S,A00,494369,Braswell; Geoffrey E.,0,0,0,0
1714210102782,BENG 196,001,628496,Engler; Adam J.,9998,0,9999,1
1714210103810,CAT 124RS,A01,519847,Geibel; William,0,0,20,20
1714210104836,CAT 125RS,A01,515971,Geibel; William,0,0,20,20
1714210105863,CLRE 250,A00,511389,Morris; Sheldon,9993,0,9999,6
1714210106891,CLRE 251,A00,507176,Mehta; Ravindra L.,9993,0,9999,6
1714210106891,CLRE 251,B00,511410,Mehta; Ravindra L.,9998,0,9999,1
1714210107916,CLRE 252,A00,507189,Cuomo; Raphael Eduardo,9995,0,9999,4
1714210108946,CLRE 253,A00,507199,Vaida; Florin,9994,0,9999,5
1714210108946,CLRE 253,B00,507202,Vaida; Florin,9999,0,9999,0
1714210109970,CLRE 259,A00,507211,Patel; Hemal,9996,0,9999,3
1714210110996,CLRE 260,A00,507221,Cuomo; Raphael Eduardo,9999,0,9999,0
1714210112024,CLRE 297,001,507242,Cuomo; Raphael Eduardo,9999,0,9999,0
1714210113051,COGS 197,001,638244,Voytek; Bradley Thomas,9999,0,9999,0
1714210114075,CSE 191,A00,516875,Minnes Kemp; Mor Mia,9993,0,9999,6
1714210115100,CSE 197,001,637388,Minnes Kemp; Mor Mia,9998,0,9999,1
1714210116127,CSS 201S,A01,494383,Staff,35,0,35,0
1714210117153,CSS 202S,A01,494387,Staff,35,0,35,0
1714210118180,DSC 197,001,628532,Eldridge; Justin Matthew,9996,0,9999,3
1714210119207,EAP 100,A00,516065,Staff,9797,0,9999,202
1714210120237,ECE 45,A01,507414,Staff,33,0,60,27
1714210122287,ECE 111,A01,507420,Staff,21,0,50,29
1714210123314,ECE 197,001,548057,Sievenpiper; Daniel F.,9994,0,9999,5
1714210124342,EDS 115,A00,507243,Choi; Bailey Miyeon,12,0,28,16
1714210125368,EDS 117,A01,494379,Staff,0,1,30,30
1714210126396,EDS 125,A00,507246,Hopkins; Megan Beth,12,0,30,18
1714210127421,EDS 128A,A01,507264,Fargason; Sharon Gayle,14,0,26,12
1714210128447,EDS 128B,A01,507293,Pappas; Elizabeth,18,0,30,12
1714210129476,EDS 139,A00,507294,Fargason; Sharon Gayle,18,0,30,12
1714210129476,EDS 139,B00,507313,Pappas; Elizabeth,15,0,30,15
1714210130500,EDS 201,A00,507315,Staff,13,0,30,17
1714210131526,EDS 203,A01,507317,Halter; Christopher P.,12,0,30,18
1714210132556,EDS 204R,A01,507319,Halter; Christopher P.,0,3,30,30
1714210132556,EDS 204R,B01,507331,Heinzman; Erica M.,17,0,30,13
1714210133582,EDS 206R,A00,507332,Staff,0,4,30,30
1714210133582,EDS 206R,B00,507343,Staff,18,0,30,12
1714210134611,EDS 250,A00,507344,Hemans; Patricia Ann Benitez,22,0,40,18
1714210135639,EDS 281,A00,507345,Daly; Alan J.,18,0,18,0
1714210136667,EDS 284,A00,507350,Daly; Alan J.,16,0,16,0
1714210137693,EDS 286,A00,507359,Fine; Sarah,18,0,18,0
1714210138718,EDS 289C,A01,507361,Daly; Alan J.,18,0,18,0
1714210139745,EDS 290,A00,507366,Hofstetter; Carolyn,15,0,15,0
1714210140780,LIGM 5A,A00,507421,Fischer-Grunski; Eva K,18,0,20,2
1714210141804,LIGM 5B,A00,507423,Fischer-Grunski; Eva K,19,0,20,1
1714210142830,LIGM 5C,A00,507425,Fischer-Grunski; Eva K,19,0,20,1
1714210143859,LIIT 5AS,A00,507427,Carnelos; Chiara,20,0,20,0
1714210144883,LIIT 5BS,A00,507430,Carnelos; Chiara,20,0,20,0
1714210145912,LIIT 5CS,A00,507432,Carnelos; Chiara,20,0,20,0
1714210146937,LISP 5A,A00,507541,Munoz Sanchez; Alicia,11,0,20,9
1714210147962,LISP 5B,A00,507671,Munoz Sanchez; Alicia,9,0,20,11
1714210148990,LISP 5C,A00,507696,Munoz Sanchez; Alicia,9,0,20,11
1714210150017,MAE 197,001,528363,Boechler; Nicholas Sebastia,9998,0,9999,1
1714210151045,MATH 197,001,523477,Kedlaya; Kiran S.,9996,0,9999,3
1714210151045,MATH 197,002,563811,Zhang; Danna,9995,0,9999,4
1714210151045,MATH 197,003,628552,Dumitriu; Ioana,9998,0,9999,1
1714210152074,MCWP 40R,A00,518780,Staff,5,0,20,15
1714210152074,MCWP 40R,B00,518781,Staff,7,0,20,13
1714210152074,MCWP 40R,C00,518783,Staff,5,0,20,15
1714210153103,MCWP 50R,A00,518791,Staff,0,0,20,20
1714210153103,MCWP 50R,B00,518792,Staff,0,1,20,20
1714210153103,MCWP 50R,C00,518793,Staff,0,1,20,20
1714210153103,MCWP 50R,D00,518794,Staff,0,0,20,20
1714210153103,MCWP 50R,E00,518795,Staff,0,1,20,20
1714210153103,MCWP 50R,F00,518796,Staff,0,0,20,20
1714210153103,MCWP 50R,G00,518797,Staff,0,1,20,20
1714210154129,MMW 12R,A01,514034,Herbst; Matthew,0,1,16,16
1714210154129,MMW 12R,A02,514035,Herbst; Matthew,2,0,16,14
1714210155156,MMW 13R,A01,514037,Staff,0,4,16,16
1714210155156,MMW 13R,A02,514039,Staff,0,2,16,16
1714210155156,MMW 13R,A03,628519,Staff,0,2,16,16
1714210157206,SIO 295LS,A00,523233,Staff,13,0,30,17
1714210158233,SIO 295S,A00,523232,Staff,13,0,30,17
1714210159262,SIOC 290S,A01,637330,Merrifield; Mark A,28,0,30,2
1714210160287,SIOC 291S,A01,637333,Gabriel; Corey John,28,0,30,2
1714210161313,SOCI 117,A01,494376,Staff,0,2,5,5
1714210162341,WES 237B,A00,494380,Staff,9,0,20,11
1714210164410,AESE 279B,A00,494370,Wade; Jon P,0,0,33,33
1714210165436,AIP 197,001,627712,Vespa; Emanuel Ignacio,9998,0,9999,1
1714210166462,ANAR 135S,A00,494369,Braswell; Geoffrey E.,0,0,0,0
1714210167493,BENG 196,001,628496,Engler; Adam J.,9998,0,9999,1
1714210168519,CAT 124RS,A01,519847,Geibel; William,0,0,20,20
1714210169547,CAT 125RS,A01,515971,Geibel; William,0,0,20,20
1714210170576,CLRE 250,A00,511389,Morris; Sheldon,9993,0,9999,6
1714210171601,CLRE 251,A00,507176,Mehta; Ravindra L.,9993,0,9999,6
1714210171601,CLRE 251,B00,511410,Mehta; Ravindra L.,9998,0,9999,1
1714210172627,CLRE 252,A00,507189,Cuomo; Raphael Eduardo,9995,0,9999,4
1714210173651,CLRE 253,A00,507199,Vaida; Florin,9994,0,9999,5
1714210173651,CLRE 253,B00,507202,Vaida; Florin,9999,0,9999,0
1714210174677,CLRE 259,A00,507211,Patel; Hemal,9996,0,9999,3
1714210175703,CLRE 260,A00,507221,Cuomo; Raphael Eduardo,9999,0,9999,0
1714210176728,CLRE 297,001,507242,Cuomo; Raphael Eduardo,9999,0,9999,0
1714210177756,COGS 197,001,638244,Voytek; Bradley Thomas,9999,0,9999,0
1714210178835,CSE 191,A00,516875,Minnes Kemp; Mor Mia,9993,0,9999,6
1714210179863,CSE 197,001,637388,Minnes Kemp; Mor Mia,9998,0,9999,1
1714210180889,CSS 201S,A01,494383,Staff,35,0,35,0
1714210181915,CSS 202S,A01,494387,Staff,35,0,35,0
1714210182940,DSC 197,001,628532,Eldridge; Justin Matthew,9996,0,9999,3
1714210183966,EAP 100,A00,516065,Staff,9797,0,9999,202
1714210184990,ECE 45,A01,507414,Staff,33,0,60,27
1714210187044,ECE 111,A01,507420,Staff,21,0,50,29
1714210188070,ECE 197,001,548057,Sievenpiper; Daniel F.,9994,0,9999,5
1714210189095,EDS 115,A00,507243,Choi; Bailey Miyeon,12,0,28,16
1714210190123,EDS 117,A01,494379,Staff,0,1,30,30
1714210191147,EDS 125,A00,507246,Hopkins; Megan Beth,12,0,30,18
1714210192172,EDS 128A,A01,507264,Fargason; Sharon Gayle,14,0,26,12
1714210193197,EDS 128B,A01,507293,Pappas; Elizabeth,18,0,30,12
1714210194221,EDS 139,A00,507294,Fargason; Sharon Gayle,18,0,30,12
1714210194221,EDS 139,B00,507313,Pappas; Elizabeth,15,0,30,15
1714210195252,EDS 201,A00,507315,Staff,13,0,30,17
1714210196281,EDS 203,A01,507317,Halter; Christopher P.,12,0,30,18
1714210197308,EDS 204R,A01,507319,Halter; Christopher P.,0,3,30,30
1714210197308,EDS 204R,B01,507331,Heinzman; Erica M.,17,0,30,13
1714210198332,EDS 206R,A00,507332,Staff,0,4,30,30
1714210198332,EDS 206R,B00,507343,Staff,18,0,30,12
1714210199358,EDS 250,A00,507344,Hemans; Patricia Ann Benitez,22,0,40,18
1714210200385,EDS 281,A00,507345,Daly; Alan J.,18,0,18,0
1714210201411,EDS 284,A00,507350,Daly; Alan J.,16,0,16,0
1714210202440,EDS 286,A00,507359,Fine; Sarah,18,0,18,0
1714210203466,EDS 289C,A01,507361,Daly; Alan J.,18,0,18,0
1714210204490,EDS 290,A00,507366,Hofstetter; Carolyn,15,0,15,0
1714210205516,LIGM 5A,A00,507421,Fischer-Grunski; Eva K,18,0,20,2
1714210206545,LIGM 5B,A00,507423,Fischer-Grunski; Eva K,19,0,20,1
1714210207570,LIGM 5C,A00,507425,Fischer-Grunski; Eva K,19,0,20,1
1714210208595,LIIT 5AS,A00,507427,Carnelos; Chiara,20,0,20,0
1714210209623,LIIT 5BS,A00,507430,Carnelos; Chiara,20,0,20,0
1714210210652,LIIT 5CS,A00,507432,Carnelos; Chiara,20,0,20,0
1714210211678,LISP 5A,A00,507541,Munoz Sanchez; Alicia,11,0,20,9
1714210212704,LISP 5B,A00,507671,Munoz Sanchez; Alicia,9,0,20,11
1714210213733,LISP 5C,A00,507696,Munoz Sanchez; Alicia,9,0,20,11
1714210214760,MAE 197,001,528363,Boechler; Nicholas Sebastia,9998,0,9999,1
1714210215845,MATH 197,001,523477,Kedlaya; Kiran S.,9996,0,9999,3
1714210215845,MATH 197,002,563811,Zhang; Danna,9995,0,9999,4
1714210215845,MATH 197,003,628552,Dumitriu; Ioana,9998,0,9999,1
1714210216874,MCWP 40R,A00,518780,Staff,5,0,20,15
1714210216874,MCWP 40R,B00,518781,Staff,7,0,20,13
1714210216874,MCWP 40R,C00,518783,Staff,5,0,20,15
1714210217904,MCWP 50R,A00,518791,Staff,0,0,20,20
1714210217904,MCWP 50R,B00,518792,Staff,0,1,20,20
1714210217904,MCWP 50R,C00,518793,Staff,0,1,20,20
1714210217904,MCWP 50R,D00,518794,Staff,0,0,20,20
1714210217904,MCWP 50R,E00,518795,Staff,0,1,20,20
1714210217904,MCWP 50R,F00,518796,Staff,0,0,20,20
1714210217904,MCWP 50R,G00,518797,Staff,0,1,20,20
1714210218932,MMW 12R,A01,514034,Herbst; Matthew,0,1,16,16
1714210218932,MMW 12R,A02,514035,Herbst; Matthew,2,0,16,14
1714210219957,MMW 13R,A01,514037,Staff,0,4,16,16
1714210219957,MMW 13R,A02,514039,Staff,0,2,16,16
1714210219957,MMW 13R,A03,628519,Staff,0,2,16,16
1714210222007,SIO 295LS,A00,523233,Staff,13,0,30,17
1714210223033,SIO 295S,A00,523232,Staff,13,0,30,17
1714210224057,SIOC 290S,A01,637330,Merrifield; Mark A,28,0,30,2
1714210225085,SIOC 291S,A01,637333,Gabriel; Corey John,28,0,30,2
1714210226111,SOCI 117,A01,494376,Staff,0,2,5,5
1714210227135,WES 237B,A00,494380,Staff,9,0,20,11
1714210229203,AESE 279B,A00,494370,Wade; Jon P,0,0,33,33
1714210230229,AIP 197,001,627712,Vespa; Emanuel Ignacio,9998,0,9999,1
1714210231254,ANAR 135S,A00,494369,Braswell; Geoffrey E.,0,0,0,0
1714210232277,BENG 196,001,628496,Engler; Adam J.,9998,0,9999,1
1714210233302,CAT 124RS,A01,519847,Geibel; William,0,0,20,20
1714210234327,CAT 125RS,A01,515971,Geibel; William,0,0,20,20
1714210235352,CLRE 250,A00,511389,Morris; Sheldon,9993,0,9999,6
1714210236377,CLRE 251,A00,507176,Mehta; Ravindra L.,9993,0,9999,6
1714210236377,CLRE 251,B00,511410,Mehta; Ravindra L.,9998,0,9999,1
1714210237403,CLRE 252,A00,507189,Cuomo; Raphael Eduardo,9995,0,9999,4
1714210238429,CLRE 253,A00,507199,Vaida; Florin,9994,0,9999,5
1714210238429,CLRE 253,B00,507202,Vaida; Florin,9999,0,9999,0
1714210239454,CLRE 259,A00,507211,Patel; Hemal,9996,0,9999,3
1714210240483,CLRE 260,A00,507221,Cuomo; Raphael Eduardo,9999,0,9999,0
1714210241509,CLRE 297,001,507242,Cuomo; Raphael Eduardo,9999,0,9999,0
1714210242539,COGS 197,001,638244,Voytek; Bradley Thomas,9999,0,9999,0
1714210243564,CSE 191,A00,516875,Minnes Kemp; Mor Mia,9993,0,9999,6
1714210244592,CSE 197,001,637388,Minnes Kemp; Mor Mia,9998,0,9999,1
1714210245619,CSS 201S,A01,494383,Staff,35,0,35,0
1714210246643,CSS 202S,A01,494387,Staff,35,0,35,0
1714210247671,DSC 197,001,628532,Eldridge; Justin Matthew,9996,0,9999,3
1714210248698,EAP 100,A00,516065,Staff,9797,0,9999,202
1714210249725,ECE 45,A01,507414,Staff,33,0,60,27
1714210251778,ECE 111,A01,507420,Staff,21,0,50,29
1714210252803,ECE 197,001,548057,Sievenpiper; Daniel F.,9994,0,9999,5
1714210253830,EDS 115,A00,507243,Choi; Bailey Miyeon,12,0,28,16
1714210254858,EDS 117,A01,494379,Staff,0,1,30,30
1714210255888,EDS 125,A00,507246,Hopkins; Megan Beth,12,0,30,18
1714210256917,EDS 128A,A01,507264,Fargason; Sharon Gayle,14,0,26,12
1714210257947,EDS 128B,A01,507293,Pappas; Elizabeth,18,0,30,12
1714210258976,EDS 139,A00,507294,Fargason; Sharon Gayle,18,0,30,12
1714210258976,EDS 139,B00,507313,Pappas; Elizabeth,15,0,30,15
1714210260005,EDS 201,A00,507315,Staff,13,0,30,17
1714210261033,EDS 203,A01,507317,Halter; Christopher P.,12,0,30,18
1714210262058,EDS 204R,A01,507319,Halter; Christopher P.,0,3,30,30
1714210262058,EDS 204R,B01,507331,Heinzman; Erica M.,17,0,30,13
1714210263084,EDS 206R,A00,507332,Staff,0,4,30,30
1714210263084,EDS 206R,B00,507343,Staff,18,0,30,12
1714210264111,EDS 250,A00,507344,Hemans; Patricia Ann Benitez,22,0,40,18
1714210265137,EDS 281,A00,507345,Daly; Alan J.,18,0,18,0
1714210266160,EDS 284,A00,507350,Daly; Alan J.,16,0,16,0
1714210267187,EDS 286,A00,507359,Fine; Sarah,18,0,18,0
1714210268213,EDS 289C,A01,507361,Daly; Alan J.,18,0,18,0
1714210269241,EDS 290,A00,507366,Hofstetter; Carolyn,15,0,15,0
1714210270268,LIGM 5A,A00,507421,Fischer-Grunski; Eva K,18,0,20,2
1714210271293,LIGM 5B,A00,507423,Fischer-Grunski; Eva K,19,0,20,1
1714210272324,LIGM 5C,A00,507425,Fischer-Grunski; Eva K,19,0,20,1
1714210273354,LIIT 5AS,A00,507427,Carnelos; Chiara,20,0,20,0
1714210274384,LIIT 5BS,A00,507430,Carnelos; Chiara,20,0,20,0
1714210275408,LIIT 5CS,A00,507432,Carnelos; Chiara,20,0,20,0
1714210276441,LISP 5A,A00,507541,Munoz Sanchez; Alicia,11,0,20,9
1714210277466,LISP 5B,A00,507671,Munoz Sanchez; Alicia,9,0,20,11
1714210278497,LISP 5C,A00,507696,Munoz Sanchez; Alicia,9,0,20,11
1714210279524,MAE 197,001,528363,Boechler; Nicholas Sebastia,9998,0,9999,1
1714210280555,MATH 197,001,523477,Kedlaya; Kiran S.,9996,0,9999,3
1714210280555,MATH 197,002,563811,Zhang; Danna,9995,0,9999,4
1714210280555,MATH 197,003,628552,Dumitriu; Ioana,9998,0,9999,1
1714210281581,MCWP 40R,A00,518780,Staff,5,0,20,15
1714210281581,MCWP 40R,B00,518781,Staff,7,0,20,13
1714210281581,MCWP 40R,C00,518783,Staff,5,0,20,15
1714210282678,MCWP 50R,A00,518791,Staff,0,0,20,20
1714210282678,MCWP 50R,B00,518792,Staff,0,1,20,20
1714210282678,MCWP 50R,C00,518793,Staff,0,1,20,20
1714210282678,MCWP 50R,D00,518794,Staff,0,0,20,20
1714210282678,MCWP 50R,E00,518795,Staff,0,1,20,20
1714210282678,MCWP 50R,F00,518796,Staff,0,0,20,20
1714210282678,MCWP 50R,G00,518797,Staff,0,1,20,20
1714210283707,MMW 12R,A01,514034,Herbst; Matthew,0,1,16,16
1714210283707,MMW 12R,A02,514035,Herbst; Matthew,2,0,16,14
1714210284742,MMW 13R,A01,514037,Staff,0,4,16,16
1714210284742,MMW 13R,A02,514039,Staff,0,2,16,16
1714210284742,MMW 13R,A03,628519,Staff,0,2,16,16
1714210286798,SIO 295LS,A00,523233,Staff,13,0,30,17
1714210287825,SIO 295S,A00,523232,Staff,13,0,30,17
1714210288852,SIOC 290S,A01,637330,Merrifield; Mark A,28,0,30,2
1714210289882,SIOC 291S,A01,637333,Gabriel; Corey John,28,0,30,2
1714210290907,SOCI 117,A01,494376,Staff,0,2,5,5
1714210291932,WES 237B,A00,494380,Staff,9,0,20,11
1714210294004,AESE 279B,A00,494370,Wade; Jon P,0,0,33,33
1714210295029,AIP 197,001,627712,Vespa; Emanuel Ignacio,9998,0,9999,1
1714210296054,ANAR 135S,A00,494369,Braswell; Geoffrey E.,0,0,0,0
1714210297079,BENG 196,001,628496,Engler; Adam J.,9998,0,9999,1
1714210298109,CAT 124RS,A01,519847,Geibel; William,0,0,20,20
1714210299138,CAT 125RS,A01,515971,Geibel; William,0,0,20,20
1714210300164,CLRE 250,A00,511389,Morris; Sheldon,9993,0,9999,6
1714210301192,CLRE 251,A00,507176,Mehta; Ravindra L.,9993,0,9999,6
1714210301192,CLRE 251,B00,511410,Mehta; Ravindra L.,9998,0,9999,1
1714210302217,CLRE 252,A00,507189,Cuomo; Raphael Eduardo,9995,0,9999,4
1714210303243,CLRE 253,A00,507199,Vaida; Florin,9994,0,9999,5
1714210303243,CLRE 253,B00,507202,Vaida; Florin,9999,0,9999,0
1714210304268,CLRE 259,A00,507211,Patel; Hemal,9996,0,9999,3
1714210305294,CLRE 260,A00,507221,Cuomo; Raphael Eduardo,9999,0,9999,0
1714210306320,CLRE 297,001,507242,Cuomo; Raphael Eduardo,9999,0,9999,0
1714210307345,COGS 197,001,638244,Voytek; Bradley Thomas,9999,0,9999,0
1714210308369,CSE 191,A00,516875,Minnes Kemp; Mor Mia,9993,0,9999,6
1714210309395,CSE 197,001,637388,Minnes Kemp; Mor Mia,9998,0,9999,1
1714210310424,CSS 201S,A01,494383,Staff,35,0,35,0
1714210311450,CSS 202S,A01,494387,Staff,35,0,35,0
1714210312480,DSC 197,001,628532,Eldridge; Justin Matthew,9996,0,9999,3
1714210313507,EAP 100,A00,516065,Staff,9797,0,9999,202
1714210314536,ECE 45,A01,507414,Staff,33,0,60,27
1714210316588,ECE 111,A01,507420,Staff,21,0,50,29
1714210317618,ECE 197,001,548057,Sievenpiper; Daniel F.,9994,0,9999,5
1714210318646,EDS 115,A00,507243,Choi; Bailey Miyeon,12,0,28,16
1714210319673,EDS 117,A01,494379,Staff,0,1,30,30
1714210320699,EDS 125,A00,507246,Hopkins; Megan Beth,12,0,30,18
1714210321732,EDS 128A,A01,507264,Fargason; Sharon Gayle,14,0,26,12
1714210322756,EDS 128B,A01,507293,Pappas; Elizabeth,18,0,30,12
1714210323782,EDS 139,A00,507294,Fargason; Sharon Gayle,18,0,30,12
1714210323782,EDS 139,B00,507313,Pappas; Elizabeth,15,0,30,15
1714210324806,EDS 201,A00,507315,Staff,13,0,30,17
1714210325833,EDS 203,A01,507317,Halter; Christopher P.,12,0,30,18
1714210326860,EDS 204R,A01,507319,Halter; Christopher P.,0,3,30,30
1714210326860,EDS 204R,B01,507331,Heinzman; Erica M.,17,0,30,13
1714210327885,EDS 206R,A00,507332,Staff,0,4,30,30
1714210327885,EDS 206R,B00,507343,Staff,18,0,30,12
1714210328912,EDS 250,A00,507344,Hemans; Patricia Ann Benitez,22,0,40,18
1714210329939,EDS 281,A00,507345,Daly; Alan J.,18,0,18,0
1714210330964,EDS 284,A00,507350,Daly; Alan J.,16,0,16,0
1714210331994,EDS 286,A00,507359,Fine; Sarah,18,0,18,0
1714210333022,EDS 289C,A01,507361,Daly; Alan J.,18,0,18,0
1714210334049,EDS 290,A00,507366,Hofstetter; Carolyn,15,0,15,0
1714210335079,LIGM 5A,A00,507421,Fischer-Grunski; Eva K,18,0,20,2
1714210336110,LIGM 5B,A00,507423,Fischer-Grunski; Eva K,19,0,20,1
1714210337137,LIGM 5C,A00,507425,Fischer-Grunski; Eva K,19,0,20,1
1714210338167,LIIT 5AS,A00,507427,Carnelos; Chiara,20,0,20,0
1714210339191,LIIT 5BS,A00,507430,Carnelos; Chiara,20,0,20,0
1714210340218,LIIT 5CS,A00,507432,Carnelos; Chiara,20,0,20,0
1714210341244,LISP 5A,A00,507541,Munoz Sanchez; Alicia,11,0,20,9
1714210342274,LISP 5B,A00,507671,Munoz Sanchez; Alicia,9,0,20,11
1714210343300,LISP 5C,A00,507696,Munoz Sanchez; Alicia,9,0,20,11
1714210344325,MAE 197,001,528363,Boechler; Nicholas Sebastia,9998,0,9999,1
1714210345357,MATH 197,001,523477,Kedlaya; Kiran S.,9996,0,9999,3
1714210345357,MATH 197,002,563811,Zhang; Danna,9995,0,9999,4
1714210345357,MATH 197,003,628552,Dumitriu; Ioana,9998,0,9999,1
1714210346386,MCWP 40R,A00,518780,Staff,5,0,20,15
1714210346386,MCWP 40R,B00,518781,Staff,7,0,20,13
1714210346386,MCWP 40R,C00,518783,Staff,5,0,20,15
1714210347412,MCWP 50R,A00,518791,Staff,0,0,20,20
1714210347412,MCWP 50R,B00,518792,Staff,0,1,20,20
1714210347412,MCWP 50R,C00,518793,Staff,0,1,20,20
1714210347412,MCWP 50R,D00,518794,Staff,0,0,20,20
1714210347412,MCWP 50R,E00,518795,Staff,0,1,20,20
1714210347412,MCWP 50R,F00,518796,Staff,0,0,20,20
1714210347412,MCWP 50R,G00,518797,Staff,0,1,20,20
1714210348439,MMW 12R,A01,514034,Herbst; Matthew,0,1,16,16
1714210348439,MMW 12R,A02,514035,Herbst; Matthew,2,0,16,14
1714210349468,MMW 13R,A01,514037,Staff,0,4,16,16
1714210349468,MMW 13R,A02,514039,Staff,0,2,16,16
1714210349468,MMW 13R,A03,628519,Staff,0,2,16,16
1714210351523,SIO 295LS,A00,523233,Staff,13,0,30,17
1714210352548,SIO 295S,A00,523232,Staff,13,0,30,17
1714210353574,SIOC 290S,A01,637330,Merrifield; Mark A,28,0,30,2
1714210354601,SIOC 291S,A01,637333,Gabriel; Corey John,28,0,30,2
1714210355626,SOCI 117,A01,494376,Staff,0,2,5,5
1714210356655,WES 237B,A00,494380,Staff,9,0,20,11
1714210358725,AESE 279B,A00,494370,Wade; Jon P,0,0,33,33
1714210359752,AIP 197,001,627712,Vespa; Emanuel Ignacio,9998,0,9999,1
1714210360781,ANAR 135S,A00,494369,Braswell; Geoffrey E.,0,0,0,0
1714210361807,BENG 196,001,628496,Engler; Adam J.,9998,0,9999,1
1714210362833,CAT 124RS,A01,519847,Geibel; William,0,0,20,20
1714210363861,CAT 125RS,A01,515971,Geibel; William,0,0,20,20
1714210364886,CLRE 250,A00,511389,Morris; Sheldon,9993,0,9999,6
1714210365918,CLRE 251,A00,507176,Mehta; Ravindra L.,9993,0,9999,6
1714210365918,CLRE 251,B00,511410,Mehta; Ravindra L.,9998,0,9999,1
1714210366943,CLRE 252,A00,507189,Cuomo; Raphael Eduardo,9995,0,9999,4
1714210367975,CLRE 253,A00,507199,Vaida; Florin,9994,0,9999,5
1714210367975,CLRE 253,B00,507202,Vaida; Florin,9999,0,9999,0
1714210368999,CLRE 259,A00,507211,Patel; Hemal,9996,0,9999,3
1714210370025,CLRE 260,A00,507221,Cuomo; Raphael Eduardo,9999,0,9999,0
1714210371052,CLRE 297,001,507242,Cuomo; Raphael Eduardo,9999,0,9999,0
1714210372079,COGS 197,001,638244,Voytek; Bradley Thomas,9999,0,9999,0
1714210373105,CSE 191,A00,516875,Minnes Kemp; Mor Mia,9993,0,9999,6
1714210374128,CSE 197,001,637388,Minnes Kemp; Mor Mia,9998,0,9999,1
1714210375156,CSS 201S,A01,494383,Staff,35,0,35,0
1714210376185,CSS 202S,A01,494387,Staff,35,0,35,0
1714210377210,DSC 197,001,628532,Eldridge; Justin Matthew,9996,0,9999,3
1714210378239,EAP 100,A00,516065,Staff,9797,0,9999,202
1714210379266,ECE 45,A01,507414,Staff,33,0,60,27
1714210381318,ECE 111,A01,507420,Staff,21,0,50,29
1714210382350,ECE 197,001,548057,Sievenpiper; Daniel F.,9994,0,9999,5
1714210383381,EDS 115,A00,507243,Choi; Bailey Miyeon,12,0,28,16
1714210384406,EDS 117,A01,494379,Staff,0,1,30,30
1714210385431,EDS 125,A00,507246,Hopkins; Megan Beth,12,0,30,18
1714210386513,EDS 128A,A01,507264,Fargason; Sharon Gayle,14,0,26,12
1714210387539,EDS 128B,A01,507293,Pappas; Elizabeth,18,0,30,12
1714210388565,EDS 139,A00,507294,Fargason; Sharon Gayle,18,0,30,12
1714210388565,EDS 139,B00,507313,Pappas; Elizabeth,15,0,30,15
1714210389593,EDS 201,A00,507315,Staff,13,0,30,17
1714210390618,EDS 203,A01,507317,Halter; Christopher P.,12,0,30,18
1714210391648,EDS 204R,A01,507319,Halter; Christopher P.,0,3,30,30
1714210391648,EDS 204R,B01,507331,Heinzman; Erica M.,17,0,30,13
1714210392675,EDS 206R,A00,507332,Staff,0,4,30,30
1714210392675,EDS 206R,B00,507343,Staff,18,0,30,12
1714210393703,EDS 250,A00,507344,Hemans; Patricia Ann Benitez,22,0,40,18
1714210394729,EDS 281,A00,507345,Daly; Alan J.,18,0,18,0
1714210395753,EDS 284,A00,507350,Daly; Alan J.,16,0,16,0
1714210396781,EDS 286,A00,507359,Fine; Sarah,18,0,18,0
1714210397809,EDS 289C,A01,507361,Daly; Alan J.,18,0,18,0
1714210398837,EDS 290,A00,507366,Hofstetter; Carolyn,15,0,15,0
1714210399866,LIGM 5A,A00,507421,Fischer-Grunski; Eva K,18,0,20,2
1714210400895,LIGM 5B,A00,507423,Fischer-Grunski; Eva K,19,0,20,1
1714210401924,LIGM 5C,A00,507425,Fischer-Grunski; Eva K,19,0,20,1
1714210402948,LIIT 5AS,A00,507427,Carnelos; Chiara,20,0,20,0
1714210403971,LIIT 5BS,A00,507430,Carnelos; Chiara,20,0,20,0
1714210404997,LIIT 5CS,A00,507432,Carnelos; Chiara,20,0,20,0
1714210406026,LISP 5A,A00,507541,Munoz Sanchez; Alicia,11,0,20,9
1714210407053,LISP 5B,A00,507671,Munoz Sanchez; Alicia,9,0,20,11
1714210408080,LISP 5C,A00,507696,Munoz Sanchez; Alicia,9,0,20,11
1714210409107,MAE 197,001,528363,Boechler; Nicholas Sebastia,9998,0,9999,1
1714210410132,MATH 197,001,523477,Kedlaya; Kiran S.,9996,0,9999,3
1714210410132,MATH 197,002,563811,Zhang; Danna,9995,0,9999,4
1714210410132,MATH 197,003,628552,Dumitriu; Ioana,9998,0,9999,1
1714210411160,MCWP 40R,A00,518780,Staff,5,0,20,15
1714210411160,MCWP 40R,B00,518781,Staff,7,0,20,13
1714210411160,MCWP 40R,C00,518783,Staff,5,0,20,15
1714210412189,MCWP 50R,A00,518791,Staff,0,0,20,20
1714210412189,MCWP 50R,B00,518792,Staff,0,1,20,20
1714210412189,MCWP 50R,C00,518793,Staff,0,1,20,20
1714210412189,MCWP 50R,D00,518794,Staff,0,0,20,20
1714210412189,MCWP 50R,E00,518795,Staff,0,1,20,20
1714210412189,MCWP 50R,F00,518796,Staff,0,0,20,20
1714210412189,MCWP 50R,G00,518797,Staff,0,1,20,20
1714210413215,MMW 12R,A01,514034,Herbst; Matthew,0,1,16,16
1714210413215,MMW 12R,A02,514035,Herbst; Matthew,2,0,16,14
1714210414241,MMW 13R,A01,514037,Staff,0,4,16,16
1714210414241,MMW 13R,A02,514039,Staff,0,2,16,16
1714210414241,MMW 13R,A03,628519,Staff,0,2,16,16
1714210416293,SIO 295LS,A00,523233,Staff,13,0,30,17
1714210417318,SIO 295S,A00,523232,Staff,13,0,30,17
1714210418344,SIOC 290S,A01,637330,Merrifield; Mark A,28,0,30,2
1714210419369,SIOC 291S,A01,637333,Gabriel; Corey John,28,0,30,2
1714210420396,SOCI 117,A01,494376,Staff,0,2,5,5
1714210421421,WES 237B,A00,494380,Staff,9,0,20,11
1714210423502,AESE 279B,A00,494370,Wade; Jon P,0,0,33,33
1714210424529,AIP 197,001,627712,Vespa; Emanuel Ignacio,9998,0,9999,1
1714210425554,ANAR 135S,A00,494369,Braswell; Geoffrey E.,0,0,0,0
1714210426579,BENG 196,001,628496,Engler; Adam J.,9998,0,9999,1
1714210427606,CAT 124RS,A01,519847,Geibel; William,0,0,20,20
1714210428630,CAT 125RS,A01,515971,Geibel; William,0,0,20,20
1714210429657,CLRE 250,A00,511389,Morris; Sheldon,9993,0,9999,6
1714210430685,CLRE 251,A00,507176,Mehta; Ravindra L.,9993,0,9999,6
1714210430685,CLRE 251,B00,511410,Mehta; Ravindra L.,9998,0,9999,1
1714210431712,CLRE 252,A00,507189,Cuomo; Raphael Eduardo,9995,0,9999,4
1714210432737,CLRE 253,A00,507199,Vaida; Florin,9994,0,9999,5
1714210432737,CLRE 253,B00,507202,Vaida; Florin,9999,0,9999,0
1714210433763,CLRE 259,A00,507211,Patel; Hemal,9996,0,9999,3
1714210434789,CLRE 260,A00,507221,Cuomo; Raphael Eduardo,9999,0,9999,0
1714210435815,CLRE 297,001,507242,Cuomo; Raphael Eduardo,9999,0,9999,0
1714210436843,COGS 197,001,638244,Voytek; Bradley Thomas,9999,0,9999,0
1714210437870,CSE 191,A00,516875,Minnes Kemp; Mor Mia,9993,0,9999,6
1714210438895,CSE 197,001,637388,Minnes Kemp; Mor Mia,9998,0,9999,1
1714210439923,CSS 201S,A01,494383,Staff,35,0,35,0
1714210440949,CSS 202S,A01,494387,Staff,35,0,35,0
1714210441976,DSC 197,001,628532,Eldridge; Justin Matthew,9996,0,9999,3
1714210443000,EAP 100,A00,516065,Staff,9797,0,9999,202
1714210444025,ECE 45,A01,507414,Staff,33,0,60,27
1714210446075,ECE 111,A01,507420,Staff,21,0,50,29
1714210447104,ECE 197,001,548057,Sievenpiper; Daniel F.,9994,0,9999,5
1714210448132,EDS 115,A00,507243,Choi; Bailey Miyeon,12,0,28,16
1714210449162,EDS 117,A01,494379,Staff,0,1,30,30
1714210450188,EDS 125,A00,507246,Hopkins; Megan Beth,12,0,30,18
1714210451218,EDS 128A,A01,507264,Fargason; Sharon Gayle,14,0,26,12
1714210452247,EDS 128B,A01,507293,Pappas; Elizabeth,18,0,30,12
1714210453274,EDS 139,A00,507294,Fargason; Sharon Gayle,18,0,30,12
1714210453274,EDS 139,B00,507313,Pappas; Elizabeth,15,0,30,15
1714210454300,EDS 201,A00,507315,Staff,13,0,30,17
1714210455328,EDS 203,A01,507317,Halter; Christopher P.,12,0,30,18
1714210456355,EDS 204R,A01,507319,Halter; Christopher P.,0,3,30,30
1714210456355,EDS 204R,B01,507331,Heinzman; Erica M.,17,0,30,13
1714210457381,EDS 206R,A00,507332,Staff,0,4,30,30
1714210457381,EDS 206R,B00,507343,Staff,18,0,30,12
1714210458411,EDS 250,A00,507344,Hemans; Patricia Ann Benitez,22,0,40,18
1714210459441,EDS 281,A00,507345,Daly; Alan J.,18,0,18,0
1714210460472,EDS 284,A00,507350,Daly; Alan J.,16,0,16,0
1714210461496,EDS 286,A00,507359,Fine; Sarah,18,0,18,0
1714210462525,EDS 289C,A01,507361,Daly; Alan J.,18,0,18,0
1714210463554,EDS 290,A00,507366,Hofstetter; Carolyn,15,0,15,0
1714210464580,LIGM 5A,A00,507421,Fischer-Grunski; Eva K,18,0,20,2
1714210465606,LIGM 5B,A00,507423,Fischer-Grunski; Eva K,19,0,20,1
1714210466630,LIGM 5C,A00,507425,Fischer-Grunski; Eva K,19,0,20,1
1714210467657,LIIT 5AS,A00,507427,Carnelos; Chiara,20,0,20,0
1714210468687,LIIT 5BS,A00,507430,Carnelos; Chiara,20,0,20,0
1714210469712,LIIT 5CS,A00,507432,Carnelos; Chiara,20,0,20,0
1714210470741,LISP 5A,A00,507541,Munoz Sanchez; Alicia,11,0,20,9
1714210471772,LISP 5B,A00,507671,Munoz Sanchez; Alicia,9,0,20,11
1714210472798,LISP 5C,A00,507696,Munoz Sanchez; Alicia,9,0,20,11
1714210473827,MAE 197,001,528363,Boechler; Nicholas Sebastia,9998,0,9999,1
1714210474853,MATH 197,001,523477,Kedlaya; Kiran S.,9996,0,9999,3
1714210474853,MATH 197,002,563811,Zhang; Danna,9995,0,9999,4
1714210474853,MATH 197,003,628552,Dumitriu; Ioana,9998,0,9999,1
1714210475880,MCWP 40R,A00,518780,Staff,5,0,20,15
1714210475880,MCWP 40R,B00,518781,Staff,7,0,20,13
1714210475880,MCWP 40R,C00,518783,Staff,5,0,20,15
1714210476910,MCWP 50R,A00,518791,Staff,0,0,20,20
1714210476910,MCWP 50R,B00,518792,Staff,0,1,20,20
1714210476910,MCWP 50R,C00,518793,Staff,0,1,20,20
1714210476910,MCWP 50R,D00,518794,Staff,0,0,20,20
1714210476910,MCWP 50R,E00,518795,Staff,0,1,20,20
1714210476910,MCWP 50R,F00,518796,Staff,0,0,20,20
1714210476910,MCWP 50R,G00,518797,Staff,0,1,20,20
1714210477936,MMW 12R,A01,514034,Herbst; Matthew,0,1,16,16
1714210477936,MMW 12R,A02,514035,Herbst; Matthew,2,0,16,14
1714210478962,MMW 13R,A01,514037,Staff,0,4,16,16
1714210478962,MMW 13R,A02,514039,Staff,0,2,16,16
1714210478962,MMW 13R,A03,628519,Staff,0,2,16,16
1714210481013,SIO 295LS,A00,523233,Staff,13,0,30,17
1714210482037,SIO 295S,A00,523232,Staff,13,0,30,17
1714210483070,SIOC 290S,A01,637330,Merrifield; Mark A,28,0,30,2
1714210484100,SIOC 291S,A01,637333,Gabriel; Corey John,28,0,30,2
1714210485124,SOCI 117,A01,494376,Staff,0,2,5,5
1714210486153,WES 237B,A00,494380,Staff,9,0,20,11
1714210488231,AESE 279B,A00,494370,Wade; Jon P,0,0,33,33
1714210489261,AIP 197,001,627712,Vespa; Emanuel Ignacio,9998,0,9999,1
1714210490341,ANAR 135S,A00,494369,Braswell; Geoffrey E.,0,0,0,0
1714210491370,BENG 196,001,628496,Engler; Adam J.,9998,0,9999,1
1714210492396,CAT 124RS,A01,519847,Geibel; William,0,0,20,20
1714210493424,CAT 125RS,A01,515971,Geibel; William,0,0,20,20
1714210494450,CLRE 250,A00,511389,Morris; Sheldon,9993,0,9999,6
1714210495476,CLRE 251,A00,507176,Mehta; Ravindra L.,9993,0,9999,6
1714210495476,CLRE 251,B00,511410,Mehta; Ravindra L.,9998,0,9999,1
1714210496504,CLRE 252,A00,507189,Cuomo; Raphael Eduardo,9995,0,9999,4
1714210497530,CLRE 253,A00,507199,Vaida; Florin,9994,0,9999,5
1714210497530,CLRE 253,B00,507202,Vaida; Florin,9999,0,9999,0
1714210498556,CLRE 259,A00,507211,Patel; Hemal,9996,0,9999,3
1714210499581,CLRE 260,A00,507221,Cuomo; Raphael Eduardo,9999,0,9999,0
1714210500609,CLRE 297,001,507242,Cuomo; Raphael Eduardo,9999,0,9999,0
1714210501634,COGS 197,001,638244,Voytek; Bradley Thomas,9999,0,9999,0
1714210502659,CSE 191,A00,516875,Minnes Kemp; Mor Mia,9993,0,9999,6
1714210503688,CSE 197,001,637388,Minnes Kemp; Mor Mia,9998,0,9999,1
1714210504717,CSS 201S,A01,494383,Staff,35,0,35,0
1714210505745,CSS 202S,A01,494387,Staff,35,0,35,0
1714210506769,DSC 197,001,628532,Eldridge; Justin Matthew,9996,0,9999,3
1714210507792,EAP 100,A00,516065,Staff,9797,0,9999,202
1714210508823,ECE 45,A01,507414,Staff,33,0,60,27
1714210510874,ECE 111,A01,507420,Staff,21,0,50,29
1714210511903,ECE 197,001,548057,Sievenpiper; Daniel F.,9994,0,9999,5
1714210512930,EDS 115,A00,507243,Choi; Bailey Miyeon,12,0,28,16
1714210513959,EDS 117,A01,494379,Staff,0,1,30,30
1714210514985,EDS 125,A00,507246,Hopkins; Megan Beth,12,0,30,18
1714210516010,EDS 128A,A01,507264,Fargason; Sharon Gayle,14,0,26,12
1714210517035,EDS 128B,A01,507293,Pappas; Elizabeth,18,0,30,12
1714210518061,EDS 139,A00,507294,Fargason; Sharon Gayle,18,0,30,12
1714210518061,EDS 139,B00,507313,Pappas; Elizabeth,15,0,30,15
1714210519089,EDS 201,A00,507315,Staff,13,0,30,17
1714210520117,EDS 203,A01,507317,Halter; Christopher P.,12,0,30,18
1714210521141,EDS 204R,A01,507319,Halter; Christopher P.,0,3,30,30
1714210521141,EDS 204R,B01,507331,Heinzman; Erica M.,17,0,30,13
1714210522169,EDS 206R,A00,507332,Staff,0,4,30,30
1714210522169,EDS 206R,B00,507343,Staff,18,0,30,12
1714210523195,EDS 250,A00,507344,Hemans; Patricia Ann Benitez,22,0,40,18
1714210524221,EDS 281,A00,507345,Daly; Alan J.,18,0,18,0
1714210525247,EDS 284,A00,507350,Daly; Alan J.,16,0,16,0
1714210526273,EDS 286,A00,507359,Fine; Sarah,18,0,18,0
1714210527297,EDS 289C,A01,507361,Daly; Alan J.,18,0,18,0
1714210528323,EDS 290,A00,507366,Hofstetter; Carolyn,15,0,15,0
1714210529353,LIGM 5A,A00,507421,Fischer-Grunski; Eva K,18,0,20,2
1714210530379,LIGM 5B,A00,507423,Fischer-Grunski; Eva K,19,0,20,1
1714210531409,LIGM 5C,A00,507425,Fischer-Grunski; Eva K,19,0,20,1
1714210532435,LIIT 5AS,A00,507427,Carnelos; Chiara,20,0,20,0
1714210533460,LIIT 5BS,A00,507430,Carnelos; Chiara,20,0,20,0
1714210534489,LIIT 5CS,A00,507432,Carnelos; Chiara,20,0,20,0
1714210535515,LISP 5A,A00,507541,Munoz Sanchez; Alicia,11,0,20,9
1714210536541,LISP 5B,A00,507671,Munoz Sanchez; Alicia,9,0,20,11
1714210537571,LISP 5C,A00,507696,Munoz Sanchez; Alicia,9,0,20,11
1714210538601,MAE 197,001,528363,Boechler; Nicholas Sebastia,9998,0,9999,1
1714210539630,MATH 197,001,523477,Kedlaya; Kiran S.,9996,0,9999,3
1714210539630,MATH 197,002,563811,Zhang; Danna,9995,0,9999,4
1714210539630,MATH 197,003,628552,Dumitriu; Ioana,9998,0,9999,1
1714210540656,MCWP 40R,A00,518780,Staff,5,0,20,15
1714210540656,MCWP 40R,B00,518781,Staff,7,0,20,13
1714210540656,MCWP 40R,C00,518783,Staff,5,0,20,15
1714210541683,MCWP 50R,A00,518791,Staff,0,0,20,20
1714210541683,MCWP 50R,B00,518792,Staff,0,1,20,20
1714210541683,MCWP 50R,C00,518793,Staff,0,1,20,20
1714210541683,MCWP 50R,D00,518794,Staff,0,0,20,20
1714210541683,MCWP 50R,E00,518795,Staff,0,1,20,20
1714210541683,MCWP 50R,F00,518796,Staff,0,0,20,20
1714210541683,MCWP 50R,G00,518797,Staff,0,1,20,20
1714210542713,MMW 12R,A01,514034,Herbst; Matthew,0,1,16,16
1714210542713,MMW 12R,A02,514035,Herbst; Matthew,2,0,16,14
1714210543744,MMW 13R,A01,514037,Staff,0,4,16,16
1714210543744,MMW 13R,A02,514039,Staff,0,2,16,16
1714210543744,MMW 13R,A03,628519,Staff,0,2,16,16
1714210545793,SIO 295LS,A00,523233,Staff,13,0,30,17
1714210546819,SIO 295S,A00,523232,Staff,13,0,30,17
1714210547848,SIOC 290S,A01,637330,Merrifield; Mark A,28,0,30,2
1714210548873,SIOC 291S,A01,637333,Gabriel; Corey John,28,0,30,2
1714210549898,SOCI 117,A01,494376,Staff,0,2,5,5
1714210550927,WES 237B,A00,494380,Staff,9,0,20,11
1714210553005,AESE 279B,A00,494370,Wade; Jon P,0,0,33,33
1714210554031,AIP 197,001,627712,Vespa; Emanuel Ignacio,9998,0,9999,1
1714210555059,ANAR 135S,A00,494369,Braswell; Geoffrey E.,0,0,0,0
1714210556088,BENG 196,001,628496,Engler; Adam J.,9998,0,9999,1
1714210557114,CAT 124RS,A01,519847,Geibel; William,0,0,20,20
1714210558140,CAT 125RS,A01,515971,Geibel; William,0,0,20,20
1714210559169,CLRE 250,A00,511389,Morris; Sheldon,9993,0,9999,6
1714210560200,CLRE 251,A00,507176,Mehta; Ravindra L.,9993,0,9999,6
1714210560200,CLRE 251,B00,511410,Mehta; Ravindra L.,9998,0,9999,1
1714210561227,CLRE 252,A00,507189,Cuomo; Raphael Eduardo,9995,0,9999,4
1714210562256,CLRE 253,A00,507199,Vaida; Florin,9994,0,9999,5
1714210562256,CLRE 253,B00,507202,Vaida; Florin,9999,0,9999,0
1714210563280,CLRE 259,A00,507211,Patel; Hemal,9996,0,9999,3
1714210564309,CLRE 260,A00,507221,Cuomo; Raphael Eduardo,9999,0,9999,0
1714210565334,CLRE 297,001,507242,Cuomo; Raphael Eduardo,9999,0,9999,0
1714210566360,COGS 197,001,638244,Voytek; Bradley Thomas,9999,0,9999,0
1714210567387,CSE 191,A00,516875,Minnes Kemp; Mor Mia,9993,0,9999,6
1714210568417,CSE 197,001,637388,Minnes Kemp; Mor Mia,9998,0,9999,1
1714210569445,CSS 201S,A01,494383,Staff,35,0,35,0
1714210570474,CSS 202S,A01,494387,Staff,35,0,35,0
1714210571501,DSC 197,001,628532,Eldridge; Justin Matthew,9996,0,9999,3
1714210572527,EAP 100,A00,516065,Staff,9797,0,9999,202
1714210573554,ECE 45,A01,507414,Staff,33,0,60,27
1714210575609,ECE 111,A01,507420,Staff,21,0,50,29
1714210576634,ECE 197,001,548057,Sievenpiper; Daniel F.,9994,0,9999,5
1714210577662,EDS 115,A00,507243,Choi; Bailey Miyeon,12,0,28,16
1714210578689,EDS 117,A01,494379,Staff,0,1,30,30
1714210579714,EDS 125,A00,507246,Hopkins; Megan Beth,12,0,30,18
1714210580744,EDS 128A,A01,507264,Fargason; Sharon Gayle,14,0,26,12
1714210581769,EDS 128B,A01,507293,Pappas; Elizabeth,18,0,30,12
1714210582797,EDS 139,A00,507294,Fargason; Sharon Gayle,18,0,30,12
1714210582797,EDS 139,B00,507313,Pappas; Elizabeth,15,0,30,15
1714210583824,EDS 201,A00,507315,Staff,13,0,30,17
1714210584850,EDS 203,A01,507317,Halter; Christopher P.,12,0,30,18
1714210585878,EDS 204R,A01,507319,Halter; Christopher P.,0,3,30,30
1714210585878,EDS 204R,B01,507331,Heinzman; Erica M.,17,0,30,13
1714210586902,EDS 206R,A00,507332,Staff,0,4,30,30
1714210586902,EDS 206R,B00,507343,Staff,18,0,30,12
1714210587930,EDS 250,A00,507344,Hemans; Patricia Ann Benitez,22,0,40,18
1714210588954,EDS 281,A00,507345,Daly; Alan J.,18,0,18,0
1714210589979,EDS 284,A00,507350,Daly; Alan J.,16,0,16,0
1714210591007,EDS 286,A00,507359,Fine; Sarah,18,0,18,0
1714210592035,EDS 289C,A01,507361,Daly; Alan J.,18,0,18,0
1714210593059,EDS 290,A00,507366,Hofstetter; Carolyn,15,0,15,0
1714210594142,LIGM 5A,A00,507421,Fischer-Grunski; Eva K,18,0,20,2
1714210595171,LIGM 5B,A00,507423,Fischer-Grunski; Eva K,19,0,20,1
1714210596197,LIGM 5C,A00,507425,Fischer-Grunski; Eva K,19,0,20,1
1714210597225,LIIT 5AS,A00,507427,Carnelos; Chiara,20,0,20,0
1714210598251,LIIT 5BS,A00,507430,Carnelos; Chiara,20,0,20,0
1714210599276,LIIT 5CS,A00,507432,Carnelos; Chiara,20,0,20,0
1714210600306,LISP 5A,A00,507541,Munoz Sanchez; Alicia,11,0,20,9
1714210601336,LISP 5B,A00,507671,Munoz Sanchez; Alicia,9,0,20,11
1714210602362,LISP 5C,A00,507696,Munoz Sanchez; Alicia,9,0,20,11
1714210603390,MAE 197,001,528363,Boechler; Nicholas Sebastia,9998,0,9999,1
1714210604415,MATH 197,001,523477,Kedlaya; Kiran S.,9996,0,9999,3
1714210604415,MATH 197,002,563811,Zhang; Danna,9995,0,9999,4
1714210604415,MATH 197,003,628552,Dumitriu; Ioana,9998,0,9999,1
1714210605439,MCWP 40R,A00,518780,Staff,5,0,20,15
1714210605439,MCWP 40R,B00,518781,Staff,7,0,20,13
1714210605439,MCWP 40R,C00,518783,Staff,5,0,20,15
1714210606465,MCWP 50R,A00,518791,Staff,0,0,20,20
1714210606465,MCWP 50R,B00,518792,Staff,0,1,20,20
1714210606465,MCWP 50R,C00,518793,Staff,0,1,20,20
1714210606465,MCWP 50R,D00,518794,Staff,0,0,20,20
1714210606465,MCWP 50R,E00,518795,Staff,0,1,20,20
1714210606465,MCWP 50R,F00,518796,Staff,0,0,20,20
1714210606465,MCWP 50R,G00,518797,Staff,0,1,20,20
1714210607493,MMW 12R,A01,514034,Herbst; Matthew,0,1,16,16
1714210607493,MMW 12R,A02,514035,Herbst; Matthew,2,0,16,14
1714210608519,MMW 13R,A01,514037,Staff,0,4,16,16
1714210608519,MMW 13R,A02,514039,Staff,0,2,16,16
1714210608519,MMW 13R,A03,628519,Staff,0,2,16,16
1714210610573,SIO 295LS,A00,523233,Staff,13,0,30,17
1714210611598,SIO 295S,A00,523232,Staff,13,0,30,17
1714210612629,SIOC 290S,A01,637330,Merrifield; Mark A,28,0,30,2
1714210613660,SIOC 291S,A01,637333,Gabriel; Corey John,28,0,30,2
1714210614686,SOCI 117,A01,494376,Staff,0,2,5,5
1714210615712,WES 237B,A00,494380,Staff,9,0,20,11
1714210617792,AESE 279B,A00,494370,Wade; Jon P,0,0,33,33
1714210618818,AIP 197,001,627712,Vespa; Emanuel Ignacio,9998,0,9999,1
1714210619843,ANAR 135S,A00,494369,Braswell; Geoffrey E.,0,0,0,0
1714210620869,BENG 196,001,628496,Engler; Adam J.,9998,0,9999,1
1714210621895,CAT 124RS,A01,519847,Geibel; William,0,0,20,20
1714210622920,CAT 125RS,A01,515971,Geibel; William,0,0,20,20
1714210623949,CLRE 250,A00,511389,Morris; Sheldon,9993,0,9999,6
1714210624977,CLRE 251,A00,507176,Mehta; Ravindra L.,9993,0,9999,6
1714210624977,CLRE 251,B00,511410,Mehta; Ravindra L.,9998,0,9999,1
1714210626002,CLRE 252,A00,507189,Cuomo; Raphael Eduardo,9995,0,9999,4
1714210627029,CLRE 253,A00,507199,Vaida; Florin,9994,0,9999,5
1714210627029,CLRE 253,B00,507202,Vaida; Florin,9999,0,9999,0
1714210628058,CLRE 259,A00,507211,Patel; Hemal,9996,0,9999,3
1714210629083,CLRE 260,A00,507221,Cuomo; Raphael Eduardo,9999,0,9999,0
1714210630109,CLRE 297,001,507242,Cuomo; Raphael Eduardo,9999,0,9999,0
1714210631140,COGS 197,001,638244,Voytek; Bradley Thomas,9999,0,9999,0
1714210632168,CSE 191,A00,516875,Minnes Kemp; Mor Mia,9993,0,9999,6
1714210633196,CSE 197,001,637388,Minnes Kemp; Mor Mia,9998,0,9999,1
1714210634226,CSS 201S,A01,494383,Staff,35,0,35,0
1714210635252,CSS 202S,A01,494387,Staff,35,0,35,0
1714210636299,DSC 197,001,628532,Eldridge; Justin Matthew,9996,0,9999,3
1714210637327,EAP 100,A00,516065,Staff,9797,0,9999,202
1714210638355,ECE 45,A01,507414,Staff,33,0,60,27
1714210640406,ECE 111,A01,507420,Staff,21,0,50,29
1714210641436,ECE 197,001,548057,Sievenpiper; Daniel F.,9994,0,9999,5
1714210642466,EDS 115,A00,507243,Choi; Bailey Miyeon,12,0,28,16
1714210643496,EDS 117,A01,494379,Staff,0,1,30,30
1714210644521,EDS 125,A00,507246,Hopkins; Megan Beth,12,0,30,18
1714210645551,EDS 128A,A01,507264,Fargason; Sharon Gayle,14,0,26,12
1714210646577,EDS 128B,A01,507293,Pappas; Elizabeth,18,0,30,12
1714210647605,EDS 139,A00,507294,Fargason; Sharon Gayle,18,0,30,12
1714210647605,EDS 139,B00,507313,Pappas; Elizabeth,15,0,30,15
1714210648633,EDS 201,A00,507315,Staff,13,0,30,17
1714210649660,EDS 203,A01,507317,Halter; Christopher P.,12,0,30,18
1714210650690,EDS 204R,A01,507319,Halter; Christopher P.,0,3,30,30
1714210650690,EDS 204R,B01,507331,Heinzman; Erica M.,17,0,30,13
1714210651719,EDS 206R,A00,507332,Staff,0,4,30,30
1714210651719,EDS 206R,B00,507343,Staff,18,0,30,12
1714210652745,EDS 250,A00,507344,Hemans; Patricia Ann Benitez,22,0,40,18
1714210653771,EDS 281,A00,507345,Daly; Alan J.,18,0,18,0
1714210654797,EDS 284,A00,507350,Daly; Alan J.,16,0,16,0
1714210655823,EDS 286,A00,507359,Fine; Sarah,18,0,18,0
1714210656849,EDS 289C,A01,507361,Daly; Alan J.,18,0,18,0
1714210657878,EDS 290,A00,507366,Hofstetter; Carolyn,15,0,15,0
1714210658905,LIGM 5A,A00,507421,Fischer-Grunski; Eva K,18,0,20,2
1714210659930,LIGM 5B,A00,507423,Fischer-Grunski; Eva K,19,0,20,1
1714210660956,LIGM 5C,A00,507425,Fischer-Grunski; Eva K,19,0,20,1
1714210661986,LIIT 5AS,A00,507427,Carnelos; Chiara,20,0,20,0
1714210663014,LIIT 5BS,A00,507430,Carnelos; Chiara,20,0,20,0
1714210664043,LIIT 5CS,A00,507432,Carnelos; Chiara,20,0,20,0
1714210665068,LISP 5A,A00,507541,Munoz Sanchez; Alicia,11,0,20,9
1714210666097,LISP 5B,A00,507671,Munoz Sanchez; Alicia,9,0,20,11
1714210667125,LISP 5C,A00,507696,Munoz Sanchez; Alicia,9,0,20,11
1714210668150,MAE 197,001,528363,Boechler; Nicholas Sebastia,9998,0,9999,1
1714210669178,MATH 197,001,523477,Kedlaya; Kiran S.,9996,0,9999,3
1714210669178,MATH 197,002,563811,Zhang; Danna,9995,0,9999,4
1714210669178,MATH 197,003,628552,Dumitriu; Ioana,9998,0,9999,1
1714210670206,MCWP 40R,A00,518780,Staff,5,0,20,15
1714210670206,MCWP 40R,B00,518781,Staff,7,0,20,13
1714210670206,MCWP 40R,C00,518783,Staff,5,0,20,15
1714210671232,MCWP 50R,A00,518791,Staff,0,0,20,20
1714210671232,MCWP 50R,B00,518792,Staff,0,1,20,20
1714210671232,MCWP 50R,C00,518793,Staff,0,1,20,20
1714210671232,MCWP 50R,D00,518794,Staff,0,0,20,20
1714210671232,MCWP 50R,E00,518795,Staff,0,1,20,20
1714210671232,MCWP 50R,F00,518796,Staff,0,0,20,20
1714210671232,MCWP 50R,G00,518797,Staff,0,1,20,20
1714210672260,MMW 12R,A01,514034,Herbst; Matthew,0,1,16,16
1714210672260,MMW 12R,A02,514035,Herbst; Matthew,2,0,16,14
1714210673285,MMW 13R,A01,514037,Staff,0,4,16,16
1714210673285,MMW 13R,A02,514039,Staff,0,2,16,16
1714210673285,MMW 13R,A03,628519,Staff,0,2,16,16
1714210675334,SIO 295LS,A00,523233,Staff,13,0,30,17
1714210676359,SIO 295S,A00,523232,Staff,13,0,30,17
1714210677385,SIOC 290S,A01,637330,Merrifield; Mark A,28,0,30,2
1714210678411,SIOC 291S,A01,637333,Gabriel; Corey John,28,0,30,2
1714210679437,SOCI 117,A01,494376,Staff,0,2,5,5
1714210680462,WES 237B,A00,494380,Staff,9,0,20,11
1714210682550,AESE 279B,A00,494370,Wade; Jon P,0,0,33,33
1714210683578,AIP 197,001,627712,Vespa; Emanuel Ignacio,9998,0,9999,1
1714210684607,ANAR 135S,A00,494369,Braswell; Geoffrey E.,0,0,0,0
1714210685632,BENG 196,001,628496,Engler; Adam J.,9998,0,9999,1
1714210686658,CAT 124RS,A01,519847,Geibel; William,0,0,20,20
1714210687686,CAT 125RS,A01,515971,Geibel; William,0,0,20,20
1714210688713,CLRE 250,A00,511389,Morris; Sheldon,9993,0,9999,6
1714210689740,CLRE 251,A00,507176,Mehta; Ravindra L.,9993,0,9999,6
1714210689740,CLRE 251,B00,511410,Mehta; Ravindra L.,9998,0,9999,1
1714210690768,CLRE 252,A00,507189,Cuomo; Raphael Eduardo,9995,0,9999,4
1714210691797,CLRE 253,A00,507199,Vaida; Florin,9994,0,9999,5
1714210691797,CLRE 253,B00,507202,Vaida; Florin,9999,0,9999,0
1714210692825,CLRE 259,A00,507211,Patel; Hemal,9996,0,9999,3
1714210693854,CLRE 260,A00,507221,Cuomo; Raphael Eduardo,9999,0,9999,0
1714210694882,CLRE 297,001,507242,Cuomo; Raphael Eduardo,9999,0,9999,0
1714210695908,COGS 197,001,638244,Voytek; Bradley Thomas,9999,0,9999,0
1714210696935,CSE 191,A00,516875,Minnes Kemp; Mor Mia,9993,0,9999,6
1714210698015,CSE 197,001,637388,Minnes Kemp; Mor Mia,9998,0,9999,1
1714210699044,CSS 201S,A01,494383,Staff,35,0,35,0
1714210700068,CSS 202S,A01,494387,Staff,35,0,35,0
1714210701094,DSC 197,001,628532,Eldridge; Justin Matthew,9996,0,9999,3
1714210702121,EAP 100,A00,516065,Staff,9797,0,9999,202
1714210703148,ECE 45,A01,507414,Staff,33,0,60,27
1714210705201,ECE 111,A01,507420,Staff,21,0,50,29
1714210706226,ECE 197,001,548057,Sievenpiper; Daniel F.,9994,0,9999,5
1714210707254,EDS 115,A00,507243,Choi; Bailey Miyeon,12,0,28,16
1714210708282,EDS 117,A01,494379,Staff,0,1,30,30
1714210709309,EDS 125,A00,507246,Hopkins; Megan Beth,12,0,30,18
1714210710335,EDS 128A,A01,507264,Fargason; Sharon Gayle,14,0,26,12
1714210711362,EDS 128B,A01,507293,Pappas; Elizabeth,18,0,30,12
1714210712389,EDS 139,A00,507294,Fargason; Sharon Gayle,18,0,30,12
1714210712389,EDS 139,B00,507313,Pappas; Elizabeth,15,0,30,15
1714210713414,EDS 201,A00,507315,Staff,13,0,30,17
1714210714439,EDS 203,A01,507317,Halter; Christopher P.,12,0,30,18
1714210715468,EDS 204R,A01,507319,Halter; Christopher P.,0,3,30,30
1714210715468,EDS 204R,B01,507331,Heinzman; Erica M.,17,0,30,13
1714210716493,EDS 206R,A00,507332,Staff,0,4,30,30
1714210716493,EDS 206R,B00,507343,Staff,18,0,30,12
1714210717518,EDS 250,A00,507344,Hemans; Patricia Ann Benitez,22,0,40,18
1714210718542,EDS 281,A00,507345,Daly; Alan J.,18,0,18,0
1714210719569,EDS 284,A00,507350,Daly; Alan J.,16,0,16,0
1714210720594,EDS 286,A00,507359,Fine; Sarah,18,0,18,0
1714210721621,EDS 289C,A01,507361,Daly; Alan J.,18,0,18,0
1714210722646,EDS 290,A00,507366,Hofstetter; Carolyn,15,0,15,0
1714210723671,LIGM 5A,A00,507421,Fischer-Grunski; Eva K,18,0,20,2
1714210724698,LIGM 5B,A00,507423,Fischer-Grunski; Eva K,19,0,20,1
1714210725726,LIGM 5C,A00,507425,Fischer-Grunski; Eva K,19,0,20,1
1714210726757,LIIT 5AS,A00,507427,Carnelos; Chiara,20,0,20,0
1714210727783,LIIT 5BS,A00,507430,Carnelos; Chiara,20,0,20,0
1714210728808,LIIT 5CS,A00,507432,Carnelos; Chiara,20,0,20,0
1714210729834,LISP 5A,A00,507541,Munoz Sanchez; Alicia,11,0,20,9
1714210730860,LISP 5B,A00,507671,Munoz Sanchez; Alicia,9,0,20,11
1714210731886,LISP 5C,A00,507696,Munoz Sanchez; Alicia,9,0,20,11
1714210732914,MAE 197,001,528363,Boechler; Nicholas Sebastia,9998,0,9999,1
1714210733943,MATH 197,001,523477,Kedlaya; Kiran S.,9996,0,9999,3
1714210733943,MATH 197,002,563811,Zhang; Danna,9995,0,9999,4
1714210733943,MATH 197,003,628552,Dumitriu; Ioana,9998,0,9999,1
1714210734975,MCWP 40R,A00,518780,Staff,5,0,20,15
1714210734975,MCWP 40R,B00,518781,Staff,7,0,20,13
1714210734975,MCWP 40R,C00,518783,Staff,5,0,20,15
1714210736000,MCWP 50R,A00,518791,Staff,0,0,20,20
1714210736000,MCWP 50R,B00,518792,Staff,0,1,20,20
1714210736000,MCWP 50R,C00,518793,Staff,0,1,20,20
1714210736000,MCWP 50R,D00,518794,Staff,0,0,20,20
1714210736000,MCWP 50R,E00,518795,Staff,0,1,20,20
1714210736000,MCWP 50R,F00,518796,Staff,0,0,20,20
1714210736000,MCWP 50R,G00,518797,Staff,0,1,20,20
1714210737025,MMW 12R,A01,514034,Herbst; Matthew,0,1,16,16
1714210737025,MMW 12R,A02,514035,Herbst; Matthew,2,0,16,14
1714210738051,MMW 13R,A01,514037,Staff,0,4,16,16
1714210738051,MMW 13R,A02,514039,Staff,0,2,16,16
1714210738051,MMW 13R,A03,628519,Staff,0,2,16,16
1714210740111,SIO 295LS,A00,523233,Staff,13,0,30,17
1714210741136,SIO 295S,A00,523232,Staff,13,0,30,17
1714210742165,SIOC 290S,A01,637330,Merrifield; Mark A,28,0,30,2
1714210743191,SIOC 291S,A01,637333,Gabriel; Corey John,28,0,30,2
1714210744218,SOCI 117,A01,494376,Staff,0,2,5,5
1714210745245,WES 237B,A00,494380,Staff,9,0,20,11
1714210747314,AESE 279B,A00,494370,Wade; Jon P,0,0,33,33
1714210748341,AIP 197,001,627712,Vespa; Emanuel Ignacio,9998,0,9999,1
1714210749367,ANAR 135S,A00,494369,Braswell; Geoffrey E.,0,0,0,0
1714210750391,BENG 196,001,628496,Engler; Adam J.,9998,0,9999,1
1714210751418,CAT 124RS,A01,519847,Geibel; William,0,0,20,20
1714210752448,CAT 125RS,A01,515971,Geibel; William,0,0,20,20
1714210753476,CLRE 250,A00,511389,Morris; Sheldon,9993,0,9999,6
1714210754509,CLRE 251,A00,507176,Mehta; Ravindra L.,9993,0,9999,6
1714210754509,CLRE 251,B00,511410,Mehta; Ravindra L.,9998,0,9999,1
1714210755538,CLRE 252,A00,507189,Cuomo; Raphael Eduardo,9995,0,9999,4
1714210756568,CLRE 253,A00,507199,Vaida; Florin,9994,0,9999,5
1714210756568,CLRE 253,B00,507202,Vaida; Florin,9999,0,9999,0
1714210757593,CLRE 259,A00,507211,Patel; Hemal,9996,0,9999,3
1714210758620,CLRE 260,A00,507221,Cuomo; Raphael Eduardo,9999,0,9999,0
1714210759647,CLRE 297,001,507242,Cuomo; Raphael Eduardo,9999,0,9999,0
1714210760678,COGS 197,001,638244,Voytek; Bradley Thomas,9999,0,9999,0
1714210761702,CSE 191,A00,516875,Minnes Kemp; Mor Mia,9993,0,9999,6
1714210762726,CSE 197,001,637388,Minnes Kemp; Mor Mia,9998,0,9999,1
1714210763756,CSS 201S,A01,494383,Staff,35,0,35,0
1714210764783,CSS 202S,A01,494387,Staff,35,0,35,0
1714210765810,DSC 197,001,628532,Eldridge; Justin Matthew,9996,0,9999,3
1714210766836,EAP 100,A00,516065,Staff,9797,0,9999,202
1714210767864,ECE 45,A01,507414,Staff,33,0,60,27
1714210769919,ECE 111,A01,507420,Staff,21,0,50,29
1714210770944,ECE 197,001,548057,Sievenpiper; Daniel F.,9994,0,9999,5
1714210771971,EDS 115,A00,507243,Choi; Bailey Miyeon,12,0,28,16
1714210773002,EDS 117,A01,494379,Staff,0,1,30,30
1714210774028,EDS 125,A00,507246,Hopkins; Megan Beth,12,0,30,18
1714210775054,EDS 128A,A01,507264,Fargason; Sharon Gayle,14,0,26,12
1714210776080,EDS 128B,A01,507293,Pappas; Elizabeth,18,0,30,12
1714210777106,EDS 139,A00,507294,Fargason; Sharon Gayle,18,0,30,12
1714210777106,EDS 139,B00,507313,Pappas; Elizabeth,15,0,30,15
1714210778134,EDS 201,A00,507315,Staff,13,0,30,17
1714210779164,EDS 203,A01,507317,Halter; Christopher P.,12,0,30,18
1714210780189,EDS 204R,A01,507319,Halter; Christopher P.,0,3,30,30
1714210780189,EDS 204R,B01,507331,Heinzman; Erica M.,17,0,30,13
1714210781218,EDS 206R,A00,507332,Staff,0,4,30,30
1714210781218,EDS 206R,B00,507343,Staff,18,0,30,12
1714210782243,EDS 250,A00,507344,Hemans; Patricia Ann Benitez,22,0,40,18
1714210783272,EDS 281,A00,507345,Daly; Alan J.,18,0,18,0
1714210784297,EDS 284,A00,507350,Daly; Alan J.,16,0,16,0
1714210785325,EDS 286,A00,507359,Fine; Sarah,18,0,18,0
1714210786353,EDS 289C,A01,507361,Daly; Alan J.,18,0,18,0
1714210787379,EDS 290,A00,507366,Hofstetter; Carolyn,15,0,15,0
1714210788405,LIGM 5A,A00,507421,Fischer-Grunski; Eva K,18,0,20,2
1714210789431,LIGM 5B,A00,507423,Fischer-Grunski; Eva K,19,0,20,1
1714210790461,LIGM 5C,A00,507425,Fischer-Grunski; Eva K,19,0,20,1
1714210791490,LIIT 5AS,A00,507427,Carnelos; Chiara,20,0,20,0
1714210792519,LIIT 5BS,A00,507430,Carnelos; Chiara,20,0,20,0
1714210793548,LIIT 5CS,A00,507432,Carnelos; Chiara,20,0,20,0
1714210794575,LISP 5A,A00,507541,Munoz Sanchez; Alicia,11,0,20,9
1714210795604,LISP 5B,A00,507671,Munoz Sanchez; Alicia,9,0,20,11
1714210796633,LISP 5C,A00,507696,Munoz Sanchez; Alicia,9,0,20,11
1714210797658,MAE 197,001,528363,Boechler; Nicholas Sebastia,9998,0,9999,1
1714210798688,MATH 197,001,523477,Kedlaya; Kiran S.,9996,0,9999,3
1714210798688,MATH 197,002,563811,Zhang; Danna,9995,0,9999,4
1714210798688,MATH 197,003,628552,Dumitriu; Ioana,9998,0,9999,1
1714210799713,MCWP 40R,A00,518780,Staff,5,0,20,15
1714210799713,MCWP 40R,B00,518781,Staff,7,0,20,13
1714210799713,MCWP 40R,C00,518783,Staff,5,0,20,15
1714210800739,MCWP 50R,A00,518791,Staff,0,0,20,20
1714210800739,MCWP 50R,B00,518792,Staff,0,1,20,20
1714210800739,MCWP 50R,C00,518793,Staff,0,1,20,20
1714210800739,MCWP 50R,D00,518794,Staff,0,0,20,20
1714210800739,MCWP 50R,E00,518795,Staff,0,1,20,20
1714210800739,MCWP 50R,F00,518796,Staff,0,0,20,20
1714210800739,MCWP 50R,G00,518797,Staff,0,1,20,20
1714210801828,MMW 12R,A01,514034,Herbst; Matthew,0,1,16,16
1714210801828,MMW 12R,A02,514035,Herbst; Matthew,2,0,16,14
1714210802854,MMW 13R,A01,514037,Staff,0,4,16,16
1714210802854,MMW 13R,A02,514039,Staff,0,2,16,16
1714210802854,MMW 13R,A03,628519,Staff,0,2,16,16
1714210804909,SIO 295LS,A00,523233,Staff,13,0,30,17
1714210805934,SIO 295S,A00,523232,Staff,13,0,30,17
1714210806964,SIOC 290S,A01,637330,Merrifield; Mark A,28,0,30,2
1714210807989,SIOC 291S,A01,637333,Gabriel; Corey John,28,0,30,2
1714210809016,SOCI 117,A01,494376,Staff,0,2,5,5
1714210810043,WES 237B,A00,494380,Staff,9,0,20,11
1714210812108,AESE 279B,A00,494370,Wade; Jon P,0,0,33,33
1714210813135,AIP 197,001,627712,Vespa; Emanuel Ignacio,9998,0,9999,1
1714210814161,ANAR 135S,A00,494369,Braswell; Geoffrey E.,0,0,0,0
1714210815186,BENG 196,001,628496,Engler; Adam J.,9998,0,9999,1
1714210816213,CAT 124RS,A01,519847,Geibel; William,0,0,20,20
1714210817238,CAT 125RS,A01,515971,Geibel; William,0,0,20,20
1714210818264,CLRE 250,A00,511389,Morris; Sheldon,9993,0,9999,6
1714210819292,CLRE 251,A00,507176,Mehta; Ravindra L.,9993,0,9999,6
1714210819292,CLRE 251,B00,511410,Mehta; Ravindra L.,9998,0,9999,1
1714210820319,CLRE 252,A00,507189,Cuomo; Raphael Eduardo,9995,0,9999,4
1714210821348,CLRE 253,A00,507199,Vaida; Florin,9994,0,9999,5
1714210821348,CLRE 253,B00,507202,Vaida; Florin,9999,0,9999,0
1714210822374,CLRE 259,A00,507211,Patel; Hemal,9996,0,9999,3
1714210823401,CLRE 260,A00,507221,Cuomo; Raphael Eduardo,9999,0,9999,0
1714210824429,CLRE 297,001,507242,Cuomo; Raphael Eduardo,9999,0,9999,0
1714210825454,COGS 197,001,638244,Voytek; Bradley Thomas,9999,0,9999,0
1714210826480,CSE 191,A00,516875,Minnes Kemp; Mor Mia,9993,0,9999,6
1714210827505,CSE 197,001,637388,Minnes Kemp; Mor Mia,9998,0,9999,1
1714210828531,CSS 201S,A01,494383,Staff,35,0,35,0
1714210829557,CSS 202S,A01,494387,Staff,35,0,35,0
1714210830580,DSC 197,001,628532,Eldridge; Justin Matthew,9996,0,9999,3
1714210831607,EAP 100,A00,516065,Staff,9797,0,9999,202
1714210832637,ECE 45,A01,507414,Staff,33,0,60,27
1714210834690,ECE 111,A01,507420,Staff,21,0,50,29
1714210835721,ECE 197,001,548057,Sievenpiper; Daniel F.,9994,0,9999,5
1714210836747,EDS 115,A00,507243,Choi; Bailey Miyeon,12,0,28,16
1714210837774,EDS 117,A01,494379,Staff,0,1,30,30
1714210838804,EDS 125,A00,507246,Hopkins; Megan Beth,12,0,30,18
1714210839828,EDS 128A,A01,507264,Fargason; Sharon Gayle,14,0,26,12
1714210840857,EDS 128B,A01,507293,Pappas; Elizabeth,18,0,30,12
1714210841881,EDS 139,A00,507294,Fargason; Sharon Gayle,18,0,30,12
1714210841881,EDS 139,B00,507313,Pappas; Elizabeth,15,0,30,15
1714210842908,EDS 201,A00,507315,Staff,13,0,30,17
1714210843934,EDS 203,A01,507317,Halter; Christopher P.,12,0,30,18
1714210844959,EDS 204R,A01,507319,Halter; Christopher P.,0,3,30,30
1714210844959,EDS 204R,B01,507331,Heinzman; Erica M.,17,0,30,13
1714210845987,EDS 206R,A00,507332,Staff,0,4,30,30
1714210845987,EDS 206R,B00,507343,Staff,18,0,30,12
1714210847015,EDS 250,A00,507344,Hemans; Patricia Ann Benitez,22,0,40,18
1714210848040,EDS 281,A00,507345,Daly; Alan J.,18,0,18,0
1714210849065,EDS 284,A00,507350,Daly; Alan J.,16,0,16,0
1714210850089,EDS 286,A00,507359,Fine; Sarah,18,0,18,0
1714210851114,EDS 289C,A01,507361,Daly; Alan J.,18,0,18,0
1714210852140,EDS 290,A00,507366,Hofstetter; Carolyn,15,0,15,0
1714210853170,LIGM 5A,A00,507421,Fischer-Grunski; Eva K,18,0,20,2
1714210854199,LIGM 5B,A00,507423,Fischer-Grunski; Eva K,19,0,20,1
1714210855225,LIGM 5C,A00,507425,Fischer-Grunski; Eva K,19,0,20,1
1714210856254,LIIT 5AS,A00,507427,Carnelos; Chiara,20,0,20,0
1714210857279,LIIT 5BS,A00,507430,Carnelos; Chiara,20,0,20,0
1714210858304,LIIT 5CS,A00,507432,Carnelos; Chiara,20,0,20,0
1714210859332,LISP 5A,A00,507541,Munoz Sanchez; Alicia,11,0,20,9
1714210860357,LISP 5B,A00,507671,Munoz Sanchez; Alicia,9,0,20,11
1714210861383,LISP 5C,A00,507696,Munoz Sanchez; Alicia,9,0,20,11
1714210862409,MAE 197,001,528363,Boechler; Nicholas Sebastia,9998,0,9999,1
1714210863441,MATH 197,001,523477,Kedlaya; Kiran S.,9996,0,9999,3
1714210863441,MATH 197,002,563811,Zhang; Danna,9995,0,9999,4
1714210863441,MATH 197,003,628552,Dumitriu; Ioana,9998,0,9999,1
1714210864470,MCWP 40R,A00,518780,Staff,5,0,20,15
1714210864470,MCWP 40R,B00,518781,Staff,7,0,20,13
1714210864470,MCWP 40R,C00,518783,Staff,5,0,20,15
1714210865499,MCWP 50R,A00,518791,Staff,0,0,20,20
1714210865499,MCWP 50R,B00,518792,Staff,0,1,20,20
1714210865499,MCWP 50R,C00,518793,Staff,0,1,20,20
1714210865499,MCWP 50R,D00,518794,Staff,0,0,20,20
1714210865499,MCWP 50R,E00,518795,Staff,0,1,20,20
1714210865499,MCWP 50R,F00,518796,Staff,0,0,20,20
1714210865499,MCWP 50R,G00,518797,Staff,0,1,20,20
1714210866529,MMW 12R,A01,514034,Herbst; Matthew,0,1,16,16
1714210866529,MMW 12R,A02,514035,Herbst; Matthew,2,0,16,14
1714210867561,MMW 13R,A01,514037,Staff,0,4,16,16
1714210867561,MMW 13R,A02,514039,Staff,0,2,16,16
1714210867561,MMW 13R,A03,628519,Staff,0,2,16,16
1714210869612,SIO 295LS,A00,523233,Staff,13,0,30,17
1714210870641,SIO 295S,A00,523232,Staff,13,0,30,17
1714210871672,SIOC 290S,A01,637330,Merrifield; Mark A,28,0,30,2
1714210872704,SIOC 291S,A01,637333,Gabriel; Corey John,28,0,30,2
1714210873730,SOCI 117,A01,494376,Staff,0,2,5,5
1714210874758,WES 237B,A00,494380,Staff,9,0,20,11
1714210876830,AESE 279B,A00,494370,Wade; Jon P,0,0,33,33
1714210877856,AIP 197,001,627712,Vespa; Emanuel Ignacio,9998,0,9999,1
1714210878887,ANAR 135S,A00,494369,Braswell; Geoffrey E.,0,0,0,0
1714210879917,BENG 196,001,628496,Engler; Adam J.,9998,0,9999,1
1714210880942,CAT 124RS,A01,519847,Geibel; William,0,0,20,20
1714210881969,CAT 125RS,A01,515971,Geibel; William,0,0,20,20
1714210882998,CLRE 250,A00,511389,Morris; Sheldon,9993,0,9999,6
1714210884025,CLRE 251,A00,507176,Mehta; Ravindra L.,9993,0,9999,6
1714210884025,CLRE 251,B00,511410,Mehta; Ravindra L.,9998,0,9999,1
1714210885051,CLRE 252,A00,507189,Cuomo; Raphael Eduardo,9995,0,9999,4
1714210886078,CLRE 253,A00,507199,Vaida; Florin,9994,0,9999,5
1714210886078,CLRE 253,B00,507202,Vaida; Florin,9999,0,9999,0
1714210887104,CLRE 259,A00,507211,Patel; Hemal,9996,0,9999,3
1714210888131,CLRE 260,A00,507221,Cuomo; Raphael Eduardo,9999,0,9999,0
1714210889155,CLRE 297,001,507242,Cuomo; Raphael Eduardo,9999,0,9999,0
1714210890181,COGS 197,001,638244,Voytek; Bradley Thomas,9999,0,9999,0
1714210891206,CSE 191,A00,516875,Minnes Kemp; Mor Mia,9993,0,9999,6
1714210892231,CSE 197,001,637388,Minnes Kemp; Mor Mia,9998,0,9999,1
1714210893263,CSS 201S,A01,494383,Staff,35,0,35,0
1714210894289,CSS 202S,A01,494387,Staff,35,0,35,0
1714210895314,DSC 197,001,628532,Eldridge; Justin Matthew,9996,0,9999,3
1714210896340,EAP 100,A00,516065,Staff,9797,0,9999,202
1714210897373,ECE 45,A01,507414,Staff,33,0,60,27
1714210899430,ECE 111,A01,507420,Staff,21,0,50,29
1714210900457,ECE 197,001,548057,Sievenpiper; Daniel F.,9994,0,9999,5
1714210901487,EDS 115,A00,507243,Choi; Bailey Miyeon,12,0,28,16
1714210902516,EDS 117,A01,494379,Staff,0,1,30,30
1714210903541,EDS 125,A00,507246,Hopkins; Megan Beth,12,0,30,18
1714210904568,EDS 128A,A01,507264,Fargason; Sharon Gayle,14,0,26,12
1714210905647,EDS 128B,A01,507293,Pappas; Elizabeth,18,0,30,12
1714210906675,EDS 139,A00,507294,Fargason; Sharon Gayle,18,0,30,12
1714210906675,EDS 139,B00,507313,Pappas; Elizabeth,15,0,30,15
1714210907699,EDS 201,A00,507315,Staff,13,0,30,17
1714210908727,EDS 203,A01,507317,Halter; Christopher P.,12,0,30,18
1714210909752,EDS 204R,A01,507319,Halter; Christopher P.,0,3,30,30
1714210909752,EDS 204R,B01,507331,Heinzman; Erica M.,17,0,30,13
1714210910780,EDS 206R,A00,507332,Staff,0,4,30,30
1714210910780,EDS 206R,B00,507343,Staff,18,0,30,12
1714210911805,EDS 250,A00,507344,Hemans; Patricia Ann Benitez,22,0,40,18
1714210912830,EDS 281,A00,507345,Daly; Alan J.,18,0,18,0
1714210913864,EDS 284,A00,507350,Daly; Alan J.,16,0,16,0
1714210914887,EDS 286,A00,507359,Fine; Sarah,18,0,18,0
1714210915914,EDS 289C,A01,507361,Daly; Alan J.,18,0,18,0
1714210916940,EDS 290,A00,507366,Hofstetter; Carolyn,15,0,15,0
1714210917968,LIGM 5A,A00,507421,Fischer-Grunski; Eva K,18,0,20,2
1714210918996,LIGM 5B,A00,507423,Fischer-Grunski; Eva K,19,0,20,1
1714210920028,LIGM 5C,A00,507425,Fischer-Grunski; Eva K,19,0,20,1
1714210921054,LIIT 5AS,A00,507427,Carnelos; Chiara,20,0,20,0
1714210922079,LIIT 5BS,A00,507430,Carnelos; Chiara,20,0,20,0
1714210923105,LIIT 5CS,A00,507432,Carnelos; Chiara,20,0,20,0
1714210924130,LISP 5A,A00,507541,Munoz Sanchez; Alicia,11,0,20,9
1714210925155,LISP 5B,A00,507671,Munoz Sanchez; Alicia,9,0,20,11
1714210926179,LISP 5C,A00,507696,Munoz Sanchez; Alicia,9,0,20,11
1714210927207,MAE 197,001,528363,Boechler; Nicholas Sebastia,9998,0,9999,1
1714210928233,MATH 197,001,523477,Kedlaya; Kiran S.,9996,0,9999,3
1714210928233,MATH 197,002,563811,Zhang; Danna,9995,0,9999,4
1714210928233,MATH 197,003,628552,Dumitriu; Ioana,9998,0,9999,1
1714210929258,MCWP 40R,A00,518780,Staff,5,0,20,15
1714210929258,MCWP 40R,B00,518781,Staff,7,0,20,13
1714210929258,MCWP 40R,C00,518783,Staff,5,0,20,15
1714210930285,MCWP 50R,A00,518791,Staff,0,0,20,20
1714210930285,MCWP 50R,B00,518792,Staff,0,1,20,20
1714210930285,MCWP 50R,C00,518793,Staff,0,1,20,20
1714210930285,MCWP 50R,D00,518794,Staff,0,0,20,20
1714210930285,MCWP 50R,E00,518795,Staff,0,1,20,20
1714210930285,MCWP 50R,F00,518796,Staff,0,0,20,20
1714210930285,MCWP 50R,G00,518797,Staff,0,1,20,20
1714210931312,MMW 12R,A01,514034,Herbst; Matthew,0,1,16,16
1714210931312,MMW 12R,A02,514035,Herbst; Matthew,2,0,16,14
1714210932338,MMW 13R,A01,514037,Staff,0,4,16,16
1714210932338,MMW 13R,A02,514039,Staff,0,2,16,16
1714210932338,MMW 13R,A03,628519,Staff,0,2,16,16
1714210934394,SIO 295LS,A00,523233,Staff,13,0,30,17
1714210935420,SIO 295S,A00,523232,Staff,13,0,30,17
1714210936446,SIOC 290S,A01,637330,Merrifield; Mark A,28,0,30,2
1714210937475,SIOC 291S,A01,637333,Gabriel; Corey John,28,0,30,2
1714210938499,SOCI 117,A01,494376,Staff,0,2,5,5
1714210939525,WES 237B,A00,494380,Staff,9,0,20,11
1714210941601,AESE 279B,A00,494370,Wade; Jon P,0,0,33,33
1714210942626,AIP 197,001,627712,Vespa; Emanuel Ignacio,9998,0,9999,1
1714210943652,ANAR 135S,A00,494369,Braswell; Geoffrey E.,0,0,0,0
1714210944679,BENG 196,001,628496,Engler; Adam J.,9998,0,9999,1
1714210945706,CAT 124RS,A01,519847,Geibel; William,0,0,20,20
1714210946733,CAT 125RS,A01,515971,Geibel; William,0,0,20,20
1714210947759,CLRE 250,A00,511389,Morris; Sheldon,9993,0,9999,6
1714210948790,CLRE 251,A00,507176,Mehta; Ravindra L.,9993,0,9999,6
1714210948790,CLRE 251,B00,511410,Mehta; Ravindra L.,9998,0,9999,1
1714210949817,CLRE 252,A00,507189,Cuomo; Raphael Eduardo,9995,0,9999,4
1714210950843,CLRE 253,A00,507199,Vaida; Florin,9994,0,9999,5
1714210950843,CLRE 253,B00,507202,Vaida; Florin,9999,0,9999,0
1714210951868,CLRE 259,A00,507211,Patel; Hemal,9996,0,9999,3
1714210952896,CLRE 260,A00,507221,Cuomo; Raphael Eduardo,9999,0,9999,0
1714210953921,CLRE 297,001,507242,Cuomo; Raphael Eduardo,9999,0,9999,0
1714210954946,COGS 197,001,638244,Voytek; Bradley Thomas,9999,0,9999,0
1714210955972,CSE 191,A00,516875,Minnes Kemp; Mor Mia,9993,0,9999,6
1714210957000,CSE 197,001,637388,Minnes Kemp; Mor Mia,9998,0,9999,1
1714210958026,CSS 201S,A01,494383,Staff,35,0,35,0
1714210959053,CSS 202S,A01,494387,Staff,35,0,35,0
1714210960079,DSC 197,001,628532,Eldridge; Justin Matthew,9996,0,9999,3
1714210961104,EAP 100,A00,516065,Staff,9797,0,9999,202
1714210962130,ECE 45,A01,507414,Staff,33,0,60,27
1714210964181,ECE 111,A01,507420,Staff,21,0,50,29
1714210965210,ECE 197,001,548057,Sievenpiper; Daniel F.,9994,0,9999,5
1714210966236,EDS 115,A00,507243,Choi; Bailey Miyeon,12,0,28,16
1714210967263,EDS 117,A01,494379,Staff,0,1,30,30
1714210968288,EDS 125,A00,507246,Hopkins; Megan Beth,12,0,30,18
1714210969313,EDS 128A,A01,507264,Fargason; Sharon Gayle,14,0,26,12
1714210970342,EDS 128B,A01,507293,Pappas; Elizabeth,18,0,30,12
1714210971368,EDS 139,A00,507294,Fargason; Sharon Gayle,18,0,30,12
1714210971368,EDS 139,B00,507313,Pappas; Elizabeth,15,0,30,15
1714210972393,EDS 201,A00,507315,Staff,13,0,30,17
1714210973421,EDS 203,A01,507317,Halter; Christopher P.,12,0,30,18
1714210974446,EDS 204R,A01,507319,Halter; Christopher P.,0,3,30,30
1714210974446,EDS 204R,B01,507331,Heinzman; Erica M.,17,0,30,13
1714210975474,EDS 206R,A00,507332,Staff,0,4,30,30
1714210975474,EDS 206R,B00,507343,Staff,18,0,30,12
1714210976521,EDS 250,A00,507344,Hemans; Patricia Ann Benitez,22,0,40,18
1714210977547,EDS 281,A00,507345,Daly; Alan J.,18,0,18,0
1714210978571,EDS 284,A00,507350,Daly; Alan J.,16,0,16,0
1714210979596,EDS 286,A00,507359,Fine; Sarah,18,0,18,0
1714210980621,EDS 289C,A01,507361,Daly; Alan J.,18,0,18,0
1714210981649,EDS 290,A00,507366,Hofstetter; Carolyn,15,0,15,0
1714210982679,LIGM 5A,A00,507421,Fischer-Grunski; Eva K,18,0,20,2
1714210983705,LIGM 5B,A00,507423,Fischer-Grunski; Eva K,19,0,20,1
1714210984734,LIGM 5C,A00,507425,Fischer-Grunski; Eva K,19,0,20,1
1714210985763,LIIT 5AS,A00,507427,Carnelos; Chiara,20,0,20,0
1714210986788,LIIT 5BS,A00,507430,Carnelos; Chiara,20,0,20,0
1714210987814,LIIT 5CS,A00,507432,Carnelos; Chiara,20,0,20,0
1714210988839,LISP 5A,A00,507541,Munoz Sanchez; Alicia,11,0,20,9
1714210989863,LISP 5B,A00,507671,Munoz Sanchez; Alicia,9,0,20,11
1714210990892,LISP 5C,A00,507696,Munoz Sanchez; Alicia,9,0,20,11
1714210991917,MAE 197,001,528363,Boechler; Nicholas Sebastia,9998,0,9999,1
1714210992950,MATH 197,001,523477,Kedlaya; Kiran S.,9996,0,9999,3
1714210992950,MATH 197,002,563811,Zhang; Danna,9995,0,9999,4
1714210992950,MATH 197,003,628552,Dumitriu; Ioana,9998,0,9999,1
1714210993974,MCWP 40R,A00,518780,Staff,5,0,20,15
1714210993974,MCWP 40R,B00,518781,Staff,7,0,20,13
1714210993974,MCWP 40R,C00,518783,Staff,5,0,20,15
1714210994999,MCWP 50R,A00,518791,Staff,0,0,20,20
1714210994999,MCWP 50R,B00,518792,Staff,0,1,20,20
1714210994999,MCWP 50R,C00,518793,Staff,0,1,20,20
1714210994999,MCWP 50R,D00,518794,Staff,0,0,20,20
1714210994999,MCWP 50R,E00,518795,Staff,0,1,20,20
1714210994999,MCWP 50R,F00,518796,Staff,0,0,20,20
1714210994999,MCWP 50R,G00,518797,Staff,0,1,20,20
1714210996025,MMW 12R,A01,514034,Herbst; Matthew,0,1,16,16
1714210996025,MMW 12R,A02,514035,Herbst; Matthew,2,0,16,14
1714210997048,MMW 13R,A01,514037,Staff,0,4,16,16
1714210997048,MMW 13R,A02,514039,Staff,0,2,16,16
1714210997048,MMW 13R,A03,628519,Staff,0,2,16,16
1714210999097,SIO 295LS,A00,523233,Staff,13,0,30,17
1714211000122,SIO 295S,A00,523232,Staff,13,0,30,17
1714211001147,SIOC 290S,A01,637330,Merrifield; Mark A,28,0,30,2
1714211002173,SIOC 291S,A01,637333,Gabriel; Corey John,28,0,30,2
1714211003200,SOCI 117,A01,494376,Staff,0,2,5,5
1714211004227,WES 237B,A00,494380,Staff,9,0,20,11
1714211006301,AESE 279B,A00,494370,Wade; Jon P,0,0,33,33
1714211007328,AIP 197,001,627712,Vespa; Emanuel Ignacio,9998,0,9999,1
1714211008353,ANAR 135S,A00,494369,Braswell; Geoffrey E.,0,0,0,0
1714211009433,BENG 196,001,628496,Engler; Adam J.,9998,0,9999,1
1714211010461,CAT 124RS,A01,519847,Geibel; William,0,0,20,20
1714211011486,CAT 125RS,A01,515971,Geibel; William,0,0,20,20
1714211012512,CLRE 250,A00,511389,Morris; Sheldon,9993,0,9999,6
1714211013541,CLRE 251,A00,507176,Mehta; Ravindra L.,9993,0,9999,6
1714211013541,CLRE 251,B00,511410,Mehta; Ravindra L.,9998,0,9999,1
1714211014570,CLRE 252,A00,507189,Cuomo; Raphael Eduardo,9995,0,9999,4
1714211015594,CLRE 253,A00,507199,Vaida; Florin,9994,0,9999,5
1714211015594,CLRE 253,B00,507202,Vaida; Florin,9999,0,9999,0
1714211016620,CLRE 259,A00,507211,Patel; Hemal,9996,0,9999,3
1714211017647,CLRE 260,A00,507221,Cuomo; Raphael Eduardo,9999,0,9999,0
1714211018674,CLRE 297,001,507242,Cuomo; Raphael Eduardo,9999,0,9999,0
1714211019701,COGS 197,001,638244,Voytek; Bradley Thomas,9999,0,9999,0
1714211020728,CSE 191,A00,516875,Minnes Kemp; Mor Mia,9993,0,9999,6
1714211021755,CSE 197,001,637388,Minnes Kemp; Mor Mia,9998,0,9999,1
1714211022779,CSS 201S,A01,494383,Staff,35,0,35,0
1714211023809,CSS 202S,A01,494387,Staff,35,0,35,0
1714211024833,DSC 197,001,628532,Eldridge; Justin Matthew,9996,0,9999,3
1714211025860,EAP 100,A00,516065,Staff,9797,0,9999,202
1714211026889,ECE 45,A01,507414,Staff,33,0,60,27
1714211028943,ECE 111,A01,507420,Staff,21,0,50,29
1714211029970,ECE 197,001,548057,Sievenpiper; Daniel F.,9994,0,9999,5
1714211030998,EDS 115,A00,507243,Choi; Bailey Miyeon,12,0,28,16
1714211032025,EDS 117,A01,494379,Staff,0,1,30,30
1714211033109,EDS 125,A00,507246,Hopkins; Megan Beth,12,0,30,18
1714211034133,EDS 128A,A01,507264,Fargason; Sharon Gayle,14,0,26,12
1714211035158,EDS 128B,A01,507293,Pappas; Elizabeth,18,0,30,12
1714211036182,EDS 139,A00,507294,Fargason; Sharon Gayle,18,0,30,12
1714211036182,EDS 139,B00,507313,Pappas; Elizabeth,15,0,30,15
1714211037208,EDS 201,A00,507315,Staff,13,0,30,17
1714211038238,EDS 203,A01,507317,Halter; Christopher P.,12,0,30,18
1714211039263,EDS 204R,A01,507319,Halter; Christopher P.,0,3,30,30
1714211039263,EDS 204R,B01,507331,Heinzman; Erica M.,17,0,30,13
1714211040287,EDS 206R,A00,507332,Staff,0,4,30,30
1714211040287,EDS 206R,B00,507343,Staff,18,0,30,12
1714211041314,EDS 250,A00,507344,Hemans; Patricia Ann Benitez,22,0,40,18
1714211042338,EDS 281,A00,507345,Daly; Alan J.,18,0,18,0
1714211043366,EDS 284,A00,507350,Daly; Alan J.,16,0,16,0
1714211044390,EDS 286,A00,507359,Fine; Sarah,18,0,18,0
1714211045415,EDS 289C,A01,507361,Daly; Alan J.,18,0,18,0
1714211046441,EDS 290,A00,507366,Hofstetter; Carolyn,15,0,15,0
1714211047469,LIGM 5A,A00,507421,Fischer-Grunski; Eva K,18,0,20,2
1714211048498,LIGM 5B,A00,507423,Fischer-Grunski; Eva K,19,0,20,1
1714211049523,LIGM 5C,A00,507425,Fischer-Grunski; Eva K,19,0,20,1
1714211050554,LIIT 5AS,A00,507427,Carnelos; Chiara,20,0,20,0
1714211051583,LIIT 5BS,A00,507430,Carnelos; Chiara,20,0,20,0
1714211052611,LIIT 5CS,A00,507432,Carnelos; Chiara,20,0,20,0
1714211053641,LISP 5A,A00,507541,Munoz Sanchez; Alicia,11,0,20,9
1714211054669,LISP 5B,A00,507671,Munoz Sanchez; Alicia,9,0,20,11
1714211055700,LISP 5C,A00,507696,Munoz Sanchez; Alicia,9,0,20,11
1714211056727,MAE 197,001,528363,Boechler; Nicholas Sebastia,9998,0,9999,1
1714211057752,MATH 197,001,523477,Kedlaya; Kiran S.,9996,0,9999,3
1714211057752,MATH 197,002,563811,Zhang; Danna,9995,0,9999,4
1714211057752,MATH 197,003,628552,Dumitriu; Ioana,9998,0,9999,1
1714211058778,MCWP 40R,A00,518780,Staff,5,0,20,15
1714211058778,MCWP 40R,B00,518781,Staff,7,0,20,13
1714211058778,MCWP 40R,C00,518783,Staff,5,0,20,15
1714211059809,MCWP 50R,A00,518791,Staff,0,0,20,20
1714211059809,MCWP 50R,B00,518792,Staff,0,1,20,20
1714211059809,MCWP 50R,C00,518793,Staff,0,1,20,20
1714211059809,MCWP 50R,D00,518794,Staff,0,0,20,20
1714211059809,MCWP 50R,E00,518795,Staff,0,1,20,20
1714211059809,MCWP 50R,F00,518796,Staff,0,0,20,20
1714211059809,MCWP 50R,G00,518797,Staff,0,1,20,20
1714211060835,MMW 12R,A01,514034,Herbst; Matthew,0,1,16,16
1714211060835,MMW 12R,A02,514035,Herbst; Matthew,2,0,16,14
1714211061864,MMW 13R,A01,514037,Staff,0,4,16,16
1714211061864,MMW 13R,A02,514039,Staff,0,2,16,16
1714211061864,MMW 13R,A03,628519,Staff,0,2,16,16
1714211063917,SIO 295LS,A00,523233,Staff,13,0,30,17
1714211064942,SIO 295S,A00,523232,Staff,13,0,30,17
1714211065966,SIOC 290S,A01,637330,Merrifield; Mark A,28,0,30,2
1714211066990,SIOC 291S,A01,637333,Gabriel; Corey John,28,0,30,2
1714211068019,SOCI 117,A01,494376,Staff,0,2,5,5
1714211069043,WES 237B,A00,494380,Staff,9,0,20,11
1714211071108,AESE 279B,A00,494370,Wade; Jon P,0,0,33,33
1714211072136,AIP 197,001,627712,Vespa; Emanuel Ignacio,9998,0,9999,1
1714211073161,ANAR 135S,A00,494369,Braswell; Geoffrey E.,0,0,0,0
1714211074189,BENG 196,001,628496,Engler; Adam J.,9998,0,9999,1
1714211075212,CAT 124RS,A01,519847,Geibel; William,0,0,20,20
1714211076237,CAT 125RS,A01,515971,Geibel; William,0,0,20,20
1714211077262,CLRE 250,A00,511389,Morris; Sheldon,9993,0,9999,6
1714211078288,CLRE 251,A00,507176,Mehta; Ravindra L.,9993,0,9999,6
1714211078288,CLRE 251,B00,511410,Mehta; Ravindra L.,9998,0,9999,1
1714211079315,CLRE 252,A00,507189,Cuomo; Raphael Eduardo,9995,0,9999,4
1714211080342,CLRE 253,A00,507199,Vaida; Florin,9994,0,9999,5
1714211080342,CLRE 253,B00,507202,Vaida; Florin,9999,0,9999,0
1714211081369,CLRE 259,A00,507211,Patel; Hemal,9996,0,9999,3
1714211082396,CLRE 260,A00,507221,Cuomo; Raphael Eduardo,9999,0,9999,0
1714211083424,CLRE 297,001,507242,Cuomo; Raphael Eduardo,9999,0,9999,0
1714211084450,COGS 197,001,638244,Voytek; Bradley Thomas,9999,0,9999,0
1714211085474,CSE 191,A00,516875,Minnes Kemp; Mor Mia,9993,0,9999,6
1714211086499,CSE 197,001,637388,Minnes Kemp; Mor Mia,9998,0,9999,1
1714211087528,CSS 201S,A01,494383,Staff,35,0,35,0
1714211088554,CSS 202S,A01,494387,Staff,35,0,35,0
1714211089587,DSC 197,001,628532,Eldridge; Justin Matthew,9996,0,9999,3
1714211090612,EAP 100,A00,516065,Staff,9797,0,9999,202
1714211091640,ECE 45,A01,507414,Staff,33,0,60,27
1714211093701,ECE 111,A01,507420,Staff,21,0,50,29
1714211094725,ECE 197,001,548057,Sievenpiper; Daniel F.,9994,0,9999,5
1714211095751,EDS 115,A00,507243,Choi; Bailey Miyeon,12,0,28,16
1714211096779,EDS 117,A01,494379,Staff,0,1,30,30
1714211097809,EDS 125,A00,507246,Hopkins; Megan Beth,12,0,30,18
1714211098834,EDS 128A,A01,507264,Fargason; Sharon Gayle,14,0,26,12
1714211099859,EDS 128B,A01,507293,Pappas; Elizabeth,18,0,30,12
1714211100887,EDS 139,A00,507294,Fargason; Sharon Gayle,18,0,30,12
1714211100887,EDS 139,B00,507313,Pappas; Elizabeth,15,0,30,15
1714211101911,EDS 201,A00,507315,Staff,13,0,30,17
1714211102939,EDS 203,A01,507317,Halter; Christopher P.,12,0,30,18
1714211103965,EDS 204R,A01,507319,Halter; Christopher P.,0,3,30,30
1714211103965,EDS 204R,B01,507331,Heinzman; Erica M.,17,0,30,13
1714211104989,EDS 206R,A00,507332,Staff,0,4,30,30
1714211104989,EDS 206R,B00,507343,Staff,18,0,30,12
1714211106016,EDS 250,A00,507344,Hemans; Patricia Ann Benitez,22,0,40,18
1714211107043,EDS 281,A00,507345,Daly; Alan J.,18,0,18,0
1714211108070,EDS 284,A00,507350,Daly; Alan J.,16,0,16,0
1714211109095,EDS 286,A00,507359,Fine; Sarah,18,0,18,0
1714211110121,EDS 289C,A01,507361,Daly; Alan J.,18,0,18,0
1714211111148,EDS 290,A00,507366,Hofstetter; Carolyn,15,0,15,0
1714211112174,LIGM 5A,A00,507421,Fischer-Grunski; Eva K,18,0,20,2
1714211113257,LIGM 5B,A00,507423,Fischer-Grunski; Eva K,19,0,20,1
1714211114281,LIGM 5C,A00,507425,Fischer-Grunski; Eva K,19,0,20,1
1714211115307,LIIT 5AS,A00,507427,Carnelos; Chiara,20,0,20,0
1714211116335,LIIT 5BS,A00,507430,Carnelos; Chiara,20,0,20,0
1714211117361,LIIT 5CS,A00,507432,Carnelos; Chiara,20,0,20,0
1714211118389,LISP 5A,A00,507541,Munoz Sanchez; Alicia,11,0,20,9
1714211119415,LISP 5B,A00,507671,Munoz Sanchez; Alicia,9,0,20,11
1714211120440,LISP 5C,A00,507696,Munoz Sanchez; Alicia,9,0,20,11
1714211121467,MAE 197,001,528363,Boechler; Nicholas Sebastia,9998,0,9999,1
1714211122494,MATH 197,001,523477,Kedlaya; Kiran S.,9996,0,9999,3
1714211122494,MATH 197,002,563811,Zhang; Danna,9995,0,9999,4
1714211122494,MATH 197,003,628552,Dumitriu; Ioana,9998,0,9999,1
1714211123520,MCWP 40R,A00,518780,Staff,5,0,20,15
1714211123520,MCWP 40R,B00,518781,Staff,7,0,20,13
1714211123520,MCWP 40R,C00,518783,Staff,5,0,20,15
1714211124546,MCWP 50R,A00,518791,Staff,0,0,20,20
1714211124546,MCWP 50R,B00,518792,Staff,0,1,20,20
1714211124546,MCWP 50R,C00,518793,Staff,0,1,20,20
1714211124546,MCWP 50R,D00,518794,Staff,0,0,20,20
1714211124546,MCWP 50R,E00,518795,Staff,0,1,20,20
1714211124546,MCWP 50R,F00,518796,Staff,0,0,20,20
1714211124546,MCWP 50R,G00,518797,Staff,0,1,20,20
1714211125569,MMW 12R,A01,514034,Herbst; Matthew,0,1,16,16
1714211125569,MMW 12R,A02,514035,Herbst; Matthew,2,0,16,14
1714211126608,MMW 13R,A01,514037,Staff,0,4,16,16
1714211126608,MMW 13R,A02,514039,Staff,0,2,16,16
1714211126608,MMW 13R,A03,628519,Staff,0,2,16,16
1714211128659,SIO 295LS,A00,523233,Staff,13,0,30,17
1714211129684,SIO 295S,A00,523232,Staff,13,0,30,17
1714211130709,SIOC 290S,A01,637330,Merrifield; Mark A,28,0,30,2
1714211131734,SIOC 291S,A01,637333,Gabriel; Corey John,28,0,30,2
1714211132760,SOCI 117,A01,494376,Staff,0,2,5,5
1714211133784,WES 237B,A00,494380,Staff,9,0,20,11
1714211135844,AESE 279B,A00,494370,Wade; Jon P,0,0,33,33
1714211136871,AIP 197,001,627712,Vespa; Emanuel Ignacio,9998,0,9999,1
1714211137896,ANAR 135S,A00,494369,Braswell; Geoffrey E.,0,0,0,0
1714211138921,BENG 196,001,628496,Engler; Adam J.,9998,0,9999,1
1714211139950,CAT 124RS,A01,519847,Geibel; William,0,0,20,20
1714211140974,CAT 125RS,A01,515971,Geibel; William,0,0,20,20
1714211142002,CLRE 250,A00,511389,Morris; Sheldon,9993,0,9999,6
1714211143031,CLRE 251,A00,507176,Mehta; Ravindra L.,9993,0,9999,6
1714211143031,CLRE 251,B00,511410,Mehta; Ravindra L.,9998,0,9999,1
1714211144057,CLRE 252,A00,507189,Cuomo; Raphael Eduardo,9995,0,9999,4
1714211145085,CLRE 253,A00,507199,Vaida; Florin,9994,0,9999,5
1714211145085,CLRE 253,B00,507202,Vaida; Florin,9999,0,9999,0
1714211146113,CLRE 259,A00,507211,Patel; Hemal,9996,0,9999,3
1714211147142,CLRE 260,A00,507221,Cuomo; Raphael Eduardo,9999,0,9999,0
1714211148167,CLRE 297,001,507242,Cuomo; Raphael Eduardo,9999,0,9999,0
1714211149194,COGS 197,001,638244,Voytek; Bradley Thomas,9999,0,9999,0
1714211150219,CSE 191,A00,516875,Minnes Kemp; Mor Mia,9993,0,9999,6
1714211151243,CSE 197,001,637388,Minnes Kemp; Mor Mia,9998,0,9999,1
1714211152268,CSS 201S,A01,494383,Staff,35,0,35,0
1714211153296,CSS 202S,A01,494387,Staff,35,0,35,0
1714211154320,DSC 197,001,628532,Eldridge; Justin Matthew,9996,0,9999,3
1714211155344,EAP 100,A00,516065,Staff,9797,0,9999,202
1714211156369,ECE 45,A01,507414,Staff,33,0,60,27
1714211158425,ECE 111,A01,507420,Staff,21,0,50,29
1714211159450,ECE 197,001,548057,Sievenpiper; Daniel F.,9994,0,9999,5
1714211160475,EDS 115,A00,507243,Choi; Bailey Miyeon,12,0,28,16
1714211161504,EDS 117,A01,494379,Staff,0,1,30,30
1714211162532,EDS 125,A00,507246,Hopkins; Megan Beth,12,0,30,18
1714211163560,EDS 128A,A01,507264,Fargason; Sharon Gayle,14,0,26,12
1714211164588,EDS 128B,A01,507293,Pappas; Elizabeth,18,0,30,12
1714211165616,EDS 139,A00,507294,Fargason; Sharon Gayle,18,0,30,12
1714211165616,EDS 139,B00,507313,Pappas; Elizabeth,15,0,30,15
1714211166641,EDS 201,A00,507315,Staff,13,0,30,17
1714211167667,EDS 203,A01,507317,Halter; Christopher P.,12,0,30,18
1714211168692,EDS 204R,A01,507319,Halter; Christopher P.,0,3,30,30
1714211168692,EDS 204R,B01,507331,Heinzman; Erica M.,17,0,30,13
1714211169717,EDS 206R,A00,507332,Staff,0,4,30,30
1714211169717,EDS 206R,B00,507343,Staff,18,0,30,12
1714211170742,EDS 250,A00,507344,Hemans; Patricia Ann Benitez,22,0,40,18
1714211171766,EDS 281,A00,507345,Daly; Alan J.,18,0,18,0
1714211172794,EDS 284,A00,507350,Daly; Alan J.,16,0,16,0
1714211173819,EDS 286,A00,507359,Fine; Sarah,18,0,18,0
1714211174843,EDS 289C,A01,507361,Daly; Alan J.,18,0,18,0
1714211175868,EDS 290,A00,507366,Hofstetter; Carolyn,15,0,15,0
1714211176891,LIGM 5A,A00,507421,Fischer-Grunski; Eva K,18,0,20,2
1714211177916,LIGM 5B,A00,507423,Fischer-Grunski; Eva K,19,0,20,1
1714211178942,LIGM 5C,A00,507425,Fischer-Grunski; Eva K,19,0,20,1
1714211179969,LIIT 5AS,A00,507427,Carnelos; Chiara,20,0,20,0
1714211180993,LIIT 5BS,A00,507430,Carnelos; Chiara,20,0,20,0
1714211182022,LIIT 5CS,A00,507432,Carnelos; Chiara,20,0,20,0
1714211183051,LISP 5A,A00,507541,Munoz Sanchez; Alicia,11,0,20,9
1714211184076,LISP 5B,A00,507671,Munoz Sanchez; Alicia,9,0,20,11
1714211185101,LISP 5C,A00,507696,Munoz Sanchez; Alicia,9,0,20,11
1714211186129,MAE 197,001,528363,Boechler; Nicholas Sebastia,9998,0,9999,1
1714211187154,MATH 197,001,523477,Kedlaya; Kiran S.,9996,0,9999,3
1714211187154,MATH 197,002,563811,Zhang; Danna,9995,0,9999,4
1714211187154,MATH 197,003,628552,Dumitriu; Ioana,9998,0,9999,1
1714211188179,MCWP 40R,A00,518780,Staff,5,0,20,15
1714211188179,MCWP 40R,B00,518781,Staff,7,0,20,13
1714211188179,MCWP 40R,C00,518783,Staff,5,0,20,15
1714211189204,MCWP 50R,A00,518791,Staff,0,0,20,20
1714211189204,MCWP 50R,B00,518792,Staff,0,1,20,20
1714211189204,MCWP 50R,C00,518793,Staff,0,1,20,20
1714211189204,MCWP 50R,D00,518794,Staff,0,0,20,20
1714211189204,MCWP 50R,E00,518795,Staff,0,1,20,20
1714211189204,MCWP 50R,F00,518796,Staff,0,0,20,20
1714211189204,MCWP 50R,G00,518797,Staff,0,1,20,20
1714211190231,MMW 12R,A01,514034,Herbst; Matthew,0,1,16,16
1714211190231,MMW 12R,A02,514035,Herbst; Matthew,2,0,16,14
1714211191259,MMW 13R,A01,514037,Staff,0,4,16,16
1714211191259,MMW 13R,A02,514039,Staff,0,2,16,16
1714211191259,MMW 13R,A03,628519,Staff,0,2,16,16
1714211193308,SIO 295LS,A00,523233,Staff,13,0,30,17
1714211194337,SIO 295S,A00,523232,Staff,13,0,30,17
1714211195364,SIOC 290S,A01,637330,Merrifield; Mark A,28,0,30,2
1714211196392,SIOC 291S,A01,637333,Gabriel; Corey John,28,0,30,2
1714211197417,SOCI 117,A01,494376,Staff,0,2,5,5
1714211198441,WES 237B,A00,494380,Staff,9,0,20,11
1714211200497,AESE 279B,A00,494370,Wade; Jon P,0,0,33,33
1714211201522,AIP 197,001,627712,Vespa; Emanuel Ignacio,9998,0,9999,1
1714211202547,ANAR 135S,A00,494369,Braswell; Geoffrey E.,0,0,0,0
1714211203571,BENG 196,001,628496,Engler; Adam J.,9998,0,9999,1
1714211204597,CAT 124RS,A01,519847,Geibel; William,0,0,20,20
1714211205622,CAT 125RS,A01,515971,Geibel; William,0,0,20,20
1714211206650,CLRE 250,A00,511389,Morris; Sheldon,9993,0,9999,6
1714211207676,CLRE 251,A00,507176,Mehta; Ravindra L.,9993,0,9999,6
1714211207676,CLRE 251,B00,511410,Mehta; Ravindra L.,9998,0,9999,1
1714211208702,CLRE 252,A00,507189,Cuomo; Raphael Eduardo,9995,0,9999,4
1714211209731,CLRE 253,A00,507199,Vaida; Florin,9994,0,9999,5
1714211209731,CLRE 253,B00,507202,Vaida; Florin,9999,0,9999,0
1714211210756,CLRE 259,A00,507211,Patel; Hemal,9996,0,9999,3
1714211211781,CLRE 260,A00,507221,Cuomo; Raphael Eduardo,9999,0,9999,0
1714211212807,CLRE 297,001,507242,Cuomo; Raphael Eduardo,9999,0,9999,0
1714211213835,COGS 197,001,638244,Voytek; Bradley Thomas,9999,0,9999,0
1714211214862,CSE 191,A00,516875,Minnes Kemp; Mor Mia,9993,0,9999,6
1714211215890,CSE 197,001,637388,Minnes Kemp; Mor Mia,9998,0,9999,1
1714211216973,CSS 201S,A01,494383,Staff,35,0,35,0
1714211217998,CSS 202S,A01,494387,Staff,35,0,35,0
1714211219024,DSC 197,001,628532,Eldridge; Justin Matthew,9996,0,9999,3
1714211220050,EAP 100,A00,516065,Staff,9797,0,9999,202
1714211221074,ECE 45,A01,507414,Staff,33,0,60,27
1714211223123,ECE 111,A01,507420,Staff,21,0,50,29
1714211224147,ECE 197,001,548057,Sievenpiper; Daniel F.,9994,0,9999,5
1714211225172,EDS 115,A00,507243,Choi; Bailey Miyeon,12,0,28,16
1714211226196,EDS 117,A01,494379,Staff,0,1,30,30
1714211227220,EDS 125,A00,507246,Hopkins; Megan Beth,12,0,30,18
1714211228249,EDS 128A,A01,507264,Fargason; Sharon Gayle,14,0,26,12
1714211229273,EDS 128B,A01,507293,Pappas; Elizabeth,18,0,30,12
1714211230298,EDS 139,A00,507294,Fargason; Sharon Gayle,18,0,30,12
1714211230298,EDS 139,B00,507313,Pappas; Elizabeth,15,0,30,15
1714211231325,EDS 201,A00,507315,Staff,13,0,30,17
1714211232349,EDS 203,A01,507317,Halter; Christopher P.,12,0,30,18
1714211233377,EDS 204R,A01,507319,Halter; Christopher P.,0,3,30,30
1714211233377,EDS 204R,B01,507331,Heinzman; Erica M.,17,0,30,13
1714211234402,EDS 206R,A00,507332,Staff,0,4,30,30
1714211234402,EDS 206R,B00,507343,Staff,18,0,30,12
1714211235430,EDS 250,A00,507344,Hemans; Patricia Ann Benitez,22,0,40,18
1714211236454,EDS 281,A00,507345,Daly; Alan J.,18,0,18,0
1714211237478,EDS 284,A00,507350,Daly; Alan J.,16,0,16,0
1714211238504,EDS 286,A00,507359,Fine; Sarah,18,0,18,0
1714211239529,EDS 289C,A01,507361,Daly; Alan J.,18,0,18,0
1714211240554,EDS 290,A00,507366,Hofstetter; Carolyn,15,0,15,0
1714211241585,LIGM 5A,A00,507421,Fischer-Grunski; Eva K,18,0,20,2
1714211242610,LIGM 5B,A00,507423,Fischer-Grunski; Eva K,19,0,20,1
1714211243634,LIGM 5C,A00,507425,Fischer-Grunski; Eva K,19,0,20,1
1714211244662,LIIT 5AS,A00,507427,Carnelos; Chiara,20,0,20,0
1714211245688,LIIT 5BS,A00,507430,Carnelos; Chiara,20,0,20,0
1714211246714,LIIT 5CS,A00,507432,Carnelos; Chiara,20,0,20,0
1714211247740,LISP 5A,A00,507541,Munoz Sanchez; Alicia,11,0,20,9
1714211248765,LISP 5B,A00,507671,Munoz Sanchez; Alicia,9,0,20,11
1714211249796,LISP 5C,A00,507696,Munoz Sanchez; Alicia,9,0,20,11
1714211250821,MAE 197,001,528363,Boechler; Nicholas Sebastia,9998,0,9999,1
1714211251849,MATH 197,001,523477,Kedlaya; Kiran S.,9996,0,9999,3
1714211251849,MATH 197,002,563811,Zhang; Danna,9995,0,9999,4
1714211251849,MATH 197,003,628552,Dumitriu; Ioana,9998,0,9999,1
1714211252876,MCWP 40R,A00,518780,Staff,5,0,20,15
1714211252876,MCWP 40R,B00,518781,Staff,7,0,20,13
1714211252876,MCWP 40R,C00,518783,Staff,5,0,20,15
1714211253900,MCWP 50R,A00,518791,Staff,0,0,20,20
1714211253900,MCWP 50R,B00,518792,Staff,0,1,20,20
1714211253900,MCWP 50R,C00,518793,Staff,0,1,20,20
1714211253900,MCWP 50R,D00,518794,Staff,0,0,20,20
1714211253900,MCWP 50R,E00,518795,Staff,0,1,20,20
1714211253900,MCWP 50R,F00,518796,Staff,0,0,20,20
1714211253900,MCWP 50R,G00,518797,Staff,0,1,20,20
1714211254927,MMW 12R,A01,514034,Herbst; Matthew,0,1,16,16
1714211254927,MMW 12R,A02,514035,Herbst; Matthew,2,0,16,14
1714211255956,MMW 13R,A01,514037,Staff,0,4,16,16
1714211255956,MMW 13R,A02,514039,Staff,0,2,16,16
1714211255956,MMW 13R,A03,628519,Staff,0,2,16,16
1714211258015,SIO 295LS,A00,523233,Staff,13,0,30,17
1714211259045,SIO 295S,A00,523232,Staff,13,0,30,17
1714211260076,SIOC 290S,A01,637330,Merrifield; Mark A,28,0,30,2
1714211261101,SIOC 291S,A01,637333,Gabriel; Corey John,28,0,30,2
1714211262128,SOCI 117,A01,494376,Staff,0,2,5,5
1714211263153,WES 237B,A00,494380,Staff,9,0,20,11
1714211265226,AESE 279B,A00,494370,Wade; Jon P,0,0,33,33
1714211266251,AIP 197,001,627712,Vespa; Emanuel Ignacio,9998,0,9999,1
1714211267276,ANAR 135S,A00,494369,Braswell; Geoffrey E.,0,0,0,0
1714211268302,BENG 196,001,628496,Engler; Adam J.,9998,0,9999,1
1714211269328,CAT 124RS,A01,519847,Geibel; William,0,0,20,20
1714211270356,CAT 125RS,A01,515971,Geibel; William,0,0,20,20
1714211271381,CLRE 250,A00,511389,Morris; Sheldon,9993,0,9999,6
1714211272411,CLRE 251,A00,507176,Mehta; Ravindra L.,9993,0,9999,6
1714211272411,CLRE 251,B00,511410,Mehta; Ravindra L.,9998,0,9999,1
1714211273436,CLRE 252,A00,507189,Cuomo; Raphael Eduardo,9995,0,9999,4
1714211274461,CLRE 253,A00,507199,Vaida; Florin,9994,0,9999,5
1714211274461,CLRE 253,B00,507202,Vaida; Florin,9999,0,9999,0
1714211275488,CLRE 259,A00,507211,Patel; Hemal,9996,0,9999,3
1714211276512,CLRE 260,A00,507221,Cuomo; Raphael Eduardo,9999,0,9999,0
1714211277539,CLRE 297,001,507242,Cuomo; Raphael Eduardo,9999,0,9999,0
1714211278567,COGS 197,001,638244,Voytek; Bradley Thomas,9999,0,9999,0
1714211279592,CSE 191,A00,516875,Minnes Kemp; Mor Mia,9993,0,9999,6
1714211280620,CSE 197,001,637388,Minnes Kemp; Mor Mia,9998,0,9999,1
1714211281646,CSS 201S,A01,494383,Staff,35,0,35,0
1714211282675,CSS 202S,A01,494387,Staff,35,0,35,0
1714211283700,DSC 197,001,628532,Eldridge; Justin Matthew,9996,0,9999,3
1714211284725,EAP 100,A00,516065,Staff,9797,0,9999,202
1714211285755,ECE 45,A01,507414,Staff,33,0,60,27
1714211287805,ECE 111,A01,507420,Staff,21,0,50,29
1714211288832,ECE 197,001,548057,Sievenpiper; Daniel F.,9994,0,9999,5
1714211289861,EDS 115,A00,507243,Choi; Bailey Miyeon,12,0,28,16
1714211290886,EDS 117,A01,494379,Staff,0,1,30,30
1714211291911,EDS 125,A00,507246,Hopkins; Megan Beth,12,0,30,18
1714211292938,EDS 128A,A01,507264,Fargason; Sharon Gayle,14,0,26,12
1714211293967,EDS 128B,A01,507293,Pappas; Elizabeth,18,0,30,12
1714211294992,EDS 139,A00,507294,Fargason; Sharon Gayle,18,0,30,12
1714211294992,EDS 139,B00,507313,Pappas; Elizabeth,15,0,30,15
1714211296020,EDS 201,A00,507315,Staff,13,0,30,17
1714211297046,EDS 203,A01,507317,Halter; Christopher P.,12,0,30,18
1714211298070,EDS 204R,A01,507319,Halter; Christopher P.,0,3,30,30
1714211298070,EDS 204R,B01,507331,Heinzman; Erica M.,17,0,30,13
1714211299096,EDS 206R,A00,507332,Staff,0,4,30,30
1714211299096,EDS 206R,B00,507343,Staff,18,0,30,12
1714211300125,EDS 250,A00,507344,Hemans; Patricia Ann Benitez,22,0,40,18
1714211301151,EDS 281,A00,507345,Daly; Alan J.,18,0,18,0
1714211302178,EDS 284,A00,507350,Daly; Alan J.,16,0,16,0
1714211303204,EDS 286,A00,507359,Fine; Sarah,18,0,18,0
1714211304230,EDS 289C,A01,507361,Daly; Alan J.,18,0,18,0
1714211305256,EDS 290,A00,507366,Hofstetter; Carolyn,15,0,15,0
1714211306281,LIGM 5A,A00,507421,Fischer-Grunski; Eva K,18,0,20,2
1714211307309,LIGM 5B,A00,507423,Fischer-Grunski; Eva K,19,0,20,1
1714211308334,LIGM 5C,A00,507425,Fischer-Grunski; Eva K,19,0,20,1
1714211309364,LIIT 5AS,A00,507427,Carnelos; Chiara,20,0,20,0
1714211310390,LIIT 5BS,A00,507430,Carnelos; Chiara,20,0,20,0
1714211311416,LIIT 5CS,A00,507432,Carnelos; Chiara,20,0,20,0
1714211312443,LISP 5A,A00,507541,Munoz Sanchez; Alicia,11,0,20,9
1714211313472,LISP 5B,A00,507671,Munoz Sanchez; Alicia,9,0,20,11
1714211314556,LISP 5C,A00,507696,Munoz Sanchez; Alicia,9,0,20,11
1714211315580,MAE 197,001,528363,Boechler; Nicholas Sebastia,9998,0,9999,1
1714211316604,MATH 197,001,523477,Kedlaya; Kiran S.,9996,0,9999,3
1714211316604,MATH 197,002,563811,Zhang; Danna,9995,0,9999,4
1714211316604,MATH 197,003,628552,Dumitriu; Ioana,9998,0,9999,1
1714211317630,MCWP 40R,A00,518780,Staff,5,0,20,15
1714211317630,MCWP 40R,B00,518781,Staff,7,0,20,13
1714211317630,MCWP 40R,C00,518783,Staff,5,0,20,15
1714211318658,MCWP 50R,A00,518791,Staff,0,0,20,20
1714211318658,MCWP 50R,B00,518792,Staff,0,1,20,20
1714211318658,MCWP 50R,C00,518793,Staff,0,1,20,20
1714211318658,MCWP 50R,D00,518794,Staff,0,0,20,20
1714211318658,MCWP 50R,E00,518795,Staff,0,1,20,20
1714211318658,MCWP 50R,F00,518796,Staff,0,0,20,20
1714211318658,MCWP 50R,G00,518797,Staff,0,1,20,20
1714211319683,MMW 12R,A01,514034,Herbst; Matthew,0,1,16,16
1714211319683,MMW 12R,A02,514035,Herbst; Matthew,2,0,16,14
1714211320761,MMW 13R,A01,514037,Staff,0,4,16,16
1714211320761,MMW 13R,A02,514039,Staff,0,2,16,16
1714211320761,MMW 13R,A03,628519,Staff,0,2,16,16
1714211322814,SIO 295LS,A00,523233,Staff,13,0,30,17
1714211323839,SIO 295S,A00,523232,Staff,13,0,30,17
1714211324867,SIOC 290S,A01,637330,Merrifield; Mark A,28,0,30,2
1714211325896,SIOC 291S,A01,637333,Gabriel; Corey John,28,0,30,2
1714211326922,SOCI 117,A01,494376,Staff,0,2,5,5
1714211327948,WES 237B,A00,494380,Staff,9,0,20,11
1714211330019,AESE 279B,A00,494370,Wade; Jon P,0,0,33,33
1714211331043,AIP 197,001,627712,Vespa; Emanuel Ignacio,9998,0,9999,1
1714211332068,ANAR 135S,A00,494369,Braswell; Geoffrey E.,0,0,0,0
1714211333092,BENG 196,001,628496,Engler; Adam J.,9998,0,9999,1
1714211334119,CAT 124RS,A01,519847,Geibel; William,0,0,20,20
1714211335143,CAT 125RS,A01,515971,Geibel; William,0,0,20,20
1714211336168,CLRE 250,A00,511389,Morris; Sheldon,9993,0,9999,6
1714211337192,CLRE 251,A00,507176,Mehta; Ravindra L.,9993,0,9999,6
1714211337192,CLRE 251,B00,511410,Mehta; Ravindra L.,9998,0,9999,1
1714211338217,CLRE 252,A00,507189,Cuomo; Raphael Eduardo,9995,0,9999,4
1714211339242,CLRE 253,A00,507199,Vaida; Florin,9994,0,9999,5
1714211339242,CLRE 253,B00,507202,Vaida; Florin,9999,0,9999,0
1714211340267,CLRE 259,A00,507211,Patel; Hemal,9996,0,9999,3
1714211341291,CLRE 260,A00,507221,Cuomo; Raphael Eduardo,9999,0,9999,0
1714211342319,CLRE 297,001,507242,Cuomo; Raphael Eduardo,9999,0,9999,0
1714211343347,COGS 197,001,638244,Voytek; Bradley Thomas,9999,0,9999,0
1714211344373,CSE 191,A00,516875,Minnes Kemp; Mor Mia,9993,0,9999,6
1714211345400,CSE 197,001,637388,Minnes Kemp; Mor Mia,9998,0,9999,1
1714211346426,CSS 201S,A01,494383,Staff,35,0,35,0
1714211347455,CSS 202S,A01,494387,Staff,35,0,35,0
1714211348480,DSC 197,001,628532,Eldridge; Justin Matthew,9996,0,9999,3
1714211349507,EAP 100,A00,516065,Staff,9797,0,9999,202
1714211350535,ECE 45,A01,507414,Staff,33,0,60,27
1714211352588,ECE 111,A01,507420,Staff,21,0,50,29
1714211353614,ECE 197,001,548057,Sievenpiper; Daniel F.,9994,0,9999,5
1714211354638,EDS 115,A00,507243,Choi; Bailey Miyeon,12,0,28,16
1714211355664,EDS 117,A01,494379,Staff,0,1,30,30
1714211356689,EDS 125,A00,507246,Hopkins; Megan Beth,12,0,30,18
1714211357713,EDS 128A,A01,507264,Fargason; Sharon Gayle,14,0,26,12
1714211358743,EDS 128B,A01,507293,Pappas; Elizabeth,18,0,30,12
1714211359768,EDS 139,A00,507294,Fargason; Sharon Gayle,18,0,30,12
1714211359768,EDS 139,B00,507313,Pappas; Elizabeth,15,0,30,15
1714211360794,EDS 201,A00,507315,Staff,13,0,30,17
1714211361817,EDS 203,A01,507317,Halter; Christopher P.,12,0,30,18
1714211362845,EDS 204R,A01,507319,Halter; Christopher P.,0,3,30,30
1714211362845,EDS 204R,B01,507331,Heinzman; Erica M.,17,0,30,13
1714211363873,EDS 206R,A00,507332,Staff,0,4,30,30
1714211363873,EDS 206R,B00,507343,Staff,18,0,30,12
1714211364898,EDS 250,A00,507344,Hemans; Patricia Ann Benitez,22,0,40,18
1714211365923,EDS 281,A00,507345,Daly; Alan J.,18,0,18,0
1714211366950,EDS 284,A00,507350,Daly; Alan J.,16,0,16,0
1714211367977,EDS 286,A00,507359,Fine; Sarah,18,0,18,0
1714211369006,EDS 289C,A01,507361,Daly; Alan J.,18,0,18,0
1714211370033,EDS 290,A00,507366,Hofstetter; Carolyn,15,0,15,0
1714211371061,LIGM 5A,A00,507421,Fischer-Grunski; Eva K,18,0,20,2
1714211372087,LIGM 5B,A00,507423,Fischer-Grunski; Eva K,19,0,20,1
1714211373116,LIGM 5C,A00,507425,Fischer-Grunski; Eva K,19,0,20,1
1714211374144,LIIT 5AS,A00,507427,Carnelos; Chiara,20,0,20,0
1714211375169,LIIT 5BS,A00,507430,Carnelos; Chiara,20,0,20,0
1714211376193,LIIT 5CS,A00,507432,Carnelos; Chiara,20,0,20,0
1714211377220,LISP 5A,A00,507541,Munoz Sanchez; Alicia,11,0,20,9
1714211378246,LISP 5B,A00,507671,Munoz Sanchez; Alicia,9,0,20,11
1714211379275,LISP 5C,A00,507696,Munoz Sanchez; Alicia,9,0,20,11
1714211380300,MAE 197,001,528363,Boechler; Nicholas Sebastia,9998,0,9999,1
1714211381328,MATH 197,001,523477,Kedlaya; Kiran S.,9996,0,9999,3
1714211381328,MATH 197,002,563811,Zhang; Danna,9995,0,9999,4
1714211381328,MATH 197,003,628552,Dumitriu; Ioana,9998,0,9999,1
1714211382356,MCWP 40R,A00,518780,Staff,5,0,20,15
1714211382356,MCWP 40R,B00,518781,Staff,7,0,20,13
1714211382356,MCWP 40R,C00,518783,Staff,5,0,20,15
1714211383387,MCWP 50R,A00,518791,Staff,0,0,20,20
1714211383387,MCWP 50R,B00,518792,Staff,0,1,20,20
1714211383387,MCWP 50R,C00,518793,Staff,0,1,20,20
1714211383387,MCWP 50R,D00,518794,Staff,0,0,20,20
1714211383387,MCWP 50R,E00,518795,Staff,0,1,20,20
1714211383387,MCWP 50R,F00,518796,Staff,0,0,20,20
1714211383387,MCWP 50R,G00,518797,Staff,0,1,20,20
1714211384416,MMW 12R,A01,514034,Herbst; Matthew,0,1,16,16
1714211384416,MMW 12R,A02,514035,Herbst; Matthew,2,0,16,14
1714211385443,MMW 13R,A01,514037,Staff,0,4,16,16
1714211385443,MMW 13R,A02,514039,Staff,0,2,16,16
1714211385443,MMW 13R,A03,628519,Staff,0,2,16,16
1714211387494,SIO 295LS,A00,523233,Staff,13,0,30,17
1714211388523,SIO 295S,A00,523232,Staff,13,0,30,17
1714211389550,SIOC 290S,A01,637330,Merrifield; Mark A,28,0,30,2
1714211390578,SIOC 291S,A01,637333,Gabriel; Corey John,28,0,30,2
1714211391606,SOCI 117,A01,494376,Staff,0,2,5,5
1714211392632,WES 237B,A00,494380,Staff,9,0,20,11
1714211394703,AESE 279B,A00,494370,Wade; Jon P,0,0,33,33
1714211395732,AIP 197,001,627712,Vespa; Emanuel Ignacio,9998,0,9999,1
1714211396760,ANAR 135S,A00,494369,Braswell; Geoffrey E.,0,0,0,0
1714211397786,BENG 196,001,628496,Engler; Adam J.,9998,0,9999,1
1714211398816,CAT 124RS,A01,519847,Geibel; William,0,0,20,20
1714211399840,CAT 125RS,A01,515971,Geibel; William,0,0,20,20
1714211400867,CLRE 250,A00,511389,Morris; Sheldon,9993,0,9999,6
1714211401896,CLRE 251,A00,507176,Mehta; Ravindra L.,9993,0,9999,6
1714211401896,CLRE 251,B00,511410,Mehta; Ravindra L.,9998,0,9999,1
1714211402921,CLRE 252,A00,507189,Cuomo; Raphael Eduardo,9995,0,9999,4
1714211403952,CLRE 253,A00,507199,Vaida; Florin,9994,0,9999,5
1714211403952,CLRE 253,B00,507202,Vaida; Florin,9999,0,9999,0
1714211404977,CLRE 259,A00,507211,Patel; Hemal,9996,0,9999,3
1714211406004,CLRE 260,A00,507221,Cuomo; Raphael Eduardo,9999,0,9999,0
1714211407031,CLRE 297,001,507242,Cuomo; Raphael Eduardo,9999,0,9999,0
1714211408056,COGS 197,001,638244,Voytek; Bradley Thomas,9999,0,9999,0
1714211409084,CSE 191,A00,516875,Minnes Kemp; Mor Mia,9993,0,9999,6
1714211410108,CSE 197,001,637388,Minnes Kemp; Mor Mia,9998,0,9999,1
1714211411137,CSS 201S,A01,494383,Staff,35,0,35,0
1714211412162,CSS 202S,A01,494387,Staff,35,0,35,0
1714211413188,DSC 197,001,628532,Eldridge; Justin Matthew,9996,0,9999,3
1714211414215,EAP 100,A00,516065,Staff,9797,0,9999,202
1714211415240,ECE 45,A01,507414,Staff,33,0,60,27
1714211417293,ECE 111,A01,507420,Staff,21,0,50,29
1714211418320,ECE 197,001,548057,Sievenpiper; Daniel F.,9994,0,9999,5
1714211419346,EDS 115,A00,507243,Choi; Bailey Miyeon,12,0,28,16
1714211420373,EDS 117,A01,494379,Staff,0,1,30,30
1714211421398,EDS 125,A00,507246,Hopkins; Megan Beth,12,0,30,18
1714211422425,EDS 128A,A01,507264,Fargason; Sharon Gayle,14,0,26,12
1714211423450,EDS 128B,A01,507293,Pappas; Elizabeth,18,0,30,12
1714211424528,EDS 139,A00,507294,Fargason; Sharon Gayle,18,0,30,12
1714211424528,EDS 139,B00,507313,Pappas; Elizabeth,15,0,30,15
1714211425555,EDS 201,A00,507315,Staff,13,0,30,17
1714211426580,EDS 203,A01,507317,Halter; Christopher P.,12,0,30,18
1714211427605,EDS 204R,A01,507319,Halter; Christopher P.,0,3,30,30
1714211427605,EDS 204R,B01,507331,Heinzman; Erica M.,17,0,30,13
1714211428630,EDS 206R,A00,507332,Staff,0,4,30,30
1714211428630,EDS 206R,B00,507343,Staff,18,0,30,12
1714211429655,EDS 250,A00,507344,Hemans; Patricia Ann Benitez,22,0,40,18
1714211430682,EDS 281,A00,507345,Daly; Alan J.,18,0,18,0
1714211431707,EDS 284,A00,507350,Daly; Alan J.,16,0,16,0
1714211432732,EDS 286,A00,507359,Fine; Sarah,18,0,18,0
1714211433756,EDS 289C,A01,507361,Daly; Alan J.,18,0,18,0
1714211434782,EDS 290,A00,507366,Hofstetter; Carolyn,15,0,15,0
1714211435807,LIGM 5A,A00,507421,Fischer-Grunski; Eva K,18,0,20,2
1714211436834,LIGM 5B,A00,507423,Fischer-Grunski; Eva K,19,0,20,1
1714211437861,LIGM 5C,A00,507425,Fischer-Grunski; Eva K,19,0,20,1
1714211438886,LIIT 5AS,A00,507427,Carnelos; Chiara,20,0,20,0
1714211439911,LIIT 5BS,A00,507430,Carnelos; Chiara,20,0,20,0
1714211440940,LIIT 5CS,A00,507432,Carnelos; Chiara,20,0,20,0
1714211441969,LISP 5A,A00,507541,Munoz Sanchez; Alicia,11,0,20,9
1714211442994,LISP 5B,A00,507671,Munoz Sanchez; Alicia,9,0,20,11
1714211444020,LISP 5C,A00,507696,Munoz Sanchez; Alicia,9,0,20,11
1714211445045,MAE 197,001,528363,Boechler; Nicholas Sebastia,9998,0,9999,1
1714211446069,MATH 197,001,523477,Kedlaya; Kiran S.,9996,0,9999,3
1714211446069,MATH 197,002,563811,Zhang; Danna,9995,0,9999,4
1714211446069,MATH 197,003,628552,Dumitriu; Ioana,9998,0,9999,1
1714211447095,MCWP 40R,A00,518780,Staff,5,0,20,15
1714211447095,MCWP 40R,B00,518781,Staff,7,0,20,13
1714211447095,MCWP 40R,C00,518783,Staff,5,0,20,15
1714211448119,MCWP 50R,A00,518791,Staff,0,0,20,20
1714211448119,MCWP 50R,B00,518792,Staff,0,1,20,20
1714211448119,MCWP 50R,C00,518793,Staff,0,1,20,20
1714211448119,MCWP 50R,D00,518794,Staff,0,0,20,20
1714211448119,MCWP 50R,E00,518795,Staff,0,1,20,20
1714211448119,MCWP 50R,F00,518796,Staff,0,0,20,20
1714211448119,MCWP 50R,G00,518797,Staff,0,1,20,20
1714211449148,MMW 12R,A01,514034,Herbst; Matthew,0,1,16,16
1714211449148,MMW 12R,A02,514035,Herbst; Matthew,2,0,16,14
1714211450173,MMW 13R,A01,514037,Staff,0,4,16,16
1714211450173,MMW 13R,A02,514039,Staff,0,2,16,16
1714211450173,MMW 13R,A03,628519,Staff,0,2,16,16
1714211452225,SIO 295LS,A00,523233,Staff,13,0,30,17
1714211453250,SIO 295S,A00,523232,Staff,13,0,30,17
1714211454279,SIOC 290S,A01,637330,Merrifield; Mark A,28,0,30,2
1714211455304,SIOC 291S,A01,637333,Gabriel; Corey John,28,0,30,2
1714211456329,SOCI 117,A01,494376,Staff,0,2,5,5
1714211457356,WES 237B,A00,494380,Staff,9,0,20,11
1714211459425,AESE 279B,A00,494370,Wade; Jon P,0,0,33,33
1714211460453,AIP 197,001,627712,Vespa; Emanuel Ignacio,9998,0,9999,1
1714211461477,ANAR 135S,A00,494369,Braswell; Geoffrey E.,0,0,0,0
1714211462504,BENG 196,001,628496,Engler; Adam J.,9998,0,9999,1
1714211463529,CAT 124RS,A01,519847,Geibel; William,0,0,20,20
1714211464556,CAT 125RS,A01,515971,Geibel; William,0,0,20,20
1714211465584,CLRE 250,A00,511389,Morris; Sheldon,9993,0,9999,6
1714211466611,CLRE 251,A00,507176,Mehta; Ravindra L.,9993,0,9999,6
1714211466611,CLRE 251,B00,511410,Mehta; Ravindra L.,9998,0,9999,1
1714211467639,CLRE 252,A00,507189,Cuomo; Raphael Eduardo,9995,0,9999,4
1714211468664,CLRE 253,A00,507199,Vaida; Florin,9994,0,9999,5
1714211468664,CLRE 253,B00,507202,Vaida; Florin,9999,0,9999,0
1714211469690,CLRE 259,A00,507211,Patel; Hemal,9996,0,9999,3
1714211470715,CLRE 260,A00,507221,Cuomo; Raphael Eduardo,9999,0,9999,0
1714211471744,CLRE 297,001,507242,Cuomo; Raphael Eduardo,9999,0,9999,0
1714211472772,COGS 197,001,638244,Voytek; Bradley Thomas,9999,0,9999,0
1714211473799,CSE 191,A00,516875,Minnes Kemp; Mor Mia,9993,0,9999,6
1714211474823,CSE 197,001,637388,Minnes Kemp; Mor Mia,9998,0,9999,1
1714211475855,CSS 201S,A01,494383,Staff,35,0,35,0
1714211476885,CSS 202S,A01,494387,Staff,35,0,35,0
1714211477908,DSC 197,001,628532,Eldridge; Justin Matthew,9996,0,9999,3
1714211478933,EAP 100,A00,516065,Staff,9797,0,9999,202
1714211479963,ECE 45,A01,507414,Staff,33,0,60,27
1714211482017,ECE 111,A01,507420,Staff,21,0,50,29
1714211483045,ECE 197,001,548057,Sievenpiper; Daniel F.,9994,0,9999,5
1714211484074,EDS 115,A00,507243,Choi; Bailey Miyeon,12,0,28,16
1714211485100,EDS 117,A01,494379,Staff,0,1,30,30
1714211486128,EDS 125,A00,507246,Hopkins; Megan Beth,12,0,30,18
1714211487156,EDS 128A,A01,507264,Fargason; Sharon Gayle,14,0,26,12
1714211488185,EDS 128B,A01,507293,Pappas; Elizabeth,18,0,30,12
1714211489213,EDS 139,A00,507294,Fargason; Sharon Gayle,18,0,30,12
1714211489213,EDS 139,B00,507313,Pappas; Elizabeth,15,0,30,15
1714211490240,EDS 201,A00,507315,Staff,13,0,30,17
1714211491271,EDS 203,A01,507317,Halter; Christopher P.,12,0,30,18
1714211492297,EDS 204R,A01,507319,Halter; Christopher P.,0,3,30,30
1714211492297,EDS 204R,B01,507331,Heinzman; Erica M.,17,0,30,13
1714211493322,EDS 206R,A00,507332,Staff,0,4,30,30
1714211493322,EDS 206R,B00,507343,Staff,18,0,30,12
1714211494350,EDS 250,A00,507344,Hemans; Patricia Ann Benitez,22,0,40,18
1714211495378,EDS 281,A00,507345,Daly; Alan J.,18,0,18,0
1714211496405,EDS 284,A00,507350,Daly; Alan J.,16,0,16,0
1714211497434,EDS 286,A00,507359,Fine; Sarah,18,0,18,0
1714211498458,EDS 289C,A01,507361,Daly; Alan J.,18,0,18,0
1714211499485,EDS 290,A00,507366,Hofstetter; Carolyn,15,0,15,0
1714211500510,LIGM 5A,A00,507421,Fischer-Grunski; Eva K,18,0,20,2
1714211501534,LIGM 5B,A00,507423,Fischer-Grunski; Eva K,19,0,20,1
1714211502558,LIGM 5C,A00,507425,Fischer-Grunski; Eva K,19,0,20,1
1714211503585,LIIT 5AS,A00,507427,Carnelos; Chiara,20,0,20,0
1714211504610,LIIT 5BS,A00,507430,Carnelos; Chiara,20,0,20,0
1714211505639,LIIT 5CS,A00,507432,Carnelos; Chiara,20,0,20,0
1714211506665,LISP 5A,A00,507541,Munoz Sanchez; Alicia,11,0,20,9
1714211507694,LISP 5B,A00,507671,Munoz Sanchez; Alicia,9,0,20,11
1714211508719,LISP 5C,A00,507696,Munoz Sanchez; Alicia,9,0,20,11
1714211509747,MAE 197,001,528363,Boechler; Nicholas Sebastia,9998,0,9999,1
1714211510778,MATH 197,001,523477,Kedlaya; Kiran S.,9996,0,9999,3
1714211510778,MATH 197,002,563811,Zhang; Danna,9995,0,9999,4
1714211510778,MATH 197,003,628552,Dumitriu; Ioana,9998,0,9999,1
1714211511807,MCWP 40R,A00,518780,Staff,5,0,20,15
1714211511807,MCWP 40R,B00,518781,Staff,7,0,20,13
1714211511807,MCWP 40R,C00,518783,Staff,5,0,20,15
1714211512835,MCWP 50R,A00,518791,Staff,0,0,20,20
1714211512835,MCWP 50R,B00,518792,Staff,0,1,20,20
1714211512835,MCWP 50R,C00,518793,Staff,0,1,20,20
1714211512835,MCWP 50R,D00,518794,Staff,0,0,20,20
1714211512835,MCWP 50R,E00,518795,Staff,0,1,20,20
1714211512835,MCWP 50R,F00,518796,Staff,0,0,20,20
1714211512835,MCWP 50R,G00,518797,Staff,0,1,20,20
1714211513862,MMW 12R,A01,514034,Herbst; Matthew,0,1,16,16
1714211513862,MMW 12R,A02,514035,Herbst; Matthew,2,0,16,14
1714211514891,MMW 13R,A01,514037,Staff,0,4,16,16
1714211514891,MMW 13R,A02,514039,Staff,0,2,16,16
1714211514891,MMW 13R,A03,628519,Staff,0,2,16,16
1714211516944,SIO 295LS,A00,523233,Staff,13,0,30,17
1714211517968,SIO 295S,A00,523232,Staff,13,0,30,17
1714211518995,SIOC 290S,A01,637330,Merrifield; Mark A,28,0,30,2
1714211520024,SIOC 291S,A01,637333,Gabriel; Corey John,28,0,30,2
1714211521050,SOCI 117,A01,494376,Staff,0,2,5,5
1714211522076,WES 237B,A00,494380,Staff,9,0,20,11
1714211524150,AESE 279B,A00,494370,Wade; Jon P,0,0,33,33
1714211525176,AIP 197,001,627712,Vespa; Emanuel Ignacio,9998,0,9999,1
1714211526203,ANAR 135S,A00,494369,Braswell; Geoffrey E.,0,0,0,0
1714211527230,BENG 196,001,628496,Engler; Adam J.,9998,0,9999,1
1714211528310,CAT 124RS,A01,519847,Geibel; William,0,0,20,20
1714211529334,CAT 125RS,A01,515971,Geibel; William,0,0,20,20
1714211530361,CLRE 250,A00,511389,Morris; Sheldon,9993,0,9999,6
1714211531392,CLRE 251,A00,507176,Mehta; Ravindra L.,9993,0,9999,6
1714211531392,CLRE 251,B00,511410,Mehta; Ravindra L.,9998,0,9999,1
1714211532419,CLRE 252,A00,507189,Cuomo; Raphael Eduardo,9995,0,9999,4
1714211533445,CLRE 253,A00,507199,Vaida; Florin,9994,0,9999,5
1714211533445,CLRE 253,B00,507202,Vaida; Florin,9999,0,9999,0
1714211534471,CLRE 259,A00,507211,Patel; Hemal,9996,0,9999,3
1714211535500,CLRE 260,A00,507221,Cuomo; Raphael Eduardo,9999,0,9999,0
1714211536524,CLRE 297,001,507242,Cuomo; Raphael Eduardo,9999,0,9999,0
1714211537550,COGS 197,001,638244,Voytek; Bradley Thomas,9999,0,9999,0
1714211538580,CSE 191,A00,516875,Minnes Kemp; Mor Mia,9993,0,9999,6
1714211539606,CSE 197,001,637388,Minnes Kemp; Mor Mia,9998,0,9999,1
1714211540634,CSS 201S,A01,494383,Staff,35,0,35,0
1714211541658,CSS 202S,A01,494387,Staff,35,0,35,0
1714211542687,DSC 197,001,628532,Eldridge; Justin Matthew,9996,0,9999,3
1714211543713,EAP 100,A00,516065,Staff,9797,0,9999,202
1714211544739,ECE 45,A01,507414,Staff,33,0,60,27
1714211546819,ECE 111,A01,507420,Staff,21,0,50,29
1714211547847,ECE 197,001,548057,Sievenpiper; Daniel F.,9994,0,9999,5
1714211548873,EDS 115,A00,507243,Choi; Bailey Miyeon,12,0,28,16
1714211549898,EDS 117,A01,494379,Staff,0,1,30,30
1714211550924,EDS 125,A00,507246,Hopkins; Megan Beth,12,0,30,18
1714211551953,EDS 128A,A01,507264,Fargason; Sharon Gayle,14,0,26,12
1714211552978,EDS 128B,A01,507293,Pappas; Elizabeth,18,0,30,12
1714211554002,EDS 139,A00,507294,Fargason; Sharon Gayle,18,0,30,12
1714211554002,EDS 139,B00,507313,Pappas; Elizabeth,15,0,30,15
1714211555029,EDS 201,A00,507315,Staff,13,0,30,17
1714211556054,EDS 203,A01,507317,Halter; Christopher P.,12,0,30,18
1714211557078,EDS 204R,A01,507319,Halter; Christopher P.,0,3,30,30
1714211557078,EDS 204R,B01,507331,Heinzman; Erica M.,17,0,30,13
1714211558106,EDS 206R,A00,507332,Staff,0,4,30,30
1714211558106,EDS 206R,B00,507343,Staff,18,0,30,12
1714211559132,EDS 250,A00,507344,Hemans; Patricia Ann Benitez,22,0,40,18
1714211560157,EDS 281,A00,507345,Daly; Alan J.,18,0,18,0
1714211561181,EDS 284,A00,507350,Daly; Alan J.,16,0,16,0
1714211562210,EDS 286,A00,507359,Fine; Sarah,18,0,18,0
1714211563234,EDS 289C,A01,507361,Daly; Alan J.,18,0,18,0
1714211564263,EDS 290,A00,507366,Hofstetter; Carolyn,15,0,15,0
1714211565290,LIGM 5A,A00,507421,Fischer-Grunski; Eva K,18,0,20,2
1714211566315,LIGM 5B,A00,507423,Fischer-Grunski; Eva K,19,0,20,1
1714211567344,LIGM 5C,A00,507425,Fischer-Grunski; Eva K,19,0,20,1
1714211568370,LIIT 5AS,A00,507427,Carnelos; Chiara,20,0,20,0
1714211569399,LIIT 5BS,A00,507430,Carnelos; Chiara,20,0,20,0
1714211570428,LIIT 5CS,A00,507432,Carnelos; Chiara,20,0,20,0
1714211571454,LISP 5A,A00,507541,Munoz Sanchez; Alicia,11,0,20,9
1714211572481,LISP 5B,A00,507671,Munoz Sanchez; Alicia,9,0,20,11
1714211573510,LISP 5C,A00,507696,Munoz Sanchez; Alicia,9,0,20,11
1714211574535,MAE 197,001,528363,Boechler; Nicholas Sebastia,9998,0,9999,1
1714211575561,MATH 197,001,523477,Kedlaya; Kiran S.,9996,0,9999,3
1714211575561,MATH 197,002,563811,Zhang; Danna,9995,0,9999,4
1714211575561,MATH 197,003,628552,Dumitriu; Ioana,9998,0,9999,1
1714211576588,MCWP 40R,A00,518780,Staff,5,0,20,15
1714211576588,MCWP 40R,B00,518781,Staff,7,0,20,13
1714211576588,MCWP 40R,C00,518783,Staff,5,0,20,15
1714211577614,MCWP 50R,A00,518791,Staff,0,0,20,20
1714211577614,MCWP 50R,B00,518792,Staff,0,1,20,20
1714211577614,MCWP 50R,C00,518793,Staff,0,1,20,20
1714211577614,MCWP 50R,D00,518794,Staff,0,0,20,20
1714211577614,MCWP 50R,E00,518795,Staff,0,1,20,20
1714211577614,MCWP 50R,F00,518796,Staff,0,0,20,20
1714211577614,MCWP 50R,G00,518797,Staff,0,1,20,20
1714211578643,MMW 12R,A01,514034,Herbst; Matthew,0,1,16,16
1714211578643,MMW 12R,A02,514035,Herbst; Matthew,2,0,16,14
1714211579669,MMW 13R,A01,514037,Staff,0,4,16,16
1714211579669,MMW 13R,A02,514039,Staff,0,2,16,16
1714211579669,MMW 13R,A03,628519,Staff,0,2,16,16
1714211581719,SIO 295LS,A00,523233,Staff,13,0,30,17
1714211582748,SIO 295S,A00,523232,Staff,13,0,30,17
1714211583775,SIOC 290S,A01,637330,Merrifield; Mark A,28,0,30,2
1714211584801,SIOC 291S,A01,637333,Gabriel; Corey John,28,0,30,2
1714211585827,SOCI 117,A01,494376,Staff,0,2,5,5
1714211586856,WES 237B,A00,494380,Staff,9,0,20,11
1714211588922,AESE 279B,A00,494370,Wade; Jon P,0,0,33,33
1714211589948,AIP 197,001,627712,Vespa; Emanuel Ignacio,9998,0,9999,1
1714211590973,ANAR 135S,A00,494369,Braswell; Geoffrey E.,0,0,0,0
1714211591999,BENG 196,001,628496,Engler; Adam J.,9998,0,9999,1
1714211593025,CAT 124RS,A01,519847,Geibel; William,0,0,20,20
1714211594051,CAT 125RS,A01,515971,Geibel; William,0,0,20,20
1714211595078,CLRE 250,A00,511389,Morris; Sheldon,9993,0,9999,6
1714211596106,CLRE 251,A00,507176,Mehta; Ravindra L.,9993,0,9999,6
1714211596106,CLRE 251,B00,511410,Mehta; Ravindra L.,9998,0,9999,1
1714211597133,CLRE 252,A00,507189,Cuomo; Raphael Eduardo,9995,0,9999,4
1714211598160,CLRE 253,A00,507199,Vaida; Florin,9994,0,9999,5
1714211598160,CLRE 253,B00,507202,Vaida; Florin,9999,0,9999,0
1714211599189,CLRE 259,A00,507211,Patel; Hemal,9996,0,9999,3
1714211600216,CLRE 260,A00,507221,Cuomo; Raphael Eduardo,9999,0,9999,0
1714211601241,CLRE 297,001,507242,Cuomo; Raphael Eduardo,9999,0,9999,0
1714211602270,COGS 197,001,638244,Voytek; Bradley Thomas,9999,0,9999,0
1714211603298,CSE 191,A00,516875,Minnes Kemp; Mor Mia,9993,0,9999,6
1714211604324,CSE 197,001,637388,Minnes Kemp; Mor Mia,9998,0,9999,1
1714211605351,CSS 201S,A01,494383,Staff,35,0,35,0
1714211606381,CSS 202S,A01,494387,Staff,35,0,35,0
1714211607408,DSC 197,001,628532,Eldridge; Justin Matthew,9996,0,9999,3
1714211608433,EAP 100,A00,516065,Staff,9797,0,9999,202
1714211609460,ECE 45,A01,507414,Staff,33,0,60,27
1714211611514,ECE 111,A01,507420,Staff,21,0,50,29
1714211612540,ECE 197,001,548057,Sievenpiper; Daniel F.,9994,0,9999,5
1714211613567,EDS 115,A00,507243,Choi; Bailey Miyeon,12,0,28,16
1714211614592,EDS 117,A01,494379,Staff,0,1,30,30
1714211615617,EDS 125,A00,507246,Hopkins; Megan Beth,12,0,30,18
1714211616642,EDS 128A,A01,507264,Fargason; Sharon Gayle,14,0,26,12
1714211617671,EDS 128B,A01,507293,Pappas; Elizabeth,18,0,30,12
1714211618699,EDS 139,A00,507294,Fargason; Sharon Gayle,18,0,30,12
1714211618699,EDS 139,B00,507313,Pappas; Elizabeth,15,0,30,15
1714211619724,EDS 201,A00,507315,Staff,13,0,30,17
1714211620750,EDS 203,A01,507317,Halter; Christopher P.,12,0,30,18
1714211621776,EDS 204R,A01,507319,Halter; Christopher P.,0,3,30,30
1714211621776,EDS 204R,B01,507331,Heinzman; Erica M.,17,0,30,13
1714211622801,EDS 206R,A00,507332,Staff,0,4,30,30
1714211622801,EDS 206R,B00,507343,Staff,18,0,30,12
1714211623830,EDS 250,A00,507344,Hemans; Patricia Ann Benitez,22,0,40,18
1714211624858,EDS 281,A00,507345,Daly; Alan J.,18,0,18,0
1714211625886,EDS 284,A00,507350,Daly; Alan J.,16,0,16,0
1714211626912,EDS 286,A00,507359,Fine; Sarah,18,0,18,0
1714211627936,EDS 289C,A01,507361,Daly; Alan J.,18,0,18,0
1714211628961,EDS 290,A00,507366,Hofstetter; Carolyn,15,0,15,0
1714211629986,LIGM 5A,A00,507421,Fischer-Grunski; Eva K,18,0,20,2
1714211631011,LIGM 5B,A00,507423,Fischer-Grunski; Eva K,19,0,20,1
1714211632093,LIGM 5C,A00,507425,Fischer-Grunski; Eva K,19,0,20,1
1714211633119,LIIT 5AS,A00,507427,Carnelos; Chiara,20,0,20,0
1714211634146,LIIT 5BS,A00,507430,Carnelos; Chiara,20,0,20,0
1714211635172,LIIT 5CS,A00,507432,Carnelos; Chiara,20,0,20,0
1714211636197,LISP 5A,A00,507541,Munoz Sanchez; Alicia,11,0,20,9
1714211637226,LISP 5B,A00,507671,Munoz Sanchez; Alicia,9,0,20,11
1714211638252,LISP 5C,A00,507696,Munoz Sanchez; Alicia,9,0,20,11
1714211639278,MAE 197,001,528363,Boechler; Nicholas Sebastia,9998,0,9999,1
1714211640305,MATH 197,001,523477,Kedlaya; Kiran S.,9996,0,9999,3
1714211640305,MATH 197,002,563811,Zhang; Danna,9995,0,9999,4
1714211640305,MATH 197,003,628552,Dumitriu; Ioana,9998,0,9999,1
1714211641330,MCWP 40R,A00,518780,Staff,5,0,20,15
1714211641330,MCWP 40R,B00,518781,Staff,7,0,20,13
1714211641330,MCWP 40R,C00,518783,Staff,5,0,20,15
1714211642359,MCWP 50R,A00,518791,Staff,0,0,20,20
1714211642359,MCWP 50R,B00,518792,Staff,0,1,20,20
1714211642359,MCWP 50R,C00,518793,Staff,0,1,20,20
1714211642359,MCWP 50R,D00,518794,Staff,0,0,20,20
1714211642359,MCWP 50R,E00,518795,Staff,0,1,20,20
1714211642359,MCWP 50R,F00,518796,Staff,0,0,20,20
1714211642359,MCWP 50R,G00,518797,Staff,0,1,20,20
1714211643384,MMW 12R,A01,514034,Herbst; Matthew,0,1,16,16
1714211643384,MMW 12R,A02,514035,Herbst; Matthew,2,0,16,14
1714211644408,MMW 13R,A01,514037,Staff,0,4,16,16
1714211644408,MMW 13R,A02,514039,Staff,0,2,16,16
1714211644408,MMW 13R,A03,628519,Staff,0,2,16,16
1714211646459,SIO 295LS,A00,523233,Staff,13,0,30,17
1714211647485,SIO 295S,A00,523232,Staff,13,0,30,17
1714211648510,SIOC 290S,A01,637330,Merrifield; Mark A,28,0,30,2
1714211649535,SIOC 291S,A01,637333,Gabriel; Corey John,28,0,30,2
1714211650561,SOCI 117,A01,494376,Staff,0,2,5,5
1714211651587,WES 237B,A00,494380,Staff,9,0,20,11
1714211653663,AESE 279B,A00,494370,Wade; Jon P,0,0,33,33
1714211654691,AIP 197,001,627712,Vespa; Emanuel Ignacio,9998,0,9999,1
1714211655717,ANAR 135S,A00,494369,Braswell; Geoffrey E.,0,0,0,0
1714211656742,BENG 196,001,628496,Engler; Adam J.,9998,0,9999,1
1714211657769,CAT 124RS,A01,519847,Geibel; William,0,0,20,20
1714211658798,CAT 125RS,A01,515971,Geibel; William,0,0,20,20
1714211659826,CLRE 250,A00,511389,Morris; Sheldon,9993,0,9999,6
1714211660858,CLRE 251,A00,507176,Mehta; Ravindra L.,9993,0,9999,6
1714211660858,CLRE 251,B00,511410,Mehta; Ravindra L.,9998,0,9999,1
1714211661886,CLRE 252,A00,507189,Cuomo; Raphael Eduardo,9995,0,9999,4
1714211662916,CLRE 253,A00,507199,Vaida; Florin,9994,0,9999,5
1714211662916,CLRE 253,B00,507202,Vaida; Florin,9999,0,9999,0
1714211663941,CLRE 259,A00,507211,Patel; Hemal,9996,0,9999,3
1714211664967,CLRE 260,A00,507221,Cuomo; Raphael Eduardo,9999,0,9999,0
1714211665993,CLRE 297,001,507242,Cuomo; Raphael Eduardo,9999,0,9999,0
1714211667020,COGS 197,001,638244,Voytek; Bradley Thomas,9999,0,9999,0
1714211668046,CSE 191,A00,516875,Minnes Kemp; Mor Mia,9993,0,9999,6
1714211669074,CSE 197,001,637388,Minnes Kemp; Mor Mia,9998,0,9999,1
1714211670101,CSS 201S,A01,494383,Staff,35,0,35,0
1714211671127,CSS 202S,A01,494387,Staff,35,0,35,0
1714211672156,DSC 197,001,628532,Eldridge; Justin Matthew,9996,0,9999,3
1714211673181,EAP 100,A00,516065,Staff,9797,0,9999,202
1714211674209,ECE 45,A01,507414,Staff,33,0,60,27
1714211676260,ECE 111,A01,507420,Staff,21,0,50,29
1714211677287,ECE 197,001,548057,Sievenpiper; Daniel F.,9994,0,9999,5
1714211678312,EDS 115,A00,507243,Choi; Bailey Miyeon,12,0,28,16
1714211679340,EDS 117,A01,494379,Staff,0,1,30,30
1714211680368,EDS 125,A00,507246,Hopkins; Megan Beth,12,0,30,18
1714211681394,EDS 128A,A01,507264,Fargason; Sharon Gayle,14,0,26,12
1714211682425,EDS 128B,A01,507293,Pappas; Elizabeth,18,0,30,12
1714211683449,EDS 139,A00,507294,Fargason; Sharon Gayle,18,0,30,12
1714211683449,EDS 139,B00,507313,Pappas; Elizabeth,15,0,30,15
1714211684474,EDS 201,A00,507315,Staff,13,0,30,17
1714211685501,EDS 203,A01,507317,Halter; Christopher P.,12,0,30,18
1714211686528,EDS 204R,A01,507319,Halter; Christopher P.,0,3,30,30
1714211686528,EDS 204R,B01,507331,Heinzman; Erica M.,17,0,30,13
1714211687554,EDS 206R,A00,507332,Staff,0,4,30,30
1714211687554,EDS 206R,B00,507343,Staff,18,0,30,12
1714211688581,EDS 250,A00,507344,Hemans; Patricia Ann Benitez,22,0,40,18
1714211689610,EDS 281,A00,507345,Daly; Alan J.,18,0,18,0
1714211690636,EDS 284,A00,507350,Daly; Alan J.,16,0,16,0
1714211691663,EDS 286,A00,507359,Fine; Sarah,18,0,18,0
1714211692689,EDS 289C,A01,507361,Daly; Alan J.,18,0,18,0
1714211693716,EDS 290,A00,507366,Hofstetter; Carolyn,15,0,15,0
1714211694743,LIGM 5A,A00,507421,Fischer-Grunski; Eva K,18,0,20,2
1714211695768,LIGM 5B,A00,507423,Fischer-Grunski; Eva K,19,0,20,1
1714211696794,LIGM 5C,A00,507425,Fischer-Grunski; Eva K,19,0,20,1
1714211697825,LIIT 5AS,A00,507427,Carnelos; Chiara,20,0,20,0
1714211698851,LIIT 5BS,A00,507430,Carnelos; Chiara,20,0,20,0
1714211699880,LIIT 5CS,A00,507432,Carnelos; Chiara,20,0,20,0
1714211700907,LISP 5A,A00,507541,Munoz Sanchez; Alicia,11,0,20,9
1714211701937,LISP 5B,A00,507671,Munoz Sanchez; Alicia,9,0,20,11
1714211702962,LISP 5C,A00,507696,Munoz Sanchez; Alicia,9,0,20,11
1714211703991,MAE 197,001,528363,Boechler; Nicholas Sebastia,9998,0,9999,1
1714211705020,MATH 197,001,523477,Kedlaya; Kiran S.,9996,0,9999,3
1714211705020,MATH 197,002,563811,Zhang; Danna,9995,0,9999,4
1714211705020,MATH 197,003,628552,Dumitriu; Ioana,9998,0,9999,1
1714211706050,MCWP 40R,A00,518780,Staff,5,0,20,15
1714211706050,MCWP 40R,B00,518781,Staff,7,0,20,13
1714211706050,MCWP 40R,C00,518783,Staff,5,0,20,15
1714211707080,MCWP 50R,A00,518791,Staff,0,0,20,20
1714211707080,MCWP 50R,B00,518792,Staff,0,1,20,20
1714211707080,MCWP 50R,C00,518793,Staff,0,1,20,20
1714211707080,MCWP 50R,D00,518794,Staff,0,0,20,20
1714211707080,MCWP 50R,E00,518795,Staff,0,1,20,20
1714211707080,MCWP 50R,F00,518796,Staff,0,0,20,20
1714211707080,MCWP 50R,G00,518797,Staff,0,1,20,20
1714211708109,MMW 12R,A01,514034,Herbst; Matthew,0,1,16,16
1714211708109,MMW 12R,A02,514035,Herbst; Matthew,2,0,16,14
1714211709134,MMW 13R,A01,514037,Staff,0,4,16,16
1714211709134,MMW 13R,A02,514039,Staff,0,2,16,16
1714211709134,MMW 13R,A03,628519,Staff,0,2,16,16
1714211711184,SIO 295LS,A00,523233,Staff,13,0,30,17
1714211712210,SIO 295S,A00,523232,Staff,13,0,30,17
1714211713240,SIOC 290S,A01,637330,Merrifield; Mark A,28,0,30,2
1714211714266,SIOC 291S,A01,637333,Gabriel; Corey John,28,0,30,2
1714211715291,SOCI 117,A01,494376,Staff,0,2,5,5
1714211716319,WES 237B,A00,494380,Staff,9,0,20,11
1714211718394,AESE 279B,A00,494370,Wade; Jon P,0,0,33,33
1714211719421,AIP 197,001,627712,Vespa; Emanuel Ignacio,9998,0,9999,1
1714211720445,ANAR 135S,A00,494369,Braswell; Geoffrey E.,0,0,0,0
1714211721474,BENG 196,001,628496,Engler; Adam J.,9998,0,9999,1
1714211722502,CAT 124RS,A01,519847,Geibel; William,0,0,20,20
1714211723526,CAT 125RS,A01,515971,Geibel; William,0,0,20,20
1714211724554,CLRE 250,A00,511389,Morris; Sheldon,9993,0,9999,6
1714211725583,CLRE 251,A00,507176,Mehta; Ravindra L.,9993,0,9999,6
1714211725583,CLRE 251,B00,511410,Mehta; Ravindra L.,9998,0,9999,1
1714211726608,CLRE 252,A00,507189,Cuomo; Raphael Eduardo,9995,0,9999,4
1714211727633,CLRE 253,A00,507199,Vaida; Florin,9994,0,9999,5
1714211727633,CLRE 253,B00,507202,Vaida; Florin,9999,0,9999,0
1714211728659,CLRE 259,A00,507211,Patel; Hemal,9996,0,9999,3
1714211729686,CLRE 260,A00,507221,Cuomo; Raphael Eduardo,9999,0,9999,0
1714211730710,CLRE 297,001,507242,Cuomo; Raphael Eduardo,9999,0,9999,0
1714211731735,COGS 197,001,638244,Voytek; Bradley Thomas,9999,0,9999,0
1714211732762,CSE 191,A00,516875,Minnes Kemp; Mor Mia,9993,0,9999,6
1714211733790,CSE 197,001,637388,Minnes Kemp; Mor Mia,9998,0,9999,1
1714211734819,CSS 201S,A01,494383,Staff,35,0,35,0
1714211735899,CSS 202S,A01,494387,Staff,35,0,35,0
1714211736925,DSC 197,001,628532,Eldridge; Justin Matthew,9996,0,9999,3
1714211737952,EAP 100,A00,516065,Staff,9797,0,9999,202
1714211738979,ECE 45,A01,507414,Staff,33,0,60,27
1714211741032,ECE 111,A01,507420,Staff,21,0,50,29
1714211742057,ECE 197,001,548057,Sievenpiper; Daniel F.,9994,0,9999,5
1714211743081,EDS 115,A00,507243,Choi; Bailey Miyeon,12,0,28,16
1714211744105,EDS 117,A01,494379,Staff,0,1,30,30
1714211745129,EDS 125,A00,507246,Hopkins; Megan Beth,12,0,30,18
1714211746155,EDS 128A,A01,507264,Fargason; Sharon Gayle,14,0,26,12
1714211747180,EDS 128B,A01,507293,Pappas; Elizabeth,18,0,30,12
1714211748205,EDS 139,A00,507294,Fargason; Sharon Gayle,18,0,30,12
1714211748205,EDS 139,B00,507313,Pappas; Elizabeth,15,0,30,15
1714211749232,EDS 201,A00,507315,Staff,13,0,30,17
1714211750256,EDS 203,A01,507317,Halter; Christopher P.,12,0,30,18
1714211751281,EDS 204R,A01,507319,Halter; Christopher P.,0,3,30,30
1714211751281,EDS 204R,B01,507331,Heinzman; Erica M.,17,0,30,13
1714211752309,EDS 206R,A00,507332,Staff,0,4,30,30
1714211752309,EDS 206R,B00,507343,Staff,18,0,30,12
1714211753335,EDS 250,A00,507344,Hemans; Patricia Ann Benitez,22,0,40,18
1714211754361,EDS 281,A00,507345,Daly; Alan J.,18,0,18,0
1714211755387,EDS 284,A00,507350,Daly; Alan J.,16,0,16,0
1714211756411,EDS 286,A00,507359,Fine; Sarah,18,0,18,0
1714211757437,EDS 289C,A01,507361,Daly; Alan J.,18,0,18,0
1714211758467,EDS 290,A00,507366,Hofstetter; Carolyn,15,0,15,0
1714211759493,LIGM 5A,A00,507421,Fischer-Grunski; Eva K,18,0,20,2
1714211760519,LIGM 5B,A00,507423,Fischer-Grunski; Eva K,19,0,20,1
1714211761545,LIGM 5C,A00,507425,Fischer-Grunski; Eva K,19,0,20,1
1714211762575,LIIT 5AS,A00,507427,Carnelos; Chiara,20,0,20,0
1714211763604,LIIT 5BS,A00,507430,Carnelos; Chiara,20,0,20,0
1714211764633,LIIT 5CS,A00,507432,Carnelos; Chiara,20,0,20,0
1714211765658,LISP 5A,A00,507541,Munoz Sanchez; Alicia,11,0,20,9
1714211766686,LISP 5B,A00,507671,Munoz Sanchez; Alicia,9,0,20,11
1714211767712,LISP 5C,A00,507696,Munoz Sanchez; Alicia,9,0,20,11
1714211768738,MAE 197,001,528363,Boechler; Nicholas Sebastia,9998,0,9999,1
1714211769771,MATH 197,001,523477,Kedlaya; Kiran S.,9996,0,9999,3
1714211769771,MATH 197,002,563811,Zhang; Danna,9995,0,9999,4
1714211769771,MATH 197,003,628552,Dumitriu; Ioana,9998,0,9999,1
1714211770797,MCWP 40R,A00,518780,Staff,5,0,20,15
1714211770797,MCWP 40R,B00,518781,Staff,7,0,20,13
1714211770797,MCWP 40R,C00,518783,Staff,5,0,20,15
1714211771824,MCWP 50R,A00,518791,Staff,0,0,20,20
1714211771824,MCWP 50R,B00,518792,Staff,0,1,20,20
1714211771824,MCWP 50R,C00,518793,Staff,0,1,20,20
1714211771824,MCWP 50R,D00,518794,Staff,0,0,20,20
1714211771824,MCWP 50R,E00,518795,Staff,0,1,20,20
1714211771824,MCWP 50R,F00,518796,Staff,0,0,20,20
1714211771824,MCWP 50R,G00,518797,Staff,0,1,20,20
1714211772853,MMW 12R,A01,514034,Herbst; Matthew,0,1,16,16
1714211772853,MMW 12R,A02,514035,Herbst; Matthew,2,0,16,14
1714211773881,MMW 13R,A01,514037,Staff,0,4,16,16
1714211773881,MMW 13R,A02,514039,Staff,0,2,16,16
1714211773881,MMW 13R,A03,628519,Staff,0,2,16,16
1714211775933,SIO 295LS,A00,523233,Staff,13,0,30,17
1714211776959,SIO 295S,A00,523232,Staff,13,0,30,17
1714211777987,SIOC 290S,A01,637330,Merrifield; Mark A,28,0,30,2
1714211779010,SIOC 291S,A01,637333,Gabriel; Corey John,28,0,30,2
1714211780038,SOCI 117,A01,494376,Staff,0,2,5,5
1714211781063,WES 237B,A00,494380,Staff,9,0,20,11
1714211783136,AESE 279B,A00,494370,Wade; Jon P,0,0,33,33
1714211784160,AIP 197,001,627712,Vespa; Emanuel Ignacio,9998,0,9999,1
1714211785190,ANAR 135S,A00,494369,Braswell; Geoffrey E.,0,0,0,0
1714211786219,BENG 196,001,628496,Engler; Adam J.,9998,0,9999,1
1714211787246,CAT 124RS,A01,519847,Geibel; William,0,0,20,20
1714211788273,CAT 125RS,A01,515971,Geibel; William,0,0,20,20
1714211789298,CLRE 250,A00,511389,Morris; Sheldon,9993,0,9999,6
1714211790328,CLRE 251,A00,507176,Mehta; Ravindra L.,9993,0,9999,6
1714211790328,CLRE 251,B00,511410,Mehta; Ravindra L.,9998,0,9999,1
1714211791351,CLRE 252,A00,507189,Cuomo; Raphael Eduardo,9995,0,9999,4
1714211792377,CLRE 253,A00,507199,Vaida; Florin,9994,0,9999,5
1714211792377,CLRE 253,B00,507202,Vaida; Florin,9999,0,9999,0
1714211793401,CLRE 259,A00,507211,Patel; Hemal,9996,0,9999,3
1714211794426,CLRE 260,A00,507221,Cuomo; Raphael Eduardo,9999,0,9999,0
1714211795454,CLRE 297,001,507242,Cuomo; Raphael Eduardo,9999,0,9999,0
1714211796479,COGS 197,001,638244,Voytek; Bradley Thomas,9999,0,9999,0
1714211797505,CSE 191,A00,516875,Minnes Kemp; Mor Mia,9993,0,9999,6
1714211798531,CSE 197,001,637388,Minnes Kemp; Mor Mia,9998,0,9999,1
1714211799561,CSS 201S,A01,494383,Staff,35,0,35,0
1714211800586,CSS 202S,A01,494387,Staff,35,0,35,0
1714211801615,DSC 197,001,628532,Eldridge; Justin Matthew,9996,0,9999,3
1714211802640,EAP 100,A00,516065,Staff,9797,0,9999,202
1714211803665,ECE 45,A01,507414,Staff,33,0,60,27
1714211805715,ECE 111,A01,507420,Staff,21,0,50,29
1714211806742,ECE 197,001,548057,Sievenpiper; Daniel F.,9994,0,9999,5
1714211807773,EDS 115,A00,507243,Choi; Bailey Miyeon,12,0,28,16
1714211808800,EDS 117,A01,494379,Staff,0,1,30,30
1714211809828,EDS 125,A00,507246,Hopkins; Megan Beth,12,0,30,18
1714211810856,EDS 128A,A01,507264,Fargason; Sharon Gayle,14,0,26,12
1714211811886,EDS 128B,A01,507293,Pappas; Elizabeth,18,0,30,12
1714211812914,EDS 139,A00,507294,Fargason; Sharon Gayle,18,0,30,12
1714211812914,EDS 139,B00,507313,Pappas; Elizabeth,15,0,30,15
1714211813939,EDS 201,A00,507315,Staff,13,0,30,17
1714211814967,EDS 203,A01,507317,Halter; Christopher P.,12,0,30,18
1714211815993,EDS 204R,A01,507319,Halter; Christopher P.,0,3,30,30
1714211815993,EDS 204R,B01,507331,Heinzman; Erica M.,17,0,30,13
1714211817021,EDS 206R,A00,507332,Staff,0,4,30,30
1714211817021,EDS 206R,B00,507343,Staff,18,0,30,12
1714211818050,EDS 250,A00,507344,Hemans; Patricia Ann Benitez,22,0,40,18
1714211819078,EDS 281,A00,507345,Daly; Alan J.,18,0,18,0
1714211820107,EDS 284,A00,507350,Daly; Alan J.,16,0,16,0
1714211821134,EDS 286,A00,507359,Fine; Sarah,18,0,18,0
1714211822160,EDS 289C,A01,507361,Daly; Alan J.,18,0,18,0
1714211823188,EDS 290,A00,507366,Hofstetter; Carolyn,15,0,15,0
1714211824215,LIGM 5A,A00,507421,Fischer-Grunski; Eva K,18,0,20,2
1714211825244,LIGM 5B,A00,507423,Fischer-Grunski; Eva K,19,0,20,1
1714211826268,LIGM 5C,A00,507425,Fischer-Grunski; Eva K,19,0,20,1
1714211827295,LIIT 5AS,A00,507427,Carnelos; Chiara,20,0,20,0
1714211828320,LIIT 5BS,A00,507430,Carnelos; Chiara,20,0,20,0
1714211829345,LIIT 5CS,A00,507432,Carnelos; Chiara,20,0,20,0
1714211830369,LISP 5A,A00,507541,Munoz Sanchez; Alicia,11,0,20,9
1714211831397,LISP 5B,A00,507671,Munoz Sanchez; Alicia,9,0,20,11
1714211832429,LISP 5C,A00,507696,Munoz Sanchez; Alicia,9,0,20,11
1714211833456,MAE 197,001,528363,Boechler; Nicholas Sebastia,9998,0,9999,1
1714211834485,MATH 197,001,523477,Kedlaya; Kiran S.,9996,0,9999,3
1714211834485,MATH 197,002,563811,Zhang; Danna,9995,0,9999,4
1714211834485,MATH 197,003,628552,Dumitriu; Ioana,9998,0,9999,1
1714211835514,MCWP 40R,A00,518780,Staff,5,0,20,15
1714211835514,MCWP 40R,B00,518781,Staff,7,0,20,13
1714211835514,MCWP 40R,C00,518783,Staff,5,0,20,15
1714211836541,MCWP 50R,A00,518791,Staff,0,0,20,20
1714211836541,MCWP 50R,B00,518792,Staff,0,1,20,20
1714211836541,MCWP 50R,C00,518793,Staff,0,1,20,20
1714211836541,MCWP 50R,D00,518794,Staff,0,0,20,20
1714211836541,MCWP 50R,E00,518795,Staff,0,1,20,20
1714211836541,MCWP 50R,F00,518796,Staff,0,0,20,20
1714211836541,MCWP 50R,G00,518797,Staff,0,1,20,20
1714211837568,MMW 12R,A01,514034,Herbst; Matthew,0,1,16,16
1714211837568,MMW 12R,A02,514035,Herbst; Matthew,2,0,16,14
1714211838595,MMW 13R,A01,514037,Staff,0,4,16,16
1714211838595,MMW 13R,A02,514039,Staff,0,2,16,16
1714211838595,MMW 13R,A03,628519,Staff,0,2,16,16
1714211840718,SIO 295LS,A00,523233,Staff,13,0,30,17
1714211841744,SIO 295S,A00,523232,Staff,13,0,30,17
1714211842769,SIOC 290S,A01,637330,Merrifield; Mark A,28,0,30,2
1714211843796,SIOC 291S,A01,637333,Gabriel; Corey John,28,0,30,2
1714211844820,SOCI 117,A01,494376,Staff,0,2,5,5
1714211845845,WES 237B,A00,494380,Staff,9,0,20,11
1714211847910,AESE 279B,A00,494370,Wade; Jon P,0,0,33,33
1714211848934,AIP 197,001,627712,Vespa; Emanuel Ignacio,9998,0,9999,1
1714211849963,ANAR 135S,A00,494369,Braswell; Geoffrey E.,0,0,0,0
1714211850987,BENG 196,001,628496,Engler; Adam J.,9998,0,9999,1
1714211852011,CAT 124RS,A01,519847,Geibel; William,0,0,20,20
1714211853037,CAT 125RS,A01,515971,Geibel; William,0,0,20,20
1714211854061,CLRE 250,A00,511389,Morris; Sheldon,9993,0,9999,6
1714211855087,CLRE 251,A00,507176,Mehta; Ravindra L.,9993,0,9999,6
1714211855087,CLRE 251,B00,511410,Mehta; Ravindra L.,9998,0,9999,1
1714211856109,CLRE 252,A00,507189,Cuomo; Raphael Eduardo,9995,0,9999,4
1714211857138,CLRE 253,A00,507199,Vaida; Florin,9994,0,9999,5
1714211857138,CLRE 253,B00,507202,Vaida; Florin,9999,0,9999,0
1714211858163,CLRE 259,A00,507211,Patel; Hemal,9996,0,9999,3
1714211859189,CLRE 260,A00,507221,Cuomo; Raphael Eduardo,9999,0,9999,0
1714211860214,CLRE 297,001,507242,Cuomo; Raphael Eduardo,9999,0,9999,0
1714211861237,COGS 197,001,638244,Voytek; Bradley Thomas,9999,0,9999,0
1714211862263,CSE 191,A00,516875,Minnes Kemp; Mor Mia,9993,0,9999,6
1714211863287,CSE 197,001,637388,Minnes Kemp; Mor Mia,9998,0,9999,1
1714211864315,CSS 201S,A01,494383,Staff,35,0,35,0
1714211865342,CSS 202S,A01,494387,Staff,35,0,35,0
1714211866366,DSC 197,001,628532,Eldridge; Justin Matthew,9996,0,9999,3
1714211867391,EAP 100,A00,516065,Staff,9797,0,9999,202
1714211868414,ECE 45,A01,507414,Staff,33,0,60,27
1714211870465,ECE 111,A01,507420,Staff,21,0,50,29
1714211871492,ECE 197,001,548057,Sievenpiper; Daniel F.,9994,0,9999,5
1714211872520,EDS 115,A00,507243,Choi; Bailey Miyeon,12,0,28,16
1714211873547,EDS 117,A01,494379,Staff,0,1,30,30
1714211874572,EDS 125,A00,507246,Hopkins; Megan Beth,12,0,30,18
1714211875598,EDS 128A,A01,507264,Fargason; Sharon Gayle,14,0,26,12
1714211876624,EDS 128B,A01,507293,Pappas; Elizabeth,18,0,30,12
1714211877651,EDS 139,A00,507294,Fargason; Sharon Gayle,18,0,30,12
1714211877651,EDS 139,B00,507313,Pappas; Elizabeth,15,0,30,15
1714211878678,EDS 201,A00,507315,Staff,13,0,30,17
1714211879704,EDS 203,A01,507317,Halter; Christopher P.,12,0,30,18
1714211880730,EDS 204R,A01,507319,Halter; Christopher P.,0,3,30,30
1714211880730,EDS 204R,B01,507331,Heinzman; Erica M.,17,0,30,13
1714211881755,EDS 206R,A00,507332,Staff,0,4,30,30
1714211881755,EDS 206R,B00,507343,Staff,18,0,30,12
1714211882778,EDS 250,A00,507344,Hemans; Patricia Ann Benitez,22,0,40,18
1714211883806,EDS 281,A00,507345,Daly; Alan J.,18,0,18,0
1714211884832,EDS 284,A00,507350,Daly; Alan J.,16,0,16,0
1714211885857,EDS 286,A00,507359,Fine; Sarah,18,0,18,0
1714211886883,EDS 289C,A01,507361,Daly; Alan J.,18,0,18,0
1714211887913,EDS 290,A00,507366,Hofstetter; Carolyn,15,0,15,0
1714211888941,LIGM 5A,A00,507421,Fischer-Grunski; Eva K,18,0,20,2
1714211889967,LIGM 5B,A00,507423,Fischer-Grunski; Eva K,19,0,20,1
1714211890993,LIGM 5C,A00,507425,Fischer-Grunski; Eva K,19,0,20,1
1714211892019,LIIT 5AS,A00,507427,Carnelos; Chiara,20,0,20,0
1714211893048,LIIT 5BS,A00,507430,Carnelos; Chiara,20,0,20,0
1714211894077,LIIT 5CS,A00,507432,Carnelos; Chiara,20,0,20,0
1714211895101,LISP 5A,A00,507541,Munoz Sanchez; Alicia,11,0,20,9
1714211896126,LISP 5B,A00,507671,Munoz Sanchez; Alicia,9,0,20,11
1714211897153,LISP 5C,A00,507696,Munoz Sanchez; Alicia,9,0,20,11
1714211898178,MAE 197,001,528363,Boechler; Nicholas Sebastia,9998,0,9999,1
1714211899209,MATH 197,001,523477,Kedlaya; Kiran S.,9996,0,9999,3
1714211899209,MATH 197,002,563811,Zhang; Danna,9995,0,9999,4
1714211899209,MATH 197,003,628552,Dumitriu; Ioana,9998,0,9999,1
1714211900238,MCWP 40R,A00,518780,Staff,5,0,20,15
1714211900238,MCWP 40R,B00,518781,Staff,7,0,20,13
1714211900238,MCWP 40R,C00,518783,Staff,5,0,20,15
1714211901263,MCWP 50R,A00,518791,Staff,0,0,20,20
1714211901263,MCWP 50R,B00,518792,Staff,0,1,20,20
1714211901263,MCWP 50R,C00,518793,Staff,0,1,20,20
1714211901263,MCWP 50R,D00,518794,Staff,0,0,20,20
1714211901263,MCWP 50R,E00,518795,Staff,0,1,20,20
1714211901263,MCWP 50R,F00,518796,Staff,0,0,20,20
1714211901263,MCWP 50R,G00,518797,Staff,0,1,20,20
1714211902288,MMW 12R,A01,514034,Herbst; Matthew,0,1,16,16
1714211902288,MMW 12R,A02,514035,Herbst; Matthew,2,0,16,14
1714211903315,MMW 13R,A01,514037,Staff,0,4,16,16
1714211903315,MMW 13R,A02,514039,Staff,0,2,16,16
1714211903315,MMW 13R,A03,628519,Staff,0,2,16,16
1714211905370,SIO 295LS,A00,523233,Staff,13,0,30,17
1714211906395,SIO 295S,A00,523232,Staff,13,0,30,17
1714211907432,SIOC 290S,A01,637330,Merrifield; Mark A,28,0,30,2
1714211908457,SIOC 291S,A01,637333,Gabriel; Corey John,28,0,30,2
1714211909483,SOCI 117,A01,494376,Staff,0,2,5,5
1714211910509,WES 237B,A00,494380,Staff,9,0,20,11
1714211912581,AESE 279B,A00,494370,Wade; Jon P,0,0,33,33
1714211913606,AIP 197,001,627712,Vespa; Emanuel Ignacio,9998,0,9999,1
1714211914631,ANAR 135S,A00,494369,Braswell; Geoffrey E.,0,0,0,0
1714211915656,BENG 196,001,628496,Engler; Adam J.,9998,0,9999,1
1714211916686,CAT 124RS,A01,519847,Geibel; William,0,0,20,20
1714211917710,CAT 125RS,A01,515971,Geibel; William,0,0,20,20
1714211918736,CLRE 250,A00,511389,Morris; Sheldon,9993,0,9999,6
1714211919766,CLRE 251,A00,507176,Mehta; Ravindra L.,9993,0,9999,6
1714211919766,CLRE 251,B00,511410,Mehta; Ravindra L.,9998,0,9999,1
1714211920790,CLRE 252,A00,507189,Cuomo; Raphael Eduardo,9995,0,9999,4
1714211921815,CLRE 253,A00,507199,Vaida; Florin,9994,0,9999,5
1714211921815,CLRE 253,B00,507202,Vaida; Florin,9999,0,9999,0
1714211922840,CLRE 259,A00,507211,Patel; Hemal,9996,0,9999,3
1714211923869,CLRE 260,A00,507221,Cuomo; Raphael Eduardo,9999,0,9999,0
1714211924894,CLRE 297,001,507242,Cuomo; Raphael Eduardo,9999,0,9999,0
1714211925923,COGS 197,001,638244,Voytek; Bradley Thomas,9999,0,9999,0
1714211926951,CSE 191,A00,516875,Minnes Kemp; Mor Mia,9993,0,9999,6
1714211927979,CSE 197,001,637388,Minnes Kemp; Mor Mia,9998,0,9999,1
1714211929006,CSS 201S,A01,494383,Staff,35,0,35,0
1714211930033,CSS 202S,A01,494387,Staff,35,0,35,0
1714211931058,DSC 197,001,628532,Eldridge; Justin Matthew,9996,0,9999,3
1714211932083,EAP 100,A00,516065,Staff,9797,0,9999,202
1714211933110,ECE 45,A01,507414,Staff,33,0,60,27
1714211935162,ECE 111,A01,507420,Staff,21,0,50,29
1714211936188,ECE 197,001,548057,Sievenpiper; Daniel F.,9994,0,9999,5
1714211937214,EDS 115,A00,507243,Choi; Bailey Miyeon,12,0,28,16
1714211938240,EDS 117,A01,494379,Staff,0,1,30,30
1714211939265,EDS 125,A00,507246,Hopkins; Megan Beth,12,0,30,18
1714211940291,EDS 128A,A01,507264,Fargason; Sharon Gayle,14,0,26,12
1714211941319,EDS 128B,A01,507293,Pappas; Elizabeth,18,0,30,12
1714211942345,EDS 139,A00,507294,Fargason; Sharon Gayle,18,0,30,12
1714211942345,EDS 139,B00,507313,Pappas; Elizabeth,15,0,30,15
1714211943424,EDS 201,A00,507315,Staff,13,0,30,17
1714211944447,EDS 203,A01,507317,Halter; Christopher P.,12,0,30,18
1714211945472,EDS 204R,A01,507319,Halter; Christopher P.,0,3,30,30
1714211945472,EDS 204R,B01,507331,Heinzman; Erica M.,17,0,30,13
1714211946496,EDS 206R,A00,507332,Staff,0,4,30,30
1714211946496,EDS 206R,B00,507343,Staff,18,0,30,12
1714211947522,EDS 250,A00,507344,Hemans; Patricia Ann Benitez,22,0,40,18
1714211948548,EDS 281,A00,507345,Daly; Alan J.,18,0,18,0
1714211949572,EDS 284,A00,507350,Daly; Alan J.,16,0,16,0
1714211950597,EDS 286,A00,507359,Fine; Sarah,18,0,18,0
1714211951620,EDS 289C,A01,507361,Daly; Alan J.,18,0,18,0
1714211952647,EDS 290,A00,507366,Hofstetter; Carolyn,15,0,15,0
1714211953672,LIGM 5A,A00,507421,Fischer-Grunski; Eva K,18,0,20,2
1714211954698,LIGM 5B,A00,507423,Fischer-Grunski; Eva K,19,0,20,1
1714211955725,LIGM 5C,A00,507425,Fischer-Grunski; Eva K,19,0,20,1
1714211956751,LIIT 5AS,A00,507427,Carnelos; Chiara,20,0,20,0
1714211957780,LIIT 5BS,A00,507430,Carnelos; Chiara,20,0,20,0
1714211958807,LIIT 5CS,A00,507432,Carnelos; Chiara,20,0,20,0
1714211959833,LISP 5A,A00,507541,Munoz Sanchez; Alicia,11,0,20,9
1714211960859,LISP 5B,A00,507671,Munoz Sanchez; Alicia,9,0,20,11
1714211961885,LISP 5C,A00,507696,Munoz Sanchez; Alicia,9,0,20,11
1714211962907,MAE 197,001,528363,Boechler; Nicholas Sebastia,9998,0,9999,1
1714211963934,MATH 197,001,523477,Kedlaya; Kiran S.,9996,0,9999,3
1714211963934,MATH 197,002,563811,Zhang; Danna,9995,0,9999,4
1714211963934,MATH 197,003,628552,Dumitriu; Ioana,9998,0,9999,1
1714211964960,MCWP 40R,A00,518780,Staff,5,0,20,15
1714211964960,MCWP 40R,B00,518781,Staff,7,0,20,13
1714211964960,MCWP 40R,C00,518783,Staff,5,0,20,15
1714211965987,MCWP 50R,A00,518791,Staff,0,0,20,20
1714211965987,MCWP 50R,B00,518792,Staff,0,1,20,20
1714211965987,MCWP 50R,C00,518793,Staff,0,1,20,20
1714211965987,MCWP 50R,D00,518794,Staff,0,0,20,20
1714211965987,MCWP 50R,E00,518795,Staff,0,1,20,20
1714211965987,MCWP 50R,F00,518796,Staff,0,0,20,20
1714211965987,MCWP 50R,G00,518797,Staff,0,1,20,20
1714211967011,MMW 12R,A01,514034,Herbst; Matthew,0,1,16,16
1714211967011,MMW 12R,A02,514035,Herbst; Matthew,2,0,16,14
1714211968037,MMW 13R,A01,514037,Staff,0,4,16,16
1714211968037,MMW 13R,A02,514039,Staff,0,2,16,16
1714211968037,MMW 13R,A03,628519,Staff,0,2,16,16
1714211970091,SIO 295LS,A00,523233,Staff,13,0,30,17
1714211971118,SIO 295S,A00,523232,Staff,13,0,30,17
1714211972147,SIOC 290S,A01,637330,Merrifield; Mark A,28,0,30,2
1714211973177,SIOC 291S,A01,637333,Gabriel; Corey John,28,0,30,2
1714211974205,SOCI 117,A01,494376,Staff,0,2,5,5
1714211975231,WES 237B,A00,494380,Staff,9,0,20,11
1714211977308,AESE 279B,A00,494370,Wade; Jon P,0,0,33,33
1714211978333,AIP 197,001,627712,Vespa; Emanuel Ignacio,9998,0,9999,1
1714211979364,ANAR 135S,A00,494369,Braswell; Geoffrey E.,0,0,0,0
1714211980390,BENG 196,001,628496,Engler; Adam J.,9998,0,9999,1
1714211981418,CAT 124RS,A01,519847,Geibel; William,0,0,20,20
1714211982448,CAT 125RS,A01,515971,Geibel; William,0,0,20,20
1714211983473,CLRE 250,A00,511389,Morris; Sheldon,9993,0,9999,6
1714211984499,CLRE 251,A00,507176,Mehta; Ravindra L.,9993,0,9999,6
1714211984499,CLRE 251,B00,511410,Mehta; Ravindra L.,9998,0,9999,1
1714211985525,CLRE 252,A00,507189,Cuomo; Raphael Eduardo,9995,0,9999,4
1714211986554,CLRE 253,A00,507199,Vaida; Florin,9994,0,9999,5
1714211986554,CLRE 253,B00,507202,Vaida; Florin,9999,0,9999,0
1714211987578,CLRE 259,A00,507211,Patel; Hemal,9996,0,9999,3
1714211988606,CLRE 260,A00,507221,Cuomo; Raphael Eduardo,9999,0,9999,0
1714211989631,CLRE 297,001,507242,Cuomo; Raphael Eduardo,9999,0,9999,0
1714211990660,COGS 197,001,638244,Voytek; Bradley Thomas,9999,0,9999,0
1714211991687,CSE 191,A00,516875,Minnes Kemp; Mor Mia,9993,0,9999,6
1714211992712,CSE 197,001,637388,Minnes Kemp; Mor Mia,9998,0,9999,1
1714211993739,CSS 201S,A01,494383,Staff,35,0,35,0
1714211994768,CSS 202S,A01,494387,Staff,35,0,35,0
1714211995794,DSC 197,001,628532,Eldridge; Justin Matthew,9996,0,9999,3
1714211996820,EAP 100,A00,516065,Staff,9797,0,9999,202
1714211997847,ECE 45,A01,507414,Staff,33,0,60,27
1714211999899,ECE 111,A01,507420,Staff,21,0,50,29
1714212000925,ECE 197,001,548057,Sievenpiper; Daniel F.,9994,0,9999,5
1714212001950,EDS 115,A00,507243,Choi; Bailey Miyeon,12,0,28,16
1714212002975,EDS 117,A01,494379,Staff,0,1,30,30
1714212004001,EDS 125,A00,507246,Hopkins; Megan Beth,12,0,30,18
1714212005029,EDS 128A,A01,507264,Fargason; Sharon Gayle,14,0,26,12
1714212006055,EDS 128B,A01,507293,Pappas; Elizabeth,18,0,30,12
1714212007080,EDS 139,A00,507294,Fargason; Sharon Gayle,18,0,30,12
1714212007080,EDS 139,B00,507313,Pappas; Elizabeth,15,0,30,15
1714212008108,EDS 201,A00,507315,Staff,13,0,30,17
1714212009133,EDS 203,A01,507317,Halter; Christopher P.,12,0,30,18
1714212010160,EDS 204R,A01,507319,Halter; Christopher P.,0,3,30,30
1714212010160,EDS 204R,B01,507331,Heinzman; Erica M.,17,0,30,13
1714212011186,EDS 206R,A00,507332,Staff,0,4,30,30
1714212011186,EDS 206R,B00,507343,Staff,18,0,30,12
1714212012212,EDS 250,A00,507344,Hemans; Patricia Ann Benitez,22,0,40,18
1714212013238,EDS 281,A00,507345,Daly; Alan J.,18,0,18,0
1714212014263,EDS 284,A00,507350,Daly; Alan J.,16,0,16,0
1714212015290,EDS 286,A00,507359,Fine; Sarah,18,0,18,0
1714212016319,EDS 289C,A01,507361,Daly; Alan J.,18,0,18,0
1714212017346,EDS 290,A00,507366,Hofstetter; Carolyn,15,0,15,0
1714212018373,LIGM 5A,A00,507421,Fischer-Grunski; Eva K,18,0,20,2
1714212019399,LIGM 5B,A00,507423,Fischer-Grunski; Eva K,19,0,20,1
1714212020426,LIGM 5C,A00,507425,Fischer-Grunski; Eva K,19,0,20,1
1714212021454,LIIT 5AS,A00,507427,Carnelos; Chiara,20,0,20,0
1714212022485,LIIT 5BS,A00,507430,Carnelos; Chiara,20,0,20,0
1714212023510,LIIT 5CS,A00,507432,Carnelos; Chiara,20,0,20,0
1714212024539,LISP 5A,A00,507541,Munoz Sanchez; Alicia,11,0,20,9
1714212025568,LISP 5B,A00,507671,Munoz Sanchez; Alicia,9,0,20,11
1714212026597,LISP 5C,A00,507696,Munoz Sanchez; Alicia,9,0,20,11
1714212027622,MAE 197,001,528363,Boechler; Nicholas Sebastia,9998,0,9999,1
1714212028647,MATH 197,001,523477,Kedlaya; Kiran S.,9996,0,9999,3
1714212028647,MATH 197,002,563811,Zhang; Danna,9995,0,9999,4
1714212028647,MATH 197,003,628552,Dumitriu; Ioana,9998,0,9999,1
1714212029676,MCWP 40R,A00,518780,Staff,5,0,20,15
1714212029676,MCWP 40R,B00,518781,Staff,7,0,20,13
1714212029676,MCWP 40R,C00,518783,Staff,5,0,20,15
1714212030701,MCWP 50R,A00,518791,Staff,0,0,20,20
1714212030701,MCWP 50R,B00,518792,Staff,0,1,20,20
1714212030701,MCWP 50R,C00,518793,Staff,0,1,20,20
1714212030701,MCWP 50R,D00,518794,Staff,0,0,20,20
1714212030701,MCWP 50R,E00,518795,Staff,0,1,20,20
1714212030701,MCWP 50R,F00,518796,Staff,0,0,20,20
1714212030701,MCWP 50R,G00,518797,Staff,0,1,20,20
1714212031729,MMW 12R,A01,514034,Herbst; Matthew,0,1,16,16
1714212031729,MMW 12R,A02,514035,Herbst; Matthew,2,0,16,14
1714212032756,MMW 13R,A01,514037,Staff,0,4,16,16
1714212032756,MMW 13R,A02,514039,Staff,0,2,16,16
1714212032756,MMW 13R,A03,628519,Staff,0,2,16,16
1714212034808,SIO 295LS,A00,523233,Staff,13,0,30,17
1714212035834,SIO 295S,A00,523232,Staff,13,0,30,17
1714212036859,SIOC 290S,A01,637330,Merrifield; Mark A,28,0,30,2
1714212037888,SIOC 291S,A01,637333,Gabriel; Corey John,28,0,30,2
1714212038915,SOCI 117,A01,494376,Staff,0,2,5,5
1714212039941,WES 237B,A00,494380,Staff,9,0,20,11
1714212042014,AESE 279B,A00,494370,Wade; Jon P,0,0,33,33
1714212043039,AIP 197,001,627712,Vespa; Emanuel Ignacio,9998,0,9999,1
1714212044064,ANAR 135S,A00,494369,Braswell; Geoffrey E.,0,0,0,0
1714212045090,BENG 196,001,628496,Engler; Adam J.,9998,0,9999,1
1714212046116,CAT 124RS,A01,519847,Geibel; William,0,0,20,20
1714212047198,CAT 125RS,A01,515971,Geibel; William,0,0,20,20
1714212048223,CLRE 250,A00,511389,Morris; Sheldon,9993,0,9999,6
1714212049248,CLRE 251,A00,507176,Mehta; Ravindra L.,9993,0,9999,6
1714212049248,CLRE 251,B00,511410,Mehta; Ravindra L.,9998,0,9999,1
1714212050273,CLRE 252,A00,507189,Cuomo; Raphael Eduardo,9995,0,9999,4
1714212051301,CLRE 253,A00,507199,Vaida; Florin,9994,0,9999,5
1714212051301,CLRE 253,B00,507202,Vaida; Florin,9999,0,9999,0
1714212052325,CLRE 259,A00,507211,Patel; Hemal,9996,0,9999,3
1714212053352,CLRE 260,A00,507221,Cuomo; Raphael Eduardo,9999,0,9999,0
1714212054378,CLRE 297,001,507242,Cuomo; Raphael Eduardo,9999,0,9999,0
1714212055403,COGS 197,001,638244,Voytek; Bradley Thomas,9999,0,9999,0
1714212056428,CSE 191,A00,516875,Minnes Kemp; Mor Mia,9993,0,9999,6
1714212057456,CSE 197,001,637388,Minnes Kemp; Mor Mia,9998,0,9999,1
1714212058481,CSS 201S,A01,494383,Staff,35,0,35,0
1714212059510,CSS 202S,A01,494387,Staff,35,0,35,0
1714212060561,DSC 197,001,628532,Eldridge; Justin Matthew,9996,0,9999,3
1714212061586,EAP 100,A00,516065,Staff,9797,0,9999,202
1714212062612,ECE 45,A01,507414,Staff,33,0,60,27
1714212064664,ECE 111,A01,507420,Staff,21,0,50,29
1714212065694,ECE 197,001,548057,Sievenpiper; Daniel F.,9994,0,9999,5
1714212066722,EDS 115,A00,507243,Choi; Bailey Miyeon,12,0,28,16
1714212067747,EDS 117,A01,494379,Staff,0,1,30,30
1714212068772,EDS 125,A00,507246,Hopkins; Megan Beth,12,0,30,18
1714212069798,EDS 128A,A01,507264,Fargason; Sharon Gayle,14,0,26,12
1714212070825,EDS 128B,A01,507293,Pappas; Elizabeth,18,0,30,12
1714212071853,EDS 139,A00,507294,Fargason; Sharon Gayle,18,0,30,12
1714212071853,EDS 139,B00,507313,Pappas; Elizabeth,15,0,30,15
1714212072879,EDS 201,A00,507315,Staff,13,0,30,17
1714212073906,EDS 203,A01,507317,Halter; Christopher P.,12,0,30,18
1714212074932,EDS 204R,A01,507319,Halter; Christopher P.,0,3,30,30
1714212074932,EDS 204R,B01,507331,Heinzman; Erica M.,17,0,30,13
1714212075961,EDS 206R,A00,507332,Staff,0,4,30,30
1714212075961,EDS 206R,B00,507343,Staff,18,0,30,12
1714212076988,EDS 250,A00,507344,Hemans; Patricia Ann Benitez,22,0,40,18
1714212078016,EDS 281,A00,507345,Daly; Alan J.,18,0,18,0
1714212079044,EDS 284,A00,507350,Daly; Alan J.,16,0,16,0
1714212080071,EDS 286,A00,507359,Fine; Sarah,18,0,18,0
1714212081099,EDS 289C,A01,507361,Daly; Alan J.,18,0,18,0
1714212082125,EDS 290,A00,507366,Hofstetter; Carolyn,15,0,15,0
1714212083150,LIGM 5A,A00,507421,Fischer-Grunski; Eva K,18,0,20,2
1714212084176,LIGM 5B,A00,507423,Fischer-Grunski; Eva K,19,0,20,1
1714212085201,LIGM 5C,A00,507425,Fischer-Grunski; Eva K,19,0,20,1
1714212086226,LIIT 5AS,A00,507427,Carnelos; Chiara,20,0,20,0
1714212087255,LIIT 5BS,A00,507430,Carnelos; Chiara,20,0,20,0
1714212088280,LIIT 5CS,A00,507432,Carnelos; Chiara,20,0,20,0
1714212089308,LISP 5A,A00,507541,Munoz Sanchez; Alicia,11,0,20,9
1714212090338,LISP 5B,A00,507671,Munoz Sanchez; Alicia,9,0,20,11
1714212091364,LISP 5C,A00,507696,Munoz Sanchez; Alicia,9,0,20,11
1714212092391,MAE 197,001,528363,Boechler; Nicholas Sebastia,9998,0,9999,1
1714212093427,MATH 197,001,523477,Kedlaya; Kiran S.,9996,0,9999,3
1714212093427,MATH 197,002,563811,Zhang; Danna,9995,0,9999,4
1714212093427,MATH 197,003,628552,Dumitriu; Ioana,9998,0,9999,1
1714212094451,MCWP 40R,A00,518780,Staff,5,0,20,15
1714212094451,MCWP 40R,B00,518781,Staff,7,0,20,13
1714212094451,MCWP 40R,C00,518783,Staff,5,0,20,15
1714212095481,MCWP 50R,A00,518791,Staff,0,0,20,20
1714212095481,MCWP 50R,B00,518792,Staff,0,1,20,20
1714212095481,MCWP 50R,C00,518793,Staff,0,1,20,20
1714212095481,MCWP 50R,D00,518794,Staff,0,0,20,20
1714212095481,MCWP 50R,E00,518795,Staff,0,1,20,20
1714212095481,MCWP 50R,F00,518796,Staff,0,0,20,20
1714212095481,MCWP 50R,G00,518797,Staff,0,1,20,20
1714212096508,MMW 12R,A01,514034,Herbst; Matthew,0,1,16,16
1714212096508,MMW 12R,A02,514035,Herbst; Matthew,2,0,16,14
1714212097533,MMW 13R,A01,514037,Staff,0,4,16,16
1714212097533,MMW 13R,A02,514039,Staff,0,2,16,16
1714212097533,MMW 13R,A03,628519,Staff,0,2,16,16
1714212099592,SIO 295LS,A00,523233,Staff,13,0,30,17
1714212100616,SIO 295S,A00,523232,Staff,13,0,30,17
1714212101643,SIOC 290S,A01,637330,Merrifield; Mark A,28,0,30,2
1714212102673,SIOC 291S,A01,637333,Gabriel; Corey John,28,0,30,2
1714212103698,SOCI 117,A01,494376,Staff,0,2,5,5
1714212104723,WES 237B,A00,494380,Staff,9,0,20,11
1714212106795,AESE 279B,A00,494370,Wade; Jon P,0,0,33,33
1714212107824,AIP 197,001,627712,Vespa; Emanuel Ignacio,9998,0,9999,1
1714212108849,ANAR 135S,A00,494369,Braswell; Geoffrey E.,0,0,0,0
1714212109874,BENG 196,001,628496,Engler; Adam J.,9998,0,9999,1
1714212110900,CAT 124RS,A01,519847,Geibel; William,0,0,20,20
1714212111927,CAT 125RS,A01,515971,Geibel; William,0,0,20,20
1714212112958,CLRE 250,A00,511389,Morris; Sheldon,9993,0,9999,6
1714212113987,CLRE 251,A00,507176,Mehta; Ravindra L.,9993,0,9999,6
1714212113987,CLRE 251,B00,511410,Mehta; Ravindra L.,9998,0,9999,1
1714212115012,CLRE 252,A00,507189,Cuomo; Raphael Eduardo,9995,0,9999,4
1714212116038,CLRE 253,A00,507199,Vaida; Florin,9994,0,9999,5
1714212116038,CLRE 253,B00,507202,Vaida; Florin,9999,0,9999,0
1714212117063,CLRE 259,A00,507211,Patel; Hemal,9996,0,9999,3
1714212118091,CLRE 260,A00,507221,Cuomo; Raphael Eduardo,9999,0,9999,0
1714212119116,CLRE 297,001,507242,Cuomo; Raphael Eduardo,9999,0,9999,0
1714212120148,COGS 197,001,638244,Voytek; Bradley Thomas,9999,0,9999,0
1714212121173,CSE 191,A00,516875,Minnes Kemp; Mor Mia,9993,0,9999,6
1714212122203,CSE 197,001,637388,Minnes Kemp; Mor Mia,9998,0,9999,1
1714212123229,CSS 201S,A01,494383,Staff,35,0,35,0
1714212124261,CSS 202S,A01,494387,Staff,35,0,35,0
1714212125287,DSC 197,001,628532,Eldridge; Justin Matthew,9996,0,9999,3
1714212126315,EAP 100,A00,516065,Staff,9797,0,9999,202
1714212127340,ECE 45,A01,507414,Staff,33,0,60,27
1714212129391,ECE 111,A01,507420,Staff,21,0,50,29
1714212130417,ECE 197,001,548057,Sievenpiper; Daniel F.,9994,0,9999,5
1714212131444,EDS 115,A00,507243,Choi; Bailey Miyeon,12,0,28,16
1714212132469,EDS 117,A01,494379,Staff,0,1,30,30
1714212133495,EDS 125,A00,507246,Hopkins; Megan Beth,12,0,30,18
1714212134520,EDS 128A,A01,507264,Fargason; Sharon Gayle,14,0,26,12
1714212135550,EDS 128B,A01,507293,Pappas; Elizabeth,18,0,30,12
1714212136580,EDS 139,A00,507294,Fargason; Sharon Gayle,18,0,30,12
1714212136580,EDS 139,B00,507313,Pappas; Elizabeth,15,0,30,15
1714212137605,EDS 201,A00,507315,Staff,13,0,30,17
1714212138633,EDS 203,A01,507317,Halter; Christopher P.,12,0,30,18
1714212139658,EDS 204R,A01,507319,Halter; Christopher P.,0,3,30,30
1714212139658,EDS 204R,B01,507331,Heinzman; Erica M.,17,0,30,13
1714212140683,EDS 206R,A00,507332,Staff,0,4,30,30
1714212140683,EDS 206R,B00,507343,Staff,18,0,30,12
1714212141709,EDS 250,A00,507344,Hemans; Patricia Ann Benitez,22,0,40,18
1714212142735,EDS 281,A00,507345,Daly; Alan J.,18,0,18,0
1714212143759,EDS 284,A00,507350,Daly; Alan J.,16,0,16,0
1714212144790,EDS 286,A00,507359,Fine; Sarah,18,0,18,0
1714212145819,EDS 289C,A01,507361,Daly; Alan J.,18,0,18,0
1714212146846,EDS 290,A00,507366,Hofstetter; Carolyn,15,0,15,0
1714212147873,LIGM 5A,A00,507421,Fischer-Grunski; Eva K,18,0,20,2
1714212148899,LIGM 5B,A00,507423,Fischer-Grunski; Eva K,19,0,20,1
1714212149928,LIGM 5C,A00,507425,Fischer-Grunski; Eva K,19,0,20,1
1714212151009,LIIT 5AS,A00,507427,Carnelos; Chiara,20,0,20,0
1714212152035,LIIT 5BS,A00,507430,Carnelos; Chiara,20,0,20,0
1714212153061,LIIT 5CS,A00,507432,Carnelos; Chiara,20,0,20,0
1714212154101,LISP 5A,A00,507541,Munoz Sanchez; Alicia,11,0,20,9
1714212155131,LISP 5B,A00,507671,Munoz Sanchez; Alicia,9,0,20,11
1714212156161,LISP 5C,A00,507696,Munoz Sanchez; Alicia,9,0,20,11
1714212157190,MAE 197,001,528363,Boechler; Nicholas Sebastia,9998,0,9999,1
1714212158215,MATH 197,001,523477,Kedlaya; Kiran S.,9996,0,9999,3
1714212158215,MATH 197,002,563811,Zhang; Danna,9995,0,9999,4
1714212158215,MATH 197,003,628552,Dumitriu; Ioana,9998,0,9999,1
1714212159240,MCWP 40R,A00,518780,Staff,5,0,20,15
1714212159240,MCWP 40R,B00,518781,Staff,7,0,20,13
1714212159240,MCWP 40R,C00,518783,Staff,5,0,20,15
1714212160266,MCWP 50R,A00,518791,Staff,0,0,20,20
1714212160266,MCWP 50R,B00,518792,Staff,0,1,20,20
1714212160266,MCWP 50R,C00,518793,Staff,0,1,20,20
1714212160266,MCWP 50R,D00,518794,Staff,0,0,20,20
1714212160266,MCWP 50R,E00,518795,Staff,0,1,20,20
1714212160266,MCWP 50R,F00,518796,Staff,0,0,20,20
1714212160266,MCWP 50R,G00,518797,Staff,0,1,20,20
1714212161294,MMW 12R,A01,514034,Herbst; Matthew,0,1,16,16
1714212161294,MMW 12R,A02,514035,Herbst; Matthew,2,0,16,14
1714212162319,MMW 13R,A01,514037,Staff,0,4,16,16
1714212162319,MMW 13R,A02,514039,Staff,0,2,16,16
1714212162319,MMW 13R,A03,628519,Staff,0,2,16,16
1714212164371,SIO 295LS,A00,523233,Staff,13,0,30,17
1714212165400,SIO 295S,A00,523232,Staff,13,0,30,17
1714212166425,SIOC 290S,A01,637330,Merrifield; Mark A,28,0,30,2
1714212167459,SIOC 291S,A01,637333,Gabriel; Corey John,28,0,30,2
1714212168485,SOCI 117,A01,494376,Staff,0,2,5,5
1714212169514,WES 237B,A00,494380,Staff,9,0,20,11
1714212171586,AESE 279B,A00,494370,Wade; Jon P,0,0,33,33
1714212172612,AIP 197,001,627712,Vespa; Emanuel Ignacio,9998,0,9999,1
1714212173640,ANAR 135S,A00,494369,Braswell; Geoffrey E.,0,0,0,0
1714212174666,BENG 196,001,628496,Engler; Adam J.,9998,0,9999,1
1714212175694,CAT 124RS,A01,519847,Geibel; William,0,0,20,20
1714212176720,CAT 125RS,A01,515971,Geibel; William,0,0,20,20
1714212177744,CLRE 250,A00,511389,Morris; Sheldon,9993,0,9999,6
1714212178769,CLRE 251,A00,507176,Mehta; Ravindra L.,9993,0,9999,6
1714212178769,CLRE 251,B00,511410,Mehta; Ravindra L.,9998,0,9999,1
1714212179797,CLRE 252,A00,507189,Cuomo; Raphael Eduardo,9995,0,9999,4
1714212180821,CLRE 253,A00,507199,Vaida; Florin,9994,0,9999,5
1714212180821,CLRE 253,B00,507202,Vaida; Florin,9999,0,9999,0
1714212181851,CLRE 259,A00,507211,Patel; Hemal,9996,0,9999,3
1714212182875,CLRE 260,A00,507221,Cuomo; Raphael Eduardo,9999,0,9999,0
1714212183901,CLRE 297,001,507242,Cuomo; Raphael Eduardo,9999,0,9999,0
1714212184927,COGS 197,001,638244,Voytek; Bradley Thomas,9999,0,9999,0
1714212185952,CSE 191,A00,516875,Minnes Kemp; Mor Mia,9993,0,9999,6
1714212186978,CSE 197,001,637388,Minnes Kemp; Mor Mia,9998,0,9999,1
1714212188005,CSS 201S,A01,494383,Staff,35,0,35,0
1714212189034,CSS 202S,A01,494387,Staff,35,0,35,0
1714212190059,DSC 197,001,628532,Eldridge; Justin Matthew,9996,0,9999,3
1714212191086,EAP 100,A00,516065,Staff,9797,0,9999,202
1714212192113,ECE 45,A01,507414,Staff,33,0,60,27
1714212194167,ECE 111,A01,507420,Staff,21,0,50,29
1714212195197,ECE 197,001,548057,Sievenpiper; Daniel F.,9994,0,9999,5
1714212196225,EDS 115,A00,507243,Choi; Bailey Miyeon,12,0,28,16
1714212197255,EDS 117,A01,494379,Staff,0,1,30,30
1714212198282,EDS 125,A00,507246,Hopkins; Megan Beth,12,0,30,18
1714212199307,EDS 128A,A01,507264,Fargason; Sharon Gayle,14,0,26,12
1714212200335,EDS 128B,A01,507293,Pappas; Elizabeth,18,0,30,12
1714212201366,EDS 139,A00,507294,Fargason; Sharon Gayle,18,0,30,12
1714212201366,EDS 139,B00,507313,Pappas; Elizabeth,15,0,30,15
1714212202391,EDS 201,A00,507315,Staff,13,0,30,17
1714212203417,EDS 203,A01,507317,Halter; Christopher P.,12,0,30,18
1714212204443,EDS 204R,A01,507319,Halter; Christopher P.,0,3,30,30
1714212204443,EDS 204R,B01,507331,Heinzman; Erica M.,17,0,30,13
1714212205469,EDS 206R,A00,507332,Staff,0,4,30,30
1714212205469,EDS 206R,B00,507343,Staff,18,0,30,12
1714212206498,EDS 250,A00,507344,Hemans; Patricia Ann Benitez,22,0,40,18
1714212207528,EDS 281,A00,507345,Daly; Alan J.,18,0,18,0
1714212208554,EDS 284,A00,507350,Daly; Alan J.,16,0,16,0
1714212209583,EDS 286,A00,507359,Fine; Sarah,18,0,18,0
1714212210612,EDS 289C,A01,507361,Daly; Alan J.,18,0,18,0
1714212211638,EDS 290,A00,507366,Hofstetter; Carolyn,15,0,15,0
1714212212670,LIGM 5A,A00,507421,Fischer-Grunski; Eva K,18,0,20,2
1714212213696,LIGM 5B,A00,507423,Fischer-Grunski; Eva K,19,0,20,1
1714212214725,LIGM 5C,A00,507425,Fischer-Grunski; Eva K,19,0,20,1
1714212215751,LIIT 5AS,A00,507427,Carnelos; Chiara,20,0,20,0
1714212216781,LIIT 5BS,A00,507430,Carnelos; Chiara,20,0,20,0
1714212217811,LIIT 5CS,A00,507432,Carnelos; Chiara,20,0,20,0
1714212218838,LISP 5A,A00,507541,Munoz Sanchez; Alicia,11,0,20,9
1714212219868,LISP 5B,A00,507671,Munoz Sanchez; Alicia,9,0,20,11
1714212220897,LISP 5C,A00,507696,Munoz Sanchez; Alicia,9,0,20,11
1714212221922,MAE 197,001,528363,Boechler; Nicholas Sebastia,9998,0,9999,1
1714212222952,MATH 197,001,523477,Kedlaya; Kiran S.,9996,0,9999,3
1714212222952,MATH 197,002,563811,Zhang; Danna,9995,0,9999,4
1714212222952,MATH 197,003,628552,Dumitriu; Ioana,9998,0,9999,1
1714212223982,MCWP 40R,A00,518780,Staff,5,0,20,15
1714212223982,MCWP 40R,B00,518781,Staff,7,0,20,13
1714212223982,MCWP 40R,C00,518783,Staff,5,0,20,15
1714212225008,MCWP 50R,A00,518791,Staff,0,0,20,20
1714212225008,MCWP 50R,B00,518792,Staff,0,1,20,20
1714212225008,MCWP 50R,C00,518793,Staff,0,1,20,20
1714212225008,MCWP 50R,D00,518794,Staff,0,0,20,20
1714212225008,MCWP 50R,E00,518795,Staff,0,1,20,20
1714212225008,MCWP 50R,F00,518796,Staff,0,0,20,20
1714212225008,MCWP 50R,G00,518797,Staff,0,1,20,20
1714212226039,MMW 12R,A01,514034,Herbst; Matthew,0,1,16,16
1714212226039,MMW 12R,A02,514035,Herbst; Matthew,2,0,16,14
1714212227064,MMW 13R,A01,514037,Staff,0,4,16,16
1714212227064,MMW 13R,A02,514039,Staff,0,2,16,16
1714212227064,MMW 13R,A03,628519,Staff,0,2,16,16
1714212229115,SIO 295LS,A00,523233,Staff,13,0,30,17
1714212230142,SIO 295S,A00,523232,Staff,13,0,30,17
1714212231169,SIOC 290S,A01,637330,Merrifield; Mark A,28,0,30,2
1714212232196,SIOC 291S,A01,637333,Gabriel; Corey John,28,0,30,2
1714212233223,SOCI 117,A01,494376,Staff,0,2,5,5
1714212234250,WES 237B,A00,494380,Staff,9,0,20,11
1714212236327,AESE 279B,A00,494370,Wade; Jon P,0,0,33,33
1714212237353,AIP 197,001,627712,Vespa; Emanuel Ignacio,9998,0,9999,1
1714212238379,ANAR 135S,A00,494369,Braswell; Geoffrey E.,0,0,0,0
1714212239407,BENG 196,001,628496,Engler; Adam J.,9998,0,9999,1
1714212240435,CAT 124RS,A01,519847,Geibel; William,0,0,20,20
1714212241459,CAT 125RS,A01,515971,Geibel; William,0,0,20,20
1714212242490,CLRE 250,A00,511389,Morris; Sheldon,9993,0,9999,6
1714212243524,CLRE 251,A00,507176,Mehta; Ravindra L.,9993,0,9999,6
1714212243524,CLRE 251,B00,511410,Mehta; Ravindra L.,9998,0,9999,1
1714212244550,CLRE 252,A00,507189,Cuomo; Raphael Eduardo,9995,0,9999,4
1714212245576,CLRE 253,A00,507199,Vaida; Florin,9994,0,9999,5
1714212245576,CLRE 253,B00,507202,Vaida; Florin,9999,0,9999,0
1714212246603,CLRE 259,A00,507211,Patel; Hemal,9996,0,9999,3
1714212247628,CLRE 260,A00,507221,Cuomo; Raphael Eduardo,9999,0,9999,0
1714212248653,CLRE 297,001,507242,Cuomo; Raphael Eduardo,9999,0,9999,0
1714212249678,COGS 197,001,638244,Voytek; Bradley Thomas,9999,0,9999,0
1714212250707,CSE 191,A00,516875,Minnes Kemp; Mor Mia,9993,0,9999,6
1714212251732,CSE 197,001,637388,Minnes Kemp; Mor Mia,9998,0,9999,1
1714212252760,CSS 201S,A01,494383,Staff,35,0,35,0
1714212253785,CSS 202S,A01,494387,Staff,35,0,35,0
1714212254875,DSC 197,001,628532,Eldridge; Justin Matthew,9996,0,9999,3
1714212255902,EAP 100,A00,516065,Staff,9797,0,9999,202
1714212256928,ECE 45,A01,507414,Staff,33,0,60,27
1714212258982,ECE 111,A01,507420,Staff,21,0,50,29
1714212260008,ECE 197,001,548057,Sievenpiper; Daniel F.,9994,0,9999,5
1714212261036,EDS 115,A00,507243,Choi; Bailey Miyeon,12,0,28,16
1714212262061,EDS 117,A01,494379,Staff,0,1,30,30
1714212263085,EDS 125,A00,507246,Hopkins; Megan Beth,12,0,30,18
1714212264109,EDS 128A,A01,507264,Fargason; Sharon Gayle,14,0,26,12
1714212265139,EDS 128B,A01,507293,Pappas; Elizabeth,18,0,30,12
1714212266165,EDS 139,A00,507294,Fargason; Sharon Gayle,18,0,30,12
1714212266165,EDS 139,B00,507313,Pappas; Elizabeth,15,0,30,15
1714212267197,EDS 201,A00,507315,Staff,13,0,30,17
1714212268227,EDS 203,A01,507317,Halter; Christopher P.,12,0,30,18
1714212269256,EDS 204R,A01,507319,Halter; Christopher P.,0,3,30,30
1714212269256,EDS 204R,B01,507331,Heinzman; Erica M.,17,0,30,13
1714212270280,EDS 206R,A00,507332,Staff,0,4,30,30
1714212270280,EDS 206R,B00,507343,Staff,18,0,30,12
1714212271308,EDS 250,A00,507344,Hemans; Patricia Ann Benitez,22,0,40,18
1714212272334,EDS 281,A00,507345,Daly; Alan J.,18,0,18,0
1714212273359,EDS 284,A00,507350,Daly; Alan J.,16,0,16,0
1714212274389,EDS 286,A00,507359,Fine; Sarah,18,0,18,0
1714212275414,EDS 289C,A01,507361,Daly; Alan J.,18,0,18,0
1714212276440,EDS 290,A00,507366,Hofstetter; Carolyn,15,0,15,0
1714212277471,LIGM 5A,A00,507421,Fischer-Grunski; Eva K,18,0,20,2
1714212278499,LIGM 5B,A00,507423,Fischer-Grunski; Eva K,19,0,20,1
1714212279525,LIGM 5C,A00,507425,Fischer-Grunski; Eva K,19,0,20,1
1714212280551,LIIT 5AS,A00,507427,Carnelos; Chiara,20,0,20,0
1714212281582,LIIT 5BS,A00,507430,Carnelos; Chiara,20,0,20,0
1714212282608,LIIT 5CS,A00,507432,Carnelos; Chiara,20,0,20,0
1714212283640,LISP 5A,A00,507541,Munoz Sanchez; Alicia,11,0,20,9
1714212284666,LISP 5B,A00,507671,Munoz Sanchez; Alicia,9,0,20,11
1714212285696,LISP 5C,A00,507696,Munoz Sanchez; Alicia,9,0,20,11
1714212286725,MAE 197,001,528363,Boechler; Nicholas Sebastia,9998,0,9999,1
1714212287759,MATH 197,001,523477,Kedlaya; Kiran S.,9996,0,9999,3
1714212287759,MATH 197,002,563811,Zhang; Danna,9995,0,9999,4
1714212287759,MATH 197,003,628552,Dumitriu; Ioana,9998,0,9999,1
1714212288791,MCWP 40R,A00,518780,Staff,5,0,20,15
1714212288791,MCWP 40R,B00,518781,Staff,7,0,20,13
1714212288791,MCWP 40R,C00,518783,Staff,5,0,20,15
1714212289822,MCWP 50R,A00,518791,Staff,0,0,20,20
1714212289822,MCWP 50R,B00,518792,Staff,0,1,20,20
1714212289822,MCWP 50R,C00,518793,Staff,0,1,20,20
1714212289822,MCWP 50R,D00,518794,Staff,0,0,20,20
1714212289822,MCWP 50R,E00,518795,Staff,0,1,20,20
1714212289822,MCWP 50R,F00,518796,Staff,0,0,20,20
1714212289822,MCWP 50R,G00,518797,Staff,0,1,20,20
1714212290854,MMW 12R,A01,514034,Herbst; Matthew,0,1,16,16
1714212290854,MMW 12R,A02,514035,Herbst; Matthew,2,0,16,14
1714212291880,MMW 13R,A01,514037,Staff,0,4,16,16
1714212291880,MMW 13R,A02,514039,Staff,0,2,16,16
1714212291880,MMW 13R,A03,628519,Staff,0,2,16,16
1714212293931,SIO 295LS,A00,523233,Staff,13,0,30,17
1714212294961,SIO 295S,A00,523232,Staff,13,0,30,17
1714212295988,SIOC 290S,A01,637330,Merrifield; Mark A,28,0,30,2
1714212297015,SIOC 291S,A01,637333,Gabriel; Corey John,28,0,30,2
1714212298044,SOCI 117,A01,494376,Staff,0,2,5,5
1714212299077,WES 237B,A00,494380,Staff,9,0,20,11
1714212301223,AESE 279B,A00,494370,Wade; Jon P,0,0,33,33
1714212302252,AIP 197,001,627712,Vespa; Emanuel Ignacio,9998,0,9999,1
1714212303276,ANAR 135S,A00,494369,Braswell; Geoffrey E.,0,0,0,0
1714212304304,BENG 196,001,628496,Engler; Adam J.,9998,0,9999,1
1714212305333,CAT 124RS,A01,519847,Geibel; William,0,0,20,20
1714212306360,CAT 125RS,A01,515971,Geibel; William,0,0,20,20
1714212307385,CLRE 250,A00,511389,Morris; Sheldon,9993,0,9999,6
1714212308411,CLRE 251,A00,507176,Mehta; Ravindra L.,9993,0,9999,6
1714212308411,CLRE 251,B00,511410,Mehta; Ravindra L.,9998,0,9999,1
1714212309436,CLRE 252,A00,507189,Cuomo; Raphael Eduardo,9995,0,9999,4
1714212310462,CLRE 253,A00,507199,Vaida; Florin,9994,0,9999,5
1714212310462,CLRE 253,B00,507202,Vaida; Florin,9999,0,9999,0
1714212311487,CLRE 259,A00,507211,Patel; Hemal,9996,0,9999,3
1714212312511,CLRE 260,A00,507221,Cuomo; Raphael Eduardo,9999,0,9999,0
1714212313539,CLRE 297,001,507242,Cuomo; Raphael Eduardo,9999,0,9999,0
1714212314564,COGS 197,001,638244,Voytek; Bradley Thomas,9999,0,9999,0
1714212315589,CSE 191,A00,516875,Minnes Kemp; Mor Mia,9993,0,9999,6
1714212316616,CSE 197,001,637388,Minnes Kemp; Mor Mia,9998,0,9999,1
1714212317642,CSS 201S,A01,494383,Staff,35,0,35,0
1714212318667,CSS 202S,A01,494387,Staff,35,0,35,0
1714212319693,DSC 197,001,628532,Eldridge; Justin Matthew,9996,0,9999,3
1714212320719,EAP 100,A00,516065,Staff,9797,0,9999,202
1714212321743,ECE 45,A01,507414,Staff,33,0,60,27
1714212323791,ECE 111,A01,507420,Staff,21,0,50,29
1714212324815,ECE 197,001,548057,Sievenpiper; Daniel F.,9994,0,9999,5
1714212325840,EDS 115,A00,507243,Choi; Bailey Miyeon,12,0,28,16
1714212326865,EDS 117,A01,494379,Staff,0,1,30,30
1714212327892,EDS 125,A00,507246,Hopkins; Megan Beth,12,0,30,18
1714212328917,EDS 128A,A01,507264,Fargason; Sharon Gayle,14,0,26,12
1714212329945,EDS 128B,A01,507293,Pappas; Elizabeth,18,0,30,12
1714212330974,EDS 139,A00,507294,Fargason; Sharon Gayle,18,0,30,12
1714212330974,EDS 139,B00,507313,Pappas; Elizabeth,15,0,30,15
1714212332001,EDS 201,A00,507315,Staff,13,0,30,17
1714212333030,EDS 203,A01,507317,Halter; Christopher P.,12,0,30,18
1714212334054,EDS 204R,A01,507319,Halter; Christopher P.,0,3,30,30
1714212334054,EDS 204R,B01,507331,Heinzman; Erica M.,17,0,30,13
1714212335079,EDS 206R,A00,507332,Staff,0,4,30,30
1714212335079,EDS 206R,B00,507343,Staff,18,0,30,12
1714212336104,EDS 250,A00,507344,Hemans; Patricia Ann Benitez,22,0,40,18
1714212337128,EDS 281,A00,507345,Daly; Alan J.,18,0,18,0
1714212338153,EDS 284,A00,507350,Daly; Alan J.,16,0,16,0
1714212339179,EDS 286,A00,507359,Fine; Sarah,18,0,18,0
1714212340205,EDS 289C,A01,507361,Daly; Alan J.,18,0,18,0
1714212341231,EDS 290,A00,507366,Hofstetter; Carolyn,15,0,15,0
1714212342261,LIGM 5A,A00,507421,Fischer-Grunski; Eva K,18,0,20,2
1714212343285,LIGM 5B,A00,507423,Fischer-Grunski; Eva K,19,0,20,1
1714212344309,LIGM 5C,A00,507425,Fischer-Grunski; Eva K,19,0,20,1
1714212345334,LIIT 5AS,A00,507427,Carnelos; Chiara,20,0,20,0
1714212346359,LIIT 5BS,A00,507430,Carnelos; Chiara,20,0,20,0
1714212347388,LIIT 5CS,A00,507432,Carnelos; Chiara,20,0,20,0
1714212348418,LISP 5A,A00,507541,Munoz Sanchez; Alicia,11,0,20,9
1714212349447,LISP 5B,A00,507671,Munoz Sanchez; Alicia,9,0,20,11
1714212350473,LISP 5C,A00,507696,Munoz Sanchez; Alicia,9,0,20,11
1714212351498,MAE 197,001,528363,Boechler; Nicholas Sebastia,9998,0,9999,1
1714212352522,MATH 197,001,523477,Kedlaya; Kiran S.,9996,0,9999,3
1714212352522,MATH 197,002,563811,Zhang; Danna,9995,0,9999,4
1714212352522,MATH 197,003,628552,Dumitriu; Ioana,9998,0,9999,1
1714212353547,MCWP 40R,A00,518780,Staff,5,0,20,15
1714212353547,MCWP 40R,B00,518781,Staff,7,0,20,13
1714212353547,MCWP 40R,C00,518783,Staff,5,0,20,15
1714212354578,MCWP 50R,A00,518791,Staff,0,0,20,20
1714212354578,MCWP 50R,B00,518792,Staff,0,1,20,20
1714212354578,MCWP 50R,C00,518793,Staff,0,1,20,20
1714212354578,MCWP 50R,D00,518794,Staff,0,0,20,20
1714212354578,MCWP 50R,E00,518795,Staff,0,1,20,20
1714212354578,MCWP 50R,F00,518796,Staff,0,0,20,20
1714212354578,MCWP 50R,G00,518797,Staff,0,1,20,20
1714212355603,MMW 12R,A01,514034,Herbst; Matthew,0,1,16,16
1714212355603,MMW 12R,A02,514035,Herbst; Matthew,2,0,16,14
1714212356628,MMW 13R,A01,514037,Staff,0,4,16,16
1714212356628,MMW 13R,A02,514039,Staff,0,2,16,16
1714212356628,MMW 13R,A03,628519,Staff,0,2,16,16
1714212358737,SIO 295LS,A00,523233,Staff,13,0,30,17
1714212359766,SIO 295S,A00,523232,Staff,13,0,30,17
1714212360798,SIOC 290S,A01,637330,Merrifield; Mark A,28,0,30,2
1714212361824,SIOC 291S,A01,637333,Gabriel; Corey John,28,0,30,2
1714212362854,SOCI 117,A01,494376,Staff,0,2,5,5
1714212363884,WES 237B,A00,494380,Staff,9,0,20,11
1714212365943,AESE 279B,A00,494370,Wade; Jon P,0,0,33,33
1714212366969,AIP 197,001,627712,Vespa; Emanuel Ignacio,9998,0,9999,1
1714212367996,ANAR 135S,A00,494369,Braswell; Geoffrey E.,0,0,0,0
1714212369019,BENG 196,001,628496,Engler; Adam J.,9998,0,9999,1
1714212370047,CAT 124RS,A01,519847,Geibel; William,0,0,20,20
1714212371073,CAT 125RS,A01,515971,Geibel; William,0,0,20,20
1714212372099,CLRE 250,A00,511389,Morris; Sheldon,9993,0,9999,6
1714212373128,CLRE 251,A00,507176,Mehta; Ravindra L.,9993,0,9999,6
1714212373128,CLRE 251,B00,511410,Mehta; Ravindra L.,9998,0,9999,1
1714212374157,CLRE 252,A00,507189,Cuomo; Raphael Eduardo,9995,0,9999,4
1714212375189,CLRE 253,A00,507199,Vaida; Florin,9994,0,9999,5
1714212375189,CLRE 253,B00,507202,Vaida; Florin,9999,0,9999,0
1714212376214,CLRE 259,A00,507211,Patel; Hemal,9996,0,9999,3
1714212377240,CLRE 260,A00,507221,Cuomo; Raphael Eduardo,9999,0,9999,0
1714212378268,CLRE 297,001,507242,Cuomo; Raphael Eduardo,9999,0,9999,0
1714212379297,COGS 197,001,638244,Voytek; Bradley Thomas,9999,0,9999,0
1714212380321,CSE 191,A00,516875,Minnes Kemp; Mor Mia,9993,0,9999,6
1714212381345,CSE 197,001,637388,Minnes Kemp; Mor Mia,9998,0,9999,1
1714212382371,CSS 201S,A01,494383,Staff,35,0,35,0
1714212383401,CSS 202S,A01,494387,Staff,35,0,35,0
1714212384425,DSC 197,001,628532,Eldridge; Justin Matthew,9996,0,9999,3
1714212385451,EAP 100,A00,516065,Staff,9797,0,9999,202
1714212386476,ECE 45,A01,507414,Staff,33,0,60,27
1714212388526,ECE 111,A01,507420,Staff,21,0,50,29
1714212389550,ECE 197,001,548057,Sievenpiper; Daniel F.,9994,0,9999,5
1714212390575,EDS 115,A00,507243,Choi; Bailey Miyeon,12,0,28,16
1714212391604,EDS 117,A01,494379,Staff,0,1,30,30
1714212392632,EDS 125,A00,507246,Hopkins; Megan Beth,12,0,30,18
1714212393657,EDS 128A,A01,507264,Fargason; Sharon Gayle,14,0,26,12
1714212394681,EDS 128B,A01,507293,Pappas; Elizabeth,18,0,30,12
1714212395708,EDS 139,A00,507294,Fargason; Sharon Gayle,18,0,30,12
1714212395708,EDS 139,B00,507313,Pappas; Elizabeth,15,0,30,15
1714212396733,EDS 201,A00,507315,Staff,13,0,30,17
1714212397758,EDS 203,A01,507317,Halter; Christopher P.,12,0,30,18
1714212398781,EDS 204R,A01,507319,Halter; Christopher P.,0,3,30,30
1714212398781,EDS 204R,B01,507331,Heinzman; Erica M.,17,0,30,13
1714212399806,EDS 206R,A00,507332,Staff,0,4,30,30
1714212399806,EDS 206R,B00,507343,Staff,18,0,30,12
1714212400831,EDS 250,A00,507344,Hemans; Patricia Ann Benitez,22,0,40,18
1714212401860,EDS 281,A00,507345,Daly; Alan J.,18,0,18,0
1714212402887,EDS 284,A00,507350,Daly; Alan J.,16,0,16,0
1714212403912,EDS 286,A00,507359,Fine; Sarah,18,0,18,0
1714212404942,EDS 289C,A01,507361,Daly; Alan J.,18,0,18,0
1714212405967,EDS 290,A00,507366,Hofstetter; Carolyn,15,0,15,0
1714212406993,LIGM 5A,A00,507421,Fischer-Grunski; Eva K,18,0,20,2
1714212408018,LIGM 5B,A00,507423,Fischer-Grunski; Eva K,19,0,20,1
1714212409042,LIGM 5C,A00,507425,Fischer-Grunski; Eva K,19,0,20,1
1714212410071,LIIT 5AS,A00,507427,Carnelos; Chiara,20,0,20,0
1714212411099,LIIT 5BS,A00,507430,Carnelos; Chiara,20,0,20,0
1714212412124,LIIT 5CS,A00,507432,Carnelos; Chiara,20,0,20,0
1714212413154,LISP 5A,A00,507541,Munoz Sanchez; Alicia,11,0,20,9
1714212414180,LISP 5B,A00,507671,Munoz Sanchez; Alicia,9,0,20,11
1714212415206,LISP 5C,A00,507696,Munoz Sanchez; Alicia,9,0,20,11
1714212416234,MAE 197,001,528363,Boechler; Nicholas Sebastia,9998,0,9999,1
1714212417263,MATH 197,001,523477,Kedlaya; Kiran S.,9996,0,9999,3
1714212417263,MATH 197,002,563811,Zhang; Danna,9995,0,9999,4
1714212417263,MATH 197,003,628552,Dumitriu; Ioana,9998,0,9999,1
1714212418290,MCWP 40R,A00,518780,Staff,5,0,20,15
1714212418290,MCWP 40R,B00,518781,Staff,7,0,20,13
1714212418290,MCWP 40R,C00,518783,Staff,5,0,20,15
1714212419320,MCWP 50R,A00,518791,Staff,0,0,20,20
1714212419320,MCWP 50R,B00,518792,Staff,0,1,20,20
1714212419320,MCWP 50R,C00,518793,Staff,0,1,20,20
1714212419320,MCWP 50R,D00,518794,Staff,0,0,20,20
1714212419320,MCWP 50R,E00,518795,Staff,0,1,20,20
1714212419320,MCWP 50R,F00,518796,Staff,0,0,20,20
1714212419320,MCWP 50R,G00,518797,Staff,0,1,20,20
1714212420351,MMW 12R,A01,514034,Herbst; Matthew,0,1,16,16
1714212420351,MMW 12R,A02,514035,Herbst; Matthew,2,0,16,14
1714212421380,MMW 13R,A01,514037,Staff,0,4,16,16
1714212421380,MMW 13R,A02,514039,Staff,0,2,16,16
1714212421380,MMW 13R,A03,628519,Staff,0,2,16,16
1714212423431,SIO 295LS,A00,523233,Staff,13,0,30,17
1714212424458,SIO 295S,A00,523232,Staff,13,0,30,17
1714212425483,SIOC 290S,A01,637330,Merrifield; Mark A,28,0,30,2
1714212426513,SIOC 291S,A01,637333,Gabriel; Corey John,28,0,30,2
1714212427539,SOCI 117,A01,494376,Staff,0,2,5,5
1714212428564,WES 237B,A00,494380,Staff,9,0,20,11
1714212430633,AESE 279B,A00,494370,Wade; Jon P,0,0,33,33
1714212431659,AIP 197,001,627712,Vespa; Emanuel Ignacio,9998,0,9999,1
1714212432684,ANAR 135S,A00,494369,Braswell; Geoffrey E.,0,0,0,0
1714212433710,BENG 196,001,628496,Engler; Adam J.,9998,0,9999,1
1714212434736,CAT 124RS,A01,519847,Geibel; William,0,0,20,20
1714212435761,CAT 125RS,A01,515971,Geibel; William,0,0,20,20
1714212436786,CLRE 250,A00,511389,Morris; Sheldon,9993,0,9999,6
1714212437817,CLRE 251,A00,507176,Mehta; Ravindra L.,9993,0,9999,6
1714212437817,CLRE 251,B00,511410,Mehta; Ravindra L.,9998,0,9999,1
1714212438845,CLRE 252,A00,507189,Cuomo; Raphael Eduardo,9995,0,9999,4
1714212439870,CLRE 253,A00,507199,Vaida; Florin,9994,0,9999,5
1714212439870,CLRE 253,B00,507202,Vaida; Florin,9999,0,9999,0
1714212440896,CLRE 259,A00,507211,Patel; Hemal,9996,0,9999,3
1714212441920,CLRE 260,A00,507221,Cuomo; Raphael Eduardo,9999,0,9999,0
1714212442950,CLRE 297,001,507242,Cuomo; Raphael Eduardo,9999,0,9999,0
1714212443976,COGS 197,001,638244,Voytek; Bradley Thomas,9999,0,9999,0
1714212445005,CSE 191,A00,516875,Minnes Kemp; Mor Mia,9993,0,9999,6
1714212446031,CSE 197,001,637388,Minnes Kemp; Mor Mia,9998,0,9999,1
1714212447060,CSS 201S,A01,494383,Staff,35,0,35,0
1714212448090,CSS 202S,A01,494387,Staff,35,0,35,0
1714212449117,DSC 197,001,628532,Eldridge; Justin Matthew,9996,0,9999,3
1714212450147,EAP 100,A00,516065,Staff,9797,0,9999,202
1714212451176,ECE 45,A01,507414,Staff,33,0,60,27
1714212453235,ECE 111,A01,507420,Staff,21,0,50,29
1714212454265,ECE 197,001,548057,Sievenpiper; Daniel F.,9994,0,9999,5
1714212455291,EDS 115,A00,507243,Choi; Bailey Miyeon,12,0,28,16
1714212456317,EDS 117,A01,494379,Staff,0,1,30,30
1714212457349,EDS 125,A00,507246,Hopkins; Megan Beth,12,0,30,18
1714212458374,EDS 128A,A01,507264,Fargason; Sharon Gayle,14,0,26,12
1714212459400,EDS 128B,A01,507293,Pappas; Elizabeth,18,0,30,12
1714212460426,EDS 139,A00,507294,Fargason; Sharon Gayle,18,0,30,12
1714212460426,EDS 139,B00,507313,Pappas; Elizabeth,15,0,30,15
1714212461451,EDS 201,A00,507315,Staff,13,0,30,17
1714212462530,EDS 203,A01,507317,Halter; Christopher P.,12,0,30,18
1714212463555,EDS 204R,A01,507319,Halter; Christopher P.,0,3,30,30
1714212463555,EDS 204R,B01,507331,Heinzman; Erica M.,17,0,30,13
1714212464579,EDS 206R,A00,507332,Staff,0,4,30,30
1714212464579,EDS 206R,B00,507343,Staff,18,0,30,12
1714212465603,EDS 250,A00,507344,Hemans; Patricia Ann Benitez,22,0,40,18
1714212466631,EDS 281,A00,507345,Daly; Alan J.,18,0,18,0
1714212467659,EDS 284,A00,507350,Daly; Alan J.,16,0,16,0
1714212468684,EDS 286,A00,507359,Fine; Sarah,18,0,18,0
1714212469709,EDS 289C,A01,507361,Daly; Alan J.,18,0,18,0
1714212470735,EDS 290,A00,507366,Hofstetter; Carolyn,15,0,15,0
1714212471764,LIGM 5A,A00,507421,Fischer-Grunski; Eva K,18,0,20,2
1714212472793,LIGM 5B,A00,507423,Fischer-Grunski; Eva K,19,0,20,1
1714212473817,LIGM 5C,A00,507425,Fischer-Grunski; Eva K,19,0,20,1
1714212474842,LIIT 5AS,A00,507427,Carnelos; Chiara,20,0,20,0
1714212475868,LIIT 5BS,A00,507430,Carnelos; Chiara,20,0,20,0
1714212476897,LIIT 5CS,A00,507432,Carnelos; Chiara,20,0,20,0
1714212477922,LISP 5A,A00,507541,Munoz Sanchez; Alicia,11,0,20,9
1714212478948,LISP 5B,A00,507671,Munoz Sanchez; Alicia,9,0,20,11
1714212479974,LISP 5C,A00,507696,Munoz Sanchez; Alicia,9,0,20,11
1714212480999,MAE 197,001,528363,Boechler; Nicholas Sebastia,9998,0,9999,1
1714212482023,MATH 197,001,523477,Kedlaya; Kiran S.,9996,0,9999,3
1714212482023,MATH 197,002,563811,Zhang; Danna,9995,0,9999,4
1714212482023,MATH 197,003,628552,Dumitriu; Ioana,9998,0,9999,1
1714212483054,MCWP 40R,A00,518780,Staff,5,0,20,15
1714212483054,MCWP 40R,B00,518781,Staff,7,0,20,13
1714212483054,MCWP 40R,C00,518783,Staff,5,0,20,15
1714212484080,MCWP 50R,A00,518791,Staff,0,0,20,20
1714212484080,MCWP 50R,B00,518792,Staff,0,1,20,20
1714212484080,MCWP 50R,C00,518793,Staff,0,1,20,20
1714212484080,MCWP 50R,D00,518794,Staff,0,0,20,20
1714212484080,MCWP 50R,E00,518795,Staff,0,1,20,20
1714212484080,MCWP 50R,F00,518796,Staff,0,0,20,20
1714212484080,MCWP 50R,G00,518797,Staff,0,1,20,20
1714212485108,MMW 12R,A01,514034,Herbst; Matthew,0,1,16,16
1714212485108,MMW 12R,A02,514035,Herbst; Matthew,2,0,16,14
1714212486137,MMW 13R,A01,514037,Staff,0,4,16,16
1714212486137,MMW 13R,A02,514039,Staff,0,2,16,16
1714212486137,MMW 13R,A03,628519,Staff,0,2,16,16
1714212488188,SIO 295LS,A00,523233,Staff,13,0,30,17
1714212489216,SIO 295S,A00,523232,Staff,13,0,30,17
1714212490243,SIOC 290S,A01,637330,Merrifield; Mark A,28,0,30,2
1714212491273,SIOC 291S,A01,637333,Gabriel; Corey John,28,0,30,2
1714212492299,SOCI 117,A01,494376,Staff,0,2,5,5
1714212493328,WES 237B,A00,494380,Staff,9,0,20,11
1714212495416,AESE 279B,A00,494370,Wade; Jon P,0,0,33,33
1714212496443,AIP 197,001,627712,Vespa; Emanuel Ignacio,9998,0,9999,1
1714212497472,ANAR 135S,A00,494369,Braswell; Geoffrey E.,0,0,0,0
1714212498503,BENG 196,001,628496,Engler; Adam J.,9998,0,9999,1
1714212499532,CAT 124RS,A01,519847,Geibel; William,0,0,20,20
1714212500563,CAT 125RS,A01,515971,Geibel; William,0,0,20,20
1714212501592,CLRE 250,A00,511389,Morris; Sheldon,9993,0,9999,6
1714212502623,CLRE 251,A00,507176,Mehta; Ravindra L.,9993,0,9999,6
1714212502623,CLRE 251,B00,511410,Mehta; Ravindra L.,9998,0,9999,1
1714212503647,CLRE 252,A00,507189,Cuomo; Raphael Eduardo,9995,0,9999,4
1714212504676,CLRE 253,A00,507199,Vaida; Florin,9994,0,9999,5
1714212504676,CLRE 253,B00,507202,Vaida; Florin,9999,0,9999,0
1714212505705,CLRE 259,A00,507211,Patel; Hemal,9996,0,9999,3
1714212506735,CLRE 260,A00,507221,Cuomo; Raphael Eduardo,9999,0,9999,0
1714212507763,CLRE 297,001,507242,Cuomo; Raphael Eduardo,9999,0,9999,0
1714212508791,COGS 197,001,638244,Voytek; Bradley Thomas,9999,0,9999,0
1714212509820,CSE 191,A00,516875,Minnes Kemp; Mor Mia,9993,0,9999,6
1714212510849,CSE 197,001,637388,Minnes Kemp; Mor Mia,9998,0,9999,1
1714212511875,CSS 201S,A01,494383,Staff,35,0,35,0
1714212512903,CSS 202S,A01,494387,Staff,35,0,35,0
1714212513929,DSC 197,001,628532,Eldridge; Justin Matthew,9996,0,9999,3
1714212514952,EAP 100,A00,516065,Staff,9797,0,9999,202
1714212515978,ECE 45,A01,507414,Staff,33,0,60,27
1714212518032,ECE 111,A01,507420,Staff,21,0,50,29
1714212519058,ECE 197,001,548057,Sievenpiper; Daniel F.,9994,0,9999,5
1714212520090,EDS 115,A00,507243,Choi; Bailey Miyeon,12,0,28,16
1714212521116,EDS 117,A01,494379,Staff,0,1,30,30
1714212522144,EDS 125,A00,507246,Hopkins; Megan Beth,12,0,30,18
1714212523174,EDS 128A,A01,507264,Fargason; Sharon Gayle,14,0,26,12
1714212524199,EDS 128B,A01,507293,Pappas; Elizabeth,18,0,30,12
1714212525227,EDS 139,A00,507294,Fargason; Sharon Gayle,18,0,30,12
1714212525227,EDS 139,B00,507313,Pappas; Elizabeth,15,0,30,15
1714212526251,EDS 201,A00,507315,Staff,13,0,30,17
1714212527280,EDS 203,A01,507317,Halter; Christopher P.,12,0,30,18
1714212528305,EDS 204R,A01,507319,Halter; Christopher P.,0,3,30,30
1714212528305,EDS 204R,B01,507331,Heinzman; Erica M.,17,0,30,13
1714212529335,EDS 206R,A00,507332,Staff,0,4,30,30
1714212529335,EDS 206R,B00,507343,Staff,18,0,30,12
1714212530360,EDS 250,A00,507344,Hemans; Patricia Ann Benitez,22,0,40,18
1714212531389,EDS 281,A00,507345,Daly; Alan J.,18,0,18,0
1714212532414,EDS 284,A00,507350,Daly; Alan J.,16,0,16,0
1714212533440,EDS 286,A00,507359,Fine; Sarah,18,0,18,0
1714212534466,EDS 289C,A01,507361,Daly; Alan J.,18,0,18,0
1714212535493,EDS 290,A00,507366,Hofstetter; Carolyn,15,0,15,0
1714212536521,LIGM 5A,A00,507421,Fischer-Grunski; Eva K,18,0,20,2
1714212537545,LIGM 5B,A00,507423,Fischer-Grunski; Eva K,19,0,20,1
1714212538570,LIGM 5C,A00,507425,Fischer-Grunski; Eva K,19,0,20,1
1714212539596,LIIT 5AS,A00,507427,Carnelos; Chiara,20,0,20,0
1714212540622,LIIT 5BS,A00,507430,Carnelos; Chiara,20,0,20,0
1714212541650,LIIT 5CS,A00,507432,Carnelos; Chiara,20,0,20,0
1714212542680,LISP 5A,A00,507541,Munoz Sanchez; Alicia,11,0,20,9
1714212543705,LISP 5B,A00,507671,Munoz Sanchez; Alicia,9,0,20,11
1714212544735,LISP 5C,A00,507696,Munoz Sanchez; Alicia,9,0,20,11
1714212545762,MAE 197,001,528363,Boechler; Nicholas Sebastia,9998,0,9999,1
1714212546795,MATH 197,001,523477,Kedlaya; Kiran S.,9996,0,9999,3
1714212546795,MATH 197,002,563811,Zhang; Danna,9995,0,9999,4
1714212546795,MATH 197,003,628552,Dumitriu; Ioana,9998,0,9999,1
1714212547823,MCWP 40R,A00,518780,Staff,5,0,20,15
1714212547823,MCWP 40R,B00,518781,Staff,7,0,20,13
1714212547823,MCWP 40R,C00,518783,Staff,5,0,20,15
1714212548852,MCWP 50R,A00,518791,Staff,0,0,20,20
1714212548852,MCWP 50R,B00,518792,Staff,0,1,20,20
1714212548852,MCWP 50R,C00,518793,Staff,0,1,20,20
1714212548852,MCWP 50R,D00,518794,Staff,0,0,20,20
1714212548852,MCWP 50R,E00,518795,Staff,0,1,20,20
1714212548852,MCWP 50R,F00,518796,Staff,0,0,20,20
1714212548852,MCWP 50R,G00,518797,Staff,0,1,20,20
1714212549876,MMW 12R,A01,514034,Herbst; Matthew,0,1,16,16
1714212549876,MMW 12R,A02,514035,Herbst; Matthew,2,0,16,14
1714212550903,MMW 13R,A01,514037,Staff,0,4,16,16
1714212550903,MMW 13R,A02,514039,Staff,0,2,16,16
1714212550903,MMW 13R,A03,628519,Staff,0,2,16,16
1714212552955,SIO 295LS,A00,523233,Staff,13,0,30,17
1714212553981,SIO 295S,A00,523232,Staff,13,0,30,17
1714212555011,SIOC 290S,A01,637330,Merrifield; Mark A,28,0,30,2
1714212556040,SIOC 291S,A01,637333,Gabriel; Corey John,28,0,30,2
1714212557069,SOCI 117,A01,494376,Staff,0,2,5,5
1714212558094,WES 237B,A00,494380,Staff,9,0,20,11
1714212560179,AESE 279B,A00,494370,Wade; Jon P,0,0,33,33
1714212561203,AIP 197,001,627712,Vespa; Emanuel Ignacio,9998,0,9999,1
1714212562229,ANAR 135S,A00,494369,Braswell; Geoffrey E.,0,0,0,0
1714212563255,BENG 196,001,628496,Engler; Adam J.,9998,0,9999,1
1714212564281,CAT 124RS,A01,519847,Geibel; William,0,0,20,20
1714212565307,CAT 125RS,A01,515971,Geibel; William,0,0,20,20
1714212566389,CLRE 250,A00,511389,Morris; Sheldon,9993,0,9999,6
1714212567460,CLRE 251,A00,507176,Mehta; Ravindra L.,9993,0,9999,6
1714212567460,CLRE 251,B00,511410,Mehta; Ravindra L.,9998,0,9999,1
1714212568484,CLRE 252,A00,507189,Cuomo; Raphael Eduardo,9995,0,9999,4
1714212569511,CLRE 253,A00,507199,Vaida; Florin,9994,0,9999,5
1714212569511,CLRE 253,B00,507202,Vaida; Florin,9999,0,9999,0
1714212570536,CLRE 259,A00,507211,Patel; Hemal,9996,0,9999,3
1714212571564,CLRE 260,A00,507221,Cuomo; Raphael Eduardo,9999,0,9999,0
1714212572592,CLRE 297,001,507242,Cuomo; Raphael Eduardo,9999,0,9999,0
1714212573619,COGS 197,001,638244,Voytek; Bradley Thomas,9999,0,9999,0
1714212574643,CSE 191,A00,516875,Minnes Kemp; Mor Mia,9993,0,9999,6
1714212575668,CSE 197,001,637388,Minnes Kemp; Mor Mia,9998,0,9999,1
1714212576697,CSS 201S,A01,494383,Staff,35,0,35,0
1714212577726,CSS 202S,A01,494387,Staff,35,0,35,0
1714212578750,DSC 197,001,628532,Eldridge; Justin Matthew,9996,0,9999,3
1714212579775,EAP 100,A00,516065,Staff,9797,0,9999,202
1714212580804,ECE 45,A01,507414,Staff,33,0,60,27
1714212582858,ECE 111,A01,507420,Staff,21,0,50,29
1714212583893,ECE 197,001,548057,Sievenpiper; Daniel F.,9994,0,9999,5
1714212584918,EDS 115,A00,507243,Choi; Bailey Miyeon,12,0,28,16
1714212585943,EDS 117,A01,494379,Staff,0,1,30,30
1714212586974,EDS 125,A00,507246,Hopkins; Megan Beth,12,0,30,18
1714212587997,EDS 128A,A01,507264,Fargason; Sharon Gayle,14,0,26,12
1714212589026,EDS 128B,A01,507293,Pappas; Elizabeth,18,0,30,12
1714212590051,EDS 139,A00,507294,Fargason; Sharon Gayle,18,0,30,12
1714212590051,EDS 139,B00,507313,Pappas; Elizabeth,15,0,30,15
1714212591076,EDS 201,A00,507315,Staff,13,0,30,17
1714212592103,EDS 203,A01,507317,Halter; Christopher P.,12,0,30,18
1714212593129,EDS 204R,A01,507319,Halter; Christopher P.,0,3,30,30
1714212593129,EDS 204R,B01,507331,Heinzman; Erica M.,17,0,30,13
1714212594158,EDS 206R,A00,507332,Staff,0,4,30,30
1714212594158,EDS 206R,B00,507343,Staff,18,0,30,12
1714212595184,EDS 250,A00,507344,Hemans; Patricia Ann Benitez,22,0,40,18
1714212596212,EDS 281,A00,507345,Daly; Alan J.,18,0,18,0
1714212597242,EDS 284,A00,507350,Daly; Alan J.,16,0,16,0
1714212598270,EDS 286,A00,507359,Fine; Sarah,18,0,18,0
1714212599296,EDS 289C,A01,507361,Daly; Alan J.,18,0,18,0
1714212600323,EDS 290,A00,507366,Hofstetter; Carolyn,15,0,15,0
1714212601349,LIGM 5A,A00,507421,Fischer-Grunski; Eva K,18,0,20,2
1714212602375,LIGM 5B,A00,507423,Fischer-Grunski; Eva K,19,0,20,1
1714212603402,LIGM 5C,A00,507425,Fischer-Grunski; Eva K,19,0,20,1
1714212604429,LIIT 5AS,A00,507427,Carnelos; Chiara,20,0,20,0
1714212605455,LIIT 5BS,A00,507430,Carnelos; Chiara,20,0,20,0
1714212606485,LIIT 5CS,A00,507432,Carnelos; Chiara,20,0,20,0
1714212607511,LISP 5A,A00,507541,Munoz Sanchez; Alicia,11,0,20,9
1714212608537,LISP 5B,A00,507671,Munoz Sanchez; Alicia,9,0,20,11
1714212609565,LISP 5C,A00,507696,Munoz Sanchez; Alicia,9,0,20,11
1714212610591,MAE 197,001,528363,Boechler; Nicholas Sebastia,9998,0,9999,1
1714212611616,MATH 197,001,523477,Kedlaya; Kiran S.,9996,0,9999,3
1714212611616,MATH 197,002,563811,Zhang; Danna,9995,0,9999,4
1714212611616,MATH 197,003,628552,Dumitriu; Ioana,9998,0,9999,1
1714212612641,MCWP 40R,A00,518780,Staff,5,0,20,15
1714212612641,MCWP 40R,B00,518781,Staff,7,0,20,13
1714212612641,MCWP 40R,C00,518783,Staff,5,0,20,15
1714212613666,MCWP 50R,A00,518791,Staff,0,0,20,20
1714212613666,MCWP 50R,B00,518792,Staff,0,1,20,20
1714212613666,MCWP 50R,C00,518793,Staff,0,1,20,20
1714212613666,MCWP 50R,D00,518794,Staff,0,0,20,20
1714212613666,MCWP 50R,E00,518795,Staff,0,1,20,20
1714212613666,MCWP 50R,F00,518796,Staff,0,0,20,20
1714212613666,MCWP 50R,G00,518797,Staff,0,1,20,20
1714212614692,MMW 12R,A01,514034,Herbst; Matthew,0,1,16,16
1714212614692,MMW 12R,A02,514035,Herbst; Matthew,2,0,16,14
1714212615720,MMW 13R,A01,514037,Staff,0,4,16,16
1714212615720,MMW 13R,A02,514039,Staff,0,2,16,16
1714212615720,MMW 13R,A03,628519,Staff,0,2,16,16
1714212617777,SIO 295LS,A00,523233,Staff,13,0,30,17
1714212618802,SIO 295S,A00,523232,Staff,13,0,30,17
1714212619827,SIOC 290S,A01,637330,Merrifield; Mark A,28,0,30,2
1714212620851,SIOC 291S,A01,637333,Gabriel; Corey John,28,0,30,2
1714212621875,SOCI 117,A01,494376,Staff,0,2,5,5
1714212622901,WES 237B,A00,494380,Staff,9,0,20,11
1714212624974,AESE 279B,A00,494370,Wade; Jon P,0,0,33,33
1714212625999,AIP 197,001,627712,Vespa; Emanuel Ignacio,9998,0,9999,1
1714212627028,ANAR 135S,A00,494369,Braswell; Geoffrey E.,0,0,0,0
1714212628056,BENG 196,001,628496,Engler; Adam J.,9998,0,9999,1
1714212629081,CAT 124RS,A01,519847,Geibel; William,0,0,20,20
1714212630108,CAT 125RS,A01,515971,Geibel; William,0,0,20,20
1714212631137,CLRE 250,A00,511389,Morris; Sheldon,9993,0,9999,6
1714212632166,CLRE 251,A00,507176,Mehta; Ravindra L.,9993,0,9999,6
1714212632166,CLRE 251,B00,511410,Mehta; Ravindra L.,9998,0,9999,1
1714212633195,CLRE 252,A00,507189,Cuomo; Raphael Eduardo,9995,0,9999,4
1714212634221,CLRE 253,A00,507199,Vaida; Florin,9994,0,9999,5
1714212634221,CLRE 253,B00,507202,Vaida; Florin,9999,0,9999,0
1714212635247,CLRE 259,A00,507211,Patel; Hemal,9996,0,9999,3
1714212636272,CLRE 260,A00,507221,Cuomo; Raphael Eduardo,9999,0,9999,0
1714212637299,CLRE 297,001,507242,Cuomo; Raphael Eduardo,9999,0,9999,0
1714212638330,COGS 197,001,638244,Voytek; Bradley Thomas,9999,0,9999,0
1714212639354,CSE 191,A00,516875,Minnes Kemp; Mor Mia,9993,0,9999,6
1714212640383,CSE 197,001,637388,Minnes Kemp; Mor Mia,9998,0,9999,1
1714212641413,CSS 201S,A01,494383,Staff,35,0,35,0
1714212642439,CSS 202S,A01,494387,Staff,35,0,35,0
1714212643464,DSC 197,001,628532,Eldridge; Justin Matthew,9996,0,9999,3
1714212644490,EAP 100,A00,516065,Staff,9797,0,9999,202
1714212645518,ECE 45,A01,507414,Staff,33,0,60,27
1714212647573,ECE 111,A01,507420,Staff,21,0,50,29
1714212648603,ECE 197,001,548057,Sievenpiper; Daniel F.,9994,0,9999,5
1714212649633,EDS 115,A00,507243,Choi; Bailey Miyeon,12,0,28,16
1714212650659,EDS 117,A01,494379,Staff,0,1,30,30
1714212651688,EDS 125,A00,507246,Hopkins; Megan Beth,12,0,30,18
1714212652713,EDS 128A,A01,507264,Fargason; Sharon Gayle,14,0,26,12
1714212653741,EDS 128B,A01,507293,Pappas; Elizabeth,18,0,30,12
1714212654767,EDS 139,A00,507294,Fargason; Sharon Gayle,18,0,30,12
1714212654767,EDS 139,B00,507313,Pappas; Elizabeth,15,0,30,15
1714212655793,EDS 201,A00,507315,Staff,13,0,30,17
1714212656819,EDS 203,A01,507317,Halter; Christopher P.,12,0,30,18
1714212657847,EDS 204R,A01,507319,Halter; Christopher P.,0,3,30,30
1714212657847,EDS 204R,B01,507331,Heinzman; Erica M.,17,0,30,13
1714212658873,EDS 206R,A00,507332,Staff,0,4,30,30
1714212658873,EDS 206R,B00,507343,Staff,18,0,30,12
1714212659902,EDS 250,A00,507344,Hemans; Patricia Ann Benitez,22,0,40,18
1714212660930,EDS 281,A00,507345,Daly; Alan J.,18,0,18,0
1714212661960,EDS 284,A00,507350,Daly; Alan J.,16,0,16,0
1714212662988,EDS 286,A00,507359,Fine; Sarah,18,0,18,0
1714212664012,EDS 289C,A01,507361,Daly; Alan J.,18,0,18,0
1714212665038,EDS 290,A00,507366,Hofstetter; Carolyn,15,0,15,0
1714212666061,LIGM 5A,A00,507421,Fischer-Grunski; Eva K,18,0,20,2
1714212667087,LIGM 5B,A00,507423,Fischer-Grunski; Eva K,19,0,20,1
1714212668116,LIGM 5C,A00,507425,Fischer-Grunski; Eva K,19,0,20,1
1714212669146,LIIT 5AS,A00,507427,Carnelos; Chiara,20,0,20,0
1714212670228,LIIT 5BS,A00,507430,Carnelos; Chiara,20,0,20,0
1714212671257,LIIT 5CS,A00,507432,Carnelos; Chiara,20,0,20,0
1714212672282,LISP 5A,A00,507541,Munoz Sanchez; Alicia,11,0,20,9
1714212673314,LISP 5B,A00,507671,Munoz Sanchez; Alicia,9,0,20,11
1714212674340,LISP 5C,A00,507696,Munoz Sanchez; Alicia,9,0,20,11
1714212675365,MAE 197,001,528363,Boechler; Nicholas Sebastia,9998,0,9999,1
1714212676394,MATH 197,001,523477,Kedlaya; Kiran S.,9996,0,9999,3
1714212676394,MATH 197,002,563811,Zhang; Danna,9995,0,9999,4
1714212676394,MATH 197,003,628552,Dumitriu; Ioana,9998,0,9999,1
1714212677418,MCWP 40R,A00,518780,Staff,5,0,20,15
1714212677418,MCWP 40R,B00,518781,Staff,7,0,20,13
1714212677418,MCWP 40R,C00,518783,Staff,5,0,20,15
1714212678444,MCWP 50R,A00,518791,Staff,0,0,20,20
1714212678444,MCWP 50R,B00,518792,Staff,0,1,20,20
1714212678444,MCWP 50R,C00,518793,Staff,0,1,20,20
1714212678444,MCWP 50R,D00,518794,Staff,0,0,20,20
1714212678444,MCWP 50R,E00,518795,Staff,0,1,20,20
1714212678444,MCWP 50R,F00,518796,Staff,0,0,20,20
1714212678444,MCWP 50R,G00,518797,Staff,0,1,20,20
1714212679471,MMW 12R,A01,514034,Herbst; Matthew,0,1,16,16
1714212679471,MMW 12R,A02,514035,Herbst; Matthew,2,0,16,14
1714212680499,MMW 13R,A01,514037,Staff,0,4,16,16
1714212680499,MMW 13R,A02,514039,Staff,0,2,16,16
1714212680499,MMW 13R,A03,628519,Staff,0,2,16,16
1714212682553,SIO 295LS,A00,523233,Staff,13,0,30,17
1714212683580,SIO 295S,A00,523232,Staff,13,0,30,17
1714212684605,SIOC 290S,A01,637330,Merrifield; Mark A,28,0,30,2
1714212685632,SIOC 291S,A01,637333,Gabriel; Corey John,28,0,30,2
1714212686660,SOCI 117,A01,494376,Staff,0,2,5,5
1714212687684,WES 237B,A00,494380,Staff,9,0,20,11
1714212689748,AESE 279B,A00,494370,Wade; Jon P,0,0,33,33
1714212690771,AIP 197,001,627712,Vespa; Emanuel Ignacio,9998,0,9999,1
1714212691799,ANAR 135S,A00,494369,Braswell; Geoffrey E.,0,0,0,0
1714212692828,BENG 196,001,628496,Engler; Adam J.,9998,0,9999,1
1714212693851,CAT 124RS,A01,519847,Geibel; William,0,0,20,20
1714212694876,CAT 125RS,A01,515971,Geibel; William,0,0,20,20
1714212695903,CLRE 250,A00,511389,Morris; Sheldon,9993,0,9999,6
1714212696932,CLRE 251,A00,507176,Mehta; Ravindra L.,9993,0,9999,6
1714212696932,CLRE 251,B00,511410,Mehta; Ravindra L.,9998,0,9999,1
1714212697960,CLRE 252,A00,507189,Cuomo; Raphael Eduardo,9995,0,9999,4
1714212698985,CLRE 253,A00,507199,Vaida; Florin,9994,0,9999,5
1714212698985,CLRE 253,B00,507202,Vaida; Florin,9999,0,9999,0
1714212700010,CLRE 259,A00,507211,Patel; Hemal,9996,0,9999,3
1714212701036,CLRE 260,A00,507221,Cuomo; Raphael Eduardo,9999,0,9999,0
1714212702060,CLRE 297,001,507242,Cuomo; Raphael Eduardo,9999,0,9999,0
1714212703090,COGS 197,001,638244,Voytek; Bradley Thomas,9999,0,9999,0
1714212704116,CSE 191,A00,516875,Minnes Kemp; Mor Mia,9993,0,9999,6
1714212705141,CSE 197,001,637388,Minnes Kemp; Mor Mia,9998,0,9999,1
1714212706171,CSS 201S,A01,494383,Staff,35,0,35,0
1714212707196,CSS 202S,A01,494387,Staff,35,0,35,0
1714212708222,DSC 197,001,628532,Eldridge; Justin Matthew,9996,0,9999,3
1714212709247,EAP 100,A00,516065,Staff,9797,0,9999,202
1714212710278,ECE 45,A01,507414,Staff,33,0,60,27
1714212712333,ECE 111,A01,507420,Staff,21,0,50,29
1714212713365,ECE 197,001,548057,Sievenpiper; Daniel F.,9994,0,9999,5
1714212714392,EDS 115,A00,507243,Choi; Bailey Miyeon,12,0,28,16
1714212715419,EDS 117,A01,494379,Staff,0,1,30,30
1714212716444,EDS 125,A00,507246,Hopkins; Megan Beth,12,0,30,18
1714212717475,EDS 128A,A01,507264,Fargason; Sharon Gayle,14,0,26,12
1714212718500,EDS 128B,A01,507293,Pappas; Elizabeth,18,0,30,12
1714212719529,EDS 139,A00,507294,Fargason; Sharon Gayle,18,0,30,12
1714212719529,EDS 139,B00,507313,Pappas; Elizabeth,15,0,30,15
1714212720558,EDS 201,A00,507315,Staff,13,0,30,17
1714212721583,EDS 203,A01,507317,Halter; Christopher P.,12,0,30,18
1714212722613,EDS 204R,A01,507319,Halter; Christopher P.,0,3,30,30
1714212722613,EDS 204R,B01,507331,Heinzman; Erica M.,17,0,30,13
1714212723641,EDS 206R,A00,507332,Staff,0,4,30,30
1714212723641,EDS 206R,B00,507343,Staff,18,0,30,12
1714212724671,EDS 250,A00,507344,Hemans; Patricia Ann Benitez,22,0,40,18
1714212725697,EDS 281,A00,507345,Daly; Alan J.,18,0,18,0
1714212726724,EDS 284,A00,507350,Daly; Alan J.,16,0,16,0
1714212727753,EDS 286,A00,507359,Fine; Sarah,18,0,18,0
1714212728779,EDS 289C,A01,507361,Daly; Alan J.,18,0,18,0
1714212729806,EDS 290,A00,507366,Hofstetter; Carolyn,15,0,15,0
1714212730832,LIGM 5A,A00,507421,Fischer-Grunski; Eva K,18,0,20,2
1714212731858,LIGM 5B,A00,507423,Fischer-Grunski; Eva K,19,0,20,1
1714212732885,LIGM 5C,A00,507425,Fischer-Grunski; Eva K,19,0,20,1
1714212733915,LIIT 5AS,A00,507427,Carnelos; Chiara,20,0,20,0
1714212734946,LIIT 5BS,A00,507430,Carnelos; Chiara,20,0,20,0
1714212735971,LIIT 5CS,A00,507432,Carnelos; Chiara,20,0,20,0
1714212736996,LISP 5A,A00,507541,Munoz Sanchez; Alicia,11,0,20,9
1714212738021,LISP 5B,A00,507671,Munoz Sanchez; Alicia,9,0,20,11
1714212739050,LISP 5C,A00,507696,Munoz Sanchez; Alicia,9,0,20,11
1714212740077,MAE 197,001,528363,Boechler; Nicholas Sebastia,9998,0,9999,1
1714212741109,MATH 197,001,523477,Kedlaya; Kiran S.,9996,0,9999,3
1714212741109,MATH 197,002,563811,Zhang; Danna,9995,0,9999,4
1714212741109,MATH 197,003,628552,Dumitriu; Ioana,9998,0,9999,1
1714212742139,MCWP 40R,A00,518780,Staff,5,0,20,15
1714212742139,MCWP 40R,B00,518781,Staff,7,0,20,13
1714212742139,MCWP 40R,C00,518783,Staff,5,0,20,15
1714212743165,MCWP 50R,A00,518791,Staff,0,0,20,20
1714212743165,MCWP 50R,B00,518792,Staff,0,1,20,20
1714212743165,MCWP 50R,C00,518793,Staff,0,1,20,20
1714212743165,MCWP 50R,D00,518794,Staff,0,0,20,20
1714212743165,MCWP 50R,E00,518795,Staff,0,1,20,20
1714212743165,MCWP 50R,F00,518796,Staff,0,0,20,20
1714212743165,MCWP 50R,G00,518797,Staff,0,1,20,20
1714212744192,MMW 12R,A01,514034,Herbst; Matthew,0,1,16,16
1714212744192,MMW 12R,A02,514035,Herbst; Matthew,2,0,16,14
1714212745217,MMW 13R,A01,514037,Staff,0,4,16,16
1714212745217,MMW 13R,A02,514039,Staff,0,2,16,16
1714212745217,MMW 13R,A03,628519,Staff,0,2,16,16
1714212747269,SIO 295LS,A00,523233,Staff,13,0,30,17
1714212748293,SIO 295S,A00,523232,Staff,13,0,30,17
1714212749320,SIOC 290S,A01,637330,Merrifield; Mark A,28,0,30,2
1714212750345,SIOC 291S,A01,637333,Gabriel; Corey John,28,0,30,2
1714212751372,SOCI 117,A01,494376,Staff,0,2,5,5
1714212752399,WES 237B,A00,494380,Staff,9,0,20,11
1714212754474,AESE 279B,A00,494370,Wade; Jon P,0,0,33,33
1714212755499,AIP 197,001,627712,Vespa; Emanuel Ignacio,9998,0,9999,1
1714212756524,ANAR 135S,A00,494369,Braswell; Geoffrey E.,0,0,0,0
1714212757556,BENG 196,001,628496,Engler; Adam J.,9998,0,9999,1
1714212758580,CAT 124RS,A01,519847,Geibel; William,0,0,20,20
1714212759605,CAT 125RS,A01,515971,Geibel; William,0,0,20,20
1714212760634,CLRE 250,A00,511389,Morris; Sheldon,9993,0,9999,6
1714212761662,CLRE 251,A00,507176,Mehta; Ravindra L.,9993,0,9999,6
1714212761662,CLRE 251,B00,511410,Mehta; Ravindra L.,9998,0,9999,1
1714212762693,CLRE 252,A00,507189,Cuomo; Raphael Eduardo,9995,0,9999,4
1714212763721,CLRE 253,A00,507199,Vaida; Florin,9994,0,9999,5
1714212763721,CLRE 253,B00,507202,Vaida; Florin,9999,0,9999,0
1714212764746,CLRE 259,A00,507211,Patel; Hemal,9996,0,9999,3
1714212765772,CLRE 260,A00,507221,Cuomo; Raphael Eduardo,9999,0,9999,0
1714212766801,CLRE 297,001,507242,Cuomo; Raphael Eduardo,9999,0,9999,0
1714212767829,COGS 197,001,638244,Voytek; Bradley Thomas,9999,0,9999,0
1714212768855,CSE 191,A00,516875,Minnes Kemp; Mor Mia,9993,0,9999,6
1714212769882,CSE 197,001,637388,Minnes Kemp; Mor Mia,9998,0,9999,1
1714212770908,CSS 201S,A01,494383,Staff,35,0,35,0
1714212771936,CSS 202S,A01,494387,Staff,35,0,35,0
1714212772963,DSC 197,001,628532,Eldridge; Justin Matthew,9996,0,9999,3
1714212774043,EAP 100,A00,516065,Staff,9797,0,9999,202
1714212775069,ECE 45,A01,507414,Staff,33,0,60,27
1714212777119,ECE 111,A01,507420,Staff,21,0,50,29
1714212778144,ECE 197,001,548057,Sievenpiper; Daniel F.,9994,0,9999,5
1714212779169,EDS 115,A00,507243,Choi; Bailey Miyeon,12,0,28,16
1714212780195,EDS 117,A01,494379,Staff,0,1,30,30
1714212781220,EDS 125,A00,507246,Hopkins; Megan Beth,12,0,30,18
1714212782248,EDS 128A,A01,507264,Fargason; Sharon Gayle,14,0,26,12
1714212783276,EDS 128B,A01,507293,Pappas; Elizabeth,18,0,30,12
1714212784301,EDS 139,A00,507294,Fargason; Sharon Gayle,18,0,30,12
1714212784301,EDS 139,B00,507313,Pappas; Elizabeth,15,0,30,15
1714212785328,EDS 201,A00,507315,Staff,13,0,30,17
1714212786353,EDS 203,A01,507317,Halter; Christopher P.,12,0,30,18
1714212787381,EDS 204R,A01,507319,Halter; Christopher P.,0,3,30,30
1714212787381,EDS 204R,B01,507331,Heinzman; Erica M.,17,0,30,13
1714212788407,EDS 206R,A00,507332,Staff,0,4,30,30
1714212788407,EDS 206R,B00,507343,Staff,18,0,30,12
1714212789432,EDS 250,A00,507344,Hemans; Patricia Ann Benitez,22,0,40,18
1714212790457,EDS 281,A00,507345,Daly; Alan J.,18,0,18,0
1714212791484,EDS 284,A00,507350,Daly; Alan J.,16,0,16,0
1714212792513,EDS 286,A00,507359,Fine; Sarah,18,0,18,0
1714212793538,EDS 289C,A01,507361,Daly; Alan J.,18,0,18,0
1714212794563,EDS 290,A00,507366,Hofstetter; Carolyn,15,0,15,0
1714212795588,LIGM 5A,A00,507421,Fischer-Grunski; Eva K,18,0,20,2
1714212796614,LIGM 5B,A00,507423,Fischer-Grunski; Eva K,19,0,20,1
1714212797639,LIGM 5C,A00,507425,Fischer-Grunski; Eva K,19,0,20,1
1714212798664,LIIT 5AS,A00,507427,Carnelos; Chiara,20,0,20,0
1714212799689,LIIT 5BS,A00,507430,Carnelos; Chiara,20,0,20,0
1714212800714,LIIT 5CS,A00,507432,Carnelos; Chiara,20,0,20,0
1714212801745,LISP 5A,A00,507541,Munoz Sanchez; Alicia,11,0,20,9
1714212802771,LISP 5B,A00,507671,Munoz Sanchez; Alicia,9,0,20,11
1714212803797,LISP 5C,A00,507696,Munoz Sanchez; Alicia,9,0,20,11
1714212804822,MAE 197,001,528363,Boechler; Nicholas Sebastia,9998,0,9999,1
1714212805851,MATH 197,001,523477,Kedlaya; Kiran S.,9996,0,9999,3
1714212805851,MATH 197,002,563811,Zhang; Danna,9995,0,9999,4
1714212805851,MATH 197,003,628552,Dumitriu; Ioana,9998,0,9999,1
1714212806876,MCWP 40R,A00,518780,Staff,5,0,20,15
1714212806876,MCWP 40R,B00,518781,Staff,7,0,20,13
1714212806876,MCWP 40R,C00,518783,Staff,5,0,20,15
1714212807902,MCWP 50R,A00,518791,Staff,0,0,20,20
1714212807902,MCWP 50R,B00,518792,Staff,0,1,20,20
1714212807902,MCWP 50R,C00,518793,Staff,0,1,20,20
1714212807902,MCWP 50R,D00,518794,Staff,0,0,20,20
1714212807902,MCWP 50R,E00,518795,Staff,0,1,20,20
1714212807902,MCWP 50R,F00,518796,Staff,0,0,20,20
1714212807902,MCWP 50R,G00,518797,Staff,0,1,20,20
1714212808928,MMW 12R,A01,514034,Herbst; Matthew,0,1,16,16
1714212808928,MMW 12R,A02,514035,Herbst; Matthew,2,0,16,14
1714212809956,MMW 13R,A01,514037,Staff,0,4,16,16
1714212809956,MMW 13R,A02,514039,Staff,0,2,16,16
1714212809956,MMW 13R,A03,628519,Staff,0,2,16,16
1714212812013,SIO 295LS,A00,523233,Staff,13,0,30,17
1714212813043,SIO 295S,A00,523232,Staff,13,0,30,17
1714212814076,SIOC 290S,A01,637330,Merrifield; Mark A,28,0,30,2
1714212815106,SIOC 291S,A01,637333,Gabriel; Corey John,28,0,30,2
1714212816132,SOCI 117,A01,494376,Staff,0,2,5,5
1714212817159,WES 237B,A00,494380,Staff,9,0,20,11
1714212819232,AESE 279B,A00,494370,Wade; Jon P,0,0,33,33
1714212820256,AIP 197,001,627712,Vespa; Emanuel Ignacio,9998,0,9999,1
1714212821282,ANAR 135S,A00,494369,Braswell; Geoffrey E.,0,0,0,0
1714212822308,BENG 196,001,628496,Engler; Adam J.,9998,0,9999,1
1714212823334,CAT 124RS,A01,519847,Geibel; William,0,0,20,20
1714212824359,CAT 125RS,A01,515971,Geibel; William,0,0,20,20
1714212825384,CLRE 250,A00,511389,Morris; Sheldon,9993,0,9999,6
1714212826411,CLRE 251,A00,507176,Mehta; Ravindra L.,9993,0,9999,6
1714212826411,CLRE 251,B00,511410,Mehta; Ravindra L.,9998,0,9999,1
1714212827437,CLRE 252,A00,507189,Cuomo; Raphael Eduardo,9995,0,9999,4
1714212828467,CLRE 253,A00,507199,Vaida; Florin,9994,0,9999,5
1714212828467,CLRE 253,B00,507202,Vaida; Florin,9999,0,9999,0
1714212829498,CLRE 259,A00,507211,Patel; Hemal,9996,0,9999,3
1714212830523,CLRE 260,A00,507221,Cuomo; Raphael Eduardo,9999,0,9999,0
1714212831548,CLRE 297,001,507242,Cuomo; Raphael Eduardo,9999,0,9999,0
1714212832577,COGS 197,001,638244,Voytek; Bradley Thomas,9999,0,9999,0
1714212833603,CSE 191,A00,516875,Minnes Kemp; Mor Mia,9993,0,9999,6
1714212834631,CSE 197,001,637388,Minnes Kemp; Mor Mia,9998,0,9999,1
1714212835659,CSS 201S,A01,494383,Staff,35,0,35,0
1714212836685,CSS 202S,A01,494387,Staff,35,0,35,0
1714212837709,DSC 197,001,628532,Eldridge; Justin Matthew,9996,0,9999,3
1714212838735,EAP 100,A00,516065,Staff,9797,0,9999,202
1714212839762,ECE 45,A01,507414,Staff,33,0,60,27
1714212841820,ECE 111,A01,507420,Staff,21,0,50,29
1714212842850,ECE 197,001,548057,Sievenpiper; Daniel F.,9994,0,9999,5
1714212843878,EDS 115,A00,507243,Choi; Bailey Miyeon,12,0,28,16
1714212844904,EDS 117,A01,494379,Staff,0,1,30,30
1714212845931,EDS 125,A00,507246,Hopkins; Megan Beth,12,0,30,18
1714212846956,EDS 128A,A01,507264,Fargason; Sharon Gayle,14,0,26,12
1714212847982,EDS 128B,A01,507293,Pappas; Elizabeth,18,0,30,12
1714212849009,EDS 139,A00,507294,Fargason; Sharon Gayle,18,0,30,12
1714212849009,EDS 139,B00,507313,Pappas; Elizabeth,15,0,30,15
1714212850035,EDS 201,A00,507315,Staff,13,0,30,17
1714212851062,EDS 203,A01,507317,Halter; Christopher P.,12,0,30,18
1714212852093,EDS 204R,A01,507319,Halter; Christopher P.,0,3,30,30
1714212852093,EDS 204R,B01,507331,Heinzman; Erica M.,17,0,30,13
1714212853117,EDS 206R,A00,507332,Staff,0,4,30,30
1714212853117,EDS 206R,B00,507343,Staff,18,0,30,12
1714212854143,EDS 250,A00,507344,Hemans; Patricia Ann Benitez,22,0,40,18
1714212855172,EDS 281,A00,507345,Daly; Alan J.,18,0,18,0
1714212856196,EDS 284,A00,507350,Daly; Alan J.,16,0,16,0
1714212857225,EDS 286,A00,507359,Fine; Sarah,18,0,18,0
1714212858251,EDS 289C,A01,507361,Daly; Alan J.,18,0,18,0
1714212859278,EDS 290,A00,507366,Hofstetter; Carolyn,15,0,15,0
1714212860306,LIGM 5A,A00,507421,Fischer-Grunski; Eva K,18,0,20,2
1714212861333,LIGM 5B,A00,507423,Fischer-Grunski; Eva K,19,0,20,1
1714212862363,LIGM 5C,A00,507425,Fischer-Grunski; Eva K,19,0,20,1
1714212863393,LIIT 5AS,A00,507427,Carnelos; Chiara,20,0,20,0
1714212864421,LIIT 5BS,A00,507430,Carnelos; Chiara,20,0,20,0
1714212865450,LIIT 5CS,A00,507432,Carnelos; Chiara,20,0,20,0
1714212866483,LISP 5A,A00,507541,Munoz Sanchez; Alicia,11,0,20,9
1714212867510,LISP 5B,A00,507671,Munoz Sanchez; Alicia,9,0,20,11
1714212868540,LISP 5C,A00,507696,Munoz Sanchez; Alicia,9,0,20,11
1714212869567,MAE 197,001,528363,Boechler; Nicholas Sebastia,9998,0,9999,1
1714212870595,MATH 197,001,523477,Kedlaya; Kiran S.,9996,0,9999,3
1714212870595,MATH 197,002,563811,Zhang; Danna,9995,0,9999,4
1714212870595,MATH 197,003,628552,Dumitriu; Ioana,9998,0,9999,1
1714212871626,MCWP 40R,A00,518780,Staff,5,0,20,15
1714212871626,MCWP 40R,B00,518781,Staff,7,0,20,13
1714212871626,MCWP 40R,C00,518783,Staff,5,0,20,15
1714212872653,MCWP 50R,A00,518791,Staff,0,0,20,20
1714212872653,MCWP 50R,B00,518792,Staff,0,1,20,20
1714212872653,MCWP 50R,C00,518793,Staff,0,1,20,20
1714212872653,MCWP 50R,D00,518794,Staff,0,0,20,20
1714212872653,MCWP 50R,E00,518795,Staff,0,1,20,20
1714212872653,MCWP 50R,F00,518796,Staff,0,0,20,20
1714212872653,MCWP 50R,G00,518797,Staff,0,1,20,20
1714212873679,MMW 12R,A01,514034,Herbst; Matthew,0,1,16,16
1714212873679,MMW 12R,A02,514035,Herbst; Matthew,2,0,16,14
1714212874705,MMW 13R,A01,514037,Staff,0,4,16,16
1714212874705,MMW 13R,A02,514039,Staff,0,2,16,16
1714212874705,MMW 13R,A03,628519,Staff,0,2,16,16
1714212876758,SIO 295LS,A00,523233,Staff,13,0,30,17
1714212877836,SIO 295S,A00,523232,Staff,13,0,30,17
1714212878864,SIOC 290S,A01,637330,Merrifield; Mark A,28,0,30,2
1714212879895,SIOC 291S,A01,637333,Gabriel; Corey John,28,0,30,2
1714212880921,SOCI 117,A01,494376,Staff,0,2,5,5
1714212881947,WES 237B,A00,494380,Staff,9,0,20,11
1714212884019,AESE 279B,A00,494370,Wade; Jon P,0,0,33,33
1714212885045,AIP 197,001,627712,Vespa; Emanuel Ignacio,9998,0,9999,1
1714212886071,ANAR 135S,A00,494369,Braswell; Geoffrey E.,0,0,0,0
1714212887099,BENG 196,001,628496,Engler; Adam J.,9998,0,9999,1
1714212888125,CAT 124RS,A01,519847,Geibel; William,0,0,20,20
1714212889150,CAT 125RS,A01,515971,Geibel; William,0,0,20,20
1714212890175,CLRE 250,A00,511389,Morris; Sheldon,9993,0,9999,6
1714212891201,CLRE 251,A00,507176,Mehta; Ravindra L.,9993,0,9999,6
1714212891201,CLRE 251,B00,511410,Mehta; Ravindra L.,9998,0,9999,1
1714212892227,CLRE 252,A00,507189,Cuomo; Raphael Eduardo,9995,0,9999,4
1714212893253,CLRE 253,A00,507199,Vaida; Florin,9994,0,9999,5
1714212893253,CLRE 253,B00,507202,Vaida; Florin,9999,0,9999,0
1714212894280,CLRE 259,A00,507211,Patel; Hemal,9996,0,9999,3
1714212895310,CLRE 260,A00,507221,Cuomo; Raphael Eduardo,9999,0,9999,0
1714212896340,CLRE 297,001,507242,Cuomo; Raphael Eduardo,9999,0,9999,0
1714212897368,COGS 197,001,638244,Voytek; Bradley Thomas,9999,0,9999,0
1714212898397,CSE 191,A00,516875,Minnes Kemp; Mor Mia,9993,0,9999,6
1714212899423,CSE 197,001,637388,Minnes Kemp; Mor Mia,9998,0,9999,1
1714212900448,CSS 201S,A01,494383,Staff,35,0,35,0
1714212901474,CSS 202S,A01,494387,Staff,35,0,35,0
1714212902499,DSC 197,001,628532,Eldridge; Justin Matthew,9996,0,9999,3
1714212903527,EAP 100,A00,516065,Staff,9797,0,9999,202
1714212904553,ECE 45,A01,507414,Staff,33,0,60,27
1714212906608,ECE 111,A01,507420,Staff,21,0,50,29
1714212907634,ECE 197,001,548057,Sievenpiper; Daniel F.,9994,0,9999,5
1714212908660,EDS 115,A00,507243,Choi; Bailey Miyeon,12,0,28,16
1714212909688,EDS 117,A01,494379,Staff,0,1,30,30
1714212910717,EDS 125,A00,507246,Hopkins; Megan Beth,12,0,30,18
1714212911743,EDS 128A,A01,507264,Fargason; Sharon Gayle,14,0,26,12
1714212912770,EDS 128B,A01,507293,Pappas; Elizabeth,18,0,30,12
1714212913794,EDS 139,A00,507294,Fargason; Sharon Gayle,18,0,30,12
1714212913794,EDS 139,B00,507313,Pappas; Elizabeth,15,0,30,15
1714212914818,EDS 201,A00,507315,Staff,13,0,30,17
1714212915846,EDS 203,A01,507317,Halter; Christopher P.,12,0,30,18
1714212916876,EDS 204R,A01,507319,Halter; Christopher P.,0,3,30,30
1714212916876,EDS 204R,B01,507331,Heinzman; Erica M.,17,0,30,13
1714212917902,EDS 206R,A00,507332,Staff,0,4,30,30
1714212917902,EDS 206R,B00,507343,Staff,18,0,30,12
1714212918926,EDS 250,A00,507344,Hemans; Patricia Ann Benitez,22,0,40,18
1714212919951,EDS 281,A00,507345,Daly; Alan J.,18,0,18,0
1714212920978,EDS 284,A00,507350,Daly; Alan J.,16,0,16,0
1714212922005,EDS 286,A00,507359,Fine; Sarah,18,0,18,0
1714212923032,EDS 289C,A01,507361,Daly; Alan J.,18,0,18,0
1714212924056,EDS 290,A00,507366,Hofstetter; Carolyn,15,0,15,0
1714212925082,LIGM 5A,A00,507421,Fischer-Grunski; Eva K,18,0,20,2
1714212926107,LIGM 5B,A00,507423,Fischer-Grunski; Eva K,19,0,20,1
1714212927131,LIGM 5C,A00,507425,Fischer-Grunski; Eva K,19,0,20,1
1714212928157,LIIT 5AS,A00,507427,Carnelos; Chiara,20,0,20,0
1714212929187,LIIT 5BS,A00,507430,Carnelos; Chiara,20,0,20,0
1714212930216,LIIT 5CS,A00,507432,Carnelos; Chiara,20,0,20,0
1714212931247,LISP 5A,A00,507541,Munoz Sanchez; Alicia,11,0,20,9
1714212932272,LISP 5B,A00,507671,Munoz Sanchez; Alicia,9,0,20,11
1714212933296,LISP 5C,A00,507696,Munoz Sanchez; Alicia,9,0,20,11
1714212934321,MAE 197,001,528363,Boechler; Nicholas Sebastia,9998,0,9999,1
1714212935347,MATH 197,001,523477,Kedlaya; Kiran S.,9996,0,9999,3
1714212935347,MATH 197,002,563811,Zhang; Danna,9995,0,9999,4
1714212935347,MATH 197,003,628552,Dumitriu; Ioana,9998,0,9999,1
1714212936372,MCWP 40R,A00,518780,Staff,5,0,20,15
1714212936372,MCWP 40R,B00,518781,Staff,7,0,20,13
1714212936372,MCWP 40R,C00,518783,Staff,5,0,20,15
1714212937401,MCWP 50R,A00,518791,Staff,0,0,20,20
1714212937401,MCWP 50R,B00,518792,Staff,0,1,20,20
1714212937401,MCWP 50R,C00,518793,Staff,0,1,20,20
1714212937401,MCWP 50R,D00,518794,Staff,0,0,20,20
1714212937401,MCWP 50R,E00,518795,Staff,0,1,20,20
1714212937401,MCWP 50R,F00,518796,Staff,0,0,20,20
1714212937401,MCWP 50R,G00,518797,Staff,0,1,20,20
1714212938430,MMW 12R,A01,514034,Herbst; Matthew,0,1,16,16
1714212938430,MMW 12R,A02,514035,Herbst; Matthew,2,0,16,14
1714212939456,MMW 13R,A01,514037,Staff,0,4,16,16
1714212939456,MMW 13R,A02,514039,Staff,0,2,16,16
1714212939456,MMW 13R,A03,628519,Staff,0,2,16,16
1714212941508,SIO 295LS,A00,523233,Staff,13,0,30,17
1714212942533,SIO 295S,A00,523232,Staff,13,0,30,17
1714212943565,SIOC 290S,A01,637330,Merrifield; Mark A,28,0,30,2
1714212944593,SIOC 291S,A01,637333,Gabriel; Corey John,28,0,30,2
1714212945620,SOCI 117,A01,494376,Staff,0,2,5,5
1714212946649,WES 237B,A00,494380,Staff,9,0,20,11
1714212948726,AESE 279B,A00,494370,Wade; Jon P,0,0,33,33
1714212949755,AIP 197,001,627712,Vespa; Emanuel Ignacio,9998,0,9999,1
1714212950782,ANAR 135S,A00,494369,Braswell; Geoffrey E.,0,0,0,0
1714212951807,BENG 196,001,628496,Engler; Adam J.,9998,0,9999,1
1714212952835,CAT 124RS,A01,519847,Geibel; William,0,0,20,20
1714212953862,CAT 125RS,A01,515971,Geibel; William,0,0,20,20
1714212954889,CLRE 250,A00,511389,Morris; Sheldon,9993,0,9999,6
1714212955921,CLRE 251,A00,507176,Mehta; Ravindra L.,9993,0,9999,6
1714212955921,CLRE 251,B00,511410,Mehta; Ravindra L.,9998,0,9999,1
1714212956948,CLRE 252,A00,507189,Cuomo; Raphael Eduardo,9995,0,9999,4
1714212957979,CLRE 253,A00,507199,Vaida; Florin,9994,0,9999,5
1714212957979,CLRE 253,B00,507202,Vaida; Florin,9999,0,9999,0
1714212959005,CLRE 259,A00,507211,Patel; Hemal,9996,0,9999,3
1714212960095,CLRE 260,A00,507221,Cuomo; Raphael Eduardo,9999,0,9999,0
1714212961124,CLRE 297,001,507242,Cuomo; Raphael Eduardo,9999,0,9999,0
1714212962153,COGS 197,001,638244,Voytek; Bradley Thomas,9999,0,9999,0
1714212963180,CSE 191,A00,516875,Minnes Kemp; Mor Mia,9993,0,9999,6
1714212964207,CSE 197,001,637388,Minnes Kemp; Mor Mia,9998,0,9999,1
1714212965233,CSS 201S,A01,494383,Staff,35,0,35,0
1714212966259,CSS 202S,A01,494387,Staff,35,0,35,0
1714212967285,DSC 197,001,628532,Eldridge; Justin Matthew,9996,0,9999,3
1714212968314,EAP 100,A00,516065,Staff,9797,0,9999,202
1714212969348,ECE 45,A01,507414,Staff,33,0,60,27
1714212971399,ECE 111,A01,507420,Staff,21,0,50,29
1714212972432,ECE 197,001,548057,Sievenpiper; Daniel F.,9994,0,9999,5
1714212973460,EDS 115,A00,507243,Choi; Bailey Miyeon,12,0,28,16
1714212974485,EDS 117,A01,494379,Staff,0,1,30,30
1714212975516,EDS 125,A00,507246,Hopkins; Megan Beth,12,0,30,18
1714212976547,EDS 128A,A01,507264,Fargason; Sharon Gayle,14,0,26,12
1714212977575,EDS 128B,A01,507293,Pappas; Elizabeth,18,0,30,12
1714212978603,EDS 139,A00,507294,Fargason; Sharon Gayle,18,0,30,12
1714212978603,EDS 139,B00,507313,Pappas; Elizabeth,15,0,30,15
1714212979633,EDS 201,A00,507315,Staff,13,0,30,17
1714212980658,EDS 203,A01,507317,Halter; Christopher P.,12,0,30,18
1714212981741,EDS 204R,A01,507319,Halter; Christopher P.,0,3,30,30
1714212981741,EDS 204R,B01,507331,Heinzman; Erica M.,17,0,30,13
1714212982767,EDS 206R,A00,507332,Staff,0,4,30,30
1714212982767,EDS 206R,B00,507343,Staff,18,0,30,12
1714212983794,EDS 250,A00,507344,Hemans; Patricia Ann Benitez,22,0,40,18
1714212984820,EDS 281,A00,507345,Daly; Alan J.,18,0,18,0
1714212985845,EDS 284,A00,507350,Daly; Alan J.,16,0,16,0
1714212986869,EDS 286,A00,507359,Fine; Sarah,18,0,18,0
1714212987896,EDS 289C,A01,507361,Daly; Alan J.,18,0,18,0
1714212988924,EDS 290,A00,507366,Hofstetter; Carolyn,15,0,15,0
1714212989952,LIGM 5A,A00,507421,Fischer-Grunski; Eva K,18,0,20,2
1714212990978,LIGM 5B,A00,507423,Fischer-Grunski; Eva K,19,0,20,1
1714212992003,LIGM 5C,A00,507425,Fischer-Grunski; Eva K,19,0,20,1
1714212993027,LIIT 5AS,A00,507427,Carnelos; Chiara,20,0,20,0
1714212994053,LIIT 5BS,A00,507430,Carnelos; Chiara,20,0,20,0
1714212995082,LIIT 5CS,A00,507432,Carnelos; Chiara,20,0,20,0
1714212996106,LISP 5A,A00,507541,Munoz Sanchez; Alicia,11,0,20,9
1714212997132,LISP 5B,A00,507671,Munoz Sanchez; Alicia,9,0,20,11
1714212998158,LISP 5C,A00,507696,Munoz Sanchez; Alicia,9,0,20,11
1714212999183,MAE 197,001,528363,Boechler; Nicholas Sebastia,9998,0,9999,1
1714213000208,MATH 197,001,523477,Kedlaya; Kiran S.,9996,0,9999,3
1714213000208,MATH 197,002,563811,Zhang; Danna,9995,0,9999,4
1714213000208,MATH 197,003,628552,Dumitriu; Ioana,9998,0,9999,1
1714213001234,MCWP 40R,A00,518780,Staff,5,0,20,15
1714213001234,MCWP 40R,B00,518781,Staff,7,0,20,13
1714213001234,MCWP 40R,C00,518783,Staff,5,0,20,15
1714213002261,MCWP 50R,A00,518791,Staff,0,0,20,20
1714213002261,MCWP 50R,B00,518792,Staff,0,1,20,20
1714213002261,MCWP 50R,C00,518793,Staff,0,1,20,20
1714213002261,MCWP 50R,D00,518794,Staff,0,0,20,20
1714213002261,MCWP 50R,E00,518795,Staff,0,1,20,20
1714213002261,MCWP 50R,F00,518796,Staff,0,0,20,20
1714213002261,MCWP 50R,G00,518797,Staff,0,1,20,20
1714213003286,MMW 12R,A01,514034,Herbst; Matthew,0,1,16,16
1714213003286,MMW 12R,A02,514035,Herbst; Matthew,2,0,16,14
1714213004311,MMW 13R,A01,514037,Staff,0,4,16,16
1714213004311,MMW 13R,A02,514039,Staff,0,2,16,16
1714213004311,MMW 13R,A03,628519,Staff,0,2,16,16
1714213006360,SIO 295LS,A00,523233,Staff,13,0,30,17
1714213007385,SIO 295S,A00,523232,Staff,13,0,30,17
1714213008415,SIOC 290S,A01,637330,Merrifield; Mark A,28,0,30,2
1714213009444,SIOC 291S,A01,637333,Gabriel; Corey John,28,0,30,2
1714213010471,SOCI 117,A01,494376,Staff,0,2,5,5
1714213011497,WES 237B,A00,494380,Staff,9,0,20,11
1714213013573,AESE 279B,A00,494370,Wade; Jon P,0,0,33,33
1714213014603,AIP 197,001,627712,Vespa; Emanuel Ignacio,9998,0,9999,1
1714213015628,ANAR 135S,A00,494369,Braswell; Geoffrey E.,0,0,0,0
1714213016653,BENG 196,001,628496,Engler; Adam J.,9998,0,9999,1
1714213017678,CAT 124RS,A01,519847,Geibel; William,0,0,20,20
1714213018706,CAT 125RS,A01,515971,Geibel; William,0,0,20,20
1714213019735,CLRE 250,A00,511389,Morris; Sheldon,9993,0,9999,6
1714213020769,CLRE 251,A00,507176,Mehta; Ravindra L.,9993,0,9999,6
1714213020769,CLRE 251,B00,511410,Mehta; Ravindra L.,9998,0,9999,1
1714213021795,CLRE 252,A00,507189,Cuomo; Raphael Eduardo,9995,0,9999,4
1714213022819,CLRE 253,A00,507199,Vaida; Florin,9994,0,9999,5
1714213022819,CLRE 253,B00,507202,Vaida; Florin,9999,0,9999,0
1714213023845,CLRE 259,A00,507211,Patel; Hemal,9996,0,9999,3
1714213024869,CLRE 260,A00,507221,Cuomo; Raphael Eduardo,9999,0,9999,0
1714213025896,CLRE 297,001,507242,Cuomo; Raphael Eduardo,9999,0,9999,0
1714213026925,COGS 197,001,638244,Voytek; Bradley Thomas,9999,0,9999,0
1714213027954,CSE 191,A00,516875,Minnes Kemp; Mor Mia,9993,0,9999,6
1714213028978,CSE 197,001,637388,Minnes Kemp; Mor Mia,9998,0,9999,1
1714213030004,CSS 201S,A01,494383,Staff,35,0,35,0
1714213031031,CSS 202S,A01,494387,Staff,35,0,35,0
1714213032055,DSC 197,001,628532,Eldridge; Justin Matthew,9996,0,9999,3
1714213033084,EAP 100,A00,516065,Staff,9797,0,9999,202
1714213034110,ECE 45,A01,507414,Staff,33,0,60,27
1714213036162,ECE 111,A01,507420,Staff,21,0,50,29
1714213037188,ECE 197,001,548057,Sievenpiper; Daniel F.,9994,0,9999,5
1714213038214,EDS 115,A00,507243,Choi; Bailey Miyeon,12,0,28,16
1714213039244,EDS 117,A01,494379,Staff,0,1,30,30
1714213040270,EDS 125,A00,507246,Hopkins; Megan Beth,12,0,30,18
1714213041294,EDS 128A,A01,507264,Fargason; Sharon Gayle,14,0,26,12
1714213042323,EDS 128B,A01,507293,Pappas; Elizabeth,18,0,30,12
1714213043348,EDS 139,A00,507294,Fargason; Sharon Gayle,18,0,30,12
1714213043348,EDS 139,B00,507313,Pappas; Elizabeth,15,0,30,15
1714213044374,EDS 201,A00,507315,Staff,13,0,30,17
1714213045401,EDS 203,A01,507317,Halter; Christopher P.,12,0,30,18
1714213046431,EDS 204R,A01,507319,Halter; Christopher P.,0,3,30,30
1714213046431,EDS 204R,B01,507331,Heinzman; Erica M.,17,0,30,13
1714213047457,EDS 206R,A00,507332,Staff,0,4,30,30
1714213047457,EDS 206R,B00,507343,Staff,18,0,30,12
1714213048483,EDS 250,A00,507344,Hemans; Patricia Ann Benitez,22,0,40,18
1714213049513,EDS 281,A00,507345,Daly; Alan J.,18,0,18,0
1714213050541,EDS 284,A00,507350,Daly; Alan J.,16,0,16,0
1714213051567,EDS 286,A00,507359,Fine; Sarah,18,0,18,0
1714213052593,EDS 289C,A01,507361,Daly; Alan J.,18,0,18,0
1714213053618,EDS 290,A00,507366,Hofstetter; Carolyn,15,0,15,0
1714213054646,LIGM 5A,A00,507421,Fischer-Grunski; Eva K,18,0,20,2
1714213055673,LIGM 5B,A00,507423,Fischer-Grunski; Eva K,19,0,20,1
1714213056698,LIGM 5C,A00,507425,Fischer-Grunski; Eva K,19,0,20,1
1714213057728,LIIT 5AS,A00,507427,Carnelos; Chiara,20,0,20,0
1714213058757,LIIT 5BS,A00,507430,Carnelos; Chiara,20,0,20,0
1714213059785,LIIT 5CS,A00,507432,Carnelos; Chiara,20,0,20,0
1714213060811,LISP 5A,A00,507541,Munoz Sanchez; Alicia,11,0,20,9
1714213061836,LISP 5B,A00,507671,Munoz Sanchez; Alicia,9,0,20,11
1714213062866,LISP 5C,A00,507696,Munoz Sanchez; Alicia,9,0,20,11
1714213063891,MAE 197,001,528363,Boechler; Nicholas Sebastia,9998,0,9999,1
1714213064923,MATH 197,001,523477,Kedlaya; Kiran S.,9996,0,9999,3
1714213064923,MATH 197,002,563811,Zhang; Danna,9995,0,9999,4
1714213064923,MATH 197,003,628552,Dumitriu; Ioana,9998,0,9999,1
1714213065948,MCWP 40R,A00,518780,Staff,5,0,20,15
1714213065948,MCWP 40R,B00,518781,Staff,7,0,20,13
1714213065948,MCWP 40R,C00,518783,Staff,5,0,20,15
1714213066977,MCWP 50R,A00,518791,Staff,0,0,20,20
1714213066977,MCWP 50R,B00,518792,Staff,0,1,20,20
1714213066977,MCWP 50R,C00,518793,Staff,0,1,20,20
1714213066977,MCWP 50R,D00,518794,Staff,0,0,20,20
1714213066977,MCWP 50R,E00,518795,Staff,0,1,20,20
1714213066977,MCWP 50R,F00,518796,Staff,0,0,20,20
1714213066977,MCWP 50R,G00,518797,Staff,0,1,20,20
1714213068002,MMW 12R,A01,514034,Herbst; Matthew,0,1,16,16
1714213068002,MMW 12R,A02,514035,Herbst; Matthew,2,0,16,14
1714213069028,MMW 13R,A01,514037,Staff,0,4,16,16
1714213069028,MMW 13R,A02,514039,Staff,0,2,16,16
1714213069028,MMW 13R,A03,628519,Staff,0,2,16,16
1714213071084,SIO 295LS,A00,523233,Staff,13,0,30,17
1714213072108,SIO 295S,A00,523232,Staff,13,0,30,17
1714213073139,SIOC 290S,A01,637330,Merrifield; Mark A,28,0,30,2
1714213074167,SIOC 291S,A01,637333,Gabriel; Corey John,28,0,30,2
1714213075196,SOCI 117,A01,494376,Staff,0,2,5,5
1714213076223,WES 237B,A00,494380,Staff,9,0,20,11
1714213078310,AESE 279B,A00,494370,Wade; Jon P,0,0,33,33
1714213079339,AIP 197,001,627712,Vespa; Emanuel Ignacio,9998,0,9999,1
1714213080365,ANAR 135S,A00,494369,Braswell; Geoffrey E.,0,0,0,0
1714213081395,BENG 196,001,628496,Engler; Adam J.,9998,0,9999,1
1714213082421,CAT 124RS,A01,519847,Geibel; William,0,0,20,20
1714213083447,CAT 125RS,A01,515971,Geibel; William,0,0,20,20
1714213084475,CLRE 250,A00,511389,Morris; Sheldon,9993,0,9999,6
1714213085554,CLRE 251,A00,507176,Mehta; Ravindra L.,9993,0,9999,6
1714213085554,CLRE 251,B00,511410,Mehta; Ravindra L.,9998,0,9999,1
1714213086580,CLRE 252,A00,507189,Cuomo; Raphael Eduardo,9995,0,9999,4
1714213087609,CLRE 253,A00,507199,Vaida; Florin,9994,0,9999,5
1714213087609,CLRE 253,B00,507202,Vaida; Florin,9999,0,9999,0
1714213088636,CLRE 259,A00,507211,Patel; Hemal,9996,0,9999,3
1714213089664,CLRE 260,A00,507221,Cuomo; Raphael Eduardo,9999,0,9999,0
1714213090688,CLRE 297,001,507242,Cuomo; Raphael Eduardo,9999,0,9999,0
1714213091716,COGS 197,001,638244,Voytek; Bradley Thomas,9999,0,9999,0
1714213092744,CSE 191,A00,516875,Minnes Kemp; Mor Mia,9993,0,9999,6
1714213093769,CSE 197,001,637388,Minnes Kemp; Mor Mia,9998,0,9999,1
1714213094798,CSS 201S,A01,494383,Staff,35,0,35,0
1714213095823,CSS 202S,A01,494387,Staff,35,0,35,0
1714213096849,DSC 197,001,628532,Eldridge; Justin Matthew,9996,0,9999,3
1714213097874,EAP 100,A00,516065,Staff,9797,0,9999,202
1714213098898,ECE 45,A01,507414,Staff,33,0,60,27
1714213100950,ECE 111,A01,507420,Staff,21,0,50,29
1714213101975,ECE 197,001,548057,Sievenpiper; Daniel F.,9994,0,9999,5
1714213102999,EDS 115,A00,507243,Choi; Bailey Miyeon,12,0,28,16
1714213104024,EDS 117,A01,494379,Staff,0,1,30,30
1714213105048,EDS 125,A00,507246,Hopkins; Megan Beth,12,0,30,18
1714213106073,EDS 128A,A01,507264,Fargason; Sharon Gayle,14,0,26,12
1714213107103,EDS 128B,A01,507293,Pappas; Elizabeth,18,0,30,12
1714213108131,EDS 139,A00,507294,Fargason; Sharon Gayle,18,0,30,12
1714213108131,EDS 139,B00,507313,Pappas; Elizabeth,15,0,30,15
1714213109159,EDS 201,A00,507315,Staff,13,0,30,17
1714213110185,EDS 203,A01,507317,Halter; Christopher P.,12,0,30,18
1714213111213,EDS 204R,A01,507319,Halter; Christopher P.,0,3,30,30
1714213111213,EDS 204R,B01,507331,Heinzman; Erica M.,17,0,30,13
1714213112238,EDS 206R,A00,507332,Staff,0,4,30,30
1714213112238,EDS 206R,B00,507343,Staff,18,0,30,12
1714213113263,EDS 250,A00,507344,Hemans; Patricia Ann Benitez,22,0,40,18
1714213114292,EDS 281,A00,507345,Daly; Alan J.,18,0,18,0
1714213115316,EDS 284,A00,507350,Daly; Alan J.,16,0,16,0
1714213116340,EDS 286,A00,507359,Fine; Sarah,18,0,18,0
1714213117367,EDS 289C,A01,507361,Daly; Alan J.,18,0,18,0
1714213118392,EDS 290,A00,507366,Hofstetter; Carolyn,15,0,15,0
1714213119419,LIGM 5A,A00,507421,Fischer-Grunski; Eva K,18,0,20,2
1714213120443,LIGM 5B,A00,507423,Fischer-Grunski; Eva K,19,0,20,1
1714213121467,LIGM 5C,A00,507425,Fischer-Grunski; Eva K,19,0,20,1
1714213122492,LIIT 5AS,A00,507427,Carnelos; Chiara,20,0,20,0
1714213123517,LIIT 5BS,A00,507430,Carnelos; Chiara,20,0,20,0
1714213124542,LIIT 5CS,A00,507432,Carnelos; Chiara,20,0,20,0
1714213125567,LISP 5A,A00,507541,Munoz Sanchez; Alicia,11,0,20,9
1714213126593,LISP 5B,A00,507671,Munoz Sanchez; Alicia,9,0,20,11
1714213127622,LISP 5C,A00,507696,Munoz Sanchez; Alicia,9,0,20,11
1714213128648,MAE 197,001,528363,Boechler; Nicholas Sebastia,9998,0,9999,1
1714213129673,MATH 197,001,523477,Kedlaya; Kiran S.,9996,0,9999,3
1714213129673,MATH 197,002,563811,Zhang; Danna,9995,0,9999,4
1714213129673,MATH 197,003,628552,Dumitriu; Ioana,9998,0,9999,1
1714213130701,MCWP 40R,A00,518780,Staff,5,0,20,15
1714213130701,MCWP 40R,B00,518781,Staff,7,0,20,13
1714213130701,MCWP 40R,C00,518783,Staff,5,0,20,15
1714213131727,MCWP 50R,A00,518791,Staff,0,0,20,20
1714213131727,MCWP 50R,B00,518792,Staff,0,1,20,20
1714213131727,MCWP 50R,C00,518793,Staff,0,1,20,20
1714213131727,MCWP 50R,D00,518794,Staff,0,0,20,20
1714213131727,MCWP 50R,E00,518795,Staff,0,1,20,20
1714213131727,MCWP 50R,F00,518796,Staff,0,0,20,20
1714213131727,MCWP 50R,G00,518797,Staff,0,1,20,20
1714213132753,MMW 12R,A01,514034,Herbst; Matthew,0,1,16,16
1714213132753,MMW 12R,A02,514035,Herbst; Matthew,2,0,16,14
1714213133782,MMW 13R,A01,514037,Staff,0,4,16,16
1714213133782,MMW 13R,A02,514039,Staff,0,2,16,16
1714213133782,MMW 13R,A03,628519,Staff,0,2,16,16
1714213135835,SIO 295LS,A00,523233,Staff,13,0,30,17
1714213136861,SIO 295S,A00,523232,Staff,13,0,30,17
1714213137887,SIOC 290S,A01,637330,Merrifield; Mark A,28,0,30,2
1714213138913,SIOC 291S,A01,637333,Gabriel; Corey John,28,0,30,2
1714213139944,SOCI 117,A01,494376,Staff,0,2,5,5
1714213140979,WES 237B,A00,494380,Staff,9,0,20,11
1714213143055,AESE 279B,A00,494370,Wade; Jon P,0,0,33,33
1714213144083,AIP 197,001,627712,Vespa; Emanuel Ignacio,9998,0,9999,1
1714213145108,ANAR 135S,A00,494369,Braswell; Geoffrey E.,0,0,0,0
1714213146134,BENG 196,001,628496,Engler; Adam J.,9998,0,9999,1
1714213147161,CAT 124RS,A01,519847,Geibel; William,0,0,20,20
1714213148185,CAT 125RS,A01,515971,Geibel; William,0,0,20,20
1714213149214,CLRE 250,A00,511389,Morris; Sheldon,9993,0,9999,6
1714213150239,CLRE 251,A00,507176,Mehta; Ravindra L.,9993,0,9999,6
1714213150239,CLRE 251,B00,511410,Mehta; Ravindra L.,9998,0,9999,1
1714213151267,CLRE 252,A00,507189,Cuomo; Raphael Eduardo,9995,0,9999,4
1714213152292,CLRE 253,A00,507199,Vaida; Florin,9994,0,9999,5
1714213152292,CLRE 253,B00,507202,Vaida; Florin,9999,0,9999,0
1714213153318,CLRE 259,A00,507211,Patel; Hemal,9996,0,9999,3
1714213154345,CLRE 260,A00,507221,Cuomo; Raphael Eduardo,9999,0,9999,0
1714213155375,CLRE 297,001,507242,Cuomo; Raphael Eduardo,9999,0,9999,0
1714213156403,COGS 197,001,638244,Voytek; Bradley Thomas,9999,0,9999,0
1714213157428,CSE 191,A00,516875,Minnes Kemp; Mor Mia,9993,0,9999,6
1714213158454,CSE 197,001,637388,Minnes Kemp; Mor Mia,9998,0,9999,1
1714213159480,CSS 201S,A01,494383,Staff,35,0,35,0
1714213160510,CSS 202S,A01,494387,Staff,35,0,35,0
1714213161538,DSC 197,001,628532,Eldridge; Justin Matthew,9996,0,9999,3
1714213162563,EAP 100,A00,516065,Staff,9797,0,9999,202
1714213163588,ECE 45,A01,507414,Staff,33,0,60,27
1714213165645,ECE 111,A01,507420,Staff,21,0,50,29
1714213166671,ECE 197,001,548057,Sievenpiper; Daniel F.,9994,0,9999,5
1714213167698,EDS 115,A00,507243,Choi; Bailey Miyeon,12,0,28,16
1714213168728,EDS 117,A01,494379,Staff,0,1,30,30
1714213169755,EDS 125,A00,507246,Hopkins; Megan Beth,12,0,30,18
1714213170783,EDS 128A,A01,507264,Fargason; Sharon Gayle,14,0,26,12
1714213171812,EDS 128B,A01,507293,Pappas; Elizabeth,18,0,30,12
1714213172837,EDS 139,A00,507294,Fargason; Sharon Gayle,18,0,30,12
1714213172837,EDS 139,B00,507313,Pappas; Elizabeth,15,0,30,15
1714213173870,EDS 201,A00,507315,Staff,13,0,30,17
1714213174894,EDS 203,A01,507317,Halter; Christopher P.,12,0,30,18
1714213175921,EDS 204R,A01,507319,Halter; Christopher P.,0,3,30,30
1714213175921,EDS 204R,B01,507331,Heinzman; Erica M.,17,0,30,13
1714213176946,EDS 206R,A00,507332,Staff,0,4,30,30
1714213176946,EDS 206R,B00,507343,Staff,18,0,30,12
1714213177973,EDS 250,A00,507344,Hemans; Patricia Ann Benitez,22,0,40,18
1714213178998,EDS 281,A00,507345,Daly; Alan J.,18,0,18,0
1714213180026,EDS 284,A00,507350,Daly; Alan J.,16,0,16,0
1714213181051,EDS 286,A00,507359,Fine; Sarah,18,0,18,0
1714213182077,EDS 289C,A01,507361,Daly; Alan J.,18,0,18,0
1714213183102,EDS 290,A00,507366,Hofstetter; Carolyn,15,0,15,0
1714213184135,LIGM 5A,A00,507421,Fischer-Grunski; Eva K,18,0,20,2
1714213185163,LIGM 5B,A00,507423,Fischer-Grunski; Eva K,19,0,20,1
1714213186190,LIGM 5C,A00,507425,Fischer-Grunski; Eva K,19,0,20,1
1714213187216,LIIT 5AS,A00,507427,Carnelos; Chiara,20,0,20,0
1714213188240,LIIT 5BS,A00,507430,Carnelos; Chiara,20,0,20,0
1714213189320,LIIT 5CS,A00,507432,Carnelos; Chiara,20,0,20,0
1714213190348,LISP 5A,A00,507541,Munoz Sanchez; Alicia,11,0,20,9
1714213191372,LISP 5B,A00,507671,Munoz Sanchez; Alicia,9,0,20,11
1714213192399,LISP 5C,A00,507696,Munoz Sanchez; Alicia,9,0,20,11
1714213193427,MAE 197,001,528363,Boechler; Nicholas Sebastia,9998,0,9999,1
1714213194452,MATH 197,001,523477,Kedlaya; Kiran S.,9996,0,9999,3
1714213194452,MATH 197,002,563811,Zhang; Danna,9995,0,9999,4
1714213194452,MATH 197,003,628552,Dumitriu; Ioana,9998,0,9999,1
1714213195479,MCWP 40R,A00,518780,Staff,5,0,20,15
1714213195479,MCWP 40R,B00,518781,Staff,7,0,20,13
1714213195479,MCWP 40R,C00,518783,Staff,5,0,20,15
1714213196508,MCWP 50R,A00,518791,Staff,0,0,20,20
1714213196508,MCWP 50R,B00,518792,Staff,0,1,20,20
1714213196508,MCWP 50R,C00,518793,Staff,0,1,20,20
1714213196508,MCWP 50R,D00,518794,Staff,0,0,20,20
1714213196508,MCWP 50R,E00,518795,Staff,0,1,20,20
1714213196508,MCWP 50R,F00,518796,Staff,0,0,20,20
1714213196508,MCWP 50R,G00,518797,Staff,0,1,20,20
1714213197539,MMW 12R,A01,514034,Herbst; Matthew,0,1,16,16
1714213197539,MMW 12R,A02,514035,Herbst; Matthew,2,0,16,14
1714213198567,MMW 13R,A01,514037,Staff,0,4,16,16
1714213198567,MMW 13R,A02,514039,Staff,0,2,16,16
1714213198567,MMW 13R,A03,628519,Staff,0,2,16,16
1714213200621,SIO 295LS,A00,523233,Staff,13,0,30,17
1714213201648,SIO 295S,A00,523232,Staff,13,0,30,17
1714213202676,SIOC 290S,A01,637330,Merrifield; Mark A,28,0,30,2
1714213203703,SIOC 291S,A01,637333,Gabriel; Corey John,28,0,30,2
1714213204728,SOCI 117,A01,494376,Staff,0,2,5,5
1714213205752,WES 237B,A00,494380,Staff,9,0,20,11
1714213207819,AESE 279B,A00,494370,Wade; Jon P,0,0,33,33
1714213208845,AIP 197,001,627712,Vespa; Emanuel Ignacio,9998,0,9999,1
1714213209872,ANAR 135S,A00,494369,Braswell; Geoffrey E.,0,0,0,0
1714213210897,BENG 196,001,628496,Engler; Adam J.,9998,0,9999,1
1714213211925,CAT 124RS,A01,519847,Geibel; William,0,0,20,20
1714213212951,CAT 125RS,A01,515971,Geibel; William,0,0,20,20
1714213213979,CLRE 250,A00,511389,Morris; Sheldon,9993,0,9999,6
1714213215006,CLRE 251,A00,507176,Mehta; Ravindra L.,9993,0,9999,6
1714213215006,CLRE 251,B00,511410,Mehta; Ravindra L.,9998,0,9999,1
1714213216036,CLRE 252,A00,507189,Cuomo; Raphael Eduardo,9995,0,9999,4
1714213217062,CLRE 253,A00,507199,Vaida; Florin,9994,0,9999,5
1714213217062,CLRE 253,B00,507202,Vaida; Florin,9999,0,9999,0
1714213218088,CLRE 259,A00,507211,Patel; Hemal,9996,0,9999,3
1714213219112,CLRE 260,A00,507221,Cuomo; Raphael Eduardo,9999,0,9999,0
1714213220139,CLRE 297,001,507242,Cuomo; Raphael Eduardo,9999,0,9999,0
1714213221166,COGS 197,001,638244,Voytek; Bradley Thomas,9999,0,9999,0
1714213222190,CSE 191,A00,516875,Minnes Kemp; Mor Mia,9993,0,9999,6
1714213223214,CSE 197,001,637388,Minnes Kemp; Mor Mia,9998,0,9999,1
1714213224239,CSS 201S,A01,494383,Staff,35,0,35,0
1714213225265,CSS 202S,A01,494387,Staff,35,0,35,0
1714213226290,DSC 197,001,628532,Eldridge; Justin Matthew,9996,0,9999,3
1714213227314,EAP 100,A00,516065,Staff,9797,0,9999,202
1714213228341,ECE 45,A01,507414,Staff,33,0,60,27
1714213230392,ECE 111,A01,507420,Staff,21,0,50,29
1714213231417,ECE 197,001,548057,Sievenpiper; Daniel F.,9994,0,9999,5
1714213232447,EDS 115,A00,507243,Choi; Bailey Miyeon,12,0,28,16
1714213233475,EDS 117,A01,494379,Staff,0,1,30,30
1714213234503,EDS 125,A00,507246,Hopkins; Megan Beth,12,0,30,18
1714213235536,EDS 128A,A01,507264,Fargason; Sharon Gayle,14,0,26,12
1714213236561,EDS 128B,A01,507293,Pappas; Elizabeth,18,0,30,12
1714213237586,EDS 139,A00,507294,Fargason; Sharon Gayle,18,0,30,12
1714213237586,EDS 139,B00,507313,Pappas; Elizabeth,15,0,30,15
1714213238615,EDS 201,A00,507315,Staff,13,0,30,17
1714213239644,EDS 203,A01,507317,Halter; Christopher P.,12,0,30,18
1714213240669,EDS 204R,A01,507319,Halter; Christopher P.,0,3,30,30
1714213240669,EDS 204R,B01,507331,Heinzman; Erica M.,17,0,30,13
1714213241695,EDS 206R,A00,507332,Staff,0,4,30,30
1714213241695,EDS 206R,B00,507343,Staff,18,0,30,12
1714213242721,EDS 250,A00,507344,Hemans; Patricia Ann Benitez,22,0,40,18
1714213243748,EDS 281,A00,507345,Daly; Alan J.,18,0,18,0
1714213244774,EDS 284,A00,507350,Daly; Alan J.,16,0,16,0
1714213245803,EDS 286,A00,507359,Fine; Sarah,18,0,18,0
1714213246829,EDS 289C,A01,507361,Daly; Alan J.,18,0,18,0
1714213247858,EDS 290,A00,507366,Hofstetter; Carolyn,15,0,15,0
1714213248885,LIGM 5A,A00,507421,Fischer-Grunski; Eva K,18,0,20,2
1714213249912,LIGM 5B,A00,507423,Fischer-Grunski; Eva K,19,0,20,1
1714213250939,LIGM 5C,A00,507425,Fischer-Grunski; Eva K,19,0,20,1
1714213251967,LIIT 5AS,A00,507427,Carnelos; Chiara,20,0,20,0
1714213252997,LIIT 5BS,A00,507430,Carnelos; Chiara,20,0,20,0
1714213254022,LIIT 5CS,A00,507432,Carnelos; Chiara,20,0,20,0
1714213255048,LISP 5A,A00,507541,Munoz Sanchez; Alicia,11,0,20,9
1714213256078,LISP 5B,A00,507671,Munoz Sanchez; Alicia,9,0,20,11
1714213257105,LISP 5C,A00,507696,Munoz Sanchez; Alicia,9,0,20,11
1714213258134,MAE 197,001,528363,Boechler; Nicholas Sebastia,9998,0,9999,1
1714213259168,MATH 197,001,523477,Kedlaya; Kiran S.,9996,0,9999,3
1714213259168,MATH 197,002,563811,Zhang; Danna,9995,0,9999,4
1714213259168,MATH 197,003,628552,Dumitriu; Ioana,9998,0,9999,1
1714213260196,MCWP 40R,A00,518780,Staff,5,0,20,15
1714213260196,MCWP 40R,B00,518781,Staff,7,0,20,13
1714213260196,MCWP 40R,C00,518783,Staff,5,0,20,15
1714213261228,MCWP 50R,A00,518791,Staff,0,0,20,20
1714213261228,MCWP 50R,B00,518792,Staff,0,1,20,20
1714213261228,MCWP 50R,C00,518793,Staff,0,1,20,20
1714213261228,MCWP 50R,D00,518794,Staff,0,0,20,20
1714213261228,MCWP 50R,E00,518795,Staff,0,1,20,20
1714213261228,MCWP 50R,F00,518796,Staff,0,0,20,20
1714213261228,MCWP 50R,G00,518797,Staff,0,1,20,20
1714213262254,MMW 12R,A01,514034,Herbst; Matthew,0,1,16,16
1714213262254,MMW 12R,A02,514035,Herbst; Matthew,2,0,16,14
1714213263280,MMW 13R,A01,514037,Staff,0,4,16,16
1714213263280,MMW 13R,A02,514039,Staff,0,2,16,16
1714213263280,MMW 13R,A03,628519,Staff,0,2,16,16
1714213265337,SIO 295LS,A00,523233,Staff,13,0,30,17
1714213266362,SIO 295S,A00,523232,Staff,13,0,30,17
1714213267394,SIOC 290S,A01,637330,Merrifield; Mark A,28,0,30,2
1714213268421,SIOC 291S,A01,637333,Gabriel; Corey John,28,0,30,2
1714213269448,SOCI 117,A01,494376,Staff,0,2,5,5
1714213270478,WES 237B,A00,494380,Staff,9,0,20,11
1714213272551,AESE 279B,A00,494370,Wade; Jon P,0,0,33,33
1714213273583,AIP 197,001,627712,Vespa; Emanuel Ignacio,9998,0,9999,1
1714213274609,ANAR 135S,A00,494369,Braswell; Geoffrey E.,0,0,0,0
1714213275635,BENG 196,001,628496,Engler; Adam J.,9998,0,9999,1
1714213276666,CAT 124RS,A01,519847,Geibel; William,0,0,20,20
1714213277691,CAT 125RS,A01,515971,Geibel; William,0,0,20,20
1714213278717,CLRE 250,A00,511389,Morris; Sheldon,9993,0,9999,6
1714213279743,CLRE 251,A00,507176,Mehta; Ravindra L.,9993,0,9999,6
1714213279743,CLRE 251,B00,511410,Mehta; Ravindra L.,9998,0,9999,1
1714213280768,CLRE 252,A00,507189,Cuomo; Raphael Eduardo,9995,0,9999,4
1714213281796,CLRE 253,A00,507199,Vaida; Florin,9994,0,9999,5
1714213281796,CLRE 253,B00,507202,Vaida; Florin,9999,0,9999,0
1714213282826,CLRE 259,A00,507211,Patel; Hemal,9996,0,9999,3
1714213283852,CLRE 260,A00,507221,Cuomo; Raphael Eduardo,9999,0,9999,0
1714213284881,CLRE 297,001,507242,Cuomo; Raphael Eduardo,9999,0,9999,0
1714213285905,COGS 197,001,638244,Voytek; Bradley Thomas,9999,0,9999,0
1714213286935,CSE 191,A00,516875,Minnes Kemp; Mor Mia,9993,0,9999,6
1714213287975,CSE 197,001,637388,Minnes Kemp; Mor Mia,9998,0,9999,1
1714213289002,CSS 201S,A01,494383,Staff,35,0,35,0
1714213290030,CSS 202S,A01,494387,Staff,35,0,35,0
1714213291055,DSC 197,001,628532,Eldridge; Justin Matthew,9996,0,9999,3
1714213292081,EAP 100,A00,516065,Staff,9797,0,9999,202
1714213293162,ECE 45,A01,507414,Staff,33,0,60,27
1714213295214,ECE 111,A01,507420,Staff,21,0,50,29
1714213296239,ECE 197,001,548057,Sievenpiper; Daniel F.,9994,0,9999,5
1714213297266,EDS 115,A00,507243,Choi; Bailey Miyeon,12,0,28,16
1714213298293,EDS 117,A01,494379,Staff,0,1,30,30
1714213299320,EDS 125,A00,507246,Hopkins; Megan Beth,12,0,30,18
1714213300345,EDS 128A,A01,507264,Fargason; Sharon Gayle,14,0,26,12
1714213301377,EDS 128B,A01,507293,Pappas; Elizabeth,18,0,30,12
1714213302403,EDS 139,A00,507294,Fargason; Sharon Gayle,18,0,30,12
1714213302403,EDS 139,B00,507313,Pappas; Elizabeth,15,0,30,15
1714213303431,EDS 201,A00,507315,Staff,13,0,30,17
1714213304456,EDS 203,A01,507317,Halter; Christopher P.,12,0,30,18
1714213305482,EDS 204R,A01,507319,Halter; Christopher P.,0,3,30,30
1714213305482,EDS 204R,B01,507331,Heinzman; Erica M.,17,0,30,13
1714213306509,EDS 206R,A00,507332,Staff,0,4,30,30
1714213306509,EDS 206R,B00,507343,Staff,18,0,30,12
1714213307536,EDS 250,A00,507344,Hemans; Patricia Ann Benitez,22,0,40,18
1714213308559,EDS 281,A00,507345,Daly; Alan J.,18,0,18,0
1714213309587,EDS 284,A00,507350,Daly; Alan J.,16,0,16,0
1714213310613,EDS 286,A00,507359,Fine; Sarah,18,0,18,0
1714213311637,EDS 289C,A01,507361,Daly; Alan J.,18,0,18,0
1714213312662,EDS 290,A00,507366,Hofstetter; Carolyn,15,0,15,0
1714213313687,LIGM 5A,A00,507421,Fischer-Grunski; Eva K,18,0,20,2
1714213314713,LIGM 5B,A00,507423,Fischer-Grunski; Eva K,19,0,20,1
1714213315738,LIGM 5C,A00,507425,Fischer-Grunski; Eva K,19,0,20,1
1714213316764,LIIT 5AS,A00,507427,Carnelos; Chiara,20,0,20,0
1714213317789,LIIT 5BS,A00,507430,Carnelos; Chiara,20,0,20,0
1714213318814,LIIT 5CS,A00,507432,Carnelos; Chiara,20,0,20,0
1714213319840,LISP 5A,A00,507541,Munoz Sanchez; Alicia,11,0,20,9
1714213320866,LISP 5B,A00,507671,Munoz Sanchez; Alicia,9,0,20,11
1714213321895,LISP 5C,A00,507696,Munoz Sanchez; Alicia,9,0,20,11
1714213322923,MAE 197,001,528363,Boechler; Nicholas Sebastia,9998,0,9999,1
1714213323948,MATH 197,001,523477,Kedlaya; Kiran S.,9996,0,9999,3
1714213323948,MATH 197,002,563811,Zhang; Danna,9995,0,9999,4
1714213323948,MATH 197,003,628552,Dumitriu; Ioana,9998,0,9999,1
1714213324976,MCWP 40R,A00,518780,Staff,5,0,20,15
1714213324976,MCWP 40R,B00,518781,Staff,7,0,20,13
1714213324976,MCWP 40R,C00,518783,Staff,5,0,20,15
1714213326000,MCWP 50R,A00,518791,Staff,0,0,20,20
1714213326000,MCWP 50R,B00,518792,Staff,0,1,20,20
1714213326000,MCWP 50R,C00,518793,Staff,0,1,20,20
1714213326000,MCWP 50R,D00,518794,Staff,0,0,20,20
1714213326000,MCWP 50R,E00,518795,Staff,0,1,20,20
1714213326000,MCWP 50R,F00,518796,Staff,0,0,20,20
1714213326000,MCWP 50R,G00,518797,Staff,0,1,20,20
1714213327029,MMW 12R,A01,514034,Herbst; Matthew,0,1,16,16
1714213327029,MMW 12R,A02,514035,Herbst; Matthew,2,0,16,14
1714213328057,MMW 13R,A01,514037,Staff,0,4,16,16
1714213328057,MMW 13R,A02,514039,Staff,0,2,16,16
1714213328057,MMW 13R,A03,628519,Staff,0,2,16,16
1714213330110,SIO 295LS,A00,523233,Staff,13,0,30,17
1714213331135,SIO 295S,A00,523232,Staff,13,0,30,17
1714213332162,SIOC 290S,A01,637330,Merrifield; Mark A,28,0,30,2
1714213333192,SIOC 291S,A01,637333,Gabriel; Corey John,28,0,30,2
1714213334218,SOCI 117,A01,494376,Staff,0,2,5,5
1714213335245,WES 237B,A00,494380,Staff,9,0,20,11
1714213337319,AESE 279B,A00,494370,Wade; Jon P,0,0,33,33
1714213338343,AIP 197,001,627712,Vespa; Emanuel Ignacio,9998,0,9999,1
1714213339371,ANAR 135S,A00,494369,Braswell; Geoffrey E.,0,0,0,0
1714213340397,BENG 196,001,628496,Engler; Adam J.,9998,0,9999,1
1714213341426,CAT 124RS,A01,519847,Geibel; William,0,0,20,20
1714213342451,CAT 125RS,A01,515971,Geibel; William,0,0,20,20
1714213343477,CLRE 250,A00,511389,Morris; Sheldon,9993,0,9999,6
1714213344512,CLRE 251,A00,507176,Mehta; Ravindra L.,9993,0,9999,6
1714213344512,CLRE 251,B00,511410,Mehta; Ravindra L.,9998,0,9999,1
1714213345541,CLRE 252,A00,507189,Cuomo; Raphael Eduardo,9995,0,9999,4
1714213346566,CLRE 253,A00,507199,Vaida; Florin,9994,0,9999,5
1714213346566,CLRE 253,B00,507202,Vaida; Florin,9999,0,9999,0
1714213347596,CLRE 259,A00,507211,Patel; Hemal,9996,0,9999,3
1714213348621,CLRE 260,A00,507221,Cuomo; Raphael Eduardo,9999,0,9999,0
1714213349649,CLRE 297,001,507242,Cuomo; Raphael Eduardo,9999,0,9999,0
1714213350679,COGS 197,001,638244,Voytek; Bradley Thomas,9999,0,9999,0
1714213351707,CSE 191,A00,516875,Minnes Kemp; Mor Mia,9993,0,9999,6
1714213352734,CSE 197,001,637388,Minnes Kemp; Mor Mia,9998,0,9999,1
1714213353761,CSS 201S,A01,494383,Staff,35,0,35,0
1714213354785,CSS 202S,A01,494387,Staff,35,0,35,0
1714213355814,DSC 197,001,628532,Eldridge; Justin Matthew,9996,0,9999,3
1714213356840,EAP 100,A00,516065,Staff,9797,0,9999,202
1714213357867,ECE 45,A01,507414,Staff,33,0,60,27
1714213359921,ECE 111,A01,507420,Staff,21,0,50,29
1714213360946,ECE 197,001,548057,Sievenpiper; Daniel F.,9994,0,9999,5
1714213361976,EDS 115,A00,507243,Choi; Bailey Miyeon,12,0,28,16
1714213363001,EDS 117,A01,494379,Staff,0,1,30,30
1714213364028,EDS 125,A00,507246,Hopkins; Megan Beth,12,0,30,18
1714213365053,EDS 128A,A01,507264,Fargason; Sharon Gayle,14,0,26,12
1714213366082,EDS 128B,A01,507293,Pappas; Elizabeth,18,0,30,12
1714213367110,EDS 139,A00,507294,Fargason; Sharon Gayle,18,0,30,12
1714213367110,EDS 139,B00,507313,Pappas; Elizabeth,15,0,30,15
1714213368134,EDS 201,A00,507315,Staff,13,0,30,17
1714213369165,EDS 203,A01,507317,Halter; Christopher P.,12,0,30,18
1714213370194,EDS 204R,A01,507319,Halter; Christopher P.,0,3,30,30
1714213370194,EDS 204R,B01,507331,Heinzman; Erica M.,17,0,30,13
1714213371222,EDS 206R,A00,507332,Staff,0,4,30,30
1714213371222,EDS 206R,B00,507343,Staff,18,0,30,12
1714213372250,EDS 250,A00,507344,Hemans; Patricia Ann Benitez,22,0,40,18
1714213373279,EDS 281,A00,507345,Daly; Alan J.,18,0,18,0
1714213374302,EDS 284,A00,507350,Daly; Alan J.,16,0,16,0
1714213375333,EDS 286,A00,507359,Fine; Sarah,18,0,18,0
1714213376361,EDS 289C,A01,507361,Daly; Alan J.,18,0,18,0
1714213377385,EDS 290,A00,507366,Hofstetter; Carolyn,15,0,15,0
1714213378416,LIGM 5A,A00,507421,Fischer-Grunski; Eva K,18,0,20,2
1714213379445,LIGM 5B,A00,507423,Fischer-Grunski; Eva K,19,0,20,1
1714213380470,LIGM 5C,A00,507425,Fischer-Grunski; Eva K,19,0,20,1
1714213381495,LIIT 5AS,A00,507427,Carnelos; Chiara,20,0,20,0
1714213382520,LIIT 5BS,A00,507430,Carnelos; Chiara,20,0,20,0
1714213383545,LIIT 5CS,A00,507432,Carnelos; Chiara,20,0,20,0
1714213384572,LISP 5A,A00,507541,Munoz Sanchez; Alicia,11,0,20,9
1714213385602,LISP 5B,A00,507671,Munoz Sanchez; Alicia,9,0,20,11
1714213386628,LISP 5C,A00,507696,Munoz Sanchez; Alicia,9,0,20,11
1714213387657,MAE 197,001,528363,Boechler; Nicholas Sebastia,9998,0,9999,1
1714213388685,MATH 197,001,523477,Kedlaya; Kiran S.,9996,0,9999,3
1714213388685,MATH 197,002,563811,Zhang; Danna,9995,0,9999,4
1714213388685,MATH 197,003,628552,Dumitriu; Ioana,9998,0,9999,1
1714213389710,MCWP 40R,A00,518780,Staff,5,0,20,15
1714213389710,MCWP 40R,B00,518781,Staff,7,0,20,13
1714213389710,MCWP 40R,C00,518783,Staff,5,0,20,15
1714213390739,MCWP 50R,A00,518791,Staff,0,0,20,20
1714213390739,MCWP 50R,B00,518792,Staff,0,1,20,20
1714213390739,MCWP 50R,C00,518793,Staff,0,1,20,20
1714213390739,MCWP 50R,D00,518794,Staff,0,0,20,20
1714213390739,MCWP 50R,E00,518795,Staff,0,1,20,20
1714213390739,MCWP 50R,F00,518796,Staff,0,0,20,20
1714213390739,MCWP 50R,G00,518797,Staff,0,1,20,20
1714213391765,MMW 12R,A01,514034,Herbst; Matthew,0,1,16,16
1714213391765,MMW 12R,A02,514035,Herbst; Matthew,2,0,16,14
1714213392790,MMW 13R,A01,514037,Staff,0,4,16,16
1714213392790,MMW 13R,A02,514039,Staff,0,2,16,16
1714213392790,MMW 13R,A03,628519,Staff,0,2,16,16
1714213394842,SIO 295LS,A00,523233,Staff,13,0,30,17
1714213395867,SIO 295S,A00,523232,Staff,13,0,30,17
1714213396948,SIOC 290S,A01,637330,Merrifield; Mark A,28,0,30,2
1714213397975,SIOC 291S,A01,637333,Gabriel; Corey John,28,0,30,2
1714213399003,SOCI 117,A01,494376,Staff,0,2,5,5
1714213400027,WES 237B,A00,494380,Staff,9,0,20,11
1714213402093,AESE 279B,A00,494370,Wade; Jon P,0,0,33,33
1714213403121,AIP 197,001,627712,Vespa; Emanuel Ignacio,9998,0,9999,1
1714213404146,ANAR 135S,A00,494369,Braswell; Geoffrey E.,0,0,0,0
1714213405171,BENG 196,001,628496,Engler; Adam J.,9998,0,9999,1
1714213406197,CAT 124RS,A01,519847,Geibel; William,0,0,20,20
1714213407222,CAT 125RS,A01,515971,Geibel; William,0,0,20,20
1714213408252,CLRE 250,A00,511389,Morris; Sheldon,9993,0,9999,6
1714213409278,CLRE 251,A00,507176,Mehta; Ravindra L.,9993,0,9999,6
1714213409278,CLRE 251,B00,511410,Mehta; Ravindra L.,9998,0,9999,1
1714213410303,CLRE 252,A00,507189,Cuomo; Raphael Eduardo,9995,0,9999,4
1714213411334,CLRE 253,A00,507199,Vaida; Florin,9994,0,9999,5
1714213411334,CLRE 253,B00,507202,Vaida; Florin,9999,0,9999,0
1714213412358,CLRE 259,A00,507211,Patel; Hemal,9996,0,9999,3
1714213413385,CLRE 260,A00,507221,Cuomo; Raphael Eduardo,9999,0,9999,0
1714213414411,CLRE 297,001,507242,Cuomo; Raphael Eduardo,9999,0,9999,0
1714213415441,COGS 197,001,638244,Voytek; Bradley Thomas,9999,0,9999,0
1714213416464,CSE 191,A00,516875,Minnes Kemp; Mor Mia,9993,0,9999,6
1714213417492,CSE 197,001,637388,Minnes Kemp; Mor Mia,9998,0,9999,1
1714213418519,CSS 201S,A01,494383,Staff,35,0,35,0
1714213419549,CSS 202S,A01,494387,Staff,35,0,35,0
1714213420579,DSC 197,001,628532,Eldridge; Justin Matthew,9996,0,9999,3
1714213421606,EAP 100,A00,516065,Staff,9797,0,9999,202
1714213422632,ECE 45,A01,507414,Staff,33,0,60,27
1714213424682,ECE 111,A01,507420,Staff,21,0,50,29
1714213425712,ECE 197,001,548057,Sievenpiper; Daniel F.,9994,0,9999,5
1714213426738,EDS 115,A00,507243,Choi; Bailey Miyeon,12,0,28,16
1714213427820,EDS 117,A01,494379,Staff,0,1,30,30
1714213428844,EDS 125,A00,507246,Hopkins; Megan Beth,12,0,30,18
1714213429873,EDS 128A,A01,507264,Fargason; Sharon Gayle,14,0,26,12
1714213430899,EDS 128B,A01,507293,Pappas; Elizabeth,18,0,30,12
1714213431926,EDS 139,A00,507294,Fargason; Sharon Gayle,18,0,30,12
1714213431926,EDS 139,B00,507313,Pappas; Elizabeth,15,0,30,15
1714213432953,EDS 201,A00,507315,Staff,13,0,30,17
1714213433978,EDS 203,A01,507317,Halter; Christopher P.,12,0,30,18
1714213435003,EDS 204R,A01,507319,Halter; Christopher P.,0,3,30,30
1714213435003,EDS 204R,B01,507331,Heinzman; Erica M.,17,0,30,13
1714213436029,EDS 206R,A00,507332,Staff,0,4,30,30
1714213436029,EDS 206R,B00,507343,Staff,18,0,30,12
1714213437053,EDS 250,A00,507344,Hemans; Patricia Ann Benitez,22,0,40,18
1714213438079,EDS 281,A00,507345,Daly; Alan J.,18,0,18,0
1714213439104,EDS 284,A00,507350,Daly; Alan J.,16,0,16,0
1714213440129,EDS 286,A00,507359,Fine; Sarah,18,0,18,0
1714213441157,EDS 289C,A01,507361,Daly; Alan J.,18,0,18,0
1714213442181,EDS 290,A00,507366,Hofstetter; Carolyn,15,0,15,0
1714213443206,LIGM 5A,A00,507421,Fischer-Grunski; Eva K,18,0,20,2
1714213444230,LIGM 5B,A00,507423,Fischer-Grunski; Eva K,19,0,20,1
1714213445254,LIGM 5C,A00,507425,Fischer-Grunski; Eva K,19,0,20,1
1714213446278,LIIT 5AS,A00,507427,Carnelos; Chiara,20,0,20,0
1714213447302,LIIT 5BS,A00,507430,Carnelos; Chiara,20,0,20,0
1714213448327,LIIT 5CS,A00,507432,Carnelos; Chiara,20,0,20,0
1714213449352,LISP 5A,A00,507541,Munoz Sanchez; Alicia,11,0,20,9
1714213450382,LISP 5B,A00,507671,Munoz Sanchez; Alicia,9,0,20,11
1714213451412,LISP 5C,A00,507696,Munoz Sanchez; Alicia,9,0,20,11
1714213452438,MAE 197,001,528363,Boechler; Nicholas Sebastia,9998,0,9999,1
1714213453471,MATH 197,001,523477,Kedlaya; Kiran S.,9996,0,9999,3
1714213453471,MATH 197,002,563811,Zhang; Danna,9995,0,9999,4
1714213453471,MATH 197,003,628552,Dumitriu; Ioana,9998,0,9999,1
1714213454501,MCWP 40R,A00,518780,Staff,5,0,20,15
1714213454501,MCWP 40R,B00,518781,Staff,7,0,20,13
1714213454501,MCWP 40R,C00,518783,Staff,5,0,20,15
1714213455527,MCWP 50R,A00,518791,Staff,0,0,20,20
1714213455527,MCWP 50R,B00,518792,Staff,0,1,20,20
1714213455527,MCWP 50R,C00,518793,Staff,0,1,20,20
1714213455527,MCWP 50R,D00,518794,Staff,0,0,20,20
1714213455527,MCWP 50R,E00,518795,Staff,0,1,20,20
1714213455527,MCWP 50R,F00,518796,Staff,0,0,20,20
1714213455527,MCWP 50R,G00,518797,Staff,0,1,20,20
1714213456553,MMW 12R,A01,514034,Herbst; Matthew,0,1,16,16
1714213456553,MMW 12R,A02,514035,Herbst; Matthew,2,0,16,14
1714213457582,MMW 13R,A01,514037,Staff,0,4,16,16
1714213457582,MMW 13R,A02,514039,Staff,0,2,16,16
1714213457582,MMW 13R,A03,628519,Staff,0,2,16,16
1714213459635,SIO 295LS,A00,523233,Staff,13,0,30,17
1714213460661,SIO 295S,A00,523232,Staff,13,0,30,17
1714213461688,SIOC 290S,A01,637330,Merrifield; Mark A,28,0,30,2
1714213462713,SIOC 291S,A01,637333,Gabriel; Corey John,28,0,30,2
1714213463739,SOCI 117,A01,494376,Staff,0,2,5,5
1714213464762,WES 237B,A00,494380,Staff,9,0,20,11
1714213466834,AESE 279B,A00,494370,Wade; Jon P,0,0,33,33
1714213467860,AIP 197,001,627712,Vespa; Emanuel Ignacio,9998,0,9999,1
1714213468887,ANAR 135S,A00,494369,Braswell; Geoffrey E.,0,0,0,0
1714213469912,BENG 196,001,628496,Engler; Adam J.,9998,0,9999,1
1714213470938,CAT 124RS,A01,519847,Geibel; William,0,0,20,20
1714213471968,CAT 125RS,A01,515971,Geibel; William,0,0,20,20
1714213472993,CLRE 250,A00,511389,Morris; Sheldon,9993,0,9999,6
1714213474020,CLRE 251,A00,507176,Mehta; Ravindra L.,9993,0,9999,6
1714213474020,CLRE 251,B00,511410,Mehta; Ravindra L.,9998,0,9999,1
1714213475051,CLRE 252,A00,507189,Cuomo; Raphael Eduardo,9995,0,9999,4
1714213476081,CLRE 253,A00,507199,Vaida; Florin,9994,0,9999,5
1714213476081,CLRE 253,B00,507202,Vaida; Florin,9999,0,9999,0
1714213477106,CLRE 259,A00,507211,Patel; Hemal,9996,0,9999,3
1714213478132,CLRE 260,A00,507221,Cuomo; Raphael Eduardo,9999,0,9999,0
1714213479159,CLRE 297,001,507242,Cuomo; Raphael Eduardo,9999,0,9999,0
1714213480186,COGS 197,001,638244,Voytek; Bradley Thomas,9999,0,9999,0
1714213481210,CSE 191,A00,516875,Minnes Kemp; Mor Mia,9993,0,9999,6
1714213482238,CSE 197,001,637388,Minnes Kemp; Mor Mia,9998,0,9999,1
1714213483265,CSS 201S,A01,494383,Staff,35,0,35,0
1714213484291,CSS 202S,A01,494387,Staff,35,0,35,0
1714213485316,DSC 197,001,628532,Eldridge; Justin Matthew,9996,0,9999,3
1714213486344,EAP 100,A00,516065,Staff,9797,0,9999,202
1714213487375,ECE 45,A01,507414,Staff,33,0,60,27
1714213489425,ECE 111,A01,507420,Staff,21,0,50,29
1714213490456,ECE 197,001,548057,Sievenpiper; Daniel F.,9994,0,9999,5
1714213491481,EDS 115,A00,507243,Choi; Bailey Miyeon,12,0,28,16
1714213492508,EDS 117,A01,494379,Staff,0,1,30,30
1714213493539,EDS 125,A00,507246,Hopkins; Megan Beth,12,0,30,18
1714213494565,EDS 128A,A01,507264,Fargason; Sharon Gayle,14,0,26,12
1714213495592,EDS 128B,A01,507293,Pappas; Elizabeth,18,0,30,12
1714213496618,EDS 139,A00,507294,Fargason; Sharon Gayle,18,0,30,12
1714213496618,EDS 139,B00,507313,Pappas; Elizabeth,15,0,30,15
1714213497645,EDS 201,A00,507315,Staff,13,0,30,17
1714213498671,EDS 203,A01,507317,Halter; Christopher P.,12,0,30,18
1714213499701,EDS 204R,A01,507319,Halter; Christopher P.,0,3,30,30
1714213499701,EDS 204R,B01,507331,Heinzman; Erica M.,17,0,30,13
1714213500784,EDS 206R,A00,507332,Staff,0,4,30,30
1714213500784,EDS 206R,B00,507343,Staff,18,0,30,12
1714213501814,EDS 250,A00,507344,Hemans; Patricia Ann Benitez,22,0,40,18
1714213502838,EDS 281,A00,507345,Daly; Alan J.,18,0,18,0
1714213503865,EDS 284,A00,507350,Daly; Alan J.,16,0,16,0
1714213504891,EDS 286,A00,507359,Fine; Sarah,18,0,18,0
1714213505921,EDS 289C,A01,507361,Daly; Alan J.,18,0,18,0
1714213506950,EDS 290,A00,507366,Hofstetter; Carolyn,15,0,15,0
1714213507976,LIGM 5A,A00,507421,Fischer-Grunski; Eva K,18,0,20,2
1714213509002,LIGM 5B,A00,507423,Fischer-Grunski; Eva K,19,0,20,1
1714213510030,LIGM 5C,A00,507425,Fischer-Grunski; Eva K,19,0,20,1
1714213511059,LIIT 5AS,A00,507427,Carnelos; Chiara,20,0,20,0
1714213512086,LIIT 5BS,A00,507430,Carnelos; Chiara,20,0,20,0
1714213513114,LIIT 5CS,A00,507432,Carnelos; Chiara,20,0,20,0
1714213514144,LISP 5A,A00,507541,Munoz Sanchez; Alicia,11,0,20,9
1714213515170,LISP 5B,A00,507671,Munoz Sanchez; Alicia,9,0,20,11
1714213516196,LISP 5C,A00,507696,Munoz Sanchez; Alicia,9,0,20,11
1714213517224,MAE 197,001,528363,Boechler; Nicholas Sebastia,9998,0,9999,1
1714213518250,MATH 197,001,523477,Kedlaya; Kiran S.,9996,0,9999,3
1714213518250,MATH 197,002,563811,Zhang; Danna,9995,0,9999,4
1714213518250,MATH 197,003,628552,Dumitriu; Ioana,9998,0,9999,1
1714213519276,MCWP 40R,A00,518780,Staff,5,0,20,15
1714213519276,MCWP 40R,B00,518781,Staff,7,0,20,13
1714213519276,MCWP 40R,C00,518783,Staff,5,0,20,15
1714213520305,MCWP 50R,A00,518791,Staff,0,0,20,20
1714213520305,MCWP 50R,B00,518792,Staff,0,1,20,20
1714213520305,MCWP 50R,C00,518793,Staff,0,1,20,20
1714213520305,MCWP 50R,D00,518794,Staff,0,0,20,20
1714213520305,MCWP 50R,E00,518795,Staff,0,1,20,20
1714213520305,MCWP 50R,F00,518796,Staff,0,0,20,20
1714213520305,MCWP 50R,G00,518797,Staff,0,1,20,20
1714213521331,MMW 12R,A01,514034,Herbst; Matthew,0,1,16,16
1714213521331,MMW 12R,A02,514035,Herbst; Matthew,2,0,16,14
1714213522356,MMW 13R,A01,514037,Staff,0,4,16,16
1714213522356,MMW 13R,A02,514039,Staff,0,2,16,16
1714213522356,MMW 13R,A03,628519,Staff,0,2,16,16
1714213524409,SIO 295LS,A00,523233,Staff,13,0,30,17
1714213525435,SIO 295S,A00,523232,Staff,13,0,30,17
1714213526460,SIOC 290S,A01,637330,Merrifield; Mark A,28,0,30,2
1714213527485,SIOC 291S,A01,637333,Gabriel; Corey John,28,0,30,2
1714213528511,SOCI 117,A01,494376,Staff,0,2,5,5
1714213529537,WES 237B,A00,494380,Staff,9,0,20,11
1714213531597,AESE 279B,A00,494370,Wade; Jon P,0,0,33,33
1714213532625,AIP 197,001,627712,Vespa; Emanuel Ignacio,9998,0,9999,1
1714213533650,ANAR 135S,A00,494369,Braswell; Geoffrey E.,0,0,0,0
1714213534674,BENG 196,001,628496,Engler; Adam J.,9998,0,9999,1
1714213535702,CAT 124RS,A01,519847,Geibel; William,0,0,20,20
1714213536730,CAT 125RS,A01,515971,Geibel; William,0,0,20,20
1714213537758,CLRE 250,A00,511389,Morris; Sheldon,9993,0,9999,6
1714213538783,CLRE 251,A00,507176,Mehta; Ravindra L.,9993,0,9999,6
1714213538783,CLRE 251,B00,511410,Mehta; Ravindra L.,9998,0,9999,1
1714213539809,CLRE 252,A00,507189,Cuomo; Raphael Eduardo,9995,0,9999,4
1714213540837,CLRE 253,A00,507199,Vaida; Florin,9994,0,9999,5
1714213540837,CLRE 253,B00,507202,Vaida; Florin,9999,0,9999,0
1714213541865,CLRE 259,A00,507211,Patel; Hemal,9996,0,9999,3
1714213542893,CLRE 260,A00,507221,Cuomo; Raphael Eduardo,9999,0,9999,0
1714213543920,CLRE 297,001,507242,Cuomo; Raphael Eduardo,9999,0,9999,0
1714213544945,COGS 197,001,638244,Voytek; Bradley Thomas,9999,0,9999,0
1714213545969,CSE 191,A00,516875,Minnes Kemp; Mor Mia,9993,0,9999,6
1714213546994,CSE 197,001,637388,Minnes Kemp; Mor Mia,9998,0,9999,1
1714213548023,CSS 201S,A01,494383,Staff,35,0,35,0
1714213549049,CSS 202S,A01,494387,Staff,35,0,35,0
1714213550077,DSC 197,001,628532,Eldridge; Justin Matthew,9996,0,9999,3
1714213551103,EAP 100,A00,516065,Staff,9797,0,9999,202
1714213552128,ECE 45,A01,507414,Staff,33,0,60,27
1714213554184,ECE 111,A01,507420,Staff,21,0,50,29
1714213555209,ECE 197,001,548057,Sievenpiper; Daniel F.,9994,0,9999,5
1714213556237,EDS 115,A00,507243,Choi; Bailey Miyeon,12,0,28,16
1714213557266,EDS 117,A01,494379,Staff,0,1,30,30
1714213558293,EDS 125,A00,507246,Hopkins; Megan Beth,12,0,30,18
1714213559320,EDS 128A,A01,507264,Fargason; Sharon Gayle,14,0,26,12
1714213560349,EDS 128B,A01,507293,Pappas; Elizabeth,18,0,30,12
1714213561377,EDS 139,A00,507294,Fargason; Sharon Gayle,18,0,30,12
1714213561377,EDS 139,B00,507313,Pappas; Elizabeth,15,0,30,15
1714213562402,EDS 201,A00,507315,Staff,13,0,30,17
1714213563428,EDS 203,A01,507317,Halter; Christopher P.,12,0,30,18
1714213564454,EDS 204R,A01,507319,Halter; Christopher P.,0,3,30,30
1714213564454,EDS 204R,B01,507331,Heinzman; Erica M.,17,0,30,13
1714213565481,EDS 206R,A00,507332,Staff,0,4,30,30
1714213565481,EDS 206R,B00,507343,Staff,18,0,30,12
1714213566509,EDS 250,A00,507344,Hemans; Patricia Ann Benitez,22,0,40,18
1714213567537,EDS 281,A00,507345,Daly; Alan J.,18,0,18,0
1714213568561,EDS 284,A00,507350,Daly; Alan J.,16,0,16,0
1714213569588,EDS 286,A00,507359,Fine; Sarah,18,0,18,0
1714213570617,EDS 289C,A01,507361,Daly; Alan J.,18,0,18,0
1714213571643,EDS 290,A00,507366,Hofstetter; Carolyn,15,0,15,0
1714213572669,LIGM 5A,A00,507421,Fischer-Grunski; Eva K,18,0,20,2
1714213573696,LIGM 5B,A00,507423,Fischer-Grunski; Eva K,19,0,20,1
1714213574726,LIGM 5C,A00,507425,Fischer-Grunski; Eva K,19,0,20,1
1714213575753,LIIT 5AS,A00,507427,Carnelos; Chiara,20,0,20,0
1714213576781,LIIT 5BS,A00,507430,Carnelos; Chiara,20,0,20,0
1714213577808,LIIT 5CS,A00,507432,Carnelos; Chiara,20,0,20,0
1714213578835,LISP 5A,A00,507541,Munoz Sanchez; Alicia,11,0,20,9
1714213579861,LISP 5B,A00,507671,Munoz Sanchez; Alicia,9,0,20,11
1714213580890,LISP 5C,A00,507696,Munoz Sanchez; Alicia,9,0,20,11
1714213581915,MAE 197,001,528363,Boechler; Nicholas Sebastia,9998,0,9999,1
1714213582944,MATH 197,001,523477,Kedlaya; Kiran S.,9996,0,9999,3
1714213582944,MATH 197,002,563811,Zhang; Danna,9995,0,9999,4
1714213582944,MATH 197,003,628552,Dumitriu; Ioana,9998,0,9999,1
1714213583969,MCWP 40R,A00,518780,Staff,5,0,20,15
1714213583969,MCWP 40R,B00,518781,Staff,7,0,20,13
1714213583969,MCWP 40R,C00,518783,Staff,5,0,20,15
1714213584997,MCWP 50R,A00,518791,Staff,0,0,20,20
1714213584997,MCWP 50R,B00,518792,Staff,0,1,20,20
1714213584997,MCWP 50R,C00,518793,Staff,0,1,20,20
1714213584997,MCWP 50R,D00,518794,Staff,0,0,20,20
1714213584997,MCWP 50R,E00,518795,Staff,0,1,20,20
1714213584997,MCWP 50R,F00,518796,Staff,0,0,20,20
1714213584997,MCWP 50R,G00,518797,Staff,0,1,20,20
1714213586023,MMW 12R,A01,514034,Herbst; Matthew,0,1,16,16
1714213586023,MMW 12R,A02,514035,Herbst; Matthew,2,0,16,14
1714213587048,MMW 13R,A01,514037,Staff,0,4,16,16
1714213587048,MMW 13R,A02,514039,Staff,0,2,16,16
1714213587048,MMW 13R,A03,628519,Staff,0,2,16,16
1714213589098,SIO 295LS,A00,523233,Staff,13,0,30,17
1714213590126,SIO 295S,A00,523232,Staff,13,0,30,17
1714213591153,SIOC 290S,A01,637330,Merrifield; Mark A,28,0,30,2
1714213592184,SIOC 291S,A01,637333,Gabriel; Corey John,28,0,30,2
1714213593212,SOCI 117,A01,494376,Staff,0,2,5,5
1714213594238,WES 237B,A00,494380,Staff,9,0,20,11
1714213596314,AESE 279B,A00,494370,Wade; Jon P,0,0,33,33
1714213597341,AIP 197,001,627712,Vespa; Emanuel Ignacio,9998,0,9999,1
1714213598367,ANAR 135S,A00,494369,Braswell; Geoffrey E.,0,0,0,0
1714213599391,BENG 196,001,628496,Engler; Adam J.,9998,0,9999,1
1714213600416,CAT 124RS,A01,519847,Geibel; William,0,0,20,20
1714213601443,CAT 125RS,A01,515971,Geibel; William,0,0,20,20
1714213602474,CLRE 250,A00,511389,Morris; Sheldon,9993,0,9999,6
1714213603507,CLRE 251,A00,507176,Mehta; Ravindra L.,9993,0,9999,6
1714213603507,CLRE 251,B00,511410,Mehta; Ravindra L.,9998,0,9999,1
1714213604586,CLRE 252,A00,507189,Cuomo; Raphael Eduardo,9995,0,9999,4
1714213605615,CLRE 253,A00,507199,Vaida; Florin,9994,0,9999,5
1714213605615,CLRE 253,B00,507202,Vaida; Florin,9999,0,9999,0
1714213606641,CLRE 259,A00,507211,Patel; Hemal,9996,0,9999,3
1714213607667,CLRE 260,A00,507221,Cuomo; Raphael Eduardo,9999,0,9999,0
1714213608692,CLRE 297,001,507242,Cuomo; Raphael Eduardo,9999,0,9999,0
1714213609721,COGS 197,001,638244,Voytek; Bradley Thomas,9999,0,9999,0
1714213610747,CSE 191,A00,516875,Minnes Kemp; Mor Mia,9993,0,9999,6
1714213611774,CSE 197,001,637388,Minnes Kemp; Mor Mia,9998,0,9999,1
1714213612803,CSS 201S,A01,494383,Staff,35,0,35,0
1714213613831,CSS 202S,A01,494387,Staff,35,0,35,0
1714213614856,DSC 197,001,628532,Eldridge; Justin Matthew,9996,0,9999,3
1714213615885,EAP 100,A00,516065,Staff,9797,0,9999,202
1714213616909,ECE 45,A01,507414,Staff,33,0,60,27
1714213618961,ECE 111,A01,507420,Staff,21,0,50,29
1714213619989,ECE 197,001,548057,Sievenpiper; Daniel F.,9994,0,9999,5
1714213621014,EDS 115,A00,507243,Choi; Bailey Miyeon,12,0,28,16
1714213622041,EDS 117,A01,494379,Staff,0,1,30,30
1714213623068,EDS 125,A00,507246,Hopkins; Megan Beth,12,0,30,18
1714213624093,EDS 128A,A01,507264,Fargason; Sharon Gayle,14,0,26,12
1714213625118,EDS 128B,A01,507293,Pappas; Elizabeth,18,0,30,12
1714213626145,EDS 139,A00,507294,Fargason; Sharon Gayle,18,0,30,12
1714213626145,EDS 139,B00,507313,Pappas; Elizabeth,15,0,30,15
1714213627174,EDS 201,A00,507315,Staff,13,0,30,17
1714213628210,EDS 203,A01,507317,Halter; Christopher P.,12,0,30,18
1714213629236,EDS 204R,A01,507319,Halter; Christopher P.,0,3,30,30
1714213629236,EDS 204R,B01,507331,Heinzman; Erica M.,17,0,30,13
1714213630266,EDS 206R,A00,507332,Staff,0,4,30,30
1714213630266,EDS 206R,B00,507343,Staff,18,0,30,12
1714213631293,EDS 250,A00,507344,Hemans; Patricia Ann Benitez,22,0,40,18
1714213632317,EDS 281,A00,507345,Daly; Alan J.,18,0,18,0
1714213633344,EDS 284,A00,507350,Daly; Alan J.,16,0,16,0
1714213634374,EDS 286,A00,507359,Fine; Sarah,18,0,18,0
1714213635400,EDS 289C,A01,507361,Daly; Alan J.,18,0,18,0
1714213636425,EDS 290,A00,507366,Hofstetter; Carolyn,15,0,15,0
1714213637453,LIGM 5A,A00,507421,Fischer-Grunski; Eva K,18,0,20,2
1714213638480,LIGM 5B,A00,507423,Fischer-Grunski; Eva K,19,0,20,1
1714213639506,LIGM 5C,A00,507425,Fischer-Grunski; Eva K,19,0,20,1
1714213640538,LIIT 5AS,A00,507427,Carnelos; Chiara,20,0,20,0
1714213641565,LIIT 5BS,A00,507430,Carnelos; Chiara,20,0,20,0
1714213642592,LIIT 5CS,A00,507432,Carnelos; Chiara,20,0,20,0
1714213643618,LISP 5A,A00,507541,Munoz Sanchez; Alicia,11,0,20,9
1714213644646,LISP 5B,A00,507671,Munoz Sanchez; Alicia,9,0,20,11
1714213645671,LISP 5C,A00,507696,Munoz Sanchez; Alicia,9,0,20,11
1714213646697,MAE 197,001,528363,Boechler; Nicholas Sebastia,9998,0,9999,1
1714213647726,MATH 197,001,523477,Kedlaya; Kiran S.,9996,0,9999,3
1714213647726,MATH 197,002,563811,Zhang; Danna,9995,0,9999,4
1714213647726,MATH 197,003,628552,Dumitriu; Ioana,9998,0,9999,1
1714213648755,MCWP 40R,A00,518780,Staff,5,0,20,15
1714213648755,MCWP 40R,B00,518781,Staff,7,0,20,13
1714213648755,MCWP 40R,C00,518783,Staff,5,0,20,15
1714213649785,MCWP 50R,A00,518791,Staff,0,0,20,20
1714213649785,MCWP 50R,B00,518792,Staff,0,1,20,20
1714213649785,MCWP 50R,C00,518793,Staff,0,1,20,20
1714213649785,MCWP 50R,D00,518794,Staff,0,0,20,20
1714213649785,MCWP 50R,E00,518795,Staff,0,1,20,20
1714213649785,MCWP 50R,F00,518796,Staff,0,0,20,20
1714213649785,MCWP 50R,G00,518797,Staff,0,1,20,20
1714213650814,MMW 12R,A01,514034,Herbst; Matthew,0,1,16,16
1714213650814,MMW 12R,A02,514035,Herbst; Matthew,2,0,16,14
1714213651842,MMW 13R,A01,514037,Staff,0,4,16,16
1714213651842,MMW 13R,A02,514039,Staff,0,2,16,16
1714213651842,MMW 13R,A03,628519,Staff,0,2,16,16
1714213653896,SIO 295LS,A00,523233,Staff,13,0,30,17
1714213654923,SIO 295S,A00,523232,Staff,13,0,30,17
1714213655948,SIOC 290S,A01,637330,Merrifield; Mark A,28,0,30,2
1714213656976,SIOC 291S,A01,637333,Gabriel; Corey John,28,0,30,2
1714213658000,SOCI 117,A01,494376,Staff,0,2,5,5
1714213659026,WES 237B,A00,494380,Staff,9,0,20,11
1714213661101,AESE 279B,A00,494370,Wade; Jon P,0,0,33,33
1714213662127,AIP 197,001,627712,Vespa; Emanuel Ignacio,9998,0,9999,1
1714213663153,ANAR 135S,A00,494369,Braswell; Geoffrey E.,0,0,0,0
1714213664181,BENG 196,001,628496,Engler; Adam J.,9998,0,9999,1
1714213665207,CAT 124RS,A01,519847,Geibel; William,0,0,20,20
1714213666237,CAT 125RS,A01,515971,Geibel; William,0,0,20,20
1714213667267,CLRE 250,A00,511389,Morris; Sheldon,9993,0,9999,6
1714213668295,CLRE 251,A00,507176,Mehta; Ravindra L.,9993,0,9999,6
1714213668295,CLRE 251,B00,511410,Mehta; Ravindra L.,9998,0,9999,1
1714213669324,CLRE 252,A00,507189,Cuomo; Raphael Eduardo,9995,0,9999,4
1714213670350,CLRE 253,A00,507199,Vaida; Florin,9994,0,9999,5
1714213670350,CLRE 253,B00,507202,Vaida; Florin,9999,0,9999,0
1714213671379,CLRE 259,A00,507211,Patel; Hemal,9996,0,9999,3
1714213672404,CLRE 260,A00,507221,Cuomo; Raphael Eduardo,9999,0,9999,0
1714213673429,CLRE 297,001,507242,Cuomo; Raphael Eduardo,9999,0,9999,0
1714213674455,COGS 197,001,638244,Voytek; Bradley Thomas,9999,0,9999,0
1714213675482,CSE 191,A00,516875,Minnes Kemp; Mor Mia,9993,0,9999,6
1714213676507,CSE 197,001,637388,Minnes Kemp; Mor Mia,9998,0,9999,1
1714213677533,CSS 201S,A01,494383,Staff,35,0,35,0
1714213678564,CSS 202S,A01,494387,Staff,35,0,35,0
1714213679590,DSC 197,001,628532,Eldridge; Justin Matthew,9996,0,9999,3
1714213680620,EAP 100,A00,516065,Staff,9797,0,9999,202
1714213681646,ECE 45,A01,507414,Staff,33,0,60,27
1714213683697,ECE 111,A01,507420,Staff,21,0,50,29
1714213684721,ECE 197,001,548057,Sievenpiper; Daniel F.,9994,0,9999,5
1714213685749,EDS 115,A00,507243,Choi; Bailey Miyeon,12,0,28,16
1714213686775,EDS 117,A01,494379,Staff,0,1,30,30
1714213687803,EDS 125,A00,507246,Hopkins; Megan Beth,12,0,30,18
1714213688830,EDS 128A,A01,507264,Fargason; Sharon Gayle,14,0,26,12
1714213689856,EDS 128B,A01,507293,Pappas; Elizabeth,18,0,30,12
1714213690882,EDS 139,A00,507294,Fargason; Sharon Gayle,18,0,30,12
1714213690882,EDS 139,B00,507313,Pappas; Elizabeth,15,0,30,15
1714213691911,EDS 201,A00,507315,Staff,13,0,30,17
1714213692938,EDS 203,A01,507317,Halter; Christopher P.,12,0,30,18
1714213693964,EDS 204R,A01,507319,Halter; Christopher P.,0,3,30,30
1714213693964,EDS 204R,B01,507331,Heinzman; Erica M.,17,0,30,13
1714213694992,EDS 206R,A00,507332,Staff,0,4,30,30
1714213694992,EDS 206R,B00,507343,Staff,18,0,30,12
1714213696019,EDS 250,A00,507344,Hemans; Patricia Ann Benitez,22,0,40,18
1714213697044,EDS 281,A00,507345,Daly; Alan J.,18,0,18,0
1714213698072,EDS 284,A00,507350,Daly; Alan J.,16,0,16,0
1714213699101,EDS 286,A00,507359,Fine; Sarah,18,0,18,0
1714213700126,EDS 289C,A01,507361,Daly; Alan J.,18,0,18,0
1714213701151,EDS 290,A00,507366,Hofstetter; Carolyn,15,0,15,0
1714213702180,LIGM 5A,A00,507421,Fischer-Grunski; Eva K,18,0,20,2
1714213703206,LIGM 5B,A00,507423,Fischer-Grunski; Eva K,19,0,20,1
1714213704234,LIGM 5C,A00,507425,Fischer-Grunski; Eva K,19,0,20,1
1714213705263,LIIT 5AS,A00,507427,Carnelos; Chiara,20,0,20,0
1714213706288,LIIT 5BS,A00,507430,Carnelos; Chiara,20,0,20,0
1714213707317,LIIT 5CS,A00,507432,Carnelos; Chiara,20,0,20,0
1714213708398,LISP 5A,A00,507541,Munoz Sanchez; Alicia,11,0,20,9
1714213709423,LISP 5B,A00,507671,Munoz Sanchez; Alicia,9,0,20,11
1714213710450,LISP 5C,A00,507696,Munoz Sanchez; Alicia,9,0,20,11
1714213711475,MAE 197,001,528363,Boechler; Nicholas Sebastia,9998,0,9999,1
1714213712500,MATH 197,001,523477,Kedlaya; Kiran S.,9996,0,9999,3
1714213712500,MATH 197,002,563811,Zhang; Danna,9995,0,9999,4
1714213712500,MATH 197,003,628552,Dumitriu; Ioana,9998,0,9999,1
1714213713526,MCWP 40R,A00,518780,Staff,5,0,20,15
1714213713526,MCWP 40R,B00,518781,Staff,7,0,20,13
1714213713526,MCWP 40R,C00,518783,Staff,5,0,20,15
1714213714551,MCWP 50R,A00,518791,Staff,0,0,20,20
1714213714551,MCWP 50R,B00,518792,Staff,0,1,20,20
1714213714551,MCWP 50R,C00,518793,Staff,0,1,20,20
1714213714551,MCWP 50R,D00,518794,Staff,0,0,20,20
1714213714551,MCWP 50R,E00,518795,Staff,0,1,20,20
1714213714551,MCWP 50R,F00,518796,Staff,0,0,20,20
1714213714551,MCWP 50R,G00,518797,Staff,0,1,20,20
1714213715580,MMW 12R,A01,514034,Herbst; Matthew,0,1,16,16
1714213715580,MMW 12R,A02,514035,Herbst; Matthew,2,0,16,14
1714213716608,MMW 13R,A01,514037,Staff,0,4,16,16
1714213716608,MMW 13R,A02,514039,Staff,0,2,16,16
1714213716608,MMW 13R,A03,628519,Staff,0,2,16,16
1714213718658,SIO 295LS,A00,523233,Staff,13,0,30,17
1714213719684,SIO 295S,A00,523232,Staff,13,0,30,17
1714213720709,SIOC 290S,A01,637330,Merrifield; Mark A,28,0,30,2
1714213721738,SIOC 291S,A01,637333,Gabriel; Corey John,28,0,30,2
1714213722763,SOCI 117,A01,494376,Staff,0,2,5,5
1714213723787,WES 237B,A00,494380,Staff,9,0,20,11
1714213725847,AESE 279B,A00,494370,Wade; Jon P,0,0,33,33
1714213726875,AIP 197,001,627712,Vespa; Emanuel Ignacio,9998,0,9999,1
1714213727898,ANAR 135S,A00,494369,Braswell; Geoffrey E.,0,0,0,0
1714213728922,BENG 196,001,628496,Engler; Adam J.,9998,0,9999,1
1714213729946,CAT 124RS,A01,519847,Geibel; William,0,0,20,20
1714213730970,CAT 125RS,A01,515971,Geibel; William,0,0,20,20
1714213731993,CLRE 250,A00,511389,Morris; Sheldon,9993,0,9999,6
1714213733021,CLRE 251,A00,507176,Mehta; Ravindra L.,9993,0,9999,6
1714213733021,CLRE 251,B00,511410,Mehta; Ravindra L.,9998,0,9999,1
1714213734047,CLRE 252,A00,507189,Cuomo; Raphael Eduardo,9995,0,9999,4
1714213735073,CLRE 253,A00,507199,Vaida; Florin,9994,0,9999,5
1714213735073,CLRE 253,B00,507202,Vaida; Florin,9999,0,9999,0
1714213736102,CLRE 259,A00,507211,Patel; Hemal,9996,0,9999,3
1714213737127,CLRE 260,A00,507221,Cuomo; Raphael Eduardo,9999,0,9999,0
1714213738155,CLRE 297,001,507242,Cuomo; Raphael Eduardo,9999,0,9999,0
1714213739181,COGS 197,001,638244,Voytek; Bradley Thomas,9999,0,9999,0
1714213740230,CSE 191,A00,516875,Minnes Kemp; Mor Mia,9993,0,9999,6
1714213741255,CSE 197,001,637388,Minnes Kemp; Mor Mia,9998,0,9999,1
1714213742281,CSS 201S,A01,494383,Staff,35,0,35,0
1714213743307,CSS 202S,A01,494387,Staff,35,0,35,0
1714213744331,DSC 197,001,628532,Eldridge; Justin Matthew,9996,0,9999,3
1714213745356,EAP 100,A00,516065,Staff,9797,0,9999,202
1714213746384,ECE 45,A01,507414,Staff,33,0,60,27
1714213748436,ECE 111,A01,507420,Staff,21,0,50,29
1714213749464,ECE 197,001,548057,Sievenpiper; Daniel F.,9994,0,9999,5
1714213750495,EDS 115,A00,507243,Choi; Bailey Miyeon,12,0,28,16
1714213751521,EDS 117,A01,494379,Staff,0,1,30,30
1714213752547,EDS 125,A00,507246,Hopkins; Megan Beth,12,0,30,18
1714213753574,EDS 128A,A01,507264,Fargason; Sharon Gayle,14,0,26,12
1714213754605,EDS 128B,A01,507293,Pappas; Elizabeth,18,0,30,12
1714213755631,EDS 139,A00,507294,Fargason; Sharon Gayle,18,0,30,12
1714213755631,EDS 139,B00,507313,Pappas; Elizabeth,15,0,30,15
1714213756658,EDS 201,A00,507315,Staff,13,0,30,17
1714213757686,EDS 203,A01,507317,Halter; Christopher P.,12,0,30,18
1714213758712,EDS 204R,A01,507319,Halter; Christopher P.,0,3,30,30
1714213758712,EDS 204R,B01,507331,Heinzman; Erica M.,17,0,30,13
1714213759738,EDS 206R,A00,507332,Staff,0,4,30,30
1714213759738,EDS 206R,B00,507343,Staff,18,0,30,12
1714213760764,EDS 250,A00,507344,Hemans; Patricia Ann Benitez,22,0,40,18
1714213761789,EDS 281,A00,507345,Daly; Alan J.,18,0,18,0
1714213762817,EDS 284,A00,507350,Daly; Alan J.,16,0,16,0
1714213763845,EDS 286,A00,507359,Fine; Sarah,18,0,18,0
1714213764870,EDS 289C,A01,507361,Daly; Alan J.,18,0,18,0
1714213765899,EDS 290,A00,507366,Hofstetter; Carolyn,15,0,15,0
1714213766925,LIGM 5A,A00,507421,Fischer-Grunski; Eva K,18,0,20,2
1714213767956,LIGM 5B,A00,507423,Fischer-Grunski; Eva K,19,0,20,1
1714213768982,LIGM 5C,A00,507425,Fischer-Grunski; Eva K,19,0,20,1
1714213770010,LIIT 5AS,A00,507427,Carnelos; Chiara,20,0,20,0
1714213771036,LIIT 5BS,A00,507430,Carnelos; Chiara,20,0,20,0
1714213772065,LIIT 5CS,A00,507432,Carnelos; Chiara,20,0,20,0
1714213773093,LISP 5A,A00,507541,Munoz Sanchez; Alicia,11,0,20,9
1714213774122,LISP 5B,A00,507671,Munoz Sanchez; Alicia,9,0,20,11
1714213775150,LISP 5C,A00,507696,Munoz Sanchez; Alicia,9,0,20,11
1714213776182,MAE 197,001,528363,Boechler; Nicholas Sebastia,9998,0,9999,1
1714213777211,MATH 197,001,523477,Kedlaya; Kiran S.,9996,0,9999,3
1714213777211,MATH 197,002,563811,Zhang; Danna,9995,0,9999,4
1714213777211,MATH 197,003,628552,Dumitriu; Ioana,9998,0,9999,1
1714213778237,MCWP 40R,A00,518780,Staff,5,0,20,15
1714213778237,MCWP 40R,B00,518781,Staff,7,0,20,13
1714213778237,MCWP 40R,C00,518783,Staff,5,0,20,15
1714213779267,MCWP 50R,A00,518791,Staff,0,0,20,20
1714213779267,MCWP 50R,B00,518792,Staff,0,1,20,20
1714213779267,MCWP 50R,C00,518793,Staff,0,1,20,20
1714213779267,MCWP 50R,D00,518794,Staff,0,0,20,20
1714213779267,MCWP 50R,E00,518795,Staff,0,1,20,20
1714213779267,MCWP 50R,F00,518796,Staff,0,0,20,20
1714213779267,MCWP 50R,G00,518797,Staff,0,1,20,20
1714213780297,MMW 12R,A01,514034,Herbst; Matthew,0,1,16,16
1714213780297,MMW 12R,A02,514035,Herbst; Matthew,2,0,16,14
1714213781323,MMW 13R,A01,514037,Staff,0,4,16,16
1714213781323,MMW 13R,A02,514039,Staff,0,2,16,16
1714213781323,MMW 13R,A03,628519,Staff,0,2,16,16
1714213783380,SIO 295LS,A00,523233,Staff,13,0,30,17
1714213784406,SIO 295S,A00,523232,Staff,13,0,30,17
1714213785434,SIOC 290S,A01,637330,Merrifield; Mark A,28,0,30,2
1714213786465,SIOC 291S,A01,637333,Gabriel; Corey John,28,0,30,2
1714213787491,SOCI 117,A01,494376,Staff,0,2,5,5
1714213788522,WES 237B,A00,494380,Staff,9,0,20,11
1714213790598,AESE 279B,A00,494370,Wade; Jon P,0,0,33,33
1714213791626,AIP 197,001,627712,Vespa; Emanuel Ignacio,9998,0,9999,1
1714213792652,ANAR 135S,A00,494369,Braswell; Geoffrey E.,0,0,0,0
1714213793676,BENG 196,001,628496,Engler; Adam J.,9998,0,9999,1
1714213794707,CAT 124RS,A01,519847,Geibel; William,0,0,20,20
1714213795736,CAT 125RS,A01,515971,Geibel; William,0,0,20,20
1714213796764,CLRE 250,A00,511389,Morris; Sheldon,9993,0,9999,6
1714213797793,CLRE 251,A00,507176,Mehta; Ravindra L.,9993,0,9999,6
1714213797793,CLRE 251,B00,511410,Mehta; Ravindra L.,9998,0,9999,1
1714213798820,CLRE 252,A00,507189,Cuomo; Raphael Eduardo,9995,0,9999,4
1714213799846,CLRE 253,A00,507199,Vaida; Florin,9994,0,9999,5
1714213799846,CLRE 253,B00,507202,Vaida; Florin,9999,0,9999,0
1714213800871,CLRE 259,A00,507211,Patel; Hemal,9996,0,9999,3
1714213801901,CLRE 260,A00,507221,Cuomo; Raphael Eduardo,9999,0,9999,0
1714213802925,CLRE 297,001,507242,Cuomo; Raphael Eduardo,9999,0,9999,0
1714213803954,COGS 197,001,638244,Voytek; Bradley Thomas,9999,0,9999,0
1714213804978,CSE 191,A00,516875,Minnes Kemp; Mor Mia,9993,0,9999,6
1714213806005,CSE 197,001,637388,Minnes Kemp; Mor Mia,9998,0,9999,1
1714213807031,CSS 201S,A01,494383,Staff,35,0,35,0
1714213808058,CSS 202S,A01,494387,Staff,35,0,35,0
1714213809084,DSC 197,001,628532,Eldridge; Justin Matthew,9996,0,9999,3
1714213810110,EAP 100,A00,516065,Staff,9797,0,9999,202
1714213811136,ECE 45,A01,507414,Staff,33,0,60,27
1714213813243,ECE 111,A01,507420,Staff,21,0,50,29
1714213814269,ECE 197,001,548057,Sievenpiper; Daniel F.,9994,0,9999,5
1714213815295,EDS 115,A00,507243,Choi; Bailey Miyeon,12,0,28,16
1714213816321,EDS 117,A01,494379,Staff,0,1,30,30
1714213817346,EDS 125,A00,507246,Hopkins; Megan Beth,12,0,30,18
1714213818374,EDS 128A,A01,507264,Fargason; Sharon Gayle,14,0,26,12
1714213819400,EDS 128B,A01,507293,Pappas; Elizabeth,18,0,30,12
1714213820426,EDS 139,A00,507294,Fargason; Sharon Gayle,18,0,30,12
1714213820426,EDS 139,B00,507313,Pappas; Elizabeth,15,0,30,15
1714213821450,EDS 201,A00,507315,Staff,13,0,30,17
1714213822474,EDS 203,A01,507317,Halter; Christopher P.,12,0,30,18
1714213823498,EDS 204R,A01,507319,Halter; Christopher P.,0,3,30,30
1714213823498,EDS 204R,B01,507331,Heinzman; Erica M.,17,0,30,13
1714213824524,EDS 206R,A00,507332,Staff,0,4,30,30
1714213824524,EDS 206R,B00,507343,Staff,18,0,30,12
1714213825551,EDS 250,A00,507344,Hemans; Patricia Ann Benitez,22,0,40,18
1714213826579,EDS 281,A00,507345,Daly; Alan J.,18,0,18,0
1714213827604,EDS 284,A00,507350,Daly; Alan J.,16,0,16,0
1714213828629,EDS 286,A00,507359,Fine; Sarah,18,0,18,0
1714213829654,EDS 289C,A01,507361,Daly; Alan J.,18,0,18,0
1714213830679,EDS 290,A00,507366,Hofstetter; Carolyn,15,0,15,0
1714213831705,LIGM 5A,A00,507421,Fischer-Grunski; Eva K,18,0,20,2
1714213832730,LIGM 5B,A00,507423,Fischer-Grunski; Eva K,19,0,20,1
1714213833757,LIGM 5C,A00,507425,Fischer-Grunski; Eva K,19,0,20,1
1714213834785,LIIT 5AS,A00,507427,Carnelos; Chiara,20,0,20,0
1714213835812,LIIT 5BS,A00,507430,Carnelos; Chiara,20,0,20,0
1714213836838,LIIT 5CS,A00,507432,Carnelos; Chiara,20,0,20,0
1714213837870,LISP 5A,A00,507541,Munoz Sanchez; Alicia,11,0,20,9
1714213838896,LISP 5B,A00,507671,Munoz Sanchez; Alicia,9,0,20,11
1714213839920,LISP 5C,A00,507696,Munoz Sanchez; Alicia,9,0,20,11
1714213840946,MAE 197,001,528363,Boechler; Nicholas Sebastia,9998,0,9999,1
1714213841972,MATH 197,001,523477,Kedlaya; Kiran S.,9996,0,9999,3
1714213841972,MATH 197,002,563811,Zhang; Danna,9995,0,9999,4
1714213841972,MATH 197,003,628552,Dumitriu; Ioana,9998,0,9999,1
1714213842999,MCWP 40R,A00,518780,Staff,5,0,20,15
1714213842999,MCWP 40R,B00,518781,Staff,7,0,20,13
1714213842999,MCWP 40R,C00,518783,Staff,5,0,20,15
1714213844029,MCWP 50R,A00,518791,Staff,0,0,20,20
1714213844029,MCWP 50R,B00,518792,Staff,0,1,20,20
1714213844029,MCWP 50R,C00,518793,Staff,0,1,20,20
1714213844029,MCWP 50R,D00,518794,Staff,0,0,20,20
1714213844029,MCWP 50R,E00,518795,Staff,0,1,20,20
1714213844029,MCWP 50R,F00,518796,Staff,0,0,20,20
1714213844029,MCWP 50R,G00,518797,Staff,0,1,20,20
1714213845059,MMW 12R,A01,514034,Herbst; Matthew,0,1,16,16
1714213845059,MMW 12R,A02,514035,Herbst; Matthew,2,0,16,14
1714213846085,MMW 13R,A01,514037,Staff,0,4,16,16
1714213846085,MMW 13R,A02,514039,Staff,0,2,16,16
1714213846085,MMW 13R,A03,628519,Staff,0,2,16,16
1714213848141,SIO 295LS,A00,523233,Staff,13,0,30,17
1714213849168,SIO 295S,A00,523232,Staff,13,0,30,17
1714213850194,SIOC 290S,A01,637330,Merrifield; Mark A,28,0,30,2
1714213851221,SIOC 291S,A01,637333,Gabriel; Corey John,28,0,30,2
1714213852249,SOCI 117,A01,494376,Staff,0,2,5,5
1714213853275,WES 237B,A00,494380,Staff,9,0,20,11
1714213855361,AESE 279B,A00,494370,Wade; Jon P,0,0,33,33
1714213856392,AIP 197,001,627712,Vespa; Emanuel Ignacio,9998,0,9999,1
1714213857417,ANAR 135S,A00,494369,Braswell; Geoffrey E.,0,0,0,0
1714213858448,BENG 196,001,628496,Engler; Adam J.,9998,0,9999,1
1714213859477,CAT 124RS,A01,519847,Geibel; William,0,0,20,20
1714213860502,CAT 125RS,A01,515971,Geibel; William,0,0,20,20
1714213861533,CLRE 250,A00,511389,Morris; Sheldon,9993,0,9999,6
1714213862558,CLRE 251,A00,507176,Mehta; Ravindra L.,9993,0,9999,6
1714213862558,CLRE 251,B00,511410,Mehta; Ravindra L.,9998,0,9999,1
1714213863587,CLRE 252,A00,507189,Cuomo; Raphael Eduardo,9995,0,9999,4
1714213864615,CLRE 253,A00,507199,Vaida; Florin,9994,0,9999,5
1714213864615,CLRE 253,B00,507202,Vaida; Florin,9999,0,9999,0
1714213865640,CLRE 259,A00,507211,Patel; Hemal,9996,0,9999,3
1714213866665,CLRE 260,A00,507221,Cuomo; Raphael Eduardo,9999,0,9999,0
1714213867688,CLRE 297,001,507242,Cuomo; Raphael Eduardo,9999,0,9999,0
1714213868713,COGS 197,001,638244,Voytek; Bradley Thomas,9999,0,9999,0
1714213869739,CSE 191,A00,516875,Minnes Kemp; Mor Mia,9993,0,9999,6
1714213870767,CSE 197,001,637388,Minnes Kemp; Mor Mia,9998,0,9999,1
1714213871793,CSS 201S,A01,494383,Staff,35,0,35,0
1714213872818,CSS 202S,A01,494387,Staff,35,0,35,0
1714213873842,DSC 197,001,628532,Eldridge; Justin Matthew,9996,0,9999,3
1714213874866,EAP 100,A00,516065,Staff,9797,0,9999,202
1714213875892,ECE 45,A01,507414,Staff,33,0,60,27
1714213877948,ECE 111,A01,507420,Staff,21,0,50,29
1714213878974,ECE 197,001,548057,Sievenpiper; Daniel F.,9994,0,9999,5
1714213880001,EDS 115,A00,507243,Choi; Bailey Miyeon,12,0,28,16
1714213881027,EDS 117,A01,494379,Staff,0,1,30,30
1714213882054,EDS 125,A00,507246,Hopkins; Megan Beth,12,0,30,18
1714213883081,EDS 128A,A01,507264,Fargason; Sharon Gayle,14,0,26,12
1714213884109,EDS 128B,A01,507293,Pappas; Elizabeth,18,0,30,12
1714213885134,EDS 139,A00,507294,Fargason; Sharon Gayle,18,0,30,12
1714213885134,EDS 139,B00,507313,Pappas; Elizabeth,15,0,30,15
1714213886162,EDS 201,A00,507315,Staff,13,0,30,17
1714213887186,EDS 203,A01,507317,Halter; Christopher P.,12,0,30,18
1714213888216,EDS 204R,A01,507319,Halter; Christopher P.,0,3,30,30
1714213888216,EDS 204R,B01,507331,Heinzman; Erica M.,17,0,30,13
1714213889240,EDS 206R,A00,507332,Staff,0,4,30,30
1714213889240,EDS 206R,B00,507343,Staff,18,0,30,12
1714213890269,EDS 250,A00,507344,Hemans; Patricia Ann Benitez,22,0,40,18
1714213891298,EDS 281,A00,507345,Daly; Alan J.,18,0,18,0
1714213892322,EDS 284,A00,507350,Daly; Alan J.,16,0,16,0
1714213893353,EDS 286,A00,507359,Fine; Sarah,18,0,18,0
1714213894380,EDS 289C,A01,507361,Daly; Alan J.,18,0,18,0
1714213895409,EDS 290,A00,507366,Hofstetter; Carolyn,15,0,15,0
1714213896441,LIGM 5A,A00,507421,Fischer-Grunski; Eva K,18,0,20,2
1714213897466,LIGM 5B,A00,507423,Fischer-Grunski; Eva K,19,0,20,1
1714213898492,LIGM 5C,A00,507425,Fischer-Grunski; Eva K,19,0,20,1
1714213899522,LIIT 5AS,A00,507427,Carnelos; Chiara,20,0,20,0
1714213900547,LIIT 5BS,A00,507430,Carnelos; Chiara,20,0,20,0
1714213901574,LIIT 5CS,A00,507432,Carnelos; Chiara,20,0,20,0
1714213902599,LISP 5A,A00,507541,Munoz Sanchez; Alicia,11,0,20,9
1714213903625,LISP 5B,A00,507671,Munoz Sanchez; Alicia,9,0,20,11
1714213904650,LISP 5C,A00,507696,Munoz Sanchez; Alicia,9,0,20,11
1714213905675,MAE 197,001,528363,Boechler; Nicholas Sebastia,9998,0,9999,1
1714213906702,MATH 197,001,523477,Kedlaya; Kiran S.,9996,0,9999,3
1714213906702,MATH 197,002,563811,Zhang; Danna,9995,0,9999,4
1714213906702,MATH 197,003,628552,Dumitriu; Ioana,9998,0,9999,1
1714213907730,MCWP 40R,A00,518780,Staff,5,0,20,15
1714213907730,MCWP 40R,B00,518781,Staff,7,0,20,13
1714213907730,MCWP 40R,C00,518783,Staff,5,0,20,15
1714213908758,MCWP 50R,A00,518791,Staff,0,0,20,20
1714213908758,MCWP 50R,B00,518792,Staff,0,1,20,20
1714213908758,MCWP 50R,C00,518793,Staff,0,1,20,20
1714213908758,MCWP 50R,D00,518794,Staff,0,0,20,20
1714213908758,MCWP 50R,E00,518795,Staff,0,1,20,20
1714213908758,MCWP 50R,F00,518796,Staff,0,0,20,20
1714213908758,MCWP 50R,G00,518797,Staff,0,1,20,20
1714213909787,MMW 12R,A01,514034,Herbst; Matthew,0,1,16,16
1714213909787,MMW 12R,A02,514035,Herbst; Matthew,2,0,16,14
1714213910811,MMW 13R,A01,514037,Staff,0,4,16,16
1714213910811,MMW 13R,A02,514039,Staff,0,2,16,16
1714213910811,MMW 13R,A03,628519,Staff,0,2,16,16
1714213912864,SIO 295LS,A00,523233,Staff,13,0,30,17
1714213913900,SIO 295S,A00,523232,Staff,13,0,30,17
1714213914926,SIOC 290S,A01,637330,Merrifield; Mark A,28,0,30,2
1714213916024,SIOC 291S,A01,637333,Gabriel; Corey John,28,0,30,2
1714213917050,SOCI 117,A01,494376,Staff,0,2,5,5
1714213918077,WES 237B,A00,494380,Staff,9,0,20,11
1714213920136,AESE 279B,A00,494370,Wade; Jon P,0,0,33,33
1714213921162,AIP 197,001,627712,Vespa; Emanuel Ignacio,9998,0,9999,1
1714213922191,ANAR 135S,A00,494369,Braswell; Geoffrey E.,0,0,0,0
1714213923217,BENG 196,001,628496,Engler; Adam J.,9998,0,9999,1
1714213924242,CAT 124RS,A01,519847,Geibel; William,0,0,20,20
1714213925267,CAT 125RS,A01,515971,Geibel; William,0,0,20,20
1714213926290,CLRE 250,A00,511389,Morris; Sheldon,9993,0,9999,6
1714213927316,CLRE 251,A00,507176,Mehta; Ravindra L.,9993,0,9999,6
1714213927316,CLRE 251,B00,511410,Mehta; Ravindra L.,9998,0,9999,1
1714213928343,CLRE 252,A00,507189,Cuomo; Raphael Eduardo,9995,0,9999,4
1714213929368,CLRE 253,A00,507199,Vaida; Florin,9994,0,9999,5
1714213929368,CLRE 253,B00,507202,Vaida; Florin,9999,0,9999,0
1714213930396,CLRE 259,A00,507211,Patel; Hemal,9996,0,9999,3
1714213931423,CLRE 260,A00,507221,Cuomo; Raphael Eduardo,9999,0,9999,0
1714213932448,CLRE 297,001,507242,Cuomo; Raphael Eduardo,9999,0,9999,0
1714213933476,COGS 197,001,638244,Voytek; Bradley Thomas,9999,0,9999,0
1714213934502,CSE 191,A00,516875,Minnes Kemp; Mor Mia,9993,0,9999,6
1714213935527,CSE 197,001,637388,Minnes Kemp; Mor Mia,9998,0,9999,1
1714213936555,CSS 201S,A01,494383,Staff,35,0,35,0
1714213937580,CSS 202S,A01,494387,Staff,35,0,35,0
1714213938605,DSC 197,001,628532,Eldridge; Justin Matthew,9996,0,9999,3
1714213939630,EAP 100,A00,516065,Staff,9797,0,9999,202
1714213940658,ECE 45,A01,507414,Staff,33,0,60,27
1714213942710,ECE 111,A01,507420,Staff,21,0,50,29
1714213943737,ECE 197,001,548057,Sievenpiper; Daniel F.,9994,0,9999,5
1714213944762,EDS 115,A00,507243,Choi; Bailey Miyeon,12,0,28,16
1714213945791,EDS 117,A01,494379,Staff,0,1,30,30
1714213946815,EDS 125,A00,507246,Hopkins; Megan Beth,12,0,30,18
1714213947842,EDS 128A,A01,507264,Fargason; Sharon Gayle,14,0,26,12
1714213948871,EDS 128B,A01,507293,Pappas; Elizabeth,18,0,30,12
1714213949898,EDS 139,A00,507294,Fargason; Sharon Gayle,18,0,30,12
1714213949898,EDS 139,B00,507313,Pappas; Elizabeth,15,0,30,15
1714213950926,EDS 201,A00,507315,Staff,13,0,30,17
1714213951952,EDS 203,A01,507317,Halter; Christopher P.,12,0,30,18
1714213952977,EDS 204R,A01,507319,Halter; Christopher P.,0,3,30,30
1714213952977,EDS 204R,B01,507331,Heinzman; Erica M.,17,0,30,13
1714213954005,EDS 206R,A00,507332,Staff,0,4,30,30
1714213954005,EDS 206R,B00,507343,Staff,18,0,30,12
1714213955030,EDS 250,A00,507344,Hemans; Patricia Ann Benitez,22,0,40,18
1714213956057,EDS 281,A00,507345,Daly; Alan J.,18,0,18,0
1714213957084,EDS 284,A00,507350,Daly; Alan J.,16,0,16,0
1714213958109,EDS 286,A00,507359,Fine; Sarah,18,0,18,0
1714213959133,EDS 289C,A01,507361,Daly; Alan J.,18,0,18,0
1714213960158,EDS 290,A00,507366,Hofstetter; Carolyn,15,0,15,0
1714213961186,LIGM 5A,A00,507421,Fischer-Grunski; Eva K,18,0,20,2
1714213962216,LIGM 5B,A00,507423,Fischer-Grunski; Eva K,19,0,20,1
1714213963242,LIGM 5C,A00,507425,Fischer-Grunski; Eva K,19,0,20,1
1714213964272,LIIT 5AS,A00,507427,Carnelos; Chiara,20,0,20,0
1714213965297,LIIT 5BS,A00,507430,Carnelos; Chiara,20,0,20,0
1714213966326,LIIT 5CS,A00,507432,Carnelos; Chiara,20,0,20,0
1714213967350,LISP 5A,A00,507541,Munoz Sanchez; Alicia,11,0,20,9
1714213968382,LISP 5B,A00,507671,Munoz Sanchez; Alicia,9,0,20,11
1714213969410,LISP 5C,A00,507696,Munoz Sanchez; Alicia,9,0,20,11
1714213970436,MAE 197,001,528363,Boechler; Nicholas Sebastia,9998,0,9999,1
1714213971463,MATH 197,001,523477,Kedlaya; Kiran S.,9996,0,9999,3
1714213971463,MATH 197,002,563811,Zhang; Danna,9995,0,9999,4
1714213971463,MATH 197,003,628552,Dumitriu; Ioana,9998,0,9999,1
1714213972494,MCWP 40R,A00,518780,Staff,5,0,20,15
1714213972494,MCWP 40R,B00,518781,Staff,7,0,20,13
1714213972494,MCWP 40R,C00,518783,Staff,5,0,20,15
1714213973524,MCWP 50R,A00,518791,Staff,0,0,20,20
1714213973524,MCWP 50R,B00,518792,Staff,0,1,20,20
1714213973524,MCWP 50R,C00,518793,Staff,0,1,20,20
1714213973524,MCWP 50R,D00,518794,Staff,0,0,20,20
1714213973524,MCWP 50R,E00,518795,Staff,0,1,20,20
1714213973524,MCWP 50R,F00,518796,Staff,0,0,20,20
1714213973524,MCWP 50R,G00,518797,Staff,0,1,20,20
1714213974553,MMW 12R,A01,514034,Herbst; Matthew,0,1,16,16
1714213974553,MMW 12R,A02,514035,Herbst; Matthew,2,0,16,14
1714213975579,MMW 13R,A01,514037,Staff,0,4,16,16
1714213975579,MMW 13R,A02,514039,Staff,0,2,16,16
1714213975579,MMW 13R,A03,628519,Staff,0,2,16,16
1714213977636,SIO 295LS,A00,523233,Staff,13,0,30,17
1714213978662,SIO 295S,A00,523232,Staff,13,0,30,17
1714213979689,SIOC 290S,A01,637330,Merrifield; Mark A,28,0,30,2
1714213980722,SIOC 291S,A01,637333,Gabriel; Corey John,28,0,30,2
1714213981748,SOCI 117,A01,494376,Staff,0,2,5,5
1714213982778,WES 237B,A00,494380,Staff,9,0,20,11
1714213984863,AESE 279B,A00,494370,Wade; Jon P,0,0,33,33
1714213985890,AIP 197,001,627712,Vespa; Emanuel Ignacio,9998,0,9999,1
1714213986916,ANAR 135S,A00,494369,Braswell; Geoffrey E.,0,0,0,0
1714213987941,BENG 196,001,628496,Engler; Adam J.,9998,0,9999,1
1714213988968,CAT 124RS,A01,519847,Geibel; William,0,0,20,20
1714213989997,CAT 125RS,A01,515971,Geibel; William,0,0,20,20
1714213991027,CLRE 250,A00,511389,Morris; Sheldon,9993,0,9999,6
1714213992061,CLRE 251,A00,507176,Mehta; Ravindra L.,9993,0,9999,6
1714213992061,CLRE 251,B00,511410,Mehta; Ravindra L.,9998,0,9999,1
1714213993085,CLRE 252,A00,507189,Cuomo; Raphael Eduardo,9995,0,9999,4
1714213994110,CLRE 253,A00,507199,Vaida; Florin,9994,0,9999,5
1714213994110,CLRE 253,B00,507202,Vaida; Florin,9999,0,9999,0
1714213995135,CLRE 259,A00,507211,Patel; Hemal,9996,0,9999,3
1714213996164,CLRE 260,A00,507221,Cuomo; Raphael Eduardo,9999,0,9999,0
1714213997188,CLRE 297,001,507242,Cuomo; Raphael Eduardo,9999,0,9999,0
1714213998218,COGS 197,001,638244,Voytek; Bradley Thomas,9999,0,9999,0
1714213999243,CSE 191,A00,516875,Minnes Kemp; Mor Mia,9993,0,9999,6
1714214000270,CSE 197,001,637388,Minnes Kemp; Mor Mia,9998,0,9999,1
1714214001298,CSS 201S,A01,494383,Staff,35,0,35,0
1714214002325,CSS 202S,A01,494387,Staff,35,0,35,0
1714214003351,DSC 197,001,628532,Eldridge; Justin Matthew,9996,0,9999,3
1714214004377,EAP 100,A00,516065,Staff,9797,0,9999,202
1714214005406,ECE 45,A01,507414,Staff,33,0,60,27
1714214007461,ECE 111,A01,507420,Staff,21,0,50,29
1714214008488,ECE 197,001,548057,Sievenpiper; Daniel F.,9994,0,9999,5
1714214009519,EDS 115,A00,507243,Choi; Bailey Miyeon,12,0,28,16
1714214010546,EDS 117,A01,494379,Staff,0,1,30,30
1714214011575,EDS 125,A00,507246,Hopkins; Megan Beth,12,0,30,18
1714214012604,EDS 128A,A01,507264,Fargason; Sharon Gayle,14,0,26,12
1714214013630,EDS 128B,A01,507293,Pappas; Elizabeth,18,0,30,12
1714214014656,EDS 139,A00,507294,Fargason; Sharon Gayle,18,0,30,12
1714214014656,EDS 139,B00,507313,Pappas; Elizabeth,15,0,30,15
1714214015681,EDS 201,A00,507315,Staff,13,0,30,17
1714214016711,EDS 203,A01,507317,Halter; Christopher P.,12,0,30,18
1714214017738,EDS 204R,A01,507319,Halter; Christopher P.,0,3,30,30
1714214017738,EDS 204R,B01,507331,Heinzman; Erica M.,17,0,30,13
1714214018764,EDS 206R,A00,507332,Staff,0,4,30,30
1714214018764,EDS 206R,B00,507343,Staff,18,0,30,12
1714214019845,EDS 250,A00,507344,Hemans; Patricia Ann Benitez,22,0,40,18
1714214020872,EDS 281,A00,507345,Daly; Alan J.,18,0,18,0
1714214021896,EDS 284,A00,507350,Daly; Alan J.,16,0,16,0
1714214022920,EDS 286,A00,507359,Fine; Sarah,18,0,18,0
1714214023947,EDS 289C,A01,507361,Daly; Alan J.,18,0,18,0
1714214024976,EDS 290,A00,507366,Hofstetter; Carolyn,15,0,15,0
1714214026000,LIGM 5A,A00,507421,Fischer-Grunski; Eva K,18,0,20,2
1714214027029,LIGM 5B,A00,507423,Fischer-Grunski; Eva K,19,0,20,1
1714214028053,LIGM 5C,A00,507425,Fischer-Grunski; Eva K,19,0,20,1
1714214029079,LIIT 5AS,A00,507427,Carnelos; Chiara,20,0,20,0
1714214030107,LIIT 5BS,A00,507430,Carnelos; Chiara,20,0,20,0
1714214031134,LIIT 5CS,A00,507432,Carnelos; Chiara,20,0,20,0
1714214032158,LISP 5A,A00,507541,Munoz Sanchez; Alicia,11,0,20,9
1714214033184,LISP 5B,A00,507671,Munoz Sanchez; Alicia,9,0,20,11
1714214034208,LISP 5C,A00,507696,Munoz Sanchez; Alicia,9,0,20,11
1714214035236,MAE 197,001,528363,Boechler; Nicholas Sebastia,9998,0,9999,1
1714214036261,MATH 197,001,523477,Kedlaya; Kiran S.,9996,0,9999,3
1714214036261,MATH 197,002,563811,Zhang; Danna,9995,0,9999,4
1714214036261,MATH 197,003,628552,Dumitriu; Ioana,9998,0,9999,1
1714214037286,MCWP 40R,A00,518780,Staff,5,0,20,15
1714214037286,MCWP 40R,B00,518781,Staff,7,0,20,13
1714214037286,MCWP 40R,C00,518783,Staff,5,0,20,15
1714214038313,MCWP 50R,A00,518791,Staff,0,0,20,20
1714214038313,MCWP 50R,B00,518792,Staff,0,1,20,20
1714214038313,MCWP 50R,C00,518793,Staff,0,1,20,20
1714214038313,MCWP 50R,D00,518794,Staff,0,0,20,20
1714214038313,MCWP 50R,E00,518795,Staff,0,1,20,20
1714214038313,MCWP 50R,F00,518796,Staff,0,0,20,20
1714214038313,MCWP 50R,G00,518797,Staff,0,1,20,20
1714214039337,MMW 12R,A01,514034,Herbst; Matthew,0,1,16,16
1714214039337,MMW 12R,A02,514035,Herbst; Matthew,2,0,16,14
1714214040364,MMW 13R,A01,514037,Staff,0,4,16,16
1714214040364,MMW 13R,A02,514039,Staff,0,2,16,16
1714214040364,MMW 13R,A03,628519,Staff,0,2,16,16
1714214042417,SIO 295LS,A00,523233,Staff,13,0,30,17
1714214043443,SIO 295S,A00,523232,Staff,13,0,30,17
1714214044470,SIOC 290S,A01,637330,Merrifield; Mark A,28,0,30,2
1714214045494,SIOC 291S,A01,637333,Gabriel; Corey John,28,0,30,2
1714214046519,SOCI 117,A01,494376,Staff,0,2,5,5
1714214047546,WES 237B,A00,494380,Staff,9,0,20,11
1714214049622,AESE 279B,A00,494370,Wade; Jon P,0,0,33,33
1714214050649,AIP 197,001,627712,Vespa; Emanuel Ignacio,9998,0,9999,1
1714214051678,ANAR 135S,A00,494369,Braswell; Geoffrey E.,0,0,0,0
1714214052706,BENG 196,001,628496,Engler; Adam J.,9998,0,9999,1
1714214053736,CAT 124RS,A01,519847,Geibel; William,0,0,20,20
1714214054763,CAT 125RS,A01,515971,Geibel; William,0,0,20,20
1714214055789,CLRE 250,A00,511389,Morris; Sheldon,9993,0,9999,6
1714214056818,CLRE 251,A00,507176,Mehta; Ravindra L.,9993,0,9999,6
1714214056818,CLRE 251,B00,511410,Mehta; Ravindra L.,9998,0,9999,1
1714214057849,CLRE 252,A00,507189,Cuomo; Raphael Eduardo,9995,0,9999,4
1714214058881,CLRE 253,A00,507199,Vaida; Florin,9994,0,9999,5
1714214058881,CLRE 253,B00,507202,Vaida; Florin,9999,0,9999,0
1714214059908,CLRE 259,A00,507211,Patel; Hemal,9996,0,9999,3
1714214060939,CLRE 260,A00,507221,Cuomo; Raphael Eduardo,9999,0,9999,0
1714214061966,CLRE 297,001,507242,Cuomo; Raphael Eduardo,9999,0,9999,0
1714214062992,COGS 197,001,638244,Voytek; Bradley Thomas,9999,0,9999,0
1714214064021,CSE 191,A00,516875,Minnes Kemp; Mor Mia,9993,0,9999,6
1714214065048,CSE 197,001,637388,Minnes Kemp; Mor Mia,9998,0,9999,1
1714214066076,CSS 201S,A01,494383,Staff,35,0,35,0
1714214067104,CSS 202S,A01,494387,Staff,35,0,35,0
1714214068131,DSC 197,001,628532,Eldridge; Justin Matthew,9996,0,9999,3
1714214069158,EAP 100,A00,516065,Staff,9797,0,9999,202
1714214070190,ECE 45,A01,507414,Staff,33,0,60,27
1714214072249,ECE 111,A01,507420,Staff,21,0,50,29
1714214073278,ECE 197,001,548057,Sievenpiper; Daniel F.,9994,0,9999,5
1714214074305,EDS 115,A00,507243,Choi; Bailey Miyeon,12,0,28,16
1714214075331,EDS 117,A01,494379,Staff,0,1,30,30
1714214076358,EDS 125,A00,507246,Hopkins; Megan Beth,12,0,30,18
1714214077389,EDS 128A,A01,507264,Fargason; Sharon Gayle,14,0,26,12
1714214078440,EDS 128B,A01,507293,Pappas; Elizabeth,18,0,30,12
1714214079470,EDS 139,A00,507294,Fargason; Sharon Gayle,18,0,30,12
1714214079470,EDS 139,B00,507313,Pappas; Elizabeth,15,0,30,15
1714214080495,EDS 201,A00,507315,Staff,13,0,30,17
1714214081525,EDS 203,A01,507317,Halter; Christopher P.,12,0,30,18
1714214082554,EDS 204R,A01,507319,Halter; Christopher P.,0,3,30,30
1714214082554,EDS 204R,B01,507331,Heinzman; Erica M.,17,0,30,13
1714214083579,EDS 206R,A00,507332,Staff,0,4,30,30
1714214083579,EDS 206R,B00,507343,Staff,18,0,30,12
1714214084606,EDS 250,A00,507344,Hemans; Patricia Ann Benitez,22,0,40,18
1714214085634,EDS 281,A00,507345,Daly; Alan J.,18,0,18,0
1714214086660,EDS 284,A00,507350,Daly; Alan J.,16,0,16,0
1714214087683,EDS 286,A00,507359,Fine; Sarah,18,0,18,0
1714214088710,EDS 289C,A01,507361,Daly; Alan J.,18,0,18,0
1714214089739,EDS 290,A00,507366,Hofstetter; Carolyn,15,0,15,0
1714214090766,LIGM 5A,A00,507421,Fischer-Grunski; Eva K,18,0,20,2
1714214091796,LIGM 5B,A00,507423,Fischer-Grunski; Eva K,19,0,20,1
1714214092825,LIGM 5C,A00,507425,Fischer-Grunski; Eva K,19,0,20,1
1714214093851,LIIT 5AS,A00,507427,Carnelos; Chiara,20,0,20,0
1714214094879,LIIT 5BS,A00,507430,Carnelos; Chiara,20,0,20,0
1714214095907,LIIT 5CS,A00,507432,Carnelos; Chiara,20,0,20,0
1714214096933,LISP 5A,A00,507541,Munoz Sanchez; Alicia,11,0,20,9
1714214097959,LISP 5B,A00,507671,Munoz Sanchez; Alicia,9,0,20,11
1714214098990,LISP 5C,A00,507696,Munoz Sanchez; Alicia,9,0,20,11
1714214100016,MAE 197,001,528363,Boechler; Nicholas Sebastia,9998,0,9999,1
1714214101048,MATH 197,001,523477,Kedlaya; Kiran S.,9996,0,9999,3
1714214101048,MATH 197,002,563811,Zhang; Danna,9995,0,9999,4
1714214101048,MATH 197,003,628552,Dumitriu; Ioana,9998,0,9999,1
1714214102076,MCWP 40R,A00,518780,Staff,5,0,20,15
1714214102076,MCWP 40R,B00,518781,Staff,7,0,20,13
1714214102076,MCWP 40R,C00,518783,Staff,5,0,20,15
1714214103103,MCWP 50R,A00,518791,Staff,0,0,20,20
1714214103103,MCWP 50R,B00,518792,Staff,0,1,20,20
1714214103103,MCWP 50R,C00,518793,Staff,0,1,20,20
1714214103103,MCWP 50R,D00,518794,Staff,0,0,20,20
1714214103103,MCWP 50R,E00,518795,Staff,0,1,20,20
1714214103103,MCWP 50R,F00,518796,Staff,0,0,20,20
1714214103103,MCWP 50R,G00,518797,Staff,0,1,20,20
1714214104132,MMW 12R,A01,514034,Herbst; Matthew,0,1,16,16
1714214104132,MMW 12R,A02,514035,Herbst; Matthew,2,0,16,14
1714214105162,MMW 13R,A01,514037,Staff,0,4,16,16
1714214105162,MMW 13R,A02,514039,Staff,0,2,16,16
1714214105162,MMW 13R,A03,628519,Staff,0,2,16,16
1714214107218,SIO 295LS,A00,523233,Staff,13,0,30,17
1714214108246,SIO 295S,A00,523232,Staff,13,0,30,17
1714214109270,SIOC 290S,A01,637330,Merrifield; Mark A,28,0,30,2
1714214110295,SIOC 291S,A01,637333,Gabriel; Corey John,28,0,30,2
1714214111321,SOCI 117,A01,494376,Staff,0,2,5,5
1714214112346,WES 237B,A00,494380,Staff,9,0,20,11
1714214114415,AESE 279B,A00,494370,Wade; Jon P,0,0,33,33
1714214115440,AIP 197,001,627712,Vespa; Emanuel Ignacio,9998,0,9999,1
1714214116468,ANAR 135S,A00,494369,Braswell; Geoffrey E.,0,0,0,0
1714214117495,BENG 196,001,628496,Engler; Adam J.,9998,0,9999,1
1714214118524,CAT 124RS,A01,519847,Geibel; William,0,0,20,20
1714214119550,CAT 125RS,A01,515971,Geibel; William,0,0,20,20
1714214120577,CLRE 250,A00,511389,Morris; Sheldon,9993,0,9999,6
1714214121608,CLRE 251,A00,507176,Mehta; Ravindra L.,9993,0,9999,6
1714214121608,CLRE 251,B00,511410,Mehta; Ravindra L.,9998,0,9999,1
1714214122633,CLRE 252,A00,507189,Cuomo; Raphael Eduardo,9995,0,9999,4
1714214123712,CLRE 253,A00,507199,Vaida; Florin,9994,0,9999,5
1714214123712,CLRE 253,B00,507202,Vaida; Florin,9999,0,9999,0
1714214124738,CLRE 259,A00,507211,Patel; Hemal,9996,0,9999,3
1714214125763,CLRE 260,A00,507221,Cuomo; Raphael Eduardo,9999,0,9999,0
1714214126790,CLRE 297,001,507242,Cuomo; Raphael Eduardo,9999,0,9999,0
1714214127814,COGS 197,001,638244,Voytek; Bradley Thomas,9999,0,9999,0
1714214128839,CSE 191,A00,516875,Minnes Kemp; Mor Mia,9993,0,9999,6
1714214129864,CSE 197,001,637388,Minnes Kemp; Mor Mia,9998,0,9999,1
1714214130894,CSS 201S,A01,494383,Staff,35,0,35,0
1714214131921,CSS 202S,A01,494387,Staff,35,0,35,0
1714214132946,DSC 197,001,628532,Eldridge; Justin Matthew,9996,0,9999,3
1714214133972,EAP 100,A00,516065,Staff,9797,0,9999,202
1714214134997,ECE 45,A01,507414,Staff,33,0,60,27
1714214137047,ECE 111,A01,507420,Staff,21,0,50,29
1714214138074,ECE 197,001,548057,Sievenpiper; Daniel F.,9994,0,9999,5
1714214139101,EDS 115,A00,507243,Choi; Bailey Miyeon,12,0,28,16
1714214140130,EDS 117,A01,494379,Staff,0,1,30,30
1714214141155,EDS 125,A00,507246,Hopkins; Megan Beth,12,0,30,18
1714214142181,EDS 128A,A01,507264,Fargason; Sharon Gayle,14,0,26,12
1714214143207,EDS 128B,A01,507293,Pappas; Elizabeth,18,0,30,12
1714214144236,EDS 139,A00,507294,Fargason; Sharon Gayle,18,0,30,12
1714214144236,EDS 139,B00,507313,Pappas; Elizabeth,15,0,30,15
1714214145264,EDS 201,A00,507315,Staff,13,0,30,17
1714214146293,EDS 203,A01,507317,Halter; Christopher P.,12,0,30,18
1714214147322,EDS 204R,A01,507319,Halter; Christopher P.,0,3,30,30
1714214147322,EDS 204R,B01,507331,Heinzman; Erica M.,17,0,30,13
1714214148348,EDS 206R,A00,507332,Staff,0,4,30,30
1714214148348,EDS 206R,B00,507343,Staff,18,0,30,12
1714214149374,EDS 250,A00,507344,Hemans; Patricia Ann Benitez,22,0,40,18
1714214150404,EDS 281,A00,507345,Daly; Alan J.,18,0,18,0
1714214151430,EDS 284,A00,507350,Daly; Alan J.,16,0,16,0
1714214152456,EDS 286,A00,507359,Fine; Sarah,18,0,18,0
1714214153481,EDS 289C,A01,507361,Daly; Alan J.,18,0,18,0
1714214154506,EDS 290,A00,507366,Hofstetter; Carolyn,15,0,15,0
1714214155533,LIGM 5A,A00,507421,Fischer-Grunski; Eva K,18,0,20,2
1714214156559,LIGM 5B,A00,507423,Fischer-Grunski; Eva K,19,0,20,1
1714214157585,LIGM 5C,A00,507425,Fischer-Grunski; Eva K,19,0,20,1
1714214158616,LIIT 5AS,A00,507427,Carnelos; Chiara,20,0,20,0
1714214159645,LIIT 5BS,A00,507430,Carnelos; Chiara,20,0,20,0
1714214160671,LIIT 5CS,A00,507432,Carnelos; Chiara,20,0,20,0
1714214161702,LISP 5A,A00,507541,Munoz Sanchez; Alicia,11,0,20,9
1714214162728,LISP 5B,A00,507671,Munoz Sanchez; Alicia,9,0,20,11
1714214163754,LISP 5C,A00,507696,Munoz Sanchez; Alicia,9,0,20,11
1714214164782,MAE 197,001,528363,Boechler; Nicholas Sebastia,9998,0,9999,1
1714214165806,MATH 197,001,523477,Kedlaya; Kiran S.,9996,0,9999,3
1714214165806,MATH 197,002,563811,Zhang; Danna,9995,0,9999,4
1714214165806,MATH 197,003,628552,Dumitriu; Ioana,9998,0,9999,1
1714214166830,MCWP 40R,A00,518780,Staff,5,0,20,15
1714214166830,MCWP 40R,B00,518781,Staff,7,0,20,13
1714214166830,MCWP 40R,C00,518783,Staff,5,0,20,15
1714214167856,MCWP 50R,A00,518791,Staff,0,0,20,20
1714214167856,MCWP 50R,B00,518792,Staff,0,1,20,20
1714214167856,MCWP 50R,C00,518793,Staff,0,1,20,20
1714214167856,MCWP 50R,D00,518794,Staff,0,0,20,20
1714214167856,MCWP 50R,E00,518795,Staff,0,1,20,20
1714214167856,MCWP 50R,F00,518796,Staff,0,0,20,20
1714214167856,MCWP 50R,G00,518797,Staff,0,1,20,20
1714214168888,MMW 12R,A01,514034,Herbst; Matthew,0,1,16,16
1714214168888,MMW 12R,A02,514035,Herbst; Matthew,2,0,16,14
1714214169916,MMW 13R,A01,514037,Staff,0,4,16,16
1714214169916,MMW 13R,A02,514039,Staff,0,2,16,16
1714214169916,MMW 13R,A03,628519,Staff,0,2,16,16
1714214171970,SIO 295LS,A00,523233,Staff,13,0,30,17
1714214172996,SIO 295S,A00,523232,Staff,13,0,30,17
1714214174023,SIOC 290S,A01,637330,Merrifield; Mark A,28,0,30,2
1714214175053,SIOC 291S,A01,637333,Gabriel; Corey John,28,0,30,2
1714214176079,SOCI 117,A01,494376,Staff,0,2,5,5
1714214177109,WES 237B,A00,494380,Staff,9,0,20,11
1714214179184,AESE 279B,A00,494370,Wade; Jon P,0,0,33,33
1714214180212,AIP 197,001,627712,Vespa; Emanuel Ignacio,9998,0,9999,1
1714214181239,ANAR 135S,A00,494369,Braswell; Geoffrey E.,0,0,0,0
1714214182264,BENG 196,001,628496,Engler; Adam J.,9998,0,9999,1
1714214183291,CAT 124RS,A01,519847,Geibel; William,0,0,20,20
1714214184317,CAT 125RS,A01,515971,Geibel; William,0,0,20,20
1714214185344,CLRE 250,A00,511389,Morris; Sheldon,9993,0,9999,6
1714214186375,CLRE 251,A00,507176,Mehta; Ravindra L.,9993,0,9999,6
1714214186375,CLRE 251,B00,511410,Mehta; Ravindra L.,9998,0,9999,1
1714214187401,CLRE 252,A00,507189,Cuomo; Raphael Eduardo,9995,0,9999,4
1714214188429,CLRE 253,A00,507199,Vaida; Florin,9994,0,9999,5
1714214188429,CLRE 253,B00,507202,Vaida; Florin,9999,0,9999,0
1714214189455,CLRE 259,A00,507211,Patel; Hemal,9996,0,9999,3
1714214190479,CLRE 260,A00,507221,Cuomo; Raphael Eduardo,9999,0,9999,0
1714214191504,CLRE 297,001,507242,Cuomo; Raphael Eduardo,9999,0,9999,0
1714214192530,COGS 197,001,638244,Voytek; Bradley Thomas,9999,0,9999,0
1714214193560,CSE 191,A00,516875,Minnes Kemp; Mor Mia,9993,0,9999,6
1714214194584,CSE 197,001,637388,Minnes Kemp; Mor Mia,9998,0,9999,1
1714214195612,CSS 201S,A01,494383,Staff,35,0,35,0
1714214196637,CSS 202S,A01,494387,Staff,35,0,35,0
1714214197668,DSC 197,001,628532,Eldridge; Justin Matthew,9996,0,9999,3
1714214198693,EAP 100,A00,516065,Staff,9797,0,9999,202
1714214199726,ECE 45,A01,507414,Staff,33,0,60,27
1714214201779,ECE 111,A01,507420,Staff,21,0,50,29
1714214202805,ECE 197,001,548057,Sievenpiper; Daniel F.,9994,0,9999,5
1714214203833,EDS 115,A00,507243,Choi; Bailey Miyeon,12,0,28,16
1714214204860,EDS 117,A01,494379,Staff,0,1,30,30
1714214205892,EDS 125,A00,507246,Hopkins; Megan Beth,12,0,30,18
1714214206923,EDS 128A,A01,507264,Fargason; Sharon Gayle,14,0,26,12
1714214207952,EDS 128B,A01,507293,Pappas; Elizabeth,18,0,30,12
1714214208976,EDS 139,A00,507294,Fargason; Sharon Gayle,18,0,30,12
1714214208976,EDS 139,B00,507313,Pappas; Elizabeth,15,0,30,15
1714214210005,EDS 201,A00,507315,Staff,13,0,30,17
1714214211033,EDS 203,A01,507317,Halter; Christopher P.,12,0,30,18
1714214212058,EDS 204R,A01,507319,Halter; Christopher P.,0,3,30,30
1714214212058,EDS 204R,B01,507331,Heinzman; Erica M.,17,0,30,13
1714214213083,EDS 206R,A00,507332,Staff,0,4,30,30
1714214213083,EDS 206R,B00,507343,Staff,18,0,30,12
1714214214112,EDS 250,A00,507344,Hemans; Patricia Ann Benitez,22,0,40,18
1714214215136,EDS 281,A00,507345,Daly; Alan J.,18,0,18,0
1714214216162,EDS 284,A00,507350,Daly; Alan J.,16,0,16,0
1714214217188,EDS 286,A00,507359,Fine; Sarah,18,0,18,0
1714214218213,EDS 289C,A01,507361,Daly; Alan J.,18,0,18,0
1714214219239,EDS 290,A00,507366,Hofstetter; Carolyn,15,0,15,0
1714214220278,LIGM 5A,A00,507421,Fischer-Grunski; Eva K,18,0,20,2
1714214221302,LIGM 5B,A00,507423,Fischer-Grunski; Eva K,19,0,20,1
1714214222328,LIGM 5C,A00,507425,Fischer-Grunski; Eva K,19,0,20,1
1714214223354,LIIT 5AS,A00,507427,Carnelos; Chiara,20,0,20,0
1714214224385,LIIT 5BS,A00,507430,Carnelos; Chiara,20,0,20,0
1714214225414,LIIT 5CS,A00,507432,Carnelos; Chiara,20,0,20,0
1714214226439,LISP 5A,A00,507541,Munoz Sanchez; Alicia,11,0,20,9
1714214227523,LISP 5B,A00,507671,Munoz Sanchez; Alicia,9,0,20,11
1714214228550,LISP 5C,A00,507696,Munoz Sanchez; Alicia,9,0,20,11
1714214229578,MAE 197,001,528363,Boechler; Nicholas Sebastia,9998,0,9999,1
1714214230607,MATH 197,001,523477,Kedlaya; Kiran S.,9996,0,9999,3
1714214230607,MATH 197,002,563811,Zhang; Danna,9995,0,9999,4
1714214230607,MATH 197,003,628552,Dumitriu; Ioana,9998,0,9999,1
1714214231636,MCWP 40R,A00,518780,Staff,5,0,20,15
1714214231636,MCWP 40R,B00,518781,Staff,7,0,20,13
1714214231636,MCWP 40R,C00,518783,Staff,5,0,20,15
1714214232665,MCWP 50R,A00,518791,Staff,0,0,20,20
1714214232665,MCWP 50R,B00,518792,Staff,0,1,20,20
1714214232665,MCWP 50R,C00,518793,Staff,0,1,20,20
1714214232665,MCWP 50R,D00,518794,Staff,0,0,20,20
1714214232665,MCWP 50R,E00,518795,Staff,0,1,20,20
1714214232665,MCWP 50R,F00,518796,Staff,0,0,20,20
1714214232665,MCWP 50R,G00,518797,Staff,0,1,20,20
1714214233694,MMW 12R,A01,514034,Herbst; Matthew,0,1,16,16
1714214233694,MMW 12R,A02,514035,Herbst; Matthew,2,0,16,14
1714214234719,MMW 13R,A01,514037,Staff,0,4,16,16
1714214234719,MMW 13R,A02,514039,Staff,0,2,16,16
1714214234719,MMW 13R,A03,628519,Staff,0,2,16,16
1714214236773,SIO 295LS,A00,523233,Staff,13,0,30,17
1714214237798,SIO 295S,A00,523232,Staff,13,0,30,17
1714214238825,SIOC 290S,A01,637330,Merrifield; Mark A,28,0,30,2
1714214239854,SIOC 291S,A01,637333,Gabriel; Corey John,28,0,30,2
1714214240881,SOCI 117,A01,494376,Staff,0,2,5,5
1714214241905,WES 237B,A00,494380,Staff,9,0,20,11
1714214243966,AESE 279B,A00,494370,Wade; Jon P,0,0,33,33
1714214244992,AIP 197,001,627712,Vespa; Emanuel Ignacio,9998,0,9999,1
1714214246015,ANAR 135S,A00,494369,Braswell; Geoffrey E.,0,0,0,0
1714214247041,BENG 196,001,628496,Engler; Adam J.,9998,0,9999,1
1714214248066,CAT 124RS,A01,519847,Geibel; William,0,0,20,20
1714214249091,CAT 125RS,A01,515971,Geibel; William,0,0,20,20
1714214250116,CLRE 250,A00,511389,Morris; Sheldon,9993,0,9999,6
1714214251143,CLRE 251,A00,507176,Mehta; Ravindra L.,9993,0,9999,6
1714214251143,CLRE 251,B00,511410,Mehta; Ravindra L.,9998,0,9999,1
1714214252169,CLRE 252,A00,507189,Cuomo; Raphael Eduardo,9995,0,9999,4
1714214253195,CLRE 253,A00,507199,Vaida; Florin,9994,0,9999,5
1714214253195,CLRE 253,B00,507202,Vaida; Florin,9999,0,9999,0
1714214254221,CLRE 259,A00,507211,Patel; Hemal,9996,0,9999,3
1714214255247,CLRE 260,A00,507221,Cuomo; Raphael Eduardo,9999,0,9999,0
1714214256271,CLRE 297,001,507242,Cuomo; Raphael Eduardo,9999,0,9999,0
1714214257304,COGS 197,001,638244,Voytek; Bradley Thomas,9999,0,9999,0
1714214258330,CSE 191,A00,516875,Minnes Kemp; Mor Mia,9993,0,9999,6
1714214259359,CSE 197,001,637388,Minnes Kemp; Mor Mia,9998,0,9999,1
1714214260390,CSS 201S,A01,494383,Staff,35,0,35,0
1714214261418,CSS 202S,A01,494387,Staff,35,0,35,0
1714214262445,DSC 197,001,628532,Eldridge; Justin Matthew,9996,0,9999,3
1714214263474,EAP 100,A00,516065,Staff,9797,0,9999,202
1714214264500,ECE 45,A01,507414,Staff,33,0,60,27
1714214266551,ECE 111,A01,507420,Staff,21,0,50,29
1714214267577,ECE 197,001,548057,Sievenpiper; Daniel F.,9994,0,9999,5
1714214268603,EDS 115,A00,507243,Choi; Bailey Miyeon,12,0,28,16
1714214269629,EDS 117,A01,494379,Staff,0,1,30,30
1714214270656,EDS 125,A00,507246,Hopkins; Megan Beth,12,0,30,18
1714214271682,EDS 128A,A01,507264,Fargason; Sharon Gayle,14,0,26,12
1714214272708,EDS 128B,A01,507293,Pappas; Elizabeth,18,0,30,12
1714214273736,EDS 139,A00,507294,Fargason; Sharon Gayle,18,0,30,12
1714214273736,EDS 139,B00,507313,Pappas; Elizabeth,15,0,30,15
1714214274762,EDS 201,A00,507315,Staff,13,0,30,17
1714214275789,EDS 203,A01,507317,Halter; Christopher P.,12,0,30,18
1714214276816,EDS 204R,A01,507319,Halter; Christopher P.,0,3,30,30
1714214276816,EDS 204R,B01,507331,Heinzman; Erica M.,17,0,30,13
1714214277841,EDS 206R,A00,507332,Staff,0,4,30,30
1714214277841,EDS 206R,B00,507343,Staff,18,0,30,12
1714214278867,EDS 250,A00,507344,Hemans; Patricia Ann Benitez,22,0,40,18
1714214279893,EDS 281,A00,507345,Daly; Alan J.,18,0,18,0
1714214280918,EDS 284,A00,507350,Daly; Alan J.,16,0,16,0
1714214281946,EDS 286,A00,507359,Fine; Sarah,18,0,18,0
1714214282973,EDS 289C,A01,507361,Daly; Alan J.,18,0,18,0
1714214283998,EDS 290,A00,507366,Hofstetter; Carolyn,15,0,15,0
1714214285025,LIGM 5A,A00,507421,Fischer-Grunski; Eva K,18,0,20,2
1714214286051,LIGM 5B,A00,507423,Fischer-Grunski; Eva K,19,0,20,1
1714214287077,LIGM 5C,A00,507425,Fischer-Grunski; Eva K,19,0,20,1
1714214288103,LIIT 5AS,A00,507427,Carnelos; Chiara,20,0,20,0
1714214289132,LIIT 5BS,A00,507430,Carnelos; Chiara,20,0,20,0
1714214290158,LIIT 5CS,A00,507432,Carnelos; Chiara,20,0,20,0
1714214291182,LISP 5A,A00,507541,Munoz Sanchez; Alicia,11,0,20,9
1714214292208,LISP 5B,A00,507671,Munoz Sanchez; Alicia,9,0,20,11
1714214293235,LISP 5C,A00,507696,Munoz Sanchez; Alicia,9,0,20,11
1714214294262,MAE 197,001,528363,Boechler; Nicholas Sebastia,9998,0,9999,1
1714214295293,MATH 197,001,523477,Kedlaya; Kiran S.,9996,0,9999,3
1714214295293,MATH 197,002,563811,Zhang; Danna,9995,0,9999,4
1714214295293,MATH 197,003,628552,Dumitriu; Ioana,9998,0,9999,1
1714214296319,MCWP 40R,A00,518780,Staff,5,0,20,15
1714214296319,MCWP 40R,B00,518781,Staff,7,0,20,13
1714214296319,MCWP 40R,C00,518783,Staff,5,0,20,15
1714214297346,MCWP 50R,A00,518791,Staff,0,0,20,20
1714214297346,MCWP 50R,B00,518792,Staff,0,1,20,20
1714214297346,MCWP 50R,C00,518793,Staff,0,1,20,20
1714214297346,MCWP 50R,D00,518794,Staff,0,0,20,20
1714214297346,MCWP 50R,E00,518795,Staff,0,1,20,20
1714214297346,MCWP 50R,F00,518796,Staff,0,0,20,20
1714214297346,MCWP 50R,G00,518797,Staff,0,1,20,20
1714214298370,MMW 12R,A01,514034,Herbst; Matthew,0,1,16,16
1714214298370,MMW 12R,A02,514035,Herbst; Matthew,2,0,16,14
1714214299395,MMW 13R,A01,514037,Staff,0,4,16,16
1714214299395,MMW 13R,A02,514039,Staff,0,2,16,16
1714214299395,MMW 13R,A03,628519,Staff,0,2,16,16
1714214301452,SIO 295LS,A00,523233,Staff,13,0,30,17
1714214302478,SIO 295S,A00,523232,Staff,13,0,30,17
1714214303507,SIOC 290S,A01,637330,Merrifield; Mark A,28,0,30,2
1714214304534,SIOC 291S,A01,637333,Gabriel; Corey John,28,0,30,2
1714214305567,SOCI 117,A01,494376,Staff,0,2,5,5
1714214306597,WES 237B,A00,494380,Staff,9,0,20,11
1714214308915,AESE 279B,A00,494370,Wade; Jon P,0,0,33,33
1714214309943,AIP 197,001,627712,Vespa; Emanuel Ignacio,9998,0,9999,1
1714214310972,ANAR 135S,A00,494369,Braswell; Geoffrey E.,0,0,0,0
1714214311996,BENG 196,001,628496,Engler; Adam J.,9998,0,9999,1
1714214313024,CAT 124RS,A01,519847,Geibel; William,0,0,20,20
1714214314049,CAT 125RS,A01,515971,Geibel; William,0,0,20,20
1714214315076,CLRE 250,A00,511389,Morris; Sheldon,9993,0,9999,6
1714214316101,CLRE 251,A00,507176,Mehta; Ravindra L.,9993,0,9999,6
1714214316101,CLRE 251,B00,511410,Mehta; Ravindra L.,9998,0,9999,1
1714214317127,CLRE 252,A00,507189,Cuomo; Raphael Eduardo,9995,0,9999,4
1714214318152,CLRE 253,A00,507199,Vaida; Florin,9994,0,9999,5
1714214318152,CLRE 253,B00,507202,Vaida; Florin,9999,0,9999,0
1714214319177,CLRE 259,A00,507211,Patel; Hemal,9996,0,9999,3
1714214320203,CLRE 260,A00,507221,Cuomo; Raphael Eduardo,9999,0,9999,0
1714214321227,CLRE 297,001,507242,Cuomo; Raphael Eduardo,9999,0,9999,0
1714214322254,COGS 197,001,638244,Voytek; Bradley Thomas,9999,0,9999,0
1714214323283,CSE 191,A00,516875,Minnes Kemp; Mor Mia,9993,0,9999,6
1714214324310,CSE 197,001,637388,Minnes Kemp; Mor Mia,9998,0,9999,1
1714214325334,CSS 201S,A01,494383,Staff,35,0,35,0
1714214326364,CSS 202S,A01,494387,Staff,35,0,35,0
1714214327392,DSC 197,001,628532,Eldridge; Justin Matthew,9996,0,9999,3
1714214328418,EAP 100,A00,516065,Staff,9797,0,9999,202
1714214329443,ECE 45,A01,507414,Staff,33,0,60,27
1714214331552,ECE 111,A01,507420,Staff,21,0,50,29
1714214332580,ECE 197,001,548057,Sievenpiper; Daniel F.,9994,0,9999,5
1714214333609,EDS 115,A00,507243,Choi; Bailey Miyeon,12,0,28,16
1714214334636,EDS 117,A01,494379,Staff,0,1,30,30
1714214335661,EDS 125,A00,507246,Hopkins; Megan Beth,12,0,30,18
1714214336690,EDS 128A,A01,507264,Fargason; Sharon Gayle,14,0,26,12
1714214337719,EDS 128B,A01,507293,Pappas; Elizabeth,18,0,30,12
1714214338748,EDS 139,A00,507294,Fargason; Sharon Gayle,18,0,30,12
1714214338748,EDS 139,B00,507313,Pappas; Elizabeth,15,0,30,15
1714214339774,EDS 201,A00,507315,Staff,13,0,30,17
1714214340804,EDS 203,A01,507317,Halter; Christopher P.,12,0,30,18
1714214341835,EDS 204R,A01,507319,Halter; Christopher P.,0,3,30,30
1714214341835,EDS 204R,B01,507331,Heinzman; Erica M.,17,0,30,13
1714214342863,EDS 206R,A00,507332,Staff,0,4,30,30
1714214342863,EDS 206R,B00,507343,Staff,18,0,30,12
1714214343904,EDS 250,A00,507344,Hemans; Patricia Ann Benitez,22,0,40,18
1714214344932,EDS 281,A00,507345,Daly; Alan J.,18,0,18,0
1714214345959,EDS 284,A00,507350,Daly; Alan J.,16,0,16,0
1714214346985,EDS 286,A00,507359,Fine; Sarah,18,0,18,0
1714214348013,EDS 289C,A01,507361,Daly; Alan J.,18,0,18,0
1714214349039,EDS 290,A00,507366,Hofstetter; Carolyn,15,0,15,0
1714214350069,LIGM 5A,A00,507421,Fischer-Grunski; Eva K,18,0,20,2
1714214351096,LIGM 5B,A00,507423,Fischer-Grunski; Eva K,19,0,20,1
1714214352121,LIGM 5C,A00,507425,Fischer-Grunski; Eva K,19,0,20,1
1714214353151,LIIT 5AS,A00,507427,Carnelos; Chiara,20,0,20,0
1714214354177,LIIT 5BS,A00,507430,Carnelos; Chiara,20,0,20,0
1714214355204,LIIT 5CS,A00,507432,Carnelos; Chiara,20,0,20,0
1714214356235,LISP 5A,A00,507541,Munoz Sanchez; Alicia,11,0,20,9
1714214357265,LISP 5B,A00,507671,Munoz Sanchez; Alicia,9,0,20,11
1714214358293,LISP 5C,A00,507696,Munoz Sanchez; Alicia,9,0,20,11
1714214359322,MAE 197,001,528363,Boechler; Nicholas Sebastia,9998,0,9999,1
1714214360351,MATH 197,001,523477,Kedlaya; Kiran S.,9996,0,9999,3
1714214360351,MATH 197,002,563811,Zhang; Danna,9995,0,9999,4
1714214360351,MATH 197,003,628552,Dumitriu; Ioana,9998,0,9999,1
1714214361380,MCWP 40R,A00,518780,Staff,5,0,20,15
1714214361380,MCWP 40R,B00,518781,Staff,7,0,20,13
1714214361380,MCWP 40R,C00,518783,Staff,5,0,20,15
1714214362410,MCWP 50R,A00,518791,Staff,0,0,20,20
1714214362410,MCWP 50R,B00,518792,Staff,0,1,20,20
1714214362410,MCWP 50R,C00,518793,Staff,0,1,20,20
1714214362410,MCWP 50R,D00,518794,Staff,0,0,20,20
1714214362410,MCWP 50R,E00,518795,Staff,0,1,20,20
1714214362410,MCWP 50R,F00,518796,Staff,0,0,20,20
1714214362410,MCWP 50R,G00,518797,Staff,0,1,20,20
1714214363436,MMW 12R,A01,514034,Herbst; Matthew,0,1,16,16
1714214363436,MMW 12R,A02,514035,Herbst; Matthew,2,0,16,14
1714214364462,MMW 13R,A01,514037,Staff,0,4,16,16
1714214364462,MMW 13R,A02,514039,Staff,0,2,16,16
1714214364462,MMW 13R,A03,628519,Staff,0,2,16,16
1714214366517,SIO 295LS,A00,523233,Staff,13,0,30,17
1714214367548,SIO 295S,A00,523232,Staff,13,0,30,17
1714214368576,SIOC 290S,A01,637330,Merrifield; Mark A,28,0,30,2
1714214369602,SIOC 291S,A01,637333,Gabriel; Corey John,28,0,30,2
1714214370628,SOCI 117,A01,494376,Staff,0,2,5,5
1714214371655,WES 237B,A00,494380,Staff,9,0,20,11
1714214373723,AESE 279B,A00,494370,Wade; Jon P,0,0,33,33
1714214374752,AIP 197,001,627712,Vespa; Emanuel Ignacio,9998,0,9999,1
1714214375778,ANAR 135S,A00,494369,Braswell; Geoffrey E.,0,0,0,0
1714214376806,BENG 196,001,628496,Engler; Adam J.,9998,0,9999,1
1714214377831,CAT 124RS,A01,519847,Geibel; William,0,0,20,20
1714214378857,CAT 125RS,A01,515971,Geibel; William,0,0,20,20
1714214379887,CLRE 250,A00,511389,Morris; Sheldon,9993,0,9999,6
1714214380914,CLRE 251,A00,507176,Mehta; Ravindra L.,9993,0,9999,6
1714214380914,CLRE 251,B00,511410,Mehta; Ravindra L.,9998,0,9999,1
1714214381941,CLRE 252,A00,507189,Cuomo; Raphael Eduardo,9995,0,9999,4
1714214382971,CLRE 253,A00,507199,Vaida; Florin,9994,0,9999,5
1714214382971,CLRE 253,B00,507202,Vaida; Florin,9999,0,9999,0
1714214383996,CLRE 259,A00,507211,Patel; Hemal,9996,0,9999,3
1714214385024,CLRE 260,A00,507221,Cuomo; Raphael Eduardo,9999,0,9999,0
1714214386050,CLRE 297,001,507242,Cuomo; Raphael Eduardo,9999,0,9999,0
1714214387078,COGS 197,001,638244,Voytek; Bradley Thomas,9999,0,9999,0
1714214388105,CSE 191,A00,516875,Minnes Kemp; Mor Mia,9993,0,9999,6
1714214389131,CSE 197,001,637388,Minnes Kemp; Mor Mia,9998,0,9999,1
1714214390158,CSS 201S,A01,494383,Staff,35,0,35,0
1714214391189,CSS 202S,A01,494387,Staff,35,0,35,0
1714214392217,DSC 197,001,628532,Eldridge; Justin Matthew,9996,0,9999,3
1714214393242,EAP 100,A00,516065,Staff,9797,0,9999,202
1714214394268,ECE 45,A01,507414,Staff,33,0,60,27
1714214396323,ECE 111,A01,507420,Staff,21,0,50,29
1714214397349,ECE 197,001,548057,Sievenpiper; Daniel F.,9994,0,9999,5
1714214398376,EDS 115,A00,507243,Choi; Bailey Miyeon,12,0,28,16
1714214399403,EDS 117,A01,494379,Staff,0,1,30,30
1714214400433,EDS 125,A00,507246,Hopkins; Megan Beth,12,0,30,18
1714214401461,EDS 128A,A01,507264,Fargason; Sharon Gayle,14,0,26,12
1714214402486,EDS 128B,A01,507293,Pappas; Elizabeth,18,0,30,12
1714214403512,EDS 139,A00,507294,Fargason; Sharon Gayle,18,0,30,12
1714214403512,EDS 139,B00,507313,Pappas; Elizabeth,15,0,30,15
1714214404540,EDS 201,A00,507315,Staff,13,0,30,17
1714214405565,EDS 203,A01,507317,Halter; Christopher P.,12,0,30,18
1714214406591,EDS 204R,A01,507319,Halter; Christopher P.,0,3,30,30
1714214406591,EDS 204R,B01,507331,Heinzman; Erica M.,17,0,30,13
1714214407618,EDS 206R,A00,507332,Staff,0,4,30,30
1714214407618,EDS 206R,B00,507343,Staff,18,0,30,12
1714214408647,EDS 250,A00,507344,Hemans; Patricia Ann Benitez,22,0,40,18
1714214409674,EDS 281,A00,507345,Daly; Alan J.,18,0,18,0
1714214410700,EDS 284,A00,507350,Daly; Alan J.,16,0,16,0
1714214411726,EDS 286,A00,507359,Fine; Sarah,18,0,18,0
1714214412751,EDS 289C,A01,507361,Daly; Alan J.,18,0,18,0
1714214413776,EDS 290,A00,507366,Hofstetter; Carolyn,15,0,15,0
1714214414806,LIGM 5A,A00,507421,Fischer-Grunski; Eva K,18,0,20,2
1714214415832,LIGM 5B,A00,507423,Fischer-Grunski; Eva K,19,0,20,1
1714214416859,LIGM 5C,A00,507425,Fischer-Grunski; Eva K,19,0,20,1
1714214417884,LIIT 5AS,A00,507427,Carnelos; Chiara,20,0,20,0
1714214418910,LIIT 5BS,A00,507430,Carnelos; Chiara,20,0,20,0
1714214419939,LIIT 5CS,A00,507432,Carnelos; Chiara,20,0,20,0
1714214420968,LISP 5A,A00,507541,Munoz Sanchez; Alicia,11,0,20,9
1714214422003,LISP 5B,A00,507671,Munoz Sanchez; Alicia,9,0,20,11
1714214423027,LISP 5C,A00,507696,Munoz Sanchez; Alicia,9,0,20,11
1714214424056,MAE 197,001,528363,Boechler; Nicholas Sebastia,9998,0,9999,1
1714214425082,MATH 197,001,523477,Kedlaya; Kiran S.,9996,0,9999,3
1714214425082,MATH 197,002,563811,Zhang; Danna,9995,0,9999,4
1714214425082,MATH 197,003,628552,Dumitriu; Ioana,9998,0,9999,1
1714214426107,MCWP 40R,A00,518780,Staff,5,0,20,15
1714214426107,MCWP 40R,B00,518781,Staff,7,0,20,13
1714214426107,MCWP 40R,C00,518783,Staff,5,0,20,15
1714214427136,MCWP 50R,A00,518791,Staff,0,0,20,20
1714214427136,MCWP 50R,B00,518792,Staff,0,1,20,20
1714214427136,MCWP 50R,C00,518793,Staff,0,1,20,20
1714214427136,MCWP 50R,D00,518794,Staff,0,0,20,20
1714214427136,MCWP 50R,E00,518795,Staff,0,1,20,20
1714214427136,MCWP 50R,F00,518796,Staff,0,0,20,20
1714214427136,MCWP 50R,G00,518797,Staff,0,1,20,20
1714214428164,MMW 12R,A01,514034,Herbst; Matthew,0,1,16,16
1714214428164,MMW 12R,A02,514035,Herbst; Matthew,2,0,16,14
1714214429192,MMW 13R,A01,514037,Staff,0,4,16,16
1714214429192,MMW 13R,A02,514039,Staff,0,2,16,16
1714214429192,MMW 13R,A03,628519,Staff,0,2,16,16
1714214431242,SIO 295LS,A00,523233,Staff,13,0,30,17
1714214432268,SIO 295S,A00,523232,Staff,13,0,30,17
1714214433295,SIOC 290S,A01,637330,Merrifield; Mark A,28,0,30,2
1714214434324,SIOC 291S,A01,637333,Gabriel; Corey John,28,0,30,2
1714214435404,SOCI 117,A01,494376,Staff,0,2,5,5
1714214436434,WES 237B,A00,494380,Staff,9,0,20,11
1714214438490,AESE 279B,A00,494370,Wade; Jon P,0,0,33,33
1714214439514,AIP 197,001,627712,Vespa; Emanuel Ignacio,9998,0,9999,1
1714214440541,ANAR 135S,A00,494369,Braswell; Geoffrey E.,0,0,0,0
1714214441569,BENG 196,001,628496,Engler; Adam J.,9998,0,9999,1
1714214442598,CAT 124RS,A01,519847,Geibel; William,0,0,20,20
1714214443626,CAT 125RS,A01,515971,Geibel; William,0,0,20,20
1714214444651,CLRE 250,A00,511389,Morris; Sheldon,9993,0,9999,6
1714214445677,CLRE 251,A00,507176,Mehta; Ravindra L.,9993,0,9999,6
1714214445677,CLRE 251,B00,511410,Mehta; Ravindra L.,9998,0,9999,1
1714214446706,CLRE 252,A00,507189,Cuomo; Raphael Eduardo,9995,0,9999,4
1714214447732,CLRE 253,A00,507199,Vaida; Florin,9994,0,9999,5
1714214447732,CLRE 253,B00,507202,Vaida; Florin,9999,0,9999,0
1714214448757,CLRE 259,A00,507211,Patel; Hemal,9996,0,9999,3
1714214449785,CLRE 260,A00,507221,Cuomo; Raphael Eduardo,9999,0,9999,0
1714214450814,CLRE 297,001,507242,Cuomo; Raphael Eduardo,9999,0,9999,0
1714214451840,COGS 197,001,638244,Voytek; Bradley Thomas,9999,0,9999,0
1714214452868,CSE 191,A00,516875,Minnes Kemp; Mor Mia,9993,0,9999,6
1714214453966,CSE 197,001,637388,Minnes Kemp; Mor Mia,9998,0,9999,1
1714214454992,CSS 201S,A01,494383,Staff,35,0,35,0
1714214456017,CSS 202S,A01,494387,Staff,35,0,35,0
1714214457041,DSC 197,001,628532,Eldridge; Justin Matthew,9996,0,9999,3
1714214458067,EAP 100,A00,516065,Staff,9797,0,9999,202
1714214459092,ECE 45,A01,507414,Staff,33,0,60,27
1714214461146,ECE 111,A01,507420,Staff,21,0,50,29
1714214462172,ECE 197,001,548057,Sievenpiper; Daniel F.,9994,0,9999,5
1714214463198,EDS 115,A00,507243,Choi; Bailey Miyeon,12,0,28,16
1714214464228,EDS 117,A01,494379,Staff,0,1,30,30
1714214465255,EDS 125,A00,507246,Hopkins; Megan Beth,12,0,30,18
1714214466282,EDS 128A,A01,507264,Fargason; Sharon Gayle,14,0,26,12
1714214467308,EDS 128B,A01,507293,Pappas; Elizabeth,18,0,30,12
1714214468335,EDS 139,A00,507294,Fargason; Sharon Gayle,18,0,30,12
1714214468335,EDS 139,B00,507313,Pappas; Elizabeth,15,0,30,15
1714214469363,EDS 201,A00,507315,Staff,13,0,30,17
1714214470390,EDS 203,A01,507317,Halter; Christopher P.,12,0,30,18
1714214471417,EDS 204R,A01,507319,Halter; Christopher P.,0,3,30,30
1714214471417,EDS 204R,B01,507331,Heinzman; Erica M.,17,0,30,13
1714214472441,EDS 206R,A00,507332,Staff,0,4,30,30
1714214472441,EDS 206R,B00,507343,Staff,18,0,30,12
1714214473467,EDS 250,A00,507344,Hemans; Patricia Ann Benitez,22,0,40,18
1714214474493,EDS 281,A00,507345,Daly; Alan J.,18,0,18,0
1714214475519,EDS 284,A00,507350,Daly; Alan J.,16,0,16,0
1714214476545,EDS 286,A00,507359,Fine; Sarah,18,0,18,0
1714214477574,EDS 289C,A01,507361,Daly; Alan J.,18,0,18,0
1714214478599,EDS 290,A00,507366,Hofstetter; Carolyn,15,0,15,0
1714214479626,LIGM 5A,A00,507421,Fischer-Grunski; Eva K,18,0,20,2
1714214480652,LIGM 5B,A00,507423,Fischer-Grunski; Eva K,19,0,20,1
1714214481680,LIGM 5C,A00,507425,Fischer-Grunski; Eva K,19,0,20,1
1714214482706,LIIT 5AS,A00,507427,Carnelos; Chiara,20,0,20,0
1714214483732,LIIT 5BS,A00,507430,Carnelos; Chiara,20,0,20,0
1714214484758,LIIT 5CS,A00,507432,Carnelos; Chiara,20,0,20,0
1714214485783,LISP 5A,A00,507541,Munoz Sanchez; Alicia,11,0,20,9
1714214486808,LISP 5B,A00,507671,Munoz Sanchez; Alicia,9,0,20,11
1714214487838,LISP 5C,A00,507696,Munoz Sanchez; Alicia,9,0,20,11
1714214488866,MAE 197,001,528363,Boechler; Nicholas Sebastia,9998,0,9999,1
1714214489895,MATH 197,001,523477,Kedlaya; Kiran S.,9996,0,9999,3
1714214489895,MATH 197,002,563811,Zhang; Danna,9995,0,9999,4
1714214489895,MATH 197,003,628552,Dumitriu; Ioana,9998,0,9999,1
1714214490920,MCWP 40R,A00,518780,Staff,5,0,20,15
1714214490920,MCWP 40R,B00,518781,Staff,7,0,20,13
1714214490920,MCWP 40R,C00,518783,Staff,5,0,20,15
1714214491950,MCWP 50R,A00,518791,Staff,0,0,20,20
1714214491950,MCWP 50R,B00,518792,Staff,0,1,20,20
1714214491950,MCWP 50R,C00,518793,Staff,0,1,20,20
1714214491950,MCWP 50R,D00,518794,Staff,0,0,20,20
1714214491950,MCWP 50R,E00,518795,Staff,0,1,20,20
1714214491950,MCWP 50R,F00,518796,Staff,0,0,20,20
1714214491950,MCWP 50R,G00,518797,Staff,0,1,20,20
1714214492975,MMW 12R,A01,514034,Herbst; Matthew,0,1,16,16
1714214492975,MMW 12R,A02,514035,Herbst; Matthew,2,0,16,14
1714214494004,MMW 13R,A01,514037,Staff,0,4,16,16
1714214494004,MMW 13R,A02,514039,Staff,0,2,16,16
1714214494004,MMW 13R,A03,628519,Staff,0,2,16,16
1714214496053,SIO 295LS,A00,523233,Staff,13,0,30,17
1714214497081,SIO 295S,A00,523232,Staff,13,0,30,17
1714214498107,SIOC 290S,A01,637330,Merrifield; Mark A,28,0,30,2
1714214499136,SIOC 291S,A01,637333,Gabriel; Corey John,28,0,30,2
1714214500164,SOCI 117,A01,494376,Staff,0,2,5,5
1714214501189,WES 237B,A00,494380,Staff,9,0,20,11
1714214503251,AESE 279B,A00,494370,Wade; Jon P,0,0,33,33
1714214504280,AIP 197,001,627712,Vespa; Emanuel Ignacio,9998,0,9999,1
1714214505304,ANAR 135S,A00,494369,Braswell; Geoffrey E.,0,0,0,0
1714214506333,BENG 196,001,628496,Engler; Adam J.,9998,0,9999,1
1714214507360,CAT 124RS,A01,519847,Geibel; William,0,0,20,20
1714214508387,CAT 125RS,A01,515971,Geibel; William,0,0,20,20
1714214509413,CLRE 250,A00,511389,Morris; Sheldon,9993,0,9999,6
1714214510439,CLRE 251,A00,507176,Mehta; Ravindra L.,9993,0,9999,6
1714214510439,CLRE 251,B00,511410,Mehta; Ravindra L.,9998,0,9999,1
1714214511465,CLRE 252,A00,507189,Cuomo; Raphael Eduardo,9995,0,9999,4
1714214512494,CLRE 253,A00,507199,Vaida; Florin,9994,0,9999,5
1714214512494,CLRE 253,B00,507202,Vaida; Florin,9999,0,9999,0
1714214513523,CLRE 259,A00,507211,Patel; Hemal,9996,0,9999,3
1714214514548,CLRE 260,A00,507221,Cuomo; Raphael Eduardo,9999,0,9999,0
1714214515577,CLRE 297,001,507242,Cuomo; Raphael Eduardo,9999,0,9999,0
1714214516606,COGS 197,001,638244,Voytek; Bradley Thomas,9999,0,9999,0
1714214517634,CSE 191,A00,516875,Minnes Kemp; Mor Mia,9993,0,9999,6
1714214518658,CSE 197,001,637388,Minnes Kemp; Mor Mia,9998,0,9999,1
1714214519683,CSS 201S,A01,494383,Staff,35,0,35,0
1714214520708,CSS 202S,A01,494387,Staff,35,0,35,0
1714214521732,DSC 197,001,628532,Eldridge; Justin Matthew,9996,0,9999,3
1714214522760,EAP 100,A00,516065,Staff,9797,0,9999,202
1714214523785,ECE 45,A01,507414,Staff,33,0,60,27
1714214525857,ECE 111,A01,507420,Staff,21,0,50,29
1714214526884,ECE 197,001,548057,Sievenpiper; Daniel F.,9994,0,9999,5
1714214527913,EDS 115,A00,507243,Choi; Bailey Miyeon,12,0,28,16
1714214528944,EDS 117,A01,494379,Staff,0,1,30,30
1714214529973,EDS 125,A00,507246,Hopkins; Megan Beth,12,0,30,18
1714214531002,EDS 128A,A01,507264,Fargason; Sharon Gayle,14,0,26,12
1714214532032,EDS 128B,A01,507293,Pappas; Elizabeth,18,0,30,12
1714214533061,EDS 139,A00,507294,Fargason; Sharon Gayle,18,0,30,12
1714214533061,EDS 139,B00,507313,Pappas; Elizabeth,15,0,30,15
1714214534091,EDS 201,A00,507315,Staff,13,0,30,17
1714214535121,EDS 203,A01,507317,Halter; Christopher P.,12,0,30,18
1714214536151,EDS 204R,A01,507319,Halter; Christopher P.,0,3,30,30
1714214536151,EDS 204R,B01,507331,Heinzman; Erica M.,17,0,30,13
1714214537178,EDS 206R,A00,507332,Staff,0,4,30,30
1714214537178,EDS 206R,B00,507343,Staff,18,0,30,12
1714214538206,EDS 250,A00,507344,Hemans; Patricia Ann Benitez,22,0,40,18
1714214539290,EDS 281,A00,507345,Daly; Alan J.,18,0,18,0
1714214540315,EDS 284,A00,507350,Daly; Alan J.,16,0,16,0
1714214541341,EDS 286,A00,507359,Fine; Sarah,18,0,18,0
1714214542371,EDS 289C,A01,507361,Daly; Alan J.,18,0,18,0
1714214543399,EDS 290,A00,507366,Hofstetter; Carolyn,15,0,15,0
1714214544428,LIGM 5A,A00,507421,Fischer-Grunski; Eva K,18,0,20,2
1714214545454,LIGM 5B,A00,507423,Fischer-Grunski; Eva K,19,0,20,1
1714214546484,LIGM 5C,A00,507425,Fischer-Grunski; Eva K,19,0,20,1
1714214547509,LIIT 5AS,A00,507427,Carnelos; Chiara,20,0,20,0
1714214548535,LIIT 5BS,A00,507430,Carnelos; Chiara,20,0,20,0
1714214549562,LIIT 5CS,A00,507432,Carnelos; Chiara,20,0,20,0
1714214550592,LISP 5A,A00,507541,Munoz Sanchez; Alicia,11,0,20,9
1714214551622,LISP 5B,A00,507671,Munoz Sanchez; Alicia,9,0,20,11
1714214552653,LISP 5C,A00,507696,Munoz Sanchez; Alicia,9,0,20,11
1714214553682,MAE 197,001,528363,Boechler; Nicholas Sebastia,9998,0,9999,1
1714214554707,MATH 197,001,523477,Kedlaya; Kiran S.,9996,0,9999,3
1714214554707,MATH 197,002,563811,Zhang; Danna,9995,0,9999,4
1714214554707,MATH 197,003,628552,Dumitriu; Ioana,9998,0,9999,1
1714214555732,MCWP 40R,A00,518780,Staff,5,0,20,15
1714214555732,MCWP 40R,B00,518781,Staff,7,0,20,13
1714214555732,MCWP 40R,C00,518783,Staff,5,0,20,15
1714214556758,MCWP 50R,A00,518791,Staff,0,0,20,20
1714214556758,MCWP 50R,B00,518792,Staff,0,1,20,20
1714214556758,MCWP 50R,C00,518793,Staff,0,1,20,20
1714214556758,MCWP 50R,D00,518794,Staff,0,0,20,20
1714214556758,MCWP 50R,E00,518795,Staff,0,1,20,20
1714214556758,MCWP 50R,F00,518796,Staff,0,0,20,20
1714214556758,MCWP 50R,G00,518797,Staff,0,1,20,20
1714214557783,MMW 12R,A01,514034,Herbst; Matthew,0,1,16,16
1714214557783,MMW 12R,A02,514035,Herbst; Matthew,2,0,16,14
1714214558808,MMW 13R,A01,514037,Staff,0,4,16,16
1714214558808,MMW 13R,A02,514039,Staff,0,2,16,16
1714214558808,MMW 13R,A03,628519,Staff,0,2,16,16
1714214560862,SIO 295LS,A00,523233,Staff,13,0,30,17
1714214561887,SIO 295S,A00,523232,Staff,13,0,30,17
1714214562913,SIOC 290S,A01,637330,Merrifield; Mark A,28,0,30,2
1714214563939,SIOC 291S,A01,637333,Gabriel; Corey John,28,0,30,2
1714214564966,SOCI 117,A01,494376,Staff,0,2,5,5
1714214565992,WES 237B,A00,494380,Staff,9,0,20,11
1714214568050,AESE 279B,A00,494370,Wade; Jon P,0,0,33,33
1714214569077,AIP 197,001,627712,Vespa; Emanuel Ignacio,9998,0,9999,1
1714214570103,ANAR 135S,A00,494369,Braswell; Geoffrey E.,0,0,0,0
1714214571131,BENG 196,001,628496,Engler; Adam J.,9998,0,9999,1
1714214572159,CAT 124RS,A01,519847,Geibel; William,0,0,20,20
1714214573188,CAT 125RS,A01,515971,Geibel; William,0,0,20,20
1714214574212,CLRE 250,A00,511389,Morris; Sheldon,9993,0,9999,6
1714214575238,CLRE 251,A00,507176,Mehta; Ravindra L.,9993,0,9999,6
1714214575238,CLRE 251,B00,511410,Mehta; Ravindra L.,9998,0,9999,1
1714214576263,CLRE 252,A00,507189,Cuomo; Raphael Eduardo,9995,0,9999,4
1714214577292,CLRE 253,A00,507199,Vaida; Florin,9994,0,9999,5
1714214577292,CLRE 253,B00,507202,Vaida; Florin,9999,0,9999,0
1714214578317,CLRE 259,A00,507211,Patel; Hemal,9996,0,9999,3
1714214579342,CLRE 260,A00,507221,Cuomo; Raphael Eduardo,9999,0,9999,0
1714214580368,CLRE 297,001,507242,Cuomo; Raphael Eduardo,9999,0,9999,0
1714214581392,COGS 197,001,638244,Voytek; Bradley Thomas,9999,0,9999,0
1714214582416,CSE 191,A00,516875,Minnes Kemp; Mor Mia,9993,0,9999,6
1714214583443,CSE 197,001,637388,Minnes Kemp; Mor Mia,9998,0,9999,1
1714214584469,CSS 201S,A01,494383,Staff,35,0,35,0
1714214585497,CSS 202S,A01,494387,Staff,35,0,35,0
1714214586523,DSC 197,001,628532,Eldridge; Justin Matthew,9996,0,9999,3
1714214587547,EAP 100,A00,516065,Staff,9797,0,9999,202
1714214588575,ECE 45,A01,507414,Staff,33,0,60,27
1714214590628,ECE 111,A01,507420,Staff,21,0,50,29
1714214591654,ECE 197,001,548057,Sievenpiper; Daniel F.,9994,0,9999,5
1714214592679,EDS 115,A00,507243,Choi; Bailey Miyeon,12,0,28,16
1714214593705,EDS 117,A01,494379,Staff,0,1,30,30
1714214594731,EDS 125,A00,507246,Hopkins; Megan Beth,12,0,30,18
1714214595758,EDS 128A,A01,507264,Fargason; Sharon Gayle,14,0,26,12
1714214596786,EDS 128B,A01,507293,Pappas; Elizabeth,18,0,30,12
1714214597812,EDS 139,A00,507294,Fargason; Sharon Gayle,18,0,30,12
1714214597812,EDS 139,B00,507313,Pappas; Elizabeth,15,0,30,15
1714214598836,EDS 201,A00,507315,Staff,13,0,30,17
1714214599864,EDS 203,A01,507317,Halter; Christopher P.,12,0,30,18
1714214600892,EDS 204R,A01,507319,Halter; Christopher P.,0,3,30,30
1714214600892,EDS 204R,B01,507331,Heinzman; Erica M.,17,0,30,13
1714214601921,EDS 206R,A00,507332,Staff,0,4,30,30
1714214601921,EDS 206R,B00,507343,Staff,18,0,30,12
1714214602949,EDS 250,A00,507344,Hemans; Patricia Ann Benitez,22,0,40,18
1714214603978,EDS 281,A00,507345,Daly; Alan J.,18,0,18,0
1714214605005,EDS 284,A00,507350,Daly; Alan J.,16,0,16,0
1714214606033,EDS 286,A00,507359,Fine; Sarah,18,0,18,0
1714214607058,EDS 289C,A01,507361,Daly; Alan J.,18,0,18,0
1714214608083,EDS 290,A00,507366,Hofstetter; Carolyn,15,0,15,0
1714214609108,LIGM 5A,A00,507421,Fischer-Grunski; Eva K,18,0,20,2
1714214610137,LIGM 5B,A00,507423,Fischer-Grunski; Eva K,19,0,20,1
1714214611162,LIGM 5C,A00,507425,Fischer-Grunski; Eva K,19,0,20,1
1714214612188,LIIT 5AS,A00,507427,Carnelos; Chiara,20,0,20,0
1714214613213,LIIT 5BS,A00,507430,Carnelos; Chiara,20,0,20,0
1714214614240,LIIT 5CS,A00,507432,Carnelos; Chiara,20,0,20,0
1714214615269,LISP 5A,A00,507541,Munoz Sanchez; Alicia,11,0,20,9
1714214616294,LISP 5B,A00,507671,Munoz Sanchez; Alicia,9,0,20,11
1714214617319,LISP 5C,A00,507696,Munoz Sanchez; Alicia,9,0,20,11
1714214618346,MAE 197,001,528363,Boechler; Nicholas Sebastia,9998,0,9999,1
1714214619370,MATH 197,001,523477,Kedlaya; Kiran S.,9996,0,9999,3
1714214619370,MATH 197,002,563811,Zhang; Danna,9995,0,9999,4
1714214619370,MATH 197,003,628552,Dumitriu; Ioana,9998,0,9999,1
1714214620398,MCWP 40R,A00,518780,Staff,5,0,20,15
1714214620398,MCWP 40R,B00,518781,Staff,7,0,20,13
1714214620398,MCWP 40R,C00,518783,Staff,5,0,20,15
1714214621424,MCWP 50R,A00,518791,Staff,0,0,20,20
1714214621424,MCWP 50R,B00,518792,Staff,0,1,20,20
1714214621424,MCWP 50R,C00,518793,Staff,0,1,20,20
1714214621424,MCWP 50R,D00,518794,Staff,0,0,20,20
1714214621424,MCWP 50R,E00,518795,Staff,0,1,20,20
1714214621424,MCWP 50R,F00,518796,Staff,0,0,20,20
1714214621424,MCWP 50R,G00,518797,Staff,0,1,20,20
1714214622452,MMW 12R,A01,514034,Herbst; Matthew,0,1,16,16
1714214622452,MMW 12R,A02,514035,Herbst; Matthew,2,0,16,14
1714214623481,MMW 13R,A01,514037,Staff,0,4,16,16
1714214623481,MMW 13R,A02,514039,Staff,0,2,16,16
1714214623481,MMW 13R,A03,628519,Staff,0,2,16,16
1714214625532,SIO 295LS,A00,523233,Staff,13,0,30,17
1714214626560,SIO 295S,A00,523232,Staff,13,0,30,17
1714214627589,SIOC 290S,A01,637330,Merrifield; Mark A,28,0,30,2
1714214628615,SIOC 291S,A01,637333,Gabriel; Corey John,28,0,30,2
1714214629640,SOCI 117,A01,494376,Staff,0,2,5,5
1714214630666,WES 237B,A00,494380,Staff,9,0,20,11
1714214632725,AESE 279B,A00,494370,Wade; Jon P,0,0,33,33
1714214633750,AIP 197,001,627712,Vespa; Emanuel Ignacio,9998,0,9999,1
1714214634776,ANAR 135S,A00,494369,Braswell; Geoffrey E.,0,0,0,0
1714214635802,BENG 196,001,628496,Engler; Adam J.,9998,0,9999,1
1714214636832,CAT 124RS,A01,519847,Geibel; William,0,0,20,20
1714214637856,CAT 125RS,A01,515971,Geibel; William,0,0,20,20
1714214638885,CLRE 250,A00,511389,Morris; Sheldon,9993,0,9999,6
1714214639911,CLRE 251,A00,507176,Mehta; Ravindra L.,9993,0,9999,6
1714214639911,CLRE 251,B00,511410,Mehta; Ravindra L.,9998,0,9999,1
1714214640936,CLRE 252,A00,507189,Cuomo; Raphael Eduardo,9995,0,9999,4
1714214641963,CLRE 253,A00,507199,Vaida; Florin,9994,0,9999,5
1714214641963,CLRE 253,B00,507202,Vaida; Florin,9999,0,9999,0
1714214643041,CLRE 259,A00,507211,Patel; Hemal,9996,0,9999,3
1714214644067,CLRE 260,A00,507221,Cuomo; Raphael Eduardo,9999,0,9999,0
1714214645094,CLRE 297,001,507242,Cuomo; Raphael Eduardo,9999,0,9999,0
1714214646120,COGS 197,001,638244,Voytek; Bradley Thomas,9999,0,9999,0
1714214647145,CSE 191,A00,516875,Minnes Kemp; Mor Mia,9993,0,9999,6
1714214648173,CSE 197,001,637388,Minnes Kemp; Mor Mia,9998,0,9999,1
1714214649201,CSS 201S,A01,494383,Staff,35,0,35,0
1714214650228,CSS 202S,A01,494387,Staff,35,0,35,0
1714214651254,DSC 197,001,628532,Eldridge; Justin Matthew,9996,0,9999,3
1714214652280,EAP 100,A00,516065,Staff,9797,0,9999,202
1714214653305,ECE 45,A01,507414,Staff,33,0,60,27
1714214655353,ECE 111,A01,507420,Staff,21,0,50,29
1714214656377,ECE 197,001,548057,Sievenpiper; Daniel F.,9994,0,9999,5
1714214657403,EDS 115,A00,507243,Choi; Bailey Miyeon,12,0,28,16
1714214658432,EDS 117,A01,494379,Staff,0,1,30,30
1714214659458,EDS 125,A00,507246,Hopkins; Megan Beth,12,0,30,18
1714214660485,EDS 128A,A01,507264,Fargason; Sharon Gayle,14,0,26,12
1714214661512,EDS 128B,A01,507293,Pappas; Elizabeth,18,0,30,12
1714214662540,EDS 139,A00,507294,Fargason; Sharon Gayle,18,0,30,12
1714214662540,EDS 139,B00,507313,Pappas; Elizabeth,15,0,30,15
1714214663566,EDS 201,A00,507315,Staff,13,0,30,17
1714214664591,EDS 203,A01,507317,Halter; Christopher P.,12,0,30,18
1714214665615,EDS 204R,A01,507319,Halter; Christopher P.,0,3,30,30
1714214665615,EDS 204R,B01,507331,Heinzman; Erica M.,17,0,30,13
1714214666640,EDS 206R,A00,507332,Staff,0,4,30,30
1714214666640,EDS 206R,B00,507343,Staff,18,0,30,12
1714214667666,EDS 250,A00,507344,Hemans; Patricia Ann Benitez,22,0,40,18
1714214668691,EDS 281,A00,507345,Daly; Alan J.,18,0,18,0
1714214669717,EDS 284,A00,507350,Daly; Alan J.,16,0,16,0
1714214670744,EDS 286,A00,507359,Fine; Sarah,18,0,18,0
1714214671773,EDS 289C,A01,507361,Daly; Alan J.,18,0,18,0
1714214672798,EDS 290,A00,507366,Hofstetter; Carolyn,15,0,15,0
1714214673823,LIGM 5A,A00,507421,Fischer-Grunski; Eva K,18,0,20,2
1714214674852,LIGM 5B,A00,507423,Fischer-Grunski; Eva K,19,0,20,1
1714214675878,LIGM 5C,A00,507425,Fischer-Grunski; Eva K,19,0,20,1
1714214676904,LIIT 5AS,A00,507427,Carnelos; Chiara,20,0,20,0
1714214677929,LIIT 5BS,A00,507430,Carnelos; Chiara,20,0,20,0
1714214678954,LIIT 5CS,A00,507432,Carnelos; Chiara,20,0,20,0
1714214679979,LISP 5A,A00,507541,Munoz Sanchez; Alicia,11,0,20,9
1714214681009,LISP 5B,A00,507671,Munoz Sanchez; Alicia,9,0,20,11
1714214682038,LISP 5C,A00,507696,Munoz Sanchez; Alicia,9,0,20,11
1714214683064,MAE 197,001,528363,Boechler; Nicholas Sebastia,9998,0,9999,1
1714214684090,MATH 197,001,523477,Kedlaya; Kiran S.,9996,0,9999,3
1714214684090,MATH 197,002,563811,Zhang; Danna,9995,0,9999,4
1714214684090,MATH 197,003,628552,Dumitriu; Ioana,9998,0,9999,1
1714214685115,MCWP 40R,A00,518780,Staff,5,0,20,15
1714214685115,MCWP 40R,B00,518781,Staff,7,0,20,13
1714214685115,MCWP 40R,C00,518783,Staff,5,0,20,15
1714214686144,MCWP 50R,A00,518791,Staff,0,0,20,20
1714214686144,MCWP 50R,B00,518792,Staff,0,1,20,20
1714214686144,MCWP 50R,C00,518793,Staff,0,1,20,20
1714214686144,MCWP 50R,D00,518794,Staff,0,0,20,20
1714214686144,MCWP 50R,E00,518795,Staff,0,1,20,20
1714214686144,MCWP 50R,F00,518796,Staff,0,0,20,20
1714214686144,MCWP 50R,G00,518797,Staff,0,1,20,20
1714214687170,MMW 12R,A01,514034,Herbst; Matthew,0,1,16,16
1714214687170,MMW 12R,A02,514035,Herbst; Matthew,2,0,16,14
1714214688196,MMW 13R,A01,514037,Staff,0,4,16,16
1714214688196,MMW 13R,A02,514039,Staff,0,2,16,16
1714214688196,MMW 13R,A03,628519,Staff,0,2,16,16
1714214690253,SIO 295LS,A00,523233,Staff,13,0,30,17
1714214691277,SIO 295S,A00,523232,Staff,13,0,30,17
1714214692305,SIOC 290S,A01,637330,Merrifield; Mark A,28,0,30,2
1714214693335,SIOC 291S,A01,637333,Gabriel; Corey John,28,0,30,2
1714214694362,SOCI 117,A01,494376,Staff,0,2,5,5
1714214695389,WES 237B,A00,494380,Staff,9,0,20,11
1714214697451,AESE 279B,A00,494370,Wade; Jon P,0,0,33,33
1714214698476,AIP 197,001,627712,Vespa; Emanuel Ignacio,9998,0,9999,1
1714214699503,ANAR 135S,A00,494369,Braswell; Geoffrey E.,0,0,0,0
1714214700533,BENG 196,001,628496,Engler; Adam J.,9998,0,9999,1
1714214701559,CAT 124RS,A01,519847,Geibel; William,0,0,20,20
1714214702587,CAT 125RS,A01,515971,Geibel; William,0,0,20,20
1714214703611,CLRE 250,A00,511389,Morris; Sheldon,9993,0,9999,6
1714214704640,CLRE 251,A00,507176,Mehta; Ravindra L.,9993,0,9999,6
1714214704640,CLRE 251,B00,511410,Mehta; Ravindra L.,9998,0,9999,1
1714214705664,CLRE 252,A00,507189,Cuomo; Raphael Eduardo,9995,0,9999,4
1714214706688,CLRE 253,A00,507199,Vaida; Florin,9994,0,9999,5
1714214706688,CLRE 253,B00,507202,Vaida; Florin,9999,0,9999,0
1714214707712,CLRE 259,A00,507211,Patel; Hemal,9996,0,9999,3
1714214708737,CLRE 260,A00,507221,Cuomo; Raphael Eduardo,9999,0,9999,0
1714214709762,CLRE 297,001,507242,Cuomo; Raphael Eduardo,9999,0,9999,0
1714214710787,COGS 197,001,638244,Voytek; Bradley Thomas,9999,0,9999,0
1714214711815,CSE 191,A00,516875,Minnes Kemp; Mor Mia,9993,0,9999,6
1714214712842,CSE 197,001,637388,Minnes Kemp; Mor Mia,9998,0,9999,1
1714214713878,CSS 201S,A01,494383,Staff,35,0,35,0
1714214714906,CSS 202S,A01,494387,Staff,35,0,35,0
1714214715932,DSC 197,001,628532,Eldridge; Justin Matthew,9996,0,9999,3
1714214716957,EAP 100,A00,516065,Staff,9797,0,9999,202
1714214717982,ECE 45,A01,507414,Staff,33,0,60,27
1714214720037,ECE 111,A01,507420,Staff,21,0,50,29
1714214721062,ECE 197,001,548057,Sievenpiper; Daniel F.,9994,0,9999,5
1714214722087,EDS 115,A00,507243,Choi; Bailey Miyeon,12,0,28,16
1714214723116,EDS 117,A01,494379,Staff,0,1,30,30
1714214724139,EDS 125,A00,507246,Hopkins; Megan Beth,12,0,30,18
1714214725167,EDS 128A,A01,507264,Fargason; Sharon Gayle,14,0,26,12
1714214726193,EDS 128B,A01,507293,Pappas; Elizabeth,18,0,30,12
1714214727218,EDS 139,A00,507294,Fargason; Sharon Gayle,18,0,30,12
1714214727218,EDS 139,B00,507313,Pappas; Elizabeth,15,0,30,15
1714214728243,EDS 201,A00,507315,Staff,13,0,30,17
1714214729272,EDS 203,A01,507317,Halter; Christopher P.,12,0,30,18
1714214730296,EDS 204R,A01,507319,Halter; Christopher P.,0,3,30,30
1714214730296,EDS 204R,B01,507331,Heinzman; Erica M.,17,0,30,13
1714214731323,EDS 206R,A00,507332,Staff,0,4,30,30
1714214731323,EDS 206R,B00,507343,Staff,18,0,30,12
1714214732349,EDS 250,A00,507344,Hemans; Patricia Ann Benitez,22,0,40,18
1714214733376,EDS 281,A00,507345,Daly; Alan J.,18,0,18,0
1714214734402,EDS 284,A00,507350,Daly; Alan J.,16,0,16,0
1714214735430,EDS 286,A00,507359,Fine; Sarah,18,0,18,0
1714214736456,EDS 289C,A01,507361,Daly; Alan J.,18,0,18,0
1714214737481,EDS 290,A00,507366,Hofstetter; Carolyn,15,0,15,0
1714214738506,LIGM 5A,A00,507421,Fischer-Grunski; Eva K,18,0,20,2
1714214739531,LIGM 5B,A00,507423,Fischer-Grunski; Eva K,19,0,20,1
1714214740558,LIGM 5C,A00,507425,Fischer-Grunski; Eva K,19,0,20,1
1714214741582,LIIT 5AS,A00,507427,Carnelos; Chiara,20,0,20,0
1714214742610,LIIT 5BS,A00,507430,Carnelos; Chiara,20,0,20,0
1714214743638,LIIT 5CS,A00,507432,Carnelos; Chiara,20,0,20,0
1714214744668,LISP 5A,A00,507541,Munoz Sanchez; Alicia,11,0,20,9
1714214745697,LISP 5B,A00,507671,Munoz Sanchez; Alicia,9,0,20,11
1714214746777,LISP 5C,A00,507696,Munoz Sanchez; Alicia,9,0,20,11
1714214747803,MAE 197,001,528363,Boechler; Nicholas Sebastia,9998,0,9999,1
1714214748840,MATH 197,001,523477,Kedlaya; Kiran S.,9996,0,9999,3
1714214748840,MATH 197,002,563811,Zhang; Danna,9995,0,9999,4
1714214748840,MATH 197,003,628552,Dumitriu; Ioana,9998,0,9999,1
1714214749865,MCWP 40R,A00,518780,Staff,5,0,20,15
1714214749865,MCWP 40R,B00,518781,Staff,7,0,20,13
1714214749865,MCWP 40R,C00,518783,Staff,5,0,20,15
1714214750896,MCWP 50R,A00,518791,Staff,0,0,20,20
1714214750896,MCWP 50R,B00,518792,Staff,0,1,20,20
1714214750896,MCWP 50R,C00,518793,Staff,0,1,20,20
1714214750896,MCWP 50R,D00,518794,Staff,0,0,20,20
1714214750896,MCWP 50R,E00,518795,Staff,0,1,20,20
1714214750896,MCWP 50R,F00,518796,Staff,0,0,20,20
1714214750896,MCWP 50R,G00,518797,Staff,0,1,20,20
1714214751924,MMW 12R,A01,514034,Herbst; Matthew,0,1,16,16
1714214751924,MMW 12R,A02,514035,Herbst; Matthew,2,0,16,14
1714214752953,MMW 13R,A01,514037,Staff,0,4,16,16
1714214752953,MMW 13R,A02,514039,Staff,0,2,16,16
1714214752953,MMW 13R,A03,628519,Staff,0,2,16,16
1714214755009,SIO 295LS,A00,523233,Staff,13,0,30,17
1714214756035,SIO 295S,A00,523232,Staff,13,0,30,17
1714214757061,SIOC 290S,A01,637330,Merrifield; Mark A,28,0,30,2
1714214758089,SIOC 291S,A01,637333,Gabriel; Corey John,28,0,30,2
1714214759118,SOCI 117,A01,494376,Staff,0,2,5,5
1714214760142,WES 237B,A00,494380,Staff,9,0,20,11
1714214762210,AESE 279B,A00,494370,Wade; Jon P,0,0,33,33
1714214763239,AIP 197,001,627712,Vespa; Emanuel Ignacio,9998,0,9999,1
1714214764265,ANAR 135S,A00,494369,Braswell; Geoffrey E.,0,0,0,0
1714214765291,BENG 196,001,628496,Engler; Adam J.,9998,0,9999,1
1714214766315,CAT 124RS,A01,519847,Geibel; William,0,0,20,20
1714214767340,CAT 125RS,A01,515971,Geibel; William,0,0,20,20
1714214768365,CLRE 250,A00,511389,Morris; Sheldon,9993,0,9999,6
1714214769389,CLRE 251,A00,507176,Mehta; Ravindra L.,9993,0,9999,6
1714214769389,CLRE 251,B00,511410,Mehta; Ravindra L.,9998,0,9999,1
1714214770413,CLRE 252,A00,507189,Cuomo; Raphael Eduardo,9995,0,9999,4
1714214771442,CLRE 253,A00,507199,Vaida; Florin,9994,0,9999,5
1714214771442,CLRE 253,B00,507202,Vaida; Florin,9999,0,9999,0
1714214772470,CLRE 259,A00,507211,Patel; Hemal,9996,0,9999,3
1714214773495,CLRE 260,A00,507221,Cuomo; Raphael Eduardo,9999,0,9999,0
1714214774523,CLRE 297,001,507242,Cuomo; Raphael Eduardo,9999,0,9999,0
1714214775548,COGS 197,001,638244,Voytek; Bradley Thomas,9999,0,9999,0
1714214776575,CSE 191,A00,516875,Minnes Kemp; Mor Mia,9993,0,9999,6
1714214777600,CSE 197,001,637388,Minnes Kemp; Mor Mia,9998,0,9999,1
1714214778629,CSS 201S,A01,494383,Staff,35,0,35,0
1714214779654,CSS 202S,A01,494387,Staff,35,0,35,0
1714214780679,DSC 197,001,628532,Eldridge; Justin Matthew,9996,0,9999,3
1714214781704,EAP 100,A00,516065,Staff,9797,0,9999,202
1714214782729,ECE 45,A01,507414,Staff,33,0,60,27
1714214784783,ECE 111,A01,507420,Staff,21,0,50,29
1714214785811,ECE 197,001,548057,Sievenpiper; Daniel F.,9994,0,9999,5
1714214786836,EDS 115,A00,507243,Choi; Bailey Miyeon,12,0,28,16
1714214787863,EDS 117,A01,494379,Staff,0,1,30,30
1714214788888,EDS 125,A00,507246,Hopkins; Megan Beth,12,0,30,18
1714214789912,EDS 128A,A01,507264,Fargason; Sharon Gayle,14,0,26,12
1714214790937,EDS 128B,A01,507293,Pappas; Elizabeth,18,0,30,12
1714214791962,EDS 139,A00,507294,Fargason; Sharon Gayle,18,0,30,12
1714214791962,EDS 139,B00,507313,Pappas; Elizabeth,15,0,30,15
1714214792986,EDS 201,A00,507315,Staff,13,0,30,17
1714214794011,EDS 203,A01,507317,Halter; Christopher P.,12,0,30,18
1714214795039,EDS 204R,A01,507319,Halter; Christopher P.,0,3,30,30
1714214795039,EDS 204R,B01,507331,Heinzman; Erica M.,17,0,30,13
1714214796065,EDS 206R,A00,507332,Staff,0,4,30,30
1714214796065,EDS 206R,B00,507343,Staff,18,0,30,12
1714214797094,EDS 250,A00,507344,Hemans; Patricia Ann Benitez,22,0,40,18
1714214798120,EDS 281,A00,507345,Daly; Alan J.,18,0,18,0
1714214799146,EDS 284,A00,507350,Daly; Alan J.,16,0,16,0
1714214800175,EDS 286,A00,507359,Fine; Sarah,18,0,18,0
1714214801202,EDS 289C,A01,507361,Daly; Alan J.,18,0,18,0
1714214802228,EDS 290,A00,507366,Hofstetter; Carolyn,15,0,15,0
1714214803257,LIGM 5A,A00,507421,Fischer-Grunski; Eva K,18,0,20,2
1714214804282,LIGM 5B,A00,507423,Fischer-Grunski; Eva K,19,0,20,1
1714214805309,LIGM 5C,A00,507425,Fischer-Grunski; Eva K,19,0,20,1
1714214806338,LIIT 5AS,A00,507427,Carnelos; Chiara,20,0,20,0
1714214807365,LIIT 5BS,A00,507430,Carnelos; Chiara,20,0,20,0
1714214808392,LIIT 5CS,A00,507432,Carnelos; Chiara,20,0,20,0
1714214809418,LISP 5A,A00,507541,Munoz Sanchez; Alicia,11,0,20,9
1714214810445,LISP 5B,A00,507671,Munoz Sanchez; Alicia,9,0,20,11
1714214811470,LISP 5C,A00,507696,Munoz Sanchez; Alicia,9,0,20,11
1714214812495,MAE 197,001,528363,Boechler; Nicholas Sebastia,9998,0,9999,1
1714214813523,MATH 197,001,523477,Kedlaya; Kiran S.,9996,0,9999,3
1714214813523,MATH 197,002,563811,Zhang; Danna,9995,0,9999,4
1714214813523,MATH 197,003,628552,Dumitriu; Ioana,9998,0,9999,1
1714214814552,MCWP 40R,A00,518780,Staff,5,0,20,15
1714214814552,MCWP 40R,B00,518781,Staff,7,0,20,13
1714214814552,MCWP 40R,C00,518783,Staff,5,0,20,15
1714214815578,MCWP 50R,A00,518791,Staff,0,0,20,20
1714214815578,MCWP 50R,B00,518792,Staff,0,1,20,20
1714214815578,MCWP 50R,C00,518793,Staff,0,1,20,20
1714214815578,MCWP 50R,D00,518794,Staff,0,0,20,20
1714214815578,MCWP 50R,E00,518795,Staff,0,1,20,20
1714214815578,MCWP 50R,F00,518796,Staff,0,0,20,20
1714214815578,MCWP 50R,G00,518797,Staff,0,1,20,20
1714214816608,MMW 12R,A01,514034,Herbst; Matthew,0,1,16,16
1714214816608,MMW 12R,A02,514035,Herbst; Matthew,2,0,16,14
1714214817639,MMW 13R,A01,514037,Staff,0,4,16,16
1714214817639,MMW 13R,A02,514039,Staff,0,2,16,16
1714214817639,MMW 13R,A03,628519,Staff,0,2,16,16
1714214819696,SIO 295LS,A00,523233,Staff,13,0,30,17
1714214820722,SIO 295S,A00,523232,Staff,13,0,30,17
1714214821749,SIOC 290S,A01,637330,Merrifield; Mark A,28,0,30,2
1714214822775,SIOC 291S,A01,637333,Gabriel; Corey John,28,0,30,2
1714214823801,SOCI 117,A01,494376,Staff,0,2,5,5
1714214824827,WES 237B,A00,494380,Staff,9,0,20,11
1714214826912,AESE 279B,A00,494370,Wade; Jon P,0,0,33,33
1714214827938,AIP 197,001,627712,Vespa; Emanuel Ignacio,9998,0,9999,1
1714214828964,ANAR 135S,A00,494369,Braswell; Geoffrey E.,0,0,0,0
1714214829993,BENG 196,001,628496,Engler; Adam J.,9998,0,9999,1
1714214831019,CAT 124RS,A01,519847,Geibel; William,0,0,20,20
1714214832045,CAT 125RS,A01,515971,Geibel; William,0,0,20,20
1714214833076,CLRE 250,A00,511389,Morris; Sheldon,9993,0,9999,6
1714214834104,CLRE 251,A00,507176,Mehta; Ravindra L.,9993,0,9999,6
1714214834104,CLRE 251,B00,511410,Mehta; Ravindra L.,9998,0,9999,1
1714214835129,CLRE 252,A00,507189,Cuomo; Raphael Eduardo,9995,0,9999,4
1714214836159,CLRE 253,A00,507199,Vaida; Florin,9994,0,9999,5
1714214836159,CLRE 253,B00,507202,Vaida; Florin,9999,0,9999,0
1714214837185,CLRE 259,A00,507211,Patel; Hemal,9996,0,9999,3
1714214838209,CLRE 260,A00,507221,Cuomo; Raphael Eduardo,9999,0,9999,0
1714214839235,CLRE 297,001,507242,Cuomo; Raphael Eduardo,9999,0,9999,0
1714214840262,COGS 197,001,638244,Voytek; Bradley Thomas,9999,0,9999,0
1714214841290,CSE 191,A00,516875,Minnes Kemp; Mor Mia,9993,0,9999,6
1714214842316,CSE 197,001,637388,Minnes Kemp; Mor Mia,9998,0,9999,1
1714214843343,CSS 201S,A01,494383,Staff,35,0,35,0
1714214844376,CSS 202S,A01,494387,Staff,35,0,35,0
1714214845405,DSC 197,001,628532,Eldridge; Justin Matthew,9996,0,9999,3
1714214846433,EAP 100,A00,516065,Staff,9797,0,9999,202
1714214847459,ECE 45,A01,507414,Staff,33,0,60,27
1714214849515,ECE 111,A01,507420,Staff,21,0,50,29
1714214850593,ECE 197,001,548057,Sievenpiper; Daniel F.,9994,0,9999,5
1714214851617,EDS 115,A00,507243,Choi; Bailey Miyeon,12,0,28,16
1714214852645,EDS 117,A01,494379,Staff,0,1,30,30
1714214853672,EDS 125,A00,507246,Hopkins; Megan Beth,12,0,30,18
1714214854697,EDS 128A,A01,507264,Fargason; Sharon Gayle,14,0,26,12
1714214855726,EDS 128B,A01,507293,Pappas; Elizabeth,18,0,30,12
1714214856754,EDS 139,A00,507294,Fargason; Sharon Gayle,18,0,30,12
1714214856754,EDS 139,B00,507313,Pappas; Elizabeth,15,0,30,15
1714214857779,EDS 201,A00,507315,Staff,13,0,30,17
1714214858803,EDS 203,A01,507317,Halter; Christopher P.,12,0,30,18
1714214859832,EDS 204R,A01,507319,Halter; Christopher P.,0,3,30,30
1714214859832,EDS 204R,B01,507331,Heinzman; Erica M.,17,0,30,13
1714214860857,EDS 206R,A00,507332,Staff,0,4,30,30
1714214860857,EDS 206R,B00,507343,Staff,18,0,30,12
1714214861884,EDS 250,A00,507344,Hemans; Patricia Ann Benitez,22,0,40,18
1714214862908,EDS 281,A00,507345,Daly; Alan J.,18,0,18,0
1714214863935,EDS 284,A00,507350,Daly; Alan J.,16,0,16,0
1714214864967,EDS 286,A00,507359,Fine; Sarah,18,0,18,0
1714214865992,EDS 289C,A01,507361,Daly; Alan J.,18,0,18,0
1714214867016,EDS 290,A00,507366,Hofstetter; Carolyn,15,0,15,0
1714214868044,LIGM 5A,A00,507421,Fischer-Grunski; Eva K,18,0,20,2
1714214869072,LIGM 5B,A00,507423,Fischer-Grunski; Eva K,19,0,20,1
1714214870098,LIGM 5C,A00,507425,Fischer-Grunski; Eva K,19,0,20,1
1714214871124,LIIT 5AS,A00,507427,Carnelos; Chiara,20,0,20,0
1714214872152,LIIT 5BS,A00,507430,Carnelos; Chiara,20,0,20,0
1714214873177,LIIT 5CS,A00,507432,Carnelos; Chiara,20,0,20,0
1714214874207,LISP 5A,A00,507541,Munoz Sanchez; Alicia,11,0,20,9
1714214875237,LISP 5B,A00,507671,Munoz Sanchez; Alicia,9,0,20,11
1714214876263,LISP 5C,A00,507696,Munoz Sanchez; Alicia,9,0,20,11
1714214877288,MAE 197,001,528363,Boechler; Nicholas Sebastia,9998,0,9999,1
1714214878313,MATH 197,001,523477,Kedlaya; Kiran S.,9996,0,9999,3
1714214878313,MATH 197,002,563811,Zhang; Danna,9995,0,9999,4
1714214878313,MATH 197,003,628552,Dumitriu; Ioana,9998,0,9999,1
1714214879340,MCWP 40R,A00,518780,Staff,5,0,20,15
1714214879340,MCWP 40R,B00,518781,Staff,7,0,20,13
1714214879340,MCWP 40R,C00,518783,Staff,5,0,20,15
1714214880368,MCWP 50R,A00,518791,Staff,0,0,20,20
1714214880368,MCWP 50R,B00,518792,Staff,0,1,20,20
1714214880368,MCWP 50R,C00,518793,Staff,0,1,20,20
1714214880368,MCWP 50R,D00,518794,Staff,0,0,20,20
1714214880368,MCWP 50R,E00,518795,Staff,0,1,20,20
1714214880368,MCWP 50R,F00,518796,Staff,0,0,20,20
1714214880368,MCWP 50R,G00,518797,Staff,0,1,20,20
1714214881396,MMW 12R,A01,514034,Herbst; Matthew,0,1,16,16
1714214881396,MMW 12R,A02,514035,Herbst; Matthew,2,0,16,14
1714214882421,MMW 13R,A01,514037,Staff,0,4,16,16
1714214882421,MMW 13R,A02,514039,Staff,0,2,16,16
1714214882421,MMW 13R,A03,628519,Staff,0,2,16,16
1714214884477,SIO 295LS,A00,523233,Staff,13,0,30,17
1714214885505,SIO 295S,A00,523232,Staff,13,0,30,17
1714214886533,SIOC 290S,A01,637330,Merrifield; Mark A,28,0,30,2
1714214887562,SIOC 291S,A01,637333,Gabriel; Corey John,28,0,30,2
1714214888592,SOCI 117,A01,494376,Staff,0,2,5,5
1714214889619,WES 237B,A00,494380,Staff,9,0,20,11
1714214891694,AESE 279B,A00,494370,Wade; Jon P,0,0,33,33
1714214892724,AIP 197,001,627712,Vespa; Emanuel Ignacio,9998,0,9999,1
1714214893749,ANAR 135S,A00,494369,Braswell; Geoffrey E.,0,0,0,0
1714214894777,BENG 196,001,628496,Engler; Adam J.,9998,0,9999,1
1714214895807,CAT 124RS,A01,519847,Geibel; William,0,0,20,20
1714214896836,CAT 125RS,A01,515971,Geibel; William,0,0,20,20
1714214897863,CLRE 250,A00,511389,Morris; Sheldon,9993,0,9999,6
1714214898893,CLRE 251,A00,507176,Mehta; Ravindra L.,9993,0,9999,6
1714214898893,CLRE 251,B00,511410,Mehta; Ravindra L.,9998,0,9999,1
1714214899922,CLRE 252,A00,507189,Cuomo; Raphael Eduardo,9995,0,9999,4
1714214900951,CLRE 253,A00,507199,Vaida; Florin,9994,0,9999,5
1714214900951,CLRE 253,B00,507202,Vaida; Florin,9999,0,9999,0
1714214901980,CLRE 259,A00,507211,Patel; Hemal,9996,0,9999,3
1714214903006,CLRE 260,A00,507221,Cuomo; Raphael Eduardo,9999,0,9999,0
1714214904031,CLRE 297,001,507242,Cuomo; Raphael Eduardo,9999,0,9999,0
1714214905060,COGS 197,001,638244,Voytek; Bradley Thomas,9999,0,9999,0
1714214906087,CSE 191,A00,516875,Minnes Kemp; Mor Mia,9993,0,9999,6
1714214907112,CSE 197,001,637388,Minnes Kemp; Mor Mia,9998,0,9999,1
1714214908139,CSS 201S,A01,494383,Staff,35,0,35,0
1714214909170,CSS 202S,A01,494387,Staff,35,0,35,0
1714214910196,DSC 197,001,628532,Eldridge; Justin Matthew,9996,0,9999,3
1714214911221,EAP 100,A00,516065,Staff,9797,0,9999,202
1714214912252,ECE 45,A01,507414,Staff,33,0,60,27
1714214914304,ECE 111,A01,507420,Staff,21,0,50,29
1714214915335,ECE 197,001,548057,Sievenpiper; Daniel F.,9994,0,9999,5
1714214916363,EDS 115,A00,507243,Choi; Bailey Miyeon,12,0,28,16
1714214917389,EDS 117,A01,494379,Staff,0,1,30,30
1714214918415,EDS 125,A00,507246,Hopkins; Megan Beth,12,0,30,18
1714214919441,EDS 128A,A01,507264,Fargason; Sharon Gayle,14,0,26,12
1714214920466,EDS 128B,A01,507293,Pappas; Elizabeth,18,0,30,12
1714214921493,EDS 139,A00,507294,Fargason; Sharon Gayle,18,0,30,12
1714214921493,EDS 139,B00,507313,Pappas; Elizabeth,15,0,30,15
1714214922516,EDS 201,A00,507315,Staff,13,0,30,17
1714214923545,EDS 203,A01,507317,Halter; Christopher P.,12,0,30,18
1714214924576,EDS 204R,A01,507319,Halter; Christopher P.,0,3,30,30
1714214924576,EDS 204R,B01,507331,Heinzman; Erica M.,17,0,30,13
1714214925602,EDS 206R,A00,507332,Staff,0,4,30,30
1714214925602,EDS 206R,B00,507343,Staff,18,0,30,12
1714214926628,EDS 250,A00,507344,Hemans; Patricia Ann Benitez,22,0,40,18
1714214927654,EDS 281,A00,507345,Daly; Alan J.,18,0,18,0
1714214928678,EDS 284,A00,507350,Daly; Alan J.,16,0,16,0
1714214929705,EDS 286,A00,507359,Fine; Sarah,18,0,18,0
1714214930734,EDS 289C,A01,507361,Daly; Alan J.,18,0,18,0
1714214931759,EDS 290,A00,507366,Hofstetter; Carolyn,15,0,15,0
1714214932786,LIGM 5A,A00,507421,Fischer-Grunski; Eva K,18,0,20,2
1714214933812,LIGM 5B,A00,507423,Fischer-Grunski; Eva K,19,0,20,1
1714214934838,LIGM 5C,A00,507425,Fischer-Grunski; Eva K,19,0,20,1
1714214935869,LIIT 5AS,A00,507427,Carnelos; Chiara,20,0,20,0
1714214936895,LIIT 5BS,A00,507430,Carnelos; Chiara,20,0,20,0
1714214937924,LIIT 5CS,A00,507432,Carnelos; Chiara,20,0,20,0
1714214938950,LISP 5A,A00,507541,Munoz Sanchez; Alicia,11,0,20,9
1714214939978,LISP 5B,A00,507671,Munoz Sanchez; Alicia,9,0,20,11
1714214941003,LISP 5C,A00,507696,Munoz Sanchez; Alicia,9,0,20,11
1714214942029,MAE 197,001,528363,Boechler; Nicholas Sebastia,9998,0,9999,1
1714214943057,MATH 197,001,523477,Kedlaya; Kiran S.,9996,0,9999,3
1714214943057,MATH 197,002,563811,Zhang; Danna,9995,0,9999,4
1714214943057,MATH 197,003,628552,Dumitriu; Ioana,9998,0,9999,1
1714214944084,MCWP 40R,A00,518780,Staff,5,0,20,15
1714214944084,MCWP 40R,B00,518781,Staff,7,0,20,13
1714214944084,MCWP 40R,C00,518783,Staff,5,0,20,15
1714214945113,MCWP 50R,A00,518791,Staff,0,0,20,20
1714214945113,MCWP 50R,B00,518792,Staff,0,1,20,20
1714214945113,MCWP 50R,C00,518793,Staff,0,1,20,20
1714214945113,MCWP 50R,D00,518794,Staff,0,0,20,20
1714214945113,MCWP 50R,E00,518795,Staff,0,1,20,20
1714214945113,MCWP 50R,F00,518796,Staff,0,0,20,20
1714214945113,MCWP 50R,G00,518797,Staff,0,1,20,20
1714214946138,MMW 12R,A01,514034,Herbst; Matthew,0,1,16,16
1714214946138,MMW 12R,A02,514035,Herbst; Matthew,2,0,16,14
1714214947167,MMW 13R,A01,514037,Staff,0,4,16,16
1714214947167,MMW 13R,A02,514039,Staff,0,2,16,16
1714214947167,MMW 13R,A03,628519,Staff,0,2,16,16
1714214949218,SIO 295LS,A00,523233,Staff,13,0,30,17
1714214950244,SIO 295S,A00,523232,Staff,13,0,30,17
1714214951271,SIOC 290S,A01,637330,Merrifield; Mark A,28,0,30,2
1714214952296,SIOC 291S,A01,637333,Gabriel; Corey John,28,0,30,2
1714214953321,SOCI 117,A01,494376,Staff,0,2,5,5
1714214954405,WES 237B,A00,494380,Staff,9,0,20,11
1714214956476,AESE 279B,A00,494370,Wade; Jon P,0,0,33,33
1714214957505,AIP 197,001,627712,Vespa; Emanuel Ignacio,9998,0,9999,1
1714214958532,ANAR 135S,A00,494369,Braswell; Geoffrey E.,0,0,0,0
1714214959558,BENG 196,001,628496,Engler; Adam J.,9998,0,9999,1
1714214960585,CAT 124RS,A01,519847,Geibel; William,0,0,20,20
1714214961613,CAT 125RS,A01,515971,Geibel; William,0,0,20,20
1714214962640,CLRE 250,A00,511389,Morris; Sheldon,9993,0,9999,6
1714214963668,CLRE 251,A00,507176,Mehta; Ravindra L.,9993,0,9999,6
1714214963668,CLRE 251,B00,511410,Mehta; Ravindra L.,9998,0,9999,1
1714214964694,CLRE 252,A00,507189,Cuomo; Raphael Eduardo,9995,0,9999,4
1714214965725,CLRE 253,A00,507199,Vaida; Florin,9994,0,9999,5
1714214965725,CLRE 253,B00,507202,Vaida; Florin,9999,0,9999,0
1714214966751,CLRE 259,A00,507211,Patel; Hemal,9996,0,9999,3
1714214967776,CLRE 260,A00,507221,Cuomo; Raphael Eduardo,9999,0,9999,0
1714214968804,CLRE 297,001,507242,Cuomo; Raphael Eduardo,9999,0,9999,0
1714214969830,COGS 197,001,638244,Voytek; Bradley Thomas,9999,0,9999,0
1714214970859,CSE 191,A00,516875,Minnes Kemp; Mor Mia,9993,0,9999,6
1714214971884,CSE 197,001,637388,Minnes Kemp; Mor Mia,9998,0,9999,1
1714214972913,CSS 201S,A01,494383,Staff,35,0,35,0
1714214973939,CSS 202S,A01,494387,Staff,35,0,35,0
1714214974965,DSC 197,001,628532,Eldridge; Justin Matthew,9996,0,9999,3
1714214975989,EAP 100,A00,516065,Staff,9797,0,9999,202
1714214977017,ECE 45,A01,507414,Staff,33,0,60,27
1714214979068,ECE 111,A01,507420,Staff,21,0,50,29
1714214980094,ECE 197,001,548057,Sievenpiper; Daniel F.,9994,0,9999,5
1714214981121,EDS 115,A00,507243,Choi; Bailey Miyeon,12,0,28,16
1714214982148,EDS 117,A01,494379,Staff,0,1,30,30
1714214983174,EDS 125,A00,507246,Hopkins; Megan Beth,12,0,30,18
1714214984201,EDS 128A,A01,507264,Fargason; Sharon Gayle,14,0,26,12
1714214985227,EDS 128B,A01,507293,Pappas; Elizabeth,18,0,30,12
1714214986257,EDS 139,A00,507294,Fargason; Sharon Gayle,18,0,30,12
1714214986257,EDS 139,B00,507313,Pappas; Elizabeth,15,0,30,15
1714214987282,EDS 201,A00,507315,Staff,13,0,30,17
1714214988312,EDS 203,A01,507317,Halter; Christopher P.,12,0,30,18
1714214989343,EDS 204R,A01,507319,Halter; Christopher P.,0,3,30,30
1714214989343,EDS 204R,B01,507331,Heinzman; Erica M.,17,0,30,13
1714214990372,EDS 206R,A00,507332,Staff,0,4,30,30
1714214990372,EDS 206R,B00,507343,Staff,18,0,30,12
1714214991399,EDS 250,A00,507344,Hemans; Patricia Ann Benitez,22,0,40,18
1714214992426,EDS 281,A00,507345,Daly; Alan J.,18,0,18,0
1714214993451,EDS 284,A00,507350,Daly; Alan J.,16,0,16,0
1714214994478,EDS 286,A00,507359,Fine; Sarah,18,0,18,0
1714214995503,EDS 289C,A01,507361,Daly; Alan J.,18,0,18,0
1714214996529,EDS 290,A00,507366,Hofstetter; Carolyn,15,0,15,0
1714214997556,LIGM 5A,A00,507421,Fischer-Grunski; Eva K,18,0,20,2
1714214998586,LIGM 5B,A00,507423,Fischer-Grunski; Eva K,19,0,20,1
1714214999614,LIGM 5C,A00,507425,Fischer-Grunski; Eva K,19,0,20,1
1714215000645,LIIT 5AS,A00,507427,Carnelos; Chiara,20,0,20,0
1714215001671,LIIT 5BS,A00,507430,Carnelos; Chiara,20,0,20,0
1714215002701,LIIT 5CS,A00,507432,Carnelos; Chiara,20,0,20,0
1714215003729,LISP 5A,A00,507541,Munoz Sanchez; Alicia,11,0,20,9
1714215004754,LISP 5B,A00,507671,Munoz Sanchez; Alicia,9,0,20,11
1714215005779,LISP 5C,A00,507696,Munoz Sanchez; Alicia,9,0,20,11
1714215006809,MAE 197,001,528363,Boechler; Nicholas Sebastia,9998,0,9999,1
1714215007843,MATH 197,001,523477,Kedlaya; Kiran S.,9996,0,9999,3
1714215007843,MATH 197,002,563811,Zhang; Danna,9995,0,9999,4
1714215007843,MATH 197,003,628552,Dumitriu; Ioana,9998,0,9999,1
1714215008874,MCWP 40R,A00,518780,Staff,5,0,20,15
1714215008874,MCWP 40R,B00,518781,Staff,7,0,20,13
1714215008874,MCWP 40R,C00,518783,Staff,5,0,20,15
1714215009901,MCWP 50R,A00,518791,Staff,0,0,20,20
1714215009901,MCWP 50R,B00,518792,Staff,0,1,20,20
1714215009901,MCWP 50R,C00,518793,Staff,0,1,20,20
1714215009901,MCWP 50R,D00,518794,Staff,0,0,20,20
1714215009901,MCWP 50R,E00,518795,Staff,0,1,20,20
1714215009901,MCWP 50R,F00,518796,Staff,0,0,20,20
1714215009901,MCWP 50R,G00,518797,Staff,0,1,20,20
1714215010933,MMW 12R,A01,514034,Herbst; Matthew,0,1,16,16
1714215010933,MMW 12R,A02,514035,Herbst; Matthew,2,0,16,14
1714215011958,MMW 13R,A01,514037,Staff,0,4,16,16
1714215011958,MMW 13R,A02,514039,Staff,0,2,16,16
1714215011958,MMW 13R,A03,628519,Staff,0,2,16,16
1714215014010,SIO 295LS,A00,523233,Staff,13,0,30,17
1714215015033,SIO 295S,A00,523232,Staff,13,0,30,17
1714215016065,SIOC 290S,A01,637330,Merrifield; Mark A,28,0,30,2
1714215017092,SIOC 291S,A01,637333,Gabriel; Corey John,28,0,30,2
1714215018121,SOCI 117,A01,494376,Staff,0,2,5,5
1714215019149,WES 237B,A00,494380,Staff,9,0,20,11
1714215021223,AESE 279B,A00,494370,Wade; Jon P,0,0,33,33
1714215022250,AIP 197,001,627712,Vespa; Emanuel Ignacio,9998,0,9999,1
1714215023275,ANAR 135S,A00,494369,Braswell; Geoffrey E.,0,0,0,0
1714215024303,BENG 196,001,628496,Engler; Adam J.,9998,0,9999,1
1714215025333,CAT 124RS,A01,519847,Geibel; William,0,0,20,20
1714215026361,CAT 125RS,A01,515971,Geibel; William,0,0,20,20
1714215027388,CLRE 250,A00,511389,Morris; Sheldon,9993,0,9999,6
1714215028415,CLRE 251,A00,507176,Mehta; Ravindra L.,9993,0,9999,6
1714215028415,CLRE 251,B00,511410,Mehta; Ravindra L.,9998,0,9999,1
1714215029441,CLRE 252,A00,507189,Cuomo; Raphael Eduardo,9995,0,9999,4
1714215030471,CLRE 253,A00,507199,Vaida; Florin,9994,0,9999,5
1714215030471,CLRE 253,B00,507202,Vaida; Florin,9999,0,9999,0
1714215031502,CLRE 259,A00,507211,Patel; Hemal,9996,0,9999,3
1714215032528,CLRE 260,A00,507221,Cuomo; Raphael Eduardo,9999,0,9999,0
1714215033556,CLRE 297,001,507242,Cuomo; Raphael Eduardo,9999,0,9999,0
1714215034584,COGS 197,001,638244,Voytek; Bradley Thomas,9999,0,9999,0
1714215035611,CSE 191,A00,516875,Minnes Kemp; Mor Mia,9993,0,9999,6
1714215036637,CSE 197,001,637388,Minnes Kemp; Mor Mia,9998,0,9999,1
1714215037664,CSS 201S,A01,494383,Staff,35,0,35,0
1714215038693,CSS 202S,A01,494387,Staff,35,0,35,0
1714215039719,DSC 197,001,628532,Eldridge; Justin Matthew,9996,0,9999,3
1714215040744,EAP 100,A00,516065,Staff,9797,0,9999,202
1714215041771,ECE 45,A01,507414,Staff,33,0,60,27
1714215043826,ECE 111,A01,507420,Staff,21,0,50,29
1714215044854,ECE 197,001,548057,Sievenpiper; Daniel F.,9994,0,9999,5
1714215045882,EDS 115,A00,507243,Choi; Bailey Miyeon,12,0,28,16
1714215046914,EDS 117,A01,494379,Staff,0,1,30,30
1714215047941,EDS 125,A00,507246,Hopkins; Megan Beth,12,0,30,18
1714215048968,EDS 128A,A01,507264,Fargason; Sharon Gayle,14,0,26,12
1714215049996,EDS 128B,A01,507293,Pappas; Elizabeth,18,0,30,12
1714215051021,EDS 139,A00,507294,Fargason; Sharon Gayle,18,0,30,12
1714215051021,EDS 139,B00,507313,Pappas; Elizabeth,15,0,30,15
1714215052047,EDS 201,A00,507315,Staff,13,0,30,17
1714215053074,EDS 203,A01,507317,Halter; Christopher P.,12,0,30,18
1714215054100,EDS 204R,A01,507319,Halter; Christopher P.,0,3,30,30
1714215054100,EDS 204R,B01,507331,Heinzman; Erica M.,17,0,30,13
1714215055128,EDS 206R,A00,507332,Staff,0,4,30,30
1714215055128,EDS 206R,B00,507343,Staff,18,0,30,12
1714215056158,EDS 250,A00,507344,Hemans; Patricia Ann Benitez,22,0,40,18
1714215057184,EDS 281,A00,507345,Daly; Alan J.,18,0,18,0
1714215058264,EDS 284,A00,507350,Daly; Alan J.,16,0,16,0
1714215059294,EDS 286,A00,507359,Fine; Sarah,18,0,18,0
1714215060320,EDS 289C,A01,507361,Daly; Alan J.,18,0,18,0
1714215061346,EDS 290,A00,507366,Hofstetter; Carolyn,15,0,15,0
1714215062377,LIGM 5A,A00,507421,Fischer-Grunski; Eva K,18,0,20,2
1714215063402,LIGM 5B,A00,507423,Fischer-Grunski; Eva K,19,0,20,1
1714215064431,LIGM 5C,A00,507425,Fischer-Grunski; Eva K,19,0,20,1
1714215065464,LIIT 5AS,A00,507427,Carnelos; Chiara,20,0,20,0
1714215066490,LIIT 5BS,A00,507430,Carnelos; Chiara,20,0,20,0
1714215067516,LIIT 5CS,A00,507432,Carnelos; Chiara,20,0,20,0
1714215068547,LISP 5A,A00,507541,Munoz Sanchez; Alicia,11,0,20,9
1714215069572,LISP 5B,A00,507671,Munoz Sanchez; Alicia,9,0,20,11
1714215070601,LISP 5C,A00,507696,Munoz Sanchez; Alicia,9,0,20,11
1714215071626,MAE 197,001,528363,Boechler; Nicholas Sebastia,9998,0,9999,1
1714215072653,MATH 197,001,523477,Kedlaya; Kiran S.,9996,0,9999,3
1714215072653,MATH 197,002,563811,Zhang; Danna,9995,0,9999,4
1714215072653,MATH 197,003,628552,Dumitriu; Ioana,9998,0,9999,1
1714215073681,MCWP 40R,A00,518780,Staff,5,0,20,15
1714215073681,MCWP 40R,B00,518781,Staff,7,0,20,13
1714215073681,MCWP 40R,C00,518783,Staff,5,0,20,15
1714215074707,MCWP 50R,A00,518791,Staff,0,0,20,20
1714215074707,MCWP 50R,B00,518792,Staff,0,1,20,20
1714215074707,MCWP 50R,C00,518793,Staff,0,1,20,20
1714215074707,MCWP 50R,D00,518794,Staff,0,0,20,20
1714215074707,MCWP 50R,E00,518795,Staff,0,1,20,20
1714215074707,MCWP 50R,F00,518796,Staff,0,0,20,20
1714215074707,MCWP 50R,G00,518797,Staff,0,1,20,20
1714215075736,MMW 12R,A01,514034,Herbst; Matthew,0,1,16,16
1714215075736,MMW 12R,A02,514035,Herbst; Matthew,2,0,16,14
1714215076761,MMW 13R,A01,514037,Staff,0,4,16,16
1714215076761,MMW 13R,A02,514039,Staff,0,2,16,16
1714215076761,MMW 13R,A03,628519,Staff,0,2,16,16
1714215078812,SIO 295LS,A00,523233,Staff,13,0,30,17
1714215079840,SIO 295S,A00,523232,Staff,13,0,30,17
1714215080868,SIOC 290S,A01,637330,Merrifield; Mark A,28,0,30,2
1714215081894,SIOC 291S,A01,637333,Gabriel; Corey John,28,0,30,2
1714215082925,SOCI 117,A01,494376,Staff,0,2,5,5
1714215083951,WES 237B,A00,494380,Staff,9,0,20,11
1714215086028,AESE 279B,A00,494370,Wade; Jon P,0,0,33,33
1714215087057,AIP 197,001,627712,Vespa; Emanuel Ignacio,9998,0,9999,1
1714215088085,ANAR 135S,A00,494369,Braswell; Geoffrey E.,0,0,0,0
1714215089115,BENG 196,001,628496,Engler; Adam J.,9998,0,9999,1
1714215090147,CAT 124RS,A01,519847,Geibel; William,0,0,20,20
1714215091172,CAT 125RS,A01,515971,Geibel; William,0,0,20,20
1714215092199,CLRE 250,A00,511389,Morris; Sheldon,9993,0,9999,6
1714215093227,CLRE 251,A00,507176,Mehta; Ravindra L.,9993,0,9999,6
1714215093227,CLRE 251,B00,511410,Mehta; Ravindra L.,9998,0,9999,1
1714215094254,CLRE 252,A00,507189,Cuomo; Raphael Eduardo,9995,0,9999,4
1714215095281,CLRE 253,A00,507199,Vaida; Florin,9994,0,9999,5
1714215095281,CLRE 253,B00,507202,Vaida; Florin,9999,0,9999,0
1714215096307,CLRE 259,A00,507211,Patel; Hemal,9996,0,9999,3
1714215097333,CLRE 260,A00,507221,Cuomo; Raphael Eduardo,9999,0,9999,0
1714215098357,CLRE 297,001,507242,Cuomo; Raphael Eduardo,9999,0,9999,0
1714215099386,COGS 197,001,638244,Voytek; Bradley Thomas,9999,0,9999,0
1714215100412,CSE 191,A00,516875,Minnes Kemp; Mor Mia,9993,0,9999,6
1714215101437,CSE 197,001,637388,Minnes Kemp; Mor Mia,9998,0,9999,1
1714215102469,CSS 201S,A01,494383,Staff,35,0,35,0
1714215103502,CSS 202S,A01,494387,Staff,35,0,35,0
1714215104528,DSC 197,001,628532,Eldridge; Justin Matthew,9996,0,9999,3
1714215105554,EAP 100,A00,516065,Staff,9797,0,9999,202
1714215106582,ECE 45,A01,507414,Staff,33,0,60,27
1714215108637,ECE 111,A01,507420,Staff,21,0,50,29
1714215109668,ECE 197,001,548057,Sievenpiper; Daniel F.,9994,0,9999,5
1714215110699,EDS 115,A00,507243,Choi; Bailey Miyeon,12,0,28,16
1714215111730,EDS 117,A01,494379,Staff,0,1,30,30
1714215112762,EDS 125,A00,507246,Hopkins; Megan Beth,12,0,30,18
1714215113789,EDS 128A,A01,507264,Fargason; Sharon Gayle,14,0,26,12
1714215114814,EDS 128B,A01,507293,Pappas; Elizabeth,18,0,30,12
1714215115839,EDS 139,A00,507294,Fargason; Sharon Gayle,18,0,30,12
1714215115839,EDS 139,B00,507313,Pappas; Elizabeth,15,0,30,15
1714215116866,EDS 201,A00,507315,Staff,13,0,30,17
1714215117897,EDS 203,A01,507317,Halter; Christopher P.,12,0,30,18
1714215118928,EDS 204R,A01,507319,Halter; Christopher P.,0,3,30,30
1714215118928,EDS 204R,B01,507331,Heinzman; Erica M.,17,0,30,13
1714215119957,EDS 206R,A00,507332,Staff,0,4,30,30
1714215119957,EDS 206R,B00,507343,Staff,18,0,30,12
1714215120987,EDS 250,A00,507344,Hemans; Patricia Ann Benitez,22,0,40,18
1714215122012,EDS 281,A00,507345,Daly; Alan J.,18,0,18,0
1714215123044,EDS 284,A00,507350,Daly; Alan J.,16,0,16,0
1714215124069,EDS 286,A00,507359,Fine; Sarah,18,0,18,0
1714215125094,EDS 289C,A01,507361,Daly; Alan J.,18,0,18,0
1714215126119,EDS 290,A00,507366,Hofstetter; Carolyn,15,0,15,0
1714215127150,LIGM 5A,A00,507421,Fischer-Grunski; Eva K,18,0,20,2
1714215128177,LIGM 5B,A00,507423,Fischer-Grunski; Eva K,19,0,20,1
1714215129203,LIGM 5C,A00,507425,Fischer-Grunski; Eva K,19,0,20,1
1714215130229,LIIT 5AS,A00,507427,Carnelos; Chiara,20,0,20,0
1714215131256,LIIT 5BS,A00,507430,Carnelos; Chiara,20,0,20,0
1714215132281,LIIT 5CS,A00,507432,Carnelos; Chiara,20,0,20,0
1714215133305,LISP 5A,A00,507541,Munoz Sanchez; Alicia,11,0,20,9
1714215134334,LISP 5B,A00,507671,Munoz Sanchez; Alicia,9,0,20,11
1714215135364,LISP 5C,A00,507696,Munoz Sanchez; Alicia,9,0,20,11
1714215136393,MAE 197,001,528363,Boechler; Nicholas Sebastia,9998,0,9999,1
1714215137428,MATH 197,001,523477,Kedlaya; Kiran S.,9996,0,9999,3
1714215137428,MATH 197,002,563811,Zhang; Danna,9995,0,9999,4
1714215137428,MATH 197,003,628552,Dumitriu; Ioana,9998,0,9999,1
1714215138456,MCWP 40R,A00,518780,Staff,5,0,20,15
1714215138456,MCWP 40R,B00,518781,Staff,7,0,20,13
1714215138456,MCWP 40R,C00,518783,Staff,5,0,20,15
1714215139484,MCWP 50R,A00,518791,Staff,0,0,20,20
1714215139484,MCWP 50R,B00,518792,Staff,0,1,20,20
1714215139484,MCWP 50R,C00,518793,Staff,0,1,20,20
1714215139484,MCWP 50R,D00,518794,Staff,0,0,20,20
1714215139484,MCWP 50R,E00,518795,Staff,0,1,20,20
1714215139484,MCWP 50R,F00,518796,Staff,0,0,20,20
1714215139484,MCWP 50R,G00,518797,Staff,0,1,20,20
1714215140511,MMW 12R,A01,514034,Herbst; Matthew,0,1,16,16
1714215140511,MMW 12R,A02,514035,Herbst; Matthew,2,0,16,14
1714215141537,MMW 13R,A01,514037,Staff,0,4,16,16
1714215141537,MMW 13R,A02,514039,Staff,0,2,16,16
1714215141537,MMW 13R,A03,628519,Staff,0,2,16,16
1714215143588,SIO 295LS,A00,523233,Staff,13,0,30,17
1714215144615,SIO 295S,A00,523232,Staff,13,0,30,17
1714215145643,SIOC 290S,A01,637330,Merrifield; Mark A,28,0,30,2
1714215146731,SIOC 291S,A01,637333,Gabriel; Corey John,28,0,30,2
1714215147758,SOCI 117,A01,494376,Staff,0,2,5,5
1714215148785,WES 237B,A00,494380,Staff,9,0,20,11
1714215150859,AESE 279B,A00,494370,Wade; Jon P,0,0,33,33
1714215151890,AIP 197,001,627712,Vespa; Emanuel Ignacio,9998,0,9999,1
1714215152915,ANAR 135S,A00,494369,Braswell; Geoffrey E.,0,0,0,0
1714215153946,BENG 196,001,628496,Engler; Adam J.,9998,0,9999,1
1714215154973,CAT 124RS,A01,519847,Geibel; William,0,0,20,20
1714215156000,CAT 125RS,A01,515971,Geibel; William,0,0,20,20
1714215157027,CLRE 250,A00,511389,Morris; Sheldon,9993,0,9999,6
1714215158058,CLRE 251,A00,507176,Mehta; Ravindra L.,9993,0,9999,6
1714215158058,CLRE 251,B00,511410,Mehta; Ravindra L.,9998,0,9999,1
1714215159085,CLRE 252,A00,507189,Cuomo; Raphael Eduardo,9995,0,9999,4
1714215160117,CLRE 253,A00,507199,Vaida; Florin,9994,0,9999,5
1714215160117,CLRE 253,B00,507202,Vaida; Florin,9999,0,9999,0
1714215161143,CLRE 259,A00,507211,Patel; Hemal,9996,0,9999,3
1714215162225,CLRE 260,A00,507221,Cuomo; Raphael Eduardo,9999,0,9999,0
1714215163254,CLRE 297,001,507242,Cuomo; Raphael Eduardo,9999,0,9999,0
1714215164286,COGS 197,001,638244,Voytek; Bradley Thomas,9999,0,9999,0
1714215165312,CSE 191,A00,516875,Minnes Kemp; Mor Mia,9993,0,9999,6
1714215166342,CSE 197,001,637388,Minnes Kemp; Mor Mia,9998,0,9999,1
1714215167369,CSS 201S,A01,494383,Staff,35,0,35,0
1714215168395,CSS 202S,A01,494387,Staff,35,0,35,0
1714215169420,DSC 197,001,628532,Eldridge; Justin Matthew,9996,0,9999,3
1714215170447,EAP 100,A00,516065,Staff,9797,0,9999,202
1714215171476,ECE 45,A01,507414,Staff,33,0,60,27
1714215173531,ECE 111,A01,507420,Staff,21,0,50,29
1714215174561,ECE 197,001,548057,Sievenpiper; Daniel F.,9994,0,9999,5
1714215175587,EDS 115,A00,507243,Choi; Bailey Miyeon,12,0,28,16
1714215176613,EDS 117,A01,494379,Staff,0,1,30,30
1714215177639,EDS 125,A00,507246,Hopkins; Megan Beth,12,0,30,18
1714215178671,EDS 128A,A01,507264,Fargason; Sharon Gayle,14,0,26,12
1714215179703,EDS 128B,A01,507293,Pappas; Elizabeth,18,0,30,12
1714215180735,EDS 139,A00,507294,Fargason; Sharon Gayle,18,0,30,12
1714215180735,EDS 139,B00,507313,Pappas; Elizabeth,15,0,30,15
1714215181760,EDS 201,A00,507315,Staff,13,0,30,17
1714215182789,EDS 203,A01,507317,Halter; Christopher P.,12,0,30,18
1714215183820,EDS 204R,A01,507319,Halter; Christopher P.,0,3,30,30
1714215183820,EDS 204R,B01,507331,Heinzman; Erica M.,17,0,30,13
1714215184846,EDS 206R,A00,507332,Staff,0,4,30,30
1714215184846,EDS 206R,B00,507343,Staff,18,0,30,12
1714215185874,EDS 250,A00,507344,Hemans; Patricia Ann Benitez,22,0,40,18
1714215186899,EDS 281,A00,507345,Daly; Alan J.,18,0,18,0
1714215187927,EDS 284,A00,507350,Daly; Alan J.,16,0,16,0
1714215188958,EDS 286,A00,507359,Fine; Sarah,18,0,18,0
1714215189982,EDS 289C,A01,507361,Daly; Alan J.,18,0,18,0
1714215191013,EDS 290,A00,507366,Hofstetter; Carolyn,15,0,15,0
1714215192039,LIGM 5A,A00,507421,Fischer-Grunski; Eva K,18,0,20,2
1714215193065,LIGM 5B,A00,507423,Fischer-Grunski; Eva K,19,0,20,1
1714215194095,LIGM 5C,A00,507425,Fischer-Grunski; Eva K,19,0,20,1
1714215195122,LIIT 5AS,A00,507427,Carnelos; Chiara,20,0,20,0
1714215196151,LIIT 5BS,A00,507430,Carnelos; Chiara,20,0,20,0
1714215197176,LIIT 5CS,A00,507432,Carnelos; Chiara,20,0,20,0
1714215198208,LISP 5A,A00,507541,Munoz Sanchez; Alicia,11,0,20,9
1714215199237,LISP 5B,A00,507671,Munoz Sanchez; Alicia,9,0,20,11
1714215200262,LISP 5C,A00,507696,Munoz Sanchez; Alicia,9,0,20,11
1714215201292,MAE 197,001,528363,Boechler; Nicholas Sebastia,9998,0,9999,1
1714215202327,MATH 197,001,523477,Kedlaya; Kiran S.,9996,0,9999,3
1714215202327,MATH 197,002,563811,Zhang; Danna,9995,0,9999,4
1714215202327,MATH 197,003,628552,Dumitriu; Ioana,9998,0,9999,1
1714215203354,MCWP 40R,A00,518780,Staff,5,0,20,15
1714215203354,MCWP 40R,B00,518781,Staff,7,0,20,13
1714215203354,MCWP 40R,C00,518783,Staff,5,0,20,15
1714215204384,MCWP 50R,A00,518791,Staff,0,0,20,20
1714215204384,MCWP 50R,B00,518792,Staff,0,1,20,20
1714215204384,MCWP 50R,C00,518793,Staff,0,1,20,20
1714215204384,MCWP 50R,D00,518794,Staff,0,0,20,20
1714215204384,MCWP 50R,E00,518795,Staff,0,1,20,20
1714215204384,MCWP 50R,F00,518796,Staff,0,0,20,20
1714215204384,MCWP 50R,G00,518797,Staff,0,1,20,20
1714215205416,MMW 12R,A01,514034,Herbst; Matthew,0,1,16,16
1714215205416,MMW 12R,A02,514035,Herbst; Matthew,2,0,16,14
1714215206445,MMW 13R,A01,514037,Staff,0,4,16,16
1714215206445,MMW 13R,A02,514039,Staff,0,2,16,16
1714215206445,MMW 13R,A03,628519,Staff,0,2,16,16
1714215208496,SIO 295LS,A00,523233,Staff,13,0,30,17
1714215209521,SIO 295S,A00,523232,Staff,13,0,30,17
1714215210546,SIOC 290S,A01,637330,Merrifield; Mark A,28,0,30,2
1714215211577,SIOC 291S,A01,637333,Gabriel; Corey John,28,0,30,2
1714215212608,SOCI 117,A01,494376,Staff,0,2,5,5
1714215213635,WES 237B,A00,494380,Staff,9,0,20,11
1714215215702,AESE 279B,A00,494370,Wade; Jon P,0,0,33,33
1714215216731,AIP 197,001,627712,Vespa; Emanuel Ignacio,9998,0,9999,1
1714215217757,ANAR 135S,A00,494369,Braswell; Geoffrey E.,0,0,0,0
1714215218789,BENG 196,001,628496,Engler; Adam J.,9998,0,9999,1
1714215219815,CAT 124RS,A01,519847,Geibel; William,0,0,20,20
1714215220844,CAT 125RS,A01,515971,Geibel; William,0,0,20,20
1714215221870,CLRE 250,A00,511389,Morris; Sheldon,9993,0,9999,6
1714215222896,CLRE 251,A00,507176,Mehta; Ravindra L.,9993,0,9999,6
1714215222896,CLRE 251,B00,511410,Mehta; Ravindra L.,9998,0,9999,1
1714215223923,CLRE 252,A00,507189,Cuomo; Raphael Eduardo,9995,0,9999,4
1714215224953,CLRE 253,A00,507199,Vaida; Florin,9994,0,9999,5
1714215224953,CLRE 253,B00,507202,Vaida; Florin,9999,0,9999,0
1714215225978,CLRE 259,A00,507211,Patel; Hemal,9996,0,9999,3
1714215227002,CLRE 260,A00,507221,Cuomo; Raphael Eduardo,9999,0,9999,0
1714215228030,CLRE 297,001,507242,Cuomo; Raphael Eduardo,9999,0,9999,0
1714215229063,COGS 197,001,638244,Voytek; Bradley Thomas,9999,0,9999,0
1714215230088,CSE 191,A00,516875,Minnes Kemp; Mor Mia,9993,0,9999,6
1714215231113,CSE 197,001,637388,Minnes Kemp; Mor Mia,9998,0,9999,1
1714215232146,CSS 201S,A01,494383,Staff,35,0,35,0
1714215233170,CSS 202S,A01,494387,Staff,35,0,35,0
1714215234197,DSC 197,001,628532,Eldridge; Justin Matthew,9996,0,9999,3
1714215235225,EAP 100,A00,516065,Staff,9797,0,9999,202
1714215236251,ECE 45,A01,507414,Staff,33,0,60,27
1714215238300,ECE 111,A01,507420,Staff,21,0,50,29
1714215239325,ECE 197,001,548057,Sievenpiper; Daniel F.,9994,0,9999,5
1714215240351,EDS 115,A00,507243,Choi; Bailey Miyeon,12,0,28,16
1714215241381,EDS 117,A01,494379,Staff,0,1,30,30
1714215242407,EDS 125,A00,507246,Hopkins; Megan Beth,12,0,30,18
1714215243438,EDS 128A,A01,507264,Fargason; Sharon Gayle,14,0,26,12
1714215244463,EDS 128B,A01,507293,Pappas; Elizabeth,18,0,30,12
1714215245493,EDS 139,A00,507294,Fargason; Sharon Gayle,18,0,30,12
1714215245493,EDS 139,B00,507313,Pappas; Elizabeth,15,0,30,15
1714215246523,EDS 201,A00,507315,Staff,13,0,30,17
1714215247552,EDS 203,A01,507317,Halter; Christopher P.,12,0,30,18
1714215248578,EDS 204R,A01,507319,Halter; Christopher P.,0,3,30,30
1714215248578,EDS 204R,B01,507331,Heinzman; Erica M.,17,0,30,13
1714215249604,EDS 206R,A00,507332,Staff,0,4,30,30
1714215249604,EDS 206R,B00,507343,Staff,18,0,30,12
1714215250632,EDS 250,A00,507344,Hemans; Patricia Ann Benitez,22,0,40,18
1714215251657,EDS 281,A00,507345,Daly; Alan J.,18,0,18,0
1714215252683,EDS 284,A00,507350,Daly; Alan J.,16,0,16,0
1714215253714,EDS 286,A00,507359,Fine; Sarah,18,0,18,0
1714215254743,EDS 289C,A01,507361,Daly; Alan J.,18,0,18,0
1714215255769,EDS 290,A00,507366,Hofstetter; Carolyn,15,0,15,0
1714215256796,LIGM 5A,A00,507421,Fischer-Grunski; Eva K,18,0,20,2
1714215257826,LIGM 5B,A00,507423,Fischer-Grunski; Eva K,19,0,20,1
1714215258853,LIGM 5C,A00,507425,Fischer-Grunski; Eva K,19,0,20,1
1714215259877,LIIT 5AS,A00,507427,Carnelos; Chiara,20,0,20,0
1714215260908,LIIT 5BS,A00,507430,Carnelos; Chiara,20,0,20,0
1714215261938,LIIT 5CS,A00,507432,Carnelos; Chiara,20,0,20,0
1714215262969,LISP 5A,A00,507541,Munoz Sanchez; Alicia,11,0,20,9
1714215263994,LISP 5B,A00,507671,Munoz Sanchez; Alicia,9,0,20,11
1714215265021,LISP 5C,A00,507696,Munoz Sanchez; Alicia,9,0,20,11
1714215266105,MAE 197,001,528363,Boechler; Nicholas Sebastia,9998,0,9999,1
1714215267133,MATH 197,001,523477,Kedlaya; Kiran S.,9996,0,9999,3
1714215267133,MATH 197,002,563811,Zhang; Danna,9995,0,9999,4
1714215267133,MATH 197,003,628552,Dumitriu; Ioana,9998,0,9999,1
1714215268159,MCWP 40R,A00,518780,Staff,5,0,20,15
1714215268159,MCWP 40R,B00,518781,Staff,7,0,20,13
1714215268159,MCWP 40R,C00,518783,Staff,5,0,20,15
1714215269186,MCWP 50R,A00,518791,Staff,0,0,20,20
1714215269186,MCWP 50R,B00,518792,Staff,0,1,20,20
1714215269186,MCWP 50R,C00,518793,Staff,0,1,20,20
1714215269186,MCWP 50R,D00,518794,Staff,0,0,20,20
1714215269186,MCWP 50R,E00,518795,Staff,0,1,20,20
1714215269186,MCWP 50R,F00,518796,Staff,0,0,20,20
1714215269186,MCWP 50R,G00,518797,Staff,0,1,20,20
1714215270212,MMW 12R,A01,514034,Herbst; Matthew,0,1,16,16
1714215270212,MMW 12R,A02,514035,Herbst; Matthew,2,0,16,14
1714215271242,MMW 13R,A01,514037,Staff,0,4,16,16
1714215271242,MMW 13R,A02,514039,Staff,0,2,16,16
1714215271242,MMW 13R,A03,628519,Staff,0,2,16,16
1714215273294,SIO 295LS,A00,523233,Staff,13,0,30,17
1714215274321,SIO 295S,A00,523232,Staff,13,0,30,17
1714215275347,SIOC 290S,A01,637330,Merrifield; Mark A,28,0,30,2
1714215276372,SIOC 291S,A01,637333,Gabriel; Corey John,28,0,30,2
1714215277403,SOCI 117,A01,494376,Staff,0,2,5,5
1714215278432,WES 237B,A00,494380,Staff,9,0,20,11
1714215280497,AESE 279B,A00,494370,Wade; Jon P,0,0,33,33
1714215281523,AIP 197,001,627712,Vespa; Emanuel Ignacio,9998,0,9999,1
1714215282548,ANAR 135S,A00,494369,Braswell; Geoffrey E.,0,0,0,0
1714215283578,BENG 196,001,628496,Engler; Adam J.,9998,0,9999,1
1714215284612,CAT 124RS,A01,519847,Geibel; William,0,0,20,20
1714215285642,CAT 125RS,A01,515971,Geibel; William,0,0,20,20
1714215286672,CLRE 250,A00,511389,Morris; Sheldon,9993,0,9999,6
1714215287709,CLRE 251,A00,507176,Mehta; Ravindra L.,9993,0,9999,6
1714215287709,CLRE 251,B00,511410,Mehta; Ravindra L.,9998,0,9999,1
1714215288736,CLRE 252,A00,507189,Cuomo; Raphael Eduardo,9995,0,9999,4
1714215289767,CLRE 253,A00,507199,Vaida; Florin,9994,0,9999,5
1714215289767,CLRE 253,B00,507202,Vaida; Florin,9999,0,9999,0
1714215290793,CLRE 259,A00,507211,Patel; Hemal,9996,0,9999,3
1714215291818,CLRE 260,A00,507221,Cuomo; Raphael Eduardo,9999,0,9999,0
1714215292842,CLRE 297,001,507242,Cuomo; Raphael Eduardo,9999,0,9999,0
1714215293871,COGS 197,001,638244,Voytek; Bradley Thomas,9999,0,9999,0
1714215294896,CSE 191,A00,516875,Minnes Kemp; Mor Mia,9993,0,9999,6
1714215295924,CSE 197,001,637388,Minnes Kemp; Mor Mia,9998,0,9999,1
1714215296951,CSS 201S,A01,494383,Staff,35,0,35,0
1714215297979,CSS 202S,A01,494387,Staff,35,0,35,0
1714215299006,DSC 197,001,628532,Eldridge; Justin Matthew,9996,0,9999,3
1714215300039,EAP 100,A00,516065,Staff,9797,0,9999,202
1714215301066,ECE 45,A01,507414,Staff,33,0,60,27
1714215303122,ECE 111,A01,507420,Staff,21,0,50,29
1714215304148,ECE 197,001,548057,Sievenpiper; Daniel F.,9994,0,9999,5
1714215305178,EDS 115,A00,507243,Choi; Bailey Miyeon,12,0,28,16
1714215306205,EDS 117,A01,494379,Staff,0,1,30,30
1714215307234,EDS 125,A00,507246,Hopkins; Megan Beth,12,0,30,18
1714215308263,EDS 128A,A01,507264,Fargason; Sharon Gayle,14,0,26,12
1714215309288,EDS 128B,A01,507293,Pappas; Elizabeth,18,0,30,12
1714215310317,EDS 139,A00,507294,Fargason; Sharon Gayle,18,0,30,12
1714215310317,EDS 139,B00,507313,Pappas; Elizabeth,15,0,30,15
1714215311344,EDS 201,A00,507315,Staff,13,0,30,17
1714215312375,EDS 203,A01,507317,Halter; Christopher P.,12,0,30,18
1714215313406,EDS 204R,A01,507319,Halter; Christopher P.,0,3,30,30
1714215313406,EDS 204R,B01,507331,Heinzman; Erica M.,17,0,30,13
1714215314431,EDS 206R,A00,507332,Staff,0,4,30,30
1714215314431,EDS 206R,B00,507343,Staff,18,0,30,12
1714215315458,EDS 250,A00,507344,Hemans; Patricia Ann Benitez,22,0,40,18
1714215316483,EDS 281,A00,507345,Daly; Alan J.,18,0,18,0
1714215317508,EDS 284,A00,507350,Daly; Alan J.,16,0,16,0
1714215318538,EDS 286,A00,507359,Fine; Sarah,18,0,18,0
1714215319565,EDS 289C,A01,507361,Daly; Alan J.,18,0,18,0
1714215320590,EDS 290,A00,507366,Hofstetter; Carolyn,15,0,15,0
1714215321617,LIGM 5A,A00,507421,Fischer-Grunski; Eva K,18,0,20,2
1714215322641,LIGM 5B,A00,507423,Fischer-Grunski; Eva K,19,0,20,1
1714215323672,LIGM 5C,A00,507425,Fischer-Grunski; Eva K,19,0,20,1
1714215324698,LIIT 5AS,A00,507427,Carnelos; Chiara,20,0,20,0
1714215325724,LIIT 5BS,A00,507430,Carnelos; Chiara,20,0,20,0
1714215326749,LIIT 5CS,A00,507432,Carnelos; Chiara,20,0,20,0
1714215327775,LISP 5A,A00,507541,Munoz Sanchez; Alicia,11,0,20,9
1714215328803,LISP 5B,A00,507671,Munoz Sanchez; Alicia,9,0,20,11
1714215329829,LISP 5C,A00,507696,Munoz Sanchez; Alicia,9,0,20,11
1714215330856,MAE 197,001,528363,Boechler; Nicholas Sebastia,9998,0,9999,1
1714215331890,MATH 197,001,523477,Kedlaya; Kiran S.,9996,0,9999,3
1714215331890,MATH 197,002,563811,Zhang; Danna,9995,0,9999,4
1714215331890,MATH 197,003,628552,Dumitriu; Ioana,9998,0,9999,1
1714215332919,MCWP 40R,A00,518780,Staff,5,0,20,15
1714215332919,MCWP 40R,B00,518781,Staff,7,0,20,13
1714215332919,MCWP 40R,C00,518783,Staff,5,0,20,15
1714215333946,MCWP 50R,A00,518791,Staff,0,0,20,20
1714215333946,MCWP 50R,B00,518792,Staff,0,1,20,20
1714215333946,MCWP 50R,C00,518793,Staff,0,1,20,20
1714215333946,MCWP 50R,D00,518794,Staff,0,0,20,20
1714215333946,MCWP 50R,E00,518795,Staff,0,1,20,20
1714215333946,MCWP 50R,F00,518796,Staff,0,0,20,20
1714215333946,MCWP 50R,G00,518797,Staff,0,1,20,20
1714215334976,MMW 12R,A01,514034,Herbst; Matthew,0,1,16,16
1714215334976,MMW 12R,A02,514035,Herbst; Matthew,2,0,16,14
1714215336006,MMW 13R,A01,514037,Staff,0,4,16,16
1714215336006,MMW 13R,A02,514039,Staff,0,2,16,16
1714215336006,MMW 13R,A03,628519,Staff,0,2,16,16
1714215338058,SIO 295LS,A00,523233,Staff,13,0,30,17
1714215339082,SIO 295S,A00,523232,Staff,13,0,30,17
1714215340109,SIOC 290S,A01,637330,Merrifield; Mark A,28,0,30,2
1714215341134,SIOC 291S,A01,637333,Gabriel; Corey John,28,0,30,2
1714215342160,SOCI 117,A01,494376,Staff,0,2,5,5
1714215343186,WES 237B,A00,494380,Staff,9,0,20,11
1714215345262,AESE 279B,A00,494370,Wade; Jon P,0,0,33,33
1714215346289,AIP 197,001,627712,Vespa; Emanuel Ignacio,9998,0,9999,1
1714215347318,ANAR 135S,A00,494369,Braswell; Geoffrey E.,0,0,0,0
1714215348343,BENG 196,001,628496,Engler; Adam J.,9998,0,9999,1
1714215349371,CAT 124RS,A01,519847,Geibel; William,0,0,20,20
1714215350398,CAT 125RS,A01,515971,Geibel; William,0,0,20,20
1714215351431,CLRE 250,A00,511389,Morris; Sheldon,9993,0,9999,6
1714215352459,CLRE 251,A00,507176,Mehta; Ravindra L.,9993,0,9999,6
1714215352459,CLRE 251,B00,511410,Mehta; Ravindra L.,9998,0,9999,1
1714215353486,CLRE 252,A00,507189,Cuomo; Raphael Eduardo,9995,0,9999,4
1714215354511,CLRE 253,A00,507199,Vaida; Florin,9994,0,9999,5
1714215354511,CLRE 253,B00,507202,Vaida; Florin,9999,0,9999,0
1714215355538,CLRE 259,A00,507211,Patel; Hemal,9996,0,9999,3
1714215356568,CLRE 260,A00,507221,Cuomo; Raphael Eduardo,9999,0,9999,0
1714215357596,CLRE 297,001,507242,Cuomo; Raphael Eduardo,9999,0,9999,0
1714215358623,COGS 197,001,638244,Voytek; Bradley Thomas,9999,0,9999,0
1714215359655,CSE 191,A00,516875,Minnes Kemp; Mor Mia,9993,0,9999,6
1714215360682,CSE 197,001,637388,Minnes Kemp; Mor Mia,9998,0,9999,1
1714215361710,CSS 201S,A01,494383,Staff,35,0,35,0
1714215362739,CSS 202S,A01,494387,Staff,35,0,35,0
1714215363766,DSC 197,001,628532,Eldridge; Justin Matthew,9996,0,9999,3
1714215364791,EAP 100,A00,516065,Staff,9797,0,9999,202
1714215365818,ECE 45,A01,507414,Staff,33,0,60,27
1714215367874,ECE 111,A01,507420,Staff,21,0,50,29
1714215368901,ECE 197,001,548057,Sievenpiper; Daniel F.,9994,0,9999,5
1714215369984,EDS 115,A00,507243,Choi; Bailey Miyeon,12,0,28,16
1714215371013,EDS 117,A01,494379,Staff,0,1,30,30
1714215372038,EDS 125,A00,507246,Hopkins; Megan Beth,12,0,30,18
1714215373064,EDS 128A,A01,507264,Fargason; Sharon Gayle,14,0,26,12
1714215374088,EDS 128B,A01,507293,Pappas; Elizabeth,18,0,30,12
1714215375116,EDS 139,A00,507294,Fargason; Sharon Gayle,18,0,30,12
1714215375116,EDS 139,B00,507313,Pappas; Elizabeth,15,0,30,15
1714215376139,EDS 201,A00,507315,Staff,13,0,30,17
1714215377164,EDS 203,A01,507317,Halter; Christopher P.,12,0,30,18
1714215378189,EDS 204R,A01,507319,Halter; Christopher P.,0,3,30,30
1714215378189,EDS 204R,B01,507331,Heinzman; Erica M.,17,0,30,13
1714215379220,EDS 206R,A00,507332,Staff,0,4,30,30
1714215379220,EDS 206R,B00,507343,Staff,18,0,30,12
1714215380243,EDS 250,A00,507344,Hemans; Patricia Ann Benitez,22,0,40,18
1714215381269,EDS 281,A00,507345,Daly; Alan J.,18,0,18,0
1714215382295,EDS 284,A00,507350,Daly; Alan J.,16,0,16,0
1714215383321,EDS 286,A00,507359,Fine; Sarah,18,0,18,0
1714215384348,EDS 289C,A01,507361,Daly; Alan J.,18,0,18,0
1714215385372,EDS 290,A00,507366,Hofstetter; Carolyn,15,0,15,0
1714215386398,LIGM 5A,A00,507421,Fischer-Grunski; Eva K,18,0,20,2
1714215387423,LIGM 5B,A00,507423,Fischer-Grunski; Eva K,19,0,20,1
1714215388449,LIGM 5C,A00,507425,Fischer-Grunski; Eva K,19,0,20,1
1714215389478,LIIT 5AS,A00,507427,Carnelos; Chiara,20,0,20,0
1714215390504,LIIT 5BS,A00,507430,Carnelos; Chiara,20,0,20,0
1714215391532,LIIT 5CS,A00,507432,Carnelos; Chiara,20,0,20,0
1714215392557,LISP 5A,A00,507541,Munoz Sanchez; Alicia,11,0,20,9
1714215393585,LISP 5B,A00,507671,Munoz Sanchez; Alicia,9,0,20,11
1714215394611,LISP 5C,A00,507696,Munoz Sanchez; Alicia,9,0,20,11
1714215395637,MAE 197,001,528363,Boechler; Nicholas Sebastia,9998,0,9999,1
1714215396670,MATH 197,001,523477,Kedlaya; Kiran S.,9996,0,9999,3
1714215396670,MATH 197,002,563811,Zhang; Danna,9995,0,9999,4
1714215396670,MATH 197,003,628552,Dumitriu; Ioana,9998,0,9999,1
1714215397698,MCWP 40R,A00,518780,Staff,5,0,20,15
1714215397698,MCWP 40R,B00,518781,Staff,7,0,20,13
1714215397698,MCWP 40R,C00,518783,Staff,5,0,20,15
1714215398727,MCWP 50R,A00,518791,Staff,0,0,20,20
1714215398727,MCWP 50R,B00,518792,Staff,0,1,20,20
1714215398727,MCWP 50R,C00,518793,Staff,0,1,20,20
1714215398727,MCWP 50R,D00,518794,Staff,0,0,20,20
1714215398727,MCWP 50R,E00,518795,Staff,0,1,20,20
1714215398727,MCWP 50R,F00,518796,Staff,0,0,20,20
1714215398727,MCWP 50R,G00,518797,Staff,0,1,20,20
1714215399751,MMW 12R,A01,514034,Herbst; Matthew,0,1,16,16
1714215399751,MMW 12R,A02,514035,Herbst; Matthew,2,0,16,14
1714215400780,MMW 13R,A01,514037,Staff,0,4,16,16
1714215400780,MMW 13R,A02,514039,Staff,0,2,16,16
1714215400780,MMW 13R,A03,628519,Staff,0,2,16,16
1714215402829,SIO 295LS,A00,523233,Staff,13,0,30,17
1714215403866,SIO 295S,A00,523232,Staff,13,0,30,17
1714215404895,SIOC 290S,A01,637330,Merrifield; Mark A,28,0,30,2
1714215405921,SIOC 291S,A01,637333,Gabriel; Corey John,28,0,30,2
1714215406948,SOCI 117,A01,494376,Staff,0,2,5,5
1714215407975,WES 237B,A00,494380,Staff,9,0,20,11
1714215410049,AESE 279B,A00,494370,Wade; Jon P,0,0,33,33
1714215411074,AIP 197,001,627712,Vespa; Emanuel Ignacio,9998,0,9999,1
1714215412098,ANAR 135S,A00,494369,Braswell; Geoffrey E.,0,0,0,0
1714215413123,BENG 196,001,628496,Engler; Adam J.,9998,0,9999,1
1714215414147,CAT 124RS,A01,519847,Geibel; William,0,0,20,20
1714215415175,CAT 125RS,A01,515971,Geibel; William,0,0,20,20
1714215416200,CLRE 250,A00,511389,Morris; Sheldon,9993,0,9999,6
1714215417226,CLRE 251,A00,507176,Mehta; Ravindra L.,9993,0,9999,6
1714215417226,CLRE 251,B00,511410,Mehta; Ravindra L.,9998,0,9999,1
1714215418253,CLRE 252,A00,507189,Cuomo; Raphael Eduardo,9995,0,9999,4
1714215419278,CLRE 253,A00,507199,Vaida; Florin,9994,0,9999,5
1714215419278,CLRE 253,B00,507202,Vaida; Florin,9999,0,9999,0
1714215420303,CLRE 259,A00,507211,Patel; Hemal,9996,0,9999,3
1714215421332,CLRE 260,A00,507221,Cuomo; Raphael Eduardo,9999,0,9999,0
1714215422359,CLRE 297,001,507242,Cuomo; Raphael Eduardo,9999,0,9999,0
1714215423385,COGS 197,001,638244,Voytek; Bradley Thomas,9999,0,9999,0
1714215424414,CSE 191,A00,516875,Minnes Kemp; Mor Mia,9993,0,9999,6
1714215425440,CSE 197,001,637388,Minnes Kemp; Mor Mia,9998,0,9999,1
1714215426472,CSS 201S,A01,494383,Staff,35,0,35,0
1714215427501,CSS 202S,A01,494387,Staff,35,0,35,0
1714215428526,DSC 197,001,628532,Eldridge; Justin Matthew,9996,0,9999,3
1714215429550,EAP 100,A00,516065,Staff,9797,0,9999,202
1714215430577,ECE 45,A01,507414,Staff,33,0,60,27
1714215432630,ECE 111,A01,507420,Staff,21,0,50,29
1714215433659,ECE 197,001,548057,Sievenpiper; Daniel F.,9994,0,9999,5
1714215434684,EDS 115,A00,507243,Choi; Bailey Miyeon,12,0,28,16
1714215435713,EDS 117,A01,494379,Staff,0,1,30,30
1714215436742,EDS 125,A00,507246,Hopkins; Megan Beth,12,0,30,18
1714215437772,EDS 128A,A01,507264,Fargason; Sharon Gayle,14,0,26,12
1714215438801,EDS 128B,A01,507293,Pappas; Elizabeth,18,0,30,12
1714215439827,EDS 139,A00,507294,Fargason; Sharon Gayle,18,0,30,12
1714215439827,EDS 139,B00,507313,Pappas; Elizabeth,15,0,30,15
1714215440853,EDS 201,A00,507315,Staff,13,0,30,17
1714215441883,EDS 203,A01,507317,Halter; Christopher P.,12,0,30,18
1714215442908,EDS 204R,A01,507319,Halter; Christopher P.,0,3,30,30
1714215442908,EDS 204R,B01,507331,Heinzman; Erica M.,17,0,30,13
1714215443934,EDS 206R,A00,507332,Staff,0,4,30,30
1714215443934,EDS 206R,B00,507343,Staff,18,0,30,12
1714215444960,EDS 250,A00,507344,Hemans; Patricia Ann Benitez,22,0,40,18
1714215445985,EDS 281,A00,507345,Daly; Alan J.,18,0,18,0
1714215447011,EDS 284,A00,507350,Daly; Alan J.,16,0,16,0
1714215448037,EDS 286,A00,507359,Fine; Sarah,18,0,18,0
1714215449066,EDS 289C,A01,507361,Daly; Alan J.,18,0,18,0
1714215450094,EDS 290,A00,507366,Hofstetter; Carolyn,15,0,15,0
1714215451119,LIGM 5A,A00,507421,Fischer-Grunski; Eva K,18,0,20,2
1714215452146,LIGM 5B,A00,507423,Fischer-Grunski; Eva K,19,0,20,1
1714215453176,LIGM 5C,A00,507425,Fischer-Grunski; Eva K,19,0,20,1
1714215454203,LIIT 5AS,A00,507427,Carnelos; Chiara,20,0,20,0
1714215455229,LIIT 5BS,A00,507430,Carnelos; Chiara,20,0,20,0
1714215456253,LIIT 5CS,A00,507432,Carnelos; Chiara,20,0,20,0
1714215457284,LISP 5A,A00,507541,Munoz Sanchez; Alicia,11,0,20,9
1714215458311,LISP 5B,A00,507671,Munoz Sanchez; Alicia,9,0,20,11
1714215459335,LISP 5C,A00,507696,Munoz Sanchez; Alicia,9,0,20,11
1714215460361,MAE 197,001,528363,Boechler; Nicholas Sebastia,9998,0,9999,1
1714215461390,MATH 197,001,523477,Kedlaya; Kiran S.,9996,0,9999,3
1714215461390,MATH 197,002,563811,Zhang; Danna,9995,0,9999,4
1714215461390,MATH 197,003,628552,Dumitriu; Ioana,9998,0,9999,1
1714215462420,MCWP 40R,A00,518780,Staff,5,0,20,15
1714215462420,MCWP 40R,B00,518781,Staff,7,0,20,13
1714215462420,MCWP 40R,C00,518783,Staff,5,0,20,15
1714215463448,MCWP 50R,A00,518791,Staff,0,0,20,20
1714215463448,MCWP 50R,B00,518792,Staff,0,1,20,20
1714215463448,MCWP 50R,C00,518793,Staff,0,1,20,20
1714215463448,MCWP 50R,D00,518794,Staff,0,0,20,20
1714215463448,MCWP 50R,E00,518795,Staff,0,1,20,20
1714215463448,MCWP 50R,F00,518796,Staff,0,0,20,20
1714215463448,MCWP 50R,G00,518797,Staff,0,1,20,20
1714215464477,MMW 12R,A01,514034,Herbst; Matthew,0,1,16,16
1714215464477,MMW 12R,A02,514035,Herbst; Matthew,2,0,16,14
1714215465503,MMW 13R,A01,514037,Staff,0,4,16,16
1714215465503,MMW 13R,A02,514039,Staff,0,2,16,16
1714215465503,MMW 13R,A03,628519,Staff,0,2,16,16
1714215467554,SIO 295LS,A00,523233,Staff,13,0,30,17
1714215468580,SIO 295S,A00,523232,Staff,13,0,30,17
1714215469611,SIOC 290S,A01,637330,Merrifield; Mark A,28,0,30,2
1714215470639,SIOC 291S,A01,637333,Gabriel; Corey John,28,0,30,2
1714215471668,SOCI 117,A01,494376,Staff,0,2,5,5
1714215472694,WES 237B,A00,494380,Staff,9,0,20,11
1714215474820,AESE 279B,A00,494370,Wade; Jon P,0,0,33,33
1714215475845,AIP 197,001,627712,Vespa; Emanuel Ignacio,9998,0,9999,1
1714215476870,ANAR 135S,A00,494369,Braswell; Geoffrey E.,0,0,0,0
1714215477896,BENG 196,001,628496,Engler; Adam J.,9998,0,9999,1
1714215478922,CAT 124RS,A01,519847,Geibel; William,0,0,20,20
1714215479948,CAT 125RS,A01,515971,Geibel; William,0,0,20,20
1714215480973,CLRE 250,A00,511389,Morris; Sheldon,9993,0,9999,6
1714215481999,CLRE 251,A00,507176,Mehta; Ravindra L.,9993,0,9999,6
1714215481999,CLRE 251,B00,511410,Mehta; Ravindra L.,9998,0,9999,1
1714215483025,CLRE 252,A00,507189,Cuomo; Raphael Eduardo,9995,0,9999,4
1714215484053,CLRE 253,A00,507199,Vaida; Florin,9994,0,9999,5
1714215484053,CLRE 253,B00,507202,Vaida; Florin,9999,0,9999,0
1714215485079,CLRE 259,A00,507211,Patel; Hemal,9996,0,9999,3
1714215486103,CLRE 260,A00,507221,Cuomo; Raphael Eduardo,9999,0,9999,0
1714215487128,CLRE 297,001,507242,Cuomo; Raphael Eduardo,9999,0,9999,0
1714215488156,COGS 197,001,638244,Voytek; Bradley Thomas,9999,0,9999,0
1714215489181,CSE 191,A00,516875,Minnes Kemp; Mor Mia,9993,0,9999,6
1714215490210,CSE 197,001,637388,Minnes Kemp; Mor Mia,9998,0,9999,1
1714215491239,CSS 201S,A01,494383,Staff,35,0,35,0
1714215492265,CSS 202S,A01,494387,Staff,35,0,35,0
1714215493291,DSC 197,001,628532,Eldridge; Justin Matthew,9996,0,9999,3
1714215494319,EAP 100,A00,516065,Staff,9797,0,9999,202
1714215495344,ECE 45,A01,507414,Staff,33,0,60,27
1714215497396,ECE 111,A01,507420,Staff,21,0,50,29
1714215498424,ECE 197,001,548057,Sievenpiper; Daniel F.,9994,0,9999,5
1714215499449,EDS 115,A00,507243,Choi; Bailey Miyeon,12,0,28,16
1714215500475,EDS 117,A01,494379,Staff,0,1,30,30
1714215501502,EDS 125,A00,507246,Hopkins; Megan Beth,12,0,30,18
1714215502527,EDS 128A,A01,507264,Fargason; Sharon Gayle,14,0,26,12
1714215503552,EDS 128B,A01,507293,Pappas; Elizabeth,18,0,30,12
1714215504577,EDS 139,A00,507294,Fargason; Sharon Gayle,18,0,30,12
1714215504577,EDS 139,B00,507313,Pappas; Elizabeth,15,0,30,15
1714215505604,EDS 201,A00,507315,Staff,13,0,30,17
1714215506632,EDS 203,A01,507317,Halter; Christopher P.,12,0,30,18
1714215507658,EDS 204R,A01,507319,Halter; Christopher P.,0,3,30,30
1714215507658,EDS 204R,B01,507331,Heinzman; Erica M.,17,0,30,13
1714215508687,EDS 206R,A00,507332,Staff,0,4,30,30
1714215508687,EDS 206R,B00,507343,Staff,18,0,30,12
1714215509712,EDS 250,A00,507344,Hemans; Patricia Ann Benitez,22,0,40,18
1714215510738,EDS 281,A00,507345,Daly; Alan J.,18,0,18,0
1714215511764,EDS 284,A00,507350,Daly; Alan J.,16,0,16,0
1714215512790,EDS 286,A00,507359,Fine; Sarah,18,0,18,0
1714215513816,EDS 289C,A01,507361,Daly; Alan J.,18,0,18,0
1714215514841,EDS 290,A00,507366,Hofstetter; Carolyn,15,0,15,0
1714215515869,LIGM 5A,A00,507421,Fischer-Grunski; Eva K,18,0,20,2
1714215516898,LIGM 5B,A00,507423,Fischer-Grunski; Eva K,19,0,20,1
1714215517929,LIGM 5C,A00,507425,Fischer-Grunski; Eva K,19,0,20,1
1714215518956,LIIT 5AS,A00,507427,Carnelos; Chiara,20,0,20,0
1714215519981,LIIT 5BS,A00,507430,Carnelos; Chiara,20,0,20,0
1714215521008,LIIT 5CS,A00,507432,Carnelos; Chiara,20,0,20,0
1714215522037,LISP 5A,A00,507541,Munoz Sanchez; Alicia,11,0,20,9
1714215523066,LISP 5B,A00,507671,Munoz Sanchez; Alicia,9,0,20,11
1714215524095,LISP 5C,A00,507696,Munoz Sanchez; Alicia,9,0,20,11
1714215525120,MAE 197,001,528363,Boechler; Nicholas Sebastia,9998,0,9999,1
1714215526149,MATH 197,001,523477,Kedlaya; Kiran S.,9996,0,9999,3
1714215526149,MATH 197,002,563811,Zhang; Danna,9995,0,9999,4
1714215526149,MATH 197,003,628552,Dumitriu; Ioana,9998,0,9999,1
1714215527181,MCWP 40R,A00,518780,Staff,5,0,20,15
1714215527181,MCWP 40R,B00,518781,Staff,7,0,20,13
1714215527181,MCWP 40R,C00,518783,Staff,5,0,20,15
1714215528210,MCWP 50R,A00,518791,Staff,0,0,20,20
1714215528210,MCWP 50R,B00,518792,Staff,0,1,20,20
1714215528210,MCWP 50R,C00,518793,Staff,0,1,20,20
1714215528210,MCWP 50R,D00,518794,Staff,0,0,20,20
1714215528210,MCWP 50R,E00,518795,Staff,0,1,20,20
1714215528210,MCWP 50R,F00,518796,Staff,0,0,20,20
1714215528210,MCWP 50R,G00,518797,Staff,0,1,20,20
1714215529237,MMW 12R,A01,514034,Herbst; Matthew,0,1,16,16
1714215529237,MMW 12R,A02,514035,Herbst; Matthew,2,0,16,14
1714215530263,MMW 13R,A01,514037,Staff,0,4,16,16
1714215530263,MMW 13R,A02,514039,Staff,0,2,16,16
1714215530263,MMW 13R,A03,628519,Staff,0,2,16,16
1714215532317,SIO 295LS,A00,523233,Staff,13,0,30,17
1714215533342,SIO 295S,A00,523232,Staff,13,0,30,17
1714215534373,SIOC 290S,A01,637330,Merrifield; Mark A,28,0,30,2
1714215535400,SIOC 291S,A01,637333,Gabriel; Corey John,28,0,30,2
1714215536429,SOCI 117,A01,494376,Staff,0,2,5,5
1714215537455,WES 237B,A00,494380,Staff,9,0,20,11
1714215539526,AESE 279B,A00,494370,Wade; Jon P,0,0,33,33
1714215540556,AIP 197,001,627712,Vespa; Emanuel Ignacio,9998,0,9999,1
1714215541581,ANAR 135S,A00,494369,Braswell; Geoffrey E.,0,0,0,0
1714215542611,BENG 196,001,628496,Engler; Adam J.,9998,0,9999,1
1714215543641,CAT 124RS,A01,519847,Geibel; William,0,0,20,20
1714215544665,CAT 125RS,A01,515971,Geibel; William,0,0,20,20
1714215545692,CLRE 250,A00,511389,Morris; Sheldon,9993,0,9999,6
1714215546718,CLRE 251,A00,507176,Mehta; Ravindra L.,9993,0,9999,6
1714215546718,CLRE 251,B00,511410,Mehta; Ravindra L.,9998,0,9999,1
1714215547745,CLRE 252,A00,507189,Cuomo; Raphael Eduardo,9995,0,9999,4
1714215548772,CLRE 253,A00,507199,Vaida; Florin,9994,0,9999,5
1714215548772,CLRE 253,B00,507202,Vaida; Florin,9999,0,9999,0
1714215549801,CLRE 259,A00,507211,Patel; Hemal,9996,0,9999,3
1714215550825,CLRE 260,A00,507221,Cuomo; Raphael Eduardo,9999,0,9999,0
1714215551854,CLRE 297,001,507242,Cuomo; Raphael Eduardo,9999,0,9999,0
1714215552881,COGS 197,001,638244,Voytek; Bradley Thomas,9999,0,9999,0
1714215553907,CSE 191,A00,516875,Minnes Kemp; Mor Mia,9993,0,9999,6
1714215554932,CSE 197,001,637388,Minnes Kemp; Mor Mia,9998,0,9999,1
1714215555959,CSS 201S,A01,494383,Staff,35,0,35,0
1714215556989,CSS 202S,A01,494387,Staff,35,0,35,0
1714215558015,DSC 197,001,628532,Eldridge; Justin Matthew,9996,0,9999,3
1714215559048,EAP 100,A00,516065,Staff,9797,0,9999,202
1714215560075,ECE 45,A01,507414,Staff,33,0,60,27
1714215562128,ECE 111,A01,507420,Staff,21,0,50,29
1714215563158,ECE 197,001,548057,Sievenpiper; Daniel F.,9994,0,9999,5
1714215564186,EDS 115,A00,507243,Choi; Bailey Miyeon,12,0,28,16
1714215565212,EDS 117,A01,494379,Staff,0,1,30,30
1714215566237,EDS 125,A00,507246,Hopkins; Megan Beth,12,0,30,18
1714215567263,EDS 128A,A01,507264,Fargason; Sharon Gayle,14,0,26,12
1714215568289,EDS 128B,A01,507293,Pappas; Elizabeth,18,0,30,12
1714215569317,EDS 139,A00,507294,Fargason; Sharon Gayle,18,0,30,12
1714215569317,EDS 139,B00,507313,Pappas; Elizabeth,15,0,30,15
1714215570342,EDS 201,A00,507315,Staff,13,0,30,17
1714215571373,EDS 203,A01,507317,Halter; Christopher P.,12,0,30,18
1714215572398,EDS 204R,A01,507319,Halter; Christopher P.,0,3,30,30
1714215572398,EDS 204R,B01,507331,Heinzman; Erica M.,17,0,30,13
1714215573428,EDS 206R,A00,507332,Staff,0,4,30,30
1714215573428,EDS 206R,B00,507343,Staff,18,0,30,12
1714215574457,EDS 250,A00,507344,Hemans; Patricia Ann Benitez,22,0,40,18
1714215575487,EDS 281,A00,507345,Daly; Alan J.,18,0,18,0
1714215576514,EDS 284,A00,507350,Daly; Alan J.,16,0,16,0
1714215577609,EDS 286,A00,507359,Fine; Sarah,18,0,18,0
1714215578635,EDS 289C,A01,507361,Daly; Alan J.,18,0,18,0
1714215579660,EDS 290,A00,507366,Hofstetter; Carolyn,15,0,15,0
1714215580685,LIGM 5A,A00,507421,Fischer-Grunski; Eva K,18,0,20,2
1714215581713,LIGM 5B,A00,507423,Fischer-Grunski; Eva K,19,0,20,1
1714215582740,LIGM 5C,A00,507425,Fischer-Grunski; Eva K,19,0,20,1
1714215583766,LIIT 5AS,A00,507427,Carnelos; Chiara,20,0,20,0
1714215584796,LIIT 5BS,A00,507430,Carnelos; Chiara,20,0,20,0
1714215585824,LIIT 5CS,A00,507432,Carnelos; Chiara,20,0,20,0
1714215586854,LISP 5A,A00,507541,Munoz Sanchez; Alicia,11,0,20,9
1714215587880,LISP 5B,A00,507671,Munoz Sanchez; Alicia,9,0,20,11
1714215588906,LISP 5C,A00,507696,Munoz Sanchez; Alicia,9,0,20,11
1714215589935,MAE 197,001,528363,Boechler; Nicholas Sebastia,9998,0,9999,1
1714215590964,MATH 197,001,523477,Kedlaya; Kiran S.,9996,0,9999,3
1714215590964,MATH 197,002,563811,Zhang; Danna,9995,0,9999,4
1714215590964,MATH 197,003,628552,Dumitriu; Ioana,9998,0,9999,1
1714215591992,MCWP 40R,A00,518780,Staff,5,0,20,15
1714215591992,MCWP 40R,B00,518781,Staff,7,0,20,13
1714215591992,MCWP 40R,C00,518783,Staff,5,0,20,15
1714215593020,MCWP 50R,A00,518791,Staff,0,0,20,20
1714215593020,MCWP 50R,B00,518792,Staff,0,1,20,20
1714215593020,MCWP 50R,C00,518793,Staff,0,1,20,20
1714215593020,MCWP 50R,D00,518794,Staff,0,0,20,20
1714215593020,MCWP 50R,E00,518795,Staff,0,1,20,20
1714215593020,MCWP 50R,F00,518796,Staff,0,0,20,20
1714215593020,MCWP 50R,G00,518797,Staff,0,1,20,20
1714215594045,MMW 12R,A01,514034,Herbst; Matthew,0,1,16,16
1714215594045,MMW 12R,A02,514035,Herbst; Matthew,2,0,16,14
1714215595072,MMW 13R,A01,514037,Staff,0,4,16,16
1714215595072,MMW 13R,A02,514039,Staff,0,2,16,16
1714215595072,MMW 13R,A03,628519,Staff,0,2,16,16
1714215597126,SIO 295LS,A00,523233,Staff,13,0,30,17
1714215598152,SIO 295S,A00,523232,Staff,13,0,30,17
1714215599179,SIOC 290S,A01,637330,Merrifield; Mark A,28,0,30,2
1714215600205,SIOC 291S,A01,637333,Gabriel; Corey John,28,0,30,2
1714215601231,SOCI 117,A01,494376,Staff,0,2,5,5
1714215602258,WES 237B,A00,494380,Staff,9,0,20,11
1714215604334,AESE 279B,A00,494370,Wade; Jon P,0,0,33,33
1714215605360,AIP 197,001,627712,Vespa; Emanuel Ignacio,9998,0,9999,1
1714215606388,ANAR 135S,A00,494369,Braswell; Geoffrey E.,0,0,0,0
1714215607413,BENG 196,001,628496,Engler; Adam J.,9998,0,9999,1
1714215608438,CAT 124RS,A01,519847,Geibel; William,0,0,20,20
1714215609465,CAT 125RS,A01,515971,Geibel; William,0,0,20,20
1714215610491,CLRE 250,A00,511389,Morris; Sheldon,9993,0,9999,6
1714215611517,CLRE 251,A00,507176,Mehta; Ravindra L.,9993,0,9999,6
1714215611517,CLRE 251,B00,511410,Mehta; Ravindra L.,9998,0,9999,1
1714215612541,CLRE 252,A00,507189,Cuomo; Raphael Eduardo,9995,0,9999,4
1714215613566,CLRE 253,A00,507199,Vaida; Florin,9994,0,9999,5
1714215613566,CLRE 253,B00,507202,Vaida; Florin,9999,0,9999,0
1714215614590,CLRE 259,A00,507211,Patel; Hemal,9996,0,9999,3
1714215615614,CLRE 260,A00,507221,Cuomo; Raphael Eduardo,9999,0,9999,0
1714215616639,CLRE 297,001,507242,Cuomo; Raphael Eduardo,9999,0,9999,0
1714215617664,COGS 197,001,638244,Voytek; Bradley Thomas,9999,0,9999,0
1714215618691,CSE 191,A00,516875,Minnes Kemp; Mor Mia,9993,0,9999,6
1714215619716,CSE 197,001,637388,Minnes Kemp; Mor Mia,9998,0,9999,1
1714215620741,CSS 201S,A01,494383,Staff,35,0,35,0
1714215621765,CSS 202S,A01,494387,Staff,35,0,35,0
1714215622790,DSC 197,001,628532,Eldridge; Justin Matthew,9996,0,9999,3
1714215623818,EAP 100,A00,516065,Staff,9797,0,9999,202
1714215624843,ECE 45,A01,507414,Staff,33,0,60,27
1714215626893,ECE 111,A01,507420,Staff,21,0,50,29
1714215627919,ECE 197,001,548057,Sievenpiper; Daniel F.,9994,0,9999,5
1714215628944,EDS 115,A00,507243,Choi; Bailey Miyeon,12,0,28,16
1714215629971,EDS 117,A01,494379,Staff,0,1,30,30
1714215630996,EDS 125,A00,507246,Hopkins; Megan Beth,12,0,30,18
1714215632027,EDS 128A,A01,507264,Fargason; Sharon Gayle,14,0,26,12
1714215633053,EDS 128B,A01,507293,Pappas; Elizabeth,18,0,30,12
1714215634081,EDS 139,A00,507294,Fargason; Sharon Gayle,18,0,30,12
1714215634081,EDS 139,B00,507313,Pappas; Elizabeth,15,0,30,15
1714215635107,EDS 201,A00,507315,Staff,13,0,30,17
1714215636131,EDS 203,A01,507317,Halter; Christopher P.,12,0,30,18
1714215637156,EDS 204R,A01,507319,Halter; Christopher P.,0,3,30,30
1714215637156,EDS 204R,B01,507331,Heinzman; Erica M.,17,0,30,13
1714215638182,EDS 206R,A00,507332,Staff,0,4,30,30
1714215638182,EDS 206R,B00,507343,Staff,18,0,30,12
1714215639207,EDS 250,A00,507344,Hemans; Patricia Ann Benitez,22,0,40,18
1714215640234,EDS 281,A00,507345,Daly; Alan J.,18,0,18,0
1714215641258,EDS 284,A00,507350,Daly; Alan J.,16,0,16,0
1714215642282,EDS 286,A00,507359,Fine; Sarah,18,0,18,0
1714215643311,EDS 289C,A01,507361,Daly; Alan J.,18,0,18,0
1714215644338,EDS 290,A00,507366,Hofstetter; Carolyn,15,0,15,0
1714215645369,LIGM 5A,A00,507421,Fischer-Grunski; Eva K,18,0,20,2
1714215646394,LIGM 5B,A00,507423,Fischer-Grunski; Eva K,19,0,20,1
1714215647419,LIGM 5C,A00,507425,Fischer-Grunski; Eva K,19,0,20,1
1714215648450,LIIT 5AS,A00,507427,Carnelos; Chiara,20,0,20,0
1714215649479,LIIT 5BS,A00,507430,Carnelos; Chiara,20,0,20,0
1714215650505,LIIT 5CS,A00,507432,Carnelos; Chiara,20,0,20,0
1714215651533,LISP 5A,A00,507541,Munoz Sanchez; Alicia,11,0,20,9
1714215652560,LISP 5B,A00,507671,Munoz Sanchez; Alicia,9,0,20,11
1714215653588,LISP 5C,A00,507696,Munoz Sanchez; Alicia,9,0,20,11
1714215654613,MAE 197,001,528363,Boechler; Nicholas Sebastia,9998,0,9999,1
1714215655642,MATH 197,001,523477,Kedlaya; Kiran S.,9996,0,9999,3
1714215655642,MATH 197,002,563811,Zhang; Danna,9995,0,9999,4
1714215655642,MATH 197,003,628552,Dumitriu; Ioana,9998,0,9999,1
1714215656673,MCWP 40R,A00,518780,Staff,5,0,20,15
1714215656673,MCWP 40R,B00,518781,Staff,7,0,20,13
1714215656673,MCWP 40R,C00,518783,Staff,5,0,20,15
1714215657700,MCWP 50R,A00,518791,Staff,0,0,20,20
1714215657700,MCWP 50R,B00,518792,Staff,0,1,20,20
1714215657700,MCWP 50R,C00,518793,Staff,0,1,20,20
1714215657700,MCWP 50R,D00,518794,Staff,0,0,20,20
1714215657700,MCWP 50R,E00,518795,Staff,0,1,20,20
1714215657700,MCWP 50R,F00,518796,Staff,0,0,20,20
1714215657700,MCWP 50R,G00,518797,Staff,0,1,20,20
1714215658726,MMW 12R,A01,514034,Herbst; Matthew,0,1,16,16
1714215658726,MMW 12R,A02,514035,Herbst; Matthew,2,0,16,14
1714215659755,MMW 13R,A01,514037,Staff,0,4,16,16
1714215659755,MMW 13R,A02,514039,Staff,0,2,16,16
1714215659755,MMW 13R,A03,628519,Staff,0,2,16,16
1714215661813,SIO 295LS,A00,523233,Staff,13,0,30,17
1714215662840,SIO 295S,A00,523232,Staff,13,0,30,17
1714215663871,SIOC 290S,A01,637330,Merrifield; Mark A,28,0,30,2
1714215664898,SIOC 291S,A01,637333,Gabriel; Corey John,28,0,30,2
1714215665925,SOCI 117,A01,494376,Staff,0,2,5,5
1714215666950,WES 237B,A00,494380,Staff,9,0,20,11
1714215669025,AESE 279B,A00,494370,Wade; Jon P,0,0,33,33
1714215670055,AIP 197,001,627712,Vespa; Emanuel Ignacio,9998,0,9999,1
1714215671086,ANAR 135S,A00,494369,Braswell; Geoffrey E.,0,0,0,0
1714215672114,BENG 196,001,628496,Engler; Adam J.,9998,0,9999,1
1714215673145,CAT 124RS,A01,519847,Geibel; William,0,0,20,20
1714215674170,CAT 125RS,A01,515971,Geibel; William,0,0,20,20
1714215675201,CLRE 250,A00,511389,Morris; Sheldon,9993,0,9999,6
1714215676230,CLRE 251,A00,507176,Mehta; Ravindra L.,9993,0,9999,6
1714215676230,CLRE 251,B00,511410,Mehta; Ravindra L.,9998,0,9999,1
1714215677257,CLRE 252,A00,507189,Cuomo; Raphael Eduardo,9995,0,9999,4
1714215678288,CLRE 253,A00,507199,Vaida; Florin,9994,0,9999,5
1714215678288,CLRE 253,B00,507202,Vaida; Florin,9999,0,9999,0
1714215679314,CLRE 259,A00,507211,Patel; Hemal,9996,0,9999,3
1714215680342,CLRE 260,A00,507221,Cuomo; Raphael Eduardo,9999,0,9999,0
1714215681422,CLRE 297,001,507242,Cuomo; Raphael Eduardo,9999,0,9999,0
1714215682447,COGS 197,001,638244,Voytek; Bradley Thomas,9999,0,9999,0
1714215683470,CSE 191,A00,516875,Minnes Kemp; Mor Mia,9993,0,9999,6
1714215684499,CSE 197,001,637388,Minnes Kemp; Mor Mia,9998,0,9999,1
1714215685524,CSS 201S,A01,494383,Staff,35,0,35,0
1714215686549,CSS 202S,A01,494387,Staff,35,0,35,0
1714215687574,DSC 197,001,628532,Eldridge; Justin Matthew,9996,0,9999,3
1714215688600,EAP 100,A00,516065,Staff,9797,0,9999,202
1714215689627,ECE 45,A01,507414,Staff,33,0,60,27
1714215691681,ECE 111,A01,507420,Staff,21,0,50,29
1714215692706,ECE 197,001,548057,Sievenpiper; Daniel F.,9994,0,9999,5
1714215693731,EDS 115,A00,507243,Choi; Bailey Miyeon,12,0,28,16
1714215694758,EDS 117,A01,494379,Staff,0,1,30,30
1714215695787,EDS 125,A00,507246,Hopkins; Megan Beth,12,0,30,18
1714215696813,EDS 128A,A01,507264,Fargason; Sharon Gayle,14,0,26,12
1714215697842,EDS 128B,A01,507293,Pappas; Elizabeth,18,0,30,12
1714215698871,EDS 139,A00,507294,Fargason; Sharon Gayle,18,0,30,12
1714215698871,EDS 139,B00,507313,Pappas; Elizabeth,15,0,30,15
1714215699896,EDS 201,A00,507315,Staff,13,0,30,17
1714215700925,EDS 203,A01,507317,Halter; Christopher P.,12,0,30,18
1714215701950,EDS 204R,A01,507319,Halter; Christopher P.,0,3,30,30
1714215701950,EDS 204R,B01,507331,Heinzman; Erica M.,17,0,30,13
1714215702980,EDS 206R,A00,507332,Staff,0,4,30,30
1714215702980,EDS 206R,B00,507343,Staff,18,0,30,12
1714215704005,EDS 250,A00,507344,Hemans; Patricia Ann Benitez,22,0,40,18
1714215705030,EDS 281,A00,507345,Daly; Alan J.,18,0,18,0
1714215706056,EDS 284,A00,507350,Daly; Alan J.,16,0,16,0
1714215707085,EDS 286,A00,507359,Fine; Sarah,18,0,18,0
1714215708111,EDS 289C,A01,507361,Daly; Alan J.,18,0,18,0
1714215709138,EDS 290,A00,507366,Hofstetter; Carolyn,15,0,15,0
1714215710164,LIGM 5A,A00,507421,Fischer-Grunski; Eva K,18,0,20,2
1714215711190,LIGM 5B,A00,507423,Fischer-Grunski; Eva K,19,0,20,1
1714215712219,LIGM 5C,A00,507425,Fischer-Grunski; Eva K,19,0,20,1
1714215713247,LIIT 5AS,A00,507427,Carnelos; Chiara,20,0,20,0
1714215714273,LIIT 5BS,A00,507430,Carnelos; Chiara,20,0,20,0
1714215715298,LIIT 5CS,A00,507432,Carnelos; Chiara,20,0,20,0
1714215716324,LISP 5A,A00,507541,Munoz Sanchez; Alicia,11,0,20,9
1714215717349,LISP 5B,A00,507671,Munoz Sanchez; Alicia,9,0,20,11
1714215718376,LISP 5C,A00,507696,Munoz Sanchez; Alicia,9,0,20,11
1714215719402,MAE 197,001,528363,Boechler; Nicholas Sebastia,9998,0,9999,1
1714215720444,MATH 197,001,523477,Kedlaya; Kiran S.,9996,0,9999,3
1714215720444,MATH 197,002,563811,Zhang; Danna,9995,0,9999,4
1714215720444,MATH 197,003,628552,Dumitriu; Ioana,9998,0,9999,1
1714215721471,MCWP 40R,A00,518780,Staff,5,0,20,15
1714215721471,MCWP 40R,B00,518781,Staff,7,0,20,13
1714215721471,MCWP 40R,C00,518783,Staff,5,0,20,15
1714215722501,MCWP 50R,A00,518791,Staff,0,0,20,20
1714215722501,MCWP 50R,B00,518792,Staff,0,1,20,20
1714215722501,MCWP 50R,C00,518793,Staff,0,1,20,20
1714215722501,MCWP 50R,D00,518794,Staff,0,0,20,20
1714215722501,MCWP 50R,E00,518795,Staff,0,1,20,20
1714215722501,MCWP 50R,F00,518796,Staff,0,0,20,20
1714215722501,MCWP 50R,G00,518797,Staff,0,1,20,20
1714215723531,MMW 12R,A01,514034,Herbst; Matthew,0,1,16,16
1714215723531,MMW 12R,A02,514035,Herbst; Matthew,2,0,16,14
1714215724563,MMW 13R,A01,514037,Staff,0,4,16,16
1714215724563,MMW 13R,A02,514039,Staff,0,2,16,16
1714215724563,MMW 13R,A03,628519,Staff,0,2,16,16
1714215726620,SIO 295LS,A00,523233,Staff,13,0,30,17
1714215727645,SIO 295S,A00,523232,Staff,13,0,30,17
1714215728671,SIOC 290S,A01,637330,Merrifield; Mark A,28,0,30,2
1714215729701,SIOC 291S,A01,637333,Gabriel; Corey John,28,0,30,2
1714215730728,SOCI 117,A01,494376,Staff,0,2,5,5
1714215731757,WES 237B,A00,494380,Staff,9,0,20,11
1714215733835,AESE 279B,A00,494370,Wade; Jon P,0,0,33,33
1714215734865,AIP 197,001,627712,Vespa; Emanuel Ignacio,9998,0,9999,1
1714215735892,ANAR 135S,A00,494369,Braswell; Geoffrey E.,0,0,0,0
1714215736917,BENG 196,001,628496,Engler; Adam J.,9998,0,9999,1
1714215737948,CAT 124RS,A01,519847,Geibel; William,0,0,20,20
1714215738976,CAT 125RS,A01,515971,Geibel; William,0,0,20,20
1714215740003,CLRE 250,A00,511389,Morris; Sheldon,9993,0,9999,6
1714215741031,CLRE 251,A00,507176,Mehta; Ravindra L.,9993,0,9999,6
1714215741031,CLRE 251,B00,511410,Mehta; Ravindra L.,9998,0,9999,1
1714215742055,CLRE 252,A00,507189,Cuomo; Raphael Eduardo,9995,0,9999,4
1714215743080,CLRE 253,A00,507199,Vaida; Florin,9994,0,9999,5
1714215743080,CLRE 253,B00,507202,Vaida; Florin,9999,0,9999,0
1714215744104,CLRE 259,A00,507211,Patel; Hemal,9996,0,9999,3
1714215745138,CLRE 260,A00,507221,Cuomo; Raphael Eduardo,9999,0,9999,0
1714215746163,CLRE 297,001,507242,Cuomo; Raphael Eduardo,9999,0,9999,0
1714215747189,COGS 197,001,638244,Voytek; Bradley Thomas,9999,0,9999,0
1714215748215,CSE 191,A00,516875,Minnes Kemp; Mor Mia,9993,0,9999,6
1714215749242,CSE 197,001,637388,Minnes Kemp; Mor Mia,9998,0,9999,1
1714215750273,CSS 201S,A01,494383,Staff,35,0,35,0
1714215751302,CSS 202S,A01,494387,Staff,35,0,35,0
1714215752332,DSC 197,001,628532,Eldridge; Justin Matthew,9996,0,9999,3
1714215753361,EAP 100,A00,516065,Staff,9797,0,9999,202
1714215754393,ECE 45,A01,507414,Staff,33,0,60,27
1714215756445,ECE 111,A01,507420,Staff,21,0,50,29
1714215757473,ECE 197,001,548057,Sievenpiper; Daniel F.,9994,0,9999,5
1714215758501,EDS 115,A00,507243,Choi; Bailey Miyeon,12,0,28,16
1714215759530,EDS 117,A01,494379,Staff,0,1,30,30
1714215760558,EDS 125,A00,507246,Hopkins; Megan Beth,12,0,30,18
1714215761585,EDS 128A,A01,507264,Fargason; Sharon Gayle,14,0,26,12
1714215762610,EDS 128B,A01,507293,Pappas; Elizabeth,18,0,30,12
1714215763639,EDS 139,A00,507294,Fargason; Sharon Gayle,18,0,30,12
1714215763639,EDS 139,B00,507313,Pappas; Elizabeth,15,0,30,15
1714215764665,EDS 201,A00,507315,Staff,13,0,30,17
1714215765692,EDS 203,A01,507317,Halter; Christopher P.,12,0,30,18
1714215766722,EDS 204R,A01,507319,Halter; Christopher P.,0,3,30,30
1714215766722,EDS 204R,B01,507331,Heinzman; Erica M.,17,0,30,13
1714215767752,EDS 206R,A00,507332,Staff,0,4,30,30
1714215767752,EDS 206R,B00,507343,Staff,18,0,30,12
1714215768778,EDS 250,A00,507344,Hemans; Patricia Ann Benitez,22,0,40,18
1714215769807,EDS 281,A00,507345,Daly; Alan J.,18,0,18,0
1714215770836,EDS 284,A00,507350,Daly; Alan J.,16,0,16,0
1714215771868,EDS 286,A00,507359,Fine; Sarah,18,0,18,0
1714215772897,EDS 289C,A01,507361,Daly; Alan J.,18,0,18,0
1714215773922,EDS 290,A00,507366,Hofstetter; Carolyn,15,0,15,0
1714215774949,LIGM 5A,A00,507421,Fischer-Grunski; Eva K,18,0,20,2
1714215775976,LIGM 5B,A00,507423,Fischer-Grunski; Eva K,19,0,20,1
1714215777009,LIGM 5C,A00,507425,Fischer-Grunski; Eva K,19,0,20,1
1714215778040,LIIT 5AS,A00,507427,Carnelos; Chiara,20,0,20,0
1714215779066,LIIT 5BS,A00,507430,Carnelos; Chiara,20,0,20,0
1714215780092,LIIT 5CS,A00,507432,Carnelos; Chiara,20,0,20,0
1714215781123,LISP 5A,A00,507541,Munoz Sanchez; Alicia,11,0,20,9
1714215782152,LISP 5B,A00,507671,Munoz Sanchez; Alicia,9,0,20,11
1714215783178,LISP 5C,A00,507696,Munoz Sanchez; Alicia,9,0,20,11
1714215784203,MAE 197,001,528363,Boechler; Nicholas Sebastia,9998,0,9999,1
1714215785284,MATH 197,001,523477,Kedlaya; Kiran S.,9996,0,9999,3
1714215785284,MATH 197,002,563811,Zhang; Danna,9995,0,9999,4
1714215785284,MATH 197,003,628552,Dumitriu; Ioana,9998,0,9999,1
1714215786309,MCWP 40R,A00,518780,Staff,5,0,20,15
1714215786309,MCWP 40R,B00,518781,Staff,7,0,20,13
1714215786309,MCWP 40R,C00,518783,Staff,5,0,20,15
1714215787334,MCWP 50R,A00,518791,Staff,0,0,20,20
1714215787334,MCWP 50R,B00,518792,Staff,0,1,20,20
1714215787334,MCWP 50R,C00,518793,Staff,0,1,20,20
1714215787334,MCWP 50R,D00,518794,Staff,0,0,20,20
1714215787334,MCWP 50R,E00,518795,Staff,0,1,20,20
1714215787334,MCWP 50R,F00,518796,Staff,0,0,20,20
1714215787334,MCWP 50R,G00,518797,Staff,0,1,20,20
1714215788363,MMW 12R,A01,514034,Herbst; Matthew,0,1,16,16
1714215788363,MMW 12R,A02,514035,Herbst; Matthew,2,0,16,14
1714215789389,MMW 13R,A01,514037,Staff,0,4,16,16
1714215789389,MMW 13R,A02,514039,Staff,0,2,16,16
1714215789389,MMW 13R,A03,628519,Staff,0,2,16,16
1714215791444,SIO 295LS,A00,523233,Staff,13,0,30,17
1714215792470,SIO 295S,A00,523232,Staff,13,0,30,17
1714215793496,SIOC 290S,A01,637330,Merrifield; Mark A,28,0,30,2
1714215794520,SIOC 291S,A01,637333,Gabriel; Corey John,28,0,30,2
1714215795549,SOCI 117,A01,494376,Staff,0,2,5,5
1714215796575,WES 237B,A00,494380,Staff,9,0,20,11
1714215798633,AESE 279B,A00,494370,Wade; Jon P,0,0,33,33
1714215799662,AIP 197,001,627712,Vespa; Emanuel Ignacio,9998,0,9999,1
1714215800690,ANAR 135S,A00,494369,Braswell; Geoffrey E.,0,0,0,0
1714215801716,BENG 196,001,628496,Engler; Adam J.,9998,0,9999,1
1714215802741,CAT 124RS,A01,519847,Geibel; William,0,0,20,20
1714215803766,CAT 125RS,A01,515971,Geibel; William,0,0,20,20
1714215804792,CLRE 250,A00,511389,Morris; Sheldon,9993,0,9999,6
1714215805821,CLRE 251,A00,507176,Mehta; Ravindra L.,9993,0,9999,6
1714215805821,CLRE 251,B00,511410,Mehta; Ravindra L.,9998,0,9999,1
1714215806902,CLRE 252,A00,507189,Cuomo; Raphael Eduardo,9995,0,9999,4
1714215807928,CLRE 253,A00,507199,Vaida; Florin,9994,0,9999,5
1714215807928,CLRE 253,B00,507202,Vaida; Florin,9999,0,9999,0
1714215808952,CLRE 259,A00,507211,Patel; Hemal,9996,0,9999,3
1714215809980,CLRE 260,A00,507221,Cuomo; Raphael Eduardo,9999,0,9999,0
1714215811008,CLRE 297,001,507242,Cuomo; Raphael Eduardo,9999,0,9999,0
1714215812036,COGS 197,001,638244,Voytek; Bradley Thomas,9999,0,9999,0
1714215813064,CSE 191,A00,516875,Minnes Kemp; Mor Mia,9993,0,9999,6
1714215814091,CSE 197,001,637388,Minnes Kemp; Mor Mia,9998,0,9999,1
1714215815119,CSS 201S,A01,494383,Staff,35,0,35,0
1714215816143,CSS 202S,A01,494387,Staff,35,0,35,0
1714215817171,DSC 197,001,628532,Eldridge; Justin Matthew,9996,0,9999,3
1714215818204,EAP 100,A00,516065,Staff,9797,0,9999,202
1714215819234,ECE 45,A01,507414,Staff,33,0,60,27
1714215821285,ECE 111,A01,507420,Staff,21,0,50,29
1714215822310,ECE 197,001,548057,Sievenpiper; Daniel F.,9994,0,9999,5
1714215823337,EDS 115,A00,507243,Choi; Bailey Miyeon,12,0,28,16
1714215824362,EDS 117,A01,494379,Staff,0,1,30,30
1714215825390,EDS 125,A00,507246,Hopkins; Megan Beth,12,0,30,18
1714215826416,EDS 128A,A01,507264,Fargason; Sharon Gayle,14,0,26,12
1714215827445,EDS 128B,A01,507293,Pappas; Elizabeth,18,0,30,12
1714215828470,EDS 139,A00,507294,Fargason; Sharon Gayle,18,0,30,12
1714215828470,EDS 139,B00,507313,Pappas; Elizabeth,15,0,30,15
1714215829495,EDS 201,A00,507315,Staff,13,0,30,17
1714215830520,EDS 203,A01,507317,Halter; Christopher P.,12,0,30,18
1714215831551,EDS 204R,A01,507319,Halter; Christopher P.,0,3,30,30
1714215831551,EDS 204R,B01,507331,Heinzman; Erica M.,17,0,30,13
1714215832576,EDS 206R,A00,507332,Staff,0,4,30,30
1714215832576,EDS 206R,B00,507343,Staff,18,0,30,12
1714215833602,EDS 250,A00,507344,Hemans; Patricia Ann Benitez,22,0,40,18
1714215834626,EDS 281,A00,507345,Daly; Alan J.,18,0,18,0
1714215835651,EDS 284,A00,507350,Daly; Alan J.,16,0,16,0
1714215836675,EDS 286,A00,507359,Fine; Sarah,18,0,18,0
1714215837707,EDS 289C,A01,507361,Daly; Alan J.,18,0,18,0
1714215838735,EDS 290,A00,507366,Hofstetter; Carolyn,15,0,15,0
1714215839765,LIGM 5A,A00,507421,Fischer-Grunski; Eva K,18,0,20,2
1714215840790,LIGM 5B,A00,507423,Fischer-Grunski; Eva K,19,0,20,1
1714215841814,LIGM 5C,A00,507425,Fischer-Grunski; Eva K,19,0,20,1
1714215842848,LIIT 5AS,A00,507427,Carnelos; Chiara,20,0,20,0
1714215843874,LIIT 5BS,A00,507430,Carnelos; Chiara,20,0,20,0
1714215844904,LIIT 5CS,A00,507432,Carnelos; Chiara,20,0,20,0
1714215845928,LISP 5A,A00,507541,Munoz Sanchez; Alicia,11,0,20,9
1714215846955,LISP 5B,A00,507671,Munoz Sanchez; Alicia,9,0,20,11
1714215847980,LISP 5C,A00,507696,Munoz Sanchez; Alicia,9,0,20,11
1714215849004,MAE 197,001,528363,Boechler; Nicholas Sebastia,9998,0,9999,1
1714215850029,MATH 197,001,523477,Kedlaya; Kiran S.,9996,0,9999,3
1714215850029,MATH 197,002,563811,Zhang; Danna,9995,0,9999,4
1714215850029,MATH 197,003,628552,Dumitriu; Ioana,9998,0,9999,1
1714215851057,MCWP 40R,A00,518780,Staff,5,0,20,15
1714215851057,MCWP 40R,B00,518781,Staff,7,0,20,13
1714215851057,MCWP 40R,C00,518783,Staff,5,0,20,15
1714215852083,MCWP 50R,A00,518791,Staff,0,0,20,20
1714215852083,MCWP 50R,B00,518792,Staff,0,1,20,20
1714215852083,MCWP 50R,C00,518793,Staff,0,1,20,20
1714215852083,MCWP 50R,D00,518794,Staff,0,0,20,20
1714215852083,MCWP 50R,E00,518795,Staff,0,1,20,20
1714215852083,MCWP 50R,F00,518796,Staff,0,0,20,20
1714215852083,MCWP 50R,G00,518797,Staff,0,1,20,20
1714215853111,MMW 12R,A01,514034,Herbst; Matthew,0,1,16,16
1714215853111,MMW 12R,A02,514035,Herbst; Matthew,2,0,16,14
1714215854135,MMW 13R,A01,514037,Staff,0,4,16,16
1714215854135,MMW 13R,A02,514039,Staff,0,2,16,16
1714215854135,MMW 13R,A03,628519,Staff,0,2,16,16
1714215856189,SIO 295LS,A00,523233,Staff,13,0,30,17
1714215857219,SIO 295S,A00,523232,Staff,13,0,30,17
1714215858243,SIOC 290S,A01,637330,Merrifield; Mark A,28,0,30,2
1714215859275,SIOC 291S,A01,637333,Gabriel; Corey John,28,0,30,2
1714215860301,SOCI 117,A01,494376,Staff,0,2,5,5
1714215861328,WES 237B,A00,494380,Staff,9,0,20,11
1714215863417,AESE 279B,A00,494370,Wade; Jon P,0,0,33,33
1714215864444,AIP 197,001,627712,Vespa; Emanuel Ignacio,9998,0,9999,1
1714215865474,ANAR 135S,A00,494369,Braswell; Geoffrey E.,0,0,0,0
1714215866505,BENG 196,001,628496,Engler; Adam J.,9998,0,9999,1
1714215867536,CAT 124RS,A01,519847,Geibel; William,0,0,20,20
1714215868562,CAT 125RS,A01,515971,Geibel; William,0,0,20,20
1714215869593,CLRE 250,A00,511389,Morris; Sheldon,9993,0,9999,6
1714215870618,CLRE 251,A00,507176,Mehta; Ravindra L.,9993,0,9999,6
1714215870618,CLRE 251,B00,511410,Mehta; Ravindra L.,9998,0,9999,1
1714215871648,CLRE 252,A00,507189,Cuomo; Raphael Eduardo,9995,0,9999,4
1714215872674,CLRE 253,A00,507199,Vaida; Florin,9994,0,9999,5
1714215872674,CLRE 253,B00,507202,Vaida; Florin,9999,0,9999,0
1714215873706,CLRE 259,A00,507211,Patel; Hemal,9996,0,9999,3
1714215874731,CLRE 260,A00,507221,Cuomo; Raphael Eduardo,9999,0,9999,0
1714215875757,CLRE 297,001,507242,Cuomo; Raphael Eduardo,9999,0,9999,0
1714215876783,COGS 197,001,638244,Voytek; Bradley Thomas,9999,0,9999,0
1714215877812,CSE 191,A00,516875,Minnes Kemp; Mor Mia,9993,0,9999,6
1714215878840,CSE 197,001,637388,Minnes Kemp; Mor Mia,9998,0,9999,1
1714215879871,CSS 201S,A01,494383,Staff,35,0,35,0
1714215880896,CSS 202S,A01,494387,Staff,35,0,35,0
1714215881922,DSC 197,001,628532,Eldridge; Justin Matthew,9996,0,9999,3
1714215882947,EAP 100,A00,516065,Staff,9797,0,9999,202
1714215883979,ECE 45,A01,507414,Staff,33,0,60,27
1714215886030,ECE 111,A01,507420,Staff,21,0,50,29
1714215887054,ECE 197,001,548057,Sievenpiper; Daniel F.,9994,0,9999,5
1714215888079,EDS 115,A00,507243,Choi; Bailey Miyeon,12,0,28,16
1714215889103,EDS 117,A01,494379,Staff,0,1,30,30
1714215890131,EDS 125,A00,507246,Hopkins; Megan Beth,12,0,30,18
1714215891155,EDS 128A,A01,507264,Fargason; Sharon Gayle,14,0,26,12
1714215892188,EDS 128B,A01,507293,Pappas; Elizabeth,18,0,30,12
1714215893217,EDS 139,A00,507294,Fargason; Sharon Gayle,18,0,30,12
1714215893217,EDS 139,B00,507313,Pappas; Elizabeth,15,0,30,15
1714215894243,EDS 201,A00,507315,Staff,13,0,30,17
1714215895274,EDS 203,A01,507317,Halter; Christopher P.,12,0,30,18
1714215896300,EDS 204R,A01,507319,Halter; Christopher P.,0,3,30,30
1714215896300,EDS 204R,B01,507331,Heinzman; Erica M.,17,0,30,13
1714215897328,EDS 206R,A00,507332,Staff,0,4,30,30
1714215897328,EDS 206R,B00,507343,Staff,18,0,30,12
1714215898354,EDS 250,A00,507344,Hemans; Patricia Ann Benitez,22,0,40,18
1714215899383,EDS 281,A00,507345,Daly; Alan J.,18,0,18,0
1714215900409,EDS 284,A00,507350,Daly; Alan J.,16,0,16,0
1714215901432,EDS 286,A00,507359,Fine; Sarah,18,0,18,0
1714215902460,EDS 289C,A01,507361,Daly; Alan J.,18,0,18,0
1714215903487,EDS 290,A00,507366,Hofstetter; Carolyn,15,0,15,0
1714215904514,LIGM 5A,A00,507421,Fischer-Grunski; Eva K,18,0,20,2
1714215905541,LIGM 5B,A00,507423,Fischer-Grunski; Eva K,19,0,20,1
1714215906570,LIGM 5C,A00,507425,Fischer-Grunski; Eva K,19,0,20,1
1714215907595,LIIT 5AS,A00,507427,Carnelos; Chiara,20,0,20,0
1714215908622,LIIT 5BS,A00,507430,Carnelos; Chiara,20,0,20,0
1714215909647,LIIT 5CS,A00,507432,Carnelos; Chiara,20,0,20,0
1714215910731,LISP 5A,A00,507541,Munoz Sanchez; Alicia,11,0,20,9
1714215911759,LISP 5B,A00,507671,Munoz Sanchez; Alicia,9,0,20,11
1714215912784,LISP 5C,A00,507696,Munoz Sanchez; Alicia,9,0,20,11
1714215913810,MAE 197,001,528363,Boechler; Nicholas Sebastia,9998,0,9999,1
1714215914835,MATH 197,001,523477,Kedlaya; Kiran S.,9996,0,9999,3
1714215914835,MATH 197,002,563811,Zhang; Danna,9995,0,9999,4
1714215914835,MATH 197,003,628552,Dumitriu; Ioana,9998,0,9999,1
1714215915860,MCWP 40R,A00,518780,Staff,5,0,20,15
1714215915860,MCWP 40R,B00,518781,Staff,7,0,20,13
1714215915860,MCWP 40R,C00,518783,Staff,5,0,20,15
1714215916890,MCWP 50R,A00,518791,Staff,0,0,20,20
1714215916890,MCWP 50R,B00,518792,Staff,0,1,20,20
1714215916890,MCWP 50R,C00,518793,Staff,0,1,20,20
1714215916890,MCWP 50R,D00,518794,Staff,0,0,20,20
1714215916890,MCWP 50R,E00,518795,Staff,0,1,20,20
1714215916890,MCWP 50R,F00,518796,Staff,0,0,20,20
1714215916890,MCWP 50R,G00,518797,Staff,0,1,20,20
1714215917919,MMW 12R,A01,514034,Herbst; Matthew,0,1,16,16
1714215917919,MMW 12R,A02,514035,Herbst; Matthew,2,0,16,14
1714215918946,MMW 13R,A01,514037,Staff,0,4,16,16
1714215918946,MMW 13R,A02,514039,Staff,0,2,16,16
1714215918946,MMW 13R,A03,628519,Staff,0,2,16,16
1714215920998,SIO 295LS,A00,523233,Staff,13,0,30,17
1714215922027,SIO 295S,A00,523232,Staff,13,0,30,17
1714215923050,SIOC 290S,A01,637330,Merrifield; Mark A,28,0,30,2
1714215924080,SIOC 291S,A01,637333,Gabriel; Corey John,28,0,30,2
1714215925106,SOCI 117,A01,494376,Staff,0,2,5,5
1714215926134,WES 237B,A00,494380,Staff,9,0,20,11
1714215928189,AESE 279B,A00,494370,Wade; Jon P,0,0,33,33
1714215929215,AIP 197,001,627712,Vespa; Emanuel Ignacio,9998,0,9999,1
1714215930241,ANAR 135S,A00,494369,Braswell; Geoffrey E.,0,0,0,0
1714215931269,BENG 196,001,628496,Engler; Adam J.,9998,0,9999,1
1714215932295,CAT 124RS,A01,519847,Geibel; William,0,0,20,20
1714215933320,CAT 125RS,A01,515971,Geibel; William,0,0,20,20
1714215934344,CLRE 250,A00,511389,Morris; Sheldon,9993,0,9999,6
1714215935372,CLRE 251,A00,507176,Mehta; Ravindra L.,9993,0,9999,6
1714215935372,CLRE 251,B00,511410,Mehta; Ravindra L.,9998,0,9999,1
1714215936395,CLRE 252,A00,507189,Cuomo; Raphael Eduardo,9995,0,9999,4
1714215937422,CLRE 253,A00,507199,Vaida; Florin,9994,0,9999,5
1714215937422,CLRE 253,B00,507202,Vaida; Florin,9999,0,9999,0
1714215938449,CLRE 259,A00,507211,Patel; Hemal,9996,0,9999,3
1714215939478,CLRE 260,A00,507221,Cuomo; Raphael Eduardo,9999,0,9999,0
1714215940503,CLRE 297,001,507242,Cuomo; Raphael Eduardo,9999,0,9999,0
1714215941529,COGS 197,001,638244,Voytek; Bradley Thomas,9999,0,9999,0
1714215942559,CSE 191,A00,516875,Minnes Kemp; Mor Mia,9993,0,9999,6
1714215943588,CSE 197,001,637388,Minnes Kemp; Mor Mia,9998,0,9999,1
1714215944616,CSS 201S,A01,494383,Staff,35,0,35,0
1714215945641,CSS 202S,A01,494387,Staff,35,0,35,0
1714215946670,DSC 197,001,628532,Eldridge; Justin Matthew,9996,0,9999,3
1714215947695,EAP 100,A00,516065,Staff,9797,0,9999,202
1714215948722,ECE 45,A01,507414,Staff,33,0,60,27
1714215950777,ECE 111,A01,507420,Staff,21,0,50,29
1714215951803,ECE 197,001,548057,Sievenpiper; Daniel F.,9994,0,9999,5
1714215952829,EDS 115,A00,507243,Choi; Bailey Miyeon,12,0,28,16
1714215953854,EDS 117,A01,494379,Staff,0,1,30,30
1714215954880,EDS 125,A00,507246,Hopkins; Megan Beth,12,0,30,18
1714215955909,EDS 128A,A01,507264,Fargason; Sharon Gayle,14,0,26,12
1714215956939,EDS 128B,A01,507293,Pappas; Elizabeth,18,0,30,12
1714215957965,EDS 139,A00,507294,Fargason; Sharon Gayle,18,0,30,12
1714215957965,EDS 139,B00,507313,Pappas; Elizabeth,15,0,30,15
1714215958995,EDS 201,A00,507315,Staff,13,0,30,17
1714215960023,EDS 203,A01,507317,Halter; Christopher P.,12,0,30,18
1714215961053,EDS 204R,A01,507319,Halter; Christopher P.,0,3,30,30
1714215961053,EDS 204R,B01,507331,Heinzman; Erica M.,17,0,30,13
1714215962081,EDS 206R,A00,507332,Staff,0,4,30,30
1714215962081,EDS 206R,B00,507343,Staff,18,0,30,12
1714215963108,EDS 250,A00,507344,Hemans; Patricia Ann Benitez,22,0,40,18
1714215964134,EDS 281,A00,507345,Daly; Alan J.,18,0,18,0
1714215965159,EDS 284,A00,507350,Daly; Alan J.,16,0,16,0
1714215966190,EDS 286,A00,507359,Fine; Sarah,18,0,18,0
1714215967215,EDS 289C,A01,507361,Daly; Alan J.,18,0,18,0
1714215968242,EDS 290,A00,507366,Hofstetter; Carolyn,15,0,15,0
1714215969268,LIGM 5A,A00,507421,Fischer-Grunski; Eva K,18,0,20,2
1714215970293,LIGM 5B,A00,507423,Fischer-Grunski; Eva K,19,0,20,1
1714215971318,LIGM 5C,A00,507425,Fischer-Grunski; Eva K,19,0,20,1
1714215972345,LIIT 5AS,A00,507427,Carnelos; Chiara,20,0,20,0
1714215973373,LIIT 5BS,A00,507430,Carnelos; Chiara,20,0,20,0
1714215974399,LIIT 5CS,A00,507432,Carnelos; Chiara,20,0,20,0
1714215975432,LISP 5A,A00,507541,Munoz Sanchez; Alicia,11,0,20,9
1714215976457,LISP 5B,A00,507671,Munoz Sanchez; Alicia,9,0,20,11
1714215977485,LISP 5C,A00,507696,Munoz Sanchez; Alicia,9,0,20,11
1714215978516,MAE 197,001,528363,Boechler; Nicholas Sebastia,9998,0,9999,1
1714215979544,MATH 197,001,523477,Kedlaya; Kiran S.,9996,0,9999,3
1714215979544,MATH 197,002,563811,Zhang; Danna,9995,0,9999,4
1714215979544,MATH 197,003,628552,Dumitriu; Ioana,9998,0,9999,1
1714215980574,MCWP 40R,A00,518780,Staff,5,0,20,15
1714215980574,MCWP 40R,B00,518781,Staff,7,0,20,13
1714215980574,MCWP 40R,C00,518783,Staff,5,0,20,15
1714215981599,MCWP 50R,A00,518791,Staff,0,0,20,20
1714215981599,MCWP 50R,B00,518792,Staff,0,1,20,20
1714215981599,MCWP 50R,C00,518793,Staff,0,1,20,20
1714215981599,MCWP 50R,D00,518794,Staff,0,0,20,20
1714215981599,MCWP 50R,E00,518795,Staff,0,1,20,20
1714215981599,MCWP 50R,F00,518796,Staff,0,0,20,20
1714215981599,MCWP 50R,G00,518797,Staff,0,1,20,20
1714215982628,MMW 12R,A01,514034,Herbst; Matthew,0,1,16,16
1714215982628,MMW 12R,A02,514035,Herbst; Matthew,2,0,16,14
1714215983659,MMW 13R,A01,514037,Staff,0,4,16,16
1714215983659,MMW 13R,A02,514039,Staff,0,2,16,16
1714215983659,MMW 13R,A03,628519,Staff,0,2,16,16
1714215985712,SIO 295LS,A00,523233,Staff,13,0,30,17
1714215986739,SIO 295S,A00,523232,Staff,13,0,30,17
1714215987772,SIOC 290S,A01,637330,Merrifield; Mark A,28,0,30,2
1714215988799,SIOC 291S,A01,637333,Gabriel; Corey John,28,0,30,2
1714215989826,SOCI 117,A01,494376,Staff,0,2,5,5
1714215990857,WES 237B,A00,494380,Staff,9,0,20,11
1714215992945,AESE 279B,A00,494370,Wade; Jon P,0,0,33,33
1714215993972,AIP 197,001,627712,Vespa; Emanuel Ignacio,9998,0,9999,1
1714215995001,ANAR 135S,A00,494369,Braswell; Geoffrey E.,0,0,0,0
1714215996026,BENG 196,001,628496,Engler; Adam J.,9998,0,9999,1
1714215997057,CAT 124RS,A01,519847,Geibel; William,0,0,20,20
1714215998083,CAT 125RS,A01,515971,Geibel; William,0,0,20,20
1714215999114,CLRE 250,A00,511389,Morris; Sheldon,9993,0,9999,6
1714216000142,CLRE 251,A00,507176,Mehta; Ravindra L.,9993,0,9999,6
1714216000142,CLRE 251,B00,511410,Mehta; Ravindra L.,9998,0,9999,1
1714216001166,CLRE 252,A00,507189,Cuomo; Raphael Eduardo,9995,0,9999,4
1714216002195,CLRE 253,A00,507199,Vaida; Florin,9994,0,9999,5
1714216002195,CLRE 253,B00,507202,Vaida; Florin,9999,0,9999,0
1714216003221,CLRE 259,A00,507211,Patel; Hemal,9996,0,9999,3
1714216004246,CLRE 260,A00,507221,Cuomo; Raphael Eduardo,9999,0,9999,0
1714216005270,CLRE 297,001,507242,Cuomo; Raphael Eduardo,9999,0,9999,0
1714216006298,COGS 197,001,638244,Voytek; Bradley Thomas,9999,0,9999,0
1714216007326,CSE 191,A00,516875,Minnes Kemp; Mor Mia,9993,0,9999,6
1714216008351,CSE 197,001,637388,Minnes Kemp; Mor Mia,9998,0,9999,1
1714216009386,CSS 201S,A01,494383,Staff,35,0,35,0
1714216010416,CSS 202S,A01,494387,Staff,35,0,35,0
1714216011445,DSC 197,001,628532,Eldridge; Justin Matthew,9996,0,9999,3
1714216012472,EAP 100,A00,516065,Staff,9797,0,9999,202
1714216013502,ECE 45,A01,507414,Staff,33,0,60,27
1714216015613,ECE 111,A01,507420,Staff,21,0,50,29
1714216016640,ECE 197,001,548057,Sievenpiper; Daniel F.,9994,0,9999,5
1714216017669,EDS 115,A00,507243,Choi; Bailey Miyeon,12,0,28,16
1714216018696,EDS 117,A01,494379,Staff,0,1,30,30
1714216019722,EDS 125,A00,507246,Hopkins; Megan Beth,12,0,30,18
1714216020748,EDS 128A,A01,507264,Fargason; Sharon Gayle,14,0,26,12
1714216021778,EDS 128B,A01,507293,Pappas; Elizabeth,18,0,30,12
1714216022806,EDS 139,A00,507294,Fargason; Sharon Gayle,18,0,30,12
1714216022806,EDS 139,B00,507313,Pappas; Elizabeth,15,0,30,15
1714216023832,EDS 201,A00,507315,Staff,13,0,30,17
1714216024859,EDS 203,A01,507317,Halter; Christopher P.,12,0,30,18
1714216025885,EDS 204R,A01,507319,Halter; Christopher P.,0,3,30,30
1714216025885,EDS 204R,B01,507331,Heinzman; Erica M.,17,0,30,13
1714216026911,EDS 206R,A00,507332,Staff,0,4,30,30
1714216026911,EDS 206R,B00,507343,Staff,18,0,30,12
1714216027940,EDS 250,A00,507344,Hemans; Patricia Ann Benitez,22,0,40,18
1714216028969,EDS 281,A00,507345,Daly; Alan J.,18,0,18,0
1714216029998,EDS 284,A00,507350,Daly; Alan J.,16,0,16,0
1714216031029,EDS 286,A00,507359,Fine; Sarah,18,0,18,0
1714216032053,EDS 289C,A01,507361,Daly; Alan J.,18,0,18,0
1714216033080,EDS 290,A00,507366,Hofstetter; Carolyn,15,0,15,0
1714216034105,LIGM 5A,A00,507421,Fischer-Grunski; Eva K,18,0,20,2
1714216035128,LIGM 5B,A00,507423,Fischer-Grunski; Eva K,19,0,20,1
1714216036154,LIGM 5C,A00,507425,Fischer-Grunski; Eva K,19,0,20,1
1714216037179,LIIT 5AS,A00,507427,Carnelos; Chiara,20,0,20,0
1714216038207,LIIT 5BS,A00,507430,Carnelos; Chiara,20,0,20,0
1714216039234,LIIT 5CS,A00,507432,Carnelos; Chiara,20,0,20,0
1714216040261,LISP 5A,A00,507541,Munoz Sanchez; Alicia,11,0,20,9
1714216041288,LISP 5B,A00,507671,Munoz Sanchez; Alicia,9,0,20,11
1714216042319,LISP 5C,A00,507696,Munoz Sanchez; Alicia,9,0,20,11
1714216043350,MAE 197,001,528363,Boechler; Nicholas Sebastia,9998,0,9999,1
1714216044378,MATH 197,001,523477,Kedlaya; Kiran S.,9996,0,9999,3
1714216044378,MATH 197,002,563811,Zhang; Danna,9995,0,9999,4
1714216044378,MATH 197,003,628552,Dumitriu; Ioana,9998,0,9999,1
1714216045408,MCWP 40R,A00,518780,Staff,5,0,20,15
1714216045408,MCWP 40R,B00,518781,Staff,7,0,20,13
1714216045408,MCWP 40R,C00,518783,Staff,5,0,20,15
1714216046435,MCWP 50R,A00,518791,Staff,0,0,20,20
1714216046435,MCWP 50R,B00,518792,Staff,0,1,20,20
1714216046435,MCWP 50R,C00,518793,Staff,0,1,20,20
1714216046435,MCWP 50R,D00,518794,Staff,0,0,20,20
1714216046435,MCWP 50R,E00,518795,Staff,0,1,20,20
1714216046435,MCWP 50R,F00,518796,Staff,0,0,20,20
1714216046435,MCWP 50R,G00,518797,Staff,0,1,20,20
1714216047464,MMW 12R,A01,514034,Herbst; Matthew,0,1,16,16
1714216047464,MMW 12R,A02,514035,Herbst; Matthew,2,0,16,14
1714216048493,MMW 13R,A01,514037,Staff,0,4,16,16
1714216048493,MMW 13R,A02,514039,Staff,0,2,16,16
1714216048493,MMW 13R,A03,628519,Staff,0,2,16,16
1714216051059,SIO 295LS,A00,523233,Staff,13,0,30,17
1714216052088,SIO 295S,A00,523232,Staff,13,0,30,17
1714216053115,SIOC 290S,A01,637330,Merrifield; Mark A,28,0,30,2
1714216054139,SIOC 291S,A01,637333,Gabriel; Corey John,28,0,30,2
1714216055163,SOCI 117,A01,494376,Staff,0,2,5,5
1714216056187,WES 237B,A00,494380,Staff,9,0,20,11
1714216058257,AESE 279B,A00,494370,Wade; Jon P,0,0,33,33
1714216059282,AIP 197,001,627712,Vespa; Emanuel Ignacio,9998,0,9999,1
1714216060309,ANAR 135S,A00,494369,Braswell; Geoffrey E.,0,0,0,0
1714216061337,BENG 196,001,628496,Engler; Adam J.,9998,0,9999,1
1714216062365,CAT 124RS,A01,519847,Geibel; William,0,0,20,20
1714216063390,CAT 125RS,A01,515971,Geibel; William,0,0,20,20
1714216064416,CLRE 250,A00,511389,Morris; Sheldon,9993,0,9999,6
1714216065443,CLRE 251,A00,507176,Mehta; Ravindra L.,9993,0,9999,6
1714216065443,CLRE 251,B00,511410,Mehta; Ravindra L.,9998,0,9999,1
1714216066469,CLRE 252,A00,507189,Cuomo; Raphael Eduardo,9995,0,9999,4
1714216067496,CLRE 253,A00,507199,Vaida; Florin,9994,0,9999,5
1714216067496,CLRE 253,B00,507202,Vaida; Florin,9999,0,9999,0
1714216068524,CLRE 259,A00,507211,Patel; Hemal,9996,0,9999,3
1714216069550,CLRE 260,A00,507221,Cuomo; Raphael Eduardo,9999,0,9999,0
1714216070575,CLRE 297,001,507242,Cuomo; Raphael Eduardo,9999,0,9999,0
1714216071604,COGS 197,001,638244,Voytek; Bradley Thomas,9999,0,9999,0
1714216072630,CSE 191,A00,516875,Minnes Kemp; Mor Mia,9993,0,9999,6
1714216073654,CSE 197,001,637388,Minnes Kemp; Mor Mia,9998,0,9999,1
1714216074682,CSS 201S,A01,494383,Staff,35,0,35,0
1714216075710,CSS 202S,A01,494387,Staff,35,0,35,0
1714216076736,DSC 197,001,628532,Eldridge; Justin Matthew,9996,0,9999,3
1714216077761,EAP 100,A00,516065,Staff,9797,0,9999,202
1714216078790,ECE 45,A01,507414,Staff,33,0,60,27
1714216080844,ECE 111,A01,507420,Staff,21,0,50,29
1714216081870,ECE 197,001,548057,Sievenpiper; Daniel F.,9994,0,9999,5
1714216082898,EDS 115,A00,507243,Choi; Bailey Miyeon,12,0,28,16
1714216083924,EDS 117,A01,494379,Staff,0,1,30,30
1714216084950,EDS 125,A00,507246,Hopkins; Megan Beth,12,0,30,18
1714216085976,EDS 128A,A01,507264,Fargason; Sharon Gayle,14,0,26,12
1714216087001,EDS 128B,A01,507293,Pappas; Elizabeth,18,0,30,12
1714216088027,EDS 139,A00,507294,Fargason; Sharon Gayle,18,0,30,12
1714216088027,EDS 139,B00,507313,Pappas; Elizabeth,15,0,30,15
1714216089052,EDS 201,A00,507315,Staff,13,0,30,17
1714216090079,EDS 203,A01,507317,Halter; Christopher P.,12,0,30,18
1714216091109,EDS 204R,A01,507319,Halter; Christopher P.,0,3,30,30
1714216091109,EDS 204R,B01,507331,Heinzman; Erica M.,17,0,30,13
1714216092134,EDS 206R,A00,507332,Staff,0,4,30,30
1714216092134,EDS 206R,B00,507343,Staff,18,0,30,12
1714216093163,EDS 250,A00,507344,Hemans; Patricia Ann Benitez,22,0,40,18
1714216094189,EDS 281,A00,507345,Daly; Alan J.,18,0,18,0
1714216095212,EDS 284,A00,507350,Daly; Alan J.,16,0,16,0
1714216096237,EDS 286,A00,507359,Fine; Sarah,18,0,18,0
1714216097263,EDS 289C,A01,507361,Daly; Alan J.,18,0,18,0
1714216098292,EDS 290,A00,507366,Hofstetter; Carolyn,15,0,15,0
1714216099315,LIGM 5A,A00,507421,Fischer-Grunski; Eva K,18,0,20,2
1714216100340,LIGM 5B,A00,507423,Fischer-Grunski; Eva K,19,0,20,1
1714216101370,LIGM 5C,A00,507425,Fischer-Grunski; Eva K,19,0,20,1
1714216102399,LIIT 5AS,A00,507427,Carnelos; Chiara,20,0,20,0
1714216103425,LIIT 5BS,A00,507430,Carnelos; Chiara,20,0,20,0
1714216104450,LIIT 5CS,A00,507432,Carnelos; Chiara,20,0,20,0
1714216105476,LISP 5A,A00,507541,Munoz Sanchez; Alicia,11,0,20,9
1714216106502,LISP 5B,A00,507671,Munoz Sanchez; Alicia,9,0,20,11
1714216107527,LISP 5C,A00,507696,Munoz Sanchez; Alicia,9,0,20,11
1714216108553,MAE 197,001,528363,Boechler; Nicholas Sebastia,9998,0,9999,1
1714216109581,MATH 197,001,523477,Kedlaya; Kiran S.,9996,0,9999,3
1714216109581,MATH 197,002,563811,Zhang; Danna,9995,0,9999,4
1714216109581,MATH 197,003,628552,Dumitriu; Ioana,9998,0,9999,1
1714216110611,MCWP 40R,A00,518780,Staff,5,0,20,15
1714216110611,MCWP 40R,B00,518781,Staff,7,0,20,13
1714216110611,MCWP 40R,C00,518783,Staff,5,0,20,15
1714216111637,MCWP 50R,A00,518791,Staff,0,0,20,20
1714216111637,MCWP 50R,B00,518792,Staff,0,1,20,20
1714216111637,MCWP 50R,C00,518793,Staff,0,1,20,20
1714216111637,MCWP 50R,D00,518794,Staff,0,0,20,20
1714216111637,MCWP 50R,E00,518795,Staff,0,1,20,20
1714216111637,MCWP 50R,F00,518796,Staff,0,0,20,20
1714216111637,MCWP 50R,G00,518797,Staff,0,1,20,20
1714216112661,MMW 12R,A01,514034,Herbst; Matthew,0,1,16,16
1714216112661,MMW 12R,A02,514035,Herbst; Matthew,2,0,16,14
1714216113687,MMW 13R,A01,514037,Staff,0,4,16,16
1714216113687,MMW 13R,A02,514039,Staff,0,2,16,16
1714216113687,MMW 13R,A03,628519,Staff,0,2,16,16
1714216115742,SIO 295LS,A00,523233,Staff,13,0,30,17
1714216116768,SIO 295S,A00,523232,Staff,13,0,30,17
1714216117798,SIOC 290S,A01,637330,Merrifield; Mark A,28,0,30,2
1714216118879,SIOC 291S,A01,637333,Gabriel; Corey John,28,0,30,2
1714216119908,SOCI 117,A01,494376,Staff,0,2,5,5
1714216120932,WES 237B,A00,494380,Staff,9,0,20,11
1714216123003,AESE 279B,A00,494370,Wade; Jon P,0,0,33,33
1714216124028,AIP 197,001,627712,Vespa; Emanuel Ignacio,9998,0,9999,1
1714216125055,ANAR 135S,A00,494369,Braswell; Geoffrey E.,0,0,0,0
1714216126081,BENG 196,001,628496,Engler; Adam J.,9998,0,9999,1
1714216127108,CAT 124RS,A01,519847,Geibel; William,0,0,20,20
1714216128133,CAT 125RS,A01,515971,Geibel; William,0,0,20,20
1714216129160,CLRE 250,A00,511389,Morris; Sheldon,9993,0,9999,6
1714216130184,CLRE 251,A00,507176,Mehta; Ravindra L.,9993,0,9999,6
1714216130184,CLRE 251,B00,511410,Mehta; Ravindra L.,9998,0,9999,1
1714216131213,CLRE 252,A00,507189,Cuomo; Raphael Eduardo,9995,0,9999,4
1714216132238,CLRE 253,A00,507199,Vaida; Florin,9994,0,9999,5
1714216132238,CLRE 253,B00,507202,Vaida; Florin,9999,0,9999,0
1714216133268,CLRE 259,A00,507211,Patel; Hemal,9996,0,9999,3
1714216134296,CLRE 260,A00,507221,Cuomo; Raphael Eduardo,9999,0,9999,0
1714216135321,CLRE 297,001,507242,Cuomo; Raphael Eduardo,9999,0,9999,0
1714216136347,COGS 197,001,638244,Voytek; Bradley Thomas,9999,0,9999,0
1714216137374,CSE 191,A00,516875,Minnes Kemp; Mor Mia,9993,0,9999,6
1714216138400,CSE 197,001,637388,Minnes Kemp; Mor Mia,9998,0,9999,1
1714216139430,CSS 201S,A01,494383,Staff,35,0,35,0
1714216140460,CSS 202S,A01,494387,Staff,35,0,35,0
1714216141485,DSC 197,001,628532,Eldridge; Justin Matthew,9996,0,9999,3
1714216142511,EAP 100,A00,516065,Staff,9797,0,9999,202
1714216143542,ECE 45,A01,507414,Staff,33,0,60,27
1714216145593,ECE 111,A01,507420,Staff,21,0,50,29
1714216146618,ECE 197,001,548057,Sievenpiper; Daniel F.,9994,0,9999,5
1714216147642,EDS 115,A00,507243,Choi; Bailey Miyeon,12,0,28,16
1714216148669,EDS 117,A01,494379,Staff,0,1,30,30
1714216149695,EDS 125,A00,507246,Hopkins; Megan Beth,12,0,30,18
1714216150723,EDS 128A,A01,507264,Fargason; Sharon Gayle,14,0,26,12
1714216151746,EDS 128B,A01,507293,Pappas; Elizabeth,18,0,30,12
1714216152774,EDS 139,A00,507294,Fargason; Sharon Gayle,18,0,30,12
1714216152774,EDS 139,B00,507313,Pappas; Elizabeth,15,0,30,15
1714216153803,EDS 201,A00,507315,Staff,13,0,30,17
1714216154831,EDS 203,A01,507317,Halter; Christopher P.,12,0,30,18
1714216155857,EDS 204R,A01,507319,Halter; Christopher P.,0,3,30,30
1714216155857,EDS 204R,B01,507331,Heinzman; Erica M.,17,0,30,13
1714216156885,EDS 206R,A00,507332,Staff,0,4,30,30
1714216156885,EDS 206R,B00,507343,Staff,18,0,30,12
1714216157909,EDS 250,A00,507344,Hemans; Patricia Ann Benitez,22,0,40,18
1714216158933,EDS 281,A00,507345,Daly; Alan J.,18,0,18,0
1714216159958,EDS 284,A00,507350,Daly; Alan J.,16,0,16,0
1714216160985,EDS 286,A00,507359,Fine; Sarah,18,0,18,0
1714216162014,EDS 289C,A01,507361,Daly; Alan J.,18,0,18,0
1714216163040,EDS 290,A00,507366,Hofstetter; Carolyn,15,0,15,0
1714216164066,LIGM 5A,A00,507421,Fischer-Grunski; Eva K,18,0,20,2
1714216165095,LIGM 5B,A00,507423,Fischer-Grunski; Eva K,19,0,20,1
1714216166121,LIGM 5C,A00,507425,Fischer-Grunski; Eva K,19,0,20,1
1714216167145,LIIT 5AS,A00,507427,Carnelos; Chiara,20,0,20,0
1714216168171,LIIT 5BS,A00,507430,Carnelos; Chiara,20,0,20,0
1714216169198,LIIT 5CS,A00,507432,Carnelos; Chiara,20,0,20,0
1714216170223,LISP 5A,A00,507541,Munoz Sanchez; Alicia,11,0,20,9
1714216171250,LISP 5B,A00,507671,Munoz Sanchez; Alicia,9,0,20,11
1714216172278,LISP 5C,A00,507696,Munoz Sanchez; Alicia,9,0,20,11
1714216173306,MAE 197,001,528363,Boechler; Nicholas Sebastia,9998,0,9999,1
1714216174333,MATH 197,001,523477,Kedlaya; Kiran S.,9996,0,9999,3
1714216174333,MATH 197,002,563811,Zhang; Danna,9995,0,9999,4
1714216174333,MATH 197,003,628552,Dumitriu; Ioana,9998,0,9999,1
1714216175358,MCWP 40R,A00,518780,Staff,5,0,20,15
1714216175358,MCWP 40R,B00,518781,Staff,7,0,20,13
1714216175358,MCWP 40R,C00,518783,Staff,5,0,20,15
1714216176384,MCWP 50R,A00,518791,Staff,0,0,20,20
1714216176384,MCWP 50R,B00,518792,Staff,0,1,20,20
1714216176384,MCWP 50R,C00,518793,Staff,0,1,20,20
1714216176384,MCWP 50R,D00,518794,Staff,0,0,20,20
1714216176384,MCWP 50R,E00,518795,Staff,0,1,20,20
1714216176384,MCWP 50R,F00,518796,Staff,0,0,20,20
1714216176384,MCWP 50R,G00,518797,Staff,0,1,20,20
1714216177414,MMW 12R,A01,514034,Herbst; Matthew,0,1,16,16
1714216177414,MMW 12R,A02,514035,Herbst; Matthew,2,0,16,14
1714216178440,MMW 13R,A01,514037,Staff,0,4,16,16
1714216178440,MMW 13R,A02,514039,Staff,0,2,16,16
1714216178440,MMW 13R,A03,628519,Staff,0,2,16,16
1714216180496,SIO 295LS,A00,523233,Staff,13,0,30,17
1714216181521,SIO 295S,A00,523232,Staff,13,0,30,17
1714216182548,SIOC 290S,A01,637330,Merrifield; Mark A,28,0,30,2
1714216183574,SIOC 291S,A01,637333,Gabriel; Corey John,28,0,30,2
1714216184600,SOCI 117,A01,494376,Staff,0,2,5,5
1714216185625,WES 237B,A00,494380,Staff,9,0,20,11
1714216187694,AESE 279B,A00,494370,Wade; Jon P,0,0,33,33
1714216188720,AIP 197,001,627712,Vespa; Emanuel Ignacio,9998,0,9999,1
1714216189747,ANAR 135S,A00,494369,Braswell; Geoffrey E.,0,0,0,0
1714216190772,BENG 196,001,628496,Engler; Adam J.,9998,0,9999,1
1714216191798,CAT 124RS,A01,519847,Geibel; William,0,0,20,20
1714216192824,CAT 125RS,A01,515971,Geibel; William,0,0,20,20
1714216193849,CLRE 250,A00,511389,Morris; Sheldon,9993,0,9999,6
1714216194877,CLRE 251,A00,507176,Mehta; Ravindra L.,9993,0,9999,6
1714216194877,CLRE 251,B00,511410,Mehta; Ravindra L.,9998,0,9999,1
1714216195905,CLRE 252,A00,507189,Cuomo; Raphael Eduardo,9995,0,9999,4
1714216196936,CLRE 253,A00,507199,Vaida; Florin,9994,0,9999,5
1714216196936,CLRE 253,B00,507202,Vaida; Florin,9999,0,9999,0
1714216197962,CLRE 259,A00,507211,Patel; Hemal,9996,0,9999,3
1714216198989,CLRE 260,A00,507221,Cuomo; Raphael Eduardo,9999,0,9999,0
1714216200014,CLRE 297,001,507242,Cuomo; Raphael Eduardo,9999,0,9999,0
1714216201039,COGS 197,001,638244,Voytek; Bradley Thomas,9999,0,9999,0
1714216202064,CSE 191,A00,516875,Minnes Kemp; Mor Mia,9993,0,9999,6
1714216203089,CSE 197,001,637388,Minnes Kemp; Mor Mia,9998,0,9999,1
1714216204116,CSS 201S,A01,494383,Staff,35,0,35,0
1714216205145,CSS 202S,A01,494387,Staff,35,0,35,0
1714216206170,DSC 197,001,628532,Eldridge; Justin Matthew,9996,0,9999,3
1714216207198,EAP 100,A00,516065,Staff,9797,0,9999,202
1714216208224,ECE 45,A01,507414,Staff,33,0,60,27
1714216210486,ECE 111,A01,507420,Staff,21,0,50,29
1714216211515,ECE 197,001,548057,Sievenpiper; Daniel F.,9994,0,9999,5
1714216212538,EDS 115,A00,507243,Choi; Bailey Miyeon,12,0,28,16
1714216213566,EDS 117,A01,494379,Staff,0,1,30,30
1714216214595,EDS 125,A00,507246,Hopkins; Megan Beth,12,0,30,18
1714216215624,EDS 128A,A01,507264,Fargason; Sharon Gayle,14,0,26,12
1714216216650,EDS 128B,A01,507293,Pappas; Elizabeth,18,0,30,12
