time,subj_course_id,sec_code,sec_id,prof,available,waitlist,total,enrolled_ct
1714600105326,AESE 279B,A00,494370,Wade; Jon P,0,0,33,33
1714600106354,AIP 197,001,627712,Vespa; Emanuel Ignacio,9998,0,9999,1
1714600107380,ANAR 135S,A00,494369,Braswell; Geoffrey E.,0,0,0,0
1714600108408,BENG 196,001,628496,Engler; Adam J.,9998,0,9999,1
1714600109437,CAT 124RS,A01,519847,Geibel; William,0,0,20,20
1714600110463,CAT 125RS,A01,515971,Geibel; William,0,0,20,20
1714600111489,CLRE 250,A00,511389,Morris; Sheldon,9993,0,9999,6
1714600112515,CLRE 251,A00,507176,Mehta; Ravindra L.,9993,0,9999,6
1714600112515,CLRE 251,B00,511410,Mehta; Ravindra L.,9998,0,9999,1
1714600113546,CLRE 252,A00,507189,Cuomo; Raphael Eduardo,9995,0,9999,4
1714600114577,CLRE 253,A00,507199,Vaida; Florin,9994,0,9999,5
1714600114577,CLRE 253,B00,507202,Vaida; Florin,9999,0,9999,0
1714600115603,CLRE 259,A00,507211,Patel; Hemal,9996,0,9999,3
1714600116628,CLRE 260,A00,507221,Cuomo; Raphael Eduardo,9999,0,9999,0
1714600117656,CLRE 297,001,507242,Cuomo; Raphael Eduardo,9999,0,9999,0
1714600118682,COGS 197,001,638244,Voytek; Bradley Thomas,9998,0,9999,1
1714600119707,CSE 191,A00,516875,Minnes Kemp; Mor Mia,9993,0,9999,6
1714600120732,CSE 197,001,637388,Minnes Kemp; Mor Mia,9998,0,9999,1
1714600121758,CSS 201S,A01,494383,Staff,35,0,35,0
1714600122786,CSS 202S,A01,494387,Staff,35,0,35,0
1714600123811,DSC 197,001,628532,Eldridge; Justin Matthew,9996,0,9999,3
1714600124836,EAP 100,A00,516065,Staff,9797,0,9999,202
1714600125861,ECE 45,A01,507414,Staff,33,0,60,27
1714600127919,ECE 111,A01,507420,Staff,15,0,50,35
1714600128947,ECE 197,001,548057,Sievenpiper; Daniel F.,9993,0,9999,6
1714600129974,EDS 115,A00,507243,Choi; Bailey Miyeon,10,0,28,18
1714600131002,EDS 117,A01,494379,Staff,1,5,30,29
1714600132031,EDS 125,A00,507246,Hopkins; Megan Beth,9,0,30,21
1714600133061,EDS 128A,A01,507264,Fargason; Sharon Gayle,8,0,26,18
1714600134087,EDS 128B,A01,507293,Pappas; Elizabeth,12,0,30,18
1714600135111,EDS 139,A00,507294,Fargason; Sharon Gayle,13,0,30,17
1714600135111,EDS 139,B00,507313,Pappas; Elizabeth,13,0,30,17
1714600136136,EDS 201,A00,507315,Staff,13,0,30,17
1714600137162,EDS 203,A01,507317,Halter; Christopher P.,12,0,30,18
1714600138187,EDS 204R,A01,507319,Halter; Christopher P.,0,3,30,30
1714600138187,EDS 204R,B01,507331,Heinzman; Erica M.,16,0,30,14
1714600139213,EDS 206R,A00,507332,Staff,0,4,30,30
1714600139213,EDS 206R,B00,507343,Staff,17,0,30,13
1714600140241,EDS 250,A00,507344,Hemans; Patricia Ann Benitez,22,0,40,18
1714600141266,EDS 281,A00,507345,Daly; Alan J.,18,0,18,0
1714600142294,EDS 284,A00,507350,Daly; Alan J.,16,0,16,0
1714600143320,EDS 286,A00,507359,Fine; Sarah,18,0,18,0
1714600144344,EDS 289C,A01,507361,Daly; Alan J.,18,0,18,0
1714600145369,EDS 290,A00,507366,Hofstetter; Carolyn,15,0,15,0
1714600146399,LIGM 5A,A00,507421,Fischer-Grunski; Eva K,18,0,20,2
1714600147423,LIGM 5B,A00,507423,Fischer-Grunski; Eva K,19,0,20,1
1714600148449,LIGM 5C,A00,507425,Fischer-Grunski; Eva K,19,0,20,1
1714600149476,LIIT 5AS,A00,507427,Carnelos; Chiara,20,0,20,0
1714600150503,LIIT 5BS,A00,507430,Carnelos; Chiara,20,0,20,0
1714600151534,LIIT 5CS,A00,507432,Carnelos; Chiara,20,0,20,0
1714600152561,LISP 5A,A00,507541,Munoz Sanchez; Alicia,11,0,20,9
1714600153589,LISP 5B,A00,507671,Munoz Sanchez; Alicia,8,0,20,12
1714600154618,LISP 5C,A00,507696,Munoz Sanchez; Alicia,9,0,20,11
1714600155645,MAE 197,001,528363,Boechler; Nicholas Sebastia,9998,0,9999,1
1714600156674,MATH 197,001,523477,Kedlaya; Kiran S.,9995,0,9999,4
1714600156674,MATH 197,002,563811,Zhang; Danna,9995,0,9999,4
1714600156674,MATH 197,003,628552,Dumitriu; Ioana,9998,0,9999,1
1714600157700,MCWP 40R,A00,518780,Staff,2,0,20,18
1714600157700,MCWP 40R,B00,518781,Staff,8,0,20,12
1714600157700,MCWP 40R,C00,518783,Staff,6,0,20,14
1714600158728,MCWP 50R,A00,518791,Staff,0,0,20,20
1714600158728,MCWP 50R,B00,518792,Staff,0,2,20,20
1714600158728,MCWP 50R,C00,518793,Staff,0,2,20,20
1714600158728,MCWP 50R,D00,518794,Staff,0,0,20,20
1714600158728,MCWP 50R,E00,518795,Staff,0,2,20,20
1714600158728,MCWP 50R,F00,518796,Staff,0,0,20,20
1714600158728,MCWP 50R,G00,518797,Staff,0,1,20,20
1714600159760,MMW 12R,A01,514034,Herbst; Matthew,0,0,16,16
1714600159760,MMW 12R,A02,514035,Herbst; Matthew,2,0,16,14
1714600160787,MMW 13R,A01,514037,Staff,0,4,16,16
1714600160787,MMW 13R,A02,514039,Staff,0,2,16,16
1714600160787,MMW 13R,A03,628519,Staff,0,2,16,16
1714600162858,SIO 295LS,A00,523233,Staff,10,0,30,20
1714600163882,SIO 295S,A00,523232,Staff,10,0,30,20
1714600164910,SIOC 290S,A01,637330,Merrifield; Mark A,24,0,30,6
1714600165941,SIOC 291S,A01,637333,Gabriel; Corey John,24,0,30,6
1714600166967,SOCI 117,A01,494376,Staff,0,4,5,5
1714600167992,WES 237B,A00,494380,Staff,9,0,20,11
1714600170070,AESE 279B,A00,494370,Wade; Jon P,0,0,33,33
1714600171096,AIP 197,001,627712,Vespa; Emanuel Ignacio,9998,0,9999,1
1714600172121,ANAR 135S,A00,494369,Braswell; Geoffrey E.,0,0,0,0
1714600173146,BENG 196,001,628496,Engler; Adam J.,9998,0,9999,1
1714600174176,CAT 124RS,A01,519847,Geibel; William,0,0,20,20
1714600175201,CAT 125RS,A01,515971,Geibel; William,0,0,20,20
1714600176226,CLRE 250,A00,511389,Morris; Sheldon,9993,0,9999,6
1714600177251,CLRE 251,A00,507176,Mehta; Ravindra L.,9993,0,9999,6
1714600177251,CLRE 251,B00,511410,Mehta; Ravindra L.,9998,0,9999,1
1714600178277,CLRE 252,A00,507189,Cuomo; Raphael Eduardo,9995,0,9999,4
1714600179301,CLRE 253,A00,507199,Vaida; Florin,9994,0,9999,5
1714600179301,CLRE 253,B00,507202,Vaida; Florin,9999,0,9999,0
1714600180326,CLRE 259,A00,507211,Patel; Hemal,9996,0,9999,3
1714600181355,CLRE 260,A00,507221,Cuomo; Raphael Eduardo,9999,0,9999,0
1714600182379,CLRE 297,001,507242,Cuomo; Raphael Eduardo,9999,0,9999,0
1714600183405,COGS 197,001,638244,Voytek; Bradley Thomas,9998,0,9999,1
1714600184431,CSE 191,A00,516875,Minnes Kemp; Mor Mia,9993,0,9999,6
1714600185456,CSE 197,001,637388,Minnes Kemp; Mor Mia,9998,0,9999,1
1714600186480,CSS 201S,A01,494383,Staff,35,0,35,0
1714600187509,CSS 202S,A01,494387,Staff,35,0,35,0
1714600188537,DSC 197,001,628532,Eldridge; Justin Matthew,9996,0,9999,3
1714600189565,EAP 100,A00,516065,Staff,9797,0,9999,202
1714600190595,ECE 45,A01,507414,Staff,33,0,60,27
1714600192647,ECE 111,A01,507420,Staff,15,0,50,35
1714600193673,ECE 197,001,548057,Sievenpiper; Daniel F.,9993,0,9999,6
1714600194701,EDS 115,A00,507243,Choi; Bailey Miyeon,10,0,28,18
1714600195726,EDS 117,A01,494379,Staff,1,5,30,29
1714600196752,EDS 125,A00,507246,Hopkins; Megan Beth,9,0,30,21
1714600197784,EDS 128A,A01,507264,Fargason; Sharon Gayle,8,0,26,18
1714600198814,EDS 128B,A01,507293,Pappas; Elizabeth,12,0,30,18
1714600199839,EDS 139,A00,507294,Fargason; Sharon Gayle,13,0,30,17
1714600199839,EDS 139,B00,507313,Pappas; Elizabeth,13,0,30,17
1714600200866,EDS 201,A00,507315,Staff,13,0,30,17
1714600201895,EDS 203,A01,507317,Halter; Christopher P.,12,0,30,18
1714600202924,EDS 204R,A01,507319,Halter; Christopher P.,0,3,30,30
1714600202924,EDS 204R,B01,507331,Heinzman; Erica M.,16,0,30,14
1714600203953,EDS 206R,A00,507332,Staff,0,4,30,30
1714600203953,EDS 206R,B00,507343,Staff,17,0,30,13
1714600204982,EDS 250,A00,507344,Hemans; Patricia Ann Benitez,22,0,40,18
1714600206011,EDS 281,A00,507345,Daly; Alan J.,18,0,18,0
1714600207039,EDS 284,A00,507350,Daly; Alan J.,16,0,16,0
1714600208064,EDS 286,A00,507359,Fine; Sarah,18,0,18,0
1714600209090,EDS 289C,A01,507361,Daly; Alan J.,18,0,18,0
1714600210116,EDS 290,A00,507366,Hofstetter; Carolyn,15,0,15,0
1714600211146,LIGM 5A,A00,507421,Fischer-Grunski; Eva K,18,0,20,2
1714600212173,LIGM 5B,A00,507423,Fischer-Grunski; Eva K,19,0,20,1
1714600213197,LIGM 5C,A00,507425,Fischer-Grunski; Eva K,19,0,20,1
1714600214223,LIIT 5AS,A00,507427,Carnelos; Chiara,20,0,20,0
1714600215251,LIIT 5BS,A00,507430,Carnelos; Chiara,20,0,20,0
1714600216278,LIIT 5CS,A00,507432,Carnelos; Chiara,20,0,20,0
1714600217305,LISP 5A,A00,507541,Munoz Sanchez; Alicia,11,0,20,9
1714600218330,LISP 5B,A00,507671,Munoz Sanchez; Alicia,8,0,20,12
1714600219358,LISP 5C,A00,507696,Munoz Sanchez; Alicia,9,0,20,11
1714600220384,MAE 197,001,528363,Boechler; Nicholas Sebastia,9998,0,9999,1
1714600221416,MATH 197,001,523477,Kedlaya; Kiran S.,9995,0,9999,4
1714600221416,MATH 197,002,563811,Zhang; Danna,9995,0,9999,4
1714600221416,MATH 197,003,628552,Dumitriu; Ioana,9998,0,9999,1
1714600222440,MCWP 40R,A00,518780,Staff,2,0,20,18
1714600222440,MCWP 40R,B00,518781,Staff,8,0,20,12
1714600222440,MCWP 40R,C00,518783,Staff,6,0,20,14
1714600223467,MCWP 50R,A00,518791,Staff,0,0,20,20
1714600223467,MCWP 50R,B00,518792,Staff,0,2,20,20
1714600223467,MCWP 50R,C00,518793,Staff,0,2,20,20
1714600223467,MCWP 50R,D00,518794,Staff,0,0,20,20
1714600223467,MCWP 50R,E00,518795,Staff,0,2,20,20
1714600223467,MCWP 50R,F00,518796,Staff,0,0,20,20
1714600223467,MCWP 50R,G00,518797,Staff,0,1,20,20
1714600224492,MMW 12R,A01,514034,Herbst; Matthew,0,0,16,16
1714600224492,MMW 12R,A02,514035,Herbst; Matthew,2,0,16,14
1714600225520,MMW 13R,A01,514037,Staff,0,4,16,16
1714600225520,MMW 13R,A02,514039,Staff,0,2,16,16
1714600225520,MMW 13R,A03,628519,Staff,0,2,16,16
1714600227577,SIO 295LS,A00,523233,Staff,10,0,30,20
1714600228601,SIO 295S,A00,523232,Staff,10,0,30,20
1714600229632,SIOC 290S,A01,637330,Merrifield; Mark A,24,0,30,6
1714600230658,SIOC 291S,A01,637333,Gabriel; Corey John,24,0,30,6
1714600231687,SOCI 117,A01,494376,Staff,0,4,5,5
1714600232712,WES 237B,A00,494380,Staff,9,0,20,11
1714600234791,AESE 279B,A00,494370,Wade; Jon P,0,0,33,33
1714600235819,AIP 197,001,627712,Vespa; Emanuel Ignacio,9998,0,9999,1
1714600236845,ANAR 135S,A00,494369,Braswell; Geoffrey E.,0,0,0,0
1714600237869,BENG 196,001,628496,Engler; Adam J.,9998,0,9999,1
1714600238900,CAT 124RS,A01,519847,Geibel; William,0,0,20,20
1714600239928,CAT 125RS,A01,515971,Geibel; William,0,0,20,20
1714600240954,CLRE 250,A00,511389,Morris; Sheldon,9993,0,9999,6
1714600241981,CLRE 251,A00,507176,Mehta; Ravindra L.,9993,0,9999,6
1714600241981,CLRE 251,B00,511410,Mehta; Ravindra L.,9998,0,9999,1
1714600243066,CLRE 252,A00,507189,Cuomo; Raphael Eduardo,9995,0,9999,4
1714600244092,CLRE 253,A00,507199,Vaida; Florin,9994,0,9999,5
1714600244092,CLRE 253,B00,507202,Vaida; Florin,9999,0,9999,0
1714600245123,CLRE 259,A00,507211,Patel; Hemal,9996,0,9999,3
1714600246151,CLRE 260,A00,507221,Cuomo; Raphael Eduardo,9999,0,9999,0
1714600247180,CLRE 297,001,507242,Cuomo; Raphael Eduardo,9999,0,9999,0
1714600248204,COGS 197,001,638244,Voytek; Bradley Thomas,9998,0,9999,1
1714600249231,CSE 191,A00,516875,Minnes Kemp; Mor Mia,9993,0,9999,6
1714600250255,CSE 197,001,637388,Minnes Kemp; Mor Mia,9998,0,9999,1
1714600251283,CSS 201S,A01,494383,Staff,35,0,35,0
1714600252309,CSS 202S,A01,494387,Staff,35,0,35,0
1714600253334,DSC 197,001,628532,Eldridge; Justin Matthew,9996,0,9999,3
1714600254363,EAP 100,A00,516065,Staff,9797,0,9999,202
1714600255389,ECE 45,A01,507414,Staff,33,0,60,27
1714600257455,ECE 111,A01,507420,Staff,15,0,50,35
1714600258479,ECE 197,001,548057,Sievenpiper; Daniel F.,9993,0,9999,6
1714600259510,EDS 115,A00,507243,Choi; Bailey Miyeon,10,0,28,18
1714600260535,EDS 117,A01,494379,Staff,1,5,30,29
1714600261562,EDS 125,A00,507246,Hopkins; Megan Beth,9,0,30,21
1714600262587,EDS 128A,A01,507264,Fargason; Sharon Gayle,8,0,26,18
1714600263612,EDS 128B,A01,507293,Pappas; Elizabeth,12,0,30,18
1714600264639,EDS 139,A00,507294,Fargason; Sharon Gayle,13,0,30,17
1714600264639,EDS 139,B00,507313,Pappas; Elizabeth,13,0,30,17
1714600265664,EDS 201,A00,507315,Staff,13,0,30,17
1714600266691,EDS 203,A01,507317,Halter; Christopher P.,12,0,30,18
1714600267717,EDS 204R,A01,507319,Halter; Christopher P.,0,3,30,30
1714600267717,EDS 204R,B01,507331,Heinzman; Erica M.,16,0,30,14
1714600268741,EDS 206R,A00,507332,Staff,0,4,30,30
1714600268741,EDS 206R,B00,507343,Staff,17,0,30,13
1714600269767,EDS 250,A00,507344,Hemans; Patricia Ann Benitez,22,0,40,18
1714600270795,EDS 281,A00,507345,Daly; Alan J.,18,0,18,0
1714600271823,EDS 284,A00,507350,Daly; Alan J.,16,0,16,0
1714600272849,EDS 286,A00,507359,Fine; Sarah,18,0,18,0
1714600273875,EDS 289C,A01,507361,Daly; Alan J.,18,0,18,0
1714600274904,EDS 290,A00,507366,Hofstetter; Carolyn,15,0,15,0
1714600275931,LIGM 5A,A00,507421,Fischer-Grunski; Eva K,18,0,20,2
1714600276955,LIGM 5B,A00,507423,Fischer-Grunski; Eva K,19,0,20,1
1714600277981,LIGM 5C,A00,507425,Fischer-Grunski; Eva K,19,0,20,1
1714600279008,LIIT 5AS,A00,507427,Carnelos; Chiara,20,0,20,0
1714600280035,LIIT 5BS,A00,507430,Carnelos; Chiara,20,0,20,0
1714600281061,LIIT 5CS,A00,507432,Carnelos; Chiara,20,0,20,0
1714600282087,LISP 5A,A00,507541,Munoz Sanchez; Alicia,11,0,20,9
1714600283117,LISP 5B,A00,507671,Munoz Sanchez; Alicia,8,0,20,12
1714600284144,LISP 5C,A00,507696,Munoz Sanchez; Alicia,9,0,20,11
1714600285171,MAE 197,001,528363,Boechler; Nicholas Sebastia,9998,0,9999,1
1714600286202,MATH 197,001,523477,Kedlaya; Kiran S.,9995,0,9999,4
1714600286202,MATH 197,002,563811,Zhang; Danna,9995,0,9999,4
1714600286202,MATH 197,003,628552,Dumitriu; Ioana,9998,0,9999,1
1714600287231,MCWP 40R,A00,518780,Staff,2,0,20,18
1714600287231,MCWP 40R,B00,518781,Staff,8,0,20,12
1714600287231,MCWP 40R,C00,518783,Staff,6,0,20,14
1714600288263,MCWP 50R,A00,518791,Staff,0,0,20,20
1714600288263,MCWP 50R,B00,518792,Staff,0,2,20,20
1714600288263,MCWP 50R,C00,518793,Staff,0,2,20,20
1714600288263,MCWP 50R,D00,518794,Staff,0,0,20,20
1714600288263,MCWP 50R,E00,518795,Staff,0,2,20,20
1714600288263,MCWP 50R,F00,518796,Staff,0,0,20,20
1714600288263,MCWP 50R,G00,518797,Staff,0,1,20,20
1714600289291,MMW 12R,A01,514034,Herbst; Matthew,0,0,16,16
1714600289291,MMW 12R,A02,514035,Herbst; Matthew,2,0,16,14
1714600290316,MMW 13R,A01,514037,Staff,0,4,16,16
1714600290316,MMW 13R,A02,514039,Staff,0,2,16,16
1714600290316,MMW 13R,A03,628519,Staff,0,2,16,16
1714600292366,SIO 295LS,A00,523233,Staff,10,0,30,20
1714600293392,SIO 295S,A00,523232,Staff,10,0,30,20
1714600294417,SIOC 290S,A01,637330,Merrifield; Mark A,24,0,30,6
1714600295443,SIOC 291S,A01,637333,Gabriel; Corey John,24,0,30,6
1714600296471,SOCI 117,A01,494376,Staff,0,4,5,5
1714600297496,WES 237B,A00,494380,Staff,9,0,20,11
1714600299575,AESE 279B,A00,494370,Wade; Jon P,0,0,33,33
1714600300601,AIP 197,001,627712,Vespa; Emanuel Ignacio,9998,0,9999,1
1714600301626,ANAR 135S,A00,494369,Braswell; Geoffrey E.,0,0,0,0
1714600302656,BENG 196,001,628496,Engler; Adam J.,9998,0,9999,1
1714600303685,CAT 124RS,A01,519847,Geibel; William,0,0,20,20
1714600304713,CAT 125RS,A01,515971,Geibel; William,0,0,20,20
1714600305741,CLRE 250,A00,511389,Morris; Sheldon,9993,0,9999,6
1714600306768,CLRE 251,A00,507176,Mehta; Ravindra L.,9993,0,9999,6
1714600306768,CLRE 251,B00,511410,Mehta; Ravindra L.,9998,0,9999,1
1714600307795,CLRE 252,A00,507189,Cuomo; Raphael Eduardo,9995,0,9999,4
1714600308819,CLRE 253,A00,507199,Vaida; Florin,9994,0,9999,5
1714600308819,CLRE 253,B00,507202,Vaida; Florin,9999,0,9999,0
1714600309844,CLRE 259,A00,507211,Patel; Hemal,9996,0,9999,3
1714600310871,CLRE 260,A00,507221,Cuomo; Raphael Eduardo,9999,0,9999,0
1714600311896,CLRE 297,001,507242,Cuomo; Raphael Eduardo,9999,0,9999,0
1714600312922,COGS 197,001,638244,Voytek; Bradley Thomas,9998,0,9999,1
1714600313948,CSE 191,A00,516875,Minnes Kemp; Mor Mia,9993,0,9999,6
1714600314972,CSE 197,001,637388,Minnes Kemp; Mor Mia,9998,0,9999,1
1714600316000,CSS 201S,A01,494383,Staff,35,0,35,0
1714600317029,CSS 202S,A01,494387,Staff,35,0,35,0
1714600318057,DSC 197,001,628532,Eldridge; Justin Matthew,9996,0,9999,3
1714600319083,EAP 100,A00,516065,Staff,9797,0,9999,202
1714600320110,ECE 45,A01,507414,Staff,33,0,60,27
1714600322160,ECE 111,A01,507420,Staff,15,0,50,35
1714600323186,ECE 197,001,548057,Sievenpiper; Daniel F.,9993,0,9999,6
1714600324216,EDS 115,A00,507243,Choi; Bailey Miyeon,10,0,28,18
1714600325245,EDS 117,A01,494379,Staff,1,5,30,29
1714600326270,EDS 125,A00,507246,Hopkins; Megan Beth,9,0,30,21
1714600327299,EDS 128A,A01,507264,Fargason; Sharon Gayle,8,0,26,18
1714600328325,EDS 128B,A01,507293,Pappas; Elizabeth,12,0,30,18
1714600329351,EDS 139,A00,507294,Fargason; Sharon Gayle,13,0,30,17
1714600329351,EDS 139,B00,507313,Pappas; Elizabeth,13,0,30,17
1714600330376,EDS 201,A00,507315,Staff,13,0,30,17
1714600331406,EDS 203,A01,507317,Halter; Christopher P.,12,0,30,18
1714600332434,EDS 204R,A01,507319,Halter; Christopher P.,0,3,30,30
1714600332434,EDS 204R,B01,507331,Heinzman; Erica M.,16,0,30,14
1714600333461,EDS 206R,A00,507332,Staff,0,4,30,30
1714600333461,EDS 206R,B00,507343,Staff,17,0,30,13
1714600334484,EDS 250,A00,507344,Hemans; Patricia Ann Benitez,22,0,40,18
1714600335513,EDS 281,A00,507345,Daly; Alan J.,18,0,18,0
1714600336538,EDS 284,A00,507350,Daly; Alan J.,16,0,16,0
1714600337565,EDS 286,A00,507359,Fine; Sarah,18,0,18,0
1714600338591,EDS 289C,A01,507361,Daly; Alan J.,18,0,18,0
1714600339619,EDS 290,A00,507366,Hofstetter; Carolyn,15,0,15,0
1714600340649,LIGM 5A,A00,507421,Fischer-Grunski; Eva K,18,0,20,2
1714600341674,LIGM 5B,A00,507423,Fischer-Grunski; Eva K,19,0,20,1
1714600342698,LIGM 5C,A00,507425,Fischer-Grunski; Eva K,19,0,20,1
1714600343727,LIIT 5AS,A00,507427,Carnelos; Chiara,20,0,20,0
1714600344751,LIIT 5BS,A00,507430,Carnelos; Chiara,20,0,20,0
1714600345777,LIIT 5CS,A00,507432,Carnelos; Chiara,20,0,20,0
1714600346802,LISP 5A,A00,507541,Munoz Sanchez; Alicia,11,0,20,9
1714600347828,LISP 5B,A00,507671,Munoz Sanchez; Alicia,8,0,20,12
1714600348857,LISP 5C,A00,507696,Munoz Sanchez; Alicia,9,0,20,11
1714600349885,MAE 197,001,528363,Boechler; Nicholas Sebastia,9998,0,9999,1
1714600350913,MATH 197,001,523477,Kedlaya; Kiran S.,9995,0,9999,4
1714600350913,MATH 197,002,563811,Zhang; Danna,9995,0,9999,4
1714600350913,MATH 197,003,628552,Dumitriu; Ioana,9998,0,9999,1
1714600351937,MCWP 40R,A00,518780,Staff,2,0,20,18
1714600351937,MCWP 40R,B00,518781,Staff,8,0,20,12
1714600351937,MCWP 40R,C00,518783,Staff,6,0,20,14
1714600352962,MCWP 50R,A00,518791,Staff,0,0,20,20
1714600352962,MCWP 50R,B00,518792,Staff,0,2,20,20
1714600352962,MCWP 50R,C00,518793,Staff,0,2,20,20
1714600352962,MCWP 50R,D00,518794,Staff,0,0,20,20
1714600352962,MCWP 50R,E00,518795,Staff,0,2,20,20
1714600352962,MCWP 50R,F00,518796,Staff,0,0,20,20
1714600352962,MCWP 50R,G00,518797,Staff,0,1,20,20
1714600353990,MMW 12R,A01,514034,Herbst; Matthew,0,0,16,16
1714600353990,MMW 12R,A02,514035,Herbst; Matthew,2,0,16,14
1714600355014,MMW 13R,A01,514037,Staff,0,4,16,16
1714600355014,MMW 13R,A02,514039,Staff,0,2,16,16
1714600355014,MMW 13R,A03,628519,Staff,0,2,16,16
1714600357071,SIO 295LS,A00,523233,Staff,10,0,30,20
1714600358095,SIO 295S,A00,523232,Staff,10,0,30,20
1714600359121,SIOC 290S,A01,637330,Merrifield; Mark A,24,0,30,6
1714600360146,SIOC 291S,A01,637333,Gabriel; Corey John,24,0,30,6
1714600361173,SOCI 117,A01,494376,Staff,0,4,5,5
1714600362197,WES 237B,A00,494380,Staff,9,0,20,11
1714600364276,AESE 279B,A00,494370,Wade; Jon P,0,0,33,33
1714600365302,AIP 197,001,627712,Vespa; Emanuel Ignacio,9998,0,9999,1
1714600366331,ANAR 135S,A00,494369,Braswell; Geoffrey E.,0,0,0,0
1714600367359,BENG 196,001,628496,Engler; Adam J.,9998,0,9999,1
1714600368389,CAT 124RS,A01,519847,Geibel; William,0,0,20,20
1714600369415,CAT 125RS,A01,515971,Geibel; William,0,0,20,20
1714600370441,CLRE 250,A00,511389,Morris; Sheldon,9993,0,9999,6
1714600371467,CLRE 251,A00,507176,Mehta; Ravindra L.,9993,0,9999,6
1714600371467,CLRE 251,B00,511410,Mehta; Ravindra L.,9998,0,9999,1
1714600372492,CLRE 252,A00,507189,Cuomo; Raphael Eduardo,9995,0,9999,4
1714600373517,CLRE 253,A00,507199,Vaida; Florin,9994,0,9999,5
1714600373517,CLRE 253,B00,507202,Vaida; Florin,9999,0,9999,0
1714600374546,CLRE 259,A00,507211,Patel; Hemal,9996,0,9999,3
1714600375572,CLRE 260,A00,507221,Cuomo; Raphael Eduardo,9999,0,9999,0
1714600376595,CLRE 297,001,507242,Cuomo; Raphael Eduardo,9999,0,9999,0
1714600377621,COGS 197,001,638244,Voytek; Bradley Thomas,9998,0,9999,1
1714600378648,CSE 191,A00,516875,Minnes Kemp; Mor Mia,9993,0,9999,6
1714600379673,CSE 197,001,637388,Minnes Kemp; Mor Mia,9998,0,9999,1
1714600380699,CSS 201S,A01,494383,Staff,35,0,35,0
1714600381724,CSS 202S,A01,494387,Staff,35,0,35,0
1714600382749,DSC 197,001,628532,Eldridge; Justin Matthew,9996,0,9999,3
1714600383774,EAP 100,A00,516065,Staff,9797,0,9999,202
1714600384804,ECE 45,A01,507414,Staff,33,0,60,27
1714600386855,ECE 111,A01,507420,Staff,15,0,50,35
1714600387879,ECE 197,001,548057,Sievenpiper; Daniel F.,9993,0,9999,6
1714600388912,EDS 115,A00,507243,Choi; Bailey Miyeon,10,0,28,18
1714600389937,EDS 117,A01,494379,Staff,1,5,30,29
1714600390963,EDS 125,A00,507246,Hopkins; Megan Beth,9,0,30,21
1714600391988,EDS 128A,A01,507264,Fargason; Sharon Gayle,8,0,26,18
1714600393013,EDS 128B,A01,507293,Pappas; Elizabeth,12,0,30,18
1714600394043,EDS 139,A00,507294,Fargason; Sharon Gayle,13,0,30,17
1714600394043,EDS 139,B00,507313,Pappas; Elizabeth,13,0,30,17
1714600395070,EDS 201,A00,507315,Staff,13,0,30,17
1714600396096,EDS 203,A01,507317,Halter; Christopher P.,12,0,30,18
1714600397124,EDS 204R,A01,507319,Halter; Christopher P.,0,3,30,30
1714600397124,EDS 204R,B01,507331,Heinzman; Erica M.,16,0,30,14
1714600398152,EDS 206R,A00,507332,Staff,0,4,30,30
1714600398152,EDS 206R,B00,507343,Staff,17,0,30,13
1714600399177,EDS 250,A00,507344,Hemans; Patricia Ann Benitez,22,0,40,18
1714600400201,EDS 281,A00,507345,Daly; Alan J.,18,0,18,0
1714600401226,EDS 284,A00,507350,Daly; Alan J.,16,0,16,0
1714600402254,EDS 286,A00,507359,Fine; Sarah,18,0,18,0
1714600403277,EDS 289C,A01,507361,Daly; Alan J.,18,0,18,0
1714600404302,EDS 290,A00,507366,Hofstetter; Carolyn,15,0,15,0
1714600405331,LIGM 5A,A00,507421,Fischer-Grunski; Eva K,18,0,20,2
1714600406360,LIGM 5B,A00,507423,Fischer-Grunski; Eva K,19,0,20,1
1714600407390,LIGM 5C,A00,507425,Fischer-Grunski; Eva K,19,0,20,1
1714600408420,LIIT 5AS,A00,507427,Carnelos; Chiara,20,0,20,0
1714600409447,LIIT 5BS,A00,507430,Carnelos; Chiara,20,0,20,0
1714600410476,LIIT 5CS,A00,507432,Carnelos; Chiara,20,0,20,0
1714600411500,LISP 5A,A00,507541,Munoz Sanchez; Alicia,11,0,20,9
1714600412528,LISP 5B,A00,507671,Munoz Sanchez; Alicia,8,0,20,12
1714600413552,LISP 5C,A00,507696,Munoz Sanchez; Alicia,9,0,20,11
1714600414577,MAE 197,001,528363,Boechler; Nicholas Sebastia,9998,0,9999,1
1714600415605,MATH 197,001,523477,Kedlaya; Kiran S.,9995,0,9999,4
1714600415605,MATH 197,002,563811,Zhang; Danna,9995,0,9999,4
1714600415605,MATH 197,003,628552,Dumitriu; Ioana,9998,0,9999,1
1714600416630,MCWP 40R,A00,518780,Staff,2,0,20,18
1714600416630,MCWP 40R,B00,518781,Staff,8,0,20,12
1714600416630,MCWP 40R,C00,518783,Staff,6,0,20,14
1714600417660,MCWP 50R,A00,518791,Staff,0,0,20,20
1714600417660,MCWP 50R,B00,518792,Staff,0,2,20,20
1714600417660,MCWP 50R,C00,518793,Staff,0,2,20,20
1714600417660,MCWP 50R,D00,518794,Staff,0,0,20,20
1714600417660,MCWP 50R,E00,518795,Staff,0,2,20,20
1714600417660,MCWP 50R,F00,518796,Staff,0,0,20,20
1714600417660,MCWP 50R,G00,518797,Staff,0,1,20,20
1714600418687,MMW 12R,A01,514034,Herbst; Matthew,0,0,16,16
1714600418687,MMW 12R,A02,514035,Herbst; Matthew,2,0,16,14
1714600419713,MMW 13R,A01,514037,Staff,0,4,16,16
1714600419713,MMW 13R,A02,514039,Staff,0,2,16,16
1714600419713,MMW 13R,A03,628519,Staff,0,2,16,16
1714600421767,SIO 295LS,A00,523233,Staff,10,0,30,20
1714600422791,SIO 295S,A00,523232,Staff,10,0,30,20
1714600423816,SIOC 290S,A01,637330,Merrifield; Mark A,24,0,30,6
1714600424846,SIOC 291S,A01,637333,Gabriel; Corey John,24,0,30,6
1714600425870,SOCI 117,A01,494376,Staff,0,4,5,5
1714600426894,WES 237B,A00,494380,Staff,9,0,20,11
1714600428971,AESE 279B,A00,494370,Wade; Jon P,0,0,33,33
1714600429997,AIP 197,001,627712,Vespa; Emanuel Ignacio,9998,0,9999,1
1714600431079,ANAR 135S,A00,494369,Braswell; Geoffrey E.,0,0,0,0
1714600432109,BENG 196,001,628496,Engler; Adam J.,9998,0,9999,1
1714600433134,CAT 124RS,A01,519847,Geibel; William,0,0,20,20
1714600434158,CAT 125RS,A01,515971,Geibel; William,0,0,20,20
1714600435186,CLRE 250,A00,511389,Morris; Sheldon,9993,0,9999,6
1714600436213,CLRE 251,A00,507176,Mehta; Ravindra L.,9993,0,9999,6
1714600436213,CLRE 251,B00,511410,Mehta; Ravindra L.,9998,0,9999,1
1714600437239,CLRE 252,A00,507189,Cuomo; Raphael Eduardo,9995,0,9999,4
1714600438266,CLRE 253,A00,507199,Vaida; Florin,9994,0,9999,5
1714600438266,CLRE 253,B00,507202,Vaida; Florin,9999,0,9999,0
1714600439291,CLRE 259,A00,507211,Patel; Hemal,9996,0,9999,3
1714600440316,CLRE 260,A00,507221,Cuomo; Raphael Eduardo,9999,0,9999,0
1714600441341,CLRE 297,001,507242,Cuomo; Raphael Eduardo,9999,0,9999,0
1714600442372,COGS 197,001,638244,Voytek; Bradley Thomas,9998,0,9999,1
1714600443396,CSE 191,A00,516875,Minnes Kemp; Mor Mia,9993,0,9999,6
1714600444422,CSE 197,001,637388,Minnes Kemp; Mor Mia,9998,0,9999,1
1714600445448,CSS 201S,A01,494383,Staff,35,0,35,0
1714600446473,CSS 202S,A01,494387,Staff,35,0,35,0
1714600447500,DSC 197,001,628532,Eldridge; Justin Matthew,9996,0,9999,3
1714600448525,EAP 100,A00,516065,Staff,9797,0,9999,202
1714600449552,ECE 45,A01,507414,Staff,33,0,60,27
1714600451605,ECE 111,A01,507420,Staff,15,0,50,35
1714600452632,ECE 197,001,548057,Sievenpiper; Daniel F.,9993,0,9999,6
1714600453662,EDS 115,A00,507243,Choi; Bailey Miyeon,10,0,28,18
1714600454696,EDS 117,A01,494379,Staff,1,5,30,29
1714600455722,EDS 125,A00,507246,Hopkins; Megan Beth,9,0,30,21
1714600456748,EDS 128A,A01,507264,Fargason; Sharon Gayle,8,0,26,18
1714600457774,EDS 128B,A01,507293,Pappas; Elizabeth,12,0,30,18
1714600458801,EDS 139,A00,507294,Fargason; Sharon Gayle,13,0,30,17
1714600458801,EDS 139,B00,507313,Pappas; Elizabeth,13,0,30,17
1714600459826,EDS 201,A00,507315,Staff,13,0,30,17
1714600460851,EDS 203,A01,507317,Halter; Christopher P.,12,0,30,18
1714600461878,EDS 204R,A01,507319,Halter; Christopher P.,0,3,30,30
1714600461878,EDS 204R,B01,507331,Heinzman; Erica M.,16,0,30,14
1714600462906,EDS 206R,A00,507332,Staff,0,4,30,30
1714600462906,EDS 206R,B00,507343,Staff,17,0,30,13
1714600463935,EDS 250,A00,507344,Hemans; Patricia Ann Benitez,22,0,40,18
1714600464962,EDS 281,A00,507345,Daly; Alan J.,18,0,18,0
1714600465989,EDS 284,A00,507350,Daly; Alan J.,16,0,16,0
1714600467014,EDS 286,A00,507359,Fine; Sarah,18,0,18,0
1714600468038,EDS 289C,A01,507361,Daly; Alan J.,18,0,18,0
1714600469066,EDS 290,A00,507366,Hofstetter; Carolyn,15,0,15,0
1714600470097,LIGM 5A,A00,507421,Fischer-Grunski; Eva K,18,0,20,2
1714600471125,LIGM 5B,A00,507423,Fischer-Grunski; Eva K,19,0,20,1
1714600472153,LIGM 5C,A00,507425,Fischer-Grunski; Eva K,19,0,20,1
1714600473178,LIIT 5AS,A00,507427,Carnelos; Chiara,20,0,20,0
1714600474203,LIIT 5BS,A00,507430,Carnelos; Chiara,20,0,20,0
1714600475233,LIIT 5CS,A00,507432,Carnelos; Chiara,20,0,20,0
1714600476260,LISP 5A,A00,507541,Munoz Sanchez; Alicia,11,0,20,9
1714600477286,LISP 5B,A00,507671,Munoz Sanchez; Alicia,8,0,20,12
1714600478309,LISP 5C,A00,507696,Munoz Sanchez; Alicia,9,0,20,11
1714600479333,MAE 197,001,528363,Boechler; Nicholas Sebastia,9998,0,9999,1
1714600480360,MATH 197,001,523477,Kedlaya; Kiran S.,9995,0,9999,4
1714600480360,MATH 197,002,563811,Zhang; Danna,9995,0,9999,4
1714600480360,MATH 197,003,628552,Dumitriu; Ioana,9998,0,9999,1
1714600481386,MCWP 40R,A00,518780,Staff,2,0,20,18
1714600481386,MCWP 40R,B00,518781,Staff,8,0,20,12
1714600481386,MCWP 40R,C00,518783,Staff,6,0,20,14
1714600482427,MCWP 50R,A00,518791,Staff,0,0,20,20
1714600482427,MCWP 50R,B00,518792,Staff,0,2,20,20
1714600482427,MCWP 50R,C00,518793,Staff,0,2,20,20
1714600482427,MCWP 50R,D00,518794,Staff,0,0,20,20
1714600482427,MCWP 50R,E00,518795,Staff,0,2,20,20
1714600482427,MCWP 50R,F00,518796,Staff,0,0,20,20
1714600482427,MCWP 50R,G00,518797,Staff,0,1,20,20
1714600483456,MMW 12R,A01,514034,Herbst; Matthew,0,0,16,16
1714600483456,MMW 12R,A02,514035,Herbst; Matthew,2,0,16,14
1714600484482,MMW 13R,A01,514037,Staff,0,4,16,16
1714600484482,MMW 13R,A02,514039,Staff,0,2,16,16
1714600484482,MMW 13R,A03,628519,Staff,0,2,16,16
1714600486531,SIO 295LS,A00,523233,Staff,10,0,30,20
1714600487555,SIO 295S,A00,523232,Staff,10,0,30,20
1714600488580,SIOC 290S,A01,637330,Merrifield; Mark A,24,0,30,6
1714600489609,SIOC 291S,A01,637333,Gabriel; Corey John,24,0,30,6
1714600490637,SOCI 117,A01,494376,Staff,0,4,5,5
1714600491664,WES 237B,A00,494380,Staff,9,0,20,11
1714600493743,AESE 279B,A00,494370,Wade; Jon P,0,0,33,33
1714600494768,AIP 197,001,627712,Vespa; Emanuel Ignacio,9998,0,9999,1
1714600495793,ANAR 135S,A00,494369,Braswell; Geoffrey E.,0,0,0,0
1714600496818,BENG 196,001,628496,Engler; Adam J.,9998,0,9999,1
1714600497845,CAT 124RS,A01,519847,Geibel; William,0,0,20,20
1714600498872,CAT 125RS,A01,515971,Geibel; William,0,0,20,20
1714600499896,CLRE 250,A00,511389,Morris; Sheldon,9993,0,9999,6
1714600500925,CLRE 251,A00,507176,Mehta; Ravindra L.,9993,0,9999,6
1714600500925,CLRE 251,B00,511410,Mehta; Ravindra L.,9998,0,9999,1
1714600501952,CLRE 252,A00,507189,Cuomo; Raphael Eduardo,9995,0,9999,4
1714600502980,CLRE 253,A00,507199,Vaida; Florin,9994,0,9999,5
1714600502980,CLRE 253,B00,507202,Vaida; Florin,9999,0,9999,0
1714600504008,CLRE 259,A00,507211,Patel; Hemal,9996,0,9999,3
1714600505033,CLRE 260,A00,507221,Cuomo; Raphael Eduardo,9999,0,9999,0
1714600506058,CLRE 297,001,507242,Cuomo; Raphael Eduardo,9999,0,9999,0
1714600507084,COGS 197,001,638244,Voytek; Bradley Thomas,9998,0,9999,1
1714600508115,CSE 191,A00,516875,Minnes Kemp; Mor Mia,9993,0,9999,6
1714600509139,CSE 197,001,637388,Minnes Kemp; Mor Mia,9998,0,9999,1
1714600510166,CSS 201S,A01,494383,Staff,35,0,35,0
1714600511193,CSS 202S,A01,494387,Staff,35,0,35,0
1714600512218,DSC 197,001,628532,Eldridge; Justin Matthew,9996,0,9999,3
1714600513246,EAP 100,A00,516065,Staff,9797,0,9999,202
1714600514276,ECE 45,A01,507414,Staff,33,0,60,27
1714600516330,ECE 111,A01,507420,Staff,15,0,50,35
1714600517354,ECE 197,001,548057,Sievenpiper; Daniel F.,9993,0,9999,6
1714600518381,EDS 115,A00,507243,Choi; Bailey Miyeon,10,0,28,18
1714600519406,EDS 117,A01,494379,Staff,1,5,30,29
1714600520431,EDS 125,A00,507246,Hopkins; Megan Beth,9,0,30,21
1714600521458,EDS 128A,A01,507264,Fargason; Sharon Gayle,8,0,26,18
1714600522483,EDS 128B,A01,507293,Pappas; Elizabeth,12,0,30,18
1714600523509,EDS 139,A00,507294,Fargason; Sharon Gayle,13,0,30,17
1714600523509,EDS 139,B00,507313,Pappas; Elizabeth,13,0,30,17
1714600524533,EDS 201,A00,507315,Staff,13,0,30,17
1714600525562,EDS 203,A01,507317,Halter; Christopher P.,12,0,30,18
1714600526588,EDS 204R,A01,507319,Halter; Christopher P.,0,3,30,30
1714600526588,EDS 204R,B01,507331,Heinzman; Erica M.,16,0,30,14
1714600527613,EDS 206R,A00,507332,Staff,0,4,30,30
1714600527613,EDS 206R,B00,507343,Staff,17,0,30,13
1714600528642,EDS 250,A00,507344,Hemans; Patricia Ann Benitez,22,0,40,18
1714600529667,EDS 281,A00,507345,Daly; Alan J.,18,0,18,0
1714600530695,EDS 284,A00,507350,Daly; Alan J.,16,0,16,0
1714600531722,EDS 286,A00,507359,Fine; Sarah,18,0,18,0
1714600532748,EDS 289C,A01,507361,Daly; Alan J.,18,0,18,0
1714600533775,EDS 290,A00,507366,Hofstetter; Carolyn,15,0,15,0
1714600534855,LIGM 5A,A00,507421,Fischer-Grunski; Eva K,18,0,20,2
1714600535881,LIGM 5B,A00,507423,Fischer-Grunski; Eva K,19,0,20,1
1714600536910,LIGM 5C,A00,507425,Fischer-Grunski; Eva K,19,0,20,1
1714600537939,LIIT 5AS,A00,507427,Carnelos; Chiara,20,0,20,0
1714600538968,LIIT 5BS,A00,507430,Carnelos; Chiara,20,0,20,0
1714600539998,LIIT 5CS,A00,507432,Carnelos; Chiara,20,0,20,0
1714600541026,LISP 5A,A00,507541,Munoz Sanchez; Alicia,11,0,20,9
1714600542055,LISP 5B,A00,507671,Munoz Sanchez; Alicia,8,0,20,12
1714600543080,LISP 5C,A00,507696,Munoz Sanchez; Alicia,9,0,20,11
1714600544108,MAE 197,001,528363,Boechler; Nicholas Sebastia,9998,0,9999,1
1714600545136,MATH 197,001,523477,Kedlaya; Kiran S.,9995,0,9999,4
1714600545136,MATH 197,002,563811,Zhang; Danna,9995,0,9999,4
1714600545136,MATH 197,003,628552,Dumitriu; Ioana,9998,0,9999,1
1714600546163,MCWP 40R,A00,518780,Staff,2,0,20,18
1714600546163,MCWP 40R,B00,518781,Staff,8,0,20,12
1714600546163,MCWP 40R,C00,518783,Staff,6,0,20,14
1714600547189,MCWP 50R,A00,518791,Staff,0,0,20,20
1714600547189,MCWP 50R,B00,518792,Staff,0,2,20,20
1714600547189,MCWP 50R,C00,518793,Staff,0,2,20,20
1714600547189,MCWP 50R,D00,518794,Staff,0,0,20,20
1714600547189,MCWP 50R,E00,518795,Staff,0,2,20,20
1714600547189,MCWP 50R,F00,518796,Staff,0,0,20,20
1714600547189,MCWP 50R,G00,518797,Staff,0,1,20,20
1714600548218,MMW 12R,A01,514034,Herbst; Matthew,0,0,16,16
1714600548218,MMW 12R,A02,514035,Herbst; Matthew,2,0,16,14
1714600549242,MMW 13R,A01,514037,Staff,0,4,16,16
1714600549242,MMW 13R,A02,514039,Staff,0,2,16,16
1714600549242,MMW 13R,A03,628519,Staff,0,2,16,16
1714600551294,SIO 295LS,A00,523233,Staff,10,0,30,20
1714600552318,SIO 295S,A00,523232,Staff,10,0,30,20
1714600553344,SIOC 290S,A01,637330,Merrifield; Mark A,24,0,30,6
1714600554370,SIOC 291S,A01,637333,Gabriel; Corey John,24,0,30,6
1714600555398,SOCI 117,A01,494376,Staff,0,4,5,5
1714600556426,WES 237B,A00,494380,Staff,9,0,20,11
1714600558505,AESE 279B,A00,494370,Wade; Jon P,0,0,33,33
1714600559531,AIP 197,001,627712,Vespa; Emanuel Ignacio,9998,0,9999,1
1714600560557,ANAR 135S,A00,494369,Braswell; Geoffrey E.,0,0,0,0
1714600561587,BENG 196,001,628496,Engler; Adam J.,9998,0,9999,1
1714600562614,CAT 124RS,A01,519847,Geibel; William,0,0,20,20
1714600563643,CAT 125RS,A01,515971,Geibel; William,0,0,20,20
1714600564671,CLRE 250,A00,511389,Morris; Sheldon,9993,0,9999,6
1714600565704,CLRE 251,A00,507176,Mehta; Ravindra L.,9993,0,9999,6
1714600565704,CLRE 251,B00,511410,Mehta; Ravindra L.,9998,0,9999,1
1714600566733,CLRE 252,A00,507189,Cuomo; Raphael Eduardo,9995,0,9999,4
1714600567760,CLRE 253,A00,507199,Vaida; Florin,9994,0,9999,5
1714600567760,CLRE 253,B00,507202,Vaida; Florin,9999,0,9999,0
1714600568788,CLRE 259,A00,507211,Patel; Hemal,9996,0,9999,3
1714600569816,CLRE 260,A00,507221,Cuomo; Raphael Eduardo,9999,0,9999,0
1714600570845,CLRE 297,001,507242,Cuomo; Raphael Eduardo,9999,0,9999,0
1714600571873,COGS 197,001,638244,Voytek; Bradley Thomas,9998,0,9999,1
1714600572899,CSE 191,A00,516875,Minnes Kemp; Mor Mia,9993,0,9999,6
1714600573926,CSE 197,001,637388,Minnes Kemp; Mor Mia,9998,0,9999,1
1714600574955,CSS 201S,A01,494383,Staff,35,0,35,0
1714600575981,CSS 202S,A01,494387,Staff,35,0,35,0
1714600577007,DSC 197,001,628532,Eldridge; Justin Matthew,9996,0,9999,3
1714600578030,EAP 100,A00,516065,Staff,9797,0,9999,202
1714600579056,ECE 45,A01,507414,Staff,33,0,60,27
1714600581112,ECE 111,A01,507420,Staff,15,0,50,35
1714600582137,ECE 197,001,548057,Sievenpiper; Daniel F.,9993,0,9999,6
1714600583162,EDS 115,A00,507243,Choi; Bailey Miyeon,10,0,28,18
1714600584186,EDS 117,A01,494379,Staff,1,5,30,29
1714600585211,EDS 125,A00,507246,Hopkins; Megan Beth,9,0,30,21
1714600586243,EDS 128A,A01,507264,Fargason; Sharon Gayle,8,0,26,18
1714600587273,EDS 128B,A01,507293,Pappas; Elizabeth,12,0,30,18
1714600588302,EDS 139,A00,507294,Fargason; Sharon Gayle,13,0,30,17
1714600588302,EDS 139,B00,507313,Pappas; Elizabeth,13,0,30,17
1714600589326,EDS 201,A00,507315,Staff,13,0,30,17
1714600590353,EDS 203,A01,507317,Halter; Christopher P.,12,0,30,18
1714600591380,EDS 204R,A01,507319,Halter; Christopher P.,0,3,30,30
1714600591380,EDS 204R,B01,507331,Heinzman; Erica M.,16,0,30,14
1714600592421,EDS 206R,A00,507332,Staff,0,4,30,30
1714600592421,EDS 206R,B00,507343,Staff,17,0,30,13
1714600593447,EDS 250,A00,507344,Hemans; Patricia Ann Benitez,22,0,40,18
1714600594471,EDS 281,A00,507345,Daly; Alan J.,18,0,18,0
1714600595498,EDS 284,A00,507350,Daly; Alan J.,16,0,16,0
1714600596523,EDS 286,A00,507359,Fine; Sarah,18,0,18,0
1714600597550,EDS 289C,A01,507361,Daly; Alan J.,18,0,18,0
1714600598574,EDS 290,A00,507366,Hofstetter; Carolyn,15,0,15,0
1714600599602,LIGM 5A,A00,507421,Fischer-Grunski; Eva K,18,0,20,2
1714600600630,LIGM 5B,A00,507423,Fischer-Grunski; Eva K,19,0,20,1
1714600601654,LIGM 5C,A00,507425,Fischer-Grunski; Eva K,19,0,20,1
1714600602684,LIIT 5AS,A00,507427,Carnelos; Chiara,20,0,20,0
1714600603708,LIIT 5BS,A00,507430,Carnelos; Chiara,20,0,20,0
1714600604735,LIIT 5CS,A00,507432,Carnelos; Chiara,20,0,20,0
1714600605761,LISP 5A,A00,507541,Munoz Sanchez; Alicia,11,0,20,9
1714600606791,LISP 5B,A00,507671,Munoz Sanchez; Alicia,8,0,20,12
1714600607815,LISP 5C,A00,507696,Munoz Sanchez; Alicia,9,0,20,11
1714600608839,MAE 197,001,528363,Boechler; Nicholas Sebastia,9998,0,9999,1
1714600609867,MATH 197,001,523477,Kedlaya; Kiran S.,9995,0,9999,4
1714600609867,MATH 197,002,563811,Zhang; Danna,9995,0,9999,4
1714600609867,MATH 197,003,628552,Dumitriu; Ioana,9998,0,9999,1
1714600610893,MCWP 40R,A00,518780,Staff,2,0,20,18
1714600610893,MCWP 40R,B00,518781,Staff,8,0,20,12
1714600610893,MCWP 40R,C00,518783,Staff,6,0,20,14
1714600611919,MCWP 50R,A00,518791,Staff,0,0,20,20
1714600611919,MCWP 50R,B00,518792,Staff,0,2,20,20
1714600611919,MCWP 50R,C00,518793,Staff,0,2,20,20
1714600611919,MCWP 50R,D00,518794,Staff,0,0,20,20
1714600611919,MCWP 50R,E00,518795,Staff,0,2,20,20
1714600611919,MCWP 50R,F00,518796,Staff,0,0,20,20
1714600611919,MCWP 50R,G00,518797,Staff,0,1,20,20
1714600612947,MMW 12R,A01,514034,Herbst; Matthew,0,0,16,16
1714600612947,MMW 12R,A02,514035,Herbst; Matthew,2,0,16,14
1714600613974,MMW 13R,A01,514037,Staff,0,4,16,16
1714600613974,MMW 13R,A02,514039,Staff,0,2,16,16
1714600613974,MMW 13R,A03,628519,Staff,0,2,16,16
1714600616025,SIO 295LS,A00,523233,Staff,10,0,30,20
1714600617054,SIO 295S,A00,523232,Staff,10,0,30,20
1714600618086,SIOC 290S,A01,637330,Merrifield; Mark A,24,0,30,6
1714600619112,SIOC 291S,A01,637333,Gabriel; Corey John,24,0,30,6
1714600620138,SOCI 117,A01,494376,Staff,0,4,5,5
1714600621164,WES 237B,A00,494380,Staff,9,0,20,11
1714600623232,AESE 279B,A00,494370,Wade; Jon P,0,0,33,33
1714600624257,AIP 197,001,627712,Vespa; Emanuel Ignacio,9998,0,9999,1
1714600625285,ANAR 135S,A00,494369,Braswell; Geoffrey E.,0,0,0,0
1714600626310,BENG 196,001,628496,Engler; Adam J.,9998,0,9999,1
1714600627334,CAT 124RS,A01,519847,Geibel; William,0,0,20,20
1714600628360,CAT 125RS,A01,515971,Geibel; William,0,0,20,20
1714600629387,CLRE 250,A00,511389,Morris; Sheldon,9993,0,9999,6
1714600630417,CLRE 251,A00,507176,Mehta; Ravindra L.,9993,0,9999,6
1714600630417,CLRE 251,B00,511410,Mehta; Ravindra L.,9998,0,9999,1
1714600631447,CLRE 252,A00,507189,Cuomo; Raphael Eduardo,9995,0,9999,4
1714600632473,CLRE 253,A00,507199,Vaida; Florin,9994,0,9999,5
1714600632473,CLRE 253,B00,507202,Vaida; Florin,9999,0,9999,0
1714600633500,CLRE 259,A00,507211,Patel; Hemal,9996,0,9999,3
1714600634529,CLRE 260,A00,507221,Cuomo; Raphael Eduardo,9999,0,9999,0
1714600635554,CLRE 297,001,507242,Cuomo; Raphael Eduardo,9999,0,9999,0
1714600636584,COGS 197,001,638244,Voytek; Bradley Thomas,9998,0,9999,1
1714600637608,CSE 191,A00,516875,Minnes Kemp; Mor Mia,9993,0,9999,6
1714600638685,CSE 197,001,637388,Minnes Kemp; Mor Mia,9998,0,9999,1
1714600639713,CSS 201S,A01,494383,Staff,35,0,35,0
1714600640739,CSS 202S,A01,494387,Staff,35,0,35,0
1714600641768,DSC 197,001,628532,Eldridge; Justin Matthew,9996,0,9999,3
1714600642793,EAP 100,A00,516065,Staff,9797,0,9999,202
1714600643821,ECE 45,A01,507414,Staff,33,0,60,27
1714600645874,ECE 111,A01,507420,Staff,15,0,50,35
1714600646900,ECE 197,001,548057,Sievenpiper; Daniel F.,9993,0,9999,6
1714600647927,EDS 115,A00,507243,Choi; Bailey Miyeon,10,0,28,18
1714600648952,EDS 117,A01,494379,Staff,1,5,30,29
1714600649977,EDS 125,A00,507246,Hopkins; Megan Beth,9,0,30,21
1714600651009,EDS 128A,A01,507264,Fargason; Sharon Gayle,8,0,26,18
1714600652034,EDS 128B,A01,507293,Pappas; Elizabeth,12,0,30,18
1714600653063,EDS 139,A00,507294,Fargason; Sharon Gayle,13,0,30,17
1714600653063,EDS 139,B00,507313,Pappas; Elizabeth,13,0,30,17
1714600654088,EDS 201,A00,507315,Staff,13,0,30,17
1714600655114,EDS 203,A01,507317,Halter; Christopher P.,12,0,30,18
1714600656140,EDS 204R,A01,507319,Halter; Christopher P.,0,3,30,30
1714600656140,EDS 204R,B01,507331,Heinzman; Erica M.,16,0,30,14
1714600657165,EDS 206R,A00,507332,Staff,0,4,30,30
1714600657165,EDS 206R,B00,507343,Staff,17,0,30,13
1714600658194,EDS 250,A00,507344,Hemans; Patricia Ann Benitez,22,0,40,18
1714600659222,EDS 281,A00,507345,Daly; Alan J.,18,0,18,0
1714600660247,EDS 284,A00,507350,Daly; Alan J.,16,0,16,0
1714600661276,EDS 286,A00,507359,Fine; Sarah,18,0,18,0
1714600662300,EDS 289C,A01,507361,Daly; Alan J.,18,0,18,0
1714600663330,EDS 290,A00,507366,Hofstetter; Carolyn,15,0,15,0
1714600664360,LIGM 5A,A00,507421,Fischer-Grunski; Eva K,18,0,20,2
1714600665388,LIGM 5B,A00,507423,Fischer-Grunski; Eva K,19,0,20,1
1714600666412,LIGM 5C,A00,507425,Fischer-Grunski; Eva K,19,0,20,1
1714600667439,LIIT 5AS,A00,507427,Carnelos; Chiara,20,0,20,0
1714600668464,LIIT 5BS,A00,507430,Carnelos; Chiara,20,0,20,0
1714600669488,LIIT 5CS,A00,507432,Carnelos; Chiara,20,0,20,0
1714600670514,LISP 5A,A00,507541,Munoz Sanchez; Alicia,11,0,20,9
1714600671542,LISP 5B,A00,507671,Munoz Sanchez; Alicia,8,0,20,12
1714600672567,LISP 5C,A00,507696,Munoz Sanchez; Alicia,9,0,20,11
1714600673593,MAE 197,001,528363,Boechler; Nicholas Sebastia,9998,0,9999,1
1714600674621,MATH 197,001,523477,Kedlaya; Kiran S.,9995,0,9999,4
1714600674621,MATH 197,002,563811,Zhang; Danna,9995,0,9999,4
1714600674621,MATH 197,003,628552,Dumitriu; Ioana,9998,0,9999,1
1714600675647,MCWP 40R,A00,518780,Staff,2,0,20,18
1714600675647,MCWP 40R,B00,518781,Staff,8,0,20,12
1714600675647,MCWP 40R,C00,518783,Staff,6,0,20,14
1714600676672,MCWP 50R,A00,518791,Staff,0,0,20,20
1714600676672,MCWP 50R,B00,518792,Staff,0,2,20,20
1714600676672,MCWP 50R,C00,518793,Staff,0,2,20,20
1714600676672,MCWP 50R,D00,518794,Staff,0,0,20,20
1714600676672,MCWP 50R,E00,518795,Staff,0,2,20,20
1714600676672,MCWP 50R,F00,518796,Staff,0,0,20,20
1714600676672,MCWP 50R,G00,518797,Staff,0,1,20,20
1714600677698,MMW 12R,A01,514034,Herbst; Matthew,0,0,16,16
1714600677698,MMW 12R,A02,514035,Herbst; Matthew,2,0,16,14
1714600678723,MMW 13R,A01,514037,Staff,0,4,16,16
1714600678723,MMW 13R,A02,514039,Staff,0,2,16,16
1714600678723,MMW 13R,A03,628519,Staff,0,2,16,16
1714600680775,SIO 295LS,A00,523233,Staff,10,0,30,20
1714600681800,SIO 295S,A00,523232,Staff,10,0,30,20
1714600682830,SIOC 290S,A01,637330,Merrifield; Mark A,24,0,30,6
1714600683859,SIOC 291S,A01,637333,Gabriel; Corey John,24,0,30,6
1714600684895,SOCI 117,A01,494376,Staff,0,4,5,5
1714600685919,WES 237B,A00,494380,Staff,9,0,20,11
1714600687991,AESE 279B,A00,494370,Wade; Jon P,0,0,33,33
1714600689018,AIP 197,001,627712,Vespa; Emanuel Ignacio,9998,0,9999,1
1714600690048,ANAR 135S,A00,494369,Braswell; Geoffrey E.,0,0,0,0
1714600691074,BENG 196,001,628496,Engler; Adam J.,9998,0,9999,1
1714600692100,CAT 124RS,A01,519847,Geibel; William,0,0,20,20
1714600693123,CAT 125RS,A01,515971,Geibel; William,0,0,20,20
1714600694149,CLRE 250,A00,511389,Morris; Sheldon,9993,0,9999,6
1714600695184,CLRE 251,A00,507176,Mehta; Ravindra L.,9993,0,9999,6
1714600695184,CLRE 251,B00,511410,Mehta; Ravindra L.,9998,0,9999,1
1714600696209,CLRE 252,A00,507189,Cuomo; Raphael Eduardo,9995,0,9999,4
1714600697236,CLRE 253,A00,507199,Vaida; Florin,9994,0,9999,5
1714600697236,CLRE 253,B00,507202,Vaida; Florin,9999,0,9999,0
1714600698261,CLRE 259,A00,507211,Patel; Hemal,9996,0,9999,3
1714600699290,CLRE 260,A00,507221,Cuomo; Raphael Eduardo,9999,0,9999,0
1714600700317,CLRE 297,001,507242,Cuomo; Raphael Eduardo,9999,0,9999,0
1714600701344,COGS 197,001,638244,Voytek; Bradley Thomas,9998,0,9999,1
1714600702369,CSE 191,A00,516875,Minnes Kemp; Mor Mia,9993,0,9999,6
1714600703396,CSE 197,001,637388,Minnes Kemp; Mor Mia,9998,0,9999,1
1714600704425,CSS 201S,A01,494383,Staff,35,0,35,0
1714600705449,CSS 202S,A01,494387,Staff,35,0,35,0
1714600706478,DSC 197,001,628532,Eldridge; Justin Matthew,9996,0,9999,3
1714600707505,EAP 100,A00,516065,Staff,9797,0,9999,202
1714600708531,ECE 45,A01,507414,Staff,33,0,60,27
1714600710582,ECE 111,A01,507420,Staff,15,0,50,35
1714600711608,ECE 197,001,548057,Sievenpiper; Daniel F.,9993,0,9999,6
1714600712634,EDS 115,A00,507243,Choi; Bailey Miyeon,10,0,28,18
1714600713662,EDS 117,A01,494379,Staff,1,5,30,29
1714600714689,EDS 125,A00,507246,Hopkins; Megan Beth,9,0,30,21
1714600715720,EDS 128A,A01,507264,Fargason; Sharon Gayle,8,0,26,18
1714600716749,EDS 128B,A01,507293,Pappas; Elizabeth,12,0,30,18
1714600717777,EDS 139,A00,507294,Fargason; Sharon Gayle,13,0,30,17
1714600717777,EDS 139,B00,507313,Pappas; Elizabeth,13,0,30,17
1714600718803,EDS 201,A00,507315,Staff,13,0,30,17
1714600719830,EDS 203,A01,507317,Halter; Christopher P.,12,0,30,18
1714600720954,EDS 204R,A01,507319,Halter; Christopher P.,0,3,30,30
1714600720954,EDS 204R,B01,507331,Heinzman; Erica M.,16,0,30,14
1714600721980,EDS 206R,A00,507332,Staff,0,4,30,30
1714600721980,EDS 206R,B00,507343,Staff,17,0,30,13
1714600723005,EDS 250,A00,507344,Hemans; Patricia Ann Benitez,22,0,40,18
1714600724036,EDS 281,A00,507345,Daly; Alan J.,18,0,18,0
1714600725065,EDS 284,A00,507350,Daly; Alan J.,16,0,16,0
1714600726091,EDS 286,A00,507359,Fine; Sarah,18,0,18,0
1714600727116,EDS 289C,A01,507361,Daly; Alan J.,18,0,18,0
1714600728145,EDS 290,A00,507366,Hofstetter; Carolyn,15,0,15,0
1714600729173,LIGM 5A,A00,507421,Fischer-Grunski; Eva K,18,0,20,2
1714600730202,LIGM 5B,A00,507423,Fischer-Grunski; Eva K,19,0,20,1
1714600731230,LIGM 5C,A00,507425,Fischer-Grunski; Eva K,19,0,20,1
1714600732256,LIIT 5AS,A00,507427,Carnelos; Chiara,20,0,20,0
1714600733282,LIIT 5BS,A00,507430,Carnelos; Chiara,20,0,20,0
1714600734310,LIIT 5CS,A00,507432,Carnelos; Chiara,20,0,20,0
1714600735335,LISP 5A,A00,507541,Munoz Sanchez; Alicia,11,0,20,9
1714600736361,LISP 5B,A00,507671,Munoz Sanchez; Alicia,8,0,20,12
1714600737390,LISP 5C,A00,507696,Munoz Sanchez; Alicia,9,0,20,11
1714600738418,MAE 197,001,528363,Boechler; Nicholas Sebastia,9998,0,9999,1
1714600739448,MATH 197,001,523477,Kedlaya; Kiran S.,9995,0,9999,4
1714600739448,MATH 197,002,563811,Zhang; Danna,9995,0,9999,4
1714600739448,MATH 197,003,628552,Dumitriu; Ioana,9998,0,9999,1
1714600740475,MCWP 40R,A00,518780,Staff,2,0,20,18
1714600740475,MCWP 40R,B00,518781,Staff,8,0,20,12
1714600740475,MCWP 40R,C00,518783,Staff,6,0,20,14
1714600741503,MCWP 50R,A00,518791,Staff,0,0,20,20
1714600741503,MCWP 50R,B00,518792,Staff,0,2,20,20
1714600741503,MCWP 50R,C00,518793,Staff,0,2,20,20
1714600741503,MCWP 50R,D00,518794,Staff,0,0,20,20
1714600741503,MCWP 50R,E00,518795,Staff,0,2,20,20
1714600741503,MCWP 50R,F00,518796,Staff,0,0,20,20
1714600741503,MCWP 50R,G00,518797,Staff,0,1,20,20
1714600742527,MMW 12R,A01,514034,Herbst; Matthew,0,0,16,16
1714600742527,MMW 12R,A02,514035,Herbst; Matthew,2,0,16,14
1714600743557,MMW 13R,A01,514037,Staff,0,4,16,16
1714600743557,MMW 13R,A02,514039,Staff,0,2,16,16
1714600743557,MMW 13R,A03,628519,Staff,0,2,16,16
1714600745610,SIO 295LS,A00,523233,Staff,10,0,30,20
1714600746634,SIO 295S,A00,523232,Staff,10,0,30,20
1714600747659,SIOC 290S,A01,637330,Merrifield; Mark A,24,0,30,6
1714600748684,SIOC 291S,A01,637333,Gabriel; Corey John,24,0,30,6
1714600749713,SOCI 117,A01,494376,Staff,0,4,5,5
1714600750944,WES 237B,A00,494380,Staff,9,0,20,11
1714600753028,AESE 279B,A00,494370,Wade; Jon P,0,0,33,33
1714600754056,AIP 197,001,627712,Vespa; Emanuel Ignacio,9998,0,9999,1
1714600755081,ANAR 135S,A00,494369,Braswell; Geoffrey E.,0,0,0,0
1714600756108,BENG 196,001,628496,Engler; Adam J.,9998,0,9999,1
1714600757135,CAT 124RS,A01,519847,Geibel; William,0,0,20,20
1714600758164,CAT 125RS,A01,515971,Geibel; William,0,0,20,20
1714600759189,CLRE 250,A00,511389,Morris; Sheldon,9993,0,9999,6
1714600760216,CLRE 251,A00,507176,Mehta; Ravindra L.,9993,0,9999,6
1714600760216,CLRE 251,B00,511410,Mehta; Ravindra L.,9998,0,9999,1
1714600761244,CLRE 252,A00,507189,Cuomo; Raphael Eduardo,9995,0,9999,4
1714600762272,CLRE 253,A00,507199,Vaida; Florin,9994,0,9999,5
1714600762272,CLRE 253,B00,507202,Vaida; Florin,9999,0,9999,0
1714600763301,CLRE 259,A00,507211,Patel; Hemal,9996,0,9999,3
1714600764326,CLRE 260,A00,507221,Cuomo; Raphael Eduardo,9999,0,9999,0
1714600765353,CLRE 297,001,507242,Cuomo; Raphael Eduardo,9999,0,9999,0
1714600766386,COGS 197,001,638244,Voytek; Bradley Thomas,9998,0,9999,1
1714600767418,CSE 191,A00,516875,Minnes Kemp; Mor Mia,9993,0,9999,6
1714600768442,CSE 197,001,637388,Minnes Kemp; Mor Mia,9998,0,9999,1
1714600769471,CSS 201S,A01,494383,Staff,35,0,35,0
1714600770496,CSS 202S,A01,494387,Staff,35,0,35,0
1714600771526,DSC 197,001,628532,Eldridge; Justin Matthew,9996,0,9999,3
1714600772554,EAP 100,A00,516065,Staff,9797,0,9999,202
1714600773580,ECE 45,A01,507414,Staff,33,0,60,27
1714600775629,ECE 111,A01,507420,Staff,15,0,50,35
1714600776654,ECE 197,001,548057,Sievenpiper; Daniel F.,9993,0,9999,6
1714600777681,EDS 115,A00,507243,Choi; Bailey Miyeon,10,0,28,18
1714600778709,EDS 117,A01,494379,Staff,1,5,30,29
1714600779735,EDS 125,A00,507246,Hopkins; Megan Beth,9,0,30,21
1714600780766,EDS 128A,A01,507264,Fargason; Sharon Gayle,8,0,26,18
1714600781790,EDS 128B,A01,507293,Pappas; Elizabeth,12,0,30,18
1714600782814,EDS 139,A00,507294,Fargason; Sharon Gayle,13,0,30,17
1714600782814,EDS 139,B00,507313,Pappas; Elizabeth,13,0,30,17
1714600783842,EDS 201,A00,507315,Staff,13,0,30,17
1714600784866,EDS 203,A01,507317,Halter; Christopher P.,12,0,30,18
1714600785891,EDS 204R,A01,507319,Halter; Christopher P.,0,3,30,30
1714600785891,EDS 204R,B01,507331,Heinzman; Erica M.,16,0,30,14
1714600786916,EDS 206R,A00,507332,Staff,0,4,30,30
1714600786916,EDS 206R,B00,507343,Staff,17,0,30,13
1714600787942,EDS 250,A00,507344,Hemans; Patricia Ann Benitez,22,0,40,18
1714600788967,EDS 281,A00,507345,Daly; Alan J.,18,0,18,0
1714600789996,EDS 284,A00,507350,Daly; Alan J.,16,0,16,0
1714600791025,EDS 286,A00,507359,Fine; Sarah,18,0,18,0
1714600792049,EDS 289C,A01,507361,Daly; Alan J.,18,0,18,0
1714600793075,EDS 290,A00,507366,Hofstetter; Carolyn,15,0,15,0
1714600794107,LIGM 5A,A00,507421,Fischer-Grunski; Eva K,18,0,20,2
1714600795137,LIGM 5B,A00,507423,Fischer-Grunski; Eva K,19,0,20,1
1714600796165,LIGM 5C,A00,507425,Fischer-Grunski; Eva K,19,0,20,1
1714600797192,LIIT 5AS,A00,507427,Carnelos; Chiara,20,0,20,0
1714600798221,LIIT 5BS,A00,507430,Carnelos; Chiara,20,0,20,0
1714600799252,LIIT 5CS,A00,507432,Carnelos; Chiara,20,0,20,0
1714600800278,LISP 5A,A00,507541,Munoz Sanchez; Alicia,11,0,20,9
1714600801308,LISP 5B,A00,507671,Munoz Sanchez; Alicia,8,0,20,12
1714600802333,LISP 5C,A00,507696,Munoz Sanchez; Alicia,9,0,20,11
1714600803363,MAE 197,001,528363,Boechler; Nicholas Sebastia,9998,0,9999,1
1714600804395,MATH 197,001,523477,Kedlaya; Kiran S.,9995,0,9999,4
1714600804395,MATH 197,002,563811,Zhang; Danna,9995,0,9999,4
1714600804395,MATH 197,003,628552,Dumitriu; Ioana,9998,0,9999,1
1714600805421,MCWP 40R,A00,518780,Staff,2,0,20,18
1714600805421,MCWP 40R,B00,518781,Staff,8,0,20,12
1714600805421,MCWP 40R,C00,518783,Staff,6,0,20,14
1714600806450,MCWP 50R,A00,518791,Staff,0,0,20,20
1714600806450,MCWP 50R,B00,518792,Staff,0,2,20,20
1714600806450,MCWP 50R,C00,518793,Staff,0,2,20,20
1714600806450,MCWP 50R,D00,518794,Staff,0,0,20,20
1714600806450,MCWP 50R,E00,518795,Staff,0,2,20,20
1714600806450,MCWP 50R,F00,518796,Staff,0,0,20,20
1714600806450,MCWP 50R,G00,518797,Staff,0,1,20,20
1714600807480,MMW 12R,A01,514034,Herbst; Matthew,0,0,16,16
1714600807480,MMW 12R,A02,514035,Herbst; Matthew,2,0,16,14
1714600808509,MMW 13R,A01,514037,Staff,0,4,16,16
1714600808509,MMW 13R,A02,514039,Staff,0,2,16,16
1714600808509,MMW 13R,A03,628519,Staff,0,2,16,16
1714600810559,SIO 295LS,A00,523233,Staff,10,0,30,20
1714600811586,SIO 295S,A00,523232,Staff,10,0,30,20
1714600812611,SIOC 290S,A01,637330,Merrifield; Mark A,24,0,30,6
1714600813635,SIOC 291S,A01,637333,Gabriel; Corey John,24,0,30,6
1714600814661,SOCI 117,A01,494376,Staff,0,4,5,5
1714600815691,WES 237B,A00,494380,Staff,9,0,20,11
1714600817778,AESE 279B,A00,494370,Wade; Jon P,0,0,33,33
1714600818804,AIP 197,001,627712,Vespa; Emanuel Ignacio,9998,0,9999,1
1714600819831,ANAR 135S,A00,494369,Braswell; Geoffrey E.,0,0,0,0
1714600820857,BENG 196,001,628496,Engler; Adam J.,9998,0,9999,1
1714600821884,CAT 124RS,A01,519847,Geibel; William,0,0,20,20
1714600822910,CAT 125RS,A01,515971,Geibel; William,0,0,20,20
1714600823934,CLRE 250,A00,511389,Morris; Sheldon,9993,0,9999,6
1714600824960,CLRE 251,A00,507176,Mehta; Ravindra L.,9993,0,9999,6
1714600824960,CLRE 251,B00,511410,Mehta; Ravindra L.,9998,0,9999,1
1714600825985,CLRE 252,A00,507189,Cuomo; Raphael Eduardo,9995,0,9999,4
1714600827014,CLRE 253,A00,507199,Vaida; Florin,9994,0,9999,5
1714600827014,CLRE 253,B00,507202,Vaida; Florin,9999,0,9999,0
1714600828041,CLRE 259,A00,507211,Patel; Hemal,9996,0,9999,3
1714600829066,CLRE 260,A00,507221,Cuomo; Raphael Eduardo,9999,0,9999,0
1714600830092,CLRE 297,001,507242,Cuomo; Raphael Eduardo,9999,0,9999,0
1714600831120,COGS 197,001,638244,Voytek; Bradley Thomas,9998,0,9999,1
1714600832147,CSE 191,A00,516875,Minnes Kemp; Mor Mia,9993,0,9999,6
1714600833173,CSE 197,001,637388,Minnes Kemp; Mor Mia,9998,0,9999,1
1714600834198,CSS 201S,A01,494383,Staff,35,0,35,0
1714600835223,CSS 202S,A01,494387,Staff,35,0,35,0
1714600836251,DSC 197,001,628532,Eldridge; Justin Matthew,9996,0,9999,3
1714600837278,EAP 100,A00,516065,Staff,9797,0,9999,202
1714600838303,ECE 45,A01,507414,Staff,33,0,60,27
1714600840353,ECE 111,A01,507420,Staff,15,0,50,35
1714600841379,ECE 197,001,548057,Sievenpiper; Daniel F.,9993,0,9999,6
1714600842406,EDS 115,A00,507243,Choi; Bailey Miyeon,10,0,28,18
1714600843435,EDS 117,A01,494379,Staff,1,5,30,29
1714600844461,EDS 125,A00,507246,Hopkins; Megan Beth,9,0,30,21
1714600845489,EDS 128A,A01,507264,Fargason; Sharon Gayle,8,0,26,18
1714600846515,EDS 128B,A01,507293,Pappas; Elizabeth,12,0,30,18
1714600847538,EDS 139,A00,507294,Fargason; Sharon Gayle,13,0,30,17
1714600847538,EDS 139,B00,507313,Pappas; Elizabeth,13,0,30,17
1714600848563,EDS 201,A00,507315,Staff,13,0,30,17
1714600849589,EDS 203,A01,507317,Halter; Christopher P.,12,0,30,18
1714600850613,EDS 204R,A01,507319,Halter; Christopher P.,0,3,30,30
1714600850613,EDS 204R,B01,507331,Heinzman; Erica M.,16,0,30,14
1714600851643,EDS 206R,A00,507332,Staff,0,4,30,30
1714600851643,EDS 206R,B00,507343,Staff,17,0,30,13
1714600852671,EDS 250,A00,507344,Hemans; Patricia Ann Benitez,22,0,40,18
1714600853698,EDS 281,A00,507345,Daly; Alan J.,18,0,18,0
1714600854725,EDS 284,A00,507350,Daly; Alan J.,16,0,16,0
1714600855752,EDS 286,A00,507359,Fine; Sarah,18,0,18,0
1714600856779,EDS 289C,A01,507361,Daly; Alan J.,18,0,18,0
1714600857804,EDS 290,A00,507366,Hofstetter; Carolyn,15,0,15,0
1714600858830,LIGM 5A,A00,507421,Fischer-Grunski; Eva K,18,0,20,2
1714600859859,LIGM 5B,A00,507423,Fischer-Grunski; Eva K,19,0,20,1
1714600860886,LIGM 5C,A00,507425,Fischer-Grunski; Eva K,19,0,20,1
1714600861913,LIIT 5AS,A00,507427,Carnelos; Chiara,20,0,20,0
1714600862945,LIIT 5BS,A00,507430,Carnelos; Chiara,20,0,20,0
1714600863982,LIIT 5CS,A00,507432,Carnelos; Chiara,20,0,20,0
1714600865013,LISP 5A,A00,507541,Munoz Sanchez; Alicia,11,0,20,9
1714600866037,LISP 5B,A00,507671,Munoz Sanchez; Alicia,8,0,20,12
1714600867063,LISP 5C,A00,507696,Munoz Sanchez; Alicia,9,0,20,11
1714600868095,MAE 197,001,528363,Boechler; Nicholas Sebastia,9998,0,9999,1
1714600869121,MATH 197,001,523477,Kedlaya; Kiran S.,9995,0,9999,4
1714600869121,MATH 197,002,563811,Zhang; Danna,9995,0,9999,4
1714600869121,MATH 197,003,628552,Dumitriu; Ioana,9998,0,9999,1
1714600870148,MCWP 40R,A00,518780,Staff,2,0,20,18
1714600870148,MCWP 40R,B00,518781,Staff,8,0,20,12
1714600870148,MCWP 40R,C00,518783,Staff,6,0,20,14
1714600871182,MCWP 50R,A00,518791,Staff,0,0,20,20
1714600871182,MCWP 50R,B00,518792,Staff,0,2,20,20
1714600871182,MCWP 50R,C00,518793,Staff,0,2,20,20
1714600871182,MCWP 50R,D00,518794,Staff,0,0,20,20
1714600871182,MCWP 50R,E00,518795,Staff,0,2,20,20
1714600871182,MCWP 50R,F00,518796,Staff,0,0,20,20
1714600871182,MCWP 50R,G00,518797,Staff,0,1,20,20
1714600872208,MMW 12R,A01,514034,Herbst; Matthew,0,0,16,16
1714600872208,MMW 12R,A02,514035,Herbst; Matthew,2,0,16,14
1714600873233,MMW 13R,A01,514037,Staff,0,4,16,16
1714600873233,MMW 13R,A02,514039,Staff,0,2,16,16
1714600873233,MMW 13R,A03,628519,Staff,0,2,16,16
1714600875285,SIO 295LS,A00,523233,Staff,10,0,30,20
1714600876312,SIO 295S,A00,523232,Staff,10,0,30,20
1714600877393,SIOC 290S,A01,637330,Merrifield; Mark A,24,0,30,6
1714600878421,SIOC 291S,A01,637333,Gabriel; Corey John,24,0,30,6
1714600879449,SOCI 117,A01,494376,Staff,0,4,5,5
1714600880473,WES 237B,A00,494380,Staff,9,0,20,11
1714600882546,AESE 279B,A00,494370,Wade; Jon P,0,0,33,33
1714600883576,AIP 197,001,627712,Vespa; Emanuel Ignacio,9998,0,9999,1
1714600884600,ANAR 135S,A00,494369,Braswell; Geoffrey E.,0,0,0,0
1714600885626,BENG 196,001,628496,Engler; Adam J.,9998,0,9999,1
1714600886657,CAT 124RS,A01,519847,Geibel; William,0,0,20,20
1714600887682,CAT 125RS,A01,515971,Geibel; William,0,0,20,20
1714600888711,CLRE 250,A00,511389,Morris; Sheldon,9993,0,9999,6
1714600889741,CLRE 251,A00,507176,Mehta; Ravindra L.,9993,0,9999,6
1714600889741,CLRE 251,B00,511410,Mehta; Ravindra L.,9998,0,9999,1
1714600890770,CLRE 252,A00,507189,Cuomo; Raphael Eduardo,9995,0,9999,4
1714600891802,CLRE 253,A00,507199,Vaida; Florin,9994,0,9999,5
1714600891802,CLRE 253,B00,507202,Vaida; Florin,9999,0,9999,0
1714600892828,CLRE 259,A00,507211,Patel; Hemal,9996,0,9999,3
1714600893865,CLRE 260,A00,507221,Cuomo; Raphael Eduardo,9999,0,9999,0
1714600894892,CLRE 297,001,507242,Cuomo; Raphael Eduardo,9999,0,9999,0
1714600895921,COGS 197,001,638244,Voytek; Bradley Thomas,9998,0,9999,1
1714600896946,CSE 191,A00,516875,Minnes Kemp; Mor Mia,9993,0,9999,6
1714600897975,CSE 197,001,637388,Minnes Kemp; Mor Mia,9998,0,9999,1
1714600899002,CSS 201S,A01,494383,Staff,35,0,35,0
1714600900032,CSS 202S,A01,494387,Staff,35,0,35,0
1714600901057,DSC 197,001,628532,Eldridge; Justin Matthew,9996,0,9999,3
1714600902083,EAP 100,A00,516065,Staff,9797,0,9999,202
1714600903114,ECE 45,A01,507414,Staff,33,0,60,27
1714600905164,ECE 111,A01,507420,Staff,15,0,50,35
1714600906192,ECE 197,001,548057,Sievenpiper; Daniel F.,9993,0,9999,6
1714600907219,EDS 115,A00,507243,Choi; Bailey Miyeon,10,0,28,18
1714600908246,EDS 117,A01,494379,Staff,1,5,30,29
1714600909270,EDS 125,A00,507246,Hopkins; Megan Beth,9,0,30,21
1714600910301,EDS 128A,A01,507264,Fargason; Sharon Gayle,8,0,26,18
1714600911329,EDS 128B,A01,507293,Pappas; Elizabeth,12,0,30,18
1714600912353,EDS 139,A00,507294,Fargason; Sharon Gayle,13,0,30,17
1714600912353,EDS 139,B00,507313,Pappas; Elizabeth,13,0,30,17
1714600913377,EDS 201,A00,507315,Staff,13,0,30,17
1714600914407,EDS 203,A01,507317,Halter; Christopher P.,12,0,30,18
1714600915437,EDS 204R,A01,507319,Halter; Christopher P.,0,3,30,30
1714600915437,EDS 204R,B01,507331,Heinzman; Erica M.,16,0,30,14
1714600916463,EDS 206R,A00,507332,Staff,0,4,30,30
1714600916463,EDS 206R,B00,507343,Staff,17,0,30,13
1714600917488,EDS 250,A00,507344,Hemans; Patricia Ann Benitez,22,0,40,18
1714600918516,EDS 281,A00,507345,Daly; Alan J.,18,0,18,0
1714600919543,EDS 284,A00,507350,Daly; Alan J.,16,0,16,0
1714600920569,EDS 286,A00,507359,Fine; Sarah,18,0,18,0
1714600921596,EDS 289C,A01,507361,Daly; Alan J.,18,0,18,0
1714600922624,EDS 290,A00,507366,Hofstetter; Carolyn,15,0,15,0
1714600923659,LIGM 5A,A00,507421,Fischer-Grunski; Eva K,18,0,20,2
1714600924683,LIGM 5B,A00,507423,Fischer-Grunski; Eva K,19,0,20,1
1714600925709,LIGM 5C,A00,507425,Fischer-Grunski; Eva K,19,0,20,1
1714600926734,LIIT 5AS,A00,507427,Carnelos; Chiara,20,0,20,0
1714600927759,LIIT 5BS,A00,507430,Carnelos; Chiara,20,0,20,0
1714600928789,LIIT 5CS,A00,507432,Carnelos; Chiara,20,0,20,0
1714600929814,LISP 5A,A00,507541,Munoz Sanchez; Alicia,11,0,20,9
1714600930840,LISP 5B,A00,507671,Munoz Sanchez; Alicia,8,0,20,12
1714600931865,LISP 5C,A00,507696,Munoz Sanchez; Alicia,9,0,20,11
1714600932913,MAE 197,001,528363,Boechler; Nicholas Sebastia,9998,0,9999,1
1714600933939,MATH 197,001,523477,Kedlaya; Kiran S.,9995,0,9999,4
1714600933939,MATH 197,002,563811,Zhang; Danna,9995,0,9999,4
1714600933939,MATH 197,003,628552,Dumitriu; Ioana,9998,0,9999,1
1714600934967,MCWP 40R,A00,518780,Staff,2,0,20,18
1714600934967,MCWP 40R,B00,518781,Staff,8,0,20,12
1714600934967,MCWP 40R,C00,518783,Staff,6,0,20,14
1714600936062,MCWP 50R,A00,518791,Staff,0,0,20,20
1714600936062,MCWP 50R,B00,518792,Staff,0,2,20,20
1714600936062,MCWP 50R,C00,518793,Staff,0,2,20,20
1714600936062,MCWP 50R,D00,518794,Staff,0,0,20,20
1714600936062,MCWP 50R,E00,518795,Staff,0,2,20,20
1714600936062,MCWP 50R,F00,518796,Staff,0,0,20,20
1714600936062,MCWP 50R,G00,518797,Staff,0,1,20,20
1714600937087,MMW 12R,A01,514034,Herbst; Matthew,0,0,16,16
1714600937087,MMW 12R,A02,514035,Herbst; Matthew,2,0,16,14
1714600938112,MMW 13R,A01,514037,Staff,0,4,16,16
1714600938112,MMW 13R,A02,514039,Staff,0,2,16,16
1714600938112,MMW 13R,A03,628519,Staff,0,2,16,16
1714600940161,SIO 295LS,A00,523233,Staff,10,0,30,20
1714600941187,SIO 295S,A00,523232,Staff,10,0,30,20
1714600942221,SIOC 290S,A01,637330,Merrifield; Mark A,24,0,30,6
1714600943246,SIOC 291S,A01,637333,Gabriel; Corey John,24,0,30,6
1714600944271,SOCI 117,A01,494376,Staff,0,4,5,5
1714600945295,WES 237B,A00,494380,Staff,9,0,20,11
1714600947365,AESE 279B,A00,494370,Wade; Jon P,0,0,33,33
1714600948400,AIP 197,001,627712,Vespa; Emanuel Ignacio,9998,0,9999,1
1714600949428,ANAR 135S,A00,494369,Braswell; Geoffrey E.,0,0,0,0
1714600950453,BENG 196,001,628496,Engler; Adam J.,9998,0,9999,1
1714600951483,CAT 124RS,A01,519847,Geibel; William,0,0,20,20
1714600952508,CAT 125RS,A01,515971,Geibel; William,0,0,20,20
1714600953534,CLRE 250,A00,511389,Morris; Sheldon,9993,0,9999,6
1714600954561,CLRE 251,A00,507176,Mehta; Ravindra L.,9993,0,9999,6
1714600954561,CLRE 251,B00,511410,Mehta; Ravindra L.,9998,0,9999,1
1714600955586,CLRE 252,A00,507189,Cuomo; Raphael Eduardo,9995,0,9999,4
1714600956613,CLRE 253,A00,507199,Vaida; Florin,9994,0,9999,5
1714600956613,CLRE 253,B00,507202,Vaida; Florin,9999,0,9999,0
1714600957640,CLRE 259,A00,507211,Patel; Hemal,9996,0,9999,3
1714600958668,CLRE 260,A00,507221,Cuomo; Raphael Eduardo,9999,0,9999,0
1714600959694,CLRE 297,001,507242,Cuomo; Raphael Eduardo,9999,0,9999,0
1714600960721,COGS 197,001,638244,Voytek; Bradley Thomas,9998,0,9999,1
1714600961745,CSE 191,A00,516875,Minnes Kemp; Mor Mia,9993,0,9999,6
1714600962769,CSE 197,001,637388,Minnes Kemp; Mor Mia,9998,0,9999,1
1714600963795,CSS 201S,A01,494383,Staff,35,0,35,0
1714600964823,CSS 202S,A01,494387,Staff,35,0,35,0
1714600965849,DSC 197,001,628532,Eldridge; Justin Matthew,9996,0,9999,3
1714600966873,EAP 100,A00,516065,Staff,9797,0,9999,202
1714600967903,ECE 45,A01,507414,Staff,33,0,60,27
1714600969956,ECE 111,A01,507420,Staff,15,0,50,35
1714600970985,ECE 197,001,548057,Sievenpiper; Daniel F.,9993,0,9999,6
1714600972016,EDS 115,A00,507243,Choi; Bailey Miyeon,10,0,28,18
1714600973042,EDS 117,A01,494379,Staff,1,5,30,29
1714600974071,EDS 125,A00,507246,Hopkins; Megan Beth,9,0,30,21
1714600975102,EDS 128A,A01,507264,Fargason; Sharon Gayle,8,0,26,18
1714600976133,EDS 128B,A01,507293,Pappas; Elizabeth,12,0,30,18
1714600977157,EDS 139,A00,507294,Fargason; Sharon Gayle,13,0,30,17
1714600977157,EDS 139,B00,507313,Pappas; Elizabeth,13,0,30,17
1714600978182,EDS 201,A00,507315,Staff,13,0,30,17
1714600979212,EDS 203,A01,507317,Halter; Christopher P.,12,0,30,18
1714600980244,EDS 204R,A01,507319,Halter; Christopher P.,0,3,30,30
1714600980244,EDS 204R,B01,507331,Heinzman; Erica M.,16,0,30,14
1714600981327,EDS 206R,A00,507332,Staff,0,4,30,30
1714600981327,EDS 206R,B00,507343,Staff,17,0,30,13
1714600982357,EDS 250,A00,507344,Hemans; Patricia Ann Benitez,22,0,40,18
1714600983383,EDS 281,A00,507345,Daly; Alan J.,18,0,18,0
1714600984408,EDS 284,A00,507350,Daly; Alan J.,16,0,16,0
1714600985435,EDS 286,A00,507359,Fine; Sarah,18,0,18,0
1714600986466,EDS 289C,A01,507361,Daly; Alan J.,18,0,18,0
1714600987493,EDS 290,A00,507366,Hofstetter; Carolyn,15,0,15,0
1714600988524,LIGM 5A,A00,507421,Fischer-Grunski; Eva K,18,0,20,2
1714600989549,LIGM 5B,A00,507423,Fischer-Grunski; Eva K,19,0,20,1
1714600990575,LIGM 5C,A00,507425,Fischer-Grunski; Eva K,19,0,20,1
1714600991604,LIIT 5AS,A00,507427,Carnelos; Chiara,20,0,20,0
1714600992630,LIIT 5BS,A00,507430,Carnelos; Chiara,20,0,20,0
1714600993654,LIIT 5CS,A00,507432,Carnelos; Chiara,20,0,20,0
1714600994680,LISP 5A,A00,507541,Munoz Sanchez; Alicia,11,0,20,9
1714600995708,LISP 5B,A00,507671,Munoz Sanchez; Alicia,8,0,20,12
1714600996733,LISP 5C,A00,507696,Munoz Sanchez; Alicia,9,0,20,11
1714600997758,MAE 197,001,528363,Boechler; Nicholas Sebastia,9998,0,9999,1
1714600998799,MATH 197,001,523477,Kedlaya; Kiran S.,9995,0,9999,4
1714600998799,MATH 197,002,563811,Zhang; Danna,9995,0,9999,4
1714600998799,MATH 197,003,628552,Dumitriu; Ioana,9998,0,9999,1
1714600999824,MCWP 40R,A00,518780,Staff,2,0,20,18
1714600999824,MCWP 40R,B00,518781,Staff,8,0,20,12
1714600999824,MCWP 40R,C00,518783,Staff,6,0,20,14
1714601000850,MCWP 50R,A00,518791,Staff,0,0,20,20
1714601000850,MCWP 50R,B00,518792,Staff,0,2,20,20
1714601000850,MCWP 50R,C00,518793,Staff,0,2,20,20
1714601000850,MCWP 50R,D00,518794,Staff,0,0,20,20
1714601000850,MCWP 50R,E00,518795,Staff,0,2,20,20
1714601000850,MCWP 50R,F00,518796,Staff,0,0,20,20
1714601000850,MCWP 50R,G00,518797,Staff,0,1,20,20
1714601001876,MMW 12R,A01,514034,Herbst; Matthew,0,0,16,16
1714601001876,MMW 12R,A02,514035,Herbst; Matthew,2,0,16,14
1714601002903,MMW 13R,A01,514037,Staff,0,4,16,16
1714601002903,MMW 13R,A02,514039,Staff,0,2,16,16
1714601002903,MMW 13R,A03,628519,Staff,0,2,16,16
1714601004956,SIO 295LS,A00,523233,Staff,10,0,30,20
1714601005980,SIO 295S,A00,523232,Staff,10,0,30,20
1714601007016,SIOC 290S,A01,637330,Merrifield; Mark A,24,0,30,6
1714601008044,SIOC 291S,A01,637333,Gabriel; Corey John,24,0,30,6
1714601009069,SOCI 117,A01,494376,Staff,0,4,5,5
1714601010094,WES 237B,A00,494380,Staff,9,0,20,11
1714601012193,AESE 279B,A00,494370,Wade; Jon P,0,0,33,33
1714601013220,AIP 197,001,627712,Vespa; Emanuel Ignacio,9998,0,9999,1
1714601014250,ANAR 135S,A00,494369,Braswell; Geoffrey E.,0,0,0,0
1714601015275,BENG 196,001,628496,Engler; Adam J.,9998,0,9999,1
1714601016301,CAT 124RS,A01,519847,Geibel; William,0,0,20,20
1714601017325,CAT 125RS,A01,515971,Geibel; William,0,0,20,20
1714601018354,CLRE 250,A00,511389,Morris; Sheldon,9993,0,9999,6
1714601019383,CLRE 251,A00,507176,Mehta; Ravindra L.,9993,0,9999,6
1714601019383,CLRE 251,B00,511410,Mehta; Ravindra L.,9998,0,9999,1
1714601020409,CLRE 252,A00,507189,Cuomo; Raphael Eduardo,9995,0,9999,4
1714601021437,CLRE 253,A00,507199,Vaida; Florin,9994,0,9999,5
1714601021437,CLRE 253,B00,507202,Vaida; Florin,9999,0,9999,0
1714601022462,CLRE 259,A00,507211,Patel; Hemal,9996,0,9999,3
1714601023486,CLRE 260,A00,507221,Cuomo; Raphael Eduardo,9999,0,9999,0
1714601024510,CLRE 297,001,507242,Cuomo; Raphael Eduardo,9999,0,9999,0
1714601025535,COGS 197,001,638244,Voytek; Bradley Thomas,9998,0,9999,1
1714601026562,CSE 191,A00,516875,Minnes Kemp; Mor Mia,9993,0,9999,6
1714601027590,CSE 197,001,637388,Minnes Kemp; Mor Mia,9998,0,9999,1
1714601028619,CSS 201S,A01,494383,Staff,35,0,35,0
1714601029644,CSS 202S,A01,494387,Staff,35,0,35,0
1714601030674,DSC 197,001,628532,Eldridge; Justin Matthew,9996,0,9999,3
1714601031698,EAP 100,A00,516065,Staff,9797,0,9999,202
1714601032755,ECE 45,A01,507414,Staff,33,0,60,27
1714601034809,ECE 111,A01,507420,Staff,15,0,50,35
1714601035837,ECE 197,001,548057,Sievenpiper; Daniel F.,9993,0,9999,6
1714601036863,EDS 115,A00,507243,Choi; Bailey Miyeon,10,0,28,18
1714601037893,EDS 117,A01,494379,Staff,1,5,30,29
1714601038918,EDS 125,A00,507246,Hopkins; Megan Beth,9,0,30,21
1714601039944,EDS 128A,A01,507264,Fargason; Sharon Gayle,8,0,26,18
1714601040974,EDS 128B,A01,507293,Pappas; Elizabeth,12,0,30,18
1714601042004,EDS 139,A00,507294,Fargason; Sharon Gayle,13,0,30,17
1714601042004,EDS 139,B00,507313,Pappas; Elizabeth,13,0,30,17
1714601043034,EDS 201,A00,507315,Staff,13,0,30,17
1714601044063,EDS 203,A01,507317,Halter; Christopher P.,12,0,30,18
1714601045089,EDS 204R,A01,507319,Halter; Christopher P.,0,3,30,30
1714601045089,EDS 204R,B01,507331,Heinzman; Erica M.,16,0,30,14
1714601046114,EDS 206R,A00,507332,Staff,0,4,30,30
1714601046114,EDS 206R,B00,507343,Staff,17,0,30,13
1714601047143,EDS 250,A00,507344,Hemans; Patricia Ann Benitez,22,0,40,18
1714601048169,EDS 281,A00,507345,Daly; Alan J.,18,0,18,0
1714601049194,EDS 284,A00,507350,Daly; Alan J.,16,0,16,0
1714601050218,EDS 286,A00,507359,Fine; Sarah,18,0,18,0
1714601051248,EDS 289C,A01,507361,Daly; Alan J.,18,0,18,0
1714601052274,EDS 290,A00,507366,Hofstetter; Carolyn,15,0,15,0
1714601053302,LIGM 5A,A00,507421,Fischer-Grunski; Eva K,18,0,20,2
1714601054331,LIGM 5B,A00,507423,Fischer-Grunski; Eva K,19,0,20,1
1714601055356,LIGM 5C,A00,507425,Fischer-Grunski; Eva K,19,0,20,1
1714601056382,LIIT 5AS,A00,507427,Carnelos; Chiara,20,0,20,0
1714601057409,LIIT 5BS,A00,507430,Carnelos; Chiara,20,0,20,0
1714601058443,LIIT 5CS,A00,507432,Carnelos; Chiara,20,0,20,0
1714601059468,LISP 5A,A00,507541,Munoz Sanchez; Alicia,11,0,20,9
1714601060492,LISP 5B,A00,507671,Munoz Sanchez; Alicia,8,0,20,12
1714601061517,LISP 5C,A00,507696,Munoz Sanchez; Alicia,9,0,20,11
1714601062543,MAE 197,001,528363,Boechler; Nicholas Sebastia,9998,0,9999,1
1714601063571,MATH 197,001,523477,Kedlaya; Kiran S.,9995,0,9999,4
1714601063571,MATH 197,002,563811,Zhang; Danna,9995,0,9999,4
1714601063571,MATH 197,003,628552,Dumitriu; Ioana,9998,0,9999,1
1714601064598,MCWP 40R,A00,518780,Staff,2,0,20,18
1714601064598,MCWP 40R,B00,518781,Staff,8,0,20,12
1714601064598,MCWP 40R,C00,518783,Staff,6,0,20,14
1714601065628,MCWP 50R,A00,518791,Staff,0,0,20,20
1714601065628,MCWP 50R,B00,518792,Staff,0,2,20,20
1714601065628,MCWP 50R,C00,518793,Staff,0,2,20,20
1714601065628,MCWP 50R,D00,518794,Staff,0,0,20,20
1714601065628,MCWP 50R,E00,518795,Staff,0,2,20,20
1714601065628,MCWP 50R,F00,518796,Staff,0,0,20,20
1714601065628,MCWP 50R,G00,518797,Staff,0,1,20,20
1714601066655,MMW 12R,A01,514034,Herbst; Matthew,0,0,16,16
1714601066655,MMW 12R,A02,514035,Herbst; Matthew,2,0,16,14
1714601067680,MMW 13R,A01,514037,Staff,0,4,16,16
1714601067680,MMW 13R,A02,514039,Staff,0,2,16,16
1714601067680,MMW 13R,A03,628519,Staff,0,2,16,16
1714601069730,SIO 295LS,A00,523233,Staff,10,0,30,20
1714601070755,SIO 295S,A00,523232,Staff,10,0,30,20
1714601071785,SIOC 290S,A01,637330,Merrifield; Mark A,24,0,30,6
1714601072814,SIOC 291S,A01,637333,Gabriel; Corey John,24,0,30,6
1714601073841,SOCI 117,A01,494376,Staff,0,4,5,5
1714601074866,WES 237B,A00,494380,Staff,9,0,20,11
1714601076939,AESE 279B,A00,494370,Wade; Jon P,0,0,33,33
1714601077964,AIP 197,001,627712,Vespa; Emanuel Ignacio,9998,0,9999,1
1714601078991,ANAR 135S,A00,494369,Braswell; Geoffrey E.,0,0,0,0
1714601080020,BENG 196,001,628496,Engler; Adam J.,9998,0,9999,1
1714601081046,CAT 124RS,A01,519847,Geibel; William,0,0,20,20
1714601082072,CAT 125RS,A01,515971,Geibel; William,0,0,20,20
1714601083101,CLRE 250,A00,511389,Morris; Sheldon,9993,0,9999,6
1714601084127,CLRE 251,A00,507176,Mehta; Ravindra L.,9993,0,9999,6
1714601084127,CLRE 251,B00,511410,Mehta; Ravindra L.,9998,0,9999,1
1714601085207,CLRE 252,A00,507189,Cuomo; Raphael Eduardo,9995,0,9999,4
1714601086234,CLRE 253,A00,507199,Vaida; Florin,9994,0,9999,5
1714601086234,CLRE 253,B00,507202,Vaida; Florin,9999,0,9999,0
1714601087264,CLRE 259,A00,507211,Patel; Hemal,9996,0,9999,3
1714601088288,CLRE 260,A00,507221,Cuomo; Raphael Eduardo,9999,0,9999,0
1714601089313,CLRE 297,001,507242,Cuomo; Raphael Eduardo,9999,0,9999,0
1714601090343,COGS 197,001,638244,Voytek; Bradley Thomas,9998,0,9999,1
1714601091369,CSE 191,A00,516875,Minnes Kemp; Mor Mia,9993,0,9999,6
1714601092393,CSE 197,001,637388,Minnes Kemp; Mor Mia,9998,0,9999,1
1714601093422,CSS 201S,A01,494383,Staff,35,0,35,0
1714601094448,CSS 202S,A01,494387,Staff,35,0,35,0
1714601095476,DSC 197,001,628532,Eldridge; Justin Matthew,9996,0,9999,3
1714601096500,EAP 100,A00,516065,Staff,9797,0,9999,202
1714601097526,ECE 45,A01,507414,Staff,33,0,60,27
1714601099576,ECE 111,A01,507420,Staff,15,0,50,35
1714601100603,ECE 197,001,548057,Sievenpiper; Daniel F.,9993,0,9999,6
1714601101629,EDS 115,A00,507243,Choi; Bailey Miyeon,10,0,28,18
1714601102654,EDS 117,A01,494379,Staff,1,5,30,29
1714601103684,EDS 125,A00,507246,Hopkins; Megan Beth,9,0,30,21
1714601104714,EDS 128A,A01,507264,Fargason; Sharon Gayle,8,0,26,18
1714601105793,EDS 128B,A01,507293,Pappas; Elizabeth,12,0,30,18
1714601106820,EDS 139,A00,507294,Fargason; Sharon Gayle,13,0,30,17
1714601106820,EDS 139,B00,507313,Pappas; Elizabeth,13,0,30,17
1714601107846,EDS 201,A00,507315,Staff,13,0,30,17
1714601108874,EDS 203,A01,507317,Halter; Christopher P.,12,0,30,18
1714601109902,EDS 204R,A01,507319,Halter; Christopher P.,0,3,30,30
1714601109902,EDS 204R,B01,507331,Heinzman; Erica M.,16,0,30,14
1714601110929,EDS 206R,A00,507332,Staff,0,4,30,30
1714601110929,EDS 206R,B00,507343,Staff,17,0,30,13
1714601111957,EDS 250,A00,507344,Hemans; Patricia Ann Benitez,22,0,40,18
1714601112984,EDS 281,A00,507345,Daly; Alan J.,18,0,18,0
1714601114012,EDS 284,A00,507350,Daly; Alan J.,16,0,16,0
1714601115041,EDS 286,A00,507359,Fine; Sarah,18,0,18,0
1714601116072,EDS 289C,A01,507361,Daly; Alan J.,18,0,18,0
1714601117102,EDS 290,A00,507366,Hofstetter; Carolyn,15,0,15,0
1714601118133,LIGM 5A,A00,507421,Fischer-Grunski; Eva K,18,0,20,2
1714601119162,LIGM 5B,A00,507423,Fischer-Grunski; Eva K,19,0,20,1
1714601120190,LIGM 5C,A00,507425,Fischer-Grunski; Eva K,19,0,20,1
1714601121215,LIIT 5AS,A00,507427,Carnelos; Chiara,20,0,20,0
1714601122240,LIIT 5BS,A00,507430,Carnelos; Chiara,20,0,20,0
1714601123269,LIIT 5CS,A00,507432,Carnelos; Chiara,20,0,20,0
1714601124298,LISP 5A,A00,507541,Munoz Sanchez; Alicia,11,0,20,9
1714601125323,LISP 5B,A00,507671,Munoz Sanchez; Alicia,8,0,20,12
1714601126349,LISP 5C,A00,507696,Munoz Sanchez; Alicia,9,0,20,11
1714601127375,MAE 197,001,528363,Boechler; Nicholas Sebastia,9998,0,9999,1
1714601128403,MATH 197,001,523477,Kedlaya; Kiran S.,9995,0,9999,4
1714601128403,MATH 197,002,563811,Zhang; Danna,9995,0,9999,4
1714601128403,MATH 197,003,628552,Dumitriu; Ioana,9998,0,9999,1
1714601129436,MCWP 40R,A00,518780,Staff,2,0,20,18
1714601129436,MCWP 40R,B00,518781,Staff,8,0,20,12
1714601129436,MCWP 40R,C00,518783,Staff,6,0,20,14
1714601130463,MCWP 50R,A00,518791,Staff,0,0,20,20
1714601130463,MCWP 50R,B00,518792,Staff,0,2,20,20
1714601130463,MCWP 50R,C00,518793,Staff,0,2,20,20
1714601130463,MCWP 50R,D00,518794,Staff,0,0,20,20
1714601130463,MCWP 50R,E00,518795,Staff,0,2,20,20
1714601130463,MCWP 50R,F00,518796,Staff,0,0,20,20
1714601130463,MCWP 50R,G00,518797,Staff,0,1,20,20
1714601131487,MMW 12R,A01,514034,Herbst; Matthew,0,0,16,16
1714601131487,MMW 12R,A02,514035,Herbst; Matthew,2,0,16,14
1714601132512,MMW 13R,A01,514037,Staff,0,4,16,16
1714601132512,MMW 13R,A02,514039,Staff,0,2,16,16
1714601132512,MMW 13R,A03,628519,Staff,0,2,16,16
1714601134562,SIO 295LS,A00,523233,Staff,10,0,30,20
1714601135592,SIO 295S,A00,523232,Staff,10,0,30,20
1714601136618,SIOC 290S,A01,637330,Merrifield; Mark A,24,0,30,6
1714601137643,SIOC 291S,A01,637333,Gabriel; Corey John,24,0,30,6
1714601138671,SOCI 117,A01,494376,Staff,0,4,5,5
1714601139697,WES 237B,A00,494380,Staff,9,0,20,11
1714601141771,AESE 279B,A00,494370,Wade; Jon P,0,0,33,33
1714601142796,AIP 197,001,627712,Vespa; Emanuel Ignacio,9998,0,9999,1
1714601143822,ANAR 135S,A00,494369,Braswell; Geoffrey E.,0,0,0,0
1714601144852,BENG 196,001,628496,Engler; Adam J.,9998,0,9999,1
1714601145881,CAT 124RS,A01,519847,Geibel; William,0,0,20,20
1714601146905,CAT 125RS,A01,515971,Geibel; William,0,0,20,20
1714601147932,CLRE 250,A00,511389,Morris; Sheldon,9993,0,9999,6
1714601148959,CLRE 251,A00,507176,Mehta; Ravindra L.,9993,0,9999,6
1714601148959,CLRE 251,B00,511410,Mehta; Ravindra L.,9998,0,9999,1
1714601149991,CLRE 252,A00,507189,Cuomo; Raphael Eduardo,9995,0,9999,4
1714601151021,CLRE 253,A00,507199,Vaida; Florin,9994,0,9999,5
1714601151021,CLRE 253,B00,507202,Vaida; Florin,9999,0,9999,0
1714601152050,CLRE 259,A00,507211,Patel; Hemal,9996,0,9999,3
1714601153077,CLRE 260,A00,507221,Cuomo; Raphael Eduardo,9999,0,9999,0
1714601154101,CLRE 297,001,507242,Cuomo; Raphael Eduardo,9999,0,9999,0
1714601155126,COGS 197,001,638244,Voytek; Bradley Thomas,9998,0,9999,1
1714601156156,CSE 191,A00,516875,Minnes Kemp; Mor Mia,9993,0,9999,6
1714601157181,CSE 197,001,637388,Minnes Kemp; Mor Mia,9998,0,9999,1
1714601158207,CSS 201S,A01,494383,Staff,35,0,35,0
1714601159233,CSS 202S,A01,494387,Staff,35,0,35,0
1714601160259,DSC 197,001,628532,Eldridge; Justin Matthew,9996,0,9999,3
1714601161287,EAP 100,A00,516065,Staff,9797,0,9999,202
1714601162312,ECE 45,A01,507414,Staff,33,0,60,27
1714601164367,ECE 111,A01,507420,Staff,15,0,50,35
1714601165392,ECE 197,001,548057,Sievenpiper; Daniel F.,9993,0,9999,6
1714601166417,EDS 115,A00,507243,Choi; Bailey Miyeon,10,0,28,18
1714601167445,EDS 117,A01,494379,Staff,1,5,30,29
1714601168473,EDS 125,A00,507246,Hopkins; Megan Beth,9,0,30,21
1714601169506,EDS 128A,A01,507264,Fargason; Sharon Gayle,8,0,26,18
1714601170533,EDS 128B,A01,507293,Pappas; Elizabeth,12,0,30,18
1714601171560,EDS 139,A00,507294,Fargason; Sharon Gayle,13,0,30,17
1714601171560,EDS 139,B00,507313,Pappas; Elizabeth,13,0,30,17
1714601172585,EDS 201,A00,507315,Staff,13,0,30,17
1714601173616,EDS 203,A01,507317,Halter; Christopher P.,12,0,30,18
1714601174641,EDS 204R,A01,507319,Halter; Christopher P.,0,3,30,30
1714601174641,EDS 204R,B01,507331,Heinzman; Erica M.,16,0,30,14
1714601175667,EDS 206R,A00,507332,Staff,0,4,30,30
1714601175667,EDS 206R,B00,507343,Staff,17,0,30,13
1714601176694,EDS 250,A00,507344,Hemans; Patricia Ann Benitez,22,0,40,18
1714601177721,EDS 281,A00,507345,Daly; Alan J.,18,0,18,0
1714601178748,EDS 284,A00,507350,Daly; Alan J.,16,0,16,0
1714601179773,EDS 286,A00,507359,Fine; Sarah,18,0,18,0
1714601180800,EDS 289C,A01,507361,Daly; Alan J.,18,0,18,0
1714601181828,EDS 290,A00,507366,Hofstetter; Carolyn,15,0,15,0
1714601182855,LIGM 5A,A00,507421,Fischer-Grunski; Eva K,18,0,20,2
1714601183896,LIGM 5B,A00,507423,Fischer-Grunski; Eva K,19,0,20,1
1714601184925,LIGM 5C,A00,507425,Fischer-Grunski; Eva K,19,0,20,1
1714601185950,LIIT 5AS,A00,507427,Carnelos; Chiara,20,0,20,0
1714601186974,LIIT 5BS,A00,507430,Carnelos; Chiara,20,0,20,0
1714601187997,LIIT 5CS,A00,507432,Carnelos; Chiara,20,0,20,0
1714601189081,LISP 5A,A00,507541,Munoz Sanchez; Alicia,11,0,20,9
1714601190107,LISP 5B,A00,507671,Munoz Sanchez; Alicia,8,0,20,12
1714601191133,LISP 5C,A00,507696,Munoz Sanchez; Alicia,9,0,20,11
1714601192158,MAE 197,001,528363,Boechler; Nicholas Sebastia,9998,0,9999,1
1714601193184,MATH 197,001,523477,Kedlaya; Kiran S.,9995,0,9999,4
1714601193184,MATH 197,002,563811,Zhang; Danna,9995,0,9999,4
1714601193184,MATH 197,003,628552,Dumitriu; Ioana,9998,0,9999,1
1714601194212,MCWP 40R,A00,518780,Staff,2,0,20,18
1714601194212,MCWP 40R,B00,518781,Staff,8,0,20,12
1714601194212,MCWP 40R,C00,518783,Staff,6,0,20,14
1714601195240,MCWP 50R,A00,518791,Staff,0,0,20,20
1714601195240,MCWP 50R,B00,518792,Staff,0,2,20,20
1714601195240,MCWP 50R,C00,518793,Staff,0,2,20,20
1714601195240,MCWP 50R,D00,518794,Staff,0,0,20,20
1714601195240,MCWP 50R,E00,518795,Staff,0,2,20,20
1714601195240,MCWP 50R,F00,518796,Staff,0,0,20,20
1714601195240,MCWP 50R,G00,518797,Staff,0,1,20,20
1714601196265,MMW 12R,A01,514034,Herbst; Matthew,0,0,16,16
1714601196265,MMW 12R,A02,514035,Herbst; Matthew,2,0,16,14
1714601197295,MMW 13R,A01,514037,Staff,0,4,16,16
1714601197295,MMW 13R,A02,514039,Staff,0,2,16,16
1714601197295,MMW 13R,A03,628519,Staff,0,2,16,16
1714601199345,SIO 295LS,A00,523233,Staff,10,0,30,20
1714601200371,SIO 295S,A00,523232,Staff,10,0,30,20
1714601201399,SIOC 290S,A01,637330,Merrifield; Mark A,24,0,30,6
1714601202425,SIOC 291S,A01,637333,Gabriel; Corey John,24,0,30,6
1714601203451,SOCI 117,A01,494376,Staff,0,4,5,5
1714601204478,WES 237B,A00,494380,Staff,9,0,20,11
1714601206545,AESE 279B,A00,494370,Wade; Jon P,0,0,33,33
1714601207572,AIP 197,001,627712,Vespa; Emanuel Ignacio,9998,0,9999,1
1714601208599,ANAR 135S,A00,494369,Braswell; Geoffrey E.,0,0,0,0
1714601209624,BENG 196,001,628496,Engler; Adam J.,9998,0,9999,1
1714601210651,CAT 124RS,A01,519847,Geibel; William,0,0,20,20
1714601211676,CAT 125RS,A01,515971,Geibel; William,0,0,20,20
1714601212701,CLRE 250,A00,511389,Morris; Sheldon,9993,0,9999,6
1714601213731,CLRE 251,A00,507176,Mehta; Ravindra L.,9993,0,9999,6
1714601213731,CLRE 251,B00,511410,Mehta; Ravindra L.,9998,0,9999,1
1714601214760,CLRE 252,A00,507189,Cuomo; Raphael Eduardo,9995,0,9999,4
1714601215786,CLRE 253,A00,507199,Vaida; Florin,9994,0,9999,5
1714601215786,CLRE 253,B00,507202,Vaida; Florin,9999,0,9999,0
1714601216810,CLRE 259,A00,507211,Patel; Hemal,9996,0,9999,3
1714601217836,CLRE 260,A00,507221,Cuomo; Raphael Eduardo,9999,0,9999,0
1714601218860,CLRE 297,001,507242,Cuomo; Raphael Eduardo,9999,0,9999,0
1714601219884,COGS 197,001,638244,Voytek; Bradley Thomas,9998,0,9999,1
1714601220911,CSE 191,A00,516875,Minnes Kemp; Mor Mia,9993,0,9999,6
1714601221935,CSE 197,001,637388,Minnes Kemp; Mor Mia,9998,0,9999,1
1714601222960,CSS 201S,A01,494383,Staff,35,0,35,0
1714601223987,CSS 202S,A01,494387,Staff,35,0,35,0
1714601225012,DSC 197,001,628532,Eldridge; Justin Matthew,9996,0,9999,3
1714601226037,EAP 100,A00,516065,Staff,9797,0,9999,202
1714601227062,ECE 45,A01,507414,Staff,33,0,60,27
1714601229111,ECE 111,A01,507420,Staff,15,0,50,35
1714601230136,ECE 197,001,548057,Sievenpiper; Daniel F.,9993,0,9999,6
1714601231164,EDS 115,A00,507243,Choi; Bailey Miyeon,10,0,28,18
1714601232188,EDS 117,A01,494379,Staff,1,5,30,29
1714601233212,EDS 125,A00,507246,Hopkins; Megan Beth,9,0,30,21
1714601234241,EDS 128A,A01,507264,Fargason; Sharon Gayle,8,0,26,18
1714601235268,EDS 128B,A01,507293,Pappas; Elizabeth,12,0,30,18
1714601236293,EDS 139,A00,507294,Fargason; Sharon Gayle,13,0,30,17
1714601236293,EDS 139,B00,507313,Pappas; Elizabeth,13,0,30,17
1714601237320,EDS 201,A00,507315,Staff,13,0,30,17
1714601238345,EDS 203,A01,507317,Halter; Christopher P.,12,0,30,18
1714601239374,EDS 204R,A01,507319,Halter; Christopher P.,0,3,30,30
1714601239374,EDS 204R,B01,507331,Heinzman; Erica M.,16,0,30,14
1714601240400,EDS 206R,A00,507332,Staff,0,4,30,30
1714601240400,EDS 206R,B00,507343,Staff,17,0,30,13
1714601241428,EDS 250,A00,507344,Hemans; Patricia Ann Benitez,22,0,40,18
1714601242452,EDS 281,A00,507345,Daly; Alan J.,18,0,18,0
1714601243479,EDS 284,A00,507350,Daly; Alan J.,16,0,16,0
1714601244510,EDS 286,A00,507359,Fine; Sarah,18,0,18,0
1714601245537,EDS 289C,A01,507361,Daly; Alan J.,18,0,18,0
1714601246563,EDS 290,A00,507366,Hofstetter; Carolyn,15,0,15,0
1714601247593,LIGM 5A,A00,507421,Fischer-Grunski; Eva K,18,0,20,2
1714601248621,LIGM 5B,A00,507423,Fischer-Grunski; Eva K,19,0,20,1
1714601249646,LIGM 5C,A00,507425,Fischer-Grunski; Eva K,19,0,20,1
1714601250674,LIIT 5AS,A00,507427,Carnelos; Chiara,20,0,20,0
1714601251699,LIIT 5BS,A00,507430,Carnelos; Chiara,20,0,20,0
1714601252722,LIIT 5CS,A00,507432,Carnelos; Chiara,20,0,20,0
1714601253749,LISP 5A,A00,507541,Munoz Sanchez; Alicia,11,0,20,9
1714601254774,LISP 5B,A00,507671,Munoz Sanchez; Alicia,8,0,20,12
1714601255797,LISP 5C,A00,507696,Munoz Sanchez; Alicia,9,0,20,11
1714601256822,MAE 197,001,528363,Boechler; Nicholas Sebastia,9998,0,9999,1
1714601257847,MATH 197,001,523477,Kedlaya; Kiran S.,9995,0,9999,4
1714601257847,MATH 197,002,563811,Zhang; Danna,9995,0,9999,4
1714601257847,MATH 197,003,628552,Dumitriu; Ioana,9998,0,9999,1
1714601258874,MCWP 40R,A00,518780,Staff,2,0,20,18
1714601258874,MCWP 40R,B00,518781,Staff,8,0,20,12
1714601258874,MCWP 40R,C00,518783,Staff,6,0,20,14
1714601259898,MCWP 50R,A00,518791,Staff,0,0,20,20
1714601259898,MCWP 50R,B00,518792,Staff,0,2,20,20
1714601259898,MCWP 50R,C00,518793,Staff,0,2,20,20
1714601259898,MCWP 50R,D00,518794,Staff,0,0,20,20
1714601259898,MCWP 50R,E00,518795,Staff,0,2,20,20
1714601259898,MCWP 50R,F00,518796,Staff,0,0,20,20
1714601259898,MCWP 50R,G00,518797,Staff,0,1,20,20
1714601260923,MMW 12R,A01,514034,Herbst; Matthew,0,0,16,16
1714601260923,MMW 12R,A02,514035,Herbst; Matthew,2,0,16,14
1714601261949,MMW 13R,A01,514037,Staff,0,4,16,16
1714601261949,MMW 13R,A02,514039,Staff,0,2,16,16
1714601261949,MMW 13R,A03,628519,Staff,0,2,16,16
1714601264004,SIO 295LS,A00,523233,Staff,10,0,30,20
1714601265029,SIO 295S,A00,523232,Staff,10,0,30,20
1714601266055,SIOC 290S,A01,637330,Merrifield; Mark A,24,0,30,6
1714601267081,SIOC 291S,A01,637333,Gabriel; Corey John,24,0,30,6
1714601268110,SOCI 117,A01,494376,Staff,0,4,5,5
1714601269135,WES 237B,A00,494380,Staff,9,0,20,11
1714601271197,AESE 279B,A00,494370,Wade; Jon P,0,0,33,33
1714601272223,AIP 197,001,627712,Vespa; Emanuel Ignacio,9998,0,9999,1
1714601273250,ANAR 135S,A00,494369,Braswell; Geoffrey E.,0,0,0,0
1714601274276,BENG 196,001,628496,Engler; Adam J.,9998,0,9999,1
1714601275301,CAT 124RS,A01,519847,Geibel; William,0,0,20,20
1714601276326,CAT 125RS,A01,515971,Geibel; William,0,0,20,20
1714601277352,CLRE 250,A00,511389,Morris; Sheldon,9993,0,9999,6
1714601278380,CLRE 251,A00,507176,Mehta; Ravindra L.,9993,0,9999,6
1714601278380,CLRE 251,B00,511410,Mehta; Ravindra L.,9998,0,9999,1
1714601279409,CLRE 252,A00,507189,Cuomo; Raphael Eduardo,9995,0,9999,4
1714601280434,CLRE 253,A00,507199,Vaida; Florin,9994,0,9999,5
1714601280434,CLRE 253,B00,507202,Vaida; Florin,9999,0,9999,0
1714601281458,CLRE 259,A00,507211,Patel; Hemal,9996,0,9999,3
1714601282485,CLRE 260,A00,507221,Cuomo; Raphael Eduardo,9999,0,9999,0
1714601283510,CLRE 297,001,507242,Cuomo; Raphael Eduardo,9999,0,9999,0
1714601284535,COGS 197,001,638244,Voytek; Bradley Thomas,9998,0,9999,1
1714601285560,CSE 191,A00,516875,Minnes Kemp; Mor Mia,9993,0,9999,6
1714601286587,CSE 197,001,637388,Minnes Kemp; Mor Mia,9998,0,9999,1
1714601287612,CSS 201S,A01,494383,Staff,35,0,35,0
1714601288637,CSS 202S,A01,494387,Staff,35,0,35,0
1714601289665,DSC 197,001,628532,Eldridge; Justin Matthew,9996,0,9999,3
1714601290689,EAP 100,A00,516065,Staff,9797,0,9999,202
1714601291718,ECE 45,A01,507414,Staff,33,0,60,27
1714601293819,ECE 111,A01,507420,Staff,15,0,50,35
1714601294845,ECE 197,001,548057,Sievenpiper; Daniel F.,9993,0,9999,6
1714601295871,EDS 115,A00,507243,Choi; Bailey Miyeon,10,0,28,18
1714601296897,EDS 117,A01,494379,Staff,1,5,30,29
1714601297921,EDS 125,A00,507246,Hopkins; Megan Beth,9,0,30,21
1714601298949,EDS 128A,A01,507264,Fargason; Sharon Gayle,8,0,26,18
1714601299977,EDS 128B,A01,507293,Pappas; Elizabeth,12,0,30,18
1714601301002,EDS 139,A00,507294,Fargason; Sharon Gayle,13,0,30,17
1714601301002,EDS 139,B00,507313,Pappas; Elizabeth,13,0,30,17
1714601302030,EDS 201,A00,507315,Staff,13,0,30,17
1714601303058,EDS 203,A01,507317,Halter; Christopher P.,12,0,30,18
1714601304084,EDS 204R,A01,507319,Halter; Christopher P.,0,3,30,30
1714601304084,EDS 204R,B01,507331,Heinzman; Erica M.,16,0,30,14
1714601305110,EDS 206R,A00,507332,Staff,0,4,30,30
1714601305110,EDS 206R,B00,507343,Staff,17,0,30,13
1714601306136,EDS 250,A00,507344,Hemans; Patricia Ann Benitez,22,0,40,18
1714601307163,EDS 281,A00,507345,Daly; Alan J.,18,0,18,0
1714601308188,EDS 284,A00,507350,Daly; Alan J.,16,0,16,0
1714601309213,EDS 286,A00,507359,Fine; Sarah,18,0,18,0
1714601310239,EDS 289C,A01,507361,Daly; Alan J.,18,0,18,0
1714601311268,EDS 290,A00,507366,Hofstetter; Carolyn,15,0,15,0
1714601312295,LIGM 5A,A00,507421,Fischer-Grunski; Eva K,18,0,20,2
1714601313318,LIGM 5B,A00,507423,Fischer-Grunski; Eva K,19,0,20,1
1714601314343,LIGM 5C,A00,507425,Fischer-Grunski; Eva K,19,0,20,1
1714601315367,LIIT 5AS,A00,507427,Carnelos; Chiara,20,0,20,0
1714601316391,LIIT 5BS,A00,507430,Carnelos; Chiara,20,0,20,0
1714601317415,LIIT 5CS,A00,507432,Carnelos; Chiara,20,0,20,0
1714601318445,LISP 5A,A00,507541,Munoz Sanchez; Alicia,11,0,20,9
1714601319474,LISP 5B,A00,507671,Munoz Sanchez; Alicia,8,0,20,12
1714601320500,LISP 5C,A00,507696,Munoz Sanchez; Alicia,9,0,20,11
1714601321527,MAE 197,001,528363,Boechler; Nicholas Sebastia,9998,0,9999,1
1714601322557,MATH 197,001,523477,Kedlaya; Kiran S.,9995,0,9999,4
1714601322557,MATH 197,002,563811,Zhang; Danna,9995,0,9999,4
1714601322557,MATH 197,003,628552,Dumitriu; Ioana,9998,0,9999,1
1714601323581,MCWP 40R,A00,518780,Staff,2,0,20,18
1714601323581,MCWP 40R,B00,518781,Staff,8,0,20,12
1714601323581,MCWP 40R,C00,518783,Staff,6,0,20,14
1714601324608,MCWP 50R,A00,518791,Staff,0,0,20,20
1714601324608,MCWP 50R,B00,518792,Staff,0,2,20,20
1714601324608,MCWP 50R,C00,518793,Staff,0,2,20,20
1714601324608,MCWP 50R,D00,518794,Staff,0,0,20,20
1714601324608,MCWP 50R,E00,518795,Staff,0,2,20,20
1714601324608,MCWP 50R,F00,518796,Staff,0,0,20,20
1714601324608,MCWP 50R,G00,518797,Staff,0,1,20,20
1714601325633,MMW 12R,A01,514034,Herbst; Matthew,0,0,16,16
1714601325633,MMW 12R,A02,514035,Herbst; Matthew,2,0,16,14
1714601326657,MMW 13R,A01,514037,Staff,0,4,16,16
1714601326657,MMW 13R,A02,514039,Staff,0,2,16,16
1714601326657,MMW 13R,A03,628519,Staff,0,2,16,16
1714601328709,SIO 295LS,A00,523233,Staff,10,0,30,20
1714601329735,SIO 295S,A00,523232,Staff,10,0,30,20
1714601330764,SIOC 290S,A01,637330,Merrifield; Mark A,24,0,30,6
1714601331795,SIOC 291S,A01,637333,Gabriel; Corey John,24,0,30,6
1714601332834,SOCI 117,A01,494376,Staff,0,4,5,5
1714601333859,WES 237B,A00,494380,Staff,9,0,20,11
1714601335928,AESE 279B,A00,494370,Wade; Jon P,0,0,33,33
1714601336952,AIP 197,001,627712,Vespa; Emanuel Ignacio,9998,0,9999,1
1714601337976,ANAR 135S,A00,494369,Braswell; Geoffrey E.,0,0,0,0
1714601339004,BENG 196,001,628496,Engler; Adam J.,9998,0,9999,1
1714601340036,CAT 124RS,A01,519847,Geibel; William,0,0,20,20
1714601341062,CAT 125RS,A01,515971,Geibel; William,0,0,20,20
1714601342088,CLRE 250,A00,511389,Morris; Sheldon,9993,0,9999,6
1714601343121,CLRE 251,A00,507176,Mehta; Ravindra L.,9993,0,9999,6
1714601343121,CLRE 251,B00,511410,Mehta; Ravindra L.,9998,0,9999,1
1714601344149,CLRE 252,A00,507189,Cuomo; Raphael Eduardo,9995,0,9999,4
1714601345178,CLRE 253,A00,507199,Vaida; Florin,9994,0,9999,5
1714601345178,CLRE 253,B00,507202,Vaida; Florin,9999,0,9999,0
1714601346204,CLRE 259,A00,507211,Patel; Hemal,9996,0,9999,3
1714601347230,CLRE 260,A00,507221,Cuomo; Raphael Eduardo,9999,0,9999,0
1714601348256,CLRE 297,001,507242,Cuomo; Raphael Eduardo,9999,0,9999,0
1714601349287,COGS 197,001,638244,Voytek; Bradley Thomas,9998,0,9999,1
1714601350315,CSE 191,A00,516875,Minnes Kemp; Mor Mia,9993,0,9999,6
1714601351340,CSE 197,001,637388,Minnes Kemp; Mor Mia,9998,0,9999,1
1714601352366,CSS 201S,A01,494383,Staff,35,0,35,0
1714601353392,CSS 202S,A01,494387,Staff,35,0,35,0
1714601354420,DSC 197,001,628532,Eldridge; Justin Matthew,9996,0,9999,3
1714601355446,EAP 100,A00,516065,Staff,9797,0,9999,202
1714601356474,ECE 45,A01,507414,Staff,33,0,60,27
1714601358525,ECE 111,A01,507420,Staff,15,0,50,35
1714601359551,ECE 197,001,548057,Sievenpiper; Daniel F.,9993,0,9999,6
1714601360579,EDS 115,A00,507243,Choi; Bailey Miyeon,10,0,28,18
1714601361608,EDS 117,A01,494379,Staff,1,5,30,29
1714601362633,EDS 125,A00,507246,Hopkins; Megan Beth,9,0,30,21
1714601363659,EDS 128A,A01,507264,Fargason; Sharon Gayle,8,0,26,18
1714601364688,EDS 128B,A01,507293,Pappas; Elizabeth,12,0,30,18
1714601365714,EDS 139,A00,507294,Fargason; Sharon Gayle,13,0,30,17
1714601365714,EDS 139,B00,507313,Pappas; Elizabeth,13,0,30,17
1714601366741,EDS 201,A00,507315,Staff,13,0,30,17
1714601367766,EDS 203,A01,507317,Halter; Christopher P.,12,0,30,18
1714601368791,EDS 204R,A01,507319,Halter; Christopher P.,0,3,30,30
1714601368791,EDS 204R,B01,507331,Heinzman; Erica M.,16,0,30,14
1714601369817,EDS 206R,A00,507332,Staff,0,4,30,30
1714601369817,EDS 206R,B00,507343,Staff,17,0,30,13
1714601370841,EDS 250,A00,507344,Hemans; Patricia Ann Benitez,22,0,40,18
1714601371867,EDS 281,A00,507345,Daly; Alan J.,18,0,18,0
1714601372893,EDS 284,A00,507350,Daly; Alan J.,16,0,16,0
1714601373919,EDS 286,A00,507359,Fine; Sarah,18,0,18,0
1714601374945,EDS 289C,A01,507361,Daly; Alan J.,18,0,18,0
1714601375972,EDS 290,A00,507366,Hofstetter; Carolyn,15,0,15,0
1714601377003,LIGM 5A,A00,507421,Fischer-Grunski; Eva K,18,0,20,2
1714601378030,LIGM 5B,A00,507423,Fischer-Grunski; Eva K,19,0,20,1
1714601379067,LIGM 5C,A00,507425,Fischer-Grunski; Eva K,19,0,20,1
1714601380092,LIIT 5AS,A00,507427,Carnelos; Chiara,20,0,20,0
1714601381120,LIIT 5BS,A00,507430,Carnelos; Chiara,20,0,20,0
1714601382148,LIIT 5CS,A00,507432,Carnelos; Chiara,20,0,20,0
1714601383174,LISP 5A,A00,507541,Munoz Sanchez; Alicia,11,0,20,9
1714601384198,LISP 5B,A00,507671,Munoz Sanchez; Alicia,8,0,20,12
1714601385224,LISP 5C,A00,507696,Munoz Sanchez; Alicia,9,0,20,11
1714601386250,MAE 197,001,528363,Boechler; Nicholas Sebastia,9998,0,9999,1
1714601387277,MATH 197,001,523477,Kedlaya; Kiran S.,9995,0,9999,4
1714601387277,MATH 197,002,563811,Zhang; Danna,9995,0,9999,4
1714601387277,MATH 197,003,628552,Dumitriu; Ioana,9998,0,9999,1
1714601388305,MCWP 40R,A00,518780,Staff,2,0,20,18
1714601388305,MCWP 40R,B00,518781,Staff,8,0,20,12
1714601388305,MCWP 40R,C00,518783,Staff,6,0,20,14
1714601389331,MCWP 50R,A00,518791,Staff,0,0,20,20
1714601389331,MCWP 50R,B00,518792,Staff,0,2,20,20
1714601389331,MCWP 50R,C00,518793,Staff,0,2,20,20
1714601389331,MCWP 50R,D00,518794,Staff,0,0,20,20
1714601389331,MCWP 50R,E00,518795,Staff,0,2,20,20
1714601389331,MCWP 50R,F00,518796,Staff,0,0,20,20
1714601389331,MCWP 50R,G00,518797,Staff,0,1,20,20
1714601390357,MMW 12R,A01,514034,Herbst; Matthew,0,0,16,16
1714601390357,MMW 12R,A02,514035,Herbst; Matthew,2,0,16,14
1714601391384,MMW 13R,A01,514037,Staff,0,4,16,16
1714601391384,MMW 13R,A02,514039,Staff,0,2,16,16
1714601391384,MMW 13R,A03,628519,Staff,0,2,16,16
1714601393437,SIO 295LS,A00,523233,Staff,10,0,30,20
1714601394460,SIO 295S,A00,523232,Staff,10,0,30,20
1714601395488,SIOC 290S,A01,637330,Merrifield; Mark A,24,0,30,6
1714601396513,SIOC 291S,A01,637333,Gabriel; Corey John,24,0,30,6
1714601397541,SOCI 117,A01,494376,Staff,0,4,5,5
1714601398574,WES 237B,A00,494380,Staff,9,0,20,11
1714601400649,AESE 279B,A00,494370,Wade; Jon P,0,0,33,33
1714601401674,AIP 197,001,627712,Vespa; Emanuel Ignacio,9998,0,9999,1
1714601402703,ANAR 135S,A00,494369,Braswell; Geoffrey E.,0,0,0,0
1714601403728,BENG 196,001,628496,Engler; Adam J.,9998,0,9999,1
1714601404753,CAT 124RS,A01,519847,Geibel; William,0,0,20,20
1714601405778,CAT 125RS,A01,515971,Geibel; William,0,0,20,20
1714601406804,CLRE 250,A00,511389,Morris; Sheldon,9993,0,9999,6
1714601407833,CLRE 251,A00,507176,Mehta; Ravindra L.,9993,0,9999,6
1714601407833,CLRE 251,B00,511410,Mehta; Ravindra L.,9998,0,9999,1
1714601408857,CLRE 252,A00,507189,Cuomo; Raphael Eduardo,9995,0,9999,4
1714601409886,CLRE 253,A00,507199,Vaida; Florin,9994,0,9999,5
1714601409886,CLRE 253,B00,507202,Vaida; Florin,9999,0,9999,0
1714601410911,CLRE 259,A00,507211,Patel; Hemal,9996,0,9999,3
1714601411935,CLRE 260,A00,507221,Cuomo; Raphael Eduardo,9999,0,9999,0
1714601412963,CLRE 297,001,507242,Cuomo; Raphael Eduardo,9999,0,9999,0
1714601413993,COGS 197,001,638244,Voytek; Bradley Thomas,9998,0,9999,1
1714601415018,CSE 191,A00,516875,Minnes Kemp; Mor Mia,9993,0,9999,6
1714601416046,CSE 197,001,637388,Minnes Kemp; Mor Mia,9998,0,9999,1
1714601417072,CSS 201S,A01,494383,Staff,35,0,35,0
1714601418095,CSS 202S,A01,494387,Staff,35,0,35,0
1714601419121,DSC 197,001,628532,Eldridge; Justin Matthew,9996,0,9999,3
1714601420145,EAP 100,A00,516065,Staff,9797,0,9999,202
1714601421173,ECE 45,A01,507414,Staff,33,0,60,27
1714601423228,ECE 111,A01,507420,Staff,15,0,50,35
1714601424253,ECE 197,001,548057,Sievenpiper; Daniel F.,9993,0,9999,6
1714601425284,EDS 115,A00,507243,Choi; Bailey Miyeon,10,0,28,18
1714601426308,EDS 117,A01,494379,Staff,1,5,30,29
1714601427339,EDS 125,A00,507246,Hopkins; Megan Beth,9,0,30,21
1714601428362,EDS 128A,A01,507264,Fargason; Sharon Gayle,8,0,26,18
1714601429387,EDS 128B,A01,507293,Pappas; Elizabeth,12,0,30,18
1714601430413,EDS 139,A00,507294,Fargason; Sharon Gayle,13,0,30,17
1714601430413,EDS 139,B00,507313,Pappas; Elizabeth,13,0,30,17
1714601431437,EDS 201,A00,507315,Staff,13,0,30,17
1714601432462,EDS 203,A01,507317,Halter; Christopher P.,12,0,30,18
1714601433490,EDS 204R,A01,507319,Halter; Christopher P.,0,3,30,30
1714601433490,EDS 204R,B01,507331,Heinzman; Erica M.,16,0,30,14
1714601434517,EDS 206R,A00,507332,Staff,0,4,30,30
1714601434517,EDS 206R,B00,507343,Staff,17,0,30,13
1714601435545,EDS 250,A00,507344,Hemans; Patricia Ann Benitez,22,0,40,18
1714601436569,EDS 281,A00,507345,Daly; Alan J.,18,0,18,0
1714601437592,EDS 284,A00,507350,Daly; Alan J.,16,0,16,0
1714601438618,EDS 286,A00,507359,Fine; Sarah,18,0,18,0
1714601439644,EDS 289C,A01,507361,Daly; Alan J.,18,0,18,0
1714601440667,EDS 290,A00,507366,Hofstetter; Carolyn,15,0,15,0
1714601441695,LIGM 5A,A00,507421,Fischer-Grunski; Eva K,18,0,20,2
1714601442722,LIGM 5B,A00,507423,Fischer-Grunski; Eva K,19,0,20,1
1714601443746,LIGM 5C,A00,507425,Fischer-Grunski; Eva K,19,0,20,1
1714601444772,LIIT 5AS,A00,507427,Carnelos; Chiara,20,0,20,0
1714601445797,LIIT 5BS,A00,507430,Carnelos; Chiara,20,0,20,0
1714601446822,LIIT 5CS,A00,507432,Carnelos; Chiara,20,0,20,0
1714601447850,LISP 5A,A00,507541,Munoz Sanchez; Alicia,11,0,20,9
1714601448877,LISP 5B,A00,507671,Munoz Sanchez; Alicia,8,0,20,12
1714601449901,LISP 5C,A00,507696,Munoz Sanchez; Alicia,9,0,20,11
1714601450925,MAE 197,001,528363,Boechler; Nicholas Sebastia,9998,0,9999,1
1714601451950,MATH 197,001,523477,Kedlaya; Kiran S.,9995,0,9999,4
1714601451950,MATH 197,002,563811,Zhang; Danna,9995,0,9999,4
1714601451950,MATH 197,003,628552,Dumitriu; Ioana,9998,0,9999,1
1714601452999,MCWP 40R,A00,518780,Staff,2,0,20,18
1714601452999,MCWP 40R,B00,518781,Staff,8,0,20,12
1714601452999,MCWP 40R,C00,518783,Staff,6,0,20,14
1714601454031,MCWP 50R,A00,518791,Staff,0,0,20,20
1714601454031,MCWP 50R,B00,518792,Staff,0,2,20,20
1714601454031,MCWP 50R,C00,518793,Staff,0,2,20,20
1714601454031,MCWP 50R,D00,518794,Staff,0,0,20,20
1714601454031,MCWP 50R,E00,518795,Staff,0,2,20,20
1714601454031,MCWP 50R,F00,518796,Staff,0,0,20,20
1714601454031,MCWP 50R,G00,518797,Staff,0,1,20,20
1714601455055,MMW 12R,A01,514034,Herbst; Matthew,0,0,16,16
1714601455055,MMW 12R,A02,514035,Herbst; Matthew,2,0,16,14
1714601456079,MMW 13R,A01,514037,Staff,0,4,16,16
1714601456079,MMW 13R,A02,514039,Staff,0,2,16,16
1714601456079,MMW 13R,A03,628519,Staff,0,2,16,16
1714601458131,SIO 295LS,A00,523233,Staff,10,0,30,20
1714601459159,SIO 295S,A00,523232,Staff,10,0,30,20
1714601460185,SIOC 290S,A01,637330,Merrifield; Mark A,24,0,30,6
1714601461214,SIOC 291S,A01,637333,Gabriel; Corey John,24,0,30,6
1714601462238,SOCI 117,A01,494376,Staff,0,4,5,5
1714601463306,WES 237B,A00,494380,Staff,9,0,20,11
1714601465383,AESE 279B,A00,494370,Wade; Jon P,0,0,33,33
1714601466407,AIP 197,001,627712,Vespa; Emanuel Ignacio,9998,0,9999,1
1714601467433,ANAR 135S,A00,494369,Braswell; Geoffrey E.,0,0,0,0
1714601468460,BENG 196,001,628496,Engler; Adam J.,9998,0,9999,1
1714601469484,CAT 124RS,A01,519847,Geibel; William,0,0,20,20
1714601470510,CAT 125RS,A01,515971,Geibel; William,0,0,20,20
1714601471541,CLRE 250,A00,511389,Morris; Sheldon,9993,0,9999,6
1714601472567,CLRE 251,A00,507176,Mehta; Ravindra L.,9993,0,9999,6
1714601472567,CLRE 251,B00,511410,Mehta; Ravindra L.,9998,0,9999,1
1714601473597,CLRE 252,A00,507189,Cuomo; Raphael Eduardo,9995,0,9999,4
1714601474625,CLRE 253,A00,507199,Vaida; Florin,9994,0,9999,5
1714601474625,CLRE 253,B00,507202,Vaida; Florin,9999,0,9999,0
1714601475651,CLRE 259,A00,507211,Patel; Hemal,9996,0,9999,3
1714601476680,CLRE 260,A00,507221,Cuomo; Raphael Eduardo,9999,0,9999,0
1714601477704,CLRE 297,001,507242,Cuomo; Raphael Eduardo,9999,0,9999,0
1714601478734,COGS 197,001,638244,Voytek; Bradley Thomas,9998,0,9999,1
1714601479757,CSE 191,A00,516875,Minnes Kemp; Mor Mia,9993,0,9999,6
1714601480785,CSE 197,001,637388,Minnes Kemp; Mor Mia,9998,0,9999,1
1714601481814,CSS 201S,A01,494383,Staff,35,0,35,0
1714601482839,CSS 202S,A01,494387,Staff,35,0,35,0
1714601483864,DSC 197,001,628532,Eldridge; Justin Matthew,9996,0,9999,3
1714601484890,EAP 100,A00,516065,Staff,9797,0,9999,202
1714601485917,ECE 45,A01,507414,Staff,33,0,60,27
1714601487972,ECE 111,A01,507420,Staff,15,0,50,35
1714601488998,ECE 197,001,548057,Sievenpiper; Daniel F.,9993,0,9999,6
1714601490025,EDS 115,A00,507243,Choi; Bailey Miyeon,10,0,28,18
1714601491055,EDS 117,A01,494379,Staff,1,5,30,29
1714601492082,EDS 125,A00,507246,Hopkins; Megan Beth,9,0,30,21
1714601493107,EDS 128A,A01,507264,Fargason; Sharon Gayle,8,0,26,18
1714601494133,EDS 128B,A01,507293,Pappas; Elizabeth,12,0,30,18
1714601495159,EDS 139,A00,507294,Fargason; Sharon Gayle,13,0,30,17
1714601495159,EDS 139,B00,507313,Pappas; Elizabeth,13,0,30,17
1714601496185,EDS 201,A00,507315,Staff,13,0,30,17
1714601497214,EDS 203,A01,507317,Halter; Christopher P.,12,0,30,18
1714601498243,EDS 204R,A01,507319,Halter; Christopher P.,0,3,30,30
1714601498243,EDS 204R,B01,507331,Heinzman; Erica M.,16,0,30,14
1714601499267,EDS 206R,A00,507332,Staff,0,4,30,30
1714601499267,EDS 206R,B00,507343,Staff,17,0,30,13
1714601500293,EDS 250,A00,507344,Hemans; Patricia Ann Benitez,22,0,40,18
1714601501318,EDS 281,A00,507345,Daly; Alan J.,18,0,18,0
1714601502342,EDS 284,A00,507350,Daly; Alan J.,16,0,16,0
1714601503370,EDS 286,A00,507359,Fine; Sarah,18,0,18,0
1714601504393,EDS 289C,A01,507361,Daly; Alan J.,18,0,18,0
1714601505418,EDS 290,A00,507366,Hofstetter; Carolyn,15,0,15,0
1714601506443,LIGM 5A,A00,507421,Fischer-Grunski; Eva K,18,0,20,2
1714601507473,LIGM 5B,A00,507423,Fischer-Grunski; Eva K,19,0,20,1
1714601508498,LIGM 5C,A00,507425,Fischer-Grunski; Eva K,19,0,20,1
1714601509527,LIIT 5AS,A00,507427,Carnelos; Chiara,20,0,20,0
1714601510615,LIIT 5BS,A00,507430,Carnelos; Chiara,20,0,20,0
1714601511642,LIIT 5CS,A00,507432,Carnelos; Chiara,20,0,20,0
1714601512679,LISP 5A,A00,507541,Munoz Sanchez; Alicia,11,0,20,9
1714601513736,LISP 5B,A00,507671,Munoz Sanchez; Alicia,8,0,20,12
1714601514760,LISP 5C,A00,507696,Munoz Sanchez; Alicia,9,0,20,11
1714601515797,MAE 197,001,528363,Boechler; Nicholas Sebastia,9998,0,9999,1
1714601516825,MATH 197,001,523477,Kedlaya; Kiran S.,9995,0,9999,4
1714601516825,MATH 197,002,563811,Zhang; Danna,9995,0,9999,4
1714601516825,MATH 197,003,628552,Dumitriu; Ioana,9998,0,9999,1
1714601517857,MCWP 40R,A00,518780,Staff,2,0,20,18
1714601517857,MCWP 40R,B00,518781,Staff,8,0,20,12
1714601517857,MCWP 40R,C00,518783,Staff,6,0,20,14
1714601518885,MCWP 50R,A00,518791,Staff,0,0,20,20
1714601518885,MCWP 50R,B00,518792,Staff,0,2,20,20
1714601518885,MCWP 50R,C00,518793,Staff,0,2,20,20
1714601518885,MCWP 50R,D00,518794,Staff,0,0,20,20
1714601518885,MCWP 50R,E00,518795,Staff,0,2,20,20
1714601518885,MCWP 50R,F00,518796,Staff,0,0,20,20
1714601518885,MCWP 50R,G00,518797,Staff,0,1,20,20
1714601519960,MMW 12R,A01,514034,Herbst; Matthew,0,0,16,16
1714601519960,MMW 12R,A02,514035,Herbst; Matthew,2,0,16,14
1714601520987,MMW 13R,A01,514037,Staff,0,4,16,16
1714601520987,MMW 13R,A02,514039,Staff,0,2,16,16
1714601520987,MMW 13R,A03,628519,Staff,0,2,16,16
1714601523039,SIO 295LS,A00,523233,Staff,10,0,30,20
1714601524068,SIO 295S,A00,523232,Staff,10,0,30,20
1714601525099,SIOC 290S,A01,637330,Merrifield; Mark A,24,0,30,6
1714601526124,SIOC 291S,A01,637333,Gabriel; Corey John,24,0,30,6
1714601527151,SOCI 117,A01,494376,Staff,0,4,5,5
1714601528179,WES 237B,A00,494380,Staff,9,0,20,11
1714601530255,AESE 279B,A00,494370,Wade; Jon P,0,0,33,33
1714601531290,AIP 197,001,627712,Vespa; Emanuel Ignacio,9998,0,9999,1
1714601532467,ANAR 135S,A00,494369,Braswell; Geoffrey E.,0,0,0,0
1714601533504,BENG 196,001,628496,Engler; Adam J.,9998,0,9999,1
1714601534531,CAT 124RS,A01,519847,Geibel; William,0,0,20,20
1714601535556,CAT 125RS,A01,515971,Geibel; William,0,0,20,20
1714601536598,CLRE 250,A00,511389,Morris; Sheldon,9993,0,9999,6
1714601537630,CLRE 251,A00,507176,Mehta; Ravindra L.,9993,0,9999,6
1714601537630,CLRE 251,B00,511410,Mehta; Ravindra L.,9998,0,9999,1
1714601538660,CLRE 252,A00,507189,Cuomo; Raphael Eduardo,9995,0,9999,4
1714601539689,CLRE 253,A00,507199,Vaida; Florin,9994,0,9999,5
1714601539689,CLRE 253,B00,507202,Vaida; Florin,9999,0,9999,0
1714601540720,CLRE 259,A00,507211,Patel; Hemal,9996,0,9999,3
1714601541747,CLRE 260,A00,507221,Cuomo; Raphael Eduardo,9999,0,9999,0
1714601542771,CLRE 297,001,507242,Cuomo; Raphael Eduardo,9999,0,9999,0
1714601543801,COGS 197,001,638244,Voytek; Bradley Thomas,9998,0,9999,1
1714601544831,CSE 191,A00,516875,Minnes Kemp; Mor Mia,9993,0,9999,6
1714601545865,CSE 197,001,637388,Minnes Kemp; Mor Mia,9998,0,9999,1
1714601546902,CSS 201S,A01,494383,Staff,35,0,35,0
1714601548053,CSS 202S,A01,494387,Staff,35,0,35,0
1714601549081,DSC 197,001,628532,Eldridge; Justin Matthew,9996,0,9999,3
1714601550110,EAP 100,A00,516065,Staff,9797,0,9999,202
1714601551141,ECE 45,A01,507414,Staff,33,0,60,27
1714601553228,ECE 111,A01,507420,Staff,15,0,50,35
1714601554257,ECE 197,001,548057,Sievenpiper; Daniel F.,9993,0,9999,6
1714601555282,EDS 115,A00,507243,Choi; Bailey Miyeon,10,0,28,18
1714601556310,EDS 117,A01,494379,Staff,1,5,30,29
1714601557421,EDS 125,A00,507246,Hopkins; Megan Beth,9,0,30,21
1714601558450,EDS 128A,A01,507264,Fargason; Sharon Gayle,8,0,26,18
1714601559474,EDS 128B,A01,507293,Pappas; Elizabeth,12,0,30,18
1714601560501,EDS 139,A00,507294,Fargason; Sharon Gayle,13,0,30,17
1714601560501,EDS 139,B00,507313,Pappas; Elizabeth,13,0,30,17
1714601561681,EDS 201,A00,507315,Staff,13,0,30,17
1714601562709,EDS 203,A01,507317,Halter; Christopher P.,12,0,30,18
1714601563746,EDS 204R,A01,507319,Halter; Christopher P.,0,3,30,30
1714601563746,EDS 204R,B01,507331,Heinzman; Erica M.,16,0,30,14
1714601564775,EDS 206R,A00,507332,Staff,0,4,30,30
1714601564775,EDS 206R,B00,507343,Staff,17,0,30,13
1714601565801,EDS 250,A00,507344,Hemans; Patricia Ann Benitez,22,0,40,18
1714601566830,EDS 281,A00,507345,Daly; Alan J.,18,0,18,0
1714601567854,EDS 284,A00,507350,Daly; Alan J.,16,0,16,0
1714601568879,EDS 286,A00,507359,Fine; Sarah,18,0,18,0
1714601569904,EDS 289C,A01,507361,Daly; Alan J.,18,0,18,0
1714601570934,EDS 290,A00,507366,Hofstetter; Carolyn,15,0,15,0
1714601571965,LIGM 5A,A00,507421,Fischer-Grunski; Eva K,18,0,20,2
1714601572993,LIGM 5B,A00,507423,Fischer-Grunski; Eva K,19,0,20,1
1714601574018,LIGM 5C,A00,507425,Fischer-Grunski; Eva K,19,0,20,1
1714601575107,LIIT 5AS,A00,507427,Carnelos; Chiara,20,0,20,0
1714601576137,LIIT 5BS,A00,507430,Carnelos; Chiara,20,0,20,0
1714601577165,LIIT 5CS,A00,507432,Carnelos; Chiara,20,0,20,0
1714601578193,LISP 5A,A00,507541,Munoz Sanchez; Alicia,11,0,20,9
1714601579221,LISP 5B,A00,507671,Munoz Sanchez; Alicia,8,0,20,12
1714601580249,LISP 5C,A00,507696,Munoz Sanchez; Alicia,9,0,20,11
1714601581277,MAE 197,001,528363,Boechler; Nicholas Sebastia,9998,0,9999,1
1714601582304,MATH 197,001,523477,Kedlaya; Kiran S.,9995,0,9999,4
1714601582304,MATH 197,002,563811,Zhang; Danna,9995,0,9999,4
1714601582304,MATH 197,003,628552,Dumitriu; Ioana,9998,0,9999,1
1714601583330,MCWP 40R,A00,518780,Staff,2,0,20,18
1714601583330,MCWP 40R,B00,518781,Staff,8,0,20,12
1714601583330,MCWP 40R,C00,518783,Staff,6,0,20,14
1714601584353,MCWP 50R,A00,518791,Staff,0,0,20,20
1714601584353,MCWP 50R,B00,518792,Staff,0,2,20,20
1714601584353,MCWP 50R,C00,518793,Staff,0,2,20,20
1714601584353,MCWP 50R,D00,518794,Staff,0,0,20,20
1714601584353,MCWP 50R,E00,518795,Staff,0,2,20,20
1714601584353,MCWP 50R,F00,518796,Staff,0,0,20,20
1714601584353,MCWP 50R,G00,518797,Staff,0,1,20,20
1714601585379,MMW 12R,A01,514034,Herbst; Matthew,0,0,16,16
1714601585379,MMW 12R,A02,514035,Herbst; Matthew,2,0,16,14
1714601586414,MMW 13R,A01,514037,Staff,0,4,16,16
1714601586414,MMW 13R,A02,514039,Staff,0,2,16,16
1714601586414,MMW 13R,A03,628519,Staff,0,2,16,16
1714601588475,SIO 295LS,A00,523233,Staff,10,0,30,20
1714601589502,SIO 295S,A00,523232,Staff,10,0,30,20
1714601590529,SIOC 290S,A01,637330,Merrifield; Mark A,24,0,30,6
1714601591558,SIOC 291S,A01,637333,Gabriel; Corey John,24,0,30,6
1714601592587,SOCI 117,A01,494376,Staff,0,4,5,5
1714601593614,WES 237B,A00,494380,Staff,9,0,20,11
1714601595702,AESE 279B,A00,494370,Wade; Jon P,0,0,33,33
1714601596732,AIP 197,001,627712,Vespa; Emanuel Ignacio,9998,0,9999,1
1714601597760,ANAR 135S,A00,494369,Braswell; Geoffrey E.,0,0,0,0
1714601598789,BENG 196,001,628496,Engler; Adam J.,9998,0,9999,1
1714601599813,CAT 124RS,A01,519847,Geibel; William,0,0,20,20
1714601600838,CAT 125RS,A01,515971,Geibel; William,0,0,20,20
1714601601865,CLRE 250,A00,511389,Morris; Sheldon,9993,0,9999,6
1714601602896,CLRE 251,A00,507176,Mehta; Ravindra L.,9993,0,9999,6
1714601602896,CLRE 251,B00,511410,Mehta; Ravindra L.,9998,0,9999,1
1714601603921,CLRE 252,A00,507189,Cuomo; Raphael Eduardo,9995,0,9999,4
1714601604952,CLRE 253,A00,507199,Vaida; Florin,9994,0,9999,5
1714601604952,CLRE 253,B00,507202,Vaida; Florin,9999,0,9999,0
1714601605975,CLRE 259,A00,507211,Patel; Hemal,9996,0,9999,3
1714601607006,CLRE 260,A00,507221,Cuomo; Raphael Eduardo,9999,0,9999,0
1714601608034,CLRE 297,001,507242,Cuomo; Raphael Eduardo,9999,0,9999,0
1714601609065,COGS 197,001,638244,Voytek; Bradley Thomas,9998,0,9999,1
1714601610095,CSE 191,A00,516875,Minnes Kemp; Mor Mia,9993,0,9999,6
1714601611121,CSE 197,001,637388,Minnes Kemp; Mor Mia,9998,0,9999,1
1714601612152,CSS 201S,A01,494383,Staff,35,0,35,0
1714601613182,CSS 202S,A01,494387,Staff,35,0,35,0
1714601614206,DSC 197,001,628532,Eldridge; Justin Matthew,9996,0,9999,3
1714601617181,EAP 100,A00,516065,Staff,9797,0,9999,202
1714601618211,ECE 45,A01,507414,Staff,33,0,60,27
1714601620264,ECE 111,A01,507420,Staff,15,0,50,35
1714601621288,ECE 197,001,548057,Sievenpiper; Daniel F.,9993,0,9999,6
1714601622315,EDS 115,A00,507243,Choi; Bailey Miyeon,10,0,28,18
1714601623342,EDS 117,A01,494379,Staff,1,5,30,29
1714601624369,EDS 125,A00,507246,Hopkins; Megan Beth,9,0,30,21
1714601625481,EDS 128A,A01,507264,Fargason; Sharon Gayle,8,0,26,18
1714601626513,EDS 128B,A01,507293,Pappas; Elizabeth,12,0,30,18
1714601627541,EDS 139,A00,507294,Fargason; Sharon Gayle,13,0,30,17
1714601627541,EDS 139,B00,507313,Pappas; Elizabeth,13,0,30,17
1714601628563,EDS 201,A00,507315,Staff,13,0,30,17
1714601629592,EDS 203,A01,507317,Halter; Christopher P.,12,0,30,18
1714601630623,EDS 204R,A01,507319,Halter; Christopher P.,0,3,30,30
1714601630623,EDS 204R,B01,507331,Heinzman; Erica M.,16,0,30,14
1714601631647,EDS 206R,A00,507332,Staff,0,4,30,30
1714601631647,EDS 206R,B00,507343,Staff,17,0,30,13
1714601632685,EDS 250,A00,507344,Hemans; Patricia Ann Benitez,22,0,40,18
1714601633710,EDS 281,A00,507345,Daly; Alan J.,18,0,18,0
1714601634735,EDS 284,A00,507350,Daly; Alan J.,16,0,16,0
1714601635762,EDS 286,A00,507359,Fine; Sarah,18,0,18,0
1714601636787,EDS 289C,A01,507361,Daly; Alan J.,18,0,18,0
1714601637815,EDS 290,A00,507366,Hofstetter; Carolyn,15,0,15,0
1714601638841,LIGM 5A,A00,507421,Fischer-Grunski; Eva K,18,0,20,2
1714601639865,LIGM 5B,A00,507423,Fischer-Grunski; Eva K,19,0,20,1
1714601640890,LIGM 5C,A00,507425,Fischer-Grunski; Eva K,19,0,20,1
1714601641919,LIIT 5AS,A00,507427,Carnelos; Chiara,20,0,20,0
1714601642942,LIIT 5BS,A00,507430,Carnelos; Chiara,20,0,20,0
1714601644008,LIIT 5CS,A00,507432,Carnelos; Chiara,20,0,20,0
1714601645037,LISP 5A,A00,507541,Munoz Sanchez; Alicia,11,0,20,9
1714601646064,LISP 5B,A00,507671,Munoz Sanchez; Alicia,8,0,20,12
1714601647094,LISP 5C,A00,507696,Munoz Sanchez; Alicia,9,0,20,11
1714601648117,MAE 197,001,528363,Boechler; Nicholas Sebastia,9998,0,9999,1
1714601649154,MATH 197,001,523477,Kedlaya; Kiran S.,9995,0,9999,4
1714601649154,MATH 197,002,563811,Zhang; Danna,9995,0,9999,4
1714601649154,MATH 197,003,628552,Dumitriu; Ioana,9998,0,9999,1
1714601650177,MCWP 40R,A00,518780,Staff,2,0,20,18
1714601650177,MCWP 40R,B00,518781,Staff,8,0,20,12
1714601650177,MCWP 40R,C00,518783,Staff,6,0,20,14
1714601651203,MCWP 50R,A00,518791,Staff,0,0,20,20
1714601651203,MCWP 50R,B00,518792,Staff,0,2,20,20
1714601651203,MCWP 50R,C00,518793,Staff,0,2,20,20
1714601651203,MCWP 50R,D00,518794,Staff,0,0,20,20
1714601651203,MCWP 50R,E00,518795,Staff,0,2,20,20
1714601651203,MCWP 50R,F00,518796,Staff,0,0,20,20
1714601651203,MCWP 50R,G00,518797,Staff,0,1,20,20
1714601652229,MMW 12R,A01,514034,Herbst; Matthew,0,0,16,16
1714601652229,MMW 12R,A02,514035,Herbst; Matthew,2,0,16,14
1714601653254,MMW 13R,A01,514037,Staff,0,4,16,16
1714601653254,MMW 13R,A02,514039,Staff,0,2,16,16
1714601653254,MMW 13R,A03,628519,Staff,0,2,16,16
1714601655305,SIO 295LS,A00,523233,Staff,10,0,30,20
1714601656334,SIO 295S,A00,523232,Staff,10,0,30,20
1714601657361,SIOC 290S,A01,637330,Merrifield; Mark A,24,0,30,6
1714601658390,SIOC 291S,A01,637333,Gabriel; Corey John,24,0,30,6
1714601659416,SOCI 117,A01,494376,Staff,0,4,5,5
1714601660440,WES 237B,A00,494380,Staff,9,0,20,11
1714601662536,AESE 279B,A00,494370,Wade; Jon P,0,0,33,33
1714601663567,AIP 197,001,627712,Vespa; Emanuel Ignacio,9998,0,9999,1
1714601664592,ANAR 135S,A00,494369,Braswell; Geoffrey E.,0,0,0,0
1714601665618,BENG 196,001,628496,Engler; Adam J.,9998,0,9999,1
1714601666644,CAT 124RS,A01,519847,Geibel; William,0,0,20,20
1714601667682,CAT 125RS,A01,515971,Geibel; William,0,0,20,20
1714601668709,CLRE 250,A00,511389,Morris; Sheldon,9993,0,9999,6
1714601669734,CLRE 251,A00,507176,Mehta; Ravindra L.,9993,0,9999,6
1714601669734,CLRE 251,B00,511410,Mehta; Ravindra L.,9998,0,9999,1
1714601670762,CLRE 252,A00,507189,Cuomo; Raphael Eduardo,9995,0,9999,4
1714601671786,CLRE 253,A00,507199,Vaida; Florin,9994,0,9999,5
1714601671786,CLRE 253,B00,507202,Vaida; Florin,9999,0,9999,0
1714601672812,CLRE 259,A00,507211,Patel; Hemal,9996,0,9999,3
1714601673839,CLRE 260,A00,507221,Cuomo; Raphael Eduardo,9999,0,9999,0
1714601674863,CLRE 297,001,507242,Cuomo; Raphael Eduardo,9999,0,9999,0
1714601675887,COGS 197,001,638244,Voytek; Bradley Thomas,9998,0,9999,1
1714601676915,CSE 191,A00,516875,Minnes Kemp; Mor Mia,9993,0,9999,6
1714601677939,CSE 197,001,637388,Minnes Kemp; Mor Mia,9998,0,9999,1
1714601678969,CSS 201S,A01,494383,Staff,35,0,35,0
1714601679993,CSS 202S,A01,494387,Staff,35,0,35,0
1714601681018,DSC 197,001,628532,Eldridge; Justin Matthew,9996,0,9999,3
1714601682043,EAP 100,A00,516065,Staff,9797,0,9999,202
1714601683069,ECE 45,A01,507414,Staff,33,0,60,27
1714601685120,ECE 111,A01,507420,Staff,15,0,50,35
1714601686153,ECE 197,001,548057,Sievenpiper; Daniel F.,9993,0,9999,6
1714601687182,EDS 115,A00,507243,Choi; Bailey Miyeon,10,0,28,18
1714601688208,EDS 117,A01,494379,Staff,1,5,30,29
1714601689235,EDS 125,A00,507246,Hopkins; Megan Beth,9,0,30,21
1714601690260,EDS 128A,A01,507264,Fargason; Sharon Gayle,8,0,26,18
1714601691287,EDS 128B,A01,507293,Pappas; Elizabeth,12,0,30,18
1714601692314,EDS 139,A00,507294,Fargason; Sharon Gayle,13,0,30,17
1714601692314,EDS 139,B00,507313,Pappas; Elizabeth,13,0,30,17
1714601693339,EDS 201,A00,507315,Staff,13,0,30,17
1714601694365,EDS 203,A01,507317,Halter; Christopher P.,12,0,30,18
1714601695391,EDS 204R,A01,507319,Halter; Christopher P.,0,3,30,30
1714601695391,EDS 204R,B01,507331,Heinzman; Erica M.,16,0,30,14
1714601696418,EDS 206R,A00,507332,Staff,0,4,30,30
1714601696418,EDS 206R,B00,507343,Staff,17,0,30,13
1714601697442,EDS 250,A00,507344,Hemans; Patricia Ann Benitez,22,0,40,18
1714601698468,EDS 281,A00,507345,Daly; Alan J.,18,0,18,0
1714601699494,EDS 284,A00,507350,Daly; Alan J.,16,0,16,0
1714601700522,EDS 286,A00,507359,Fine; Sarah,18,0,18,0
1714601701549,EDS 289C,A01,507361,Daly; Alan J.,18,0,18,0
1714601702595,EDS 290,A00,507366,Hofstetter; Carolyn,15,0,15,0
1714601703620,LIGM 5A,A00,507421,Fischer-Grunski; Eva K,18,0,20,2
1714601704647,LIGM 5B,A00,507423,Fischer-Grunski; Eva K,19,0,20,1
1714601705676,LIGM 5C,A00,507425,Fischer-Grunski; Eva K,19,0,20,1
1714601706702,LIIT 5AS,A00,507427,Carnelos; Chiara,20,0,20,0
1714601707727,LIIT 5BS,A00,507430,Carnelos; Chiara,20,0,20,0
1714601708752,LIIT 5CS,A00,507432,Carnelos; Chiara,20,0,20,0
1714601709781,LISP 5A,A00,507541,Munoz Sanchez; Alicia,11,0,20,9
1714601710807,LISP 5B,A00,507671,Munoz Sanchez; Alicia,8,0,20,12
1714601711833,LISP 5C,A00,507696,Munoz Sanchez; Alicia,9,0,20,11
1714601712858,MAE 197,001,528363,Boechler; Nicholas Sebastia,9998,0,9999,1
1714601713885,MATH 197,001,523477,Kedlaya; Kiran S.,9995,0,9999,4
1714601713885,MATH 197,002,563811,Zhang; Danna,9995,0,9999,4
1714601713885,MATH 197,003,628552,Dumitriu; Ioana,9998,0,9999,1
1714601714908,MCWP 40R,A00,518780,Staff,2,0,20,18
1714601714908,MCWP 40R,B00,518781,Staff,8,0,20,12
1714601714908,MCWP 40R,C00,518783,Staff,6,0,20,14
1714601715959,MCWP 50R,A00,518791,Staff,0,0,20,20
1714601715959,MCWP 50R,B00,518792,Staff,0,2,20,20
1714601715959,MCWP 50R,C00,518793,Staff,0,2,20,20
1714601715959,MCWP 50R,D00,518794,Staff,0,0,20,20
1714601715959,MCWP 50R,E00,518795,Staff,0,2,20,20
1714601715959,MCWP 50R,F00,518796,Staff,0,0,20,20
1714601715959,MCWP 50R,G00,518797,Staff,0,1,20,20
1714601716983,MMW 12R,A01,514034,Herbst; Matthew,0,0,16,16
1714601716983,MMW 12R,A02,514035,Herbst; Matthew,2,0,16,14
1714601718012,MMW 13R,A01,514037,Staff,0,4,16,16
1714601718012,MMW 13R,A02,514039,Staff,0,2,16,16
1714601718012,MMW 13R,A03,628519,Staff,0,2,16,16
1714601720060,SIO 295LS,A00,523233,Staff,10,0,30,20
1714601721084,SIO 295S,A00,523232,Staff,10,0,30,20
1714601722115,SIOC 290S,A01,637330,Merrifield; Mark A,24,0,30,6
1714601723145,SIOC 291S,A01,637333,Gabriel; Corey John,24,0,30,6
1714601724168,SOCI 117,A01,494376,Staff,0,4,5,5
1714601725196,WES 237B,A00,494380,Staff,9,0,20,11
1714601727265,AESE 279B,A00,494370,Wade; Jon P,0,0,33,33
1714601728292,AIP 197,001,627712,Vespa; Emanuel Ignacio,9998,0,9999,1
1714601729319,ANAR 135S,A00,494369,Braswell; Geoffrey E.,0,0,0,0
1714601730347,BENG 196,001,628496,Engler; Adam J.,9998,0,9999,1
1714601731373,CAT 124RS,A01,519847,Geibel; William,0,0,20,20
1714601732400,CAT 125RS,A01,515971,Geibel; William,0,0,20,20
1714601733426,CLRE 250,A00,511389,Morris; Sheldon,9993,0,9999,6
1714601734455,CLRE 251,A00,507176,Mehta; Ravindra L.,9993,0,9999,6
1714601734455,CLRE 251,B00,511410,Mehta; Ravindra L.,9998,0,9999,1
1714601735480,CLRE 252,A00,507189,Cuomo; Raphael Eduardo,9995,0,9999,4
1714601736505,CLRE 253,A00,507199,Vaida; Florin,9994,0,9999,5
1714601736505,CLRE 253,B00,507202,Vaida; Florin,9999,0,9999,0
1714601737532,CLRE 259,A00,507211,Patel; Hemal,9996,0,9999,3
1714601738557,CLRE 260,A00,507221,Cuomo; Raphael Eduardo,9999,0,9999,0
1714601739582,CLRE 297,001,507242,Cuomo; Raphael Eduardo,9999,0,9999,0
1714601740608,COGS 197,001,638244,Voytek; Bradley Thomas,9998,0,9999,1
1714601741634,CSE 191,A00,516875,Minnes Kemp; Mor Mia,9993,0,9999,6
1714601742657,CSE 197,001,637388,Minnes Kemp; Mor Mia,9998,0,9999,1
1714601743685,CSS 201S,A01,494383,Staff,35,0,35,0
1714601744709,CSS 202S,A01,494387,Staff,35,0,35,0
1714601745737,DSC 197,001,628532,Eldridge; Justin Matthew,9996,0,9999,3
1714601746762,EAP 100,A00,516065,Staff,9797,0,9999,202
1714601747789,ECE 45,A01,507414,Staff,33,0,60,27
1714601749838,ECE 111,A01,507420,Staff,15,0,50,35
1714601750863,ECE 197,001,548057,Sievenpiper; Daniel F.,9993,0,9999,6
1714601751888,EDS 115,A00,507243,Choi; Bailey Miyeon,10,0,28,18
1714601752919,EDS 117,A01,494379,Staff,1,5,30,29
1714601753948,EDS 125,A00,507246,Hopkins; Megan Beth,9,0,30,21
1714601754973,EDS 128A,A01,507264,Fargason; Sharon Gayle,8,0,26,18
1714601755999,EDS 128B,A01,507293,Pappas; Elizabeth,12,0,30,18
1714601757028,EDS 139,A00,507294,Fargason; Sharon Gayle,13,0,30,17
1714601757028,EDS 139,B00,507313,Pappas; Elizabeth,13,0,30,17
1714601758058,EDS 201,A00,507315,Staff,13,0,30,17
1714601759084,EDS 203,A01,507317,Halter; Christopher P.,12,0,30,18
1714601760110,EDS 204R,A01,507319,Halter; Christopher P.,0,3,30,30
1714601760110,EDS 204R,B01,507331,Heinzman; Erica M.,16,0,30,14
1714601761135,EDS 206R,A00,507332,Staff,0,4,30,30
1714601761135,EDS 206R,B00,507343,Staff,17,0,30,13
1714601762165,EDS 250,A00,507344,Hemans; Patricia Ann Benitez,22,0,40,18
1714601763191,EDS 281,A00,507345,Daly; Alan J.,18,0,18,0
1714601764219,EDS 284,A00,507350,Daly; Alan J.,16,0,16,0
1714601765244,EDS 286,A00,507359,Fine; Sarah,18,0,18,0
1714601766268,EDS 289C,A01,507361,Daly; Alan J.,18,0,18,0
1714601767294,EDS 290,A00,507366,Hofstetter; Carolyn,15,0,15,0
1714601768319,LIGM 5A,A00,507421,Fischer-Grunski; Eva K,18,0,20,2
1714601769345,LIGM 5B,A00,507423,Fischer-Grunski; Eva K,19,0,20,1
1714601770372,LIGM 5C,A00,507425,Fischer-Grunski; Eva K,19,0,20,1
1714601771397,LIIT 5AS,A00,507427,Carnelos; Chiara,20,0,20,0
1714601772423,LIIT 5BS,A00,507430,Carnelos; Chiara,20,0,20,0
1714601773452,LIIT 5CS,A00,507432,Carnelos; Chiara,20,0,20,0
1714601774478,LISP 5A,A00,507541,Munoz Sanchez; Alicia,11,0,20,9
1714601775510,LISP 5B,A00,507671,Munoz Sanchez; Alicia,8,0,20,12
1714601776535,LISP 5C,A00,507696,Munoz Sanchez; Alicia,9,0,20,11
1714601777560,MAE 197,001,528363,Boechler; Nicholas Sebastia,9998,0,9999,1
1714601778588,MATH 197,001,523477,Kedlaya; Kiran S.,9995,0,9999,4
1714601778588,MATH 197,002,563811,Zhang; Danna,9995,0,9999,4
1714601778588,MATH 197,003,628552,Dumitriu; Ioana,9998,0,9999,1
1714601779612,MCWP 40R,A00,518780,Staff,2,0,20,18
1714601779612,MCWP 40R,B00,518781,Staff,8,0,20,12
1714601779612,MCWP 40R,C00,518783,Staff,6,0,20,14
1714601780638,MCWP 50R,A00,518791,Staff,0,0,20,20
1714601780638,MCWP 50R,B00,518792,Staff,0,2,20,20
1714601780638,MCWP 50R,C00,518793,Staff,0,2,20,20
1714601780638,MCWP 50R,D00,518794,Staff,0,0,20,20
1714601780638,MCWP 50R,E00,518795,Staff,0,2,20,20
1714601780638,MCWP 50R,F00,518796,Staff,0,0,20,20
1714601780638,MCWP 50R,G00,518797,Staff,0,1,20,20
1714601781664,MMW 12R,A01,514034,Herbst; Matthew,0,0,16,16
1714601781664,MMW 12R,A02,514035,Herbst; Matthew,2,0,16,14
1714601782689,MMW 13R,A01,514037,Staff,0,4,16,16
1714601782689,MMW 13R,A02,514039,Staff,0,2,16,16
1714601782689,MMW 13R,A03,628519,Staff,0,2,16,16
1714601784741,SIO 295LS,A00,523233,Staff,10,0,30,20
1714601785770,SIO 295S,A00,523232,Staff,10,0,30,20
1714601786799,SIOC 290S,A01,637330,Merrifield; Mark A,24,0,30,6
1714601787824,SIOC 291S,A01,637333,Gabriel; Corey John,24,0,30,6
1714601788850,SOCI 117,A01,494376,Staff,0,4,5,5
1714601789873,WES 237B,A00,494380,Staff,9,0,20,11
1714601791943,AESE 279B,A00,494370,Wade; Jon P,0,0,33,33
1714601792968,AIP 197,001,627712,Vespa; Emanuel Ignacio,9998,0,9999,1
1714601793993,ANAR 135S,A00,494369,Braswell; Geoffrey E.,0,0,0,0
1714601795019,BENG 196,001,628496,Engler; Adam J.,9998,0,9999,1
1714601796048,CAT 124RS,A01,519847,Geibel; William,0,0,20,20
1714601797073,CAT 125RS,A01,515971,Geibel; William,0,0,20,20
1714601798098,CLRE 250,A00,511389,Morris; Sheldon,9993,0,9999,6
1714601799127,CLRE 251,A00,507176,Mehta; Ravindra L.,9993,0,9999,6
1714601799127,CLRE 251,B00,511410,Mehta; Ravindra L.,9998,0,9999,1
1714601800151,CLRE 252,A00,507189,Cuomo; Raphael Eduardo,9995,0,9999,4
1714601801180,CLRE 253,A00,507199,Vaida; Florin,9994,0,9999,5
1714601801180,CLRE 253,B00,507202,Vaida; Florin,9999,0,9999,0
1714601802206,CLRE 259,A00,507211,Patel; Hemal,9996,0,9999,3
1714601803231,CLRE 260,A00,507221,Cuomo; Raphael Eduardo,9999,0,9999,0
1714601804258,CLRE 297,001,507242,Cuomo; Raphael Eduardo,9999,0,9999,0
1714601805285,COGS 197,001,638244,Voytek; Bradley Thomas,9998,0,9999,1
1714601806310,CSE 191,A00,516875,Minnes Kemp; Mor Mia,9993,0,9999,6
1714601807335,CSE 197,001,637388,Minnes Kemp; Mor Mia,9998,0,9999,1
1714601808363,CSS 201S,A01,494383,Staff,35,0,35,0
1714601809388,CSS 202S,A01,494387,Staff,35,0,35,0
1714601810414,DSC 197,001,628532,Eldridge; Justin Matthew,9996,0,9999,3
1714601811441,EAP 100,A00,516065,Staff,9797,0,9999,202
1714601812468,ECE 45,A01,507414,Staff,33,0,60,27
1714601814522,ECE 111,A01,507420,Staff,15,0,50,35
1714601815550,ECE 197,001,548057,Sievenpiper; Daniel F.,9993,0,9999,6
1714601816580,EDS 115,A00,507243,Choi; Bailey Miyeon,10,0,28,18
1714601817606,EDS 117,A01,494379,Staff,1,5,30,29
1714601818633,EDS 125,A00,507246,Hopkins; Megan Beth,9,0,30,21
1714601819657,EDS 128A,A01,507264,Fargason; Sharon Gayle,8,0,26,18
1714601820687,EDS 128B,A01,507293,Pappas; Elizabeth,12,0,30,18
1714601821714,EDS 139,A00,507294,Fargason; Sharon Gayle,13,0,30,17
1714601821714,EDS 139,B00,507313,Pappas; Elizabeth,13,0,30,17
1714601822739,EDS 201,A00,507315,Staff,13,0,30,17
1714601823766,EDS 203,A01,507317,Halter; Christopher P.,12,0,30,18
1714601824793,EDS 204R,A01,507319,Halter; Christopher P.,0,3,30,30
1714601824793,EDS 204R,B01,507331,Heinzman; Erica M.,16,0,30,14
1714601825819,EDS 206R,A00,507332,Staff,0,4,30,30
1714601825819,EDS 206R,B00,507343,Staff,17,0,30,13
1714601826844,EDS 250,A00,507344,Hemans; Patricia Ann Benitez,22,0,40,18
1714601827873,EDS 281,A00,507345,Daly; Alan J.,18,0,18,0
1714601828900,EDS 284,A00,507350,Daly; Alan J.,16,0,16,0
1714601829926,EDS 286,A00,507359,Fine; Sarah,18,0,18,0
1714601830954,EDS 289C,A01,507361,Daly; Alan J.,18,0,18,0
1714601831979,EDS 290,A00,507366,Hofstetter; Carolyn,15,0,15,0
1714601833010,LIGM 5A,A00,507421,Fischer-Grunski; Eva K,18,0,20,2
1714601834036,LIGM 5B,A00,507423,Fischer-Grunski; Eva K,19,0,20,1
1714601835063,LIGM 5C,A00,507425,Fischer-Grunski; Eva K,19,0,20,1
1714601836088,LIIT 5AS,A00,507427,Carnelos; Chiara,20,0,20,0
1714601837113,LIIT 5BS,A00,507430,Carnelos; Chiara,20,0,20,0
1714601838141,LIIT 5CS,A00,507432,Carnelos; Chiara,20,0,20,0
1714601839165,LISP 5A,A00,507541,Munoz Sanchez; Alicia,11,0,20,9
1714601840194,LISP 5B,A00,507671,Munoz Sanchez; Alicia,8,0,20,12
1714601841222,LISP 5C,A00,507696,Munoz Sanchez; Alicia,9,0,20,11
1714601842253,MAE 197,001,528363,Boechler; Nicholas Sebastia,9998,0,9999,1
1714601843281,MATH 197,001,523477,Kedlaya; Kiran S.,9995,0,9999,4
1714601843281,MATH 197,002,563811,Zhang; Danna,9995,0,9999,4
1714601843281,MATH 197,003,628552,Dumitriu; Ioana,9998,0,9999,1
1714601844310,MCWP 40R,A00,518780,Staff,2,0,20,18
1714601844310,MCWP 40R,B00,518781,Staff,8,0,20,12
1714601844310,MCWP 40R,C00,518783,Staff,6,0,20,14
1714601845339,MCWP 50R,A00,518791,Staff,0,0,20,20
1714601845339,MCWP 50R,B00,518792,Staff,0,2,20,20
1714601845339,MCWP 50R,C00,518793,Staff,0,2,20,20
1714601845339,MCWP 50R,D00,518794,Staff,0,0,20,20
1714601845339,MCWP 50R,E00,518795,Staff,0,2,20,20
1714601845339,MCWP 50R,F00,518796,Staff,0,0,20,20
1714601845339,MCWP 50R,G00,518797,Staff,0,1,20,20
1714601846364,MMW 12R,A01,514034,Herbst; Matthew,0,0,16,16
1714601846364,MMW 12R,A02,514035,Herbst; Matthew,2,0,16,14
1714601847389,MMW 13R,A01,514037,Staff,0,4,16,16
1714601847389,MMW 13R,A02,514039,Staff,0,2,16,16
1714601847389,MMW 13R,A03,628519,Staff,0,2,16,16
1714601849442,SIO 295LS,A00,523233,Staff,10,0,30,20
1714601850474,SIO 295S,A00,523232,Staff,10,0,30,20
1714601851501,SIOC 290S,A01,637330,Merrifield; Mark A,24,0,30,6
1714601852531,SIOC 291S,A01,637333,Gabriel; Corey John,24,0,30,6
1714601853560,SOCI 117,A01,494376,Staff,0,4,5,5
1714601854587,WES 237B,A00,494380,Staff,9,0,20,11
1714601856672,AESE 279B,A00,494370,Wade; Jon P,0,0,33,33
1714601857696,AIP 197,001,627712,Vespa; Emanuel Ignacio,9998,0,9999,1
1714601858721,ANAR 135S,A00,494369,Braswell; Geoffrey E.,0,0,0,0
1714601859746,BENG 196,001,628496,Engler; Adam J.,9998,0,9999,1
1714601860771,CAT 124RS,A01,519847,Geibel; William,0,0,20,20
1714601861795,CAT 125RS,A01,515971,Geibel; William,0,0,20,20
1714601862823,CLRE 250,A00,511389,Morris; Sheldon,9993,0,9999,6
1714601863855,CLRE 251,A00,507176,Mehta; Ravindra L.,9993,0,9999,6
1714601863855,CLRE 251,B00,511410,Mehta; Ravindra L.,9998,0,9999,1
1714601864881,CLRE 252,A00,507189,Cuomo; Raphael Eduardo,9995,0,9999,4
1714601865908,CLRE 253,A00,507199,Vaida; Florin,9994,0,9999,5
1714601865908,CLRE 253,B00,507202,Vaida; Florin,9999,0,9999,0
1714601866939,CLRE 259,A00,507211,Patel; Hemal,9996,0,9999,3
1714601867966,CLRE 260,A00,507221,Cuomo; Raphael Eduardo,9999,0,9999,0
1714601868994,CLRE 297,001,507242,Cuomo; Raphael Eduardo,9999,0,9999,0
1714601870022,COGS 197,001,638244,Voytek; Bradley Thomas,9998,0,9999,1
1714601871052,CSE 191,A00,516875,Minnes Kemp; Mor Mia,9993,0,9999,6
1714601872077,CSE 197,001,637388,Minnes Kemp; Mor Mia,9998,0,9999,1
1714601873106,CSS 201S,A01,494383,Staff,35,0,35,0
1714601874134,CSS 202S,A01,494387,Staff,35,0,35,0
1714601875165,DSC 197,001,628532,Eldridge; Justin Matthew,9996,0,9999,3
1714601876193,EAP 100,A00,516065,Staff,9797,0,9999,202
1714601877221,ECE 45,A01,507414,Staff,33,0,60,27
1714601879279,ECE 111,A01,507420,Staff,15,0,50,35
1714601880305,ECE 197,001,548057,Sievenpiper; Daniel F.,9993,0,9999,6
1714601881332,EDS 115,A00,507243,Choi; Bailey Miyeon,10,0,28,18
1714601882363,EDS 117,A01,494379,Staff,1,5,30,29
1714601883390,EDS 125,A00,507246,Hopkins; Megan Beth,9,0,30,21
1714601884414,EDS 128A,A01,507264,Fargason; Sharon Gayle,8,0,26,18
1714601885441,EDS 128B,A01,507293,Pappas; Elizabeth,12,0,30,18
1714601886465,EDS 139,A00,507294,Fargason; Sharon Gayle,13,0,30,17
1714601886465,EDS 139,B00,507313,Pappas; Elizabeth,13,0,30,17
1714601887543,EDS 201,A00,507315,Staff,13,0,30,17
1714601888572,EDS 203,A01,507317,Halter; Christopher P.,12,0,30,18
1714601889601,EDS 204R,A01,507319,Halter; Christopher P.,0,3,30,30
1714601889601,EDS 204R,B01,507331,Heinzman; Erica M.,16,0,30,14
1714601890627,EDS 206R,A00,507332,Staff,0,4,30,30
1714601890627,EDS 206R,B00,507343,Staff,17,0,30,13
1714601891653,EDS 250,A00,507344,Hemans; Patricia Ann Benitez,22,0,40,18
1714601892681,EDS 281,A00,507345,Daly; Alan J.,18,0,18,0
1714601893706,EDS 284,A00,507350,Daly; Alan J.,16,0,16,0
1714601894732,EDS 286,A00,507359,Fine; Sarah,18,0,18,0
1714601895759,EDS 289C,A01,507361,Daly; Alan J.,18,0,18,0
1714601896787,EDS 290,A00,507366,Hofstetter; Carolyn,15,0,15,0
1714601897812,LIGM 5A,A00,507421,Fischer-Grunski; Eva K,18,0,20,2
1714601898838,LIGM 5B,A00,507423,Fischer-Grunski; Eva K,19,0,20,1
1714601899862,LIGM 5C,A00,507425,Fischer-Grunski; Eva K,19,0,20,1
1714601900888,LIIT 5AS,A00,507427,Carnelos; Chiara,20,0,20,0
1714601901917,LIIT 5BS,A00,507430,Carnelos; Chiara,20,0,20,0
1714601902942,LIIT 5CS,A00,507432,Carnelos; Chiara,20,0,20,0
1714601903971,LISP 5A,A00,507541,Munoz Sanchez; Alicia,11,0,20,9
1714601904996,LISP 5B,A00,507671,Munoz Sanchez; Alicia,8,0,20,12
1714601906022,LISP 5C,A00,507696,Munoz Sanchez; Alicia,9,0,20,11
1714601907052,MAE 197,001,528363,Boechler; Nicholas Sebastia,9998,0,9999,1
1714601908078,MATH 197,001,523477,Kedlaya; Kiran S.,9995,0,9999,4
1714601908078,MATH 197,002,563811,Zhang; Danna,9995,0,9999,4
1714601908078,MATH 197,003,628552,Dumitriu; Ioana,9998,0,9999,1
1714601909103,MCWP 40R,A00,518780,Staff,2,0,20,18
1714601909103,MCWP 40R,B00,518781,Staff,8,0,20,12
1714601909103,MCWP 40R,C00,518783,Staff,6,0,20,14
1714601910132,MCWP 50R,A00,518791,Staff,0,0,20,20
1714601910132,MCWP 50R,B00,518792,Staff,0,2,20,20
1714601910132,MCWP 50R,C00,518793,Staff,0,2,20,20
1714601910132,MCWP 50R,D00,518794,Staff,0,0,20,20
1714601910132,MCWP 50R,E00,518795,Staff,0,2,20,20
1714601910132,MCWP 50R,F00,518796,Staff,0,0,20,20
1714601910132,MCWP 50R,G00,518797,Staff,0,1,20,20
1714601911160,MMW 12R,A01,514034,Herbst; Matthew,0,0,16,16
1714601911160,MMW 12R,A02,514035,Herbst; Matthew,1,0,16,15
1714601912184,MMW 13R,A01,514037,Staff,0,4,16,16
1714601912184,MMW 13R,A02,514039,Staff,0,2,16,16
1714601912184,MMW 13R,A03,628519,Staff,0,2,16,16
1714601914237,SIO 295LS,A00,523233,Staff,10,0,30,20
1714601915261,SIO 295S,A00,523232,Staff,10,0,30,20
1714601916296,SIOC 290S,A01,637330,Merrifield; Mark A,24,0,30,6
1714601917325,SIOC 291S,A01,637333,Gabriel; Corey John,24,0,30,6
1714601918351,SOCI 117,A01,494376,Staff,0,4,5,5
1714601919379,WES 237B,A00,494380,Staff,9,0,20,11
1714601921466,AESE 279B,A00,494370,Wade; Jon P,0,0,33,33
1714601922491,AIP 197,001,627712,Vespa; Emanuel Ignacio,9998,0,9999,1
1714601923516,ANAR 135S,A00,494369,Braswell; Geoffrey E.,0,0,0,0
1714601924546,BENG 196,001,628496,Engler; Adam J.,9998,0,9999,1
1714601925571,CAT 124RS,A01,519847,Geibel; William,0,0,20,20
1714601926596,CAT 125RS,A01,515971,Geibel; William,0,0,20,20
1714601927621,CLRE 250,A00,511389,Morris; Sheldon,9993,0,9999,6
1714601928648,CLRE 251,A00,507176,Mehta; Ravindra L.,9993,0,9999,6
1714601928648,CLRE 251,B00,511410,Mehta; Ravindra L.,9998,0,9999,1
1714601929674,CLRE 252,A00,507189,Cuomo; Raphael Eduardo,9995,0,9999,4
1714601930699,CLRE 253,A00,507199,Vaida; Florin,9994,0,9999,5
1714601930699,CLRE 253,B00,507202,Vaida; Florin,9999,0,9999,0
1714601931727,CLRE 259,A00,507211,Patel; Hemal,9996,0,9999,3
1714601932752,CLRE 260,A00,507221,Cuomo; Raphael Eduardo,9999,0,9999,0
1714601933776,CLRE 297,001,507242,Cuomo; Raphael Eduardo,9999,0,9999,0
1714601934807,COGS 197,001,638244,Voytek; Bradley Thomas,9998,0,9999,1
1714601935831,CSE 191,A00,516875,Minnes Kemp; Mor Mia,9993,0,9999,6
1714601936856,CSE 197,001,637388,Minnes Kemp; Mor Mia,9998,0,9999,1
1714601937887,CSS 201S,A01,494383,Staff,35,0,35,0
1714601938912,CSS 202S,A01,494387,Staff,35,0,35,0
1714601939942,DSC 197,001,628532,Eldridge; Justin Matthew,9996,0,9999,3
1714601940970,EAP 100,A00,516065,Staff,9797,0,9999,202
1714601941995,ECE 45,A01,507414,Staff,33,0,60,27
1714601944046,ECE 111,A01,507420,Staff,15,0,50,35
1714601945074,ECE 197,001,548057,Sievenpiper; Daniel F.,9993,0,9999,6
1714601946103,EDS 115,A00,507243,Choi; Bailey Miyeon,10,0,28,18
1714601947132,EDS 117,A01,494379,Staff,1,5,30,29
1714601948158,EDS 125,A00,507246,Hopkins; Megan Beth,9,0,30,21
1714601949188,EDS 128A,A01,507264,Fargason; Sharon Gayle,8,0,26,18
1714601950214,EDS 128B,A01,507293,Pappas; Elizabeth,12,0,30,18
1714601951240,EDS 139,A00,507294,Fargason; Sharon Gayle,13,0,30,17
1714601951240,EDS 139,B00,507313,Pappas; Elizabeth,13,0,30,17
1714601952265,EDS 201,A00,507315,Staff,13,0,30,17
1714601953290,EDS 203,A01,507317,Halter; Christopher P.,12,0,30,18
1714601954315,EDS 204R,A01,507319,Halter; Christopher P.,0,3,30,30
1714601954315,EDS 204R,B01,507331,Heinzman; Erica M.,16,0,30,14
1714601955342,EDS 206R,A00,507332,Staff,0,4,30,30
1714601955342,EDS 206R,B00,507343,Staff,17,0,30,13
1714601956366,EDS 250,A00,507344,Hemans; Patricia Ann Benitez,22,0,40,18
1714601957389,EDS 281,A00,507345,Daly; Alan J.,18,0,18,0
1714601958413,EDS 284,A00,507350,Daly; Alan J.,16,0,16,0
1714601959440,EDS 286,A00,507359,Fine; Sarah,18,0,18,0
1714601960463,EDS 289C,A01,507361,Daly; Alan J.,18,0,18,0
1714601961487,EDS 290,A00,507366,Hofstetter; Carolyn,15,0,15,0
1714601962511,LIGM 5A,A00,507421,Fischer-Grunski; Eva K,18,0,20,2
1714601963537,LIGM 5B,A00,507423,Fischer-Grunski; Eva K,19,0,20,1
1714601964565,LIGM 5C,A00,507425,Fischer-Grunski; Eva K,19,0,20,1
1714601965588,LIIT 5AS,A00,507427,Carnelos; Chiara,20,0,20,0
1714601966617,LIIT 5BS,A00,507430,Carnelos; Chiara,20,0,20,0
1714601967645,LIIT 5CS,A00,507432,Carnelos; Chiara,20,0,20,0
1714601968670,LISP 5A,A00,507541,Munoz Sanchez; Alicia,11,0,20,9
1714601969694,LISP 5B,A00,507671,Munoz Sanchez; Alicia,8,0,20,12
1714601970724,LISP 5C,A00,507696,Munoz Sanchez; Alicia,9,0,20,11
1714601971752,MAE 197,001,528363,Boechler; Nicholas Sebastia,9998,0,9999,1
1714601972782,MATH 197,001,523477,Kedlaya; Kiran S.,9995,0,9999,4
1714601972782,MATH 197,002,563811,Zhang; Danna,9995,0,9999,4
1714601972782,MATH 197,003,628552,Dumitriu; Ioana,9998,0,9999,1
1714601973808,MCWP 40R,A00,518780,Staff,2,0,20,18
1714601973808,MCWP 40R,B00,518781,Staff,8,0,20,12
1714601973808,MCWP 40R,C00,518783,Staff,6,0,20,14
1714601974833,MCWP 50R,A00,518791,Staff,0,0,20,20
1714601974833,MCWP 50R,B00,518792,Staff,0,2,20,20
1714601974833,MCWP 50R,C00,518793,Staff,0,2,20,20
1714601974833,MCWP 50R,D00,518794,Staff,0,0,20,20
1714601974833,MCWP 50R,E00,518795,Staff,0,2,20,20
1714601974833,MCWP 50R,F00,518796,Staff,0,0,20,20
1714601974833,MCWP 50R,G00,518797,Staff,0,1,20,20
1714601975861,MMW 12R,A01,514034,Herbst; Matthew,0,0,16,16
1714601975861,MMW 12R,A02,514035,Herbst; Matthew,1,0,16,15
1714601976889,MMW 13R,A01,514037,Staff,0,4,16,16
1714601976889,MMW 13R,A02,514039,Staff,0,2,16,16
1714601976889,MMW 13R,A03,628519,Staff,0,2,16,16
1714601978942,SIO 295LS,A00,523233,Staff,10,0,30,20
1714601979967,SIO 295S,A00,523232,Staff,10,0,30,20
1714601980994,SIOC 290S,A01,637330,Merrifield; Mark A,24,0,30,6
1714601982020,SIOC 291S,A01,637333,Gabriel; Corey John,24,0,30,6
1714601983045,SOCI 117,A01,494376,Staff,0,4,5,5
1714601984074,WES 237B,A00,494380,Staff,9,0,20,11
1714601986160,AESE 279B,A00,494370,Wade; Jon P,0,0,33,33
1714601987191,AIP 197,001,627712,Vespa; Emanuel Ignacio,9998,0,9999,1
1714601988218,ANAR 135S,A00,494369,Braswell; Geoffrey E.,0,0,0,0
1714601989244,BENG 196,001,628496,Engler; Adam J.,9998,0,9999,1
1714601990271,CAT 124RS,A01,519847,Geibel; William,0,0,20,20
1714601991353,CAT 125RS,A01,515971,Geibel; William,0,0,20,20
1714601992378,CLRE 250,A00,511389,Morris; Sheldon,9993,0,9999,6
1714601993410,CLRE 251,A00,507176,Mehta; Ravindra L.,9993,0,9999,6
1714601993410,CLRE 251,B00,511410,Mehta; Ravindra L.,9998,0,9999,1
1714601994434,CLRE 252,A00,507189,Cuomo; Raphael Eduardo,9995,0,9999,4
1714601995460,CLRE 253,A00,507199,Vaida; Florin,9994,0,9999,5
1714601995460,CLRE 253,B00,507202,Vaida; Florin,9999,0,9999,0
1714601996484,CLRE 259,A00,507211,Patel; Hemal,9996,0,9999,3
1714601997509,CLRE 260,A00,507221,Cuomo; Raphael Eduardo,9999,0,9999,0
1714601998532,CLRE 297,001,507242,Cuomo; Raphael Eduardo,9999,0,9999,0
1714601999558,COGS 197,001,638244,Voytek; Bradley Thomas,9998,0,9999,1
1714602000586,CSE 191,A00,516875,Minnes Kemp; Mor Mia,9993,0,9999,6
1714602001613,CSE 197,001,637388,Minnes Kemp; Mor Mia,9998,0,9999,1
1714602002644,CSS 201S,A01,494383,Staff,35,0,35,0
1714602003675,CSS 202S,A01,494387,Staff,35,0,35,0
1714602004699,DSC 197,001,628532,Eldridge; Justin Matthew,9996,0,9999,3
1714602005725,EAP 100,A00,516065,Staff,9797,0,9999,202
1714602006749,ECE 45,A01,507414,Staff,33,0,60,27
1714602008803,ECE 111,A01,507420,Staff,15,0,50,35
1714602009827,ECE 197,001,548057,Sievenpiper; Daniel F.,9993,0,9999,6
1714602010857,EDS 115,A00,507243,Choi; Bailey Miyeon,10,0,28,18
1714602011884,EDS 117,A01,494379,Staff,1,5,30,29
1714602012913,EDS 125,A00,507246,Hopkins; Megan Beth,9,0,30,21
1714602013943,EDS 128A,A01,507264,Fargason; Sharon Gayle,8,0,26,18
1714602014968,EDS 128B,A01,507293,Pappas; Elizabeth,12,0,30,18
1714602015995,EDS 139,A00,507294,Fargason; Sharon Gayle,13,0,30,17
1714602015995,EDS 139,B00,507313,Pappas; Elizabeth,13,0,30,17
1714602017023,EDS 201,A00,507315,Staff,13,0,30,17
1714602018050,EDS 203,A01,507317,Halter; Christopher P.,12,0,30,18
1714602019078,EDS 204R,A01,507319,Halter; Christopher P.,0,3,30,30
1714602019078,EDS 204R,B01,507331,Heinzman; Erica M.,16,0,30,14
1714602020101,EDS 206R,A00,507332,Staff,0,4,30,30
1714602020101,EDS 206R,B00,507343,Staff,17,0,30,13
1714602021126,EDS 250,A00,507344,Hemans; Patricia Ann Benitez,22,0,40,18
1714602022155,EDS 281,A00,507345,Daly; Alan J.,18,0,18,0
1714602023179,EDS 284,A00,507350,Daly; Alan J.,16,0,16,0
1714602024205,EDS 286,A00,507359,Fine; Sarah,18,0,18,0
1714602025232,EDS 289C,A01,507361,Daly; Alan J.,18,0,18,0
1714602026260,EDS 290,A00,507366,Hofstetter; Carolyn,15,0,15,0
1714602027286,LIGM 5A,A00,507421,Fischer-Grunski; Eva K,18,0,20,2
1714602028315,LIGM 5B,A00,507423,Fischer-Grunski; Eva K,19,0,20,1
1714602029341,LIGM 5C,A00,507425,Fischer-Grunski; Eva K,19,0,20,1
1714602030367,LIIT 5AS,A00,507427,Carnelos; Chiara,20,0,20,0
1714602031396,LIIT 5BS,A00,507430,Carnelos; Chiara,20,0,20,0
1714602032421,LIIT 5CS,A00,507432,Carnelos; Chiara,20,0,20,0
1714602033454,LISP 5A,A00,507541,Munoz Sanchez; Alicia,11,0,20,9
1714602034479,LISP 5B,A00,507671,Munoz Sanchez; Alicia,8,0,20,12
1714602035509,LISP 5C,A00,507696,Munoz Sanchez; Alicia,9,0,20,11
1714602036536,MAE 197,001,528363,Boechler; Nicholas Sebastia,9998,0,9999,1
1714602037562,MATH 197,001,523477,Kedlaya; Kiran S.,9995,0,9999,4
1714602037562,MATH 197,002,563811,Zhang; Danna,9995,0,9999,4
1714602037562,MATH 197,003,628552,Dumitriu; Ioana,9998,0,9999,1
1714602038592,MCWP 40R,A00,518780,Staff,2,0,20,18
1714602038592,MCWP 40R,B00,518781,Staff,8,0,20,12
1714602038592,MCWP 40R,C00,518783,Staff,6,0,20,14
1714602039619,MCWP 50R,A00,518791,Staff,0,0,20,20
1714602039619,MCWP 50R,B00,518792,Staff,0,2,20,20
1714602039619,MCWP 50R,C00,518793,Staff,0,2,20,20
1714602039619,MCWP 50R,D00,518794,Staff,0,0,20,20
1714602039619,MCWP 50R,E00,518795,Staff,0,2,20,20
1714602039619,MCWP 50R,F00,518796,Staff,0,0,20,20
1714602039619,MCWP 50R,G00,518797,Staff,0,1,20,20
1714602040646,MMW 12R,A01,514034,Herbst; Matthew,0,0,16,16
1714602040646,MMW 12R,A02,514035,Herbst; Matthew,1,0,16,15
1714602041670,MMW 13R,A01,514037,Staff,0,4,16,16
1714602041670,MMW 13R,A02,514039,Staff,0,2,16,16
1714602041670,MMW 13R,A03,628519,Staff,0,2,16,16
1714602043720,SIO 295LS,A00,523233,Staff,10,0,30,20
1714602044744,SIO 295S,A00,523232,Staff,10,0,30,20
1714602045769,SIOC 290S,A01,637330,Merrifield; Mark A,24,0,30,6
1714602046802,SIOC 291S,A01,637333,Gabriel; Corey John,24,0,30,6
1714602047829,SOCI 117,A01,494376,Staff,0,4,5,5
1714602048856,WES 237B,A00,494380,Staff,9,0,20,11
1714602050938,AESE 279B,A00,494370,Wade; Jon P,0,0,33,33
1714602051965,AIP 197,001,627712,Vespa; Emanuel Ignacio,9998,0,9999,1
1714602052991,ANAR 135S,A00,494369,Braswell; Geoffrey E.,0,0,0,0
1714602054020,BENG 196,001,628496,Engler; Adam J.,9998,0,9999,1
1714602055049,CAT 124RS,A01,519847,Geibel; William,0,0,20,20
1714602056074,CAT 125RS,A01,515971,Geibel; William,0,0,20,20
1714602057103,CLRE 250,A00,511389,Morris; Sheldon,9993,0,9999,6
1714602058129,CLRE 251,A00,507176,Mehta; Ravindra L.,9993,0,9999,6
1714602058129,CLRE 251,B00,511410,Mehta; Ravindra L.,9998,0,9999,1
1714602059153,CLRE 252,A00,507189,Cuomo; Raphael Eduardo,9995,0,9999,4
1714602060181,CLRE 253,A00,507199,Vaida; Florin,9994,0,9999,5
1714602060181,CLRE 253,B00,507202,Vaida; Florin,9999,0,9999,0
1714602061205,CLRE 259,A00,507211,Patel; Hemal,9996,0,9999,3
1714602062230,CLRE 260,A00,507221,Cuomo; Raphael Eduardo,9999,0,9999,0
1714602063254,CLRE 297,001,507242,Cuomo; Raphael Eduardo,9999,0,9999,0
1714602064281,COGS 197,001,638244,Voytek; Bradley Thomas,9998,0,9999,1
1714602065312,CSE 191,A00,516875,Minnes Kemp; Mor Mia,9993,0,9999,6
1714602066342,CSE 197,001,637388,Minnes Kemp; Mor Mia,9998,0,9999,1
1714602067370,CSS 201S,A01,494383,Staff,35,0,35,0
1714602068395,CSS 202S,A01,494387,Staff,35,0,35,0
1714602069422,DSC 197,001,628532,Eldridge; Justin Matthew,9996,0,9999,3
1714602070446,EAP 100,A00,516065,Staff,9797,0,9999,202
1714602071474,ECE 45,A01,507414,Staff,33,0,60,27
1714602073525,ECE 111,A01,507420,Staff,15,0,50,35
1714602074550,ECE 197,001,548057,Sievenpiper; Daniel F.,9993,0,9999,6
1714602075576,EDS 115,A00,507243,Choi; Bailey Miyeon,10,0,28,18
1714602076604,EDS 117,A01,494379,Staff,1,5,30,29
1714602077629,EDS 125,A00,507246,Hopkins; Megan Beth,9,0,30,21
1714602078655,EDS 128A,A01,507264,Fargason; Sharon Gayle,8,0,26,18
1714602079683,EDS 128B,A01,507293,Pappas; Elizabeth,12,0,30,18
1714602080712,EDS 139,A00,507294,Fargason; Sharon Gayle,13,0,30,17
1714602080712,EDS 139,B00,507313,Pappas; Elizabeth,13,0,30,17
1714602081739,EDS 201,A00,507315,Staff,13,0,30,17
1714602082766,EDS 203,A01,507317,Halter; Christopher P.,12,0,30,18
1714602083795,EDS 204R,A01,507319,Halter; Christopher P.,0,3,30,30
1714602083795,EDS 204R,B01,507331,Heinzman; Erica M.,16,0,30,14
1714602084820,EDS 206R,A00,507332,Staff,0,4,30,30
1714602084820,EDS 206R,B00,507343,Staff,17,0,30,13
1714602085847,EDS 250,A00,507344,Hemans; Patricia Ann Benitez,22,0,40,18
1714602086873,EDS 281,A00,507345,Daly; Alan J.,18,0,18,0
1714602087896,EDS 284,A00,507350,Daly; Alan J.,16,0,16,0
1714602088923,EDS 286,A00,507359,Fine; Sarah,18,0,18,0
1714602089950,EDS 289C,A01,507361,Daly; Alan J.,18,0,18,0
1714602090978,EDS 290,A00,507366,Hofstetter; Carolyn,15,0,15,0
1714602092003,LIGM 5A,A00,507421,Fischer-Grunski; Eva K,18,0,20,2
1714602093030,LIGM 5B,A00,507423,Fischer-Grunski; Eva K,19,0,20,1
1714602094054,LIGM 5C,A00,507425,Fischer-Grunski; Eva K,19,0,20,1
1714602095133,LIIT 5AS,A00,507427,Carnelos; Chiara,20,0,20,0
1714602096156,LIIT 5BS,A00,507430,Carnelos; Chiara,20,0,20,0
1714602097181,LIIT 5CS,A00,507432,Carnelos; Chiara,20,0,20,0
1714602098211,LISP 5A,A00,507541,Munoz Sanchez; Alicia,11,0,20,9
1714602099239,LISP 5B,A00,507671,Munoz Sanchez; Alicia,8,0,20,12
1714602100270,LISP 5C,A00,507696,Munoz Sanchez; Alicia,9,0,20,11
1714602101299,MAE 197,001,528363,Boechler; Nicholas Sebastia,9998,0,9999,1
1714602102331,MATH 197,001,523477,Kedlaya; Kiran S.,9995,0,9999,4
1714602102331,MATH 197,002,563811,Zhang; Danna,9995,0,9999,4
1714602102331,MATH 197,003,628552,Dumitriu; Ioana,9998,0,9999,1
1714602103359,MCWP 40R,A00,518780,Staff,2,0,20,18
1714602103359,MCWP 40R,B00,518781,Staff,8,0,20,12
1714602103359,MCWP 40R,C00,518783,Staff,6,0,20,14
1714602104384,MCWP 50R,A00,518791,Staff,0,0,20,20
1714602104384,MCWP 50R,B00,518792,Staff,0,2,20,20
1714602104384,MCWP 50R,C00,518793,Staff,0,2,20,20
1714602104384,MCWP 50R,D00,518794,Staff,0,0,20,20
1714602104384,MCWP 50R,E00,518795,Staff,0,2,20,20
1714602104384,MCWP 50R,F00,518796,Staff,0,0,20,20
1714602104384,MCWP 50R,G00,518797,Staff,0,1,20,20
1714602105409,MMW 12R,A01,514034,Herbst; Matthew,0,0,16,16
1714602105409,MMW 12R,A02,514035,Herbst; Matthew,1,0,16,15
1714602106437,MMW 13R,A01,514037,Staff,0,4,16,16
1714602106437,MMW 13R,A02,514039,Staff,0,2,16,16
1714602106437,MMW 13R,A03,628519,Staff,0,2,16,16
1714602108487,SIO 295LS,A00,523233,Staff,10,0,30,20
1714602109512,SIO 295S,A00,523232,Staff,10,0,30,20
1714602110539,SIOC 290S,A01,637330,Merrifield; Mark A,24,0,30,6
1714602111565,SIOC 291S,A01,637333,Gabriel; Corey John,24,0,30,6
1714602112589,SOCI 117,A01,494376,Staff,0,4,5,5
1714602113614,WES 237B,A00,494380,Staff,9,0,20,11
1714602115687,AESE 279B,A00,494370,Wade; Jon P,0,0,33,33
1714602116713,AIP 197,001,627712,Vespa; Emanuel Ignacio,9998,0,9999,1
1714602117737,ANAR 135S,A00,494369,Braswell; Geoffrey E.,0,0,0,0
1714602118766,BENG 196,001,628496,Engler; Adam J.,9998,0,9999,1
1714602119796,CAT 124RS,A01,519847,Geibel; William,0,0,20,20
1714602120821,CAT 125RS,A01,515971,Geibel; William,0,0,20,20
1714602121851,CLRE 250,A00,511389,Morris; Sheldon,9993,0,9999,6
1714602122885,CLRE 251,A00,507176,Mehta; Ravindra L.,9993,0,9999,6
1714602122885,CLRE 251,B00,511410,Mehta; Ravindra L.,9998,0,9999,1
1714602123911,CLRE 252,A00,507189,Cuomo; Raphael Eduardo,9995,0,9999,4
1714602124943,CLRE 253,A00,507199,Vaida; Florin,9994,0,9999,5
1714602124943,CLRE 253,B00,507202,Vaida; Florin,9999,0,9999,0
1714602125968,CLRE 259,A00,507211,Patel; Hemal,9996,0,9999,3
1714602126993,CLRE 260,A00,507221,Cuomo; Raphael Eduardo,9999,0,9999,0
1714602128020,CLRE 297,001,507242,Cuomo; Raphael Eduardo,9999,0,9999,0
1714602129045,COGS 197,001,638244,Voytek; Bradley Thomas,9998,0,9999,1
1714602130070,CSE 191,A00,516875,Minnes Kemp; Mor Mia,9993,0,9999,6
1714602131097,CSE 197,001,637388,Minnes Kemp; Mor Mia,9998,0,9999,1
1714602132122,CSS 201S,A01,494383,Staff,35,0,35,0
1714602133147,CSS 202S,A01,494387,Staff,35,0,35,0
1714602134171,DSC 197,001,628532,Eldridge; Justin Matthew,9996,0,9999,3
1714602135199,EAP 100,A00,516065,Staff,9797,0,9999,202
1714602136226,ECE 45,A01,507414,Staff,33,0,60,27
1714602138277,ECE 111,A01,507420,Staff,15,0,50,35
1714602139302,ECE 197,001,548057,Sievenpiper; Daniel F.,9993,0,9999,6
1714602140334,EDS 115,A00,507243,Choi; Bailey Miyeon,10,0,28,18
1714602141359,EDS 117,A01,494379,Staff,1,5,30,29
1714602142386,EDS 125,A00,507246,Hopkins; Megan Beth,9,0,30,21
1714602143414,EDS 128A,A01,507264,Fargason; Sharon Gayle,8,0,26,18
1714602144439,EDS 128B,A01,507293,Pappas; Elizabeth,12,0,30,18
1714602145466,EDS 139,A00,507294,Fargason; Sharon Gayle,13,0,30,17
1714602145466,EDS 139,B00,507313,Pappas; Elizabeth,13,0,30,17
1714602146491,EDS 201,A00,507315,Staff,13,0,30,17
1714602147516,EDS 203,A01,507317,Halter; Christopher P.,12,0,30,18
1714602148541,EDS 204R,A01,507319,Halter; Christopher P.,0,3,30,30
1714602148541,EDS 204R,B01,507331,Heinzman; Erica M.,16,0,30,14
1714602149568,EDS 206R,A00,507332,Staff,0,4,30,30
1714602149568,EDS 206R,B00,507343,Staff,17,0,30,13
1714602150593,EDS 250,A00,507344,Hemans; Patricia Ann Benitez,22,0,40,18
1714602151620,EDS 281,A00,507345,Daly; Alan J.,18,0,18,0
1714602152645,EDS 284,A00,507350,Daly; Alan J.,16,0,16,0
1714602153673,EDS 286,A00,507359,Fine; Sarah,18,0,18,0
1714602154700,EDS 289C,A01,507361,Daly; Alan J.,18,0,18,0
1714602155728,EDS 290,A00,507366,Hofstetter; Carolyn,15,0,15,0
1714602156753,LIGM 5A,A00,507421,Fischer-Grunski; Eva K,18,0,20,2
1714602157778,LIGM 5B,A00,507423,Fischer-Grunski; Eva K,19,0,20,1
1714602158804,LIGM 5C,A00,507425,Fischer-Grunski; Eva K,19,0,20,1
1714602159829,LIIT 5AS,A00,507427,Carnelos; Chiara,20,0,20,0
1714602160857,LIIT 5BS,A00,507430,Carnelos; Chiara,20,0,20,0
1714602161885,LIIT 5CS,A00,507432,Carnelos; Chiara,20,0,20,0
1714602162912,LISP 5A,A00,507541,Munoz Sanchez; Alicia,11,0,20,9
1714602163939,LISP 5B,A00,507671,Munoz Sanchez; Alicia,8,0,20,12
1714602164964,LISP 5C,A00,507696,Munoz Sanchez; Alicia,9,0,20,11
1714602165993,MAE 197,001,528363,Boechler; Nicholas Sebastia,9998,0,9999,1
1714602167022,MATH 197,001,523477,Kedlaya; Kiran S.,9995,0,9999,4
1714602167022,MATH 197,002,563811,Zhang; Danna,9995,0,9999,4
1714602167022,MATH 197,003,628552,Dumitriu; Ioana,9998,0,9999,1
1714602168050,MCWP 40R,A00,518780,Staff,2,0,20,18
1714602168050,MCWP 40R,B00,518781,Staff,8,0,20,12
1714602168050,MCWP 40R,C00,518783,Staff,6,0,20,14
1714602169076,MCWP 50R,A00,518791,Staff,0,0,20,20
1714602169076,MCWP 50R,B00,518792,Staff,0,2,20,20
1714602169076,MCWP 50R,C00,518793,Staff,0,2,20,20
1714602169076,MCWP 50R,D00,518794,Staff,0,0,20,20
1714602169076,MCWP 50R,E00,518795,Staff,0,2,20,20
1714602169076,MCWP 50R,F00,518796,Staff,0,0,20,20
1714602169076,MCWP 50R,G00,518797,Staff,0,1,20,20
1714602170104,MMW 12R,A01,514034,Herbst; Matthew,0,0,16,16
1714602170104,MMW 12R,A02,514035,Herbst; Matthew,1,0,16,15
1714602171130,MMW 13R,A01,514037,Staff,0,4,16,16
1714602171130,MMW 13R,A02,514039,Staff,0,2,16,16
1714602171130,MMW 13R,A03,628519,Staff,0,2,16,16
1714602173181,SIO 295LS,A00,523233,Staff,10,0,30,20
1714602174205,SIO 295S,A00,523232,Staff,10,0,30,20
1714602175233,SIOC 290S,A01,637330,Merrifield; Mark A,24,0,30,6
1714602176262,SIOC 291S,A01,637333,Gabriel; Corey John,24,0,30,6
1714602177291,SOCI 117,A01,494376,Staff,0,4,5,5
1714602178315,WES 237B,A00,494380,Staff,9,0,20,11
1714602180387,AESE 279B,A00,494370,Wade; Jon P,0,0,33,33
1714602181416,AIP 197,001,627712,Vespa; Emanuel Ignacio,9998,0,9999,1
1714602182444,ANAR 135S,A00,494369,Braswell; Geoffrey E.,0,0,0,0
1714602183469,BENG 196,001,628496,Engler; Adam J.,9998,0,9999,1
1714602184495,CAT 124RS,A01,519847,Geibel; William,0,0,20,20
1714602185523,CAT 125RS,A01,515971,Geibel; William,0,0,20,20
1714602186547,CLRE 250,A00,511389,Morris; Sheldon,9993,0,9999,6
1714602187576,CLRE 251,A00,507176,Mehta; Ravindra L.,9993,0,9999,6
1714602187576,CLRE 251,B00,511410,Mehta; Ravindra L.,9998,0,9999,1
1714602188603,CLRE 252,A00,507189,Cuomo; Raphael Eduardo,9995,0,9999,4
1714602189629,CLRE 253,A00,507199,Vaida; Florin,9994,0,9999,5
1714602189629,CLRE 253,B00,507202,Vaida; Florin,9999,0,9999,0
1714602190658,CLRE 259,A00,507211,Patel; Hemal,9996,0,9999,3
1714602191685,CLRE 260,A00,507221,Cuomo; Raphael Eduardo,9999,0,9999,0
1714602192710,CLRE 297,001,507242,Cuomo; Raphael Eduardo,9999,0,9999,0
1714602193737,COGS 197,001,638244,Voytek; Bradley Thomas,9998,0,9999,1
1714602194762,CSE 191,A00,516875,Minnes Kemp; Mor Mia,9993,0,9999,6
1714602195790,CSE 197,001,637388,Minnes Kemp; Mor Mia,9998,0,9999,1
1714602196815,CSS 201S,A01,494383,Staff,35,0,35,0
1714602197841,CSS 202S,A01,494387,Staff,35,0,35,0
1714602198919,DSC 197,001,628532,Eldridge; Justin Matthew,9996,0,9999,3
1714602199946,EAP 100,A00,516065,Staff,9797,0,9999,202
1714602200975,ECE 45,A01,507414,Staff,33,0,60,27
1714602203029,ECE 111,A01,507420,Staff,15,0,50,35
1714602204053,ECE 197,001,548057,Sievenpiper; Daniel F.,9993,0,9999,6
1714602205080,EDS 115,A00,507243,Choi; Bailey Miyeon,10,0,28,18
1714602206111,EDS 117,A01,494379,Staff,1,5,30,29
1714602207136,EDS 125,A00,507246,Hopkins; Megan Beth,9,0,30,21
1714602208161,EDS 128A,A01,507264,Fargason; Sharon Gayle,8,0,26,18
1714602209191,EDS 128B,A01,507293,Pappas; Elizabeth,12,0,30,18
1714602210216,EDS 139,A00,507294,Fargason; Sharon Gayle,13,0,30,17
1714602210216,EDS 139,B00,507313,Pappas; Elizabeth,13,0,30,17
1714602211242,EDS 201,A00,507315,Staff,13,0,30,17
1714602212271,EDS 203,A01,507317,Halter; Christopher P.,12,0,30,18
1714602213301,EDS 204R,A01,507319,Halter; Christopher P.,0,3,30,30
1714602213301,EDS 204R,B01,507331,Heinzman; Erica M.,16,0,30,14
1714602214325,EDS 206R,A00,507332,Staff,0,4,30,30
1714602214325,EDS 206R,B00,507343,Staff,17,0,30,13
1714602215351,EDS 250,A00,507344,Hemans; Patricia Ann Benitez,22,0,40,18
1714602216376,EDS 281,A00,507345,Daly; Alan J.,18,0,18,0
1714602217400,EDS 284,A00,507350,Daly; Alan J.,16,0,16,0
1714602218430,EDS 286,A00,507359,Fine; Sarah,18,0,18,0
1714602219458,EDS 289C,A01,507361,Daly; Alan J.,18,0,18,0
1714602220482,EDS 290,A00,507366,Hofstetter; Carolyn,15,0,15,0
1714602221514,LIGM 5A,A00,507421,Fischer-Grunski; Eva K,18,0,20,2
1714602222541,LIGM 5B,A00,507423,Fischer-Grunski; Eva K,19,0,20,1
1714602223566,LIGM 5C,A00,507425,Fischer-Grunski; Eva K,19,0,20,1
1714602224596,LIIT 5AS,A00,507427,Carnelos; Chiara,20,0,20,0
1714602225622,LIIT 5BS,A00,507430,Carnelos; Chiara,20,0,20,0
1714602226651,LIIT 5CS,A00,507432,Carnelos; Chiara,20,0,20,0
1714602227677,LISP 5A,A00,507541,Munoz Sanchez; Alicia,11,0,20,9
1714602228702,LISP 5B,A00,507671,Munoz Sanchez; Alicia,8,0,20,12
1714602229727,LISP 5C,A00,507696,Munoz Sanchez; Alicia,9,0,20,11
1714602230755,MAE 197,001,528363,Boechler; Nicholas Sebastia,9998,0,9999,1
1714602231782,MATH 197,001,523477,Kedlaya; Kiran S.,9995,0,9999,4
1714602231782,MATH 197,002,563811,Zhang; Danna,9995,0,9999,4
1714602231782,MATH 197,003,628552,Dumitriu; Ioana,9998,0,9999,1
1714602232806,MCWP 40R,A00,518780,Staff,2,0,20,18
1714602232806,MCWP 40R,B00,518781,Staff,8,0,20,12
1714602232806,MCWP 40R,C00,518783,Staff,6,0,20,14
1714602233838,MCWP 50R,A00,518791,Staff,0,0,20,20
1714602233838,MCWP 50R,B00,518792,Staff,0,2,20,20
1714602233838,MCWP 50R,C00,518793,Staff,0,2,20,20
1714602233838,MCWP 50R,D00,518794,Staff,0,0,20,20
1714602233838,MCWP 50R,E00,518795,Staff,0,2,20,20
1714602233838,MCWP 50R,F00,518796,Staff,0,0,20,20
1714602233838,MCWP 50R,G00,518797,Staff,0,1,20,20
1714602234866,MMW 12R,A01,514034,Herbst; Matthew,0,0,16,16
1714602234866,MMW 12R,A02,514035,Herbst; Matthew,1,0,16,15
1714602235890,MMW 13R,A01,514037,Staff,0,4,16,16
1714602235890,MMW 13R,A02,514039,Staff,0,2,16,16
1714602235890,MMW 13R,A03,628519,Staff,0,2,16,16
1714602237950,SIO 295LS,A00,523233,Staff,10,0,30,20
1714602238978,SIO 295S,A00,523232,Staff,10,0,30,20
1714602240006,SIOC 290S,A01,637330,Merrifield; Mark A,24,0,30,6
1714602241033,SIOC 291S,A01,637333,Gabriel; Corey John,24,0,30,6
1714602242064,SOCI 117,A01,494376,Staff,0,4,5,5
1714602243090,WES 237B,A00,494380,Staff,9,0,20,11
1714602245173,AESE 279B,A00,494370,Wade; Jon P,0,0,33,33
1714602246200,AIP 197,001,627712,Vespa; Emanuel Ignacio,9998,0,9999,1
1714602247232,ANAR 135S,A00,494369,Braswell; Geoffrey E.,0,0,0,0
1714602248255,BENG 196,001,628496,Engler; Adam J.,9998,0,9999,1
1714602249281,CAT 124RS,A01,519847,Geibel; William,0,0,20,20
1714602250311,CAT 125RS,A01,515971,Geibel; William,0,0,20,20
1714602251342,CLRE 250,A00,511389,Morris; Sheldon,9993,0,9999,6
1714602252370,CLRE 251,A00,507176,Mehta; Ravindra L.,9993,0,9999,6
1714602252370,CLRE 251,B00,511410,Mehta; Ravindra L.,9998,0,9999,1
1714602253399,CLRE 252,A00,507189,Cuomo; Raphael Eduardo,9995,0,9999,4
1714602254426,CLRE 253,A00,507199,Vaida; Florin,9994,0,9999,5
1714602254426,CLRE 253,B00,507202,Vaida; Florin,9999,0,9999,0
1714602255452,CLRE 259,A00,507211,Patel; Hemal,9996,0,9999,3
1714602256481,CLRE 260,A00,507221,Cuomo; Raphael Eduardo,9999,0,9999,0
1714602257506,CLRE 297,001,507242,Cuomo; Raphael Eduardo,9999,0,9999,0
1714602258537,COGS 197,001,638244,Voytek; Bradley Thomas,9998,0,9999,1
1714602259562,CSE 191,A00,516875,Minnes Kemp; Mor Mia,9993,0,9999,6
1714602260590,CSE 197,001,637388,Minnes Kemp; Mor Mia,9998,0,9999,1
1714602261616,CSS 201S,A01,494383,Staff,35,0,35,0
1714602262645,CSS 202S,A01,494387,Staff,35,0,35,0
1714602263673,DSC 197,001,628532,Eldridge; Justin Matthew,9996,0,9999,3
1714602264698,EAP 100,A00,516065,Staff,9797,0,9999,202
1714602265727,ECE 45,A01,507414,Staff,33,0,60,27
1714602267779,ECE 111,A01,507420,Staff,15,0,50,35
1714602268806,ECE 197,001,548057,Sievenpiper; Daniel F.,9993,0,9999,6
1714602269832,EDS 115,A00,507243,Choi; Bailey Miyeon,10,0,28,18
1714602270858,EDS 117,A01,494379,Staff,1,5,30,29
1714602271883,EDS 125,A00,507246,Hopkins; Megan Beth,9,0,30,21
1714602272908,EDS 128A,A01,507264,Fargason; Sharon Gayle,8,0,26,18
1714602273938,EDS 128B,A01,507293,Pappas; Elizabeth,12,0,30,18
1714602274963,EDS 139,A00,507294,Fargason; Sharon Gayle,13,0,30,17
1714602274963,EDS 139,B00,507313,Pappas; Elizabeth,13,0,30,17
1714602275987,EDS 201,A00,507315,Staff,13,0,30,17
1714602277015,EDS 203,A01,507317,Halter; Christopher P.,12,0,30,18
1714602278044,EDS 204R,A01,507319,Halter; Christopher P.,0,3,30,30
1714602278044,EDS 204R,B01,507331,Heinzman; Erica M.,16,0,30,14
1714602279069,EDS 206R,A00,507332,Staff,0,4,30,30
1714602279069,EDS 206R,B00,507343,Staff,17,0,30,13
1714602280097,EDS 250,A00,507344,Hemans; Patricia Ann Benitez,22,0,40,18
1714602281124,EDS 281,A00,507345,Daly; Alan J.,18,0,18,0
1714602282150,EDS 284,A00,507350,Daly; Alan J.,16,0,16,0
1714602283177,EDS 286,A00,507359,Fine; Sarah,18,0,18,0
1714602284206,EDS 289C,A01,507361,Daly; Alan J.,18,0,18,0
1714602285235,EDS 290,A00,507366,Hofstetter; Carolyn,15,0,15,0
1714602286264,LIGM 5A,A00,507421,Fischer-Grunski; Eva K,18,0,20,2
1714602287289,LIGM 5B,A00,507423,Fischer-Grunski; Eva K,19,0,20,1
1714602288313,LIGM 5C,A00,507425,Fischer-Grunski; Eva K,19,0,20,1
1714602289349,LIIT 5AS,A00,507427,Carnelos; Chiara,20,0,20,0
1714602290378,LIIT 5BS,A00,507430,Carnelos; Chiara,20,0,20,0
1714602291404,LIIT 5CS,A00,507432,Carnelos; Chiara,20,0,20,0
1714602292430,LISP 5A,A00,507541,Munoz Sanchez; Alicia,11,0,20,9
1714602293458,LISP 5B,A00,507671,Munoz Sanchez; Alicia,8,0,20,12
1714602294482,LISP 5C,A00,507696,Munoz Sanchez; Alicia,9,0,20,11
1714602295506,MAE 197,001,528363,Boechler; Nicholas Sebastia,9998,0,9999,1
1714602296532,MATH 197,001,523477,Kedlaya; Kiran S.,9995,0,9999,4
1714602296532,MATH 197,002,563811,Zhang; Danna,9995,0,9999,4
1714602296532,MATH 197,003,628552,Dumitriu; Ioana,9998,0,9999,1
1714602297561,MCWP 40R,A00,518780,Staff,2,0,20,18
1714602297561,MCWP 40R,B00,518781,Staff,8,0,20,12
1714602297561,MCWP 40R,C00,518783,Staff,6,0,20,14
1714602298590,MCWP 50R,A00,518791,Staff,0,0,20,20
1714602298590,MCWP 50R,B00,518792,Staff,0,2,20,20
1714602298590,MCWP 50R,C00,518793,Staff,0,2,20,20
1714602298590,MCWP 50R,D00,518794,Staff,0,0,20,20
1714602298590,MCWP 50R,E00,518795,Staff,0,2,20,20
1714602298590,MCWP 50R,F00,518796,Staff,0,0,20,20
1714602298590,MCWP 50R,G00,518797,Staff,0,1,20,20
1714602299617,MMW 12R,A01,514034,Herbst; Matthew,0,0,16,16
1714602299617,MMW 12R,A02,514035,Herbst; Matthew,1,0,16,15
1714602300642,MMW 13R,A01,514037,Staff,0,4,16,16
1714602300642,MMW 13R,A02,514039,Staff,0,2,16,16
1714602300642,MMW 13R,A03,628519,Staff,0,2,16,16
1714602302754,SIO 295LS,A00,523233,Staff,10,0,30,20
1714602303777,SIO 295S,A00,523232,Staff,10,0,30,20
1714602304804,SIOC 290S,A01,637330,Merrifield; Mark A,24,0,30,6
1714602305928,SIOC 291S,A01,637333,Gabriel; Corey John,24,0,30,6
1714602306956,SOCI 117,A01,494376,Staff,0,4,5,5
1714602307983,WES 237B,A00,494380,Staff,9,0,20,11
1714602310056,AESE 279B,A00,494370,Wade; Jon P,0,0,33,33
1714602311084,AIP 197,001,627712,Vespa; Emanuel Ignacio,9998,0,9999,1
1714602312111,ANAR 135S,A00,494369,Braswell; Geoffrey E.,0,0,0,0
1714602313138,BENG 196,001,628496,Engler; Adam J.,9998,0,9999,1
1714602314168,CAT 124RS,A01,519847,Geibel; William,0,0,20,20
1714602315196,CAT 125RS,A01,515971,Geibel; William,0,0,20,20
1714602316225,CLRE 250,A00,511389,Morris; Sheldon,9993,0,9999,6
1714602317253,CLRE 251,A00,507176,Mehta; Ravindra L.,9993,0,9999,6
1714602317253,CLRE 251,B00,511410,Mehta; Ravindra L.,9998,0,9999,1
1714602318282,CLRE 252,A00,507189,Cuomo; Raphael Eduardo,9995,0,9999,4
1714602319308,CLRE 253,A00,507199,Vaida; Florin,9994,0,9999,5
1714602319308,CLRE 253,B00,507202,Vaida; Florin,9999,0,9999,0
1714602320333,CLRE 259,A00,507211,Patel; Hemal,9996,0,9999,3
1714602321357,CLRE 260,A00,507221,Cuomo; Raphael Eduardo,9999,0,9999,0
1714602322384,CLRE 297,001,507242,Cuomo; Raphael Eduardo,9999,0,9999,0
1714602323408,COGS 197,001,638244,Voytek; Bradley Thomas,9998,0,9999,1
1714602324436,CSE 191,A00,516875,Minnes Kemp; Mor Mia,9993,0,9999,6
1714602325464,CSE 197,001,637388,Minnes Kemp; Mor Mia,9998,0,9999,1
1714602326489,CSS 201S,A01,494383,Staff,35,0,35,0
1714602327513,CSS 202S,A01,494387,Staff,35,0,35,0
1714602328539,DSC 197,001,628532,Eldridge; Justin Matthew,9996,0,9999,3
1714602329566,EAP 100,A00,516065,Staff,9797,0,9999,202
1714602330595,ECE 45,A01,507414,Staff,33,0,60,27
1714602332644,ECE 111,A01,507420,Staff,15,0,50,35
1714602333670,ECE 197,001,548057,Sievenpiper; Daniel F.,9993,0,9999,6
1714602334699,EDS 115,A00,507243,Choi; Bailey Miyeon,10,0,28,18
1714602335724,EDS 117,A01,494379,Staff,1,5,30,29
1714602336750,EDS 125,A00,507246,Hopkins; Megan Beth,9,0,30,21
1714602337783,EDS 128A,A01,507264,Fargason; Sharon Gayle,8,0,26,18
1714602338808,EDS 128B,A01,507293,Pappas; Elizabeth,12,0,30,18
1714602339836,EDS 139,A00,507294,Fargason; Sharon Gayle,13,0,30,17
1714602339836,EDS 139,B00,507313,Pappas; Elizabeth,13,0,30,17
1714602340863,EDS 201,A00,507315,Staff,13,0,30,17
1714602341887,EDS 203,A01,507317,Halter; Christopher P.,12,0,30,18
1714602342913,EDS 204R,A01,507319,Halter; Christopher P.,0,3,30,30
1714602342913,EDS 204R,B01,507331,Heinzman; Erica M.,16,0,30,14
1714602343939,EDS 206R,A00,507332,Staff,0,4,30,30
1714602343939,EDS 206R,B00,507343,Staff,17,0,30,13
1714602344965,EDS 250,A00,507344,Hemans; Patricia Ann Benitez,22,0,40,18
1714602345993,EDS 281,A00,507345,Daly; Alan J.,18,0,18,0
1714602347021,EDS 284,A00,507350,Daly; Alan J.,16,0,16,0
1714602348049,EDS 286,A00,507359,Fine; Sarah,18,0,18,0
1714602349074,EDS 289C,A01,507361,Daly; Alan J.,18,0,18,0
1714602350103,EDS 290,A00,507366,Hofstetter; Carolyn,15,0,15,0
1714602351130,LIGM 5A,A00,507421,Fischer-Grunski; Eva K,18,0,20,2
1714602352155,LIGM 5B,A00,507423,Fischer-Grunski; Eva K,19,0,20,1
1714602353183,LIGM 5C,A00,507425,Fischer-Grunski; Eva K,19,0,20,1
1714602354207,LIIT 5AS,A00,507427,Carnelos; Chiara,20,0,20,0
1714602355231,LIIT 5BS,A00,507430,Carnelos; Chiara,20,0,20,0
1714602356257,LIIT 5CS,A00,507432,Carnelos; Chiara,20,0,20,0
1714602357287,LISP 5A,A00,507541,Munoz Sanchez; Alicia,11,0,20,9
1714602358316,LISP 5B,A00,507671,Munoz Sanchez; Alicia,8,0,20,12
1714602359342,LISP 5C,A00,507696,Munoz Sanchez; Alicia,9,0,20,11
1714602360366,MAE 197,001,528363,Boechler; Nicholas Sebastia,9998,0,9999,1
1714602361396,MATH 197,001,523477,Kedlaya; Kiran S.,9995,0,9999,4
1714602361396,MATH 197,002,563811,Zhang; Danna,9995,0,9999,4
1714602361396,MATH 197,003,628552,Dumitriu; Ioana,9998,0,9999,1
1714602362425,MCWP 40R,A00,518780,Staff,2,0,20,18
1714602362425,MCWP 40R,B00,518781,Staff,8,0,20,12
1714602362425,MCWP 40R,C00,518783,Staff,6,0,20,14
1714602363456,MCWP 50R,A00,518791,Staff,0,0,20,20
1714602363456,MCWP 50R,B00,518792,Staff,0,2,20,20
1714602363456,MCWP 50R,C00,518793,Staff,0,2,20,20
1714602363456,MCWP 50R,D00,518794,Staff,0,0,20,20
1714602363456,MCWP 50R,E00,518795,Staff,0,2,20,20
1714602363456,MCWP 50R,F00,518796,Staff,0,0,20,20
1714602363456,MCWP 50R,G00,518797,Staff,0,1,20,20
1714602364481,MMW 12R,A01,514034,Herbst; Matthew,0,0,16,16
1714602364481,MMW 12R,A02,514035,Herbst; Matthew,1,0,16,15
1714602365506,MMW 13R,A01,514037,Staff,0,4,16,16
1714602365506,MMW 13R,A02,514039,Staff,0,2,16,16
1714602365506,MMW 13R,A03,628519,Staff,0,2,16,16
1714602367559,SIO 295LS,A00,523233,Staff,10,0,30,20
1714602368585,SIO 295S,A00,523232,Staff,10,0,30,20
1714602369613,SIOC 290S,A01,637330,Merrifield; Mark A,24,0,30,6
1714602370637,SIOC 291S,A01,637333,Gabriel; Corey John,24,0,30,6
1714602371667,SOCI 117,A01,494376,Staff,0,4,5,5
1714602372692,WES 237B,A00,494380,Staff,9,0,20,11
1714602374765,AESE 279B,A00,494370,Wade; Jon P,0,0,33,33
1714602375792,AIP 197,001,627712,Vespa; Emanuel Ignacio,9998,0,9999,1
1714602376818,ANAR 135S,A00,494369,Braswell; Geoffrey E.,0,0,0,0
1714602377844,BENG 196,001,628496,Engler; Adam J.,9998,0,9999,1
1714602378870,CAT 124RS,A01,519847,Geibel; William,0,0,20,20
1714602379902,CAT 125RS,A01,515971,Geibel; William,0,0,20,20
1714602380930,CLRE 250,A00,511389,Morris; Sheldon,9993,0,9999,6
1714602381956,CLRE 251,A00,507176,Mehta; Ravindra L.,9993,0,9999,6
1714602381956,CLRE 251,B00,511410,Mehta; Ravindra L.,9998,0,9999,1
1714602382983,CLRE 252,A00,507189,Cuomo; Raphael Eduardo,9995,0,9999,4
1714602384008,CLRE 253,A00,507199,Vaida; Florin,9994,0,9999,5
1714602384008,CLRE 253,B00,507202,Vaida; Florin,9999,0,9999,0
1714602385036,CLRE 259,A00,507211,Patel; Hemal,9996,0,9999,3
1714602386061,CLRE 260,A00,507221,Cuomo; Raphael Eduardo,9999,0,9999,0
1714602387086,CLRE 297,001,507242,Cuomo; Raphael Eduardo,9999,0,9999,0
1714602388111,COGS 197,001,638244,Voytek; Bradley Thomas,9998,0,9999,1
1714602389137,CSE 191,A00,516875,Minnes Kemp; Mor Mia,9993,0,9999,6
1714602390162,CSE 197,001,637388,Minnes Kemp; Mor Mia,9998,0,9999,1
1714602391189,CSS 201S,A01,494383,Staff,35,0,35,0
1714602392213,CSS 202S,A01,494387,Staff,35,0,35,0
1714602393241,DSC 197,001,628532,Eldridge; Justin Matthew,9996,0,9999,3
1714602394266,EAP 100,A00,516065,Staff,9797,0,9999,202
1714602395296,ECE 45,A01,507414,Staff,33,0,60,27
1714602397353,ECE 111,A01,507420,Staff,15,0,50,35
1714602398378,ECE 197,001,548057,Sievenpiper; Daniel F.,9993,0,9999,6
1714602399409,EDS 115,A00,507243,Choi; Bailey Miyeon,10,0,28,18
1714602400434,EDS 117,A01,494379,Staff,1,5,30,29
1714602401459,EDS 125,A00,507246,Hopkins; Megan Beth,9,0,30,21
1714602402486,EDS 128A,A01,507264,Fargason; Sharon Gayle,8,0,26,18
1714602403516,EDS 128B,A01,507293,Pappas; Elizabeth,12,0,30,18
1714602404540,EDS 139,A00,507294,Fargason; Sharon Gayle,13,0,30,17
1714602404540,EDS 139,B00,507313,Pappas; Elizabeth,13,0,30,17
1714602405569,EDS 201,A00,507315,Staff,13,0,30,17
1714602406663,EDS 203,A01,507317,Halter; Christopher P.,12,0,30,18
1714602407690,EDS 204R,A01,507319,Halter; Christopher P.,0,3,30,30
1714602407690,EDS 204R,B01,507331,Heinzman; Erica M.,16,0,30,14
1714602408720,EDS 206R,A00,507332,Staff,0,4,30,30
1714602408720,EDS 206R,B00,507343,Staff,17,0,30,13
1714602409745,EDS 250,A00,507344,Hemans; Patricia Ann Benitez,22,0,40,18
1714602410772,EDS 281,A00,507345,Daly; Alan J.,18,0,18,0
1714602411799,EDS 284,A00,507350,Daly; Alan J.,16,0,16,0
1714602412826,EDS 286,A00,507359,Fine; Sarah,18,0,18,0
1714602413854,EDS 289C,A01,507361,Daly; Alan J.,18,0,18,0
1714602414879,EDS 290,A00,507366,Hofstetter; Carolyn,15,0,15,0
1714602415905,LIGM 5A,A00,507421,Fischer-Grunski; Eva K,18,0,20,2
1714602416935,LIGM 5B,A00,507423,Fischer-Grunski; Eva K,19,0,20,1
1714602417960,LIGM 5C,A00,507425,Fischer-Grunski; Eva K,19,0,20,1
1714602418985,LIIT 5AS,A00,507427,Carnelos; Chiara,20,0,20,0
1714602420015,LIIT 5BS,A00,507430,Carnelos; Chiara,20,0,20,0
1714602421041,LIIT 5CS,A00,507432,Carnelos; Chiara,20,0,20,0
1714602422067,LISP 5A,A00,507541,Munoz Sanchez; Alicia,11,0,20,9
1714602423093,LISP 5B,A00,507671,Munoz Sanchez; Alicia,8,0,20,12
1714602424122,LISP 5C,A00,507696,Munoz Sanchez; Alicia,9,0,20,11
1714602425147,MAE 197,001,528363,Boechler; Nicholas Sebastia,9998,0,9999,1
1714602426178,MATH 197,001,523477,Kedlaya; Kiran S.,9995,0,9999,4
1714602426178,MATH 197,002,563811,Zhang; Danna,9995,0,9999,4
1714602426178,MATH 197,003,628552,Dumitriu; Ioana,9998,0,9999,1
1714602427205,MCWP 40R,A00,518780,Staff,2,0,20,18
1714602427205,MCWP 40R,B00,518781,Staff,8,0,20,12
1714602427205,MCWP 40R,C00,518783,Staff,6,0,20,14
1714602428231,MCWP 50R,A00,518791,Staff,0,0,20,20
1714602428231,MCWP 50R,B00,518792,Staff,0,2,20,20
1714602428231,MCWP 50R,C00,518793,Staff,0,2,20,20
1714602428231,MCWP 50R,D00,518794,Staff,0,0,20,20
1714602428231,MCWP 50R,E00,518795,Staff,0,2,20,20
1714602428231,MCWP 50R,F00,518796,Staff,0,0,20,20
1714602428231,MCWP 50R,G00,518797,Staff,0,1,20,20
1714602429259,MMW 12R,A01,514034,Herbst; Matthew,0,0,16,16
1714602429259,MMW 12R,A02,514035,Herbst; Matthew,1,0,16,15
1714602430288,MMW 13R,A01,514037,Staff,0,4,16,16
1714602430288,MMW 13R,A02,514039,Staff,0,2,16,16
1714602430288,MMW 13R,A03,628519,Staff,0,2,16,16
1714602432344,SIO 295LS,A00,523233,Staff,10,0,30,20
1714602433368,SIO 295S,A00,523232,Staff,10,0,30,20
1714602434393,SIOC 290S,A01,637330,Merrifield; Mark A,24,0,30,6
1714602435418,SIOC 291S,A01,637333,Gabriel; Corey John,24,0,30,6
1714602436442,SOCI 117,A01,494376,Staff,0,4,5,5
1714602437470,WES 237B,A00,494380,Staff,9,0,20,11
1714602439548,AESE 279B,A00,494370,Wade; Jon P,0,0,33,33
1714602440574,AIP 197,001,627712,Vespa; Emanuel Ignacio,9998,0,9999,1
1714602441599,ANAR 135S,A00,494369,Braswell; Geoffrey E.,0,0,0,0
1714602442626,BENG 196,001,628496,Engler; Adam J.,9998,0,9999,1
1714602443654,CAT 124RS,A01,519847,Geibel; William,0,0,20,20
1714602444679,CAT 125RS,A01,515971,Geibel; William,0,0,20,20
1714602445706,CLRE 250,A00,511389,Morris; Sheldon,9993,0,9999,6
1714602446734,CLRE 251,A00,507176,Mehta; Ravindra L.,9993,0,9999,6
1714602446734,CLRE 251,B00,511410,Mehta; Ravindra L.,9998,0,9999,1
1714602447761,CLRE 252,A00,507189,Cuomo; Raphael Eduardo,9995,0,9999,4
1714602448789,CLRE 253,A00,507199,Vaida; Florin,9994,0,9999,5
1714602448789,CLRE 253,B00,507202,Vaida; Florin,9999,0,9999,0
1714602449819,CLRE 259,A00,507211,Patel; Hemal,9996,0,9999,3
1714602450845,CLRE 260,A00,507221,Cuomo; Raphael Eduardo,9999,0,9999,0
1714602451873,CLRE 297,001,507242,Cuomo; Raphael Eduardo,9999,0,9999,0
1714602452900,COGS 197,001,638244,Voytek; Bradley Thomas,9998,0,9999,1
1714602453927,CSE 191,A00,516875,Minnes Kemp; Mor Mia,9993,0,9999,6
1714602454952,CSE 197,001,637388,Minnes Kemp; Mor Mia,9998,0,9999,1
1714602455979,CSS 201S,A01,494383,Staff,35,0,35,0
1714602457008,CSS 202S,A01,494387,Staff,35,0,35,0
1714602458034,DSC 197,001,628532,Eldridge; Justin Matthew,9996,0,9999,3
1714602459059,EAP 100,A00,516065,Staff,9797,0,9999,202
1714602460084,ECE 45,A01,507414,Staff,33,0,60,27
1714602462136,ECE 111,A01,507420,Staff,15,0,50,35
1714602463165,ECE 197,001,548057,Sievenpiper; Daniel F.,9993,0,9999,6
1714602464190,EDS 115,A00,507243,Choi; Bailey Miyeon,10,0,28,18
1714602465215,EDS 117,A01,494379,Staff,1,5,30,29
1714602466244,EDS 125,A00,507246,Hopkins; Megan Beth,9,0,30,21
1714602467270,EDS 128A,A01,507264,Fargason; Sharon Gayle,8,0,26,18
1714602468299,EDS 128B,A01,507293,Pappas; Elizabeth,12,0,30,18
1714602469325,EDS 139,A00,507294,Fargason; Sharon Gayle,13,0,30,17
1714602469325,EDS 139,B00,507313,Pappas; Elizabeth,13,0,30,17
1714602470349,EDS 201,A00,507315,Staff,13,0,30,17
1714602471379,EDS 203,A01,507317,Halter; Christopher P.,12,0,30,18
1714602472405,EDS 204R,A01,507319,Halter; Christopher P.,0,3,30,30
1714602472405,EDS 204R,B01,507331,Heinzman; Erica M.,16,0,30,14
1714602473432,EDS 206R,A00,507332,Staff,0,4,30,30
1714602473432,EDS 206R,B00,507343,Staff,17,0,30,13
1714602474460,EDS 250,A00,507344,Hemans; Patricia Ann Benitez,22,0,40,18
1714602475486,EDS 281,A00,507345,Daly; Alan J.,18,0,18,0
1714602476511,EDS 284,A00,507350,Daly; Alan J.,16,0,16,0
1714602477538,EDS 286,A00,507359,Fine; Sarah,18,0,18,0
1714602478562,EDS 289C,A01,507361,Daly; Alan J.,18,0,18,0
1714602479588,EDS 290,A00,507366,Hofstetter; Carolyn,15,0,15,0
1714602480618,LIGM 5A,A00,507421,Fischer-Grunski; Eva K,18,0,20,2
1714602481644,LIGM 5B,A00,507423,Fischer-Grunski; Eva K,19,0,20,1
1714602482673,LIGM 5C,A00,507425,Fischer-Grunski; Eva K,19,0,20,1
1714602483700,LIIT 5AS,A00,507427,Carnelos; Chiara,20,0,20,0
1714602484724,LIIT 5BS,A00,507430,Carnelos; Chiara,20,0,20,0
1714602485749,LIIT 5CS,A00,507432,Carnelos; Chiara,20,0,20,0
1714602486774,LISP 5A,A00,507541,Munoz Sanchez; Alicia,11,0,20,9
1714602487798,LISP 5B,A00,507671,Munoz Sanchez; Alicia,8,0,20,12
1714602488828,LISP 5C,A00,507696,Munoz Sanchez; Alicia,9,0,20,11
1714602489854,MAE 197,001,528363,Boechler; Nicholas Sebastia,9998,0,9999,1
1714602490881,MATH 197,001,523477,Kedlaya; Kiran S.,9995,0,9999,4
1714602490881,MATH 197,002,563811,Zhang; Danna,9995,0,9999,4
1714602490881,MATH 197,003,628552,Dumitriu; Ioana,9998,0,9999,1
1714602491905,MCWP 40R,A00,518780,Staff,2,0,20,18
1714602491905,MCWP 40R,B00,518781,Staff,8,0,20,12
1714602491905,MCWP 40R,C00,518783,Staff,6,0,20,14
1714602492934,MCWP 50R,A00,518791,Staff,0,0,20,20
1714602492934,MCWP 50R,B00,518792,Staff,0,2,20,20
1714602492934,MCWP 50R,C00,518793,Staff,0,2,20,20
1714602492934,MCWP 50R,D00,518794,Staff,0,0,20,20
1714602492934,MCWP 50R,E00,518795,Staff,0,2,20,20
1714602492934,MCWP 50R,F00,518796,Staff,0,0,20,20
1714602492934,MCWP 50R,G00,518797,Staff,0,1,20,20
1714602493960,MMW 12R,A01,514034,Herbst; Matthew,0,0,16,16
1714602493960,MMW 12R,A02,514035,Herbst; Matthew,1,0,16,15
1714602494989,MMW 13R,A01,514037,Staff,0,4,16,16
1714602494989,MMW 13R,A02,514039,Staff,0,2,16,16
1714602494989,MMW 13R,A03,628519,Staff,0,2,16,16
1714602497042,SIO 295LS,A00,523233,Staff,10,0,30,20
1714602498070,SIO 295S,A00,523232,Staff,10,0,30,20
1714602499095,SIOC 290S,A01,637330,Merrifield; Mark A,24,0,30,6
1714602500127,SIOC 291S,A01,637333,Gabriel; Corey John,24,0,30,6
1714602501155,SOCI 117,A01,494376,Staff,0,4,5,5
1714602502181,WES 237B,A00,494380,Staff,9,0,20,11
1714602504251,AESE 279B,A00,494370,Wade; Jon P,0,0,33,33
1714602505277,AIP 197,001,627712,Vespa; Emanuel Ignacio,9998,0,9999,1
1714602506303,ANAR 135S,A00,494369,Braswell; Geoffrey E.,0,0,0,0
1714602507329,BENG 196,001,628496,Engler; Adam J.,9998,0,9999,1
1714602508355,CAT 124RS,A01,519847,Geibel; William,0,0,20,20
1714602509381,CAT 125RS,A01,515971,Geibel; William,0,0,20,20
1714602510481,CLRE 250,A00,511389,Morris; Sheldon,9993,0,9999,6
1714602511511,CLRE 251,A00,507176,Mehta; Ravindra L.,9993,0,9999,6
1714602511511,CLRE 251,B00,511410,Mehta; Ravindra L.,9998,0,9999,1
1714602512537,CLRE 252,A00,507189,Cuomo; Raphael Eduardo,9995,0,9999,4
1714602513561,CLRE 253,A00,507199,Vaida; Florin,9994,0,9999,5
1714602513561,CLRE 253,B00,507202,Vaida; Florin,9999,0,9999,0
1714602514586,CLRE 259,A00,507211,Patel; Hemal,9996,0,9999,3
1714602515613,CLRE 260,A00,507221,Cuomo; Raphael Eduardo,9999,0,9999,0
1714602516641,CLRE 297,001,507242,Cuomo; Raphael Eduardo,9999,0,9999,0
1714602517669,COGS 197,001,638244,Voytek; Bradley Thomas,9998,0,9999,1
1714602518694,CSE 191,A00,516875,Minnes Kemp; Mor Mia,9993,0,9999,6
1714602519721,CSE 197,001,637388,Minnes Kemp; Mor Mia,9998,0,9999,1
1714602520752,CSS 201S,A01,494383,Staff,35,0,35,0
1714602521778,CSS 202S,A01,494387,Staff,35,0,35,0
1714602522806,DSC 197,001,628532,Eldridge; Justin Matthew,9996,0,9999,3
1714602523830,EAP 100,A00,516065,Staff,9797,0,9999,202
1714602524859,ECE 45,A01,507414,Staff,33,0,60,27
1714602526911,ECE 111,A01,507420,Staff,15,0,50,35
1714602527937,ECE 197,001,548057,Sievenpiper; Daniel F.,9993,0,9999,6
1714602528963,EDS 115,A00,507243,Choi; Bailey Miyeon,10,0,28,18
1714602529991,EDS 117,A01,494379,Staff,1,5,30,29
1714602531016,EDS 125,A00,507246,Hopkins; Megan Beth,9,0,30,21
1714602532046,EDS 128A,A01,507264,Fargason; Sharon Gayle,8,0,26,18
1714602533074,EDS 128B,A01,507293,Pappas; Elizabeth,12,0,30,18
1714602534098,EDS 139,A00,507294,Fargason; Sharon Gayle,13,0,30,17
1714602534098,EDS 139,B00,507313,Pappas; Elizabeth,13,0,30,17
1714602535125,EDS 201,A00,507315,Staff,13,0,30,17
1714602536152,EDS 203,A01,507317,Halter; Christopher P.,12,0,30,18
1714602537183,EDS 204R,A01,507319,Halter; Christopher P.,0,3,30,30
1714602537183,EDS 204R,B01,507331,Heinzman; Erica M.,16,0,30,14
1714602538208,EDS 206R,A00,507332,Staff,0,4,30,30
1714602538208,EDS 206R,B00,507343,Staff,17,0,30,13
1714602539236,EDS 250,A00,507344,Hemans; Patricia Ann Benitez,22,0,40,18
1714602540266,EDS 281,A00,507345,Daly; Alan J.,18,0,18,0
1714602541292,EDS 284,A00,507350,Daly; Alan J.,16,0,16,0
1714602542321,EDS 286,A00,507359,Fine; Sarah,18,0,18,0
1714602543345,EDS 289C,A01,507361,Daly; Alan J.,18,0,18,0
1714602544374,EDS 290,A00,507366,Hofstetter; Carolyn,15,0,15,0
1714602545404,LIGM 5A,A00,507421,Fischer-Grunski; Eva K,18,0,20,2
1714602546428,LIGM 5B,A00,507423,Fischer-Grunski; Eva K,19,0,20,1
1714602547455,LIGM 5C,A00,507425,Fischer-Grunski; Eva K,19,0,20,1
1714602548480,LIIT 5AS,A00,507427,Carnelos; Chiara,20,0,20,0
1714602549513,LIIT 5BS,A00,507430,Carnelos; Chiara,20,0,20,0
1714602550540,LIIT 5CS,A00,507432,Carnelos; Chiara,20,0,20,0
1714602551570,LISP 5A,A00,507541,Munoz Sanchez; Alicia,11,0,20,9
1714602552595,LISP 5B,A00,507671,Munoz Sanchez; Alicia,8,0,20,12
1714602553628,LISP 5C,A00,507696,Munoz Sanchez; Alicia,9,0,20,11
1714602554653,MAE 197,001,528363,Boechler; Nicholas Sebastia,9998,0,9999,1
1714602555682,MATH 197,001,523477,Kedlaya; Kiran S.,9995,0,9999,4
1714602555682,MATH 197,002,563811,Zhang; Danna,9995,0,9999,4
1714602555682,MATH 197,003,628552,Dumitriu; Ioana,9998,0,9999,1
1714602556707,MCWP 40R,A00,518780,Staff,2,0,20,18
1714602556707,MCWP 40R,B00,518781,Staff,8,0,20,12
1714602556707,MCWP 40R,C00,518783,Staff,6,0,20,14
1714602557731,MCWP 50R,A00,518791,Staff,0,0,20,20
1714602557731,MCWP 50R,B00,518792,Staff,0,2,20,20
1714602557731,MCWP 50R,C00,518793,Staff,0,2,20,20
1714602557731,MCWP 50R,D00,518794,Staff,0,0,20,20
1714602557731,MCWP 50R,E00,518795,Staff,0,2,20,20
1714602557731,MCWP 50R,F00,518796,Staff,0,0,20,20
1714602557731,MCWP 50R,G00,518797,Staff,0,1,20,20
1714602558756,MMW 12R,A01,514034,Herbst; Matthew,0,0,16,16
1714602558756,MMW 12R,A02,514035,Herbst; Matthew,1,0,16,15
1714602559782,MMW 13R,A01,514037,Staff,0,4,16,16
1714602559782,MMW 13R,A02,514039,Staff,0,2,16,16
1714602559782,MMW 13R,A03,628519,Staff,0,2,16,16
1714602561837,SIO 295LS,A00,523233,Staff,10,0,30,20
1714602562863,SIO 295S,A00,523232,Staff,10,0,30,20
1714602563893,SIOC 290S,A01,637330,Merrifield; Mark A,23,0,30,7
1714602564918,SIOC 291S,A01,637333,Gabriel; Corey John,23,0,30,7
1714602565944,SOCI 117,A01,494376,Staff,0,4,5,5
1714602566972,WES 237B,A00,494380,Staff,9,0,20,11
1714602569048,AESE 279B,A00,494370,Wade; Jon P,0,0,33,33
1714602570075,AIP 197,001,627712,Vespa; Emanuel Ignacio,9998,0,9999,1
1714602571101,ANAR 135S,A00,494369,Braswell; Geoffrey E.,0,0,0,0
1714602572129,BENG 196,001,628496,Engler; Adam J.,9998,0,9999,1
1714602573160,CAT 124RS,A01,519847,Geibel; William,0,0,20,20
1714602574185,CAT 125RS,A01,515971,Geibel; William,0,0,20,20
1714602575211,CLRE 250,A00,511389,Morris; Sheldon,9993,0,9999,6
1714602576238,CLRE 251,A00,507176,Mehta; Ravindra L.,9993,0,9999,6
1714602576238,CLRE 251,B00,511410,Mehta; Ravindra L.,9998,0,9999,1
1714602577266,CLRE 252,A00,507189,Cuomo; Raphael Eduardo,9995,0,9999,4
1714602578291,CLRE 253,A00,507199,Vaida; Florin,9994,0,9999,5
1714602578291,CLRE 253,B00,507202,Vaida; Florin,9999,0,9999,0
1714602579319,CLRE 259,A00,507211,Patel; Hemal,9996,0,9999,3
1714602580346,CLRE 260,A00,507221,Cuomo; Raphael Eduardo,9999,0,9999,0
1714602581373,CLRE 297,001,507242,Cuomo; Raphael Eduardo,9999,0,9999,0
1714602582399,COGS 197,001,638244,Voytek; Bradley Thomas,9998,0,9999,1
1714602583424,CSE 191,A00,516875,Minnes Kemp; Mor Mia,9993,0,9999,6
1714602584448,CSE 197,001,637388,Minnes Kemp; Mor Mia,9998,0,9999,1
1714602585477,CSS 201S,A01,494383,Staff,35,0,35,0
1714602586502,CSS 202S,A01,494387,Staff,35,0,35,0
1714602587531,DSC 197,001,628532,Eldridge; Justin Matthew,9996,0,9999,3
1714602588557,EAP 100,A00,516065,Staff,9797,0,9999,202
1714602589581,ECE 45,A01,507414,Staff,33,0,60,27
1714602591633,ECE 111,A01,507420,Staff,15,0,50,35
1714602592658,ECE 197,001,548057,Sievenpiper; Daniel F.,9993,0,9999,6
1714602593688,EDS 115,A00,507243,Choi; Bailey Miyeon,10,0,28,18
1714602594718,EDS 117,A01,494379,Staff,1,5,30,29
1714602595743,EDS 125,A00,507246,Hopkins; Megan Beth,9,0,30,21
1714602596768,EDS 128A,A01,507264,Fargason; Sharon Gayle,8,0,26,18
1714602597792,EDS 128B,A01,507293,Pappas; Elizabeth,12,0,30,18
1714602598820,EDS 139,A00,507294,Fargason; Sharon Gayle,13,0,30,17
1714602598820,EDS 139,B00,507313,Pappas; Elizabeth,13,0,30,17
1714602599848,EDS 201,A00,507315,Staff,13,0,30,17
1714602600874,EDS 203,A01,507317,Halter; Christopher P.,12,0,30,18
1714602601906,EDS 204R,A01,507319,Halter; Christopher P.,0,3,30,30
1714602601906,EDS 204R,B01,507331,Heinzman; Erica M.,16,0,30,14
1714602602930,EDS 206R,A00,507332,Staff,0,4,30,30
1714602602930,EDS 206R,B00,507343,Staff,17,0,30,13
1714602603954,EDS 250,A00,507344,Hemans; Patricia Ann Benitez,22,0,40,18
1714602604979,EDS 281,A00,507345,Daly; Alan J.,18,0,18,0
1714602606004,EDS 284,A00,507350,Daly; Alan J.,16,0,16,0
1714602607030,EDS 286,A00,507359,Fine; Sarah,18,0,18,0
1714602608065,EDS 289C,A01,507361,Daly; Alan J.,18,0,18,0
1714602609091,EDS 290,A00,507366,Hofstetter; Carolyn,15,0,15,0
1714602610121,LIGM 5A,A00,507421,Fischer-Grunski; Eva K,18,0,20,2
1714602611147,LIGM 5B,A00,507423,Fischer-Grunski; Eva K,19,0,20,1
1714602612171,LIGM 5C,A00,507425,Fischer-Grunski; Eva K,19,0,20,1
1714602613197,LIIT 5AS,A00,507427,Carnelos; Chiara,20,0,20,0
1714602614281,LIIT 5BS,A00,507430,Carnelos; Chiara,20,0,20,0
1714602615307,LIIT 5CS,A00,507432,Carnelos; Chiara,20,0,20,0
1714602616337,LISP 5A,A00,507541,Munoz Sanchez; Alicia,11,0,20,9
1714602617362,LISP 5B,A00,507671,Munoz Sanchez; Alicia,8,0,20,12
1714602618389,LISP 5C,A00,507696,Munoz Sanchez; Alicia,9,0,20,11
1714602619416,MAE 197,001,528363,Boechler; Nicholas Sebastia,9998,0,9999,1
1714602620441,MATH 197,001,523477,Kedlaya; Kiran S.,9995,0,9999,4
1714602620441,MATH 197,002,563811,Zhang; Danna,9995,0,9999,4
1714602620441,MATH 197,003,628552,Dumitriu; Ioana,9998,0,9999,1
1714602621471,MCWP 40R,A00,518780,Staff,2,0,20,18
1714602621471,MCWP 40R,B00,518781,Staff,8,0,20,12
1714602621471,MCWP 40R,C00,518783,Staff,6,0,20,14
1714602622500,MCWP 50R,A00,518791,Staff,0,0,20,20
1714602622500,MCWP 50R,B00,518792,Staff,0,2,20,20
1714602622500,MCWP 50R,C00,518793,Staff,0,2,20,20
1714602622500,MCWP 50R,D00,518794,Staff,0,0,20,20
1714602622500,MCWP 50R,E00,518795,Staff,0,2,20,20
1714602622500,MCWP 50R,F00,518796,Staff,0,0,20,20
1714602622500,MCWP 50R,G00,518797,Staff,0,1,20,20
1714602623527,MMW 12R,A01,514034,Herbst; Matthew,0,0,16,16
1714602623527,MMW 12R,A02,514035,Herbst; Matthew,1,0,16,15
1714602624553,MMW 13R,A01,514037,Staff,0,4,16,16
1714602624553,MMW 13R,A02,514039,Staff,0,2,16,16
1714602624553,MMW 13R,A03,628519,Staff,0,2,16,16
1714602626609,SIO 295LS,A00,523233,Staff,10,0,30,20
1714602627637,SIO 295S,A00,523232,Staff,10,0,30,20
1714602628661,SIOC 290S,A01,637330,Merrifield; Mark A,23,0,30,7
1714602629686,SIOC 291S,A01,637333,Gabriel; Corey John,23,0,30,7
1714602630713,SOCI 117,A01,494376,Staff,0,4,5,5
1714602631739,WES 237B,A00,494380,Staff,9,0,20,11
1714602633818,AESE 279B,A00,494370,Wade; Jon P,0,0,33,33
1714602634847,AIP 197,001,627712,Vespa; Emanuel Ignacio,9998,0,9999,1
1714602635872,ANAR 135S,A00,494369,Braswell; Geoffrey E.,0,0,0,0
1714602636896,BENG 196,001,628496,Engler; Adam J.,9998,0,9999,1
1714602637924,CAT 124RS,A01,519847,Geibel; William,0,0,20,20
1714602638949,CAT 125RS,A01,515971,Geibel; William,0,0,20,20
1714602639974,CLRE 250,A00,511389,Morris; Sheldon,9993,0,9999,6
1714602641004,CLRE 251,A00,507176,Mehta; Ravindra L.,9993,0,9999,6
1714602641004,CLRE 251,B00,511410,Mehta; Ravindra L.,9998,0,9999,1
1714602642033,CLRE 252,A00,507189,Cuomo; Raphael Eduardo,9995,0,9999,4
1714602643061,CLRE 253,A00,507199,Vaida; Florin,9994,0,9999,5
1714602643061,CLRE 253,B00,507202,Vaida; Florin,9999,0,9999,0
1714602644087,CLRE 259,A00,507211,Patel; Hemal,9996,0,9999,3
1714602645112,CLRE 260,A00,507221,Cuomo; Raphael Eduardo,9999,0,9999,0
1714602646139,CLRE 297,001,507242,Cuomo; Raphael Eduardo,9999,0,9999,0
1714602647168,COGS 197,001,638244,Voytek; Bradley Thomas,9998,0,9999,1
1714602648193,CSE 191,A00,516875,Minnes Kemp; Mor Mia,9993,0,9999,6
1714602649216,CSE 197,001,637388,Minnes Kemp; Mor Mia,9998,0,9999,1
1714602650243,CSS 201S,A01,494383,Staff,35,0,35,0
1714602651268,CSS 202S,A01,494387,Staff,35,0,35,0
1714602652293,DSC 197,001,628532,Eldridge; Justin Matthew,9996,0,9999,3
1714602653317,EAP 100,A00,516065,Staff,9797,0,9999,202
1714602654346,ECE 45,A01,507414,Staff,33,0,60,27
1714602656398,ECE 111,A01,507420,Staff,15,0,50,35
1714602657422,ECE 197,001,548057,Sievenpiper; Daniel F.,9993,0,9999,6
1714602658448,EDS 115,A00,507243,Choi; Bailey Miyeon,10,0,28,18
1714602659476,EDS 117,A01,494379,Staff,1,5,30,29
1714602660501,EDS 125,A00,507246,Hopkins; Megan Beth,9,0,30,21
1714602661526,EDS 128A,A01,507264,Fargason; Sharon Gayle,8,0,26,18
1714602662555,EDS 128B,A01,507293,Pappas; Elizabeth,12,0,30,18
1714602663580,EDS 139,A00,507294,Fargason; Sharon Gayle,13,0,30,17
1714602663580,EDS 139,B00,507313,Pappas; Elizabeth,13,0,30,17
1714602664604,EDS 201,A00,507315,Staff,13,0,30,17
1714602665629,EDS 203,A01,507317,Halter; Christopher P.,12,0,30,18
1714602666656,EDS 204R,A01,507319,Halter; Christopher P.,0,3,30,30
1714602666656,EDS 204R,B01,507331,Heinzman; Erica M.,16,0,30,14
1714602667682,EDS 206R,A00,507332,Staff,0,4,30,30
1714602667682,EDS 206R,B00,507343,Staff,17,0,30,13
1714602668712,EDS 250,A00,507344,Hemans; Patricia Ann Benitez,22,0,40,18
1714602669737,EDS 281,A00,507345,Daly; Alan J.,18,0,18,0
1714602670762,EDS 284,A00,507350,Daly; Alan J.,16,0,16,0
1714602671789,EDS 286,A00,507359,Fine; Sarah,18,0,18,0
1714602672816,EDS 289C,A01,507361,Daly; Alan J.,18,0,18,0
1714602673842,EDS 290,A00,507366,Hofstetter; Carolyn,15,0,15,0
1714602675071,LIGM 5A,A00,507421,Fischer-Grunski; Eva K,18,0,20,2
1714602676100,LIGM 5B,A00,507423,Fischer-Grunski; Eva K,19,0,20,1
1714602677127,LIGM 5C,A00,507425,Fischer-Grunski; Eva K,19,0,20,1
1714602678156,LIIT 5AS,A00,507427,Carnelos; Chiara,20,0,20,0
1714602679183,LIIT 5BS,A00,507430,Carnelos; Chiara,20,0,20,0
1714602680208,LIIT 5CS,A00,507432,Carnelos; Chiara,20,0,20,0
1714602681238,LISP 5A,A00,507541,Munoz Sanchez; Alicia,11,0,20,9
1714602682267,LISP 5B,A00,507671,Munoz Sanchez; Alicia,8,0,20,12
1714602683296,LISP 5C,A00,507696,Munoz Sanchez; Alicia,9,0,20,11
1714602684326,MAE 197,001,528363,Boechler; Nicholas Sebastia,9998,0,9999,1
1714602685352,MATH 197,001,523477,Kedlaya; Kiran S.,9995,0,9999,4
1714602685352,MATH 197,002,563811,Zhang; Danna,9995,0,9999,4
1714602685352,MATH 197,003,628552,Dumitriu; Ioana,9998,0,9999,1
1714602686380,MCWP 40R,A00,518780,Staff,2,0,20,18
1714602686380,MCWP 40R,B00,518781,Staff,8,0,20,12
1714602686380,MCWP 40R,C00,518783,Staff,6,0,20,14
1714602687410,MCWP 50R,A00,518791,Staff,0,0,20,20
1714602687410,MCWP 50R,B00,518792,Staff,0,2,20,20
1714602687410,MCWP 50R,C00,518793,Staff,0,2,20,20
1714602687410,MCWP 50R,D00,518794,Staff,0,0,20,20
1714602687410,MCWP 50R,E00,518795,Staff,0,2,20,20
1714602687410,MCWP 50R,F00,518796,Staff,0,0,20,20
1714602687410,MCWP 50R,G00,518797,Staff,0,1,20,20
1714602688435,MMW 12R,A01,514034,Herbst; Matthew,0,0,16,16
1714602688435,MMW 12R,A02,514035,Herbst; Matthew,1,0,16,15
1714602689461,MMW 13R,A01,514037,Staff,0,4,16,16
1714602689461,MMW 13R,A02,514039,Staff,0,2,16,16
1714602689461,MMW 13R,A03,628519,Staff,0,2,16,16
1714602691510,SIO 295LS,A00,523233,Staff,10,0,30,20
1714602692537,SIO 295S,A00,523232,Staff,10,0,30,20
1714602693564,SIOC 290S,A01,637330,Merrifield; Mark A,23,0,30,7
1714602694593,SIOC 291S,A01,637333,Gabriel; Corey John,23,0,30,7
1714602695621,SOCI 117,A01,494376,Staff,0,4,5,5
1714602696648,WES 237B,A00,494380,Staff,9,0,20,11
1714602698729,AESE 279B,A00,494370,Wade; Jon P,0,0,33,33
1714602699755,AIP 197,001,627712,Vespa; Emanuel Ignacio,9998,0,9999,1
1714602700783,ANAR 135S,A00,494369,Braswell; Geoffrey E.,0,0,0,0
1714602701811,BENG 196,001,628496,Engler; Adam J.,9998,0,9999,1
1714602702839,CAT 124RS,A01,519847,Geibel; William,0,0,20,20
1714602703874,CAT 125RS,A01,515971,Geibel; William,0,0,20,20
1714602704904,CLRE 250,A00,511389,Morris; Sheldon,9993,0,9999,6
1714602705934,CLRE 251,A00,507176,Mehta; Ravindra L.,9993,0,9999,6
1714602705934,CLRE 251,B00,511410,Mehta; Ravindra L.,9998,0,9999,1
1714602706965,CLRE 252,A00,507189,Cuomo; Raphael Eduardo,9995,0,9999,4
1714602707995,CLRE 253,A00,507199,Vaida; Florin,9994,0,9999,5
1714602707995,CLRE 253,B00,507202,Vaida; Florin,9999,0,9999,0
1714602709024,CLRE 259,A00,507211,Patel; Hemal,9996,0,9999,3
1714602710052,CLRE 260,A00,507221,Cuomo; Raphael Eduardo,9999,0,9999,0
1714602711080,CLRE 297,001,507242,Cuomo; Raphael Eduardo,9999,0,9999,0
1714602712105,COGS 197,001,638244,Voytek; Bradley Thomas,9998,0,9999,1
1714602713133,CSE 191,A00,516875,Minnes Kemp; Mor Mia,9993,0,9999,6
1714602714159,CSE 197,001,637388,Minnes Kemp; Mor Mia,9998,0,9999,1
1714602715186,CSS 201S,A01,494383,Staff,35,0,35,0
1714602716211,CSS 202S,A01,494387,Staff,35,0,35,0
1714602717237,DSC 197,001,628532,Eldridge; Justin Matthew,9996,0,9999,3
1714602718318,EAP 100,A00,516065,Staff,9797,0,9999,202
1714602719347,ECE 45,A01,507414,Staff,33,0,60,27
1714602721399,ECE 111,A01,507420,Staff,15,0,50,35
1714602722428,ECE 197,001,548057,Sievenpiper; Daniel F.,9993,0,9999,6
1714602723453,EDS 115,A00,507243,Choi; Bailey Miyeon,10,0,28,18
1714602724481,EDS 117,A01,494379,Staff,1,5,30,29
1714602725507,EDS 125,A00,507246,Hopkins; Megan Beth,9,0,30,21
1714602726533,EDS 128A,A01,507264,Fargason; Sharon Gayle,8,0,26,18
1714602727558,EDS 128B,A01,507293,Pappas; Elizabeth,12,0,30,18
1714602728585,EDS 139,A00,507294,Fargason; Sharon Gayle,13,0,30,17
1714602728585,EDS 139,B00,507313,Pappas; Elizabeth,13,0,30,17
1714602729608,EDS 201,A00,507315,Staff,13,0,30,17
1714602730634,EDS 203,A01,507317,Halter; Christopher P.,12,0,30,18
1714602731662,EDS 204R,A01,507319,Halter; Christopher P.,0,3,30,30
1714602731662,EDS 204R,B01,507331,Heinzman; Erica M.,16,0,30,14
1714602732687,EDS 206R,A00,507332,Staff,0,4,30,30
1714602732687,EDS 206R,B00,507343,Staff,17,0,30,13
1714602733712,EDS 250,A00,507344,Hemans; Patricia Ann Benitez,22,0,40,18
1714602734741,EDS 281,A00,507345,Daly; Alan J.,18,0,18,0
1714602735767,EDS 284,A00,507350,Daly; Alan J.,16,0,16,0
1714602736792,EDS 286,A00,507359,Fine; Sarah,18,0,18,0
1714602737822,EDS 289C,A01,507361,Daly; Alan J.,18,0,18,0
1714602738850,EDS 290,A00,507366,Hofstetter; Carolyn,15,0,15,0
1714602739879,LIGM 5A,A00,507421,Fischer-Grunski; Eva K,18,0,20,2
1714602740909,LIGM 5B,A00,507423,Fischer-Grunski; Eva K,19,0,20,1
1714602741934,LIGM 5C,A00,507425,Fischer-Grunski; Eva K,19,0,20,1
1714602742962,LIIT 5AS,A00,507427,Carnelos; Chiara,20,0,20,0
1714602743993,LIIT 5BS,A00,507430,Carnelos; Chiara,20,0,20,0
1714602745018,LIIT 5CS,A00,507432,Carnelos; Chiara,20,0,20,0
1714602746047,LISP 5A,A00,507541,Munoz Sanchez; Alicia,11,0,20,9
1714602747079,LISP 5B,A00,507671,Munoz Sanchez; Alicia,8,0,20,12
1714602748103,LISP 5C,A00,507696,Munoz Sanchez; Alicia,9,0,20,11
1714602749128,MAE 197,001,528363,Boechler; Nicholas Sebastia,9998,0,9999,1
1714602750158,MATH 197,001,523477,Kedlaya; Kiran S.,9995,0,9999,4
1714602750158,MATH 197,002,563811,Zhang; Danna,9995,0,9999,4
1714602750158,MATH 197,003,628552,Dumitriu; Ioana,9998,0,9999,1
1714602751183,MCWP 40R,A00,518780,Staff,2,0,20,18
1714602751183,MCWP 40R,B00,518781,Staff,8,0,20,12
1714602751183,MCWP 40R,C00,518783,Staff,6,0,20,14
1714602752208,MCWP 50R,A00,518791,Staff,0,0,20,20
1714602752208,MCWP 50R,B00,518792,Staff,0,2,20,20
1714602752208,MCWP 50R,C00,518793,Staff,0,2,20,20
1714602752208,MCWP 50R,D00,518794,Staff,0,0,20,20
1714602752208,MCWP 50R,E00,518795,Staff,0,2,20,20
1714602752208,MCWP 50R,F00,518796,Staff,0,0,20,20
1714602752208,MCWP 50R,G00,518797,Staff,0,1,20,20
1714602753234,MMW 12R,A01,514034,Herbst; Matthew,0,0,16,16
1714602753234,MMW 12R,A02,514035,Herbst; Matthew,1,0,16,15
1714602754263,MMW 13R,A01,514037,Staff,0,4,16,16
1714602754263,MMW 13R,A02,514039,Staff,0,2,16,16
1714602754263,MMW 13R,A03,628519,Staff,0,2,16,16
1714602756314,SIO 295LS,A00,523233,Staff,10,0,30,20
1714602757346,SIO 295S,A00,523232,Staff,10,0,30,20
1714602758428,SIOC 290S,A01,637330,Merrifield; Mark A,23,0,30,7
1714602759454,SIOC 291S,A01,637333,Gabriel; Corey John,23,0,30,7
1714602760480,SOCI 117,A01,494376,Staff,0,4,5,5
1714602761505,WES 237B,A00,494380,Staff,9,0,20,11
1714602763583,AESE 279B,A00,494370,Wade; Jon P,0,0,33,33
1714602764612,AIP 197,001,627712,Vespa; Emanuel Ignacio,9998,0,9999,1
1714602765637,ANAR 135S,A00,494369,Braswell; Geoffrey E.,0,0,0,0
1714602766662,BENG 196,001,628496,Engler; Adam J.,9998,0,9999,1
1714602767693,CAT 124RS,A01,519847,Geibel; William,0,0,20,20
1714602768722,CAT 125RS,A01,515971,Geibel; William,0,0,20,20
1714602769746,CLRE 250,A00,511389,Morris; Sheldon,9993,0,9999,6
1714602770777,CLRE 251,A00,507176,Mehta; Ravindra L.,9993,0,9999,6
1714602770777,CLRE 251,B00,511410,Mehta; Ravindra L.,9998,0,9999,1
1714602771802,CLRE 252,A00,507189,Cuomo; Raphael Eduardo,9995,0,9999,4
1714602772828,CLRE 253,A00,507199,Vaida; Florin,9994,0,9999,5
1714602772828,CLRE 253,B00,507202,Vaida; Florin,9999,0,9999,0
1714602773860,CLRE 259,A00,507211,Patel; Hemal,9996,0,9999,3
1714602774886,CLRE 260,A00,507221,Cuomo; Raphael Eduardo,9999,0,9999,0
1714602775910,CLRE 297,001,507242,Cuomo; Raphael Eduardo,9999,0,9999,0
1714602776937,COGS 197,001,638244,Voytek; Bradley Thomas,9998,0,9999,1
1714602777961,CSE 191,A00,516875,Minnes Kemp; Mor Mia,9993,0,9999,6
1714602778989,CSE 197,001,637388,Minnes Kemp; Mor Mia,9998,0,9999,1
1714602780020,CSS 201S,A01,494383,Staff,35,0,35,0
1714602781048,CSS 202S,A01,494387,Staff,35,0,35,0
1714602782074,DSC 197,001,628532,Eldridge; Justin Matthew,9996,0,9999,3
1714602783101,EAP 100,A00,516065,Staff,9797,0,9999,202
1714602784128,ECE 45,A01,507414,Staff,33,0,60,27
1714602786182,ECE 111,A01,507420,Staff,15,0,50,35
1714602787206,ECE 197,001,548057,Sievenpiper; Daniel F.,9993,0,9999,6
1714602788232,EDS 115,A00,507243,Choi; Bailey Miyeon,10,0,28,18
1714602789262,EDS 117,A01,494379,Staff,1,5,30,29
1714602790286,EDS 125,A00,507246,Hopkins; Megan Beth,9,0,30,21
1714602791312,EDS 128A,A01,507264,Fargason; Sharon Gayle,8,0,26,18
1714602792339,EDS 128B,A01,507293,Pappas; Elizabeth,12,0,30,18
1714602793365,EDS 139,A00,507294,Fargason; Sharon Gayle,13,0,30,17
1714602793365,EDS 139,B00,507313,Pappas; Elizabeth,13,0,30,17
1714602794390,EDS 201,A00,507315,Staff,13,0,30,17
1714602795418,EDS 203,A01,507317,Halter; Christopher P.,12,0,30,18
1714602796443,EDS 204R,A01,507319,Halter; Christopher P.,0,3,30,30
1714602796443,EDS 204R,B01,507331,Heinzman; Erica M.,16,0,30,14
1714602797471,EDS 206R,A00,507332,Staff,0,4,30,30
1714602797471,EDS 206R,B00,507343,Staff,17,0,30,13
1714602798495,EDS 250,A00,507344,Hemans; Patricia Ann Benitez,22,0,40,18
1714602799520,EDS 281,A00,507345,Daly; Alan J.,18,0,18,0
1714602800548,EDS 284,A00,507350,Daly; Alan J.,16,0,16,0
1714602801575,EDS 286,A00,507359,Fine; Sarah,18,0,18,0
1714602802606,EDS 289C,A01,507361,Daly; Alan J.,18,0,18,0
1714602803632,EDS 290,A00,507366,Hofstetter; Carolyn,15,0,15,0
1714602804665,LIGM 5A,A00,507421,Fischer-Grunski; Eva K,18,0,20,2
1714602805690,LIGM 5B,A00,507423,Fischer-Grunski; Eva K,19,0,20,1
1714602806721,LIGM 5C,A00,507425,Fischer-Grunski; Eva K,19,0,20,1
1714602807748,LIIT 5AS,A00,507427,Carnelos; Chiara,20,0,20,0
1714602808776,LIIT 5BS,A00,507430,Carnelos; Chiara,20,0,20,0
1714602809801,LIIT 5CS,A00,507432,Carnelos; Chiara,20,0,20,0
1714602810826,LISP 5A,A00,507541,Munoz Sanchez; Alicia,11,0,20,9
1714602811851,LISP 5B,A00,507671,Munoz Sanchez; Alicia,8,0,20,12
1714602812877,LISP 5C,A00,507696,Munoz Sanchez; Alicia,9,0,20,11
1714602813904,MAE 197,001,528363,Boechler; Nicholas Sebastia,9998,0,9999,1
1714602814935,MATH 197,001,523477,Kedlaya; Kiran S.,9995,0,9999,4
1714602814935,MATH 197,002,563811,Zhang; Danna,9995,0,9999,4
1714602814935,MATH 197,003,628552,Dumitriu; Ioana,9998,0,9999,1
1714602815963,MCWP 40R,A00,518780,Staff,2,0,20,18
1714602815963,MCWP 40R,B00,518781,Staff,8,0,20,12
1714602815963,MCWP 40R,C00,518783,Staff,6,0,20,14
1714602816990,MCWP 50R,A00,518791,Staff,0,0,20,20
1714602816990,MCWP 50R,B00,518792,Staff,0,2,20,20
1714602816990,MCWP 50R,C00,518793,Staff,0,2,20,20
1714602816990,MCWP 50R,D00,518794,Staff,0,0,20,20
1714602816990,MCWP 50R,E00,518795,Staff,0,2,20,20
1714602816990,MCWP 50R,F00,518796,Staff,0,0,20,20
1714602816990,MCWP 50R,G00,518797,Staff,0,1,20,20
1714602818016,MMW 12R,A01,514034,Herbst; Matthew,0,0,16,16
1714602818016,MMW 12R,A02,514035,Herbst; Matthew,1,0,16,15
1714602819041,MMW 13R,A01,514037,Staff,0,4,16,16
1714602819041,MMW 13R,A02,514039,Staff,0,2,16,16
1714602819041,MMW 13R,A03,628519,Staff,0,2,16,16
1714602821091,SIO 295LS,A00,523233,Staff,10,0,30,20
1714602822115,SIO 295S,A00,523232,Staff,10,0,30,20
1714602823142,SIOC 290S,A01,637330,Merrifield; Mark A,23,0,30,7
1714602824165,SIOC 291S,A01,637333,Gabriel; Corey John,23,0,30,7
1714602825192,SOCI 117,A01,494376,Staff,0,4,5,5
1714602826218,WES 237B,A00,494380,Staff,9,0,20,11
1714602828287,AESE 279B,A00,494370,Wade; Jon P,0,0,33,33
1714602829312,AIP 197,001,627712,Vespa; Emanuel Ignacio,9998,0,9999,1
1714602830352,ANAR 135S,A00,494369,Braswell; Geoffrey E.,0,0,0,0
1714602831381,BENG 196,001,628496,Engler; Adam J.,9998,0,9999,1
1714602832406,CAT 124RS,A01,519847,Geibel; William,0,0,20,20
1714602833433,CAT 125RS,A01,515971,Geibel; William,0,0,20,20
1714602834459,CLRE 250,A00,511389,Morris; Sheldon,9993,0,9999,6
1714602835486,CLRE 251,A00,507176,Mehta; Ravindra L.,9993,0,9999,6
1714602835486,CLRE 251,B00,511410,Mehta; Ravindra L.,9998,0,9999,1
1714602836517,CLRE 252,A00,507189,Cuomo; Raphael Eduardo,9995,0,9999,4
1714602837545,CLRE 253,A00,507199,Vaida; Florin,9994,0,9999,5
1714602837545,CLRE 253,B00,507202,Vaida; Florin,9999,0,9999,0
1714602838572,CLRE 259,A00,507211,Patel; Hemal,9996,0,9999,3
1714602839600,CLRE 260,A00,507221,Cuomo; Raphael Eduardo,9999,0,9999,0
1714602840623,CLRE 297,001,507242,Cuomo; Raphael Eduardo,9999,0,9999,0
1714602841651,COGS 197,001,638244,Voytek; Bradley Thomas,9998,0,9999,1
1714602842674,CSE 191,A00,516875,Minnes Kemp; Mor Mia,9993,0,9999,6
1714602843701,CSE 197,001,637388,Minnes Kemp; Mor Mia,9998,0,9999,1
1714602844727,CSS 201S,A01,494383,Staff,35,0,35,0
1714602845758,CSS 202S,A01,494387,Staff,35,0,35,0
1714602846782,DSC 197,001,628532,Eldridge; Justin Matthew,9996,0,9999,3
1714602847807,EAP 100,A00,516065,Staff,9797,0,9999,202
1714602848836,ECE 45,A01,507414,Staff,33,0,60,27
1714602850887,ECE 111,A01,507420,Staff,15,0,50,35
1714602851918,ECE 197,001,548057,Sievenpiper; Daniel F.,9993,0,9999,6
1714602852944,EDS 115,A00,507243,Choi; Bailey Miyeon,10,0,28,18
1714602853971,EDS 117,A01,494379,Staff,1,5,30,29
1714602855004,EDS 125,A00,507246,Hopkins; Megan Beth,9,0,30,21
1714602856029,EDS 128A,A01,507264,Fargason; Sharon Gayle,8,0,26,18
1714602857054,EDS 128B,A01,507293,Pappas; Elizabeth,12,0,30,18
1714602858083,EDS 139,A00,507294,Fargason; Sharon Gayle,13,0,30,17
1714602858083,EDS 139,B00,507313,Pappas; Elizabeth,13,0,30,17
1714602859110,EDS 201,A00,507315,Staff,13,0,30,17
1714602860139,EDS 203,A01,507317,Halter; Christopher P.,12,0,30,18
1714602861171,EDS 204R,A01,507319,Halter; Christopher P.,0,3,30,30
1714602861171,EDS 204R,B01,507331,Heinzman; Erica M.,16,0,30,14
1714602862250,EDS 206R,A00,507332,Staff,0,4,30,30
1714602862250,EDS 206R,B00,507343,Staff,17,0,30,13
1714602863279,EDS 250,A00,507344,Hemans; Patricia Ann Benitez,22,0,40,18
1714602864307,EDS 281,A00,507345,Daly; Alan J.,18,0,18,0
1714602865331,EDS 284,A00,507350,Daly; Alan J.,16,0,16,0
1714602866357,EDS 286,A00,507359,Fine; Sarah,18,0,18,0
1714602867381,EDS 289C,A01,507361,Daly; Alan J.,18,0,18,0
1714602868409,EDS 290,A00,507366,Hofstetter; Carolyn,15,0,15,0
1714602869436,LIGM 5A,A00,507421,Fischer-Grunski; Eva K,18,0,20,2
1714602870462,LIGM 5B,A00,507423,Fischer-Grunski; Eva K,19,0,20,1
1714602871493,LIGM 5C,A00,507425,Fischer-Grunski; Eva K,19,0,20,1
1714602872524,LIIT 5AS,A00,507427,Carnelos; Chiara,20,0,20,0
1714602873560,LIIT 5BS,A00,507430,Carnelos; Chiara,20,0,20,0
1714602874591,LIIT 5CS,A00,507432,Carnelos; Chiara,20,0,20,0
1714602875617,LISP 5A,A00,507541,Munoz Sanchez; Alicia,11,0,20,9
1714602876643,LISP 5B,A00,507671,Munoz Sanchez; Alicia,8,0,20,12
1714602877667,LISP 5C,A00,507696,Munoz Sanchez; Alicia,9,0,20,11
1714602878699,MAE 197,001,528363,Boechler; Nicholas Sebastia,9998,0,9999,1
1714602879728,MATH 197,001,523477,Kedlaya; Kiran S.,9995,0,9999,4
1714602879728,MATH 197,002,563811,Zhang; Danna,9995,0,9999,4
1714602879728,MATH 197,003,628552,Dumitriu; Ioana,9998,0,9999,1
1714602880757,MCWP 40R,A00,518780,Staff,2,0,20,18
1714602880757,MCWP 40R,B00,518781,Staff,8,0,20,12
1714602880757,MCWP 40R,C00,518783,Staff,6,0,20,14
1714602881786,MCWP 50R,A00,518791,Staff,0,0,20,20
1714602881786,MCWP 50R,B00,518792,Staff,0,2,20,20
1714602881786,MCWP 50R,C00,518793,Staff,0,2,20,20
1714602881786,MCWP 50R,D00,518794,Staff,0,0,20,20
1714602881786,MCWP 50R,E00,518795,Staff,0,2,20,20
1714602881786,MCWP 50R,F00,518796,Staff,0,0,20,20
1714602881786,MCWP 50R,G00,518797,Staff,0,1,20,20
1714602882811,MMW 12R,A01,514034,Herbst; Matthew,0,0,16,16
1714602882811,MMW 12R,A02,514035,Herbst; Matthew,1,0,16,15
1714602883841,MMW 13R,A01,514037,Staff,0,4,16,16
1714602883841,MMW 13R,A02,514039,Staff,0,2,16,16
1714602883841,MMW 13R,A03,628519,Staff,0,2,16,16
1714602885898,SIO 295LS,A00,523233,Staff,10,0,30,20
1714602886925,SIO 295S,A00,523232,Staff,10,0,30,20
1714602888036,SIOC 290S,A01,637330,Merrifield; Mark A,23,0,30,7
1714602889066,SIOC 291S,A01,637333,Gabriel; Corey John,23,0,30,7
1714602890090,SOCI 117,A01,494376,Staff,0,4,5,5
1714602891116,WES 237B,A00,494380,Staff,9,0,20,11
1714602893199,AESE 279B,A00,494370,Wade; Jon P,0,0,33,33
1714602894225,AIP 197,001,627712,Vespa; Emanuel Ignacio,9998,0,9999,1
1714602895253,ANAR 135S,A00,494369,Braswell; Geoffrey E.,0,0,0,0
1714602896293,BENG 196,001,628496,Engler; Adam J.,9998,0,9999,1
1714602897317,CAT 124RS,A01,519847,Geibel; William,0,0,20,20
1714602898341,CAT 125RS,A01,515971,Geibel; William,0,0,20,20
1714602899370,CLRE 250,A00,511389,Morris; Sheldon,9993,0,9999,6
1714602900400,CLRE 251,A00,507176,Mehta; Ravindra L.,9993,0,9999,6
1714602900400,CLRE 251,B00,511410,Mehta; Ravindra L.,9998,0,9999,1
1714602901429,CLRE 252,A00,507189,Cuomo; Raphael Eduardo,9995,0,9999,4
1714602902455,CLRE 253,A00,507199,Vaida; Florin,9994,0,9999,5
1714602902455,CLRE 253,B00,507202,Vaida; Florin,9999,0,9999,0
1714602903481,CLRE 259,A00,507211,Patel; Hemal,9996,0,9999,3
1714602904503,CLRE 260,A00,507221,Cuomo; Raphael Eduardo,9999,0,9999,0
1714602905530,CLRE 297,001,507242,Cuomo; Raphael Eduardo,9999,0,9999,0
1714602906559,COGS 197,001,638244,Voytek; Bradley Thomas,9998,0,9999,1
1714602907583,CSE 191,A00,516875,Minnes Kemp; Mor Mia,9993,0,9999,6
1714602908609,CSE 197,001,637388,Minnes Kemp; Mor Mia,9998,0,9999,1
1714602909641,CSS 201S,A01,494383,Staff,35,0,35,0
1714602910670,CSS 202S,A01,494387,Staff,35,0,35,0
1714602911697,DSC 197,001,628532,Eldridge; Justin Matthew,9996,0,9999,3
1714602912723,EAP 100,A00,516065,Staff,9797,0,9999,202
1714602913748,ECE 45,A01,507414,Staff,33,0,60,27
1714602915801,ECE 111,A01,507420,Staff,15,0,50,35
1714602916829,ECE 197,001,548057,Sievenpiper; Daniel F.,9993,0,9999,6
1714602917855,EDS 115,A00,507243,Choi; Bailey Miyeon,10,0,28,18
1714602918880,EDS 117,A01,494379,Staff,1,5,30,29
1714602919904,EDS 125,A00,507246,Hopkins; Megan Beth,9,0,30,21
1714602920933,EDS 128A,A01,507264,Fargason; Sharon Gayle,8,0,26,18
1714602921958,EDS 128B,A01,507293,Pappas; Elizabeth,12,0,30,18
1714602922984,EDS 139,A00,507294,Fargason; Sharon Gayle,13,0,30,17
1714602922984,EDS 139,B00,507313,Pappas; Elizabeth,13,0,30,17
1714602924012,EDS 201,A00,507315,Staff,13,0,30,17
1714602925038,EDS 203,A01,507317,Halter; Christopher P.,12,0,30,18
1714602926065,EDS 204R,A01,507319,Halter; Christopher P.,0,3,30,30
1714602926065,EDS 204R,B01,507331,Heinzman; Erica M.,16,0,30,14
1714602927093,EDS 206R,A00,507332,Staff,0,4,30,30
1714602927093,EDS 206R,B00,507343,Staff,17,0,30,13
1714602928121,EDS 250,A00,507344,Hemans; Patricia Ann Benitez,22,0,40,18
1714602929148,EDS 281,A00,507345,Daly; Alan J.,18,0,18,0
1714602930173,EDS 284,A00,507350,Daly; Alan J.,16,0,16,0
1714602931202,EDS 286,A00,507359,Fine; Sarah,18,0,18,0
1714602932230,EDS 289C,A01,507361,Daly; Alan J.,18,0,18,0
1714602933258,EDS 290,A00,507366,Hofstetter; Carolyn,15,0,15,0
1714602934285,LIGM 5A,A00,507421,Fischer-Grunski; Eva K,18,0,20,2
1714602935309,LIGM 5B,A00,507423,Fischer-Grunski; Eva K,19,0,20,1
1714602936333,LIGM 5C,A00,507425,Fischer-Grunski; Eva K,19,0,20,1
1714602937357,LIIT 5AS,A00,507427,Carnelos; Chiara,20,0,20,0
1714602938381,LIIT 5BS,A00,507430,Carnelos; Chiara,20,0,20,0
1714602939410,LIIT 5CS,A00,507432,Carnelos; Chiara,20,0,20,0
1714602940438,LISP 5A,A00,507541,Munoz Sanchez; Alicia,11,0,20,9
1714602941463,LISP 5B,A00,507671,Munoz Sanchez; Alicia,8,0,20,12
1714602942488,LISP 5C,A00,507696,Munoz Sanchez; Alicia,9,0,20,11
1714602943512,MAE 197,001,528363,Boechler; Nicholas Sebastia,9998,0,9999,1
1714602944540,MATH 197,001,523477,Kedlaya; Kiran S.,9995,0,9999,4
1714602944540,MATH 197,002,563811,Zhang; Danna,9995,0,9999,4
1714602944540,MATH 197,003,628552,Dumitriu; Ioana,9998,0,9999,1
1714602945568,MCWP 40R,A00,518780,Staff,2,0,20,18
1714602945568,MCWP 40R,B00,518781,Staff,8,0,20,12
1714602945568,MCWP 40R,C00,518783,Staff,6,0,20,14
1714602946593,MCWP 50R,A00,518791,Staff,0,0,20,20
1714602946593,MCWP 50R,B00,518792,Staff,0,2,20,20
1714602946593,MCWP 50R,C00,518793,Staff,0,2,20,20
1714602946593,MCWP 50R,D00,518794,Staff,0,0,20,20
1714602946593,MCWP 50R,E00,518795,Staff,0,2,20,20
1714602946593,MCWP 50R,F00,518796,Staff,0,0,20,20
1714602946593,MCWP 50R,G00,518797,Staff,0,1,20,20
1714602947621,MMW 12R,A01,514034,Herbst; Matthew,0,0,16,16
1714602947621,MMW 12R,A02,514035,Herbst; Matthew,1,0,16,15
1714602948646,MMW 13R,A01,514037,Staff,0,4,16,16
1714602948646,MMW 13R,A02,514039,Staff,0,2,16,16
1714602948646,MMW 13R,A03,628519,Staff,0,2,16,16
1714602950698,SIO 295LS,A00,523233,Staff,10,0,30,20
1714602951722,SIO 295S,A00,523232,Staff,10,0,30,20
1714602952747,SIOC 290S,A01,637330,Merrifield; Mark A,23,0,30,7
1714602953771,SIOC 291S,A01,637333,Gabriel; Corey John,23,0,30,7
1714602954801,SOCI 117,A01,494376,Staff,0,4,5,5
1714602955831,WES 237B,A00,494380,Staff,9,0,20,11
1714602957913,AESE 279B,A00,494370,Wade; Jon P,0,0,33,33
1714602958941,AIP 197,001,627712,Vespa; Emanuel Ignacio,9998,0,9999,1
1714602959966,ANAR 135S,A00,494369,Braswell; Geoffrey E.,0,0,0,0
1714602960995,BENG 196,001,628496,Engler; Adam J.,9998,0,9999,1
1714602962021,CAT 124RS,A01,519847,Geibel; William,0,0,20,20
1714602963047,CAT 125RS,A01,515971,Geibel; William,0,0,20,20
1714602964073,CLRE 250,A00,511389,Morris; Sheldon,9993,0,9999,6
1714602965102,CLRE 251,A00,507176,Mehta; Ravindra L.,9993,0,9999,6
1714602965102,CLRE 251,B00,511410,Mehta; Ravindra L.,9998,0,9999,1
1714602966183,CLRE 252,A00,507189,Cuomo; Raphael Eduardo,9995,0,9999,4
1714602967213,CLRE 253,A00,507199,Vaida; Florin,9994,0,9999,5
1714602967213,CLRE 253,B00,507202,Vaida; Florin,9999,0,9999,0
1714602968242,CLRE 259,A00,507211,Patel; Hemal,9996,0,9999,3
1714602969269,CLRE 260,A00,507221,Cuomo; Raphael Eduardo,9999,0,9999,0
1714602970294,CLRE 297,001,507242,Cuomo; Raphael Eduardo,9999,0,9999,0
1714602971320,COGS 197,001,638244,Voytek; Bradley Thomas,9998,0,9999,1
1714602972346,CSE 191,A00,516875,Minnes Kemp; Mor Mia,9993,0,9999,6
1714602973370,CSE 197,001,637388,Minnes Kemp; Mor Mia,9998,0,9999,1
1714602974397,CSS 201S,A01,494383,Staff,35,0,35,0
1714602975423,CSS 202S,A01,494387,Staff,35,0,35,0
1714602976449,DSC 197,001,628532,Eldridge; Justin Matthew,9996,0,9999,3
1714602977473,EAP 100,A00,516065,Staff,9797,0,9999,202
1714602978501,ECE 45,A01,507414,Staff,33,0,60,27
1714602980551,ECE 111,A01,507420,Staff,15,0,50,35
1714602981577,ECE 197,001,548057,Sievenpiper; Daniel F.,9993,0,9999,6
1714602982603,EDS 115,A00,507243,Choi; Bailey Miyeon,10,0,28,18
1714602983629,EDS 117,A01,494379,Staff,1,5,30,29
1714602984654,EDS 125,A00,507246,Hopkins; Megan Beth,9,0,30,21
1714602985680,EDS 128A,A01,507264,Fargason; Sharon Gayle,8,0,26,18
1714602986709,EDS 128B,A01,507293,Pappas; Elizabeth,12,0,30,18
1714602987737,EDS 139,A00,507294,Fargason; Sharon Gayle,13,0,30,17
1714602987737,EDS 139,B00,507313,Pappas; Elizabeth,13,0,30,17
1714602988764,EDS 201,A00,507315,Staff,13,0,30,17
1714602989789,EDS 203,A01,507317,Halter; Christopher P.,12,0,30,18
1714602990815,EDS 204R,A01,507319,Halter; Christopher P.,0,3,30,30
1714602990815,EDS 204R,B01,507331,Heinzman; Erica M.,16,0,30,14
1714602991843,EDS 206R,A00,507332,Staff,0,4,30,30
1714602991843,EDS 206R,B00,507343,Staff,17,0,30,13
1714602992869,EDS 250,A00,507344,Hemans; Patricia Ann Benitez,22,0,40,18
1714602993907,EDS 281,A00,507345,Daly; Alan J.,18,0,18,0
1714602994935,EDS 284,A00,507350,Daly; Alan J.,16,0,16,0
1714602995961,EDS 286,A00,507359,Fine; Sarah,18,0,18,0
1714602996990,EDS 289C,A01,507361,Daly; Alan J.,18,0,18,0
1714602998016,EDS 290,A00,507366,Hofstetter; Carolyn,15,0,15,0
1714602999045,LIGM 5A,A00,507421,Fischer-Grunski; Eva K,18,0,20,2
1714603000073,LIGM 5B,A00,507423,Fischer-Grunski; Eva K,19,0,20,1
1714603001103,LIGM 5C,A00,507425,Fischer-Grunski; Eva K,19,0,20,1
1714603002130,LIIT 5AS,A00,507427,Carnelos; Chiara,20,0,20,0
1714603003154,LIIT 5BS,A00,507430,Carnelos; Chiara,20,0,20,0
1714603004179,LIIT 5CS,A00,507432,Carnelos; Chiara,20,0,20,0
1714603005207,LISP 5A,A00,507541,Munoz Sanchez; Alicia,11,0,20,9
1714603006232,LISP 5B,A00,507671,Munoz Sanchez; Alicia,8,0,20,12
1714603007258,LISP 5C,A00,507696,Munoz Sanchez; Alicia,9,0,20,11
1714603008287,MAE 197,001,528363,Boechler; Nicholas Sebastia,9998,0,9999,1
1714603009318,MATH 197,001,523477,Kedlaya; Kiran S.,9995,0,9999,4
1714603009318,MATH 197,002,563811,Zhang; Danna,9995,0,9999,4
1714603009318,MATH 197,003,628552,Dumitriu; Ioana,9998,0,9999,1
1714603010343,MCWP 40R,A00,518780,Staff,2,0,20,18
1714603010343,MCWP 40R,B00,518781,Staff,8,0,20,12
1714603010343,MCWP 40R,C00,518783,Staff,6,0,20,14
1714603011369,MCWP 50R,A00,518791,Staff,0,0,20,20
1714603011369,MCWP 50R,B00,518792,Staff,0,2,20,20
1714603011369,MCWP 50R,C00,518793,Staff,0,2,20,20
1714603011369,MCWP 50R,D00,518794,Staff,0,0,20,20
1714603011369,MCWP 50R,E00,518795,Staff,0,2,20,20
1714603011369,MCWP 50R,F00,518796,Staff,0,0,20,20
1714603011369,MCWP 50R,G00,518797,Staff,0,1,20,20
1714603012400,MMW 12R,A01,514034,Herbst; Matthew,0,0,16,16
1714603012400,MMW 12R,A02,514035,Herbst; Matthew,1,0,16,15
1714603013429,MMW 13R,A01,514037,Staff,0,4,16,16
1714603013429,MMW 13R,A02,514039,Staff,0,2,16,16
1714603013429,MMW 13R,A03,628519,Staff,0,2,16,16
1714603015479,SIO 295LS,A00,523233,Staff,10,0,30,20
1714603016507,SIO 295S,A00,523232,Staff,10,0,30,20
1714603017534,SIOC 290S,A01,637330,Merrifield; Mark A,23,0,30,7
1714603018559,SIOC 291S,A01,637333,Gabriel; Corey John,23,0,30,7
1714603019585,SOCI 117,A01,494376,Staff,0,4,5,5
1714603020610,WES 237B,A00,494380,Staff,9,0,20,11
1714603022690,AESE 279B,A00,494370,Wade; Jon P,0,0,33,33
1714603023721,AIP 197,001,627712,Vespa; Emanuel Ignacio,9998,0,9999,1
1714603024751,ANAR 135S,A00,494369,Braswell; Geoffrey E.,0,0,0,0
1714603025776,BENG 196,001,628496,Engler; Adam J.,9998,0,9999,1
1714603026806,CAT 124RS,A01,519847,Geibel; William,0,0,20,20
1714603027831,CAT 125RS,A01,515971,Geibel; William,0,0,20,20
1714603028859,CLRE 250,A00,511389,Morris; Sheldon,9993,0,9999,6
1714603029885,CLRE 251,A00,507176,Mehta; Ravindra L.,9993,0,9999,6
1714603029885,CLRE 251,B00,511410,Mehta; Ravindra L.,9998,0,9999,1
1714603030911,CLRE 252,A00,507189,Cuomo; Raphael Eduardo,9995,0,9999,4
1714603031941,CLRE 253,A00,507199,Vaida; Florin,9994,0,9999,5
1714603031941,CLRE 253,B00,507202,Vaida; Florin,9999,0,9999,0
1714603032965,CLRE 259,A00,507211,Patel; Hemal,9996,0,9999,3
1714603033994,CLRE 260,A00,507221,Cuomo; Raphael Eduardo,9999,0,9999,0
1714603035019,CLRE 297,001,507242,Cuomo; Raphael Eduardo,9999,0,9999,0
1714603036047,COGS 197,001,638244,Voytek; Bradley Thomas,9998,0,9999,1
1714603037073,CSE 191,A00,516875,Minnes Kemp; Mor Mia,9993,0,9999,6
1714603038101,CSE 197,001,637388,Minnes Kemp; Mor Mia,9998,0,9999,1
1714603039132,CSS 201S,A01,494383,Staff,35,0,35,0
1714603040156,CSS 202S,A01,494387,Staff,35,0,35,0
1714603041185,DSC 197,001,628532,Eldridge; Justin Matthew,9996,0,9999,3
1714603042209,EAP 100,A00,516065,Staff,9797,0,9999,202
1714603043235,ECE 45,A01,507414,Staff,33,0,60,27
1714603045290,ECE 111,A01,507420,Staff,15,0,50,35
1714603046315,ECE 197,001,548057,Sievenpiper; Daniel F.,9993,0,9999,6
1714603047344,EDS 115,A00,507243,Choi; Bailey Miyeon,10,0,28,18
1714603048369,EDS 117,A01,494379,Staff,1,5,30,29
1714603049414,EDS 125,A00,507246,Hopkins; Megan Beth,9,0,30,21
1714603050444,EDS 128A,A01,507264,Fargason; Sharon Gayle,8,0,26,18
1714603051472,EDS 128B,A01,507293,Pappas; Elizabeth,12,0,30,18
1714603052498,EDS 139,A00,507294,Fargason; Sharon Gayle,13,0,30,17
1714603052498,EDS 139,B00,507313,Pappas; Elizabeth,13,0,30,17
1714603053527,EDS 201,A00,507315,Staff,13,0,30,17
1714603054556,EDS 203,A01,507317,Halter; Christopher P.,12,0,30,18
1714603055581,EDS 204R,A01,507319,Halter; Christopher P.,0,3,30,30
1714603055581,EDS 204R,B01,507331,Heinzman; Erica M.,16,0,30,14
1714603056606,EDS 206R,A00,507332,Staff,0,4,30,30
1714603056606,EDS 206R,B00,507343,Staff,17,0,30,13
1714603057629,EDS 250,A00,507344,Hemans; Patricia Ann Benitez,22,0,40,18
1714603058655,EDS 281,A00,507345,Daly; Alan J.,18,0,18,0
1714603059679,EDS 284,A00,507350,Daly; Alan J.,16,0,16,0
1714603060704,EDS 286,A00,507359,Fine; Sarah,18,0,18,0
1714603061729,EDS 289C,A01,507361,Daly; Alan J.,18,0,18,0
1714603062758,EDS 290,A00,507366,Hofstetter; Carolyn,15,0,15,0
1714603063783,LIGM 5A,A00,507421,Fischer-Grunski; Eva K,18,0,20,2
1714603064813,LIGM 5B,A00,507423,Fischer-Grunski; Eva K,19,0,20,1
1714603065840,LIGM 5C,A00,507425,Fischer-Grunski; Eva K,19,0,20,1
1714603066864,LIIT 5AS,A00,507427,Carnelos; Chiara,20,0,20,0
1714603067889,LIIT 5BS,A00,507430,Carnelos; Chiara,20,0,20,0
1714603068917,LIIT 5CS,A00,507432,Carnelos; Chiara,20,0,20,0
1714603069948,LISP 5A,A00,507541,Munoz Sanchez; Alicia,11,0,20,9
1714603070974,LISP 5B,A00,507671,Munoz Sanchez; Alicia,8,0,20,12
1714603072002,LISP 5C,A00,507696,Munoz Sanchez; Alicia,9,0,20,11
1714603073033,MAE 197,001,528363,Boechler; Nicholas Sebastia,9998,0,9999,1
1714603074061,MATH 197,001,523477,Kedlaya; Kiran S.,9995,0,9999,4
1714603074061,MATH 197,002,563811,Zhang; Danna,9995,0,9999,4
1714603074061,MATH 197,003,628552,Dumitriu; Ioana,9998,0,9999,1
1714603075091,MCWP 40R,A00,518780,Staff,2,0,20,18
1714603075091,MCWP 40R,B00,518781,Staff,8,0,20,12
1714603075091,MCWP 40R,C00,518783,Staff,6,0,20,14
1714603076120,MCWP 50R,A00,518791,Staff,0,0,20,20
1714603076120,MCWP 50R,B00,518792,Staff,0,2,20,20
1714603076120,MCWP 50R,C00,518793,Staff,0,2,20,20
1714603076120,MCWP 50R,D00,518794,Staff,0,0,20,20
1714603076120,MCWP 50R,E00,518795,Staff,0,2,20,20
1714603076120,MCWP 50R,F00,518796,Staff,0,0,20,20
1714603076120,MCWP 50R,G00,518797,Staff,0,1,20,20
1714603077146,MMW 12R,A01,514034,Herbst; Matthew,0,0,16,16
1714603077146,MMW 12R,A02,514035,Herbst; Matthew,1,0,16,15
1714603078170,MMW 13R,A01,514037,Staff,0,4,16,16
1714603078170,MMW 13R,A02,514039,Staff,0,2,16,16
1714603078170,MMW 13R,A03,628519,Staff,0,2,16,16
1714603080221,SIO 295LS,A00,523233,Staff,10,0,30,20
1714603081244,SIO 295S,A00,523232,Staff,10,0,30,20
1714603082269,SIOC 290S,A01,637330,Merrifield; Mark A,23,0,30,7
1714603083298,SIOC 291S,A01,637333,Gabriel; Corey John,23,0,30,7
1714603084324,SOCI 117,A01,494376,Staff,0,4,5,5
1714603085352,WES 237B,A00,494380,Staff,9,0,20,11
1714603087425,AESE 279B,A00,494370,Wade; Jon P,0,0,33,33
1714603088449,AIP 197,001,627712,Vespa; Emanuel Ignacio,9998,0,9999,1
1714603089478,ANAR 135S,A00,494369,Braswell; Geoffrey E.,0,0,0,0
1714603090503,BENG 196,001,628496,Engler; Adam J.,9998,0,9999,1
1714603091534,CAT 124RS,A01,519847,Geibel; William,0,0,20,20
1714603092559,CAT 125RS,A01,515971,Geibel; William,0,0,20,20
1714603093585,CLRE 250,A00,511389,Morris; Sheldon,9993,0,9999,6
1714603094612,CLRE 251,A00,507176,Mehta; Ravindra L.,9993,0,9999,6
1714603094612,CLRE 251,B00,511410,Mehta; Ravindra L.,9998,0,9999,1
1714603095639,CLRE 252,A00,507189,Cuomo; Raphael Eduardo,9995,0,9999,4
1714603096663,CLRE 253,A00,507199,Vaida; Florin,9994,0,9999,5
1714603096663,CLRE 253,B00,507202,Vaida; Florin,9999,0,9999,0
1714603097688,CLRE 259,A00,507211,Patel; Hemal,9996,0,9999,3
1714603098712,CLRE 260,A00,507221,Cuomo; Raphael Eduardo,9999,0,9999,0
1714603099737,CLRE 297,001,507242,Cuomo; Raphael Eduardo,9999,0,9999,0
1714603100766,COGS 197,001,638244,Voytek; Bradley Thomas,9998,0,9999,1
1714603101791,CSE 191,A00,516875,Minnes Kemp; Mor Mia,9993,0,9999,6
1714603102818,CSE 197,001,637388,Minnes Kemp; Mor Mia,9998,0,9999,1
1714603103847,CSS 201S,A01,494383,Staff,35,0,35,0
1714603104875,CSS 202S,A01,494387,Staff,35,0,35,0
1714603105900,DSC 197,001,628532,Eldridge; Justin Matthew,9996,0,9999,3
1714603106925,EAP 100,A00,516065,Staff,9797,0,9999,202
1714603107951,ECE 45,A01,507414,Staff,33,0,60,27
1714603110008,ECE 111,A01,507420,Staff,15,0,50,35
1714603111033,ECE 197,001,548057,Sievenpiper; Daniel F.,9993,0,9999,6
1714603112061,EDS 115,A00,507243,Choi; Bailey Miyeon,10,0,28,18
1714603113093,EDS 117,A01,494379,Staff,1,5,30,29
1714603114121,EDS 125,A00,507246,Hopkins; Megan Beth,9,0,30,21
1714603115150,EDS 128A,A01,507264,Fargason; Sharon Gayle,8,0,26,18
1714603116175,EDS 128B,A01,507293,Pappas; Elizabeth,12,0,30,18
1714603117203,EDS 139,A00,507294,Fargason; Sharon Gayle,13,0,30,17
1714603117203,EDS 139,B00,507313,Pappas; Elizabeth,13,0,30,17
1714603118228,EDS 201,A00,507315,Staff,13,0,30,17
1714603119253,EDS 203,A01,507317,Halter; Christopher P.,12,0,30,18
1714603120285,EDS 204R,A01,507319,Halter; Christopher P.,0,3,30,30
1714603120285,EDS 204R,B01,507331,Heinzman; Erica M.,16,0,30,14
1714603121309,EDS 206R,A00,507332,Staff,0,4,30,30
1714603121309,EDS 206R,B00,507343,Staff,17,0,30,13
1714603122339,EDS 250,A00,507344,Hemans; Patricia Ann Benitez,22,0,40,18
1714603123365,EDS 281,A00,507345,Daly; Alan J.,18,0,18,0
1714603124390,EDS 284,A00,507350,Daly; Alan J.,16,0,16,0
1714603125415,EDS 286,A00,507359,Fine; Sarah,18,0,18,0
1714603126445,EDS 289C,A01,507361,Daly; Alan J.,18,0,18,0
1714603127470,EDS 290,A00,507366,Hofstetter; Carolyn,15,0,15,0
1714603128499,LIGM 5A,A00,507421,Fischer-Grunski; Eva K,18,0,20,2
1714603129526,LIGM 5B,A00,507423,Fischer-Grunski; Eva K,19,0,20,1
1714603130553,LIGM 5C,A00,507425,Fischer-Grunski; Eva K,19,0,20,1
1714603131582,LIIT 5AS,A00,507427,Carnelos; Chiara,20,0,20,0
1714603132613,LIIT 5BS,A00,507430,Carnelos; Chiara,20,0,20,0
1714603133637,LIIT 5CS,A00,507432,Carnelos; Chiara,20,0,20,0
1714603134663,LISP 5A,A00,507541,Munoz Sanchez; Alicia,11,0,20,9
1714603135689,LISP 5B,A00,507671,Munoz Sanchez; Alicia,8,0,20,12
1714603136718,LISP 5C,A00,507696,Munoz Sanchez; Alicia,9,0,20,11
1714603137745,MAE 197,001,528363,Boechler; Nicholas Sebastia,9998,0,9999,1
1714603138772,MATH 197,001,523477,Kedlaya; Kiran S.,9995,0,9999,4
1714603138772,MATH 197,002,563811,Zhang; Danna,9995,0,9999,4
1714603138772,MATH 197,003,628552,Dumitriu; Ioana,9998,0,9999,1
1714603139801,MCWP 40R,A00,518780,Staff,2,0,20,18
1714603139801,MCWP 40R,B00,518781,Staff,8,0,20,12
1714603139801,MCWP 40R,C00,518783,Staff,6,0,20,14
1714603140830,MCWP 50R,A00,518791,Staff,0,0,20,20
1714603140830,MCWP 50R,B00,518792,Staff,0,2,20,20
1714603140830,MCWP 50R,C00,518793,Staff,0,2,20,20
1714603140830,MCWP 50R,D00,518794,Staff,0,0,20,20
1714603140830,MCWP 50R,E00,518795,Staff,0,2,20,20
1714603140830,MCWP 50R,F00,518796,Staff,0,0,20,20
1714603140830,MCWP 50R,G00,518797,Staff,0,1,20,20
1714603141861,MMW 12R,A01,514034,Herbst; Matthew,0,0,16,16
1714603141861,MMW 12R,A02,514035,Herbst; Matthew,1,0,16,15
1714603142887,MMW 13R,A01,514037,Staff,0,4,16,16
1714603142887,MMW 13R,A02,514039,Staff,0,2,16,16
1714603142887,MMW 13R,A03,628519,Staff,0,2,16,16
1714603144946,SIO 295LS,A00,523233,Staff,10,0,30,20
1714603145971,SIO 295S,A00,523232,Staff,10,0,30,20
1714603147004,SIOC 290S,A01,637330,Merrifield; Mark A,23,0,30,7
1714603148033,SIOC 291S,A01,637333,Gabriel; Corey John,23,0,30,7
1714603149059,SOCI 117,A01,494376,Staff,0,4,5,5
1714603150084,WES 237B,A00,494380,Staff,9,0,20,11
1714603152154,AESE 279B,A00,494370,Wade; Jon P,0,0,33,33
1714603153180,AIP 197,001,627712,Vespa; Emanuel Ignacio,9998,0,9999,1
1714603154205,ANAR 135S,A00,494369,Braswell; Geoffrey E.,0,0,0,0
1714603155230,BENG 196,001,628496,Engler; Adam J.,9998,0,9999,1
1714603156258,CAT 124RS,A01,519847,Geibel; William,0,0,20,20
1714603157285,CAT 125RS,A01,515971,Geibel; William,0,0,20,20
1714603158309,CLRE 250,A00,511389,Morris; Sheldon,9993,0,9999,6
1714603159335,CLRE 251,A00,507176,Mehta; Ravindra L.,9993,0,9999,6
1714603159335,CLRE 251,B00,511410,Mehta; Ravindra L.,9998,0,9999,1
1714603160359,CLRE 252,A00,507189,Cuomo; Raphael Eduardo,9995,0,9999,4
1714603161391,CLRE 253,A00,507199,Vaida; Florin,9994,0,9999,5
1714603161391,CLRE 253,B00,507202,Vaida; Florin,9999,0,9999,0
1714603162416,CLRE 259,A00,507211,Patel; Hemal,9996,0,9999,3
1714603163442,CLRE 260,A00,507221,Cuomo; Raphael Eduardo,9999,0,9999,0
1714603164472,CLRE 297,001,507242,Cuomo; Raphael Eduardo,9999,0,9999,0
1714603165499,COGS 197,001,638244,Voytek; Bradley Thomas,9998,0,9999,1
1714603166524,CSE 191,A00,516875,Minnes Kemp; Mor Mia,9993,0,9999,6
1714603167550,CSE 197,001,637388,Minnes Kemp; Mor Mia,9998,0,9999,1
1714603168576,CSS 201S,A01,494383,Staff,35,0,35,0
1714603169606,CSS 202S,A01,494387,Staff,35,0,35,0
1714603170630,DSC 197,001,628532,Eldridge; Justin Matthew,9996,0,9999,3
1714603171654,EAP 100,A00,516065,Staff,9797,0,9999,202
1714603172685,ECE 45,A01,507414,Staff,33,0,60,27
1714603174740,ECE 111,A01,507420,Staff,15,0,50,35
1714603175765,ECE 197,001,548057,Sievenpiper; Daniel F.,9993,0,9999,6
1714603176792,EDS 115,A00,507243,Choi; Bailey Miyeon,10,0,28,18
1714603177816,EDS 117,A01,494379,Staff,1,5,30,29
1714603178845,EDS 125,A00,507246,Hopkins; Megan Beth,9,0,30,21
1714603179873,EDS 128A,A01,507264,Fargason; Sharon Gayle,8,0,26,18
1714603180901,EDS 128B,A01,507293,Pappas; Elizabeth,12,0,30,18
1714603181927,EDS 139,A00,507294,Fargason; Sharon Gayle,13,0,30,17
1714603181927,EDS 139,B00,507313,Pappas; Elizabeth,13,0,30,17
1714603182953,EDS 201,A00,507315,Staff,13,0,30,17
1714603183977,EDS 203,A01,507317,Halter; Christopher P.,12,0,30,18
1714603185001,EDS 204R,A01,507319,Halter; Christopher P.,0,3,30,30
1714603185001,EDS 204R,B01,507331,Heinzman; Erica M.,16,0,30,14
1714603186030,EDS 206R,A00,507332,Staff,0,4,30,30
1714603186030,EDS 206R,B00,507343,Staff,17,0,30,13
1714603187054,EDS 250,A00,507344,Hemans; Patricia Ann Benitez,22,0,40,18
1714603188079,EDS 281,A00,507345,Daly; Alan J.,18,0,18,0
1714603189105,EDS 284,A00,507350,Daly; Alan J.,16,0,16,0
1714603190135,EDS 286,A00,507359,Fine; Sarah,18,0,18,0
1714603191159,EDS 289C,A01,507361,Daly; Alan J.,18,0,18,0
1714603192189,EDS 290,A00,507366,Hofstetter; Carolyn,15,0,15,0
1714603193215,LIGM 5A,A00,507421,Fischer-Grunski; Eva K,18,0,20,2
1714603194240,LIGM 5B,A00,507423,Fischer-Grunski; Eva K,19,0,20,1
1714603195270,LIGM 5C,A00,507425,Fischer-Grunski; Eva K,19,0,20,1
1714603196294,LIIT 5AS,A00,507427,Carnelos; Chiara,20,0,20,0
1714603197322,LIIT 5BS,A00,507430,Carnelos; Chiara,20,0,20,0
1714603198348,LIIT 5CS,A00,507432,Carnelos; Chiara,20,0,20,0
1714603199378,LISP 5A,A00,507541,Munoz Sanchez; Alicia,11,0,20,9
1714603200408,LISP 5B,A00,507671,Munoz Sanchez; Alicia,8,0,20,12
1714603201433,LISP 5C,A00,507696,Munoz Sanchez; Alicia,9,0,20,11
1714603202461,MAE 197,001,528363,Boechler; Nicholas Sebastia,9998,0,9999,1
1714603203489,MATH 197,001,523477,Kedlaya; Kiran S.,9995,0,9999,4
1714603203489,MATH 197,002,563811,Zhang; Danna,9995,0,9999,4
1714603203489,MATH 197,003,628552,Dumitriu; Ioana,9998,0,9999,1
1714603204514,MCWP 40R,A00,518780,Staff,2,0,20,18
1714603204514,MCWP 40R,B00,518781,Staff,8,0,20,12
1714603204514,MCWP 40R,C00,518783,Staff,6,0,20,14
1714603205545,MCWP 50R,A00,518791,Staff,0,0,20,20
1714603205545,MCWP 50R,B00,518792,Staff,0,2,20,20
1714603205545,MCWP 50R,C00,518793,Staff,0,2,20,20
1714603205545,MCWP 50R,D00,518794,Staff,0,0,20,20
1714603205545,MCWP 50R,E00,518795,Staff,0,2,20,20
1714603205545,MCWP 50R,F00,518796,Staff,0,0,20,20
1714603205545,MCWP 50R,G00,518797,Staff,0,1,20,20
1714603206570,MMW 12R,A01,514034,Herbst; Matthew,0,0,16,16
1714603206570,MMW 12R,A02,514035,Herbst; Matthew,1,0,16,15
1714603207594,MMW 13R,A01,514037,Staff,0,4,16,16
1714603207594,MMW 13R,A02,514039,Staff,0,2,16,16
1714603207594,MMW 13R,A03,628519,Staff,0,2,16,16
1714603209645,SIO 295LS,A00,523233,Staff,10,0,30,20
1714603210670,SIO 295S,A00,523232,Staff,10,0,30,20
1714603211696,SIOC 290S,A01,637330,Merrifield; Mark A,23,0,30,7
1714603212729,SIOC 291S,A01,637333,Gabriel; Corey John,23,0,30,7
1714603213760,SOCI 117,A01,494376,Staff,0,4,5,5
1714603214785,WES 237B,A00,494380,Staff,9,0,20,11
1714603216869,AESE 279B,A00,494370,Wade; Jon P,0,0,33,33
1714603217897,AIP 197,001,627712,Vespa; Emanuel Ignacio,9998,0,9999,1
1714603218922,ANAR 135S,A00,494369,Braswell; Geoffrey E.,0,0,0,0
1714603219949,BENG 196,001,628496,Engler; Adam J.,9998,0,9999,1
1714603220975,CAT 124RS,A01,519847,Geibel; William,0,0,20,20
1714603222001,CAT 125RS,A01,515971,Geibel; William,0,0,20,20
1714603223025,CLRE 250,A00,511389,Morris; Sheldon,9993,0,9999,6
1714603224070,CLRE 251,A00,507176,Mehta; Ravindra L.,9993,0,9999,6
1714603224070,CLRE 251,B00,511410,Mehta; Ravindra L.,9998,0,9999,1
1714603225094,CLRE 252,A00,507189,Cuomo; Raphael Eduardo,9995,0,9999,4
1714603226123,CLRE 253,A00,507199,Vaida; Florin,9994,0,9999,5
1714603226123,CLRE 253,B00,507202,Vaida; Florin,9999,0,9999,0
1714603227149,CLRE 259,A00,507211,Patel; Hemal,9996,0,9999,3
1714603228174,CLRE 260,A00,507221,Cuomo; Raphael Eduardo,9999,0,9999,0
1714603229202,CLRE 297,001,507242,Cuomo; Raphael Eduardo,9999,0,9999,0
1714603230226,COGS 197,001,638244,Voytek; Bradley Thomas,9998,0,9999,1
1714603231256,CSE 191,A00,516875,Minnes Kemp; Mor Mia,9993,0,9999,6
1714603232281,CSE 197,001,637388,Minnes Kemp; Mor Mia,9998,0,9999,1
1714603233306,CSS 201S,A01,494383,Staff,35,0,35,0
1714603234334,CSS 202S,A01,494387,Staff,35,0,35,0
1714603235359,DSC 197,001,628532,Eldridge; Justin Matthew,9996,0,9999,3
1714603236384,EAP 100,A00,516065,Staff,9797,0,9999,202
1714603237414,ECE 45,A01,507414,Staff,33,0,60,27
1714603239473,ECE 111,A01,507420,Staff,15,0,50,35
1714603240499,ECE 197,001,548057,Sievenpiper; Daniel F.,9993,0,9999,6
1714603241531,EDS 115,A00,507243,Choi; Bailey Miyeon,10,0,28,18
1714603242560,EDS 117,A01,494379,Staff,1,5,30,29
1714603243585,EDS 125,A00,507246,Hopkins; Megan Beth,9,0,30,21
1714603244614,EDS 128A,A01,507264,Fargason; Sharon Gayle,8,0,26,18
1714603245643,EDS 128B,A01,507293,Pappas; Elizabeth,12,0,30,18
1714603246667,EDS 139,A00,507294,Fargason; Sharon Gayle,13,0,30,17
1714603246667,EDS 139,B00,507313,Pappas; Elizabeth,13,0,30,17
1714603247689,EDS 201,A00,507315,Staff,13,0,30,17
1714603248723,EDS 203,A01,507317,Halter; Christopher P.,12,0,30,18
1714603249750,EDS 204R,A01,507319,Halter; Christopher P.,0,3,30,30
1714603249750,EDS 204R,B01,507331,Heinzman; Erica M.,16,0,30,14
1714603250778,EDS 206R,A00,507332,Staff,0,4,30,30
1714603250778,EDS 206R,B00,507343,Staff,17,0,30,13
1714603251808,EDS 250,A00,507344,Hemans; Patricia Ann Benitez,22,0,40,18
1714603252832,EDS 281,A00,507345,Daly; Alan J.,18,0,18,0
1714603253856,EDS 284,A00,507350,Daly; Alan J.,16,0,16,0
1714603254883,EDS 286,A00,507359,Fine; Sarah,18,0,18,0
1714603255907,EDS 289C,A01,507361,Daly; Alan J.,18,0,18,0
1714603256933,EDS 290,A00,507366,Hofstetter; Carolyn,15,0,15,0
1714603257960,LIGM 5A,A00,507421,Fischer-Grunski; Eva K,18,0,20,2
1714603258985,LIGM 5B,A00,507423,Fischer-Grunski; Eva K,19,0,20,1
1714603260013,LIGM 5C,A00,507425,Fischer-Grunski; Eva K,19,0,20,1
1714603261038,LIIT 5AS,A00,507427,Carnelos; Chiara,20,0,20,0
1714603262063,LIIT 5BS,A00,507430,Carnelos; Chiara,20,0,20,0
1714603263094,LIIT 5CS,A00,507432,Carnelos; Chiara,20,0,20,0
1714603264120,LISP 5A,A00,507541,Munoz Sanchez; Alicia,11,0,20,9
1714603265144,LISP 5B,A00,507671,Munoz Sanchez; Alicia,8,0,20,12
1714603266178,LISP 5C,A00,507696,Munoz Sanchez; Alicia,9,0,20,11
1714603267204,MAE 197,001,528363,Boechler; Nicholas Sebastia,9998,0,9999,1
1714603268231,MATH 197,001,523477,Kedlaya; Kiran S.,9995,0,9999,4
1714603268231,MATH 197,002,563811,Zhang; Danna,9995,0,9999,4
1714603268231,MATH 197,003,628552,Dumitriu; Ioana,9998,0,9999,1
1714603269256,MCWP 40R,A00,518780,Staff,2,0,20,18
1714603269256,MCWP 40R,B00,518781,Staff,8,0,20,12
1714603269256,MCWP 40R,C00,518783,Staff,6,0,20,14
1714603270282,MCWP 50R,A00,518791,Staff,0,0,20,20
1714603270282,MCWP 50R,B00,518792,Staff,0,2,20,20
1714603270282,MCWP 50R,C00,518793,Staff,0,2,20,20
1714603270282,MCWP 50R,D00,518794,Staff,0,0,20,20
1714603270282,MCWP 50R,E00,518795,Staff,0,2,20,20
1714603270282,MCWP 50R,F00,518796,Staff,0,0,20,20
1714603270282,MCWP 50R,G00,518797,Staff,0,1,20,20
1714603271312,MMW 12R,A01,514034,Herbst; Matthew,0,0,16,16
1714603271312,MMW 12R,A02,514035,Herbst; Matthew,1,0,16,15
1714603272337,MMW 13R,A01,514037,Staff,0,4,16,16
1714603272337,MMW 13R,A02,514039,Staff,0,2,16,16
1714603272337,MMW 13R,A03,628519,Staff,0,2,16,16
1714603274394,SIO 295LS,A00,523233,Staff,10,0,30,20
1714603275419,SIO 295S,A00,523232,Staff,10,0,30,20
1714603276450,SIOC 290S,A01,637330,Merrifield; Mark A,23,0,30,7
1714603277479,SIOC 291S,A01,637333,Gabriel; Corey John,23,0,30,7
1714603278504,SOCI 117,A01,494376,Staff,0,4,5,5
1714603279533,WES 237B,A00,494380,Staff,9,0,20,11
1714603281614,AESE 279B,A00,494370,Wade; Jon P,0,0,33,33
1714603282639,AIP 197,001,627712,Vespa; Emanuel Ignacio,9998,0,9999,1
1714603283667,ANAR 135S,A00,494369,Braswell; Geoffrey E.,0,0,0,0
1714603284694,BENG 196,001,628496,Engler; Adam J.,9998,0,9999,1
1714603285719,CAT 124RS,A01,519847,Geibel; William,0,0,20,20
1714603286748,CAT 125RS,A01,515971,Geibel; William,0,0,20,20
1714603287773,CLRE 250,A00,511389,Morris; Sheldon,9993,0,9999,6
1714603288804,CLRE 251,A00,507176,Mehta; Ravindra L.,9993,0,9999,6
1714603288804,CLRE 251,B00,511410,Mehta; Ravindra L.,9998,0,9999,1
1714603289830,CLRE 252,A00,507189,Cuomo; Raphael Eduardo,9995,0,9999,4
1714603290859,CLRE 253,A00,507199,Vaida; Florin,9994,0,9999,5
1714603290859,CLRE 253,B00,507202,Vaida; Florin,9999,0,9999,0
1714603291889,CLRE 259,A00,507211,Patel; Hemal,9996,0,9999,3
1714603292915,CLRE 260,A00,507221,Cuomo; Raphael Eduardo,9999,0,9999,0
1714603293946,CLRE 297,001,507242,Cuomo; Raphael Eduardo,9999,0,9999,0
1714603294975,COGS 197,001,638244,Voytek; Bradley Thomas,9998,0,9999,1
1714603296000,CSE 191,A00,516875,Minnes Kemp; Mor Mia,9993,0,9999,6
1714603297026,CSE 197,001,637388,Minnes Kemp; Mor Mia,9998,0,9999,1
1714603298055,CSS 201S,A01,494383,Staff,35,0,35,0
1714603299080,CSS 202S,A01,494387,Staff,35,0,35,0
1714603300106,DSC 197,001,628532,Eldridge; Justin Matthew,9996,0,9999,3
1714603301132,EAP 100,A00,516065,Staff,9797,0,9999,202
1714603302158,ECE 45,A01,507414,Staff,33,0,60,27
1714603304213,ECE 111,A01,507420,Staff,15,0,50,35
1714603305237,ECE 197,001,548057,Sievenpiper; Daniel F.,9993,0,9999,6
1714603306268,EDS 115,A00,507243,Choi; Bailey Miyeon,10,0,28,18
1714603307293,EDS 117,A01,494379,Staff,1,5,30,29
1714603308323,EDS 125,A00,507246,Hopkins; Megan Beth,9,0,30,21
1714603309348,EDS 128A,A01,507264,Fargason; Sharon Gayle,8,0,26,18
1714603310375,EDS 128B,A01,507293,Pappas; Elizabeth,12,0,30,18
1714603311402,EDS 139,A00,507294,Fargason; Sharon Gayle,13,0,30,17
1714603311402,EDS 139,B00,507313,Pappas; Elizabeth,13,0,30,17
1714603312425,EDS 201,A00,507315,Staff,13,0,30,17
1714603313453,EDS 203,A01,507317,Halter; Christopher P.,12,0,30,18
1714603314478,EDS 204R,A01,507319,Halter; Christopher P.,0,3,30,30
1714603314478,EDS 204R,B01,507331,Heinzman; Erica M.,16,0,30,14
1714603315504,EDS 206R,A00,507332,Staff,0,4,30,30
1714603315504,EDS 206R,B00,507343,Staff,17,0,30,13
1714603316528,EDS 250,A00,507344,Hemans; Patricia Ann Benitez,22,0,40,18
1714603317557,EDS 281,A00,507345,Daly; Alan J.,18,0,18,0
1714603318588,EDS 284,A00,507350,Daly; Alan J.,16,0,16,0
1714603319618,EDS 286,A00,507359,Fine; Sarah,18,0,18,0
1714603320648,EDS 289C,A01,507361,Daly; Alan J.,18,0,18,0
1714603321676,EDS 290,A00,507366,Hofstetter; Carolyn,15,0,15,0
1714603322706,LIGM 5A,A00,507421,Fischer-Grunski; Eva K,18,0,20,2
1714603323731,LIGM 5B,A00,507423,Fischer-Grunski; Eva K,19,0,20,1
1714603324760,LIGM 5C,A00,507425,Fischer-Grunski; Eva K,19,0,20,1
1714603325789,LIIT 5AS,A00,507427,Carnelos; Chiara,20,0,20,0
1714603326813,LIIT 5BS,A00,507430,Carnelos; Chiara,20,0,20,0
1714603340260,LIIT 5CS,A00,507432,Carnelos; Chiara,20,0,20,0
1714603341290,LISP 5A,A00,507541,Munoz Sanchez; Alicia,11,0,20,9
1714603342315,LISP 5B,A00,507671,Munoz Sanchez; Alicia,8,0,20,12
1714603343345,LISP 5C,A00,507696,Munoz Sanchez; Alicia,9,0,20,11
1714603344370,MAE 197,001,528363,Boechler; Nicholas Sebastia,9998,0,9999,1
1714603345399,MATH 197,001,523477,Kedlaya; Kiran S.,9995,0,9999,4
1714603345399,MATH 197,002,563811,Zhang; Danna,9995,0,9999,4
1714603345399,MATH 197,003,628552,Dumitriu; Ioana,9998,0,9999,1
1714603346426,MCWP 40R,A00,518780,Staff,2,0,20,18
1714603346426,MCWP 40R,B00,518781,Staff,8,0,20,12
1714603346426,MCWP 40R,C00,518783,Staff,6,0,20,14
1714603347456,MCWP 50R,A00,518791,Staff,0,0,20,20
1714603347456,MCWP 50R,B00,518792,Staff,0,2,20,20
1714603347456,MCWP 50R,C00,518793,Staff,0,2,20,20
1714603347456,MCWP 50R,D00,518794,Staff,0,0,20,20
1714603347456,MCWP 50R,E00,518795,Staff,0,2,20,20
1714603347456,MCWP 50R,F00,518796,Staff,0,0,20,20
1714603347456,MCWP 50R,G00,518797,Staff,0,1,20,20
1714603348484,MMW 12R,A01,514034,Herbst; Matthew,0,0,16,16
1714603348484,MMW 12R,A02,514035,Herbst; Matthew,1,0,16,15
1714603349508,MMW 13R,A01,514037,Staff,0,4,16,16
1714603349508,MMW 13R,A02,514039,Staff,0,2,16,16
1714603349508,MMW 13R,A03,628519,Staff,0,2,16,16
1714603351563,SIO 295LS,A00,523233,Staff,10,0,30,20
1714603352592,SIO 295S,A00,523232,Staff,10,0,30,20
1714603353621,SIOC 290S,A01,637330,Merrifield; Mark A,23,0,30,7
1714603354645,SIOC 291S,A01,637333,Gabriel; Corey John,23,0,30,7
1714603355670,SOCI 117,A01,494376,Staff,0,4,5,5
1714603356698,WES 237B,A00,494380,Staff,9,0,20,11
1714603358778,AESE 279B,A00,494370,Wade; Jon P,0,0,33,33
1714603359802,AIP 197,001,627712,Vespa; Emanuel Ignacio,9998,0,9999,1
1714603360827,ANAR 135S,A00,494369,Braswell; Geoffrey E.,0,0,0,0
1714603361852,BENG 196,001,628496,Engler; Adam J.,9998,0,9999,1
1714603362878,CAT 124RS,A01,519847,Geibel; William,0,0,20,20
1714603364921,CAT 125RS,A01,515971,Geibel; William,0,0,20,20
1714603365946,CLRE 250,A00,511389,Morris; Sheldon,9993,0,9999,6
1714603366971,CLRE 251,A00,507176,Mehta; Ravindra L.,9993,0,9999,6
1714603366971,CLRE 251,B00,511410,Mehta; Ravindra L.,9998,0,9999,1
1714603367998,CLRE 252,A00,507189,Cuomo; Raphael Eduardo,9995,0,9999,4
1714603369022,CLRE 253,A00,507199,Vaida; Florin,9994,0,9999,5
1714603369022,CLRE 253,B00,507202,Vaida; Florin,9999,0,9999,0
1714603370048,CLRE 259,A00,507211,Patel; Hemal,9996,0,9999,3
1714603371072,CLRE 260,A00,507221,Cuomo; Raphael Eduardo,9999,0,9999,0
1714603372098,CLRE 297,001,507242,Cuomo; Raphael Eduardo,9999,0,9999,0
1714603373125,COGS 197,001,638244,Voytek; Bradley Thomas,9998,0,9999,1
1714603374151,CSE 191,A00,516875,Minnes Kemp; Mor Mia,9993,0,9999,6
1714603375177,CSE 197,001,637388,Minnes Kemp; Mor Mia,9998,0,9999,1
1714603376205,CSS 201S,A01,494383,Staff,35,0,35,0
1714603377237,CSS 202S,A01,494387,Staff,35,0,35,0
1714603378266,DSC 197,001,628532,Eldridge; Justin Matthew,9996,0,9999,3
1714603379290,EAP 100,A00,516065,Staff,9797,0,9999,202
1714603380315,ECE 45,A01,507414,Staff,33,0,60,27
1714603382370,ECE 111,A01,507420,Staff,15,0,50,35
1714603383395,ECE 197,001,548057,Sievenpiper; Daniel F.,9993,0,9999,6
1714603384421,EDS 115,A00,507243,Choi; Bailey Miyeon,10,0,28,18
1714603385447,EDS 117,A01,494379,Staff,1,5,30,29
1714603386472,EDS 125,A00,507246,Hopkins; Megan Beth,9,0,30,21
1714603387497,EDS 128A,A01,507264,Fargason; Sharon Gayle,8,0,26,18
1714603388526,EDS 128B,A01,507293,Pappas; Elizabeth,12,0,30,18
1714603389551,EDS 139,A00,507294,Fargason; Sharon Gayle,13,0,30,17
1714603389551,EDS 139,B00,507313,Pappas; Elizabeth,13,0,30,17
1714603390575,EDS 201,A00,507315,Staff,13,0,30,17
1714603391600,EDS 203,A01,507317,Halter; Christopher P.,12,0,30,18
1714603392629,EDS 204R,A01,507319,Halter; Christopher P.,0,3,30,30
1714603392629,EDS 204R,B01,507331,Heinzman; Erica M.,16,0,30,14
1714603393658,EDS 206R,A00,507332,Staff,0,4,30,30
1714603393658,EDS 206R,B00,507343,Staff,17,0,30,13
1714603394683,EDS 250,A00,507344,Hemans; Patricia Ann Benitez,22,0,40,18
1714603395713,EDS 281,A00,507345,Daly; Alan J.,18,0,18,0
1714603396738,EDS 284,A00,507350,Daly; Alan J.,16,0,16,0
1714603397768,EDS 286,A00,507359,Fine; Sarah,18,0,18,0
1714603398797,EDS 289C,A01,507361,Daly; Alan J.,18,0,18,0
1714603399824,EDS 290,A00,507366,Hofstetter; Carolyn,15,0,15,0
1714603400854,LIGM 5A,A00,507421,Fischer-Grunski; Eva K,18,0,20,2
1714603401881,LIGM 5B,A00,507423,Fischer-Grunski; Eva K,19,0,20,1
1714603402905,LIGM 5C,A00,507425,Fischer-Grunski; Eva K,19,0,20,1
1714603403933,LIIT 5AS,A00,507427,Carnelos; Chiara,20,0,20,0
1714603404959,LIIT 5BS,A00,507430,Carnelos; Chiara,20,0,20,0
1714603405982,LIIT 5CS,A00,507432,Carnelos; Chiara,20,0,20,0
1714603407008,LISP 5A,A00,507541,Munoz Sanchez; Alicia,11,0,20,9
1714603408033,LISP 5B,A00,507671,Munoz Sanchez; Alicia,8,0,20,12
1714603409059,LISP 5C,A00,507696,Munoz Sanchez; Alicia,9,0,20,11
1714603410086,MAE 197,001,528363,Boechler; Nicholas Sebastia,9998,0,9999,1
1714603411115,MATH 197,001,523477,Kedlaya; Kiran S.,9995,0,9999,4
1714603411115,MATH 197,002,563811,Zhang; Danna,9995,0,9999,4
1714603411115,MATH 197,003,628552,Dumitriu; Ioana,9998,0,9999,1
1714603412139,MCWP 40R,A00,518780,Staff,2,0,20,18
1714603412139,MCWP 40R,B00,518781,Staff,8,0,20,12
1714603412139,MCWP 40R,C00,518783,Staff,6,0,20,14
1714603413164,MCWP 50R,A00,518791,Staff,0,0,20,20
1714603413164,MCWP 50R,B00,518792,Staff,0,2,20,20
1714603413164,MCWP 50R,C00,518793,Staff,0,2,20,20
1714603413164,MCWP 50R,D00,518794,Staff,0,0,20,20
1714603413164,MCWP 50R,E00,518795,Staff,0,2,20,20
1714603413164,MCWP 50R,F00,518796,Staff,0,0,20,20
1714603413164,MCWP 50R,G00,518797,Staff,0,1,20,20
1714603414240,MMW 12R,A01,514034,Herbst; Matthew,0,0,16,16
1714603414240,MMW 12R,A02,514035,Herbst; Matthew,1,0,16,15
1714603415264,MMW 13R,A01,514037,Staff,0,4,16,16
1714603415264,MMW 13R,A02,514039,Staff,0,2,16,16
1714603415264,MMW 13R,A03,628519,Staff,0,2,16,16
1714603417319,SIO 295LS,A00,523233,Staff,10,0,30,20
1714603418347,SIO 295S,A00,523232,Staff,10,0,30,20
1714603419372,SIOC 290S,A01,637330,Merrifield; Mark A,23,0,30,7
1714603420397,SIOC 291S,A01,637333,Gabriel; Corey John,23,0,30,7
1714603421427,SOCI 117,A01,494376,Staff,0,4,5,5
1714603422451,WES 237B,A00,494380,Staff,9,0,20,11
1714603424521,AESE 279B,A00,494370,Wade; Jon P,0,0,33,33
1714603425545,AIP 197,001,627712,Vespa; Emanuel Ignacio,9998,0,9999,1
1714603426568,ANAR 135S,A00,494369,Braswell; Geoffrey E.,0,0,0,0
1714603427597,BENG 196,001,628496,Engler; Adam J.,9998,0,9999,1
1714603428623,CAT 124RS,A01,519847,Geibel; William,0,0,20,20
1714603429646,CAT 125RS,A01,515971,Geibel; William,0,0,20,20
1714603430674,CLRE 250,A00,511389,Morris; Sheldon,9993,0,9999,6
1714603431705,CLRE 251,A00,507176,Mehta; Ravindra L.,9993,0,9999,6
1714603431705,CLRE 251,B00,511410,Mehta; Ravindra L.,9998,0,9999,1
1714603432732,CLRE 252,A00,507189,Cuomo; Raphael Eduardo,9995,0,9999,4
1714603433757,CLRE 253,A00,507199,Vaida; Florin,9994,0,9999,5
1714603433757,CLRE 253,B00,507202,Vaida; Florin,9999,0,9999,0
1714603434785,CLRE 259,A00,507211,Patel; Hemal,9996,0,9999,3
1714603435811,CLRE 260,A00,507221,Cuomo; Raphael Eduardo,9999,0,9999,0
1714603436836,CLRE 297,001,507242,Cuomo; Raphael Eduardo,9999,0,9999,0
1714603437860,COGS 197,001,638244,Voytek; Bradley Thomas,9998,0,9999,1
1714603438887,CSE 191,A00,516875,Minnes Kemp; Mor Mia,9993,0,9999,6
1714603439912,CSE 197,001,637388,Minnes Kemp; Mor Mia,9998,0,9999,1
1714603440937,CSS 201S,A01,494383,Staff,35,0,35,0
1714603441961,CSS 202S,A01,494387,Staff,35,0,35,0
1714603442992,DSC 197,001,628532,Eldridge; Justin Matthew,9996,0,9999,3
1714603444015,EAP 100,A00,516065,Staff,9797,0,9999,202
1714603445042,ECE 45,A01,507414,Staff,33,0,60,27
1714603447100,ECE 111,A01,507420,Staff,15,0,50,35
1714603448125,ECE 197,001,548057,Sievenpiper; Daniel F.,9993,0,9999,6
1714603449154,EDS 115,A00,507243,Choi; Bailey Miyeon,10,0,28,18
1714603450184,EDS 117,A01,494379,Staff,1,5,30,29
1714603451219,EDS 125,A00,507246,Hopkins; Megan Beth,9,0,30,21
1714603452249,EDS 128A,A01,507264,Fargason; Sharon Gayle,8,0,26,18
1714603453278,EDS 128B,A01,507293,Pappas; Elizabeth,12,0,30,18
1714603454305,EDS 139,A00,507294,Fargason; Sharon Gayle,13,0,30,17
1714603454305,EDS 139,B00,507313,Pappas; Elizabeth,13,0,30,17
1714603455333,EDS 201,A00,507315,Staff,13,0,30,17
1714603456360,EDS 203,A01,507317,Halter; Christopher P.,12,0,30,18
1714603457391,EDS 204R,A01,507319,Halter; Christopher P.,0,3,30,30
1714603457391,EDS 204R,B01,507331,Heinzman; Erica M.,16,0,30,14
1714603458416,EDS 206R,A00,507332,Staff,0,4,30,30
1714603458416,EDS 206R,B00,507343,Staff,17,0,30,13
1714603459443,EDS 250,A00,507344,Hemans; Patricia Ann Benitez,22,0,40,18
1714603460469,EDS 281,A00,507345,Daly; Alan J.,18,0,18,0
1714603461495,EDS 284,A00,507350,Daly; Alan J.,16,0,16,0
1714603462520,EDS 286,A00,507359,Fine; Sarah,18,0,18,0
1714603463545,EDS 289C,A01,507361,Daly; Alan J.,18,0,18,0
1714603464574,EDS 290,A00,507366,Hofstetter; Carolyn,15,0,15,0
1714603465600,LIGM 5A,A00,507421,Fischer-Grunski; Eva K,18,0,20,2
1714603466623,LIGM 5B,A00,507423,Fischer-Grunski; Eva K,19,0,20,1
1714603467648,LIGM 5C,A00,507425,Fischer-Grunski; Eva K,19,0,20,1
1714603468677,LIIT 5AS,A00,507427,Carnelos; Chiara,20,0,20,0
1714603469707,LIIT 5BS,A00,507430,Carnelos; Chiara,20,0,20,0
1714603470731,LIIT 5CS,A00,507432,Carnelos; Chiara,20,0,20,0
1714603471761,LISP 5A,A00,507541,Munoz Sanchez; Alicia,11,0,20,9
1714603472790,LISP 5B,A00,507671,Munoz Sanchez; Alicia,8,0,20,12
1714603473815,LISP 5C,A00,507696,Munoz Sanchez; Alicia,9,0,20,11
1714603474845,MAE 197,001,528363,Boechler; Nicholas Sebastia,9998,0,9999,1
1714603475870,MATH 197,001,523477,Kedlaya; Kiran S.,9995,0,9999,4
1714603475870,MATH 197,002,563811,Zhang; Danna,9995,0,9999,4
1714603475870,MATH 197,003,628552,Dumitriu; Ioana,9998,0,9999,1
1714603476893,MCWP 40R,A00,518780,Staff,2,0,20,18
1714603476893,MCWP 40R,B00,518781,Staff,8,0,20,12
1714603476893,MCWP 40R,C00,518783,Staff,6,0,20,14
1714603477922,MCWP 50R,A00,518791,Staff,0,0,20,20
1714603477922,MCWP 50R,B00,518792,Staff,0,2,20,20
1714603477922,MCWP 50R,C00,518793,Staff,0,2,20,20
1714603477922,MCWP 50R,D00,518794,Staff,0,0,20,20
1714603477922,MCWP 50R,E00,518795,Staff,0,2,20,20
1714603477922,MCWP 50R,F00,518796,Staff,0,0,20,20
1714603477922,MCWP 50R,G00,518797,Staff,0,1,20,20
1714603478948,MMW 12R,A01,514034,Herbst; Matthew,0,0,16,16
1714603478948,MMW 12R,A02,514035,Herbst; Matthew,1,0,16,15
1714603479974,MMW 13R,A01,514037,Staff,0,4,16,16
1714603479974,MMW 13R,A02,514039,Staff,0,2,16,16
1714603479974,MMW 13R,A03,628519,Staff,0,2,16,16
1714603482023,SIO 295LS,A00,523233,Staff,10,0,30,20
1714603483047,SIO 295S,A00,523232,Staff,10,0,30,20
1714603484073,SIOC 290S,A01,637330,Merrifield; Mark A,23,0,30,7
1714603485101,SIOC 291S,A01,637333,Gabriel; Corey John,23,0,30,7
1714603486127,SOCI 117,A01,494376,Staff,0,4,5,5
1714603487155,WES 237B,A00,494380,Staff,9,0,20,11
1714603489225,AESE 279B,A00,494370,Wade; Jon P,0,0,33,33
1714603490322,AIP 197,001,627712,Vespa; Emanuel Ignacio,9998,0,9999,1
1714603491352,ANAR 135S,A00,494369,Braswell; Geoffrey E.,0,0,0,0
1714603492380,BENG 196,001,628496,Engler; Adam J.,9998,0,9999,1
1714603493406,CAT 124RS,A01,519847,Geibel; William,0,0,20,20
1714603494437,CAT 125RS,A01,515971,Geibel; William,0,0,20,20
1714603495466,CLRE 250,A00,511389,Morris; Sheldon,9993,0,9999,6
1714603496492,CLRE 251,A00,507176,Mehta; Ravindra L.,9993,0,9999,6
1714603496492,CLRE 251,B00,511410,Mehta; Ravindra L.,9998,0,9999,1
1714603497519,CLRE 252,A00,507189,Cuomo; Raphael Eduardo,9995,0,9999,4
1714603498545,CLRE 253,A00,507199,Vaida; Florin,9994,0,9999,5
1714603498545,CLRE 253,B00,507202,Vaida; Florin,9999,0,9999,0
1714603499572,CLRE 259,A00,507211,Patel; Hemal,9996,0,9999,3
1714603500600,CLRE 260,A00,507221,Cuomo; Raphael Eduardo,9999,0,9999,0
1714603501628,CLRE 297,001,507242,Cuomo; Raphael Eduardo,9999,0,9999,0
1714603502657,COGS 197,001,638244,Voytek; Bradley Thomas,9998,0,9999,1
1714603503681,CSE 191,A00,516875,Minnes Kemp; Mor Mia,9993,0,9999,6
1714603504708,CSE 197,001,637388,Minnes Kemp; Mor Mia,9998,0,9999,1
1714603505737,CSS 201S,A01,494383,Staff,35,0,35,0
1714603506765,CSS 202S,A01,494387,Staff,35,0,35,0
1714603507790,DSC 197,001,628532,Eldridge; Justin Matthew,9996,0,9999,3
1714603508816,EAP 100,A00,516065,Staff,9797,0,9999,202
1714603509843,ECE 45,A01,507414,Staff,33,0,60,27
1714603511894,ECE 111,A01,507420,Staff,15,0,50,35
1714603512922,ECE 197,001,548057,Sievenpiper; Daniel F.,9993,0,9999,6
1714603513953,EDS 115,A00,507243,Choi; Bailey Miyeon,10,0,28,18
1714603514983,EDS 117,A01,494379,Staff,1,5,30,29
1714603516009,EDS 125,A00,507246,Hopkins; Megan Beth,9,0,30,21
1714603517035,EDS 128A,A01,507264,Fargason; Sharon Gayle,8,0,26,18
1714603518063,EDS 128B,A01,507293,Pappas; Elizabeth,12,0,30,18
1714603519087,EDS 139,A00,507294,Fargason; Sharon Gayle,13,0,30,17
1714603519087,EDS 139,B00,507313,Pappas; Elizabeth,13,0,30,17
1714603520116,EDS 201,A00,507315,Staff,13,0,30,17
1714603521141,EDS 203,A01,507317,Halter; Christopher P.,12,0,30,18
1714603522171,EDS 204R,A01,507319,Halter; Christopher P.,0,3,30,30
1714603522171,EDS 204R,B01,507331,Heinzman; Erica M.,16,0,30,14
1714603523199,EDS 206R,A00,507332,Staff,0,4,30,30
1714603523199,EDS 206R,B00,507343,Staff,17,0,30,13
1714603524234,EDS 250,A00,507344,Hemans; Patricia Ann Benitez,22,0,40,18
1714603525262,EDS 281,A00,507345,Daly; Alan J.,18,0,18,0
1714603526291,EDS 284,A00,507350,Daly; Alan J.,16,0,16,0
1714603527318,EDS 286,A00,507359,Fine; Sarah,18,0,18,0
1714603528344,EDS 289C,A01,507361,Daly; Alan J.,18,0,18,0
1714603529372,EDS 290,A00,507366,Hofstetter; Carolyn,15,0,15,0
1714603530404,LIGM 5A,A00,507421,Fischer-Grunski; Eva K,18,0,20,2
1714603531431,LIGM 5B,A00,507423,Fischer-Grunski; Eva K,19,0,20,1
1714603532455,LIGM 5C,A00,507425,Fischer-Grunski; Eva K,19,0,20,1
1714603533479,LIIT 5AS,A00,507427,Carnelos; Chiara,20,0,20,0
1714603534504,LIIT 5BS,A00,507430,Carnelos; Chiara,20,0,20,0
1714603535530,LIIT 5CS,A00,507432,Carnelos; Chiara,20,0,20,0
1714603536559,LISP 5A,A00,507541,Munoz Sanchez; Alicia,11,0,20,9
1714603537587,LISP 5B,A00,507671,Munoz Sanchez; Alicia,8,0,20,12
1714603538615,LISP 5C,A00,507696,Munoz Sanchez; Alicia,9,0,20,11
1714603539640,MAE 197,001,528363,Boechler; Nicholas Sebastia,9998,0,9999,1
1714603540666,MATH 197,001,523477,Kedlaya; Kiran S.,9995,0,9999,4
1714603540666,MATH 197,002,563811,Zhang; Danna,9995,0,9999,4
1714603540666,MATH 197,003,628552,Dumitriu; Ioana,9998,0,9999,1
1714603541694,MCWP 40R,A00,518780,Staff,2,0,20,18
1714603541694,MCWP 40R,B00,518781,Staff,8,0,20,12
1714603541694,MCWP 40R,C00,518783,Staff,6,0,20,14
1714603542723,MCWP 50R,A00,518791,Staff,0,0,20,20
1714603542723,MCWP 50R,B00,518792,Staff,0,2,20,20
1714603542723,MCWP 50R,C00,518793,Staff,0,2,20,20
1714603542723,MCWP 50R,D00,518794,Staff,0,0,20,20
1714603542723,MCWP 50R,E00,518795,Staff,0,2,20,20
1714603542723,MCWP 50R,F00,518796,Staff,0,0,20,20
1714603542723,MCWP 50R,G00,518797,Staff,0,1,20,20
1714603543750,MMW 12R,A01,514034,Herbst; Matthew,0,0,16,16
1714603543750,MMW 12R,A02,514035,Herbst; Matthew,1,0,16,15
1714603544774,MMW 13R,A01,514037,Staff,0,4,16,16
1714603544774,MMW 13R,A02,514039,Staff,0,2,16,16
1714603544774,MMW 13R,A03,628519,Staff,0,2,16,16
1714603546828,SIO 295LS,A00,523233,Staff,10,0,30,20
1714603547852,SIO 295S,A00,523232,Staff,10,0,30,20
1714603548882,SIOC 290S,A01,637330,Merrifield; Mark A,23,0,30,7
1714603549911,SIOC 291S,A01,637333,Gabriel; Corey John,23,0,30,7
1714603550937,SOCI 117,A01,494376,Staff,0,4,5,5
1714603551961,WES 237B,A00,494380,Staff,9,0,20,11
1714603554034,AESE 279B,A00,494370,Wade; Jon P,0,0,33,33
1714603555059,AIP 197,001,627712,Vespa; Emanuel Ignacio,9998,0,9999,1
1714603556089,ANAR 135S,A00,494369,Braswell; Geoffrey E.,0,0,0,0
1714603557114,BENG 196,001,628496,Engler; Adam J.,9998,0,9999,1
1714603558149,CAT 124RS,A01,519847,Geibel; William,0,0,20,20
1714603559174,CAT 125RS,A01,515971,Geibel; William,0,0,20,20
1714603560197,CLRE 250,A00,511389,Morris; Sheldon,9993,0,9999,6
1714603561225,CLRE 251,A00,507176,Mehta; Ravindra L.,9993,0,9999,6
1714603561225,CLRE 251,B00,511410,Mehta; Ravindra L.,9998,0,9999,1
1714603562252,CLRE 252,A00,507189,Cuomo; Raphael Eduardo,9995,0,9999,4
1714603563278,CLRE 253,A00,507199,Vaida; Florin,9994,0,9999,5
1714603563278,CLRE 253,B00,507202,Vaida; Florin,9999,0,9999,0
1714603564323,CLRE 259,A00,507211,Patel; Hemal,9996,0,9999,3
1714603565350,CLRE 260,A00,507221,Cuomo; Raphael Eduardo,9999,0,9999,0
1714603566379,CLRE 297,001,507242,Cuomo; Raphael Eduardo,9999,0,9999,0
1714603567404,COGS 197,001,638244,Voytek; Bradley Thomas,9998,0,9999,1
1714603568432,CSE 191,A00,516875,Minnes Kemp; Mor Mia,9993,0,9999,6
1714603569461,CSE 197,001,637388,Minnes Kemp; Mor Mia,9998,0,9999,1
1714603570485,CSS 201S,A01,494383,Staff,35,0,35,0
1714603571512,CSS 202S,A01,494387,Staff,35,0,35,0
1714603572543,DSC 197,001,628532,Eldridge; Justin Matthew,9996,0,9999,3
1714603573568,EAP 100,A00,516065,Staff,9797,0,9999,202
1714603574598,ECE 45,A01,507414,Staff,33,0,60,27
1714603576653,ECE 111,A01,507420,Staff,15,0,50,35
1714603577678,ECE 197,001,548057,Sievenpiper; Daniel F.,9993,0,9999,6
1714603578705,EDS 115,A00,507243,Choi; Bailey Miyeon,10,0,28,18
1714603579736,EDS 117,A01,494379,Staff,1,5,30,29
1714603580761,EDS 125,A00,507246,Hopkins; Megan Beth,9,0,30,21
1714603581812,EDS 128A,A01,507264,Fargason; Sharon Gayle,8,0,26,18
1714603582844,EDS 128B,A01,507293,Pappas; Elizabeth,12,0,30,18
1714603583872,EDS 139,A00,507294,Fargason; Sharon Gayle,13,0,30,17
1714603583872,EDS 139,B00,507313,Pappas; Elizabeth,13,0,30,17
1714603584903,EDS 201,A00,507315,Staff,13,0,30,17
1714603585929,EDS 203,A01,507317,Halter; Christopher P.,12,0,30,18
1714603586958,EDS 204R,A01,507319,Halter; Christopher P.,0,3,30,30
1714603586958,EDS 204R,B01,507331,Heinzman; Erica M.,16,0,30,14
1714603587985,EDS 206R,A00,507332,Staff,0,4,30,30
1714603587985,EDS 206R,B00,507343,Staff,17,0,30,13
1714603589015,EDS 250,A00,507344,Hemans; Patricia Ann Benitez,22,0,40,18
1714603590044,EDS 281,A00,507345,Daly; Alan J.,18,0,18,0
1714603591069,EDS 284,A00,507350,Daly; Alan J.,16,0,16,0
1714603592097,EDS 286,A00,507359,Fine; Sarah,18,0,18,0
1714603593121,EDS 289C,A01,507361,Daly; Alan J.,18,0,18,0
1714603594147,EDS 290,A00,507366,Hofstetter; Carolyn,15,0,15,0
1714603595174,LIGM 5A,A00,507421,Fischer-Grunski; Eva K,18,0,20,2
1714603596204,LIGM 5B,A00,507423,Fischer-Grunski; Eva K,19,0,20,1
1714603597228,LIGM 5C,A00,507425,Fischer-Grunski; Eva K,19,0,20,1
1714603598255,LIIT 5AS,A00,507427,Carnelos; Chiara,20,0,20,0
1714603599284,LIIT 5BS,A00,507430,Carnelos; Chiara,20,0,20,0
1714603600308,LIIT 5CS,A00,507432,Carnelos; Chiara,20,0,20,0
1714603601336,LISP 5A,A00,507541,Munoz Sanchez; Alicia,11,0,20,9
1714603602360,LISP 5B,A00,507671,Munoz Sanchez; Alicia,8,0,20,12
1714603603386,LISP 5C,A00,507696,Munoz Sanchez; Alicia,9,0,20,11
1714603604410,MAE 197,001,528363,Boechler; Nicholas Sebastia,9998,0,9999,1
1714603605444,MATH 197,001,523477,Kedlaya; Kiran S.,9995,0,9999,4
1714603605444,MATH 197,002,563811,Zhang; Danna,9995,0,9999,4
1714603605444,MATH 197,003,628552,Dumitriu; Ioana,9998,0,9999,1
1714603606469,MCWP 40R,A00,518780,Staff,2,0,20,18
1714603606469,MCWP 40R,B00,518781,Staff,8,0,20,12
1714603606469,MCWP 40R,C00,518783,Staff,6,0,20,14
1714603607494,MCWP 50R,A00,518791,Staff,0,0,20,20
1714603607494,MCWP 50R,B00,518792,Staff,0,2,20,20
1714603607494,MCWP 50R,C00,518793,Staff,0,2,20,20
1714603607494,MCWP 50R,D00,518794,Staff,0,0,20,20
1714603607494,MCWP 50R,E00,518795,Staff,0,2,20,20
1714603607494,MCWP 50R,F00,518796,Staff,0,0,20,20
1714603607494,MCWP 50R,G00,518797,Staff,0,1,20,20
1714603608525,MMW 12R,A01,514034,Herbst; Matthew,0,0,16,16
1714603608525,MMW 12R,A02,514035,Herbst; Matthew,1,0,16,15
1714603609550,MMW 13R,A01,514037,Staff,0,4,16,16
1714603609550,MMW 13R,A02,514039,Staff,0,2,16,16
1714603609550,MMW 13R,A03,628519,Staff,0,2,16,16
1714603611603,SIO 295LS,A00,523233,Staff,10,0,30,20
1714603612630,SIO 295S,A00,523232,Staff,10,0,30,20
1714603613661,SIOC 290S,A01,637330,Merrifield; Mark A,23,0,30,7
1714603614687,SIOC 291S,A01,637333,Gabriel; Corey John,23,0,30,7
1714603615713,SOCI 117,A01,494376,Staff,0,4,5,5
1714603616740,WES 237B,A00,494380,Staff,9,0,20,11
1714603618811,AESE 279B,A00,494370,Wade; Jon P,0,0,33,33
1714603619837,AIP 197,001,627712,Vespa; Emanuel Ignacio,9998,0,9999,1
1714603620862,ANAR 135S,A00,494369,Braswell; Geoffrey E.,0,0,0,0
1714603621885,BENG 196,001,628496,Engler; Adam J.,9998,0,9999,1
1714603622916,CAT 124RS,A01,519847,Geibel; William,0,0,20,20
1714603623942,CAT 125RS,A01,515971,Geibel; William,0,0,20,20
1714603624969,CLRE 250,A00,511389,Morris; Sheldon,9993,0,9999,6
1714603626003,CLRE 251,A00,507176,Mehta; Ravindra L.,9993,0,9999,6
1714603626003,CLRE 251,B00,511410,Mehta; Ravindra L.,9998,0,9999,1
1714603627031,CLRE 252,A00,507189,Cuomo; Raphael Eduardo,9995,0,9999,4
1714603628057,CLRE 253,A00,507199,Vaida; Florin,9994,0,9999,5
1714603628057,CLRE 253,B00,507202,Vaida; Florin,9999,0,9999,0
1714603629082,CLRE 259,A00,507211,Patel; Hemal,9996,0,9999,3
1714603630106,CLRE 260,A00,507221,Cuomo; Raphael Eduardo,9999,0,9999,0
1714603631131,CLRE 297,001,507242,Cuomo; Raphael Eduardo,9999,0,9999,0
1714603632160,COGS 197,001,638244,Voytek; Bradley Thomas,9998,0,9999,1
1714603633185,CSE 191,A00,516875,Minnes Kemp; Mor Mia,9993,0,9999,6
1714603634213,CSE 197,001,637388,Minnes Kemp; Mor Mia,9998,0,9999,1
1714603635238,CSS 201S,A01,494383,Staff,35,0,35,0
1714603636263,CSS 202S,A01,494387,Staff,35,0,35,0
1714603637287,DSC 197,001,628532,Eldridge; Justin Matthew,9996,0,9999,3
1714603638316,EAP 100,A00,516065,Staff,9797,0,9999,202
1714603639342,ECE 45,A01,507414,Staff,33,0,60,27
1714603641396,ECE 111,A01,507420,Staff,15,0,50,35
1714603642423,ECE 197,001,548057,Sievenpiper; Daniel F.,9993,0,9999,6
1714603643452,EDS 115,A00,507243,Choi; Bailey Miyeon,10,0,28,18
1714603644478,EDS 117,A01,494379,Staff,1,5,30,29
1714603645503,EDS 125,A00,507246,Hopkins; Megan Beth,9,0,30,21
1714603646530,EDS 128A,A01,507264,Fargason; Sharon Gayle,8,0,26,18
1714603647556,EDS 128B,A01,507293,Pappas; Elizabeth,12,0,30,18
1714603648582,EDS 139,A00,507294,Fargason; Sharon Gayle,13,0,30,17
1714603648582,EDS 139,B00,507313,Pappas; Elizabeth,13,0,30,17
1714603649608,EDS 201,A00,507315,Staff,13,0,30,17
1714603650634,EDS 203,A01,507317,Halter; Christopher P.,12,0,30,18
1714603651657,EDS 204R,A01,507319,Halter; Christopher P.,0,3,30,30
1714603651657,EDS 204R,B01,507331,Heinzman; Erica M.,16,0,30,14
1714603652682,EDS 206R,A00,507332,Staff,0,4,30,30
1714603652682,EDS 206R,B00,507343,Staff,17,0,30,13
1714603653706,EDS 250,A00,507344,Hemans; Patricia Ann Benitez,22,0,40,18
1714603654735,EDS 281,A00,507345,Daly; Alan J.,18,0,18,0
1714603655763,EDS 284,A00,507350,Daly; Alan J.,16,0,16,0
1714603656792,EDS 286,A00,507359,Fine; Sarah,18,0,18,0
1714603657816,EDS 289C,A01,507361,Daly; Alan J.,18,0,18,0
1714603658846,EDS 290,A00,507366,Hofstetter; Carolyn,15,0,15,0
1714603659875,LIGM 5A,A00,507421,Fischer-Grunski; Eva K,18,0,20,2
1714603660905,LIGM 5B,A00,507423,Fischer-Grunski; Eva K,19,0,20,1
1714603661931,LIGM 5C,A00,507425,Fischer-Grunski; Eva K,19,0,20,1
1714603662959,LIIT 5AS,A00,507427,Carnelos; Chiara,20,0,20,0
1714603663985,LIIT 5BS,A00,507430,Carnelos; Chiara,20,0,20,0
1714603665013,LIIT 5CS,A00,507432,Carnelos; Chiara,20,0,20,0
1714603666037,LISP 5A,A00,507541,Munoz Sanchez; Alicia,11,0,20,9
1714603667063,LISP 5B,A00,507671,Munoz Sanchez; Alicia,8,0,20,12
1714603668092,LISP 5C,A00,507696,Munoz Sanchez; Alicia,9,0,20,11
1714603669116,MAE 197,001,528363,Boechler; Nicholas Sebastia,9998,0,9999,1
1714603670152,MATH 197,001,523477,Kedlaya; Kiran S.,9995,0,9999,4
1714603670152,MATH 197,002,563811,Zhang; Danna,9995,0,9999,4
1714603670152,MATH 197,003,628552,Dumitriu; Ioana,9998,0,9999,1
1714603671177,MCWP 40R,A00,518780,Staff,2,0,20,18
1714603671177,MCWP 40R,B00,518781,Staff,8,0,20,12
1714603671177,MCWP 40R,C00,518783,Staff,6,0,20,14
1714603672208,MCWP 50R,A00,518791,Staff,0,0,20,20
1714603672208,MCWP 50R,B00,518792,Staff,0,2,20,20
1714603672208,MCWP 50R,C00,518793,Staff,0,2,20,20
1714603672208,MCWP 50R,D00,518794,Staff,0,0,20,20
1714603672208,MCWP 50R,E00,518795,Staff,0,2,20,20
1714603672208,MCWP 50R,F00,518796,Staff,0,0,20,20
1714603672208,MCWP 50R,G00,518797,Staff,0,1,20,20
1714603673238,MMW 12R,A01,514034,Herbst; Matthew,0,0,16,16
1714603673238,MMW 12R,A02,514035,Herbst; Matthew,1,0,16,15
1714603674269,MMW 13R,A01,514037,Staff,0,4,16,16
1714603674269,MMW 13R,A02,514039,Staff,0,2,16,16
1714603674269,MMW 13R,A03,628519,Staff,0,2,16,16
1714603676320,SIO 295LS,A00,523233,Staff,10,0,30,20
1714603677346,SIO 295S,A00,523232,Staff,10,0,30,20
1714603678373,SIOC 290S,A01,637330,Merrifield; Mark A,23,0,30,7
1714603679401,SIOC 291S,A01,637333,Gabriel; Corey John,23,0,30,7
1714603680427,SOCI 117,A01,494376,Staff,0,4,5,5
1714603681453,WES 237B,A00,494380,Staff,9,0,20,11
1714603683519,AESE 279B,A00,494370,Wade; Jon P,0,0,33,33
1714603684542,AIP 197,001,627712,Vespa; Emanuel Ignacio,9998,0,9999,1
1714603685568,ANAR 135S,A00,494369,Braswell; Geoffrey E.,0,0,0,0
1714603686593,BENG 196,001,628496,Engler; Adam J.,9998,0,9999,1
1714603687617,CAT 124RS,A01,519847,Geibel; William,0,0,20,20
1714603688642,CAT 125RS,A01,515971,Geibel; William,0,0,20,20
1714603689671,CLRE 250,A00,511389,Morris; Sheldon,9993,0,9999,6
1714603690698,CLRE 251,A00,507176,Mehta; Ravindra L.,9993,0,9999,6
1714603690698,CLRE 251,B00,511410,Mehta; Ravindra L.,9998,0,9999,1
1714603691726,CLRE 252,A00,507189,Cuomo; Raphael Eduardo,9995,0,9999,4
1714603692805,CLRE 253,A00,507199,Vaida; Florin,9994,0,9999,5
1714603692805,CLRE 253,B00,507202,Vaida; Florin,9999,0,9999,0
1714603693835,CLRE 259,A00,507211,Patel; Hemal,9996,0,9999,3
1714603694860,CLRE 260,A00,507221,Cuomo; Raphael Eduardo,9999,0,9999,0
1714603695886,CLRE 297,001,507242,Cuomo; Raphael Eduardo,9999,0,9999,0
1714603696911,COGS 197,001,638244,Voytek; Bradley Thomas,9998,0,9999,1
1714603697943,CSE 191,A00,516875,Minnes Kemp; Mor Mia,9993,0,9999,6
1714603698970,CSE 197,001,637388,Minnes Kemp; Mor Mia,9998,0,9999,1
1714603699998,CSS 201S,A01,494383,Staff,35,0,35,0
1714603701024,CSS 202S,A01,494387,Staff,35,0,35,0
1714603702052,DSC 197,001,628532,Eldridge; Justin Matthew,9996,0,9999,3
1714603703078,EAP 100,A00,516065,Staff,9797,0,9999,202
1714603704104,ECE 45,A01,507414,Staff,33,0,60,27
1714603706158,ECE 111,A01,507420,Staff,15,0,50,35
1714603707183,ECE 197,001,548057,Sievenpiper; Daniel F.,9993,0,9999,6
1714603708212,EDS 115,A00,507243,Choi; Bailey Miyeon,10,0,28,18
1714603709238,EDS 117,A01,494379,Staff,1,5,30,29
1714603710265,EDS 125,A00,507246,Hopkins; Megan Beth,9,0,30,21
1714603711289,EDS 128A,A01,507264,Fargason; Sharon Gayle,8,0,26,18
1714603712312,EDS 128B,A01,507293,Pappas; Elizabeth,12,0,30,18
1714603713339,EDS 139,A00,507294,Fargason; Sharon Gayle,13,0,30,17
1714603713339,EDS 139,B00,507313,Pappas; Elizabeth,13,0,30,17
1714603714363,EDS 201,A00,507315,Staff,13,0,30,17
1714603715392,EDS 203,A01,507317,Halter; Christopher P.,12,0,30,18
1714603716420,EDS 204R,A01,507319,Halter; Christopher P.,0,3,30,30
1714603716420,EDS 204R,B01,507331,Heinzman; Erica M.,16,0,30,14
1714603717449,EDS 206R,A00,507332,Staff,0,4,30,30
1714603717449,EDS 206R,B00,507343,Staff,17,0,30,13
1714603718477,EDS 250,A00,507344,Hemans; Patricia Ann Benitez,22,0,40,18
1714603719504,EDS 281,A00,507345,Daly; Alan J.,18,0,18,0
1714603720530,EDS 284,A00,507350,Daly; Alan J.,16,0,16,0
1714603721556,EDS 286,A00,507359,Fine; Sarah,18,0,18,0
1714603722581,EDS 289C,A01,507361,Daly; Alan J.,18,0,18,0
1714603723604,EDS 290,A00,507366,Hofstetter; Carolyn,15,0,15,0
1714603724630,LIGM 5A,A00,507421,Fischer-Grunski; Eva K,18,0,20,2
1714603725654,LIGM 5B,A00,507423,Fischer-Grunski; Eva K,19,0,20,1
1714603726679,LIGM 5C,A00,507425,Fischer-Grunski; Eva K,19,0,20,1
1714603727708,LIIT 5AS,A00,507427,Carnelos; Chiara,20,0,20,0
1714603728732,LIIT 5BS,A00,507430,Carnelos; Chiara,20,0,20,0
1714603729756,LIIT 5CS,A00,507432,Carnelos; Chiara,20,0,20,0
1714603730782,LISP 5A,A00,507541,Munoz Sanchez; Alicia,11,0,20,9
1714603731833,LISP 5B,A00,507671,Munoz Sanchez; Alicia,8,0,20,12
1714603732860,LISP 5C,A00,507696,Munoz Sanchez; Alicia,9,0,20,11
1714603733898,MAE 197,001,528363,Boechler; Nicholas Sebastia,9998,0,9999,1
1714603734927,MATH 197,001,523477,Kedlaya; Kiran S.,9995,0,9999,4
1714603734927,MATH 197,002,563811,Zhang; Danna,9995,0,9999,4
1714603734927,MATH 197,003,628552,Dumitriu; Ioana,9998,0,9999,1
1714603735956,MCWP 40R,A00,518780,Staff,2,0,20,18
1714603735956,MCWP 40R,B00,518781,Staff,8,0,20,12
1714603735956,MCWP 40R,C00,518783,Staff,6,0,20,14
1714603736980,MCWP 50R,A00,518791,Staff,0,0,20,20
1714603736980,MCWP 50R,B00,518792,Staff,0,2,20,20
1714603736980,MCWP 50R,C00,518793,Staff,0,2,20,20
1714603736980,MCWP 50R,D00,518794,Staff,0,0,20,20
1714603736980,MCWP 50R,E00,518795,Staff,0,2,20,20
1714603736980,MCWP 50R,F00,518796,Staff,0,0,20,20
1714603736980,MCWP 50R,G00,518797,Staff,0,1,20,20
1714603738009,MMW 12R,A01,514034,Herbst; Matthew,0,0,16,16
1714603738009,MMW 12R,A02,514035,Herbst; Matthew,1,0,16,15
1714603739033,MMW 13R,A01,514037,Staff,0,4,16,16
1714603739033,MMW 13R,A02,514039,Staff,0,2,16,16
1714603739033,MMW 13R,A03,628519,Staff,0,2,16,16
1714603741085,SIO 295LS,A00,523233,Staff,10,0,30,20
1714603742113,SIO 295S,A00,523232,Staff,10,0,30,20
1714603743140,SIOC 290S,A01,637330,Merrifield; Mark A,23,0,30,7
1714603744169,SIOC 291S,A01,637333,Gabriel; Corey John,23,0,30,7
1714603745193,SOCI 117,A01,494376,Staff,0,4,5,5
1714603746217,WES 237B,A00,494380,Staff,9,0,20,11
1714603748289,AESE 279B,A00,494370,Wade; Jon P,0,0,33,33
1714603749319,AIP 197,001,627712,Vespa; Emanuel Ignacio,9998,0,9999,1
1714603750345,ANAR 135S,A00,494369,Braswell; Geoffrey E.,0,0,0,0
1714603751370,BENG 196,001,628496,Engler; Adam J.,9998,0,9999,1
1714603752398,CAT 124RS,A01,519847,Geibel; William,0,0,20,20
1714603753425,CAT 125RS,A01,515971,Geibel; William,0,0,20,20
1714603754454,CLRE 250,A00,511389,Morris; Sheldon,9993,0,9999,6
1714603755481,CLRE 251,A00,507176,Mehta; Ravindra L.,9993,0,9999,6
1714603755481,CLRE 251,B00,511410,Mehta; Ravindra L.,9998,0,9999,1
1714603756504,CLRE 252,A00,507189,Cuomo; Raphael Eduardo,9995,0,9999,4
1714603757535,CLRE 253,A00,507199,Vaida; Florin,9994,0,9999,5
1714603757535,CLRE 253,B00,507202,Vaida; Florin,9999,0,9999,0
1714603758564,CLRE 259,A00,507211,Patel; Hemal,9996,0,9999,3
1714603759588,CLRE 260,A00,507221,Cuomo; Raphael Eduardo,9999,0,9999,0
1714603760614,CLRE 297,001,507242,Cuomo; Raphael Eduardo,9999,0,9999,0
1714603761642,COGS 197,001,638244,Voytek; Bradley Thomas,9998,0,9999,1
1714603762668,CSE 191,A00,516875,Minnes Kemp; Mor Mia,9993,0,9999,6
1714603763692,CSE 197,001,637388,Minnes Kemp; Mor Mia,9998,0,9999,1
1714603764717,CSS 201S,A01,494383,Staff,35,0,35,0
1714603765745,CSS 202S,A01,494387,Staff,35,0,35,0
1714603766771,DSC 197,001,628532,Eldridge; Justin Matthew,9996,0,9999,3
1714603767797,EAP 100,A00,516065,Staff,9797,0,9999,202
1714603768824,ECE 45,A01,507414,Staff,33,0,60,27
1714603770880,ECE 111,A01,507420,Staff,15,0,50,35
1714603771905,ECE 197,001,548057,Sievenpiper; Daniel F.,9993,0,9999,6
1714603772932,EDS 115,A00,507243,Choi; Bailey Miyeon,10,0,28,18
1714603773959,EDS 117,A01,494379,Staff,1,5,30,29
1714603774990,EDS 125,A00,507246,Hopkins; Megan Beth,9,0,30,21
1714603776016,EDS 128A,A01,507264,Fargason; Sharon Gayle,8,0,26,18
1714603777043,EDS 128B,A01,507293,Pappas; Elizabeth,12,0,30,18
1714603778070,EDS 139,A00,507294,Fargason; Sharon Gayle,13,0,30,17
1714603778070,EDS 139,B00,507313,Pappas; Elizabeth,13,0,30,17
1714603779096,EDS 201,A00,507315,Staff,13,0,30,17
1714603780123,EDS 203,A01,507317,Halter; Christopher P.,12,0,30,18
1714603781152,EDS 204R,A01,507319,Halter; Christopher P.,0,3,30,30
1714603781152,EDS 204R,B01,507331,Heinzman; Erica M.,16,0,30,14
1714603782178,EDS 206R,A00,507332,Staff,0,4,30,30
1714603782178,EDS 206R,B00,507343,Staff,17,0,30,13
1714603783204,EDS 250,A00,507344,Hemans; Patricia Ann Benitez,22,0,40,18
1714603784234,EDS 281,A00,507345,Daly; Alan J.,18,0,18,0
1714603785261,EDS 284,A00,507350,Daly; Alan J.,16,0,16,0
1714603786287,EDS 286,A00,507359,Fine; Sarah,18,0,18,0
1714603787311,EDS 289C,A01,507361,Daly; Alan J.,18,0,18,0
1714603788336,EDS 290,A00,507366,Hofstetter; Carolyn,15,0,15,0
1714603789361,LIGM 5A,A00,507421,Fischer-Grunski; Eva K,18,0,20,2
1714603790389,LIGM 5B,A00,507423,Fischer-Grunski; Eva K,19,0,20,1
1714603791415,LIGM 5C,A00,507425,Fischer-Grunski; Eva K,19,0,20,1
1714603792442,LIIT 5AS,A00,507427,Carnelos; Chiara,20,0,20,0
1714603793470,LIIT 5BS,A00,507430,Carnelos; Chiara,20,0,20,0
1714603794498,LIIT 5CS,A00,507432,Carnelos; Chiara,20,0,20,0
1714603795525,LISP 5A,A00,507541,Munoz Sanchez; Alicia,11,0,20,9
1714603796549,LISP 5B,A00,507671,Munoz Sanchez; Alicia,8,0,20,12
1714603797575,LISP 5C,A00,507696,Munoz Sanchez; Alicia,9,0,20,11
1714603798600,MAE 197,001,528363,Boechler; Nicholas Sebastia,9998,0,9999,1
1714603799629,MATH 197,001,523477,Kedlaya; Kiran S.,9995,0,9999,4
1714603799629,MATH 197,002,563811,Zhang; Danna,9995,0,9999,4
1714603799629,MATH 197,003,628552,Dumitriu; Ioana,9998,0,9999,1
1714603800655,MCWP 40R,A00,518780,Staff,2,0,20,18
1714603800655,MCWP 40R,B00,518781,Staff,8,0,20,12
1714603800655,MCWP 40R,C00,518783,Staff,6,0,20,14
1714603801684,MCWP 50R,A00,518791,Staff,0,0,20,20
1714603801684,MCWP 50R,B00,518792,Staff,0,2,20,20
1714603801684,MCWP 50R,C00,518793,Staff,0,2,20,20
1714603801684,MCWP 50R,D00,518794,Staff,0,0,20,20
1714603801684,MCWP 50R,E00,518795,Staff,0,2,20,20
1714603801684,MCWP 50R,F00,518796,Staff,0,0,20,20
1714603801684,MCWP 50R,G00,518797,Staff,0,1,20,20
1714603802710,MMW 12R,A01,514034,Herbst; Matthew,0,0,16,16
1714603802710,MMW 12R,A02,514035,Herbst; Matthew,1,0,16,15
1714603803738,MMW 13R,A01,514037,Staff,0,4,16,16
1714603803738,MMW 13R,A02,514039,Staff,0,2,16,16
1714603803738,MMW 13R,A03,628519,Staff,0,2,16,16
1714603805786,SIO 295LS,A00,523233,Staff,10,0,30,20
1714603806809,SIO 295S,A00,523232,Staff,10,0,30,20
1714603807836,SIOC 290S,A01,637330,Merrifield; Mark A,23,0,30,7
1714603808861,SIOC 291S,A01,637333,Gabriel; Corey John,23,0,30,7
1714603809888,SOCI 117,A01,494376,Staff,0,4,5,5
1714603810914,WES 237B,A00,494380,Staff,9,0,20,11
1714603812995,AESE 279B,A00,494370,Wade; Jon P,0,0,33,33
1714603814025,AIP 197,001,627712,Vespa; Emanuel Ignacio,9998,0,9999,1
1714603815054,ANAR 135S,A00,494369,Braswell; Geoffrey E.,0,0,0,0
1714603816084,BENG 196,001,628496,Engler; Adam J.,9998,0,9999,1
1714603817113,CAT 124RS,A01,519847,Geibel; William,0,0,20,20
1714603818142,CAT 125RS,A01,515971,Geibel; William,0,0,20,20
1714603819171,CLRE 250,A00,511389,Morris; Sheldon,9993,0,9999,6
1714603820197,CLRE 251,A00,507176,Mehta; Ravindra L.,9993,0,9999,6
1714603820197,CLRE 251,B00,511410,Mehta; Ravindra L.,9998,0,9999,1
1714603821222,CLRE 252,A00,507189,Cuomo; Raphael Eduardo,9995,0,9999,4
1714603822327,CLRE 253,A00,507199,Vaida; Florin,9994,0,9999,5
1714603822327,CLRE 253,B00,507202,Vaida; Florin,9999,0,9999,0
1714603823354,CLRE 259,A00,507211,Patel; Hemal,9996,0,9999,3
1714603824379,CLRE 260,A00,507221,Cuomo; Raphael Eduardo,9999,0,9999,0
1714603825403,CLRE 297,001,507242,Cuomo; Raphael Eduardo,9999,0,9999,0
1714603826428,COGS 197,001,638244,Voytek; Bradley Thomas,9998,0,9999,1
1714603827452,CSE 191,A00,516875,Minnes Kemp; Mor Mia,9993,0,9999,6
1714603828477,CSE 197,001,637388,Minnes Kemp; Mor Mia,9998,0,9999,1
1714603829507,CSS 201S,A01,494383,Staff,35,0,35,0
1714603830530,CSS 202S,A01,494387,Staff,35,0,35,0
1714603831560,DSC 197,001,628532,Eldridge; Justin Matthew,9996,0,9999,3
1714603832586,EAP 100,A00,516065,Staff,9797,0,9999,202
1714603833614,ECE 45,A01,507414,Staff,33,0,60,27
1714603835664,ECE 111,A01,507420,Staff,15,0,50,35
1714603836689,ECE 197,001,548057,Sievenpiper; Daniel F.,9993,0,9999,6
1714603837718,EDS 115,A00,507243,Choi; Bailey Miyeon,10,0,28,18
1714603838746,EDS 117,A01,494379,Staff,1,5,30,29
1714603839770,EDS 125,A00,507246,Hopkins; Megan Beth,9,0,30,21
1714603840794,EDS 128A,A01,507264,Fargason; Sharon Gayle,8,0,26,18
1714603841824,EDS 128B,A01,507293,Pappas; Elizabeth,12,0,30,18
1714603842848,EDS 139,A00,507294,Fargason; Sharon Gayle,13,0,30,17
1714603842848,EDS 139,B00,507313,Pappas; Elizabeth,13,0,30,17
1714603843874,EDS 201,A00,507315,Staff,13,0,30,17
1714603844902,EDS 203,A01,507317,Halter; Christopher P.,12,0,30,18
1714603845928,EDS 204R,A01,507319,Halter; Christopher P.,0,3,30,30
1714603845928,EDS 204R,B01,507331,Heinzman; Erica M.,16,0,30,14
1714603846953,EDS 206R,A00,507332,Staff,0,4,30,30
1714603846953,EDS 206R,B00,507343,Staff,17,0,30,13
1714603847981,EDS 250,A00,507344,Hemans; Patricia Ann Benitez,22,0,40,18
1714603849007,EDS 281,A00,507345,Daly; Alan J.,18,0,18,0
1714603850035,EDS 284,A00,507350,Daly; Alan J.,16,0,16,0
1714603851060,EDS 286,A00,507359,Fine; Sarah,18,0,18,0
1714603852084,EDS 289C,A01,507361,Daly; Alan J.,18,0,18,0
1714603853108,EDS 290,A00,507366,Hofstetter; Carolyn,15,0,15,0
1714603854133,LIGM 5A,A00,507421,Fischer-Grunski; Eva K,18,0,20,2
1714603855159,LIGM 5B,A00,507423,Fischer-Grunski; Eva K,19,0,20,1
1714603856189,LIGM 5C,A00,507425,Fischer-Grunski; Eva K,19,0,20,1
1714603857214,LIIT 5AS,A00,507427,Carnelos; Chiara,20,0,20,0
1714603858240,LIIT 5BS,A00,507430,Carnelos; Chiara,20,0,20,0
1714603859264,LIIT 5CS,A00,507432,Carnelos; Chiara,20,0,20,0
1714603860295,LISP 5A,A00,507541,Munoz Sanchez; Alicia,11,0,20,9
1714603861325,LISP 5B,A00,507671,Munoz Sanchez; Alicia,8,0,20,12
1714603862349,LISP 5C,A00,507696,Munoz Sanchez; Alicia,9,0,20,11
1714603863378,MAE 197,001,528363,Boechler; Nicholas Sebastia,9998,0,9999,1
1714603864408,MATH 197,001,523477,Kedlaya; Kiran S.,9995,0,9999,4
1714603864408,MATH 197,002,563811,Zhang; Danna,9995,0,9999,4
1714603864408,MATH 197,003,628552,Dumitriu; Ioana,9998,0,9999,1
1714603865434,MCWP 40R,A00,518780,Staff,2,0,20,18
1714603865434,MCWP 40R,B00,518781,Staff,8,0,20,12
1714603865434,MCWP 40R,C00,518783,Staff,6,0,20,14
1714603866459,MCWP 50R,A00,518791,Staff,0,0,20,20
1714603866459,MCWP 50R,B00,518792,Staff,0,2,20,20
1714603866459,MCWP 50R,C00,518793,Staff,0,2,20,20
1714603866459,MCWP 50R,D00,518794,Staff,0,0,20,20
1714603866459,MCWP 50R,E00,518795,Staff,0,2,20,20
1714603866459,MCWP 50R,F00,518796,Staff,0,0,20,20
1714603866459,MCWP 50R,G00,518797,Staff,0,1,20,20
1714603867486,MMW 12R,A01,514034,Herbst; Matthew,0,0,16,16
1714603867486,MMW 12R,A02,514035,Herbst; Matthew,1,0,16,15
1714603868511,MMW 13R,A01,514037,Staff,0,4,16,16
1714603868511,MMW 13R,A02,514039,Staff,0,2,16,16
1714603868511,MMW 13R,A03,628519,Staff,0,2,16,16
1714603870559,SIO 295LS,A00,523233,Staff,10,0,30,20
1714603871584,SIO 295S,A00,523232,Staff,10,0,30,20
1714603872610,SIOC 290S,A01,637330,Merrifield; Mark A,23,0,30,7
1714603873634,SIOC 291S,A01,637333,Gabriel; Corey John,23,0,30,7
1714603874658,SOCI 117,A01,494376,Staff,0,4,5,5
1714603875684,WES 237B,A00,494380,Staff,9,0,20,11
1714603877760,AESE 279B,A00,494370,Wade; Jon P,0,0,33,33
1714603878785,AIP 197,001,627712,Vespa; Emanuel Ignacio,9998,0,9999,1
1714603879810,ANAR 135S,A00,494369,Braswell; Geoffrey E.,0,0,0,0
1714603880839,BENG 196,001,628496,Engler; Adam J.,9998,0,9999,1
1714603881866,CAT 124RS,A01,519847,Geibel; William,0,0,20,20
1714603882890,CAT 125RS,A01,515971,Geibel; William,0,0,20,20
1714603883916,CLRE 250,A00,511389,Morris; Sheldon,9993,0,9999,6
1714603884943,CLRE 251,A00,507176,Mehta; Ravindra L.,9993,0,9999,6
1714603884943,CLRE 251,B00,511410,Mehta; Ravindra L.,9998,0,9999,1
1714603885972,CLRE 252,A00,507189,Cuomo; Raphael Eduardo,9995,0,9999,4
1714603886997,CLRE 253,A00,507199,Vaida; Florin,9994,0,9999,5
1714603886997,CLRE 253,B00,507202,Vaida; Florin,9999,0,9999,0
1714603888025,CLRE 259,A00,507211,Patel; Hemal,9996,0,9999,3
1714603889053,CLRE 260,A00,507221,Cuomo; Raphael Eduardo,9999,0,9999,0
1714603890078,CLRE 297,001,507242,Cuomo; Raphael Eduardo,9999,0,9999,0
1714603891105,COGS 197,001,638244,Voytek; Bradley Thomas,9998,0,9999,1
1714603892133,CSE 191,A00,516875,Minnes Kemp; Mor Mia,9993,0,9999,6
1714603893158,CSE 197,001,637388,Minnes Kemp; Mor Mia,9998,0,9999,1
1714603894185,CSS 201S,A01,494383,Staff,35,0,35,0
1714603895210,CSS 202S,A01,494387,Staff,35,0,35,0
1714603896239,DSC 197,001,628532,Eldridge; Justin Matthew,9996,0,9999,3
1714603897263,EAP 100,A00,516065,Staff,9797,0,9999,202
1714603898297,ECE 45,A01,507414,Staff,33,0,60,27
1714603900350,ECE 111,A01,507420,Staff,15,0,50,35
1714603901376,ECE 197,001,548057,Sievenpiper; Daniel F.,9993,0,9999,6
1714603902403,EDS 115,A00,507243,Choi; Bailey Miyeon,10,0,28,18
1714603903429,EDS 117,A01,494379,Staff,1,5,30,29
1714603904458,EDS 125,A00,507246,Hopkins; Megan Beth,9,0,30,21
1714603905486,EDS 128A,A01,507264,Fargason; Sharon Gayle,8,0,26,18
1714603906516,EDS 128B,A01,507293,Pappas; Elizabeth,12,0,30,18
1714603907539,EDS 139,A00,507294,Fargason; Sharon Gayle,13,0,30,17
1714603907539,EDS 139,B00,507313,Pappas; Elizabeth,13,0,30,17
1714603908562,EDS 201,A00,507315,Staff,13,0,30,17
1714603909590,EDS 203,A01,507317,Halter; Christopher P.,12,0,30,18
1714603910619,EDS 204R,A01,507319,Halter; Christopher P.,0,3,30,30
1714603910619,EDS 204R,B01,507331,Heinzman; Erica M.,16,0,30,14
1714603911644,EDS 206R,A00,507332,Staff,0,4,30,30
1714603911644,EDS 206R,B00,507343,Staff,17,0,30,13
1714603912671,EDS 250,A00,507344,Hemans; Patricia Ann Benitez,22,0,40,18
1714603913699,EDS 281,A00,507345,Daly; Alan J.,18,0,18,0
1714603914727,EDS 284,A00,507350,Daly; Alan J.,16,0,16,0
1714603915757,EDS 286,A00,507359,Fine; Sarah,18,0,18,0
1714603916785,EDS 289C,A01,507361,Daly; Alan J.,18,0,18,0
1714603917814,EDS 290,A00,507366,Hofstetter; Carolyn,15,0,15,0
1714603918840,LIGM 5A,A00,507421,Fischer-Grunski; Eva K,18,0,20,2
1714603919866,LIGM 5B,A00,507423,Fischer-Grunski; Eva K,19,0,20,1
1714603920897,LIGM 5C,A00,507425,Fischer-Grunski; Eva K,19,0,20,1
1714603921923,LIIT 5AS,A00,507427,Carnelos; Chiara,20,0,20,0
1714603922951,LIIT 5BS,A00,507430,Carnelos; Chiara,20,0,20,0
1714603923981,LIIT 5CS,A00,507432,Carnelos; Chiara,20,0,20,0
1714603925006,LISP 5A,A00,507541,Munoz Sanchez; Alicia,11,0,20,9
1714603926036,LISP 5B,A00,507671,Munoz Sanchez; Alicia,8,0,20,12
1714603927065,LISP 5C,A00,507696,Munoz Sanchez; Alicia,9,0,20,11
1714603928090,MAE 197,001,528363,Boechler; Nicholas Sebastia,9998,0,9999,1
1714603929116,MATH 197,001,523477,Kedlaya; Kiran S.,9995,0,9999,4
1714603929116,MATH 197,002,563811,Zhang; Danna,9995,0,9999,4
1714603929116,MATH 197,003,628552,Dumitriu; Ioana,9998,0,9999,1
1714603930140,MCWP 40R,A00,518780,Staff,2,0,20,18
1714603930140,MCWP 40R,B00,518781,Staff,8,0,20,12
1714603930140,MCWP 40R,C00,518783,Staff,6,0,20,14
1714603931165,MCWP 50R,A00,518791,Staff,0,0,20,20
1714603931165,MCWP 50R,B00,518792,Staff,0,2,20,20
1714603931165,MCWP 50R,C00,518793,Staff,0,2,20,20
1714603931165,MCWP 50R,D00,518794,Staff,0,0,20,20
1714603931165,MCWP 50R,E00,518795,Staff,0,2,20,20
1714603931165,MCWP 50R,F00,518796,Staff,0,0,20,20
1714603931165,MCWP 50R,G00,518797,Staff,0,1,20,20
1714603932191,MMW 12R,A01,514034,Herbst; Matthew,0,0,16,16
1714603932191,MMW 12R,A02,514035,Herbst; Matthew,1,0,16,15
1714603933219,MMW 13R,A01,514037,Staff,0,4,16,16
1714603933219,MMW 13R,A02,514039,Staff,0,2,16,16
1714603933219,MMW 13R,A03,628519,Staff,0,2,16,16
1714603935271,SIO 295LS,A00,523233,Staff,10,0,30,20
1714603936297,SIO 295S,A00,523232,Staff,10,0,30,20
1714603937328,SIOC 290S,A01,637330,Merrifield; Mark A,23,0,30,7
1714603938353,SIOC 291S,A01,637333,Gabriel; Corey John,23,0,30,7
1714603939380,SOCI 117,A01,494376,Staff,0,4,5,5
1714603940404,WES 237B,A00,494380,Staff,9,0,20,11
1714603942477,AESE 279B,A00,494370,Wade; Jon P,0,0,33,33
1714603943507,AIP 197,001,627712,Vespa; Emanuel Ignacio,9998,0,9999,1
1714603944533,ANAR 135S,A00,494369,Braswell; Geoffrey E.,0,0,0,0
1714603945560,BENG 196,001,628496,Engler; Adam J.,9998,0,9999,1
1714603946588,CAT 124RS,A01,519847,Geibel; William,0,0,20,20
1714603947613,CAT 125RS,A01,515971,Geibel; William,0,0,20,20
1714603948641,CLRE 250,A00,511389,Morris; Sheldon,9993,0,9999,6
1714603949669,CLRE 251,A00,507176,Mehta; Ravindra L.,9993,0,9999,6
1714603949669,CLRE 251,B00,511410,Mehta; Ravindra L.,9998,0,9999,1
1714603950698,CLRE 252,A00,507189,Cuomo; Raphael Eduardo,9995,0,9999,4
1714603951776,CLRE 253,A00,507199,Vaida; Florin,9994,0,9999,5
1714603951776,CLRE 253,B00,507202,Vaida; Florin,9999,0,9999,0
1714603952802,CLRE 259,A00,507211,Patel; Hemal,9996,0,9999,3
1714603953829,CLRE 260,A00,507221,Cuomo; Raphael Eduardo,9999,0,9999,0
1714603954859,CLRE 297,001,507242,Cuomo; Raphael Eduardo,9999,0,9999,0
1714603955890,COGS 197,001,638244,Voytek; Bradley Thomas,9998,0,9999,1
1714603956914,CSE 191,A00,516875,Minnes Kemp; Mor Mia,9993,0,9999,6
1714603957939,CSE 197,001,637388,Minnes Kemp; Mor Mia,9998,0,9999,1
1714603958966,CSS 201S,A01,494383,Staff,35,0,35,0
1714603959997,CSS 202S,A01,494387,Staff,35,0,35,0
1714603961026,DSC 197,001,628532,Eldridge; Justin Matthew,9996,0,9999,3
1714603962051,EAP 100,A00,516065,Staff,9797,0,9999,202
1714603963080,ECE 45,A01,507414,Staff,33,0,60,27
1714603965136,ECE 111,A01,507420,Staff,15,0,50,35
1714603966166,ECE 197,001,548057,Sievenpiper; Daniel F.,9993,0,9999,6
1714603967191,EDS 115,A00,507243,Choi; Bailey Miyeon,10,0,28,18
1714603968222,EDS 117,A01,494379,Staff,1,5,30,29
1714603969245,EDS 125,A00,507246,Hopkins; Megan Beth,9,0,30,21
1714603970275,EDS 128A,A01,507264,Fargason; Sharon Gayle,8,0,26,18
1714603971299,EDS 128B,A01,507293,Pappas; Elizabeth,12,0,30,18
1714603972327,EDS 139,A00,507294,Fargason; Sharon Gayle,13,0,30,17
1714603972327,EDS 139,B00,507313,Pappas; Elizabeth,13,0,30,17
1714603973355,EDS 201,A00,507315,Staff,13,0,30,17
1714603974383,EDS 203,A01,507317,Halter; Christopher P.,12,0,30,18
1714603975411,EDS 204R,A01,507319,Halter; Christopher P.,0,3,30,30
1714603975411,EDS 204R,B01,507331,Heinzman; Erica M.,16,0,30,14
1714603976437,EDS 206R,A00,507332,Staff,0,4,30,30
1714603976437,EDS 206R,B00,507343,Staff,17,0,30,13
1714603977461,EDS 250,A00,507344,Hemans; Patricia Ann Benitez,22,0,40,18
1714603978486,EDS 281,A00,507345,Daly; Alan J.,18,0,18,0
1714603979515,EDS 284,A00,507350,Daly; Alan J.,16,0,16,0
1714603980540,EDS 286,A00,507359,Fine; Sarah,18,0,18,0
1714603981569,EDS 289C,A01,507361,Daly; Alan J.,18,0,18,0
1714603982595,EDS 290,A00,507366,Hofstetter; Carolyn,15,0,15,0
1714603983621,LIGM 5A,A00,507421,Fischer-Grunski; Eva K,18,0,20,2
1714603984649,LIGM 5B,A00,507423,Fischer-Grunski; Eva K,19,0,20,1
1714603985680,LIGM 5C,A00,507425,Fischer-Grunski; Eva K,19,0,20,1
1714603986705,LIIT 5AS,A00,507427,Carnelos; Chiara,20,0,20,0
1714603987729,LIIT 5BS,A00,507430,Carnelos; Chiara,20,0,20,0
1714603988753,LIIT 5CS,A00,507432,Carnelos; Chiara,20,0,20,0
1714603989781,LISP 5A,A00,507541,Munoz Sanchez; Alicia,11,0,20,9
1714603990810,LISP 5B,A00,507671,Munoz Sanchez; Alicia,8,0,20,12
1714603991835,LISP 5C,A00,507696,Munoz Sanchez; Alicia,9,0,20,11
1714603992865,MAE 197,001,528363,Boechler; Nicholas Sebastia,9998,0,9999,1
1714603993895,MATH 197,001,523477,Kedlaya; Kiran S.,9995,0,9999,4
1714603993895,MATH 197,002,563811,Zhang; Danna,9995,0,9999,4
1714603993895,MATH 197,003,628552,Dumitriu; Ioana,9998,0,9999,1
1714603994924,MCWP 40R,A00,518780,Staff,2,0,20,18
1714603994924,MCWP 40R,B00,518781,Staff,8,0,20,12
1714603994924,MCWP 40R,C00,518783,Staff,6,0,20,14
1714603995953,MCWP 50R,A00,518791,Staff,0,0,20,20
1714603995953,MCWP 50R,B00,518792,Staff,0,2,20,20
1714603995953,MCWP 50R,C00,518793,Staff,0,2,20,20
1714603995953,MCWP 50R,D00,518794,Staff,0,0,20,20
1714603995953,MCWP 50R,E00,518795,Staff,0,2,20,20
1714603995953,MCWP 50R,F00,518796,Staff,0,0,20,20
1714603995953,MCWP 50R,G00,518797,Staff,0,1,20,20
1714603996983,MMW 12R,A01,514034,Herbst; Matthew,0,0,16,16
1714603996983,MMW 12R,A02,514035,Herbst; Matthew,1,0,16,15
1714603998009,MMW 13R,A01,514037,Staff,0,4,16,16
1714603998009,MMW 13R,A02,514039,Staff,0,2,16,16
1714603998009,MMW 13R,A03,628519,Staff,0,2,16,16
1714604000062,SIO 295LS,A00,523233,Staff,10,0,30,20
1714604001088,SIO 295S,A00,523232,Staff,10,0,30,20
1714604002119,SIOC 290S,A01,637330,Merrifield; Mark A,23,0,30,7
1714604003144,SIOC 291S,A01,637333,Gabriel; Corey John,23,0,30,7
1714604004170,SOCI 117,A01,494376,Staff,0,4,5,5
1714604005196,WES 237B,A00,494380,Staff,9,0,20,11
1714604007277,AESE 279B,A00,494370,Wade; Jon P,0,0,33,33
1714604008301,AIP 197,001,627712,Vespa; Emanuel Ignacio,9998,0,9999,1
1714604009329,ANAR 135S,A00,494369,Braswell; Geoffrey E.,0,0,0,0
1714604010354,BENG 196,001,628496,Engler; Adam J.,9998,0,9999,1
1714604011383,CAT 124RS,A01,519847,Geibel; William,0,0,20,20
1714604012410,CAT 125RS,A01,515971,Geibel; William,0,0,20,20
1714604013434,CLRE 250,A00,511389,Morris; Sheldon,9993,0,9999,6
1714604014461,CLRE 251,A00,507176,Mehta; Ravindra L.,9993,0,9999,6
1714604014461,CLRE 251,B00,511410,Mehta; Ravindra L.,9998,0,9999,1
1714604015486,CLRE 252,A00,507189,Cuomo; Raphael Eduardo,9995,0,9999,4
1714604016511,CLRE 253,A00,507199,Vaida; Florin,9994,0,9999,5
1714604016511,CLRE 253,B00,507202,Vaida; Florin,9999,0,9999,0
1714604017538,CLRE 259,A00,507211,Patel; Hemal,9996,0,9999,3
1714604018562,CLRE 260,A00,507221,Cuomo; Raphael Eduardo,9999,0,9999,0
1714604019587,CLRE 297,001,507242,Cuomo; Raphael Eduardo,9999,0,9999,0
1714604020666,COGS 197,001,638244,Voytek; Bradley Thomas,9998,0,9999,1
1714604021694,CSE 191,A00,516875,Minnes Kemp; Mor Mia,9993,0,9999,6
1714604022718,CSE 197,001,637388,Minnes Kemp; Mor Mia,9998,0,9999,1
1714604023747,CSS 201S,A01,494383,Staff,35,0,35,0
1714604024777,CSS 202S,A01,494387,Staff,35,0,35,0
1714604025809,DSC 197,001,628532,Eldridge; Justin Matthew,9996,0,9999,3
1714604026832,EAP 100,A00,516065,Staff,9797,0,9999,202
1714604027861,ECE 45,A01,507414,Staff,33,0,60,27
1714604029914,ECE 111,A01,507420,Staff,15,0,50,35
1714604030939,ECE 197,001,548057,Sievenpiper; Daniel F.,9993,0,9999,6
1714604031970,EDS 115,A00,507243,Choi; Bailey Miyeon,10,0,28,18
1714604032996,EDS 117,A01,494379,Staff,1,5,30,29
1714604034024,EDS 125,A00,507246,Hopkins; Megan Beth,9,0,30,21
1714604035049,EDS 128A,A01,507264,Fargason; Sharon Gayle,8,0,26,18
1714604036073,EDS 128B,A01,507293,Pappas; Elizabeth,12,0,30,18
1714604037097,EDS 139,A00,507294,Fargason; Sharon Gayle,13,0,30,17
1714604037097,EDS 139,B00,507313,Pappas; Elizabeth,13,0,30,17
1714604038138,EDS 201,A00,507315,Staff,13,0,30,17
1714604039163,EDS 203,A01,507317,Halter; Christopher P.,12,0,30,18
1714604040190,EDS 204R,A01,507319,Halter; Christopher P.,0,3,30,30
1714604040190,EDS 204R,B01,507331,Heinzman; Erica M.,16,0,30,14
1714604041217,EDS 206R,A00,507332,Staff,0,4,30,30
1714604041217,EDS 206R,B00,507343,Staff,17,0,30,13
1714604042246,EDS 250,A00,507344,Hemans; Patricia Ann Benitez,22,0,40,18
1714604043275,EDS 281,A00,507345,Daly; Alan J.,18,0,18,0
1714604044302,EDS 284,A00,507350,Daly; Alan J.,16,0,16,0
1714604045331,EDS 286,A00,507359,Fine; Sarah,18,0,18,0
1714604046358,EDS 289C,A01,507361,Daly; Alan J.,18,0,18,0
1714604047381,EDS 290,A00,507366,Hofstetter; Carolyn,15,0,15,0
1714604048407,LIGM 5A,A00,507421,Fischer-Grunski; Eva K,18,0,20,2
1714604049436,LIGM 5B,A00,507423,Fischer-Grunski; Eva K,19,0,20,1
1714604050461,LIGM 5C,A00,507425,Fischer-Grunski; Eva K,19,0,20,1
1714604051492,LIIT 5AS,A00,507427,Carnelos; Chiara,20,0,20,0
1714604052521,LIIT 5BS,A00,507430,Carnelos; Chiara,20,0,20,0
1714604053550,LIIT 5CS,A00,507432,Carnelos; Chiara,20,0,20,0
1714604054579,LISP 5A,A00,507541,Munoz Sanchez; Alicia,11,0,20,9
1714604055604,LISP 5B,A00,507671,Munoz Sanchez; Alicia,8,0,20,12
1714604056635,LISP 5C,A00,507696,Munoz Sanchez; Alicia,9,0,20,11
1714604057660,MAE 197,001,528363,Boechler; Nicholas Sebastia,9998,0,9999,1
1714604058687,MATH 197,001,523477,Kedlaya; Kiran S.,9995,0,9999,4
1714604058687,MATH 197,002,563811,Zhang; Danna,9995,0,9999,4
1714604058687,MATH 197,003,628552,Dumitriu; Ioana,9998,0,9999,1
1714604059718,MCWP 40R,A00,518780,Staff,2,0,20,18
1714604059718,MCWP 40R,B00,518781,Staff,8,0,20,12
1714604059718,MCWP 40R,C00,518783,Staff,6,0,20,14
1714604060748,MCWP 50R,A00,518791,Staff,0,0,20,20
1714604060748,MCWP 50R,B00,518792,Staff,0,2,20,20
1714604060748,MCWP 50R,C00,518793,Staff,0,2,20,20
1714604060748,MCWP 50R,D00,518794,Staff,0,0,20,20
1714604060748,MCWP 50R,E00,518795,Staff,0,2,20,20
1714604060748,MCWP 50R,F00,518796,Staff,0,0,20,20
1714604060748,MCWP 50R,G00,518797,Staff,0,1,20,20
1714604061776,MMW 12R,A01,514034,Herbst; Matthew,0,0,16,16
1714604061776,MMW 12R,A02,514035,Herbst; Matthew,1,0,16,15
1714604062802,MMW 13R,A01,514037,Staff,0,4,16,16
1714604062802,MMW 13R,A02,514039,Staff,0,2,16,16
1714604062802,MMW 13R,A03,628519,Staff,0,2,16,16
1714604064853,SIO 295LS,A00,523233,Staff,10,0,30,20
1714604065879,SIO 295S,A00,523232,Staff,10,0,30,20
1714604066904,SIOC 290S,A01,637330,Merrifield; Mark A,23,0,30,7
1714604067931,SIOC 291S,A01,637333,Gabriel; Corey John,23,0,30,7
1714604068960,SOCI 117,A01,494376,Staff,0,4,5,5
1714604069985,WES 237B,A00,494380,Staff,9,0,20,11
1714604072062,AESE 279B,A00,494370,Wade; Jon P,0,0,33,33
1714604073087,AIP 197,001,627712,Vespa; Emanuel Ignacio,9998,0,9999,1
1714604074113,ANAR 135S,A00,494369,Braswell; Geoffrey E.,0,0,0,0
1714604075140,BENG 196,001,628496,Engler; Adam J.,9998,0,9999,1
1714604076169,CAT 124RS,A01,519847,Geibel; William,0,0,20,20
1714604077195,CAT 125RS,A01,515971,Geibel; William,0,0,20,20
1714604078222,CLRE 250,A00,511389,Morris; Sheldon,9993,0,9999,6
1714604079252,CLRE 251,A00,507176,Mehta; Ravindra L.,9993,0,9999,6
1714604079252,CLRE 251,B00,511410,Mehta; Ravindra L.,9998,0,9999,1
1714604080281,CLRE 252,A00,507189,Cuomo; Raphael Eduardo,9995,0,9999,4
1714604081310,CLRE 253,A00,507199,Vaida; Florin,9994,0,9999,5
1714604081310,CLRE 253,B00,507202,Vaida; Florin,9999,0,9999,0
1714604082335,CLRE 259,A00,507211,Patel; Hemal,9996,0,9999,3
1714604083363,CLRE 260,A00,507221,Cuomo; Raphael Eduardo,9999,0,9999,0
1714604084387,CLRE 297,001,507242,Cuomo; Raphael Eduardo,9999,0,9999,0
1714604085413,COGS 197,001,638244,Voytek; Bradley Thomas,9998,0,9999,1
1714604086442,CSE 191,A00,516875,Minnes Kemp; Mor Mia,9993,0,9999,6
1714604087470,CSE 197,001,637388,Minnes Kemp; Mor Mia,9998,0,9999,1
1714604088495,CSS 201S,A01,494383,Staff,35,0,35,0
1714604089521,CSS 202S,A01,494387,Staff,35,0,35,0
1714604090545,DSC 197,001,628532,Eldridge; Justin Matthew,9996,0,9999,3
1714604091570,EAP 100,A00,516065,Staff,9797,0,9999,202
1714604092595,ECE 45,A01,507414,Staff,33,0,60,27
1714604094642,ECE 111,A01,507420,Staff,15,0,50,35
1714604095667,ECE 197,001,548057,Sievenpiper; Daniel F.,9993,0,9999,6
1714604096694,EDS 115,A00,507243,Choi; Bailey Miyeon,10,0,28,18
1714604097720,EDS 117,A01,494379,Staff,1,5,30,29
1714604098746,EDS 125,A00,507246,Hopkins; Megan Beth,9,0,30,21
1714604099772,EDS 128A,A01,507264,Fargason; Sharon Gayle,8,0,26,18
1714604100797,EDS 128B,A01,507293,Pappas; Elizabeth,12,0,30,18
1714604101824,EDS 139,A00,507294,Fargason; Sharon Gayle,13,0,30,17
1714604101824,EDS 139,B00,507313,Pappas; Elizabeth,13,0,30,17
1714604102851,EDS 201,A00,507315,Staff,13,0,30,17
1714604103878,EDS 203,A01,507317,Halter; Christopher P.,12,0,30,18
1714604104905,EDS 204R,A01,507319,Halter; Christopher P.,0,3,30,30
1714604104905,EDS 204R,B01,507331,Heinzman; Erica M.,16,0,30,14
1714604105931,EDS 206R,A00,507332,Staff,0,4,30,30
1714604105931,EDS 206R,B00,507343,Staff,17,0,30,13
1714604106959,EDS 250,A00,507344,Hemans; Patricia Ann Benitez,22,0,40,18
1714604107988,EDS 281,A00,507345,Daly; Alan J.,18,0,18,0
1714604109014,EDS 284,A00,507350,Daly; Alan J.,16,0,16,0
1714604110040,EDS 286,A00,507359,Fine; Sarah,18,0,18,0
1714604111066,EDS 289C,A01,507361,Daly; Alan J.,18,0,18,0
1714604112089,EDS 290,A00,507366,Hofstetter; Carolyn,15,0,15,0
1714604113113,LIGM 5A,A00,507421,Fischer-Grunski; Eva K,18,0,20,2
1714604114138,LIGM 5B,A00,507423,Fischer-Grunski; Eva K,19,0,20,1
1714604115162,LIGM 5C,A00,507425,Fischer-Grunski; Eva K,19,0,20,1
1714604116192,LIIT 5AS,A00,507427,Carnelos; Chiara,20,0,20,0
1714604117217,LIIT 5BS,A00,507430,Carnelos; Chiara,20,0,20,0
1714604118244,LIIT 5CS,A00,507432,Carnelos; Chiara,20,0,20,0
1714604119274,LISP 5A,A00,507541,Munoz Sanchez; Alicia,11,0,20,9
1714604120301,LISP 5B,A00,507671,Munoz Sanchez; Alicia,8,0,20,12
1714604121328,LISP 5C,A00,507696,Munoz Sanchez; Alicia,9,0,20,11
1714604122358,MAE 197,001,528363,Boechler; Nicholas Sebastia,9998,0,9999,1
1714604123389,MATH 197,001,523477,Kedlaya; Kiran S.,9995,0,9999,4
1714604123389,MATH 197,002,563811,Zhang; Danna,9995,0,9999,4
1714604123389,MATH 197,003,628552,Dumitriu; Ioana,9998,0,9999,1
1714604124417,MCWP 40R,A00,518780,Staff,2,0,20,18
1714604124417,MCWP 40R,B00,518781,Staff,8,0,20,12
1714604124417,MCWP 40R,C00,518783,Staff,6,0,20,14
1714604125448,MCWP 50R,A00,518791,Staff,0,0,20,20
1714604125448,MCWP 50R,B00,518792,Staff,0,2,20,20
1714604125448,MCWP 50R,C00,518793,Staff,0,2,20,20
1714604125448,MCWP 50R,D00,518794,Staff,0,0,20,20
1714604125448,MCWP 50R,E00,518795,Staff,0,2,20,20
1714604125448,MCWP 50R,F00,518796,Staff,0,0,20,20
1714604125448,MCWP 50R,G00,518797,Staff,0,1,20,20
1714604126476,MMW 12R,A01,514034,Herbst; Matthew,0,0,16,16
1714604126476,MMW 12R,A02,514035,Herbst; Matthew,1,0,16,15
1714604127501,MMW 13R,A01,514037,Staff,0,4,16,16
1714604127501,MMW 13R,A02,514039,Staff,0,2,16,16
1714604127501,MMW 13R,A03,628519,Staff,0,2,16,16
1714604129556,SIO 295LS,A00,523233,Staff,10,0,30,20
1714604130580,SIO 295S,A00,523232,Staff,10,0,30,20
1714604131609,SIOC 290S,A01,637330,Merrifield; Mark A,23,0,30,7
1714604132638,SIOC 291S,A01,637333,Gabriel; Corey John,23,0,30,7
1714604133664,SOCI 117,A01,494376,Staff,0,4,5,5
1714604134725,WES 237B,A00,494380,Staff,9,0,20,11
1714604136800,AESE 279B,A00,494370,Wade; Jon P,0,0,33,33
1714604137825,AIP 197,001,627712,Vespa; Emanuel Ignacio,9998,0,9999,1
1714604138852,ANAR 135S,A00,494369,Braswell; Geoffrey E.,0,0,0,0
1714604139876,BENG 196,001,628496,Engler; Adam J.,9998,0,9999,1
1714604140901,CAT 124RS,A01,519847,Geibel; William,0,0,20,20
1714604141926,CAT 125RS,A01,515971,Geibel; William,0,0,20,20
1714604142954,CLRE 250,A00,511389,Morris; Sheldon,9993,0,9999,6
1714604143985,CLRE 251,A00,507176,Mehta; Ravindra L.,9993,0,9999,6
1714604143985,CLRE 251,B00,511410,Mehta; Ravindra L.,9998,0,9999,1
1714604145014,CLRE 252,A00,507189,Cuomo; Raphael Eduardo,9995,0,9999,4
1714604146041,CLRE 253,A00,507199,Vaida; Florin,9994,0,9999,5
1714604146041,CLRE 253,B00,507202,Vaida; Florin,9999,0,9999,0
1714604147066,CLRE 259,A00,507211,Patel; Hemal,9996,0,9999,3
1714604148094,CLRE 260,A00,507221,Cuomo; Raphael Eduardo,9999,0,9999,0
1714604149120,CLRE 297,001,507242,Cuomo; Raphael Eduardo,9999,0,9999,0
1714604150143,COGS 197,001,638244,Voytek; Bradley Thomas,9998,0,9999,1
1714604151171,CSE 191,A00,516875,Minnes Kemp; Mor Mia,9993,0,9999,6
1714604152196,CSE 197,001,637388,Minnes Kemp; Mor Mia,9998,0,9999,1
1714604153221,CSS 201S,A01,494383,Staff,35,0,35,0
1714604154247,CSS 202S,A01,494387,Staff,35,0,35,0
1714604155272,DSC 197,001,628532,Eldridge; Justin Matthew,9996,0,9999,3
1714604156297,EAP 100,A00,516065,Staff,9797,0,9999,202
1714604157325,ECE 45,A01,507414,Staff,33,0,60,27
1714604159382,ECE 111,A01,507420,Staff,15,0,50,35
1714604160410,ECE 197,001,548057,Sievenpiper; Daniel F.,9993,0,9999,6
1714604161437,EDS 115,A00,507243,Choi; Bailey Miyeon,10,0,28,18
1714604162465,EDS 117,A01,494379,Staff,1,5,30,29
1714604163496,EDS 125,A00,507246,Hopkins; Megan Beth,9,0,30,21
1714604164527,EDS 128A,A01,507264,Fargason; Sharon Gayle,8,0,26,18
1714604165554,EDS 128B,A01,507293,Pappas; Elizabeth,12,0,30,18
1714604166583,EDS 139,A00,507294,Fargason; Sharon Gayle,13,0,30,17
1714604166583,EDS 139,B00,507313,Pappas; Elizabeth,13,0,30,17
1714604167607,EDS 201,A00,507315,Staff,13,0,30,17
1714604168637,EDS 203,A01,507317,Halter; Christopher P.,12,0,30,18
1714604169663,EDS 204R,A01,507319,Halter; Christopher P.,0,3,30,30
1714604169663,EDS 204R,B01,507331,Heinzman; Erica M.,16,0,30,14
1714604170692,EDS 206R,A00,507332,Staff,0,4,30,30
1714604170692,EDS 206R,B00,507343,Staff,17,0,30,13
1714604171720,EDS 250,A00,507344,Hemans; Patricia Ann Benitez,22,0,40,18
1714604172750,EDS 281,A00,507345,Daly; Alan J.,18,0,18,0
1714604173773,EDS 284,A00,507350,Daly; Alan J.,16,0,16,0
1714604174798,EDS 286,A00,507359,Fine; Sarah,18,0,18,0
1714604175826,EDS 289C,A01,507361,Daly; Alan J.,18,0,18,0
1714604176856,EDS 290,A00,507366,Hofstetter; Carolyn,15,0,15,0
1714604177881,LIGM 5A,A00,507421,Fischer-Grunski; Eva K,18,0,20,2
1714604178906,LIGM 5B,A00,507423,Fischer-Grunski; Eva K,19,0,20,1
1714604179930,LIGM 5C,A00,507425,Fischer-Grunski; Eva K,19,0,20,1
1714604180957,LIIT 5AS,A00,507427,Carnelos; Chiara,20,0,20,0
1714604181986,LIIT 5BS,A00,507430,Carnelos; Chiara,20,0,20,0
1714604183010,LIIT 5CS,A00,507432,Carnelos; Chiara,20,0,20,0
1714604184130,LISP 5A,A00,507541,Munoz Sanchez; Alicia,11,0,20,9
1714604185154,LISP 5B,A00,507671,Munoz Sanchez; Alicia,8,0,20,12
1714604186178,LISP 5C,A00,507696,Munoz Sanchez; Alicia,9,0,20,11
1714604187203,MAE 197,001,528363,Boechler; Nicholas Sebastia,9998,0,9999,1
1714604188228,MATH 197,001,523477,Kedlaya; Kiran S.,9995,0,9999,4
1714604188228,MATH 197,002,563811,Zhang; Danna,9995,0,9999,4
1714604188228,MATH 197,003,628552,Dumitriu; Ioana,9998,0,9999,1
1714604189254,MCWP 40R,A00,518780,Staff,2,0,20,18
1714604189254,MCWP 40R,B00,518781,Staff,8,0,20,12
1714604189254,MCWP 40R,C00,518783,Staff,6,0,20,14
1714604190280,MCWP 50R,A00,518791,Staff,0,0,20,20
1714604190280,MCWP 50R,B00,518792,Staff,0,2,20,20
1714604190280,MCWP 50R,C00,518793,Staff,0,2,20,20
1714604190280,MCWP 50R,D00,518794,Staff,0,0,20,20
1714604190280,MCWP 50R,E00,518795,Staff,0,2,20,20
1714604190280,MCWP 50R,F00,518796,Staff,0,0,20,20
1714604190280,MCWP 50R,G00,518797,Staff,0,1,20,20
1714604191307,MMW 12R,A01,514034,Herbst; Matthew,0,0,16,16
1714604191307,MMW 12R,A02,514035,Herbst; Matthew,1,0,16,15
1714604192334,MMW 13R,A01,514037,Staff,0,4,16,16
1714604192334,MMW 13R,A02,514039,Staff,0,2,16,16
1714604192334,MMW 13R,A03,628519,Staff,0,2,16,16
1714604194387,SIO 295LS,A00,523233,Staff,10,0,30,20
1714604195413,SIO 295S,A00,523232,Staff,10,0,30,20
1714604196439,SIOC 290S,A01,637330,Merrifield; Mark A,23,0,30,7
1714604197466,SIOC 291S,A01,637333,Gabriel; Corey John,23,0,30,7
1714604198494,SOCI 117,A01,494376,Staff,0,4,5,5
1714604199519,WES 237B,A00,494380,Staff,9,0,20,11
1714604201583,AESE 279B,A00,494370,Wade; Jon P,0,0,33,33
1714604202607,AIP 197,001,627712,Vespa; Emanuel Ignacio,9998,0,9999,1
1714604203687,ANAR 135S,A00,494369,Braswell; Geoffrey E.,0,0,0,0
1714604204728,BENG 196,001,628496,Engler; Adam J.,9998,0,9999,1
1714604205754,CAT 124RS,A01,519847,Geibel; William,0,0,20,20
1714604206779,CAT 125RS,A01,515971,Geibel; William,0,0,20,20
1714604207804,CLRE 250,A00,511389,Morris; Sheldon,9993,0,9999,6
1714604208832,CLRE 251,A00,507176,Mehta; Ravindra L.,9993,0,9999,6
1714604208832,CLRE 251,B00,511410,Mehta; Ravindra L.,9998,0,9999,1
1714604209863,CLRE 252,A00,507189,Cuomo; Raphael Eduardo,9995,0,9999,4
1714604210893,CLRE 253,A00,507199,Vaida; Florin,9994,0,9999,5
1714604210893,CLRE 253,B00,507202,Vaida; Florin,9999,0,9999,0
1714604211922,CLRE 259,A00,507211,Patel; Hemal,9996,0,9999,3
1714604212946,CLRE 260,A00,507221,Cuomo; Raphael Eduardo,9999,0,9999,0
1714604213971,CLRE 297,001,507242,Cuomo; Raphael Eduardo,9999,0,9999,0
1714604215001,COGS 197,001,638244,Voytek; Bradley Thomas,9998,0,9999,1
1714604216027,CSE 191,A00,516875,Minnes Kemp; Mor Mia,9993,0,9999,6
1714604217053,CSE 197,001,637388,Minnes Kemp; Mor Mia,9998,0,9999,1
1714604218082,CSS 201S,A01,494383,Staff,35,0,35,0
1714604219113,CSS 202S,A01,494387,Staff,35,0,35,0
1714604220141,DSC 197,001,628532,Eldridge; Justin Matthew,9996,0,9999,3
1714604221173,EAP 100,A00,516065,Staff,9797,0,9999,202
1714604222199,ECE 45,A01,507414,Staff,33,0,60,27
1714604224253,ECE 111,A01,507420,Staff,15,0,50,35
1714604225279,ECE 197,001,548057,Sievenpiper; Daniel F.,9993,0,9999,6
1714604226308,EDS 115,A00,507243,Choi; Bailey Miyeon,10,0,28,18
1714604227334,EDS 117,A01,494379,Staff,1,5,30,29
1714604228358,EDS 125,A00,507246,Hopkins; Megan Beth,9,0,30,21
1714604229388,EDS 128A,A01,507264,Fargason; Sharon Gayle,8,0,26,18
1714604230417,EDS 128B,A01,507293,Pappas; Elizabeth,12,0,30,18
1714604231441,EDS 139,A00,507294,Fargason; Sharon Gayle,13,0,30,17
1714604231441,EDS 139,B00,507313,Pappas; Elizabeth,13,0,30,17
1714604232468,EDS 201,A00,507315,Staff,13,0,30,17
1714604233492,EDS 203,A01,507317,Halter; Christopher P.,12,0,30,18
1714604234521,EDS 204R,A01,507319,Halter; Christopher P.,0,3,30,30
1714604234521,EDS 204R,B01,507331,Heinzman; Erica M.,16,0,30,14
1714604235549,EDS 206R,A00,507332,Staff,0,4,30,30
1714604235549,EDS 206R,B00,507343,Staff,17,0,30,13
1714604236572,EDS 250,A00,507344,Hemans; Patricia Ann Benitez,22,0,40,18
1714604237597,EDS 281,A00,507345,Daly; Alan J.,18,0,18,0
1714604238625,EDS 284,A00,507350,Daly; Alan J.,16,0,16,0
1714604239653,EDS 286,A00,507359,Fine; Sarah,18,0,18,0
1714604240683,EDS 289C,A01,507361,Daly; Alan J.,18,0,18,0
1714604241711,EDS 290,A00,507366,Hofstetter; Carolyn,15,0,15,0
1714604242738,LIGM 5A,A00,507421,Fischer-Grunski; Eva K,18,0,20,2
1714604243763,LIGM 5B,A00,507423,Fischer-Grunski; Eva K,19,0,20,1
1714604244791,LIGM 5C,A00,507425,Fischer-Grunski; Eva K,19,0,20,1
1714604245838,LIIT 5AS,A00,507427,Carnelos; Chiara,20,0,20,0
1714604246865,LIIT 5BS,A00,507430,Carnelos; Chiara,20,0,20,0
1714604247893,LIIT 5CS,A00,507432,Carnelos; Chiara,20,0,20,0
1714604248918,LISP 5A,A00,507541,Munoz Sanchez; Alicia,11,0,20,9
1714604249947,LISP 5B,A00,507671,Munoz Sanchez; Alicia,8,0,20,12
1714604250978,LISP 5C,A00,507696,Munoz Sanchez; Alicia,9,0,20,11
1714604252006,MAE 197,001,528363,Boechler; Nicholas Sebastia,9998,0,9999,1
1714604253039,MATH 197,001,523477,Kedlaya; Kiran S.,9995,0,9999,4
1714604253039,MATH 197,002,563811,Zhang; Danna,9995,0,9999,4
1714604253039,MATH 197,003,628552,Dumitriu; Ioana,9998,0,9999,1
1714604254066,MCWP 40R,A00,518780,Staff,2,0,20,18
1714604254066,MCWP 40R,B00,518781,Staff,8,0,20,12
1714604254066,MCWP 40R,C00,518783,Staff,6,0,20,14
1714604255092,MCWP 50R,A00,518791,Staff,0,0,20,20
1714604255092,MCWP 50R,B00,518792,Staff,0,2,20,20
1714604255092,MCWP 50R,C00,518793,Staff,0,2,20,20
1714604255092,MCWP 50R,D00,518794,Staff,0,0,20,20
1714604255092,MCWP 50R,E00,518795,Staff,0,2,20,20
1714604255092,MCWP 50R,F00,518796,Staff,0,0,20,20
1714604255092,MCWP 50R,G00,518797,Staff,0,1,20,20
1714604256118,MMW 12R,A01,514034,Herbst; Matthew,0,0,16,16
1714604256118,MMW 12R,A02,514035,Herbst; Matthew,1,0,16,15
1714604257144,MMW 13R,A01,514037,Staff,0,4,16,16
1714604257144,MMW 13R,A02,514039,Staff,0,2,16,16
1714604257144,MMW 13R,A03,628519,Staff,0,2,16,16
1714604259196,SIO 295LS,A00,523233,Staff,10,0,30,20
1714604260220,SIO 295S,A00,523232,Staff,10,0,30,20
1714604261246,SIOC 290S,A01,637330,Merrifield; Mark A,23,0,30,7
1714604262272,SIOC 291S,A01,637333,Gabriel; Corey John,23,0,30,7
1714604263298,SOCI 117,A01,494376,Staff,0,4,5,5
1714604264322,WES 237B,A00,494380,Staff,9,0,20,11
1714604266391,AESE 279B,A00,494370,Wade; Jon P,0,0,33,33
1714604267416,AIP 197,001,627712,Vespa; Emanuel Ignacio,9998,0,9999,1
1714604268444,ANAR 135S,A00,494369,Braswell; Geoffrey E.,0,0,0,0
1714604269470,BENG 196,001,628496,Engler; Adam J.,9998,0,9999,1
1714604270499,CAT 124RS,A01,519847,Geibel; William,0,0,20,20
1714604271525,CAT 125RS,A01,515971,Geibel; William,0,0,20,20
1714604272550,CLRE 250,A00,511389,Morris; Sheldon,9993,0,9999,6
1714604273581,CLRE 251,A00,507176,Mehta; Ravindra L.,9993,0,9999,6
1714604273581,CLRE 251,B00,511410,Mehta; Ravindra L.,9998,0,9999,1
1714604274607,CLRE 252,A00,507189,Cuomo; Raphael Eduardo,9995,0,9999,4
1714604275635,CLRE 253,A00,507199,Vaida; Florin,9994,0,9999,5
1714604275635,CLRE 253,B00,507202,Vaida; Florin,9999,0,9999,0
1714604276665,CLRE 259,A00,507211,Patel; Hemal,9996,0,9999,3
1714604277694,CLRE 260,A00,507221,Cuomo; Raphael Eduardo,9999,0,9999,0
1714604278719,CLRE 297,001,507242,Cuomo; Raphael Eduardo,9999,0,9999,0
1714604279747,COGS 197,001,638244,Voytek; Bradley Thomas,9998,0,9999,1
1714604280773,CSE 191,A00,516875,Minnes Kemp; Mor Mia,9993,0,9999,6
1714604281798,CSE 197,001,637388,Minnes Kemp; Mor Mia,9998,0,9999,1
1714604282827,CSS 201S,A01,494383,Staff,35,0,35,0
1714604283867,CSS 202S,A01,494387,Staff,35,0,35,0
1714604284897,DSC 197,001,628532,Eldridge; Justin Matthew,9996,0,9999,3
1714604285921,EAP 100,A00,516065,Staff,9797,0,9999,202
1714604286949,ECE 45,A01,507414,Staff,33,0,60,27
1714604288999,ECE 111,A01,507420,Staff,15,0,50,35
1714604290023,ECE 197,001,548057,Sievenpiper; Daniel F.,9993,0,9999,6
1714604291053,EDS 115,A00,507243,Choi; Bailey Miyeon,10,0,28,18
1714604292079,EDS 117,A01,494379,Staff,1,5,30,29
1714604293106,EDS 125,A00,507246,Hopkins; Megan Beth,9,0,30,21
1714604294135,EDS 128A,A01,507264,Fargason; Sharon Gayle,8,0,26,18
1714604295160,EDS 128B,A01,507293,Pappas; Elizabeth,12,0,30,18
1714604296185,EDS 139,A00,507294,Fargason; Sharon Gayle,13,0,30,17
1714604296185,EDS 139,B00,507313,Pappas; Elizabeth,13,0,30,17
1714604297210,EDS 201,A00,507315,Staff,13,0,30,17
1714604298237,EDS 203,A01,507317,Halter; Christopher P.,12,0,30,18
1714604299261,EDS 204R,A01,507319,Halter; Christopher P.,0,3,30,30
1714604299261,EDS 204R,B01,507331,Heinzman; Erica M.,16,0,30,14
1714604300287,EDS 206R,A00,507332,Staff,0,4,30,30
1714604300287,EDS 206R,B00,507343,Staff,17,0,30,13
1714604301312,EDS 250,A00,507344,Hemans; Patricia Ann Benitez,22,0,40,18
1714604302339,EDS 281,A00,507345,Daly; Alan J.,18,0,18,0
1714604303366,EDS 284,A00,507350,Daly; Alan J.,16,0,16,0
1714604304394,EDS 286,A00,507359,Fine; Sarah,18,0,18,0
1714604305422,EDS 289C,A01,507361,Daly; Alan J.,18,0,18,0
1714604306447,EDS 290,A00,507366,Hofstetter; Carolyn,15,0,15,0
1714604307473,LIGM 5A,A00,507421,Fischer-Grunski; Eva K,18,0,20,2
1714604308500,LIGM 5B,A00,507423,Fischer-Grunski; Eva K,19,0,20,1
1714604309529,LIGM 5C,A00,507425,Fischer-Grunski; Eva K,19,0,20,1
1714604310555,LIIT 5AS,A00,507427,Carnelos; Chiara,20,0,20,0
1714604311582,LIIT 5BS,A00,507430,Carnelos; Chiara,20,0,20,0
1714604312608,LIIT 5CS,A00,507432,Carnelos; Chiara,20,0,20,0
1714604313637,LISP 5A,A00,507541,Munoz Sanchez; Alicia,11,0,20,9
1714604314662,LISP 5B,A00,507671,Munoz Sanchez; Alicia,8,0,20,12
1714604315689,LISP 5C,A00,507696,Munoz Sanchez; Alicia,9,0,20,11
1714604316715,MAE 197,001,528363,Boechler; Nicholas Sebastia,9998,0,9999,1
1714604317741,MATH 197,001,523477,Kedlaya; Kiran S.,9995,0,9999,4
1714604317741,MATH 197,002,563811,Zhang; Danna,9995,0,9999,4
1714604317741,MATH 197,003,628552,Dumitriu; Ioana,9998,0,9999,1
1714604318766,MCWP 40R,A00,518780,Staff,2,0,20,18
1714604318766,MCWP 40R,B00,518781,Staff,8,0,20,12
1714604318766,MCWP 40R,C00,518783,Staff,6,0,20,14
1714604319791,MCWP 50R,A00,518791,Staff,0,0,20,20
1714604319791,MCWP 50R,B00,518792,Staff,0,2,20,20
1714604319791,MCWP 50R,C00,518793,Staff,0,2,20,20
1714604319791,MCWP 50R,D00,518794,Staff,0,0,20,20
1714604319791,MCWP 50R,E00,518795,Staff,0,2,20,20
1714604319791,MCWP 50R,F00,518796,Staff,0,0,20,20
1714604319791,MCWP 50R,G00,518797,Staff,0,1,20,20
1714604320817,MMW 12R,A01,514034,Herbst; Matthew,0,0,16,16
1714604320817,MMW 12R,A02,514035,Herbst; Matthew,1,0,16,15
1714604321845,MMW 13R,A01,514037,Staff,0,4,16,16
1714604321845,MMW 13R,A02,514039,Staff,0,2,16,16
1714604321845,MMW 13R,A03,628519,Staff,0,2,16,16
1714604323911,SIO 295LS,A00,523233,Staff,10,0,30,20
1714604324935,SIO 295S,A00,523232,Staff,10,0,30,20
1714604325965,SIOC 290S,A01,637330,Merrifield; Mark A,23,0,30,7
1714604326996,SIOC 291S,A01,637333,Gabriel; Corey John,23,0,30,7
1714604328025,SOCI 117,A01,494376,Staff,0,4,5,5
1714604329050,WES 237B,A00,494380,Staff,9,0,20,11
1714604331121,AESE 279B,A00,494370,Wade; Jon P,0,0,33,33
1714604332146,AIP 197,001,627712,Vespa; Emanuel Ignacio,9998,0,9999,1
1714604333171,ANAR 135S,A00,494369,Braswell; Geoffrey E.,0,0,0,0
1714604334196,BENG 196,001,628496,Engler; Adam J.,9998,0,9999,1
1714604335226,CAT 124RS,A01,519847,Geibel; William,0,0,20,20
1714604336254,CAT 125RS,A01,515971,Geibel; William,0,0,20,20
1714604337279,CLRE 250,A00,511389,Morris; Sheldon,9993,0,9999,6
1714604338309,CLRE 251,A00,507176,Mehta; Ravindra L.,9993,0,9999,6
1714604338309,CLRE 251,B00,511410,Mehta; Ravindra L.,9998,0,9999,1
1714604339337,CLRE 252,A00,507189,Cuomo; Raphael Eduardo,9995,0,9999,4
1714604340363,CLRE 253,A00,507199,Vaida; Florin,9994,0,9999,5
1714604340363,CLRE 253,B00,507202,Vaida; Florin,9999,0,9999,0
1714604341387,CLRE 259,A00,507211,Patel; Hemal,9996,0,9999,3
1714604342413,CLRE 260,A00,507221,Cuomo; Raphael Eduardo,9999,0,9999,0
1714604343439,CLRE 297,001,507242,Cuomo; Raphael Eduardo,9999,0,9999,0
1714604344462,COGS 197,001,638244,Voytek; Bradley Thomas,9998,0,9999,1
1714604345488,CSE 191,A00,516875,Minnes Kemp; Mor Mia,9993,0,9999,6
1714604346517,CSE 197,001,637388,Minnes Kemp; Mor Mia,9998,0,9999,1
1714604347545,CSS 201S,A01,494383,Staff,35,0,35,0
1714604348570,CSS 202S,A01,494387,Staff,35,0,35,0
1714604349595,DSC 197,001,628532,Eldridge; Justin Matthew,9996,0,9999,3
1714604350621,EAP 100,A00,516065,Staff,9797,0,9999,202
1714604351651,ECE 45,A01,507414,Staff,33,0,60,27
1714604353700,ECE 111,A01,507420,Staff,15,0,50,35
1714604354728,ECE 197,001,548057,Sievenpiper; Daniel F.,9993,0,9999,6
1714604355758,EDS 115,A00,507243,Choi; Bailey Miyeon,10,0,28,18
1714604356784,EDS 117,A01,494379,Staff,1,5,30,29
1714604357810,EDS 125,A00,507246,Hopkins; Megan Beth,9,0,30,21
1714604358835,EDS 128A,A01,507264,Fargason; Sharon Gayle,8,0,26,18
1714604359861,EDS 128B,A01,507293,Pappas; Elizabeth,12,0,30,18
1714604360885,EDS 139,A00,507294,Fargason; Sharon Gayle,13,0,30,17
1714604360885,EDS 139,B00,507313,Pappas; Elizabeth,13,0,30,17
1714604361911,EDS 201,A00,507315,Staff,13,0,30,17
1714604362937,EDS 203,A01,507317,Halter; Christopher P.,12,0,30,18
1714604363963,EDS 204R,A01,507319,Halter; Christopher P.,0,3,30,30
1714604363963,EDS 204R,B01,507331,Heinzman; Erica M.,16,0,30,14
1714604364988,EDS 206R,A00,507332,Staff,0,4,30,30
1714604364988,EDS 206R,B00,507343,Staff,17,0,30,13
1714604366017,EDS 250,A00,507344,Hemans; Patricia Ann Benitez,22,0,40,18
1714604367045,EDS 281,A00,507345,Daly; Alan J.,18,0,18,0
1714604368068,EDS 284,A00,507350,Daly; Alan J.,16,0,16,0
1714604369097,EDS 286,A00,507359,Fine; Sarah,18,0,18,0
1714604370126,EDS 289C,A01,507361,Daly; Alan J.,18,0,18,0
1714604371150,EDS 290,A00,507366,Hofstetter; Carolyn,15,0,15,0
1714604372176,LIGM 5A,A00,507421,Fischer-Grunski; Eva K,18,0,20,2
1714604373204,LIGM 5B,A00,507423,Fischer-Grunski; Eva K,19,0,20,1
1714604374232,LIGM 5C,A00,507425,Fischer-Grunski; Eva K,19,0,20,1
1714604375262,LIIT 5AS,A00,507427,Carnelos; Chiara,20,0,20,0
1714604376289,LIIT 5BS,A00,507430,Carnelos; Chiara,20,0,20,0
1714604377314,LIIT 5CS,A00,507432,Carnelos; Chiara,20,0,20,0
1714604378341,LISP 5A,A00,507541,Munoz Sanchez; Alicia,11,0,20,9
1714604379370,LISP 5B,A00,507671,Munoz Sanchez; Alicia,8,0,20,12
1714604380401,LISP 5C,A00,507696,Munoz Sanchez; Alicia,9,0,20,11
1714604381429,MAE 197,001,528363,Boechler; Nicholas Sebastia,9998,0,9999,1
1714604382456,MATH 197,001,523477,Kedlaya; Kiran S.,9995,0,9999,4
1714604382456,MATH 197,002,563811,Zhang; Danna,9995,0,9999,4
1714604382456,MATH 197,003,628552,Dumitriu; Ioana,9998,0,9999,1
1714604383482,MCWP 40R,A00,518780,Staff,2,0,20,18
1714604383482,MCWP 40R,B00,518781,Staff,8,0,20,12
1714604383482,MCWP 40R,C00,518783,Staff,6,0,20,14
1714604384508,MCWP 50R,A00,518791,Staff,0,0,20,20
1714604384508,MCWP 50R,B00,518792,Staff,0,2,20,20
1714604384508,MCWP 50R,C00,518793,Staff,0,2,20,20
1714604384508,MCWP 50R,D00,518794,Staff,0,0,20,20
1714604384508,MCWP 50R,E00,518795,Staff,0,2,20,20
1714604384508,MCWP 50R,F00,518796,Staff,0,0,20,20
1714604384508,MCWP 50R,G00,518797,Staff,0,1,20,20
1714604385537,MMW 12R,A01,514034,Herbst; Matthew,0,0,16,16
1714604385537,MMW 12R,A02,514035,Herbst; Matthew,1,0,16,15
1714604386561,MMW 13R,A01,514037,Staff,0,4,16,16
1714604386561,MMW 13R,A02,514039,Staff,0,2,16,16
1714604386561,MMW 13R,A03,628519,Staff,0,2,16,16
1714604388611,SIO 295LS,A00,523233,Staff,10,0,30,20
1714604389638,SIO 295S,A00,523232,Staff,10,0,30,20
1714604390666,SIOC 290S,A01,637330,Merrifield; Mark A,23,0,30,7
1714604391697,SIOC 291S,A01,637333,Gabriel; Corey John,23,0,30,7
1714604392721,SOCI 117,A01,494376,Staff,0,4,5,5
1714604393745,WES 237B,A00,494380,Staff,9,0,20,11
1714604395814,AESE 279B,A00,494370,Wade; Jon P,0,0,33,33
1714604396838,AIP 197,001,627712,Vespa; Emanuel Ignacio,9998,0,9999,1
1714604397865,ANAR 135S,A00,494369,Braswell; Geoffrey E.,0,0,0,0
1714604398892,BENG 196,001,628496,Engler; Adam J.,9998,0,9999,1
1714604399919,CAT 124RS,A01,519847,Geibel; William,0,0,20,20
1714604400943,CAT 125RS,A01,515971,Geibel; William,0,0,20,20
1714604401973,CLRE 250,A00,511389,Morris; Sheldon,9993,0,9999,6
1714604403004,CLRE 251,A00,507176,Mehta; Ravindra L.,9993,0,9999,6
1714604403004,CLRE 251,B00,511410,Mehta; Ravindra L.,9998,0,9999,1
1714604404037,CLRE 252,A00,507189,Cuomo; Raphael Eduardo,9995,0,9999,4
1714604405062,CLRE 253,A00,507199,Vaida; Florin,9994,0,9999,5
1714604405062,CLRE 253,B00,507202,Vaida; Florin,9999,0,9999,0
1714604406091,CLRE 259,A00,507211,Patel; Hemal,9996,0,9999,3
1714604407171,CLRE 260,A00,507221,Cuomo; Raphael Eduardo,9999,0,9999,0
1714604408195,CLRE 297,001,507242,Cuomo; Raphael Eduardo,9999,0,9999,0
1714604409220,COGS 197,001,638244,Voytek; Bradley Thomas,9998,0,9999,1
1714604410247,CSE 191,A00,516875,Minnes Kemp; Mor Mia,9993,0,9999,6
1714604411280,CSE 197,001,637388,Minnes Kemp; Mor Mia,9998,0,9999,1
1714604412313,CSS 201S,A01,494383,Staff,35,0,35,0
1714604413338,CSS 202S,A01,494387,Staff,35,0,35,0
1714604414366,DSC 197,001,628532,Eldridge; Justin Matthew,9996,0,9999,3
1714604415393,EAP 100,A00,516065,Staff,9797,0,9999,202
1714604416419,ECE 45,A01,507414,Staff,33,0,60,27
1714604418481,ECE 111,A01,507420,Staff,15,0,50,35
1714604419517,ECE 197,001,548057,Sievenpiper; Daniel F.,9993,0,9999,6
1714604420542,EDS 115,A00,507243,Choi; Bailey Miyeon,10,0,28,18
1714604421572,EDS 117,A01,494379,Staff,1,5,30,29
1714604422597,EDS 125,A00,507246,Hopkins; Megan Beth,9,0,30,21
1714604423622,EDS 128A,A01,507264,Fargason; Sharon Gayle,8,0,26,18
1714604424648,EDS 128B,A01,507293,Pappas; Elizabeth,12,0,30,18
1714604425675,EDS 139,A00,507294,Fargason; Sharon Gayle,13,0,30,17
1714604425675,EDS 139,B00,507313,Pappas; Elizabeth,13,0,30,17
1714604426701,EDS 201,A00,507315,Staff,13,0,30,17
1714604427725,EDS 203,A01,507317,Halter; Christopher P.,12,0,30,18
1714604428750,EDS 204R,A01,507319,Halter; Christopher P.,0,3,30,30
1714604428750,EDS 204R,B01,507331,Heinzman; Erica M.,16,0,30,14
1714604429776,EDS 206R,A00,507332,Staff,0,4,30,30
1714604429776,EDS 206R,B00,507343,Staff,17,0,30,13
1714604430802,EDS 250,A00,507344,Hemans; Patricia Ann Benitez,22,0,40,18
1714604431828,EDS 281,A00,507345,Daly; Alan J.,18,0,18,0
1714604432853,EDS 284,A00,507350,Daly; Alan J.,16,0,16,0
1714604433879,EDS 286,A00,507359,Fine; Sarah,18,0,18,0
1714604434933,EDS 289C,A01,507361,Daly; Alan J.,18,0,18,0
1714604435964,EDS 290,A00,507366,Hofstetter; Carolyn,15,0,15,0
1714604436990,LIGM 5A,A00,507421,Fischer-Grunski; Eva K,18,0,20,2
1714604438018,LIGM 5B,A00,507423,Fischer-Grunski; Eva K,19,0,20,1
1714604439042,LIGM 5C,A00,507425,Fischer-Grunski; Eva K,19,0,20,1
1714604440072,LIIT 5AS,A00,507427,Carnelos; Chiara,20,0,20,0
1714604441098,LIIT 5BS,A00,507430,Carnelos; Chiara,20,0,20,0
1714604442121,LIIT 5CS,A00,507432,Carnelos; Chiara,20,0,20,0
1714604443151,LISP 5A,A00,507541,Munoz Sanchez; Alicia,11,0,20,9
1714604444175,LISP 5B,A00,507671,Munoz Sanchez; Alicia,8,0,20,12
1714604445203,LISP 5C,A00,507696,Munoz Sanchez; Alicia,9,0,20,11
1714604446228,MAE 197,001,528363,Boechler; Nicholas Sebastia,9998,0,9999,1
1714604447256,MATH 197,001,523477,Kedlaya; Kiran S.,9995,0,9999,4
1714604447256,MATH 197,002,563811,Zhang; Danna,9995,0,9999,4
1714604447256,MATH 197,003,628552,Dumitriu; Ioana,9998,0,9999,1
1714604448283,MCWP 40R,A00,518780,Staff,2,0,20,18
1714604448283,MCWP 40R,B00,518781,Staff,8,0,20,12
1714604448283,MCWP 40R,C00,518783,Staff,6,0,20,14
1714604449312,MCWP 50R,A00,518791,Staff,0,0,20,20
1714604449312,MCWP 50R,B00,518792,Staff,0,2,20,20
1714604449312,MCWP 50R,C00,518793,Staff,0,2,20,20
1714604449312,MCWP 50R,D00,518794,Staff,0,0,20,20
1714604449312,MCWP 50R,E00,518795,Staff,0,2,20,20
1714604449312,MCWP 50R,F00,518796,Staff,0,0,20,20
1714604449312,MCWP 50R,G00,518797,Staff,0,1,20,20
1714604450340,MMW 12R,A01,514034,Herbst; Matthew,0,0,16,16
1714604450340,MMW 12R,A02,514035,Herbst; Matthew,1,0,16,15
1714604451365,MMW 13R,A01,514037,Staff,0,4,16,16
1714604451365,MMW 13R,A02,514039,Staff,0,2,16,16
1714604451365,MMW 13R,A03,628519,Staff,0,2,16,16
1714604453441,SIO 295LS,A00,523233,Staff,10,0,30,20
1714604454464,SIO 295S,A00,523232,Staff,10,0,30,20
1714604455491,SIOC 290S,A01,637330,Merrifield; Mark A,23,0,30,7
1714604456517,SIOC 291S,A01,637333,Gabriel; Corey John,23,0,30,7
1714604457543,SOCI 117,A01,494376,Staff,0,4,5,5
1714604458568,WES 237B,A00,494380,Staff,9,0,20,11
1714604460648,AESE 279B,A00,494370,Wade; Jon P,0,0,33,33
1714604461673,AIP 197,001,627712,Vespa; Emanuel Ignacio,9998,0,9999,1
1714604462700,ANAR 135S,A00,494369,Braswell; Geoffrey E.,0,0,0,0
1714604463727,BENG 196,001,628496,Engler; Adam J.,9998,0,9999,1
1714604464759,CAT 124RS,A01,519847,Geibel; William,0,0,20,20
1714604465783,CAT 125RS,A01,515971,Geibel; William,0,0,20,20
1714604466809,CLRE 250,A00,511389,Morris; Sheldon,9993,0,9999,6
1714604467835,CLRE 251,A00,507176,Mehta; Ravindra L.,9993,0,9999,6
1714604467835,CLRE 251,B00,511410,Mehta; Ravindra L.,9998,0,9999,1
1714604468859,CLRE 252,A00,507189,Cuomo; Raphael Eduardo,9995,0,9999,4
1714604469891,CLRE 253,A00,507199,Vaida; Florin,9994,0,9999,5
1714604469891,CLRE 253,B00,507202,Vaida; Florin,9999,0,9999,0
1714604470916,CLRE 259,A00,507211,Patel; Hemal,9996,0,9999,3
1714604471941,CLRE 260,A00,507221,Cuomo; Raphael Eduardo,9999,0,9999,0
1714604472965,CLRE 297,001,507242,Cuomo; Raphael Eduardo,9999,0,9999,0
1714604473995,COGS 197,001,638244,Voytek; Bradley Thomas,9998,0,9999,1
1714604475020,CSE 191,A00,516875,Minnes Kemp; Mor Mia,9993,0,9999,6
1714604476051,CSE 197,001,637388,Minnes Kemp; Mor Mia,9998,0,9999,1
1714604477078,CSS 201S,A01,494383,Staff,35,0,35,0
1714604478104,CSS 202S,A01,494387,Staff,35,0,35,0
1714604479131,DSC 197,001,628532,Eldridge; Justin Matthew,9996,0,9999,3
1714604480157,EAP 100,A00,516065,Staff,9797,0,9999,202
1714604481182,ECE 45,A01,507414,Staff,33,0,60,27
1714604483246,ECE 111,A01,507420,Staff,15,0,50,35
1714604484271,ECE 197,001,548057,Sievenpiper; Daniel F.,9993,0,9999,6
1714604485296,EDS 115,A00,507243,Choi; Bailey Miyeon,10,0,28,18
1714604486320,EDS 117,A01,494379,Staff,1,5,30,29
1714604487344,EDS 125,A00,507246,Hopkins; Megan Beth,9,0,30,21
1714604488376,EDS 128A,A01,507264,Fargason; Sharon Gayle,8,0,26,18
1714604489402,EDS 128B,A01,507293,Pappas; Elizabeth,12,0,30,18
1714604490429,EDS 139,A00,507294,Fargason; Sharon Gayle,13,0,30,17
1714604490429,EDS 139,B00,507313,Pappas; Elizabeth,13,0,30,17
1714604491453,EDS 201,A00,507315,Staff,13,0,30,17
1714604492482,EDS 203,A01,507317,Halter; Christopher P.,12,0,30,18
1714604493513,EDS 204R,A01,507319,Halter; Christopher P.,0,3,30,30
1714604493513,EDS 204R,B01,507331,Heinzman; Erica M.,16,0,30,14
1714604494541,EDS 206R,A00,507332,Staff,0,4,30,30
1714604494541,EDS 206R,B00,507343,Staff,17,0,30,13
1714604495571,EDS 250,A00,507344,Hemans; Patricia Ann Benitez,22,0,40,18
1714604496596,EDS 281,A00,507345,Daly; Alan J.,18,0,18,0
1714604497619,EDS 284,A00,507350,Daly; Alan J.,16,0,16,0
1714604498644,EDS 286,A00,507359,Fine; Sarah,18,0,18,0
1714604499670,EDS 289C,A01,507361,Daly; Alan J.,18,0,18,0
1714604500694,EDS 290,A00,507366,Hofstetter; Carolyn,15,0,15,0
1714604501720,LIGM 5A,A00,507421,Fischer-Grunski; Eva K,18,0,20,2
1714604502746,LIGM 5B,A00,507423,Fischer-Grunski; Eva K,19,0,20,1
1714604503770,LIGM 5C,A00,507425,Fischer-Grunski; Eva K,19,0,20,1
1714604504796,LIIT 5AS,A00,507427,Carnelos; Chiara,20,0,20,0
1714604505820,LIIT 5BS,A00,507430,Carnelos; Chiara,20,0,20,0
1714604506848,LIIT 5CS,A00,507432,Carnelos; Chiara,20,0,20,0
1714604507872,LISP 5A,A00,507541,Munoz Sanchez; Alicia,11,0,20,9
1714604508897,LISP 5B,A00,507671,Munoz Sanchez; Alicia,8,0,20,12
1714604509927,LISP 5C,A00,507696,Munoz Sanchez; Alicia,9,0,20,11
1714604510954,MAE 197,001,528363,Boechler; Nicholas Sebastia,9998,0,9999,1
1714604511986,MATH 197,001,523477,Kedlaya; Kiran S.,9995,0,9999,4
1714604511986,MATH 197,002,563811,Zhang; Danna,9995,0,9999,4
1714604511986,MATH 197,003,628552,Dumitriu; Ioana,9998,0,9999,1
1714604513011,MCWP 40R,A00,518780,Staff,2,0,20,18
1714604513011,MCWP 40R,B00,518781,Staff,8,0,20,12
1714604513011,MCWP 40R,C00,518783,Staff,6,0,20,14
1714604514038,MCWP 50R,A00,518791,Staff,0,0,20,20
1714604514038,MCWP 50R,B00,518792,Staff,0,2,20,20
1714604514038,MCWP 50R,C00,518793,Staff,0,2,20,20
1714604514038,MCWP 50R,D00,518794,Staff,0,0,20,20
1714604514038,MCWP 50R,E00,518795,Staff,0,2,20,20
1714604514038,MCWP 50R,F00,518796,Staff,0,0,20,20
1714604514038,MCWP 50R,G00,518797,Staff,0,1,20,20
1714604515064,MMW 12R,A01,514034,Herbst; Matthew,0,0,16,16
1714604515064,MMW 12R,A02,514035,Herbst; Matthew,1,0,16,15
1714604516089,MMW 13R,A01,514037,Staff,0,4,16,16
1714604516089,MMW 13R,A02,514039,Staff,0,2,16,16
1714604516089,MMW 13R,A03,628519,Staff,0,2,16,16
1714604518140,SIO 295LS,A00,523233,Staff,10,0,30,20
1714604519166,SIO 295S,A00,523232,Staff,10,0,30,20
1714604520198,SIOC 290S,A01,637330,Merrifield; Mark A,23,0,30,7
1714604521228,SIOC 291S,A01,637333,Gabriel; Corey John,23,0,30,7
1714604522257,SOCI 117,A01,494376,Staff,0,4,5,5
1714604523287,WES 237B,A00,494380,Staff,9,0,20,11
1714604525350,AESE 279B,A00,494370,Wade; Jon P,0,0,33,33
1714604526376,AIP 197,001,627712,Vespa; Emanuel Ignacio,9998,0,9999,1
1714604527400,ANAR 135S,A00,494369,Braswell; Geoffrey E.,0,0,0,0
1714604528426,BENG 196,001,628496,Engler; Adam J.,9998,0,9999,1
1714604529453,CAT 124RS,A01,519847,Geibel; William,0,0,20,20
1714604530479,CAT 125RS,A01,515971,Geibel; William,0,0,20,20
1714604531509,CLRE 250,A00,511389,Morris; Sheldon,9993,0,9999,6
1714604532536,CLRE 251,A00,507176,Mehta; Ravindra L.,9993,0,9999,6
1714604532536,CLRE 251,B00,511410,Mehta; Ravindra L.,9998,0,9999,1
1714604533565,CLRE 252,A00,507189,Cuomo; Raphael Eduardo,9995,0,9999,4
1714604534591,CLRE 253,A00,507199,Vaida; Florin,9994,0,9999,5
1714604534591,CLRE 253,B00,507202,Vaida; Florin,9999,0,9999,0
1714604535614,CLRE 259,A00,507211,Patel; Hemal,9996,0,9999,3
1714604536640,CLRE 260,A00,507221,Cuomo; Raphael Eduardo,9999,0,9999,0
1714604537665,CLRE 297,001,507242,Cuomo; Raphael Eduardo,9999,0,9999,0
1714604538691,COGS 197,001,638244,Voytek; Bradley Thomas,9998,0,9999,1
1714604539715,CSE 191,A00,516875,Minnes Kemp; Mor Mia,9993,0,9999,6
1714604540742,CSE 197,001,637388,Minnes Kemp; Mor Mia,9998,0,9999,1
1714604541767,CSS 201S,A01,494383,Staff,35,0,35,0
1714604542794,CSS 202S,A01,494387,Staff,35,0,35,0
1714604543821,DSC 197,001,628532,Eldridge; Justin Matthew,9996,0,9999,3
1714604544868,EAP 100,A00,516065,Staff,9797,0,9999,202
1714604545894,ECE 45,A01,507414,Staff,33,0,60,27
1714604547946,ECE 111,A01,507420,Staff,15,0,50,35
1714604548972,ECE 197,001,548057,Sievenpiper; Daniel F.,9993,0,9999,6
1714604550001,EDS 115,A00,507243,Choi; Bailey Miyeon,10,0,28,18
1714604551033,EDS 117,A01,494379,Staff,1,5,30,29
1714604552058,EDS 125,A00,507246,Hopkins; Megan Beth,9,0,30,21
1714604553086,EDS 128A,A01,507264,Fargason; Sharon Gayle,8,0,26,18
1714604554112,EDS 128B,A01,507293,Pappas; Elizabeth,12,0,30,18
1714604555136,EDS 139,A00,507294,Fargason; Sharon Gayle,13,0,30,17
1714604555136,EDS 139,B00,507313,Pappas; Elizabeth,13,0,30,17
1714604556162,EDS 201,A00,507315,Staff,13,0,30,17
1714604557191,EDS 203,A01,507317,Halter; Christopher P.,12,0,30,18
1714604558216,EDS 204R,A01,507319,Halter; Christopher P.,0,3,30,30
1714604558216,EDS 204R,B01,507331,Heinzman; Erica M.,16,0,30,14
1714604559241,EDS 206R,A00,507332,Staff,0,4,30,30
1714604559241,EDS 206R,B00,507343,Staff,17,0,30,13
1714604560268,EDS 250,A00,507344,Hemans; Patricia Ann Benitez,22,0,40,18
1714604561292,EDS 281,A00,507345,Daly; Alan J.,18,0,18,0
1714604562317,EDS 284,A00,507350,Daly; Alan J.,16,0,16,0
1714604563544,EDS 286,A00,507359,Fine; Sarah,18,0,18,0
1714604564570,EDS 289C,A01,507361,Daly; Alan J.,18,0,18,0
1714604565598,EDS 290,A00,507366,Hofstetter; Carolyn,15,0,15,0
1714604566631,LIGM 5A,A00,507421,Fischer-Grunski; Eva K,18,0,20,2
1714604567661,LIGM 5B,A00,507423,Fischer-Grunski; Eva K,19,0,20,1
1714604568690,LIGM 5C,A00,507425,Fischer-Grunski; Eva K,19,0,20,1
1714604569717,LIIT 5AS,A00,507427,Carnelos; Chiara,20,0,20,0
1714604570744,LIIT 5BS,A00,507430,Carnelos; Chiara,20,0,20,0
1714604571773,LIIT 5CS,A00,507432,Carnelos; Chiara,20,0,20,0
1714604572803,LISP 5A,A00,507541,Munoz Sanchez; Alicia,11,0,20,9
1714604573827,LISP 5B,A00,507671,Munoz Sanchez; Alicia,8,0,20,12
1714604574857,LISP 5C,A00,507696,Munoz Sanchez; Alicia,9,0,20,11
1714604575883,MAE 197,001,528363,Boechler; Nicholas Sebastia,9998,0,9999,1
1714604576909,MATH 197,001,523477,Kedlaya; Kiran S.,9995,0,9999,4
1714604576909,MATH 197,002,563811,Zhang; Danna,9995,0,9999,4
1714604576909,MATH 197,003,628552,Dumitriu; Ioana,9998,0,9999,1
1714604577935,MCWP 40R,A00,518780,Staff,2,0,20,18
1714604577935,MCWP 40R,B00,518781,Staff,8,0,20,12
1714604577935,MCWP 40R,C00,518783,Staff,6,0,20,14
1714604578963,MCWP 50R,A00,518791,Staff,0,0,20,20
1714604578963,MCWP 50R,B00,518792,Staff,0,2,20,20
1714604578963,MCWP 50R,C00,518793,Staff,0,2,20,20
1714604578963,MCWP 50R,D00,518794,Staff,0,0,20,20
1714604578963,MCWP 50R,E00,518795,Staff,0,2,20,20
1714604578963,MCWP 50R,F00,518796,Staff,0,0,20,20
1714604578963,MCWP 50R,G00,518797,Staff,0,1,20,20
1714604579993,MMW 12R,A01,514034,Herbst; Matthew,0,0,16,16
1714604579993,MMW 12R,A02,514035,Herbst; Matthew,1,0,16,15
1714604581021,MMW 13R,A01,514037,Staff,0,4,16,16
1714604581021,MMW 13R,A02,514039,Staff,0,2,16,16
1714604581021,MMW 13R,A03,628519,Staff,0,2,16,16
1714604583083,SIO 295LS,A00,523233,Staff,10,0,30,20
1714604584108,SIO 295S,A00,523232,Staff,10,0,30,20
1714604585134,SIOC 290S,A01,637330,Merrifield; Mark A,23,0,30,7
1714604586161,SIOC 291S,A01,637333,Gabriel; Corey John,23,0,30,7
1714604587223,SOCI 117,A01,494376,Staff,0,4,5,5
1714604588249,WES 237B,A00,494380,Staff,9,0,20,11
1714604590312,AESE 279B,A00,494370,Wade; Jon P,0,0,33,33
1714604591337,AIP 197,001,627712,Vespa; Emanuel Ignacio,9998,0,9999,1
1714604592362,ANAR 135S,A00,494369,Braswell; Geoffrey E.,0,0,0,0
1714604593387,BENG 196,001,628496,Engler; Adam J.,9998,0,9999,1
1714604594413,CAT 124RS,A01,519847,Geibel; William,0,0,20,20
1714604595441,CAT 125RS,A01,515971,Geibel; William,0,0,20,20
1714604596466,CLRE 250,A00,511389,Morris; Sheldon,9993,0,9999,6
1714604597498,CLRE 251,A00,507176,Mehta; Ravindra L.,9993,0,9999,6
1714604597498,CLRE 251,B00,511410,Mehta; Ravindra L.,9998,0,9999,1
1714604598522,CLRE 252,A00,507189,Cuomo; Raphael Eduardo,9995,0,9999,4
1714604599548,CLRE 253,A00,507199,Vaida; Florin,9994,0,9999,5
1714604599548,CLRE 253,B00,507202,Vaida; Florin,9999,0,9999,0
1714604600573,CLRE 259,A00,507211,Patel; Hemal,9996,0,9999,3
1714604601601,CLRE 260,A00,507221,Cuomo; Raphael Eduardo,9999,0,9999,0
1714604602625,CLRE 297,001,507242,Cuomo; Raphael Eduardo,9999,0,9999,0
1714604603654,COGS 197,001,638244,Voytek; Bradley Thomas,9998,0,9999,1
1714604604681,CSE 191,A00,516875,Minnes Kemp; Mor Mia,9993,0,9999,6
1714604605707,CSE 197,001,637388,Minnes Kemp; Mor Mia,9998,0,9999,1
1714604606734,CSS 201S,A01,494383,Staff,35,0,35,0
1714604607759,CSS 202S,A01,494387,Staff,35,0,35,0
1714604608782,DSC 197,001,628532,Eldridge; Justin Matthew,9996,0,9999,3
1714604609810,EAP 100,A00,516065,Staff,9797,0,9999,202
1714604610836,ECE 45,A01,507414,Staff,33,0,60,27
1714604612895,ECE 111,A01,507420,Staff,15,0,50,35
1714604613919,ECE 197,001,548057,Sievenpiper; Daniel F.,9993,0,9999,6
1714604614946,EDS 115,A00,507243,Choi; Bailey Miyeon,10,0,28,18
1714604615973,EDS 117,A01,494379,Staff,1,5,30,29
1714604617001,EDS 125,A00,507246,Hopkins; Megan Beth,9,0,30,21
1714604618030,EDS 128A,A01,507264,Fargason; Sharon Gayle,8,0,26,18
1714604619056,EDS 128B,A01,507293,Pappas; Elizabeth,12,0,30,18
1714604620085,EDS 139,A00,507294,Fargason; Sharon Gayle,13,0,30,17
1714604620085,EDS 139,B00,507313,Pappas; Elizabeth,13,0,30,17
1714604621112,EDS 201,A00,507315,Staff,13,0,30,17
1714604622141,EDS 203,A01,507317,Halter; Christopher P.,12,0,30,18
1714604623165,EDS 204R,A01,507319,Halter; Christopher P.,0,3,30,30
1714604623165,EDS 204R,B01,507331,Heinzman; Erica M.,16,0,30,14
1714604624192,EDS 206R,A00,507332,Staff,0,4,30,30
1714604624192,EDS 206R,B00,507343,Staff,17,0,30,13
1714604625220,EDS 250,A00,507344,Hemans; Patricia Ann Benitez,22,0,40,18
1714604626248,EDS 281,A00,507345,Daly; Alan J.,18,0,18,0
1714604627278,EDS 284,A00,507350,Daly; Alan J.,16,0,16,0
1714604628303,EDS 286,A00,507359,Fine; Sarah,18,0,18,0
1714604629333,EDS 289C,A01,507361,Daly; Alan J.,18,0,18,0
1714604630364,EDS 290,A00,507366,Hofstetter; Carolyn,15,0,15,0
1714604631390,LIGM 5A,A00,507421,Fischer-Grunski; Eva K,18,0,20,2
1714604632419,LIGM 5B,A00,507423,Fischer-Grunski; Eva K,19,0,20,1
1714604633447,LIGM 5C,A00,507425,Fischer-Grunski; Eva K,19,0,20,1
1714604634477,LIIT 5AS,A00,507427,Carnelos; Chiara,20,0,20,0
1714604635503,LIIT 5BS,A00,507430,Carnelos; Chiara,20,0,20,0
1714604636533,LIIT 5CS,A00,507432,Carnelos; Chiara,20,0,20,0
1714604637557,LISP 5A,A00,507541,Munoz Sanchez; Alicia,11,0,20,9
1714604638587,LISP 5B,A00,507671,Munoz Sanchez; Alicia,8,0,20,12
1714604639620,LISP 5C,A00,507696,Munoz Sanchez; Alicia,9,0,20,11
1714604640645,MAE 197,001,528363,Boechler; Nicholas Sebastia,9998,0,9999,1
1714604641671,MATH 197,001,523477,Kedlaya; Kiran S.,9995,0,9999,4
1714604641671,MATH 197,002,563811,Zhang; Danna,9995,0,9999,4
1714604641671,MATH 197,003,628552,Dumitriu; Ioana,9998,0,9999,1
1714604642699,MCWP 40R,A00,518780,Staff,2,0,20,18
1714604642699,MCWP 40R,B00,518781,Staff,8,0,20,12
1714604642699,MCWP 40R,C00,518783,Staff,6,0,20,14
1714604643726,MCWP 50R,A00,518791,Staff,0,0,20,20
1714604643726,MCWP 50R,B00,518792,Staff,0,2,20,20
1714604643726,MCWP 50R,C00,518793,Staff,0,2,20,20
1714604643726,MCWP 50R,D00,518794,Staff,0,0,20,20
1714604643726,MCWP 50R,E00,518795,Staff,0,2,20,20
1714604643726,MCWP 50R,F00,518796,Staff,0,0,20,20
1714604643726,MCWP 50R,G00,518797,Staff,0,1,20,20
1714604644752,MMW 12R,A01,514034,Herbst; Matthew,0,0,16,16
1714604644752,MMW 12R,A02,514035,Herbst; Matthew,1,0,16,15
1714604645777,MMW 13R,A01,514037,Staff,0,4,16,16
1714604645777,MMW 13R,A02,514039,Staff,0,2,16,16
1714604645777,MMW 13R,A03,628519,Staff,0,2,16,16
1714604647826,SIO 295LS,A00,523233,Staff,10,0,30,20
1714604648852,SIO 295S,A00,523232,Staff,10,0,30,20
1714604649882,SIOC 290S,A01,637330,Merrifield; Mark A,23,0,30,7
1714604650910,SIOC 291S,A01,637333,Gabriel; Corey John,23,0,30,7
1714604651935,SOCI 117,A01,494376,Staff,0,4,5,5
1714604652962,WES 237B,A00,494380,Staff,9,0,20,11
1714604655026,AESE 279B,A00,494370,Wade; Jon P,0,0,33,33
1714604656053,AIP 197,001,627712,Vespa; Emanuel Ignacio,9998,0,9999,1
1714604657079,ANAR 135S,A00,494369,Braswell; Geoffrey E.,0,0,0,0
1714604658107,BENG 196,001,628496,Engler; Adam J.,9998,0,9999,1
1714604659134,CAT 124RS,A01,519847,Geibel; William,0,0,20,20
1714604660159,CAT 125RS,A01,515971,Geibel; William,0,0,20,20
1714604661182,CLRE 250,A00,511389,Morris; Sheldon,9993,0,9999,6
1714604662208,CLRE 251,A00,507176,Mehta; Ravindra L.,9993,0,9999,6
1714604662208,CLRE 251,B00,511410,Mehta; Ravindra L.,9998,0,9999,1
1714604663237,CLRE 252,A00,507189,Cuomo; Raphael Eduardo,9995,0,9999,4
1714604664263,CLRE 253,A00,507199,Vaida; Florin,9994,0,9999,5
1714604664263,CLRE 253,B00,507202,Vaida; Florin,9999,0,9999,0
1714604665293,CLRE 259,A00,507211,Patel; Hemal,9996,0,9999,3
1714604666319,CLRE 260,A00,507221,Cuomo; Raphael Eduardo,9999,0,9999,0
1714604667344,CLRE 297,001,507242,Cuomo; Raphael Eduardo,9999,0,9999,0
1714604668370,COGS 197,001,638244,Voytek; Bradley Thomas,9998,0,9999,1
1714604669398,CSE 191,A00,516875,Minnes Kemp; Mor Mia,9993,0,9999,6
1714604670424,CSE 197,001,637388,Minnes Kemp; Mor Mia,9998,0,9999,1
1714604671451,CSS 201S,A01,494383,Staff,35,0,35,0
1714604672475,CSS 202S,A01,494387,Staff,35,0,35,0
1714604673504,DSC 197,001,628532,Eldridge; Justin Matthew,9996,0,9999,3
1714604674532,EAP 100,A00,516065,Staff,9797,0,9999,202
1714604675560,ECE 45,A01,507414,Staff,33,0,60,27
1714604677615,ECE 111,A01,507420,Staff,15,0,50,35
1714604678642,ECE 197,001,548057,Sievenpiper; Daniel F.,9993,0,9999,6
1714604679669,EDS 115,A00,507243,Choi; Bailey Miyeon,10,0,28,18
1714604680694,EDS 117,A01,494379,Staff,1,5,30,29
1714604681719,EDS 125,A00,507246,Hopkins; Megan Beth,9,0,30,21
1714604682744,EDS 128A,A01,507264,Fargason; Sharon Gayle,8,0,26,18
1714604683770,EDS 128B,A01,507293,Pappas; Elizabeth,12,0,30,18
1714604684793,EDS 139,A00,507294,Fargason; Sharon Gayle,13,0,30,17
1714604684793,EDS 139,B00,507313,Pappas; Elizabeth,13,0,30,17
1714604685819,EDS 201,A00,507315,Staff,13,0,30,17
1714604686902,EDS 203,A01,507317,Halter; Christopher P.,12,0,30,18
1714604687928,EDS 204R,A01,507319,Halter; Christopher P.,0,3,30,30
1714604687928,EDS 204R,B01,507331,Heinzman; Erica M.,16,0,30,14
1714604688956,EDS 206R,A00,507332,Staff,0,4,30,30
1714604688956,EDS 206R,B00,507343,Staff,17,0,30,13
1714604689982,EDS 250,A00,507344,Hemans; Patricia Ann Benitez,22,0,40,18
1714604691007,EDS 281,A00,507345,Daly; Alan J.,18,0,18,0
1714604692032,EDS 284,A00,507350,Daly; Alan J.,16,0,16,0
1714604693057,EDS 286,A00,507359,Fine; Sarah,18,0,18,0
1714604694086,EDS 289C,A01,507361,Daly; Alan J.,18,0,18,0
1714604695115,EDS 290,A00,507366,Hofstetter; Carolyn,15,0,15,0
1714604696140,LIGM 5A,A00,507421,Fischer-Grunski; Eva K,18,0,20,2
1714604697165,LIGM 5B,A00,507423,Fischer-Grunski; Eva K,19,0,20,1
1714604698193,LIGM 5C,A00,507425,Fischer-Grunski; Eva K,19,0,20,1
1714604699219,LIIT 5AS,A00,507427,Carnelos; Chiara,20,0,20,0
1714604700250,LIIT 5BS,A00,507430,Carnelos; Chiara,20,0,20,0
1714604701275,LIIT 5CS,A00,507432,Carnelos; Chiara,20,0,20,0
1714604702300,LISP 5A,A00,507541,Munoz Sanchez; Alicia,11,0,20,9
1714604703326,LISP 5B,A00,507671,Munoz Sanchez; Alicia,8,0,20,12
1714604704351,LISP 5C,A00,507696,Munoz Sanchez; Alicia,9,0,20,11
1714604705377,MAE 197,001,528363,Boechler; Nicholas Sebastia,9998,0,9999,1
1714604706408,MATH 197,001,523477,Kedlaya; Kiran S.,9995,0,9999,4
1714604706408,MATH 197,002,563811,Zhang; Danna,9995,0,9999,4
1714604706408,MATH 197,003,628552,Dumitriu; Ioana,9998,0,9999,1
1714604707437,MCWP 40R,A00,518780,Staff,2,0,20,18
1714604707437,MCWP 40R,B00,518781,Staff,8,0,20,12
1714604707437,MCWP 40R,C00,518783,Staff,6,0,20,14
1714604708462,MCWP 50R,A00,518791,Staff,0,0,20,20
1714604708462,MCWP 50R,B00,518792,Staff,0,2,20,20
1714604708462,MCWP 50R,C00,518793,Staff,0,2,20,20
1714604708462,MCWP 50R,D00,518794,Staff,0,0,20,20
1714604708462,MCWP 50R,E00,518795,Staff,0,2,20,20
1714604708462,MCWP 50R,F00,518796,Staff,0,0,20,20
1714604708462,MCWP 50R,G00,518797,Staff,0,1,20,20
1714604709492,MMW 12R,A01,514034,Herbst; Matthew,0,0,16,16
1714604709492,MMW 12R,A02,514035,Herbst; Matthew,1,0,16,15
1714604710516,MMW 13R,A01,514037,Staff,0,4,16,16
1714604710516,MMW 13R,A02,514039,Staff,0,2,16,16
1714604710516,MMW 13R,A03,628519,Staff,0,2,16,16
1714604712571,SIO 295LS,A00,523233,Staff,10,0,30,20
1714604713598,SIO 295S,A00,523232,Staff,10,0,30,20
1714604714625,SIOC 290S,A01,637330,Merrifield; Mark A,23,0,30,7
1714604715653,SIOC 291S,A01,637333,Gabriel; Corey John,23,0,30,7
1714604716678,SOCI 117,A01,494376,Staff,0,4,5,5
1714604717707,WES 237B,A00,494380,Staff,9,0,20,11
1714604719770,AESE 279B,A00,494370,Wade; Jon P,0,0,33,33
1714604720797,AIP 197,001,627712,Vespa; Emanuel Ignacio,9998,0,9999,1
1714604721826,ANAR 135S,A00,494369,Braswell; Geoffrey E.,0,0,0,0
1714604722850,BENG 196,001,628496,Engler; Adam J.,9998,0,9999,1
1714604723876,CAT 124RS,A01,519847,Geibel; William,0,0,20,20
1714604724900,CAT 125RS,A01,515971,Geibel; William,0,0,20,20
1714604725927,CLRE 250,A00,511389,Morris; Sheldon,9993,0,9999,6
1714604726952,CLRE 251,A00,507176,Mehta; Ravindra L.,9993,0,9999,6
1714604726952,CLRE 251,B00,511410,Mehta; Ravindra L.,9998,0,9999,1
1714604727981,CLRE 252,A00,507189,Cuomo; Raphael Eduardo,9995,0,9999,4
1714604729010,CLRE 253,A00,507199,Vaida; Florin,9994,0,9999,5
1714604729010,CLRE 253,B00,507202,Vaida; Florin,9999,0,9999,0
1714604730039,CLRE 259,A00,507211,Patel; Hemal,9996,0,9999,3
1714604731065,CLRE 260,A00,507221,Cuomo; Raphael Eduardo,9999,0,9999,0
1714604732090,CLRE 297,001,507242,Cuomo; Raphael Eduardo,9999,0,9999,0
1714604733117,COGS 197,001,638244,Voytek; Bradley Thomas,9998,0,9999,1
1714604734141,CSE 191,A00,516875,Minnes Kemp; Mor Mia,9993,0,9999,6
1714604735164,CSE 197,001,637388,Minnes Kemp; Mor Mia,9998,0,9999,1
1714604736192,CSS 201S,A01,494383,Staff,35,0,35,0
1714604737216,CSS 202S,A01,494387,Staff,35,0,35,0
1714604738242,DSC 197,001,628532,Eldridge; Justin Matthew,9996,0,9999,3
1714604739267,EAP 100,A00,516065,Staff,9797,0,9999,202
1714604740295,ECE 45,A01,507414,Staff,33,0,60,27
1714604742346,ECE 111,A01,507420,Staff,15,0,50,35
1714604743372,ECE 197,001,548057,Sievenpiper; Daniel F.,9993,0,9999,6
1714604744401,EDS 115,A00,507243,Choi; Bailey Miyeon,10,0,28,18
1714604745427,EDS 117,A01,494379,Staff,1,5,30,29
1714604746454,EDS 125,A00,507246,Hopkins; Megan Beth,9,0,30,21
1714604747479,EDS 128A,A01,507264,Fargason; Sharon Gayle,8,0,26,18
1714604748504,EDS 128B,A01,507293,Pappas; Elizabeth,12,0,30,18
1714604749529,EDS 139,A00,507294,Fargason; Sharon Gayle,13,0,30,17
1714604749529,EDS 139,B00,507313,Pappas; Elizabeth,13,0,30,17
1714604750553,EDS 201,A00,507315,Staff,13,0,30,17
1714604751583,EDS 203,A01,507317,Halter; Christopher P.,12,0,30,18
1714604752608,EDS 204R,A01,507319,Halter; Christopher P.,0,3,30,30
1714604752608,EDS 204R,B01,507331,Heinzman; Erica M.,16,0,30,14
1714604753637,EDS 206R,A00,507332,Staff,0,4,30,30
1714604753637,EDS 206R,B00,507343,Staff,17,0,30,13
1714604754662,EDS 250,A00,507344,Hemans; Patricia Ann Benitez,22,0,40,18
1714604755687,EDS 281,A00,507345,Daly; Alan J.,18,0,18,0
1714604756710,EDS 284,A00,507350,Daly; Alan J.,16,0,16,0
1714604757738,EDS 286,A00,507359,Fine; Sarah,18,0,18,0
1714604758770,EDS 289C,A01,507361,Daly; Alan J.,18,0,18,0
1714604759795,EDS 290,A00,507366,Hofstetter; Carolyn,15,0,15,0
1714604760825,LIGM 5A,A00,507421,Fischer-Grunski; Eva K,18,0,20,2
1714604761853,LIGM 5B,A00,507423,Fischer-Grunski; Eva K,19,0,20,1
1714604762879,LIGM 5C,A00,507425,Fischer-Grunski; Eva K,19,0,20,1
1714604763905,LIIT 5AS,A00,507427,Carnelos; Chiara,20,0,20,0
1714604764934,LIIT 5BS,A00,507430,Carnelos; Chiara,20,0,20,0
1714604765959,LIIT 5CS,A00,507432,Carnelos; Chiara,20,0,20,0
1714604766984,LISP 5A,A00,507541,Munoz Sanchez; Alicia,11,0,20,9
1714604768010,LISP 5B,A00,507671,Munoz Sanchez; Alicia,8,0,20,12
1714604769035,LISP 5C,A00,507696,Munoz Sanchez; Alicia,9,0,20,11
1714604770060,MAE 197,001,528363,Boechler; Nicholas Sebastia,9998,0,9999,1
1714604771092,MATH 197,001,523477,Kedlaya; Kiran S.,9995,0,9999,4
1714604771092,MATH 197,002,563811,Zhang; Danna,9995,0,9999,4
1714604771092,MATH 197,003,628552,Dumitriu; Ioana,9998,0,9999,1
1714604772118,MCWP 40R,A00,518780,Staff,2,0,20,18
1714604772118,MCWP 40R,B00,518781,Staff,8,0,20,12
1714604772118,MCWP 40R,C00,518783,Staff,6,0,20,14
1714604773145,MCWP 50R,A00,518791,Staff,0,0,20,20
1714604773145,MCWP 50R,B00,518792,Staff,0,2,20,20
1714604773145,MCWP 50R,C00,518793,Staff,0,2,20,20
1714604773145,MCWP 50R,D00,518794,Staff,0,0,20,20
1714604773145,MCWP 50R,E00,518795,Staff,0,2,20,20
1714604773145,MCWP 50R,F00,518796,Staff,0,0,20,20
1714604773145,MCWP 50R,G00,518797,Staff,0,1,20,20
1714604774175,MMW 12R,A01,514034,Herbst; Matthew,0,0,16,16
1714604774175,MMW 12R,A02,514035,Herbst; Matthew,1,0,16,15
1714604775200,MMW 13R,A01,514037,Staff,0,4,16,16
1714604775200,MMW 13R,A02,514039,Staff,0,2,16,16
1714604775200,MMW 13R,A03,628519,Staff,0,2,16,16
1714604777253,SIO 295LS,A00,523233,Staff,10,0,30,20
1714604778277,SIO 295S,A00,523232,Staff,10,0,30,20
1714604779302,SIOC 290S,A01,637330,Merrifield; Mark A,23,0,30,7
1714604780331,SIOC 291S,A01,637333,Gabriel; Corey John,23,0,30,7
1714604781356,SOCI 117,A01,494376,Staff,0,4,5,5
1714604782382,WES 237B,A00,494380,Staff,9,0,20,11
1714604784458,AESE 279B,A00,494370,Wade; Jon P,0,0,33,33
1714604785486,AIP 197,001,627712,Vespa; Emanuel Ignacio,9998,0,9999,1
1714604786511,ANAR 135S,A00,494369,Braswell; Geoffrey E.,0,0,0,0
1714604787535,BENG 196,001,628496,Engler; Adam J.,9998,0,9999,1
1714604788561,CAT 124RS,A01,519847,Geibel; William,0,0,20,20
1714604789589,CAT 125RS,A01,515971,Geibel; William,0,0,20,20
1714604790616,CLRE 250,A00,511389,Morris; Sheldon,9993,0,9999,6
1714604791643,CLRE 251,A00,507176,Mehta; Ravindra L.,9993,0,9999,6
1714604791643,CLRE 251,B00,511410,Mehta; Ravindra L.,9998,0,9999,1
1714604792671,CLRE 252,A00,507189,Cuomo; Raphael Eduardo,9995,0,9999,4
1714604793702,CLRE 253,A00,507199,Vaida; Florin,9994,0,9999,5
1714604793702,CLRE 253,B00,507202,Vaida; Florin,9999,0,9999,0
1714604794729,CLRE 259,A00,507211,Patel; Hemal,9996,0,9999,3
1714604795754,CLRE 260,A00,507221,Cuomo; Raphael Eduardo,9999,0,9999,0
1714604796783,CLRE 297,001,507242,Cuomo; Raphael Eduardo,9999,0,9999,0
1714604797811,COGS 197,001,638244,Voytek; Bradley Thomas,9998,0,9999,1
1714604798834,CSE 191,A00,516875,Minnes Kemp; Mor Mia,9993,0,9999,6
1714604799864,CSE 197,001,637388,Minnes Kemp; Mor Mia,9998,0,9999,1
1714604800893,CSS 201S,A01,494383,Staff,35,0,35,0
1714604801919,CSS 202S,A01,494387,Staff,35,0,35,0
1714604802947,DSC 197,001,628532,Eldridge; Justin Matthew,9996,0,9999,3
1714604803973,EAP 100,A00,516065,Staff,9797,0,9999,202
1714604805002,ECE 45,A01,507414,Staff,33,0,60,27
1714604807054,ECE 111,A01,507420,Staff,15,0,50,35
1714604808084,ECE 197,001,548057,Sievenpiper; Daniel F.,9993,0,9999,6
1714604809114,EDS 115,A00,507243,Choi; Bailey Miyeon,10,0,28,18
1714604810165,EDS 117,A01,494379,Staff,1,5,30,29
1714604811192,EDS 125,A00,507246,Hopkins; Megan Beth,9,0,30,21
1714604812219,EDS 128A,A01,507264,Fargason; Sharon Gayle,8,0,26,18
1714604813245,EDS 128B,A01,507293,Pappas; Elizabeth,12,0,30,18
1714604814271,EDS 139,A00,507294,Fargason; Sharon Gayle,13,0,30,17
1714604814271,EDS 139,B00,507313,Pappas; Elizabeth,13,0,30,17
1714604815297,EDS 201,A00,507315,Staff,13,0,30,17
1714604816322,EDS 203,A01,507317,Halter; Christopher P.,12,0,30,18
1714604817351,EDS 204R,A01,507319,Halter; Christopher P.,0,3,30,30
1714604817351,EDS 204R,B01,507331,Heinzman; Erica M.,16,0,30,14
1714604818376,EDS 206R,A00,507332,Staff,0,4,30,30
1714604818376,EDS 206R,B00,507343,Staff,17,0,30,13
1714604819401,EDS 250,A00,507344,Hemans; Patricia Ann Benitez,22,0,40,18
1714604820425,EDS 281,A00,507345,Daly; Alan J.,18,0,18,0
1714604821449,EDS 284,A00,507350,Daly; Alan J.,16,0,16,0
1714604822516,EDS 286,A00,507359,Fine; Sarah,18,0,18,0
1714604823541,EDS 289C,A01,507361,Daly; Alan J.,18,0,18,0
1714604824566,EDS 290,A00,507366,Hofstetter; Carolyn,15,0,15,0
1714604825590,LIGM 5A,A00,507421,Fischer-Grunski; Eva K,18,0,20,2
1714604826616,LIGM 5B,A00,507423,Fischer-Grunski; Eva K,19,0,20,1
1714604827640,LIGM 5C,A00,507425,Fischer-Grunski; Eva K,19,0,20,1
1714604828666,LIIT 5AS,A00,507427,Carnelos; Chiara,20,0,20,0
1714604829691,LIIT 5BS,A00,507430,Carnelos; Chiara,20,0,20,0
1714604830717,LIIT 5CS,A00,507432,Carnelos; Chiara,20,0,20,0
1714604831748,LISP 5A,A00,507541,Munoz Sanchez; Alicia,11,0,20,9
1714604832773,LISP 5B,A00,507671,Munoz Sanchez; Alicia,8,0,20,12
1714604833799,LISP 5C,A00,507696,Munoz Sanchez; Alicia,9,0,20,11
1714604834825,MAE 197,001,528363,Boechler; Nicholas Sebastia,9998,0,9999,1
1714604835850,MATH 197,001,523477,Kedlaya; Kiran S.,9995,0,9999,4
1714604835850,MATH 197,002,563811,Zhang; Danna,9995,0,9999,4
1714604835850,MATH 197,003,628552,Dumitriu; Ioana,9998,0,9999,1
1714604836881,MCWP 40R,A00,518780,Staff,2,0,20,18
1714604836881,MCWP 40R,B00,518781,Staff,8,0,20,12
1714604836881,MCWP 40R,C00,518783,Staff,6,0,20,14
1714604837907,MCWP 50R,A00,518791,Staff,0,0,20,20
1714604837907,MCWP 50R,B00,518792,Staff,0,2,20,20
1714604837907,MCWP 50R,C00,518793,Staff,0,2,20,20
1714604837907,MCWP 50R,D00,518794,Staff,0,0,20,20
1714604837907,MCWP 50R,E00,518795,Staff,0,2,20,20
1714604837907,MCWP 50R,F00,518796,Staff,0,0,20,20
1714604837907,MCWP 50R,G00,518797,Staff,0,1,20,20
1714604838937,MMW 12R,A01,514034,Herbst; Matthew,0,0,16,16
1714604838937,MMW 12R,A02,514035,Herbst; Matthew,1,0,16,15
1714604839962,MMW 13R,A01,514037,Staff,0,4,16,16
1714604839962,MMW 13R,A02,514039,Staff,0,2,16,16
1714604839962,MMW 13R,A03,628519,Staff,0,2,16,16
1714604842018,SIO 295LS,A00,523233,Staff,10,0,30,20
1714604843048,SIO 295S,A00,523232,Staff,10,0,30,20
1714604844079,SIOC 290S,A01,637330,Merrifield; Mark A,23,0,30,7
1714604845106,SIOC 291S,A01,637333,Gabriel; Corey John,23,0,30,7
1714604846136,SOCI 117,A01,494376,Staff,0,4,5,5
1714604847161,WES 237B,A00,494380,Staff,9,0,20,11
1714604849241,AESE 279B,A00,494370,Wade; Jon P,0,0,33,33
1714604850269,AIP 197,001,627712,Vespa; Emanuel Ignacio,9998,0,9999,1
1714604851295,ANAR 135S,A00,494369,Braswell; Geoffrey E.,0,0,0,0
1714604852320,BENG 196,001,628496,Engler; Adam J.,9998,0,9999,1
1714604853348,CAT 124RS,A01,519847,Geibel; William,0,0,20,20
1714604854376,CAT 125RS,A01,515971,Geibel; William,0,0,20,20
1714604855402,CLRE 250,A00,511389,Morris; Sheldon,9993,0,9999,6
1714604856428,CLRE 251,A00,507176,Mehta; Ravindra L.,9993,0,9999,6
1714604856428,CLRE 251,B00,511410,Mehta; Ravindra L.,9998,0,9999,1
1714604857458,CLRE 252,A00,507189,Cuomo; Raphael Eduardo,9995,0,9999,4
1714604858488,CLRE 253,A00,507199,Vaida; Florin,9994,0,9999,5
1714604858488,CLRE 253,B00,507202,Vaida; Florin,9999,0,9999,0
1714604859513,CLRE 259,A00,507211,Patel; Hemal,9996,0,9999,3
1714604860540,CLRE 260,A00,507221,Cuomo; Raphael Eduardo,9999,0,9999,0
1714604861566,CLRE 297,001,507242,Cuomo; Raphael Eduardo,9999,0,9999,0
1714604862591,COGS 197,001,638244,Voytek; Bradley Thomas,9998,0,9999,1
1714604863616,CSE 191,A00,516875,Minnes Kemp; Mor Mia,9993,0,9999,6
1714604864643,CSE 197,001,637388,Minnes Kemp; Mor Mia,9998,0,9999,1
1714604865668,CSS 201S,A01,494383,Staff,35,0,35,0
1714604866694,CSS 202S,A01,494387,Staff,35,0,35,0
1714604867719,DSC 197,001,628532,Eldridge; Justin Matthew,9996,0,9999,3
1714604868744,EAP 100,A00,516065,Staff,9797,0,9999,202
1714604869776,ECE 45,A01,507414,Staff,33,0,60,27
1714604871828,ECE 111,A01,507420,Staff,15,0,50,35
1714604872853,ECE 197,001,548057,Sievenpiper; Daniel F.,9993,0,9999,6
1714604873879,EDS 115,A00,507243,Choi; Bailey Miyeon,10,0,28,18
1714604874906,EDS 117,A01,494379,Staff,1,5,30,29
1714604875931,EDS 125,A00,507246,Hopkins; Megan Beth,9,0,30,21
1714604876955,EDS 128A,A01,507264,Fargason; Sharon Gayle,8,0,26,18
1714604877984,EDS 128B,A01,507293,Pappas; Elizabeth,12,0,30,18
1714604879011,EDS 139,A00,507294,Fargason; Sharon Gayle,13,0,30,17
1714604879011,EDS 139,B00,507313,Pappas; Elizabeth,13,0,30,17
1714604880036,EDS 201,A00,507315,Staff,13,0,30,17
1714604881062,EDS 203,A01,507317,Halter; Christopher P.,12,0,30,18
1714604882091,EDS 204R,A01,507319,Halter; Christopher P.,0,3,30,30
1714604882091,EDS 204R,B01,507331,Heinzman; Erica M.,16,0,30,14
1714604883115,EDS 206R,A00,507332,Staff,0,4,30,30
1714604883115,EDS 206R,B00,507343,Staff,17,0,30,13
1714604884144,EDS 250,A00,507344,Hemans; Patricia Ann Benitez,22,0,40,18
1714604885202,EDS 281,A00,507345,Daly; Alan J.,18,0,18,0
1714604886226,EDS 284,A00,507350,Daly; Alan J.,16,0,16,0
1714604887255,EDS 286,A00,507359,Fine; Sarah,18,0,18,0
1714604888279,EDS 289C,A01,507361,Daly; Alan J.,18,0,18,0
1714604889303,EDS 290,A00,507366,Hofstetter; Carolyn,15,0,15,0
1714604890327,LIGM 5A,A00,507421,Fischer-Grunski; Eva K,18,0,20,2
1714604891352,LIGM 5B,A00,507423,Fischer-Grunski; Eva K,19,0,20,1
1714604892376,LIGM 5C,A00,507425,Fischer-Grunski; Eva K,19,0,20,1
1714604893401,LIIT 5AS,A00,507427,Carnelos; Chiara,20,0,20,0
1714604894426,LIIT 5BS,A00,507430,Carnelos; Chiara,20,0,20,0
1714604895451,LIIT 5CS,A00,507432,Carnelos; Chiara,20,0,20,0
1714604896477,LISP 5A,A00,507541,Munoz Sanchez; Alicia,11,0,20,9
1714604897502,LISP 5B,A00,507671,Munoz Sanchez; Alicia,8,0,20,12
1714604898526,LISP 5C,A00,507696,Munoz Sanchez; Alicia,9,0,20,11
1714604899553,MAE 197,001,528363,Boechler; Nicholas Sebastia,9998,0,9999,1
1714604900582,MATH 197,001,523477,Kedlaya; Kiran S.,9995,0,9999,4
1714604900582,MATH 197,002,563811,Zhang; Danna,9995,0,9999,4
1714604900582,MATH 197,003,628552,Dumitriu; Ioana,9998,0,9999,1
1714604901608,MCWP 40R,A00,518780,Staff,2,0,20,18
1714604901608,MCWP 40R,B00,518781,Staff,8,0,20,12
1714604901608,MCWP 40R,C00,518783,Staff,6,0,20,14
1714604902638,MCWP 50R,A00,518791,Staff,0,0,20,20
1714604902638,MCWP 50R,B00,518792,Staff,0,2,20,20
1714604902638,MCWP 50R,C00,518793,Staff,0,2,20,20
1714604902638,MCWP 50R,D00,518794,Staff,0,0,20,20
1714604902638,MCWP 50R,E00,518795,Staff,0,2,20,20
1714604902638,MCWP 50R,F00,518796,Staff,0,0,20,20
1714604902638,MCWP 50R,G00,518797,Staff,0,1,20,20
1714604903663,MMW 12R,A01,514034,Herbst; Matthew,0,0,16,16
1714604903663,MMW 12R,A02,514035,Herbst; Matthew,1,0,16,15
1714604904690,MMW 13R,A01,514037,Staff,0,4,16,16
1714604904690,MMW 13R,A02,514039,Staff,0,2,16,16
1714604904690,MMW 13R,A03,628519,Staff,0,2,16,16
1714604906745,SIO 295LS,A00,523233,Staff,10,0,30,20
1714604907771,SIO 295S,A00,523232,Staff,10,0,30,20
1714604908798,SIOC 290S,A01,637330,Merrifield; Mark A,23,0,30,7
1714604909822,SIOC 291S,A01,637333,Gabriel; Corey John,23,0,30,7
1714604910850,SOCI 117,A01,494376,Staff,0,4,5,5
1714604911879,WES 237B,A00,494380,Staff,9,0,20,11
1714604913948,AESE 279B,A00,494370,Wade; Jon P,0,0,33,33
1714604914974,AIP 197,001,627712,Vespa; Emanuel Ignacio,9998,0,9999,1
1714604916017,ANAR 135S,A00,494369,Braswell; Geoffrey E.,0,0,0,0
1714604917043,BENG 196,001,628496,Engler; Adam J.,9998,0,9999,1
1714604918069,CAT 124RS,A01,519847,Geibel; William,0,0,20,20
1714604919093,CAT 125RS,A01,515971,Geibel; William,0,0,20,20
1714604920118,CLRE 250,A00,511389,Morris; Sheldon,9993,0,9999,6
1714604921146,CLRE 251,A00,507176,Mehta; Ravindra L.,9993,0,9999,6
1714604921146,CLRE 251,B00,511410,Mehta; Ravindra L.,9998,0,9999,1
1714604922175,CLRE 252,A00,507189,Cuomo; Raphael Eduardo,9995,0,9999,4
1714604923204,CLRE 253,A00,507199,Vaida; Florin,9994,0,9999,5
1714604923204,CLRE 253,B00,507202,Vaida; Florin,9999,0,9999,0
1714604924230,CLRE 259,A00,507211,Patel; Hemal,9996,0,9999,3
1714604925253,CLRE 260,A00,507221,Cuomo; Raphael Eduardo,9999,0,9999,0
1714604926278,CLRE 297,001,507242,Cuomo; Raphael Eduardo,9999,0,9999,0
1714604927304,COGS 197,001,638244,Voytek; Bradley Thomas,9998,0,9999,1
1714604928328,CSE 191,A00,516875,Minnes Kemp; Mor Mia,9993,0,9999,6
1714604929356,CSE 197,001,637388,Minnes Kemp; Mor Mia,9998,0,9999,1
1714604930383,CSS 201S,A01,494383,Staff,35,0,35,0
1714604931408,CSS 202S,A01,494387,Staff,35,0,35,0
1714604932433,DSC 197,001,628532,Eldridge; Justin Matthew,9996,0,9999,3
1714604933458,EAP 100,A00,516065,Staff,9797,0,9999,202
1714604934486,ECE 45,A01,507414,Staff,33,0,60,27
1714604936539,ECE 111,A01,507420,Staff,15,0,50,35
1714604937569,ECE 197,001,548057,Sievenpiper; Daniel F.,9993,0,9999,6
1714604938595,EDS 115,A00,507243,Choi; Bailey Miyeon,10,0,28,18
1714604939618,EDS 117,A01,494379,Staff,1,5,30,29
1714604940644,EDS 125,A00,507246,Hopkins; Megan Beth,9,0,30,21
1714604941677,EDS 128A,A01,507264,Fargason; Sharon Gayle,8,0,26,18
1714604942706,EDS 128B,A01,507293,Pappas; Elizabeth,12,0,30,18
1714604943739,EDS 139,A00,507294,Fargason; Sharon Gayle,13,0,30,17
1714604943739,EDS 139,B00,507313,Pappas; Elizabeth,13,0,30,17
1714604944764,EDS 201,A00,507315,Staff,13,0,30,17
1714604945791,EDS 203,A01,507317,Halter; Christopher P.,12,0,30,18
1714604946816,EDS 204R,A01,507319,Halter; Christopher P.,0,3,30,30
1714604946816,EDS 204R,B01,507331,Heinzman; Erica M.,16,0,30,14
1714604947839,EDS 206R,A00,507332,Staff,0,4,30,30
1714604947839,EDS 206R,B00,507343,Staff,17,0,30,13
1714604948868,EDS 250,A00,507344,Hemans; Patricia Ann Benitez,22,0,40,18
1714604949896,EDS 281,A00,507345,Daly; Alan J.,18,0,18,0
1714604950921,EDS 284,A00,507350,Daly; Alan J.,16,0,16,0
1714604951950,EDS 286,A00,507359,Fine; Sarah,18,0,18,0
1714604952974,EDS 289C,A01,507361,Daly; Alan J.,18,0,18,0
1714604953999,EDS 290,A00,507366,Hofstetter; Carolyn,15,0,15,0
1714604955024,LIGM 5A,A00,507421,Fischer-Grunski; Eva K,18,0,20,2
1714604956049,LIGM 5B,A00,507423,Fischer-Grunski; Eva K,19,0,20,1
1714604957074,LIGM 5C,A00,507425,Fischer-Grunski; Eva K,19,0,20,1
1714604958099,LIIT 5AS,A00,507427,Carnelos; Chiara,20,0,20,0
1714604959124,LIIT 5BS,A00,507430,Carnelos; Chiara,20,0,20,0
1714604960149,LIIT 5CS,A00,507432,Carnelos; Chiara,20,0,20,0
1714604961173,LISP 5A,A00,507541,Munoz Sanchez; Alicia,11,0,20,9
1714604962796,LISP 5B,A00,507671,Munoz Sanchez; Alicia,8,0,20,12
1714604963825,LISP 5C,A00,507696,Munoz Sanchez; Alicia,9,0,20,11
1714604964854,MAE 197,001,528363,Boechler; Nicholas Sebastia,9998,0,9999,1
1714604965880,MATH 197,001,523477,Kedlaya; Kiran S.,9995,0,9999,4
1714604965880,MATH 197,002,563811,Zhang; Danna,9995,0,9999,4
1714604965880,MATH 197,003,628552,Dumitriu; Ioana,9998,0,9999,1
1714604966906,MCWP 40R,A00,518780,Staff,2,0,20,18
1714604966906,MCWP 40R,B00,518781,Staff,8,0,20,12
1714604966906,MCWP 40R,C00,518783,Staff,6,0,20,14
1714604967932,MCWP 50R,A00,518791,Staff,0,0,20,20
1714604967932,MCWP 50R,B00,518792,Staff,0,2,20,20
1714604967932,MCWP 50R,C00,518793,Staff,0,2,20,20
1714604967932,MCWP 50R,D00,518794,Staff,0,0,20,20
1714604967932,MCWP 50R,E00,518795,Staff,0,2,20,20
1714604967932,MCWP 50R,F00,518796,Staff,0,0,20,20
1714604967932,MCWP 50R,G00,518797,Staff,0,1,20,20
1714604968959,MMW 12R,A01,514034,Herbst; Matthew,0,0,16,16
1714604968959,MMW 12R,A02,514035,Herbst; Matthew,1,0,16,15
1714604969987,MMW 13R,A01,514037,Staff,0,4,16,16
1714604969987,MMW 13R,A02,514039,Staff,0,2,16,16
1714604969987,MMW 13R,A03,628519,Staff,0,2,16,16
1714604972044,SIO 295LS,A00,523233,Staff,10,0,30,20
1714604973068,SIO 295S,A00,523232,Staff,10,0,30,20
1714604974093,SIOC 290S,A01,637330,Merrifield; Mark A,23,0,30,7
1714604975119,SIOC 291S,A01,637333,Gabriel; Corey John,23,0,30,7
1714604976145,SOCI 117,A01,494376,Staff,0,4,5,5
1714604977171,WES 237B,A00,494380,Staff,9,0,20,11
1714604979244,AESE 279B,A00,494370,Wade; Jon P,0,0,33,33
1714604980275,AIP 197,001,627712,Vespa; Emanuel Ignacio,9998,0,9999,1
1714604981301,ANAR 135S,A00,494369,Braswell; Geoffrey E.,0,0,0,0
1714604982329,BENG 196,001,628496,Engler; Adam J.,9998,0,9999,1
1714604983360,CAT 124RS,A01,519847,Geibel; William,0,0,20,20
1714604984385,CAT 125RS,A01,515971,Geibel; William,0,0,20,20
1714604985411,CLRE 250,A00,511389,Morris; Sheldon,9993,0,9999,6
1714604986439,CLRE 251,A00,507176,Mehta; Ravindra L.,9993,0,9999,6
1714604986439,CLRE 251,B00,511410,Mehta; Ravindra L.,9998,0,9999,1
1714604987518,CLRE 252,A00,507189,Cuomo; Raphael Eduardo,9995,0,9999,4
1714604988544,CLRE 253,A00,507199,Vaida; Florin,9994,0,9999,5
1714604988544,CLRE 253,B00,507202,Vaida; Florin,9999,0,9999,0
1714604989573,CLRE 259,A00,507211,Patel; Hemal,9996,0,9999,3
1714604990599,CLRE 260,A00,507221,Cuomo; Raphael Eduardo,9999,0,9999,0
1714604991625,CLRE 297,001,507242,Cuomo; Raphael Eduardo,9999,0,9999,0
1714604992651,COGS 197,001,638244,Voytek; Bradley Thomas,9998,0,9999,1
1714604993676,CSE 191,A00,516875,Minnes Kemp; Mor Mia,9993,0,9999,6
1714604994703,CSE 197,001,637388,Minnes Kemp; Mor Mia,9998,0,9999,1
1714604995729,CSS 201S,A01,494383,Staff,35,0,35,0
1714604996756,CSS 202S,A01,494387,Staff,35,0,35,0
1714604997783,DSC 197,001,628532,Eldridge; Justin Matthew,9996,0,9999,3
1714604998810,EAP 100,A00,516065,Staff,9797,0,9999,202
1714604999835,ECE 45,A01,507414,Staff,33,0,60,27
1714605001891,ECE 111,A01,507420,Staff,15,0,50,35
1714605002916,ECE 197,001,548057,Sievenpiper; Daniel F.,9993,0,9999,6
1714605003942,EDS 115,A00,507243,Choi; Bailey Miyeon,10,0,28,18
1714605004969,EDS 117,A01,494379,Staff,1,5,30,29
1714605005994,EDS 125,A00,507246,Hopkins; Megan Beth,9,0,30,21
1714605007026,EDS 128A,A01,507264,Fargason; Sharon Gayle,8,0,26,18
1714605008054,EDS 128B,A01,507293,Pappas; Elizabeth,12,0,30,18
1714605009082,EDS 139,A00,507294,Fargason; Sharon Gayle,13,0,30,17
1714605009082,EDS 139,B00,507313,Pappas; Elizabeth,13,0,30,17
1714605010114,EDS 201,A00,507315,Staff,13,0,30,17
1714605011145,EDS 203,A01,507317,Halter; Christopher P.,12,0,30,18
1714605012177,EDS 204R,A01,507319,Halter; Christopher P.,0,3,30,30
1714605012177,EDS 204R,B01,507331,Heinzman; Erica M.,16,0,30,14
1714605013207,EDS 206R,A00,507332,Staff,0,4,30,30
1714605013207,EDS 206R,B00,507343,Staff,17,0,30,13
1714605014232,EDS 250,A00,507344,Hemans; Patricia Ann Benitez,22,0,40,18
1714605015262,EDS 281,A00,507345,Daly; Alan J.,18,0,18,0
1714605016287,EDS 284,A00,507350,Daly; Alan J.,16,0,16,0
1714605017315,EDS 286,A00,507359,Fine; Sarah,18,0,18,0
1714605018341,EDS 289C,A01,507361,Daly; Alan J.,18,0,18,0
1714605019366,EDS 290,A00,507366,Hofstetter; Carolyn,15,0,15,0
1714605020392,LIGM 5A,A00,507421,Fischer-Grunski; Eva K,18,0,20,2
1714605021417,LIGM 5B,A00,507423,Fischer-Grunski; Eva K,19,0,20,1
1714605022445,LIGM 5C,A00,507425,Fischer-Grunski; Eva K,19,0,20,1
1714605023473,LIIT 5AS,A00,507427,Carnelos; Chiara,20,0,20,0
1714605024502,LIIT 5BS,A00,507430,Carnelos; Chiara,20,0,20,0
1714605025526,LIIT 5CS,A00,507432,Carnelos; Chiara,20,0,20,0
1714605026550,LISP 5A,A00,507541,Munoz Sanchez; Alicia,11,0,20,9
1714605027574,LISP 5B,A00,507671,Munoz Sanchez; Alicia,8,0,20,12
1714605028600,LISP 5C,A00,507696,Munoz Sanchez; Alicia,9,0,20,11
1714605029625,MAE 197,001,528363,Boechler; Nicholas Sebastia,9998,0,9999,1
1714605030652,MATH 197,001,523477,Kedlaya; Kiran S.,9995,0,9999,4
1714605030652,MATH 197,002,563811,Zhang; Danna,9995,0,9999,4
1714605030652,MATH 197,003,628552,Dumitriu; Ioana,9998,0,9999,1
1714605031677,MCWP 40R,A00,518780,Staff,2,0,20,18
1714605031677,MCWP 40R,B00,518781,Staff,8,0,20,12
1714605031677,MCWP 40R,C00,518783,Staff,6,0,20,14
1714605032702,MCWP 50R,A00,518791,Staff,0,0,20,20
1714605032702,MCWP 50R,B00,518792,Staff,0,2,20,20
1714605032702,MCWP 50R,C00,518793,Staff,0,2,20,20
1714605032702,MCWP 50R,D00,518794,Staff,0,0,20,20
1714605032702,MCWP 50R,E00,518795,Staff,0,2,20,20
1714605032702,MCWP 50R,F00,518796,Staff,0,0,20,20
1714605032702,MCWP 50R,G00,518797,Staff,0,1,20,20
1714605033731,MMW 12R,A01,514034,Herbst; Matthew,0,0,16,16
1714605033731,MMW 12R,A02,514035,Herbst; Matthew,1,0,16,15
1714605034763,MMW 13R,A01,514037,Staff,0,4,16,16
1714605034763,MMW 13R,A02,514039,Staff,0,2,16,16
1714605034763,MMW 13R,A03,628519,Staff,0,2,16,16
1714605036818,SIO 295LS,A00,523233,Staff,10,0,30,20
1714605037847,SIO 295S,A00,523232,Staff,10,0,30,20
1714605038873,SIOC 290S,A01,637330,Merrifield; Mark A,23,0,30,7
1714605039899,SIOC 291S,A01,637333,Gabriel; Corey John,23,0,30,7
1714605040924,SOCI 117,A01,494376,Staff,0,4,5,5
1714605041954,WES 237B,A00,494380,Staff,9,0,20,11
1714605044021,AESE 279B,A00,494370,Wade; Jon P,0,0,33,33
1714605045045,AIP 197,001,627712,Vespa; Emanuel Ignacio,9998,0,9999,1
1714605046073,ANAR 135S,A00,494369,Braswell; Geoffrey E.,0,0,0,0
1714605047098,BENG 196,001,628496,Engler; Adam J.,9998,0,9999,1
1714605048126,CAT 124RS,A01,519847,Geibel; William,0,0,20,20
1714605049151,CAT 125RS,A01,515971,Geibel; William,0,0,20,20
1714605050178,CLRE 250,A00,511389,Morris; Sheldon,9993,0,9999,6
1714605051208,CLRE 251,A00,507176,Mehta; Ravindra L.,9993,0,9999,6
1714605051208,CLRE 251,B00,511410,Mehta; Ravindra L.,9998,0,9999,1
1714605052234,CLRE 252,A00,507189,Cuomo; Raphael Eduardo,9995,0,9999,4
1714605053258,CLRE 253,A00,507199,Vaida; Florin,9994,0,9999,5
1714605053258,CLRE 253,B00,507202,Vaida; Florin,9999,0,9999,0
1714605054283,CLRE 259,A00,507211,Patel; Hemal,9996,0,9999,3
1714605055328,CLRE 260,A00,507221,Cuomo; Raphael Eduardo,9999,0,9999,0
1714605056353,CLRE 297,001,507242,Cuomo; Raphael Eduardo,9999,0,9999,0
1714605057378,COGS 197,001,638244,Voytek; Bradley Thomas,9998,0,9999,1
1714605058402,CSE 191,A00,516875,Minnes Kemp; Mor Mia,9993,0,9999,6
1714605059426,CSE 197,001,637388,Minnes Kemp; Mor Mia,9998,0,9999,1
1714605060451,CSS 201S,A01,494383,Staff,35,0,35,0
1714605061477,CSS 202S,A01,494387,Staff,35,0,35,0
1714605062500,DSC 197,001,628532,Eldridge; Justin Matthew,9996,0,9999,3
1714605063525,EAP 100,A00,516065,Staff,9797,0,9999,202
1714605064552,ECE 45,A01,507414,Staff,33,0,60,27
1714605066607,ECE 111,A01,507420,Staff,15,0,50,35
1714605067631,ECE 197,001,548057,Sievenpiper; Daniel F.,9993,0,9999,6
1714605068666,EDS 115,A00,507243,Choi; Bailey Miyeon,10,0,28,18
1714605069692,EDS 117,A01,494379,Staff,1,5,30,29
1714605070717,EDS 125,A00,507246,Hopkins; Megan Beth,9,0,30,21
1714605071748,EDS 128A,A01,507264,Fargason; Sharon Gayle,8,0,26,18
1714605072777,EDS 128B,A01,507293,Pappas; Elizabeth,12,0,30,18
1714605073801,EDS 139,A00,507294,Fargason; Sharon Gayle,13,0,30,17
1714605073801,EDS 139,B00,507313,Pappas; Elizabeth,13,0,30,17
1714605074825,EDS 201,A00,507315,Staff,13,0,30,17
1714605075855,EDS 203,A01,507317,Halter; Christopher P.,12,0,30,18
1714605076880,EDS 204R,A01,507319,Halter; Christopher P.,0,3,30,30
1714605076880,EDS 204R,B01,507331,Heinzman; Erica M.,16,0,30,14
1714605077904,EDS 206R,A00,507332,Staff,0,4,30,30
1714605077904,EDS 206R,B00,507343,Staff,17,0,30,13
1714605078933,EDS 250,A00,507344,Hemans; Patricia Ann Benitez,22,0,40,18
1714605079962,EDS 281,A00,507345,Daly; Alan J.,18,0,18,0
1714605080991,EDS 284,A00,507350,Daly; Alan J.,16,0,16,0
1714605082016,EDS 286,A00,507359,Fine; Sarah,18,0,18,0
1714605083051,EDS 289C,A01,507361,Daly; Alan J.,18,0,18,0
1714605084080,EDS 290,A00,507366,Hofstetter; Carolyn,15,0,15,0
1714605085111,LIGM 5A,A00,507421,Fischer-Grunski; Eva K,18,0,20,2
1714605086136,LIGM 5B,A00,507423,Fischer-Grunski; Eva K,19,0,20,1
1714605087167,LIGM 5C,A00,507425,Fischer-Grunski; Eva K,19,0,20,1
1714605088192,LIIT 5AS,A00,507427,Carnelos; Chiara,20,0,20,0
1714605089218,LIIT 5BS,A00,507430,Carnelos; Chiara,20,0,20,0
1714605090244,LIIT 5CS,A00,507432,Carnelos; Chiara,20,0,20,0
1714605091325,LISP 5A,A00,507541,Munoz Sanchez; Alicia,11,0,20,9
1714605092352,LISP 5B,A00,507671,Munoz Sanchez; Alicia,8,0,20,12
1714605093379,LISP 5C,A00,507696,Munoz Sanchez; Alicia,9,0,20,11
1714605094403,MAE 197,001,528363,Boechler; Nicholas Sebastia,9998,0,9999,1
1714605095431,MATH 197,001,523477,Kedlaya; Kiran S.,9995,0,9999,4
1714605095431,MATH 197,002,563811,Zhang; Danna,9995,0,9999,4
1714605095431,MATH 197,003,628552,Dumitriu; Ioana,9998,0,9999,1
1714605096462,MCWP 40R,A00,518780,Staff,2,0,20,18
1714605096462,MCWP 40R,B00,518781,Staff,8,0,20,12
1714605096462,MCWP 40R,C00,518783,Staff,6,0,20,14
1714605097490,MCWP 50R,A00,518791,Staff,0,0,20,20
1714605097490,MCWP 50R,B00,518792,Staff,0,2,20,20
1714605097490,MCWP 50R,C00,518793,Staff,0,2,20,20
1714605097490,MCWP 50R,D00,518794,Staff,0,0,20,20
1714605097490,MCWP 50R,E00,518795,Staff,0,2,20,20
1714605097490,MCWP 50R,F00,518796,Staff,0,0,20,20
1714605097490,MCWP 50R,G00,518797,Staff,0,1,20,20
1714605098517,MMW 12R,A01,514034,Herbst; Matthew,0,0,16,16
1714605098517,MMW 12R,A02,514035,Herbst; Matthew,1,0,16,15
1714605099541,MMW 13R,A01,514037,Staff,0,4,16,16
1714605099541,MMW 13R,A02,514039,Staff,0,2,16,16
1714605099541,MMW 13R,A03,628519,Staff,0,2,16,16
1714605101591,SIO 295LS,A00,523233,Staff,10,0,30,20
1714605102615,SIO 295S,A00,523232,Staff,10,0,30,20
1714605103639,SIOC 290S,A01,637330,Merrifield; Mark A,23,0,30,7
1714605104670,SIOC 291S,A01,637333,Gabriel; Corey John,23,0,30,7
1714605105693,SOCI 117,A01,494376,Staff,0,4,5,5
1714605106720,WES 237B,A00,494380,Staff,9,0,20,11
1714605108786,AESE 279B,A00,494370,Wade; Jon P,0,0,33,33
1714605109813,AIP 197,001,627712,Vespa; Emanuel Ignacio,9998,0,9999,1
1714605110842,ANAR 135S,A00,494369,Braswell; Geoffrey E.,0,0,0,0
1714605111867,BENG 196,001,628496,Engler; Adam J.,9998,0,9999,1
1714605112892,CAT 124RS,A01,519847,Geibel; William,0,0,20,20
1714605113917,CAT 125RS,A01,515971,Geibel; William,0,0,20,20
1714605114944,CLRE 250,A00,511389,Morris; Sheldon,9993,0,9999,6
1714605115969,CLRE 251,A00,507176,Mehta; Ravindra L.,9993,0,9999,6
1714605115969,CLRE 251,B00,511410,Mehta; Ravindra L.,9998,0,9999,1
1714605116997,CLRE 252,A00,507189,Cuomo; Raphael Eduardo,9995,0,9999,4
1714605118026,CLRE 253,A00,507199,Vaida; Florin,9994,0,9999,5
1714605118026,CLRE 253,B00,507202,Vaida; Florin,9999,0,9999,0
1714605119051,CLRE 259,A00,507211,Patel; Hemal,9996,0,9999,3
1714605120076,CLRE 260,A00,507221,Cuomo; Raphael Eduardo,9999,0,9999,0
1714605121099,CLRE 297,001,507242,Cuomo; Raphael Eduardo,9999,0,9999,0
1714605122127,COGS 197,001,638244,Voytek; Bradley Thomas,9998,0,9999,1
1714605123155,CSE 191,A00,516875,Minnes Kemp; Mor Mia,9993,0,9999,6
1714605124180,CSE 197,001,637388,Minnes Kemp; Mor Mia,9998,0,9999,1
1714605125206,CSS 201S,A01,494383,Staff,35,0,35,0
1714605126231,CSS 202S,A01,494387,Staff,35,0,35,0
1714605127258,DSC 197,001,628532,Eldridge; Justin Matthew,9996,0,9999,3
1714605128285,EAP 100,A00,516065,Staff,9797,0,9999,202
1714605129311,ECE 45,A01,507414,Staff,33,0,60,27
1714605131369,ECE 111,A01,507420,Staff,15,0,50,35
1714605132399,ECE 197,001,548057,Sievenpiper; Daniel F.,9993,0,9999,6
1714605133427,EDS 115,A00,507243,Choi; Bailey Miyeon,10,0,28,18
1714605134456,EDS 117,A01,494379,Staff,1,5,30,29
1714605135484,EDS 125,A00,507246,Hopkins; Megan Beth,9,0,30,21
1714605136516,EDS 128A,A01,507264,Fargason; Sharon Gayle,8,0,26,18
1714605137544,EDS 128B,A01,507293,Pappas; Elizabeth,12,0,30,18
1714605138570,EDS 139,A00,507294,Fargason; Sharon Gayle,13,0,30,17
1714605138570,EDS 139,B00,507313,Pappas; Elizabeth,13,0,30,17
1714605139592,EDS 201,A00,507315,Staff,13,0,30,17
1714605140618,EDS 203,A01,507317,Halter; Christopher P.,12,0,30,18
1714605141645,EDS 204R,A01,507319,Halter; Christopher P.,0,3,30,30
1714605141645,EDS 204R,B01,507331,Heinzman; Erica M.,16,0,30,14
1714605142670,EDS 206R,A00,507332,Staff,0,4,30,30
1714605142670,EDS 206R,B00,507343,Staff,17,0,30,13
1714605143696,EDS 250,A00,507344,Hemans; Patricia Ann Benitez,22,0,40,18
1714605144722,EDS 281,A00,507345,Daly; Alan J.,18,0,18,0
1714605145747,EDS 284,A00,507350,Daly; Alan J.,16,0,16,0
1714605146775,EDS 286,A00,507359,Fine; Sarah,18,0,18,0
1714605147801,EDS 289C,A01,507361,Daly; Alan J.,18,0,18,0
1714605148825,EDS 290,A00,507366,Hofstetter; Carolyn,15,0,15,0
1714605149855,LIGM 5A,A00,507421,Fischer-Grunski; Eva K,18,0,20,2
1714605150879,LIGM 5B,A00,507423,Fischer-Grunski; Eva K,19,0,20,1
1714605151905,LIGM 5C,A00,507425,Fischer-Grunski; Eva K,19,0,20,1
1714605152935,LIIT 5AS,A00,507427,Carnelos; Chiara,20,0,20,0
1714605153965,LIIT 5BS,A00,507430,Carnelos; Chiara,20,0,20,0
1714605154994,LIIT 5CS,A00,507432,Carnelos; Chiara,20,0,20,0
1714605156019,LISP 5A,A00,507541,Munoz Sanchez; Alicia,11,0,20,9
1714605157047,LISP 5B,A00,507671,Munoz Sanchez; Alicia,8,0,20,12
1714605158072,LISP 5C,A00,507696,Munoz Sanchez; Alicia,9,0,20,11
1714605159101,MAE 197,001,528363,Boechler; Nicholas Sebastia,9998,0,9999,1
1714605160131,MATH 197,001,523477,Kedlaya; Kiran S.,9995,0,9999,4
1714605160131,MATH 197,002,563811,Zhang; Danna,9995,0,9999,4
1714605160131,MATH 197,003,628552,Dumitriu; Ioana,9998,0,9999,1
1714605161157,MCWP 40R,A00,518780,Staff,2,0,20,18
1714605161157,MCWP 40R,B00,518781,Staff,8,0,20,12
1714605161157,MCWP 40R,C00,518783,Staff,6,0,20,14
1714605162186,MCWP 50R,A00,518791,Staff,0,0,20,20
1714605162186,MCWP 50R,B00,518792,Staff,0,2,20,20
1714605162186,MCWP 50R,C00,518793,Staff,0,2,20,20
1714605162186,MCWP 50R,D00,518794,Staff,0,0,20,20
1714605162186,MCWP 50R,E00,518795,Staff,0,2,20,20
1714605162186,MCWP 50R,F00,518796,Staff,0,0,20,20
1714605162186,MCWP 50R,G00,518797,Staff,0,1,20,20
1714605163209,MMW 12R,A01,514034,Herbst; Matthew,0,0,16,16
1714605163209,MMW 12R,A02,514035,Herbst; Matthew,1,0,16,15
1714605164234,MMW 13R,A01,514037,Staff,0,4,16,16
1714605164234,MMW 13R,A02,514039,Staff,0,2,16,16
1714605164234,MMW 13R,A03,628519,Staff,0,2,16,16
1714605166293,SIO 295LS,A00,523233,Staff,10,0,30,20
1714605167320,SIO 295S,A00,523232,Staff,10,0,30,20
1714605168344,SIOC 290S,A01,637330,Merrifield; Mark A,23,0,30,7
1714605169370,SIOC 291S,A01,637333,Gabriel; Corey John,23,0,30,7
1714605170398,SOCI 117,A01,494376,Staff,0,4,5,5
1714605171424,WES 237B,A00,494380,Staff,9,0,20,11
1714605173507,AESE 279B,A00,494370,Wade; Jon P,0,0,33,33
1714605174537,AIP 197,001,627712,Vespa; Emanuel Ignacio,9998,0,9999,1
1714605175562,ANAR 135S,A00,494369,Braswell; Geoffrey E.,0,0,0,0
1714605176591,BENG 196,001,628496,Engler; Adam J.,9998,0,9999,1
1714605177616,CAT 124RS,A01,519847,Geibel; William,0,0,20,20
1714605178641,CAT 125RS,A01,515971,Geibel; William,0,0,20,20
1714605179671,CLRE 250,A00,511389,Morris; Sheldon,9993,0,9999,6
1714605180698,CLRE 251,A00,507176,Mehta; Ravindra L.,9993,0,9999,6
1714605180698,CLRE 251,B00,511410,Mehta; Ravindra L.,9998,0,9999,1
1714605181722,CLRE 252,A00,507189,Cuomo; Raphael Eduardo,9995,0,9999,4
1714605182747,CLRE 253,A00,507199,Vaida; Florin,9994,0,9999,5
1714605182747,CLRE 253,B00,507202,Vaida; Florin,9999,0,9999,0
1714605183772,CLRE 259,A00,507211,Patel; Hemal,9996,0,9999,3
1714605184796,CLRE 260,A00,507221,Cuomo; Raphael Eduardo,9999,0,9999,0
1714605185821,CLRE 297,001,507242,Cuomo; Raphael Eduardo,9999,0,9999,0
1714605186844,COGS 197,001,638244,Voytek; Bradley Thomas,9998,0,9999,1
1714605187869,CSE 191,A00,516875,Minnes Kemp; Mor Mia,9993,0,9999,6
1714605188895,CSE 197,001,637388,Minnes Kemp; Mor Mia,9998,0,9999,1
1714605189925,CSS 201S,A01,494383,Staff,35,0,35,0
1714605190956,CSS 202S,A01,494387,Staff,35,0,35,0
1714605191983,DSC 197,001,628532,Eldridge; Justin Matthew,9996,0,9999,3
1714605193008,EAP 100,A00,516065,Staff,9797,0,9999,202
1714605194035,ECE 45,A01,507414,Staff,33,0,60,27
1714605196144,ECE 111,A01,507420,Staff,15,0,50,35
1714605197170,ECE 197,001,548057,Sievenpiper; Daniel F.,9993,0,9999,6
1714605198198,EDS 115,A00,507243,Choi; Bailey Miyeon,10,0,28,18
1714605199225,EDS 117,A01,494379,Staff,1,5,30,29
1714605200254,EDS 125,A00,507246,Hopkins; Megan Beth,9,0,30,21
1714605201284,EDS 128A,A01,507264,Fargason; Sharon Gayle,8,0,26,18
1714605202310,EDS 128B,A01,507293,Pappas; Elizabeth,12,0,30,18
1714605203336,EDS 139,A00,507294,Fargason; Sharon Gayle,13,0,30,17
1714605203336,EDS 139,B00,507313,Pappas; Elizabeth,13,0,30,17
1714605204364,EDS 201,A00,507315,Staff,13,0,30,17
1714605205389,EDS 203,A01,507317,Halter; Christopher P.,12,0,30,18
1714605206416,EDS 204R,A01,507319,Halter; Christopher P.,0,3,30,30
1714605206416,EDS 204R,B01,507331,Heinzman; Erica M.,16,0,30,14
1714605207441,EDS 206R,A00,507332,Staff,0,4,30,30
1714605207441,EDS 206R,B00,507343,Staff,17,0,30,13
1714605208466,EDS 250,A00,507344,Hemans; Patricia Ann Benitez,22,0,40,18
1714605209491,EDS 281,A00,507345,Daly; Alan J.,18,0,18,0
1714605210515,EDS 284,A00,507350,Daly; Alan J.,16,0,16,0
1714605211540,EDS 286,A00,507359,Fine; Sarah,18,0,18,0
1714605212565,EDS 289C,A01,507361,Daly; Alan J.,18,0,18,0
1714605213590,EDS 290,A00,507366,Hofstetter; Carolyn,15,0,15,0
1714605214615,LIGM 5A,A00,507421,Fischer-Grunski; Eva K,18,0,20,2
1714605215644,LIGM 5B,A00,507423,Fischer-Grunski; Eva K,19,0,20,1
1714605216669,LIGM 5C,A00,507425,Fischer-Grunski; Eva K,19,0,20,1
1714605217695,LIIT 5AS,A00,507427,Carnelos; Chiara,20,0,20,0
1714605218724,LIIT 5BS,A00,507430,Carnelos; Chiara,20,0,20,0
1714605219748,LIIT 5CS,A00,507432,Carnelos; Chiara,20,0,20,0
1714605220773,LISP 5A,A00,507541,Munoz Sanchez; Alicia,11,0,20,9
1714605221798,LISP 5B,A00,507671,Munoz Sanchez; Alicia,8,0,20,12
1714605222825,LISP 5C,A00,507696,Munoz Sanchez; Alicia,9,0,20,11
1714605223851,MAE 197,001,528363,Boechler; Nicholas Sebastia,9998,0,9999,1
1714605224884,MATH 197,001,523477,Kedlaya; Kiran S.,9995,0,9999,4
1714605224884,MATH 197,002,563811,Zhang; Danna,9995,0,9999,4
1714605224884,MATH 197,003,628552,Dumitriu; Ioana,9998,0,9999,1
1714605225912,MCWP 40R,A00,518780,Staff,2,0,20,18
1714605225912,MCWP 40R,B00,518781,Staff,8,0,20,12
1714605225912,MCWP 40R,C00,518783,Staff,6,0,20,14
1714605226970,MCWP 50R,A00,518791,Staff,0,0,20,20
1714605226970,MCWP 50R,B00,518792,Staff,0,2,20,20
1714605226970,MCWP 50R,C00,518793,Staff,0,2,20,20
1714605226970,MCWP 50R,D00,518794,Staff,0,0,20,20
1714605226970,MCWP 50R,E00,518795,Staff,0,2,20,20
1714605226970,MCWP 50R,F00,518796,Staff,0,0,20,20
1714605226970,MCWP 50R,G00,518797,Staff,0,1,20,20
1714605227995,MMW 12R,A01,514034,Herbst; Matthew,0,0,16,16
1714605227995,MMW 12R,A02,514035,Herbst; Matthew,1,0,16,15
1714605229024,MMW 13R,A01,514037,Staff,0,4,16,16
1714605229024,MMW 13R,A02,514039,Staff,0,2,16,16
1714605229024,MMW 13R,A03,628519,Staff,0,2,16,16
1714605231073,SIO 295LS,A00,523233,Staff,10,0,30,20
1714605232098,SIO 295S,A00,523232,Staff,10,0,30,20
1714605233126,SIOC 290S,A01,637330,Merrifield; Mark A,23,0,30,7
1714605234151,SIOC 291S,A01,637333,Gabriel; Corey John,23,0,30,7
1714605235179,SOCI 117,A01,494376,Staff,0,4,5,5
1714605236204,WES 237B,A00,494380,Staff,9,0,20,11
1714605238271,AESE 279B,A00,494370,Wade; Jon P,0,0,33,33
1714605239296,AIP 197,001,627712,Vespa; Emanuel Ignacio,9998,0,9999,1
1714605240323,ANAR 135S,A00,494369,Braswell; Geoffrey E.,0,0,0,0
1714605241347,BENG 196,001,628496,Engler; Adam J.,9998,0,9999,1
1714605242374,CAT 124RS,A01,519847,Geibel; William,0,0,20,20
1714605243399,CAT 125RS,A01,515971,Geibel; William,0,0,20,20
1714605244427,CLRE 250,A00,511389,Morris; Sheldon,9993,0,9999,6
1714605245462,CLRE 251,A00,507176,Mehta; Ravindra L.,9993,0,9999,6
1714605245462,CLRE 251,B00,511410,Mehta; Ravindra L.,9998,0,9999,1
1714605246489,CLRE 252,A00,507189,Cuomo; Raphael Eduardo,9995,0,9999,4
1714605247515,CLRE 253,A00,507199,Vaida; Florin,9994,0,9999,5
1714605247515,CLRE 253,B00,507202,Vaida; Florin,9999,0,9999,0
1714605248542,CLRE 259,A00,507211,Patel; Hemal,9996,0,9999,3
1714605249567,CLRE 260,A00,507221,Cuomo; Raphael Eduardo,9999,0,9999,0
1714605250594,CLRE 297,001,507242,Cuomo; Raphael Eduardo,9999,0,9999,0
1714605251625,COGS 197,001,638244,Voytek; Bradley Thomas,9998,0,9999,1
1714605252657,CSE 191,A00,516875,Minnes Kemp; Mor Mia,9993,0,9999,6
1714605253684,CSE 197,001,637388,Minnes Kemp; Mor Mia,9998,0,9999,1
1714605254714,CSS 201S,A01,494383,Staff,35,0,35,0
1714605255740,CSS 202S,A01,494387,Staff,35,0,35,0
1714605256767,DSC 197,001,628532,Eldridge; Justin Matthew,9996,0,9999,3
1714605257794,EAP 100,A00,516065,Staff,9797,0,9999,202
1714605258819,ECE 45,A01,507414,Staff,33,0,60,27
1714605260868,ECE 111,A01,507420,Staff,15,0,50,35
1714605261895,ECE 197,001,548057,Sievenpiper; Daniel F.,9993,0,9999,6
1714605262924,EDS 115,A00,507243,Choi; Bailey Miyeon,10,0,28,18
1714605263954,EDS 117,A01,494379,Staff,1,5,30,29
1714605264979,EDS 125,A00,507246,Hopkins; Megan Beth,9,0,30,21
1714605266004,EDS 128A,A01,507264,Fargason; Sharon Gayle,8,0,26,18
1714605267032,EDS 128B,A01,507293,Pappas; Elizabeth,12,0,30,18
1714605268056,EDS 139,A00,507294,Fargason; Sharon Gayle,13,0,30,17
1714605268056,EDS 139,B00,507313,Pappas; Elizabeth,13,0,30,17
1714605269084,EDS 201,A00,507315,Staff,13,0,30,17
1714605270111,EDS 203,A01,507317,Halter; Christopher P.,12,0,30,18
1714605271138,EDS 204R,A01,507319,Halter; Christopher P.,0,3,30,30
1714605271138,EDS 204R,B01,507331,Heinzman; Erica M.,16,0,30,14
1714605272163,EDS 206R,A00,507332,Staff,0,4,30,30
1714605272163,EDS 206R,B00,507343,Staff,17,0,30,13
1714605273188,EDS 250,A00,507344,Hemans; Patricia Ann Benitez,22,0,40,18
1714605274214,EDS 281,A00,507345,Daly; Alan J.,18,0,18,0
1714605275242,EDS 284,A00,507350,Daly; Alan J.,16,0,16,0
1714605276268,EDS 286,A00,507359,Fine; Sarah,18,0,18,0
1714605277297,EDS 289C,A01,507361,Daly; Alan J.,18,0,18,0
1714605278323,EDS 290,A00,507366,Hofstetter; Carolyn,15,0,15,0
1714605279350,LIGM 5A,A00,507421,Fischer-Grunski; Eva K,18,0,20,2
1714605280376,LIGM 5B,A00,507423,Fischer-Grunski; Eva K,19,0,20,1
1714605281405,LIGM 5C,A00,507425,Fischer-Grunski; Eva K,19,0,20,1
1714605282433,LIIT 5AS,A00,507427,Carnelos; Chiara,20,0,20,0
1714605283463,LIIT 5BS,A00,507430,Carnelos; Chiara,20,0,20,0
1714605284491,LIIT 5CS,A00,507432,Carnelos; Chiara,20,0,20,0
1714605285516,LISP 5A,A00,507541,Munoz Sanchez; Alicia,11,0,20,9
1714605286544,LISP 5B,A00,507671,Munoz Sanchez; Alicia,8,0,20,12
1714605287573,LISP 5C,A00,507696,Munoz Sanchez; Alicia,9,0,20,11
1714605288597,MAE 197,001,528363,Boechler; Nicholas Sebastia,9998,0,9999,1
1714605289625,MATH 197,001,523477,Kedlaya; Kiran S.,9995,0,9999,4
1714605289625,MATH 197,002,563811,Zhang; Danna,9995,0,9999,4
1714605289625,MATH 197,003,628552,Dumitriu; Ioana,9998,0,9999,1
1714605290651,MCWP 40R,A00,518780,Staff,2,0,20,18
1714605290651,MCWP 40R,B00,518781,Staff,8,0,20,12
1714605290651,MCWP 40R,C00,518783,Staff,6,0,20,14
1714605291680,MCWP 50R,A00,518791,Staff,0,0,20,20
1714605291680,MCWP 50R,B00,518792,Staff,0,2,20,20
1714605291680,MCWP 50R,C00,518793,Staff,0,2,20,20
1714605291680,MCWP 50R,D00,518794,Staff,0,0,20,20
1714605291680,MCWP 50R,E00,518795,Staff,0,2,20,20
1714605291680,MCWP 50R,F00,518796,Staff,0,0,20,20
1714605291680,MCWP 50R,G00,518797,Staff,0,1,20,20
1714605292705,MMW 12R,A01,514034,Herbst; Matthew,0,0,16,16
1714605292705,MMW 12R,A02,514035,Herbst; Matthew,1,0,16,15
1714605293729,MMW 13R,A01,514037,Staff,0,4,16,16
1714605293729,MMW 13R,A02,514039,Staff,0,2,16,16
1714605293729,MMW 13R,A03,628519,Staff,0,2,16,16
1714605295783,SIO 295LS,A00,523233,Staff,10,0,30,20
1714605296808,SIO 295S,A00,523232,Staff,10,0,30,20
1714605297834,SIOC 290S,A01,637330,Merrifield; Mark A,23,0,30,7
1714605298914,SIOC 291S,A01,637333,Gabriel; Corey John,23,0,30,7
1714605299939,SOCI 117,A01,494376,Staff,0,4,5,5
1714605300965,WES 237B,A00,494380,Staff,9,0,20,11
1714605303045,AESE 279B,A00,494370,Wade; Jon P,0,0,33,33
1714605304070,AIP 197,001,627712,Vespa; Emanuel Ignacio,9998,0,9999,1
1714605305098,ANAR 135S,A00,494369,Braswell; Geoffrey E.,0,0,0,0
1714605306129,BENG 196,001,628496,Engler; Adam J.,9998,0,9999,1
1714605307154,CAT 124RS,A01,519847,Geibel; William,0,0,20,20
1714605308177,CAT 125RS,A01,515971,Geibel; William,0,0,20,20
1714605309204,CLRE 250,A00,511389,Morris; Sheldon,9993,0,9999,6
1714605310232,CLRE 251,A00,507176,Mehta; Ravindra L.,9993,0,9999,6
1714605310232,CLRE 251,B00,511410,Mehta; Ravindra L.,9998,0,9999,1
1714605311257,CLRE 252,A00,507189,Cuomo; Raphael Eduardo,9995,0,9999,4
1714605312285,CLRE 253,A00,507199,Vaida; Florin,9994,0,9999,5
1714605312285,CLRE 253,B00,507202,Vaida; Florin,9999,0,9999,0
1714605313313,CLRE 259,A00,507211,Patel; Hemal,9996,0,9999,3
1714605314342,CLRE 260,A00,507221,Cuomo; Raphael Eduardo,9999,0,9999,0
1714605315376,CLRE 297,001,507242,Cuomo; Raphael Eduardo,9999,0,9999,0
1714605316403,COGS 197,001,638244,Voytek; Bradley Thomas,9998,0,9999,1
1714605317428,CSE 191,A00,516875,Minnes Kemp; Mor Mia,9993,0,9999,6
1714605318459,CSE 197,001,637388,Minnes Kemp; Mor Mia,9998,0,9999,1
1714605319488,CSS 201S,A01,494383,Staff,35,0,35,0
1714605320581,CSS 202S,A01,494387,Staff,35,0,35,0
1714605321606,DSC 197,001,628532,Eldridge; Justin Matthew,9996,0,9999,3
1714605322631,EAP 100,A00,516065,Staff,9797,0,9999,202
1714605323660,ECE 45,A01,507414,Staff,33,0,60,27
1714605325713,ECE 111,A01,507420,Staff,15,0,50,35
1714605326741,ECE 197,001,548057,Sievenpiper; Daniel F.,9993,0,9999,6
1714605327769,EDS 115,A00,507243,Choi; Bailey Miyeon,10,0,28,18
1714605328793,EDS 117,A01,494379,Staff,1,5,30,29
1714605329819,EDS 125,A00,507246,Hopkins; Megan Beth,9,0,30,21
1714605330845,EDS 128A,A01,507264,Fargason; Sharon Gayle,8,0,26,18
1714605331872,EDS 128B,A01,507293,Pappas; Elizabeth,12,0,30,18
1714605332900,EDS 139,A00,507294,Fargason; Sharon Gayle,13,0,30,17
1714605332900,EDS 139,B00,507313,Pappas; Elizabeth,13,0,30,17
1714605333925,EDS 201,A00,507315,Staff,13,0,30,17
1714605334948,EDS 203,A01,507317,Halter; Christopher P.,12,0,30,18
1714605335976,EDS 204R,A01,507319,Halter; Christopher P.,0,3,30,30
1714605335976,EDS 204R,B01,507331,Heinzman; Erica M.,16,0,30,14
1714605337004,EDS 206R,A00,507332,Staff,0,4,30,30
1714605337004,EDS 206R,B00,507343,Staff,17,0,30,13
1714605338029,EDS 250,A00,507344,Hemans; Patricia Ann Benitez,22,0,40,18
1714605339054,EDS 281,A00,507345,Daly; Alan J.,18,0,18,0
1714605340082,EDS 284,A00,507350,Daly; Alan J.,16,0,16,0
1714605341110,EDS 286,A00,507359,Fine; Sarah,18,0,18,0
1714605342135,EDS 289C,A01,507361,Daly; Alan J.,18,0,18,0
1714605343162,EDS 290,A00,507366,Hofstetter; Carolyn,15,0,15,0
1714605344193,LIGM 5A,A00,507421,Fischer-Grunski; Eva K,18,0,20,2
1714605345222,LIGM 5B,A00,507423,Fischer-Grunski; Eva K,19,0,20,1
1714605346252,LIGM 5C,A00,507425,Fischer-Grunski; Eva K,19,0,20,1
1714605347277,LIIT 5AS,A00,507427,Carnelos; Chiara,20,0,20,0
1714605348304,LIIT 5BS,A00,507430,Carnelos; Chiara,20,0,20,0
1714605349329,LIIT 5CS,A00,507432,Carnelos; Chiara,20,0,20,0
1714605350359,LISP 5A,A00,507541,Munoz Sanchez; Alicia,11,0,20,9
1714605351386,LISP 5B,A00,507671,Munoz Sanchez; Alicia,8,0,20,12
1714605352414,LISP 5C,A00,507696,Munoz Sanchez; Alicia,9,0,20,11
1714605353441,MAE 197,001,528363,Boechler; Nicholas Sebastia,9998,0,9999,1
1714605354471,MATH 197,001,523477,Kedlaya; Kiran S.,9995,0,9999,4
1714605354471,MATH 197,002,563811,Zhang; Danna,9995,0,9999,4
1714605354471,MATH 197,003,628552,Dumitriu; Ioana,9998,0,9999,1
1714605355496,MCWP 40R,A00,518780,Staff,2,0,20,18
1714605355496,MCWP 40R,B00,518781,Staff,8,0,20,12
1714605355496,MCWP 40R,C00,518783,Staff,6,0,20,14
1714605356520,MCWP 50R,A00,518791,Staff,0,0,20,20
1714605356520,MCWP 50R,B00,518792,Staff,0,2,20,20
1714605356520,MCWP 50R,C00,518793,Staff,0,2,20,20
1714605356520,MCWP 50R,D00,518794,Staff,0,0,20,20
1714605356520,MCWP 50R,E00,518795,Staff,0,2,20,20
1714605356520,MCWP 50R,F00,518796,Staff,0,0,20,20
1714605356520,MCWP 50R,G00,518797,Staff,0,1,20,20
1714605357548,MMW 12R,A01,514034,Herbst; Matthew,0,0,16,16
1714605357548,MMW 12R,A02,514035,Herbst; Matthew,1,0,16,15
1714605358572,MMW 13R,A01,514037,Staff,0,4,16,16
1714605358572,MMW 13R,A02,514039,Staff,0,2,16,16
1714605358572,MMW 13R,A03,628519,Staff,0,2,16,16
1714605360627,SIO 295LS,A00,523233,Staff,10,0,30,20
1714605361650,SIO 295S,A00,523232,Staff,10,0,30,20
1714605362681,SIOC 290S,A01,637330,Merrifield; Mark A,23,0,30,7
1714605363712,SIOC 291S,A01,637333,Gabriel; Corey John,23,0,30,7
1714605364738,SOCI 117,A01,494376,Staff,0,4,5,5
1714605365763,WES 237B,A00,494380,Staff,9,0,20,11
1714605367852,AESE 279B,A00,494370,Wade; Jon P,0,0,33,33
1714605368878,AIP 197,001,627712,Vespa; Emanuel Ignacio,9998,0,9999,1
1714605369903,ANAR 135S,A00,494369,Braswell; Geoffrey E.,0,0,0,0
1714605370933,BENG 196,001,628496,Engler; Adam J.,9998,0,9999,1
1714605371958,CAT 124RS,A01,519847,Geibel; William,0,0,20,20
1714605372987,CAT 125RS,A01,515971,Geibel; William,0,0,20,20
1714605374013,CLRE 250,A00,511389,Morris; Sheldon,9993,0,9999,6
1714605375045,CLRE 251,A00,507176,Mehta; Ravindra L.,9993,0,9999,6
1714605375045,CLRE 251,B00,511410,Mehta; Ravindra L.,9998,0,9999,1
1714605376071,CLRE 252,A00,507189,Cuomo; Raphael Eduardo,9995,0,9999,4
1714605377096,CLRE 253,A00,507199,Vaida; Florin,9994,0,9999,5
1714605377096,CLRE 253,B00,507202,Vaida; Florin,9999,0,9999,0
1714605378121,CLRE 259,A00,507211,Patel; Hemal,9996,0,9999,3
1714605379150,CLRE 260,A00,507221,Cuomo; Raphael Eduardo,9999,0,9999,0
1714605380176,CLRE 297,001,507242,Cuomo; Raphael Eduardo,9999,0,9999,0
1714605381206,COGS 197,001,638244,Voytek; Bradley Thomas,9998,0,9999,1
1714605382230,CSE 191,A00,516875,Minnes Kemp; Mor Mia,9993,0,9999,6
1714605383258,CSE 197,001,637388,Minnes Kemp; Mor Mia,9998,0,9999,1
1714605384286,CSS 201S,A01,494383,Staff,35,0,35,0
1714605385310,CSS 202S,A01,494387,Staff,35,0,35,0
1714605386338,DSC 197,001,628532,Eldridge; Justin Matthew,9996,0,9999,3
1714605387363,EAP 100,A00,516065,Staff,9797,0,9999,202
1714605388388,ECE 45,A01,507414,Staff,33,0,60,27
1714605390440,ECE 111,A01,507420,Staff,15,0,50,35
1714605391467,ECE 197,001,548057,Sievenpiper; Daniel F.,9993,0,9999,6
1714605392500,EDS 115,A00,507243,Choi; Bailey Miyeon,10,0,28,18
1714605393524,EDS 117,A01,494379,Staff,1,5,30,29
1714605394576,EDS 125,A00,507246,Hopkins; Megan Beth,9,0,30,21
1714605395607,EDS 128A,A01,507264,Fargason; Sharon Gayle,8,0,26,18
1714605396635,EDS 128B,A01,507293,Pappas; Elizabeth,12,0,30,18
1714605397658,EDS 139,A00,507294,Fargason; Sharon Gayle,13,0,30,17
1714605397658,EDS 139,B00,507313,Pappas; Elizabeth,13,0,30,17
1714605398684,EDS 201,A00,507315,Staff,13,0,30,17
1714605399709,EDS 203,A01,507317,Halter; Christopher P.,12,0,30,18
1714605400736,EDS 204R,A01,507319,Halter; Christopher P.,0,3,30,30
1714605400736,EDS 204R,B01,507331,Heinzman; Erica M.,16,0,30,14
1714605401760,EDS 206R,A00,507332,Staff,0,4,30,30
1714605401760,EDS 206R,B00,507343,Staff,17,0,30,13
1714605402839,EDS 250,A00,507344,Hemans; Patricia Ann Benitez,22,0,40,18
1714605403865,EDS 281,A00,507345,Daly; Alan J.,18,0,18,0
1714605404891,EDS 284,A00,507350,Daly; Alan J.,16,0,16,0
1714605405917,EDS 286,A00,507359,Fine; Sarah,18,0,18,0
1714605406943,EDS 289C,A01,507361,Daly; Alan J.,18,0,18,0
1714605407967,EDS 290,A00,507366,Hofstetter; Carolyn,15,0,15,0
1714605408993,LIGM 5A,A00,507421,Fischer-Grunski; Eva K,18,0,20,2
1714605410022,LIGM 5B,A00,507423,Fischer-Grunski; Eva K,19,0,20,1
1714605411048,LIGM 5C,A00,507425,Fischer-Grunski; Eva K,19,0,20,1
1714605412076,LIIT 5AS,A00,507427,Carnelos; Chiara,20,0,20,0
1714605413105,LIIT 5BS,A00,507430,Carnelos; Chiara,20,0,20,0
1714605414131,LIIT 5CS,A00,507432,Carnelos; Chiara,20,0,20,0
1714605415155,LISP 5A,A00,507541,Munoz Sanchez; Alicia,11,0,20,9
1714605416185,LISP 5B,A00,507671,Munoz Sanchez; Alicia,8,0,20,12
1714605417210,LISP 5C,A00,507696,Munoz Sanchez; Alicia,9,0,20,11
1714605418241,MAE 197,001,528363,Boechler; Nicholas Sebastia,9998,0,9999,1
1714605419270,MATH 197,001,523477,Kedlaya; Kiran S.,9995,0,9999,4
1714605419270,MATH 197,002,563811,Zhang; Danna,9995,0,9999,4
1714605419270,MATH 197,003,628552,Dumitriu; Ioana,9998,0,9999,1
1714605420296,MCWP 40R,A00,518780,Staff,2,0,20,18
1714605420296,MCWP 40R,B00,518781,Staff,8,0,20,12
1714605420296,MCWP 40R,C00,518783,Staff,6,0,20,14
1714605421325,MCWP 50R,A00,518791,Staff,0,0,20,20
1714605421325,MCWP 50R,B00,518792,Staff,0,2,20,20
1714605421325,MCWP 50R,C00,518793,Staff,0,2,20,20
1714605421325,MCWP 50R,D00,518794,Staff,0,0,20,20
1714605421325,MCWP 50R,E00,518795,Staff,0,2,20,20
1714605421325,MCWP 50R,F00,518796,Staff,0,0,20,20
1714605421325,MCWP 50R,G00,518797,Staff,0,1,20,20
1714605422350,MMW 12R,A01,514034,Herbst; Matthew,0,0,16,16
1714605422350,MMW 12R,A02,514035,Herbst; Matthew,1,0,16,15
1714605423377,MMW 13R,A01,514037,Staff,0,4,16,16
1714605423377,MMW 13R,A02,514039,Staff,0,2,16,16
1714605423377,MMW 13R,A03,628519,Staff,0,2,16,16
1714605425433,SIO 295LS,A00,523233,Staff,10,0,30,20
1714605426457,SIO 295S,A00,523232,Staff,10,0,30,20
1714605427482,SIOC 290S,A01,637330,Merrifield; Mark A,23,0,30,7
1714605428512,SIOC 291S,A01,637333,Gabriel; Corey John,23,0,30,7
1714605429536,SOCI 117,A01,494376,Staff,0,4,5,5
1714605430561,WES 237B,A00,494380,Staff,9,0,20,11
1714605432632,AESE 279B,A00,494370,Wade; Jon P,0,0,33,33
1714605433657,AIP 197,001,627712,Vespa; Emanuel Ignacio,9998,0,9999,1
1714605434685,ANAR 135S,A00,494369,Braswell; Geoffrey E.,0,0,0,0
1714605435710,BENG 196,001,628496,Engler; Adam J.,9998,0,9999,1
1714605436740,CAT 124RS,A01,519847,Geibel; William,0,0,20,20
1714605437765,CAT 125RS,A01,515971,Geibel; William,0,0,20,20
1714605438789,CLRE 250,A00,511389,Morris; Sheldon,9993,0,9999,6
1714605439820,CLRE 251,A00,507176,Mehta; Ravindra L.,9993,0,9999,6
1714605439820,CLRE 251,B00,511410,Mehta; Ravindra L.,9998,0,9999,1
1714605440845,CLRE 252,A00,507189,Cuomo; Raphael Eduardo,9995,0,9999,4
1714605441876,CLRE 253,A00,507199,Vaida; Florin,9994,0,9999,5
1714605441876,CLRE 253,B00,507202,Vaida; Florin,9999,0,9999,0
1714605442900,CLRE 259,A00,507211,Patel; Hemal,9996,0,9999,3
1714605443930,CLRE 260,A00,507221,Cuomo; Raphael Eduardo,9999,0,9999,0
1714605444959,CLRE 297,001,507242,Cuomo; Raphael Eduardo,9999,0,9999,0
1714605445989,COGS 197,001,638244,Voytek; Bradley Thomas,9998,0,9999,1
1714605447015,CSE 191,A00,516875,Minnes Kemp; Mor Mia,9993,0,9999,6
1714605448041,CSE 197,001,637388,Minnes Kemp; Mor Mia,9998,0,9999,1
1714605449067,CSS 201S,A01,494383,Staff,35,0,35,0
1714605450093,CSS 202S,A01,494387,Staff,35,0,35,0
1714605451119,DSC 197,001,628532,Eldridge; Justin Matthew,9996,0,9999,3
1714605452148,EAP 100,A00,516065,Staff,9797,0,9999,202
1714605453175,ECE 45,A01,507414,Staff,33,0,60,27
1714605455227,ECE 111,A01,507420,Staff,15,0,50,35
1714605456255,ECE 197,001,548057,Sievenpiper; Daniel F.,9993,0,9999,6
1714605457282,EDS 115,A00,507243,Choi; Bailey Miyeon,10,0,28,18
1714605458312,EDS 117,A01,494379,Staff,1,5,30,29
1714605459344,EDS 125,A00,507246,Hopkins; Megan Beth,9,0,30,21
1714605460370,EDS 128A,A01,507264,Fargason; Sharon Gayle,8,0,26,18
1714605461395,EDS 128B,A01,507293,Pappas; Elizabeth,12,0,30,18
1714605462424,EDS 139,A00,507294,Fargason; Sharon Gayle,13,0,30,17
1714605462424,EDS 139,B00,507313,Pappas; Elizabeth,13,0,30,17
1714605463448,EDS 201,A00,507315,Staff,13,0,30,17
1714605464473,EDS 203,A01,507317,Halter; Christopher P.,12,0,30,18
1714605465502,EDS 204R,A01,507319,Halter; Christopher P.,0,3,30,30
1714605465502,EDS 204R,B01,507331,Heinzman; Erica M.,16,0,30,14
1714605466528,EDS 206R,A00,507332,Staff,0,4,30,30
1714605466528,EDS 206R,B00,507343,Staff,17,0,30,13
1714605467556,EDS 250,A00,507344,Hemans; Patricia Ann Benitez,22,0,40,18
1714605468583,EDS 281,A00,507345,Daly; Alan J.,18,0,18,0
1714605469608,EDS 284,A00,507350,Daly; Alan J.,16,0,16,0
1714605470634,EDS 286,A00,507359,Fine; Sarah,18,0,18,0
1714605471659,EDS 289C,A01,507361,Daly; Alan J.,18,0,18,0
1714605472687,EDS 290,A00,507366,Hofstetter; Carolyn,15,0,15,0
1714605473716,LIGM 5A,A00,507421,Fischer-Grunski; Eva K,18,0,20,2
1714605474743,LIGM 5B,A00,507423,Fischer-Grunski; Eva K,19,0,20,1
1714605475771,LIGM 5C,A00,507425,Fischer-Grunski; Eva K,19,0,20,1
1714605476797,LIIT 5AS,A00,507427,Carnelos; Chiara,20,0,20,0
1714605477821,LIIT 5BS,A00,507430,Carnelos; Chiara,20,0,20,0
1714605478847,LIIT 5CS,A00,507432,Carnelos; Chiara,20,0,20,0
1714605479878,LISP 5A,A00,507541,Munoz Sanchez; Alicia,11,0,20,9
1714605480907,LISP 5B,A00,507671,Munoz Sanchez; Alicia,8,0,20,12
1714605481936,LISP 5C,A00,507696,Munoz Sanchez; Alicia,9,0,20,11
1714605482961,MAE 197,001,528363,Boechler; Nicholas Sebastia,9998,0,9999,1
1714605483987,MATH 197,001,523477,Kedlaya; Kiran S.,9995,0,9999,4
1714605483987,MATH 197,002,563811,Zhang; Danna,9995,0,9999,4
1714605483987,MATH 197,003,628552,Dumitriu; Ioana,9998,0,9999,1
1714605485016,MCWP 40R,A00,518780,Staff,2,0,20,18
1714605485016,MCWP 40R,B00,518781,Staff,8,0,20,12
1714605485016,MCWP 40R,C00,518783,Staff,6,0,20,14
1714605486044,MCWP 50R,A00,518791,Staff,0,0,20,20
1714605486044,MCWP 50R,B00,518792,Staff,0,2,20,20
1714605486044,MCWP 50R,C00,518793,Staff,0,2,20,20
1714605486044,MCWP 50R,D00,518794,Staff,0,0,20,20
1714605486044,MCWP 50R,E00,518795,Staff,0,2,20,20
1714605486044,MCWP 50R,F00,518796,Staff,0,0,20,20
1714605486044,MCWP 50R,G00,518797,Staff,0,1,20,20
1714605487072,MMW 12R,A01,514034,Herbst; Matthew,0,0,16,16
1714605487072,MMW 12R,A02,514035,Herbst; Matthew,1,0,16,15
1714605488099,MMW 13R,A01,514037,Staff,0,4,16,16
1714605488099,MMW 13R,A02,514039,Staff,0,2,16,16
1714605488099,MMW 13R,A03,628519,Staff,0,2,16,16
1714605490151,SIO 295LS,A00,523233,Staff,10,0,30,20
1714605491180,SIO 295S,A00,523232,Staff,10,0,30,20
1714605492206,SIOC 290S,A01,637330,Merrifield; Mark A,23,0,30,7
1714605493232,SIOC 291S,A01,637333,Gabriel; Corey John,23,0,30,7
1714605494257,SOCI 117,A01,494376,Staff,0,4,5,5
1714605495285,WES 237B,A00,494380,Staff,9,0,20,11
1714605497356,AESE 279B,A00,494370,Wade; Jon P,0,0,33,33
1714605498380,AIP 197,001,627712,Vespa; Emanuel Ignacio,9998,0,9999,1
1714605499405,ANAR 135S,A00,494369,Braswell; Geoffrey E.,0,0,0,0
1714605500430,BENG 196,001,628496,Engler; Adam J.,9998,0,9999,1
1714605501459,CAT 124RS,A01,519847,Geibel; William,0,0,20,20
1714605502484,CAT 125RS,A01,515971,Geibel; William,0,0,20,20
1714605503513,CLRE 250,A00,511389,Morris; Sheldon,9993,0,9999,6
1714605504539,CLRE 251,A00,507176,Mehta; Ravindra L.,9993,0,9999,6
1714605504539,CLRE 251,B00,511410,Mehta; Ravindra L.,9998,0,9999,1
1714605505565,CLRE 252,A00,507189,Cuomo; Raphael Eduardo,9995,0,9999,4
1714605506591,CLRE 253,A00,507199,Vaida; Florin,9994,0,9999,5
1714605506591,CLRE 253,B00,507202,Vaida; Florin,9999,0,9999,0
1714605507616,CLRE 259,A00,507211,Patel; Hemal,9996,0,9999,3
1714605508641,CLRE 260,A00,507221,Cuomo; Raphael Eduardo,9999,0,9999,0
1714605509665,CLRE 297,001,507242,Cuomo; Raphael Eduardo,9999,0,9999,0
1714605510694,COGS 197,001,638244,Voytek; Bradley Thomas,9998,0,9999,1
1714605511719,CSE 191,A00,516875,Minnes Kemp; Mor Mia,9993,0,9999,6
1714605512745,CSE 197,001,637388,Minnes Kemp; Mor Mia,9998,0,9999,1
1714605513770,CSS 201S,A01,494383,Staff,35,0,35,0
1714605514795,CSS 202S,A01,494387,Staff,35,0,35,0
1714605515821,DSC 197,001,628532,Eldridge; Justin Matthew,9996,0,9999,3
1714605516845,EAP 100,A00,516065,Staff,9797,0,9999,202
1714605517871,ECE 45,A01,507414,Staff,33,0,60,27
1714605519920,ECE 111,A01,507420,Staff,15,0,50,35
1714605520945,ECE 197,001,548057,Sievenpiper; Daniel F.,9993,0,9999,6
1714605521975,EDS 115,A00,507243,Choi; Bailey Miyeon,10,0,28,18
1714605523002,EDS 117,A01,494379,Staff,1,5,30,29
1714605524028,EDS 125,A00,507246,Hopkins; Megan Beth,9,0,30,21
1714605525056,EDS 128A,A01,507264,Fargason; Sharon Gayle,8,0,26,18
1714605526087,EDS 128B,A01,507293,Pappas; Elizabeth,12,0,30,18
1714605527114,EDS 139,A00,507294,Fargason; Sharon Gayle,13,0,30,17
1714605527114,EDS 139,B00,507313,Pappas; Elizabeth,13,0,30,17
1714605528140,EDS 201,A00,507315,Staff,13,0,30,17
1714605529168,EDS 203,A01,507317,Halter; Christopher P.,12,0,30,18
1714605530194,EDS 204R,A01,507319,Halter; Christopher P.,0,3,30,30
1714605530194,EDS 204R,B01,507331,Heinzman; Erica M.,16,0,30,14
1714605531218,EDS 206R,A00,507332,Staff,0,4,30,30
1714605531218,EDS 206R,B00,507343,Staff,17,0,30,13
1714605532243,EDS 250,A00,507344,Hemans; Patricia Ann Benitez,22,0,40,18
1714605533276,EDS 281,A00,507345,Daly; Alan J.,18,0,18,0
1714605534303,EDS 284,A00,507350,Daly; Alan J.,16,0,16,0
1714605535330,EDS 286,A00,507359,Fine; Sarah,18,0,18,0
1714605536354,EDS 289C,A01,507361,Daly; Alan J.,18,0,18,0
1714605537378,EDS 290,A00,507366,Hofstetter; Carolyn,15,0,15,0
1714605538405,LIGM 5A,A00,507421,Fischer-Grunski; Eva K,18,0,20,2
1714605539434,LIGM 5B,A00,507423,Fischer-Grunski; Eva K,19,0,20,1
1714605540460,LIGM 5C,A00,507425,Fischer-Grunski; Eva K,19,0,20,1
1714605541485,LIIT 5AS,A00,507427,Carnelos; Chiara,20,0,20,0
1714605542510,LIIT 5BS,A00,507430,Carnelos; Chiara,20,0,20,0
1714605543535,LIIT 5CS,A00,507432,Carnelos; Chiara,20,0,20,0
1714605544560,LISP 5A,A00,507541,Munoz Sanchez; Alicia,11,0,20,9
1714605545587,LISP 5B,A00,507671,Munoz Sanchez; Alicia,8,0,20,12
1714605546614,LISP 5C,A00,507696,Munoz Sanchez; Alicia,9,0,20,11
1714605547642,MAE 197,001,528363,Boechler; Nicholas Sebastia,9998,0,9999,1
1714605548669,MATH 197,001,523477,Kedlaya; Kiran S.,9995,0,9999,4
1714605548669,MATH 197,002,563811,Zhang; Danna,9995,0,9999,4
1714605548669,MATH 197,003,628552,Dumitriu; Ioana,9998,0,9999,1
1714605549694,MCWP 40R,A00,518780,Staff,2,0,20,18
1714605549694,MCWP 40R,B00,518781,Staff,8,0,20,12
1714605549694,MCWP 40R,C00,518783,Staff,6,0,20,14
1714605550719,MCWP 50R,A00,518791,Staff,0,0,20,20
1714605550719,MCWP 50R,B00,518792,Staff,0,2,20,20
1714605550719,MCWP 50R,C00,518793,Staff,0,2,20,20
1714605550719,MCWP 50R,D00,518794,Staff,0,0,20,20
1714605550719,MCWP 50R,E00,518795,Staff,0,2,20,20
1714605550719,MCWP 50R,F00,518796,Staff,0,0,20,20
1714605550719,MCWP 50R,G00,518797,Staff,0,1,20,20
1714605551745,MMW 12R,A01,514034,Herbst; Matthew,0,0,16,16
1714605551745,MMW 12R,A02,514035,Herbst; Matthew,1,0,16,15
1714605552773,MMW 13R,A01,514037,Staff,0,4,16,16
1714605552773,MMW 13R,A02,514039,Staff,0,2,16,16
1714605552773,MMW 13R,A03,628519,Staff,0,2,16,16
1714605554827,SIO 295LS,A00,523233,Staff,10,0,30,20
1714605555854,SIO 295S,A00,523232,Staff,10,0,30,20
1714605556882,SIOC 290S,A01,637330,Merrifield; Mark A,23,0,30,7
1714605557907,SIOC 291S,A01,637333,Gabriel; Corey John,23,0,30,7
1714605558932,SOCI 117,A01,494376,Staff,0,4,5,5
1714605559957,WES 237B,A00,494380,Staff,9,0,20,11
1714605562042,AESE 279B,A00,494370,Wade; Jon P,0,0,33,33
1714605563070,AIP 197,001,627712,Vespa; Emanuel Ignacio,9998,0,9999,1
1714605564096,ANAR 135S,A00,494369,Braswell; Geoffrey E.,0,0,0,0
1714605565122,BENG 196,001,628496,Engler; Adam J.,9998,0,9999,1
1714605566150,CAT 124RS,A01,519847,Geibel; William,0,0,20,20
1714605567175,CAT 125RS,A01,515971,Geibel; William,0,0,20,20
1714605568200,CLRE 250,A00,511389,Morris; Sheldon,9993,0,9999,6
1714605569227,CLRE 251,A00,507176,Mehta; Ravindra L.,9993,0,9999,6
1714605569227,CLRE 251,B00,511410,Mehta; Ravindra L.,9998,0,9999,1
1714605570256,CLRE 252,A00,507189,Cuomo; Raphael Eduardo,9995,0,9999,4
1714605571284,CLRE 253,A00,507199,Vaida; Florin,9994,0,9999,5
1714605571284,CLRE 253,B00,507202,Vaida; Florin,9999,0,9999,0
1714605572310,CLRE 259,A00,507211,Patel; Hemal,9996,0,9999,3
1714605573340,CLRE 260,A00,507221,Cuomo; Raphael Eduardo,9999,0,9999,0
1714605574364,CLRE 297,001,507242,Cuomo; Raphael Eduardo,9999,0,9999,0
1714605575388,COGS 197,001,638244,Voytek; Bradley Thomas,9998,0,9999,1
1714605576413,CSE 191,A00,516875,Minnes Kemp; Mor Mia,9993,0,9999,6
1714605577439,CSE 197,001,637388,Minnes Kemp; Mor Mia,9998,0,9999,1
1714605578467,CSS 201S,A01,494383,Staff,35,0,35,0
1714605579495,CSS 202S,A01,494387,Staff,35,0,35,0
1714605580521,DSC 197,001,628532,Eldridge; Justin Matthew,9996,0,9999,3
1714605581545,EAP 100,A00,516065,Staff,9797,0,9999,202
1714605582571,ECE 45,A01,507414,Staff,33,0,60,27
1714605584622,ECE 111,A01,507420,Staff,15,0,50,35
1714605585662,ECE 197,001,548057,Sievenpiper; Daniel F.,9993,0,9999,6
1714605586688,EDS 115,A00,507243,Choi; Bailey Miyeon,10,0,28,18
1714605587711,EDS 117,A01,494379,Staff,1,5,30,29
1714605588736,EDS 125,A00,507246,Hopkins; Megan Beth,9,0,30,21
1714605589763,EDS 128A,A01,507264,Fargason; Sharon Gayle,8,0,26,18
1714605590790,EDS 128B,A01,507293,Pappas; Elizabeth,12,0,30,18
1714605591818,EDS 139,A00,507294,Fargason; Sharon Gayle,13,0,30,17
1714605591818,EDS 139,B00,507313,Pappas; Elizabeth,13,0,30,17
1714605592841,EDS 201,A00,507315,Staff,13,0,30,17
1714605593865,EDS 203,A01,507317,Halter; Christopher P.,12,0,30,18
1714605594888,EDS 204R,A01,507319,Halter; Christopher P.,0,3,30,30
1714605594888,EDS 204R,B01,507331,Heinzman; Erica M.,16,0,30,14
1714605595913,EDS 206R,A00,507332,Staff,0,4,30,30
1714605595913,EDS 206R,B00,507343,Staff,17,0,30,13
1714605596939,EDS 250,A00,507344,Hemans; Patricia Ann Benitez,22,0,40,18
1714605597965,EDS 281,A00,507345,Daly; Alan J.,18,0,18,0
1714605598989,EDS 284,A00,507350,Daly; Alan J.,16,0,16,0
1714605600016,EDS 286,A00,507359,Fine; Sarah,18,0,18,0
1714605601042,EDS 289C,A01,507361,Daly; Alan J.,18,0,18,0
1714605602069,EDS 290,A00,507366,Hofstetter; Carolyn,15,0,15,0
1714605603099,LIGM 5A,A00,507421,Fischer-Grunski; Eva K,18,0,20,2
1714605604124,LIGM 5B,A00,507423,Fischer-Grunski; Eva K,19,0,20,1
1714605605150,LIGM 5C,A00,507425,Fischer-Grunski; Eva K,19,0,20,1
1714605606175,LIIT 5AS,A00,507427,Carnelos; Chiara,20,0,20,0
1714605607203,LIIT 5BS,A00,507430,Carnelos; Chiara,20,0,20,0
1714605608229,LIIT 5CS,A00,507432,Carnelos; Chiara,20,0,20,0
1714605609313,LISP 5A,A00,507541,Munoz Sanchez; Alicia,11,0,20,9
1714605610358,LISP 5B,A00,507671,Munoz Sanchez; Alicia,8,0,20,12
1714605611387,LISP 5C,A00,507696,Munoz Sanchez; Alicia,9,0,20,11
1714605612413,MAE 197,001,528363,Boechler; Nicholas Sebastia,9998,0,9999,1
1714605613439,MATH 197,001,523477,Kedlaya; Kiran S.,9995,0,9999,4
1714605613439,MATH 197,002,563811,Zhang; Danna,9995,0,9999,4
1714605613439,MATH 197,003,628552,Dumitriu; Ioana,9998,0,9999,1
1714605614464,MCWP 40R,A00,518780,Staff,2,0,20,18
1714605614464,MCWP 40R,B00,518781,Staff,8,0,20,12
1714605614464,MCWP 40R,C00,518783,Staff,6,0,20,14
1714605615490,MCWP 50R,A00,518791,Staff,0,0,20,20
1714605615490,MCWP 50R,B00,518792,Staff,0,2,20,20
1714605615490,MCWP 50R,C00,518793,Staff,0,2,20,20
1714605615490,MCWP 50R,D00,518794,Staff,0,0,20,20
1714605615490,MCWP 50R,E00,518795,Staff,0,2,20,20
1714605615490,MCWP 50R,F00,518796,Staff,0,0,20,20
1714605615490,MCWP 50R,G00,518797,Staff,0,1,20,20
1714605616516,MMW 12R,A01,514034,Herbst; Matthew,0,0,16,16
1714605616516,MMW 12R,A02,514035,Herbst; Matthew,1,0,16,15
1714605617543,MMW 13R,A01,514037,Staff,0,4,16,16
1714605617543,MMW 13R,A02,514039,Staff,0,2,16,16
1714605617543,MMW 13R,A03,628519,Staff,0,2,16,16
1714605619593,SIO 295LS,A00,523233,Staff,10,0,30,20
1714605620623,SIO 295S,A00,523232,Staff,10,0,30,20
1714605621648,SIOC 290S,A01,637330,Merrifield; Mark A,23,0,30,7
1714605622680,SIOC 291S,A01,637333,Gabriel; Corey John,23,0,30,7
1714605623705,SOCI 117,A01,494376,Staff,0,4,5,5
1714605624730,WES 237B,A00,494380,Staff,9,0,20,11
1714605626795,AESE 279B,A00,494370,Wade; Jon P,0,0,33,33
1714605627820,AIP 197,001,627712,Vespa; Emanuel Ignacio,9998,0,9999,1
1714605628848,ANAR 135S,A00,494369,Braswell; Geoffrey E.,0,0,0,0
1714605629873,BENG 196,001,628496,Engler; Adam J.,9998,0,9999,1
1714605630902,CAT 124RS,A01,519847,Geibel; William,0,0,20,20
1714605631927,CAT 125RS,A01,515971,Geibel; William,0,0,20,20
1714605632952,CLRE 250,A00,511389,Morris; Sheldon,9993,0,9999,6
1714605633978,CLRE 251,A00,507176,Mehta; Ravindra L.,9993,0,9999,6
1714605633978,CLRE 251,B00,511410,Mehta; Ravindra L.,9998,0,9999,1
1714605635005,CLRE 252,A00,507189,Cuomo; Raphael Eduardo,9995,0,9999,4
1714605636034,CLRE 253,A00,507199,Vaida; Florin,9994,0,9999,5
1714605636034,CLRE 253,B00,507202,Vaida; Florin,9999,0,9999,0
1714605637060,CLRE 259,A00,507211,Patel; Hemal,9996,0,9999,3
1714605638084,CLRE 260,A00,507221,Cuomo; Raphael Eduardo,9999,0,9999,0
1714605639112,CLRE 297,001,507242,Cuomo; Raphael Eduardo,9999,0,9999,0
1714605640138,COGS 197,001,638244,Voytek; Bradley Thomas,9998,0,9999,1
1714605641162,CSE 191,A00,516875,Minnes Kemp; Mor Mia,9993,0,9999,6
1714605642188,CSE 197,001,637388,Minnes Kemp; Mor Mia,9998,0,9999,1
1714605643269,CSS 201S,A01,494383,Staff,35,0,35,0
1714605644294,CSS 202S,A01,494387,Staff,35,0,35,0
1714605645320,DSC 197,001,628532,Eldridge; Justin Matthew,9996,0,9999,3
1714605646346,EAP 100,A00,516065,Staff,9797,0,9999,202
1714605647370,ECE 45,A01,507414,Staff,33,0,60,27
1714605649436,ECE 111,A01,507420,Staff,15,0,50,35
1714605650462,ECE 197,001,548057,Sievenpiper; Daniel F.,9993,0,9999,6
1714605651488,EDS 115,A00,507243,Choi; Bailey Miyeon,10,0,28,18
1714605652514,EDS 117,A01,494379,Staff,1,5,30,29
1714605653543,EDS 125,A00,507246,Hopkins; Megan Beth,9,0,30,21
1714605654568,EDS 128A,A01,507264,Fargason; Sharon Gayle,8,0,26,18
1714605655596,EDS 128B,A01,507293,Pappas; Elizabeth,12,0,30,18
1714605656623,EDS 139,A00,507294,Fargason; Sharon Gayle,13,0,30,17
1714605656623,EDS 139,B00,507313,Pappas; Elizabeth,13,0,30,17
1714605657651,EDS 201,A00,507315,Staff,13,0,30,17
1714605658675,EDS 203,A01,507317,Halter; Christopher P.,12,0,30,18
1714605659701,EDS 204R,A01,507319,Halter; Christopher P.,0,3,30,30
1714605659701,EDS 204R,B01,507331,Heinzman; Erica M.,16,0,30,14
1714605660731,EDS 206R,A00,507332,Staff,0,4,30,30
1714605660731,EDS 206R,B00,507343,Staff,17,0,30,13
1714605661763,EDS 250,A00,507344,Hemans; Patricia Ann Benitez,22,0,40,18
1714605662788,EDS 281,A00,507345,Daly; Alan J.,18,0,18,0
1714605663818,EDS 284,A00,507350,Daly; Alan J.,16,0,16,0
1714605664851,EDS 286,A00,507359,Fine; Sarah,18,0,18,0
1714605665878,EDS 289C,A01,507361,Daly; Alan J.,18,0,18,0
1714605666904,EDS 290,A00,507366,Hofstetter; Carolyn,15,0,15,0
1714605667930,LIGM 5A,A00,507421,Fischer-Grunski; Eva K,18,0,20,2
1714605668956,LIGM 5B,A00,507423,Fischer-Grunski; Eva K,19,0,20,1
1714605669985,LIGM 5C,A00,507425,Fischer-Grunski; Eva K,19,0,20,1
1714605671015,LIIT 5AS,A00,507427,Carnelos; Chiara,20,0,20,0
1714605672040,LIIT 5BS,A00,507430,Carnelos; Chiara,20,0,20,0
1714605673067,LIIT 5CS,A00,507432,Carnelos; Chiara,20,0,20,0
1714605674094,LISP 5A,A00,507541,Munoz Sanchez; Alicia,11,0,20,9
1714605675121,LISP 5B,A00,507671,Munoz Sanchez; Alicia,8,0,20,12
1714605676151,LISP 5C,A00,507696,Munoz Sanchez; Alicia,9,0,20,11
1714605677180,MAE 197,001,528363,Boechler; Nicholas Sebastia,9998,0,9999,1
1714605678208,MATH 197,001,523477,Kedlaya; Kiran S.,9995,0,9999,4
1714605678208,MATH 197,002,563811,Zhang; Danna,9995,0,9999,4
1714605678208,MATH 197,003,628552,Dumitriu; Ioana,9998,0,9999,1
1714605679237,MCWP 40R,A00,518780,Staff,2,0,20,18
1714605679237,MCWP 40R,B00,518781,Staff,8,0,20,12
1714605679237,MCWP 40R,C00,518783,Staff,6,0,20,14
1714605680267,MCWP 50R,A00,518791,Staff,0,0,20,20
1714605680267,MCWP 50R,B00,518792,Staff,0,2,20,20
1714605680267,MCWP 50R,C00,518793,Staff,0,2,20,20
1714605680267,MCWP 50R,D00,518794,Staff,0,0,20,20
1714605680267,MCWP 50R,E00,518795,Staff,0,2,20,20
1714605680267,MCWP 50R,F00,518796,Staff,0,0,20,20
1714605680267,MCWP 50R,G00,518797,Staff,0,1,20,20
1714605681294,MMW 12R,A01,514034,Herbst; Matthew,0,0,16,16
1714605681294,MMW 12R,A02,514035,Herbst; Matthew,1,0,16,15
1714605682333,MMW 13R,A01,514037,Staff,0,4,16,16
1714605682333,MMW 13R,A02,514039,Staff,0,2,16,16
1714605682333,MMW 13R,A03,628519,Staff,0,2,16,16
1714605684384,SIO 295LS,A00,523233,Staff,10,0,30,20
1714605685413,SIO 295S,A00,523232,Staff,10,0,30,20
1714605686442,SIOC 290S,A01,637330,Merrifield; Mark A,23,0,30,7
1714605687467,SIOC 291S,A01,637333,Gabriel; Corey John,23,0,30,7
1714605688495,SOCI 117,A01,494376,Staff,0,4,5,5
1714605689523,WES 237B,A00,494380,Staff,9,0,20,11
1714605691592,AESE 279B,A00,494370,Wade; Jon P,0,0,33,33
1714605692617,AIP 197,001,627712,Vespa; Emanuel Ignacio,9998,0,9999,1
1714605693642,ANAR 135S,A00,494369,Braswell; Geoffrey E.,0,0,0,0
1714605694668,BENG 196,001,628496,Engler; Adam J.,9998,0,9999,1
1714605695695,CAT 124RS,A01,519847,Geibel; William,0,0,20,20
1714605696723,CAT 125RS,A01,515971,Geibel; William,0,0,20,20
1714605697750,CLRE 250,A00,511389,Morris; Sheldon,9993,0,9999,6
1714605698780,CLRE 251,A00,507176,Mehta; Ravindra L.,9993,0,9999,6
1714605698780,CLRE 251,B00,511410,Mehta; Ravindra L.,9998,0,9999,1
1714605699806,CLRE 252,A00,507189,Cuomo; Raphael Eduardo,9995,0,9999,4
1714605700832,CLRE 253,A00,507199,Vaida; Florin,9994,0,9999,5
1714605700832,CLRE 253,B00,507202,Vaida; Florin,9999,0,9999,0
1714605701856,CLRE 259,A00,507211,Patel; Hemal,9996,0,9999,3
1714605702885,CLRE 260,A00,507221,Cuomo; Raphael Eduardo,9999,0,9999,0
1714605703913,CLRE 297,001,507242,Cuomo; Raphael Eduardo,9999,0,9999,0
1714605704939,COGS 197,001,638244,Voytek; Bradley Thomas,9998,0,9999,1
1714605705967,CSE 191,A00,516875,Minnes Kemp; Mor Mia,9993,0,9999,6
1714605706996,CSE 197,001,637388,Minnes Kemp; Mor Mia,9998,0,9999,1
1714605708022,CSS 201S,A01,494383,Staff,35,0,35,0
1714605709052,CSS 202S,A01,494387,Staff,35,0,35,0
1714605710079,DSC 197,001,628532,Eldridge; Justin Matthew,9996,0,9999,3
1714605711104,EAP 100,A00,516065,Staff,9797,0,9999,202
1714605712129,ECE 45,A01,507414,Staff,33,0,60,27
1714605714177,ECE 111,A01,507420,Staff,15,0,50,35
1714605715202,ECE 197,001,548057,Sievenpiper; Daniel F.,9993,0,9999,6
1714605716232,EDS 115,A00,507243,Choi; Bailey Miyeon,10,0,28,18
1714605717258,EDS 117,A01,494379,Staff,1,5,30,29
1714605718282,EDS 125,A00,507246,Hopkins; Megan Beth,9,0,30,21
1714605719311,EDS 128A,A01,507264,Fargason; Sharon Gayle,8,0,26,18
1714605720337,EDS 128B,A01,507293,Pappas; Elizabeth,12,0,30,18
1714605721367,EDS 139,A00,507294,Fargason; Sharon Gayle,13,0,30,17
1714605721367,EDS 139,B00,507313,Pappas; Elizabeth,13,0,30,17
1714605722392,EDS 201,A00,507315,Staff,13,0,30,17
1714605723422,EDS 203,A01,507317,Halter; Christopher P.,12,0,30,18
1714605724452,EDS 204R,A01,507319,Halter; Christopher P.,0,3,30,30
1714605724452,EDS 204R,B01,507331,Heinzman; Erica M.,16,0,30,14
1714605725477,EDS 206R,A00,507332,Staff,0,4,30,30
1714605725477,EDS 206R,B00,507343,Staff,17,0,30,13
1714605726506,EDS 250,A00,507344,Hemans; Patricia Ann Benitez,22,0,40,18
1714605727531,EDS 281,A00,507345,Daly; Alan J.,18,0,18,0
1714605728556,EDS 284,A00,507350,Daly; Alan J.,16,0,16,0
1714605729581,EDS 286,A00,507359,Fine; Sarah,18,0,18,0
1714605730609,EDS 289C,A01,507361,Daly; Alan J.,18,0,18,0
1714605731641,EDS 290,A00,507366,Hofstetter; Carolyn,15,0,15,0
1714605732666,LIGM 5A,A00,507421,Fischer-Grunski; Eva K,18,0,20,2
1714605733693,LIGM 5B,A00,507423,Fischer-Grunski; Eva K,19,0,20,1
1714605734718,LIGM 5C,A00,507425,Fischer-Grunski; Eva K,19,0,20,1
1714605735773,LIIT 5AS,A00,507427,Carnelos; Chiara,20,0,20,0
1714605736797,LIIT 5BS,A00,507430,Carnelos; Chiara,20,0,20,0
1714605737823,LIIT 5CS,A00,507432,Carnelos; Chiara,20,0,20,0
1714605738847,LISP 5A,A00,507541,Munoz Sanchez; Alicia,11,0,20,9
1714605739874,LISP 5B,A00,507671,Munoz Sanchez; Alicia,8,0,20,12
1714605740901,LISP 5C,A00,507696,Munoz Sanchez; Alicia,9,0,20,11
1714605741927,MAE 197,001,528363,Boechler; Nicholas Sebastia,9998,0,9999,1
1714605742960,MATH 197,001,523477,Kedlaya; Kiran S.,9995,0,9999,4
1714605742960,MATH 197,002,563811,Zhang; Danna,9995,0,9999,4
1714605742960,MATH 197,003,628552,Dumitriu; Ioana,9998,0,9999,1
1714605743985,MCWP 40R,A00,518780,Staff,2,0,20,18
1714605743985,MCWP 40R,B00,518781,Staff,8,0,20,12
1714605743985,MCWP 40R,C00,518783,Staff,6,0,20,14
1714605745012,MCWP 50R,A00,518791,Staff,0,0,20,20
1714605745012,MCWP 50R,B00,518792,Staff,0,2,20,20
1714605745012,MCWP 50R,C00,518793,Staff,0,2,20,20
1714605745012,MCWP 50R,D00,518794,Staff,0,0,20,20
1714605745012,MCWP 50R,E00,518795,Staff,0,2,20,20
1714605745012,MCWP 50R,F00,518796,Staff,0,0,20,20
1714605745012,MCWP 50R,G00,518797,Staff,0,1,20,20
1714605746038,MMW 12R,A01,514034,Herbst; Matthew,0,0,16,16
1714605746038,MMW 12R,A02,514035,Herbst; Matthew,1,0,16,15
1714605747065,MMW 13R,A01,514037,Staff,0,4,16,16
1714605747065,MMW 13R,A02,514039,Staff,0,2,16,16
1714605747065,MMW 13R,A03,628519,Staff,0,2,16,16
1714605749116,SIO 295LS,A00,523233,Staff,10,0,30,20
1714605750143,SIO 295S,A00,523232,Staff,10,0,30,20
1714605751174,SIOC 290S,A01,637330,Merrifield; Mark A,23,0,30,7
1714605752199,SIOC 291S,A01,637333,Gabriel; Corey John,23,0,30,7
1714605753224,SOCI 117,A01,494376,Staff,0,4,5,5
1714605754249,WES 237B,A00,494380,Staff,9,0,20,11
1714605756322,AESE 279B,A00,494370,Wade; Jon P,0,0,33,33
1714605757349,AIP 197,001,627712,Vespa; Emanuel Ignacio,9998,0,9999,1
1714605758374,ANAR 135S,A00,494369,Braswell; Geoffrey E.,0,0,0,0
1714605759401,BENG 196,001,628496,Engler; Adam J.,9998,0,9999,1
1714605760428,CAT 124RS,A01,519847,Geibel; William,0,0,20,20
1714605761456,CAT 125RS,A01,515971,Geibel; William,0,0,20,20
1714605762485,CLRE 250,A00,511389,Morris; Sheldon,9993,0,9999,6
1714605763513,CLRE 251,A00,507176,Mehta; Ravindra L.,9993,0,9999,6
1714605763513,CLRE 251,B00,511410,Mehta; Ravindra L.,9998,0,9999,1
1714605764540,CLRE 252,A00,507189,Cuomo; Raphael Eduardo,9995,0,9999,4
1714605765565,CLRE 253,A00,507199,Vaida; Florin,9994,0,9999,5
1714605765565,CLRE 253,B00,507202,Vaida; Florin,9999,0,9999,0
1714605766588,CLRE 259,A00,507211,Patel; Hemal,9996,0,9999,3
1714605767613,CLRE 260,A00,507221,Cuomo; Raphael Eduardo,9999,0,9999,0
1714605768642,CLRE 297,001,507242,Cuomo; Raphael Eduardo,9999,0,9999,0
1714605769667,COGS 197,001,638244,Voytek; Bradley Thomas,9998,0,9999,1
1714605770692,CSE 191,A00,516875,Minnes Kemp; Mor Mia,9993,0,9999,6
1714605771719,CSE 197,001,637388,Minnes Kemp; Mor Mia,9998,0,9999,1
1714605772745,CSS 201S,A01,494383,Staff,35,0,35,0
1714605773770,CSS 202S,A01,494387,Staff,35,0,35,0
1714605774794,DSC 197,001,628532,Eldridge; Justin Matthew,9996,0,9999,3
1714605775820,EAP 100,A00,516065,Staff,9797,0,9999,202
1714605776844,ECE 45,A01,507414,Staff,33,0,60,27
1714605778897,ECE 111,A01,507420,Staff,15,0,50,35
1714605779926,ECE 197,001,548057,Sievenpiper; Daniel F.,9993,0,9999,6
1714605780957,EDS 115,A00,507243,Choi; Bailey Miyeon,10,0,28,18
1714605781983,EDS 117,A01,494379,Staff,1,5,30,29
1714605783009,EDS 125,A00,507246,Hopkins; Megan Beth,9,0,30,21
1714605784032,EDS 128A,A01,507264,Fargason; Sharon Gayle,8,0,26,18
1714605785059,EDS 128B,A01,507293,Pappas; Elizabeth,12,0,30,18
1714605786084,EDS 139,A00,507294,Fargason; Sharon Gayle,13,0,30,17
1714605786084,EDS 139,B00,507313,Pappas; Elizabeth,13,0,30,17
1714605787109,EDS 201,A00,507315,Staff,13,0,30,17
1714605788135,EDS 203,A01,507317,Halter; Christopher P.,12,0,30,18
1714605789160,EDS 204R,A01,507319,Halter; Christopher P.,0,3,30,30
1714605789160,EDS 204R,B01,507331,Heinzman; Erica M.,16,0,30,14
1714605790188,EDS 206R,A00,507332,Staff,0,4,30,30
1714605790188,EDS 206R,B00,507343,Staff,17,0,30,13
1714605791212,EDS 250,A00,507344,Hemans; Patricia Ann Benitez,22,0,40,18
1714605792237,EDS 281,A00,507345,Daly; Alan J.,18,0,18,0
1714605793260,EDS 284,A00,507350,Daly; Alan J.,16,0,16,0
1714605794290,EDS 286,A00,507359,Fine; Sarah,18,0,18,0
1714605795315,EDS 289C,A01,507361,Daly; Alan J.,18,0,18,0
1714605796340,EDS 290,A00,507366,Hofstetter; Carolyn,15,0,15,0
1714605797364,LIGM 5A,A00,507421,Fischer-Grunski; Eva K,18,0,20,2
1714605798394,LIGM 5B,A00,507423,Fischer-Grunski; Eva K,19,0,20,1
1714605799419,LIGM 5C,A00,507425,Fischer-Grunski; Eva K,19,0,20,1
1714605800449,LIIT 5AS,A00,507427,Carnelos; Chiara,20,0,20,0
1714605801473,LIIT 5BS,A00,507430,Carnelos; Chiara,20,0,20,0
1714605802497,LIIT 5CS,A00,507432,Carnelos; Chiara,20,0,20,0
1714605803522,LISP 5A,A00,507541,Munoz Sanchez; Alicia,11,0,20,9
1714605804550,LISP 5B,A00,507671,Munoz Sanchez; Alicia,8,0,20,12
1714605805577,LISP 5C,A00,507696,Munoz Sanchez; Alicia,9,0,20,11
1714605806602,MAE 197,001,528363,Boechler; Nicholas Sebastia,9998,0,9999,1
1714605807633,MATH 197,001,523477,Kedlaya; Kiran S.,9995,0,9999,4
1714605807633,MATH 197,002,563811,Zhang; Danna,9995,0,9999,4
1714605807633,MATH 197,003,628552,Dumitriu; Ioana,9998,0,9999,1
1714605808661,MCWP 40R,A00,518780,Staff,2,0,20,18
1714605808661,MCWP 40R,B00,518781,Staff,8,0,20,12
1714605808661,MCWP 40R,C00,518783,Staff,6,0,20,14
1714605809686,MCWP 50R,A00,518791,Staff,0,0,20,20
1714605809686,MCWP 50R,B00,518792,Staff,0,2,20,20
1714605809686,MCWP 50R,C00,518793,Staff,0,2,20,20
1714605809686,MCWP 50R,D00,518794,Staff,0,0,20,20
1714605809686,MCWP 50R,E00,518795,Staff,0,2,20,20
1714605809686,MCWP 50R,F00,518796,Staff,0,0,20,20
1714605809686,MCWP 50R,G00,518797,Staff,0,1,20,20
1714605810709,MMW 12R,A01,514034,Herbst; Matthew,0,0,16,16
1714605810709,MMW 12R,A02,514035,Herbst; Matthew,1,0,16,15
1714605811734,MMW 13R,A01,514037,Staff,0,4,16,16
1714605811734,MMW 13R,A02,514039,Staff,0,2,16,16
1714605811734,MMW 13R,A03,628519,Staff,0,2,16,16
1714605813787,SIO 295LS,A00,523233,Staff,10,0,30,20
1714605814816,SIO 295S,A00,523232,Staff,10,0,30,20
1714605815842,SIOC 290S,A01,637330,Merrifield; Mark A,23,0,30,7
1714605816870,SIOC 291S,A01,637333,Gabriel; Corey John,23,0,30,7
1714605817896,SOCI 117,A01,494376,Staff,0,4,5,5
1714605818926,WES 237B,A00,494380,Staff,9,0,20,11
1714605821007,AESE 279B,A00,494370,Wade; Jon P,0,0,33,33
1714605822032,AIP 197,001,627712,Vespa; Emanuel Ignacio,9998,0,9999,1
1714605823056,ANAR 135S,A00,494369,Braswell; Geoffrey E.,0,0,0,0
1714605824083,BENG 196,001,628496,Engler; Adam J.,9998,0,9999,1
1714605825109,CAT 124RS,A01,519847,Geibel; William,0,0,20,20
1714605826133,CAT 125RS,A01,515971,Geibel; William,0,0,20,20
1714605827163,CLRE 250,A00,511389,Morris; Sheldon,9993,0,9999,6
1714605828190,CLRE 251,A00,507176,Mehta; Ravindra L.,9993,0,9999,6
1714605828190,CLRE 251,B00,511410,Mehta; Ravindra L.,9998,0,9999,1
1714605829217,CLRE 252,A00,507189,Cuomo; Raphael Eduardo,9995,0,9999,4
1714605830242,CLRE 253,A00,507199,Vaida; Florin,9994,0,9999,5
1714605830242,CLRE 253,B00,507202,Vaida; Florin,9999,0,9999,0
1714605831271,CLRE 259,A00,507211,Patel; Hemal,9996,0,9999,3
1714605832295,CLRE 260,A00,507221,Cuomo; Raphael Eduardo,9999,0,9999,0
1714605833320,CLRE 297,001,507242,Cuomo; Raphael Eduardo,9999,0,9999,0
1714605834346,COGS 197,001,638244,Voytek; Bradley Thomas,9998,0,9999,1
1714605835371,CSE 191,A00,516875,Minnes Kemp; Mor Mia,9993,0,9999,6
1714605836398,CSE 197,001,637388,Minnes Kemp; Mor Mia,9998,0,9999,1
1714605837429,CSS 201S,A01,494383,Staff,35,0,35,0
1714605838457,CSS 202S,A01,494387,Staff,35,0,35,0
1714605839480,DSC 197,001,628532,Eldridge; Justin Matthew,9996,0,9999,3
1714605840508,EAP 100,A00,516065,Staff,9797,0,9999,202
1714605841536,ECE 45,A01,507414,Staff,33,0,60,27
1714605843591,ECE 111,A01,507420,Staff,15,0,50,35
1714605844618,ECE 197,001,548057,Sievenpiper; Daniel F.,9993,0,9999,6
1714605845645,EDS 115,A00,507243,Choi; Bailey Miyeon,10,0,28,18
1714605846672,EDS 117,A01,494379,Staff,1,5,30,29
1714605847702,EDS 125,A00,507246,Hopkins; Megan Beth,9,0,30,21
1714605848734,EDS 128A,A01,507264,Fargason; Sharon Gayle,8,0,26,18
1714605849765,EDS 128B,A01,507293,Pappas; Elizabeth,12,0,30,18
1714605850789,EDS 139,A00,507294,Fargason; Sharon Gayle,13,0,30,17
1714605850789,EDS 139,B00,507313,Pappas; Elizabeth,13,0,30,17
1714605851815,EDS 201,A00,507315,Staff,13,0,30,17
1714605852844,EDS 203,A01,507317,Halter; Christopher P.,12,0,30,18
1714605853873,EDS 204R,A01,507319,Halter; Christopher P.,0,3,30,30
1714605853873,EDS 204R,B01,507331,Heinzman; Erica M.,16,0,30,14
1714605854904,EDS 206R,A00,507332,Staff,0,4,30,30
1714605854904,EDS 206R,B00,507343,Staff,17,0,30,13
1714605855928,EDS 250,A00,507344,Hemans; Patricia Ann Benitez,22,0,40,18
1714605856953,EDS 281,A00,507345,Daly; Alan J.,18,0,18,0
1714605857976,EDS 284,A00,507350,Daly; Alan J.,16,0,16,0
1714605859001,EDS 286,A00,507359,Fine; Sarah,18,0,18,0
1714605860029,EDS 289C,A01,507361,Daly; Alan J.,18,0,18,0
1714605861052,EDS 290,A00,507366,Hofstetter; Carolyn,15,0,15,0
1714605862082,LIGM 5A,A00,507421,Fischer-Grunski; Eva K,18,0,20,2
1714605863106,LIGM 5B,A00,507423,Fischer-Grunski; Eva K,19,0,20,1
1714605864131,LIGM 5C,A00,507425,Fischer-Grunski; Eva K,19,0,20,1
1714605865161,LIIT 5AS,A00,507427,Carnelos; Chiara,20,0,20,0
1714605866189,LIIT 5BS,A00,507430,Carnelos; Chiara,20,0,20,0
1714605867218,LIIT 5CS,A00,507432,Carnelos; Chiara,20,0,20,0
1714605868244,LISP 5A,A00,507541,Munoz Sanchez; Alicia,11,0,20,9
1714605869270,LISP 5B,A00,507671,Munoz Sanchez; Alicia,8,0,20,12
1714605870296,LISP 5C,A00,507696,Munoz Sanchez; Alicia,9,0,20,11
1714605871323,MAE 197,001,528363,Boechler; Nicholas Sebastia,9998,0,9999,1
1714605872349,MATH 197,001,523477,Kedlaya; Kiran S.,9995,0,9999,4
1714605872349,MATH 197,002,563811,Zhang; Danna,9995,0,9999,4
1714605872349,MATH 197,003,628552,Dumitriu; Ioana,9998,0,9999,1
1714605873376,MCWP 40R,A00,518780,Staff,2,0,20,18
1714605873376,MCWP 40R,B00,518781,Staff,8,0,20,12
1714605873376,MCWP 40R,C00,518783,Staff,6,0,20,14
1714605874404,MCWP 50R,A00,518791,Staff,0,0,20,20
1714605874404,MCWP 50R,B00,518792,Staff,0,2,20,20
1714605874404,MCWP 50R,C00,518793,Staff,0,2,20,20
1714605874404,MCWP 50R,D00,518794,Staff,0,0,20,20
1714605874404,MCWP 50R,E00,518795,Staff,0,2,20,20
1714605874404,MCWP 50R,F00,518796,Staff,0,0,20,20
1714605874404,MCWP 50R,G00,518797,Staff,0,1,20,20
1714605875429,MMW 12R,A01,514034,Herbst; Matthew,0,0,16,16
1714605875429,MMW 12R,A02,514035,Herbst; Matthew,1,0,16,15
1714605876453,MMW 13R,A01,514037,Staff,0,4,16,16
1714605876453,MMW 13R,A02,514039,Staff,0,2,16,16
1714605876453,MMW 13R,A03,628519,Staff,0,2,16,16
1714605878507,SIO 295LS,A00,523233,Staff,10,0,30,20
1714605879531,SIO 295S,A00,523232,Staff,10,0,30,20
1714605880556,SIOC 290S,A01,637330,Merrifield; Mark A,23,0,30,7
1714605881581,SIOC 291S,A01,637333,Gabriel; Corey John,23,0,30,7
1714605882608,SOCI 117,A01,494376,Staff,0,4,5,5
1714605883637,WES 237B,A00,494380,Staff,9,0,20,11
1714605885699,AESE 279B,A00,494370,Wade; Jon P,0,0,33,33
1714605886724,AIP 197,001,627712,Vespa; Emanuel Ignacio,9998,0,9999,1
1714605887749,ANAR 135S,A00,494369,Braswell; Geoffrey E.,0,0,0,0
1714605888775,BENG 196,001,628496,Engler; Adam J.,9998,0,9999,1
1714605889801,CAT 124RS,A01,519847,Geibel; William,0,0,20,20
1714605890826,CAT 125RS,A01,515971,Geibel; William,0,0,20,20
1714605891852,CLRE 250,A00,511389,Morris; Sheldon,9993,0,9999,6
1714605892884,CLRE 251,A00,507176,Mehta; Ravindra L.,9993,0,9999,6
1714605892884,CLRE 251,B00,511410,Mehta; Ravindra L.,9998,0,9999,1
1714605893912,CLRE 252,A00,507189,Cuomo; Raphael Eduardo,9995,0,9999,4
1714605894936,CLRE 253,A00,507199,Vaida; Florin,9994,0,9999,5
1714605894936,CLRE 253,B00,507202,Vaida; Florin,9999,0,9999,0
1714605895962,CLRE 259,A00,507211,Patel; Hemal,9996,0,9999,3
1714605896986,CLRE 260,A00,507221,Cuomo; Raphael Eduardo,9999,0,9999,0
1714605898010,CLRE 297,001,507242,Cuomo; Raphael Eduardo,9999,0,9999,0
1714605899038,COGS 197,001,638244,Voytek; Bradley Thomas,9998,0,9999,1
1714605900064,CSE 191,A00,516875,Minnes Kemp; Mor Mia,9993,0,9999,6
1714605901095,CSE 197,001,637388,Minnes Kemp; Mor Mia,9998,0,9999,1
1714605902134,CSS 201S,A01,494383,Staff,35,0,35,0
1714605903171,CSS 202S,A01,494387,Staff,35,0,35,0
1714605904196,DSC 197,001,628532,Eldridge; Justin Matthew,9996,0,9999,3
1714605905220,EAP 100,A00,516065,Staff,9797,0,9999,202
1714605906247,ECE 45,A01,507414,Staff,33,0,60,27
1714605908305,ECE 111,A01,507420,Staff,15,0,50,35
1714605909333,ECE 197,001,548057,Sievenpiper; Daniel F.,9993,0,9999,6
1714605910364,EDS 115,A00,507243,Choi; Bailey Miyeon,10,0,28,18
1714605911517,EDS 117,A01,494379,Staff,1,5,30,29
1714605912543,EDS 125,A00,507246,Hopkins; Megan Beth,9,0,30,21
1714605913572,EDS 128A,A01,507264,Fargason; Sharon Gayle,8,0,26,18
1714605914601,EDS 128B,A01,507293,Pappas; Elizabeth,12,0,30,18
1714605915624,EDS 139,A00,507294,Fargason; Sharon Gayle,13,0,30,17
1714605915624,EDS 139,B00,507313,Pappas; Elizabeth,13,0,30,17
1714605916649,EDS 201,A00,507315,Staff,13,0,30,17
1714605917678,EDS 203,A01,507317,Halter; Christopher P.,12,0,30,18
1714605918703,EDS 204R,A01,507319,Halter; Christopher P.,0,3,30,30
1714605918703,EDS 204R,B01,507331,Heinzman; Erica M.,16,0,30,14
1714605919732,EDS 206R,A00,507332,Staff,0,4,30,30
1714605919732,EDS 206R,B00,507343,Staff,17,0,30,13
1714605920756,EDS 250,A00,507344,Hemans; Patricia Ann Benitez,22,0,40,18
1714605921781,EDS 281,A00,507345,Daly; Alan J.,18,0,18,0
1714605922805,EDS 284,A00,507350,Daly; Alan J.,16,0,16,0
1714605923829,EDS 286,A00,507359,Fine; Sarah,18,0,18,0
1714605924854,EDS 289C,A01,507361,Daly; Alan J.,18,0,18,0
1714605925878,EDS 290,A00,507366,Hofstetter; Carolyn,15,0,15,0
1714605926904,LIGM 5A,A00,507421,Fischer-Grunski; Eva K,18,0,20,2
1714605927929,LIGM 5B,A00,507423,Fischer-Grunski; Eva K,19,0,20,1
1714605928958,LIGM 5C,A00,507425,Fischer-Grunski; Eva K,19,0,20,1
1714605929984,LIIT 5AS,A00,507427,Carnelos; Chiara,20,0,20,0
1714605931007,LIIT 5BS,A00,507430,Carnelos; Chiara,20,0,20,0
1714605932036,LIIT 5CS,A00,507432,Carnelos; Chiara,20,0,20,0
1714605933062,LISP 5A,A00,507541,Munoz Sanchez; Alicia,11,0,20,9
1714605934140,LISP 5B,A00,507671,Munoz Sanchez; Alicia,8,0,20,12
1714605935169,LISP 5C,A00,507696,Munoz Sanchez; Alicia,9,0,20,11
1714605936195,MAE 197,001,528363,Boechler; Nicholas Sebastia,9998,0,9999,1
1714605937221,MATH 197,001,523477,Kedlaya; Kiran S.,9995,0,9999,4
1714605937221,MATH 197,002,563811,Zhang; Danna,9995,0,9999,4
1714605937221,MATH 197,003,628552,Dumitriu; Ioana,9998,0,9999,1
1714605938247,MCWP 40R,A00,518780,Staff,2,0,20,18
1714605938247,MCWP 40R,B00,518781,Staff,8,0,20,12
1714605938247,MCWP 40R,C00,518783,Staff,6,0,20,14
1714605939273,MCWP 50R,A00,518791,Staff,0,0,20,20
1714605939273,MCWP 50R,B00,518792,Staff,0,2,20,20
1714605939273,MCWP 50R,C00,518793,Staff,0,2,20,20
1714605939273,MCWP 50R,D00,518794,Staff,0,0,20,20
1714605939273,MCWP 50R,E00,518795,Staff,0,2,20,20
1714605939273,MCWP 50R,F00,518796,Staff,0,0,20,20
1714605939273,MCWP 50R,G00,518797,Staff,0,1,20,20
1714605940302,MMW 12R,A01,514034,Herbst; Matthew,0,0,16,16
1714605940302,MMW 12R,A02,514035,Herbst; Matthew,1,0,16,15
1714605941329,MMW 13R,A01,514037,Staff,0,4,16,16
1714605941329,MMW 13R,A02,514039,Staff,0,2,16,16
1714605941329,MMW 13R,A03,628519,Staff,0,2,16,16
1714605943383,SIO 295LS,A00,523233,Staff,10,0,30,20
1714605944411,SIO 295S,A00,523232,Staff,10,0,30,20
1714605945443,SIOC 290S,A01,637330,Merrifield; Mark A,23,0,30,7
1714605946469,SIOC 291S,A01,637333,Gabriel; Corey John,23,0,30,7
1714605947496,SOCI 117,A01,494376,Staff,0,4,5,5
1714605948523,WES 237B,A00,494380,Staff,9,0,20,11
1714605950604,AESE 279B,A00,494370,Wade; Jon P,0,0,33,33
1714605951630,AIP 197,001,627712,Vespa; Emanuel Ignacio,9998,0,9999,1
1714605952657,ANAR 135S,A00,494369,Braswell; Geoffrey E.,0,0,0,0
1714605953683,BENG 196,001,628496,Engler; Adam J.,9998,0,9999,1
1714605954708,CAT 124RS,A01,519847,Geibel; William,0,0,20,20
1714605955738,CAT 125RS,A01,515971,Geibel; William,0,0,20,20
1714605956766,CLRE 250,A00,511389,Morris; Sheldon,9993,0,9999,6
1714605957798,CLRE 251,A00,507176,Mehta; Ravindra L.,9993,0,9999,6
1714605957798,CLRE 251,B00,511410,Mehta; Ravindra L.,9998,0,9999,1
1714605958829,CLRE 252,A00,507189,Cuomo; Raphael Eduardo,9995,0,9999,4
1714605959855,CLRE 253,A00,507199,Vaida; Florin,9994,0,9999,5
1714605959855,CLRE 253,B00,507202,Vaida; Florin,9999,0,9999,0
1714605960880,CLRE 259,A00,507211,Patel; Hemal,9996,0,9999,3
1714605961907,CLRE 260,A00,507221,Cuomo; Raphael Eduardo,9999,0,9999,0
1714605962934,CLRE 297,001,507242,Cuomo; Raphael Eduardo,9999,0,9999,0
1714605963961,COGS 197,001,638244,Voytek; Bradley Thomas,9998,0,9999,1
1714605964986,CSE 191,A00,516875,Minnes Kemp; Mor Mia,9993,0,9999,6
1714605966010,CSE 197,001,637388,Minnes Kemp; Mor Mia,9998,0,9999,1
1714605967043,CSS 201S,A01,494383,Staff,35,0,35,0
1714605968070,CSS 202S,A01,494387,Staff,35,0,35,0
1714605969095,DSC 197,001,628532,Eldridge; Justin Matthew,9996,0,9999,3
1714605970120,EAP 100,A00,516065,Staff,9797,0,9999,202
1714605971151,ECE 45,A01,507414,Staff,33,0,60,27
1714605973204,ECE 111,A01,507420,Staff,15,0,50,35
1714605974233,ECE 197,001,548057,Sievenpiper; Daniel F.,9993,0,9999,6
1714605975264,EDS 115,A00,507243,Choi; Bailey Miyeon,10,0,28,18
1714605976290,EDS 117,A01,494379,Staff,1,5,30,29
1714605977315,EDS 125,A00,507246,Hopkins; Megan Beth,9,0,30,21
1714605978343,EDS 128A,A01,507264,Fargason; Sharon Gayle,8,0,26,18
1714605979376,EDS 128B,A01,507293,Pappas; Elizabeth,12,0,30,18
1714605980401,EDS 139,A00,507294,Fargason; Sharon Gayle,13,0,30,17
1714605980401,EDS 139,B00,507313,Pappas; Elizabeth,13,0,30,17
1714605981432,EDS 201,A00,507315,Staff,13,0,30,17
1714605982465,EDS 203,A01,507317,Halter; Christopher P.,12,0,30,18
1714605983498,EDS 204R,A01,507319,Halter; Christopher P.,0,3,30,30
1714605983498,EDS 204R,B01,507331,Heinzman; Erica M.,16,0,30,14
1714605984524,EDS 206R,A00,507332,Staff,0,4,30,30
1714605984524,EDS 206R,B00,507343,Staff,17,0,30,13
1714605985548,EDS 250,A00,507344,Hemans; Patricia Ann Benitez,22,0,40,18
1714605986576,EDS 281,A00,507345,Daly; Alan J.,18,0,18,0
1714605987600,EDS 284,A00,507350,Daly; Alan J.,16,0,16,0
1714605988627,EDS 286,A00,507359,Fine; Sarah,18,0,18,0
1714605989655,EDS 289C,A01,507361,Daly; Alan J.,18,0,18,0
1714605990682,EDS 290,A00,507366,Hofstetter; Carolyn,15,0,15,0
1714605991709,LIGM 5A,A00,507421,Fischer-Grunski; Eva K,18,0,20,2
1714605992737,LIGM 5B,A00,507423,Fischer-Grunski; Eva K,19,0,20,1
1714605993762,LIGM 5C,A00,507425,Fischer-Grunski; Eva K,19,0,20,1
1714605994787,LIIT 5AS,A00,507427,Carnelos; Chiara,20,0,20,0
1714605995812,LIIT 5BS,A00,507430,Carnelos; Chiara,20,0,20,0
1714605996842,LIIT 5CS,A00,507432,Carnelos; Chiara,20,0,20,0
1714605997871,LISP 5A,A00,507541,Munoz Sanchez; Alicia,11,0,20,9
1714605998897,LISP 5B,A00,507671,Munoz Sanchez; Alicia,8,0,20,12
1714605999922,LISP 5C,A00,507696,Munoz Sanchez; Alicia,9,0,20,11
1714606000947,MAE 197,001,528363,Boechler; Nicholas Sebastia,9998,0,9999,1
1714606001979,MATH 197,001,523477,Kedlaya; Kiran S.,9995,0,9999,4
1714606001979,MATH 197,002,563811,Zhang; Danna,9995,0,9999,4
1714606001979,MATH 197,003,628552,Dumitriu; Ioana,9998,0,9999,1
1714606003007,MCWP 40R,A00,518780,Staff,2,0,20,18
1714606003007,MCWP 40R,B00,518781,Staff,8,0,20,12
1714606003007,MCWP 40R,C00,518783,Staff,6,0,20,14
1714606004037,MCWP 50R,A00,518791,Staff,0,0,20,20
1714606004037,MCWP 50R,B00,518792,Staff,0,2,20,20
1714606004037,MCWP 50R,C00,518793,Staff,0,2,20,20
1714606004037,MCWP 50R,D00,518794,Staff,0,0,20,20
1714606004037,MCWP 50R,E00,518795,Staff,0,2,20,20
1714606004037,MCWP 50R,F00,518796,Staff,0,0,20,20
1714606004037,MCWP 50R,G00,518797,Staff,0,1,20,20
1714606005063,MMW 12R,A01,514034,Herbst; Matthew,0,0,16,16
1714606005063,MMW 12R,A02,514035,Herbst; Matthew,1,0,16,15
1714606006091,MMW 13R,A01,514037,Staff,0,4,16,16
1714606006091,MMW 13R,A02,514039,Staff,0,2,16,16
1714606006091,MMW 13R,A03,628519,Staff,0,2,16,16
1714606008143,SIO 295LS,A00,523233,Staff,10,0,30,20
1714606009168,SIO 295S,A00,523232,Staff,10,0,30,20
1714606010202,SIOC 290S,A01,637330,Merrifield; Mark A,23,0,30,7
1714606011228,SIOC 291S,A01,637333,Gabriel; Corey John,23,0,30,7
1714606012253,SOCI 117,A01,494376,Staff,0,4,5,5
1714606013279,WES 237B,A00,494380,Staff,9,0,20,11
1714606015356,AESE 279B,A00,494370,Wade; Jon P,0,0,33,33
1714606016384,AIP 197,001,627712,Vespa; Emanuel Ignacio,9998,0,9999,1
1714606017409,ANAR 135S,A00,494369,Braswell; Geoffrey E.,0,0,0,0
1714606018435,BENG 196,001,628496,Engler; Adam J.,9998,0,9999,1
1714606019465,CAT 124RS,A01,519847,Geibel; William,0,0,20,20
1714606020493,CAT 125RS,A01,515971,Geibel; William,0,0,20,20
1714606021523,CLRE 250,A00,511389,Morris; Sheldon,9993,0,9999,6
1714606022548,CLRE 251,A00,507176,Mehta; Ravindra L.,9993,0,9999,6
1714606022548,CLRE 251,B00,511410,Mehta; Ravindra L.,9998,0,9999,1
1714606023573,CLRE 252,A00,507189,Cuomo; Raphael Eduardo,9995,0,9999,4
1714606024598,CLRE 253,A00,507199,Vaida; Florin,9994,0,9999,5
1714606024598,CLRE 253,B00,507202,Vaida; Florin,9999,0,9999,0
1714606025623,CLRE 259,A00,507211,Patel; Hemal,9996,0,9999,3
1714606026648,CLRE 260,A00,507221,Cuomo; Raphael Eduardo,9999,0,9999,0
1714606027676,CLRE 297,001,507242,Cuomo; Raphael Eduardo,9999,0,9999,0
1714606028702,COGS 197,001,638244,Voytek; Bradley Thomas,9998,0,9999,1
1714606029732,CSE 191,A00,516875,Minnes Kemp; Mor Mia,9993,0,9999,6
1714606030756,CSE 197,001,637388,Minnes Kemp; Mor Mia,9998,0,9999,1
1714606031784,CSS 201S,A01,494383,Staff,35,0,35,0
1714606032812,CSS 202S,A01,494387,Staff,35,0,35,0
1714606033837,DSC 197,001,628532,Eldridge; Justin Matthew,9996,0,9999,3
1714606034863,EAP 100,A00,516065,Staff,9797,0,9999,202
1714606035891,ECE 45,A01,507414,Staff,33,0,60,27
1714606037943,ECE 111,A01,507420,Staff,15,0,50,35
1714606038970,ECE 197,001,548057,Sievenpiper; Daniel F.,9993,0,9999,6
1714606040000,EDS 115,A00,507243,Choi; Bailey Miyeon,10,0,28,18
1714606041026,EDS 117,A01,494379,Staff,1,5,30,29
1714606042054,EDS 125,A00,507246,Hopkins; Megan Beth,9,0,30,21
1714606043082,EDS 128A,A01,507264,Fargason; Sharon Gayle,8,0,26,18
1714606044107,EDS 128B,A01,507293,Pappas; Elizabeth,12,0,30,18
1714606045134,EDS 139,A00,507294,Fargason; Sharon Gayle,13,0,30,17
1714606045134,EDS 139,B00,507313,Pappas; Elizabeth,13,0,30,17
1714606046164,EDS 201,A00,507315,Staff,13,0,30,17
1714606047191,EDS 203,A01,507317,Halter; Christopher P.,12,0,30,18
1714606048215,EDS 204R,A01,507319,Halter; Christopher P.,0,3,30,30
1714606048215,EDS 204R,B01,507331,Heinzman; Erica M.,16,0,30,14
1714606049244,EDS 206R,A00,507332,Staff,0,4,30,30
1714606049244,EDS 206R,B00,507343,Staff,17,0,30,13
1714606050270,EDS 250,A00,507344,Hemans; Patricia Ann Benitez,22,0,40,18
1714606051297,EDS 281,A00,507345,Daly; Alan J.,18,0,18,0
1714606052322,EDS 284,A00,507350,Daly; Alan J.,16,0,16,0
1714606053348,EDS 286,A00,507359,Fine; Sarah,18,0,18,0
1714606054374,EDS 289C,A01,507361,Daly; Alan J.,18,0,18,0
1714606055399,EDS 290,A00,507366,Hofstetter; Carolyn,15,0,15,0
1714606056428,LIGM 5A,A00,507421,Fischer-Grunski; Eva K,18,0,20,2
1714606057455,LIGM 5B,A00,507423,Fischer-Grunski; Eva K,19,0,20,1
1714606058483,LIGM 5C,A00,507425,Fischer-Grunski; Eva K,19,0,20,1
1714606059511,LIIT 5AS,A00,507427,Carnelos; Chiara,20,0,20,0
1714606060535,LIIT 5BS,A00,507430,Carnelos; Chiara,20,0,20,0
1714606061561,LIIT 5CS,A00,507432,Carnelos; Chiara,20,0,20,0
1714606062593,LISP 5A,A00,507541,Munoz Sanchez; Alicia,11,0,20,9
1714606063617,LISP 5B,A00,507671,Munoz Sanchez; Alicia,8,0,20,12
1714606064644,LISP 5C,A00,507696,Munoz Sanchez; Alicia,9,0,20,11
1714606065671,MAE 197,001,528363,Boechler; Nicholas Sebastia,9998,0,9999,1
1714606066702,MATH 197,001,523477,Kedlaya; Kiran S.,9995,0,9999,4
1714606066702,MATH 197,002,563811,Zhang; Danna,9995,0,9999,4
1714606066702,MATH 197,003,628552,Dumitriu; Ioana,9998,0,9999,1
1714606067731,MCWP 40R,A00,518780,Staff,2,0,20,18
1714606067731,MCWP 40R,B00,518781,Staff,8,0,20,12
1714606067731,MCWP 40R,C00,518783,Staff,6,0,20,14
1714606068756,MCWP 50R,A00,518791,Staff,0,0,20,20
1714606068756,MCWP 50R,B00,518792,Staff,0,2,20,20
1714606068756,MCWP 50R,C00,518793,Staff,0,2,20,20
1714606068756,MCWP 50R,D00,518794,Staff,0,0,20,20
1714606068756,MCWP 50R,E00,518795,Staff,0,2,20,20
1714606068756,MCWP 50R,F00,518796,Staff,0,0,20,20
1714606068756,MCWP 50R,G00,518797,Staff,0,1,20,20
1714606069786,MMW 12R,A01,514034,Herbst; Matthew,0,0,16,16
1714606069786,MMW 12R,A02,514035,Herbst; Matthew,1,0,16,15
1714606070814,MMW 13R,A01,514037,Staff,0,4,16,16
1714606070814,MMW 13R,A02,514039,Staff,0,2,16,16
1714606070814,MMW 13R,A03,628519,Staff,0,2,16,16
1714606072869,SIO 295LS,A00,523233,Staff,10,0,30,20
1714606073898,SIO 295S,A00,523232,Staff,10,0,30,20
1714606074924,SIOC 290S,A01,637330,Merrifield; Mark A,23,0,30,7
1714606075954,SIOC 291S,A01,637333,Gabriel; Corey John,23,0,30,7
1714606076978,SOCI 117,A01,494376,Staff,0,4,5,5
1714606078004,WES 237B,A00,494380,Staff,9,0,20,11
1714606080080,AESE 279B,A00,494370,Wade; Jon P,0,0,33,33
1714606081108,AIP 197,001,627712,Vespa; Emanuel Ignacio,9998,0,9999,1
1714606082137,ANAR 135S,A00,494369,Braswell; Geoffrey E.,0,0,0,0
1714606083171,BENG 196,001,628496,Engler; Adam J.,9998,0,9999,1
1714606084199,CAT 124RS,A01,519847,Geibel; William,0,0,20,20
1714606085222,CAT 125RS,A01,515971,Geibel; William,0,0,20,20
1714606086247,CLRE 250,A00,511389,Morris; Sheldon,9993,0,9999,6
1714606087280,CLRE 251,A00,507176,Mehta; Ravindra L.,9993,0,9999,6
1714606087280,CLRE 251,B00,511410,Mehta; Ravindra L.,9998,0,9999,1
1714606088306,CLRE 252,A00,507189,Cuomo; Raphael Eduardo,9995,0,9999,4
1714606089331,CLRE 253,A00,507199,Vaida; Florin,9994,0,9999,5
1714606089331,CLRE 253,B00,507202,Vaida; Florin,9999,0,9999,0
1714606090358,CLRE 259,A00,507211,Patel; Hemal,9996,0,9999,3
1714606091386,CLRE 260,A00,507221,Cuomo; Raphael Eduardo,9999,0,9999,0
1714606092410,CLRE 297,001,507242,Cuomo; Raphael Eduardo,9999,0,9999,0
1714606093433,COGS 197,001,638244,Voytek; Bradley Thomas,9998,0,9999,1
1714606094462,CSE 191,A00,516875,Minnes Kemp; Mor Mia,9993,0,9999,6
1714606095488,CSE 197,001,637388,Minnes Kemp; Mor Mia,9998,0,9999,1
1714606096520,CSS 201S,A01,494383,Staff,35,0,35,0
1714606097546,CSS 202S,A01,494387,Staff,35,0,35,0
1714606098570,DSC 197,001,628532,Eldridge; Justin Matthew,9996,0,9999,3
1714606099604,EAP 100,A00,516065,Staff,9797,0,9999,202
1714606100636,ECE 45,A01,507414,Staff,33,0,60,27
1714606102684,ECE 111,A01,507420,Staff,15,0,50,35
1714606103712,ECE 197,001,548057,Sievenpiper; Daniel F.,9993,0,9999,6
1714606104742,EDS 115,A00,507243,Choi; Bailey Miyeon,10,0,28,18
1714606105767,EDS 117,A01,494379,Staff,1,5,30,29
1714606106795,EDS 125,A00,507246,Hopkins; Megan Beth,9,0,30,21
1714606107821,EDS 128A,A01,507264,Fargason; Sharon Gayle,8,0,26,18
1714606108847,EDS 128B,A01,507293,Pappas; Elizabeth,12,0,30,18
1714606109872,EDS 139,A00,507294,Fargason; Sharon Gayle,13,0,30,17
1714606109872,EDS 139,B00,507313,Pappas; Elizabeth,13,0,30,17
1714606110896,EDS 201,A00,507315,Staff,13,0,30,17
1714606111922,EDS 203,A01,507317,Halter; Christopher P.,12,0,30,18
1714606112948,EDS 204R,A01,507319,Halter; Christopher P.,0,3,30,30
1714606112948,EDS 204R,B01,507331,Heinzman; Erica M.,16,0,30,14
1714606113974,EDS 206R,A00,507332,Staff,0,4,30,30
1714606113974,EDS 206R,B00,507343,Staff,17,0,30,13
1714606114998,EDS 250,A00,507344,Hemans; Patricia Ann Benitez,22,0,40,18
1714606116022,EDS 281,A00,507345,Daly; Alan J.,18,0,18,0
1714606117048,EDS 284,A00,507350,Daly; Alan J.,16,0,16,0
1714606118073,EDS 286,A00,507359,Fine; Sarah,18,0,18,0
1714606119096,EDS 289C,A01,507361,Daly; Alan J.,18,0,18,0
1714606120124,EDS 290,A00,507366,Hofstetter; Carolyn,15,0,15,0
1714606121154,LIGM 5A,A00,507421,Fischer-Grunski; Eva K,18,0,20,2
1714606122178,LIGM 5B,A00,507423,Fischer-Grunski; Eva K,19,0,20,1
1714606123208,LIGM 5C,A00,507425,Fischer-Grunski; Eva K,19,0,20,1
1714606124234,LIIT 5AS,A00,507427,Carnelos; Chiara,20,0,20,0
1714606125259,LIIT 5BS,A00,507430,Carnelos; Chiara,20,0,20,0
1714606126287,LIIT 5CS,A00,507432,Carnelos; Chiara,20,0,20,0
1714606127312,LISP 5A,A00,507541,Munoz Sanchez; Alicia,11,0,20,9
1714606128338,LISP 5B,A00,507671,Munoz Sanchez; Alicia,8,0,20,12
1714606129364,LISP 5C,A00,507696,Munoz Sanchez; Alicia,9,0,20,11
1714606130394,MAE 197,001,528363,Boechler; Nicholas Sebastia,9998,0,9999,1
1714606131420,MATH 197,001,523477,Kedlaya; Kiran S.,9995,0,9999,4
1714606131420,MATH 197,002,563811,Zhang; Danna,9995,0,9999,4
1714606131420,MATH 197,003,628552,Dumitriu; Ioana,9998,0,9999,1
1714606132446,MCWP 40R,A00,518780,Staff,2,0,20,18
1714606132446,MCWP 40R,B00,518781,Staff,8,0,20,12
1714606132446,MCWP 40R,C00,518783,Staff,6,0,20,14
1714606133471,MCWP 50R,A00,518791,Staff,0,0,20,20
1714606133471,MCWP 50R,B00,518792,Staff,0,2,20,20
1714606133471,MCWP 50R,C00,518793,Staff,0,2,20,20
1714606133471,MCWP 50R,D00,518794,Staff,0,0,20,20
1714606133471,MCWP 50R,E00,518795,Staff,0,2,20,20
1714606133471,MCWP 50R,F00,518796,Staff,0,0,20,20
1714606133471,MCWP 50R,G00,518797,Staff,0,1,20,20
1714606134496,MMW 12R,A01,514034,Herbst; Matthew,0,0,16,16
1714606134496,MMW 12R,A02,514035,Herbst; Matthew,1,0,16,15
1714606135525,MMW 13R,A01,514037,Staff,0,4,16,16
1714606135525,MMW 13R,A02,514039,Staff,0,2,16,16
1714606135525,MMW 13R,A03,628519,Staff,0,2,16,16
1714606137576,SIO 295LS,A00,523233,Staff,10,0,30,20
1714606138599,SIO 295S,A00,523232,Staff,10,0,30,20
1714606139625,SIOC 290S,A01,637330,Merrifield; Mark A,23,0,30,7
1714606140653,SIOC 291S,A01,637333,Gabriel; Corey John,23,0,30,7
1714606141676,SOCI 117,A01,494376,Staff,0,4,5,5
1714606142703,WES 237B,A00,494380,Staff,9,0,20,11
1714606144771,AESE 279B,A00,494370,Wade; Jon P,0,0,33,33
1714606145796,AIP 197,001,627712,Vespa; Emanuel Ignacio,9998,0,9999,1
1714606146823,ANAR 135S,A00,494369,Braswell; Geoffrey E.,0,0,0,0
1714606147849,BENG 196,001,628496,Engler; Adam J.,9998,0,9999,1
1714606148876,CAT 124RS,A01,519847,Geibel; William,0,0,20,20
1714606149903,CAT 125RS,A01,515971,Geibel; William,0,0,20,20
1714606150939,CLRE 250,A00,511389,Morris; Sheldon,9993,0,9999,6
1714606151967,CLRE 251,A00,507176,Mehta; Ravindra L.,9993,0,9999,6
1714606151967,CLRE 251,B00,511410,Mehta; Ravindra L.,9998,0,9999,1
1714606152992,CLRE 252,A00,507189,Cuomo; Raphael Eduardo,9995,0,9999,4
1714606154021,CLRE 253,A00,507199,Vaida; Florin,9994,0,9999,5
1714606154021,CLRE 253,B00,507202,Vaida; Florin,9999,0,9999,0
1714606155046,CLRE 259,A00,507211,Patel; Hemal,9996,0,9999,3
1714606156071,CLRE 260,A00,507221,Cuomo; Raphael Eduardo,9999,0,9999,0
1714606157101,CLRE 297,001,507242,Cuomo; Raphael Eduardo,9999,0,9999,0
1714606158128,COGS 197,001,638244,Voytek; Bradley Thomas,9998,0,9999,1
1714606159154,CSE 191,A00,516875,Minnes Kemp; Mor Mia,9993,0,9999,6
1714606160182,CSE 197,001,637388,Minnes Kemp; Mor Mia,9998,0,9999,1
1714606161207,CSS 201S,A01,494383,Staff,35,0,35,0
1714606162237,CSS 202S,A01,494387,Staff,35,0,35,0
1714606163267,DSC 197,001,628532,Eldridge; Justin Matthew,9996,0,9999,3
1714606164291,EAP 100,A00,516065,Staff,9797,0,9999,202
1714606165321,ECE 45,A01,507414,Staff,33,0,60,27
1714606167372,ECE 111,A01,507420,Staff,15,0,50,35
1714606168397,ECE 197,001,548057,Sievenpiper; Daniel F.,9993,0,9999,6
1714606169424,EDS 115,A00,507243,Choi; Bailey Miyeon,10,0,28,18
1714606170450,EDS 117,A01,494379,Staff,1,5,30,29
1714606171478,EDS 125,A00,507246,Hopkins; Megan Beth,9,0,30,21
1714606172503,EDS 128A,A01,507264,Fargason; Sharon Gayle,8,0,26,18
1714606173529,EDS 128B,A01,507293,Pappas; Elizabeth,12,0,30,18
1714606174553,EDS 139,A00,507294,Fargason; Sharon Gayle,13,0,30,17
1714606174553,EDS 139,B00,507313,Pappas; Elizabeth,13,0,30,17
1714606175579,EDS 201,A00,507315,Staff,13,0,30,17
1714606176603,EDS 203,A01,507317,Halter; Christopher P.,12,0,30,18
1714606177628,EDS 204R,A01,507319,Halter; Christopher P.,0,3,30,30
1714606177628,EDS 204R,B01,507331,Heinzman; Erica M.,16,0,30,14
1714606178654,EDS 206R,A00,507332,Staff,0,4,30,30
1714606178654,EDS 206R,B00,507343,Staff,17,0,30,13
1714606179682,EDS 250,A00,507344,Hemans; Patricia Ann Benitez,22,0,40,18
1714606180707,EDS 281,A00,507345,Daly; Alan J.,18,0,18,0
1714606181731,EDS 284,A00,507350,Daly; Alan J.,16,0,16,0
1714606182755,EDS 286,A00,507359,Fine; Sarah,18,0,18,0
1714606183781,EDS 289C,A01,507361,Daly; Alan J.,18,0,18,0
1714606184808,EDS 290,A00,507366,Hofstetter; Carolyn,15,0,15,0
1714606185835,LIGM 5A,A00,507421,Fischer-Grunski; Eva K,18,0,20,2
1714606186863,LIGM 5B,A00,507423,Fischer-Grunski; Eva K,19,0,20,1
1714606187890,LIGM 5C,A00,507425,Fischer-Grunski; Eva K,19,0,20,1
1714606188918,LIIT 5AS,A00,507427,Carnelos; Chiara,20,0,20,0
1714606189948,LIIT 5BS,A00,507430,Carnelos; Chiara,20,0,20,0
1714606190973,LIIT 5CS,A00,507432,Carnelos; Chiara,20,0,20,0
1714606192000,LISP 5A,A00,507541,Munoz Sanchez; Alicia,11,0,20,9
1714606193024,LISP 5B,A00,507671,Munoz Sanchez; Alicia,8,0,20,12
1714606194049,LISP 5C,A00,507696,Munoz Sanchez; Alicia,9,0,20,11
1714606195079,MAE 197,001,528363,Boechler; Nicholas Sebastia,9998,0,9999,1
1714606196106,MATH 197,001,523477,Kedlaya; Kiran S.,9995,0,9999,4
1714606196106,MATH 197,002,563811,Zhang; Danna,9995,0,9999,4
1714606196106,MATH 197,003,628552,Dumitriu; Ioana,9998,0,9999,1
1714606197130,MCWP 40R,A00,518780,Staff,2,0,20,18
1714606197130,MCWP 40R,B00,518781,Staff,8,0,20,12
1714606197130,MCWP 40R,C00,518783,Staff,6,0,20,14
1714606198158,MCWP 50R,A00,518791,Staff,0,0,20,20
1714606198158,MCWP 50R,B00,518792,Staff,0,2,20,20
1714606198158,MCWP 50R,C00,518793,Staff,0,2,20,20
1714606198158,MCWP 50R,D00,518794,Staff,0,0,20,20
1714606198158,MCWP 50R,E00,518795,Staff,0,2,20,20
1714606198158,MCWP 50R,F00,518796,Staff,0,0,20,20
1714606198158,MCWP 50R,G00,518797,Staff,0,1,20,20
1714606199185,MMW 12R,A01,514034,Herbst; Matthew,0,0,16,16
1714606199185,MMW 12R,A02,514035,Herbst; Matthew,1,0,16,15
1714606200211,MMW 13R,A01,514037,Staff,0,4,16,16
1714606200211,MMW 13R,A02,514039,Staff,0,2,16,16
1714606200211,MMW 13R,A03,628519,Staff,0,2,16,16
1714606202269,SIO 295LS,A00,523233,Staff,10,0,30,20
1714606203294,SIO 295S,A00,523232,Staff,10,0,30,20
1714606204326,SIOC 290S,A01,637330,Merrifield; Mark A,23,0,30,7
1714606205351,SIOC 291S,A01,637333,Gabriel; Corey John,23,0,30,7
1714606206378,SOCI 117,A01,494376,Staff,0,4,5,5
1714606207401,WES 237B,A00,494380,Staff,9,0,20,11
1714606209485,AESE 279B,A00,494370,Wade; Jon P,0,0,33,33
1714606210509,AIP 197,001,627712,Vespa; Emanuel Ignacio,9998,0,9999,1
1714606211537,ANAR 135S,A00,494369,Braswell; Geoffrey E.,0,0,0,0
1714606212566,BENG 196,001,628496,Engler; Adam J.,9998,0,9999,1
1714606213596,CAT 124RS,A01,519847,Geibel; William,0,0,20,20
1714606214619,CAT 125RS,A01,515971,Geibel; William,0,0,20,20
1714606215648,CLRE 250,A00,511389,Morris; Sheldon,9993,0,9999,6
1714606216675,CLRE 251,A00,507176,Mehta; Ravindra L.,9993,0,9999,6
1714606216675,CLRE 251,B00,511410,Mehta; Ravindra L.,9998,0,9999,1
1714606217700,CLRE 252,A00,507189,Cuomo; Raphael Eduardo,9995,0,9999,4
1714606218733,CLRE 253,A00,507199,Vaida; Florin,9994,0,9999,5
1714606218733,CLRE 253,B00,507202,Vaida; Florin,9999,0,9999,0
1714606219759,CLRE 259,A00,507211,Patel; Hemal,9996,0,9999,3
1714606220784,CLRE 260,A00,507221,Cuomo; Raphael Eduardo,9999,0,9999,0
1714606221808,CLRE 297,001,507242,Cuomo; Raphael Eduardo,9999,0,9999,0
1714606222833,COGS 197,001,638244,Voytek; Bradley Thomas,9998,0,9999,1
1714606223858,CSE 191,A00,516875,Minnes Kemp; Mor Mia,9993,0,9999,6
1714606224885,CSE 197,001,637388,Minnes Kemp; Mor Mia,9998,0,9999,1
1714606225915,CSS 201S,A01,494383,Staff,35,0,35,0
1714606226945,CSS 202S,A01,494387,Staff,35,0,35,0
1714606227970,DSC 197,001,628532,Eldridge; Justin Matthew,9996,0,9999,3
1714606228996,EAP 100,A00,516065,Staff,9797,0,9999,202
1714606230027,ECE 45,A01,507414,Staff,33,0,60,27
1714606232084,ECE 111,A01,507420,Staff,15,0,50,35
1714606233111,ECE 197,001,548057,Sievenpiper; Daniel F.,9993,0,9999,6
1714606234136,EDS 115,A00,507243,Choi; Bailey Miyeon,10,0,28,18
1714606235162,EDS 117,A01,494379,Staff,1,5,30,29
1714606236193,EDS 125,A00,507246,Hopkins; Megan Beth,9,0,30,21
1714606237219,EDS 128A,A01,507264,Fargason; Sharon Gayle,8,0,26,18
1714606238246,EDS 128B,A01,507293,Pappas; Elizabeth,12,0,30,18
1714606239271,EDS 139,A00,507294,Fargason; Sharon Gayle,13,0,30,17
1714606239271,EDS 139,B00,507313,Pappas; Elizabeth,13,0,30,17
1714606240299,EDS 201,A00,507315,Staff,13,0,30,17
1714606241327,EDS 203,A01,507317,Halter; Christopher P.,12,0,30,18
1714606242353,EDS 204R,A01,507319,Halter; Christopher P.,0,3,30,30
1714606242353,EDS 204R,B01,507331,Heinzman; Erica M.,16,0,30,14
1714606243377,EDS 206R,A00,507332,Staff,0,4,30,30
1714606243377,EDS 206R,B00,507343,Staff,17,0,30,13
1714606244404,EDS 250,A00,507344,Hemans; Patricia Ann Benitez,22,0,40,18
1714606245430,EDS 281,A00,507345,Daly; Alan J.,18,0,18,0
1714606246456,EDS 284,A00,507350,Daly; Alan J.,16,0,16,0
1714606247480,EDS 286,A00,507359,Fine; Sarah,18,0,18,0
1714606248505,EDS 289C,A01,507361,Daly; Alan J.,18,0,18,0
1714606249532,EDS 290,A00,507366,Hofstetter; Carolyn,15,0,15,0
1714606250562,LIGM 5A,A00,507421,Fischer-Grunski; Eva K,18,0,20,2
1714606251587,LIGM 5B,A00,507423,Fischer-Grunski; Eva K,19,0,20,1
1714606252615,LIGM 5C,A00,507425,Fischer-Grunski; Eva K,19,0,20,1
1714606253645,LIIT 5AS,A00,507427,Carnelos; Chiara,20,0,20,0
1714606254677,LIIT 5BS,A00,507430,Carnelos; Chiara,20,0,20,0
1714606255700,LIIT 5CS,A00,507432,Carnelos; Chiara,20,0,20,0
1714606256728,LISP 5A,A00,507541,Munoz Sanchez; Alicia,11,0,20,9
1714606257753,LISP 5B,A00,507671,Munoz Sanchez; Alicia,8,0,20,12
1714606258777,LISP 5C,A00,507696,Munoz Sanchez; Alicia,9,0,20,11
1714606259807,MAE 197,001,528363,Boechler; Nicholas Sebastia,9998,0,9999,1
1714606260834,MATH 197,001,523477,Kedlaya; Kiran S.,9995,0,9999,4
1714606260834,MATH 197,002,563811,Zhang; Danna,9995,0,9999,4
1714606260834,MATH 197,003,628552,Dumitriu; Ioana,9998,0,9999,1
1714606261862,MCWP 40R,A00,518780,Staff,2,0,20,18
1714606261862,MCWP 40R,B00,518781,Staff,8,0,20,12
1714606261862,MCWP 40R,C00,518783,Staff,6,0,20,14
1714606262888,MCWP 50R,A00,518791,Staff,0,0,20,20
1714606262888,MCWP 50R,B00,518792,Staff,0,2,20,20
1714606262888,MCWP 50R,C00,518793,Staff,0,2,20,20
1714606262888,MCWP 50R,D00,518794,Staff,0,0,20,20
1714606262888,MCWP 50R,E00,518795,Staff,0,2,20,20
1714606262888,MCWP 50R,F00,518796,Staff,0,0,20,20
1714606262888,MCWP 50R,G00,518797,Staff,0,1,20,20
1714606263912,MMW 12R,A01,514034,Herbst; Matthew,0,0,16,16
1714606263912,MMW 12R,A02,514035,Herbst; Matthew,1,0,16,15
1714606264936,MMW 13R,A01,514037,Staff,0,4,16,16
1714606264936,MMW 13R,A02,514039,Staff,0,2,16,16
1714606264936,MMW 13R,A03,628519,Staff,0,2,16,16
1714606266995,SIO 295LS,A00,523233,Staff,10,0,30,20
1714606268022,SIO 295S,A00,523232,Staff,10,0,30,20
1714606269053,SIOC 290S,A01,637330,Merrifield; Mark A,23,0,30,7
1714606270081,SIOC 291S,A01,637333,Gabriel; Corey John,23,0,30,7
1714606271107,SOCI 117,A01,494376,Staff,0,4,5,5
1714606272138,WES 237B,A00,494380,Staff,9,0,20,11
1714606274205,AESE 279B,A00,494370,Wade; Jon P,0,0,33,33
1714606275236,AIP 197,001,627712,Vespa; Emanuel Ignacio,9998,0,9999,1
1714606276266,ANAR 135S,A00,494369,Braswell; Geoffrey E.,0,0,0,0
1714606277292,BENG 196,001,628496,Engler; Adam J.,9998,0,9999,1
1714606278318,CAT 124RS,A01,519847,Geibel; William,0,0,20,20
1714606279343,CAT 125RS,A01,515971,Geibel; William,0,0,20,20
1714606280371,CLRE 250,A00,511389,Morris; Sheldon,9993,0,9999,6
1714606281397,CLRE 251,A00,507176,Mehta; Ravindra L.,9993,0,9999,6
1714606281397,CLRE 251,B00,511410,Mehta; Ravindra L.,9998,0,9999,1
1714606282422,CLRE 252,A00,507189,Cuomo; Raphael Eduardo,9995,0,9999,4
1714606283453,CLRE 253,A00,507199,Vaida; Florin,9994,0,9999,5
1714606283453,CLRE 253,B00,507202,Vaida; Florin,9999,0,9999,0
1714606284477,CLRE 259,A00,507211,Patel; Hemal,9996,0,9999,3
1714606285504,CLRE 260,A00,507221,Cuomo; Raphael Eduardo,9999,0,9999,0
1714606286529,CLRE 297,001,507242,Cuomo; Raphael Eduardo,9999,0,9999,0
1714606287555,COGS 197,001,638244,Voytek; Bradley Thomas,9998,0,9999,1
1714606288584,CSE 191,A00,516875,Minnes Kemp; Mor Mia,9993,0,9999,6
1714606289613,CSE 197,001,637388,Minnes Kemp; Mor Mia,9998,0,9999,1
1714606290638,CSS 201S,A01,494383,Staff,35,0,35,0
1714606291662,CSS 202S,A01,494387,Staff,35,0,35,0
1714606292686,DSC 197,001,628532,Eldridge; Justin Matthew,9996,0,9999,3
1714606293712,EAP 100,A00,516065,Staff,9797,0,9999,202
1714606294743,ECE 45,A01,507414,Staff,33,0,60,27
1714606296794,ECE 111,A01,507420,Staff,15,0,50,35
1714606297818,ECE 197,001,548057,Sievenpiper; Daniel F.,9993,0,9999,6
1714606298844,EDS 115,A00,507243,Choi; Bailey Miyeon,10,0,28,18
1714606299870,EDS 117,A01,494379,Staff,1,5,30,29
1714606300899,EDS 125,A00,507246,Hopkins; Megan Beth,9,0,30,21
1714606301925,EDS 128A,A01,507264,Fargason; Sharon Gayle,8,0,26,18
1714606302953,EDS 128B,A01,507293,Pappas; Elizabeth,12,0,30,18
1714606303979,EDS 139,A00,507294,Fargason; Sharon Gayle,13,0,30,17
1714606303979,EDS 139,B00,507313,Pappas; Elizabeth,13,0,30,17
1714606305006,EDS 201,A00,507315,Staff,13,0,30,17
1714606306031,EDS 203,A01,507317,Halter; Christopher P.,12,0,30,18
1714606307058,EDS 204R,A01,507319,Halter; Christopher P.,0,3,30,30
1714606307058,EDS 204R,B01,507331,Heinzman; Erica M.,16,0,30,14
1714606308082,EDS 206R,A00,507332,Staff,0,4,30,30
1714606308082,EDS 206R,B00,507343,Staff,17,0,30,13
1714606309110,EDS 250,A00,507344,Hemans; Patricia Ann Benitez,22,0,40,18
1714606310137,EDS 281,A00,507345,Daly; Alan J.,18,0,18,0
1714606311165,EDS 284,A00,507350,Daly; Alan J.,16,0,16,0
1714606312194,EDS 286,A00,507359,Fine; Sarah,18,0,18,0
1714606313218,EDS 289C,A01,507361,Daly; Alan J.,18,0,18,0
1714606314242,EDS 290,A00,507366,Hofstetter; Carolyn,15,0,15,0
1714606315269,LIGM 5A,A00,507421,Fischer-Grunski; Eva K,18,0,20,2
1714606316299,LIGM 5B,A00,507423,Fischer-Grunski; Eva K,19,0,20,1
1714606317323,LIGM 5C,A00,507425,Fischer-Grunski; Eva K,19,0,20,1
1714606318349,LIIT 5AS,A00,507427,Carnelos; Chiara,20,0,20,0
1714606319375,LIIT 5BS,A00,507430,Carnelos; Chiara,20,0,20,0
1714606320403,LIIT 5CS,A00,507432,Carnelos; Chiara,20,0,20,0
1714606321427,LISP 5A,A00,507541,Munoz Sanchez; Alicia,11,0,20,9
1714606322453,LISP 5B,A00,507671,Munoz Sanchez; Alicia,8,0,20,12
1714606323477,LISP 5C,A00,507696,Munoz Sanchez; Alicia,9,0,20,11
1714606324508,MAE 197,001,528363,Boechler; Nicholas Sebastia,9998,0,9999,1
1714606325536,MATH 197,001,523477,Kedlaya; Kiran S.,9995,0,9999,4
1714606325536,MATH 197,002,563811,Zhang; Danna,9995,0,9999,4
1714606325536,MATH 197,003,628552,Dumitriu; Ioana,9998,0,9999,1
1714606326566,MCWP 40R,A00,518780,Staff,2,0,20,18
1714606326566,MCWP 40R,B00,518781,Staff,8,0,20,12
1714606326566,MCWP 40R,C00,518783,Staff,6,0,20,14
1714606327595,MCWP 50R,A00,518791,Staff,0,0,20,20
1714606327595,MCWP 50R,B00,518792,Staff,0,2,20,20
1714606327595,MCWP 50R,C00,518793,Staff,0,2,20,20
1714606327595,MCWP 50R,D00,518794,Staff,0,0,20,20
1714606327595,MCWP 50R,E00,518795,Staff,0,2,20,20
1714606327595,MCWP 50R,F00,518796,Staff,0,0,20,20
1714606327595,MCWP 50R,G00,518797,Staff,0,1,20,20
1714606328624,MMW 12R,A01,514034,Herbst; Matthew,0,0,16,16
1714606328624,MMW 12R,A02,514035,Herbst; Matthew,1,0,16,15
1714606329648,MMW 13R,A01,514037,Staff,0,4,16,16
1714606329648,MMW 13R,A02,514039,Staff,0,2,16,16
1714606329648,MMW 13R,A03,628519,Staff,0,2,16,16
1714606331702,SIO 295LS,A00,523233,Staff,10,0,30,20
1714606332726,SIO 295S,A00,523232,Staff,10,0,30,20
1714606333756,SIOC 290S,A01,637330,Merrifield; Mark A,23,0,30,7
1714606334781,SIOC 291S,A01,637333,Gabriel; Corey John,23,0,30,7
1714606335805,SOCI 117,A01,494376,Staff,0,4,5,5
1714606336834,WES 237B,A00,494380,Staff,9,0,20,11
1714606338906,AESE 279B,A00,494370,Wade; Jon P,0,0,33,33
1714606339931,AIP 197,001,627712,Vespa; Emanuel Ignacio,9998,0,9999,1
1714606340959,ANAR 135S,A00,494369,Braswell; Geoffrey E.,0,0,0,0
1714606341985,BENG 196,001,628496,Engler; Adam J.,9998,0,9999,1
1714606343013,CAT 124RS,A01,519847,Geibel; William,0,0,20,20
1714606344043,CAT 125RS,A01,515971,Geibel; William,0,0,20,20
1714606345068,CLRE 250,A00,511389,Morris; Sheldon,9993,0,9999,6
1714606346102,CLRE 251,A00,507176,Mehta; Ravindra L.,9993,0,9999,6
1714606346102,CLRE 251,B00,511410,Mehta; Ravindra L.,9998,0,9999,1
1714606347126,CLRE 252,A00,507189,Cuomo; Raphael Eduardo,9995,0,9999,4
1714606348154,CLRE 253,A00,507199,Vaida; Florin,9994,0,9999,5
1714606348154,CLRE 253,B00,507202,Vaida; Florin,9999,0,9999,0
1714606349182,CLRE 259,A00,507211,Patel; Hemal,9996,0,9999,3
1714606350206,CLRE 260,A00,507221,Cuomo; Raphael Eduardo,9999,0,9999,0
1714606351233,CLRE 297,001,507242,Cuomo; Raphael Eduardo,9999,0,9999,0
1714606352258,COGS 197,001,638244,Voytek; Bradley Thomas,9998,0,9999,1
1714606353284,CSE 191,A00,516875,Minnes Kemp; Mor Mia,9993,0,9999,6
1714606354309,CSE 197,001,637388,Minnes Kemp; Mor Mia,9998,0,9999,1
1714606355340,CSS 201S,A01,494383,Staff,35,0,35,0
1714606356368,CSS 202S,A01,494387,Staff,35,0,35,0
1714606357392,DSC 197,001,628532,Eldridge; Justin Matthew,9996,0,9999,3
1714606358420,EAP 100,A00,516065,Staff,9797,0,9999,202
1714606359446,ECE 45,A01,507414,Staff,33,0,60,27
1714606361496,ECE 111,A01,507420,Staff,15,0,50,35
1714606362521,ECE 197,001,548057,Sievenpiper; Daniel F.,9993,0,9999,6
1714606363550,EDS 115,A00,507243,Choi; Bailey Miyeon,10,0,28,18
1714606364575,EDS 117,A01,494379,Staff,1,5,30,29
1714606365598,EDS 125,A00,507246,Hopkins; Megan Beth,9,0,30,21
1714606366628,EDS 128A,A01,507264,Fargason; Sharon Gayle,8,0,26,18
1714606367653,EDS 128B,A01,507293,Pappas; Elizabeth,12,0,30,18
1714606368677,EDS 139,A00,507294,Fargason; Sharon Gayle,13,0,30,17
1714606368677,EDS 139,B00,507313,Pappas; Elizabeth,13,0,30,17
1714606369703,EDS 201,A00,507315,Staff,13,0,30,17
1714606370729,EDS 203,A01,507317,Halter; Christopher P.,12,0,30,18
1714606371756,EDS 204R,A01,507319,Halter; Christopher P.,0,3,30,30
1714606371756,EDS 204R,B01,507331,Heinzman; Erica M.,16,0,30,14
1714606372784,EDS 206R,A00,507332,Staff,0,4,30,30
1714606372784,EDS 206R,B00,507343,Staff,17,0,30,13
1714606373808,EDS 250,A00,507344,Hemans; Patricia Ann Benitez,22,0,40,18
1714606374834,EDS 281,A00,507345,Daly; Alan J.,18,0,18,0
1714606375859,EDS 284,A00,507350,Daly; Alan J.,16,0,16,0
1714606376884,EDS 286,A00,507359,Fine; Sarah,18,0,18,0
1714606377910,EDS 289C,A01,507361,Daly; Alan J.,18,0,18,0
1714606378936,EDS 290,A00,507366,Hofstetter; Carolyn,15,0,15,0
1714606379961,LIGM 5A,A00,507421,Fischer-Grunski; Eva K,18,0,20,2
1714606380990,LIGM 5B,A00,507423,Fischer-Grunski; Eva K,19,0,20,1
1714606382017,LIGM 5C,A00,507425,Fischer-Grunski; Eva K,19,0,20,1
1714606383044,LIIT 5AS,A00,507427,Carnelos; Chiara,20,0,20,0
1714606384068,LIIT 5BS,A00,507430,Carnelos; Chiara,20,0,20,0
1714606385094,LIIT 5CS,A00,507432,Carnelos; Chiara,20,0,20,0
1714606386128,LISP 5A,A00,507541,Munoz Sanchez; Alicia,11,0,20,9
1714606387153,LISP 5B,A00,507671,Munoz Sanchez; Alicia,8,0,20,12
1714606388179,LISP 5C,A00,507696,Munoz Sanchez; Alicia,9,0,20,11
1714606389204,MAE 197,001,528363,Boechler; Nicholas Sebastia,9998,0,9999,1
1714606390232,MATH 197,001,523477,Kedlaya; Kiran S.,9995,0,9999,4
1714606390232,MATH 197,002,563811,Zhang; Danna,9995,0,9999,4
1714606390232,MATH 197,003,628552,Dumitriu; Ioana,9998,0,9999,1
1714606391261,MCWP 40R,A00,518780,Staff,2,0,20,18
1714606391261,MCWP 40R,B00,518781,Staff,8,0,20,12
1714606391261,MCWP 40R,C00,518783,Staff,6,0,20,14
1714606392287,MCWP 50R,A00,518791,Staff,0,0,20,20
1714606392287,MCWP 50R,B00,518792,Staff,0,2,20,20
1714606392287,MCWP 50R,C00,518793,Staff,0,2,20,20
1714606392287,MCWP 50R,D00,518794,Staff,0,0,20,20
1714606392287,MCWP 50R,E00,518795,Staff,0,2,20,20
1714606392287,MCWP 50R,F00,518796,Staff,0,0,20,20
1714606392287,MCWP 50R,G00,518797,Staff,0,1,20,20
1714606393314,MMW 12R,A01,514034,Herbst; Matthew,0,0,16,16
1714606393314,MMW 12R,A02,514035,Herbst; Matthew,1,0,16,15
1714606394338,MMW 13R,A01,514037,Staff,0,4,16,16
1714606394338,MMW 13R,A02,514039,Staff,0,2,16,16
1714606394338,MMW 13R,A03,628519,Staff,0,2,16,16
1714606396392,SIO 295LS,A00,523233,Staff,10,0,30,20
1714606397416,SIO 295S,A00,523232,Staff,10,0,30,20
1714606398444,SIOC 290S,A01,637330,Merrifield; Mark A,23,0,30,7
1714606399471,SIOC 291S,A01,637333,Gabriel; Corey John,23,0,30,7
1714606400499,SOCI 117,A01,494376,Staff,0,4,5,5
1714606401526,WES 237B,A00,494380,Staff,9,0,20,11
1714606403608,AESE 279B,A00,494370,Wade; Jon P,0,0,33,33
1714606404633,AIP 197,001,627712,Vespa; Emanuel Ignacio,9998,0,9999,1
1714606405658,ANAR 135S,A00,494369,Braswell; Geoffrey E.,0,0,0,0
1714606406683,BENG 196,001,628496,Engler; Adam J.,9998,0,9999,1
1714606407711,CAT 124RS,A01,519847,Geibel; William,0,0,20,20
1714606408740,CAT 125RS,A01,515971,Geibel; William,0,0,20,20
1714606409771,CLRE 250,A00,511389,Morris; Sheldon,9993,0,9999,6
1714606410801,CLRE 251,A00,507176,Mehta; Ravindra L.,9993,0,9999,6
1714606410801,CLRE 251,B00,511410,Mehta; Ravindra L.,9998,0,9999,1
1714606411829,CLRE 252,A00,507189,Cuomo; Raphael Eduardo,9995,0,9999,4
1714606412857,CLRE 253,A00,507199,Vaida; Florin,9994,0,9999,5
1714606412857,CLRE 253,B00,507202,Vaida; Florin,9999,0,9999,0
1714606413886,CLRE 259,A00,507211,Patel; Hemal,9996,0,9999,3
1714606414910,CLRE 260,A00,507221,Cuomo; Raphael Eduardo,9999,0,9999,0
1714606415934,CLRE 297,001,507242,Cuomo; Raphael Eduardo,9999,0,9999,0
1714606416965,COGS 197,001,638244,Voytek; Bradley Thomas,9998,0,9999,1
1714606417991,CSE 191,A00,516875,Minnes Kemp; Mor Mia,9993,0,9999,6
1714606419016,CSE 197,001,637388,Minnes Kemp; Mor Mia,9998,0,9999,1
1714606420048,CSS 201S,A01,494383,Staff,35,0,35,0
1714606421077,CSS 202S,A01,494387,Staff,35,0,35,0
1714606422104,DSC 197,001,628532,Eldridge; Justin Matthew,9996,0,9999,3
1714606423130,EAP 100,A00,516065,Staff,9797,0,9999,202
1714606424157,ECE 45,A01,507414,Staff,33,0,60,27
1714606426207,ECE 111,A01,507420,Staff,15,0,50,35
1714606427235,ECE 197,001,548057,Sievenpiper; Daniel F.,9993,0,9999,6
1714606428265,EDS 115,A00,507243,Choi; Bailey Miyeon,10,0,28,18
1714606429293,EDS 117,A01,494379,Staff,1,5,30,29
1714606430320,EDS 125,A00,507246,Hopkins; Megan Beth,9,0,30,21
1714606431346,EDS 128A,A01,507264,Fargason; Sharon Gayle,8,0,26,18
1714606432372,EDS 128B,A01,507293,Pappas; Elizabeth,12,0,30,18
1714606433397,EDS 139,A00,507294,Fargason; Sharon Gayle,13,0,30,17
1714606433397,EDS 139,B00,507313,Pappas; Elizabeth,13,0,30,17
1714606434422,EDS 201,A00,507315,Staff,13,0,30,17
1714606435452,EDS 203,A01,507317,Halter; Christopher P.,12,0,30,18
1714606436476,EDS 204R,A01,507319,Halter; Christopher P.,0,3,30,30
1714606436476,EDS 204R,B01,507331,Heinzman; Erica M.,16,0,30,14
1714606437500,EDS 206R,A00,507332,Staff,0,4,30,30
1714606437500,EDS 206R,B00,507343,Staff,17,0,30,13
1714606438525,EDS 250,A00,507344,Hemans; Patricia Ann Benitez,22,0,40,18
1714606439554,EDS 281,A00,507345,Daly; Alan J.,18,0,18,0
1714606440578,EDS 284,A00,507350,Daly; Alan J.,16,0,16,0
1714606441604,EDS 286,A00,507359,Fine; Sarah,18,0,18,0
1714606442630,EDS 289C,A01,507361,Daly; Alan J.,18,0,18,0
1714606443655,EDS 290,A00,507366,Hofstetter; Carolyn,15,0,15,0
1714606444681,LIGM 5A,A00,507421,Fischer-Grunski; Eva K,18,0,20,2
1714606445707,LIGM 5B,A00,507423,Fischer-Grunski; Eva K,19,0,20,1
1714606446733,LIGM 5C,A00,507425,Fischer-Grunski; Eva K,19,0,20,1
1714606447758,LIIT 5AS,A00,507427,Carnelos; Chiara,20,0,20,0
1714606448787,LIIT 5BS,A00,507430,Carnelos; Chiara,20,0,20,0
1714606449813,LIIT 5CS,A00,507432,Carnelos; Chiara,20,0,20,0
1714606450840,LISP 5A,A00,507541,Munoz Sanchez; Alicia,11,0,20,9
1714606451867,LISP 5B,A00,507671,Munoz Sanchez; Alicia,8,0,20,12
1714606452897,LISP 5C,A00,507696,Munoz Sanchez; Alicia,9,0,20,11
1714606453923,MAE 197,001,528363,Boechler; Nicholas Sebastia,9998,0,9999,1
1714606454953,MATH 197,001,523477,Kedlaya; Kiran S.,9995,0,9999,4
1714606454953,MATH 197,002,563811,Zhang; Danna,9995,0,9999,4
1714606454953,MATH 197,003,628552,Dumitriu; Ioana,9998,0,9999,1
1714606455980,MCWP 40R,A00,518780,Staff,2,0,20,18
1714606455980,MCWP 40R,B00,518781,Staff,8,0,20,12
1714606455980,MCWP 40R,C00,518783,Staff,6,0,20,14
1714606457007,MCWP 50R,A00,518791,Staff,0,0,20,20
1714606457007,MCWP 50R,B00,518792,Staff,0,2,20,20
1714606457007,MCWP 50R,C00,518793,Staff,0,2,20,20
1714606457007,MCWP 50R,D00,518794,Staff,0,0,20,20
1714606457007,MCWP 50R,E00,518795,Staff,0,2,20,20
1714606457007,MCWP 50R,F00,518796,Staff,0,0,20,20
1714606457007,MCWP 50R,G00,518797,Staff,0,1,20,20
1714606458032,MMW 12R,A01,514034,Herbst; Matthew,0,0,16,16
1714606458032,MMW 12R,A02,514035,Herbst; Matthew,1,0,16,15
1714606459056,MMW 13R,A01,514037,Staff,0,4,16,16
1714606459056,MMW 13R,A02,514039,Staff,0,2,16,16
1714606459056,MMW 13R,A03,628519,Staff,0,2,16,16
1714606461112,SIO 295LS,A00,523233,Staff,10,0,30,20
1714606462140,SIO 295S,A00,523232,Staff,10,0,30,20
1714606463167,SIOC 290S,A01,637330,Merrifield; Mark A,23,0,30,7
1714606464195,SIOC 291S,A01,637333,Gabriel; Corey John,23,0,30,7
1714606465220,SOCI 117,A01,494376,Staff,0,4,5,5
1714606466249,WES 237B,A00,494380,Staff,9,0,20,11
1714606468332,AESE 279B,A00,494370,Wade; Jon P,0,0,33,33
1714606469358,AIP 197,001,627712,Vespa; Emanuel Ignacio,9998,0,9999,1
1714606470402,ANAR 135S,A00,494369,Braswell; Geoffrey E.,0,0,0,0
1714606471428,BENG 196,001,628496,Engler; Adam J.,9998,0,9999,1
1714606472458,CAT 124RS,A01,519847,Geibel; William,0,0,20,20
1714606473483,CAT 125RS,A01,515971,Geibel; William,0,0,20,20
1714606474507,CLRE 250,A00,511389,Morris; Sheldon,9993,0,9999,6
1714606475538,CLRE 251,A00,507176,Mehta; Ravindra L.,9993,0,9999,6
1714606475538,CLRE 251,B00,511410,Mehta; Ravindra L.,9998,0,9999,1
1714606476564,CLRE 252,A00,507189,Cuomo; Raphael Eduardo,9995,0,9999,4
1714606477593,CLRE 253,A00,507199,Vaida; Florin,9994,0,9999,5
1714606477593,CLRE 253,B00,507202,Vaida; Florin,9999,0,9999,0
1714606478620,CLRE 259,A00,507211,Patel; Hemal,9996,0,9999,3
1714606479651,CLRE 260,A00,507221,Cuomo; Raphael Eduardo,9999,0,9999,0
1714606480679,CLRE 297,001,507242,Cuomo; Raphael Eduardo,9999,0,9999,0
1714606481705,COGS 197,001,638244,Voytek; Bradley Thomas,9998,0,9999,1
1714606482731,CSE 191,A00,516875,Minnes Kemp; Mor Mia,9993,0,9999,6
1714606483758,CSE 197,001,637388,Minnes Kemp; Mor Mia,9998,0,9999,1
1714606484788,CSS 201S,A01,494383,Staff,35,0,35,0
1714606485817,CSS 202S,A01,494387,Staff,35,0,35,0
1714606486844,DSC 197,001,628532,Eldridge; Justin Matthew,9996,0,9999,3
1714606487872,EAP 100,A00,516065,Staff,9797,0,9999,202
1714606488898,ECE 45,A01,507414,Staff,33,0,60,27
1714606490953,ECE 111,A01,507420,Staff,15,0,50,35
1714606491978,ECE 197,001,548057,Sievenpiper; Daniel F.,9993,0,9999,6
1714606493004,EDS 115,A00,507243,Choi; Bailey Miyeon,10,0,28,18
1714606494032,EDS 117,A01,494379,Staff,1,5,30,29
1714606495058,EDS 125,A00,507246,Hopkins; Megan Beth,9,0,30,21
1714606496085,EDS 128A,A01,507264,Fargason; Sharon Gayle,8,0,26,18
1714606497112,EDS 128B,A01,507293,Pappas; Elizabeth,12,0,30,18
1714606498137,EDS 139,A00,507294,Fargason; Sharon Gayle,13,0,30,17
1714606498137,EDS 139,B00,507313,Pappas; Elizabeth,13,0,30,17
1714606499161,EDS 201,A00,507315,Staff,13,0,30,17
1714606500188,EDS 203,A01,507317,Halter; Christopher P.,12,0,30,18
1714606501219,EDS 204R,A01,507319,Halter; Christopher P.,0,3,30,30
1714606501219,EDS 204R,B01,507331,Heinzman; Erica M.,16,0,30,14
1714606502248,EDS 206R,A00,507332,Staff,0,4,30,30
1714606502248,EDS 206R,B00,507343,Staff,17,0,30,13
1714606503276,EDS 250,A00,507344,Hemans; Patricia Ann Benitez,22,0,40,18
1714606504301,EDS 281,A00,507345,Daly; Alan J.,18,0,18,0
1714606505325,EDS 284,A00,507350,Daly; Alan J.,16,0,16,0
1714606506352,EDS 286,A00,507359,Fine; Sarah,18,0,18,0
1714606507376,EDS 289C,A01,507361,Daly; Alan J.,18,0,18,0
1714606508400,EDS 290,A00,507366,Hofstetter; Carolyn,15,0,15,0
1714606509485,LIGM 5A,A00,507421,Fischer-Grunski; Eva K,18,0,20,2
1714606510510,LIGM 5B,A00,507423,Fischer-Grunski; Eva K,19,0,20,1
1714606511534,LIGM 5C,A00,507425,Fischer-Grunski; Eva K,19,0,20,1
1714606512562,LIIT 5AS,A00,507427,Carnelos; Chiara,20,0,20,0
1714606513587,LIIT 5BS,A00,507430,Carnelos; Chiara,20,0,20,0
1714606514612,LIIT 5CS,A00,507432,Carnelos; Chiara,20,0,20,0
1714606515636,LISP 5A,A00,507541,Munoz Sanchez; Alicia,11,0,20,9
1714606516661,LISP 5B,A00,507671,Munoz Sanchez; Alicia,8,0,20,12
1714606517688,LISP 5C,A00,507696,Munoz Sanchez; Alicia,9,0,20,11
1714606518717,MAE 197,001,528363,Boechler; Nicholas Sebastia,9998,0,9999,1
1714606519754,MATH 197,001,523477,Kedlaya; Kiran S.,9995,0,9999,4
1714606519754,MATH 197,002,563811,Zhang; Danna,9995,0,9999,4
1714606519754,MATH 197,003,628552,Dumitriu; Ioana,9998,0,9999,1
1714606520779,MCWP 40R,A00,518780,Staff,2,0,20,18
1714606520779,MCWP 40R,B00,518781,Staff,8,0,20,12
1714606520779,MCWP 40R,C00,518783,Staff,6,0,20,14
1714606521805,MCWP 50R,A00,518791,Staff,0,0,20,20
1714606521805,MCWP 50R,B00,518792,Staff,0,2,20,20
1714606521805,MCWP 50R,C00,518793,Staff,0,2,20,20
1714606521805,MCWP 50R,D00,518794,Staff,0,0,20,20
1714606521805,MCWP 50R,E00,518795,Staff,0,2,20,20
1714606521805,MCWP 50R,F00,518796,Staff,0,0,20,20
1714606521805,MCWP 50R,G00,518797,Staff,0,1,20,20
1714606522834,MMW 12R,A01,514034,Herbst; Matthew,0,0,16,16
1714606522834,MMW 12R,A02,514035,Herbst; Matthew,1,0,16,15
1714606523872,MMW 13R,A01,514037,Staff,0,4,16,16
1714606523872,MMW 13R,A02,514039,Staff,0,2,16,16
1714606523872,MMW 13R,A03,628519,Staff,0,2,16,16
1714606525924,SIO 295LS,A00,523233,Staff,10,0,30,20
1714606526949,SIO 295S,A00,523232,Staff,10,0,30,20
1714606527974,SIOC 290S,A01,637330,Merrifield; Mark A,23,0,30,7
1714606529002,SIOC 291S,A01,637333,Gabriel; Corey John,23,0,30,7
1714606530029,SOCI 117,A01,494376,Staff,0,4,5,5
1714606531056,WES 237B,A00,494380,Staff,9,0,20,11
1714606533124,AESE 279B,A00,494370,Wade; Jon P,0,0,33,33
1714606534149,AIP 197,001,627712,Vespa; Emanuel Ignacio,9998,0,9999,1
1714606535174,ANAR 135S,A00,494369,Braswell; Geoffrey E.,0,0,0,0
1714606536204,BENG 196,001,628496,Engler; Adam J.,9998,0,9999,1
1714606537232,CAT 124RS,A01,519847,Geibel; William,0,0,20,20
1714606538261,CAT 125RS,A01,515971,Geibel; William,0,0,20,20
1714606539288,CLRE 250,A00,511389,Morris; Sheldon,9993,0,9999,6
1714606540316,CLRE 251,A00,507176,Mehta; Ravindra L.,9993,0,9999,6
1714606540316,CLRE 251,B00,511410,Mehta; Ravindra L.,9998,0,9999,1
1714606541342,CLRE 252,A00,507189,Cuomo; Raphael Eduardo,9995,0,9999,4
1714606542452,CLRE 253,A00,507199,Vaida; Florin,9994,0,9999,5
1714606542452,CLRE 253,B00,507202,Vaida; Florin,9999,0,9999,0
1714606543475,CLRE 259,A00,507211,Patel; Hemal,9996,0,9999,3
1714606544501,CLRE 260,A00,507221,Cuomo; Raphael Eduardo,9999,0,9999,0
1714606545529,CLRE 297,001,507242,Cuomo; Raphael Eduardo,9999,0,9999,0
1714606546555,COGS 197,001,638244,Voytek; Bradley Thomas,9998,0,9999,1
1714606547582,CSE 191,A00,516875,Minnes Kemp; Mor Mia,9993,0,9999,6
1714606548611,CSE 197,001,637388,Minnes Kemp; Mor Mia,9998,0,9999,1
1714606549638,CSS 201S,A01,494383,Staff,35,0,35,0
1714606550664,CSS 202S,A01,494387,Staff,35,0,35,0
1714606551689,DSC 197,001,628532,Eldridge; Justin Matthew,9996,0,9999,3
1714606552715,EAP 100,A00,516065,Staff,9797,0,9999,202
1714606553744,ECE 45,A01,507414,Staff,33,0,60,27
1714606555795,ECE 111,A01,507420,Staff,15,0,50,35
1714606556828,ECE 197,001,548057,Sievenpiper; Daniel F.,9993,0,9999,6
1714606557855,EDS 115,A00,507243,Choi; Bailey Miyeon,10,0,28,18
1714606558884,EDS 117,A01,494379,Staff,1,5,30,29
1714606559909,EDS 125,A00,507246,Hopkins; Megan Beth,9,0,30,21
1714606560933,EDS 128A,A01,507264,Fargason; Sharon Gayle,8,0,26,18
1714606561958,EDS 128B,A01,507293,Pappas; Elizabeth,12,0,30,18
1714606562986,EDS 139,A00,507294,Fargason; Sharon Gayle,13,0,30,17
1714606562986,EDS 139,B00,507313,Pappas; Elizabeth,13,0,30,17
1714606564009,EDS 201,A00,507315,Staff,13,0,30,17
1714606565040,EDS 203,A01,507317,Halter; Christopher P.,12,0,30,18
1714606566068,EDS 204R,A01,507319,Halter; Christopher P.,0,3,30,30
1714606566068,EDS 204R,B01,507331,Heinzman; Erica M.,16,0,30,14
1714606567096,EDS 206R,A00,507332,Staff,0,4,30,30
1714606567096,EDS 206R,B00,507343,Staff,17,0,30,13
1714606568124,EDS 250,A00,507344,Hemans; Patricia Ann Benitez,22,0,40,18
1714606569151,EDS 281,A00,507345,Daly; Alan J.,18,0,18,0
1714606570176,EDS 284,A00,507350,Daly; Alan J.,16,0,16,0
1714606571204,EDS 286,A00,507359,Fine; Sarah,18,0,18,0
1714606572239,EDS 289C,A01,507361,Daly; Alan J.,18,0,18,0
1714606573264,EDS 290,A00,507366,Hofstetter; Carolyn,15,0,15,0
1714606574290,LIGM 5A,A00,507421,Fischer-Grunski; Eva K,18,0,20,2
1714606575319,LIGM 5B,A00,507423,Fischer-Grunski; Eva K,19,0,20,1
1714606576347,LIGM 5C,A00,507425,Fischer-Grunski; Eva K,19,0,20,1
1714606577373,LIIT 5AS,A00,507427,Carnelos; Chiara,20,0,20,0
1714606578400,LIIT 5BS,A00,507430,Carnelos; Chiara,20,0,20,0
1714606579427,LIIT 5CS,A00,507432,Carnelos; Chiara,20,0,20,0
1714606580454,LISP 5A,A00,507541,Munoz Sanchez; Alicia,11,0,20,9
1714606581480,LISP 5B,A00,507671,Munoz Sanchez; Alicia,8,0,20,12
1714606582511,LISP 5C,A00,507696,Munoz Sanchez; Alicia,9,0,20,11
1714606583535,MAE 197,001,528363,Boechler; Nicholas Sebastia,9998,0,9999,1
1714606584570,MATH 197,001,523477,Kedlaya; Kiran S.,9995,0,9999,4
1714606584570,MATH 197,002,563811,Zhang; Danna,9995,0,9999,4
1714606584570,MATH 197,003,628552,Dumitriu; Ioana,9998,0,9999,1
1714606585597,MCWP 40R,A00,518780,Staff,2,0,20,18
1714606585597,MCWP 40R,B00,518781,Staff,8,0,20,12
1714606585597,MCWP 40R,C00,518783,Staff,6,0,20,14
1714606586680,MCWP 50R,A00,518791,Staff,0,0,20,20
1714606586680,MCWP 50R,B00,518792,Staff,0,2,20,20
1714606586680,MCWP 50R,C00,518793,Staff,0,2,20,20
1714606586680,MCWP 50R,D00,518794,Staff,0,0,20,20
1714606586680,MCWP 50R,E00,518795,Staff,0,2,20,20
1714606586680,MCWP 50R,F00,518796,Staff,0,0,20,20
1714606586680,MCWP 50R,G00,518797,Staff,0,1,20,20
1714606587705,MMW 12R,A01,514034,Herbst; Matthew,0,0,16,16
1714606587705,MMW 12R,A02,514035,Herbst; Matthew,1,0,16,15
1714606588729,MMW 13R,A01,514037,Staff,0,4,16,16
1714606588729,MMW 13R,A02,514039,Staff,0,2,16,16
1714606588729,MMW 13R,A03,628519,Staff,0,2,16,16
1714606590781,SIO 295LS,A00,523233,Staff,10,0,30,20
1714606591805,SIO 295S,A00,523232,Staff,10,0,30,20
1714606592833,SIOC 290S,A01,637330,Merrifield; Mark A,23,0,30,7
1714606593873,SIOC 291S,A01,637333,Gabriel; Corey John,23,0,30,7
1714606594900,SOCI 117,A01,494376,Staff,0,4,5,5
1714606595928,WES 237B,A00,494380,Staff,9,0,20,11
1714606597999,AESE 279B,A00,494370,Wade; Jon P,0,0,33,33
1714606599028,AIP 197,001,627712,Vespa; Emanuel Ignacio,9998,0,9999,1
1714606600057,ANAR 135S,A00,494369,Braswell; Geoffrey E.,0,0,0,0
1714606601084,BENG 196,001,628496,Engler; Adam J.,9998,0,9999,1
1714606602109,CAT 124RS,A01,519847,Geibel; William,0,0,20,20
1714606603134,CAT 125RS,A01,515971,Geibel; William,0,0,20,20
1714606604158,CLRE 250,A00,511389,Morris; Sheldon,9993,0,9999,6
1714606605187,CLRE 251,A00,507176,Mehta; Ravindra L.,9993,0,9999,6
1714606605187,CLRE 251,B00,511410,Mehta; Ravindra L.,9998,0,9999,1
1714606606212,CLRE 252,A00,507189,Cuomo; Raphael Eduardo,9995,0,9999,4
1714606607241,CLRE 253,A00,507199,Vaida; Florin,9994,0,9999,5
1714606607241,CLRE 253,B00,507202,Vaida; Florin,9999,0,9999,0
1714606608265,CLRE 259,A00,507211,Patel; Hemal,9996,0,9999,3
1714606609292,CLRE 260,A00,507221,Cuomo; Raphael Eduardo,9999,0,9999,0
1714606610318,CLRE 297,001,507242,Cuomo; Raphael Eduardo,9999,0,9999,0
1714606611346,COGS 197,001,638244,Voytek; Bradley Thomas,9998,0,9999,1
1714606612373,CSE 191,A00,516875,Minnes Kemp; Mor Mia,9993,0,9999,6
1714606613398,CSE 197,001,637388,Minnes Kemp; Mor Mia,9998,0,9999,1
1714606614424,CSS 201S,A01,494383,Staff,35,0,35,0
1714606615450,CSS 202S,A01,494387,Staff,35,0,35,0
1714606616479,DSC 197,001,628532,Eldridge; Justin Matthew,9996,0,9999,3
1714606617508,EAP 100,A00,516065,Staff,9797,0,9999,202
1714606618548,ECE 45,A01,507414,Staff,33,0,60,27
1714606620601,ECE 111,A01,507420,Staff,15,0,50,35
1714606621627,ECE 197,001,548057,Sievenpiper; Daniel F.,9993,0,9999,6
1714606622657,EDS 115,A00,507243,Choi; Bailey Miyeon,10,0,28,18
1714606623686,EDS 117,A01,494379,Staff,1,5,30,29
1714606624712,EDS 125,A00,507246,Hopkins; Megan Beth,9,0,30,21
1714606625740,EDS 128A,A01,507264,Fargason; Sharon Gayle,8,0,26,18
1714606626768,EDS 128B,A01,507293,Pappas; Elizabeth,12,0,30,18
1714606627794,EDS 139,A00,507294,Fargason; Sharon Gayle,13,0,30,17
1714606627794,EDS 139,B00,507313,Pappas; Elizabeth,13,0,30,17
1714606628822,EDS 201,A00,507315,Staff,13,0,30,17
1714606629850,EDS 203,A01,507317,Halter; Christopher P.,12,0,30,18
1714606630874,EDS 204R,A01,507319,Halter; Christopher P.,0,3,30,30
1714606630874,EDS 204R,B01,507331,Heinzman; Erica M.,16,0,30,14
1714606631898,EDS 206R,A00,507332,Staff,0,4,30,30
1714606631898,EDS 206R,B00,507343,Staff,17,0,30,13
1714606632923,EDS 250,A00,507344,Hemans; Patricia Ann Benitez,22,0,40,18
1714606633948,EDS 281,A00,507345,Daly; Alan J.,18,0,18,0
1714606634975,EDS 284,A00,507350,Daly; Alan J.,16,0,16,0
1714606636001,EDS 286,A00,507359,Fine; Sarah,18,0,18,0
1714606637030,EDS 289C,A01,507361,Daly; Alan J.,18,0,18,0
1714606638055,EDS 290,A00,507366,Hofstetter; Carolyn,15,0,15,0
1714606639081,LIGM 5A,A00,507421,Fischer-Grunski; Eva K,18,0,20,2
1714606640105,LIGM 5B,A00,507423,Fischer-Grunski; Eva K,19,0,20,1
1714606641130,LIGM 5C,A00,507425,Fischer-Grunski; Eva K,19,0,20,1
1714606642155,LIIT 5AS,A00,507427,Carnelos; Chiara,20,0,20,0
1714606643180,LIIT 5BS,A00,507430,Carnelos; Chiara,20,0,20,0
1714606644205,LIIT 5CS,A00,507432,Carnelos; Chiara,20,0,20,0
1714606645233,LISP 5A,A00,507541,Munoz Sanchez; Alicia,11,0,20,9
1714606646257,LISP 5B,A00,507671,Munoz Sanchez; Alicia,8,0,20,12
1714606647282,LISP 5C,A00,507696,Munoz Sanchez; Alicia,9,0,20,11
1714606648310,MAE 197,001,528363,Boechler; Nicholas Sebastia,9998,0,9999,1
1714606649340,MATH 197,001,523477,Kedlaya; Kiran S.,9995,0,9999,4
1714606649340,MATH 197,002,563811,Zhang; Danna,9995,0,9999,4
1714606649340,MATH 197,003,628552,Dumitriu; Ioana,9998,0,9999,1
1714606650369,MCWP 40R,A00,518780,Staff,2,0,20,18
1714606650369,MCWP 40R,B00,518781,Staff,8,0,20,12
1714606650369,MCWP 40R,C00,518783,Staff,6,0,20,14
1714606651393,MCWP 50R,A00,518791,Staff,0,0,20,20
1714606651393,MCWP 50R,B00,518792,Staff,0,2,20,20
1714606651393,MCWP 50R,C00,518793,Staff,0,2,20,20
1714606651393,MCWP 50R,D00,518794,Staff,0,0,20,20
1714606651393,MCWP 50R,E00,518795,Staff,0,2,20,20
1714606651393,MCWP 50R,F00,518796,Staff,0,0,20,20
1714606651393,MCWP 50R,G00,518797,Staff,0,1,20,20
1714606652429,MMW 12R,A01,514034,Herbst; Matthew,0,0,16,16
1714606652429,MMW 12R,A02,514035,Herbst; Matthew,1,0,16,15
1714606653453,MMW 13R,A01,514037,Staff,0,4,16,16
1714606653453,MMW 13R,A02,514039,Staff,0,2,16,16
1714606653453,MMW 13R,A03,628519,Staff,0,2,16,16
1714606655504,SIO 295LS,A00,523233,Staff,10,0,30,20
1714606656532,SIO 295S,A00,523232,Staff,10,0,30,20
1714606657556,SIOC 290S,A01,637330,Merrifield; Mark A,23,0,30,7
1714606658584,SIOC 291S,A01,637333,Gabriel; Corey John,23,0,30,7
1714606659612,SOCI 117,A01,494376,Staff,0,4,5,5
1714606660639,WES 237B,A00,494380,Staff,9,0,20,11
1714606662702,AESE 279B,A00,494370,Wade; Jon P,0,0,33,33
1714606663729,AIP 197,001,627712,Vespa; Emanuel Ignacio,9998,0,9999,1
1714606664755,ANAR 135S,A00,494369,Braswell; Geoffrey E.,0,0,0,0
1714606665779,BENG 196,001,628496,Engler; Adam J.,9998,0,9999,1
1714606666807,CAT 124RS,A01,519847,Geibel; William,0,0,20,20
1714606667835,CAT 125RS,A01,515971,Geibel; William,0,0,20,20
1714606668863,CLRE 250,A00,511389,Morris; Sheldon,9993,0,9999,6
1714606669893,CLRE 251,A00,507176,Mehta; Ravindra L.,9993,0,9999,6
1714606669893,CLRE 251,B00,511410,Mehta; Ravindra L.,9998,0,9999,1
1714606670919,CLRE 252,A00,507189,Cuomo; Raphael Eduardo,9995,0,9999,4
1714606671946,CLRE 253,A00,507199,Vaida; Florin,9994,0,9999,5
1714606671946,CLRE 253,B00,507202,Vaida; Florin,9999,0,9999,0
1714606672973,CLRE 259,A00,507211,Patel; Hemal,9996,0,9999,3
1714606673999,CLRE 260,A00,507221,Cuomo; Raphael Eduardo,9999,0,9999,0
1714606675023,CLRE 297,001,507242,Cuomo; Raphael Eduardo,9999,0,9999,0
1714606676050,COGS 197,001,638244,Voytek; Bradley Thomas,9998,0,9999,1
1714606677078,CSE 191,A00,516875,Minnes Kemp; Mor Mia,9993,0,9999,6
1714606678107,CSE 197,001,637388,Minnes Kemp; Mor Mia,9998,0,9999,1
1714606679133,CSS 201S,A01,494383,Staff,35,0,35,0
1714606680158,CSS 202S,A01,494387,Staff,35,0,35,0
1714606681182,DSC 197,001,628532,Eldridge; Justin Matthew,9996,0,9999,3
1714606682207,EAP 100,A00,516065,Staff,9797,0,9999,202
1714606683232,ECE 45,A01,507414,Staff,33,0,60,27
1714606685285,ECE 111,A01,507420,Staff,15,0,50,35
1714606686317,ECE 197,001,548057,Sievenpiper; Daniel F.,9993,0,9999,6
1714606687342,EDS 115,A00,507243,Choi; Bailey Miyeon,10,0,28,18
1714606688367,EDS 117,A01,494379,Staff,1,5,30,29
1714606689391,EDS 125,A00,507246,Hopkins; Megan Beth,9,0,30,21
1714606690421,EDS 128A,A01,507264,Fargason; Sharon Gayle,8,0,26,18
1714606691450,EDS 128B,A01,507293,Pappas; Elizabeth,12,0,30,18
1714606692483,EDS 139,A00,507294,Fargason; Sharon Gayle,13,0,30,17
1714606692483,EDS 139,B00,507313,Pappas; Elizabeth,13,0,30,17
1714606693510,EDS 201,A00,507315,Staff,13,0,30,17
1714606694534,EDS 203,A01,507317,Halter; Christopher P.,12,0,30,18
1714606695564,EDS 204R,A01,507319,Halter; Christopher P.,0,3,30,30
1714606695564,EDS 204R,B01,507331,Heinzman; Erica M.,16,0,30,14
1714606696590,EDS 206R,A00,507332,Staff,0,4,30,30
1714606696590,EDS 206R,B00,507343,Staff,17,0,30,13
1714606697621,EDS 250,A00,507344,Hemans; Patricia Ann Benitez,22,0,40,18
1714606698646,EDS 281,A00,507345,Daly; Alan J.,18,0,18,0
1714606699669,EDS 284,A00,507350,Daly; Alan J.,16,0,16,0
1714606700698,EDS 286,A00,507359,Fine; Sarah,18,0,18,0
1714606701751,EDS 289C,A01,507361,Daly; Alan J.,18,0,18,0
1714606702775,EDS 290,A00,507366,Hofstetter; Carolyn,15,0,15,0
1714606703806,LIGM 5A,A00,507421,Fischer-Grunski; Eva K,18,0,20,2
1714606704831,LIGM 5B,A00,507423,Fischer-Grunski; Eva K,19,0,20,1
1714606705855,LIGM 5C,A00,507425,Fischer-Grunski; Eva K,19,0,20,1
1714606706885,LIIT 5AS,A00,507427,Carnelos; Chiara,20,0,20,0
1714606707913,LIIT 5BS,A00,507430,Carnelos; Chiara,20,0,20,0
1714606708937,LIIT 5CS,A00,507432,Carnelos; Chiara,20,0,20,0
1714606709963,LISP 5A,A00,507541,Munoz Sanchez; Alicia,11,0,20,9
1714606710990,LISP 5B,A00,507671,Munoz Sanchez; Alicia,8,0,20,12
1714606712018,LISP 5C,A00,507696,Munoz Sanchez; Alicia,9,0,20,11
1714606713043,MAE 197,001,528363,Boechler; Nicholas Sebastia,9998,0,9999,1
1714606714070,MATH 197,001,523477,Kedlaya; Kiran S.,9995,0,9999,4
1714606714070,MATH 197,002,563811,Zhang; Danna,9995,0,9999,4
1714606714070,MATH 197,003,628552,Dumitriu; Ioana,9998,0,9999,1
1714606715098,MCWP 40R,A00,518780,Staff,2,0,20,18
1714606715098,MCWP 40R,B00,518781,Staff,8,0,20,12
1714606715098,MCWP 40R,C00,518783,Staff,6,0,20,14
1714606716129,MCWP 50R,A00,518791,Staff,0,0,20,20
1714606716129,MCWP 50R,B00,518792,Staff,0,2,20,20
1714606716129,MCWP 50R,C00,518793,Staff,0,2,20,20
1714606716129,MCWP 50R,D00,518794,Staff,0,0,20,20
1714606716129,MCWP 50R,E00,518795,Staff,0,2,20,20
1714606716129,MCWP 50R,F00,518796,Staff,0,0,20,20
1714606716129,MCWP 50R,G00,518797,Staff,0,1,20,20
1714606717174,MMW 12R,A01,514034,Herbst; Matthew,0,0,16,16
1714606717174,MMW 12R,A02,514035,Herbst; Matthew,1,0,16,15
1714606718200,MMW 13R,A01,514037,Staff,0,4,16,16
1714606718200,MMW 13R,A02,514039,Staff,0,2,16,16
1714606718200,MMW 13R,A03,628519,Staff,0,2,16,16
1714606720258,SIO 295LS,A00,523233,Staff,10,0,30,20
1714606721285,SIO 295S,A00,523232,Staff,10,0,30,20
1714606722313,SIOC 290S,A01,637330,Merrifield; Mark A,23,0,30,7
1714606723337,SIOC 291S,A01,637333,Gabriel; Corey John,23,0,30,7
1714606724365,SOCI 117,A01,494376,Staff,0,4,5,5
1714606725390,WES 237B,A00,494380,Staff,9,0,20,11
1714606727462,AESE 279B,A00,494370,Wade; Jon P,0,0,33,33
1714606728489,AIP 197,001,627712,Vespa; Emanuel Ignacio,9998,0,9999,1
1714606729514,ANAR 135S,A00,494369,Braswell; Geoffrey E.,0,0,0,0
1714606730537,BENG 196,001,628496,Engler; Adam J.,9998,0,9999,1
1714606731564,CAT 124RS,A01,519847,Geibel; William,0,0,20,20
1714606732590,CAT 125RS,A01,515971,Geibel; William,0,0,20,20
1714606733616,CLRE 250,A00,511389,Morris; Sheldon,9993,0,9999,6
1714606734643,CLRE 251,A00,507176,Mehta; Ravindra L.,9993,0,9999,6
1714606734643,CLRE 251,B00,511410,Mehta; Ravindra L.,9998,0,9999,1
1714606735667,CLRE 252,A00,507189,Cuomo; Raphael Eduardo,9995,0,9999,4
1714606736690,CLRE 253,A00,507199,Vaida; Florin,9994,0,9999,5
1714606736690,CLRE 253,B00,507202,Vaida; Florin,9999,0,9999,0
1714606737717,CLRE 259,A00,507211,Patel; Hemal,9996,0,9999,3
1714606738744,CLRE 260,A00,507221,Cuomo; Raphael Eduardo,9999,0,9999,0
1714606739769,CLRE 297,001,507242,Cuomo; Raphael Eduardo,9999,0,9999,0
1714606740796,COGS 197,001,638244,Voytek; Bradley Thomas,9998,0,9999,1
1714606741822,CSE 191,A00,516875,Minnes Kemp; Mor Mia,9993,0,9999,6
1714606742849,CSE 197,001,637388,Minnes Kemp; Mor Mia,9998,0,9999,1
1714606743874,CSS 201S,A01,494383,Staff,35,0,35,0
1714606744902,CSS 202S,A01,494387,Staff,35,0,35,0
1714606745926,DSC 197,001,628532,Eldridge; Justin Matthew,9996,0,9999,3
1714606746950,EAP 100,A00,516065,Staff,9797,0,9999,202
1714606747974,ECE 45,A01,507414,Staff,33,0,60,27
1714606750026,ECE 111,A01,507420,Staff,15,0,50,35
1714606751054,ECE 197,001,548057,Sievenpiper; Daniel F.,9993,0,9999,6
1714606752082,EDS 115,A00,507243,Choi; Bailey Miyeon,10,0,28,18
1714606753106,EDS 117,A01,494379,Staff,1,5,30,29
1714606754132,EDS 125,A00,507246,Hopkins; Megan Beth,9,0,30,21
1714606755157,EDS 128A,A01,507264,Fargason; Sharon Gayle,8,0,26,18
1714606756186,EDS 128B,A01,507293,Pappas; Elizabeth,12,0,30,18
1714606757211,EDS 139,A00,507294,Fargason; Sharon Gayle,13,0,30,17
1714606757211,EDS 139,B00,507313,Pappas; Elizabeth,13,0,30,17
1714606758235,EDS 201,A00,507315,Staff,13,0,30,17
1714606759261,EDS 203,A01,507317,Halter; Christopher P.,12,0,30,18
1714606760286,EDS 204R,A01,507319,Halter; Christopher P.,0,3,30,30
1714606760286,EDS 204R,B01,507331,Heinzman; Erica M.,16,0,30,14
1714606761312,EDS 206R,A00,507332,Staff,0,4,30,30
1714606761312,EDS 206R,B00,507343,Staff,17,0,30,13
1714606762338,EDS 250,A00,507344,Hemans; Patricia Ann Benitez,22,0,40,18
1714606763362,EDS 281,A00,507345,Daly; Alan J.,18,0,18,0
1714606764388,EDS 284,A00,507350,Daly; Alan J.,16,0,16,0
1714606765417,EDS 286,A00,507359,Fine; Sarah,18,0,18,0
1714606766441,EDS 289C,A01,507361,Daly; Alan J.,18,0,18,0
1714606767467,EDS 290,A00,507366,Hofstetter; Carolyn,15,0,15,0
1714606768491,LIGM 5A,A00,507421,Fischer-Grunski; Eva K,18,0,20,2
1714606769519,LIGM 5B,A00,507423,Fischer-Grunski; Eva K,19,0,20,1
1714606770544,LIGM 5C,A00,507425,Fischer-Grunski; Eva K,19,0,20,1
1714606771587,LIIT 5AS,A00,507427,Carnelos; Chiara,20,0,20,0
1714606772612,LIIT 5BS,A00,507430,Carnelos; Chiara,20,0,20,0
1714606773637,LIIT 5CS,A00,507432,Carnelos; Chiara,20,0,20,0
1714606774660,LISP 5A,A00,507541,Munoz Sanchez; Alicia,11,0,20,9
1714606775684,LISP 5B,A00,507671,Munoz Sanchez; Alicia,8,0,20,12
1714606776708,LISP 5C,A00,507696,Munoz Sanchez; Alicia,9,0,20,11
1714606777736,MAE 197,001,528363,Boechler; Nicholas Sebastia,9998,0,9999,1
1714606778764,MATH 197,001,523477,Kedlaya; Kiran S.,9995,0,9999,4
1714606778764,MATH 197,002,563811,Zhang; Danna,9995,0,9999,4
1714606778764,MATH 197,003,628552,Dumitriu; Ioana,9998,0,9999,1
1714606779791,MCWP 40R,A00,518780,Staff,2,0,20,18
1714606779791,MCWP 40R,B00,518781,Staff,8,0,20,12
1714606779791,MCWP 40R,C00,518783,Staff,6,0,20,14
1714606780816,MCWP 50R,A00,518791,Staff,0,0,20,20
1714606780816,MCWP 50R,B00,518792,Staff,0,2,20,20
1714606780816,MCWP 50R,C00,518793,Staff,0,2,20,20
1714606780816,MCWP 50R,D00,518794,Staff,0,0,20,20
1714606780816,MCWP 50R,E00,518795,Staff,0,2,20,20
1714606780816,MCWP 50R,F00,518796,Staff,0,0,20,20
1714606780816,MCWP 50R,G00,518797,Staff,0,1,20,20
1714606781840,MMW 12R,A01,514034,Herbst; Matthew,0,0,16,16
1714606781840,MMW 12R,A02,514035,Herbst; Matthew,1,0,16,15
1714606782869,MMW 13R,A01,514037,Staff,0,4,16,16
1714606782869,MMW 13R,A02,514039,Staff,0,2,16,16
1714606782869,MMW 13R,A03,628519,Staff,0,2,16,16
1714606784928,SIO 295LS,A00,523233,Staff,10,0,30,20
1714606785952,SIO 295S,A00,523232,Staff,10,0,30,20
1714606786978,SIOC 290S,A01,637330,Merrifield; Mark A,23,0,30,7
1714606788006,SIOC 291S,A01,637333,Gabriel; Corey John,23,0,30,7
1714606789033,SOCI 117,A01,494376,Staff,0,4,5,5
1714606790060,WES 237B,A00,494380,Staff,9,0,20,11
1714606792127,AESE 279B,A00,494370,Wade; Jon P,0,0,33,33
1714606793151,AIP 197,001,627712,Vespa; Emanuel Ignacio,9998,0,9999,1
1714606794176,ANAR 135S,A00,494369,Braswell; Geoffrey E.,0,0,0,0
1714606795204,BENG 196,001,628496,Engler; Adam J.,9998,0,9999,1
1714606796232,CAT 124RS,A01,519847,Geibel; William,0,0,20,20
1714606797259,CAT 125RS,A01,515971,Geibel; William,0,0,20,20
1714606798445,CLRE 250,A00,511389,Morris; Sheldon,9993,0,9999,6
1714606799472,CLRE 251,A00,507176,Mehta; Ravindra L.,9993,0,9999,6
1714606799472,CLRE 251,B00,511410,Mehta; Ravindra L.,9998,0,9999,1
1714606800496,CLRE 252,A00,507189,Cuomo; Raphael Eduardo,9995,0,9999,4
1714606801523,CLRE 253,A00,507199,Vaida; Florin,9994,0,9999,5
1714606801523,CLRE 253,B00,507202,Vaida; Florin,9999,0,9999,0
1714606802548,CLRE 259,A00,507211,Patel; Hemal,9996,0,9999,3
1714606803571,CLRE 260,A00,507221,Cuomo; Raphael Eduardo,9999,0,9999,0
1714606804596,CLRE 297,001,507242,Cuomo; Raphael Eduardo,9999,0,9999,0
1714606805622,COGS 197,001,638244,Voytek; Bradley Thomas,9998,0,9999,1
1714606806646,CSE 191,A00,516875,Minnes Kemp; Mor Mia,9993,0,9999,6
1714606807674,CSE 197,001,637388,Minnes Kemp; Mor Mia,9998,0,9999,1
1714606808702,CSS 201S,A01,494383,Staff,35,0,35,0
1714606809731,CSS 202S,A01,494387,Staff,35,0,35,0
1714606810758,DSC 197,001,628532,Eldridge; Justin Matthew,9996,0,9999,3
1714606811781,EAP 100,A00,516065,Staff,9797,0,9999,202
1714606812807,ECE 45,A01,507414,Staff,33,0,60,27
1714606814856,ECE 111,A01,507420,Staff,15,0,50,35
1714606815881,ECE 197,001,548057,Sievenpiper; Daniel F.,9993,0,9999,6
1714606816912,EDS 115,A00,507243,Choi; Bailey Miyeon,10,0,28,18
1714606817937,EDS 117,A01,494379,Staff,1,5,30,29
1714606818962,EDS 125,A00,507246,Hopkins; Megan Beth,9,0,30,21
1714606819988,EDS 128A,A01,507264,Fargason; Sharon Gayle,8,0,26,18
1714606821018,EDS 128B,A01,507293,Pappas; Elizabeth,12,0,30,18
1714606822044,EDS 139,A00,507294,Fargason; Sharon Gayle,13,0,30,17
1714606822044,EDS 139,B00,507313,Pappas; Elizabeth,13,0,30,17
1714606823069,EDS 201,A00,507315,Staff,13,0,30,17
1714606824095,EDS 203,A01,507317,Halter; Christopher P.,12,0,30,18
1714606825121,EDS 204R,A01,507319,Halter; Christopher P.,0,3,30,30
1714606825121,EDS 204R,B01,507331,Heinzman; Erica M.,16,0,30,14
1714606826148,EDS 206R,A00,507332,Staff,0,4,30,30
1714606826148,EDS 206R,B00,507343,Staff,17,0,30,13
1714606827175,EDS 250,A00,507344,Hemans; Patricia Ann Benitez,22,0,40,18
1714606828199,EDS 281,A00,507345,Daly; Alan J.,18,0,18,0
1714606829224,EDS 284,A00,507350,Daly; Alan J.,16,0,16,0
1714606830253,EDS 286,A00,507359,Fine; Sarah,18,0,18,0
1714606831276,EDS 289C,A01,507361,Daly; Alan J.,18,0,18,0
1714606832306,EDS 290,A00,507366,Hofstetter; Carolyn,15,0,15,0
1714606833337,LIGM 5A,A00,507421,Fischer-Grunski; Eva K,18,0,20,2
1714606834364,LIGM 5B,A00,507423,Fischer-Grunski; Eva K,19,0,20,1
1714606835389,LIGM 5C,A00,507425,Fischer-Grunski; Eva K,19,0,20,1
1714606836413,LIIT 5AS,A00,507427,Carnelos; Chiara,20,0,20,0
1714606837438,LIIT 5BS,A00,507430,Carnelos; Chiara,20,0,20,0
1714606838465,LIIT 5CS,A00,507432,Carnelos; Chiara,20,0,20,0
1714606839496,LISP 5A,A00,507541,Munoz Sanchez; Alicia,11,0,20,9
1714606840524,LISP 5B,A00,507671,Munoz Sanchez; Alicia,8,0,20,12
1714606841553,LISP 5C,A00,507696,Munoz Sanchez; Alicia,9,0,20,11
1714606842580,MAE 197,001,528363,Boechler; Nicholas Sebastia,9998,0,9999,1
1714606843607,MATH 197,001,523477,Kedlaya; Kiran S.,9995,0,9999,4
1714606843607,MATH 197,002,563811,Zhang; Danna,9995,0,9999,4
1714606843607,MATH 197,003,628552,Dumitriu; Ioana,9998,0,9999,1
1714606844737,MCWP 40R,A00,518780,Staff,2,0,20,18
1714606844737,MCWP 40R,B00,518781,Staff,8,0,20,12
1714606844737,MCWP 40R,C00,518783,Staff,6,0,20,14
1714606845766,MCWP 50R,A00,518791,Staff,0,0,20,20
1714606845766,MCWP 50R,B00,518792,Staff,0,2,20,20
1714606845766,MCWP 50R,C00,518793,Staff,0,2,20,20
1714606845766,MCWP 50R,D00,518794,Staff,0,0,20,20
1714606845766,MCWP 50R,E00,518795,Staff,0,2,20,20
1714606845766,MCWP 50R,F00,518796,Staff,0,0,20,20
1714606845766,MCWP 50R,G00,518797,Staff,0,1,20,20
1714606846790,MMW 12R,A01,514034,Herbst; Matthew,0,0,16,16
1714606846790,MMW 12R,A02,514035,Herbst; Matthew,1,0,16,15
1714606847815,MMW 13R,A01,514037,Staff,0,4,16,16
1714606847815,MMW 13R,A02,514039,Staff,0,2,16,16
1714606847815,MMW 13R,A03,628519,Staff,0,2,16,16
1714606849867,SIO 295LS,A00,523233,Staff,10,0,30,20
1714606850891,SIO 295S,A00,523232,Staff,10,0,30,20
1714606851917,SIOC 290S,A01,637330,Merrifield; Mark A,23,0,30,7
1714606852942,SIOC 291S,A01,637333,Gabriel; Corey John,23,0,30,7
1714606853968,SOCI 117,A01,494376,Staff,0,4,5,5
1714606854992,WES 237B,A00,494380,Staff,9,0,20,11
1714606857071,AESE 279B,A00,494370,Wade; Jon P,0,0,33,33
1714606858098,AIP 197,001,627712,Vespa; Emanuel Ignacio,9998,0,9999,1
1714606859123,ANAR 135S,A00,494369,Braswell; Geoffrey E.,0,0,0,0
1714606860148,BENG 196,001,628496,Engler; Adam J.,9998,0,9999,1
1714606861178,CAT 124RS,A01,519847,Geibel; William,0,0,20,20
1714606862202,CAT 125RS,A01,515971,Geibel; William,0,0,20,20
1714606863227,CLRE 250,A00,511389,Morris; Sheldon,9993,0,9999,6
1714606864254,CLRE 251,A00,507176,Mehta; Ravindra L.,9993,0,9999,6
1714606864254,CLRE 251,B00,511410,Mehta; Ravindra L.,9998,0,9999,1
1714606865282,CLRE 252,A00,507189,Cuomo; Raphael Eduardo,9995,0,9999,4
1714606866311,CLRE 253,A00,507199,Vaida; Florin,9994,0,9999,5
1714606866311,CLRE 253,B00,507202,Vaida; Florin,9999,0,9999,0
1714606867336,CLRE 259,A00,507211,Patel; Hemal,9996,0,9999,3
1714606868363,CLRE 260,A00,507221,Cuomo; Raphael Eduardo,9999,0,9999,0
1714606869388,CLRE 297,001,507242,Cuomo; Raphael Eduardo,9999,0,9999,0
1714606870475,COGS 197,001,638244,Voytek; Bradley Thomas,9998,0,9999,1
1714606871500,CSE 191,A00,516875,Minnes Kemp; Mor Mia,9993,0,9999,6
1714606872524,CSE 197,001,637388,Minnes Kemp; Mor Mia,9998,0,9999,1
1714606873556,CSS 201S,A01,494383,Staff,35,0,35,0
1714606874580,CSS 202S,A01,494387,Staff,35,0,35,0
1714606875605,DSC 197,001,628532,Eldridge; Justin Matthew,9996,0,9999,3
1714606876631,EAP 100,A00,516065,Staff,9797,0,9999,202
1714606877657,ECE 45,A01,507414,Staff,33,0,60,27
1714606879708,ECE 111,A01,507420,Staff,15,0,50,35
1714606880736,ECE 197,001,548057,Sievenpiper; Daniel F.,9993,0,9999,6
1714606881763,EDS 115,A00,507243,Choi; Bailey Miyeon,10,0,28,18
1714606882791,EDS 117,A01,494379,Staff,1,5,30,29
1714606883816,EDS 125,A00,507246,Hopkins; Megan Beth,9,0,30,21
1714606884842,EDS 128A,A01,507264,Fargason; Sharon Gayle,8,0,26,18
1714606885869,EDS 128B,A01,507293,Pappas; Elizabeth,12,0,30,18
1714606886896,EDS 139,A00,507294,Fargason; Sharon Gayle,13,0,30,17
1714606886896,EDS 139,B00,507313,Pappas; Elizabeth,13,0,30,17
1714606887923,EDS 201,A00,507315,Staff,13,0,30,17
1714606888948,EDS 203,A01,507317,Halter; Christopher P.,12,0,30,18
1714606889977,EDS 204R,A01,507319,Halter; Christopher P.,0,3,30,30
1714606889977,EDS 204R,B01,507331,Heinzman; Erica M.,16,0,30,14
1714606891002,EDS 206R,A00,507332,Staff,0,4,30,30
1714606891002,EDS 206R,B00,507343,Staff,17,0,30,13
1714606892027,EDS 250,A00,507344,Hemans; Patricia Ann Benitez,22,0,40,18
1714606893053,EDS 281,A00,507345,Daly; Alan J.,18,0,18,0
1714606894079,EDS 284,A00,507350,Daly; Alan J.,16,0,16,0
1714606895104,EDS 286,A00,507359,Fine; Sarah,18,0,18,0
1714606896129,EDS 289C,A01,507361,Daly; Alan J.,18,0,18,0
1714606897158,EDS 290,A00,507366,Hofstetter; Carolyn,15,0,15,0
1714606898184,LIGM 5A,A00,507421,Fischer-Grunski; Eva K,18,0,20,2
1714606899213,LIGM 5B,A00,507423,Fischer-Grunski; Eva K,19,0,20,1
1714606900292,LIGM 5C,A00,507425,Fischer-Grunski; Eva K,19,0,20,1
1714606901318,LIIT 5AS,A00,507427,Carnelos; Chiara,20,0,20,0
1714606902343,LIIT 5BS,A00,507430,Carnelos; Chiara,20,0,20,0
1714606903368,LIIT 5CS,A00,507432,Carnelos; Chiara,20,0,20,0
1714606904398,LISP 5A,A00,507541,Munoz Sanchez; Alicia,11,0,20,9
1714606905424,LISP 5B,A00,507671,Munoz Sanchez; Alicia,8,0,20,12
1714606906453,LISP 5C,A00,507696,Munoz Sanchez; Alicia,9,0,20,11
1714606907478,MAE 197,001,528363,Boechler; Nicholas Sebastia,9998,0,9999,1
1714606908510,MATH 197,001,523477,Kedlaya; Kiran S.,9995,0,9999,4
1714606908510,MATH 197,002,563811,Zhang; Danna,9995,0,9999,4
1714606908510,MATH 197,003,628552,Dumitriu; Ioana,9998,0,9999,1
1714606909535,MCWP 40R,A00,518780,Staff,2,0,20,18
1714606909535,MCWP 40R,B00,518781,Staff,8,0,20,12
1714606909535,MCWP 40R,C00,518783,Staff,6,0,20,14
1714606910559,MCWP 50R,A00,518791,Staff,0,0,20,20
1714606910559,MCWP 50R,B00,518792,Staff,0,2,20,20
1714606910559,MCWP 50R,C00,518793,Staff,0,2,20,20
1714606910559,MCWP 50R,D00,518794,Staff,0,0,20,20
1714606910559,MCWP 50R,E00,518795,Staff,0,2,20,20
1714606910559,MCWP 50R,F00,518796,Staff,0,0,20,20
1714606910559,MCWP 50R,G00,518797,Staff,0,1,20,20
1714606911586,MMW 12R,A01,514034,Herbst; Matthew,0,0,16,16
1714606911586,MMW 12R,A02,514035,Herbst; Matthew,1,0,16,15
1714606912612,MMW 13R,A01,514037,Staff,0,4,16,16
1714606912612,MMW 13R,A02,514039,Staff,0,2,16,16
1714606912612,MMW 13R,A03,628519,Staff,0,2,16,16
1714606914667,SIO 295LS,A00,523233,Staff,10,0,30,20
1714606915690,SIO 295S,A00,523232,Staff,10,0,30,20
1714606916720,SIOC 290S,A01,637330,Merrifield; Mark A,23,0,30,7
1714606917745,SIOC 291S,A01,637333,Gabriel; Corey John,23,0,30,7
1714606918774,SOCI 117,A01,494376,Staff,0,4,5,5
1714606919799,WES 237B,A00,494380,Staff,9,0,20,11
1714606921866,AESE 279B,A00,494370,Wade; Jon P,0,0,33,33
1714606922894,AIP 197,001,627712,Vespa; Emanuel Ignacio,9998,0,9999,1
1714606923923,ANAR 135S,A00,494369,Braswell; Geoffrey E.,0,0,0,0
1714606924952,BENG 196,001,628496,Engler; Adam J.,9998,0,9999,1
1714606925981,CAT 124RS,A01,519847,Geibel; William,0,0,20,20
1714606927008,CAT 125RS,A01,515971,Geibel; William,0,0,20,20
1714606928040,CLRE 250,A00,511389,Morris; Sheldon,9993,0,9999,6
1714606929071,CLRE 251,A00,507176,Mehta; Ravindra L.,9993,0,9999,6
1714606929071,CLRE 251,B00,511410,Mehta; Ravindra L.,9998,0,9999,1
1714606930099,CLRE 252,A00,507189,Cuomo; Raphael Eduardo,9995,0,9999,4
1714606931129,CLRE 253,A00,507199,Vaida; Florin,9994,0,9999,5
1714606931129,CLRE 253,B00,507202,Vaida; Florin,9999,0,9999,0
1714606932156,CLRE 259,A00,507211,Patel; Hemal,9996,0,9999,3
1714606933185,CLRE 260,A00,507221,Cuomo; Raphael Eduardo,9999,0,9999,0
1714606934210,CLRE 297,001,507242,Cuomo; Raphael Eduardo,9999,0,9999,0
1714606935236,COGS 197,001,638244,Voytek; Bradley Thomas,9998,0,9999,1
1714606936262,CSE 191,A00,516875,Minnes Kemp; Mor Mia,9993,0,9999,6
1714606937293,CSE 197,001,637388,Minnes Kemp; Mor Mia,9998,0,9999,1
1714606938319,CSS 201S,A01,494383,Staff,35,0,35,0
1714606939348,CSS 202S,A01,494387,Staff,35,0,35,0
1714606940374,DSC 197,001,628532,Eldridge; Justin Matthew,9996,0,9999,3
1714606941400,EAP 100,A00,516065,Staff,9797,0,9999,202
1714606942429,ECE 45,A01,507414,Staff,33,0,60,27
1714606944479,ECE 111,A01,507420,Staff,15,0,50,35
1714606945503,ECE 197,001,548057,Sievenpiper; Daniel F.,9993,0,9999,6
1714606946534,EDS 115,A00,507243,Choi; Bailey Miyeon,10,0,28,18
1714606947563,EDS 117,A01,494379,Staff,1,5,30,29
1714606948589,EDS 125,A00,507246,Hopkins; Megan Beth,9,0,30,21
1714606949615,EDS 128A,A01,507264,Fargason; Sharon Gayle,8,0,26,18
1714606950644,EDS 128B,A01,507293,Pappas; Elizabeth,12,0,30,18
1714606951668,EDS 139,A00,507294,Fargason; Sharon Gayle,13,0,30,17
1714606951668,EDS 139,B00,507313,Pappas; Elizabeth,13,0,30,17
1714606952696,EDS 201,A00,507315,Staff,13,0,30,17
1714606953721,EDS 203,A01,507317,Halter; Christopher P.,12,0,30,18
1714606954748,EDS 204R,A01,507319,Halter; Christopher P.,0,3,30,30
1714606954748,EDS 204R,B01,507331,Heinzman; Erica M.,16,0,30,14
1714606955775,EDS 206R,A00,507332,Staff,0,4,30,30
1714606955775,EDS 206R,B00,507343,Staff,17,0,30,13
1714606956800,EDS 250,A00,507344,Hemans; Patricia Ann Benitez,22,0,40,18
1714606957829,EDS 281,A00,507345,Daly; Alan J.,18,0,18,0
1714606958855,EDS 284,A00,507350,Daly; Alan J.,16,0,16,0
1714606959883,EDS 286,A00,507359,Fine; Sarah,18,0,18,0
1714606960910,EDS 289C,A01,507361,Daly; Alan J.,18,0,18,0
1714606961941,EDS 290,A00,507366,Hofstetter; Carolyn,15,0,15,0
1714606962968,LIGM 5A,A00,507421,Fischer-Grunski; Eva K,18,0,20,2
1714606963996,LIGM 5B,A00,507423,Fischer-Grunski; Eva K,19,0,20,1
1714606965020,LIGM 5C,A00,507425,Fischer-Grunski; Eva K,19,0,20,1
1714606966045,LIIT 5AS,A00,507427,Carnelos; Chiara,20,0,20,0
1714606967072,LIIT 5BS,A00,507430,Carnelos; Chiara,20,0,20,0
1714606968101,LIIT 5CS,A00,507432,Carnelos; Chiara,20,0,20,0
1714606969129,LISP 5A,A00,507541,Munoz Sanchez; Alicia,11,0,20,9
1714606970155,LISP 5B,A00,507671,Munoz Sanchez; Alicia,8,0,20,12
1714606971185,LISP 5C,A00,507696,Munoz Sanchez; Alicia,9,0,20,11
1714606972211,MAE 197,001,528363,Boechler; Nicholas Sebastia,9998,0,9999,1
1714606973240,MATH 197,001,523477,Kedlaya; Kiran S.,9995,0,9999,4
1714606973240,MATH 197,002,563811,Zhang; Danna,9995,0,9999,4
1714606973240,MATH 197,003,628552,Dumitriu; Ioana,9998,0,9999,1
1714606974265,MCWP 40R,A00,518780,Staff,2,0,20,18
1714606974265,MCWP 40R,B00,518781,Staff,8,0,20,12
1714606974265,MCWP 40R,C00,518783,Staff,6,0,20,14
1714606975291,MCWP 50R,A00,518791,Staff,0,0,20,20
1714606975291,MCWP 50R,B00,518792,Staff,0,2,20,20
1714606975291,MCWP 50R,C00,518793,Staff,0,2,20,20
1714606975291,MCWP 50R,D00,518794,Staff,0,0,20,20
1714606975291,MCWP 50R,E00,518795,Staff,0,2,20,20
1714606975291,MCWP 50R,F00,518796,Staff,0,0,20,20
1714606975291,MCWP 50R,G00,518797,Staff,0,1,20,20
1714606976320,MMW 12R,A01,514034,Herbst; Matthew,0,0,16,16
1714606976320,MMW 12R,A02,514035,Herbst; Matthew,1,0,16,15
1714606977346,MMW 13R,A01,514037,Staff,0,4,16,16
1714606977346,MMW 13R,A02,514039,Staff,0,2,16,16
1714606977346,MMW 13R,A03,628519,Staff,0,2,16,16
1714606979401,SIO 295LS,A00,523233,Staff,10,0,30,20
1714606980431,SIO 295S,A00,523232,Staff,10,0,30,20
1714606981459,SIOC 290S,A01,637330,Merrifield; Mark A,23,0,30,7
1714606982490,SIOC 291S,A01,637333,Gabriel; Corey John,23,0,30,7
1714606983520,SOCI 117,A01,494376,Staff,0,4,5,5
1714606984547,WES 237B,A00,494380,Staff,9,0,20,11
1714606986617,AESE 279B,A00,494370,Wade; Jon P,0,0,33,33
1714606987643,AIP 197,001,627712,Vespa; Emanuel Ignacio,9998,0,9999,1
1714606988671,ANAR 135S,A00,494369,Braswell; Geoffrey E.,0,0,0,0
1714606989696,BENG 196,001,628496,Engler; Adam J.,9998,0,9999,1
1714606990722,CAT 124RS,A01,519847,Geibel; William,0,0,20,20
1714606991751,CAT 125RS,A01,515971,Geibel; William,0,0,20,20
1714606992776,CLRE 250,A00,511389,Morris; Sheldon,9993,0,9999,6
1714606993810,CLRE 251,A00,507176,Mehta; Ravindra L.,9993,0,9999,6
1714606993810,CLRE 251,B00,511410,Mehta; Ravindra L.,9998,0,9999,1
1714606994835,CLRE 252,A00,507189,Cuomo; Raphael Eduardo,9995,0,9999,4
1714606995860,CLRE 253,A00,507199,Vaida; Florin,9994,0,9999,5
1714606995860,CLRE 253,B00,507202,Vaida; Florin,9999,0,9999,0
1714606996889,CLRE 259,A00,507211,Patel; Hemal,9996,0,9999,3
1714606997917,CLRE 260,A00,507221,Cuomo; Raphael Eduardo,9999,0,9999,0
1714606998941,CLRE 297,001,507242,Cuomo; Raphael Eduardo,9999,0,9999,0
1714606999967,COGS 197,001,638244,Voytek; Bradley Thomas,9998,0,9999,1
1714607000991,CSE 191,A00,516875,Minnes Kemp; Mor Mia,9993,0,9999,6
1714607002020,CSE 197,001,637388,Minnes Kemp; Mor Mia,9998,0,9999,1
1714607003046,CSS 201S,A01,494383,Staff,35,0,35,0
1714607004074,CSS 202S,A01,494387,Staff,35,0,35,0
1714607005098,DSC 197,001,628532,Eldridge; Justin Matthew,9996,0,9999,3
1714607006125,EAP 100,A00,516065,Staff,9797,0,9999,202
1714607007151,ECE 45,A01,507414,Staff,33,0,60,27
1714607009201,ECE 111,A01,507420,Staff,15,0,50,35
1714607010230,ECE 197,001,548057,Sievenpiper; Daniel F.,9993,0,9999,6
1714607011256,EDS 115,A00,507243,Choi; Bailey Miyeon,10,0,28,18
1714607012282,EDS 117,A01,494379,Staff,1,5,30,29
1714607013307,EDS 125,A00,507246,Hopkins; Megan Beth,9,0,30,21
1714607014337,EDS 128A,A01,507264,Fargason; Sharon Gayle,8,0,26,18
1714607015363,EDS 128B,A01,507293,Pappas; Elizabeth,12,0,30,18
1714607016387,EDS 139,A00,507294,Fargason; Sharon Gayle,13,0,30,17
1714607016387,EDS 139,B00,507313,Pappas; Elizabeth,13,0,30,17
1714607017413,EDS 201,A00,507315,Staff,13,0,30,17
1714607018442,EDS 203,A01,507317,Halter; Christopher P.,12,0,30,18
1714607019467,EDS 204R,A01,507319,Halter; Christopher P.,0,3,30,30
1714607019467,EDS 204R,B01,507331,Heinzman; Erica M.,16,0,30,14
1714607020493,EDS 206R,A00,507332,Staff,0,4,30,30
1714607020493,EDS 206R,B00,507343,Staff,17,0,30,13
1714607021518,EDS 250,A00,507344,Hemans; Patricia Ann Benitez,22,0,40,18
1714607022547,EDS 281,A00,507345,Daly; Alan J.,18,0,18,0
1714607023572,EDS 284,A00,507350,Daly; Alan J.,16,0,16,0
1714607024602,EDS 286,A00,507359,Fine; Sarah,18,0,18,0
1714607025626,EDS 289C,A01,507361,Daly; Alan J.,18,0,18,0
1714607026654,EDS 290,A00,507366,Hofstetter; Carolyn,15,0,15,0
1714607027686,LIGM 5A,A00,507421,Fischer-Grunski; Eva K,18,0,20,2
1714607028713,LIGM 5B,A00,507423,Fischer-Grunski; Eva K,19,0,20,1
1714607029736,LIGM 5C,A00,507425,Fischer-Grunski; Eva K,19,0,20,1
1714607030760,LIIT 5AS,A00,507427,Carnelos; Chiara,20,0,20,0
1714607031785,LIIT 5BS,A00,507430,Carnelos; Chiara,20,0,20,0
1714607032810,LIIT 5CS,A00,507432,Carnelos; Chiara,20,0,20,0
1714607033834,LISP 5A,A00,507541,Munoz Sanchez; Alicia,11,0,20,9
1714607034862,LISP 5B,A00,507671,Munoz Sanchez; Alicia,8,0,20,12
1714607035893,LISP 5C,A00,507696,Munoz Sanchez; Alicia,9,0,20,11
1714607036918,MAE 197,001,528363,Boechler; Nicholas Sebastia,9998,0,9999,1
1714607037946,MATH 197,001,523477,Kedlaya; Kiran S.,9995,0,9999,4
1714607037946,MATH 197,002,563811,Zhang; Danna,9995,0,9999,4
1714607037946,MATH 197,003,628552,Dumitriu; Ioana,9998,0,9999,1
1714607038974,MCWP 40R,A00,518780,Staff,2,0,20,18
1714607038974,MCWP 40R,B00,518781,Staff,8,0,20,12
1714607038974,MCWP 40R,C00,518783,Staff,6,0,20,14
1714607039998,MCWP 50R,A00,518791,Staff,0,0,20,20
1714607039998,MCWP 50R,B00,518792,Staff,0,2,20,20
1714607039998,MCWP 50R,C00,518793,Staff,0,2,20,20
1714607039998,MCWP 50R,D00,518794,Staff,0,0,20,20
1714607039998,MCWP 50R,E00,518795,Staff,0,2,20,20
1714607039998,MCWP 50R,F00,518796,Staff,0,0,20,20
1714607039998,MCWP 50R,G00,518797,Staff,0,1,20,20
1714607041026,MMW 12R,A01,514034,Herbst; Matthew,0,0,16,16
1714607041026,MMW 12R,A02,514035,Herbst; Matthew,1,0,16,15
1714607042055,MMW 13R,A01,514037,Staff,0,4,16,16
1714607042055,MMW 13R,A02,514039,Staff,0,2,16,16
1714607042055,MMW 13R,A03,628519,Staff,0,2,16,16
1714607044104,SIO 295LS,A00,523233,Staff,10,0,30,20
1714607045130,SIO 295S,A00,523232,Staff,10,0,30,20
1714607046156,SIOC 290S,A01,637330,Merrifield; Mark A,23,0,30,7
1714607047183,SIOC 291S,A01,637333,Gabriel; Corey John,23,0,30,7
1714607048207,SOCI 117,A01,494376,Staff,0,4,5,5
1714607049232,WES 237B,A00,494380,Staff,9,0,20,11
1714607051313,AESE 279B,A00,494370,Wade; Jon P,0,0,33,33
1714607052343,AIP 197,001,627712,Vespa; Emanuel Ignacio,9998,0,9999,1
1714607053370,ANAR 135S,A00,494369,Braswell; Geoffrey E.,0,0,0,0
1714607054395,BENG 196,001,628496,Engler; Adam J.,9998,0,9999,1
1714607055422,CAT 124RS,A01,519847,Geibel; William,0,0,20,20
1714607056449,CAT 125RS,A01,515971,Geibel; William,0,0,20,20
1714607057477,CLRE 250,A00,511389,Morris; Sheldon,9993,0,9999,6
1714607058503,CLRE 251,A00,507176,Mehta; Ravindra L.,9993,0,9999,6
1714607058503,CLRE 251,B00,511410,Mehta; Ravindra L.,9998,0,9999,1
1714607059531,CLRE 252,A00,507189,Cuomo; Raphael Eduardo,9995,0,9999,4
1714607060556,CLRE 253,A00,507199,Vaida; Florin,9994,0,9999,5
1714607060556,CLRE 253,B00,507202,Vaida; Florin,9999,0,9999,0
1714607061582,CLRE 259,A00,507211,Patel; Hemal,9996,0,9999,3
1714607062608,CLRE 260,A00,507221,Cuomo; Raphael Eduardo,9999,0,9999,0
1714607063632,CLRE 297,001,507242,Cuomo; Raphael Eduardo,9999,0,9999,0
1714607064661,COGS 197,001,638244,Voytek; Bradley Thomas,9998,0,9999,1
1714607065686,CSE 191,A00,516875,Minnes Kemp; Mor Mia,9993,0,9999,6
1714607066710,CSE 197,001,637388,Minnes Kemp; Mor Mia,9998,0,9999,1
1714607067734,CSS 201S,A01,494383,Staff,35,0,35,0
1714607068762,CSS 202S,A01,494387,Staff,35,0,35,0
1714607069787,DSC 197,001,628532,Eldridge; Justin Matthew,9996,0,9999,3
1714607070815,EAP 100,A00,516065,Staff,9797,0,9999,202
1714607071840,ECE 45,A01,507414,Staff,33,0,60,27
1714607073892,ECE 111,A01,507420,Staff,15,0,50,35
1714607074921,ECE 197,001,548057,Sievenpiper; Daniel F.,9993,0,9999,6
1714607075947,EDS 115,A00,507243,Choi; Bailey Miyeon,10,0,28,18
1714607076974,EDS 117,A01,494379,Staff,1,5,30,29
1714607077998,EDS 125,A00,507246,Hopkins; Megan Beth,9,0,30,21
1714607079023,EDS 128A,A01,507264,Fargason; Sharon Gayle,8,0,26,18
1714607080049,EDS 128B,A01,507293,Pappas; Elizabeth,12,0,30,18
1714607081136,EDS 139,A00,507294,Fargason; Sharon Gayle,13,0,30,17
1714607081136,EDS 139,B00,507313,Pappas; Elizabeth,13,0,30,17
1714607082162,EDS 201,A00,507315,Staff,13,0,30,17
1714607083190,EDS 203,A01,507317,Halter; Christopher P.,12,0,30,18
1714607084217,EDS 204R,A01,507319,Halter; Christopher P.,0,3,30,30
1714607084217,EDS 204R,B01,507331,Heinzman; Erica M.,16,0,30,14
1714607085244,EDS 206R,A00,507332,Staff,0,4,30,30
1714607085244,EDS 206R,B00,507343,Staff,17,0,30,13
1714607086270,EDS 250,A00,507344,Hemans; Patricia Ann Benitez,22,0,40,18
1714607087294,EDS 281,A00,507345,Daly; Alan J.,18,0,18,0
1714607088319,EDS 284,A00,507350,Daly; Alan J.,16,0,16,0
1714607089348,EDS 286,A00,507359,Fine; Sarah,18,0,18,0
1714607090376,EDS 289C,A01,507361,Daly; Alan J.,18,0,18,0
1714607091404,EDS 290,A00,507366,Hofstetter; Carolyn,15,0,15,0
1714607092431,LIGM 5A,A00,507421,Fischer-Grunski; Eva K,18,0,20,2
1714607093457,LIGM 5B,A00,507423,Fischer-Grunski; Eva K,19,0,20,1
1714607094482,LIGM 5C,A00,507425,Fischer-Grunski; Eva K,19,0,20,1
1714607095509,LIIT 5AS,A00,507427,Carnelos; Chiara,20,0,20,0
1714607096536,LIIT 5BS,A00,507430,Carnelos; Chiara,20,0,20,0
1714607097565,LIIT 5CS,A00,507432,Carnelos; Chiara,20,0,20,0
1714607098589,LISP 5A,A00,507541,Munoz Sanchez; Alicia,11,0,20,9
1714607099615,LISP 5B,A00,507671,Munoz Sanchez; Alicia,8,0,20,12
1714607100639,LISP 5C,A00,507696,Munoz Sanchez; Alicia,9,0,20,11
1714607101664,MAE 197,001,528363,Boechler; Nicholas Sebastia,9998,0,9999,1
1714607102690,MATH 197,001,523477,Kedlaya; Kiran S.,9995,0,9999,4
1714607102690,MATH 197,002,563811,Zhang; Danna,9995,0,9999,4
1714607102690,MATH 197,003,628552,Dumitriu; Ioana,9998,0,9999,1
1714607103714,MCWP 40R,A00,518780,Staff,2,0,20,18
1714607103714,MCWP 40R,B00,518781,Staff,8,0,20,12
1714607103714,MCWP 40R,C00,518783,Staff,6,0,20,14
1714607104738,MCWP 50R,A00,518791,Staff,0,0,20,20
1714607104738,MCWP 50R,B00,518792,Staff,0,2,20,20
1714607104738,MCWP 50R,C00,518793,Staff,0,2,20,20
1714607104738,MCWP 50R,D00,518794,Staff,0,0,20,20
1714607104738,MCWP 50R,E00,518795,Staff,0,2,20,20
1714607104738,MCWP 50R,F00,518796,Staff,0,0,20,20
1714607104738,MCWP 50R,G00,518797,Staff,0,1,20,20
1714607105765,MMW 12R,A01,514034,Herbst; Matthew,0,0,16,16
1714607105765,MMW 12R,A02,514035,Herbst; Matthew,1,0,16,15
1714607106790,MMW 13R,A01,514037,Staff,0,4,16,16
1714607106790,MMW 13R,A02,514039,Staff,0,2,16,16
1714607106790,MMW 13R,A03,628519,Staff,0,2,16,16
1714607108838,SIO 295LS,A00,523233,Staff,10,0,30,20
1714607109863,SIO 295S,A00,523232,Staff,10,0,30,20
1714607110888,SIOC 290S,A01,637330,Merrifield; Mark A,23,0,30,7
1714607111913,SIOC 291S,A01,637333,Gabriel; Corey John,23,0,30,7
1714607112937,SOCI 117,A01,494376,Staff,0,4,5,5
1714607113963,WES 237B,A00,494380,Staff,9,0,20,11
1714607116072,AESE 279B,A00,494370,Wade; Jon P,0,0,33,33
1714607117097,AIP 197,001,627712,Vespa; Emanuel Ignacio,9998,0,9999,1
1714607118126,ANAR 135S,A00,494369,Braswell; Geoffrey E.,0,0,0,0
1714607119155,BENG 196,001,628496,Engler; Adam J.,9998,0,9999,1
1714607120183,CAT 124RS,A01,519847,Geibel; William,0,0,20,20
1714607121207,CAT 125RS,A01,515971,Geibel; William,0,0,20,20
1714607122237,CLRE 250,A00,511389,Morris; Sheldon,9993,0,9999,6
1714607123269,CLRE 251,A00,507176,Mehta; Ravindra L.,9993,0,9999,6
1714607123269,CLRE 251,B00,511410,Mehta; Ravindra L.,9998,0,9999,1
1714607124296,CLRE 252,A00,507189,Cuomo; Raphael Eduardo,9995,0,9999,4
1714607125322,CLRE 253,A00,507199,Vaida; Florin,9994,0,9999,5
1714607125322,CLRE 253,B00,507202,Vaida; Florin,9999,0,9999,0
1714607126346,CLRE 259,A00,507211,Patel; Hemal,9996,0,9999,3
1714607127374,CLRE 260,A00,507221,Cuomo; Raphael Eduardo,9999,0,9999,0
1714607128401,CLRE 297,001,507242,Cuomo; Raphael Eduardo,9999,0,9999,0
1714607129429,COGS 197,001,638244,Voytek; Bradley Thomas,9998,0,9999,1
1714607130454,CSE 191,A00,516875,Minnes Kemp; Mor Mia,9993,0,9999,6
1714607131479,CSE 197,001,637388,Minnes Kemp; Mor Mia,9998,0,9999,1
1714607132505,CSS 201S,A01,494383,Staff,35,0,35,0
1714607133530,CSS 202S,A01,494387,Staff,35,0,35,0
1714607134554,DSC 197,001,628532,Eldridge; Justin Matthew,9996,0,9999,3
1714607135579,EAP 100,A00,516065,Staff,9797,0,9999,202
1714607136608,ECE 45,A01,507414,Staff,33,0,60,27
1714607138658,ECE 111,A01,507420,Staff,15,0,50,35
1714607139682,ECE 197,001,548057,Sievenpiper; Daniel F.,9993,0,9999,6
1714607140709,EDS 115,A00,507243,Choi; Bailey Miyeon,10,0,28,18
1714607141732,EDS 117,A01,494379,Staff,1,5,30,29
1714607142757,EDS 125,A00,507246,Hopkins; Megan Beth,9,0,30,21
1714607143787,EDS 128A,A01,507264,Fargason; Sharon Gayle,8,0,26,18
1714607144815,EDS 128B,A01,507293,Pappas; Elizabeth,12,0,30,18
1714607145840,EDS 139,A00,507294,Fargason; Sharon Gayle,13,0,30,17
1714607145840,EDS 139,B00,507313,Pappas; Elizabeth,13,0,30,17
1714607146865,EDS 201,A00,507315,Staff,13,0,30,17
1714607147892,EDS 203,A01,507317,Halter; Christopher P.,12,0,30,18
1714607148918,EDS 204R,A01,507319,Halter; Christopher P.,0,3,30,30
1714607148918,EDS 204R,B01,507331,Heinzman; Erica M.,16,0,30,14
1714607149943,EDS 206R,A00,507332,Staff,0,4,30,30
1714607149943,EDS 206R,B00,507343,Staff,17,0,30,13
1714607150968,EDS 250,A00,507344,Hemans; Patricia Ann Benitez,22,0,40,18
1714607151994,EDS 281,A00,507345,Daly; Alan J.,18,0,18,0
1714607153027,EDS 284,A00,507350,Daly; Alan J.,16,0,16,0
1714607154055,EDS 286,A00,507359,Fine; Sarah,18,0,18,0
1714607155082,EDS 289C,A01,507361,Daly; Alan J.,18,0,18,0
1714607156109,EDS 290,A00,507366,Hofstetter; Carolyn,15,0,15,0
1714607157135,LIGM 5A,A00,507421,Fischer-Grunski; Eva K,18,0,20,2
1714607158161,LIGM 5B,A00,507423,Fischer-Grunski; Eva K,19,0,20,1
1714607159188,LIGM 5C,A00,507425,Fischer-Grunski; Eva K,19,0,20,1
1714607160211,LIIT 5AS,A00,507427,Carnelos; Chiara,20,0,20,0
1714607161239,LIIT 5BS,A00,507430,Carnelos; Chiara,20,0,20,0
1714607162270,LIIT 5CS,A00,507432,Carnelos; Chiara,20,0,20,0
1714607163298,LISP 5A,A00,507541,Munoz Sanchez; Alicia,11,0,20,9
1714607164323,LISP 5B,A00,507671,Munoz Sanchez; Alicia,8,0,20,12
1714607165353,LISP 5C,A00,507696,Munoz Sanchez; Alicia,9,0,20,11
1714607166378,MAE 197,001,528363,Boechler; Nicholas Sebastia,9998,0,9999,1
1714607167407,MATH 197,001,523477,Kedlaya; Kiran S.,9995,0,9999,4
1714607167407,MATH 197,002,563811,Zhang; Danna,9995,0,9999,4
1714607167407,MATH 197,003,628552,Dumitriu; Ioana,9998,0,9999,1
1714607168435,MCWP 40R,A00,518780,Staff,2,0,20,18
1714607168435,MCWP 40R,B00,518781,Staff,8,0,20,12
1714607168435,MCWP 40R,C00,518783,Staff,6,0,20,14
1714607169459,MCWP 50R,A00,518791,Staff,0,0,20,20
1714607169459,MCWP 50R,B00,518792,Staff,0,2,20,20
1714607169459,MCWP 50R,C00,518793,Staff,0,2,20,20
1714607169459,MCWP 50R,D00,518794,Staff,0,0,20,20
1714607169459,MCWP 50R,E00,518795,Staff,0,2,20,20
1714607169459,MCWP 50R,F00,518796,Staff,0,0,20,20
1714607169459,MCWP 50R,G00,518797,Staff,0,1,20,20
1714607170483,MMW 12R,A01,514034,Herbst; Matthew,0,0,16,16
1714607170483,MMW 12R,A02,514035,Herbst; Matthew,1,0,16,15
1714607171507,MMW 13R,A01,514037,Staff,0,4,16,16
1714607171507,MMW 13R,A02,514039,Staff,0,2,16,16
1714607171507,MMW 13R,A03,628519,Staff,0,2,16,16
1714607173556,SIO 295LS,A00,523233,Staff,10,0,30,20
1714607174585,SIO 295S,A00,523232,Staff,10,0,30,20
1714607175616,SIOC 290S,A01,637330,Merrifield; Mark A,23,0,30,7
1714607176643,SIOC 291S,A01,637333,Gabriel; Corey John,23,0,30,7
1714607177670,SOCI 117,A01,494376,Staff,0,4,5,5
1714607178695,WES 237B,A00,494380,Staff,9,0,20,11
1714607180758,AESE 279B,A00,494370,Wade; Jon P,0,0,33,33
1714607181784,AIP 197,001,627712,Vespa; Emanuel Ignacio,9998,0,9999,1
1714607182810,ANAR 135S,A00,494369,Braswell; Geoffrey E.,0,0,0,0
1714607183869,BENG 196,001,628496,Engler; Adam J.,9998,0,9999,1
1714607184899,CAT 124RS,A01,519847,Geibel; William,0,0,20,20
1714607185924,CAT 125RS,A01,515971,Geibel; William,0,0,20,20
1714607186953,CLRE 250,A00,511389,Morris; Sheldon,9993,0,9999,6
1714607187980,CLRE 251,A00,507176,Mehta; Ravindra L.,9993,0,9999,6
1714607187980,CLRE 251,B00,511410,Mehta; Ravindra L.,9998,0,9999,1
1714607189004,CLRE 252,A00,507189,Cuomo; Raphael Eduardo,9995,0,9999,4
1714607190033,CLRE 253,A00,507199,Vaida; Florin,9994,0,9999,5
1714607190033,CLRE 253,B00,507202,Vaida; Florin,9999,0,9999,0
1714607191063,CLRE 259,A00,507211,Patel; Hemal,9996,0,9999,3
1714607192088,CLRE 260,A00,507221,Cuomo; Raphael Eduardo,9999,0,9999,0
1714607193115,CLRE 297,001,507242,Cuomo; Raphael Eduardo,9999,0,9999,0
1714607194140,COGS 197,001,638244,Voytek; Bradley Thomas,9998,0,9999,1
1714607195169,CSE 191,A00,516875,Minnes Kemp; Mor Mia,9993,0,9999,6
1714607196196,CSE 197,001,637388,Minnes Kemp; Mor Mia,9998,0,9999,1
1714607197221,CSS 201S,A01,494383,Staff,35,0,35,0
1714607198250,CSS 202S,A01,494387,Staff,35,0,35,0
1714607199275,DSC 197,001,628532,Eldridge; Justin Matthew,9996,0,9999,3
1714607200299,EAP 100,A00,516065,Staff,9797,0,9999,202
1714607201326,ECE 45,A01,507414,Staff,33,0,60,27
1714607203381,ECE 111,A01,507420,Staff,15,0,50,35
1714607204405,ECE 197,001,548057,Sievenpiper; Daniel F.,9993,0,9999,6
1714607205435,EDS 115,A00,507243,Choi; Bailey Miyeon,10,0,28,18
1714607206460,EDS 117,A01,494379,Staff,1,5,30,29
1714607207490,EDS 125,A00,507246,Hopkins; Megan Beth,9,0,30,21
1714607208517,EDS 128A,A01,507264,Fargason; Sharon Gayle,8,0,26,18
1714607209543,EDS 128B,A01,507293,Pappas; Elizabeth,12,0,30,18
1714607210568,EDS 139,A00,507294,Fargason; Sharon Gayle,13,0,30,17
1714607210568,EDS 139,B00,507313,Pappas; Elizabeth,13,0,30,17
1714607211596,EDS 201,A00,507315,Staff,13,0,30,17
1714607212625,EDS 203,A01,507317,Halter; Christopher P.,12,0,30,18
1714607213650,EDS 204R,A01,507319,Halter; Christopher P.,0,3,30,30
1714607213650,EDS 204R,B01,507331,Heinzman; Erica M.,16,0,30,14
1714607214675,EDS 206R,A00,507332,Staff,0,4,30,30
1714607214675,EDS 206R,B00,507343,Staff,17,0,30,13
1714607215703,EDS 250,A00,507344,Hemans; Patricia Ann Benitez,22,0,40,18
1714607216726,EDS 281,A00,507345,Daly; Alan J.,18,0,18,0
1714607217749,EDS 284,A00,507350,Daly; Alan J.,16,0,16,0
1714607218780,EDS 286,A00,507359,Fine; Sarah,18,0,18,0
1714607219861,EDS 289C,A01,507361,Daly; Alan J.,18,0,18,0
1714607220891,EDS 290,A00,507366,Hofstetter; Carolyn,15,0,15,0
1714607221918,LIGM 5A,A00,507421,Fischer-Grunski; Eva K,18,0,20,2
1714607222948,LIGM 5B,A00,507423,Fischer-Grunski; Eva K,19,0,20,1
1714607223978,LIGM 5C,A00,507425,Fischer-Grunski; Eva K,19,0,20,1
1714607225003,LIIT 5AS,A00,507427,Carnelos; Chiara,20,0,20,0
1714607226030,LIIT 5BS,A00,507430,Carnelos; Chiara,20,0,20,0
1714607227055,LIIT 5CS,A00,507432,Carnelos; Chiara,20,0,20,0
1714607228083,LISP 5A,A00,507541,Munoz Sanchez; Alicia,11,0,20,9
1714607229111,LISP 5B,A00,507671,Munoz Sanchez; Alicia,8,0,20,12
1714607230137,LISP 5C,A00,507696,Munoz Sanchez; Alicia,9,0,20,11
1714607231163,MAE 197,001,528363,Boechler; Nicholas Sebastia,9998,0,9999,1
1714607232191,MATH 197,001,523477,Kedlaya; Kiran S.,9995,0,9999,4
1714607232191,MATH 197,002,563811,Zhang; Danna,9995,0,9999,4
1714607232191,MATH 197,003,628552,Dumitriu; Ioana,9998,0,9999,1
1714607233221,MCWP 40R,A00,518780,Staff,2,0,20,18
1714607233221,MCWP 40R,B00,518781,Staff,8,0,20,12
1714607233221,MCWP 40R,C00,518783,Staff,6,0,20,14
1714607234247,MCWP 50R,A00,518791,Staff,0,0,20,20
1714607234247,MCWP 50R,B00,518792,Staff,0,2,20,20
1714607234247,MCWP 50R,C00,518793,Staff,0,2,20,20
1714607234247,MCWP 50R,D00,518794,Staff,0,0,20,20
1714607234247,MCWP 50R,E00,518795,Staff,0,2,20,20
1714607234247,MCWP 50R,F00,518796,Staff,0,0,20,20
1714607234247,MCWP 50R,G00,518797,Staff,0,1,20,20
1714607235273,MMW 12R,A01,514034,Herbst; Matthew,0,0,16,16
1714607235273,MMW 12R,A02,514035,Herbst; Matthew,1,0,16,15
1714607236301,MMW 13R,A01,514037,Staff,0,4,16,16
1714607236301,MMW 13R,A02,514039,Staff,0,2,16,16
1714607236301,MMW 13R,A03,628519,Staff,0,2,16,16
1714607238351,SIO 295LS,A00,523233,Staff,10,0,30,20
1714607239376,SIO 295S,A00,523232,Staff,10,0,30,20
1714607240401,SIOC 290S,A01,637330,Merrifield; Mark A,23,0,30,7
1714607241432,SIOC 291S,A01,637333,Gabriel; Corey John,23,0,30,7
1714607242458,SOCI 117,A01,494376,Staff,0,4,5,5
1714607243485,WES 237B,A00,494380,Staff,9,0,20,11
1714607245558,AESE 279B,A00,494370,Wade; Jon P,0,0,33,33
1714607246586,AIP 197,001,627712,Vespa; Emanuel Ignacio,9998,0,9999,1
1714607247615,ANAR 135S,A00,494369,Braswell; Geoffrey E.,0,0,0,0
1714607248642,BENG 196,001,628496,Engler; Adam J.,9998,0,9999,1
1714607249668,CAT 124RS,A01,519847,Geibel; William,0,0,20,20
1714607250697,CAT 125RS,A01,515971,Geibel; William,0,0,20,20
1714607251721,CLRE 250,A00,511389,Morris; Sheldon,9993,0,9999,6
1714607252747,CLRE 251,A00,507176,Mehta; Ravindra L.,9993,0,9999,6
1714607252747,CLRE 251,B00,511410,Mehta; Ravindra L.,9998,0,9999,1
1714607253773,CLRE 252,A00,507189,Cuomo; Raphael Eduardo,9995,0,9999,4
1714607254808,CLRE 253,A00,507199,Vaida; Florin,9994,0,9999,5
1714607254808,CLRE 253,B00,507202,Vaida; Florin,9999,0,9999,0
1714607255836,CLRE 259,A00,507211,Patel; Hemal,9996,0,9999,3
1714607256859,CLRE 260,A00,507221,Cuomo; Raphael Eduardo,9999,0,9999,0
1714607257885,CLRE 297,001,507242,Cuomo; Raphael Eduardo,9999,0,9999,0
1714607258910,COGS 197,001,638244,Voytek; Bradley Thomas,9998,0,9999,1
1714607259963,CSE 191,A00,516875,Minnes Kemp; Mor Mia,9993,0,9999,6
1714607260989,CSE 197,001,637388,Minnes Kemp; Mor Mia,9998,0,9999,1
1714607262015,CSS 201S,A01,494383,Staff,35,0,35,0
1714607263039,CSS 202S,A01,494387,Staff,35,0,35,0
1714607264066,DSC 197,001,628532,Eldridge; Justin Matthew,9996,0,9999,3
1714607265089,EAP 100,A00,516065,Staff,9797,0,9999,202
1714607266113,ECE 45,A01,507414,Staff,33,0,60,27
1714607268167,ECE 111,A01,507420,Staff,15,0,50,35
1714607269192,ECE 197,001,548057,Sievenpiper; Daniel F.,9993,0,9999,6
1714607270218,EDS 115,A00,507243,Choi; Bailey Miyeon,10,0,28,18
1714607271247,EDS 117,A01,494379,Staff,1,5,30,29
1714607272271,EDS 125,A00,507246,Hopkins; Megan Beth,9,0,30,21
1714607273296,EDS 128A,A01,507264,Fargason; Sharon Gayle,8,0,26,18
1714607274326,EDS 128B,A01,507293,Pappas; Elizabeth,12,0,30,18
1714607275351,EDS 139,A00,507294,Fargason; Sharon Gayle,13,0,30,17
1714607275351,EDS 139,B00,507313,Pappas; Elizabeth,13,0,30,17
1714607276380,EDS 201,A00,507315,Staff,13,0,30,17
1714607277406,EDS 203,A01,507317,Halter; Christopher P.,12,0,30,18
1714607278430,EDS 204R,A01,507319,Halter; Christopher P.,0,3,30,30
1714607278430,EDS 204R,B01,507331,Heinzman; Erica M.,16,0,30,14
1714607279458,EDS 206R,A00,507332,Staff,0,4,30,30
1714607279458,EDS 206R,B00,507343,Staff,17,0,30,13
1714607280486,EDS 250,A00,507344,Hemans; Patricia Ann Benitez,22,0,40,18
1714607281510,EDS 281,A00,507345,Daly; Alan J.,18,0,18,0
1714607282532,EDS 284,A00,507350,Daly; Alan J.,16,0,16,0
1714607283557,EDS 286,A00,507359,Fine; Sarah,18,0,18,0
1714607284586,EDS 289C,A01,507361,Daly; Alan J.,18,0,18,0
1714607285611,EDS 290,A00,507366,Hofstetter; Carolyn,15,0,15,0
1714607286638,LIGM 5A,A00,507421,Fischer-Grunski; Eva K,18,0,20,2
1714607287663,LIGM 5B,A00,507423,Fischer-Grunski; Eva K,19,0,20,1
1714607288688,LIGM 5C,A00,507425,Fischer-Grunski; Eva K,19,0,20,1
1714607289712,LIIT 5AS,A00,507427,Carnelos; Chiara,20,0,20,0
1714607290768,LIIT 5BS,A00,507430,Carnelos; Chiara,20,0,20,0
1714607291795,LIIT 5CS,A00,507432,Carnelos; Chiara,20,0,20,0
1714607292819,LISP 5A,A00,507541,Munoz Sanchez; Alicia,11,0,20,9
1714607293847,LISP 5B,A00,507671,Munoz Sanchez; Alicia,8,0,20,12
1714607294875,LISP 5C,A00,507696,Munoz Sanchez; Alicia,9,0,20,11
1714607295904,MAE 197,001,528363,Boechler; Nicholas Sebastia,9998,0,9999,1
1714607296936,MATH 197,001,523477,Kedlaya; Kiran S.,9995,0,9999,4
1714607296936,MATH 197,002,563811,Zhang; Danna,9995,0,9999,4
1714607296936,MATH 197,003,628552,Dumitriu; Ioana,9998,0,9999,1
1714607297962,MCWP 40R,A00,518780,Staff,2,0,20,18
1714607297962,MCWP 40R,B00,518781,Staff,8,0,20,12
1714607297962,MCWP 40R,C00,518783,Staff,6,0,20,14
1714607298988,MCWP 50R,A00,518791,Staff,0,0,20,20
1714607298988,MCWP 50R,B00,518792,Staff,0,2,20,20
1714607298988,MCWP 50R,C00,518793,Staff,0,2,20,20
1714607298988,MCWP 50R,D00,518794,Staff,0,0,20,20
1714607298988,MCWP 50R,E00,518795,Staff,0,2,20,20
1714607298988,MCWP 50R,F00,518796,Staff,0,0,20,20
1714607298988,MCWP 50R,G00,518797,Staff,0,1,20,20
1714607300019,MMW 12R,A01,514034,Herbst; Matthew,0,0,16,16
1714607300019,MMW 12R,A02,514035,Herbst; Matthew,1,0,16,15
1714607301048,MMW 13R,A01,514037,Staff,0,4,16,16
1714607301048,MMW 13R,A02,514039,Staff,0,2,16,16
1714607301048,MMW 13R,A03,628519,Staff,0,2,16,16
1714607303102,SIO 295LS,A00,523233,Staff,10,0,30,20
1714607304128,SIO 295S,A00,523232,Staff,10,0,30,20
1714607305153,SIOC 290S,A01,637330,Merrifield; Mark A,23,0,30,7
1714607306182,SIOC 291S,A01,637333,Gabriel; Corey John,23,0,30,7
1714607307210,SOCI 117,A01,494376,Staff,0,4,5,5
1714607308234,WES 237B,A00,494380,Staff,9,0,20,11
1714607310298,AESE 279B,A00,494370,Wade; Jon P,0,0,33,33
1714607311328,AIP 197,001,627712,Vespa; Emanuel Ignacio,9998,0,9999,1
1714607312354,ANAR 135S,A00,494369,Braswell; Geoffrey E.,0,0,0,0
1714607313383,BENG 196,001,628496,Engler; Adam J.,9998,0,9999,1
1714607314411,CAT 124RS,A01,519847,Geibel; William,0,0,20,20
1714607315438,CAT 125RS,A01,515971,Geibel; William,0,0,20,20
1714607316467,CLRE 250,A00,511389,Morris; Sheldon,9993,0,9999,6
1714607317493,CLRE 251,A00,507176,Mehta; Ravindra L.,9993,0,9999,6
1714607317493,CLRE 251,B00,511410,Mehta; Ravindra L.,9998,0,9999,1
1714607318521,CLRE 252,A00,507189,Cuomo; Raphael Eduardo,9995,0,9999,4
1714607319551,CLRE 253,A00,507199,Vaida; Florin,9994,0,9999,5
1714607319551,CLRE 253,B00,507202,Vaida; Florin,9999,0,9999,0
1714607320577,CLRE 259,A00,507211,Patel; Hemal,9996,0,9999,3
1714607321602,CLRE 260,A00,507221,Cuomo; Raphael Eduardo,9999,0,9999,0
1714607322626,CLRE 297,001,507242,Cuomo; Raphael Eduardo,9999,0,9999,0
1714607323650,COGS 197,001,638244,Voytek; Bradley Thomas,9998,0,9999,1
1714607324676,CSE 191,A00,516875,Minnes Kemp; Mor Mia,9993,0,9999,6
1714607325703,CSE 197,001,637388,Minnes Kemp; Mor Mia,9998,0,9999,1
1714607326729,CSS 201S,A01,494383,Staff,35,0,35,0
1714607327754,CSS 202S,A01,494387,Staff,35,0,35,0
1714607328778,DSC 197,001,628532,Eldridge; Justin Matthew,9996,0,9999,3
1714607329802,EAP 100,A00,516065,Staff,9797,0,9999,202
1714607330830,ECE 45,A01,507414,Staff,33,0,60,27
1714607332879,ECE 111,A01,507420,Staff,15,0,50,35
1714607333908,ECE 197,001,548057,Sievenpiper; Daniel F.,9993,0,9999,6
1714607334934,EDS 115,A00,507243,Choi; Bailey Miyeon,10,0,28,18
1714607335960,EDS 117,A01,494379,Staff,1,5,30,29
1714607336985,EDS 125,A00,507246,Hopkins; Megan Beth,9,0,30,21
1714607338011,EDS 128A,A01,507264,Fargason; Sharon Gayle,8,0,26,18
1714607339042,EDS 128B,A01,507293,Pappas; Elizabeth,12,0,30,18
1714607340091,EDS 139,A00,507294,Fargason; Sharon Gayle,13,0,30,17
1714607340091,EDS 139,B00,507313,Pappas; Elizabeth,13,0,30,17
1714607341117,EDS 201,A00,507315,Staff,13,0,30,17
1714607342146,EDS 203,A01,507317,Halter; Christopher P.,12,0,30,18
1714607343176,EDS 204R,A01,507319,Halter; Christopher P.,0,3,30,30
1714607343176,EDS 204R,B01,507331,Heinzman; Erica M.,16,0,30,14
1714607344204,EDS 206R,A00,507332,Staff,0,4,30,30
1714607344204,EDS 206R,B00,507343,Staff,17,0,30,13
1714607345231,EDS 250,A00,507344,Hemans; Patricia Ann Benitez,22,0,40,18
1714607346256,EDS 281,A00,507345,Daly; Alan J.,18,0,18,0
1714607347283,EDS 284,A00,507350,Daly; Alan J.,16,0,16,0
1714607348308,EDS 286,A00,507359,Fine; Sarah,18,0,18,0
1714607349334,EDS 289C,A01,507361,Daly; Alan J.,18,0,18,0
1714607350358,EDS 290,A00,507366,Hofstetter; Carolyn,15,0,15,0
1714607351385,LIGM 5A,A00,507421,Fischer-Grunski; Eva K,18,0,20,2
1714607352413,LIGM 5B,A00,507423,Fischer-Grunski; Eva K,19,0,20,1
1714607353441,LIGM 5C,A00,507425,Fischer-Grunski; Eva K,19,0,20,1
1714607354466,LIIT 5AS,A00,507427,Carnelos; Chiara,20,0,20,0
1714607355490,LIIT 5BS,A00,507430,Carnelos; Chiara,20,0,20,0
1714607356518,LIIT 5CS,A00,507432,Carnelos; Chiara,20,0,20,0
1714607357547,LISP 5A,A00,507541,Munoz Sanchez; Alicia,11,0,20,9
1714607358573,LISP 5B,A00,507671,Munoz Sanchez; Alicia,8,0,20,12
1714607359598,LISP 5C,A00,507696,Munoz Sanchez; Alicia,9,0,20,11
1714607360627,MAE 197,001,528363,Boechler; Nicholas Sebastia,9998,0,9999,1
1714607361655,MATH 197,001,523477,Kedlaya; Kiran S.,9995,0,9999,4
1714607361655,MATH 197,002,563811,Zhang; Danna,9995,0,9999,4
1714607361655,MATH 197,003,628552,Dumitriu; Ioana,9998,0,9999,1
1714607362680,MCWP 40R,A00,518780,Staff,2,0,20,18
1714607362680,MCWP 40R,B00,518781,Staff,8,0,20,12
1714607362680,MCWP 40R,C00,518783,Staff,6,0,20,14
1714607363709,MCWP 50R,A00,518791,Staff,0,0,20,20
1714607363709,MCWP 50R,B00,518792,Staff,0,2,20,20
1714607363709,MCWP 50R,C00,518793,Staff,0,2,20,20
1714607363709,MCWP 50R,D00,518794,Staff,0,0,20,20
1714607363709,MCWP 50R,E00,518795,Staff,0,2,20,20
1714607363709,MCWP 50R,F00,518796,Staff,0,0,20,20
1714607363709,MCWP 50R,G00,518797,Staff,0,1,20,20
1714607364734,MMW 12R,A01,514034,Herbst; Matthew,0,0,16,16
1714607364734,MMW 12R,A02,514035,Herbst; Matthew,1,0,16,15
1714607365759,MMW 13R,A01,514037,Staff,0,4,16,16
1714607365759,MMW 13R,A02,514039,Staff,0,2,16,16
1714607365759,MMW 13R,A03,628519,Staff,0,2,16,16
1714607367809,SIO 295LS,A00,523233,Staff,10,0,30,20
1714607368835,SIO 295S,A00,523232,Staff,10,0,30,20
1714607369861,SIOC 290S,A01,637330,Merrifield; Mark A,23,0,30,7
1714607370889,SIOC 291S,A01,637333,Gabriel; Corey John,23,0,30,7
1714607371919,SOCI 117,A01,494376,Staff,0,4,5,5
1714607372943,WES 237B,A00,494380,Staff,9,0,20,11
1714607375013,AESE 279B,A00,494370,Wade; Jon P,0,0,33,33
1714607376039,AIP 197,001,627712,Vespa; Emanuel Ignacio,9998,0,9999,1
1714607377066,ANAR 135S,A00,494369,Braswell; Geoffrey E.,0,0,0,0
1714607378090,BENG 196,001,628496,Engler; Adam J.,9998,0,9999,1
1714607379116,CAT 124RS,A01,519847,Geibel; William,0,0,20,20
1714607380143,CAT 125RS,A01,515971,Geibel; William,0,0,20,20
1714607381167,CLRE 250,A00,511389,Morris; Sheldon,9993,0,9999,6
1714607382195,CLRE 251,A00,507176,Mehta; Ravindra L.,9993,0,9999,6
1714607382195,CLRE 251,B00,511410,Mehta; Ravindra L.,9998,0,9999,1
1714607383221,CLRE 252,A00,507189,Cuomo; Raphael Eduardo,9995,0,9999,4
1714607384247,CLRE 253,A00,507199,Vaida; Florin,9994,0,9999,5
1714607384247,CLRE 253,B00,507202,Vaida; Florin,9999,0,9999,0
1714607385274,CLRE 259,A00,507211,Patel; Hemal,9996,0,9999,3
1714607386298,CLRE 260,A00,507221,Cuomo; Raphael Eduardo,9999,0,9999,0
1714607387321,CLRE 297,001,507242,Cuomo; Raphael Eduardo,9999,0,9999,0
1714607388348,COGS 197,001,638244,Voytek; Bradley Thomas,9998,0,9999,1
1714607389377,CSE 191,A00,516875,Minnes Kemp; Mor Mia,9993,0,9999,6
1714607390402,CSE 197,001,637388,Minnes Kemp; Mor Mia,9998,0,9999,1
1714607391432,CSS 201S,A01,494383,Staff,35,0,35,0
1714607392459,CSS 202S,A01,494387,Staff,35,0,35,0
1714607393484,DSC 197,001,628532,Eldridge; Justin Matthew,9996,0,9999,3
1714607394510,EAP 100,A00,516065,Staff,9797,0,9999,202
1714607395540,ECE 45,A01,507414,Staff,33,0,60,27
1714607397595,ECE 111,A01,507420,Staff,15,0,50,35
1714607398620,ECE 197,001,548057,Sievenpiper; Daniel F.,9993,0,9999,6
1714607399649,EDS 115,A00,507243,Choi; Bailey Miyeon,10,0,28,18
1714607400674,EDS 117,A01,494379,Staff,1,5,30,29
1714607401703,EDS 125,A00,507246,Hopkins; Megan Beth,9,0,30,21
1714607402729,EDS 128A,A01,507264,Fargason; Sharon Gayle,8,0,26,18
1714607403757,EDS 128B,A01,507293,Pappas; Elizabeth,12,0,30,18
1714607404783,EDS 139,A00,507294,Fargason; Sharon Gayle,13,0,30,17
1714607404783,EDS 139,B00,507313,Pappas; Elizabeth,13,0,30,17
1714607405811,EDS 201,A00,507315,Staff,13,0,30,17
1714607406837,EDS 203,A01,507317,Halter; Christopher P.,12,0,30,18
1714607407864,EDS 204R,A01,507319,Halter; Christopher P.,0,3,30,30
1714607407864,EDS 204R,B01,507331,Heinzman; Erica M.,16,0,30,14
1714607408889,EDS 206R,A00,507332,Staff,0,4,30,30
1714607408889,EDS 206R,B00,507343,Staff,17,0,30,13
1714607409916,EDS 250,A00,507344,Hemans; Patricia Ann Benitez,22,0,40,18
1714607410941,EDS 281,A00,507345,Daly; Alan J.,18,0,18,0
1714607411965,EDS 284,A00,507350,Daly; Alan J.,16,0,16,0
1714607412994,EDS 286,A00,507359,Fine; Sarah,18,0,18,0
1714607414018,EDS 289C,A01,507361,Daly; Alan J.,18,0,18,0
1714607415045,EDS 290,A00,507366,Hofstetter; Carolyn,15,0,15,0
1714607416072,LIGM 5A,A00,507421,Fischer-Grunski; Eva K,18,0,20,2
1714607417096,LIGM 5B,A00,507423,Fischer-Grunski; Eva K,19,0,20,1
1714607418124,LIGM 5C,A00,507425,Fischer-Grunski; Eva K,19,0,20,1
1714607419150,LIIT 5AS,A00,507427,Carnelos; Chiara,20,0,20,0
1714607420179,LIIT 5BS,A00,507430,Carnelos; Chiara,20,0,20,0
1714607421204,LIIT 5CS,A00,507432,Carnelos; Chiara,20,0,20,0
1714607422230,LISP 5A,A00,507541,Munoz Sanchez; Alicia,11,0,20,9
1714607423254,LISP 5B,A00,507671,Munoz Sanchez; Alicia,8,0,20,12
1714607424283,LISP 5C,A00,507696,Munoz Sanchez; Alicia,9,0,20,11
1714607425309,MAE 197,001,528363,Boechler; Nicholas Sebastia,9998,0,9999,1
1714607426335,MATH 197,001,523477,Kedlaya; Kiran S.,9995,0,9999,4
1714607426335,MATH 197,002,563811,Zhang; Danna,9995,0,9999,4
1714607426335,MATH 197,003,628552,Dumitriu; Ioana,9998,0,9999,1
1714607427365,MCWP 40R,A00,518780,Staff,2,0,20,18
1714607427365,MCWP 40R,B00,518781,Staff,8,0,20,12
1714607427365,MCWP 40R,C00,518783,Staff,6,0,20,14
1714607428395,MCWP 50R,A00,518791,Staff,0,0,20,20
1714607428395,MCWP 50R,B00,518792,Staff,0,2,20,20
1714607428395,MCWP 50R,C00,518793,Staff,0,2,20,20
1714607428395,MCWP 50R,D00,518794,Staff,0,0,20,20
1714607428395,MCWP 50R,E00,518795,Staff,0,2,20,20
1714607428395,MCWP 50R,F00,518796,Staff,0,0,20,20
1714607428395,MCWP 50R,G00,518797,Staff,0,1,20,20
1714607429426,MMW 12R,A01,514034,Herbst; Matthew,0,0,16,16
1714607429426,MMW 12R,A02,514035,Herbst; Matthew,1,0,16,15
1714607430454,MMW 13R,A01,514037,Staff,0,4,16,16
1714607430454,MMW 13R,A02,514039,Staff,0,2,16,16
1714607430454,MMW 13R,A03,628519,Staff,0,2,16,16
1714607432511,SIO 295LS,A00,523233,Staff,10,0,30,20
1714607433537,SIO 295S,A00,523232,Staff,10,0,30,20
1714607434565,SIOC 290S,A01,637330,Merrifield; Mark A,23,0,30,7
1714607435594,SIOC 291S,A01,637333,Gabriel; Corey John,23,0,30,7
1714607436619,SOCI 117,A01,494376,Staff,0,4,5,5
1714607437644,WES 237B,A00,494380,Staff,9,0,20,11
1714607439705,AESE 279B,A00,494370,Wade; Jon P,0,0,33,33
1714607440735,AIP 197,001,627712,Vespa; Emanuel Ignacio,9998,0,9999,1
1714607441761,ANAR 135S,A00,494369,Braswell; Geoffrey E.,0,0,0,0
1714607442786,BENG 196,001,628496,Engler; Adam J.,9998,0,9999,1
1714607443813,CAT 124RS,A01,519847,Geibel; William,0,0,20,20
1714607444841,CAT 125RS,A01,515971,Geibel; William,0,0,20,20
1714607445865,CLRE 250,A00,511389,Morris; Sheldon,9993,0,9999,6
1714607446893,CLRE 251,A00,507176,Mehta; Ravindra L.,9993,0,9999,6
1714607446893,CLRE 251,B00,511410,Mehta; Ravindra L.,9998,0,9999,1
1714607447919,CLRE 252,A00,507189,Cuomo; Raphael Eduardo,9995,0,9999,4
1714607448945,CLRE 253,A00,507199,Vaida; Florin,9994,0,9999,5
1714607448945,CLRE 253,B00,507202,Vaida; Florin,9999,0,9999,0
1714607449971,CLRE 259,A00,507211,Patel; Hemal,9996,0,9999,3
1714607450997,CLRE 260,A00,507221,Cuomo; Raphael Eduardo,9999,0,9999,0
1714607452026,CLRE 297,001,507242,Cuomo; Raphael Eduardo,9999,0,9999,0
1714607453051,COGS 197,001,638244,Voytek; Bradley Thomas,9998,0,9999,1
1714607454079,CSE 191,A00,516875,Minnes Kemp; Mor Mia,9993,0,9999,6
1714607455107,CSE 197,001,637388,Minnes Kemp; Mor Mia,9998,0,9999,1
1714607456218,CSS 201S,A01,494383,Staff,35,0,35,0
1714607457243,CSS 202S,A01,494387,Staff,35,0,35,0
1714607458269,DSC 197,001,628532,Eldridge; Justin Matthew,9996,0,9999,3
1714607459297,EAP 100,A00,516065,Staff,9797,0,9999,202
1714607460376,ECE 45,A01,507414,Staff,33,0,60,27
1714607462428,ECE 111,A01,507420,Staff,15,0,50,35
1714607463455,ECE 197,001,548057,Sievenpiper; Daniel F.,9993,0,9999,6
1714607464483,EDS 115,A00,507243,Choi; Bailey Miyeon,10,0,28,18
1714607465515,EDS 117,A01,494379,Staff,1,5,30,29
1714607466545,EDS 125,A00,507246,Hopkins; Megan Beth,9,0,30,21
1714607467572,EDS 128A,A01,507264,Fargason; Sharon Gayle,8,0,26,18
1714607468604,EDS 128B,A01,507293,Pappas; Elizabeth,12,0,30,18
1714607469629,EDS 139,A00,507294,Fargason; Sharon Gayle,13,0,30,17
1714607469629,EDS 139,B00,507313,Pappas; Elizabeth,13,0,30,17
1714607470651,EDS 201,A00,507315,Staff,13,0,30,17
1714607471677,EDS 203,A01,507317,Halter; Christopher P.,12,0,30,18
1714607472701,EDS 204R,A01,507319,Halter; Christopher P.,0,3,30,30
1714607472701,EDS 204R,B01,507331,Heinzman; Erica M.,16,0,30,14
1714607473726,EDS 206R,A00,507332,Staff,0,4,30,30
1714607473726,EDS 206R,B00,507343,Staff,17,0,30,13
1714607474751,EDS 250,A00,507344,Hemans; Patricia Ann Benitez,22,0,40,18
1714607475776,EDS 281,A00,507345,Daly; Alan J.,18,0,18,0
1714607476800,EDS 284,A00,507350,Daly; Alan J.,16,0,16,0
1714607477829,EDS 286,A00,507359,Fine; Sarah,18,0,18,0
1714607478855,EDS 289C,A01,507361,Daly; Alan J.,18,0,18,0
1714607479881,EDS 290,A00,507366,Hofstetter; Carolyn,15,0,15,0
1714607480910,LIGM 5A,A00,507421,Fischer-Grunski; Eva K,18,0,20,2
1714607481938,LIGM 5B,A00,507423,Fischer-Grunski; Eva K,19,0,20,1
1714607482963,LIGM 5C,A00,507425,Fischer-Grunski; Eva K,19,0,20,1
1714607483989,LIIT 5AS,A00,507427,Carnelos; Chiara,20,0,20,0
1714607485018,LIIT 5BS,A00,507430,Carnelos; Chiara,20,0,20,0
1714607486046,LIIT 5CS,A00,507432,Carnelos; Chiara,20,0,20,0
1714607487078,LISP 5A,A00,507541,Munoz Sanchez; Alicia,11,0,20,9
1714607488103,LISP 5B,A00,507671,Munoz Sanchez; Alicia,8,0,20,12
1714607489131,LISP 5C,A00,507696,Munoz Sanchez; Alicia,9,0,20,11
1714607490160,MAE 197,001,528363,Boechler; Nicholas Sebastia,9998,0,9999,1
1714607491187,MATH 197,001,523477,Kedlaya; Kiran S.,9995,0,9999,4
1714607491187,MATH 197,002,563811,Zhang; Danna,9995,0,9999,4
1714607491187,MATH 197,003,628552,Dumitriu; Ioana,9998,0,9999,1
1714607492212,MCWP 40R,A00,518780,Staff,2,0,20,18
1714607492212,MCWP 40R,B00,518781,Staff,8,0,20,12
1714607492212,MCWP 40R,C00,518783,Staff,6,0,20,14
1714607493236,MCWP 50R,A00,518791,Staff,0,0,20,20
1714607493236,MCWP 50R,B00,518792,Staff,0,2,20,20
1714607493236,MCWP 50R,C00,518793,Staff,0,2,20,20
1714607493236,MCWP 50R,D00,518794,Staff,0,0,20,20
1714607493236,MCWP 50R,E00,518795,Staff,0,2,20,20
1714607493236,MCWP 50R,F00,518796,Staff,0,0,20,20
1714607493236,MCWP 50R,G00,518797,Staff,0,1,20,20
1714607494262,MMW 12R,A01,514034,Herbst; Matthew,0,0,16,16
1714607494262,MMW 12R,A02,514035,Herbst; Matthew,1,0,16,15
1714607495288,MMW 13R,A01,514037,Staff,0,4,16,16
1714607495288,MMW 13R,A02,514039,Staff,0,2,16,16
1714607495288,MMW 13R,A03,628519,Staff,0,2,16,16
1714607497336,SIO 295LS,A00,523233,Staff,10,0,30,20
1714607498361,SIO 295S,A00,523232,Staff,10,0,30,20
1714607499394,SIOC 290S,A01,637330,Merrifield; Mark A,23,0,30,7
1714607500421,SIOC 291S,A01,637333,Gabriel; Corey John,23,0,30,7
1714607501450,SOCI 117,A01,494376,Staff,0,4,5,5
1714607502474,WES 237B,A00,494380,Staff,9,0,20,11
1714607504560,AESE 279B,A00,494370,Wade; Jon P,0,0,33,33
1714607505590,AIP 197,001,627712,Vespa; Emanuel Ignacio,9998,0,9999,1
1714607506617,ANAR 135S,A00,494369,Braswell; Geoffrey E.,0,0,0,0
1714607507645,BENG 196,001,628496,Engler; Adam J.,9998,0,9999,1
1714607508672,CAT 124RS,A01,519847,Geibel; William,0,0,20,20
1714607509702,CAT 125RS,A01,515971,Geibel; William,0,0,20,20
1714607510730,CLRE 250,A00,511389,Morris; Sheldon,9993,0,9999,6
1714607511763,CLRE 251,A00,507176,Mehta; Ravindra L.,9993,0,9999,6
1714607511763,CLRE 251,B00,511410,Mehta; Ravindra L.,9998,0,9999,1
1714607512859,CLRE 252,A00,507189,Cuomo; Raphael Eduardo,9995,0,9999,4
1714607513895,CLRE 253,A00,507199,Vaida; Florin,9994,0,9999,5
1714607513895,CLRE 253,B00,507202,Vaida; Florin,9999,0,9999,0
1714607514922,CLRE 259,A00,507211,Patel; Hemal,9996,0,9999,3
1714607515947,CLRE 260,A00,507221,Cuomo; Raphael Eduardo,9999,0,9999,0
1714607516971,CLRE 297,001,507242,Cuomo; Raphael Eduardo,9999,0,9999,0
1714607518001,COGS 197,001,638244,Voytek; Bradley Thomas,9998,0,9999,1
1714607519034,CSE 191,A00,516875,Minnes Kemp; Mor Mia,9993,0,9999,6
1714607520063,CSE 197,001,637388,Minnes Kemp; Mor Mia,9998,0,9999,1
1714607521090,CSS 201S,A01,494383,Staff,35,0,35,0
1714607522117,CSS 202S,A01,494387,Staff,35,0,35,0
1714607523143,DSC 197,001,628532,Eldridge; Justin Matthew,9996,0,9999,3
1714607524172,EAP 100,A00,516065,Staff,9797,0,9999,202
1714607525197,ECE 45,A01,507414,Staff,33,0,60,27
1714607527258,ECE 111,A01,507420,Staff,15,0,50,35
1714607528283,ECE 197,001,548057,Sievenpiper; Daniel F.,9993,0,9999,6
1714607529309,EDS 115,A00,507243,Choi; Bailey Miyeon,10,0,28,18
1714607530336,EDS 117,A01,494379,Staff,1,5,30,29
1714607531360,EDS 125,A00,507246,Hopkins; Megan Beth,9,0,30,21
1714607532391,EDS 128A,A01,507264,Fargason; Sharon Gayle,8,0,26,18
1714607533416,EDS 128B,A01,507293,Pappas; Elizabeth,12,0,30,18
1714607534442,EDS 139,A00,507294,Fargason; Sharon Gayle,13,0,30,17
1714607534442,EDS 139,B00,507313,Pappas; Elizabeth,13,0,30,17
1714607535470,EDS 201,A00,507315,Staff,13,0,30,17
1714607536495,EDS 203,A01,507317,Halter; Christopher P.,12,0,30,18
1714607537523,EDS 204R,A01,507319,Halter; Christopher P.,0,3,30,30
1714607537523,EDS 204R,B01,507331,Heinzman; Erica M.,16,0,30,14
1714607538550,EDS 206R,A00,507332,Staff,0,4,30,30
1714607538550,EDS 206R,B00,507343,Staff,17,0,30,13
1714607539575,EDS 250,A00,507344,Hemans; Patricia Ann Benitez,22,0,40,18
1714607540601,EDS 281,A00,507345,Daly; Alan J.,18,0,18,0
1714607541625,EDS 284,A00,507350,Daly; Alan J.,16,0,16,0
1714607542653,EDS 286,A00,507359,Fine; Sarah,18,0,18,0
1714607543681,EDS 289C,A01,507361,Daly; Alan J.,18,0,18,0
1714607544707,EDS 290,A00,507366,Hofstetter; Carolyn,15,0,15,0
1714607545735,LIGM 5A,A00,507421,Fischer-Grunski; Eva K,18,0,20,2
1714607546763,LIGM 5B,A00,507423,Fischer-Grunski; Eva K,19,0,20,1
1714607547792,LIGM 5C,A00,507425,Fischer-Grunski; Eva K,19,0,20,1
1714607548818,LIIT 5AS,A00,507427,Carnelos; Chiara,20,0,20,0
1714607549848,LIIT 5BS,A00,507430,Carnelos; Chiara,20,0,20,0
1714607550876,LIIT 5CS,A00,507432,Carnelos; Chiara,20,0,20,0
1714607551905,LISP 5A,A00,507541,Munoz Sanchez; Alicia,11,0,20,9
1714607552930,LISP 5B,A00,507671,Munoz Sanchez; Alicia,8,0,20,12
1714607553958,LISP 5C,A00,507696,Munoz Sanchez; Alicia,9,0,20,11
1714607554984,MAE 197,001,528363,Boechler; Nicholas Sebastia,9998,0,9999,1
1714607556016,MATH 197,001,523477,Kedlaya; Kiran S.,9995,0,9999,4
1714607556016,MATH 197,002,563811,Zhang; Danna,9995,0,9999,4
1714607556016,MATH 197,003,628552,Dumitriu; Ioana,9998,0,9999,1
1714607557042,MCWP 40R,A00,518780,Staff,2,0,20,18
1714607557042,MCWP 40R,B00,518781,Staff,8,0,20,12
1714607557042,MCWP 40R,C00,518783,Staff,6,0,20,14
1714607558068,MCWP 50R,A00,518791,Staff,0,0,20,20
1714607558068,MCWP 50R,B00,518792,Staff,0,2,20,20
1714607558068,MCWP 50R,C00,518793,Staff,0,2,20,20
1714607558068,MCWP 50R,D00,518794,Staff,0,0,20,20
1714607558068,MCWP 50R,E00,518795,Staff,0,2,20,20
1714607558068,MCWP 50R,F00,518796,Staff,0,0,20,20
1714607558068,MCWP 50R,G00,518797,Staff,0,1,20,20
1714607559093,MMW 12R,A01,514034,Herbst; Matthew,0,0,16,16
1714607559093,MMW 12R,A02,514035,Herbst; Matthew,1,0,16,15
1714607560123,MMW 13R,A01,514037,Staff,0,4,16,16
1714607560123,MMW 13R,A02,514039,Staff,0,2,16,16
1714607560123,MMW 13R,A03,628519,Staff,0,2,16,16
1714607562176,SIO 295LS,A00,523233,Staff,10,0,30,20
1714607563203,SIO 295S,A00,523232,Staff,10,0,30,20
1714607564231,SIOC 290S,A01,637330,Merrifield; Mark A,23,0,30,7
1714607565263,SIOC 291S,A01,637333,Gabriel; Corey John,23,0,30,7
1714607566291,SOCI 117,A01,494376,Staff,0,4,5,5
1714607567320,WES 237B,A00,494380,Staff,9,0,20,11
1714607569386,AESE 279B,A00,494370,Wade; Jon P,0,0,33,33
1714607570415,AIP 197,001,627712,Vespa; Emanuel Ignacio,9998,0,9999,1
1714607571445,ANAR 135S,A00,494369,Braswell; Geoffrey E.,0,0,0,0
1714607572475,BENG 196,001,628496,Engler; Adam J.,9998,0,9999,1
1714607573501,CAT 124RS,A01,519847,Geibel; William,0,0,20,20
1714607574525,CAT 125RS,A01,515971,Geibel; William,0,0,20,20
1714607575556,CLRE 250,A00,511389,Morris; Sheldon,9993,0,9999,6
1714607576582,CLRE 251,A00,507176,Mehta; Ravindra L.,9993,0,9999,6
1714607576582,CLRE 251,B00,511410,Mehta; Ravindra L.,9998,0,9999,1
1714607577607,CLRE 252,A00,507189,Cuomo; Raphael Eduardo,9995,0,9999,4
1714607578631,CLRE 253,A00,507199,Vaida; Florin,9994,0,9999,5
1714607578631,CLRE 253,B00,507202,Vaida; Florin,9999,0,9999,0
1714607579655,CLRE 259,A00,507211,Patel; Hemal,9996,0,9999,3
1714607580680,CLRE 260,A00,507221,Cuomo; Raphael Eduardo,9999,0,9999,0
1714607581709,CLRE 297,001,507242,Cuomo; Raphael Eduardo,9999,0,9999,0
1714607582735,COGS 197,001,638244,Voytek; Bradley Thomas,9998,0,9999,1
1714607583759,CSE 191,A00,516875,Minnes Kemp; Mor Mia,9993,0,9999,6
1714607584784,CSE 197,001,637388,Minnes Kemp; Mor Mia,9998,0,9999,1
1714607585813,CSS 201S,A01,494383,Staff,35,0,35,0
1714607586838,CSS 202S,A01,494387,Staff,35,0,35,0
1714607587864,DSC 197,001,628532,Eldridge; Justin Matthew,9996,0,9999,3
1714607588889,EAP 100,A00,516065,Staff,9797,0,9999,202
1714607589918,ECE 45,A01,507414,Staff,33,0,60,27
1714607591969,ECE 111,A01,507420,Staff,15,0,50,35
1714607592994,ECE 197,001,548057,Sievenpiper; Daniel F.,9993,0,9999,6
1714607594019,EDS 115,A00,507243,Choi; Bailey Miyeon,10,0,28,18
1714607595048,EDS 117,A01,494379,Staff,1,5,30,29
1714607596074,EDS 125,A00,507246,Hopkins; Megan Beth,9,0,30,21
1714607597100,EDS 128A,A01,507264,Fargason; Sharon Gayle,8,0,26,18
1714607598127,EDS 128B,A01,507293,Pappas; Elizabeth,12,0,30,18
1714607599154,EDS 139,A00,507294,Fargason; Sharon Gayle,13,0,30,17
1714607599154,EDS 139,B00,507313,Pappas; Elizabeth,13,0,30,17
1714607600181,EDS 201,A00,507315,Staff,13,0,30,17
1714607601207,EDS 203,A01,507317,Halter; Christopher P.,12,0,30,18
1714607602232,EDS 204R,A01,507319,Halter; Christopher P.,0,3,30,30
1714607602232,EDS 204R,B01,507331,Heinzman; Erica M.,16,0,30,14
1714607603258,EDS 206R,A00,507332,Staff,0,4,30,30
1714607603258,EDS 206R,B00,507343,Staff,17,0,30,13
1714607604283,EDS 250,A00,507344,Hemans; Patricia Ann Benitez,22,0,40,18
1714607605309,EDS 281,A00,507345,Daly; Alan J.,18,0,18,0
1714607606334,EDS 284,A00,507350,Daly; Alan J.,16,0,16,0
1714607607364,EDS 286,A00,507359,Fine; Sarah,18,0,18,0
1714607608391,EDS 289C,A01,507361,Daly; Alan J.,18,0,18,0
1714607609416,EDS 290,A00,507366,Hofstetter; Carolyn,15,0,15,0
1714607610442,LIGM 5A,A00,507421,Fischer-Grunski; Eva K,18,0,20,2
1714607611467,LIGM 5B,A00,507423,Fischer-Grunski; Eva K,19,0,20,1
1714607612494,LIGM 5C,A00,507425,Fischer-Grunski; Eva K,19,0,20,1
1714607613520,LIIT 5AS,A00,507427,Carnelos; Chiara,20,0,20,0
1714607614546,LIIT 5BS,A00,507430,Carnelos; Chiara,20,0,20,0
1714607615575,LIIT 5CS,A00,507432,Carnelos; Chiara,20,0,20,0
1714607616601,LISP 5A,A00,507541,Munoz Sanchez; Alicia,11,0,20,9
1714607617624,LISP 5B,A00,507671,Munoz Sanchez; Alicia,8,0,20,12
1714607618654,LISP 5C,A00,507696,Munoz Sanchez; Alicia,9,0,20,11
1714607619680,MAE 197,001,528363,Boechler; Nicholas Sebastia,9998,0,9999,1
1714607620704,MATH 197,001,523477,Kedlaya; Kiran S.,9995,0,9999,4
1714607620704,MATH 197,002,563811,Zhang; Danna,9995,0,9999,4
1714607620704,MATH 197,003,628552,Dumitriu; Ioana,9998,0,9999,1
1714607621731,MCWP 40R,A00,518780,Staff,2,0,20,18
1714607621731,MCWP 40R,B00,518781,Staff,8,0,20,12
1714607621731,MCWP 40R,C00,518783,Staff,6,0,20,14
1714607622760,MCWP 50R,A00,518791,Staff,0,0,20,20
1714607622760,MCWP 50R,B00,518792,Staff,0,2,20,20
1714607622760,MCWP 50R,C00,518793,Staff,0,2,20,20
1714607622760,MCWP 50R,D00,518794,Staff,0,0,20,20
1714607622760,MCWP 50R,E00,518795,Staff,0,2,20,20
1714607622760,MCWP 50R,F00,518796,Staff,0,0,20,20
1714607622760,MCWP 50R,G00,518797,Staff,0,1,20,20
1714607623789,MMW 12R,A01,514034,Herbst; Matthew,0,0,16,16
1714607623789,MMW 12R,A02,514035,Herbst; Matthew,1,0,16,15
1714607624813,MMW 13R,A01,514037,Staff,0,4,16,16
1714607624813,MMW 13R,A02,514039,Staff,0,2,16,16
1714607624813,MMW 13R,A03,628519,Staff,0,2,16,16
1714607626864,SIO 295LS,A00,523233,Staff,10,0,30,20
1714607627889,SIO 295S,A00,523232,Staff,10,0,30,20
1714607628918,SIOC 290S,A01,637330,Merrifield; Mark A,23,0,30,7
1714607629947,SIOC 291S,A01,637333,Gabriel; Corey John,23,0,30,7
1714607631028,SOCI 117,A01,494376,Staff,0,4,5,5
1714607632057,WES 237B,A00,494380,Staff,9,0,20,11
1714607634129,AESE 279B,A00,494370,Wade; Jon P,0,0,33,33
1714607635154,AIP 197,001,627712,Vespa; Emanuel Ignacio,9998,0,9999,1
1714607636185,ANAR 135S,A00,494369,Braswell; Geoffrey E.,0,0,0,0
1714607637210,BENG 196,001,628496,Engler; Adam J.,9998,0,9999,1
1714607638241,CAT 124RS,A01,519847,Geibel; William,0,0,20,20
1714607639266,CAT 125RS,A01,515971,Geibel; William,0,0,20,20
1714607640295,CLRE 250,A00,511389,Morris; Sheldon,9993,0,9999,6
1714607641329,CLRE 251,A00,507176,Mehta; Ravindra L.,9993,0,9999,6
1714607641329,CLRE 251,B00,511410,Mehta; Ravindra L.,9998,0,9999,1
1714607642358,CLRE 252,A00,507189,Cuomo; Raphael Eduardo,9995,0,9999,4
1714607643407,CLRE 253,A00,507199,Vaida; Florin,9994,0,9999,5
1714607643407,CLRE 253,B00,507202,Vaida; Florin,9999,0,9999,0
1714607644433,CLRE 259,A00,507211,Patel; Hemal,9996,0,9999,3
1714607645460,CLRE 260,A00,507221,Cuomo; Raphael Eduardo,9999,0,9999,0
1714607646485,CLRE 297,001,507242,Cuomo; Raphael Eduardo,9999,0,9999,0
1714607647509,COGS 197,001,638244,Voytek; Bradley Thomas,9998,0,9999,1
1714607648533,CSE 191,A00,516875,Minnes Kemp; Mor Mia,9993,0,9999,6
1714607649562,CSE 197,001,637388,Minnes Kemp; Mor Mia,9998,0,9999,1
1714607650593,CSS 201S,A01,494383,Staff,35,0,35,0
1714607651618,CSS 202S,A01,494387,Staff,35,0,35,0
1714607652644,DSC 197,001,628532,Eldridge; Justin Matthew,9996,0,9999,3
1714607653667,EAP 100,A00,516065,Staff,9797,0,9999,202
1714607654694,ECE 45,A01,507414,Staff,33,0,60,27
1714607656749,ECE 111,A01,507420,Staff,15,0,50,35
1714607657775,ECE 197,001,548057,Sievenpiper; Daniel F.,9993,0,9999,6
1714607658803,EDS 115,A00,507243,Choi; Bailey Miyeon,10,0,28,18
1714607659832,EDS 117,A01,494379,Staff,1,5,30,29
1714607660858,EDS 125,A00,507246,Hopkins; Megan Beth,9,0,30,21
1714607661884,EDS 128A,A01,507264,Fargason; Sharon Gayle,8,0,26,18
1714607662908,EDS 128B,A01,507293,Pappas; Elizabeth,12,0,30,18
1714607663934,EDS 139,A00,507294,Fargason; Sharon Gayle,13,0,30,17
1714607663934,EDS 139,B00,507313,Pappas; Elizabeth,13,0,30,17
1714607664960,EDS 201,A00,507315,Staff,13,0,30,17
1714607665993,EDS 203,A01,507317,Halter; Christopher P.,12,0,30,18
1714607667020,EDS 204R,A01,507319,Halter; Christopher P.,0,3,30,30
1714607667020,EDS 204R,B01,507331,Heinzman; Erica M.,16,0,30,14
1714607668046,EDS 206R,A00,507332,Staff,0,4,30,30
1714607668046,EDS 206R,B00,507343,Staff,17,0,30,13
1714607669071,EDS 250,A00,507344,Hemans; Patricia Ann Benitez,22,0,40,18
1714607670099,EDS 281,A00,507345,Daly; Alan J.,18,0,18,0
1714607671126,EDS 284,A00,507350,Daly; Alan J.,16,0,16,0
1714607672150,EDS 286,A00,507359,Fine; Sarah,18,0,18,0
1714607673177,EDS 289C,A01,507361,Daly; Alan J.,18,0,18,0
1714607674203,EDS 290,A00,507366,Hofstetter; Carolyn,15,0,15,0
1714607675229,LIGM 5A,A00,507421,Fischer-Grunski; Eva K,18,0,20,2
1714607676259,LIGM 5B,A00,507423,Fischer-Grunski; Eva K,19,0,20,1
1714607677288,LIGM 5C,A00,507425,Fischer-Grunski; Eva K,19,0,20,1
1714607678315,LIIT 5AS,A00,507427,Carnelos; Chiara,20,0,20,0
1714607679345,LIIT 5BS,A00,507430,Carnelos; Chiara,20,0,20,0
1714607680370,LIIT 5CS,A00,507432,Carnelos; Chiara,20,0,20,0
1714607681401,LISP 5A,A00,507541,Munoz Sanchez; Alicia,11,0,20,9
1714607682429,LISP 5B,A00,507671,Munoz Sanchez; Alicia,8,0,20,12
1714607683457,LISP 5C,A00,507696,Munoz Sanchez; Alicia,9,0,20,11
1714607684482,MAE 197,001,528363,Boechler; Nicholas Sebastia,9998,0,9999,1
1714607685507,MATH 197,001,523477,Kedlaya; Kiran S.,9995,0,9999,4
1714607685507,MATH 197,002,563811,Zhang; Danna,9995,0,9999,4
1714607685507,MATH 197,003,628552,Dumitriu; Ioana,9998,0,9999,1
1714607686535,MCWP 40R,A00,518780,Staff,2,0,20,18
1714607686535,MCWP 40R,B00,518781,Staff,8,0,20,12
1714607686535,MCWP 40R,C00,518783,Staff,6,0,20,14
1714607687560,MCWP 50R,A00,518791,Staff,0,0,20,20
1714607687560,MCWP 50R,B00,518792,Staff,0,2,20,20
1714607687560,MCWP 50R,C00,518793,Staff,0,2,20,20
1714607687560,MCWP 50R,D00,518794,Staff,0,0,20,20
1714607687560,MCWP 50R,E00,518795,Staff,0,2,20,20
1714607687560,MCWP 50R,F00,518796,Staff,0,0,20,20
1714607687560,MCWP 50R,G00,518797,Staff,0,1,20,20
1714607688588,MMW 12R,A01,514034,Herbst; Matthew,0,0,16,16
1714607688588,MMW 12R,A02,514035,Herbst; Matthew,1,0,16,15
1714607689614,MMW 13R,A01,514037,Staff,0,4,16,16
1714607689614,MMW 13R,A02,514039,Staff,0,2,16,16
1714607689614,MMW 13R,A03,628519,Staff,0,2,16,16
1714607691667,SIO 295LS,A00,523233,Staff,10,0,30,20
1714607692691,SIO 295S,A00,523232,Staff,10,0,30,20
1714607693717,SIOC 290S,A01,637330,Merrifield; Mark A,23,0,30,7
1714607694744,SIOC 291S,A01,637333,Gabriel; Corey John,23,0,30,7
1714607695772,SOCI 117,A01,494376,Staff,0,4,5,5
1714607696798,WES 237B,A00,494380,Staff,9,0,20,11
1714607698877,AESE 279B,A00,494370,Wade; Jon P,0,0,33,33
1714607699903,AIP 197,001,627712,Vespa; Emanuel Ignacio,9998,0,9999,1
1714607700932,ANAR 135S,A00,494369,Braswell; Geoffrey E.,0,0,0,0
1714607701971,BENG 196,001,628496,Engler; Adam J.,9998,0,9999,1
1714607703000,CAT 124RS,A01,519847,Geibel; William,0,0,20,20
1714607704025,CAT 125RS,A01,515971,Geibel; William,0,0,20,20
1714607705051,CLRE 250,A00,511389,Morris; Sheldon,9993,0,9999,6
1714607706081,CLRE 251,A00,507176,Mehta; Ravindra L.,9993,0,9999,6
1714607706081,CLRE 251,B00,511410,Mehta; Ravindra L.,9998,0,9999,1
1714607707107,CLRE 252,A00,507189,Cuomo; Raphael Eduardo,9995,0,9999,4
1714607708136,CLRE 253,A00,507199,Vaida; Florin,9994,0,9999,5
1714607708136,CLRE 253,B00,507202,Vaida; Florin,9999,0,9999,0
1714607709165,CLRE 259,A00,507211,Patel; Hemal,9996,0,9999,3
1714607710190,CLRE 260,A00,507221,Cuomo; Raphael Eduardo,9999,0,9999,0
1714607711215,CLRE 297,001,507242,Cuomo; Raphael Eduardo,9999,0,9999,0
1714607712241,COGS 197,001,638244,Voytek; Bradley Thomas,9998,0,9999,1
1714607713267,CSE 191,A00,516875,Minnes Kemp; Mor Mia,9993,0,9999,6
1714607714295,CSE 197,001,637388,Minnes Kemp; Mor Mia,9998,0,9999,1
1714607715323,CSS 201S,A01,494383,Staff,35,0,35,0
1714607716349,CSS 202S,A01,494387,Staff,35,0,35,0
1714607717375,DSC 197,001,628532,Eldridge; Justin Matthew,9996,0,9999,3
1714607718403,EAP 100,A00,516065,Staff,9797,0,9999,202
1714607719429,ECE 45,A01,507414,Staff,33,0,60,27
1714607721479,ECE 111,A01,507420,Staff,15,0,50,35
1714607722504,ECE 197,001,548057,Sievenpiper; Daniel F.,9993,0,9999,6
1714607723533,EDS 115,A00,507243,Choi; Bailey Miyeon,10,0,28,18
1714607724559,EDS 117,A01,494379,Staff,1,5,30,29
1714607725586,EDS 125,A00,507246,Hopkins; Megan Beth,9,0,30,21
1714607726612,EDS 128A,A01,507264,Fargason; Sharon Gayle,8,0,26,18
1714607727637,EDS 128B,A01,507293,Pappas; Elizabeth,12,0,30,18
1714607728661,EDS 139,A00,507294,Fargason; Sharon Gayle,13,0,30,17
1714607728661,EDS 139,B00,507313,Pappas; Elizabeth,13,0,30,17
1714607729688,EDS 201,A00,507315,Staff,13,0,30,17
1714607730716,EDS 203,A01,507317,Halter; Christopher P.,12,0,30,18
1714607731742,EDS 204R,A01,507319,Halter; Christopher P.,0,3,30,30
1714607731742,EDS 204R,B01,507331,Heinzman; Erica M.,16,0,30,14
1714607732769,EDS 206R,A00,507332,Staff,0,4,30,30
1714607732769,EDS 206R,B00,507343,Staff,17,0,30,13
1714607733798,EDS 250,A00,507344,Hemans; Patricia Ann Benitez,22,0,40,18
1714607734827,EDS 281,A00,507345,Daly; Alan J.,18,0,18,0
1714607735854,EDS 284,A00,507350,Daly; Alan J.,16,0,16,0
1714607736878,EDS 286,A00,507359,Fine; Sarah,18,0,18,0
1714607737907,EDS 289C,A01,507361,Daly; Alan J.,18,0,18,0
1714607738936,EDS 290,A00,507366,Hofstetter; Carolyn,15,0,15,0
1714607739967,LIGM 5A,A00,507421,Fischer-Grunski; Eva K,18,0,20,2
1714607740997,LIGM 5B,A00,507423,Fischer-Grunski; Eva K,19,0,20,1
1714607742027,LIGM 5C,A00,507425,Fischer-Grunski; Eva K,19,0,20,1
1714607743055,LIIT 5AS,A00,507427,Carnelos; Chiara,20,0,20,0
1714607744096,LIIT 5BS,A00,507430,Carnelos; Chiara,20,0,20,0
1714607745125,LIIT 5CS,A00,507432,Carnelos; Chiara,20,0,20,0
1714607746153,LISP 5A,A00,507541,Munoz Sanchez; Alicia,11,0,20,9
1714607747181,LISP 5B,A00,507671,Munoz Sanchez; Alicia,8,0,20,12
1714607748205,LISP 5C,A00,507696,Munoz Sanchez; Alicia,9,0,20,11
1714607749285,MAE 197,001,528363,Boechler; Nicholas Sebastia,9998,0,9999,1
1714607750312,MATH 197,001,523477,Kedlaya; Kiran S.,9995,0,9999,4
1714607750312,MATH 197,002,563811,Zhang; Danna,9995,0,9999,4
1714607750312,MATH 197,003,628552,Dumitriu; Ioana,9998,0,9999,1
1714607751339,MCWP 40R,A00,518780,Staff,2,0,20,18
1714607751339,MCWP 40R,B00,518781,Staff,8,0,20,12
1714607751339,MCWP 40R,C00,518783,Staff,6,0,20,14
1714607752366,MCWP 50R,A00,518791,Staff,0,0,20,20
1714607752366,MCWP 50R,B00,518792,Staff,0,2,20,20
1714607752366,MCWP 50R,C00,518793,Staff,0,2,20,20
1714607752366,MCWP 50R,D00,518794,Staff,0,0,20,20
1714607752366,MCWP 50R,E00,518795,Staff,0,2,20,20
1714607752366,MCWP 50R,F00,518796,Staff,0,0,20,20
1714607752366,MCWP 50R,G00,518797,Staff,0,1,20,20
1714607753397,MMW 12R,A01,514034,Herbst; Matthew,0,0,16,16
1714607753397,MMW 12R,A02,514035,Herbst; Matthew,1,0,16,15
1714607754426,MMW 13R,A01,514037,Staff,0,4,16,16
1714607754426,MMW 13R,A02,514039,Staff,0,2,16,16
1714607754426,MMW 13R,A03,628519,Staff,0,2,16,16
1714607756475,SIO 295LS,A00,523233,Staff,10,0,30,20
1714607757503,SIO 295S,A00,523232,Staff,10,0,30,20
1714607758531,SIOC 290S,A01,637330,Merrifield; Mark A,23,0,30,7
1714607759557,SIOC 291S,A01,637333,Gabriel; Corey John,23,0,30,7
1714607760584,SOCI 117,A01,494376,Staff,0,4,5,5
1714607761611,WES 237B,A00,494380,Staff,9,0,20,11
1714607763684,AESE 279B,A00,494370,Wade; Jon P,0,0,33,33
1714607764712,AIP 197,001,627712,Vespa; Emanuel Ignacio,9998,0,9999,1
1714607765743,ANAR 135S,A00,494369,Braswell; Geoffrey E.,0,0,0,0
1714607766767,BENG 196,001,628496,Engler; Adam J.,9998,0,9999,1
1714607767795,CAT 124RS,A01,519847,Geibel; William,0,0,20,20
1714607768823,CAT 125RS,A01,515971,Geibel; William,0,0,20,20
1714607769851,CLRE 250,A00,511389,Morris; Sheldon,9993,0,9999,6
1714607770884,CLRE 251,A00,507176,Mehta; Ravindra L.,9993,0,9999,6
1714607770884,CLRE 251,B00,511410,Mehta; Ravindra L.,9998,0,9999,1
1714607771913,CLRE 252,A00,507189,Cuomo; Raphael Eduardo,9995,0,9999,4
1714607772942,CLRE 253,A00,507199,Vaida; Florin,9994,0,9999,5
1714607772942,CLRE 253,B00,507202,Vaida; Florin,9999,0,9999,0
1714607773966,CLRE 259,A00,507211,Patel; Hemal,9996,0,9999,3
1714607774991,CLRE 260,A00,507221,Cuomo; Raphael Eduardo,9999,0,9999,0
1714607776016,CLRE 297,001,507242,Cuomo; Raphael Eduardo,9999,0,9999,0
1714607777059,COGS 197,001,638244,Voytek; Bradley Thomas,9998,0,9999,1
1714607778088,CSE 191,A00,516875,Minnes Kemp; Mor Mia,9993,0,9999,6
1714607779113,CSE 197,001,637388,Minnes Kemp; Mor Mia,9998,0,9999,1
1714607780139,CSS 201S,A01,494383,Staff,35,0,35,0
1714607781174,CSS 202S,A01,494387,Staff,35,0,35,0
1714607782204,DSC 197,001,628532,Eldridge; Justin Matthew,9996,0,9999,3
1714607783230,EAP 100,A00,516065,Staff,9797,0,9999,202
1714607784256,ECE 45,A01,507414,Staff,33,0,60,27
1714607786306,ECE 111,A01,507420,Staff,15,0,50,35
1714607787331,ECE 197,001,548057,Sievenpiper; Daniel F.,9993,0,9999,6
1714607788355,EDS 115,A00,507243,Choi; Bailey Miyeon,10,0,28,18
1714607789380,EDS 117,A01,494379,Staff,1,5,30,29
1714607790409,EDS 125,A00,507246,Hopkins; Megan Beth,9,0,30,21
1714607791434,EDS 128A,A01,507264,Fargason; Sharon Gayle,8,0,26,18
1714607792461,EDS 128B,A01,507293,Pappas; Elizabeth,12,0,30,18
1714607793740,EDS 139,A00,507294,Fargason; Sharon Gayle,13,0,30,17
1714607793740,EDS 139,B00,507313,Pappas; Elizabeth,13,0,30,17
1714607794764,EDS 201,A00,507315,Staff,13,0,30,17
1714607795791,EDS 203,A01,507317,Halter; Christopher P.,12,0,30,18
1714607796820,EDS 204R,A01,507319,Halter; Christopher P.,0,3,30,30
1714607796820,EDS 204R,B01,507331,Heinzman; Erica M.,16,0,30,14
1714607797847,EDS 206R,A00,507332,Staff,0,4,30,30
1714607797847,EDS 206R,B00,507343,Staff,17,0,30,13
1714607798876,EDS 250,A00,507344,Hemans; Patricia Ann Benitez,22,0,40,18
1714607799903,EDS 281,A00,507345,Daly; Alan J.,18,0,18,0
1714607800927,EDS 284,A00,507350,Daly; Alan J.,16,0,16,0
1714607801951,EDS 286,A00,507359,Fine; Sarah,18,0,18,0
1714607802978,EDS 289C,A01,507361,Daly; Alan J.,18,0,18,0
1714607804006,EDS 290,A00,507366,Hofstetter; Carolyn,15,0,15,0
1714607805032,LIGM 5A,A00,507421,Fischer-Grunski; Eva K,18,0,20,2
1714607806058,LIGM 5B,A00,507423,Fischer-Grunski; Eva K,19,0,20,1
1714607807082,LIGM 5C,A00,507425,Fischer-Grunski; Eva K,19,0,20,1
1714607808108,LIIT 5AS,A00,507427,Carnelos; Chiara,20,0,20,0
1714607809133,LIIT 5BS,A00,507430,Carnelos; Chiara,20,0,20,0
1714607810161,LIIT 5CS,A00,507432,Carnelos; Chiara,20,0,20,0
1714607811187,LISP 5A,A00,507541,Munoz Sanchez; Alicia,11,0,20,9
1714607812211,LISP 5B,A00,507671,Munoz Sanchez; Alicia,8,0,20,12
1714607813237,LISP 5C,A00,507696,Munoz Sanchez; Alicia,9,0,20,11
1714607814262,MAE 197,001,528363,Boechler; Nicholas Sebastia,9998,0,9999,1
1714607815290,MATH 197,001,523477,Kedlaya; Kiran S.,9995,0,9999,4
1714607815290,MATH 197,002,563811,Zhang; Danna,9995,0,9999,4
1714607815290,MATH 197,003,628552,Dumitriu; Ioana,9998,0,9999,1
1714607816319,MCWP 40R,A00,518780,Staff,2,0,20,18
1714607816319,MCWP 40R,B00,518781,Staff,8,0,20,12
1714607816319,MCWP 40R,C00,518783,Staff,6,0,20,14
1714607817346,MCWP 50R,A00,518791,Staff,0,0,20,20
1714607817346,MCWP 50R,B00,518792,Staff,0,2,20,20
1714607817346,MCWP 50R,C00,518793,Staff,0,2,20,20
1714607817346,MCWP 50R,D00,518794,Staff,0,0,20,20
1714607817346,MCWP 50R,E00,518795,Staff,0,2,20,20
1714607817346,MCWP 50R,F00,518796,Staff,0,0,20,20
1714607817346,MCWP 50R,G00,518797,Staff,0,1,20,20
1714607818373,MMW 12R,A01,514034,Herbst; Matthew,0,0,16,16
1714607818373,MMW 12R,A02,514035,Herbst; Matthew,1,0,16,15
1714607819400,MMW 13R,A01,514037,Staff,0,4,16,16
1714607819400,MMW 13R,A02,514039,Staff,0,2,16,16
1714607819400,MMW 13R,A03,628519,Staff,0,2,16,16
1714607821455,SIO 295LS,A00,523233,Staff,10,0,30,20
1714607822480,SIO 295S,A00,523232,Staff,10,0,30,20
1714607823509,SIOC 290S,A01,637330,Merrifield; Mark A,23,0,30,7
1714607824538,SIOC 291S,A01,637333,Gabriel; Corey John,23,0,30,7
1714607825563,SOCI 117,A01,494376,Staff,0,4,5,5
1714607826588,WES 237B,A00,494380,Staff,9,0,20,11
1714607828661,AESE 279B,A00,494370,Wade; Jon P,0,0,33,33
1714607829687,AIP 197,001,627712,Vespa; Emanuel Ignacio,9998,0,9999,1
1714607830717,ANAR 135S,A00,494369,Braswell; Geoffrey E.,0,0,0,0
1714607831743,BENG 196,001,628496,Engler; Adam J.,9998,0,9999,1
1714607832772,CAT 124RS,A01,519847,Geibel; William,0,0,20,20
1714607833798,CAT 125RS,A01,515971,Geibel; William,0,0,20,20
1714607834825,CLRE 250,A00,511389,Morris; Sheldon,9993,0,9999,6
1714607835854,CLRE 251,A00,507176,Mehta; Ravindra L.,9993,0,9999,6
1714607835854,CLRE 251,B00,511410,Mehta; Ravindra L.,9998,0,9999,1
1714607836880,CLRE 252,A00,507189,Cuomo; Raphael Eduardo,9995,0,9999,4
1714607837910,CLRE 253,A00,507199,Vaida; Florin,9994,0,9999,5
1714607837910,CLRE 253,B00,507202,Vaida; Florin,9999,0,9999,0
1714607838940,CLRE 259,A00,507211,Patel; Hemal,9996,0,9999,3
1714607839968,CLRE 260,A00,507221,Cuomo; Raphael Eduardo,9999,0,9999,0
1714607840995,CLRE 297,001,507242,Cuomo; Raphael Eduardo,9999,0,9999,0
1714607842020,COGS 197,001,638244,Voytek; Bradley Thomas,9998,0,9999,1
1714607843047,CSE 191,A00,516875,Minnes Kemp; Mor Mia,9993,0,9999,6
1714607844074,CSE 197,001,637388,Minnes Kemp; Mor Mia,9998,0,9999,1
1714607845103,CSS 201S,A01,494383,Staff,35,0,35,0
1714607846132,CSS 202S,A01,494387,Staff,35,0,35,0
1714607847156,DSC 197,001,628532,Eldridge; Justin Matthew,9996,0,9999,3
1714607848187,EAP 100,A00,516065,Staff,9797,0,9999,202
1714607849212,ECE 45,A01,507414,Staff,33,0,60,27
1714607851266,ECE 111,A01,507420,Staff,15,0,50,35
1714607852292,ECE 197,001,548057,Sievenpiper; Daniel F.,9993,0,9999,6
1714607853377,EDS 115,A00,507243,Choi; Bailey Miyeon,10,0,28,18
1714607854410,EDS 117,A01,494379,Staff,1,5,30,29
1714607855436,EDS 125,A00,507246,Hopkins; Megan Beth,9,0,30,21
1714607856462,EDS 128A,A01,507264,Fargason; Sharon Gayle,8,0,26,18
1714607857488,EDS 128B,A01,507293,Pappas; Elizabeth,12,0,30,18
1714607858515,EDS 139,A00,507294,Fargason; Sharon Gayle,13,0,30,17
1714607858515,EDS 139,B00,507313,Pappas; Elizabeth,13,0,30,17
1714607859541,EDS 201,A00,507315,Staff,13,0,30,17
1714607860567,EDS 203,A01,507317,Halter; Christopher P.,12,0,30,18
1714607861593,EDS 204R,A01,507319,Halter; Christopher P.,0,3,30,30
1714607861593,EDS 204R,B01,507331,Heinzman; Erica M.,16,0,30,14
1714607862619,EDS 206R,A00,507332,Staff,0,4,30,30
1714607862619,EDS 206R,B00,507343,Staff,17,0,30,13
1714607863646,EDS 250,A00,507344,Hemans; Patricia Ann Benitez,22,0,40,18
1714607864671,EDS 281,A00,507345,Daly; Alan J.,18,0,18,0
1714607865696,EDS 284,A00,507350,Daly; Alan J.,16,0,16,0
1714607866726,EDS 286,A00,507359,Fine; Sarah,18,0,18,0
1714607867753,EDS 289C,A01,507361,Daly; Alan J.,18,0,18,0
1714607868778,EDS 290,A00,507366,Hofstetter; Carolyn,15,0,15,0
1714607869807,LIGM 5A,A00,507421,Fischer-Grunski; Eva K,18,0,20,2
1714607870832,LIGM 5B,A00,507423,Fischer-Grunski; Eva K,19,0,20,1
1714607871857,LIGM 5C,A00,507425,Fischer-Grunski; Eva K,19,0,20,1
1714607872884,LIIT 5AS,A00,507427,Carnelos; Chiara,20,0,20,0
1714607873910,LIIT 5BS,A00,507430,Carnelos; Chiara,20,0,20,0
1714607874934,LIIT 5CS,A00,507432,Carnelos; Chiara,20,0,20,0
1714607875963,LISP 5A,A00,507541,Munoz Sanchez; Alicia,11,0,20,9
1714607876989,LISP 5B,A00,507671,Munoz Sanchez; Alicia,8,0,20,12
1714607878014,LISP 5C,A00,507696,Munoz Sanchez; Alicia,9,0,20,11
1714607879042,MAE 197,001,528363,Boechler; Nicholas Sebastia,9998,0,9999,1
1714607880073,MATH 197,001,523477,Kedlaya; Kiran S.,9995,0,9999,4
1714607880073,MATH 197,002,563811,Zhang; Danna,9995,0,9999,4
1714607880073,MATH 197,003,628552,Dumitriu; Ioana,9998,0,9999,1
1714607881097,MCWP 40R,A00,518780,Staff,2,0,20,18
1714607881097,MCWP 40R,B00,518781,Staff,8,0,20,12
1714607881097,MCWP 40R,C00,518783,Staff,6,0,20,14
1714607882123,MCWP 50R,A00,518791,Staff,0,0,20,20
1714607882123,MCWP 50R,B00,518792,Staff,0,2,20,20
1714607882123,MCWP 50R,C00,518793,Staff,0,2,20,20
1714607882123,MCWP 50R,D00,518794,Staff,0,0,20,20
1714607882123,MCWP 50R,E00,518795,Staff,0,2,20,20
1714607882123,MCWP 50R,F00,518796,Staff,0,0,20,20
1714607882123,MCWP 50R,G00,518797,Staff,0,1,20,20
1714607883148,MMW 12R,A01,514034,Herbst; Matthew,0,0,16,16
1714607883148,MMW 12R,A02,514035,Herbst; Matthew,1,0,16,15
1714607884173,MMW 13R,A01,514037,Staff,0,4,16,16
1714607884173,MMW 13R,A02,514039,Staff,0,2,16,16
1714607884173,MMW 13R,A03,628519,Staff,0,2,16,16
1714607886226,SIO 295LS,A00,523233,Staff,10,0,30,20
1714607887256,SIO 295S,A00,523232,Staff,10,0,30,20
1714607888281,SIOC 290S,A01,637330,Merrifield; Mark A,23,0,30,7
1714607889311,SIOC 291S,A01,637333,Gabriel; Corey John,23,0,30,7
1714607890338,SOCI 117,A01,494376,Staff,0,4,5,5
1714607891363,WES 237B,A00,494380,Staff,9,0,20,11
1714607893439,AESE 279B,A00,494370,Wade; Jon P,0,0,33,33
1714607894468,AIP 197,001,627712,Vespa; Emanuel Ignacio,9998,0,9999,1
1714607895493,ANAR 135S,A00,494369,Braswell; Geoffrey E.,0,0,0,0
1714607896517,BENG 196,001,628496,Engler; Adam J.,9998,0,9999,1
1714607897543,CAT 124RS,A01,519847,Geibel; William,0,0,20,20
1714607898569,CAT 125RS,A01,515971,Geibel; William,0,0,20,20
1714607899596,CLRE 250,A00,511389,Morris; Sheldon,9993,0,9999,6
1714607900628,CLRE 251,A00,507176,Mehta; Ravindra L.,9993,0,9999,6
1714607900628,CLRE 251,B00,511410,Mehta; Ravindra L.,9998,0,9999,1
1714607901660,CLRE 252,A00,507189,Cuomo; Raphael Eduardo,9995,0,9999,4
1714607902686,CLRE 253,A00,507199,Vaida; Florin,9994,0,9999,5
1714607902686,CLRE 253,B00,507202,Vaida; Florin,9999,0,9999,0
1714607903713,CLRE 259,A00,507211,Patel; Hemal,9996,0,9999,3
1714607904741,CLRE 260,A00,507221,Cuomo; Raphael Eduardo,9999,0,9999,0
1714607905766,CLRE 297,001,507242,Cuomo; Raphael Eduardo,9999,0,9999,0
1714607906792,COGS 197,001,638244,Voytek; Bradley Thomas,9998,0,9999,1
1714607907819,CSE 191,A00,516875,Minnes Kemp; Mor Mia,9993,0,9999,6
1714607908847,CSE 197,001,637388,Minnes Kemp; Mor Mia,9998,0,9999,1
1714607909873,CSS 201S,A01,494383,Staff,35,0,35,0
1714607910900,CSS 202S,A01,494387,Staff,35,0,35,0
1714607911929,DSC 197,001,628532,Eldridge; Justin Matthew,9996,0,9999,3
1714607912955,EAP 100,A00,516065,Staff,9797,0,9999,202
1714607913985,ECE 45,A01,507414,Staff,33,0,60,27
1714607916037,ECE 111,A01,507420,Staff,15,0,50,35
1714607917061,ECE 197,001,548057,Sievenpiper; Daniel F.,9993,0,9999,6
1714607918090,EDS 115,A00,507243,Choi; Bailey Miyeon,10,0,28,18
1714607919117,EDS 117,A01,494379,Staff,1,5,30,29
1714607920142,EDS 125,A00,507246,Hopkins; Megan Beth,9,0,30,21
1714607921169,EDS 128A,A01,507264,Fargason; Sharon Gayle,8,0,26,18
1714607922200,EDS 128B,A01,507293,Pappas; Elizabeth,12,0,30,18
1714607923225,EDS 139,A00,507294,Fargason; Sharon Gayle,13,0,30,17
1714607923225,EDS 139,B00,507313,Pappas; Elizabeth,13,0,30,17
1714607924254,EDS 201,A00,507315,Staff,13,0,30,17
1714607925284,EDS 203,A01,507317,Halter; Christopher P.,12,0,30,18
1714607926309,EDS 204R,A01,507319,Halter; Christopher P.,0,3,30,30
1714607926309,EDS 204R,B01,507331,Heinzman; Erica M.,16,0,30,14
1714607927333,EDS 206R,A00,507332,Staff,0,4,30,30
1714607927333,EDS 206R,B00,507343,Staff,17,0,30,13
1714607928358,EDS 250,A00,507344,Hemans; Patricia Ann Benitez,22,0,40,18
1714607929383,EDS 281,A00,507345,Daly; Alan J.,18,0,18,0
1714607930411,EDS 284,A00,507350,Daly; Alan J.,16,0,16,0
1714607931435,EDS 286,A00,507359,Fine; Sarah,18,0,18,0
1714607932459,EDS 289C,A01,507361,Daly; Alan J.,18,0,18,0
1714607933484,EDS 290,A00,507366,Hofstetter; Carolyn,15,0,15,0
1714607934514,LIGM 5A,A00,507421,Fischer-Grunski; Eva K,18,0,20,2
1714607935538,LIGM 5B,A00,507423,Fischer-Grunski; Eva K,19,0,20,1
1714607936567,LIGM 5C,A00,507425,Fischer-Grunski; Eva K,19,0,20,1
1714607937593,LIIT 5AS,A00,507427,Carnelos; Chiara,20,0,20,0
1714607938622,LIIT 5BS,A00,507430,Carnelos; Chiara,20,0,20,0
1714607939647,LIIT 5CS,A00,507432,Carnelos; Chiara,20,0,20,0
1714607940671,LISP 5A,A00,507541,Munoz Sanchez; Alicia,11,0,20,9
1714607941698,LISP 5B,A00,507671,Munoz Sanchez; Alicia,8,0,20,12
1714607942723,LISP 5C,A00,507696,Munoz Sanchez; Alicia,9,0,20,11
1714607943749,MAE 197,001,528363,Boechler; Nicholas Sebastia,9998,0,9999,1
1714607944781,MATH 197,001,523477,Kedlaya; Kiran S.,9995,0,9999,4
1714607944781,MATH 197,002,563811,Zhang; Danna,9995,0,9999,4
1714607944781,MATH 197,003,628552,Dumitriu; Ioana,9998,0,9999,1
1714607945813,MCWP 40R,A00,518780,Staff,2,0,20,18
1714607945813,MCWP 40R,B00,518781,Staff,8,0,20,12
1714607945813,MCWP 40R,C00,518783,Staff,6,0,20,14
1714607946843,MCWP 50R,A00,518791,Staff,0,0,20,20
1714607946843,MCWP 50R,B00,518792,Staff,0,2,20,20
1714607946843,MCWP 50R,C00,518793,Staff,0,2,20,20
1714607946843,MCWP 50R,D00,518794,Staff,0,0,20,20
1714607946843,MCWP 50R,E00,518795,Staff,0,2,20,20
1714607946843,MCWP 50R,F00,518796,Staff,0,0,20,20
1714607946843,MCWP 50R,G00,518797,Staff,0,1,20,20
1714607947871,MMW 12R,A01,514034,Herbst; Matthew,0,0,16,16
1714607947871,MMW 12R,A02,514035,Herbst; Matthew,1,0,16,15
1714607948900,MMW 13R,A01,514037,Staff,0,4,16,16
1714607948900,MMW 13R,A02,514039,Staff,0,2,16,16
1714607948900,MMW 13R,A03,628519,Staff,0,2,16,16
1714607950957,SIO 295LS,A00,523233,Staff,10,0,30,20
1714607951986,SIO 295S,A00,523232,Staff,10,0,30,20
1714607953014,SIOC 290S,A01,637330,Merrifield; Mark A,23,0,30,7
1714607954039,SIOC 291S,A01,637333,Gabriel; Corey John,23,0,30,7
1714607955070,SOCI 117,A01,494376,Staff,0,4,5,5
1714607956094,WES 237B,A00,494380,Staff,9,0,20,11
1714607958168,AESE 279B,A00,494370,Wade; Jon P,0,0,33,33
1714607959192,AIP 197,001,627712,Vespa; Emanuel Ignacio,9998,0,9999,1
1714607960218,ANAR 135S,A00,494369,Braswell; Geoffrey E.,0,0,0,0
1714607961242,BENG 196,001,628496,Engler; Adam J.,9998,0,9999,1
1714607962267,CAT 124RS,A01,519847,Geibel; William,0,0,20,20
1714607963293,CAT 125RS,A01,515971,Geibel; William,0,0,20,20
1714607964317,CLRE 250,A00,511389,Morris; Sheldon,9993,0,9999,6
1714607965344,CLRE 251,A00,507176,Mehta; Ravindra L.,9993,0,9999,6
1714607965344,CLRE 251,B00,511410,Mehta; Ravindra L.,9998,0,9999,1
1714607966370,CLRE 252,A00,507189,Cuomo; Raphael Eduardo,9995,0,9999,4
1714607967403,CLRE 253,A00,507199,Vaida; Florin,9994,0,9999,5
1714607967403,CLRE 253,B00,507202,Vaida; Florin,9999,0,9999,0
1714607968432,CLRE 259,A00,507211,Patel; Hemal,9996,0,9999,3
1714607969460,CLRE 260,A00,507221,Cuomo; Raphael Eduardo,9999,0,9999,0
1714607970487,CLRE 297,001,507242,Cuomo; Raphael Eduardo,9999,0,9999,0
1714607971515,COGS 197,001,638244,Voytek; Bradley Thomas,9998,0,9999,1
1714607972543,CSE 191,A00,516875,Minnes Kemp; Mor Mia,9993,0,9999,6
1714607973568,CSE 197,001,637388,Minnes Kemp; Mor Mia,9998,0,9999,1
1714607974599,CSS 201S,A01,494383,Staff,35,0,35,0
1714607975624,CSS 202S,A01,494387,Staff,35,0,35,0
1714607976652,DSC 197,001,628532,Eldridge; Justin Matthew,9996,0,9999,3
1714607977676,EAP 100,A00,516065,Staff,9797,0,9999,202
1714607978702,ECE 45,A01,507414,Staff,33,0,60,27
1714607980756,ECE 111,A01,507420,Staff,15,0,50,35
1714607981781,ECE 197,001,548057,Sievenpiper; Daniel F.,9993,0,9999,6
1714607982806,EDS 115,A00,507243,Choi; Bailey Miyeon,10,0,28,18
1714607983832,EDS 117,A01,494379,Staff,1,5,30,29
1714607984860,EDS 125,A00,507246,Hopkins; Megan Beth,9,0,30,21
1714607985886,EDS 128A,A01,507264,Fargason; Sharon Gayle,8,0,26,18
1714607986916,EDS 128B,A01,507293,Pappas; Elizabeth,12,0,30,18
1714607987944,EDS 139,A00,507294,Fargason; Sharon Gayle,13,0,30,17
1714607987944,EDS 139,B00,507313,Pappas; Elizabeth,13,0,30,17
1714607988969,EDS 201,A00,507315,Staff,13,0,30,17
1714607989998,EDS 203,A01,507317,Halter; Christopher P.,12,0,30,18
1714607991023,EDS 204R,A01,507319,Halter; Christopher P.,0,3,30,30
1714607991023,EDS 204R,B01,507331,Heinzman; Erica M.,16,0,30,14
1714607992049,EDS 206R,A00,507332,Staff,0,4,30,30
1714607992049,EDS 206R,B00,507343,Staff,17,0,30,13
1714607993083,EDS 250,A00,507344,Hemans; Patricia Ann Benitez,22,0,40,18
1714607994110,EDS 281,A00,507345,Daly; Alan J.,18,0,18,0
1714607995139,EDS 284,A00,507350,Daly; Alan J.,16,0,16,0
1714607996164,EDS 286,A00,507359,Fine; Sarah,18,0,18,0
1714607997188,EDS 289C,A01,507361,Daly; Alan J.,18,0,18,0
1714607998214,EDS 290,A00,507366,Hofstetter; Carolyn,15,0,15,0
1714607999244,LIGM 5A,A00,507421,Fischer-Grunski; Eva K,18,0,20,2
1714608000327,LIGM 5B,A00,507423,Fischer-Grunski; Eva K,19,0,20,1
1714608001356,LIGM 5C,A00,507425,Fischer-Grunski; Eva K,19,0,20,1
1714608002385,LIIT 5AS,A00,507427,Carnelos; Chiara,20,0,20,0
1714608003408,LIIT 5BS,A00,507430,Carnelos; Chiara,20,0,20,0
1714608004435,LIIT 5CS,A00,507432,Carnelos; Chiara,20,0,20,0
1714608005460,LISP 5A,A00,507541,Munoz Sanchez; Alicia,11,0,20,9
1714608006484,LISP 5B,A00,507671,Munoz Sanchez; Alicia,8,0,20,12
1714608007509,LISP 5C,A00,507696,Munoz Sanchez; Alicia,9,0,20,11
1714608008539,MAE 197,001,528363,Boechler; Nicholas Sebastia,9998,0,9999,1
1714608009568,MATH 197,001,523477,Kedlaya; Kiran S.,9995,0,9999,4
1714608009568,MATH 197,002,563811,Zhang; Danna,9995,0,9999,4
1714608009568,MATH 197,003,628552,Dumitriu; Ioana,9998,0,9999,1
1714608010612,MCWP 40R,A00,518780,Staff,2,0,20,18
1714608010612,MCWP 40R,B00,518781,Staff,8,0,20,12
1714608010612,MCWP 40R,C00,518783,Staff,6,0,20,14
1714608011638,MCWP 50R,A00,518791,Staff,0,0,20,20
1714608011638,MCWP 50R,B00,518792,Staff,0,2,20,20
1714608011638,MCWP 50R,C00,518793,Staff,0,2,20,20
1714608011638,MCWP 50R,D00,518794,Staff,0,0,20,20
1714608011638,MCWP 50R,E00,518795,Staff,0,2,20,20
1714608011638,MCWP 50R,F00,518796,Staff,0,0,20,20
1714608011638,MCWP 50R,G00,518797,Staff,0,1,20,20
1714608012664,MMW 12R,A01,514034,Herbst; Matthew,0,0,16,16
1714608012664,MMW 12R,A02,514035,Herbst; Matthew,1,0,16,15
1714608013693,MMW 13R,A01,514037,Staff,0,4,16,16
1714608013693,MMW 13R,A02,514039,Staff,0,2,16,16
1714608013693,MMW 13R,A03,628519,Staff,0,2,16,16
1714608015748,SIO 295LS,A00,523233,Staff,10,0,30,20
1714608016775,SIO 295S,A00,523232,Staff,10,0,30,20
1714608017800,SIOC 290S,A01,637330,Merrifield; Mark A,23,0,30,7
1714608018826,SIOC 291S,A01,637333,Gabriel; Corey John,23,0,30,7
1714608019850,SOCI 117,A01,494376,Staff,0,4,5,5
1714608020878,WES 237B,A00,494380,Staff,9,0,20,11
1714608022944,AESE 279B,A00,494370,Wade; Jon P,0,0,33,33
1714608023973,AIP 197,001,627712,Vespa; Emanuel Ignacio,9998,0,9999,1
1714608025001,ANAR 135S,A00,494369,Braswell; Geoffrey E.,0,0,0,0
1714608026026,BENG 196,001,628496,Engler; Adam J.,9998,0,9999,1
1714608027054,CAT 124RS,A01,519847,Geibel; William,0,0,20,20
1714608028078,CAT 125RS,A01,515971,Geibel; William,0,0,20,20
1714608029107,CLRE 250,A00,511389,Morris; Sheldon,9993,0,9999,6
1714608030135,CLRE 251,A00,507176,Mehta; Ravindra L.,9993,0,9999,6
1714608030135,CLRE 251,B00,511410,Mehta; Ravindra L.,9998,0,9999,1
1714608031160,CLRE 252,A00,507189,Cuomo; Raphael Eduardo,9995,0,9999,4
1714608032186,CLRE 253,A00,507199,Vaida; Florin,9994,0,9999,5
1714608032186,CLRE 253,B00,507202,Vaida; Florin,9999,0,9999,0
1714608033212,CLRE 259,A00,507211,Patel; Hemal,9996,0,9999,3
1714608034239,CLRE 260,A00,507221,Cuomo; Raphael Eduardo,9999,0,9999,0
1714608035263,CLRE 297,001,507242,Cuomo; Raphael Eduardo,9999,0,9999,0
1714608036289,COGS 197,001,638244,Voytek; Bradley Thomas,9998,0,9999,1
1714608037313,CSE 191,A00,516875,Minnes Kemp; Mor Mia,9993,0,9999,6
1714608038337,CSE 197,001,637388,Minnes Kemp; Mor Mia,9998,0,9999,1
1714608039363,CSS 201S,A01,494383,Staff,35,0,35,0
1714608040389,CSS 202S,A01,494387,Staff,35,0,35,0
1714608041416,DSC 197,001,628532,Eldridge; Justin Matthew,9996,0,9999,3
1714608042442,EAP 100,A00,516065,Staff,9797,0,9999,202
1714608043471,ECE 45,A01,507414,Staff,33,0,60,27
1714608045520,ECE 111,A01,507420,Staff,15,0,50,35
1714608046546,ECE 197,001,548057,Sievenpiper; Daniel F.,9993,0,9999,6
1714608047572,EDS 115,A00,507243,Choi; Bailey Miyeon,10,0,28,18
1714608048602,EDS 117,A01,494379,Staff,1,5,30,29
1714608049626,EDS 125,A00,507246,Hopkins; Megan Beth,9,0,30,21
1714608050651,EDS 128A,A01,507264,Fargason; Sharon Gayle,8,0,26,18
1714608051675,EDS 128B,A01,507293,Pappas; Elizabeth,12,0,30,18
1714608052702,EDS 139,A00,507294,Fargason; Sharon Gayle,13,0,30,17
1714608052702,EDS 139,B00,507313,Pappas; Elizabeth,13,0,30,17
1714608053725,EDS 201,A00,507315,Staff,13,0,30,17
1714608054753,EDS 203,A01,507317,Halter; Christopher P.,12,0,30,18
1714608055780,EDS 204R,A01,507319,Halter; Christopher P.,0,3,30,30
1714608055780,EDS 204R,B01,507331,Heinzman; Erica M.,16,0,30,14
1714608056804,EDS 206R,A00,507332,Staff,0,4,30,30
1714608056804,EDS 206R,B00,507343,Staff,17,0,30,13
1714608057833,EDS 250,A00,507344,Hemans; Patricia Ann Benitez,22,0,40,18
1714608058860,EDS 281,A00,507345,Daly; Alan J.,18,0,18,0
1714608059884,EDS 284,A00,507350,Daly; Alan J.,16,0,16,0
1714608060914,EDS 286,A00,507359,Fine; Sarah,18,0,18,0
1714608061938,EDS 289C,A01,507361,Daly; Alan J.,18,0,18,0
1714608062963,EDS 290,A00,507366,Hofstetter; Carolyn,15,0,15,0
1714608063991,LIGM 5A,A00,507421,Fischer-Grunski; Eva K,18,0,20,2
1714608065023,LIGM 5B,A00,507423,Fischer-Grunski; Eva K,19,0,20,1
1714608066047,LIGM 5C,A00,507425,Fischer-Grunski; Eva K,19,0,20,1
1714608067077,LIIT 5AS,A00,507427,Carnelos; Chiara,20,0,20,0
1714608068103,LIIT 5BS,A00,507430,Carnelos; Chiara,20,0,20,0
1714608069128,LIIT 5CS,A00,507432,Carnelos; Chiara,20,0,20,0
1714608070159,LISP 5A,A00,507541,Munoz Sanchez; Alicia,11,0,20,9
1714608071185,LISP 5B,A00,507671,Munoz Sanchez; Alicia,8,0,20,12
1714608072217,LISP 5C,A00,507696,Munoz Sanchez; Alicia,9,0,20,11
1714608073244,MAE 197,001,528363,Boechler; Nicholas Sebastia,9998,0,9999,1
1714608074270,MATH 197,001,523477,Kedlaya; Kiran S.,9995,0,9999,4
1714608074270,MATH 197,002,563811,Zhang; Danna,9995,0,9999,4
1714608074270,MATH 197,003,628552,Dumitriu; Ioana,9998,0,9999,1
1714608075300,MCWP 40R,A00,518780,Staff,2,0,20,18
1714608075300,MCWP 40R,B00,518781,Staff,8,0,20,12
1714608075300,MCWP 40R,C00,518783,Staff,6,0,20,14
1714608076330,MCWP 50R,A00,518791,Staff,0,0,20,20
1714608076330,MCWP 50R,B00,518792,Staff,0,2,20,20
1714608076330,MCWP 50R,C00,518793,Staff,0,2,20,20
1714608076330,MCWP 50R,D00,518794,Staff,0,0,20,20
1714608076330,MCWP 50R,E00,518795,Staff,0,2,20,20
1714608076330,MCWP 50R,F00,518796,Staff,0,0,20,20
1714608076330,MCWP 50R,G00,518797,Staff,0,1,20,20
1714608077354,MMW 12R,A01,514034,Herbst; Matthew,0,0,16,16
1714608077354,MMW 12R,A02,514035,Herbst; Matthew,1,0,16,15
1714608078382,MMW 13R,A01,514037,Staff,0,4,16,16
1714608078382,MMW 13R,A02,514039,Staff,0,2,16,16
1714608078382,MMW 13R,A03,628519,Staff,0,2,16,16
1714608080430,SIO 295LS,A00,523233,Staff,10,0,30,20
1714608081455,SIO 295S,A00,523232,Staff,10,0,30,20
1714608082481,SIOC 290S,A01,637330,Merrifield; Mark A,23,0,30,7
1714608083511,SIOC 291S,A01,637333,Gabriel; Corey John,23,0,30,7
1714608084542,SOCI 117,A01,494376,Staff,0,4,5,5
1714608085567,WES 237B,A00,494380,Staff,9,0,20,11
1714608087638,AESE 279B,A00,494370,Wade; Jon P,0,0,33,33
1714608088667,AIP 197,001,627712,Vespa; Emanuel Ignacio,9998,0,9999,1
1714608089693,ANAR 135S,A00,494369,Braswell; Geoffrey E.,0,0,0,0
1714608090723,BENG 196,001,628496,Engler; Adam J.,9998,0,9999,1
1714608091749,CAT 124RS,A01,519847,Geibel; William,0,0,20,20
1714608092774,CAT 125RS,A01,515971,Geibel; William,0,0,20,20
1714608093801,CLRE 250,A00,511389,Morris; Sheldon,9993,0,9999,6
1714608094833,CLRE 251,A00,507176,Mehta; Ravindra L.,9993,0,9999,6
1714608094833,CLRE 251,B00,511410,Mehta; Ravindra L.,9998,0,9999,1
1714608095863,CLRE 252,A00,507189,Cuomo; Raphael Eduardo,9995,0,9999,4
1714608096892,CLRE 253,A00,507199,Vaida; Florin,9994,0,9999,5
1714608096892,CLRE 253,B00,507202,Vaida; Florin,9999,0,9999,0
1714608097918,CLRE 259,A00,507211,Patel; Hemal,9996,0,9999,3
1714608098947,CLRE 260,A00,507221,Cuomo; Raphael Eduardo,9999,0,9999,0
1714608099974,CLRE 297,001,507242,Cuomo; Raphael Eduardo,9999,0,9999,0
1714608101000,COGS 197,001,638244,Voytek; Bradley Thomas,9998,0,9999,1
1714608102027,CSE 191,A00,516875,Minnes Kemp; Mor Mia,9993,0,9999,6
1714608103056,CSE 197,001,637388,Minnes Kemp; Mor Mia,9998,0,9999,1
1714608104138,CSS 201S,A01,494383,Staff,35,0,35,0
1714608105166,CSS 202S,A01,494387,Staff,35,0,35,0
1714608106191,DSC 197,001,628532,Eldridge; Justin Matthew,9996,0,9999,3
1714608107234,EAP 100,A00,516065,Staff,9797,0,9999,202
1714608108260,ECE 45,A01,507414,Staff,33,0,60,27
1714608110314,ECE 111,A01,507420,Staff,15,0,50,35
1714608111339,ECE 197,001,548057,Sievenpiper; Daniel F.,9993,0,9999,6
1714608112367,EDS 115,A00,507243,Choi; Bailey Miyeon,10,0,28,18
1714608113394,EDS 117,A01,494379,Staff,1,5,30,29
1714608114427,EDS 125,A00,507246,Hopkins; Megan Beth,9,0,30,21
1714608115454,EDS 128A,A01,507264,Fargason; Sharon Gayle,8,0,26,18
1714608116480,EDS 128B,A01,507293,Pappas; Elizabeth,12,0,30,18
1714608117507,EDS 139,A00,507294,Fargason; Sharon Gayle,13,0,30,17
1714608117507,EDS 139,B00,507313,Pappas; Elizabeth,13,0,30,17
1714608118533,EDS 201,A00,507315,Staff,13,0,30,17
1714608119559,EDS 203,A01,507317,Halter; Christopher P.,12,0,30,18
1714608120585,EDS 204R,A01,507319,Halter; Christopher P.,0,3,30,30
1714608120585,EDS 204R,B01,507331,Heinzman; Erica M.,16,0,30,14
1714608121613,EDS 206R,A00,507332,Staff,0,4,30,30
1714608121613,EDS 206R,B00,507343,Staff,17,0,30,13
1714608122637,EDS 250,A00,507344,Hemans; Patricia Ann Benitez,22,0,40,18
1714608123662,EDS 281,A00,507345,Daly; Alan J.,18,0,18,0
1714608124686,EDS 284,A00,507350,Daly; Alan J.,16,0,16,0
1714608125715,EDS 286,A00,507359,Fine; Sarah,18,0,18,0
1714608126740,EDS 289C,A01,507361,Daly; Alan J.,18,0,18,0
1714608127764,EDS 290,A00,507366,Hofstetter; Carolyn,15,0,15,0
1714608128789,LIGM 5A,A00,507421,Fischer-Grunski; Eva K,18,0,20,2
1714608129816,LIGM 5B,A00,507423,Fischer-Grunski; Eva K,19,0,20,1
1714608130843,LIGM 5C,A00,507425,Fischer-Grunski; Eva K,19,0,20,1
1714608131868,LIIT 5AS,A00,507427,Carnelos; Chiara,20,0,20,0
1714608132895,LIIT 5BS,A00,507430,Carnelos; Chiara,20,0,20,0
1714608133920,LIIT 5CS,A00,507432,Carnelos; Chiara,20,0,20,0
1714608134946,LISP 5A,A00,507541,Munoz Sanchez; Alicia,11,0,20,9
1714608135976,LISP 5B,A00,507671,Munoz Sanchez; Alicia,8,0,20,12
1714608137006,LISP 5C,A00,507696,Munoz Sanchez; Alicia,9,0,20,11
1714608138030,MAE 197,001,528363,Boechler; Nicholas Sebastia,9998,0,9999,1
1714608139058,MATH 197,001,523477,Kedlaya; Kiran S.,9995,0,9999,4
1714608139058,MATH 197,002,563811,Zhang; Danna,9995,0,9999,4
1714608139058,MATH 197,003,628552,Dumitriu; Ioana,9998,0,9999,1
1714608140093,MCWP 40R,A00,518780,Staff,2,0,20,18
1714608140093,MCWP 40R,B00,518781,Staff,8,0,20,12
1714608140093,MCWP 40R,C00,518783,Staff,6,0,20,14
1714608141122,MCWP 50R,A00,518791,Staff,0,0,20,20
1714608141122,MCWP 50R,B00,518792,Staff,0,2,20,20
1714608141122,MCWP 50R,C00,518793,Staff,0,2,20,20
1714608141122,MCWP 50R,D00,518794,Staff,0,0,20,20
1714608141122,MCWP 50R,E00,518795,Staff,0,2,20,20
1714608141122,MCWP 50R,F00,518796,Staff,0,0,20,20
1714608141122,MCWP 50R,G00,518797,Staff,0,1,20,20
1714608142204,MMW 12R,A01,514034,Herbst; Matthew,0,0,16,16
1714608142204,MMW 12R,A02,514035,Herbst; Matthew,1,0,16,15
1714608143234,MMW 13R,A01,514037,Staff,0,4,16,16
1714608143234,MMW 13R,A02,514039,Staff,0,2,16,16
1714608143234,MMW 13R,A03,628519,Staff,0,2,16,16
1714608145286,SIO 295LS,A00,523233,Staff,10,0,30,20
1714608146315,SIO 295S,A00,523232,Staff,10,0,30,20
1714608147341,SIOC 290S,A01,637330,Merrifield; Mark A,23,0,30,7
1714608148367,SIOC 291S,A01,637333,Gabriel; Corey John,23,0,30,7
1714608149393,SOCI 117,A01,494376,Staff,0,4,5,5
1714608150421,WES 237B,A00,494380,Staff,9,0,20,11
1714608152498,AESE 279B,A00,494370,Wade; Jon P,0,0,33,33
1714608153523,AIP 197,001,627712,Vespa; Emanuel Ignacio,9998,0,9999,1
1714608154552,ANAR 135S,A00,494369,Braswell; Geoffrey E.,0,0,0,0
1714608155582,BENG 196,001,628496,Engler; Adam J.,9998,0,9999,1
1714608156608,CAT 124RS,A01,519847,Geibel; William,0,0,20,20
1714608157631,CAT 125RS,A01,515971,Geibel; William,0,0,20,20
1714608158658,CLRE 250,A00,511389,Morris; Sheldon,9993,0,9999,6
1714608159687,CLRE 251,A00,507176,Mehta; Ravindra L.,9993,0,9999,6
1714608159687,CLRE 251,B00,511410,Mehta; Ravindra L.,9998,0,9999,1
1714608160713,CLRE 252,A00,507189,Cuomo; Raphael Eduardo,9995,0,9999,4
1714608161744,CLRE 253,A00,507199,Vaida; Florin,9994,0,9999,5
1714608161744,CLRE 253,B00,507202,Vaida; Florin,9999,0,9999,0
1714608162770,CLRE 259,A00,507211,Patel; Hemal,9996,0,9999,3
1714608163795,CLRE 260,A00,507221,Cuomo; Raphael Eduardo,9999,0,9999,0
1714608164820,CLRE 297,001,507242,Cuomo; Raphael Eduardo,9999,0,9999,0
1714608165846,COGS 197,001,638244,Voytek; Bradley Thomas,9998,0,9999,1
1714608166871,CSE 191,A00,516875,Minnes Kemp; Mor Mia,9993,0,9999,6
1714608167898,CSE 197,001,637388,Minnes Kemp; Mor Mia,9998,0,9999,1
1714608168927,CSS 201S,A01,494383,Staff,35,0,35,0
1714608169956,CSS 202S,A01,494387,Staff,35,0,35,0
1714608170983,DSC 197,001,628532,Eldridge; Justin Matthew,9996,0,9999,3
1714608172012,EAP 100,A00,516065,Staff,9797,0,9999,202
1714608173043,ECE 45,A01,507414,Staff,33,0,60,27
1714608175096,ECE 111,A01,507420,Staff,15,0,50,35
1714608176122,ECE 197,001,548057,Sievenpiper; Daniel F.,9993,0,9999,6
1714608177153,EDS 115,A00,507243,Choi; Bailey Miyeon,10,0,28,18
1714608178180,EDS 117,A01,494379,Staff,1,5,30,29
1714608179206,EDS 125,A00,507246,Hopkins; Megan Beth,9,0,30,21
1714608180231,EDS 128A,A01,507264,Fargason; Sharon Gayle,8,0,26,18
1714608181262,EDS 128B,A01,507293,Pappas; Elizabeth,12,0,30,18
1714608182291,EDS 139,A00,507294,Fargason; Sharon Gayle,13,0,30,17
1714608182291,EDS 139,B00,507313,Pappas; Elizabeth,13,0,30,17
1714608183320,EDS 201,A00,507315,Staff,13,0,30,17
1714608184346,EDS 203,A01,507317,Halter; Christopher P.,12,0,30,18
1714608185371,EDS 204R,A01,507319,Halter; Christopher P.,0,3,30,30
1714608185371,EDS 204R,B01,507331,Heinzman; Erica M.,16,0,30,14
1714608186450,EDS 206R,A00,507332,Staff,0,4,30,30
1714608186450,EDS 206R,B00,507343,Staff,17,0,30,13
1714608187474,EDS 250,A00,507344,Hemans; Patricia Ann Benitez,22,0,40,18
1714608188499,EDS 281,A00,507345,Daly; Alan J.,18,0,18,0
1714608189527,EDS 284,A00,507350,Daly; Alan J.,16,0,16,0
1714608190551,EDS 286,A00,507359,Fine; Sarah,18,0,18,0
1714608191581,EDS 289C,A01,507361,Daly; Alan J.,18,0,18,0
1714608192613,EDS 290,A00,507366,Hofstetter; Carolyn,15,0,15,0
1714608193647,LIGM 5A,A00,507421,Fischer-Grunski; Eva K,18,0,20,2
1714608194678,LIGM 5B,A00,507423,Fischer-Grunski; Eva K,19,0,20,1
1714608195707,LIGM 5C,A00,507425,Fischer-Grunski; Eva K,19,0,20,1
1714608196739,LIIT 5AS,A00,507427,Carnelos; Chiara,20,0,20,0
1714608197768,LIIT 5BS,A00,507430,Carnelos; Chiara,20,0,20,0
1714608198794,LIIT 5CS,A00,507432,Carnelos; Chiara,20,0,20,0
1714608199819,LISP 5A,A00,507541,Munoz Sanchez; Alicia,11,0,20,9
1714608200845,LISP 5B,A00,507671,Munoz Sanchez; Alicia,8,0,20,12
1714608201876,LISP 5C,A00,507696,Munoz Sanchez; Alicia,9,0,20,11
1714608202905,MAE 197,001,528363,Boechler; Nicholas Sebastia,9998,0,9999,1
1714608203936,MATH 197,001,523477,Kedlaya; Kiran S.,9995,0,9999,4
1714608203936,MATH 197,002,563811,Zhang; Danna,9995,0,9999,4
1714608203936,MATH 197,003,628552,Dumitriu; Ioana,9998,0,9999,1
1714608204962,MCWP 40R,A00,518780,Staff,2,0,20,18
1714608204962,MCWP 40R,B00,518781,Staff,8,0,20,12
1714608204962,MCWP 40R,C00,518783,Staff,6,0,20,14
1714608205985,MCWP 50R,A00,518791,Staff,0,0,20,20
1714608205985,MCWP 50R,B00,518792,Staff,0,2,20,20
1714608205985,MCWP 50R,C00,518793,Staff,0,2,20,20
1714608205985,MCWP 50R,D00,518794,Staff,0,0,20,20
1714608205985,MCWP 50R,E00,518795,Staff,0,2,20,20
1714608205985,MCWP 50R,F00,518796,Staff,0,0,20,20
1714608205985,MCWP 50R,G00,518797,Staff,0,1,20,20
1714608207015,MMW 12R,A01,514034,Herbst; Matthew,0,0,16,16
1714608207015,MMW 12R,A02,514035,Herbst; Matthew,1,0,16,15
1714608208043,MMW 13R,A01,514037,Staff,0,4,16,16
1714608208043,MMW 13R,A02,514039,Staff,0,2,16,16
1714608208043,MMW 13R,A03,628519,Staff,0,2,16,16
1714608210094,SIO 295LS,A00,523233,Staff,10,0,30,20
1714608211118,SIO 295S,A00,523232,Staff,10,0,30,20
1714608212144,SIOC 290S,A01,637330,Merrifield; Mark A,23,0,30,7
1714608213170,SIOC 291S,A01,637333,Gabriel; Corey John,23,0,30,7
1714608214194,SOCI 117,A01,494376,Staff,0,4,5,5
1714608215272,WES 237B,A00,494380,Staff,9,0,20,11
1714608217346,AESE 279B,A00,494370,Wade; Jon P,0,0,33,33
1714608218376,AIP 197,001,627712,Vespa; Emanuel Ignacio,9998,0,9999,1
1714608219401,ANAR 135S,A00,494369,Braswell; Geoffrey E.,0,0,0,0
1714608220426,BENG 196,001,628496,Engler; Adam J.,9998,0,9999,1
1714608221455,CAT 124RS,A01,519847,Geibel; William,0,0,20,20
1714608222480,CAT 125RS,A01,515971,Geibel; William,0,0,20,20
1714608223509,CLRE 250,A00,511389,Morris; Sheldon,9993,0,9999,6
1714608224540,CLRE 251,A00,507176,Mehta; Ravindra L.,9993,0,9999,6
1714608224540,CLRE 251,B00,511410,Mehta; Ravindra L.,9998,0,9999,1
1714608225570,CLRE 252,A00,507189,Cuomo; Raphael Eduardo,9995,0,9999,4
1714608226598,CLRE 253,A00,507199,Vaida; Florin,9994,0,9999,5
1714608226598,CLRE 253,B00,507202,Vaida; Florin,9999,0,9999,0
1714608227628,CLRE 259,A00,507211,Patel; Hemal,9996,0,9999,3
1714608228652,CLRE 260,A00,507221,Cuomo; Raphael Eduardo,9999,0,9999,0
1714608229676,CLRE 297,001,507242,Cuomo; Raphael Eduardo,9999,0,9999,0
1714608230706,COGS 197,001,638244,Voytek; Bradley Thomas,9998,0,9999,1
1714608231731,CSE 191,A00,516875,Minnes Kemp; Mor Mia,9993,0,9999,6
1714608232759,CSE 197,001,637388,Minnes Kemp; Mor Mia,9998,0,9999,1
1714608233787,CSS 201S,A01,494383,Staff,35,0,35,0
1714608234816,CSS 202S,A01,494387,Staff,35,0,35,0
1714608235842,DSC 197,001,628532,Eldridge; Justin Matthew,9996,0,9999,3
1714608236884,EAP 100,A00,516065,Staff,9797,0,9999,202
1714608237911,ECE 45,A01,507414,Staff,33,0,60,27
1714608239959,ECE 111,A01,507420,Staff,15,0,50,35
1714608240988,ECE 197,001,548057,Sievenpiper; Daniel F.,9993,0,9999,6
1714608242015,EDS 115,A00,507243,Choi; Bailey Miyeon,10,0,28,18
1714608243045,EDS 117,A01,494379,Staff,1,5,30,29
1714608244077,EDS 125,A00,507246,Hopkins; Megan Beth,9,0,30,21
1714608245106,EDS 128A,A01,507264,Fargason; Sharon Gayle,8,0,26,18
1714608246132,EDS 128B,A01,507293,Pappas; Elizabeth,12,0,30,18
1714608247157,EDS 139,A00,507294,Fargason; Sharon Gayle,13,0,30,17
1714608247157,EDS 139,B00,507313,Pappas; Elizabeth,13,0,30,17
1714608248181,EDS 201,A00,507315,Staff,13,0,30,17
1714608249214,EDS 203,A01,507317,Halter; Christopher P.,12,0,30,18
1714608250239,EDS 204R,A01,507319,Halter; Christopher P.,0,3,30,30
1714608250239,EDS 204R,B01,507331,Heinzman; Erica M.,16,0,30,14
1714608251264,EDS 206R,A00,507332,Staff,0,4,30,30
1714608251264,EDS 206R,B00,507343,Staff,17,0,30,13
1714608252291,EDS 250,A00,507344,Hemans; Patricia Ann Benitez,22,0,40,18
1714608253320,EDS 281,A00,507345,Daly; Alan J.,18,0,18,0
1714608254345,EDS 284,A00,507350,Daly; Alan J.,16,0,16,0
1714608255375,EDS 286,A00,507359,Fine; Sarah,18,0,18,0
1714608256400,EDS 289C,A01,507361,Daly; Alan J.,18,0,18,0
1714608257424,EDS 290,A00,507366,Hofstetter; Carolyn,15,0,15,0
1714608258451,LIGM 5A,A00,507421,Fischer-Grunski; Eva K,18,0,20,2
1714608259476,LIGM 5B,A00,507423,Fischer-Grunski; Eva K,19,0,20,1
1714608260501,LIGM 5C,A00,507425,Fischer-Grunski; Eva K,19,0,20,1
1714608261533,LIIT 5AS,A00,507427,Carnelos; Chiara,20,0,20,0
1714608262560,LIIT 5BS,A00,507430,Carnelos; Chiara,20,0,20,0
1714608263588,LIIT 5CS,A00,507432,Carnelos; Chiara,20,0,20,0
1714608264643,LISP 5A,A00,507541,Munoz Sanchez; Alicia,11,0,20,9
1714608265667,LISP 5B,A00,507671,Munoz Sanchez; Alicia,8,0,20,12
1714608266693,LISP 5C,A00,507696,Munoz Sanchez; Alicia,9,0,20,11
1714608267718,MAE 197,001,528363,Boechler; Nicholas Sebastia,9998,0,9999,1
1714608268750,MATH 197,001,523477,Kedlaya; Kiran S.,9995,0,9999,4
1714608268750,MATH 197,002,563811,Zhang; Danna,9995,0,9999,4
1714608268750,MATH 197,003,628552,Dumitriu; Ioana,9998,0,9999,1
1714608269778,MCWP 40R,A00,518780,Staff,2,0,20,18
1714608269778,MCWP 40R,B00,518781,Staff,8,0,20,12
1714608269778,MCWP 40R,C00,518783,Staff,6,0,20,14
1714608270805,MCWP 50R,A00,518791,Staff,0,0,20,20
1714608270805,MCWP 50R,B00,518792,Staff,0,2,20,20
1714608270805,MCWP 50R,C00,518793,Staff,0,2,20,20
1714608270805,MCWP 50R,D00,518794,Staff,0,0,20,20
1714608270805,MCWP 50R,E00,518795,Staff,0,2,20,20
1714608270805,MCWP 50R,F00,518796,Staff,0,0,20,20
1714608270805,MCWP 50R,G00,518797,Staff,0,1,20,20
1714608271836,MMW 12R,A01,514034,Herbst; Matthew,0,0,16,16
1714608271836,MMW 12R,A02,514035,Herbst; Matthew,1,0,16,15
1714608272863,MMW 13R,A01,514037,Staff,0,4,16,16
1714608272863,MMW 13R,A02,514039,Staff,0,2,16,16
1714608272863,MMW 13R,A03,628519,Staff,0,2,16,16
1714608274914,SIO 295LS,A00,523233,Staff,10,0,30,20
1714608275938,SIO 295S,A00,523232,Staff,10,0,30,20
1714608276967,SIOC 290S,A01,637330,Merrifield; Mark A,23,0,30,7
1714608277993,SIOC 291S,A01,637333,Gabriel; Corey John,23,0,30,7
1714608279019,SOCI 117,A01,494376,Staff,0,4,5,5
1714608280045,WES 237B,A00,494380,Staff,9,0,20,11
1714608282132,AESE 279B,A00,494370,Wade; Jon P,0,0,33,33
1714608283157,AIP 197,001,627712,Vespa; Emanuel Ignacio,9998,0,9999,1
1714608284181,ANAR 135S,A00,494369,Braswell; Geoffrey E.,0,0,0,0
1714608285205,BENG 196,001,628496,Engler; Adam J.,9998,0,9999,1
1714608286232,CAT 124RS,A01,519847,Geibel; William,0,0,20,20
1714608287260,CAT 125RS,A01,515971,Geibel; William,0,0,20,20
1714608288286,CLRE 250,A00,511389,Morris; Sheldon,9993,0,9999,6
1714608289318,CLRE 251,A00,507176,Mehta; Ravindra L.,9993,0,9999,6
1714608289318,CLRE 251,B00,511410,Mehta; Ravindra L.,9998,0,9999,1
1714608290352,CLRE 252,A00,507189,Cuomo; Raphael Eduardo,9995,0,9999,4
1714608291377,CLRE 253,A00,507199,Vaida; Florin,9994,0,9999,5
1714608291377,CLRE 253,B00,507202,Vaida; Florin,9999,0,9999,0
1714608292406,CLRE 259,A00,507211,Patel; Hemal,9996,0,9999,3
1714608293430,CLRE 260,A00,507221,Cuomo; Raphael Eduardo,9999,0,9999,0
1714608294458,CLRE 297,001,507242,Cuomo; Raphael Eduardo,9999,0,9999,0
1714608295483,COGS 197,001,638244,Voytek; Bradley Thomas,9998,0,9999,1
1714608296515,CSE 191,A00,516875,Minnes Kemp; Mor Mia,9993,0,9999,6
1714608297542,CSE 197,001,637388,Minnes Kemp; Mor Mia,9998,0,9999,1
1714608298568,CSS 201S,A01,494383,Staff,35,0,35,0
1714608299593,CSS 202S,A01,494387,Staff,35,0,35,0
1714608300618,DSC 197,001,628532,Eldridge; Justin Matthew,9996,0,9999,3
1714608301641,EAP 100,A00,516065,Staff,9797,0,9999,202
1714608302703,ECE 45,A01,507414,Staff,33,0,60,27
1714608304756,ECE 111,A01,507420,Staff,15,0,50,35
1714608305781,ECE 197,001,548057,Sievenpiper; Daniel F.,9993,0,9999,6
1714608306807,EDS 115,A00,507243,Choi; Bailey Miyeon,10,0,28,18
1714608307832,EDS 117,A01,494379,Staff,1,5,30,29
1714608308856,EDS 125,A00,507246,Hopkins; Megan Beth,9,0,30,21
1714608309884,EDS 128A,A01,507264,Fargason; Sharon Gayle,8,0,26,18
1714608310909,EDS 128B,A01,507293,Pappas; Elizabeth,12,0,30,18
1714608311937,EDS 139,A00,507294,Fargason; Sharon Gayle,13,0,30,17
1714608311937,EDS 139,B00,507313,Pappas; Elizabeth,13,0,30,17
1714608312962,EDS 201,A00,507315,Staff,13,0,30,17
1714608313987,EDS 203,A01,507317,Halter; Christopher P.,12,0,30,18
1714608315018,EDS 204R,A01,507319,Halter; Christopher P.,0,3,30,30
1714608315018,EDS 204R,B01,507331,Heinzman; Erica M.,16,0,30,14
1714608316047,EDS 206R,A00,507332,Staff,0,4,30,30
1714608316047,EDS 206R,B00,507343,Staff,17,0,30,13
1714608317072,EDS 250,A00,507344,Hemans; Patricia Ann Benitez,22,0,40,18
1714608318099,EDS 281,A00,507345,Daly; Alan J.,18,0,18,0
1714608319127,EDS 284,A00,507350,Daly; Alan J.,16,0,16,0
1714608320178,EDS 286,A00,507359,Fine; Sarah,18,0,18,0
1714608321210,EDS 289C,A01,507361,Daly; Alan J.,18,0,18,0
1714608322239,EDS 290,A00,507366,Hofstetter; Carolyn,15,0,15,0
1714608323266,LIGM 5A,A00,507421,Fischer-Grunski; Eva K,18,0,20,2
1714608324291,LIGM 5B,A00,507423,Fischer-Grunski; Eva K,19,0,20,1
1714608325320,LIGM 5C,A00,507425,Fischer-Grunski; Eva K,19,0,20,1
1714608326346,LIIT 5AS,A00,507427,Carnelos; Chiara,20,0,20,0
1714608327371,LIIT 5BS,A00,507430,Carnelos; Chiara,20,0,20,0
1714608328398,LIIT 5CS,A00,507432,Carnelos; Chiara,20,0,20,0
1714608329430,LISP 5A,A00,507541,Munoz Sanchez; Alicia,11,0,20,9
1714608330460,LISP 5B,A00,507671,Munoz Sanchez; Alicia,8,0,20,12
1714608331490,LISP 5C,A00,507696,Munoz Sanchez; Alicia,9,0,20,11
1714608332518,MAE 197,001,528363,Boechler; Nicholas Sebastia,9998,0,9999,1
1714608333546,MATH 197,001,523477,Kedlaya; Kiran S.,9995,0,9999,4
1714608333546,MATH 197,002,563811,Zhang; Danna,9995,0,9999,4
1714608333546,MATH 197,003,628552,Dumitriu; Ioana,9998,0,9999,1
1714608334572,MCWP 40R,A00,518780,Staff,2,0,20,18
1714608334572,MCWP 40R,B00,518781,Staff,8,0,20,12
1714608334572,MCWP 40R,C00,518783,Staff,6,0,20,14
1714608335599,MCWP 50R,A00,518791,Staff,0,0,20,20
1714608335599,MCWP 50R,B00,518792,Staff,0,2,20,20
1714608335599,MCWP 50R,C00,518793,Staff,0,2,20,20
1714608335599,MCWP 50R,D00,518794,Staff,0,0,20,20
1714608335599,MCWP 50R,E00,518795,Staff,0,2,20,20
1714608335599,MCWP 50R,F00,518796,Staff,0,0,20,20
1714608335599,MCWP 50R,G00,518797,Staff,0,1,20,20
1714608336627,MMW 12R,A01,514034,Herbst; Matthew,0,0,16,16
1714608336627,MMW 12R,A02,514035,Herbst; Matthew,1,0,16,15
1714608337654,MMW 13R,A01,514037,Staff,0,4,16,16
1714608337654,MMW 13R,A02,514039,Staff,0,2,16,16
1714608337654,MMW 13R,A03,628519,Staff,0,2,16,16
1714608339708,SIO 295LS,A00,523233,Staff,10,0,30,20
1714608340733,SIO 295S,A00,523232,Staff,10,0,30,20
1714608341764,SIOC 290S,A01,637330,Merrifield; Mark A,23,0,30,7
1714608342790,SIOC 291S,A01,637333,Gabriel; Corey John,23,0,30,7
1714608343819,SOCI 117,A01,494376,Staff,0,4,5,5
1714608344849,WES 237B,A00,494380,Staff,9,0,20,11
1714608346938,AESE 279B,A00,494370,Wade; Jon P,0,0,33,33
1714608347969,AIP 197,001,627712,Vespa; Emanuel Ignacio,9998,0,9999,1
1714608348992,ANAR 135S,A00,494369,Braswell; Geoffrey E.,0,0,0,0
1714608350038,BENG 196,001,628496,Engler; Adam J.,9998,0,9999,1
1714608351070,CAT 124RS,A01,519847,Geibel; William,0,0,20,20
1714608352095,CAT 125RS,A01,515971,Geibel; William,0,0,20,20
1714608353127,CLRE 250,A00,511389,Morris; Sheldon,9993,0,9999,6
1714608354164,CLRE 251,A00,507176,Mehta; Ravindra L.,9993,0,9999,6
1714608354164,CLRE 251,B00,511410,Mehta; Ravindra L.,9998,0,9999,1
1714608355197,CLRE 252,A00,507189,Cuomo; Raphael Eduardo,9995,0,9999,4
1714608356227,CLRE 253,A00,507199,Vaida; Florin,9994,0,9999,5
1714608356227,CLRE 253,B00,507202,Vaida; Florin,9999,0,9999,0
1714608357257,CLRE 259,A00,507211,Patel; Hemal,9996,0,9999,3
1714608358283,CLRE 260,A00,507221,Cuomo; Raphael Eduardo,9999,0,9999,0
1714608359311,CLRE 297,001,507242,Cuomo; Raphael Eduardo,9999,0,9999,0
1714608360348,COGS 197,001,638244,Voytek; Bradley Thomas,9998,0,9999,1
1714608361372,CSE 191,A00,516875,Minnes Kemp; Mor Mia,9993,0,9999,6
1714608362397,CSE 197,001,637388,Minnes Kemp; Mor Mia,9998,0,9999,1
1714608363422,CSS 201S,A01,494383,Staff,35,0,35,0
1714608364451,CSS 202S,A01,494387,Staff,35,0,35,0
1714608365477,DSC 197,001,628532,Eldridge; Justin Matthew,9996,0,9999,3
1714608366574,EAP 100,A00,516065,Staff,9797,0,9999,202
1714608367604,ECE 45,A01,507414,Staff,33,0,60,27
1714608369661,ECE 111,A01,507420,Staff,15,0,50,35
1714608370693,ECE 197,001,548057,Sievenpiper; Daniel F.,9993,0,9999,6
1714608371723,EDS 115,A00,507243,Choi; Bailey Miyeon,10,0,28,18
1714608372753,EDS 117,A01,494379,Staff,1,5,30,29
1714608373778,EDS 125,A00,507246,Hopkins; Megan Beth,9,0,30,21
1714608374807,EDS 128A,A01,507264,Fargason; Sharon Gayle,8,0,26,18
1714608375834,EDS 128B,A01,507293,Pappas; Elizabeth,12,0,30,18
1714608376859,EDS 139,A00,507294,Fargason; Sharon Gayle,13,0,30,17
1714608376859,EDS 139,B00,507313,Pappas; Elizabeth,13,0,30,17
1714608377883,EDS 201,A00,507315,Staff,13,0,30,17
1714608378908,EDS 203,A01,507317,Halter; Christopher P.,12,0,30,18
1714608379936,EDS 204R,A01,507319,Halter; Christopher P.,0,3,30,30
1714608379936,EDS 204R,B01,507331,Heinzman; Erica M.,16,0,30,14
1714608380961,EDS 206R,A00,507332,Staff,0,4,30,30
1714608380961,EDS 206R,B00,507343,Staff,17,0,30,13
1714608381989,EDS 250,A00,507344,Hemans; Patricia Ann Benitez,22,0,40,18
1714608383019,EDS 281,A00,507345,Daly; Alan J.,18,0,18,0
1714608384047,EDS 284,A00,507350,Daly; Alan J.,16,0,16,0
1714608385072,EDS 286,A00,507359,Fine; Sarah,18,0,18,0
1714608386101,EDS 289C,A01,507361,Daly; Alan J.,18,0,18,0
1714608387125,EDS 290,A00,507366,Hofstetter; Carolyn,15,0,15,0
1714608388152,LIGM 5A,A00,507421,Fischer-Grunski; Eva K,18,0,20,2
1714608389185,LIGM 5B,A00,507423,Fischer-Grunski; Eva K,19,0,20,1
1714608390214,LIGM 5C,A00,507425,Fischer-Grunski; Eva K,19,0,20,1
1714608391245,LIIT 5AS,A00,507427,Carnelos; Chiara,20,0,20,0
1714608392274,LIIT 5BS,A00,507430,Carnelos; Chiara,20,0,20,0
1714608393310,LIIT 5CS,A00,507432,Carnelos; Chiara,20,0,20,0
1714608394338,LISP 5A,A00,507541,Munoz Sanchez; Alicia,11,0,20,9
1714608395363,LISP 5B,A00,507671,Munoz Sanchez; Alicia,8,0,20,12
1714608396388,LISP 5C,A00,507696,Munoz Sanchez; Alicia,9,0,20,11
1714608397423,MAE 197,001,528363,Boechler; Nicholas Sebastia,9998,0,9999,1
1714608398450,MATH 197,001,523477,Kedlaya; Kiran S.,9995,0,9999,4
1714608398450,MATH 197,002,563811,Zhang; Danna,9995,0,9999,4
1714608398450,MATH 197,003,628552,Dumitriu; Ioana,9998,0,9999,1
1714608399478,MCWP 40R,A00,518780,Staff,2,0,20,18
1714608399478,MCWP 40R,B00,518781,Staff,8,0,20,12
1714608399478,MCWP 40R,C00,518783,Staff,6,0,20,14
1714608400509,MCWP 50R,A00,518791,Staff,0,0,20,20
1714608400509,MCWP 50R,B00,518792,Staff,0,2,20,20
1714608400509,MCWP 50R,C00,518793,Staff,0,2,20,20
1714608400509,MCWP 50R,D00,518794,Staff,0,0,20,20
1714608400509,MCWP 50R,E00,518795,Staff,0,2,20,20
1714608400509,MCWP 50R,F00,518796,Staff,0,0,20,20
1714608400509,MCWP 50R,G00,518797,Staff,0,1,20,20
1714608401537,MMW 12R,A01,514034,Herbst; Matthew,0,0,16,16
1714608401537,MMW 12R,A02,514035,Herbst; Matthew,1,0,16,15
1714608402562,MMW 13R,A01,514037,Staff,0,4,16,16
1714608402562,MMW 13R,A02,514039,Staff,0,2,16,16
1714608402562,MMW 13R,A03,628519,Staff,0,2,16,16
1714608404617,SIO 295LS,A00,523233,Staff,10,0,30,20
1714608405641,SIO 295S,A00,523232,Staff,10,0,30,20
1714608406674,SIOC 290S,A01,637330,Merrifield; Mark A,23,0,30,7
1714608407699,SIOC 291S,A01,637333,Gabriel; Corey John,23,0,30,7
1714608408727,SOCI 117,A01,494376,Staff,0,4,5,5
1714608409754,WES 237B,A00,494380,Staff,9,0,20,11
1714608411835,AESE 279B,A00,494370,Wade; Jon P,0,0,33,33
1714608412862,AIP 197,001,627712,Vespa; Emanuel Ignacio,9998,0,9999,1
1714608413895,ANAR 135S,A00,494369,Braswell; Geoffrey E.,0,0,0,0
1714608414921,BENG 196,001,628496,Engler; Adam J.,9998,0,9999,1
1714608415949,CAT 124RS,A01,519847,Geibel; William,0,0,20,20
1714608416975,CAT 125RS,A01,515971,Geibel; William,0,0,20,20
1714608418007,CLRE 250,A00,511389,Morris; Sheldon,9993,0,9999,6
1714608419032,CLRE 251,A00,507176,Mehta; Ravindra L.,9993,0,9999,6
1714608419032,CLRE 251,B00,511410,Mehta; Ravindra L.,9998,0,9999,1
1714608420061,CLRE 252,A00,507189,Cuomo; Raphael Eduardo,9995,0,9999,4
1714608421090,CLRE 253,A00,507199,Vaida; Florin,9994,0,9999,5
1714608421090,CLRE 253,B00,507202,Vaida; Florin,9999,0,9999,0
1714608422115,CLRE 259,A00,507211,Patel; Hemal,9996,0,9999,3
1714608423142,CLRE 260,A00,507221,Cuomo; Raphael Eduardo,9999,0,9999,0
1714608424169,CLRE 297,001,507242,Cuomo; Raphael Eduardo,9999,0,9999,0
1714608425201,COGS 197,001,638244,Voytek; Bradley Thomas,9998,0,9999,1
1714608426226,CSE 191,A00,516875,Minnes Kemp; Mor Mia,9993,0,9999,6
1714608427250,CSE 197,001,637388,Minnes Kemp; Mor Mia,9998,0,9999,1
1714608428281,CSS 201S,A01,494383,Staff,35,0,35,0
1714608429313,CSS 202S,A01,494387,Staff,35,0,35,0
1714608430342,DSC 197,001,628532,Eldridge; Justin Matthew,9996,0,9999,3
1714608431375,EAP 100,A00,516065,Staff,9797,0,9999,202
1714608432406,ECE 45,A01,507414,Staff,33,0,60,27
1714608434462,ECE 111,A01,507420,Staff,15,0,50,35
1714608435494,ECE 197,001,548057,Sievenpiper; Daniel F.,9993,0,9999,6
1714608436520,EDS 115,A00,507243,Choi; Bailey Miyeon,10,0,28,18
1714608437544,EDS 117,A01,494379,Staff,1,5,30,29
1714608438577,EDS 125,A00,507246,Hopkins; Megan Beth,9,0,30,21
1714608439606,EDS 128A,A01,507264,Fargason; Sharon Gayle,8,0,26,18
1714608440632,EDS 128B,A01,507293,Pappas; Elizabeth,12,0,30,18
1714608441658,EDS 139,A00,507294,Fargason; Sharon Gayle,13,0,30,17
1714608441658,EDS 139,B00,507313,Pappas; Elizabeth,13,0,30,17
1714608442687,EDS 201,A00,507315,Staff,13,0,30,17
1714608443716,EDS 203,A01,507317,Halter; Christopher P.,12,0,30,18
1714608444741,EDS 204R,A01,507319,Halter; Christopher P.,0,3,30,30
1714608444741,EDS 204R,B01,507331,Heinzman; Erica M.,16,0,30,14
1714608445767,EDS 206R,A00,507332,Staff,0,4,30,30
1714608445767,EDS 206R,B00,507343,Staff,17,0,30,13
1714608446793,EDS 250,A00,507344,Hemans; Patricia Ann Benitez,22,0,40,18
1714608447824,EDS 281,A00,507345,Daly; Alan J.,18,0,18,0
1714608448850,EDS 284,A00,507350,Daly; Alan J.,16,0,16,0
1714608449876,EDS 286,A00,507359,Fine; Sarah,18,0,18,0
1714608450901,EDS 289C,A01,507361,Daly; Alan J.,18,0,18,0
1714608451930,EDS 290,A00,507366,Hofstetter; Carolyn,15,0,15,0
1714608452963,LIGM 5A,A00,507421,Fischer-Grunski; Eva K,18,0,20,2
1714608453992,LIGM 5B,A00,507423,Fischer-Grunski; Eva K,19,0,20,1
1714608455018,LIGM 5C,A00,507425,Fischer-Grunski; Eva K,19,0,20,1
1714608456044,LIIT 5AS,A00,507427,Carnelos; Chiara,20,0,20,0
1714608457067,LIIT 5BS,A00,507430,Carnelos; Chiara,20,0,20,0
1714608458092,LIIT 5CS,A00,507432,Carnelos; Chiara,20,0,20,0
1714608459118,LISP 5A,A00,507541,Munoz Sanchez; Alicia,11,0,20,9
1714608460145,LISP 5B,A00,507671,Munoz Sanchez; Alicia,8,0,20,12
1714608461180,LISP 5C,A00,507696,Munoz Sanchez; Alicia,9,0,20,11
1714608462205,MAE 197,001,528363,Boechler; Nicholas Sebastia,9998,0,9999,1
1714608463231,MATH 197,001,523477,Kedlaya; Kiran S.,9995,0,9999,4
1714608463231,MATH 197,002,563811,Zhang; Danna,9995,0,9999,4
1714608463231,MATH 197,003,628552,Dumitriu; Ioana,9998,0,9999,1
1714608464260,MCWP 40R,A00,518780,Staff,2,0,20,18
1714608464260,MCWP 40R,B00,518781,Staff,8,0,20,12
1714608464260,MCWP 40R,C00,518783,Staff,6,0,20,14
1714608465285,MCWP 50R,A00,518791,Staff,0,0,20,20
1714608465285,MCWP 50R,B00,518792,Staff,0,2,20,20
1714608465285,MCWP 50R,C00,518793,Staff,0,2,20,20
1714608465285,MCWP 50R,D00,518794,Staff,0,0,20,20
1714608465285,MCWP 50R,E00,518795,Staff,0,2,20,20
1714608465285,MCWP 50R,F00,518796,Staff,0,0,20,20
1714608465285,MCWP 50R,G00,518797,Staff,0,1,20,20
1714608466316,MMW 12R,A01,514034,Herbst; Matthew,0,0,16,16
1714608466316,MMW 12R,A02,514035,Herbst; Matthew,1,0,16,15
1714608467345,MMW 13R,A01,514037,Staff,0,4,16,16
1714608467345,MMW 13R,A02,514039,Staff,0,2,16,16
1714608467345,MMW 13R,A03,628519,Staff,0,2,16,16
1714608469395,SIO 295LS,A00,523233,Staff,10,0,30,20
1714608470475,SIO 295S,A00,523232,Staff,10,0,30,20
1714608471513,SIOC 290S,A01,637330,Merrifield; Mark A,23,0,30,7
1714608472542,SIOC 291S,A01,637333,Gabriel; Corey John,23,0,30,7
1714608473572,SOCI 117,A01,494376,Staff,0,4,5,5
1714608474597,WES 237B,A00,494380,Staff,9,0,20,11
1714608476665,AESE 279B,A00,494370,Wade; Jon P,0,0,33,33
1714608477693,AIP 197,001,627712,Vespa; Emanuel Ignacio,9998,0,9999,1
1714608478721,ANAR 135S,A00,494369,Braswell; Geoffrey E.,0,0,0,0
1714608479747,BENG 196,001,628496,Engler; Adam J.,9998,0,9999,1
1714608480773,CAT 124RS,A01,519847,Geibel; William,0,0,20,20
1714608481799,CAT 125RS,A01,515971,Geibel; William,0,0,20,20
1714608482825,CLRE 250,A00,511389,Morris; Sheldon,9993,0,9999,6
1714608483865,CLRE 251,A00,507176,Mehta; Ravindra L.,9993,0,9999,6
1714608483865,CLRE 251,B00,511410,Mehta; Ravindra L.,9998,0,9999,1
1714608484890,CLRE 252,A00,507189,Cuomo; Raphael Eduardo,9995,0,9999,4
1714608485921,CLRE 253,A00,507199,Vaida; Florin,9994,0,9999,5
1714608485921,CLRE 253,B00,507202,Vaida; Florin,9999,0,9999,0
1714608486949,CLRE 259,A00,507211,Patel; Hemal,9996,0,9999,3
1714608487977,CLRE 260,A00,507221,Cuomo; Raphael Eduardo,9999,0,9999,0
1714608489007,CLRE 297,001,507242,Cuomo; Raphael Eduardo,9999,0,9999,0
1714608490036,COGS 197,001,638244,Voytek; Bradley Thomas,9998,0,9999,1
1714608491062,CSE 191,A00,516875,Minnes Kemp; Mor Mia,9993,0,9999,6
1714608492089,CSE 197,001,637388,Minnes Kemp; Mor Mia,9998,0,9999,1
1714608493119,CSS 201S,A01,494383,Staff,35,0,35,0
1714608494145,CSS 202S,A01,494387,Staff,35,0,35,0
1714608495169,DSC 197,001,628532,Eldridge; Justin Matthew,9996,0,9999,3
1714608496195,EAP 100,A00,516065,Staff,9797,0,9999,202
1714608497221,ECE 45,A01,507414,Staff,33,0,60,27
1714608499276,ECE 111,A01,507420,Staff,15,0,50,35
1714608500302,ECE 197,001,548057,Sievenpiper; Daniel F.,9993,0,9999,6
1714608501326,EDS 115,A00,507243,Choi; Bailey Miyeon,10,0,28,18
1714608502354,EDS 117,A01,494379,Staff,1,5,30,29
1714608503382,EDS 125,A00,507246,Hopkins; Megan Beth,9,0,30,21
1714608504408,EDS 128A,A01,507264,Fargason; Sharon Gayle,8,0,26,18
1714608505433,EDS 128B,A01,507293,Pappas; Elizabeth,12,0,30,18
1714608506460,EDS 139,A00,507294,Fargason; Sharon Gayle,13,0,30,17
1714608506460,EDS 139,B00,507313,Pappas; Elizabeth,13,0,30,17
1714608507486,EDS 201,A00,507315,Staff,13,0,30,17
1714608508516,EDS 203,A01,507317,Halter; Christopher P.,12,0,30,18
1714608509543,EDS 204R,A01,507319,Halter; Christopher P.,0,3,30,30
1714608509543,EDS 204R,B01,507331,Heinzman; Erica M.,16,0,30,14
1714608510572,EDS 206R,A00,507332,Staff,0,4,30,30
1714608510572,EDS 206R,B00,507343,Staff,17,0,30,13
1714608511603,EDS 250,A00,507344,Hemans; Patricia Ann Benitez,22,0,40,18
1714608512628,EDS 281,A00,507345,Daly; Alan J.,18,0,18,0
1714608513656,EDS 284,A00,507350,Daly; Alan J.,16,0,16,0
1714608514681,EDS 286,A00,507359,Fine; Sarah,18,0,18,0
1714608515706,EDS 289C,A01,507361,Daly; Alan J.,18,0,18,0
1714608516732,EDS 290,A00,507366,Hofstetter; Carolyn,15,0,15,0
1714608517763,LIGM 5A,A00,507421,Fischer-Grunski; Eva K,18,0,20,2
1714608518790,LIGM 5B,A00,507423,Fischer-Grunski; Eva K,19,0,20,1
1714608519820,LIGM 5C,A00,507425,Fischer-Grunski; Eva K,19,0,20,1
1714608520846,LIIT 5AS,A00,507427,Carnelos; Chiara,20,0,20,0
1714608521871,LIIT 5BS,A00,507430,Carnelos; Chiara,20,0,20,0
1714608522902,LIIT 5CS,A00,507432,Carnelos; Chiara,20,0,20,0
1714608523927,LISP 5A,A00,507541,Munoz Sanchez; Alicia,11,0,20,9
1714608524952,LISP 5B,A00,507671,Munoz Sanchez; Alicia,8,0,20,12
1714608525982,LISP 5C,A00,507696,Munoz Sanchez; Alicia,9,0,20,11
1714608527009,MAE 197,001,528363,Boechler; Nicholas Sebastia,9998,0,9999,1
1714608528037,MATH 197,001,523477,Kedlaya; Kiran S.,9995,0,9999,4
1714608528037,MATH 197,002,563811,Zhang; Danna,9995,0,9999,4
1714608528037,MATH 197,003,628552,Dumitriu; Ioana,9998,0,9999,1
1714608529067,MCWP 40R,A00,518780,Staff,2,0,20,18
1714608529067,MCWP 40R,B00,518781,Staff,8,0,20,12
1714608529067,MCWP 40R,C00,518783,Staff,6,0,20,14
1714608530091,MCWP 50R,A00,518791,Staff,0,0,20,20
1714608530091,MCWP 50R,B00,518792,Staff,0,2,20,20
1714608530091,MCWP 50R,C00,518793,Staff,0,2,20,20
1714608530091,MCWP 50R,D00,518794,Staff,0,0,20,20
1714608530091,MCWP 50R,E00,518795,Staff,0,2,20,20
1714608530091,MCWP 50R,F00,518796,Staff,0,0,20,20
1714608530091,MCWP 50R,G00,518797,Staff,0,1,20,20
1714608531117,MMW 12R,A01,514034,Herbst; Matthew,0,0,16,16
1714608531117,MMW 12R,A02,514035,Herbst; Matthew,1,0,16,15
1714608532149,MMW 13R,A01,514037,Staff,0,4,16,16
1714608532149,MMW 13R,A02,514039,Staff,0,2,16,16
1714608532149,MMW 13R,A03,628519,Staff,0,2,16,16
1714608534203,SIO 295LS,A00,523233,Staff,10,0,30,20
1714608535228,SIO 295S,A00,523232,Staff,10,0,30,20
1714608536262,SIOC 290S,A01,637330,Merrifield; Mark A,23,0,30,7
1714608537287,SIOC 291S,A01,637333,Gabriel; Corey John,23,0,30,7
1714608538315,SOCI 117,A01,494376,Staff,0,4,5,5
1714608539341,WES 237B,A00,494380,Staff,9,0,20,11
1714608541460,AESE 279B,A00,494370,Wade; Jon P,0,0,33,33
1714608542490,AIP 197,001,627712,Vespa; Emanuel Ignacio,9998,0,9999,1
1714608543515,ANAR 135S,A00,494369,Braswell; Geoffrey E.,0,0,0,0
1714608544542,BENG 196,001,628496,Engler; Adam J.,9998,0,9999,1
1714608545573,CAT 124RS,A01,519847,Geibel; William,0,0,20,20
1714608546602,CAT 125RS,A01,515971,Geibel; William,0,0,20,20
1714608547630,CLRE 250,A00,511389,Morris; Sheldon,9993,0,9999,6
1714608548662,CLRE 251,A00,507176,Mehta; Ravindra L.,9993,0,9999,6
1714608548662,CLRE 251,B00,511410,Mehta; Ravindra L.,9998,0,9999,1
1714608549689,CLRE 252,A00,507189,Cuomo; Raphael Eduardo,9995,0,9999,4
1714608550719,CLRE 253,A00,507199,Vaida; Florin,9994,0,9999,5
1714608550719,CLRE 253,B00,507202,Vaida; Florin,9999,0,9999,0
1714608551744,CLRE 259,A00,507211,Patel; Hemal,9996,0,9999,3
1714608552770,CLRE 260,A00,507221,Cuomo; Raphael Eduardo,9999,0,9999,0
1714608553796,CLRE 297,001,507242,Cuomo; Raphael Eduardo,9999,0,9999,0
1714608554824,COGS 197,001,638244,Voytek; Bradley Thomas,9998,0,9999,1
1714608555849,CSE 191,A00,516875,Minnes Kemp; Mor Mia,9993,0,9999,6
1714608556875,CSE 197,001,637388,Minnes Kemp; Mor Mia,9998,0,9999,1
1714608557900,CSS 201S,A01,494383,Staff,35,0,35,0
1714608558932,CSS 202S,A01,494387,Staff,35,0,35,0
1714608559957,DSC 197,001,628532,Eldridge; Justin Matthew,9996,0,9999,3
1714608560985,EAP 100,A00,516065,Staff,9797,0,9999,202
1714608562008,ECE 45,A01,507414,Staff,33,0,60,27
1714608564060,ECE 111,A01,507420,Staff,15,0,50,35
1714608565087,ECE 197,001,548057,Sievenpiper; Daniel F.,9993,0,9999,6
1714608566115,EDS 115,A00,507243,Choi; Bailey Miyeon,10,0,28,18
1714608567319,EDS 117,A01,494379,Staff,1,5,30,29
1714608568344,EDS 125,A00,507246,Hopkins; Megan Beth,9,0,30,21
1714608569373,EDS 128A,A01,507264,Fargason; Sharon Gayle,8,0,26,18
1714608570404,EDS 128B,A01,507293,Pappas; Elizabeth,12,0,30,18
1714608571430,EDS 139,A00,507294,Fargason; Sharon Gayle,13,0,30,17
1714608571430,EDS 139,B00,507313,Pappas; Elizabeth,13,0,30,17
1714608572453,EDS 201,A00,507315,Staff,13,0,30,17
1714608573486,EDS 203,A01,507317,Halter; Christopher P.,12,0,30,18
1714608574512,EDS 204R,A01,507319,Halter; Christopher P.,0,3,30,30
1714608574512,EDS 204R,B01,507331,Heinzman; Erica M.,16,0,30,14
1714608575536,EDS 206R,A00,507332,Staff,0,4,30,30
1714608575536,EDS 206R,B00,507343,Staff,17,0,30,13
1714608576561,EDS 250,A00,507344,Hemans; Patricia Ann Benitez,22,0,40,18
1714608577590,EDS 281,A00,507345,Daly; Alan J.,18,0,18,0
1714608578614,EDS 284,A00,507350,Daly; Alan J.,16,0,16,0
1714608579646,EDS 286,A00,507359,Fine; Sarah,18,0,18,0
1714608580675,EDS 289C,A01,507361,Daly; Alan J.,18,0,18,0
1714608581705,EDS 290,A00,507366,Hofstetter; Carolyn,15,0,15,0
1714608582737,LIGM 5A,A00,507421,Fischer-Grunski; Eva K,18,0,20,2
1714608583767,LIGM 5B,A00,507423,Fischer-Grunski; Eva K,19,0,20,1
1714608584792,LIGM 5C,A00,507425,Fischer-Grunski; Eva K,19,0,20,1
1714608585819,LIIT 5AS,A00,507427,Carnelos; Chiara,20,0,20,0
1714608586848,LIIT 5BS,A00,507430,Carnelos; Chiara,20,0,20,0
1714608587876,LIIT 5CS,A00,507432,Carnelos; Chiara,20,0,20,0
1714608588906,LISP 5A,A00,507541,Munoz Sanchez; Alicia,11,0,20,9
1714608589932,LISP 5B,A00,507671,Munoz Sanchez; Alicia,8,0,20,12
1714608590957,LISP 5C,A00,507696,Munoz Sanchez; Alicia,9,0,20,11
1714608591988,MAE 197,001,528363,Boechler; Nicholas Sebastia,9998,0,9999,1
1714608593016,MATH 197,001,523477,Kedlaya; Kiran S.,9995,0,9999,4
1714608593016,MATH 197,002,563811,Zhang; Danna,9995,0,9999,4
1714608593016,MATH 197,003,628552,Dumitriu; Ioana,9998,0,9999,1
1714608594047,MCWP 40R,A00,518780,Staff,2,0,20,18
1714608594047,MCWP 40R,B00,518781,Staff,8,0,20,12
1714608594047,MCWP 40R,C00,518783,Staff,6,0,20,14
1714608595074,MCWP 50R,A00,518791,Staff,0,0,20,20
1714608595074,MCWP 50R,B00,518792,Staff,0,2,20,20
1714608595074,MCWP 50R,C00,518793,Staff,0,2,20,20
1714608595074,MCWP 50R,D00,518794,Staff,0,0,20,20
1714608595074,MCWP 50R,E00,518795,Staff,0,2,20,20
1714608595074,MCWP 50R,F00,518796,Staff,0,0,20,20
1714608595074,MCWP 50R,G00,518797,Staff,0,1,20,20
1714608596102,MMW 12R,A01,514034,Herbst; Matthew,0,0,16,16
1714608596102,MMW 12R,A02,514035,Herbst; Matthew,1,0,16,15
1714608597131,MMW 13R,A01,514037,Staff,0,4,16,16
1714608597131,MMW 13R,A02,514039,Staff,0,2,16,16
1714608597131,MMW 13R,A03,628519,Staff,0,2,16,16
1714608599186,SIO 295LS,A00,523233,Staff,10,0,30,20
1714608600211,SIO 295S,A00,523232,Staff,10,0,30,20
1714608601239,SIOC 290S,A01,637330,Merrifield; Mark A,23,0,30,7
1714608602272,SIOC 291S,A01,637333,Gabriel; Corey John,23,0,30,7
1714608603306,SOCI 117,A01,494376,Staff,0,4,5,5
1714608604333,WES 237B,A00,494380,Staff,9,0,20,11
1714608606411,AESE 279B,A00,494370,Wade; Jon P,0,0,33,33
1714608607444,AIP 197,001,627712,Vespa; Emanuel Ignacio,9998,0,9999,1
1714608608470,ANAR 135S,A00,494369,Braswell; Geoffrey E.,0,0,0,0
1714608609495,BENG 196,001,628496,Engler; Adam J.,9998,0,9999,1
1714608610524,CAT 124RS,A01,519847,Geibel; William,0,0,20,20
1714608611554,CAT 125RS,A01,515971,Geibel; William,0,0,20,20
1714608612580,CLRE 250,A00,511389,Morris; Sheldon,9993,0,9999,6
1714608613616,CLRE 251,A00,507176,Mehta; Ravindra L.,9993,0,9999,6
1714608613616,CLRE 251,B00,511410,Mehta; Ravindra L.,9998,0,9999,1
1714608614641,CLRE 252,A00,507189,Cuomo; Raphael Eduardo,9995,0,9999,4
1714608615670,CLRE 253,A00,507199,Vaida; Florin,9994,0,9999,5
1714608615670,CLRE 253,B00,507202,Vaida; Florin,9999,0,9999,0
1714608616699,CLRE 259,A00,507211,Patel; Hemal,9996,0,9999,3
1714608617728,CLRE 260,A00,507221,Cuomo; Raphael Eduardo,9999,0,9999,0
1714608618756,CLRE 297,001,507242,Cuomo; Raphael Eduardo,9999,0,9999,0
1714608619782,COGS 197,001,638244,Voytek; Bradley Thomas,9998,0,9999,1
1714608620811,CSE 191,A00,516875,Minnes Kemp; Mor Mia,9993,0,9999,6
1714608621841,CSE 197,001,637388,Minnes Kemp; Mor Mia,9998,0,9999,1
1714608622867,CSS 201S,A01,494383,Staff,35,0,35,0
1714608623907,CSS 202S,A01,494387,Staff,35,0,35,0
1714608624933,DSC 197,001,628532,Eldridge; Justin Matthew,9996,0,9999,3
1714608625958,EAP 100,A00,516065,Staff,9797,0,9999,202
1714608626982,ECE 45,A01,507414,Staff,33,0,60,27
1714608629039,ECE 111,A01,507420,Staff,15,0,50,35
1714608630067,ECE 197,001,548057,Sievenpiper; Daniel F.,9993,0,9999,6
1714608631097,EDS 115,A00,507243,Choi; Bailey Miyeon,10,0,28,18
1714608632123,EDS 117,A01,494379,Staff,1,5,30,29
1714608633150,EDS 125,A00,507246,Hopkins; Megan Beth,9,0,30,21
1714608634175,EDS 128A,A01,507264,Fargason; Sharon Gayle,8,0,26,18
1714608635205,EDS 128B,A01,507293,Pappas; Elizabeth,12,0,30,18
1714608636232,EDS 139,A00,507294,Fargason; Sharon Gayle,13,0,30,17
1714608636232,EDS 139,B00,507313,Pappas; Elizabeth,13,0,30,17
1714608637260,EDS 201,A00,507315,Staff,13,0,30,17
1714608638288,EDS 203,A01,507317,Halter; Christopher P.,12,0,30,18
1714608639315,EDS 204R,A01,507319,Halter; Christopher P.,0,3,30,30
1714608639315,EDS 204R,B01,507331,Heinzman; Erica M.,16,0,30,14
1714608640339,EDS 206R,A00,507332,Staff,0,4,30,30
1714608640339,EDS 206R,B00,507343,Staff,17,0,30,13
1714608641376,EDS 250,A00,507344,Hemans; Patricia Ann Benitez,22,0,40,18
1714608642402,EDS 281,A00,507345,Daly; Alan J.,18,0,18,0
1714608643426,EDS 284,A00,507350,Daly; Alan J.,16,0,16,0
1714608644452,EDS 286,A00,507359,Fine; Sarah,18,0,18,0
1714608645478,EDS 289C,A01,507361,Daly; Alan J.,18,0,18,0
1714608646506,EDS 290,A00,507366,Hofstetter; Carolyn,15,0,15,0
1714608647535,LIGM 5A,A00,507421,Fischer-Grunski; Eva K,18,0,20,2
1714608648561,LIGM 5B,A00,507423,Fischer-Grunski; Eva K,19,0,20,1
1714608649590,LIGM 5C,A00,507425,Fischer-Grunski; Eva K,19,0,20,1
1714608650620,LIIT 5AS,A00,507427,Carnelos; Chiara,20,0,20,0
1714608651652,LIIT 5BS,A00,507430,Carnelos; Chiara,20,0,20,0
1714608652676,LIIT 5CS,A00,507432,Carnelos; Chiara,20,0,20,0
1714608653709,LISP 5A,A00,507541,Munoz Sanchez; Alicia,11,0,20,9
1714608654741,LISP 5B,A00,507671,Munoz Sanchez; Alicia,8,0,20,12
1714608655765,LISP 5C,A00,507696,Munoz Sanchez; Alicia,9,0,20,11
1714608656795,MAE 197,001,528363,Boechler; Nicholas Sebastia,9998,0,9999,1
1714608657827,MATH 197,001,523477,Kedlaya; Kiran S.,9995,0,9999,4
1714608657827,MATH 197,002,563811,Zhang; Danna,9995,0,9999,4
1714608657827,MATH 197,003,628552,Dumitriu; Ioana,9998,0,9999,1
1714608658855,MCWP 40R,A00,518780,Staff,2,0,20,18
1714608658855,MCWP 40R,B00,518781,Staff,8,0,20,12
1714608658855,MCWP 40R,C00,518783,Staff,6,0,20,14
1714608659884,MCWP 50R,A00,518791,Staff,0,0,20,20
1714608659884,MCWP 50R,B00,518792,Staff,0,2,20,20
1714608659884,MCWP 50R,C00,518793,Staff,0,2,20,20
1714608659884,MCWP 50R,D00,518794,Staff,0,0,20,20
1714608659884,MCWP 50R,E00,518795,Staff,0,2,20,20
1714608659884,MCWP 50R,F00,518796,Staff,0,0,20,20
1714608659884,MCWP 50R,G00,518797,Staff,0,1,20,20
1714608660912,MMW 12R,A01,514034,Herbst; Matthew,0,0,16,16
1714608660912,MMW 12R,A02,514035,Herbst; Matthew,1,0,16,15
1714608661940,MMW 13R,A01,514037,Staff,0,4,16,16
1714608661940,MMW 13R,A02,514039,Staff,0,2,16,16
1714608661940,MMW 13R,A03,628519,Staff,0,2,16,16
1714608663991,SIO 295LS,A00,523233,Staff,10,0,30,20
1714608665016,SIO 295S,A00,523232,Staff,10,0,30,20
1714608666043,SIOC 290S,A01,637330,Merrifield; Mark A,23,0,30,7
1714608667070,SIOC 291S,A01,637333,Gabriel; Corey John,23,0,30,7
1714608668094,SOCI 117,A01,494376,Staff,0,4,5,5
1714608669120,WES 237B,A00,494380,Staff,9,0,20,11
1714608671192,AESE 279B,A00,494370,Wade; Jon P,0,0,33,33
1714608672218,AIP 197,001,627712,Vespa; Emanuel Ignacio,9998,0,9999,1
1714608673246,ANAR 135S,A00,494369,Braswell; Geoffrey E.,0,0,0,0
1714608674275,BENG 196,001,628496,Engler; Adam J.,9998,0,9999,1
1714608675302,CAT 124RS,A01,519847,Geibel; William,0,0,20,20
1714608676328,CAT 125RS,A01,515971,Geibel; William,0,0,20,20
1714608677361,CLRE 250,A00,511389,Morris; Sheldon,9993,0,9999,6
1714608678557,CLRE 251,A00,507176,Mehta; Ravindra L.,9993,0,9999,6
1714608678557,CLRE 251,B00,511410,Mehta; Ravindra L.,9998,0,9999,1
1714608679582,CLRE 252,A00,507189,Cuomo; Raphael Eduardo,9995,0,9999,4
1714608680609,CLRE 253,A00,507199,Vaida; Florin,9994,0,9999,5
1714608680609,CLRE 253,B00,507202,Vaida; Florin,9999,0,9999,0
1714608681636,CLRE 259,A00,507211,Patel; Hemal,9996,0,9999,3
1714608682662,CLRE 260,A00,507221,Cuomo; Raphael Eduardo,9999,0,9999,0
1714608683689,CLRE 297,001,507242,Cuomo; Raphael Eduardo,9999,0,9999,0
1714608684715,COGS 197,001,638244,Voytek; Bradley Thomas,9998,0,9999,1
1714608685743,CSE 191,A00,516875,Minnes Kemp; Mor Mia,9993,0,9999,6
1714608686768,CSE 197,001,637388,Minnes Kemp; Mor Mia,9998,0,9999,1
1714608687795,CSS 201S,A01,494383,Staff,35,0,35,0
1714608688821,CSS 202S,A01,494387,Staff,35,0,35,0
1714608689852,DSC 197,001,628532,Eldridge; Justin Matthew,9996,0,9999,3
1714608690875,EAP 100,A00,516065,Staff,9797,0,9999,202
1714608691900,ECE 45,A01,507414,Staff,33,0,60,27
1714608693956,ECE 111,A01,507420,Staff,15,0,50,35
1714608694983,ECE 197,001,548057,Sievenpiper; Daniel F.,9993,0,9999,6
1714608696010,EDS 115,A00,507243,Choi; Bailey Miyeon,10,0,28,18
1714608697041,EDS 117,A01,494379,Staff,1,5,30,29
1714608698066,EDS 125,A00,507246,Hopkins; Megan Beth,9,0,30,21
1714608699098,EDS 128A,A01,507264,Fargason; Sharon Gayle,8,0,26,18
1714608700123,EDS 128B,A01,507293,Pappas; Elizabeth,12,0,30,18
1714608701154,EDS 139,A00,507294,Fargason; Sharon Gayle,13,0,30,17
1714608701154,EDS 139,B00,507313,Pappas; Elizabeth,13,0,30,17
1714608702185,EDS 201,A00,507315,Staff,13,0,30,17
1714608703217,EDS 203,A01,507317,Halter; Christopher P.,12,0,30,18
1714608704243,EDS 204R,A01,507319,Halter; Christopher P.,0,3,30,30
1714608704243,EDS 204R,B01,507331,Heinzman; Erica M.,16,0,30,14
1714608705279,EDS 206R,A00,507332,Staff,0,4,30,30
1714608705279,EDS 206R,B00,507343,Staff,17,0,30,13
1714608706310,EDS 250,A00,507344,Hemans; Patricia Ann Benitez,22,0,40,18
1714608707344,EDS 281,A00,507345,Daly; Alan J.,18,0,18,0
1714608708366,EDS 284,A00,507350,Daly; Alan J.,16,0,16,0
1714608709399,EDS 286,A00,507359,Fine; Sarah,18,0,18,0
1714608710427,EDS 289C,A01,507361,Daly; Alan J.,18,0,18,0
1714608711452,EDS 290,A00,507366,Hofstetter; Carolyn,15,0,15,0
1714608712480,LIGM 5A,A00,507421,Fischer-Grunski; Eva K,18,0,20,2
1714608713513,LIGM 5B,A00,507423,Fischer-Grunski; Eva K,19,0,20,1
1714608714543,LIGM 5C,A00,507425,Fischer-Grunski; Eva K,19,0,20,1
1714608715569,LIIT 5AS,A00,507427,Carnelos; Chiara,20,0,20,0
1714608716599,LIIT 5BS,A00,507430,Carnelos; Chiara,20,0,20,0
1714608717676,LIIT 5CS,A00,507432,Carnelos; Chiara,20,0,20,0
1714608718707,LISP 5A,A00,507541,Munoz Sanchez; Alicia,11,0,20,9
1714608719735,LISP 5B,A00,507671,Munoz Sanchez; Alicia,8,0,20,12
1714608720762,LISP 5C,A00,507696,Munoz Sanchez; Alicia,9,0,20,11
1714608721788,MAE 197,001,528363,Boechler; Nicholas Sebastia,9998,0,9999,1
1714608722821,MATH 197,001,523477,Kedlaya; Kiran S.,9995,0,9999,4
1714608722821,MATH 197,002,563811,Zhang; Danna,9995,0,9999,4
1714608722821,MATH 197,003,628552,Dumitriu; Ioana,9998,0,9999,1
1714608723847,MCWP 40R,A00,518780,Staff,2,0,20,18
1714608723847,MCWP 40R,B00,518781,Staff,8,0,20,12
1714608723847,MCWP 40R,C00,518783,Staff,6,0,20,14
1714608724873,MCWP 50R,A00,518791,Staff,0,0,20,20
1714608724873,MCWP 50R,B00,518792,Staff,0,2,20,20
1714608724873,MCWP 50R,C00,518793,Staff,0,2,20,20
1714608724873,MCWP 50R,D00,518794,Staff,0,0,20,20
1714608724873,MCWP 50R,E00,518795,Staff,0,2,20,20
1714608724873,MCWP 50R,F00,518796,Staff,0,0,20,20
1714608724873,MCWP 50R,G00,518797,Staff,0,1,20,20
1714608725899,MMW 12R,A01,514034,Herbst; Matthew,0,0,16,16
1714608725899,MMW 12R,A02,514035,Herbst; Matthew,1,0,16,15
1714608726925,MMW 13R,A01,514037,Staff,0,4,16,16
1714608726925,MMW 13R,A02,514039,Staff,0,2,16,16
1714608726925,MMW 13R,A03,628519,Staff,0,2,16,16
1714608729056,SIO 295LS,A00,523233,Staff,10,0,30,20
1714608730080,SIO 295S,A00,523232,Staff,10,0,30,20
1714608731113,SIOC 290S,A01,637330,Merrifield; Mark A,23,0,30,7
1714608732144,SIOC 291S,A01,637333,Gabriel; Corey John,23,0,30,7
1714608733174,SOCI 117,A01,494376,Staff,0,4,5,5
1714608734199,WES 237B,A00,494380,Staff,9,0,20,11
1714608736287,AESE 279B,A00,494370,Wade; Jon P,0,0,33,33
1714608737311,AIP 197,001,627712,Vespa; Emanuel Ignacio,9998,0,9999,1
1714608738343,ANAR 135S,A00,494369,Braswell; Geoffrey E.,0,0,0,0
1714608739368,BENG 196,001,628496,Engler; Adam J.,9998,0,9999,1
1714608740394,CAT 124RS,A01,519847,Geibel; William,0,0,20,20
1714608741421,CAT 125RS,A01,515971,Geibel; William,0,0,20,20
1714608742446,CLRE 250,A00,511389,Morris; Sheldon,9993,0,9999,6
1714608743475,CLRE 251,A00,507176,Mehta; Ravindra L.,9993,0,9999,6
1714608743475,CLRE 251,B00,511410,Mehta; Ravindra L.,9998,0,9999,1
1714608744527,CLRE 252,A00,507189,Cuomo; Raphael Eduardo,9995,0,9999,4
1714608745555,CLRE 253,A00,507199,Vaida; Florin,9994,0,9999,5
1714608745555,CLRE 253,B00,507202,Vaida; Florin,9999,0,9999,0
1714608746585,CLRE 259,A00,507211,Patel; Hemal,9996,0,9999,3
1714608747610,CLRE 260,A00,507221,Cuomo; Raphael Eduardo,9999,0,9999,0
1714608748640,CLRE 297,001,507242,Cuomo; Raphael Eduardo,9999,0,9999,0
1714608749667,COGS 197,001,638244,Voytek; Bradley Thomas,9998,0,9999,1
1714608750700,CSE 191,A00,516875,Minnes Kemp; Mor Mia,9993,0,9999,6
1714608751732,CSE 197,001,637388,Minnes Kemp; Mor Mia,9998,0,9999,1
1714608752758,CSS 201S,A01,494383,Staff,35,0,35,0
1714608753798,CSS 202S,A01,494387,Staff,35,0,35,0
1714608754823,DSC 197,001,628532,Eldridge; Justin Matthew,9996,0,9999,3
1714608755848,EAP 100,A00,516065,Staff,9797,0,9999,202
1714608756879,ECE 45,A01,507414,Staff,33,0,60,27
1714608758936,ECE 111,A01,507420,Staff,15,0,50,35
1714608759963,ECE 197,001,548057,Sievenpiper; Daniel F.,9993,0,9999,6
1714608760994,EDS 115,A00,507243,Choi; Bailey Miyeon,10,0,28,18
1714608762019,EDS 117,A01,494379,Staff,1,5,30,29
1714608763045,EDS 125,A00,507246,Hopkins; Megan Beth,9,0,30,21
1714608764072,EDS 128A,A01,507264,Fargason; Sharon Gayle,8,0,26,18
1714608765101,EDS 128B,A01,507293,Pappas; Elizabeth,12,0,30,18
1714608766126,EDS 139,A00,507294,Fargason; Sharon Gayle,13,0,30,17
1714608766126,EDS 139,B00,507313,Pappas; Elizabeth,13,0,30,17
1714608767151,EDS 201,A00,507315,Staff,13,0,30,17
1714608768179,EDS 203,A01,507317,Halter; Christopher P.,12,0,30,18
1714608769210,EDS 204R,A01,507319,Halter; Christopher P.,0,3,30,30
1714608769210,EDS 204R,B01,507331,Heinzman; Erica M.,16,0,30,14
1714608770236,EDS 206R,A00,507332,Staff,0,4,30,30
1714608770236,EDS 206R,B00,507343,Staff,17,0,30,13
1714608771268,EDS 250,A00,507344,Hemans; Patricia Ann Benitez,22,0,40,18
1714608772293,EDS 281,A00,507345,Daly; Alan J.,18,0,18,0
1714608773318,EDS 284,A00,507350,Daly; Alan J.,16,0,16,0
1714608774349,EDS 286,A00,507359,Fine; Sarah,18,0,18,0
1714608775374,EDS 289C,A01,507361,Daly; Alan J.,18,0,18,0
1714608776403,EDS 290,A00,507366,Hofstetter; Carolyn,15,0,15,0
1714608777430,LIGM 5A,A00,507421,Fischer-Grunski; Eva K,18,0,20,2
1714608778459,LIGM 5B,A00,507423,Fischer-Grunski; Eva K,19,0,20,1
1714608779489,LIGM 5C,A00,507425,Fischer-Grunski; Eva K,19,0,20,1
1714608780515,LIIT 5AS,A00,507427,Carnelos; Chiara,20,0,20,0
1714608781540,LIIT 5BS,A00,507430,Carnelos; Chiara,20,0,20,0
1714608782577,LIIT 5CS,A00,507432,Carnelos; Chiara,20,0,20,0
1714608783603,LISP 5A,A00,507541,Munoz Sanchez; Alicia,11,0,20,9
1714608784627,LISP 5B,A00,507671,Munoz Sanchez; Alicia,8,0,20,12
1714608785660,LISP 5C,A00,507696,Munoz Sanchez; Alicia,9,0,20,11
1714608786691,MAE 197,001,528363,Boechler; Nicholas Sebastia,9998,0,9999,1
1714608787718,MATH 197,001,523477,Kedlaya; Kiran S.,9995,0,9999,4
1714608787718,MATH 197,002,563811,Zhang; Danna,9995,0,9999,4
1714608787718,MATH 197,003,628552,Dumitriu; Ioana,9998,0,9999,1
1714608788753,MCWP 40R,A00,518780,Staff,2,0,20,18
1714608788753,MCWP 40R,B00,518781,Staff,8,0,20,12
1714608788753,MCWP 40R,C00,518783,Staff,6,0,20,14
1714608789789,MCWP 50R,A00,518791,Staff,0,0,20,20
1714608789789,MCWP 50R,B00,518792,Staff,0,2,20,20
1714608789789,MCWP 50R,C00,518793,Staff,0,2,20,20
1714608789789,MCWP 50R,D00,518794,Staff,0,0,20,20
1714608789789,MCWP 50R,E00,518795,Staff,0,2,20,20
1714608789789,MCWP 50R,F00,518796,Staff,0,0,20,20
1714608789789,MCWP 50R,G00,518797,Staff,0,1,20,20
1714608790821,MMW 12R,A01,514034,Herbst; Matthew,0,0,16,16
1714608790821,MMW 12R,A02,514035,Herbst; Matthew,1,0,16,15
1714608791852,MMW 13R,A01,514037,Staff,0,4,16,16
1714608791852,MMW 13R,A02,514039,Staff,0,2,16,16
1714608791852,MMW 13R,A03,628519,Staff,0,2,16,16
1714608793924,SIO 295LS,A00,523233,Staff,10,0,30,20
1714608794968,SIO 295S,A00,523232,Staff,10,0,30,20
1714608796053,SIOC 290S,A01,637330,Merrifield; Mark A,23,0,30,7
1714608797092,SIOC 291S,A01,637333,Gabriel; Corey John,23,0,30,7
1714608798124,SOCI 117,A01,494376,Staff,0,4,5,5
1714608799150,WES 237B,A00,494380,Staff,9,0,20,11
1714608801222,AESE 279B,A00,494370,Wade; Jon P,0,0,33,33
1714608802247,AIP 197,001,627712,Vespa; Emanuel Ignacio,9998,0,9999,1
1714608803272,ANAR 135S,A00,494369,Braswell; Geoffrey E.,0,0,0,0
1714608804303,BENG 196,001,628496,Engler; Adam J.,9998,0,9999,1
1714608805330,CAT 124RS,A01,519847,Geibel; William,0,0,20,20
1714608806354,CAT 125RS,A01,515971,Geibel; William,0,0,20,20
1714608807389,CLRE 250,A00,511389,Morris; Sheldon,9993,0,9999,6
1714608808416,CLRE 251,A00,507176,Mehta; Ravindra L.,9993,0,9999,6
1714608808416,CLRE 251,B00,511410,Mehta; Ravindra L.,9998,0,9999,1
1714608809443,CLRE 252,A00,507189,Cuomo; Raphael Eduardo,9995,0,9999,4
1714608810470,CLRE 253,A00,507199,Vaida; Florin,9994,0,9999,5
1714608810470,CLRE 253,B00,507202,Vaida; Florin,9999,0,9999,0
1714608811495,CLRE 259,A00,507211,Patel; Hemal,9996,0,9999,3
1714608812522,CLRE 260,A00,507221,Cuomo; Raphael Eduardo,9999,0,9999,0
1714608813547,CLRE 297,001,507242,Cuomo; Raphael Eduardo,9999,0,9999,0
1714608814579,COGS 197,001,638244,Voytek; Bradley Thomas,9998,0,9999,1
1714608815606,CSE 191,A00,516875,Minnes Kemp; Mor Mia,9993,0,9999,6
1714608816631,CSE 197,001,637388,Minnes Kemp; Mor Mia,9998,0,9999,1
1714608817667,CSS 201S,A01,494383,Staff,35,0,35,0
1714608818692,CSS 202S,A01,494387,Staff,35,0,35,0
1714608819719,DSC 197,001,628532,Eldridge; Justin Matthew,9996,0,9999,3
1714608820744,EAP 100,A00,516065,Staff,9797,0,9999,202
1714608821772,ECE 45,A01,507414,Staff,33,0,60,27
1714608823828,ECE 111,A01,507420,Staff,15,0,50,35
1714608824854,ECE 197,001,548057,Sievenpiper; Daniel F.,9993,0,9999,6
1714608825881,EDS 115,A00,507243,Choi; Bailey Miyeon,10,0,28,18
1714608826908,EDS 117,A01,494379,Staff,1,5,30,29
1714608827938,EDS 125,A00,507246,Hopkins; Megan Beth,9,0,30,21
1714608828968,EDS 128A,A01,507264,Fargason; Sharon Gayle,8,0,26,18
1714608829999,EDS 128B,A01,507293,Pappas; Elizabeth,12,0,30,18
1714608831025,EDS 139,A00,507294,Fargason; Sharon Gayle,13,0,30,17
1714608831025,EDS 139,B00,507313,Pappas; Elizabeth,13,0,30,17
1714608832106,EDS 201,A00,507315,Staff,13,0,30,17
1714608833129,EDS 203,A01,507317,Halter; Christopher P.,12,0,30,18
1714608834156,EDS 204R,A01,507319,Halter; Christopher P.,0,3,30,30
1714608834156,EDS 204R,B01,507331,Heinzman; Erica M.,16,0,30,14
1714608835185,EDS 206R,A00,507332,Staff,0,4,30,30
1714608835185,EDS 206R,B00,507343,Staff,17,0,30,13
1714608836212,EDS 250,A00,507344,Hemans; Patricia Ann Benitez,22,0,40,18
1714608837241,EDS 281,A00,507345,Daly; Alan J.,18,0,18,0
1714608838271,EDS 284,A00,507350,Daly; Alan J.,16,0,16,0
1714608839296,EDS 286,A00,507359,Fine; Sarah,18,0,18,0
1714608840322,EDS 289C,A01,507361,Daly; Alan J.,18,0,18,0
1714608841350,EDS 290,A00,507366,Hofstetter; Carolyn,15,0,15,0
1714608842382,LIGM 5A,A00,507421,Fischer-Grunski; Eva K,18,0,20,2
1714608843408,LIGM 5B,A00,507423,Fischer-Grunski; Eva K,19,0,20,1
1714608844435,LIGM 5C,A00,507425,Fischer-Grunski; Eva K,19,0,20,1
1714608845461,LIIT 5AS,A00,507427,Carnelos; Chiara,20,0,20,0
1714608846487,LIIT 5BS,A00,507430,Carnelos; Chiara,20,0,20,0
1714608847513,LIIT 5CS,A00,507432,Carnelos; Chiara,20,0,20,0
1714608848540,LISP 5A,A00,507541,Munoz Sanchez; Alicia,11,0,20,9
1714608849567,LISP 5B,A00,507671,Munoz Sanchez; Alicia,8,0,20,12
1714608850592,LISP 5C,A00,507696,Munoz Sanchez; Alicia,9,0,20,11
1714608851619,MAE 197,001,528363,Boechler; Nicholas Sebastia,9998,0,9999,1
1714608852654,MATH 197,001,523477,Kedlaya; Kiran S.,9995,0,9999,4
1714608852654,MATH 197,002,563811,Zhang; Danna,9995,0,9999,4
1714608852654,MATH 197,003,628552,Dumitriu; Ioana,9998,0,9999,1
1714608853682,MCWP 40R,A00,518780,Staff,2,0,20,18
1714608853682,MCWP 40R,B00,518781,Staff,8,0,20,12
1714608853682,MCWP 40R,C00,518783,Staff,6,0,20,14
1714608854706,MCWP 50R,A00,518791,Staff,0,0,20,20
1714608854706,MCWP 50R,B00,518792,Staff,0,2,20,20
1714608854706,MCWP 50R,C00,518793,Staff,0,2,20,20
1714608854706,MCWP 50R,D00,518794,Staff,0,0,20,20
1714608854706,MCWP 50R,E00,518795,Staff,0,2,20,20
1714608854706,MCWP 50R,F00,518796,Staff,0,0,20,20
1714608854706,MCWP 50R,G00,518797,Staff,0,1,20,20
1714608855742,MMW 12R,A01,514034,Herbst; Matthew,0,0,16,16
1714608855742,MMW 12R,A02,514035,Herbst; Matthew,1,0,16,15
1714608856772,MMW 13R,A01,514037,Staff,0,4,16,16
1714608856772,MMW 13R,A02,514039,Staff,0,2,16,16
1714608856772,MMW 13R,A03,628519,Staff,0,2,16,16
1714608858826,SIO 295LS,A00,523233,Staff,10,0,30,20
1714608859850,SIO 295S,A00,523232,Staff,10,0,30,20
1714608860877,SIOC 290S,A01,637330,Merrifield; Mark A,23,0,30,7
1714608861903,SIOC 291S,A01,637333,Gabriel; Corey John,23,0,30,7
1714608862927,SOCI 117,A01,494376,Staff,0,4,5,5
1714608863955,WES 237B,A00,494380,Staff,9,0,20,11
1714608866038,AESE 279B,A00,494370,Wade; Jon P,0,0,33,33
1714608867068,AIP 197,001,627712,Vespa; Emanuel Ignacio,9998,0,9999,1
1714608868094,ANAR 135S,A00,494369,Braswell; Geoffrey E.,0,0,0,0
1714608869120,BENG 196,001,628496,Engler; Adam J.,9998,0,9999,1
1714608870145,CAT 124RS,A01,519847,Geibel; William,0,0,20,20
1714608871176,CAT 125RS,A01,515971,Geibel; William,0,0,20,20
1714608872201,CLRE 250,A00,511389,Morris; Sheldon,9993,0,9999,6
1714608873230,CLRE 251,A00,507176,Mehta; Ravindra L.,9993,0,9999,6
1714608873230,CLRE 251,B00,511410,Mehta; Ravindra L.,9998,0,9999,1
1714608874262,CLRE 252,A00,507189,Cuomo; Raphael Eduardo,9995,0,9999,4
1714608875288,CLRE 253,A00,507199,Vaida; Florin,9994,0,9999,5
1714608875288,CLRE 253,B00,507202,Vaida; Florin,9999,0,9999,0
1714608876319,CLRE 259,A00,507211,Patel; Hemal,9996,0,9999,3
1714608877347,CLRE 260,A00,507221,Cuomo; Raphael Eduardo,9999,0,9999,0
1714608878372,CLRE 297,001,507242,Cuomo; Raphael Eduardo,9999,0,9999,0
1714608879399,COGS 197,001,638244,Voytek; Bradley Thomas,9998,0,9999,1
1714608880424,CSE 191,A00,516875,Minnes Kemp; Mor Mia,9993,0,9999,6
1714608881448,CSE 197,001,637388,Minnes Kemp; Mor Mia,9998,0,9999,1
1714608882481,CSS 201S,A01,494383,Staff,35,0,35,0
1714608883505,CSS 202S,A01,494387,Staff,35,0,35,0
1714608884534,DSC 197,001,628532,Eldridge; Justin Matthew,9996,0,9999,3
1714608885561,EAP 100,A00,516065,Staff,9797,0,9999,202
1714608886590,ECE 45,A01,507414,Staff,33,0,60,27
1714608888641,ECE 111,A01,507420,Staff,15,0,50,35
1714608889667,ECE 197,001,548057,Sievenpiper; Daniel F.,9993,0,9999,6
1714608890693,EDS 115,A00,507243,Choi; Bailey Miyeon,10,0,28,18
1714608891719,EDS 117,A01,494379,Staff,1,5,30,29
1714608892743,EDS 125,A00,507246,Hopkins; Megan Beth,9,0,30,21
1714608893770,EDS 128A,A01,507264,Fargason; Sharon Gayle,8,0,26,18
1714608894801,EDS 128B,A01,507293,Pappas; Elizabeth,12,0,30,18
1714608895832,EDS 139,A00,507294,Fargason; Sharon Gayle,13,0,30,17
1714608895832,EDS 139,B00,507313,Pappas; Elizabeth,13,0,30,17
1714608896863,EDS 201,A00,507315,Staff,13,0,30,17
1714608897894,EDS 203,A01,507317,Halter; Christopher P.,12,0,30,18
1714608898927,EDS 204R,A01,507319,Halter; Christopher P.,0,3,30,30
1714608898927,EDS 204R,B01,507331,Heinzman; Erica M.,16,0,30,14
1714608899957,EDS 206R,A00,507332,Staff,0,4,30,30
1714608899957,EDS 206R,B00,507343,Staff,17,0,30,13
1714608900985,EDS 250,A00,507344,Hemans; Patricia Ann Benitez,22,0,40,18
1714608902011,EDS 281,A00,507345,Daly; Alan J.,18,0,18,0
1714608903034,EDS 284,A00,507350,Daly; Alan J.,16,0,16,0
1714608904059,EDS 286,A00,507359,Fine; Sarah,18,0,18,0
1714608905084,EDS 289C,A01,507361,Daly; Alan J.,18,0,18,0
1714608906114,EDS 290,A00,507366,Hofstetter; Carolyn,15,0,15,0
1714608907147,LIGM 5A,A00,507421,Fischer-Grunski; Eva K,18,0,20,2
1714608908172,LIGM 5B,A00,507423,Fischer-Grunski; Eva K,19,0,20,1
1714608909204,LIGM 5C,A00,507425,Fischer-Grunski; Eva K,19,0,20,1
1714608910235,LIIT 5AS,A00,507427,Carnelos; Chiara,20,0,20,0
1714608911260,LIIT 5BS,A00,507430,Carnelos; Chiara,20,0,20,0
1714608912285,LIIT 5CS,A00,507432,Carnelos; Chiara,20,0,20,0
1714608913313,LISP 5A,A00,507541,Munoz Sanchez; Alicia,11,0,20,9
1714608914338,LISP 5B,A00,507671,Munoz Sanchez; Alicia,8,0,20,12
1714608915363,LISP 5C,A00,507696,Munoz Sanchez; Alicia,9,0,20,11
1714608916396,MAE 197,001,528363,Boechler; Nicholas Sebastia,9998,0,9999,1
1714608917425,MATH 197,001,523477,Kedlaya; Kiran S.,9995,0,9999,4
1714608917425,MATH 197,002,563811,Zhang; Danna,9995,0,9999,4
1714608917425,MATH 197,003,628552,Dumitriu; Ioana,9998,0,9999,1
1714608918452,MCWP 40R,A00,518780,Staff,2,0,20,18
1714608918452,MCWP 40R,B00,518781,Staff,8,0,20,12
1714608918452,MCWP 40R,C00,518783,Staff,6,0,20,14
1714608919482,MCWP 50R,A00,518791,Staff,0,0,20,20
1714608919482,MCWP 50R,B00,518792,Staff,0,2,20,20
1714608919482,MCWP 50R,C00,518793,Staff,0,2,20,20
1714608919482,MCWP 50R,D00,518794,Staff,0,0,20,20
1714608919482,MCWP 50R,E00,518795,Staff,0,2,20,20
1714608919482,MCWP 50R,F00,518796,Staff,0,0,20,20
1714608919482,MCWP 50R,G00,518797,Staff,0,1,20,20
1714608920514,MMW 12R,A01,514034,Herbst; Matthew,0,0,16,16
1714608920514,MMW 12R,A02,514035,Herbst; Matthew,1,0,16,15
1714608921539,MMW 13R,A01,514037,Staff,0,4,16,16
1714608921539,MMW 13R,A02,514039,Staff,0,2,16,16
1714608921539,MMW 13R,A03,628519,Staff,0,2,16,16
1714608923597,SIO 295LS,A00,523233,Staff,10,0,30,20
1714608924621,SIO 295S,A00,523232,Staff,10,0,30,20
1714608925648,SIOC 290S,A01,637330,Merrifield; Mark A,23,0,30,7
1714608926675,SIOC 291S,A01,637333,Gabriel; Corey John,23,0,30,7
1714608927702,SOCI 117,A01,494376,Staff,0,4,5,5
1714608928726,WES 237B,A00,494380,Staff,9,0,20,11
1714608930795,AESE 279B,A00,494370,Wade; Jon P,0,0,33,33
1714608931821,AIP 197,001,627712,Vespa; Emanuel Ignacio,9998,0,9999,1
1714608932859,ANAR 135S,A00,494369,Braswell; Geoffrey E.,0,0,0,0
1714608933897,BENG 196,001,628496,Engler; Adam J.,9998,0,9999,1
1714608934923,CAT 124RS,A01,519847,Geibel; William,0,0,20,20
1714608936003,CAT 125RS,A01,515971,Geibel; William,0,0,20,20
1714608937038,CLRE 250,A00,511389,Morris; Sheldon,9993,0,9999,6
1714608938067,CLRE 251,A00,507176,Mehta; Ravindra L.,9993,0,9999,6
1714608938067,CLRE 251,B00,511410,Mehta; Ravindra L.,9998,0,9999,1
1714608939092,CLRE 252,A00,507189,Cuomo; Raphael Eduardo,9995,0,9999,4
1714608940119,CLRE 253,A00,507199,Vaida; Florin,9994,0,9999,5
1714608940119,CLRE 253,B00,507202,Vaida; Florin,9999,0,9999,0
1714608941150,CLRE 259,A00,507211,Patel; Hemal,9996,0,9999,3
1714608942178,CLRE 260,A00,507221,Cuomo; Raphael Eduardo,9999,0,9999,0
1714608943203,CLRE 297,001,507242,Cuomo; Raphael Eduardo,9999,0,9999,0
1714608944229,COGS 197,001,638244,Voytek; Bradley Thomas,9998,0,9999,1
1714608945255,CSE 191,A00,516875,Minnes Kemp; Mor Mia,9993,0,9999,6
1714608946286,CSE 197,001,637388,Minnes Kemp; Mor Mia,9998,0,9999,1
1714608947311,CSS 201S,A01,494383,Staff,35,0,35,0
1714608948337,CSS 202S,A01,494387,Staff,35,0,35,0
1714608949361,DSC 197,001,628532,Eldridge; Justin Matthew,9996,0,9999,3
1714608950385,EAP 100,A00,516065,Staff,9797,0,9999,202
1714608951413,ECE 45,A01,507414,Staff,33,0,60,27
1714608953467,ECE 111,A01,507420,Staff,15,0,50,35
1714608954493,ECE 197,001,548057,Sievenpiper; Daniel F.,9993,0,9999,6
1714608955519,EDS 115,A00,507243,Choi; Bailey Miyeon,10,0,28,18
1714608956545,EDS 117,A01,494379,Staff,1,5,30,29
1714608957576,EDS 125,A00,507246,Hopkins; Megan Beth,9,0,30,21
1714608958605,EDS 128A,A01,507264,Fargason; Sharon Gayle,8,0,26,18
1714608959630,EDS 128B,A01,507293,Pappas; Elizabeth,12,0,30,18
1714608960662,EDS 139,A00,507294,Fargason; Sharon Gayle,13,0,30,17
1714608960662,EDS 139,B00,507313,Pappas; Elizabeth,13,0,30,17
1714608961685,EDS 201,A00,507315,Staff,13,0,30,17
1714608962711,EDS 203,A01,507317,Halter; Christopher P.,12,0,30,18
1714608963736,EDS 204R,A01,507319,Halter; Christopher P.,0,3,30,30
1714608963736,EDS 204R,B01,507331,Heinzman; Erica M.,16,0,30,14
1714608964763,EDS 206R,A00,507332,Staff,0,4,30,30
1714608964763,EDS 206R,B00,507343,Staff,17,0,30,13
1714608965789,EDS 250,A00,507344,Hemans; Patricia Ann Benitez,22,0,40,18
1714608966818,EDS 281,A00,507345,Daly; Alan J.,18,0,18,0
1714608967845,EDS 284,A00,507350,Daly; Alan J.,16,0,16,0
1714608968875,EDS 286,A00,507359,Fine; Sarah,18,0,18,0
1714608969903,EDS 289C,A01,507361,Daly; Alan J.,18,0,18,0
1714608970937,EDS 290,A00,507366,Hofstetter; Carolyn,15,0,15,0
1714608971967,LIGM 5A,A00,507421,Fischer-Grunski; Eva K,18,0,20,2
1714608972994,LIGM 5B,A00,507423,Fischer-Grunski; Eva K,19,0,20,1
1714608974018,LIGM 5C,A00,507425,Fischer-Grunski; Eva K,19,0,20,1
1714608975046,LIIT 5AS,A00,507427,Carnelos; Chiara,20,0,20,0
1714608976076,LIIT 5BS,A00,507430,Carnelos; Chiara,20,0,20,0
1714608977105,LIIT 5CS,A00,507432,Carnelos; Chiara,20,0,20,0
1714608978135,LISP 5A,A00,507541,Munoz Sanchez; Alicia,11,0,20,9
1714608979160,LISP 5B,A00,507671,Munoz Sanchez; Alicia,8,0,20,12
1714608980189,LISP 5C,A00,507696,Munoz Sanchez; Alicia,9,0,20,11
1714608981215,MAE 197,001,528363,Boechler; Nicholas Sebastia,9998,0,9999,1
1714608982242,MATH 197,001,523477,Kedlaya; Kiran S.,9995,0,9999,4
1714608982242,MATH 197,002,563811,Zhang; Danna,9995,0,9999,4
1714608982242,MATH 197,003,628552,Dumitriu; Ioana,9998,0,9999,1
1714608983270,MCWP 40R,A00,518780,Staff,2,0,20,18
1714608983270,MCWP 40R,B00,518781,Staff,8,0,20,12
1714608983270,MCWP 40R,C00,518783,Staff,6,0,20,14
1714608984296,MCWP 50R,A00,518791,Staff,0,0,20,20
1714608984296,MCWP 50R,B00,518792,Staff,0,2,20,20
1714608984296,MCWP 50R,C00,518793,Staff,0,2,20,20
1714608984296,MCWP 50R,D00,518794,Staff,0,0,20,20
1714608984296,MCWP 50R,E00,518795,Staff,0,2,20,20
1714608984296,MCWP 50R,F00,518796,Staff,0,0,20,20
1714608984296,MCWP 50R,G00,518797,Staff,0,1,20,20
1714608985321,MMW 12R,A01,514034,Herbst; Matthew,0,0,16,16
1714608985321,MMW 12R,A02,514035,Herbst; Matthew,1,0,16,15
1714608986350,MMW 13R,A01,514037,Staff,0,4,16,16
1714608986350,MMW 13R,A02,514039,Staff,0,2,16,16
1714608986350,MMW 13R,A03,628519,Staff,0,2,16,16
1714608988403,SIO 295LS,A00,523233,Staff,10,0,30,20
1714608989429,SIO 295S,A00,523232,Staff,10,0,30,20
1714608990454,SIOC 290S,A01,637330,Merrifield; Mark A,23,0,30,7
1714608991483,SIOC 291S,A01,637333,Gabriel; Corey John,23,0,30,7
1714608992509,SOCI 117,A01,494376,Staff,0,4,5,5
1714608993538,WES 237B,A00,494380,Staff,9,0,20,11
1714608995666,AESE 279B,A00,494370,Wade; Jon P,0,0,33,33
1714608996690,AIP 197,001,627712,Vespa; Emanuel Ignacio,9998,0,9999,1
1714608997715,ANAR 135S,A00,494369,Braswell; Geoffrey E.,0,0,0,0
1714608998741,BENG 196,001,628496,Engler; Adam J.,9998,0,9999,1
1714608999769,CAT 124RS,A01,519847,Geibel; William,0,0,20,20
1714609000798,CAT 125RS,A01,515971,Geibel; William,0,0,20,20
1714609001824,CLRE 250,A00,511389,Morris; Sheldon,9993,0,9999,6
1714609002852,CLRE 251,A00,507176,Mehta; Ravindra L.,9993,0,9999,6
1714609002852,CLRE 251,B00,511410,Mehta; Ravindra L.,9998,0,9999,1
1714609003881,CLRE 252,A00,507189,Cuomo; Raphael Eduardo,9995,0,9999,4
1714609004910,CLRE 253,A00,507199,Vaida; Florin,9994,0,9999,5
1714609004910,CLRE 253,B00,507202,Vaida; Florin,9999,0,9999,0
1714609005935,CLRE 259,A00,507211,Patel; Hemal,9996,0,9999,3
1714609006959,CLRE 260,A00,507221,Cuomo; Raphael Eduardo,9999,0,9999,0
1714609007986,CLRE 297,001,507242,Cuomo; Raphael Eduardo,9999,0,9999,0
1714609009014,COGS 197,001,638244,Voytek; Bradley Thomas,9998,0,9999,1
1714609010040,CSE 191,A00,516875,Minnes Kemp; Mor Mia,9993,0,9999,6
1714609011068,CSE 197,001,637388,Minnes Kemp; Mor Mia,9998,0,9999,1
1714609012097,CSS 201S,A01,494383,Staff,35,0,35,0
1714609013126,CSS 202S,A01,494387,Staff,35,0,35,0
1714609014208,DSC 197,001,628532,Eldridge; Justin Matthew,9996,0,9999,3
1714609015237,EAP 100,A00,516065,Staff,9797,0,9999,202
1714609016264,ECE 45,A01,507414,Staff,33,0,60,27
1714609018318,ECE 111,A01,507420,Staff,15,0,50,35
1714609019346,ECE 197,001,548057,Sievenpiper; Daniel F.,9993,0,9999,6
1714609020379,EDS 115,A00,507243,Choi; Bailey Miyeon,10,0,28,18
1714609021407,EDS 117,A01,494379,Staff,1,5,30,29
1714609022433,EDS 125,A00,507246,Hopkins; Megan Beth,9,0,30,21
1714609023463,EDS 128A,A01,507264,Fargason; Sharon Gayle,8,0,26,18
1714609024487,EDS 128B,A01,507293,Pappas; Elizabeth,12,0,30,18
1714609025513,EDS 139,A00,507294,Fargason; Sharon Gayle,13,0,30,17
1714609025513,EDS 139,B00,507313,Pappas; Elizabeth,13,0,30,17
1714609026538,EDS 201,A00,507315,Staff,13,0,30,17
1714609027562,EDS 203,A01,507317,Halter; Christopher P.,12,0,30,18
1714609028590,EDS 204R,A01,507319,Halter; Christopher P.,0,3,30,30
1714609028590,EDS 204R,B01,507331,Heinzman; Erica M.,16,0,30,14
1714609029618,EDS 206R,A00,507332,Staff,0,4,30,30
1714609029618,EDS 206R,B00,507343,Staff,17,0,30,13
1714609030645,EDS 250,A00,507344,Hemans; Patricia Ann Benitez,22,0,40,18
1714609031674,EDS 281,A00,507345,Daly; Alan J.,18,0,18,0
1714609032699,EDS 284,A00,507350,Daly; Alan J.,16,0,16,0
1714609033723,EDS 286,A00,507359,Fine; Sarah,18,0,18,0
1714609034747,EDS 289C,A01,507361,Daly; Alan J.,18,0,18,0
1714609035778,EDS 290,A00,507366,Hofstetter; Carolyn,15,0,15,0
1714609036809,LIGM 5A,A00,507421,Fischer-Grunski; Eva K,18,0,20,2
1714609037836,LIGM 5B,A00,507423,Fischer-Grunski; Eva K,19,0,20,1
1714609038861,LIGM 5C,A00,507425,Fischer-Grunski; Eva K,19,0,20,1
1714609039885,LIIT 5AS,A00,507427,Carnelos; Chiara,20,0,20,0
1714609040912,LIIT 5BS,A00,507430,Carnelos; Chiara,20,0,20,0
1714609041941,LIIT 5CS,A00,507432,Carnelos; Chiara,20,0,20,0
1714609042965,LISP 5A,A00,507541,Munoz Sanchez; Alicia,11,0,20,9
1714609043989,LISP 5B,A00,507671,Munoz Sanchez; Alicia,8,0,20,12
1714609045017,LISP 5C,A00,507696,Munoz Sanchez; Alicia,9,0,20,11
1714609046046,MAE 197,001,528363,Boechler; Nicholas Sebastia,9998,0,9999,1
1714609047077,MATH 197,001,523477,Kedlaya; Kiran S.,9995,0,9999,4
1714609047077,MATH 197,002,563811,Zhang; Danna,9995,0,9999,4
1714609047077,MATH 197,003,628552,Dumitriu; Ioana,9998,0,9999,1
1714609048104,MCWP 40R,A00,518780,Staff,2,0,20,18
1714609048104,MCWP 40R,B00,518781,Staff,8,0,20,12
1714609048104,MCWP 40R,C00,518783,Staff,6,0,20,14
1714609049129,MCWP 50R,A00,518791,Staff,0,0,20,20
1714609049129,MCWP 50R,B00,518792,Staff,0,2,20,20
1714609049129,MCWP 50R,C00,518793,Staff,0,2,20,20
1714609049129,MCWP 50R,D00,518794,Staff,0,0,20,20
1714609049129,MCWP 50R,E00,518795,Staff,0,2,20,20
1714609049129,MCWP 50R,F00,518796,Staff,0,0,20,20
1714609049129,MCWP 50R,G00,518797,Staff,0,1,20,20
1714609050159,MMW 12R,A01,514034,Herbst; Matthew,0,0,16,16
1714609050159,MMW 12R,A02,514035,Herbst; Matthew,1,0,16,15
1714609051183,MMW 13R,A01,514037,Staff,0,4,16,16
1714609051183,MMW 13R,A02,514039,Staff,0,2,16,16
1714609051183,MMW 13R,A03,628519,Staff,0,2,16,16
1714609053240,SIO 295LS,A00,523233,Staff,10,0,30,20
1714609054264,SIO 295S,A00,523232,Staff,10,0,30,20
1714609055290,SIOC 290S,A01,637330,Merrifield; Mark A,23,0,30,7
1714609056314,SIOC 291S,A01,637333,Gabriel; Corey John,23,0,30,7
1714609057342,SOCI 117,A01,494376,Staff,0,4,5,5
1714609058369,WES 237B,A00,494380,Staff,9,0,20,11
1714609060442,AESE 279B,A00,494370,Wade; Jon P,0,0,33,33
1714609061468,AIP 197,001,627712,Vespa; Emanuel Ignacio,9998,0,9999,1
1714609062493,ANAR 135S,A00,494369,Braswell; Geoffrey E.,0,0,0,0
1714609063517,BENG 196,001,628496,Engler; Adam J.,9998,0,9999,1
1714609064543,CAT 124RS,A01,519847,Geibel; William,0,0,20,20
1714609065569,CAT 125RS,A01,515971,Geibel; William,0,0,20,20
1714609066596,CLRE 250,A00,511389,Morris; Sheldon,9993,0,9999,6
1714609067623,CLRE 251,A00,507176,Mehta; Ravindra L.,9993,0,9999,6
1714609067623,CLRE 251,B00,511410,Mehta; Ravindra L.,9998,0,9999,1
1714609068653,CLRE 252,A00,507189,Cuomo; Raphael Eduardo,9995,0,9999,4
1714609069679,CLRE 253,A00,507199,Vaida; Florin,9994,0,9999,5
1714609069679,CLRE 253,B00,507202,Vaida; Florin,9999,0,9999,0
1714609070704,CLRE 259,A00,507211,Patel; Hemal,9996,0,9999,3
1714609071730,CLRE 260,A00,507221,Cuomo; Raphael Eduardo,9999,0,9999,0
1714609072755,CLRE 297,001,507242,Cuomo; Raphael Eduardo,9999,0,9999,0
1714609073779,COGS 197,001,638244,Voytek; Bradley Thomas,9998,0,9999,1
1714609074807,CSE 191,A00,516875,Minnes Kemp; Mor Mia,9993,0,9999,6
1714609075833,CSE 197,001,637388,Minnes Kemp; Mor Mia,9998,0,9999,1
1714609076865,CSS 201S,A01,494383,Staff,35,0,35,0
1714609077893,CSS 202S,A01,494387,Staff,35,0,35,0
1714609078920,DSC 197,001,628532,Eldridge; Justin Matthew,9996,0,9999,3
1714609079950,EAP 100,A00,516065,Staff,9797,0,9999,202
1714609080977,ECE 45,A01,507414,Staff,33,0,60,27
1714609083027,ECE 111,A01,507420,Staff,15,0,50,35
1714609084056,ECE 197,001,548057,Sievenpiper; Daniel F.,9993,0,9999,6
1714609085088,EDS 115,A00,507243,Choi; Bailey Miyeon,10,0,28,18
1714609086167,EDS 117,A01,494379,Staff,1,5,30,29
1714609087198,EDS 125,A00,507246,Hopkins; Megan Beth,9,0,30,21
1714609088224,EDS 128A,A01,507264,Fargason; Sharon Gayle,8,0,26,18
1714609089250,EDS 128B,A01,507293,Pappas; Elizabeth,12,0,30,18
1714609090275,EDS 139,A00,507294,Fargason; Sharon Gayle,13,0,30,17
1714609090275,EDS 139,B00,507313,Pappas; Elizabeth,13,0,30,17
1714609091302,EDS 201,A00,507315,Staff,13,0,30,17
1714609092327,EDS 203,A01,507317,Halter; Christopher P.,12,0,30,18
1714609093351,EDS 204R,A01,507319,Halter; Christopher P.,0,3,30,30
1714609093351,EDS 204R,B01,507331,Heinzman; Erica M.,16,0,30,14
1714609094381,EDS 206R,A00,507332,Staff,0,4,30,30
1714609094381,EDS 206R,B00,507343,Staff,17,0,30,13
1714609095407,EDS 250,A00,507344,Hemans; Patricia Ann Benitez,22,0,40,18
1714609096430,EDS 281,A00,507345,Daly; Alan J.,18,0,18,0
1714609097458,EDS 284,A00,507350,Daly; Alan J.,16,0,16,0
1714609098484,EDS 286,A00,507359,Fine; Sarah,18,0,18,0
1714609099511,EDS 289C,A01,507361,Daly; Alan J.,18,0,18,0
1714609100536,EDS 290,A00,507366,Hofstetter; Carolyn,15,0,15,0
1714609101562,LIGM 5A,A00,507421,Fischer-Grunski; Eva K,18,0,20,2
1714609102592,LIGM 5B,A00,507423,Fischer-Grunski; Eva K,19,0,20,1
1714609103619,LIGM 5C,A00,507425,Fischer-Grunski; Eva K,19,0,20,1
1714609104649,LIIT 5AS,A00,507427,Carnelos; Chiara,20,0,20,0
1714609105676,LIIT 5BS,A00,507430,Carnelos; Chiara,20,0,20,0
1714609106701,LIIT 5CS,A00,507432,Carnelos; Chiara,20,0,20,0
1714609107727,LISP 5A,A00,507541,Munoz Sanchez; Alicia,11,0,20,9
1714609108758,LISP 5B,A00,507671,Munoz Sanchez; Alicia,8,0,20,12
1714609109782,LISP 5C,A00,507696,Munoz Sanchez; Alicia,9,0,20,11
1714609110808,MAE 197,001,528363,Boechler; Nicholas Sebastia,9998,0,9999,1
1714609111837,MATH 197,001,523477,Kedlaya; Kiran S.,9995,0,9999,4
1714609111837,MATH 197,002,563811,Zhang; Danna,9995,0,9999,4
1714609111837,MATH 197,003,628552,Dumitriu; Ioana,9998,0,9999,1
1714609112865,MCWP 40R,A00,518780,Staff,2,0,20,18
1714609112865,MCWP 40R,B00,518781,Staff,8,0,20,12
1714609112865,MCWP 40R,C00,518783,Staff,6,0,20,14
1714609113911,MCWP 50R,A00,518791,Staff,0,0,20,20
1714609113911,MCWP 50R,B00,518792,Staff,0,2,20,20
1714609113911,MCWP 50R,C00,518793,Staff,0,2,20,20
1714609113911,MCWP 50R,D00,518794,Staff,0,0,20,20
1714609113911,MCWP 50R,E00,518795,Staff,0,2,20,20
1714609113911,MCWP 50R,F00,518796,Staff,0,0,20,20
1714609113911,MCWP 50R,G00,518797,Staff,0,1,20,20
1714609114936,MMW 12R,A01,514034,Herbst; Matthew,0,0,16,16
1714609114936,MMW 12R,A02,514035,Herbst; Matthew,1,0,16,15
1714609115965,MMW 13R,A01,514037,Staff,0,4,16,16
1714609115965,MMW 13R,A02,514039,Staff,0,2,16,16
1714609115965,MMW 13R,A03,628519,Staff,0,2,16,16
1714609118019,SIO 295LS,A00,523233,Staff,10,0,30,20
1714609119047,SIO 295S,A00,523232,Staff,10,0,30,20
1714609120073,SIOC 290S,A01,637330,Merrifield; Mark A,23,0,30,7
1714609121100,SIOC 291S,A01,637333,Gabriel; Corey John,23,0,30,7
1714609122128,SOCI 117,A01,494376,Staff,0,4,5,5
1714609123157,WES 237B,A00,494380,Staff,9,0,20,11
1714609125237,AESE 279B,A00,494370,Wade; Jon P,0,0,33,33
1714609126262,AIP 197,001,627712,Vespa; Emanuel Ignacio,9998,0,9999,1
1714609127289,ANAR 135S,A00,494369,Braswell; Geoffrey E.,0,0,0,0
1714609128317,BENG 196,001,628496,Engler; Adam J.,9998,0,9999,1
1714609129342,CAT 124RS,A01,519847,Geibel; William,0,0,20,20
1714609130368,CAT 125RS,A01,515971,Geibel; William,0,0,20,20
1714609131393,CLRE 250,A00,511389,Morris; Sheldon,9993,0,9999,6
1714609132421,CLRE 251,A00,507176,Mehta; Ravindra L.,9993,0,9999,6
1714609132421,CLRE 251,B00,511410,Mehta; Ravindra L.,9998,0,9999,1
1714609133450,CLRE 252,A00,507189,Cuomo; Raphael Eduardo,9995,0,9999,4
1714609134479,CLRE 253,A00,507199,Vaida; Florin,9994,0,9999,5
1714609134479,CLRE 253,B00,507202,Vaida; Florin,9999,0,9999,0
1714609135506,CLRE 259,A00,507211,Patel; Hemal,9996,0,9999,3
1714609136534,CLRE 260,A00,507221,Cuomo; Raphael Eduardo,9999,0,9999,0
1714609137560,CLRE 297,001,507242,Cuomo; Raphael Eduardo,9999,0,9999,0
1714609138586,COGS 197,001,638244,Voytek; Bradley Thomas,9998,0,9999,1
1714609139612,CSE 191,A00,516875,Minnes Kemp; Mor Mia,9993,0,9999,6
1714609140640,CSE 197,001,637388,Minnes Kemp; Mor Mia,9998,0,9999,1
1714609141665,CSS 201S,A01,494383,Staff,35,0,35,0
1714609142694,CSS 202S,A01,494387,Staff,35,0,35,0
1714609143720,DSC 197,001,628532,Eldridge; Justin Matthew,9996,0,9999,3
1714609144744,EAP 100,A00,516065,Staff,9797,0,9999,202
1714609145770,ECE 45,A01,507414,Staff,33,0,60,27
1714609147826,ECE 111,A01,507420,Staff,15,0,50,35
1714609148852,ECE 197,001,548057,Sievenpiper; Daniel F.,9993,0,9999,6
1714609149880,EDS 115,A00,507243,Choi; Bailey Miyeon,10,0,28,18
1714609150906,EDS 117,A01,494379,Staff,1,5,30,29
1714609151933,EDS 125,A00,507246,Hopkins; Megan Beth,9,0,30,21
1714609152962,EDS 128A,A01,507264,Fargason; Sharon Gayle,8,0,26,18
1714609153992,EDS 128B,A01,507293,Pappas; Elizabeth,12,0,30,18
1714609155019,EDS 139,A00,507294,Fargason; Sharon Gayle,13,0,30,17
1714609155019,EDS 139,B00,507313,Pappas; Elizabeth,13,0,30,17
1714609156046,EDS 201,A00,507315,Staff,13,0,30,17
1714609157075,EDS 203,A01,507317,Halter; Christopher P.,12,0,30,18
1714609158102,EDS 204R,A01,507319,Halter; Christopher P.,0,3,30,30
1714609158102,EDS 204R,B01,507331,Heinzman; Erica M.,16,0,30,14
1714609159129,EDS 206R,A00,507332,Staff,0,4,30,30
1714609159129,EDS 206R,B00,507343,Staff,17,0,30,13
1714609160153,EDS 250,A00,507344,Hemans; Patricia Ann Benitez,22,0,40,18
1714609161177,EDS 281,A00,507345,Daly; Alan J.,18,0,18,0
1714609162203,EDS 284,A00,507350,Daly; Alan J.,16,0,16,0
1714609163232,EDS 286,A00,507359,Fine; Sarah,18,0,18,0
1714609164259,EDS 289C,A01,507361,Daly; Alan J.,18,0,18,0
1714609165283,EDS 290,A00,507366,Hofstetter; Carolyn,15,0,15,0
1714609166310,LIGM 5A,A00,507421,Fischer-Grunski; Eva K,18,0,20,2
1714609167338,LIGM 5B,A00,507423,Fischer-Grunski; Eva K,19,0,20,1
1714609168362,LIGM 5C,A00,507425,Fischer-Grunski; Eva K,19,0,20,1
1714609169386,LIIT 5AS,A00,507427,Carnelos; Chiara,20,0,20,0
1714609170417,LIIT 5BS,A00,507430,Carnelos; Chiara,20,0,20,0
1714609171443,LIIT 5CS,A00,507432,Carnelos; Chiara,20,0,20,0
1714609172469,LISP 5A,A00,507541,Munoz Sanchez; Alicia,11,0,20,9
1714609173493,LISP 5B,A00,507671,Munoz Sanchez; Alicia,8,0,20,12
1714609174518,LISP 5C,A00,507696,Munoz Sanchez; Alicia,9,0,20,11
1714609175544,MAE 197,001,528363,Boechler; Nicholas Sebastia,9998,0,9999,1
1714609176571,MATH 197,001,523477,Kedlaya; Kiran S.,9995,0,9999,4
1714609176571,MATH 197,002,563811,Zhang; Danna,9995,0,9999,4
1714609176571,MATH 197,003,628552,Dumitriu; Ioana,9998,0,9999,1
1714609177595,MCWP 40R,A00,518780,Staff,2,0,20,18
1714609177595,MCWP 40R,B00,518781,Staff,8,0,20,12
1714609177595,MCWP 40R,C00,518783,Staff,6,0,20,14
1714609178619,MCWP 50R,A00,518791,Staff,0,0,20,20
1714609178619,MCWP 50R,B00,518792,Staff,0,2,20,20
1714609178619,MCWP 50R,C00,518793,Staff,0,2,20,20
1714609178619,MCWP 50R,D00,518794,Staff,0,0,20,20
1714609178619,MCWP 50R,E00,518795,Staff,0,2,20,20
1714609178619,MCWP 50R,F00,518796,Staff,0,0,20,20
1714609178619,MCWP 50R,G00,518797,Staff,0,1,20,20
1714609179645,MMW 12R,A01,514034,Herbst; Matthew,0,0,16,16
1714609179645,MMW 12R,A02,514035,Herbst; Matthew,1,0,16,15
1714609180674,MMW 13R,A01,514037,Staff,0,4,16,16
1714609180674,MMW 13R,A02,514039,Staff,0,2,16,16
1714609180674,MMW 13R,A03,628519,Staff,0,2,16,16
1714609182731,SIO 295LS,A00,523233,Staff,10,0,30,20
1714609183758,SIO 295S,A00,523232,Staff,10,0,30,20
1714609184788,SIOC 290S,A01,637330,Merrifield; Mark A,23,0,30,7
1714609185813,SIOC 291S,A01,637333,Gabriel; Corey John,23,0,30,7
1714609186838,SOCI 117,A01,494376,Staff,0,4,5,5
1714609187865,WES 237B,A00,494380,Staff,9,0,20,11
1714609189984,AESE 279B,A00,494370,Wade; Jon P,0,0,33,33
1714609191011,AIP 197,001,627712,Vespa; Emanuel Ignacio,9998,0,9999,1
1714609192038,ANAR 135S,A00,494369,Braswell; Geoffrey E.,0,0,0,0
1714609193063,BENG 196,001,628496,Engler; Adam J.,9998,0,9999,1
1714609194091,CAT 124RS,A01,519847,Geibel; William,0,0,20,20
1714609195118,CAT 125RS,A01,515971,Geibel; William,0,0,20,20
1714609196148,CLRE 250,A00,511389,Morris; Sheldon,9993,0,9999,6
1714609197174,CLRE 251,A00,507176,Mehta; Ravindra L.,9993,0,9999,6
1714609197174,CLRE 251,B00,511410,Mehta; Ravindra L.,9998,0,9999,1
1714609198200,CLRE 252,A00,507189,Cuomo; Raphael Eduardo,9995,0,9999,4
1714609199228,CLRE 253,A00,507199,Vaida; Florin,9994,0,9999,5
1714609199228,CLRE 253,B00,507202,Vaida; Florin,9999,0,9999,0
1714609200258,CLRE 259,A00,507211,Patel; Hemal,9996,0,9999,3
1714609201286,CLRE 260,A00,507221,Cuomo; Raphael Eduardo,9999,0,9999,0
1714609202310,CLRE 297,001,507242,Cuomo; Raphael Eduardo,9999,0,9999,0
1714609203337,COGS 197,001,638244,Voytek; Bradley Thomas,9998,0,9999,1
1714609204360,CSE 191,A00,516875,Minnes Kemp; Mor Mia,9992,0,9999,7
1714609205385,CSE 197,001,637388,Minnes Kemp; Mor Mia,9998,0,9999,1
1714609206413,CSS 201S,A01,494383,Staff,35,0,35,0
1714609207438,CSS 202S,A01,494387,Staff,35,0,35,0
1714609208461,DSC 197,001,628532,Eldridge; Justin Matthew,9996,0,9999,3
1714609209487,EAP 100,A00,516065,Staff,9797,0,9999,202
1714609210514,ECE 45,A01,507414,Staff,33,0,60,27
1714609212568,ECE 111,A01,507420,Staff,15,0,50,35
1714609213599,ECE 197,001,548057,Sievenpiper; Daniel F.,9993,0,9999,6
1714609214629,EDS 115,A00,507243,Choi; Bailey Miyeon,10,0,28,18
1714609215656,EDS 117,A01,494379,Staff,1,5,30,29
1714609216684,EDS 125,A00,507246,Hopkins; Megan Beth,9,0,30,21
1714609217710,EDS 128A,A01,507264,Fargason; Sharon Gayle,8,0,26,18
1714609218735,EDS 128B,A01,507293,Pappas; Elizabeth,12,0,30,18
1714609219765,EDS 139,A00,507294,Fargason; Sharon Gayle,13,0,30,17
1714609219765,EDS 139,B00,507313,Pappas; Elizabeth,13,0,30,17
1714609220789,EDS 201,A00,507315,Staff,13,0,30,17
1714609221818,EDS 203,A01,507317,Halter; Christopher P.,12,0,30,18
1714609222849,EDS 204R,A01,507319,Halter; Christopher P.,0,3,30,30
1714609222849,EDS 204R,B01,507331,Heinzman; Erica M.,16,0,30,14
1714609223874,EDS 206R,A00,507332,Staff,0,4,30,30
1714609223874,EDS 206R,B00,507343,Staff,17,0,30,13
1714609224898,EDS 250,A00,507344,Hemans; Patricia Ann Benitez,22,0,40,18
1714609225927,EDS 281,A00,507345,Daly; Alan J.,18,0,18,0
1714609226953,EDS 284,A00,507350,Daly; Alan J.,16,0,16,0
1714609227983,EDS 286,A00,507359,Fine; Sarah,18,0,18,0
1714609229011,EDS 289C,A01,507361,Daly; Alan J.,18,0,18,0
1714609230036,EDS 290,A00,507366,Hofstetter; Carolyn,15,0,15,0
1714609231067,LIGM 5A,A00,507421,Fischer-Grunski; Eva K,18,0,20,2
1714609232096,LIGM 5B,A00,507423,Fischer-Grunski; Eva K,19,0,20,1
1714609233124,LIGM 5C,A00,507425,Fischer-Grunski; Eva K,19,0,20,1
1714609234149,LIIT 5AS,A00,507427,Carnelos; Chiara,20,0,20,0
1714609235176,LIIT 5BS,A00,507430,Carnelos; Chiara,20,0,20,0
1714609236200,LIIT 5CS,A00,507432,Carnelos; Chiara,20,0,20,0
1714609237227,LISP 5A,A00,507541,Munoz Sanchez; Alicia,11,0,20,9
1714609238256,LISP 5B,A00,507671,Munoz Sanchez; Alicia,8,0,20,12
1714609239284,LISP 5C,A00,507696,Munoz Sanchez; Alicia,9,0,20,11
1714609240313,MAE 197,001,528363,Boechler; Nicholas Sebastia,9998,0,9999,1
1714609241344,MATH 197,001,523477,Kedlaya; Kiran S.,9995,0,9999,4
1714609241344,MATH 197,002,563811,Zhang; Danna,9995,0,9999,4
1714609241344,MATH 197,003,628552,Dumitriu; Ioana,9998,0,9999,1
1714609242367,MCWP 40R,A00,518780,Staff,2,0,20,18
1714609242367,MCWP 40R,B00,518781,Staff,8,0,20,12
1714609242367,MCWP 40R,C00,518783,Staff,6,0,20,14
1714609243397,MCWP 50R,A00,518791,Staff,0,0,20,20
1714609243397,MCWP 50R,B00,518792,Staff,0,2,20,20
1714609243397,MCWP 50R,C00,518793,Staff,0,2,20,20
1714609243397,MCWP 50R,D00,518794,Staff,0,0,20,20
1714609243397,MCWP 50R,E00,518795,Staff,0,2,20,20
1714609243397,MCWP 50R,F00,518796,Staff,0,0,20,20
1714609243397,MCWP 50R,G00,518797,Staff,0,1,20,20
1714609244425,MMW 12R,A01,514034,Herbst; Matthew,0,0,16,16
1714609244425,MMW 12R,A02,514035,Herbst; Matthew,1,0,16,15
1714609245452,MMW 13R,A01,514037,Staff,0,4,16,16
1714609245452,MMW 13R,A02,514039,Staff,0,2,16,16
1714609245452,MMW 13R,A03,628519,Staff,0,2,16,16
1714609247507,SIO 295LS,A00,523233,Staff,10,0,30,20
1714609248533,SIO 295S,A00,523232,Staff,10,0,30,20
1714609249558,SIOC 290S,A01,637330,Merrifield; Mark A,23,0,30,7
1714609250583,SIOC 291S,A01,637333,Gabriel; Corey John,23,0,30,7
1714609251609,SOCI 117,A01,494376,Staff,0,4,5,5
1714609252633,WES 237B,A00,494380,Staff,9,0,20,11
1714609254711,AESE 279B,A00,494370,Wade; Jon P,0,0,33,33
1714609255736,AIP 197,001,627712,Vespa; Emanuel Ignacio,9998,0,9999,1
1714609256762,ANAR 135S,A00,494369,Braswell; Geoffrey E.,0,0,0,0
1714609257787,BENG 196,001,628496,Engler; Adam J.,9998,0,9999,1
1714609258812,CAT 124RS,A01,519847,Geibel; William,0,0,20,20
1714609259837,CAT 125RS,A01,515971,Geibel; William,0,0,20,20
1714609260862,CLRE 250,A00,511389,Morris; Sheldon,9993,0,9999,6
1714609261889,CLRE 251,A00,507176,Mehta; Ravindra L.,9993,0,9999,6
1714609261889,CLRE 251,B00,511410,Mehta; Ravindra L.,9998,0,9999,1
1714609262915,CLRE 252,A00,507189,Cuomo; Raphael Eduardo,9995,0,9999,4
1714609263943,CLRE 253,A00,507199,Vaida; Florin,9994,0,9999,5
1714609263943,CLRE 253,B00,507202,Vaida; Florin,9999,0,9999,0
1714609264968,CLRE 259,A00,507211,Patel; Hemal,9996,0,9999,3
1714609265994,CLRE 260,A00,507221,Cuomo; Raphael Eduardo,9999,0,9999,0
1714609267018,CLRE 297,001,507242,Cuomo; Raphael Eduardo,9999,0,9999,0
1714609268044,COGS 197,001,638244,Voytek; Bradley Thomas,9998,0,9999,1
1714609269069,CSE 191,A00,516875,Minnes Kemp; Mor Mia,9992,0,9999,7
1714609270094,CSE 197,001,637388,Minnes Kemp; Mor Mia,9998,0,9999,1
1714609271123,CSS 201S,A01,494383,Staff,35,0,35,0
1714609272149,CSS 202S,A01,494387,Staff,35,0,35,0
1714609273177,DSC 197,001,628532,Eldridge; Justin Matthew,9996,0,9999,3
1714609274201,EAP 100,A00,516065,Staff,9797,0,9999,202
1714609275226,ECE 45,A01,507414,Staff,33,0,60,27
1714609277279,ECE 111,A01,507420,Staff,15,0,50,35
1714609278304,ECE 197,001,548057,Sievenpiper; Daniel F.,9993,0,9999,6
1714609279329,EDS 115,A00,507243,Choi; Bailey Miyeon,10,0,28,18
1714609280414,EDS 117,A01,494379,Staff,1,5,30,29
1714609281439,EDS 125,A00,507246,Hopkins; Megan Beth,9,0,30,21
1714609282466,EDS 128A,A01,507264,Fargason; Sharon Gayle,8,0,26,18
1714609283490,EDS 128B,A01,507293,Pappas; Elizabeth,12,0,30,18
1714609284515,EDS 139,A00,507294,Fargason; Sharon Gayle,13,0,30,17
1714609284515,EDS 139,B00,507313,Pappas; Elizabeth,13,0,30,17
1714609285540,EDS 201,A00,507315,Staff,13,0,30,17
1714609286564,EDS 203,A01,507317,Halter; Christopher P.,12,0,30,18
1714609287592,EDS 204R,A01,507319,Halter; Christopher P.,0,3,30,30
1714609287592,EDS 204R,B01,507331,Heinzman; Erica M.,16,0,30,14
1714609288617,EDS 206R,A00,507332,Staff,0,4,30,30
1714609288617,EDS 206R,B00,507343,Staff,17,0,30,13
1714609289641,EDS 250,A00,507344,Hemans; Patricia Ann Benitez,22,0,40,18
1714609290664,EDS 281,A00,507345,Daly; Alan J.,18,0,18,0
1714609291689,EDS 284,A00,507350,Daly; Alan J.,16,0,16,0
1714609292718,EDS 286,A00,507359,Fine; Sarah,18,0,18,0
1714609293746,EDS 289C,A01,507361,Daly; Alan J.,18,0,18,0
1714609294773,EDS 290,A00,507366,Hofstetter; Carolyn,15,0,15,0
1714609295801,LIGM 5A,A00,507421,Fischer-Grunski; Eva K,18,0,20,2
1714609296830,LIGM 5B,A00,507423,Fischer-Grunski; Eva K,19,0,20,1
1714609297855,LIGM 5C,A00,507425,Fischer-Grunski; Eva K,19,0,20,1
1714609298884,LIIT 5AS,A00,507427,Carnelos; Chiara,20,0,20,0
1714609299911,LIIT 5BS,A00,507430,Carnelos; Chiara,20,0,20,0
1714609300939,LIIT 5CS,A00,507432,Carnelos; Chiara,20,0,20,0
1714609301968,LISP 5A,A00,507541,Munoz Sanchez; Alicia,11,0,20,9
1714609302997,LISP 5B,A00,507671,Munoz Sanchez; Alicia,8,0,20,12
1714609304026,LISP 5C,A00,507696,Munoz Sanchez; Alicia,9,0,20,11
1714609305051,MAE 197,001,528363,Boechler; Nicholas Sebastia,9998,0,9999,1
1714609306079,MATH 197,001,523477,Kedlaya; Kiran S.,9995,0,9999,4
1714609306079,MATH 197,002,563811,Zhang; Danna,9995,0,9999,4
1714609306079,MATH 197,003,628552,Dumitriu; Ioana,9998,0,9999,1
1714609307106,MCWP 40R,A00,518780,Staff,2,0,20,18
1714609307106,MCWP 40R,B00,518781,Staff,8,0,20,12
1714609307106,MCWP 40R,C00,518783,Staff,6,0,20,14
1714609308133,MCWP 50R,A00,518791,Staff,0,0,20,20
1714609308133,MCWP 50R,B00,518792,Staff,0,2,20,20
1714609308133,MCWP 50R,C00,518793,Staff,0,2,20,20
1714609308133,MCWP 50R,D00,518794,Staff,0,0,20,20
1714609308133,MCWP 50R,E00,518795,Staff,0,2,20,20
1714609308133,MCWP 50R,F00,518796,Staff,0,0,20,20
1714609308133,MCWP 50R,G00,518797,Staff,0,1,20,20
1714609309158,MMW 12R,A01,514034,Herbst; Matthew,0,0,16,16
1714609309158,MMW 12R,A02,514035,Herbst; Matthew,1,0,16,15
1714609310186,MMW 13R,A01,514037,Staff,0,4,16,16
1714609310186,MMW 13R,A02,514039,Staff,0,2,16,16
1714609310186,MMW 13R,A03,628519,Staff,0,2,16,16
1714609312234,SIO 295LS,A00,523233,Staff,10,0,30,20
1714609313262,SIO 295S,A00,523232,Staff,10,0,30,20
1714609314288,SIOC 290S,A01,637330,Merrifield; Mark A,23,0,30,7
1714609315324,SIOC 291S,A01,637333,Gabriel; Corey John,23,0,30,7
1714609316350,SOCI 117,A01,494376,Staff,0,4,5,5
1714609317376,WES 237B,A00,494380,Staff,9,0,20,11
1714609319459,AESE 279B,A00,494370,Wade; Jon P,0,0,33,33
1714609320485,AIP 197,001,627712,Vespa; Emanuel Ignacio,9998,0,9999,1
1714609321513,ANAR 135S,A00,494369,Braswell; Geoffrey E.,0,0,0,0
1714609322538,BENG 196,001,628496,Engler; Adam J.,9998,0,9999,1
1714609323569,CAT 124RS,A01,519847,Geibel; William,0,0,20,20
1714609324597,CAT 125RS,A01,515971,Geibel; William,0,0,20,20
1714609325628,CLRE 250,A00,511389,Morris; Sheldon,9993,0,9999,6
1714609326710,CLRE 251,A00,507176,Mehta; Ravindra L.,9993,0,9999,6
1714609326710,CLRE 251,B00,511410,Mehta; Ravindra L.,9998,0,9999,1
1714609327740,CLRE 252,A00,507189,Cuomo; Raphael Eduardo,9995,0,9999,4
1714609328770,CLRE 253,A00,507199,Vaida; Florin,9994,0,9999,5
1714609328770,CLRE 253,B00,507202,Vaida; Florin,9999,0,9999,0
1714609329797,CLRE 259,A00,507211,Patel; Hemal,9996,0,9999,3
1714609330825,CLRE 260,A00,507221,Cuomo; Raphael Eduardo,9999,0,9999,0
1714609331851,CLRE 297,001,507242,Cuomo; Raphael Eduardo,9999,0,9999,0
1714609332879,COGS 197,001,638244,Voytek; Bradley Thomas,9998,0,9999,1
1714609333904,CSE 191,A00,516875,Minnes Kemp; Mor Mia,9992,0,9999,7
1714609334930,CSE 197,001,637388,Minnes Kemp; Mor Mia,9998,0,9999,1
1714609335956,CSS 201S,A01,494383,Staff,35,0,35,0
1714609336985,CSS 202S,A01,494387,Staff,35,0,35,0
1714609338011,DSC 197,001,628532,Eldridge; Justin Matthew,9996,0,9999,3
1714609339038,EAP 100,A00,516065,Staff,9797,0,9999,202
1714609340068,ECE 45,A01,507414,Staff,33,0,60,27
1714609342118,ECE 111,A01,507420,Staff,15,0,50,35
1714609343143,ECE 197,001,548057,Sievenpiper; Daniel F.,9993,0,9999,6
1714609344170,EDS 115,A00,507243,Choi; Bailey Miyeon,10,0,28,18
1714609345199,EDS 117,A01,494379,Staff,1,5,30,29
1714609346223,EDS 125,A00,507246,Hopkins; Megan Beth,9,0,30,21
1714609347251,EDS 128A,A01,507264,Fargason; Sharon Gayle,8,0,26,18
1714609348277,EDS 128B,A01,507293,Pappas; Elizabeth,12,0,30,18
1714609349306,EDS 139,A00,507294,Fargason; Sharon Gayle,13,0,30,17
1714609349306,EDS 139,B00,507313,Pappas; Elizabeth,13,0,30,17
1714609350331,EDS 201,A00,507315,Staff,13,0,30,17
1714609351356,EDS 203,A01,507317,Halter; Christopher P.,12,0,30,18
1714609352382,EDS 204R,A01,507319,Halter; Christopher P.,0,3,30,30
1714609352382,EDS 204R,B01,507331,Heinzman; Erica M.,16,0,30,14
1714609353408,EDS 206R,A00,507332,Staff,0,4,30,30
1714609353408,EDS 206R,B00,507343,Staff,17,0,30,13
1714609354435,EDS 250,A00,507344,Hemans; Patricia Ann Benitez,22,0,40,18
1714609355459,EDS 281,A00,507345,Daly; Alan J.,18,0,18,0
1714609356484,EDS 284,A00,507350,Daly; Alan J.,16,0,16,0
1714609357511,EDS 286,A00,507359,Fine; Sarah,18,0,18,0
1714609358538,EDS 289C,A01,507361,Daly; Alan J.,18,0,18,0
1714609359562,EDS 290,A00,507366,Hofstetter; Carolyn,15,0,15,0
1714609360596,LIGM 5A,A00,507421,Fischer-Grunski; Eva K,18,0,20,2
1714609361624,LIGM 5B,A00,507423,Fischer-Grunski; Eva K,19,0,20,1
1714609362653,LIGM 5C,A00,507425,Fischer-Grunski; Eva K,19,0,20,1
1714609363681,LIIT 5AS,A00,507427,Carnelos; Chiara,20,0,20,0
1714609364710,LIIT 5BS,A00,507430,Carnelos; Chiara,20,0,20,0
1714609365734,LIIT 5CS,A00,507432,Carnelos; Chiara,20,0,20,0
1714609366761,LISP 5A,A00,507541,Munoz Sanchez; Alicia,11,0,20,9
1714609367788,LISP 5B,A00,507671,Munoz Sanchez; Alicia,8,0,20,12
1714609368815,LISP 5C,A00,507696,Munoz Sanchez; Alicia,9,0,20,11
1714609369843,MAE 197,001,528363,Boechler; Nicholas Sebastia,9998,0,9999,1
1714609370876,MATH 197,001,523477,Kedlaya; Kiran S.,9995,0,9999,4
1714609370876,MATH 197,002,563811,Zhang; Danna,9995,0,9999,4
1714609370876,MATH 197,003,628552,Dumitriu; Ioana,9998,0,9999,1
1714609371905,MCWP 40R,A00,518780,Staff,2,0,20,18
1714609371905,MCWP 40R,B00,518781,Staff,8,0,20,12
1714609371905,MCWP 40R,C00,518783,Staff,6,0,20,14
1714609372934,MCWP 50R,A00,518791,Staff,0,0,20,20
1714609372934,MCWP 50R,B00,518792,Staff,0,2,20,20
1714609372934,MCWP 50R,C00,518793,Staff,0,2,20,20
1714609372934,MCWP 50R,D00,518794,Staff,0,0,20,20
1714609372934,MCWP 50R,E00,518795,Staff,0,2,20,20
1714609372934,MCWP 50R,F00,518796,Staff,0,0,20,20
1714609372934,MCWP 50R,G00,518797,Staff,0,1,20,20
1714609373959,MMW 12R,A01,514034,Herbst; Matthew,0,0,16,16
1714609373959,MMW 12R,A02,514035,Herbst; Matthew,1,0,16,15
1714609374985,MMW 13R,A01,514037,Staff,0,4,16,16
1714609374985,MMW 13R,A02,514039,Staff,0,2,16,16
1714609374985,MMW 13R,A03,628519,Staff,0,2,16,16
1714609377033,SIO 295LS,A00,523233,Staff,10,0,30,20
1714609378057,SIO 295S,A00,523232,Staff,10,0,30,20
1714609379088,SIOC 290S,A01,637330,Merrifield; Mark A,23,0,30,7
1714609380115,SIOC 291S,A01,637333,Gabriel; Corey John,23,0,30,7
1714609381143,SOCI 117,A01,494376,Staff,0,4,5,5
1714609382169,WES 237B,A00,494380,Staff,9,0,20,11
1714609384239,AESE 279B,A00,494370,Wade; Jon P,0,0,33,33
1714609385267,AIP 197,001,627712,Vespa; Emanuel Ignacio,9998,0,9999,1
1714609386291,ANAR 135S,A00,494369,Braswell; Geoffrey E.,0,0,0,0
1714609387316,BENG 196,001,628496,Engler; Adam J.,9998,0,9999,1
1714609388345,CAT 124RS,A01,519847,Geibel; William,0,0,20,20
1714609389370,CAT 125RS,A01,515971,Geibel; William,0,0,20,20
1714609390397,CLRE 250,A00,511389,Morris; Sheldon,9993,0,9999,6
1714609391424,CLRE 251,A00,507176,Mehta; Ravindra L.,9993,0,9999,6
1714609391424,CLRE 251,B00,511410,Mehta; Ravindra L.,9998,0,9999,1
1714609392454,CLRE 252,A00,507189,Cuomo; Raphael Eduardo,9995,0,9999,4
1714609393480,CLRE 253,A00,507199,Vaida; Florin,9994,0,9999,5
1714609393480,CLRE 253,B00,507202,Vaida; Florin,9999,0,9999,0
1714609394506,CLRE 259,A00,507211,Patel; Hemal,9996,0,9999,3
1714609395531,CLRE 260,A00,507221,Cuomo; Raphael Eduardo,9999,0,9999,0
1714609396555,CLRE 297,001,507242,Cuomo; Raphael Eduardo,9999,0,9999,0
1714609397578,COGS 197,001,638244,Voytek; Bradley Thomas,9998,0,9999,1
1714609398602,CSE 191,A00,516875,Minnes Kemp; Mor Mia,9992,0,9999,7
1714609399625,CSE 197,001,637388,Minnes Kemp; Mor Mia,9998,0,9999,1
1714609400649,CSS 201S,A01,494383,Staff,35,0,35,0
1714609401677,CSS 202S,A01,494387,Staff,35,0,35,0
1714609402704,DSC 197,001,628532,Eldridge; Justin Matthew,9996,0,9999,3
1714609403728,EAP 100,A00,516065,Staff,9797,0,9999,202
1714609404755,ECE 45,A01,507414,Staff,33,0,60,27
1714609406809,ECE 111,A01,507420,Staff,15,0,50,35
1714609407837,ECE 197,001,548057,Sievenpiper; Daniel F.,9993,0,9999,6
1714609408868,EDS 115,A00,507243,Choi; Bailey Miyeon,10,0,28,18
1714609409892,EDS 117,A01,494379,Staff,1,5,30,29
1714609410923,EDS 125,A00,507246,Hopkins; Megan Beth,9,0,30,21
1714609411951,EDS 128A,A01,507264,Fargason; Sharon Gayle,8,0,26,18
1714609412981,EDS 128B,A01,507293,Pappas; Elizabeth,12,0,30,18
1714609414008,EDS 139,A00,507294,Fargason; Sharon Gayle,13,0,30,17
1714609414008,EDS 139,B00,507313,Pappas; Elizabeth,13,0,30,17
1714609415034,EDS 201,A00,507315,Staff,13,0,30,17
1714609416060,EDS 203,A01,507317,Halter; Christopher P.,12,0,30,18
1714609417087,EDS 204R,A01,507319,Halter; Christopher P.,0,3,30,30
1714609417087,EDS 204R,B01,507331,Heinzman; Erica M.,16,0,30,14
1714609418113,EDS 206R,A00,507332,Staff,0,4,30,30
1714609418113,EDS 206R,B00,507343,Staff,17,0,30,13
1714609419143,EDS 250,A00,507344,Hemans; Patricia Ann Benitez,22,0,40,18
1714609420169,EDS 281,A00,507345,Daly; Alan J.,18,0,18,0
1714609421196,EDS 284,A00,507350,Daly; Alan J.,16,0,16,0
1714609422224,EDS 286,A00,507359,Fine; Sarah,18,0,18,0
1714609423252,EDS 289C,A01,507361,Daly; Alan J.,18,0,18,0
1714609424277,EDS 290,A00,507366,Hofstetter; Carolyn,15,0,15,0
1714609425303,LIGM 5A,A00,507421,Fischer-Grunski; Eva K,18,0,20,2
1714609426328,LIGM 5B,A00,507423,Fischer-Grunski; Eva K,19,0,20,1
1714609427357,LIGM 5C,A00,507425,Fischer-Grunski; Eva K,19,0,20,1
1714609428386,LIIT 5AS,A00,507427,Carnelos; Chiara,20,0,20,0
1714609429410,LIIT 5BS,A00,507430,Carnelos; Chiara,20,0,20,0
1714609430434,LIIT 5CS,A00,507432,Carnelos; Chiara,20,0,20,0
1714609431463,LISP 5A,A00,507541,Munoz Sanchez; Alicia,11,0,20,9
1714609432490,LISP 5B,A00,507671,Munoz Sanchez; Alicia,8,0,20,12
1714609433518,LISP 5C,A00,507696,Munoz Sanchez; Alicia,9,0,20,11
1714609434543,MAE 197,001,528363,Boechler; Nicholas Sebastia,9998,0,9999,1
1714609435572,MATH 197,001,523477,Kedlaya; Kiran S.,9995,0,9999,4
1714609435572,MATH 197,002,563811,Zhang; Danna,9995,0,9999,4
1714609435572,MATH 197,003,628552,Dumitriu; Ioana,9998,0,9999,1
1714609436597,MCWP 40R,A00,518780,Staff,2,0,20,18
1714609436597,MCWP 40R,B00,518781,Staff,8,0,20,12
1714609436597,MCWP 40R,C00,518783,Staff,6,0,20,14
1714609437627,MCWP 50R,A00,518791,Staff,0,0,20,20
1714609437627,MCWP 50R,B00,518792,Staff,0,2,20,20
1714609437627,MCWP 50R,C00,518793,Staff,0,2,20,20
1714609437627,MCWP 50R,D00,518794,Staff,0,0,20,20
1714609437627,MCWP 50R,E00,518795,Staff,0,2,20,20
1714609437627,MCWP 50R,F00,518796,Staff,0,0,20,20
1714609437627,MCWP 50R,G00,518797,Staff,0,1,20,20
1714609438652,MMW 12R,A01,514034,Herbst; Matthew,0,0,16,16
1714609438652,MMW 12R,A02,514035,Herbst; Matthew,1,0,16,15
1714609439676,MMW 13R,A01,514037,Staff,0,4,16,16
1714609439676,MMW 13R,A02,514039,Staff,0,2,16,16
1714609439676,MMW 13R,A03,628519,Staff,0,2,16,16
1714609441726,SIO 295LS,A00,523233,Staff,10,0,30,20
1714609442756,SIO 295S,A00,523232,Staff,10,0,30,20
1714609443786,SIOC 290S,A01,637330,Merrifield; Mark A,23,0,30,7
1714609444816,SIOC 291S,A01,637333,Gabriel; Corey John,23,0,30,7
1714609445842,SOCI 117,A01,494376,Staff,0,4,5,5
1714609446868,WES 237B,A00,494380,Staff,9,0,20,11
1714609448949,AESE 279B,A00,494370,Wade; Jon P,0,0,33,33
1714609449976,AIP 197,001,627712,Vespa; Emanuel Ignacio,9998,0,9999,1
1714609451001,ANAR 135S,A00,494369,Braswell; Geoffrey E.,0,0,0,0
1714609452028,BENG 196,001,628496,Engler; Adam J.,9998,0,9999,1
1714609453053,CAT 124RS,A01,519847,Geibel; William,0,0,20,20
1714609454077,CAT 125RS,A01,515971,Geibel; William,0,0,20,20
1714609455104,CLRE 250,A00,511389,Morris; Sheldon,9993,0,9999,6
1714609456132,CLRE 251,A00,507176,Mehta; Ravindra L.,9993,0,9999,6
1714609456132,CLRE 251,B00,511410,Mehta; Ravindra L.,9998,0,9999,1
1714609457160,CLRE 252,A00,507189,Cuomo; Raphael Eduardo,9995,0,9999,4
1714609458187,CLRE 253,A00,507199,Vaida; Florin,9994,0,9999,5
1714609458187,CLRE 253,B00,507202,Vaida; Florin,9999,0,9999,0
1714609459211,CLRE 259,A00,507211,Patel; Hemal,9996,0,9999,3
1714609460238,CLRE 260,A00,507221,Cuomo; Raphael Eduardo,9999,0,9999,0
1714609461263,CLRE 297,001,507242,Cuomo; Raphael Eduardo,9999,0,9999,0
1714609462289,COGS 197,001,638244,Voytek; Bradley Thomas,9998,0,9999,1
1714609463313,CSE 191,A00,516875,Minnes Kemp; Mor Mia,9992,0,9999,7
1714609464338,CSE 197,001,637388,Minnes Kemp; Mor Mia,9998,0,9999,1
1714609465368,CSS 201S,A01,494383,Staff,35,0,35,0
1714609466397,CSS 202S,A01,494387,Staff,35,0,35,0
1714609467421,DSC 197,001,628532,Eldridge; Justin Matthew,9996,0,9999,3
1714609468446,EAP 100,A00,516065,Staff,9797,0,9999,202
1714609469475,ECE 45,A01,507414,Staff,33,0,60,27
1714609471527,ECE 111,A01,507420,Staff,15,0,50,35
1714609472553,ECE 197,001,548057,Sievenpiper; Daniel F.,9993,0,9999,6
1714609473583,EDS 115,A00,507243,Choi; Bailey Miyeon,10,0,28,18
1714609474608,EDS 117,A01,494379,Staff,1,5,30,29
1714609475636,EDS 125,A00,507246,Hopkins; Megan Beth,9,0,30,21
1714609476665,EDS 128A,A01,507264,Fargason; Sharon Gayle,8,0,26,18
1714609477690,EDS 128B,A01,507293,Pappas; Elizabeth,12,0,30,18
1714609478720,EDS 139,A00,507294,Fargason; Sharon Gayle,13,0,30,17
1714609478720,EDS 139,B00,507313,Pappas; Elizabeth,13,0,30,17
1714609479745,EDS 201,A00,507315,Staff,13,0,30,17
1714609480774,EDS 203,A01,507317,Halter; Christopher P.,12,0,30,18
1714609481802,EDS 204R,A01,507319,Halter; Christopher P.,0,3,30,30
1714609481802,EDS 204R,B01,507331,Heinzman; Erica M.,16,0,30,14
1714609482827,EDS 206R,A00,507332,Staff,0,4,30,30
1714609482827,EDS 206R,B00,507343,Staff,17,0,30,13
1714609483866,EDS 250,A00,507344,Hemans; Patricia Ann Benitez,22,0,40,18
1714609484894,EDS 281,A00,507345,Daly; Alan J.,18,0,18,0
1714609485922,EDS 284,A00,507350,Daly; Alan J.,16,0,16,0
1714609486948,EDS 286,A00,507359,Fine; Sarah,18,0,18,0
1714609487983,EDS 289C,A01,507361,Daly; Alan J.,18,0,18,0
1714609489009,EDS 290,A00,507366,Hofstetter; Carolyn,15,0,15,0
1714609490040,LIGM 5A,A00,507421,Fischer-Grunski; Eva K,18,0,20,2
1714609491065,LIGM 5B,A00,507423,Fischer-Grunski; Eva K,19,0,20,1
1714609492091,LIGM 5C,A00,507425,Fischer-Grunski; Eva K,19,0,20,1
1714609493116,LIIT 5AS,A00,507427,Carnelos; Chiara,20,0,20,0
1714609494141,LIIT 5BS,A00,507430,Carnelos; Chiara,20,0,20,0
1714609495165,LIIT 5CS,A00,507432,Carnelos; Chiara,20,0,20,0
1714609496193,LISP 5A,A00,507541,Munoz Sanchez; Alicia,11,0,20,9
1714609497219,LISP 5B,A00,507671,Munoz Sanchez; Alicia,8,0,20,12
1714609498245,LISP 5C,A00,507696,Munoz Sanchez; Alicia,9,0,20,11
1714609499269,MAE 197,001,528363,Boechler; Nicholas Sebastia,9998,0,9999,1
1714609500296,MATH 197,001,523477,Kedlaya; Kiran S.,9995,0,9999,4
1714609500296,MATH 197,002,563811,Zhang; Danna,9995,0,9999,4
1714609500296,MATH 197,003,628552,Dumitriu; Ioana,9998,0,9999,1
1714609501323,MCWP 40R,A00,518780,Staff,2,0,20,18
1714609501323,MCWP 40R,B00,518781,Staff,8,0,20,12
1714609501323,MCWP 40R,C00,518783,Staff,6,0,20,14
1714609502354,MCWP 50R,A00,518791,Staff,0,0,20,20
1714609502354,MCWP 50R,B00,518792,Staff,0,2,20,20
1714609502354,MCWP 50R,C00,518793,Staff,0,2,20,20
1714609502354,MCWP 50R,D00,518794,Staff,0,0,20,20
1714609502354,MCWP 50R,E00,518795,Staff,0,2,20,20
1714609502354,MCWP 50R,F00,518796,Staff,0,0,20,20
1714609502354,MCWP 50R,G00,518797,Staff,0,1,20,20
1714609503383,MMW 12R,A01,514034,Herbst; Matthew,0,0,16,16
1714609503383,MMW 12R,A02,514035,Herbst; Matthew,1,0,16,15
1714609504407,MMW 13R,A01,514037,Staff,0,4,16,16
1714609504407,MMW 13R,A02,514039,Staff,0,2,16,16
1714609504407,MMW 13R,A03,628519,Staff,0,2,16,16
1714609506459,SIO 295LS,A00,523233,Staff,10,0,30,20
1714609507484,SIO 295S,A00,523232,Staff,10,0,30,20
1714609508514,SIOC 290S,A01,637330,Merrifield; Mark A,23,0,30,7
1714609509541,SIOC 291S,A01,637333,Gabriel; Corey John,23,0,30,7
1714609510568,SOCI 117,A01,494376,Staff,0,4,5,5
1714609511592,WES 237B,A00,494380,Staff,9,0,20,11
1714609513661,AESE 279B,A00,494370,Wade; Jon P,0,0,33,33
1714609514687,AIP 197,001,627712,Vespa; Emanuel Ignacio,9998,0,9999,1
1714609515713,ANAR 135S,A00,494369,Braswell; Geoffrey E.,0,0,0,0
1714609516739,BENG 196,001,628496,Engler; Adam J.,9998,0,9999,1
1714609517765,CAT 124RS,A01,519847,Geibel; William,0,0,20,20
1714609518790,CAT 125RS,A01,515971,Geibel; William,0,0,20,20
1714609519819,CLRE 250,A00,511389,Morris; Sheldon,9993,0,9999,6
1714609520849,CLRE 251,A00,507176,Mehta; Ravindra L.,9993,0,9999,6
1714609520849,CLRE 251,B00,511410,Mehta; Ravindra L.,9998,0,9999,1
1714609521874,CLRE 252,A00,507189,Cuomo; Raphael Eduardo,9995,0,9999,4
1714609522901,CLRE 253,A00,507199,Vaida; Florin,9994,0,9999,5
1714609522901,CLRE 253,B00,507202,Vaida; Florin,9999,0,9999,0
1714609523926,CLRE 259,A00,507211,Patel; Hemal,9996,0,9999,3
1714609524952,CLRE 260,A00,507221,Cuomo; Raphael Eduardo,9999,0,9999,0
1714609525979,CLRE 297,001,507242,Cuomo; Raphael Eduardo,9999,0,9999,0
1714609527003,COGS 197,001,638244,Voytek; Bradley Thomas,9998,0,9999,1
1714609528032,CSE 191,A00,516875,Minnes Kemp; Mor Mia,9992,0,9999,7
1714609529056,CSE 197,001,637388,Minnes Kemp; Mor Mia,9998,0,9999,1
1714609530082,CSS 201S,A01,494383,Staff,35,0,35,0
1714609531107,CSS 202S,A01,494387,Staff,35,0,35,0
1714609532133,DSC 197,001,628532,Eldridge; Justin Matthew,9996,0,9999,3
1714609533158,EAP 100,A00,516065,Staff,9797,0,9999,202
1714609534186,ECE 45,A01,507414,Staff,33,0,60,27
1714609536241,ECE 111,A01,507420,Staff,15,0,50,35
1714609537267,ECE 197,001,548057,Sievenpiper; Daniel F.,9993,0,9999,6
1714609538293,EDS 115,A00,507243,Choi; Bailey Miyeon,10,0,28,18
1714609539319,EDS 117,A01,494379,Staff,1,5,30,29
1714609540344,EDS 125,A00,507246,Hopkins; Megan Beth,9,0,30,21
1714609541373,EDS 128A,A01,507264,Fargason; Sharon Gayle,8,0,26,18
1714609542399,EDS 128B,A01,507293,Pappas; Elizabeth,12,0,30,18
1714609543424,EDS 139,A00,507294,Fargason; Sharon Gayle,13,0,30,17
1714609543424,EDS 139,B00,507313,Pappas; Elizabeth,13,0,30,17
1714609544450,EDS 201,A00,507315,Staff,13,0,30,17
1714609545477,EDS 203,A01,507317,Halter; Christopher P.,12,0,30,18
1714609546503,EDS 204R,A01,507319,Halter; Christopher P.,0,3,30,30
1714609546503,EDS 204R,B01,507331,Heinzman; Erica M.,16,0,30,14
1714609547528,EDS 206R,A00,507332,Staff,0,4,30,30
1714609547528,EDS 206R,B00,507343,Staff,17,0,30,13
1714609548556,EDS 250,A00,507344,Hemans; Patricia Ann Benitez,22,0,40,18
1714609549587,EDS 281,A00,507345,Daly; Alan J.,18,0,18,0
1714609550611,EDS 284,A00,507350,Daly; Alan J.,16,0,16,0
1714609551637,EDS 286,A00,507359,Fine; Sarah,18,0,18,0
1714609552665,EDS 289C,A01,507361,Daly; Alan J.,18,0,18,0
1714609553691,EDS 290,A00,507366,Hofstetter; Carolyn,15,0,15,0
1714609554720,LIGM 5A,A00,507421,Fischer-Grunski; Eva K,18,0,20,2
1714609555744,LIGM 5B,A00,507423,Fischer-Grunski; Eva K,19,0,20,1
1714609556774,LIGM 5C,A00,507425,Fischer-Grunski; Eva K,19,0,20,1
1714609557802,LIIT 5AS,A00,507427,Carnelos; Chiara,20,0,20,0
1714609558827,LIIT 5BS,A00,507430,Carnelos; Chiara,20,0,20,0
1714609559855,LIIT 5CS,A00,507432,Carnelos; Chiara,20,0,20,0
1714609560886,LISP 5A,A00,507541,Munoz Sanchez; Alicia,11,0,20,9
1714609561911,LISP 5B,A00,507671,Munoz Sanchez; Alicia,8,0,20,12
1714609562939,LISP 5C,A00,507696,Munoz Sanchez; Alicia,9,0,20,11
1714609563968,MAE 197,001,528363,Boechler; Nicholas Sebastia,9998,0,9999,1
1714609564994,MATH 197,001,523477,Kedlaya; Kiran S.,9995,0,9999,4
1714609564994,MATH 197,002,563811,Zhang; Danna,9995,0,9999,4
1714609564994,MATH 197,003,628552,Dumitriu; Ioana,9998,0,9999,1
1714609566022,MCWP 40R,A00,518780,Staff,2,0,20,18
1714609566022,MCWP 40R,B00,518781,Staff,8,0,20,12
1714609566022,MCWP 40R,C00,518783,Staff,6,0,20,14
1714609567049,MCWP 50R,A00,518791,Staff,0,0,20,20
1714609567049,MCWP 50R,B00,518792,Staff,0,2,20,20
1714609567049,MCWP 50R,C00,518793,Staff,0,2,20,20
1714609567049,MCWP 50R,D00,518794,Staff,0,0,20,20
1714609567049,MCWP 50R,E00,518795,Staff,0,2,20,20
1714609567049,MCWP 50R,F00,518796,Staff,0,0,20,20
1714609567049,MCWP 50R,G00,518797,Staff,0,1,20,20
1714609568076,MMW 12R,A01,514034,Herbst; Matthew,0,0,16,16
1714609568076,MMW 12R,A02,514035,Herbst; Matthew,1,0,16,15
1714609569102,MMW 13R,A01,514037,Staff,0,4,16,16
1714609569102,MMW 13R,A02,514039,Staff,0,2,16,16
1714609569102,MMW 13R,A03,628519,Staff,0,2,16,16
1714609571157,SIO 295LS,A00,523233,Staff,10,0,30,20
1714609572181,SIO 295S,A00,523232,Staff,10,0,30,20
1714609573207,SIOC 290S,A01,637330,Merrifield; Mark A,23,0,30,7
1714609574236,SIOC 291S,A01,637333,Gabriel; Corey John,23,0,30,7
1714609575263,SOCI 117,A01,494376,Staff,0,4,5,5
1714609576291,WES 237B,A00,494380,Staff,9,0,20,11
1714609578361,AESE 279B,A00,494370,Wade; Jon P,0,0,33,33
1714609579388,AIP 197,001,627712,Vespa; Emanuel Ignacio,9998,0,9999,1
1714609580416,ANAR 135S,A00,494369,Braswell; Geoffrey E.,0,0,0,0
1714609581442,BENG 196,001,628496,Engler; Adam J.,9998,0,9999,1
1714609582469,CAT 124RS,A01,519847,Geibel; William,0,0,20,20
1714609583497,CAT 125RS,A01,515971,Geibel; William,0,0,20,20
1714609584523,CLRE 250,A00,511389,Morris; Sheldon,9993,0,9999,6
1714609585554,CLRE 251,A00,507176,Mehta; Ravindra L.,9993,0,9999,6
1714609585554,CLRE 251,B00,511410,Mehta; Ravindra L.,9998,0,9999,1
1714609586580,CLRE 252,A00,507189,Cuomo; Raphael Eduardo,9995,0,9999,4
1714609587608,CLRE 253,A00,507199,Vaida; Florin,9994,0,9999,5
1714609587608,CLRE 253,B00,507202,Vaida; Florin,9999,0,9999,0
1714609588635,CLRE 259,A00,507211,Patel; Hemal,9996,0,9999,3
1714609589660,CLRE 260,A00,507221,Cuomo; Raphael Eduardo,9999,0,9999,0
1714609590685,CLRE 297,001,507242,Cuomo; Raphael Eduardo,9999,0,9999,0
1714609591712,COGS 197,001,638244,Voytek; Bradley Thomas,9998,0,9999,1
1714609592738,CSE 191,A00,516875,Minnes Kemp; Mor Mia,9992,0,9999,7
1714609593762,CSE 197,001,637388,Minnes Kemp; Mor Mia,9998,0,9999,1
1714609594790,CSS 201S,A01,494383,Staff,35,0,35,0
1714609595819,CSS 202S,A01,494387,Staff,35,0,35,0
1714609596846,DSC 197,001,628532,Eldridge; Justin Matthew,9996,0,9999,3
1714609597869,EAP 100,A00,516065,Staff,9797,0,9999,202
1714609598895,ECE 45,A01,507414,Staff,33,0,60,27
1714609600950,ECE 111,A01,507420,Staff,15,0,50,35
1714609601977,ECE 197,001,548057,Sievenpiper; Daniel F.,9993,0,9999,6
1714609603001,EDS 115,A00,507243,Choi; Bailey Miyeon,10,0,28,18
1714609604028,EDS 117,A01,494379,Staff,1,5,30,29
1714609605060,EDS 125,A00,507246,Hopkins; Megan Beth,9,0,30,21
1714609606089,EDS 128A,A01,507264,Fargason; Sharon Gayle,8,0,26,18
1714609607114,EDS 128B,A01,507293,Pappas; Elizabeth,12,0,30,18
1714609608140,EDS 139,A00,507294,Fargason; Sharon Gayle,13,0,30,17
1714609608140,EDS 139,B00,507313,Pappas; Elizabeth,13,0,30,17
1714609609168,EDS 201,A00,507315,Staff,13,0,30,17
1714609610198,EDS 203,A01,507317,Halter; Christopher P.,12,0,30,18
1714609611227,EDS 204R,A01,507319,Halter; Christopher P.,0,3,30,30
1714609611227,EDS 204R,B01,507331,Heinzman; Erica M.,16,0,30,14
1714609612256,EDS 206R,A00,507332,Staff,0,4,30,30
1714609612256,EDS 206R,B00,507343,Staff,17,0,30,13
1714609613285,EDS 250,A00,507344,Hemans; Patricia Ann Benitez,22,0,40,18
1714609614312,EDS 281,A00,507345,Daly; Alan J.,18,0,18,0
1714609615339,EDS 284,A00,507350,Daly; Alan J.,16,0,16,0
1714609616367,EDS 286,A00,507359,Fine; Sarah,18,0,18,0
1714609617394,EDS 289C,A01,507361,Daly; Alan J.,18,0,18,0
1714609618421,EDS 290,A00,507366,Hofstetter; Carolyn,15,0,15,0
1714609619448,LIGM 5A,A00,507421,Fischer-Grunski; Eva K,18,0,20,2
1714609620474,LIGM 5B,A00,507423,Fischer-Grunski; Eva K,19,0,20,1
1714609621503,LIGM 5C,A00,507425,Fischer-Grunski; Eva K,19,0,20,1
1714609622529,LIIT 5AS,A00,507427,Carnelos; Chiara,20,0,20,0
1714609623558,LIIT 5BS,A00,507430,Carnelos; Chiara,20,0,20,0
1714609624588,LIIT 5CS,A00,507432,Carnelos; Chiara,20,0,20,0
1714609625618,LISP 5A,A00,507541,Munoz Sanchez; Alicia,11,0,20,9
1714609626643,LISP 5B,A00,507671,Munoz Sanchez; Alicia,8,0,20,12
1714609627667,LISP 5C,A00,507696,Munoz Sanchez; Alicia,9,0,20,11
1714609628691,MAE 197,001,528363,Boechler; Nicholas Sebastia,9998,0,9999,1
1714609629718,MATH 197,001,523477,Kedlaya; Kiran S.,9995,0,9999,4
1714609629718,MATH 197,002,563811,Zhang; Danna,9995,0,9999,4
1714609629718,MATH 197,003,628552,Dumitriu; Ioana,9998,0,9999,1
1714609630744,MCWP 40R,A00,518780,Staff,2,0,20,18
1714609630744,MCWP 40R,B00,518781,Staff,8,0,20,12
1714609630744,MCWP 40R,C00,518783,Staff,6,0,20,14
1714609631770,MCWP 50R,A00,518791,Staff,0,0,20,20
1714609631770,MCWP 50R,B00,518792,Staff,0,2,20,20
1714609631770,MCWP 50R,C00,518793,Staff,0,2,20,20
1714609631770,MCWP 50R,D00,518794,Staff,0,0,20,20
1714609631770,MCWP 50R,E00,518795,Staff,0,2,20,20
1714609631770,MCWP 50R,F00,518796,Staff,0,0,20,20
1714609631770,MCWP 50R,G00,518797,Staff,0,1,20,20
1714609632795,MMW 12R,A01,514034,Herbst; Matthew,0,0,16,16
1714609632795,MMW 12R,A02,514035,Herbst; Matthew,1,0,16,15
1714609633822,MMW 13R,A01,514037,Staff,0,4,16,16
1714609633822,MMW 13R,A02,514039,Staff,0,2,16,16
1714609633822,MMW 13R,A03,628519,Staff,0,2,16,16
1714609635872,SIO 295LS,A00,523233,Staff,10,0,30,20
1714609636896,SIO 295S,A00,523232,Staff,10,0,30,20
1714609637923,SIOC 290S,A01,637330,Merrifield; Mark A,23,0,30,7
1714609638950,SIOC 291S,A01,637333,Gabriel; Corey John,23,0,30,7
1714609639981,SOCI 117,A01,494376,Staff,0,4,5,5
1714609641010,WES 237B,A00,494380,Staff,9,0,20,11
1714609653235,AESE 279B,A00,494370,Wade; Jon P,0,0,33,33
1714609654262,AIP 197,001,627712,Vespa; Emanuel Ignacio,9998,0,9999,1
1714609655286,ANAR 135S,A00,494369,Braswell; Geoffrey E.,0,0,0,0
1714609656314,BENG 196,001,628496,Engler; Adam J.,9998,0,9999,1
1714609657343,CAT 124RS,A01,519847,Geibel; William,0,0,20,20
1714609658369,CAT 125RS,A01,515971,Geibel; William,0,0,20,20
1714609659398,CLRE 250,A00,511389,Morris; Sheldon,9993,0,9999,6
1714609660432,CLRE 251,A00,507176,Mehta; Ravindra L.,9993,0,9999,6
1714609660432,CLRE 251,B00,511410,Mehta; Ravindra L.,9998,0,9999,1
1714609661461,CLRE 252,A00,507189,Cuomo; Raphael Eduardo,9995,0,9999,4
1714609662486,CLRE 253,A00,507199,Vaida; Florin,9994,0,9999,5
1714609662486,CLRE 253,B00,507202,Vaida; Florin,9999,0,9999,0
1714609663511,CLRE 259,A00,507211,Patel; Hemal,9996,0,9999,3
1714609664535,CLRE 260,A00,507221,Cuomo; Raphael Eduardo,9999,0,9999,0
1714609665558,CLRE 297,001,507242,Cuomo; Raphael Eduardo,9999,0,9999,0
1714609666582,COGS 197,001,638244,Voytek; Bradley Thomas,9998,0,9999,1
1714609667606,CSE 191,A00,516875,Minnes Kemp; Mor Mia,9992,0,9999,7
1714609668632,CSE 197,001,637388,Minnes Kemp; Mor Mia,9998,0,9999,1
1714609669663,CSS 201S,A01,494383,Staff,35,0,35,0
1714609670689,CSS 202S,A01,494387,Staff,35,0,35,0
1714609671736,DSC 197,001,628532,Eldridge; Justin Matthew,9996,0,9999,3
1714609672760,EAP 100,A00,516065,Staff,9797,0,9999,202
1714609673789,ECE 45,A01,507414,Staff,33,0,60,27
1714609675838,ECE 111,A01,507420,Staff,15,0,50,35
1714609676865,ECE 197,001,548057,Sievenpiper; Daniel F.,9993,0,9999,6
1714609677891,EDS 115,A00,507243,Choi; Bailey Miyeon,10,0,28,18
1714609678915,EDS 117,A01,494379,Staff,1,5,30,29
1714609679943,EDS 125,A00,507246,Hopkins; Megan Beth,9,0,30,21
1714609680969,EDS 128A,A01,507264,Fargason; Sharon Gayle,8,0,26,18
1714609681994,EDS 128B,A01,507293,Pappas; Elizabeth,12,0,30,18
1714609683020,EDS 139,A00,507294,Fargason; Sharon Gayle,13,0,30,17
1714609683020,EDS 139,B00,507313,Pappas; Elizabeth,13,0,30,17
1714609684045,EDS 201,A00,507315,Staff,13,0,30,17
1714609685070,EDS 203,A01,507317,Halter; Christopher P.,12,0,30,18
1714609686098,EDS 204R,A01,507319,Halter; Christopher P.,0,3,30,30
1714609686098,EDS 204R,B01,507331,Heinzman; Erica M.,16,0,30,14
1714609687121,EDS 206R,A00,507332,Staff,0,4,30,30
1714609687121,EDS 206R,B00,507343,Staff,17,0,30,13
1714609688147,EDS 250,A00,507344,Hemans; Patricia Ann Benitez,22,0,40,18
1714609689171,EDS 281,A00,507345,Daly; Alan J.,18,0,18,0
1714609690196,EDS 284,A00,507350,Daly; Alan J.,16,0,16,0
1714609691223,EDS 286,A00,507359,Fine; Sarah,18,0,18,0
1714609692248,EDS 289C,A01,507361,Daly; Alan J.,18,0,18,0
1714609693272,EDS 290,A00,507366,Hofstetter; Carolyn,15,0,15,0
1714609694297,LIGM 5A,A00,507421,Fischer-Grunski; Eva K,18,0,20,2
1714609695323,LIGM 5B,A00,507423,Fischer-Grunski; Eva K,19,0,20,1
1714609696351,LIGM 5C,A00,507425,Fischer-Grunski; Eva K,19,0,20,1
1714609697376,LIIT 5AS,A00,507427,Carnelos; Chiara,20,0,20,0
1714609698402,LIIT 5BS,A00,507430,Carnelos; Chiara,20,0,20,0
1714609699428,LIIT 5CS,A00,507432,Carnelos; Chiara,20,0,20,0
1714609700453,LISP 5A,A00,507541,Munoz Sanchez; Alicia,11,0,20,9
1714609701478,LISP 5B,A00,507671,Munoz Sanchez; Alicia,8,0,20,12
1714609702502,LISP 5C,A00,507696,Munoz Sanchez; Alicia,9,0,20,11
1714609703526,MAE 197,001,528363,Boechler; Nicholas Sebastia,9998,0,9999,1
1714609704555,MATH 197,001,523477,Kedlaya; Kiran S.,9995,0,9999,4
1714609704555,MATH 197,002,563811,Zhang; Danna,9995,0,9999,4
1714609704555,MATH 197,003,628552,Dumitriu; Ioana,9998,0,9999,1
1714609705580,MCWP 40R,A00,518780,Staff,2,0,20,18
1714609705580,MCWP 40R,B00,518781,Staff,8,0,20,12
1714609705580,MCWP 40R,C00,518783,Staff,6,0,20,14
1714609706609,MCWP 50R,A00,518791,Staff,0,0,20,20
1714609706609,MCWP 50R,B00,518792,Staff,0,2,20,20
1714609706609,MCWP 50R,C00,518793,Staff,0,2,20,20
1714609706609,MCWP 50R,D00,518794,Staff,0,0,20,20
1714609706609,MCWP 50R,E00,518795,Staff,0,2,20,20
1714609706609,MCWP 50R,F00,518796,Staff,0,0,20,20
1714609706609,MCWP 50R,G00,518797,Staff,0,1,20,20
1714609707633,MMW 12R,A01,514034,Herbst; Matthew,0,0,16,16
1714609707633,MMW 12R,A02,514035,Herbst; Matthew,1,0,16,15
1714609708659,MMW 13R,A01,514037,Staff,0,4,16,16
1714609708659,MMW 13R,A02,514039,Staff,0,2,16,16
1714609708659,MMW 13R,A03,628519,Staff,0,2,16,16
1714609710712,SIO 295LS,A00,523233,Staff,10,0,30,20
1714609711735,SIO 295S,A00,523232,Staff,10,0,30,20
1714609712762,SIOC 290S,A01,637330,Merrifield; Mark A,23,0,30,7
1714609713788,SIOC 291S,A01,637333,Gabriel; Corey John,23,0,30,7
1714609714817,SOCI 117,A01,494376,Staff,0,4,5,5
1714609715846,WES 237B,A00,494380,Staff,9,0,20,11
1714609717927,AESE 279B,A00,494370,Wade; Jon P,0,0,33,33
1714609718959,AIP 197,001,627712,Vespa; Emanuel Ignacio,9998,0,9999,1
1714609719985,ANAR 135S,A00,494369,Braswell; Geoffrey E.,0,0,0,0
1714609721011,BENG 196,001,628496,Engler; Adam J.,9998,0,9999,1
1714609722041,CAT 124RS,A01,519847,Geibel; William,0,0,20,20
1714609723065,CAT 125RS,A01,515971,Geibel; William,0,0,20,20
1714609724094,CLRE 250,A00,511389,Morris; Sheldon,9993,0,9999,6
1714609725121,CLRE 251,A00,507176,Mehta; Ravindra L.,9993,0,9999,6
1714609725121,CLRE 251,B00,511410,Mehta; Ravindra L.,9998,0,9999,1
1714609726152,CLRE 252,A00,507189,Cuomo; Raphael Eduardo,9995,0,9999,4
1714609727182,CLRE 253,A00,507199,Vaida; Florin,9994,0,9999,5
1714609727182,CLRE 253,B00,507202,Vaida; Florin,9999,0,9999,0
1714609728207,CLRE 259,A00,507211,Patel; Hemal,9996,0,9999,3
1714609729231,CLRE 260,A00,507221,Cuomo; Raphael Eduardo,9999,0,9999,0
1714609730255,CLRE 297,001,507242,Cuomo; Raphael Eduardo,9999,0,9999,0
1714609731283,COGS 197,001,638244,Voytek; Bradley Thomas,9998,0,9999,1
1714609732309,CSE 191,A00,516875,Minnes Kemp; Mor Mia,9992,0,9999,7
1714609733338,CSE 197,001,637388,Minnes Kemp; Mor Mia,9998,0,9999,1
1714609734363,CSS 201S,A01,494383,Staff,35,0,35,0
1714609735388,CSS 202S,A01,494387,Staff,35,0,35,0
1714609736415,DSC 197,001,628532,Eldridge; Justin Matthew,9996,0,9999,3
1714609737440,EAP 100,A00,516065,Staff,9797,0,9999,202
1714609738467,ECE 45,A01,507414,Staff,33,0,60,27
1714609740517,ECE 111,A01,507420,Staff,15,0,50,35
1714609741543,ECE 197,001,548057,Sievenpiper; Daniel F.,9993,0,9999,6
1714609742569,EDS 115,A00,507243,Choi; Bailey Miyeon,10,0,28,18
1714609743593,EDS 117,A01,494379,Staff,1,5,30,29
1714609744618,EDS 125,A00,507246,Hopkins; Megan Beth,9,0,30,21
1714609745647,EDS 128A,A01,507264,Fargason; Sharon Gayle,8,0,26,18
1714609746672,EDS 128B,A01,507293,Pappas; Elizabeth,12,0,30,18
1714609747695,EDS 139,A00,507294,Fargason; Sharon Gayle,13,0,30,17
1714609747695,EDS 139,B00,507313,Pappas; Elizabeth,13,0,30,17
1714609748775,EDS 201,A00,507315,Staff,13,0,30,17
1714609749801,EDS 203,A01,507317,Halter; Christopher P.,12,0,30,18
1714609750827,EDS 204R,A01,507319,Halter; Christopher P.,0,3,30,30
1714609750827,EDS 204R,B01,507331,Heinzman; Erica M.,16,0,30,14
1714609751851,EDS 206R,A00,507332,Staff,0,4,30,30
1714609751851,EDS 206R,B00,507343,Staff,17,0,30,13
1714609752880,EDS 250,A00,507344,Hemans; Patricia Ann Benitez,22,0,40,18
1714609753910,EDS 281,A00,507345,Daly; Alan J.,18,0,18,0
1714609754935,EDS 284,A00,507350,Daly; Alan J.,16,0,16,0
1714609755963,EDS 286,A00,507359,Fine; Sarah,18,0,18,0
1714609756987,EDS 289C,A01,507361,Daly; Alan J.,18,0,18,0
1714609758015,EDS 290,A00,507366,Hofstetter; Carolyn,15,0,15,0
1714609759044,LIGM 5A,A00,507421,Fischer-Grunski; Eva K,18,0,20,2
1714609760072,LIGM 5B,A00,507423,Fischer-Grunski; Eva K,19,0,20,1
1714609761097,LIGM 5C,A00,507425,Fischer-Grunski; Eva K,19,0,20,1
1714609762125,LIIT 5AS,A00,507427,Carnelos; Chiara,20,0,20,0
1714609763153,LIIT 5BS,A00,507430,Carnelos; Chiara,20,0,20,0
1714609764180,LIIT 5CS,A00,507432,Carnelos; Chiara,20,0,20,0
1714609765207,LISP 5A,A00,507541,Munoz Sanchez; Alicia,11,0,20,9
1714609766235,LISP 5B,A00,507671,Munoz Sanchez; Alicia,8,0,20,12
1714609767259,LISP 5C,A00,507696,Munoz Sanchez; Alicia,9,0,20,11
1714609768284,MAE 197,001,528363,Boechler; Nicholas Sebastia,9998,0,9999,1
1714609769316,MATH 197,001,523477,Kedlaya; Kiran S.,9995,0,9999,4
1714609769316,MATH 197,002,563811,Zhang; Danna,9995,0,9999,4
1714609769316,MATH 197,003,628552,Dumitriu; Ioana,9998,0,9999,1
1714609770341,MCWP 40R,A00,518780,Staff,2,0,20,18
1714609770341,MCWP 40R,B00,518781,Staff,8,0,20,12
1714609770341,MCWP 40R,C00,518783,Staff,6,0,20,14
1714609771371,MCWP 50R,A00,518791,Staff,0,0,20,20
1714609771371,MCWP 50R,B00,518792,Staff,0,2,20,20
1714609771371,MCWP 50R,C00,518793,Staff,0,2,20,20
1714609771371,MCWP 50R,D00,518794,Staff,0,0,20,20
1714609771371,MCWP 50R,E00,518795,Staff,0,2,20,20
1714609771371,MCWP 50R,F00,518796,Staff,0,0,20,20
1714609771371,MCWP 50R,G00,518797,Staff,0,1,20,20
1714609772396,MMW 12R,A01,514034,Herbst; Matthew,0,0,16,16
1714609772396,MMW 12R,A02,514035,Herbst; Matthew,1,0,16,15
1714609773422,MMW 13R,A01,514037,Staff,0,4,16,16
1714609773422,MMW 13R,A02,514039,Staff,0,2,16,16
1714609773422,MMW 13R,A03,628519,Staff,0,2,16,16
1714609775476,SIO 295LS,A00,523233,Staff,10,0,30,20
1714609776501,SIO 295S,A00,523232,Staff,10,0,30,20
1714609777539,SIOC 290S,A01,637330,Merrifield; Mark A,23,0,30,7
1714609778565,SIOC 291S,A01,637333,Gabriel; Corey John,23,0,30,7
1714609779590,SOCI 117,A01,494376,Staff,0,4,5,5
1714609780615,WES 237B,A00,494380,Staff,9,0,20,11
1714609782686,AESE 279B,A00,494370,Wade; Jon P,0,0,33,33
1714609783715,AIP 197,001,627712,Vespa; Emanuel Ignacio,9998,0,9999,1
1714609784742,ANAR 135S,A00,494369,Braswell; Geoffrey E.,0,0,0,0
1714609785770,BENG 196,001,628496,Engler; Adam J.,9998,0,9999,1
1714609786795,CAT 124RS,A01,519847,Geibel; William,0,0,20,20
1714609787821,CAT 125RS,A01,515971,Geibel; William,0,0,20,20
1714609788850,CLRE 250,A00,511389,Morris; Sheldon,9993,0,9999,6
1714609789876,CLRE 251,A00,507176,Mehta; Ravindra L.,9993,0,9999,6
1714609789876,CLRE 251,B00,511410,Mehta; Ravindra L.,9998,0,9999,1
1714609790900,CLRE 252,A00,507189,Cuomo; Raphael Eduardo,9995,0,9999,4
1714609791931,CLRE 253,A00,507199,Vaida; Florin,9994,0,9999,5
1714609791931,CLRE 253,B00,507202,Vaida; Florin,9999,0,9999,0
1714609792957,CLRE 259,A00,507211,Patel; Hemal,9996,0,9999,3
1714609793981,CLRE 260,A00,507221,Cuomo; Raphael Eduardo,9999,0,9999,0
1714609795008,CLRE 297,001,507242,Cuomo; Raphael Eduardo,9999,0,9999,0
1714609796034,COGS 197,001,638244,Voytek; Bradley Thomas,9998,0,9999,1
1714609797062,CSE 191,A00,516875,Minnes Kemp; Mor Mia,9992,0,9999,7
1714609798087,CSE 197,001,637388,Minnes Kemp; Mor Mia,9998,0,9999,1
1714609799120,CSS 201S,A01,494383,Staff,35,0,35,0
1714609800146,CSS 202S,A01,494387,Staff,35,0,35,0
1714609801170,DSC 197,001,628532,Eldridge; Justin Matthew,9996,0,9999,3
1714609802200,EAP 100,A00,516065,Staff,9797,0,9999,202
1714609803229,ECE 45,A01,507414,Staff,33,0,60,27
1714609805278,ECE 111,A01,507420,Staff,15,0,50,35
1714609806304,ECE 197,001,548057,Sievenpiper; Daniel F.,9993,0,9999,6
1714609807333,EDS 115,A00,507243,Choi; Bailey Miyeon,10,0,28,18
1714609808360,EDS 117,A01,494379,Staff,1,5,30,29
1714609809386,EDS 125,A00,507246,Hopkins; Megan Beth,9,0,30,21
1714609810413,EDS 128A,A01,507264,Fargason; Sharon Gayle,8,0,26,18
1714609811438,EDS 128B,A01,507293,Pappas; Elizabeth,12,0,30,18
1714609812462,EDS 139,A00,507294,Fargason; Sharon Gayle,13,0,30,17
1714609812462,EDS 139,B00,507313,Pappas; Elizabeth,13,0,30,17
1714609813489,EDS 201,A00,507315,Staff,13,0,30,17
1714609814518,EDS 203,A01,507317,Halter; Christopher P.,12,0,30,18
1714609815543,EDS 204R,A01,507319,Halter; Christopher P.,0,3,30,30
1714609815543,EDS 204R,B01,507331,Heinzman; Erica M.,16,0,30,14
1714609816568,EDS 206R,A00,507332,Staff,0,4,30,30
1714609816568,EDS 206R,B00,507343,Staff,17,0,30,13
1714609817593,EDS 250,A00,507344,Hemans; Patricia Ann Benitez,22,0,40,18
1714609818618,EDS 281,A00,507345,Daly; Alan J.,18,0,18,0
1714609819643,EDS 284,A00,507350,Daly; Alan J.,16,0,16,0
1714609820677,EDS 286,A00,507359,Fine; Sarah,18,0,18,0
1714609821701,EDS 289C,A01,507361,Daly; Alan J.,18,0,18,0
1714609822727,EDS 290,A00,507366,Hofstetter; Carolyn,15,0,15,0
1714609823755,LIGM 5A,A00,507421,Fischer-Grunski; Eva K,18,0,20,2
1714609824783,LIGM 5B,A00,507423,Fischer-Grunski; Eva K,19,0,20,1
1714609825809,LIGM 5C,A00,507425,Fischer-Grunski; Eva K,19,0,20,1
1714609826836,LIIT 5AS,A00,507427,Carnelos; Chiara,20,0,20,0
1714609827860,LIIT 5BS,A00,507430,Carnelos; Chiara,20,0,20,0
1714609828890,LIIT 5CS,A00,507432,Carnelos; Chiara,20,0,20,0
1714609829914,LISP 5A,A00,507541,Munoz Sanchez; Alicia,11,0,20,9
1714609830939,LISP 5B,A00,507671,Munoz Sanchez; Alicia,8,0,20,12
1714609831963,LISP 5C,A00,507696,Munoz Sanchez; Alicia,9,0,20,11
1714609832989,MAE 197,001,528363,Boechler; Nicholas Sebastia,9998,0,9999,1
1714609834017,MATH 197,001,523477,Kedlaya; Kiran S.,9995,0,9999,4
1714609834017,MATH 197,002,563811,Zhang; Danna,9995,0,9999,4
1714609834017,MATH 197,003,628552,Dumitriu; Ioana,9998,0,9999,1
1714609835042,MCWP 40R,A00,518780,Staff,2,0,20,18
1714609835042,MCWP 40R,B00,518781,Staff,8,0,20,12
1714609835042,MCWP 40R,C00,518783,Staff,6,0,20,14
1714609836067,MCWP 50R,A00,518791,Staff,0,0,20,20
1714609836067,MCWP 50R,B00,518792,Staff,0,2,20,20
1714609836067,MCWP 50R,C00,518793,Staff,0,2,20,20
1714609836067,MCWP 50R,D00,518794,Staff,0,0,20,20
1714609836067,MCWP 50R,E00,518795,Staff,0,2,20,20
1714609836067,MCWP 50R,F00,518796,Staff,0,0,20,20
1714609836067,MCWP 50R,G00,518797,Staff,0,1,20,20
1714609837096,MMW 12R,A01,514034,Herbst; Matthew,0,0,16,16
1714609837096,MMW 12R,A02,514035,Herbst; Matthew,1,0,16,15
1714609838121,MMW 13R,A01,514037,Staff,0,4,16,16
1714609838121,MMW 13R,A02,514039,Staff,0,2,16,16
1714609838121,MMW 13R,A03,628519,Staff,0,2,16,16
1714609840178,SIO 295LS,A00,523233,Staff,10,0,30,20
1714609841205,SIO 295S,A00,523232,Staff,10,0,30,20
1714609842230,SIOC 290S,A01,637330,Merrifield; Mark A,23,0,30,7
1714609843258,SIOC 291S,A01,637333,Gabriel; Corey John,23,0,30,7
1714609844282,SOCI 117,A01,494376,Staff,0,4,5,5
1714609845308,WES 237B,A00,494380,Staff,9,0,20,11
1714609847382,AESE 279B,A00,494370,Wade; Jon P,0,0,33,33
1714609848405,AIP 197,001,627712,Vespa; Emanuel Ignacio,9998,0,9999,1
1714609849433,ANAR 135S,A00,494369,Braswell; Geoffrey E.,0,0,0,0
1714609850482,BENG 196,001,628496,Engler; Adam J.,9998,0,9999,1
1714609851506,CAT 124RS,A01,519847,Geibel; William,0,0,20,20
1714609852534,CAT 125RS,A01,515971,Geibel; William,0,0,20,20
1714609853560,CLRE 250,A00,511389,Morris; Sheldon,9993,0,9999,6
1714609854588,CLRE 251,A00,507176,Mehta; Ravindra L.,9993,0,9999,6
1714609854588,CLRE 251,B00,511410,Mehta; Ravindra L.,9998,0,9999,1
1714609855616,CLRE 252,A00,507189,Cuomo; Raphael Eduardo,9995,0,9999,4
1714609856642,CLRE 253,A00,507199,Vaida; Florin,9994,0,9999,5
1714609856642,CLRE 253,B00,507202,Vaida; Florin,9999,0,9999,0
1714609857666,CLRE 259,A00,507211,Patel; Hemal,9996,0,9999,3
1714609858691,CLRE 260,A00,507221,Cuomo; Raphael Eduardo,9999,0,9999,0
1714609859715,CLRE 297,001,507242,Cuomo; Raphael Eduardo,9999,0,9999,0
1714609860749,COGS 197,001,638244,Voytek; Bradley Thomas,9998,0,9999,1
1714609861781,CSE 191,A00,516875,Minnes Kemp; Mor Mia,9992,0,9999,7
1714609862806,CSE 197,001,637388,Minnes Kemp; Mor Mia,9998,0,9999,1
1714609863835,CSS 201S,A01,494383,Staff,35,0,35,0
1714609864859,CSS 202S,A01,494387,Staff,35,0,35,0
1714609865884,DSC 197,001,628532,Eldridge; Justin Matthew,9996,0,9999,3
1714609866912,EAP 100,A00,516065,Staff,9797,0,9999,202
1714609867940,ECE 45,A01,507414,Staff,33,0,60,27
1714609869990,ECE 111,A01,507420,Staff,15,0,50,35
1714609871015,ECE 197,001,548057,Sievenpiper; Daniel F.,9993,0,9999,6
1714609872041,EDS 115,A00,507243,Choi; Bailey Miyeon,10,0,28,18
1714609873065,EDS 117,A01,494379,Staff,1,5,30,29
1714609874094,EDS 125,A00,507246,Hopkins; Megan Beth,9,0,30,21
1714609875123,EDS 128A,A01,507264,Fargason; Sharon Gayle,8,0,26,18
1714609876149,EDS 128B,A01,507293,Pappas; Elizabeth,12,0,30,18
1714609877178,EDS 139,A00,507294,Fargason; Sharon Gayle,13,0,30,17
1714609877178,EDS 139,B00,507313,Pappas; Elizabeth,13,0,30,17
1714609878203,EDS 201,A00,507315,Staff,13,0,30,17
1714609879229,EDS 203,A01,507317,Halter; Christopher P.,12,0,30,18
1714609880261,EDS 204R,A01,507319,Halter; Christopher P.,0,3,30,30
1714609880261,EDS 204R,B01,507331,Heinzman; Erica M.,16,0,30,14
1714609881286,EDS 206R,A00,507332,Staff,0,4,30,30
1714609881286,EDS 206R,B00,507343,Staff,17,0,30,13
1714609882314,EDS 250,A00,507344,Hemans; Patricia Ann Benitez,22,0,40,18
1714609883343,EDS 281,A00,507345,Daly; Alan J.,18,0,18,0
1714609884368,EDS 284,A00,507350,Daly; Alan J.,16,0,16,0
1714609885394,EDS 286,A00,507359,Fine; Sarah,18,0,18,0
1714609886418,EDS 289C,A01,507361,Daly; Alan J.,18,0,18,0
1714609887445,EDS 290,A00,507366,Hofstetter; Carolyn,15,0,15,0
1714609888470,LIGM 5A,A00,507421,Fischer-Grunski; Eva K,18,0,20,2
1714609889500,LIGM 5B,A00,507423,Fischer-Grunski; Eva K,19,0,20,1
1714609890525,LIGM 5C,A00,507425,Fischer-Grunski; Eva K,19,0,20,1
1714609891552,LIIT 5AS,A00,507427,Carnelos; Chiara,20,0,20,0
1714609892582,LIIT 5BS,A00,507430,Carnelos; Chiara,20,0,20,0
1714609893607,LIIT 5CS,A00,507432,Carnelos; Chiara,20,0,20,0
1714609894633,LISP 5A,A00,507541,Munoz Sanchez; Alicia,11,0,20,9
1714609895660,LISP 5B,A00,507671,Munoz Sanchez; Alicia,8,0,20,12
1714609896688,LISP 5C,A00,507696,Munoz Sanchez; Alicia,9,0,20,11
1714609897713,MAE 197,001,528363,Boechler; Nicholas Sebastia,9998,0,9999,1
1714609898742,MATH 197,001,523477,Kedlaya; Kiran S.,9995,0,9999,4
1714609898742,MATH 197,002,563811,Zhang; Danna,9995,0,9999,4
1714609898742,MATH 197,003,628552,Dumitriu; Ioana,9998,0,9999,1
1714609899768,MCWP 40R,A00,518780,Staff,2,0,20,18
1714609899768,MCWP 40R,B00,518781,Staff,8,0,20,12
1714609899768,MCWP 40R,C00,518783,Staff,6,0,20,14
1714609900797,MCWP 50R,A00,518791,Staff,0,0,20,20
1714609900797,MCWP 50R,B00,518792,Staff,0,2,20,20
1714609900797,MCWP 50R,C00,518793,Staff,0,2,20,20
1714609900797,MCWP 50R,D00,518794,Staff,0,0,20,20
1714609900797,MCWP 50R,E00,518795,Staff,0,2,20,20
1714609900797,MCWP 50R,F00,518796,Staff,0,0,20,20
1714609900797,MCWP 50R,G00,518797,Staff,0,1,20,20
1714609901827,MMW 12R,A01,514034,Herbst; Matthew,0,0,16,16
1714609901827,MMW 12R,A02,514035,Herbst; Matthew,1,0,16,15
1714609902857,MMW 13R,A01,514037,Staff,0,4,16,16
1714609902857,MMW 13R,A02,514039,Staff,0,2,16,16
1714609902857,MMW 13R,A03,628519,Staff,0,2,16,16
1714609904916,SIO 295LS,A00,523233,Staff,10,0,30,20
1714609905942,SIO 295S,A00,523232,Staff,10,0,30,20
1714609906972,SIOC 290S,A01,637330,Merrifield; Mark A,23,0,30,7
1714609907998,SIOC 291S,A01,637333,Gabriel; Corey John,23,0,30,7
1714609909026,SOCI 117,A01,494376,Staff,0,4,5,5
1714609910052,WES 237B,A00,494380,Staff,9,0,20,11
1714609912138,AESE 279B,A00,494370,Wade; Jon P,0,0,33,33
1714609913162,AIP 197,001,627712,Vespa; Emanuel Ignacio,9998,0,9999,1
1714609914187,ANAR 135S,A00,494369,Braswell; Geoffrey E.,0,0,0,0
1714609915210,BENG 196,001,628496,Engler; Adam J.,9998,0,9999,1
1714609916236,CAT 124RS,A01,519847,Geibel; William,0,0,20,20
1714609917261,CAT 125RS,A01,515971,Geibel; William,0,0,20,20
1714609918323,CLRE 250,A00,511389,Morris; Sheldon,9993,0,9999,6
1714609919354,CLRE 251,A00,507176,Mehta; Ravindra L.,9993,0,9999,6
1714609919354,CLRE 251,B00,511410,Mehta; Ravindra L.,9998,0,9999,1
1714609920379,CLRE 252,A00,507189,Cuomo; Raphael Eduardo,9995,0,9999,4
1714609921407,CLRE 253,A00,507199,Vaida; Florin,9994,0,9999,5
1714609921407,CLRE 253,B00,507202,Vaida; Florin,9999,0,9999,0
1714609922432,CLRE 259,A00,507211,Patel; Hemal,9996,0,9999,3
1714609923456,CLRE 260,A00,507221,Cuomo; Raphael Eduardo,9999,0,9999,0
1714609924480,CLRE 297,001,507242,Cuomo; Raphael Eduardo,9999,0,9999,0
1714609925506,COGS 197,001,638244,Voytek; Bradley Thomas,9998,0,9999,1
1714609926531,CSE 191,A00,516875,Minnes Kemp; Mor Mia,9992,0,9999,7
1714609927554,CSE 197,001,637388,Minnes Kemp; Mor Mia,9998,0,9999,1
1714609928577,CSS 201S,A01,494383,Staff,35,0,35,0
1714609929602,CSS 202S,A01,494387,Staff,35,0,35,0
1714609930631,DSC 197,001,628532,Eldridge; Justin Matthew,9996,0,9999,3
1714609931656,EAP 100,A00,516065,Staff,9797,0,9999,202
1714609932684,ECE 45,A01,507414,Staff,33,0,60,27
1714609934737,ECE 111,A01,507420,Staff,15,0,50,35
1714609935762,ECE 197,001,548057,Sievenpiper; Daniel F.,9993,0,9999,6
1714609936787,EDS 115,A00,507243,Choi; Bailey Miyeon,10,0,28,18
1714609937812,EDS 117,A01,494379,Staff,1,5,30,29
1714609938837,EDS 125,A00,507246,Hopkins; Megan Beth,9,0,30,21
1714609939863,EDS 128A,A01,507264,Fargason; Sharon Gayle,8,0,26,18
1714609940894,EDS 128B,A01,507293,Pappas; Elizabeth,12,0,30,18
1714609941919,EDS 139,A00,507294,Fargason; Sharon Gayle,13,0,30,17
1714609941919,EDS 139,B00,507313,Pappas; Elizabeth,13,0,30,17
1714609942943,EDS 201,A00,507315,Staff,13,0,30,17
1714609943967,EDS 203,A01,507317,Halter; Christopher P.,12,0,30,18
1714609944991,EDS 204R,A01,507319,Halter; Christopher P.,0,3,30,30
1714609944991,EDS 204R,B01,507331,Heinzman; Erica M.,16,0,30,14
1714609946018,EDS 206R,A00,507332,Staff,0,4,30,30
1714609946018,EDS 206R,B00,507343,Staff,17,0,30,13
1714609947046,EDS 250,A00,507344,Hemans; Patricia Ann Benitez,22,0,40,18
1714609948071,EDS 281,A00,507345,Daly; Alan J.,18,0,18,0
1714609949095,EDS 284,A00,507350,Daly; Alan J.,16,0,16,0
1714609950123,EDS 286,A00,507359,Fine; Sarah,18,0,18,0
1714609951149,EDS 289C,A01,507361,Daly; Alan J.,18,0,18,0
1714609952175,EDS 290,A00,507366,Hofstetter; Carolyn,15,0,15,0
1714609953201,LIGM 5A,A00,507421,Fischer-Grunski; Eva K,18,0,20,2
1714609954225,LIGM 5B,A00,507423,Fischer-Grunski; Eva K,19,0,20,1
1714609955249,LIGM 5C,A00,507425,Fischer-Grunski; Eva K,19,0,20,1
1714609956274,LIIT 5AS,A00,507427,Carnelos; Chiara,20,0,20,0
1714609957303,LIIT 5BS,A00,507430,Carnelos; Chiara,20,0,20,0
1714609958328,LIIT 5CS,A00,507432,Carnelos; Chiara,20,0,20,0
1714609959355,LISP 5A,A00,507541,Munoz Sanchez; Alicia,11,0,20,9
1714609960380,LISP 5B,A00,507671,Munoz Sanchez; Alicia,8,0,20,12
1714609961411,LISP 5C,A00,507696,Munoz Sanchez; Alicia,9,0,20,11
1714609962436,MAE 197,001,528363,Boechler; Nicholas Sebastia,9998,0,9999,1
1714609963462,MATH 197,001,523477,Kedlaya; Kiran S.,9995,0,9999,4
1714609963462,MATH 197,002,563811,Zhang; Danna,9995,0,9999,4
1714609963462,MATH 197,003,628552,Dumitriu; Ioana,9998,0,9999,1
1714609964487,MCWP 40R,A00,518780,Staff,2,0,20,18
1714609964487,MCWP 40R,B00,518781,Staff,8,0,20,12
1714609964487,MCWP 40R,C00,518783,Staff,6,0,20,14
1714609965514,MCWP 50R,A00,518791,Staff,0,0,20,20
1714609965514,MCWP 50R,B00,518792,Staff,0,2,20,20
1714609965514,MCWP 50R,C00,518793,Staff,0,2,20,20
1714609965514,MCWP 50R,D00,518794,Staff,0,0,20,20
1714609965514,MCWP 50R,E00,518795,Staff,0,2,20,20
1714609965514,MCWP 50R,F00,518796,Staff,0,0,20,20
1714609965514,MCWP 50R,G00,518797,Staff,0,1,20,20
1714609966544,MMW 12R,A01,514034,Herbst; Matthew,0,0,16,16
1714609966544,MMW 12R,A02,514035,Herbst; Matthew,1,0,16,15
1714609967570,MMW 13R,A01,514037,Staff,0,4,16,16
1714609967570,MMW 13R,A02,514039,Staff,0,2,16,16
1714609967570,MMW 13R,A03,628519,Staff,0,2,16,16
1714609969622,SIO 295LS,A00,523233,Staff,10,0,30,20
1714609970652,SIO 295S,A00,523232,Staff,10,0,30,20
1714609971681,SIOC 290S,A01,637330,Merrifield; Mark A,23,0,30,7
1714609972712,SIOC 291S,A01,637333,Gabriel; Corey John,23,0,30,7
1714609973739,SOCI 117,A01,494376,Staff,0,4,5,5
1714609974765,WES 237B,A00,494380,Staff,9,0,20,11
1714609976837,AESE 279B,A00,494370,Wade; Jon P,0,0,33,33
1714609977862,AIP 197,001,627712,Vespa; Emanuel Ignacio,9998,0,9999,1
1714609978888,ANAR 135S,A00,494369,Braswell; Geoffrey E.,0,0,0,0
1714609979912,BENG 196,001,628496,Engler; Adam J.,9998,0,9999,1
1714609980938,CAT 124RS,A01,519847,Geibel; William,0,0,20,20
1714609981966,CAT 125RS,A01,515971,Geibel; William,0,0,20,20
1714609982993,CLRE 250,A00,511389,Morris; Sheldon,9993,0,9999,6
1714609984021,CLRE 251,A00,507176,Mehta; Ravindra L.,9993,0,9999,6
1714609984021,CLRE 251,B00,511410,Mehta; Ravindra L.,9998,0,9999,1
1714609985051,CLRE 252,A00,507189,Cuomo; Raphael Eduardo,9995,0,9999,4
1714609986080,CLRE 253,A00,507199,Vaida; Florin,9994,0,9999,5
1714609986080,CLRE 253,B00,507202,Vaida; Florin,9999,0,9999,0
1714609987107,CLRE 259,A00,507211,Patel; Hemal,9996,0,9999,3
1714609988132,CLRE 260,A00,507221,Cuomo; Raphael Eduardo,9999,0,9999,0
1714609989160,CLRE 297,001,507242,Cuomo; Raphael Eduardo,9999,0,9999,0
1714609990187,COGS 197,001,638244,Voytek; Bradley Thomas,9998,0,9999,1
1714609991213,CSE 191,A00,516875,Minnes Kemp; Mor Mia,9992,0,9999,7
1714609992239,CSE 197,001,637388,Minnes Kemp; Mor Mia,9998,0,9999,1
1714609993263,CSS 201S,A01,494383,Staff,35,0,35,0
1714609994290,CSS 202S,A01,494387,Staff,35,0,35,0
1714609995319,DSC 197,001,628532,Eldridge; Justin Matthew,9996,0,9999,3
1714609996345,EAP 100,A00,516065,Staff,9797,0,9999,202
1714609997370,ECE 45,A01,507414,Staff,33,0,60,27
1714609999422,ECE 111,A01,507420,Staff,15,0,50,35
1714610000448,ECE 197,001,548057,Sievenpiper; Daniel F.,9993,0,9999,6
1714610001474,EDS 115,A00,507243,Choi; Bailey Miyeon,10,0,28,18
1714610002502,EDS 117,A01,494379,Staff,1,5,30,29
1714610003526,EDS 125,A00,507246,Hopkins; Megan Beth,9,0,30,21
1714610004552,EDS 128A,A01,507264,Fargason; Sharon Gayle,8,0,26,18
1714610005582,EDS 128B,A01,507293,Pappas; Elizabeth,12,0,30,18
1714610006607,EDS 139,A00,507294,Fargason; Sharon Gayle,13,0,30,17
1714610006607,EDS 139,B00,507313,Pappas; Elizabeth,13,0,30,17
1714610007632,EDS 201,A00,507315,Staff,13,0,30,17
1714610008655,EDS 203,A01,507317,Halter; Christopher P.,12,0,30,18
1714610009683,EDS 204R,A01,507319,Halter; Christopher P.,0,3,30,30
1714610009683,EDS 204R,B01,507331,Heinzman; Erica M.,16,0,30,14
1714610010714,EDS 206R,A00,507332,Staff,0,4,30,30
1714610010714,EDS 206R,B00,507343,Staff,17,0,30,13
1714610011737,EDS 250,A00,507344,Hemans; Patricia Ann Benitez,22,0,40,18
1714610012764,EDS 281,A00,507345,Daly; Alan J.,18,0,18,0
1714610013789,EDS 284,A00,507350,Daly; Alan J.,16,0,16,0
1714610014816,EDS 286,A00,507359,Fine; Sarah,18,0,18,0
1714610015842,EDS 289C,A01,507361,Daly; Alan J.,18,0,18,0
1714610016868,EDS 290,A00,507366,Hofstetter; Carolyn,15,0,15,0
1714610017894,LIGM 5A,A00,507421,Fischer-Grunski; Eva K,18,0,20,2
1714610018919,LIGM 5B,A00,507423,Fischer-Grunski; Eva K,19,0,20,1
1714610019942,LIGM 5C,A00,507425,Fischer-Grunski; Eva K,19,0,20,1
1714610020968,LIIT 5AS,A00,507427,Carnelos; Chiara,20,0,20,0
1714610021992,LIIT 5BS,A00,507430,Carnelos; Chiara,20,0,20,0
1714610023017,LIIT 5CS,A00,507432,Carnelos; Chiara,20,0,20,0
1714610024047,LISP 5A,A00,507541,Munoz Sanchez; Alicia,11,0,20,9
1714610025071,LISP 5B,A00,507671,Munoz Sanchez; Alicia,8,0,20,12
1714610026098,LISP 5C,A00,507696,Munoz Sanchez; Alicia,9,0,20,11
1714610027127,MAE 197,001,528363,Boechler; Nicholas Sebastia,9998,0,9999,1
1714610028153,MATH 197,001,523477,Kedlaya; Kiran S.,9995,0,9999,4
1714610028153,MATH 197,002,563811,Zhang; Danna,9995,0,9999,4
1714610028153,MATH 197,003,628552,Dumitriu; Ioana,9998,0,9999,1
1714610029177,MCWP 40R,A00,518780,Staff,2,0,20,18
1714610029177,MCWP 40R,B00,518781,Staff,8,0,20,12
1714610029177,MCWP 40R,C00,518783,Staff,6,0,20,14
1714610030202,MCWP 50R,A00,518791,Staff,0,0,20,20
1714610030202,MCWP 50R,B00,518792,Staff,0,2,20,20
1714610030202,MCWP 50R,C00,518793,Staff,0,2,20,20
1714610030202,MCWP 50R,D00,518794,Staff,0,0,20,20
1714610030202,MCWP 50R,E00,518795,Staff,0,2,20,20
1714610030202,MCWP 50R,F00,518796,Staff,0,0,20,20
1714610030202,MCWP 50R,G00,518797,Staff,0,1,20,20
1714610031228,MMW 12R,A01,514034,Herbst; Matthew,0,0,16,16
1714610031228,MMW 12R,A02,514035,Herbst; Matthew,1,0,16,15
1714610032251,MMW 13R,A01,514037,Staff,0,4,16,16
1714610032251,MMW 13R,A02,514039,Staff,0,2,16,16
1714610032251,MMW 13R,A03,628519,Staff,0,2,16,16
1714610034302,SIO 295LS,A00,523233,Staff,10,0,30,20
1714610035381,SIO 295S,A00,523232,Staff,10,0,30,20
1714610036407,SIOC 290S,A01,637330,Merrifield; Mark A,23,0,30,7
1714610037435,SIOC 291S,A01,637333,Gabriel; Corey John,23,0,30,7
1714610038461,SOCI 117,A01,494376,Staff,0,4,5,5
1714610039489,WES 237B,A00,494380,Staff,9,0,20,11
1714610041560,AESE 279B,A00,494370,Wade; Jon P,0,0,33,33
1714610042587,AIP 197,001,627712,Vespa; Emanuel Ignacio,9998,0,9999,1
1714610043612,ANAR 135S,A00,494369,Braswell; Geoffrey E.,0,0,0,0
1714610044637,BENG 196,001,628496,Engler; Adam J.,9998,0,9999,1
1714610045661,CAT 124RS,A01,519847,Geibel; William,0,0,20,20
1714610046687,CAT 125RS,A01,515971,Geibel; William,0,0,20,20
1714610047712,CLRE 250,A00,511389,Morris; Sheldon,9993,0,9999,6
1714610048742,CLRE 251,A00,507176,Mehta; Ravindra L.,9993,0,9999,6
1714610048742,CLRE 251,B00,511410,Mehta; Ravindra L.,9998,0,9999,1
1714610049769,CLRE 252,A00,507189,Cuomo; Raphael Eduardo,9995,0,9999,4
1714610050798,CLRE 253,A00,507199,Vaida; Florin,9994,0,9999,5
1714610050798,CLRE 253,B00,507202,Vaida; Florin,9999,0,9999,0
1714610051824,CLRE 259,A00,507211,Patel; Hemal,9996,0,9999,3
1714610052853,CLRE 260,A00,507221,Cuomo; Raphael Eduardo,9999,0,9999,0
1714610053877,CLRE 297,001,507242,Cuomo; Raphael Eduardo,9999,0,9999,0
1714610054905,COGS 197,001,638244,Voytek; Bradley Thomas,9998,0,9999,1
1714610055931,CSE 191,A00,516875,Minnes Kemp; Mor Mia,9992,0,9999,7
1714610056956,CSE 197,001,637388,Minnes Kemp; Mor Mia,9998,0,9999,1
1714610057982,CSS 201S,A01,494383,Staff,35,0,35,0
1714610059007,CSS 202S,A01,494387,Staff,35,0,35,0
1714610060032,DSC 197,001,628532,Eldridge; Justin Matthew,9996,0,9999,3
1714610061058,EAP 100,A00,516065,Staff,9797,0,9999,202
1714610062084,ECE 45,A01,507414,Staff,33,0,60,27
1714610064138,ECE 111,A01,507420,Staff,15,0,50,35
1714610065164,ECE 197,001,548057,Sievenpiper; Daniel F.,9993,0,9999,6
1714610066193,EDS 115,A00,507243,Choi; Bailey Miyeon,10,0,28,18
1714610067223,EDS 117,A01,494379,Staff,1,5,30,29
1714610068250,EDS 125,A00,507246,Hopkins; Megan Beth,9,0,30,21
1714610069275,EDS 128A,A01,507264,Fargason; Sharon Gayle,8,0,26,18
1714610070299,EDS 128B,A01,507293,Pappas; Elizabeth,12,0,30,18
1714610071325,EDS 139,A00,507294,Fargason; Sharon Gayle,13,0,30,17
1714610071325,EDS 139,B00,507313,Pappas; Elizabeth,13,0,30,17
1714610072351,EDS 201,A00,507315,Staff,13,0,30,17
1714610073378,EDS 203,A01,507317,Halter; Christopher P.,12,0,30,18
1714610074408,EDS 204R,A01,507319,Halter; Christopher P.,0,3,30,30
1714610074408,EDS 204R,B01,507331,Heinzman; Erica M.,16,0,30,14
1714610075434,EDS 206R,A00,507332,Staff,0,4,30,30
1714610075434,EDS 206R,B00,507343,Staff,17,0,30,13
1714610076462,EDS 250,A00,507344,Hemans; Patricia Ann Benitez,22,0,40,18
1714610077486,EDS 281,A00,507345,Daly; Alan J.,18,0,18,0
1714610078510,EDS 284,A00,507350,Daly; Alan J.,16,0,16,0
1714610079534,EDS 286,A00,507359,Fine; Sarah,18,0,18,0
1714610080557,EDS 289C,A01,507361,Daly; Alan J.,18,0,18,0
1714610081586,EDS 290,A00,507366,Hofstetter; Carolyn,15,0,15,0
1714610082617,LIGM 5A,A00,507421,Fischer-Grunski; Eva K,18,0,20,2
1714610083642,LIGM 5B,A00,507423,Fischer-Grunski; Eva K,19,0,20,1
1714610084668,LIGM 5C,A00,507425,Fischer-Grunski; Eva K,19,0,20,1
1714610085697,LIIT 5AS,A00,507427,Carnelos; Chiara,20,0,20,0
1714610086725,LIIT 5BS,A00,507430,Carnelos; Chiara,20,0,20,0
1714610087750,LIIT 5CS,A00,507432,Carnelos; Chiara,20,0,20,0
1714610088775,LISP 5A,A00,507541,Munoz Sanchez; Alicia,11,0,20,9
1714610089801,LISP 5B,A00,507671,Munoz Sanchez; Alicia,8,0,20,12
1714610090827,LISP 5C,A00,507696,Munoz Sanchez; Alicia,9,0,20,11
1714610091852,MAE 197,001,528363,Boechler; Nicholas Sebastia,9998,0,9999,1
1714610092882,MATH 197,001,523477,Kedlaya; Kiran S.,9995,0,9999,4
1714610092882,MATH 197,002,563811,Zhang; Danna,9995,0,9999,4
1714610092882,MATH 197,003,628552,Dumitriu; Ioana,9998,0,9999,1
1714610093910,MCWP 40R,A00,518780,Staff,2,0,20,18
1714610093910,MCWP 40R,B00,518781,Staff,8,0,20,12
1714610093910,MCWP 40R,C00,518783,Staff,6,0,20,14
1714610094935,MCWP 50R,A00,518791,Staff,0,0,20,20
1714610094935,MCWP 50R,B00,518792,Staff,0,2,20,20
1714610094935,MCWP 50R,C00,518793,Staff,0,2,20,20
1714610094935,MCWP 50R,D00,518794,Staff,0,0,20,20
1714610094935,MCWP 50R,E00,518795,Staff,0,2,20,20
1714610094935,MCWP 50R,F00,518796,Staff,0,0,20,20
1714610094935,MCWP 50R,G00,518797,Staff,0,1,20,20
1714610096012,MMW 12R,A01,514034,Herbst; Matthew,0,0,16,16
1714610096012,MMW 12R,A02,514035,Herbst; Matthew,1,0,16,15
1714610097040,MMW 13R,A01,514037,Staff,0,4,16,16
1714610097040,MMW 13R,A02,514039,Staff,0,2,16,16
1714610097040,MMW 13R,A03,628519,Staff,0,2,16,16
1714610099089,SIO 295LS,A00,523233,Staff,10,0,30,20
1714610100119,SIO 295S,A00,523232,Staff,10,0,30,20
1714610101149,SIOC 290S,A01,637330,Merrifield; Mark A,23,0,30,7
1714610102178,SIOC 291S,A01,637333,Gabriel; Corey John,23,0,30,7
1714610103205,SOCI 117,A01,494376,Staff,0,4,5,5
1714610104232,WES 237B,A00,494380,Staff,9,0,20,11
1714610106303,AESE 279B,A00,494370,Wade; Jon P,0,0,33,33
1714610107331,AIP 197,001,627712,Vespa; Emanuel Ignacio,9998,0,9999,1
1714610108360,ANAR 135S,A00,494369,Braswell; Geoffrey E.,0,0,0,0
1714610109386,BENG 196,001,628496,Engler; Adam J.,9998,0,9999,1
1714610110411,CAT 124RS,A01,519847,Geibel; William,0,0,20,20
1714610111436,CAT 125RS,A01,515971,Geibel; William,0,0,20,20
1714610112463,CLRE 250,A00,511389,Morris; Sheldon,9993,0,9999,6
1714610113493,CLRE 251,A00,507176,Mehta; Ravindra L.,9993,0,9999,6
1714610113493,CLRE 251,B00,511410,Mehta; Ravindra L.,9998,0,9999,1
1714610114518,CLRE 252,A00,507189,Cuomo; Raphael Eduardo,9995,0,9999,4
1714610115543,CLRE 253,A00,507199,Vaida; Florin,9994,0,9999,5
1714610115543,CLRE 253,B00,507202,Vaida; Florin,9999,0,9999,0
1714610116573,CLRE 259,A00,507211,Patel; Hemal,9996,0,9999,3
1714610117596,CLRE 260,A00,507221,Cuomo; Raphael Eduardo,9999,0,9999,0
1714610118625,CLRE 297,001,507242,Cuomo; Raphael Eduardo,9999,0,9999,0
1714610119648,COGS 197,001,638244,Voytek; Bradley Thomas,9998,0,9999,1
1714610120678,CSE 191,A00,516875,Minnes Kemp; Mor Mia,9992,0,9999,7
1714610121703,CSE 197,001,637388,Minnes Kemp; Mor Mia,9998,0,9999,1
1714610122726,CSS 201S,A01,494383,Staff,35,0,35,0
1714610123755,CSS 202S,A01,494387,Staff,35,0,35,0
1714610124781,DSC 197,001,628532,Eldridge; Justin Matthew,9996,0,9999,3
1714610125812,EAP 100,A00,516065,Staff,9797,0,9999,202
1714610126840,ECE 45,A01,507414,Staff,33,0,60,27
1714610128896,ECE 111,A01,507420,Staff,15,0,50,35
1714610129920,ECE 197,001,548057,Sievenpiper; Daniel F.,9993,0,9999,6
1714610130950,EDS 115,A00,507243,Choi; Bailey Miyeon,10,0,28,18
1714610131975,EDS 117,A01,494379,Staff,1,5,30,29
1714610133001,EDS 125,A00,507246,Hopkins; Megan Beth,9,0,30,21
1714610134030,EDS 128A,A01,507264,Fargason; Sharon Gayle,8,0,26,18
1714610135057,EDS 128B,A01,507293,Pappas; Elizabeth,12,0,30,18
1714610136085,EDS 139,A00,507294,Fargason; Sharon Gayle,13,0,30,17
1714610136085,EDS 139,B00,507313,Pappas; Elizabeth,13,0,30,17
1714610137110,EDS 201,A00,507315,Staff,13,0,30,17
1714610138136,EDS 203,A01,507317,Halter; Christopher P.,12,0,30,18
1714610139220,EDS 204R,A01,507319,Halter; Christopher P.,0,3,30,30
1714610139220,EDS 204R,B01,507331,Heinzman; Erica M.,16,0,30,14
1714610140247,EDS 206R,A00,507332,Staff,0,4,30,30
1714610140247,EDS 206R,B00,507343,Staff,17,0,30,13
1714610141272,EDS 250,A00,507344,Hemans; Patricia Ann Benitez,22,0,40,18
1714610142300,EDS 281,A00,507345,Daly; Alan J.,18,0,18,0
1714610143324,EDS 284,A00,507350,Daly; Alan J.,16,0,16,0
1714610144349,EDS 286,A00,507359,Fine; Sarah,18,0,18,0
1714610145373,EDS 289C,A01,507361,Daly; Alan J.,18,0,18,0
1714610146399,EDS 290,A00,507366,Hofstetter; Carolyn,15,0,15,0
1714610147453,LIGM 5A,A00,507421,Fischer-Grunski; Eva K,18,0,20,2
1714610148478,LIGM 5B,A00,507423,Fischer-Grunski; Eva K,19,0,20,1
1714610149508,LIGM 5C,A00,507425,Fischer-Grunski; Eva K,19,0,20,1
1714610150535,LIIT 5AS,A00,507427,Carnelos; Chiara,20,0,20,0
1714610151560,LIIT 5BS,A00,507430,Carnelos; Chiara,20,0,20,0
1714610152585,LIIT 5CS,A00,507432,Carnelos; Chiara,20,0,20,0
1714610153614,LISP 5A,A00,507541,Munoz Sanchez; Alicia,11,0,20,9
1714610154639,LISP 5B,A00,507671,Munoz Sanchez; Alicia,8,0,20,12
1714610155669,LISP 5C,A00,507696,Munoz Sanchez; Alicia,9,0,20,11
1714610156695,MAE 197,001,528363,Boechler; Nicholas Sebastia,9998,0,9999,1
1714610157729,MATH 197,001,523477,Kedlaya; Kiran S.,9995,0,9999,4
1714610157729,MATH 197,002,563811,Zhang; Danna,9995,0,9999,4
1714610157729,MATH 197,003,628552,Dumitriu; Ioana,9998,0,9999,1
1714610158754,MCWP 40R,A00,518780,Staff,2,0,20,18
1714610158754,MCWP 40R,B00,518781,Staff,8,0,20,12
1714610158754,MCWP 40R,C00,518783,Staff,6,0,20,14
1714610159783,MCWP 50R,A00,518791,Staff,0,0,20,20
1714610159783,MCWP 50R,B00,518792,Staff,0,2,20,20
1714610159783,MCWP 50R,C00,518793,Staff,0,2,20,20
1714610159783,MCWP 50R,D00,518794,Staff,0,0,20,20
1714610159783,MCWP 50R,E00,518795,Staff,0,2,20,20
1714610159783,MCWP 50R,F00,518796,Staff,0,0,20,20
1714610159783,MCWP 50R,G00,518797,Staff,0,1,20,20
1714610160809,MMW 12R,A01,514034,Herbst; Matthew,0,0,16,16
1714610160809,MMW 12R,A02,514035,Herbst; Matthew,1,0,16,15
1714610161835,MMW 13R,A01,514037,Staff,0,4,16,16
1714610161835,MMW 13R,A02,514039,Staff,0,2,16,16
1714610161835,MMW 13R,A03,628519,Staff,0,2,16,16
1714610163897,SIO 295LS,A00,523233,Staff,10,0,30,20
1714610164924,SIO 295S,A00,523232,Staff,10,0,30,20
1714610165949,SIOC 290S,A01,637330,Merrifield; Mark A,23,0,30,7
1714610166979,SIOC 291S,A01,637333,Gabriel; Corey John,23,0,30,7
1714610168005,SOCI 117,A01,494376,Staff,0,4,5,5
1714610169034,WES 237B,A00,494380,Staff,9,0,20,11
1714610171108,AESE 279B,A00,494370,Wade; Jon P,0,0,33,33
1714610172135,AIP 197,001,627712,Vespa; Emanuel Ignacio,9998,0,9999,1
1714610173162,ANAR 135S,A00,494369,Braswell; Geoffrey E.,0,0,0,0
1714610174200,BENG 196,001,628496,Engler; Adam J.,9998,0,9999,1
1714610175225,CAT 124RS,A01,519847,Geibel; William,0,0,20,20
1714610176250,CAT 125RS,A01,515971,Geibel; William,0,0,20,20
1714610177281,CLRE 250,A00,511389,Morris; Sheldon,9993,0,9999,6
1714610178310,CLRE 251,A00,507176,Mehta; Ravindra L.,9993,0,9999,6
1714610178310,CLRE 251,B00,511410,Mehta; Ravindra L.,9998,0,9999,1
1714610179345,CLRE 252,A00,507189,Cuomo; Raphael Eduardo,9995,0,9999,4
1714610180371,CLRE 253,A00,507199,Vaida; Florin,9994,0,9999,5
1714610180371,CLRE 253,B00,507202,Vaida; Florin,9999,0,9999,0
1714610181397,CLRE 259,A00,507211,Patel; Hemal,9996,0,9999,3
1714610182422,CLRE 260,A00,507221,Cuomo; Raphael Eduardo,9999,0,9999,0
1714610183447,CLRE 297,001,507242,Cuomo; Raphael Eduardo,9999,0,9999,0
1714610184472,COGS 197,001,638244,Voytek; Bradley Thomas,9998,0,9999,1
1714610185496,CSE 191,A00,516875,Minnes Kemp; Mor Mia,9992,0,9999,7
1714610186522,CSE 197,001,637388,Minnes Kemp; Mor Mia,9998,0,9999,1
1714610187551,CSS 201S,A01,494383,Staff,35,0,35,0
1714610188582,CSS 202S,A01,494387,Staff,35,0,35,0
1714610189609,DSC 197,001,628532,Eldridge; Justin Matthew,9996,0,9999,3
1714610190634,EAP 100,A00,516065,Staff,9797,0,9999,202
1714610191659,ECE 45,A01,507414,Staff,33,0,60,27
1714610193710,ECE 111,A01,507420,Staff,15,0,50,35
1714610194734,ECE 197,001,548057,Sievenpiper; Daniel F.,9993,0,9999,6
1714610195762,EDS 115,A00,507243,Choi; Bailey Miyeon,10,0,28,18
1714610196790,EDS 117,A01,494379,Staff,1,5,30,29
1714610197818,EDS 125,A00,507246,Hopkins; Megan Beth,9,0,30,21
1714610198848,EDS 128A,A01,507264,Fargason; Sharon Gayle,8,0,26,18
1714610199875,EDS 128B,A01,507293,Pappas; Elizabeth,12,0,30,18
1714610200900,EDS 139,A00,507294,Fargason; Sharon Gayle,13,0,30,17
1714610200900,EDS 139,B00,507313,Pappas; Elizabeth,13,0,30,17
1714610201927,EDS 201,A00,507315,Staff,13,0,30,17
1714610202957,EDS 203,A01,507317,Halter; Christopher P.,12,0,30,18
1714610203984,EDS 204R,A01,507319,Halter; Christopher P.,0,3,30,30
1714610203984,EDS 204R,B01,507331,Heinzman; Erica M.,16,0,30,14
1714610205010,EDS 206R,A00,507332,Staff,0,4,30,30
1714610205010,EDS 206R,B00,507343,Staff,17,0,30,13
1714610206035,EDS 250,A00,507344,Hemans; Patricia Ann Benitez,22,0,40,18
1714610207060,EDS 281,A00,507345,Daly; Alan J.,18,0,18,0
1714610208084,EDS 284,A00,507350,Daly; Alan J.,16,0,16,0
1714610209113,EDS 286,A00,507359,Fine; Sarah,18,0,18,0
1714610210140,EDS 289C,A01,507361,Daly; Alan J.,18,0,18,0
1714610211165,EDS 290,A00,507366,Hofstetter; Carolyn,15,0,15,0
1714610212192,LIGM 5A,A00,507421,Fischer-Grunski; Eva K,18,0,20,2
1714610213217,LIGM 5B,A00,507423,Fischer-Grunski; Eva K,19,0,20,1
1714610214250,LIGM 5C,A00,507425,Fischer-Grunski; Eva K,19,0,20,1
1714610215276,LIIT 5AS,A00,507427,Carnelos; Chiara,20,0,20,0
1714610216305,LIIT 5BS,A00,507430,Carnelos; Chiara,20,0,20,0
1714610217331,LIIT 5CS,A00,507432,Carnelos; Chiara,20,0,20,0
1714610218358,LISP 5A,A00,507541,Munoz Sanchez; Alicia,11,0,20,9
1714610219387,LISP 5B,A00,507671,Munoz Sanchez; Alicia,8,0,20,12
1714610220413,LISP 5C,A00,507696,Munoz Sanchez; Alicia,9,0,20,11
1714610221440,MAE 197,001,528363,Boechler; Nicholas Sebastia,9998,0,9999,1
1714610222468,MATH 197,001,523477,Kedlaya; Kiran S.,9995,0,9999,4
1714610222468,MATH 197,002,563811,Zhang; Danna,9995,0,9999,4
1714610222468,MATH 197,003,628552,Dumitriu; Ioana,9998,0,9999,1
1714610223493,MCWP 40R,A00,518780,Staff,2,0,20,18
1714610223493,MCWP 40R,B00,518781,Staff,8,0,20,12
1714610223493,MCWP 40R,C00,518783,Staff,6,0,20,14
1714610224522,MCWP 50R,A00,518791,Staff,0,0,20,20
1714610224522,MCWP 50R,B00,518792,Staff,0,2,20,20
1714610224522,MCWP 50R,C00,518793,Staff,0,2,20,20
1714610224522,MCWP 50R,D00,518794,Staff,0,0,20,20
1714610224522,MCWP 50R,E00,518795,Staff,0,2,20,20
1714610224522,MCWP 50R,F00,518796,Staff,0,0,20,20
1714610224522,MCWP 50R,G00,518797,Staff,0,1,20,20
1714610225547,MMW 12R,A01,514034,Herbst; Matthew,0,0,16,16
1714610225547,MMW 12R,A02,514035,Herbst; Matthew,1,0,16,15
1714610226572,MMW 13R,A01,514037,Staff,0,4,16,16
1714610226572,MMW 13R,A02,514039,Staff,0,2,16,16
1714610226572,MMW 13R,A03,628519,Staff,0,2,16,16
1714610228623,SIO 295LS,A00,523233,Staff,10,0,30,20
1714610229648,SIO 295S,A00,523232,Staff,10,0,30,20
1714610230673,SIOC 290S,A01,637330,Merrifield; Mark A,23,0,30,7
1714610231700,SIOC 291S,A01,637333,Gabriel; Corey John,23,0,30,7
1714610232725,SOCI 117,A01,494376,Staff,0,4,5,5
1714610233752,WES 237B,A00,494380,Staff,9,0,20,11
1714610235833,AESE 279B,A00,494370,Wade; Jon P,0,0,33,33
1714610236859,AIP 197,001,627712,Vespa; Emanuel Ignacio,9998,0,9999,1
1714610237884,ANAR 135S,A00,494369,Braswell; Geoffrey E.,0,0,0,0
1714610238913,BENG 196,001,628496,Engler; Adam J.,9998,0,9999,1
1714610239938,CAT 124RS,A01,519847,Geibel; William,0,0,20,20
1714610240967,CAT 125RS,A01,515971,Geibel; William,0,0,20,20
1714610241995,CLRE 250,A00,511389,Morris; Sheldon,9993,0,9999,6
1714610243074,CLRE 251,A00,507176,Mehta; Ravindra L.,9993,0,9999,6
1714610243074,CLRE 251,B00,511410,Mehta; Ravindra L.,9998,0,9999,1
1714610244099,CLRE 252,A00,507189,Cuomo; Raphael Eduardo,9995,0,9999,4
1714610245124,CLRE 253,A00,507199,Vaida; Florin,9994,0,9999,5
1714610245124,CLRE 253,B00,507202,Vaida; Florin,9999,0,9999,0
1714610246149,CLRE 259,A00,507211,Patel; Hemal,9996,0,9999,3
1714610247173,CLRE 260,A00,507221,Cuomo; Raphael Eduardo,9999,0,9999,0
1714610248201,CLRE 297,001,507242,Cuomo; Raphael Eduardo,9999,0,9999,0
1714610249228,COGS 197,001,638244,Voytek; Bradley Thomas,9998,0,9999,1
1714610250253,CSE 191,A00,516875,Minnes Kemp; Mor Mia,9992,0,9999,7
1714610251280,CSE 197,001,637388,Minnes Kemp; Mor Mia,9998,0,9999,1
1714610252307,CSS 201S,A01,494383,Staff,35,0,35,0
1714610253334,CSS 202S,A01,494387,Staff,35,0,35,0
1714610254365,DSC 197,001,628532,Eldridge; Justin Matthew,9996,0,9999,3
1714610255390,EAP 100,A00,516065,Staff,9797,0,9999,202
1714610256418,ECE 45,A01,507414,Staff,33,0,60,27
1714610258468,ECE 111,A01,507420,Staff,15,0,50,35
1714610259496,ECE 197,001,548057,Sievenpiper; Daniel F.,9993,0,9999,6
1714610260521,EDS 115,A00,507243,Choi; Bailey Miyeon,10,0,28,18
1714610261551,EDS 117,A01,494379,Staff,1,5,30,29
1714610262577,EDS 125,A00,507246,Hopkins; Megan Beth,9,0,30,21
1714610263606,EDS 128A,A01,507264,Fargason; Sharon Gayle,8,0,26,18
1714610264631,EDS 128B,A01,507293,Pappas; Elizabeth,12,0,30,18
1714610265660,EDS 139,A00,507294,Fargason; Sharon Gayle,13,0,30,17
1714610265660,EDS 139,B00,507313,Pappas; Elizabeth,13,0,30,17
1714610266685,EDS 201,A00,507315,Staff,13,0,30,17
1714610267710,EDS 203,A01,507317,Halter; Christopher P.,12,0,30,18
1714610268735,EDS 204R,A01,507319,Halter; Christopher P.,0,3,30,30
1714610268735,EDS 204R,B01,507331,Heinzman; Erica M.,16,0,30,14
1714610269763,EDS 206R,A00,507332,Staff,0,4,30,30
1714610269763,EDS 206R,B00,507343,Staff,17,0,30,13
1714610270792,EDS 250,A00,507344,Hemans; Patricia Ann Benitez,22,0,40,18
1714610271819,EDS 281,A00,507345,Daly; Alan J.,18,0,18,0
1714610272843,EDS 284,A00,507350,Daly; Alan J.,16,0,16,0
1714610273868,EDS 286,A00,507359,Fine; Sarah,18,0,18,0
1714610274893,EDS 289C,A01,507361,Daly; Alan J.,18,0,18,0
1714610275918,EDS 290,A00,507366,Hofstetter; Carolyn,15,0,15,0
1714610276948,LIGM 5A,A00,507421,Fischer-Grunski; Eva K,18,0,20,2
1714610277975,LIGM 5B,A00,507423,Fischer-Grunski; Eva K,19,0,20,1
1714610279002,LIGM 5C,A00,507425,Fischer-Grunski; Eva K,19,0,20,1
1714610280028,LIIT 5AS,A00,507427,Carnelos; Chiara,20,0,20,0
1714610281052,LIIT 5BS,A00,507430,Carnelos; Chiara,20,0,20,0
1714610282078,LIIT 5CS,A00,507432,Carnelos; Chiara,20,0,20,0
1714610283107,LISP 5A,A00,507541,Munoz Sanchez; Alicia,11,0,20,9
1714610284132,LISP 5B,A00,507671,Munoz Sanchez; Alicia,8,0,20,12
1714610285156,LISP 5C,A00,507696,Munoz Sanchez; Alicia,9,0,20,11
1714610286182,MAE 197,001,528363,Boechler; Nicholas Sebastia,9998,0,9999,1
1714610287218,MATH 197,001,523477,Kedlaya; Kiran S.,9995,0,9999,4
1714610287218,MATH 197,002,563811,Zhang; Danna,9995,0,9999,4
1714610287218,MATH 197,003,628552,Dumitriu; Ioana,9998,0,9999,1
1714610288246,MCWP 40R,A00,518780,Staff,2,0,20,18
1714610288246,MCWP 40R,B00,518781,Staff,8,0,20,12
1714610288246,MCWP 40R,C00,518783,Staff,6,0,20,14
1714610289278,MCWP 50R,A00,518791,Staff,0,0,20,20
1714610289278,MCWP 50R,B00,518792,Staff,0,2,20,20
1714610289278,MCWP 50R,C00,518793,Staff,0,2,20,20
1714610289278,MCWP 50R,D00,518794,Staff,0,0,20,20
1714610289278,MCWP 50R,E00,518795,Staff,0,2,20,20
1714610289278,MCWP 50R,F00,518796,Staff,0,0,20,20
1714610289278,MCWP 50R,G00,518797,Staff,0,1,20,20
1714610290307,MMW 12R,A01,514034,Herbst; Matthew,0,0,16,16
1714610290307,MMW 12R,A02,514035,Herbst; Matthew,1,0,16,15
1714610291335,MMW 13R,A01,514037,Staff,0,4,16,16
1714610291335,MMW 13R,A02,514039,Staff,0,2,16,16
1714610291335,MMW 13R,A03,628519,Staff,0,2,16,16
1714610293389,SIO 295LS,A00,523233,Staff,10,0,30,20
1714610294415,SIO 295S,A00,523232,Staff,10,0,30,20
1714610295444,SIOC 290S,A01,637330,Merrifield; Mark A,23,0,30,7
1714610296468,SIOC 291S,A01,637333,Gabriel; Corey John,23,0,30,7
1714610297495,SOCI 117,A01,494376,Staff,0,4,5,5
1714610298522,WES 237B,A00,494380,Staff,9,0,20,11
1714610300589,AESE 279B,A00,494370,Wade; Jon P,0,0,33,33
1714610301616,AIP 197,001,627712,Vespa; Emanuel Ignacio,9998,0,9999,1
1714610302642,ANAR 135S,A00,494369,Braswell; Geoffrey E.,0,0,0,0
1714610303670,BENG 196,001,628496,Engler; Adam J.,9998,0,9999,1
1714610304698,CAT 124RS,A01,519847,Geibel; William,0,0,20,20
1714610305723,CAT 125RS,A01,515971,Geibel; William,0,0,20,20
1714610306748,CLRE 250,A00,511389,Morris; Sheldon,9993,0,9999,6
1714610307782,CLRE 251,A00,507176,Mehta; Ravindra L.,9993,0,9999,6
1714610307782,CLRE 251,B00,511410,Mehta; Ravindra L.,9998,0,9999,1
1714610308807,CLRE 252,A00,507189,Cuomo; Raphael Eduardo,9995,0,9999,4
1714610309833,CLRE 253,A00,507199,Vaida; Florin,9994,0,9999,5
1714610309833,CLRE 253,B00,507202,Vaida; Florin,9999,0,9999,0
1714610310864,CLRE 259,A00,507211,Patel; Hemal,9996,0,9999,3
1714610311892,CLRE 260,A00,507221,Cuomo; Raphael Eduardo,9999,0,9999,0
1714610312920,CLRE 297,001,507242,Cuomo; Raphael Eduardo,9999,0,9999,0
1714610313949,COGS 197,001,638244,Voytek; Bradley Thomas,9998,0,9999,1
1714610314973,CSE 191,A00,516875,Minnes Kemp; Mor Mia,9992,0,9999,7
1714610315999,CSE 197,001,637388,Minnes Kemp; Mor Mia,9998,0,9999,1
1714610317028,CSS 201S,A01,494383,Staff,35,0,35,0
1714610318053,CSS 202S,A01,494387,Staff,35,0,35,0
1714610319080,DSC 197,001,628532,Eldridge; Justin Matthew,9996,0,9999,3
1714610320107,EAP 100,A00,516065,Staff,9797,0,9999,202
1714610321132,ECE 45,A01,507414,Staff,33,0,60,27
1714610323186,ECE 111,A01,507420,Staff,15,0,50,35
1714610324211,ECE 197,001,548057,Sievenpiper; Daniel F.,9993,0,9999,6
1714610325240,EDS 115,A00,507243,Choi; Bailey Miyeon,10,0,28,18
1714610326265,EDS 117,A01,494379,Staff,1,5,30,29
1714610327295,EDS 125,A00,507246,Hopkins; Megan Beth,9,0,30,21
1714610328324,EDS 128A,A01,507264,Fargason; Sharon Gayle,8,0,26,18
1714610329348,EDS 128B,A01,507293,Pappas; Elizabeth,12,0,30,18
1714610330375,EDS 139,A00,507294,Fargason; Sharon Gayle,13,0,30,17
1714610330375,EDS 139,B00,507313,Pappas; Elizabeth,13,0,30,17
1714610331399,EDS 201,A00,507315,Staff,13,0,30,17
1714610332429,EDS 203,A01,507317,Halter; Christopher P.,12,0,30,18
1714610333455,EDS 204R,A01,507319,Halter; Christopher P.,0,3,30,30
1714610333455,EDS 204R,B01,507331,Heinzman; Erica M.,16,0,30,14
1714610334482,EDS 206R,A00,507332,Staff,0,4,30,30
1714610334482,EDS 206R,B00,507343,Staff,17,0,30,13
1714610335510,EDS 250,A00,507344,Hemans; Patricia Ann Benitez,22,0,40,18
1714610336538,EDS 281,A00,507345,Daly; Alan J.,18,0,18,0
1714610337567,EDS 284,A00,507350,Daly; Alan J.,16,0,16,0
1714610338597,EDS 286,A00,507359,Fine; Sarah,18,0,18,0
1714610339622,EDS 289C,A01,507361,Daly; Alan J.,18,0,18,0
1714610340650,EDS 290,A00,507366,Hofstetter; Carolyn,15,0,15,0
1714610341676,LIGM 5A,A00,507421,Fischer-Grunski; Eva K,18,0,20,2
1714610342701,LIGM 5B,A00,507423,Fischer-Grunski; Eva K,19,0,20,1
1714610343728,LIGM 5C,A00,507425,Fischer-Grunski; Eva K,19,0,20,1
1714610344754,LIIT 5AS,A00,507427,Carnelos; Chiara,20,0,20,0
1714610345778,LIIT 5BS,A00,507430,Carnelos; Chiara,20,0,20,0
1714610346805,LIIT 5CS,A00,507432,Carnelos; Chiara,20,0,20,0
1714610347830,LISP 5A,A00,507541,Munoz Sanchez; Alicia,11,0,20,9
1714610348857,LISP 5B,A00,507671,Munoz Sanchez; Alicia,8,0,20,12
1714610349884,LISP 5C,A00,507696,Munoz Sanchez; Alicia,9,0,20,11
1714610350911,MAE 197,001,528363,Boechler; Nicholas Sebastia,9998,0,9999,1
1714610351937,MATH 197,001,523477,Kedlaya; Kiran S.,9995,0,9999,4
1714610351937,MATH 197,002,563811,Zhang; Danna,9995,0,9999,4
1714610351937,MATH 197,003,628552,Dumitriu; Ioana,9998,0,9999,1
1714610352962,MCWP 40R,A00,518780,Staff,2,0,20,18
1714610352962,MCWP 40R,B00,518781,Staff,8,0,20,12
1714610352962,MCWP 40R,C00,518783,Staff,6,0,20,14
1714610353988,MCWP 50R,A00,518791,Staff,0,0,20,20
1714610353988,MCWP 50R,B00,518792,Staff,0,2,20,20
1714610353988,MCWP 50R,C00,518793,Staff,0,2,20,20
1714610353988,MCWP 50R,D00,518794,Staff,0,0,20,20
1714610353988,MCWP 50R,E00,518795,Staff,0,2,20,20
1714610353988,MCWP 50R,F00,518796,Staff,0,0,20,20
1714610353988,MCWP 50R,G00,518797,Staff,0,1,20,20
1714610355019,MMW 12R,A01,514034,Herbst; Matthew,0,0,16,16
1714610355019,MMW 12R,A02,514035,Herbst; Matthew,1,0,16,15
1714610356049,MMW 13R,A01,514037,Staff,0,4,16,16
1714610356049,MMW 13R,A02,514039,Staff,0,2,16,16
1714610356049,MMW 13R,A03,628519,Staff,0,2,16,16
1714610358102,SIO 295LS,A00,523233,Staff,10,0,30,20
1714610359130,SIO 295S,A00,523232,Staff,10,0,30,20
1714610360162,SIOC 290S,A01,637330,Merrifield; Mark A,23,0,30,7
1714610361187,SIOC 291S,A01,637333,Gabriel; Corey John,23,0,30,7
1714610362212,SOCI 117,A01,494376,Staff,0,4,5,5
1714610363239,WES 237B,A00,494380,Staff,9,0,20,11
1714610365312,AESE 279B,A00,494370,Wade; Jon P,0,0,33,33
1714610366337,AIP 197,001,627712,Vespa; Emanuel Ignacio,9998,0,9999,1
1714610367362,ANAR 135S,A00,494369,Braswell; Geoffrey E.,0,0,0,0
1714610368388,BENG 196,001,628496,Engler; Adam J.,9998,0,9999,1
1714610369413,CAT 124RS,A01,519847,Geibel; William,0,0,20,20
1714610370439,CAT 125RS,A01,515971,Geibel; William,0,0,20,20
1714610371468,CLRE 250,A00,511389,Morris; Sheldon,9993,0,9999,6
1714610372496,CLRE 251,A00,507176,Mehta; Ravindra L.,9993,0,9999,6
1714610372496,CLRE 251,B00,511410,Mehta; Ravindra L.,9998,0,9999,1
1714610373523,CLRE 252,A00,507189,Cuomo; Raphael Eduardo,9995,0,9999,4
1714610374552,CLRE 253,A00,507199,Vaida; Florin,9994,0,9999,5
1714610374552,CLRE 253,B00,507202,Vaida; Florin,9999,0,9999,0
1714610375577,CLRE 259,A00,507211,Patel; Hemal,9996,0,9999,3
1714610376602,CLRE 260,A00,507221,Cuomo; Raphael Eduardo,9999,0,9999,0
1714610377628,CLRE 297,001,507242,Cuomo; Raphael Eduardo,9999,0,9999,0
1714610378652,COGS 197,001,638244,Voytek; Bradley Thomas,9998,0,9999,1
1714610379681,CSE 191,A00,516875,Minnes Kemp; Mor Mia,9992,0,9999,7
1714610380708,CSE 197,001,637388,Minnes Kemp; Mor Mia,9998,0,9999,1
1714610381792,CSS 201S,A01,494383,Staff,35,0,35,0
1714610382821,CSS 202S,A01,494387,Staff,35,0,35,0
1714610383845,DSC 197,001,628532,Eldridge; Justin Matthew,9996,0,9999,3
1714610384871,EAP 100,A00,516065,Staff,9797,0,9999,202
1714610385900,ECE 45,A01,507414,Staff,33,0,60,27
1714610387954,ECE 111,A01,507420,Staff,15,0,50,35
1714610388982,ECE 197,001,548057,Sievenpiper; Daniel F.,9993,0,9999,6
1714610390014,EDS 115,A00,507243,Choi; Bailey Miyeon,10,0,28,18
1714610391041,EDS 117,A01,494379,Staff,1,5,30,29
1714610392066,EDS 125,A00,507246,Hopkins; Megan Beth,9,0,30,21
1714610393091,EDS 128A,A01,507264,Fargason; Sharon Gayle,8,0,26,18
1714610394120,EDS 128B,A01,507293,Pappas; Elizabeth,12,0,30,18
1714610395147,EDS 139,A00,507294,Fargason; Sharon Gayle,13,0,30,17
1714610395147,EDS 139,B00,507313,Pappas; Elizabeth,13,0,30,17
1714610396170,EDS 201,A00,507315,Staff,13,0,30,17
1714610397196,EDS 203,A01,507317,Halter; Christopher P.,12,0,30,18
1714610398221,EDS 204R,A01,507319,Halter; Christopher P.,0,3,30,30
1714610398221,EDS 204R,B01,507331,Heinzman; Erica M.,16,0,30,14
1714610399246,EDS 206R,A00,507332,Staff,0,4,30,30
1714610399246,EDS 206R,B00,507343,Staff,17,0,30,13
1714610400270,EDS 250,A00,507344,Hemans; Patricia Ann Benitez,22,0,40,18
1714610401300,EDS 281,A00,507345,Daly; Alan J.,18,0,18,0
1714610402325,EDS 284,A00,507350,Daly; Alan J.,16,0,16,0
1714610403351,EDS 286,A00,507359,Fine; Sarah,18,0,18,0
1714610404376,EDS 289C,A01,507361,Daly; Alan J.,18,0,18,0
1714610405402,EDS 290,A00,507366,Hofstetter; Carolyn,15,0,15,0
1714610406433,LIGM 5A,A00,507421,Fischer-Grunski; Eva K,18,0,20,2
1714610407456,LIGM 5B,A00,507423,Fischer-Grunski; Eva K,19,0,20,1
1714610408482,LIGM 5C,A00,507425,Fischer-Grunski; Eva K,19,0,20,1
1714610409514,LIIT 5AS,A00,507427,Carnelos; Chiara,20,0,20,0
1714610410542,LIIT 5BS,A00,507430,Carnelos; Chiara,20,0,20,0
1714610411567,LIIT 5CS,A00,507432,Carnelos; Chiara,20,0,20,0
1714610412591,LISP 5A,A00,507541,Munoz Sanchez; Alicia,11,0,20,9
1714610413620,LISP 5B,A00,507671,Munoz Sanchez; Alicia,8,0,20,12
1714610414645,LISP 5C,A00,507696,Munoz Sanchez; Alicia,9,0,20,11
1714610415671,MAE 197,001,528363,Boechler; Nicholas Sebastia,9998,0,9999,1
1714610416701,MATH 197,001,523477,Kedlaya; Kiran S.,9995,0,9999,4
1714610416701,MATH 197,002,563811,Zhang; Danna,9995,0,9999,4
1714610416701,MATH 197,003,628552,Dumitriu; Ioana,9998,0,9999,1
1714610417729,MCWP 40R,A00,518780,Staff,2,0,20,18
1714610417729,MCWP 40R,B00,518781,Staff,8,0,20,12
1714610417729,MCWP 40R,C00,518783,Staff,6,0,20,14
1714610418758,MCWP 50R,A00,518791,Staff,0,0,20,20
1714610418758,MCWP 50R,B00,518792,Staff,0,2,20,20
1714610418758,MCWP 50R,C00,518793,Staff,0,2,20,20
1714610418758,MCWP 50R,D00,518794,Staff,0,0,20,20
1714610418758,MCWP 50R,E00,518795,Staff,0,2,20,20
1714610418758,MCWP 50R,F00,518796,Staff,0,0,20,20
1714610418758,MCWP 50R,G00,518797,Staff,0,1,20,20
1714610419786,MMW 12R,A01,514034,Herbst; Matthew,0,0,16,16
1714610419786,MMW 12R,A02,514035,Herbst; Matthew,1,0,16,15
1714610420811,MMW 13R,A01,514037,Staff,0,4,16,16
1714610420811,MMW 13R,A02,514039,Staff,0,2,16,16
1714610420811,MMW 13R,A03,628519,Staff,0,2,16,16
1714610422860,SIO 295LS,A00,523233,Staff,10,0,30,20
1714610423886,SIO 295S,A00,523232,Staff,10,0,30,20
1714610424911,SIOC 290S,A01,637330,Merrifield; Mark A,23,0,30,7
1714610425938,SIOC 291S,A01,637333,Gabriel; Corey John,23,0,30,7
1714610426963,SOCI 117,A01,494376,Staff,0,4,5,5
1714610427990,WES 237B,A00,494380,Staff,9,0,20,11
1714610430057,AESE 279B,A00,494370,Wade; Jon P,0,0,33,33
1714610431081,AIP 197,001,627712,Vespa; Emanuel Ignacio,9998,0,9999,1
1714610432107,ANAR 135S,A00,494369,Braswell; Geoffrey E.,0,0,0,0
1714610433131,BENG 196,001,628496,Engler; Adam J.,9998,0,9999,1
1714610434158,CAT 124RS,A01,519847,Geibel; William,0,0,20,20
1714610435191,CAT 125RS,A01,515971,Geibel; William,0,0,20,20
1714610436214,CLRE 250,A00,511389,Morris; Sheldon,9993,0,9999,6
1714610437240,CLRE 251,A00,507176,Mehta; Ravindra L.,9993,0,9999,6
1714610437240,CLRE 251,B00,511410,Mehta; Ravindra L.,9998,0,9999,1
1714610438265,CLRE 252,A00,507189,Cuomo; Raphael Eduardo,9995,0,9999,4
1714610439290,CLRE 253,A00,507199,Vaida; Florin,9994,0,9999,5
1714610439290,CLRE 253,B00,507202,Vaida; Florin,9999,0,9999,0
1714610440316,CLRE 259,A00,507211,Patel; Hemal,9996,0,9999,3
1714610441338,CLRE 260,A00,507221,Cuomo; Raphael Eduardo,9999,0,9999,0
1714610442365,CLRE 297,001,507242,Cuomo; Raphael Eduardo,9999,0,9999,0
1714610443391,COGS 197,001,638244,Voytek; Bradley Thomas,9998,0,9999,1
1714610444418,CSE 191,A00,516875,Minnes Kemp; Mor Mia,9992,0,9999,7
1714610445499,CSE 197,001,637388,Minnes Kemp; Mor Mia,9998,0,9999,1
1714610446524,CSS 201S,A01,494383,Staff,35,0,35,0
1714610447548,CSS 202S,A01,494387,Staff,35,0,35,0
1714610448573,DSC 197,001,628532,Eldridge; Justin Matthew,9996,0,9999,3
1714610449596,EAP 100,A00,516065,Staff,9797,0,9999,202
1714610450621,ECE 45,A01,507414,Staff,33,0,60,27
1714610452720,ECE 111,A01,507420,Staff,15,0,50,35
1714610453748,ECE 197,001,548057,Sievenpiper; Daniel F.,9993,0,9999,6
1714610454774,EDS 115,A00,507243,Choi; Bailey Miyeon,10,0,28,18
1714610455804,EDS 117,A01,494379,Staff,1,5,30,29
1714610456830,EDS 125,A00,507246,Hopkins; Megan Beth,9,0,30,21
1714610457857,EDS 128A,A01,507264,Fargason; Sharon Gayle,8,0,26,18
1714610458885,EDS 128B,A01,507293,Pappas; Elizabeth,12,0,30,18
1714610459913,EDS 139,A00,507294,Fargason; Sharon Gayle,13,0,30,17
1714610459913,EDS 139,B00,507313,Pappas; Elizabeth,13,0,30,17
1714610460939,EDS 201,A00,507315,Staff,13,0,30,17
1714610461969,EDS 203,A01,507317,Halter; Christopher P.,12,0,30,18
1714610462994,EDS 204R,A01,507319,Halter; Christopher P.,0,3,30,30
1714610462994,EDS 204R,B01,507331,Heinzman; Erica M.,16,0,30,14
1714610464020,EDS 206R,A00,507332,Staff,0,4,30,30
1714610464020,EDS 206R,B00,507343,Staff,17,0,30,13
1714610465046,EDS 250,A00,507344,Hemans; Patricia Ann Benitez,22,0,40,18
1714610466071,EDS 281,A00,507345,Daly; Alan J.,18,0,18,0
1714610467094,EDS 284,A00,507350,Daly; Alan J.,16,0,16,0
1714610468121,EDS 286,A00,507359,Fine; Sarah,18,0,18,0
1714610469147,EDS 289C,A01,507361,Daly; Alan J.,18,0,18,0
1714610470172,EDS 290,A00,507366,Hofstetter; Carolyn,15,0,15,0
1714610471205,LIGM 5A,A00,507421,Fischer-Grunski; Eva K,18,0,20,2
1714610472236,LIGM 5B,A00,507423,Fischer-Grunski; Eva K,19,0,20,1
1714610473262,LIGM 5C,A00,507425,Fischer-Grunski; Eva K,19,0,20,1
1714610474290,LIIT 5AS,A00,507427,Carnelos; Chiara,20,0,20,0
1714610475313,LIIT 5BS,A00,507430,Carnelos; Chiara,20,0,20,0
1714610476337,LIIT 5CS,A00,507432,Carnelos; Chiara,20,0,20,0
1714610477363,LISP 5A,A00,507541,Munoz Sanchez; Alicia,11,0,20,9
1714610478390,LISP 5B,A00,507671,Munoz Sanchez; Alicia,8,0,20,12
1714610479417,LISP 5C,A00,507696,Munoz Sanchez; Alicia,9,0,20,11
1714610480448,MAE 197,001,528363,Boechler; Nicholas Sebastia,9998,0,9999,1
1714610481493,MATH 197,001,523477,Kedlaya; Kiran S.,9995,0,9999,4
1714610481493,MATH 197,002,563811,Zhang; Danna,9995,0,9999,4
1714610481493,MATH 197,003,628552,Dumitriu; Ioana,9998,0,9999,1
1714610482517,MCWP 40R,A00,518780,Staff,2,0,20,18
1714610482517,MCWP 40R,B00,518781,Staff,8,0,20,12
1714610482517,MCWP 40R,C00,518783,Staff,6,0,20,14
1714610483543,MCWP 50R,A00,518791,Staff,0,0,20,20
1714610483543,MCWP 50R,B00,518792,Staff,0,2,20,20
1714610483543,MCWP 50R,C00,518793,Staff,0,2,20,20
1714610483543,MCWP 50R,D00,518794,Staff,0,0,20,20
1714610483543,MCWP 50R,E00,518795,Staff,0,2,20,20
1714610483543,MCWP 50R,F00,518796,Staff,0,0,20,20
1714610483543,MCWP 50R,G00,518797,Staff,0,1,20,20
1714610484567,MMW 12R,A01,514034,Herbst; Matthew,0,0,16,16
1714610484567,MMW 12R,A02,514035,Herbst; Matthew,1,0,16,15
1714610485593,MMW 13R,A01,514037,Staff,0,4,16,16
1714610485593,MMW 13R,A02,514039,Staff,0,2,16,16
1714610485593,MMW 13R,A03,628519,Staff,0,2,16,16
1714610487642,SIO 295LS,A00,523233,Staff,10,0,30,20
1714610488668,SIO 295S,A00,523232,Staff,10,0,30,20
1714610489694,SIOC 290S,A01,637330,Merrifield; Mark A,23,0,30,7
1714610490718,SIOC 291S,A01,637333,Gabriel; Corey John,23,0,30,7
1714610491743,SOCI 117,A01,494376,Staff,0,4,5,5
1714610492768,WES 237B,A00,494380,Staff,9,0,20,11
1714610494838,AESE 279B,A00,494370,Wade; Jon P,0,0,33,33
1714610495865,AIP 197,001,627712,Vespa; Emanuel Ignacio,9998,0,9999,1
1714610496891,ANAR 135S,A00,494369,Braswell; Geoffrey E.,0,0,0,0
1714610497916,BENG 196,001,628496,Engler; Adam J.,9998,0,9999,1
1714610498944,CAT 124RS,A01,519847,Geibel; William,0,0,20,20
1714610499971,CAT 125RS,A01,515971,Geibel; William,0,0,20,20
1714610501002,CLRE 250,A00,511389,Morris; Sheldon,9993,0,9999,6
1714610502030,CLRE 251,A00,507176,Mehta; Ravindra L.,9993,0,9999,6
1714610502030,CLRE 251,B00,511410,Mehta; Ravindra L.,9998,0,9999,1
1714610503056,CLRE 252,A00,507189,Cuomo; Raphael Eduardo,9995,0,9999,4
1714610504084,CLRE 253,A00,507199,Vaida; Florin,9994,0,9999,5
1714610504084,CLRE 253,B00,507202,Vaida; Florin,9999,0,9999,0
1714610505110,CLRE 259,A00,507211,Patel; Hemal,9996,0,9999,3
1714610506135,CLRE 260,A00,507221,Cuomo; Raphael Eduardo,9999,0,9999,0
1714610507163,CLRE 297,001,507242,Cuomo; Raphael Eduardo,9999,0,9999,0
1714610508189,COGS 197,001,638244,Voytek; Bradley Thomas,9998,0,9999,1
1714610509218,CSE 191,A00,516875,Minnes Kemp; Mor Mia,9992,0,9999,7
1714610510245,CSE 197,001,637388,Minnes Kemp; Mor Mia,9998,0,9999,1
1714610511273,CSS 201S,A01,494383,Staff,35,0,35,0
1714610512303,CSS 202S,A01,494387,Staff,35,0,35,0
1714610513328,DSC 197,001,628532,Eldridge; Justin Matthew,9996,0,9999,3
1714610514354,EAP 100,A00,516065,Staff,9797,0,9999,202
1714610515384,ECE 45,A01,507414,Staff,33,0,60,27
1714610517438,ECE 111,A01,507420,Staff,15,0,50,35
1714610518465,ECE 197,001,548057,Sievenpiper; Daniel F.,9993,0,9999,6
1714610519492,EDS 115,A00,507243,Choi; Bailey Miyeon,10,0,28,18
1714610520518,EDS 117,A01,494379,Staff,1,5,30,29
1714610521545,EDS 125,A00,507246,Hopkins; Megan Beth,9,0,30,21
1714610522576,EDS 128A,A01,507264,Fargason; Sharon Gayle,8,0,26,18
1714610523601,EDS 128B,A01,507293,Pappas; Elizabeth,12,0,30,18
1714610524628,EDS 139,A00,507294,Fargason; Sharon Gayle,13,0,30,17
1714610524628,EDS 139,B00,507313,Pappas; Elizabeth,13,0,30,17
1714610525653,EDS 201,A00,507315,Staff,13,0,30,17
1714610526679,EDS 203,A01,507317,Halter; Christopher P.,12,0,30,18
1714610527704,EDS 204R,A01,507319,Halter; Christopher P.,0,3,30,30
1714610527704,EDS 204R,B01,507331,Heinzman; Erica M.,16,0,30,14
1714610528729,EDS 206R,A00,507332,Staff,0,4,30,30
1714610528729,EDS 206R,B00,507343,Staff,17,0,30,13
1714610529755,EDS 250,A00,507344,Hemans; Patricia Ann Benitez,22,0,40,18
1714610530782,EDS 281,A00,507345,Daly; Alan J.,18,0,18,0
1714610531808,EDS 284,A00,507350,Daly; Alan J.,16,0,16,0
1714610532834,EDS 286,A00,507359,Fine; Sarah,18,0,18,0
1714610533858,EDS 289C,A01,507361,Daly; Alan J.,18,0,18,0
1714610534883,EDS 290,A00,507366,Hofstetter; Carolyn,15,0,15,0
1714610535909,LIGM 5A,A00,507421,Fischer-Grunski; Eva K,18,0,20,2
1714610536936,LIGM 5B,A00,507423,Fischer-Grunski; Eva K,19,0,20,1
1714610537964,LIGM 5C,A00,507425,Fischer-Grunski; Eva K,19,0,20,1
1714610538991,LIIT 5AS,A00,507427,Carnelos; Chiara,20,0,20,0
1714610540020,LIIT 5BS,A00,507430,Carnelos; Chiara,20,0,20,0
1714610541045,LIIT 5CS,A00,507432,Carnelos; Chiara,20,0,20,0
1714610542072,LISP 5A,A00,507541,Munoz Sanchez; Alicia,11,0,20,9
1714610543096,LISP 5B,A00,507671,Munoz Sanchez; Alicia,8,0,20,12
1714610544122,LISP 5C,A00,507696,Munoz Sanchez; Alicia,9,0,20,11
1714610545149,MAE 197,001,528363,Boechler; Nicholas Sebastia,9998,0,9999,1
1714610546178,MATH 197,001,523477,Kedlaya; Kiran S.,9995,0,9999,4
1714610546178,MATH 197,002,563811,Zhang; Danna,9995,0,9999,4
1714610546178,MATH 197,003,628552,Dumitriu; Ioana,9998,0,9999,1
1714610547203,MCWP 40R,A00,518780,Staff,2,0,20,18
1714610547203,MCWP 40R,B00,518781,Staff,8,0,20,12
1714610547203,MCWP 40R,C00,518783,Staff,6,0,20,14
1714610548233,MCWP 50R,A00,518791,Staff,0,0,20,20
1714610548233,MCWP 50R,B00,518792,Staff,0,2,20,20
1714610548233,MCWP 50R,C00,518793,Staff,0,2,20,20
1714610548233,MCWP 50R,D00,518794,Staff,0,0,20,20
1714610548233,MCWP 50R,E00,518795,Staff,0,2,20,20
1714610548233,MCWP 50R,F00,518796,Staff,0,0,20,20
1714610548233,MCWP 50R,G00,518797,Staff,0,1,20,20
1714610549260,MMW 12R,A01,514034,Herbst; Matthew,0,0,16,16
1714610549260,MMW 12R,A02,514035,Herbst; Matthew,1,0,16,15
1714610550291,MMW 13R,A01,514037,Staff,0,4,16,16
1714610550291,MMW 13R,A02,514039,Staff,0,2,16,16
1714610550291,MMW 13R,A03,628519,Staff,0,2,16,16
1714610552343,SIO 295LS,A00,523233,Staff,10,0,30,20
1714610553368,SIO 295S,A00,523232,Staff,10,0,30,20
1714610554394,SIOC 290S,A01,637330,Merrifield; Mark A,23,0,30,7
1714610555419,SIOC 291S,A01,637333,Gabriel; Corey John,23,0,30,7
1714610556446,SOCI 117,A01,494376,Staff,0,4,5,5
1714610557470,WES 237B,A00,494380,Staff,9,0,20,11
1714610559534,AESE 279B,A00,494370,Wade; Jon P,0,0,33,33
1714610560560,AIP 197,001,627712,Vespa; Emanuel Ignacio,9998,0,9999,1
1714610561585,ANAR 135S,A00,494369,Braswell; Geoffrey E.,0,0,0,0
1714610562609,BENG 196,001,628496,Engler; Adam J.,9998,0,9999,1
1714610563632,CAT 124RS,A01,519847,Geibel; William,0,0,20,20
1714610564657,CAT 125RS,A01,515971,Geibel; William,0,0,20,20
1714610565688,CLRE 250,A00,511389,Morris; Sheldon,9993,0,9999,6
1714610566718,CLRE 251,A00,507176,Mehta; Ravindra L.,9993,0,9999,6
1714610566718,CLRE 251,B00,511410,Mehta; Ravindra L.,9998,0,9999,1
1714610567748,CLRE 252,A00,507189,Cuomo; Raphael Eduardo,9995,0,9999,4
1714610568774,CLRE 253,A00,507199,Vaida; Florin,9994,0,9999,5
1714610568774,CLRE 253,B00,507202,Vaida; Florin,9999,0,9999,0
1714610569799,CLRE 259,A00,507211,Patel; Hemal,9996,0,9999,3
1714610570826,CLRE 260,A00,507221,Cuomo; Raphael Eduardo,9999,0,9999,0
1714610571852,CLRE 297,001,507242,Cuomo; Raphael Eduardo,9999,0,9999,0
1714610572881,COGS 197,001,638244,Voytek; Bradley Thomas,9998,0,9999,1
1714610573905,CSE 191,A00,516875,Minnes Kemp; Mor Mia,9992,0,9999,7
1714610574930,CSE 197,001,637388,Minnes Kemp; Mor Mia,9998,0,9999,1
1714610575955,CSS 201S,A01,494383,Staff,35,0,35,0
1714610576980,CSS 202S,A01,494387,Staff,35,0,35,0
1714610578008,DSC 197,001,628532,Eldridge; Justin Matthew,9996,0,9999,3
1714610579033,EAP 100,A00,516065,Staff,9797,0,9999,202
1714610580058,ECE 45,A01,507414,Staff,33,0,60,27
1714610582107,ECE 111,A01,507420,Staff,15,0,50,35
1714610583136,ECE 197,001,548057,Sievenpiper; Daniel F.,9993,0,9999,6
1714610584163,EDS 115,A00,507243,Choi; Bailey Miyeon,10,0,28,18
1714610585192,EDS 117,A01,494379,Staff,1,5,30,29
1714610586220,EDS 125,A00,507246,Hopkins; Megan Beth,9,0,30,21
1714610587247,EDS 128A,A01,507264,Fargason; Sharon Gayle,8,0,26,18
1714610588279,EDS 128B,A01,507293,Pappas; Elizabeth,12,0,30,18
1714610589304,EDS 139,A00,507294,Fargason; Sharon Gayle,13,0,30,17
1714610589304,EDS 139,B00,507313,Pappas; Elizabeth,13,0,30,17
1714610590328,EDS 201,A00,507315,Staff,13,0,30,17
1714610591356,EDS 203,A01,507317,Halter; Christopher P.,12,0,30,18
1714610592384,EDS 204R,A01,507319,Halter; Christopher P.,0,3,30,30
1714610592384,EDS 204R,B01,507331,Heinzman; Erica M.,16,0,30,14
1714610593411,EDS 206R,A00,507332,Staff,0,4,30,30
1714610593411,EDS 206R,B00,507343,Staff,17,0,30,13
1714610594439,EDS 250,A00,507344,Hemans; Patricia Ann Benitez,22,0,40,18
1714610595464,EDS 281,A00,507345,Daly; Alan J.,18,0,18,0
1714610596491,EDS 284,A00,507350,Daly; Alan J.,16,0,16,0
1714610597516,EDS 286,A00,507359,Fine; Sarah,18,0,18,0
1714610598542,EDS 289C,A01,507361,Daly; Alan J.,18,0,18,0
1714610599568,EDS 290,A00,507366,Hofstetter; Carolyn,15,0,15,0
1714610600598,LIGM 5A,A00,507421,Fischer-Grunski; Eva K,18,0,20,2
1714610601624,LIGM 5B,A00,507423,Fischer-Grunski; Eva K,19,0,20,1
1714610602649,LIGM 5C,A00,507425,Fischer-Grunski; Eva K,19,0,20,1
1714610603679,LIIT 5AS,A00,507427,Carnelos; Chiara,20,0,20,0
1714610604706,LIIT 5BS,A00,507430,Carnelos; Chiara,20,0,20,0
1714610605733,LIIT 5CS,A00,507432,Carnelos; Chiara,20,0,20,0
1714610606758,LISP 5A,A00,507541,Munoz Sanchez; Alicia,11,0,20,9
1714610607785,LISP 5B,A00,507671,Munoz Sanchez; Alicia,8,0,20,12
1714610608814,LISP 5C,A00,507696,Munoz Sanchez; Alicia,9,0,20,11
1714610609843,MAE 197,001,528363,Boechler; Nicholas Sebastia,9998,0,9999,1
1714610610870,MATH 197,001,523477,Kedlaya; Kiran S.,9995,0,9999,4
1714610610870,MATH 197,002,563811,Zhang; Danna,9995,0,9999,4
1714610610870,MATH 197,003,628552,Dumitriu; Ioana,9998,0,9999,1
1714610611895,MCWP 40R,A00,518780,Staff,2,0,20,18
1714610611895,MCWP 40R,B00,518781,Staff,8,0,20,12
1714610611895,MCWP 40R,C00,518783,Staff,6,0,20,14
1714610612921,MCWP 50R,A00,518791,Staff,0,0,20,20
1714610612921,MCWP 50R,B00,518792,Staff,0,2,20,20
1714610612921,MCWP 50R,C00,518793,Staff,0,2,20,20
1714610612921,MCWP 50R,D00,518794,Staff,0,0,20,20
1714610612921,MCWP 50R,E00,518795,Staff,0,2,20,20
1714610612921,MCWP 50R,F00,518796,Staff,0,0,20,20
1714610612921,MCWP 50R,G00,518797,Staff,0,1,20,20
1714610613946,MMW 12R,A01,514034,Herbst; Matthew,0,0,16,16
1714610613946,MMW 12R,A02,514035,Herbst; Matthew,1,0,16,15
1714610614971,MMW 13R,A01,514037,Staff,0,4,16,16
1714610614971,MMW 13R,A02,514039,Staff,0,2,16,16
1714610614971,MMW 13R,A03,628519,Staff,0,2,16,16
1714610617026,SIO 295LS,A00,523233,Staff,10,0,30,20
1714610618057,SIO 295S,A00,523232,Staff,10,0,30,20
1714610619086,SIOC 290S,A01,637330,Merrifield; Mark A,23,0,30,7
1714610620110,SIOC 291S,A01,637333,Gabriel; Corey John,23,0,30,7
1714610621134,SOCI 117,A01,494376,Staff,0,4,5,5
1714610622162,WES 237B,A00,494380,Staff,9,0,20,11
1714610624236,AESE 279B,A00,494370,Wade; Jon P,0,0,33,33
1714610625263,AIP 197,001,627712,Vespa; Emanuel Ignacio,9998,0,9999,1
1714610626292,ANAR 135S,A00,494369,Braswell; Geoffrey E.,0,0,0,0
1714610627314,BENG 196,001,628496,Engler; Adam J.,9998,0,9999,1
1714610628340,CAT 124RS,A01,519847,Geibel; William,0,0,20,20
1714610629362,CAT 125RS,A01,515971,Geibel; William,0,0,20,20
1714610630402,CLRE 250,A00,511389,Morris; Sheldon,9993,0,9999,6
1714610631434,CLRE 251,A00,507176,Mehta; Ravindra L.,9993,0,9999,6
1714610631434,CLRE 251,B00,511410,Mehta; Ravindra L.,9998,0,9999,1
1714610632464,CLRE 252,A00,507189,Cuomo; Raphael Eduardo,9995,0,9999,4
1714610633489,CLRE 253,A00,507199,Vaida; Florin,9994,0,9999,5
1714610633489,CLRE 253,B00,507202,Vaida; Florin,9999,0,9999,0
1714610634513,CLRE 259,A00,507211,Patel; Hemal,9996,0,9999,3
1714610635537,CLRE 260,A00,507221,Cuomo; Raphael Eduardo,9999,0,9999,0
1714610636563,CLRE 297,001,507242,Cuomo; Raphael Eduardo,9999,0,9999,0
1714610637589,COGS 197,001,638244,Voytek; Bradley Thomas,9998,0,9999,1
1714610638613,CSE 191,A00,516875,Minnes Kemp; Mor Mia,9992,0,9999,7
1714610639639,CSE 197,001,637388,Minnes Kemp; Mor Mia,9998,0,9999,1
1714610640670,CSS 201S,A01,494383,Staff,35,0,35,0
1714610641697,CSS 202S,A01,494387,Staff,35,0,35,0
1714610642723,DSC 197,001,628532,Eldridge; Justin Matthew,9996,0,9999,3
1714610643747,EAP 100,A00,516065,Staff,9797,0,9999,202
1714610644775,ECE 45,A01,507414,Staff,33,0,60,27
1714610646826,ECE 111,A01,507420,Staff,15,0,50,35
1714610647851,ECE 197,001,548057,Sievenpiper; Daniel F.,9993,0,9999,6
1714610648877,EDS 115,A00,507243,Choi; Bailey Miyeon,10,0,28,18
1714610649904,EDS 117,A01,494379,Staff,1,5,30,29
1714610650932,EDS 125,A00,507246,Hopkins; Megan Beth,9,0,30,21
1714610651957,EDS 128A,A01,507264,Fargason; Sharon Gayle,8,0,26,18
1714610652982,EDS 128B,A01,507293,Pappas; Elizabeth,12,0,30,18
1714610654010,EDS 139,A00,507294,Fargason; Sharon Gayle,13,0,30,17
1714610654010,EDS 139,B00,507313,Pappas; Elizabeth,13,0,30,17
1714610655038,EDS 201,A00,507315,Staff,13,0,30,17
1714610656070,EDS 203,A01,507317,Halter; Christopher P.,12,0,30,18
1714610657099,EDS 204R,A01,507319,Halter; Christopher P.,0,3,30,30
1714610657099,EDS 204R,B01,507331,Heinzman; Erica M.,16,0,30,14
1714610658125,EDS 206R,A00,507332,Staff,0,4,30,30
1714610658125,EDS 206R,B00,507343,Staff,17,0,30,13
1714610659150,EDS 250,A00,507344,Hemans; Patricia Ann Benitez,22,0,40,18
1714610660175,EDS 281,A00,507345,Daly; Alan J.,18,0,18,0
1714610661199,EDS 284,A00,507350,Daly; Alan J.,16,0,16,0
1714610662235,EDS 286,A00,507359,Fine; Sarah,18,0,18,0
1714610663259,EDS 289C,A01,507361,Daly; Alan J.,18,0,18,0
1714610664283,EDS 290,A00,507366,Hofstetter; Carolyn,15,0,15,0
1714610665308,LIGM 5A,A00,507421,Fischer-Grunski; Eva K,18,0,20,2
1714610666338,LIGM 5B,A00,507423,Fischer-Grunski; Eva K,19,0,20,1
1714610667366,LIGM 5C,A00,507425,Fischer-Grunski; Eva K,19,0,20,1
1714610668391,LIIT 5AS,A00,507427,Carnelos; Chiara,20,0,20,0
1714610669415,LIIT 5BS,A00,507430,Carnelos; Chiara,20,0,20,0
1714610670440,LIIT 5CS,A00,507432,Carnelos; Chiara,20,0,20,0
1714610671466,LISP 5A,A00,507541,Munoz Sanchez; Alicia,11,0,20,9
1714610672489,LISP 5B,A00,507671,Munoz Sanchez; Alicia,8,0,20,12
1714610673514,LISP 5C,A00,507696,Munoz Sanchez; Alicia,9,0,20,11
1714610674538,MAE 197,001,528363,Boechler; Nicholas Sebastia,9998,0,9999,1
1714610675564,MATH 197,001,523477,Kedlaya; Kiran S.,9995,0,9999,4
1714610675564,MATH 197,002,563811,Zhang; Danna,9995,0,9999,4
1714610675564,MATH 197,003,628552,Dumitriu; Ioana,9998,0,9999,1
1714610676590,MCWP 40R,A00,518780,Staff,2,0,20,18
1714610676590,MCWP 40R,B00,518781,Staff,8,0,20,12
1714610676590,MCWP 40R,C00,518783,Staff,6,0,20,14
1714610677614,MCWP 50R,A00,518791,Staff,0,0,20,20
1714610677614,MCWP 50R,B00,518792,Staff,0,2,20,20
1714610677614,MCWP 50R,C00,518793,Staff,0,2,20,20
1714610677614,MCWP 50R,D00,518794,Staff,0,0,20,20
1714610677614,MCWP 50R,E00,518795,Staff,0,2,20,20
1714610677614,MCWP 50R,F00,518796,Staff,0,0,20,20
1714610677614,MCWP 50R,G00,518797,Staff,0,1,20,20
1714610678641,MMW 12R,A01,514034,Herbst; Matthew,0,0,16,16
1714610678641,MMW 12R,A02,514035,Herbst; Matthew,1,0,16,15
1714610679665,MMW 13R,A01,514037,Staff,0,4,16,16
1714610679665,MMW 13R,A02,514039,Staff,0,2,16,16
1714610679665,MMW 13R,A03,628519,Staff,0,2,16,16
1714610681714,SIO 295LS,A00,523233,Staff,10,0,30,20
1714610682738,SIO 295S,A00,523232,Staff,10,0,30,20
1714610683765,SIOC 290S,A01,637330,Merrifield; Mark A,23,0,30,7
1714610684793,SIOC 291S,A01,637333,Gabriel; Corey John,23,0,30,7
1714610685822,SOCI 117,A01,494376,Staff,0,4,5,5
1714610686851,WES 237B,A00,494380,Staff,9,0,20,11
1714610688926,AESE 279B,A00,494370,Wade; Jon P,0,0,33,33
1714610689950,AIP 197,001,627712,Vespa; Emanuel Ignacio,9998,0,9999,1
1714610690977,ANAR 135S,A00,494369,Braswell; Geoffrey E.,0,0,0,0
1714610692004,BENG 196,001,628496,Engler; Adam J.,9998,0,9999,1
1714610693030,CAT 124RS,A01,519847,Geibel; William,0,0,20,20
1714610694263,CAT 125RS,A01,515971,Geibel; William,0,0,20,20
1714610695290,CLRE 250,A00,511389,Morris; Sheldon,9993,0,9999,6
1714610696319,CLRE 251,A00,507176,Mehta; Ravindra L.,9993,0,9999,6
1714610696319,CLRE 251,B00,511410,Mehta; Ravindra L.,9998,0,9999,1
1714610697347,CLRE 252,A00,507189,Cuomo; Raphael Eduardo,9995,0,9999,4
1714610698376,CLRE 253,A00,507199,Vaida; Florin,9994,0,9999,5
1714610698376,CLRE 253,B00,507202,Vaida; Florin,9999,0,9999,0
1714610699401,CLRE 259,A00,507211,Patel; Hemal,9996,0,9999,3
1714610700426,CLRE 260,A00,507221,Cuomo; Raphael Eduardo,9999,0,9999,0
1714610701450,CLRE 297,001,507242,Cuomo; Raphael Eduardo,9999,0,9999,0
1714610702477,COGS 197,001,638244,Voytek; Bradley Thomas,9998,0,9999,1
1714610703504,CSE 191,A00,516875,Minnes Kemp; Mor Mia,9992,0,9999,7
1714610704528,CSE 197,001,637388,Minnes Kemp; Mor Mia,9998,0,9999,1
1714610705556,CSS 201S,A01,494383,Staff,35,0,35,0
1714610706581,CSS 202S,A01,494387,Staff,35,0,35,0
1714610707604,DSC 197,001,628532,Eldridge; Justin Matthew,9996,0,9999,3
1714610708633,EAP 100,A00,516065,Staff,9797,0,9999,202
1714610709661,ECE 45,A01,507414,Staff,33,0,60,27
1714610711739,ECE 111,A01,507420,Staff,15,0,50,35
1714610712763,ECE 197,001,548057,Sievenpiper; Daniel F.,9993,0,9999,6
1714610713791,EDS 115,A00,507243,Choi; Bailey Miyeon,10,0,28,18
1714610714815,EDS 117,A01,494379,Staff,1,5,30,29
1714610715838,EDS 125,A00,507246,Hopkins; Megan Beth,9,0,30,21
1714610716864,EDS 128A,A01,507264,Fargason; Sharon Gayle,8,0,26,18
1714610717893,EDS 128B,A01,507293,Pappas; Elizabeth,12,0,30,18
1714610718918,EDS 139,A00,507294,Fargason; Sharon Gayle,13,0,30,17
1714610718918,EDS 139,B00,507313,Pappas; Elizabeth,13,0,30,17
1714610719943,EDS 201,A00,507315,Staff,13,0,30,17
1714610720974,EDS 203,A01,507317,Halter; Christopher P.,12,0,30,18
1714610722002,EDS 204R,A01,507319,Halter; Christopher P.,0,3,30,30
1714610722002,EDS 204R,B01,507331,Heinzman; Erica M.,16,0,30,14
1714610723031,EDS 206R,A00,507332,Staff,0,4,30,30
1714610723031,EDS 206R,B00,507343,Staff,17,0,30,13
1714610724058,EDS 250,A00,507344,Hemans; Patricia Ann Benitez,22,0,40,18
1714610725085,EDS 281,A00,507345,Daly; Alan J.,18,0,18,0
1714610726113,EDS 284,A00,507350,Daly; Alan J.,16,0,16,0
1714610727143,EDS 286,A00,507359,Fine; Sarah,18,0,18,0
1714610728170,EDS 289C,A01,507361,Daly; Alan J.,18,0,18,0
1714610729195,EDS 290,A00,507366,Hofstetter; Carolyn,15,0,15,0
1714610730219,LIGM 5A,A00,507421,Fischer-Grunski; Eva K,18,0,20,2
1714610731248,LIGM 5B,A00,507423,Fischer-Grunski; Eva K,19,0,20,1
1714610732276,LIGM 5C,A00,507425,Fischer-Grunski; Eva K,19,0,20,1
1714610733301,LIIT 5AS,A00,507427,Carnelos; Chiara,20,0,20,0
1714610734325,LIIT 5BS,A00,507430,Carnelos; Chiara,20,0,20,0
1714610735353,LIIT 5CS,A00,507432,Carnelos; Chiara,20,0,20,0
1714610736381,LISP 5A,A00,507541,Munoz Sanchez; Alicia,11,0,20,9
1714610737404,LISP 5B,A00,507671,Munoz Sanchez; Alicia,8,0,20,12
1714610738430,LISP 5C,A00,507696,Munoz Sanchez; Alicia,9,0,20,11
1714610739455,MAE 197,001,528363,Boechler; Nicholas Sebastia,9998,0,9999,1
1714610740482,MATH 197,001,523477,Kedlaya; Kiran S.,9995,0,9999,4
1714610740482,MATH 197,002,563811,Zhang; Danna,9995,0,9999,4
1714610740482,MATH 197,003,628552,Dumitriu; Ioana,9998,0,9999,1
1714610741511,MCWP 40R,A00,518780,Staff,2,0,20,18
1714610741511,MCWP 40R,B00,518781,Staff,8,0,20,12
1714610741511,MCWP 40R,C00,518783,Staff,6,0,20,14
1714610742536,MCWP 50R,A00,518791,Staff,0,0,20,20
1714610742536,MCWP 50R,B00,518792,Staff,0,2,20,20
1714610742536,MCWP 50R,C00,518793,Staff,0,2,20,20
1714610742536,MCWP 50R,D00,518794,Staff,0,0,20,20
1714610742536,MCWP 50R,E00,518795,Staff,0,2,20,20
1714610742536,MCWP 50R,F00,518796,Staff,0,0,20,20
1714610742536,MCWP 50R,G00,518797,Staff,0,1,20,20
1714610743560,MMW 12R,A01,514034,Herbst; Matthew,0,0,16,16
1714610743560,MMW 12R,A02,514035,Herbst; Matthew,1,0,16,15
1714610744586,MMW 13R,A01,514037,Staff,0,4,16,16
1714610744586,MMW 13R,A02,514039,Staff,0,2,16,16
1714610744586,MMW 13R,A03,628519,Staff,0,2,16,16
1714610746640,SIO 295LS,A00,523233,Staff,10,0,30,20
1714610747665,SIO 295S,A00,523232,Staff,10,0,30,20
1714610748695,SIOC 290S,A01,637330,Merrifield; Mark A,23,0,30,7
1714610749722,SIOC 291S,A01,637333,Gabriel; Corey John,23,0,30,7
1714610750752,SOCI 117,A01,494376,Staff,0,4,5,5
1714610751781,WES 237B,A00,494380,Staff,9,0,20,11
1714610753848,AESE 279B,A00,494370,Wade; Jon P,0,0,33,33
1714610754873,AIP 197,001,627712,Vespa; Emanuel Ignacio,9998,0,9999,1
1714610755897,ANAR 135S,A00,494369,Braswell; Geoffrey E.,0,0,0,0
1714610756925,BENG 196,001,628496,Engler; Adam J.,9998,0,9999,1
1714610757951,CAT 124RS,A01,519847,Geibel; William,0,0,20,20
1714610758979,CAT 125RS,A01,515971,Geibel; William,0,0,20,20
1714610760055,CLRE 250,A00,511389,Morris; Sheldon,9993,0,9999,6
1714610761083,CLRE 251,A00,507176,Mehta; Ravindra L.,9993,0,9999,6
1714610761083,CLRE 251,B00,511410,Mehta; Ravindra L.,9998,0,9999,1
1714610762108,CLRE 252,A00,507189,Cuomo; Raphael Eduardo,9995,0,9999,4
1714610763133,CLRE 253,A00,507199,Vaida; Florin,9994,0,9999,5
1714610763133,CLRE 253,B00,507202,Vaida; Florin,9999,0,9999,0
1714610764165,CLRE 259,A00,507211,Patel; Hemal,9996,0,9999,3
1714610765190,CLRE 260,A00,507221,Cuomo; Raphael Eduardo,9999,0,9999,0
1714610766218,CLRE 297,001,507242,Cuomo; Raphael Eduardo,9999,0,9999,0
1714610767243,COGS 197,001,638244,Voytek; Bradley Thomas,9998,0,9999,1
1714610768268,CSE 191,A00,516875,Minnes Kemp; Mor Mia,9992,0,9999,7
1714610769295,CSE 197,001,637388,Minnes Kemp; Mor Mia,9998,0,9999,1
1714610770322,CSS 201S,A01,494383,Staff,35,0,35,0
1714610771349,CSS 202S,A01,494387,Staff,35,0,35,0
1714610772374,DSC 197,001,628532,Eldridge; Justin Matthew,9996,0,9999,3
1714610773398,EAP 100,A00,516065,Staff,9797,0,9999,202
1714610774425,ECE 45,A01,507414,Staff,33,0,60,27
1714610776478,ECE 111,A01,507420,Staff,15,0,50,35
1714610777503,ECE 197,001,548057,Sievenpiper; Daniel F.,9993,0,9999,6
1714610778583,EDS 115,A00,507243,Choi; Bailey Miyeon,10,0,28,18
1714610779608,EDS 117,A01,494379,Staff,1,5,30,29
1714610780637,EDS 125,A00,507246,Hopkins; Megan Beth,9,0,30,21
1714610781667,EDS 128A,A01,507264,Fargason; Sharon Gayle,8,0,26,18
1714610782693,EDS 128B,A01,507293,Pappas; Elizabeth,12,0,30,18
1714610783721,EDS 139,A00,507294,Fargason; Sharon Gayle,13,0,30,17
1714610783721,EDS 139,B00,507313,Pappas; Elizabeth,13,0,30,17
1714610784746,EDS 201,A00,507315,Staff,13,0,30,17
1714610785771,EDS 203,A01,507317,Halter; Christopher P.,12,0,30,18
1714610786796,EDS 204R,A01,507319,Halter; Christopher P.,0,3,30,30
1714610786796,EDS 204R,B01,507331,Heinzman; Erica M.,16,0,30,14
1714610787822,EDS 206R,A00,507332,Staff,0,4,30,30
1714610787822,EDS 206R,B00,507343,Staff,17,0,30,13
1714610788845,EDS 250,A00,507344,Hemans; Patricia Ann Benitez,22,0,40,18
1714610789871,EDS 281,A00,507345,Daly; Alan J.,18,0,18,0
1714610790896,EDS 284,A00,507350,Daly; Alan J.,16,0,16,0
1714610791922,EDS 286,A00,507359,Fine; Sarah,18,0,18,0
1714610792949,EDS 289C,A01,507361,Daly; Alan J.,18,0,18,0
1714610793973,EDS 290,A00,507366,Hofstetter; Carolyn,15,0,15,0
1714610794998,LIGM 5A,A00,507421,Fischer-Grunski; Eva K,18,0,20,2
1714610796026,LIGM 5B,A00,507423,Fischer-Grunski; Eva K,19,0,20,1
1714610797051,LIGM 5C,A00,507425,Fischer-Grunski; Eva K,19,0,20,1
1714610798078,LIIT 5AS,A00,507427,Carnelos; Chiara,20,0,20,0
1714610799104,LIIT 5BS,A00,507430,Carnelos; Chiara,20,0,20,0
1714610800131,LIIT 5CS,A00,507432,Carnelos; Chiara,20,0,20,0
1714610801158,LISP 5A,A00,507541,Munoz Sanchez; Alicia,11,0,20,9
1714610802188,LISP 5B,A00,507671,Munoz Sanchez; Alicia,8,0,20,12
1714610803214,LISP 5C,A00,507696,Munoz Sanchez; Alicia,9,0,20,11
1714610804242,MAE 197,001,528363,Boechler; Nicholas Sebastia,9998,0,9999,1
1714610805269,MATH 197,001,523477,Kedlaya; Kiran S.,9995,0,9999,4
1714610805269,MATH 197,002,563811,Zhang; Danna,9995,0,9999,4
1714610805269,MATH 197,003,628552,Dumitriu; Ioana,9998,0,9999,1
1714610806296,MCWP 40R,A00,518780,Staff,2,0,20,18
1714610806296,MCWP 40R,B00,518781,Staff,8,0,20,12
1714610806296,MCWP 40R,C00,518783,Staff,6,0,20,14
1714610807322,MCWP 50R,A00,518791,Staff,0,0,20,20
1714610807322,MCWP 50R,B00,518792,Staff,0,2,20,20
1714610807322,MCWP 50R,C00,518793,Staff,0,2,20,20
1714610807322,MCWP 50R,D00,518794,Staff,0,0,20,20
1714610807322,MCWP 50R,E00,518795,Staff,0,2,20,20
1714610807322,MCWP 50R,F00,518796,Staff,0,0,20,20
1714610807322,MCWP 50R,G00,518797,Staff,0,1,20,20
1714610808350,MMW 12R,A01,514034,Herbst; Matthew,0,0,16,16
1714610808350,MMW 12R,A02,514035,Herbst; Matthew,1,0,16,15
1714610809378,MMW 13R,A01,514037,Staff,0,4,16,16
1714610809378,MMW 13R,A02,514039,Staff,0,2,16,16
1714610809378,MMW 13R,A03,628519,Staff,0,2,16,16
1714610811432,SIO 295LS,A00,523233,Staff,10,0,30,20
1714610812458,SIO 295S,A00,523232,Staff,10,0,30,20
1714610813493,SIOC 290S,A01,637330,Merrifield; Mark A,23,0,30,7
1714610814522,SIOC 291S,A01,637333,Gabriel; Corey John,23,0,30,7
1714610815549,SOCI 117,A01,494376,Staff,0,4,5,5
1714610816577,WES 237B,A00,494380,Staff,9,0,20,11
1714610818645,AESE 279B,A00,494370,Wade; Jon P,0,0,33,33
1714610819673,AIP 197,001,627712,Vespa; Emanuel Ignacio,9998,0,9999,1
1714610820700,ANAR 135S,A00,494369,Braswell; Geoffrey E.,0,0,0,0
1714610821729,BENG 196,001,628496,Engler; Adam J.,9998,0,9999,1
1714610822755,CAT 124RS,A01,519847,Geibel; William,0,0,20,20
1714610823783,CAT 125RS,A01,515971,Geibel; William,0,0,20,20
1714610824808,CLRE 250,A00,511389,Morris; Sheldon,9993,0,9999,6
1714610825834,CLRE 251,A00,507176,Mehta; Ravindra L.,9993,0,9999,6
1714610825834,CLRE 251,B00,511410,Mehta; Ravindra L.,9998,0,9999,1
1714610826860,CLRE 252,A00,507189,Cuomo; Raphael Eduardo,9995,0,9999,4
1714610827889,CLRE 253,A00,507199,Vaida; Florin,9994,0,9999,5
1714610827889,CLRE 253,B00,507202,Vaida; Florin,9999,0,9999,0
1714610828918,CLRE 259,A00,507211,Patel; Hemal,9996,0,9999,3
1714610829943,CLRE 260,A00,507221,Cuomo; Raphael Eduardo,9999,0,9999,0
1714610830968,CLRE 297,001,507242,Cuomo; Raphael Eduardo,9999,0,9999,0
1714610831997,COGS 197,001,638244,Voytek; Bradley Thomas,9998,0,9999,1
1714610833022,CSE 191,A00,516875,Minnes Kemp; Mor Mia,9992,0,9999,7
1714610834048,CSE 197,001,637388,Minnes Kemp; Mor Mia,9998,0,9999,1
1714610835078,CSS 201S,A01,494383,Staff,35,0,35,0
1714610836102,CSS 202S,A01,494387,Staff,35,0,35,0
1714610837128,DSC 197,001,628532,Eldridge; Justin Matthew,9996,0,9999,3
1714610838154,EAP 100,A00,516065,Staff,9797,0,9999,202
1714610839181,ECE 45,A01,507414,Staff,33,0,60,27
1714610841233,ECE 111,A01,507420,Staff,15,0,50,35
1714610842258,ECE 197,001,548057,Sievenpiper; Daniel F.,9993,0,9999,6
1714610843284,EDS 115,A00,507243,Choi; Bailey Miyeon,10,0,28,18
1714610844310,EDS 117,A01,494379,Staff,1,5,30,29
1714610845334,EDS 125,A00,507246,Hopkins; Megan Beth,9,0,30,21
1714610846363,EDS 128A,A01,507264,Fargason; Sharon Gayle,8,0,26,18
1714610847393,EDS 128B,A01,507293,Pappas; Elizabeth,12,0,30,18
1714610848416,EDS 139,A00,507294,Fargason; Sharon Gayle,13,0,30,17
1714610848416,EDS 139,B00,507313,Pappas; Elizabeth,13,0,30,17
1714610849440,EDS 201,A00,507315,Staff,13,0,30,17
1714610850465,EDS 203,A01,507317,Halter; Christopher P.,12,0,30,18
1714610851493,EDS 204R,A01,507319,Halter; Christopher P.,0,3,30,30
1714610851493,EDS 204R,B01,507331,Heinzman; Erica M.,16,0,30,14
1714610852520,EDS 206R,A00,507332,Staff,0,4,30,30
1714610852520,EDS 206R,B00,507343,Staff,17,0,30,13
1714610853548,EDS 250,A00,507344,Hemans; Patricia Ann Benitez,22,0,40,18
1714610854574,EDS 281,A00,507345,Daly; Alan J.,18,0,18,0
1714610855601,EDS 284,A00,507350,Daly; Alan J.,16,0,16,0
1714610856627,EDS 286,A00,507359,Fine; Sarah,18,0,18,0
1714610857652,EDS 289C,A01,507361,Daly; Alan J.,18,0,18,0
1714610858677,EDS 290,A00,507366,Hofstetter; Carolyn,15,0,15,0
1714610859703,LIGM 5A,A00,507421,Fischer-Grunski; Eva K,18,0,20,2
1714610860728,LIGM 5B,A00,507423,Fischer-Grunski; Eva K,19,0,20,1
1714610861757,LIGM 5C,A00,507425,Fischer-Grunski; Eva K,19,0,20,1
1714610862787,LIIT 5AS,A00,507427,Carnelos; Chiara,20,0,20,0
1714610863816,LIIT 5BS,A00,507430,Carnelos; Chiara,20,0,20,0
1714610864841,LIIT 5CS,A00,507432,Carnelos; Chiara,20,0,20,0
1714610865865,LISP 5A,A00,507541,Munoz Sanchez; Alicia,11,0,20,9
1714610866890,LISP 5B,A00,507671,Munoz Sanchez; Alicia,8,0,20,12
1714610867920,LISP 5C,A00,507696,Munoz Sanchez; Alicia,9,0,20,11
1714610868945,MAE 197,001,528363,Boechler; Nicholas Sebastia,9998,0,9999,1
1714610869973,MATH 197,001,523477,Kedlaya; Kiran S.,9995,0,9999,4
1714610869973,MATH 197,002,563811,Zhang; Danna,9995,0,9999,4
1714610869973,MATH 197,003,628552,Dumitriu; Ioana,9998,0,9999,1
1714610871002,MCWP 40R,A00,518780,Staff,2,0,20,18
1714610871002,MCWP 40R,B00,518781,Staff,8,0,20,12
1714610871002,MCWP 40R,C00,518783,Staff,6,0,20,14
1714610872028,MCWP 50R,A00,518791,Staff,0,0,20,20
1714610872028,MCWP 50R,B00,518792,Staff,0,2,20,20
1714610872028,MCWP 50R,C00,518793,Staff,0,2,20,20
1714610872028,MCWP 50R,D00,518794,Staff,0,0,20,20
1714610872028,MCWP 50R,E00,518795,Staff,0,2,20,20
1714610872028,MCWP 50R,F00,518796,Staff,0,0,20,20
1714610872028,MCWP 50R,G00,518797,Staff,0,1,20,20
1714610873055,MMW 12R,A01,514034,Herbst; Matthew,0,0,16,16
1714610873055,MMW 12R,A02,514035,Herbst; Matthew,1,0,16,15
1714610874079,MMW 13R,A01,514037,Staff,0,4,16,16
1714610874079,MMW 13R,A02,514039,Staff,0,2,16,16
1714610874079,MMW 13R,A03,628519,Staff,0,2,16,16
1714610876129,SIO 295LS,A00,523233,Staff,10,0,30,20
1714610877154,SIO 295S,A00,523232,Staff,10,0,30,20
1714610878184,SIOC 290S,A01,637330,Merrifield; Mark A,23,0,30,7
1714610879211,SIOC 291S,A01,637333,Gabriel; Corey John,23,0,30,7
1714610880236,SOCI 117,A01,494376,Staff,0,4,5,5
1714610881261,WES 237B,A00,494380,Staff,9,0,20,11
1714610883330,AESE 279B,A00,494370,Wade; Jon P,0,0,33,33
1714610884355,AIP 197,001,627712,Vespa; Emanuel Ignacio,9998,0,9999,1
1714610885381,ANAR 135S,A00,494369,Braswell; Geoffrey E.,0,0,0,0
1714610886411,BENG 196,001,628496,Engler; Adam J.,9998,0,9999,1
1714610887440,CAT 124RS,A01,519847,Geibel; William,0,0,20,20
1714610888468,CAT 125RS,A01,515971,Geibel; William,0,0,20,20
1714610889496,CLRE 250,A00,511389,Morris; Sheldon,9993,0,9999,6
1714610890524,CLRE 251,A00,507176,Mehta; Ravindra L.,9993,0,9999,6
1714610890524,CLRE 251,B00,511410,Mehta; Ravindra L.,9998,0,9999,1
1714610891555,CLRE 252,A00,507189,Cuomo; Raphael Eduardo,9995,0,9999,4
1714610892579,CLRE 253,A00,507199,Vaida; Florin,9994,0,9999,5
1714610892579,CLRE 253,B00,507202,Vaida; Florin,9999,0,9999,0
1714610893607,CLRE 259,A00,507211,Patel; Hemal,9996,0,9999,3
1714610894633,CLRE 260,A00,507221,Cuomo; Raphael Eduardo,9999,0,9999,0
1714610895664,CLRE 297,001,507242,Cuomo; Raphael Eduardo,9999,0,9999,0
1714610896689,COGS 197,001,638244,Voytek; Bradley Thomas,9998,0,9999,1
1714610897718,CSE 191,A00,516875,Minnes Kemp; Mor Mia,9992,0,9999,7
1714610898745,CSE 197,001,637388,Minnes Kemp; Mor Mia,9998,0,9999,1
1714610899770,CSS 201S,A01,494383,Staff,35,0,35,0
1714610900795,CSS 202S,A01,494387,Staff,35,0,35,0
1714610901819,DSC 197,001,628532,Eldridge; Justin Matthew,9996,0,9999,3
1714610902844,EAP 100,A00,516065,Staff,9797,0,9999,202
1714610903873,ECE 45,A01,507414,Staff,33,0,60,27
1714610905920,ECE 111,A01,507420,Staff,15,0,50,35
1714610906945,ECE 197,001,548057,Sievenpiper; Daniel F.,9993,0,9999,6
1714610907974,EDS 115,A00,507243,Choi; Bailey Miyeon,10,0,28,18
1714610909001,EDS 117,A01,494379,Staff,1,5,30,29
1714610910029,EDS 125,A00,507246,Hopkins; Megan Beth,9,0,30,21
1714610911055,EDS 128A,A01,507264,Fargason; Sharon Gayle,8,0,26,18
1714610912079,EDS 128B,A01,507293,Pappas; Elizabeth,12,0,30,18
1714610913103,EDS 139,A00,507294,Fargason; Sharon Gayle,13,0,30,17
1714610913103,EDS 139,B00,507313,Pappas; Elizabeth,13,0,30,17
1714610914129,EDS 201,A00,507315,Staff,13,0,30,17
1714610915209,EDS 203,A01,507317,Halter; Christopher P.,12,0,30,18
1714610916236,EDS 204R,A01,507319,Halter; Christopher P.,0,3,30,30
1714610916236,EDS 204R,B01,507331,Heinzman; Erica M.,16,0,30,14
1714610917262,EDS 206R,A00,507332,Staff,0,4,30,30
1714610917262,EDS 206R,B00,507343,Staff,17,0,30,13
1714610918287,EDS 250,A00,507344,Hemans; Patricia Ann Benitez,22,0,40,18
1714610919316,EDS 281,A00,507345,Daly; Alan J.,18,0,18,0
1714610920339,EDS 284,A00,507350,Daly; Alan J.,16,0,16,0
1714610921364,EDS 286,A00,507359,Fine; Sarah,18,0,18,0
1714610922392,EDS 289C,A01,507361,Daly; Alan J.,18,0,18,0
1714610923418,EDS 290,A00,507366,Hofstetter; Carolyn,15,0,15,0
1714610924451,LIGM 5A,A00,507421,Fischer-Grunski; Eva K,18,0,20,2
1714610925477,LIGM 5B,A00,507423,Fischer-Grunski; Eva K,19,0,20,1
1714610926504,LIGM 5C,A00,507425,Fischer-Grunski; Eva K,19,0,20,1
1714610927587,LIIT 5AS,A00,507427,Carnelos; Chiara,20,0,20,0
1714610928613,LIIT 5BS,A00,507430,Carnelos; Chiara,20,0,20,0
1714610929642,LIIT 5CS,A00,507432,Carnelos; Chiara,20,0,20,0
1714610930677,LISP 5A,A00,507541,Munoz Sanchez; Alicia,11,0,20,9
1714610931702,LISP 5B,A00,507671,Munoz Sanchez; Alicia,8,0,20,12
1714610932730,LISP 5C,A00,507696,Munoz Sanchez; Alicia,9,0,20,11
1714610933758,MAE 197,001,528363,Boechler; Nicholas Sebastia,9998,0,9999,1
1714610934787,MATH 197,001,523477,Kedlaya; Kiran S.,9995,0,9999,4
1714610934787,MATH 197,002,563811,Zhang; Danna,9995,0,9999,4
1714610934787,MATH 197,003,628552,Dumitriu; Ioana,9998,0,9999,1
1714610935815,MCWP 40R,A00,518780,Staff,2,0,20,18
1714610935815,MCWP 40R,B00,518781,Staff,8,0,20,12
1714610935815,MCWP 40R,C00,518783,Staff,6,0,20,14
1714610936842,MCWP 50R,A00,518791,Staff,0,0,20,20
1714610936842,MCWP 50R,B00,518792,Staff,0,2,20,20
1714610936842,MCWP 50R,C00,518793,Staff,0,2,20,20
1714610936842,MCWP 50R,D00,518794,Staff,0,0,20,20
1714610936842,MCWP 50R,E00,518795,Staff,0,2,20,20
1714610936842,MCWP 50R,F00,518796,Staff,0,0,20,20
1714610936842,MCWP 50R,G00,518797,Staff,0,1,20,20
1714610937871,MMW 12R,A01,514034,Herbst; Matthew,0,0,16,16
1714610937871,MMW 12R,A02,514035,Herbst; Matthew,1,0,16,15
1714610938898,MMW 13R,A01,514037,Staff,0,4,16,16
1714610938898,MMW 13R,A02,514039,Staff,0,2,16,16
1714610938898,MMW 13R,A03,628519,Staff,0,2,16,16
1714610940952,SIO 295LS,A00,523233,Staff,10,0,30,20
1714610941978,SIO 295S,A00,523232,Staff,10,0,30,20
1714610943011,SIOC 290S,A01,637330,Merrifield; Mark A,23,0,30,7
1714610944037,SIOC 291S,A01,637333,Gabriel; Corey John,23,0,30,7
1714610945067,SOCI 117,A01,494376,Staff,0,4,5,5
1714610946092,WES 237B,A00,494380,Staff,9,0,20,11
1714610948177,AESE 279B,A00,494370,Wade; Jon P,0,0,33,33
1714610949202,AIP 197,001,627712,Vespa; Emanuel Ignacio,9998,0,9999,1
1714610950231,ANAR 135S,A00,494369,Braswell; Geoffrey E.,0,0,0,0
1714610951255,BENG 196,001,628496,Engler; Adam J.,9998,0,9999,1
1714610952283,CAT 124RS,A01,519847,Geibel; William,0,0,20,20
1714610953311,CAT 125RS,A01,515971,Geibel; William,0,0,20,20
1714610954337,CLRE 250,A00,511389,Morris; Sheldon,9993,0,9999,6
1714610955364,CLRE 251,A00,507176,Mehta; Ravindra L.,9993,0,9999,6
1714610955364,CLRE 251,B00,511410,Mehta; Ravindra L.,9998,0,9999,1
1714610956392,CLRE 252,A00,507189,Cuomo; Raphael Eduardo,9995,0,9999,4
1714610957421,CLRE 253,A00,507199,Vaida; Florin,9994,0,9999,5
1714610957421,CLRE 253,B00,507202,Vaida; Florin,9999,0,9999,0
1714610958446,CLRE 259,A00,507211,Patel; Hemal,9996,0,9999,3
1714610959470,CLRE 260,A00,507221,Cuomo; Raphael Eduardo,9999,0,9999,0
1714610960498,CLRE 297,001,507242,Cuomo; Raphael Eduardo,9999,0,9999,0
1714610961523,COGS 197,001,638244,Voytek; Bradley Thomas,9998,0,9999,1
1714610962549,CSE 191,A00,516875,Minnes Kemp; Mor Mia,9992,0,9999,7
1714610963577,CSE 197,001,637388,Minnes Kemp; Mor Mia,9998,0,9999,1
1714610964602,CSS 201S,A01,494383,Staff,35,0,35,0
1714610965631,CSS 202S,A01,494387,Staff,35,0,35,0
1714610966656,DSC 197,001,628532,Eldridge; Justin Matthew,9996,0,9999,3
1714610967682,EAP 100,A00,516065,Staff,9797,0,9999,202
1714610968709,ECE 45,A01,507414,Staff,33,0,60,27
1714610970761,ECE 111,A01,507420,Staff,15,0,50,35
1714610971791,ECE 197,001,548057,Sievenpiper; Daniel F.,9993,0,9999,6
1714610972816,EDS 115,A00,507243,Choi; Bailey Miyeon,10,0,28,18
1714610973846,EDS 117,A01,494379,Staff,1,5,30,29
1714610974874,EDS 125,A00,507246,Hopkins; Megan Beth,9,0,30,21
1714610975900,EDS 128A,A01,507264,Fargason; Sharon Gayle,8,0,26,18
1714610976930,EDS 128B,A01,507293,Pappas; Elizabeth,12,0,30,18
1714610977957,EDS 139,A00,507294,Fargason; Sharon Gayle,13,0,30,17
1714610977957,EDS 139,B00,507313,Pappas; Elizabeth,13,0,30,17
1714610978982,EDS 201,A00,507315,Staff,13,0,30,17
1714610980008,EDS 203,A01,507317,Halter; Christopher P.,12,0,30,18
1714610981035,EDS 204R,A01,507319,Halter; Christopher P.,0,3,30,30
1714610981035,EDS 204R,B01,507331,Heinzman; Erica M.,16,0,30,14
1714610982059,EDS 206R,A00,507332,Staff,0,4,30,30
1714610982059,EDS 206R,B00,507343,Staff,17,0,30,13
1714610983085,EDS 250,A00,507344,Hemans; Patricia Ann Benitez,22,0,40,18
1714610984110,EDS 281,A00,507345,Daly; Alan J.,18,0,18,0
1714610985137,EDS 284,A00,507350,Daly; Alan J.,16,0,16,0
1714610986161,EDS 286,A00,507359,Fine; Sarah,18,0,18,0
1714610987189,EDS 289C,A01,507361,Daly; Alan J.,18,0,18,0
1714610988214,EDS 290,A00,507366,Hofstetter; Carolyn,15,0,15,0
1714610989245,LIGM 5A,A00,507421,Fischer-Grunski; Eva K,18,0,20,2
1714610990276,LIGM 5B,A00,507423,Fischer-Grunski; Eva K,19,0,20,1
1714610991302,LIGM 5C,A00,507425,Fischer-Grunski; Eva K,19,0,20,1
1714610992327,LIIT 5AS,A00,507427,Carnelos; Chiara,20,0,20,0
1714610993353,LIIT 5BS,A00,507430,Carnelos; Chiara,20,0,20,0
1714610994382,LIIT 5CS,A00,507432,Carnelos; Chiara,20,0,20,0
1714610995408,LISP 5A,A00,507541,Munoz Sanchez; Alicia,11,0,20,9
1714610996437,LISP 5B,A00,507671,Munoz Sanchez; Alicia,8,0,20,12
1714610997462,LISP 5C,A00,507696,Munoz Sanchez; Alicia,9,0,20,11
1714610998487,MAE 197,001,528363,Boechler; Nicholas Sebastia,9998,0,9999,1
1714610999517,MATH 197,001,523477,Kedlaya; Kiran S.,9995,0,9999,4
1714610999517,MATH 197,002,563811,Zhang; Danna,9995,0,9999,4
1714610999517,MATH 197,003,628552,Dumitriu; Ioana,9998,0,9999,1
1714611000547,MCWP 40R,A00,518780,Staff,2,0,20,18
1714611000547,MCWP 40R,B00,518781,Staff,8,0,20,12
1714611000547,MCWP 40R,C00,518783,Staff,6,0,20,14
1714611001572,MCWP 50R,A00,518791,Staff,0,0,20,20
1714611001572,MCWP 50R,B00,518792,Staff,0,2,20,20
1714611001572,MCWP 50R,C00,518793,Staff,0,2,20,20
1714611001572,MCWP 50R,D00,518794,Staff,0,0,20,20
1714611001572,MCWP 50R,E00,518795,Staff,0,2,20,20
1714611001572,MCWP 50R,F00,518796,Staff,0,0,20,20
1714611001572,MCWP 50R,G00,518797,Staff,0,1,20,20
1714611002598,MMW 12R,A01,514034,Herbst; Matthew,0,0,16,16
1714611002598,MMW 12R,A02,514035,Herbst; Matthew,1,0,16,15
1714611003626,MMW 13R,A01,514037,Staff,0,4,16,16
1714611003626,MMW 13R,A02,514039,Staff,0,2,16,16
1714611003626,MMW 13R,A03,628519,Staff,0,2,16,16
1714611005682,SIO 295LS,A00,523233,Staff,10,0,30,20
1714611006707,SIO 295S,A00,523232,Staff,10,0,30,20
1714611007733,SIOC 290S,A01,637330,Merrifield; Mark A,23,0,30,7
1714611008758,SIOC 291S,A01,637333,Gabriel; Corey John,23,0,30,7
1714611009782,SOCI 117,A01,494376,Staff,0,4,5,5
1714611010810,WES 237B,A00,494380,Staff,9,0,20,11
1714611012882,AESE 279B,A00,494370,Wade; Jon P,0,0,33,33
1714611013911,AIP 197,001,627712,Vespa; Emanuel Ignacio,9998,0,9999,1
1714611014936,ANAR 135S,A00,494369,Braswell; Geoffrey E.,0,0,0,0
1714611015962,BENG 196,001,628496,Engler; Adam J.,9998,0,9999,1
1714611016987,CAT 124RS,A01,519847,Geibel; William,0,0,20,20
1714611018014,CAT 125RS,A01,515971,Geibel; William,0,0,20,20
1714611019093,CLRE 250,A00,511389,Morris; Sheldon,9993,0,9999,6
1714611020121,CLRE 251,A00,507176,Mehta; Ravindra L.,9993,0,9999,6
1714611020121,CLRE 251,B00,511410,Mehta; Ravindra L.,9998,0,9999,1
1714611021150,CLRE 252,A00,507189,Cuomo; Raphael Eduardo,9995,0,9999,4
1714611022183,CLRE 253,A00,507199,Vaida; Florin,9994,0,9999,5
1714611022183,CLRE 253,B00,507202,Vaida; Florin,9999,0,9999,0
1714611023212,CLRE 259,A00,507211,Patel; Hemal,9996,0,9999,3
1714611024237,CLRE 260,A00,507221,Cuomo; Raphael Eduardo,9999,0,9999,0
1714611025262,CLRE 297,001,507242,Cuomo; Raphael Eduardo,9999,0,9999,0
1714611026290,COGS 197,001,638244,Voytek; Bradley Thomas,9998,0,9999,1
1714611027319,CSE 191,A00,516875,Minnes Kemp; Mor Mia,9992,0,9999,7
1714611028347,CSE 197,001,637388,Minnes Kemp; Mor Mia,9998,0,9999,1
1714611029373,CSS 201S,A01,494383,Staff,35,0,35,0
1714611030402,CSS 202S,A01,494387,Staff,35,0,35,0
1714611031427,DSC 197,001,628532,Eldridge; Justin Matthew,9996,0,9999,3
1714611032453,EAP 100,A00,516065,Staff,9797,0,9999,202
1714611033481,ECE 45,A01,507414,Staff,33,0,60,27
1714611035534,ECE 111,A01,507420,Staff,15,0,50,35
1714611036560,ECE 197,001,548057,Sievenpiper; Daniel F.,9993,0,9999,6
1714611037588,EDS 115,A00,507243,Choi; Bailey Miyeon,10,0,28,18
1714611038613,EDS 117,A01,494379,Staff,1,5,30,29
1714611039642,EDS 125,A00,507246,Hopkins; Megan Beth,9,0,30,21
1714611040667,EDS 128A,A01,507264,Fargason; Sharon Gayle,8,0,26,18
1714611041696,EDS 128B,A01,507293,Pappas; Elizabeth,12,0,30,18
1714611042723,EDS 139,A00,507294,Fargason; Sharon Gayle,13,0,30,17
1714611042723,EDS 139,B00,507313,Pappas; Elizabeth,13,0,30,17
1714611043746,EDS 201,A00,507315,Staff,13,0,30,17
1714611044776,EDS 203,A01,507317,Halter; Christopher P.,12,0,30,18
1714611045803,EDS 204R,A01,507319,Halter; Christopher P.,0,3,30,30
1714611045803,EDS 204R,B01,507331,Heinzman; Erica M.,16,0,30,14
1714611046832,EDS 206R,A00,507332,Staff,0,4,30,30
1714611046832,EDS 206R,B00,507343,Staff,17,0,30,13
1714611047860,EDS 250,A00,507344,Hemans; Patricia Ann Benitez,22,0,40,18
1714611048889,EDS 281,A00,507345,Daly; Alan J.,18,0,18,0
1714611049914,EDS 284,A00,507350,Daly; Alan J.,16,0,16,0
1714611050943,EDS 286,A00,507359,Fine; Sarah,18,0,18,0
1714611051971,EDS 289C,A01,507361,Daly; Alan J.,18,0,18,0
1714611053000,EDS 290,A00,507366,Hofstetter; Carolyn,15,0,15,0
1714611054029,LIGM 5A,A00,507421,Fischer-Grunski; Eva K,18,0,20,2
1714611055058,LIGM 5B,A00,507423,Fischer-Grunski; Eva K,19,0,20,1
1714611056086,LIGM 5C,A00,507425,Fischer-Grunski; Eva K,19,0,20,1
1714611057111,LIIT 5AS,A00,507427,Carnelos; Chiara,20,0,20,0
1714611058134,LIIT 5BS,A00,507430,Carnelos; Chiara,20,0,20,0
1714611059159,LIIT 5CS,A00,507432,Carnelos; Chiara,20,0,20,0
1714611060184,LISP 5A,A00,507541,Munoz Sanchez; Alicia,11,0,20,9
1714611061211,LISP 5B,A00,507671,Munoz Sanchez; Alicia,8,0,20,12
1714611062236,LISP 5C,A00,507696,Munoz Sanchez; Alicia,9,0,20,11
1714611063262,MAE 197,001,528363,Boechler; Nicholas Sebastia,9998,0,9999,1
1714611064289,MATH 197,001,523477,Kedlaya; Kiran S.,9995,0,9999,4
1714611064289,MATH 197,002,563811,Zhang; Danna,9995,0,9999,4
1714611064289,MATH 197,003,628552,Dumitriu; Ioana,9998,0,9999,1
1714611065318,MCWP 40R,A00,518780,Staff,2,0,20,18
1714611065318,MCWP 40R,B00,518781,Staff,8,0,20,12
1714611065318,MCWP 40R,C00,518783,Staff,6,0,20,14
1714611066348,MCWP 50R,A00,518791,Staff,0,0,20,20
1714611066348,MCWP 50R,B00,518792,Staff,0,2,20,20
1714611066348,MCWP 50R,C00,518793,Staff,0,2,20,20
1714611066348,MCWP 50R,D00,518794,Staff,0,0,20,20
1714611066348,MCWP 50R,E00,518795,Staff,0,2,20,20
1714611066348,MCWP 50R,F00,518796,Staff,0,0,20,20
1714611066348,MCWP 50R,G00,518797,Staff,0,1,20,20
1714611067371,MMW 12R,A01,514034,Herbst; Matthew,0,0,16,16
1714611067371,MMW 12R,A02,514035,Herbst; Matthew,1,0,16,15
1714611068397,MMW 13R,A01,514037,Staff,0,4,16,16
1714611068397,MMW 13R,A02,514039,Staff,0,2,16,16
1714611068397,MMW 13R,A03,628519,Staff,0,2,16,16
1714611070450,SIO 295LS,A00,523233,Staff,10,0,30,20
1714611071480,SIO 295S,A00,523232,Staff,10,0,30,20
1714611072511,SIOC 290S,A01,637330,Merrifield; Mark A,23,0,30,7
1714611073536,SIOC 291S,A01,637333,Gabriel; Corey John,23,0,30,7
1714611074561,SOCI 117,A01,494376,Staff,0,4,5,5
1714611075586,WES 237B,A00,494380,Staff,9,0,20,11
1714611077657,AESE 279B,A00,494370,Wade; Jon P,0,0,33,33
1714611078685,AIP 197,001,627712,Vespa; Emanuel Ignacio,9998,0,9999,1
1714611079715,ANAR 135S,A00,494369,Braswell; Geoffrey E.,0,0,0,0
1714611080740,BENG 196,001,628496,Engler; Adam J.,9998,0,9999,1
1714611081772,CAT 124RS,A01,519847,Geibel; William,0,0,20,20
1714611082799,CAT 125RS,A01,515971,Geibel; William,0,0,20,20
1714611083826,CLRE 250,A00,511389,Morris; Sheldon,9993,0,9999,6
1714611084854,CLRE 251,A00,507176,Mehta; Ravindra L.,9993,0,9999,6
1714611084854,CLRE 251,B00,511410,Mehta; Ravindra L.,9998,0,9999,1
1714611085878,CLRE 252,A00,507189,Cuomo; Raphael Eduardo,9995,0,9999,4
1714611086907,CLRE 253,A00,507199,Vaida; Florin,9994,0,9999,5
1714611086907,CLRE 253,B00,507202,Vaida; Florin,9999,0,9999,0
1714611087935,CLRE 259,A00,507211,Patel; Hemal,9996,0,9999,3
1714611088960,CLRE 260,A00,507221,Cuomo; Raphael Eduardo,9999,0,9999,0
1714611089984,CLRE 297,001,507242,Cuomo; Raphael Eduardo,9999,0,9999,0
1714611091013,COGS 197,001,638244,Voytek; Bradley Thomas,9998,0,9999,1
1714611092037,CSE 191,A00,516875,Minnes Kemp; Mor Mia,9992,0,9999,7
1714611093062,CSE 197,001,637388,Minnes Kemp; Mor Mia,9998,0,9999,1
1714611094089,CSS 201S,A01,494383,Staff,35,0,35,0
1714611095115,CSS 202S,A01,494387,Staff,35,0,35,0
1714611096140,DSC 197,001,628532,Eldridge; Justin Matthew,9996,0,9999,3
1714611097165,EAP 100,A00,516065,Staff,9797,0,9999,202
1714611098194,ECE 45,A01,507414,Staff,33,0,60,27
1714611100244,ECE 111,A01,507420,Staff,15,0,50,35
1714611101275,ECE 197,001,548057,Sievenpiper; Daniel F.,9993,0,9999,6
1714611102300,EDS 115,A00,507243,Choi; Bailey Miyeon,10,0,28,18
1714611103326,EDS 117,A01,494379,Staff,1,5,30,29
1714611104353,EDS 125,A00,507246,Hopkins; Megan Beth,9,0,30,21
1714611105385,EDS 128A,A01,507264,Fargason; Sharon Gayle,8,0,26,18
1714611106409,EDS 128B,A01,507293,Pappas; Elizabeth,12,0,30,18
1714611107434,EDS 139,A00,507294,Fargason; Sharon Gayle,13,0,30,17
1714611107434,EDS 139,B00,507313,Pappas; Elizabeth,13,0,30,17
1714611108458,EDS 201,A00,507315,Staff,13,0,30,17
1714611109484,EDS 203,A01,507317,Halter; Christopher P.,12,0,30,18
1714611110512,EDS 204R,A01,507319,Halter; Christopher P.,0,3,30,30
1714611110512,EDS 204R,B01,507331,Heinzman; Erica M.,16,0,30,14
1714611111540,EDS 206R,A00,507332,Staff,0,4,30,30
1714611111540,EDS 206R,B00,507343,Staff,17,0,30,13
1714611112567,EDS 250,A00,507344,Hemans; Patricia Ann Benitez,22,0,40,18
1714611113593,EDS 281,A00,507345,Daly; Alan J.,18,0,18,0
1714611114619,EDS 284,A00,507350,Daly; Alan J.,16,0,16,0
1714611115645,EDS 286,A00,507359,Fine; Sarah,18,0,18,0
1714611116670,EDS 289C,A01,507361,Daly; Alan J.,18,0,18,0
1714611117695,EDS 290,A00,507366,Hofstetter; Carolyn,15,0,15,0
1714611118729,LIGM 5A,A00,507421,Fischer-Grunski; Eva K,18,0,20,2
1714611119753,LIGM 5B,A00,507423,Fischer-Grunski; Eva K,19,0,20,1
1714611120780,LIGM 5C,A00,507425,Fischer-Grunski; Eva K,19,0,20,1
1714611121809,LIIT 5AS,A00,507427,Carnelos; Chiara,20,0,20,0
1714611122837,LIIT 5BS,A00,507430,Carnelos; Chiara,20,0,20,0
1714611123873,LIIT 5CS,A00,507432,Carnelos; Chiara,20,0,20,0
1714611124900,LISP 5A,A00,507541,Munoz Sanchez; Alicia,11,0,20,9
1714611125926,LISP 5B,A00,507671,Munoz Sanchez; Alicia,8,0,20,12
1714611126952,LISP 5C,A00,507696,Munoz Sanchez; Alicia,9,0,20,11
1714611127980,MAE 197,001,528363,Boechler; Nicholas Sebastia,9998,0,9999,1
1714611129005,MATH 197,001,523477,Kedlaya; Kiran S.,9995,0,9999,4
1714611129005,MATH 197,002,563811,Zhang; Danna,9995,0,9999,4
1714611129005,MATH 197,003,628552,Dumitriu; Ioana,9998,0,9999,1
1714611130031,MCWP 40R,A00,518780,Staff,2,0,20,18
1714611130031,MCWP 40R,B00,518781,Staff,8,0,20,12
1714611130031,MCWP 40R,C00,518783,Staff,6,0,20,14
1714611131057,MCWP 50R,A00,518791,Staff,0,0,20,20
1714611131057,MCWP 50R,B00,518792,Staff,0,2,20,20
1714611131057,MCWP 50R,C00,518793,Staff,0,2,20,20
1714611131057,MCWP 50R,D00,518794,Staff,0,0,20,20
1714611131057,MCWP 50R,E00,518795,Staff,0,2,20,20
1714611131057,MCWP 50R,F00,518796,Staff,0,0,20,20
1714611131057,MCWP 50R,G00,518797,Staff,0,1,20,20
1714611132082,MMW 12R,A01,514034,Herbst; Matthew,0,0,16,16
1714611132082,MMW 12R,A02,514035,Herbst; Matthew,1,0,16,15
1714611133116,MMW 13R,A01,514037,Staff,0,4,16,16
1714611133116,MMW 13R,A02,514039,Staff,0,2,16,16
1714611133116,MMW 13R,A03,628519,Staff,0,2,16,16
1714611135165,SIO 295LS,A00,523233,Staff,10,0,30,20
1714611136191,SIO 295S,A00,523232,Staff,10,0,30,20
1714611137220,SIOC 290S,A01,637330,Merrifield; Mark A,23,0,30,7
1714611138249,SIOC 291S,A01,637333,Gabriel; Corey John,23,0,30,7
1714611139274,SOCI 117,A01,494376,Staff,0,4,5,5
1714611140301,WES 237B,A00,494380,Staff,9,0,20,11
1714611142364,AESE 279B,A00,494370,Wade; Jon P,0,0,33,33
1714611143390,AIP 197,001,627712,Vespa; Emanuel Ignacio,9998,0,9999,1
1714611144417,ANAR 135S,A00,494369,Braswell; Geoffrey E.,0,0,0,0
1714611145444,BENG 196,001,628496,Engler; Adam J.,9998,0,9999,1
1714611146468,CAT 124RS,A01,519847,Geibel; William,0,0,20,20
1714611147492,CAT 125RS,A01,515971,Geibel; William,0,0,20,20
1714611148519,CLRE 250,A00,511389,Morris; Sheldon,9993,0,9999,6
1714611149548,CLRE 251,A00,507176,Mehta; Ravindra L.,9993,0,9999,6
1714611149548,CLRE 251,B00,511410,Mehta; Ravindra L.,9998,0,9999,1
1714611150575,CLRE 252,A00,507189,Cuomo; Raphael Eduardo,9995,0,9999,4
1714611151601,CLRE 253,A00,507199,Vaida; Florin,9994,0,9999,5
1714611151601,CLRE 253,B00,507202,Vaida; Florin,9999,0,9999,0
1714611152630,CLRE 259,A00,507211,Patel; Hemal,9996,0,9999,3
1714611153653,CLRE 260,A00,507221,Cuomo; Raphael Eduardo,9999,0,9999,0
1714611154676,CLRE 297,001,507242,Cuomo; Raphael Eduardo,9999,0,9999,0
1714611155700,COGS 197,001,638244,Voytek; Bradley Thomas,9998,0,9999,1
1714611156726,CSE 191,A00,516875,Minnes Kemp; Mor Mia,9992,0,9999,7
1714611157751,CSE 197,001,637388,Minnes Kemp; Mor Mia,9998,0,9999,1
1714611158778,CSS 201S,A01,494383,Staff,35,0,35,0
1714611159804,CSS 202S,A01,494387,Staff,35,0,35,0
1714611160829,DSC 197,001,628532,Eldridge; Justin Matthew,9996,0,9999,3
1714611161854,EAP 100,A00,516065,Staff,9797,0,9999,202
1714611162883,ECE 45,A01,507414,Staff,33,0,60,27
1714611164935,ECE 111,A01,507420,Staff,15,0,50,35
1714611165959,ECE 197,001,548057,Sievenpiper; Daniel F.,9993,0,9999,6
1714611166989,EDS 115,A00,507243,Choi; Bailey Miyeon,10,0,28,18
1714611168014,EDS 117,A01,494379,Staff,1,5,30,29
1714611169042,EDS 125,A00,507246,Hopkins; Megan Beth,9,0,30,21
1714611170072,EDS 128A,A01,507264,Fargason; Sharon Gayle,8,0,26,18
1714611171101,EDS 128B,A01,507293,Pappas; Elizabeth,12,0,30,18
1714611172127,EDS 139,A00,507294,Fargason; Sharon Gayle,13,0,30,17
1714611172127,EDS 139,B00,507313,Pappas; Elizabeth,13,0,30,17
1714611173151,EDS 201,A00,507315,Staff,13,0,30,17
1714611174177,EDS 203,A01,507317,Halter; Christopher P.,12,0,30,18
1714611175204,EDS 204R,A01,507319,Halter; Christopher P.,0,3,30,30
1714611175204,EDS 204R,B01,507331,Heinzman; Erica M.,16,0,30,14
1714611176228,EDS 206R,A00,507332,Staff,0,4,30,30
1714611176228,EDS 206R,B00,507343,Staff,17,0,30,13
1714611177253,EDS 250,A00,507344,Hemans; Patricia Ann Benitez,22,0,40,18
1714611178277,EDS 281,A00,507345,Daly; Alan J.,18,0,18,0
1714611179302,EDS 284,A00,507350,Daly; Alan J.,16,0,16,0
1714611180328,EDS 286,A00,507359,Fine; Sarah,18,0,18,0
1714611181356,EDS 289C,A01,507361,Daly; Alan J.,18,0,18,0
1714611182380,EDS 290,A00,507366,Hofstetter; Carolyn,15,0,15,0
1714611183407,LIGM 5A,A00,507421,Fischer-Grunski; Eva K,18,0,20,2
1714611184432,LIGM 5B,A00,507423,Fischer-Grunski; Eva K,19,0,20,1
1714611185458,LIGM 5C,A00,507425,Fischer-Grunski; Eva K,19,0,20,1
1714611186483,LIIT 5AS,A00,507427,Carnelos; Chiara,20,0,20,0
1714611187510,LIIT 5BS,A00,507430,Carnelos; Chiara,20,0,20,0
1714611188536,LIIT 5CS,A00,507432,Carnelos; Chiara,20,0,20,0
1714611189560,LISP 5A,A00,507541,Munoz Sanchez; Alicia,11,0,20,9
1714611190585,LISP 5B,A00,507671,Munoz Sanchez; Alicia,8,0,20,12
1714611191613,LISP 5C,A00,507696,Munoz Sanchez; Alicia,9,0,20,11
1714611192637,MAE 197,001,528363,Boechler; Nicholas Sebastia,9998,0,9999,1
1714611193662,MATH 197,001,523477,Kedlaya; Kiran S.,9995,0,9999,4
1714611193662,MATH 197,002,563811,Zhang; Danna,9995,0,9999,4
1714611193662,MATH 197,003,628552,Dumitriu; Ioana,9998,0,9999,1
1714611194686,MCWP 40R,A00,518780,Staff,2,0,20,18
1714611194686,MCWP 40R,B00,518781,Staff,8,0,20,12
1714611194686,MCWP 40R,C00,518783,Staff,6,0,20,14
1714611195715,MCWP 50R,A00,518791,Staff,0,0,20,20
1714611195715,MCWP 50R,B00,518792,Staff,0,2,20,20
1714611195715,MCWP 50R,C00,518793,Staff,0,2,20,20
1714611195715,MCWP 50R,D00,518794,Staff,0,0,20,20
1714611195715,MCWP 50R,E00,518795,Staff,0,2,20,20
1714611195715,MCWP 50R,F00,518796,Staff,0,0,20,20
1714611195715,MCWP 50R,G00,518797,Staff,0,1,20,20
1714611196742,MMW 12R,A01,514034,Herbst; Matthew,0,0,16,16
1714611196742,MMW 12R,A02,514035,Herbst; Matthew,1,0,16,15
1714611197767,MMW 13R,A01,514037,Staff,0,4,16,16
1714611197767,MMW 13R,A02,514039,Staff,0,2,16,16
1714611197767,MMW 13R,A03,628519,Staff,0,2,16,16
1714611199820,SIO 295LS,A00,523233,Staff,10,0,30,20
1714611200847,SIO 295S,A00,523232,Staff,10,0,30,20
1714611201874,SIOC 290S,A01,637330,Merrifield; Mark A,23,0,30,7
1714611202899,SIOC 291S,A01,637333,Gabriel; Corey John,23,0,30,7
1714611203924,SOCI 117,A01,494376,Staff,0,4,5,5
1714611204951,WES 237B,A00,494380,Staff,9,0,20,11
1714611207019,AESE 279B,A00,494370,Wade; Jon P,0,0,33,33
1714611208043,AIP 197,001,627712,Vespa; Emanuel Ignacio,9998,0,9999,1
1714611209072,ANAR 135S,A00,494369,Braswell; Geoffrey E.,0,0,0,0
1714611210097,BENG 196,001,628496,Engler; Adam J.,9998,0,9999,1
1714611211126,CAT 124RS,A01,519847,Geibel; William,0,0,20,20
1714611212150,CAT 125RS,A01,515971,Geibel; William,0,0,20,20
1714611213179,CLRE 250,A00,511389,Morris; Sheldon,9993,0,9999,6
1714611214204,CLRE 251,A00,507176,Mehta; Ravindra L.,9993,0,9999,6
1714611214204,CLRE 251,B00,511410,Mehta; Ravindra L.,9998,0,9999,1
1714611215232,CLRE 252,A00,507189,Cuomo; Raphael Eduardo,9995,0,9999,4
1714611216258,CLRE 253,A00,507199,Vaida; Florin,9994,0,9999,5
1714611216258,CLRE 253,B00,507202,Vaida; Florin,9999,0,9999,0
1714611217284,CLRE 259,A00,507211,Patel; Hemal,9996,0,9999,3
1714611218308,CLRE 260,A00,507221,Cuomo; Raphael Eduardo,9999,0,9999,0
1714611219332,CLRE 297,001,507242,Cuomo; Raphael Eduardo,9999,0,9999,0
1714611220361,COGS 197,001,638244,Voytek; Bradley Thomas,9998,0,9999,1
1714611221390,CSE 191,A00,516875,Minnes Kemp; Mor Mia,9992,0,9999,7
1714611222415,CSE 197,001,637388,Minnes Kemp; Mor Mia,9998,0,9999,1
1714611223440,CSS 201S,A01,494383,Staff,35,0,35,0
1714611224466,CSS 202S,A01,494387,Staff,35,0,35,0
1714611225492,DSC 197,001,628532,Eldridge; Justin Matthew,9996,0,9999,3
1714611226516,EAP 100,A00,516065,Staff,9797,0,9999,202
1714611227539,ECE 45,A01,507414,Staff,33,0,60,27
1714611229593,ECE 111,A01,507420,Staff,15,0,50,35
1714611230621,ECE 197,001,548057,Sievenpiper; Daniel F.,9993,0,9999,6
1714611231647,EDS 115,A00,507243,Choi; Bailey Miyeon,10,0,28,18
1714611232672,EDS 117,A01,494379,Staff,1,5,30,29
1714611233698,EDS 125,A00,507246,Hopkins; Megan Beth,9,0,30,21
1714611234723,EDS 128A,A01,507264,Fargason; Sharon Gayle,8,0,26,18
1714611235753,EDS 128B,A01,507293,Pappas; Elizabeth,12,0,30,18
1714611236779,EDS 139,A00,507294,Fargason; Sharon Gayle,13,0,30,17
1714611236779,EDS 139,B00,507313,Pappas; Elizabeth,13,0,30,17
1714611237806,EDS 201,A00,507315,Staff,13,0,30,17
1714611238833,EDS 203,A01,507317,Halter; Christopher P.,12,0,30,18
1714611239861,EDS 204R,A01,507319,Halter; Christopher P.,0,3,30,30
1714611239861,EDS 204R,B01,507331,Heinzman; Erica M.,16,0,30,14
1714611240886,EDS 206R,A00,507332,Staff,0,4,30,30
1714611240886,EDS 206R,B00,507343,Staff,17,0,30,13
1714611241912,EDS 250,A00,507344,Hemans; Patricia Ann Benitez,22,0,40,18
1714611242937,EDS 281,A00,507345,Daly; Alan J.,18,0,18,0
1714611243963,EDS 284,A00,507350,Daly; Alan J.,16,0,16,0
1714611244989,EDS 286,A00,507359,Fine; Sarah,18,0,18,0
1714611246013,EDS 289C,A01,507361,Daly; Alan J.,18,0,18,0
1714611247040,EDS 290,A00,507366,Hofstetter; Carolyn,15,0,15,0
1714611248066,LIGM 5A,A00,507421,Fischer-Grunski; Eva K,18,0,20,2
1714611249093,LIGM 5B,A00,507423,Fischer-Grunski; Eva K,19,0,20,1
1714611250121,LIGM 5C,A00,507425,Fischer-Grunski; Eva K,19,0,20,1
1714611251152,LIIT 5AS,A00,507427,Carnelos; Chiara,20,0,20,0
1714611252178,LIIT 5BS,A00,507430,Carnelos; Chiara,20,0,20,0
1714611253207,LIIT 5CS,A00,507432,Carnelos; Chiara,20,0,20,0
1714611254232,LISP 5A,A00,507541,Munoz Sanchez; Alicia,11,0,20,9
1714611255258,LISP 5B,A00,507671,Munoz Sanchez; Alicia,8,0,20,12
1714611256288,LISP 5C,A00,507696,Munoz Sanchez; Alicia,9,0,20,11
1714611257312,MAE 197,001,528363,Boechler; Nicholas Sebastia,9998,0,9999,1
1714611258341,MATH 197,001,523477,Kedlaya; Kiran S.,9995,0,9999,4
1714611258341,MATH 197,002,563811,Zhang; Danna,9995,0,9999,4
1714611258341,MATH 197,003,628552,Dumitriu; Ioana,9998,0,9999,1
1714611259364,MCWP 40R,A00,518780,Staff,2,0,20,18
1714611259364,MCWP 40R,B00,518781,Staff,8,0,20,12
1714611259364,MCWP 40R,C00,518783,Staff,6,0,20,14
1714611260391,MCWP 50R,A00,518791,Staff,0,0,20,20
1714611260391,MCWP 50R,B00,518792,Staff,0,2,20,20
1714611260391,MCWP 50R,C00,518793,Staff,0,2,20,20
1714611260391,MCWP 50R,D00,518794,Staff,0,0,20,20
1714611260391,MCWP 50R,E00,518795,Staff,0,2,20,20
1714611260391,MCWP 50R,F00,518796,Staff,0,0,20,20
1714611260391,MCWP 50R,G00,518797,Staff,0,1,20,20
1714611261420,MMW 12R,A01,514034,Herbst; Matthew,0,0,16,16
1714611261420,MMW 12R,A02,514035,Herbst; Matthew,1,0,16,15
1714611262446,MMW 13R,A01,514037,Staff,0,4,16,16
1714611262446,MMW 13R,A02,514039,Staff,0,2,16,16
1714611262446,MMW 13R,A03,628519,Staff,0,2,16,16
1714611264501,SIO 295LS,A00,523233,Staff,10,0,30,20
1714611265526,SIO 295S,A00,523232,Staff,10,0,30,20
1714611266559,SIOC 290S,A01,637330,Merrifield; Mark A,23,0,30,7
1714611267588,SIOC 291S,A01,637333,Gabriel; Corey John,23,0,30,7
1714611268617,SOCI 117,A01,494376,Staff,0,4,5,5
1714611269642,WES 237B,A00,494380,Staff,9,0,20,11
1714611271710,AESE 279B,A00,494370,Wade; Jon P,0,0,33,33
1714611272739,AIP 197,001,627712,Vespa; Emanuel Ignacio,9998,0,9999,1
1714611273786,ANAR 135S,A00,494369,Braswell; Geoffrey E.,0,0,0,0
1714611274812,BENG 196,001,628496,Engler; Adam J.,9998,0,9999,1
1714611275838,CAT 124RS,A01,519847,Geibel; William,0,0,20,20
1714611276865,CAT 125RS,A01,515971,Geibel; William,0,0,20,20
1714611277889,CLRE 250,A00,511389,Morris; Sheldon,9993,0,9999,6
1714611278916,CLRE 251,A00,507176,Mehta; Ravindra L.,9993,0,9999,6
1714611278916,CLRE 251,B00,511410,Mehta; Ravindra L.,9998,0,9999,1
1714611279945,CLRE 252,A00,507189,Cuomo; Raphael Eduardo,9995,0,9999,4
1714611280970,CLRE 253,A00,507199,Vaida; Florin,9994,0,9999,5
1714611280970,CLRE 253,B00,507202,Vaida; Florin,9999,0,9999,0
1714611281996,CLRE 259,A00,507211,Patel; Hemal,9996,0,9999,3
1714611283024,CLRE 260,A00,507221,Cuomo; Raphael Eduardo,9999,0,9999,0
1714611284049,CLRE 297,001,507242,Cuomo; Raphael Eduardo,9999,0,9999,0
1714611285074,COGS 197,001,638244,Voytek; Bradley Thomas,9998,0,9999,1
1714611286100,CSE 191,A00,516875,Minnes Kemp; Mor Mia,9992,0,9999,7
1714611287123,CSE 197,001,637388,Minnes Kemp; Mor Mia,9998,0,9999,1
1714611288153,CSS 201S,A01,494383,Staff,35,0,35,0
1714611289177,CSS 202S,A01,494387,Staff,35,0,35,0
1714611290202,DSC 197,001,628532,Eldridge; Justin Matthew,9996,0,9999,3
1714611291226,EAP 100,A00,516065,Staff,9797,0,9999,202
1714611292254,ECE 45,A01,507414,Staff,33,0,60,27
1714611294307,ECE 111,A01,507420,Staff,15,0,50,35
1714611295335,ECE 197,001,548057,Sievenpiper; Daniel F.,9993,0,9999,6
1714611296360,EDS 115,A00,507243,Choi; Bailey Miyeon,10,0,28,18
1714611297386,EDS 117,A01,494379,Staff,1,5,30,29
1714611298414,EDS 125,A00,507246,Hopkins; Megan Beth,9,0,30,21
1714611299441,EDS 128A,A01,507264,Fargason; Sharon Gayle,8,0,26,18
1714611300468,EDS 128B,A01,507293,Pappas; Elizabeth,12,0,30,18
1714611301492,EDS 139,A00,507294,Fargason; Sharon Gayle,13,0,30,17
1714611301492,EDS 139,B00,507313,Pappas; Elizabeth,13,0,30,17
1714611302517,EDS 201,A00,507315,Staff,13,0,30,17
1714611303542,EDS 203,A01,507317,Halter; Christopher P.,12,0,30,18
1714611304569,EDS 204R,A01,507319,Halter; Christopher P.,0,3,30,30
1714611304569,EDS 204R,B01,507331,Heinzman; Erica M.,16,0,30,14
1714611305596,EDS 206R,A00,507332,Staff,0,4,30,30
1714611305596,EDS 206R,B00,507343,Staff,17,0,30,13
1714611306621,EDS 250,A00,507344,Hemans; Patricia Ann Benitez,22,0,40,18
1714611307650,EDS 281,A00,507345,Daly; Alan J.,18,0,18,0
1714611308675,EDS 284,A00,507350,Daly; Alan J.,16,0,16,0
1714611309725,EDS 286,A00,507359,Fine; Sarah,18,0,18,0
1714611310752,EDS 289C,A01,507361,Daly; Alan J.,18,0,18,0
1714611311776,EDS 290,A00,507366,Hofstetter; Carolyn,15,0,15,0
1714611312805,LIGM 5A,A00,507421,Fischer-Grunski; Eva K,18,0,20,2
1714611313830,LIGM 5B,A00,507423,Fischer-Grunski; Eva K,19,0,20,1
1714611314857,LIGM 5C,A00,507425,Fischer-Grunski; Eva K,19,0,20,1
1714611315882,LIIT 5AS,A00,507427,Carnelos; Chiara,20,0,20,0
1714611316906,LIIT 5BS,A00,507430,Carnelos; Chiara,20,0,20,0
1714611317931,LIIT 5CS,A00,507432,Carnelos; Chiara,20,0,20,0
1714611318957,LISP 5A,A00,507541,Munoz Sanchez; Alicia,11,0,20,9
1714611319985,LISP 5B,A00,507671,Munoz Sanchez; Alicia,8,0,20,12
1714611321009,LISP 5C,A00,507696,Munoz Sanchez; Alicia,9,0,20,11
1714611322034,MAE 197,001,528363,Boechler; Nicholas Sebastia,9998,0,9999,1
1714611323064,MATH 197,001,523477,Kedlaya; Kiran S.,9995,0,9999,4
1714611323064,MATH 197,002,563811,Zhang; Danna,9995,0,9999,4
1714611323064,MATH 197,003,628552,Dumitriu; Ioana,9998,0,9999,1
1714611324089,MCWP 40R,A00,518780,Staff,2,0,20,18
1714611324089,MCWP 40R,B00,518781,Staff,8,0,20,12
1714611324089,MCWP 40R,C00,518783,Staff,6,0,20,14
1714611325118,MCWP 50R,A00,518791,Staff,0,0,20,20
1714611325118,MCWP 50R,B00,518792,Staff,0,2,20,20
1714611325118,MCWP 50R,C00,518793,Staff,0,2,20,20
1714611325118,MCWP 50R,D00,518794,Staff,0,0,20,20
1714611325118,MCWP 50R,E00,518795,Staff,0,2,20,20
1714611325118,MCWP 50R,F00,518796,Staff,0,0,20,20
1714611325118,MCWP 50R,G00,518797,Staff,0,1,20,20
1714611326145,MMW 12R,A01,514034,Herbst; Matthew,0,0,16,16
1714611326145,MMW 12R,A02,514035,Herbst; Matthew,1,0,16,15
1714611327175,MMW 13R,A01,514037,Staff,0,4,16,16
1714611327175,MMW 13R,A02,514039,Staff,0,2,16,16
1714611327175,MMW 13R,A03,628519,Staff,0,2,16,16
1714611329224,SIO 295LS,A00,523233,Staff,10,0,30,20
1714611330252,SIO 295S,A00,523232,Staff,10,0,30,20
1714611331278,SIOC 290S,A01,637330,Merrifield; Mark A,23,0,30,7
1714611332305,SIOC 291S,A01,637333,Gabriel; Corey John,23,0,30,7
1714611333330,SOCI 117,A01,494376,Staff,0,4,5,5
1714611334356,WES 237B,A00,494380,Staff,9,0,20,11
1714611336426,AESE 279B,A00,494370,Wade; Jon P,0,0,33,33
1714611337451,AIP 197,001,627712,Vespa; Emanuel Ignacio,9998,0,9999,1
1714611338477,ANAR 135S,A00,494369,Braswell; Geoffrey E.,0,0,0,0
1714611339504,BENG 196,001,628496,Engler; Adam J.,9998,0,9999,1
1714611340530,CAT 124RS,A01,519847,Geibel; William,0,0,20,20
1714611341556,CAT 125RS,A01,515971,Geibel; William,0,0,20,20
1714611342585,CLRE 250,A00,511389,Morris; Sheldon,9993,0,9999,6
1714611343614,CLRE 251,A00,507176,Mehta; Ravindra L.,9993,0,9999,6
1714611343614,CLRE 251,B00,511410,Mehta; Ravindra L.,9998,0,9999,1
1714611344640,CLRE 252,A00,507189,Cuomo; Raphael Eduardo,9995,0,9999,4
1714611345666,CLRE 253,A00,507199,Vaida; Florin,9994,0,9999,5
1714611345666,CLRE 253,B00,507202,Vaida; Florin,9999,0,9999,0
1714611346691,CLRE 259,A00,507211,Patel; Hemal,9996,0,9999,3
1714611347719,CLRE 260,A00,507221,Cuomo; Raphael Eduardo,9999,0,9999,0
1714611348743,CLRE 297,001,507242,Cuomo; Raphael Eduardo,9999,0,9999,0
1714611349768,COGS 197,001,638244,Voytek; Bradley Thomas,9998,0,9999,1
1714611350793,CSE 191,A00,516875,Minnes Kemp; Mor Mia,9992,0,9999,7
1714611351818,CSE 197,001,637388,Minnes Kemp; Mor Mia,9998,0,9999,1
1714611353022,CSS 201S,A01,494383,Staff,35,0,35,0
1714611354048,CSS 202S,A01,494387,Staff,35,0,35,0
1714611355072,DSC 197,001,628532,Eldridge; Justin Matthew,9996,0,9999,3
1714611356099,EAP 100,A00,516065,Staff,9797,0,9999,202
1714611357128,ECE 45,A01,507414,Staff,33,0,60,27
1714611359185,ECE 111,A01,507420,Staff,15,0,50,35
1714611360213,ECE 197,001,548057,Sievenpiper; Daniel F.,9993,0,9999,6
1714611361242,EDS 115,A00,507243,Choi; Bailey Miyeon,10,0,28,18
1714611362271,EDS 117,A01,494379,Staff,1,5,30,29
1714611363305,EDS 125,A00,507246,Hopkins; Megan Beth,9,0,30,21
1714611364329,EDS 128A,A01,507264,Fargason; Sharon Gayle,8,0,26,18
1714611365355,EDS 128B,A01,507293,Pappas; Elizabeth,12,0,30,18
1714611366382,EDS 139,A00,507294,Fargason; Sharon Gayle,13,0,30,17
1714611366382,EDS 139,B00,507313,Pappas; Elizabeth,13,0,30,17
1714611367407,EDS 201,A00,507315,Staff,13,0,30,17
1714611368431,EDS 203,A01,507317,Halter; Christopher P.,12,0,30,18
1714611369474,EDS 204R,A01,507319,Halter; Christopher P.,0,3,30,30
1714611369474,EDS 204R,B01,507331,Heinzman; Erica M.,16,0,30,14
1714611370497,EDS 206R,A00,507332,Staff,0,4,30,30
1714611370497,EDS 206R,B00,507343,Staff,17,0,30,13
1714611371522,EDS 250,A00,507344,Hemans; Patricia Ann Benitez,22,0,40,18
1714611372545,EDS 281,A00,507345,Daly; Alan J.,18,0,18,0
1714611373571,EDS 284,A00,507350,Daly; Alan J.,16,0,16,0
1714611374598,EDS 286,A00,507359,Fine; Sarah,18,0,18,0
1714611375626,EDS 289C,A01,507361,Daly; Alan J.,18,0,18,0
1714611376649,EDS 290,A00,507366,Hofstetter; Carolyn,15,0,15,0
1714611377680,LIGM 5A,A00,507421,Fischer-Grunski; Eva K,18,0,20,2
1714611378704,LIGM 5B,A00,507423,Fischer-Grunski; Eva K,19,0,20,1
1714611379728,LIGM 5C,A00,507425,Fischer-Grunski; Eva K,19,0,20,1
1714611380752,LIIT 5AS,A00,507427,Carnelos; Chiara,20,0,20,0
1714611381776,LIIT 5BS,A00,507430,Carnelos; Chiara,20,0,20,0
1714611382801,LIIT 5CS,A00,507432,Carnelos; Chiara,20,0,20,0
1714611383826,LISP 5A,A00,507541,Munoz Sanchez; Alicia,11,0,20,9
1714611384851,LISP 5B,A00,507671,Munoz Sanchez; Alicia,8,0,20,12
1714611385878,LISP 5C,A00,507696,Munoz Sanchez; Alicia,9,0,20,11
1714611386906,MAE 197,001,528363,Boechler; Nicholas Sebastia,9998,0,9999,1
1714611387933,MATH 197,001,523477,Kedlaya; Kiran S.,9995,0,9999,4
1714611387933,MATH 197,002,563811,Zhang; Danna,9995,0,9999,4
1714611387933,MATH 197,003,628552,Dumitriu; Ioana,9998,0,9999,1
1714611388962,MCWP 40R,A00,518780,Staff,2,0,20,18
1714611388962,MCWP 40R,B00,518781,Staff,8,0,20,12
1714611388962,MCWP 40R,C00,518783,Staff,6,0,20,14
1714611389989,MCWP 50R,A00,518791,Staff,0,0,20,20
1714611389989,MCWP 50R,B00,518792,Staff,0,2,20,20
1714611389989,MCWP 50R,C00,518793,Staff,0,2,20,20
1714611389989,MCWP 50R,D00,518794,Staff,0,0,20,20
1714611389989,MCWP 50R,E00,518795,Staff,0,2,20,20
1714611389989,MCWP 50R,F00,518796,Staff,0,0,20,20
1714611389989,MCWP 50R,G00,518797,Staff,0,1,20,20
1714611391018,MMW 12R,A01,514034,Herbst; Matthew,0,0,16,16
1714611391018,MMW 12R,A02,514035,Herbst; Matthew,1,0,16,15
1714611392048,MMW 13R,A01,514037,Staff,0,4,16,16
1714611392048,MMW 13R,A02,514039,Staff,0,2,16,16
1714611392048,MMW 13R,A03,628519,Staff,0,2,16,16
1714611394101,SIO 295LS,A00,523233,Staff,10,0,30,20
1714611395128,SIO 295S,A00,523232,Staff,10,0,30,20
1714611396153,SIOC 290S,A01,637330,Merrifield; Mark A,23,0,30,7
1714611397179,SIOC 291S,A01,637333,Gabriel; Corey John,23,0,30,7
1714611398208,SOCI 117,A01,494376,Staff,0,4,5,5
1714611399236,WES 237B,A00,494380,Staff,9,0,20,11
1714611401306,AESE 279B,A00,494370,Wade; Jon P,0,0,33,33
1714611402332,AIP 197,001,627712,Vespa; Emanuel Ignacio,9998,0,9999,1
1714611403357,ANAR 135S,A00,494369,Braswell; Geoffrey E.,0,0,0,0
1714611404384,BENG 196,001,628496,Engler; Adam J.,9998,0,9999,1
1714611405410,CAT 124RS,A01,519847,Geibel; William,0,0,20,20
1714611406434,CAT 125RS,A01,515971,Geibel; William,0,0,20,20
1714611407464,CLRE 250,A00,511389,Morris; Sheldon,9993,0,9999,6
1714611408491,CLRE 251,A00,507176,Mehta; Ravindra L.,9993,0,9999,6
1714611408491,CLRE 251,B00,511410,Mehta; Ravindra L.,9998,0,9999,1
1714611409515,CLRE 252,A00,507189,Cuomo; Raphael Eduardo,9995,0,9999,4
1714611410539,CLRE 253,A00,507199,Vaida; Florin,9994,0,9999,5
1714611410539,CLRE 253,B00,507202,Vaida; Florin,9999,0,9999,0
1714611411565,CLRE 259,A00,507211,Patel; Hemal,9996,0,9999,3
1714611412592,CLRE 260,A00,507221,Cuomo; Raphael Eduardo,9999,0,9999,0
1714611413617,CLRE 297,001,507242,Cuomo; Raphael Eduardo,9999,0,9999,0
1714611414642,COGS 197,001,638244,Voytek; Bradley Thomas,9998,0,9999,1
1714611415666,CSE 191,A00,516875,Minnes Kemp; Mor Mia,9992,0,9999,7
1714611416693,CSE 197,001,637388,Minnes Kemp; Mor Mia,9998,0,9999,1
1714611417718,CSS 201S,A01,494383,Staff,35,0,35,0
1714611418742,CSS 202S,A01,494387,Staff,35,0,35,0
1714611419768,DSC 197,001,628532,Eldridge; Justin Matthew,9996,0,9999,3
1714611420794,EAP 100,A00,516065,Staff,9797,0,9999,202
1714611421823,ECE 45,A01,507414,Staff,33,0,60,27
1714611423876,ECE 111,A01,507420,Staff,15,0,50,35
1714611424901,ECE 197,001,548057,Sievenpiper; Daniel F.,9993,0,9999,6
1714611425929,EDS 115,A00,507243,Choi; Bailey Miyeon,10,0,28,18
1714611426958,EDS 117,A01,494379,Staff,1,5,30,29
1714611427982,EDS 125,A00,507246,Hopkins; Megan Beth,9,0,30,21
1714611429010,EDS 128A,A01,507264,Fargason; Sharon Gayle,8,0,26,18
1714611430036,EDS 128B,A01,507293,Pappas; Elizabeth,12,0,30,18
1714611431066,EDS 139,A00,507294,Fargason; Sharon Gayle,13,0,30,17
1714611431066,EDS 139,B00,507313,Pappas; Elizabeth,13,0,30,17
1714611432090,EDS 201,A00,507315,Staff,13,0,30,17
1714611433119,EDS 203,A01,507317,Halter; Christopher P.,12,0,30,18
1714611434145,EDS 204R,A01,507319,Halter; Christopher P.,0,3,30,30
1714611434145,EDS 204R,B01,507331,Heinzman; Erica M.,16,0,30,14
1714611435170,EDS 206R,A00,507332,Staff,0,4,30,30
1714611435170,EDS 206R,B00,507343,Staff,17,0,30,13
1714611436196,EDS 250,A00,507344,Hemans; Patricia Ann Benitez,22,0,40,18
1714611437224,EDS 281,A00,507345,Daly; Alan J.,18,0,18,0
1714611438252,EDS 284,A00,507350,Daly; Alan J.,16,0,16,0
1714611439278,EDS 286,A00,507359,Fine; Sarah,18,0,18,0
1714611440307,EDS 289C,A01,507361,Daly; Alan J.,18,0,18,0
1714611441337,EDS 290,A00,507366,Hofstetter; Carolyn,15,0,15,0
1714611442365,LIGM 5A,A00,507421,Fischer-Grunski; Eva K,18,0,20,2
1714611443390,LIGM 5B,A00,507423,Fischer-Grunski; Eva K,19,0,20,1
1714611444418,LIGM 5C,A00,507425,Fischer-Grunski; Eva K,19,0,20,1
1714611445450,LIIT 5AS,A00,507427,Carnelos; Chiara,20,0,20,0
1714611446481,LIIT 5BS,A00,507430,Carnelos; Chiara,20,0,20,0
1714611447508,LIIT 5CS,A00,507432,Carnelos; Chiara,20,0,20,0
1714611448537,LISP 5A,A00,507541,Munoz Sanchez; Alicia,11,0,20,9
1714611449562,LISP 5B,A00,507671,Munoz Sanchez; Alicia,8,0,20,12
1714611450588,LISP 5C,A00,507696,Munoz Sanchez; Alicia,9,0,20,11
1714611451616,MAE 197,001,528363,Boechler; Nicholas Sebastia,9998,0,9999,1
1714611452647,MATH 197,001,523477,Kedlaya; Kiran S.,9995,0,9999,4
1714611452647,MATH 197,002,563811,Zhang; Danna,9995,0,9999,4
1714611452647,MATH 197,003,628552,Dumitriu; Ioana,9998,0,9999,1
1714611453675,MCWP 40R,A00,518780,Staff,2,0,20,18
1714611453675,MCWP 40R,B00,518781,Staff,8,0,20,12
1714611453675,MCWP 40R,C00,518783,Staff,6,0,20,14
1714611454716,MCWP 50R,A00,518791,Staff,0,0,20,20
1714611454716,MCWP 50R,B00,518792,Staff,0,2,20,20
1714611454716,MCWP 50R,C00,518793,Staff,0,2,20,20
1714611454716,MCWP 50R,D00,518794,Staff,0,0,20,20
1714611454716,MCWP 50R,E00,518795,Staff,0,2,20,20
1714611454716,MCWP 50R,F00,518796,Staff,0,0,20,20
1714611454716,MCWP 50R,G00,518797,Staff,0,1,20,20
1714611455741,MMW 12R,A01,514034,Herbst; Matthew,0,0,16,16
1714611455741,MMW 12R,A02,514035,Herbst; Matthew,1,0,16,15
1714611456769,MMW 13R,A01,514037,Staff,0,4,16,16
1714611456769,MMW 13R,A02,514039,Staff,0,2,16,16
1714611456769,MMW 13R,A03,628519,Staff,0,2,16,16
1714611458824,SIO 295LS,A00,523233,Staff,10,0,30,20
1714611459852,SIO 295S,A00,523232,Staff,10,0,30,20
1714611460877,SIOC 290S,A01,637330,Merrifield; Mark A,23,0,30,7
1714611461906,SIOC 291S,A01,637333,Gabriel; Corey John,23,0,30,7
1714611462931,SOCI 117,A01,494376,Staff,0,4,5,5
1714611463956,WES 237B,A00,494380,Staff,9,0,20,11
1714611466027,AESE 279B,A00,494370,Wade; Jon P,0,0,33,33
1714611467050,AIP 197,001,627712,Vespa; Emanuel Ignacio,9998,0,9999,1
1714611468075,ANAR 135S,A00,494369,Braswell; Geoffrey E.,0,0,0,0
1714611469102,BENG 196,001,628496,Engler; Adam J.,9998,0,9999,1
1714611470129,CAT 124RS,A01,519847,Geibel; William,0,0,20,20
1714611471155,CAT 125RS,A01,515971,Geibel; William,0,0,20,20
1714611472183,CLRE 250,A00,511389,Morris; Sheldon,9993,0,9999,6
1714611473208,CLRE 251,A00,507176,Mehta; Ravindra L.,9993,0,9999,6
1714611473208,CLRE 251,B00,511410,Mehta; Ravindra L.,9998,0,9999,1
1714611474234,CLRE 252,A00,507189,Cuomo; Raphael Eduardo,9995,0,9999,4
1714611475260,CLRE 253,A00,507199,Vaida; Florin,9994,0,9999,5
1714611475260,CLRE 253,B00,507202,Vaida; Florin,9999,0,9999,0
1714611476284,CLRE 259,A00,507211,Patel; Hemal,9996,0,9999,3
1714611477310,CLRE 260,A00,507221,Cuomo; Raphael Eduardo,9999,0,9999,0
1714611478337,CLRE 297,001,507242,Cuomo; Raphael Eduardo,9999,0,9999,0
1714611479364,COGS 197,001,638244,Voytek; Bradley Thomas,9998,0,9999,1
1714611480390,CSE 191,A00,516875,Minnes Kemp; Mor Mia,9992,0,9999,7
1714611481416,CSE 197,001,637388,Minnes Kemp; Mor Mia,9998,0,9999,1
1714611482442,CSS 201S,A01,494383,Staff,35,0,35,0
1714611483472,CSS 202S,A01,494387,Staff,35,0,35,0
1714611484495,DSC 197,001,628532,Eldridge; Justin Matthew,9996,0,9999,3
1714611485521,EAP 100,A00,516065,Staff,9797,0,9999,202
1714611486545,ECE 45,A01,507414,Staff,33,0,60,27
1714611488596,ECE 111,A01,507420,Staff,15,0,50,35
1714611489620,ECE 197,001,548057,Sievenpiper; Daniel F.,9993,0,9999,6
1714611490646,EDS 115,A00,507243,Choi; Bailey Miyeon,10,0,28,18
1714611491670,EDS 117,A01,494379,Staff,1,5,30,29
1714611492696,EDS 125,A00,507246,Hopkins; Megan Beth,9,0,30,21
1714611493724,EDS 128A,A01,507264,Fargason; Sharon Gayle,8,0,26,18
1714611494752,EDS 128B,A01,507293,Pappas; Elizabeth,12,0,30,18
1714611495779,EDS 139,A00,507294,Fargason; Sharon Gayle,13,0,30,17
1714611495779,EDS 139,B00,507313,Pappas; Elizabeth,13,0,30,17
1714611496805,EDS 201,A00,507315,Staff,13,0,30,17
1714611497831,EDS 203,A01,507317,Halter; Christopher P.,12,0,30,18
1714611498860,EDS 204R,A01,507319,Halter; Christopher P.,0,3,30,30
1714611498860,EDS 204R,B01,507331,Heinzman; Erica M.,16,0,30,14
1714611499886,EDS 206R,A00,507332,Staff,0,4,30,30
1714611499886,EDS 206R,B00,507343,Staff,17,0,30,13
1714611500912,EDS 250,A00,507344,Hemans; Patricia Ann Benitez,22,0,40,18
1714611501942,EDS 281,A00,507345,Daly; Alan J.,18,0,18,0
1714611502972,EDS 284,A00,507350,Daly; Alan J.,16,0,16,0
1714611503996,EDS 286,A00,507359,Fine; Sarah,18,0,18,0
1714611505024,EDS 289C,A01,507361,Daly; Alan J.,18,0,18,0
1714611506050,EDS 290,A00,507366,Hofstetter; Carolyn,15,0,15,0
1714611507077,LIGM 5A,A00,507421,Fischer-Grunski; Eva K,18,0,20,2
1714611508108,LIGM 5B,A00,507423,Fischer-Grunski; Eva K,19,0,20,1
1714611509134,LIGM 5C,A00,507425,Fischer-Grunski; Eva K,19,0,20,1
1714611510162,LIIT 5AS,A00,507427,Carnelos; Chiara,20,0,20,0
1714611511187,LIIT 5BS,A00,507430,Carnelos; Chiara,20,0,20,0
1714611512213,LIIT 5CS,A00,507432,Carnelos; Chiara,20,0,20,0
1714611513238,LISP 5A,A00,507541,Munoz Sanchez; Alicia,11,0,20,9
1714611514263,LISP 5B,A00,507671,Munoz Sanchez; Alicia,8,0,20,12
1714611515289,LISP 5C,A00,507696,Munoz Sanchez; Alicia,9,0,20,11
1714611516318,MAE 197,001,528363,Boechler; Nicholas Sebastia,9998,0,9999,1
1714611517343,MATH 197,001,523477,Kedlaya; Kiran S.,9995,0,9999,4
1714611517343,MATH 197,002,563811,Zhang; Danna,9995,0,9999,4
1714611517343,MATH 197,003,628552,Dumitriu; Ioana,9998,0,9999,1
1714611518368,MCWP 40R,A00,518780,Staff,2,0,20,18
1714611518368,MCWP 40R,B00,518781,Staff,8,0,20,12
1714611518368,MCWP 40R,C00,518783,Staff,6,0,20,14
1714611519396,MCWP 50R,A00,518791,Staff,0,0,20,20
1714611519396,MCWP 50R,B00,518792,Staff,0,2,20,20
1714611519396,MCWP 50R,C00,518793,Staff,0,2,20,20
1714611519396,MCWP 50R,D00,518794,Staff,0,0,20,20
1714611519396,MCWP 50R,E00,518795,Staff,0,2,20,20
1714611519396,MCWP 50R,F00,518796,Staff,0,0,20,20
1714611519396,MCWP 50R,G00,518797,Staff,0,1,20,20
1714611520423,MMW 12R,A01,514034,Herbst; Matthew,0,0,16,16
1714611520423,MMW 12R,A02,514035,Herbst; Matthew,1,0,16,15
1714611521452,MMW 13R,A01,514037,Staff,0,4,16,16
1714611521452,MMW 13R,A02,514039,Staff,0,2,16,16
1714611521452,MMW 13R,A03,628519,Staff,0,2,16,16
1714611523509,SIO 295LS,A00,523233,Staff,10,0,30,20
1714611524536,SIO 295S,A00,523232,Staff,10,0,30,20
1714611525564,SIOC 290S,A01,637330,Merrifield; Mark A,23,0,30,7
1714611526591,SIOC 291S,A01,637333,Gabriel; Corey John,23,0,30,7
1714611527616,SOCI 117,A01,494376,Staff,0,4,5,5
1714611528642,WES 237B,A00,494380,Staff,9,0,20,11
1714611530715,AESE 279B,A00,494370,Wade; Jon P,0,0,33,33
1714611531738,AIP 197,001,627712,Vespa; Emanuel Ignacio,9998,0,9999,1
1714611532765,ANAR 135S,A00,494369,Braswell; Geoffrey E.,0,0,0,0
1714611533790,BENG 196,001,628496,Engler; Adam J.,9998,0,9999,1
1714611534817,CAT 124RS,A01,519847,Geibel; William,0,0,20,20
1714611535842,CAT 125RS,A01,515971,Geibel; William,0,0,20,20
1714611536871,CLRE 250,A00,511389,Morris; Sheldon,9993,0,9999,6
1714611537900,CLRE 251,A00,507176,Mehta; Ravindra L.,9993,0,9999,6
1714611537900,CLRE 251,B00,511410,Mehta; Ravindra L.,9998,0,9999,1
1714611538924,CLRE 252,A00,507189,Cuomo; Raphael Eduardo,9995,0,9999,4
1714611539953,CLRE 253,A00,507199,Vaida; Florin,9994,0,9999,5
1714611539953,CLRE 253,B00,507202,Vaida; Florin,9999,0,9999,0
1714611541030,CLRE 259,A00,507211,Patel; Hemal,9996,0,9999,3
1714611542059,CLRE 260,A00,507221,Cuomo; Raphael Eduardo,9999,0,9999,0
1714611543085,CLRE 297,001,507242,Cuomo; Raphael Eduardo,9999,0,9999,0
1714611544111,COGS 197,001,638244,Voytek; Bradley Thomas,9998,0,9999,1
1714611545135,CSE 191,A00,516875,Minnes Kemp; Mor Mia,9992,0,9999,7
1714611546163,CSE 197,001,637388,Minnes Kemp; Mor Mia,9998,0,9999,1
1714611547285,CSS 201S,A01,494383,Staff,35,0,35,0
1714611548313,CSS 202S,A01,494387,Staff,35,0,35,0
1714611549341,DSC 197,001,628532,Eldridge; Justin Matthew,9996,0,9999,3
1714611550368,EAP 100,A00,516065,Staff,9797,0,9999,202
1714611551394,ECE 45,A01,507414,Staff,33,0,60,27
1714611553448,ECE 111,A01,507420,Staff,15,0,50,35
1714611554472,ECE 197,001,548057,Sievenpiper; Daniel F.,9993,0,9999,6
1714611555499,EDS 115,A00,507243,Choi; Bailey Miyeon,10,0,28,18
1714611556524,EDS 117,A01,494379,Staff,1,5,30,29
1714611557554,EDS 125,A00,507246,Hopkins; Megan Beth,9,0,30,21
1714611558584,EDS 128A,A01,507264,Fargason; Sharon Gayle,8,0,26,18
1714611560222,EDS 128B,A01,507293,Pappas; Elizabeth,12,0,30,18
1714611561249,EDS 139,A00,507294,Fargason; Sharon Gayle,13,0,30,17
1714611561249,EDS 139,B00,507313,Pappas; Elizabeth,13,0,30,17
1714611562274,EDS 201,A00,507315,Staff,13,0,30,17
1714611563301,EDS 203,A01,507317,Halter; Christopher P.,12,0,30,18
1714611564327,EDS 204R,A01,507319,Halter; Christopher P.,0,3,30,30
1714611564327,EDS 204R,B01,507331,Heinzman; Erica M.,16,0,30,14
1714611565353,EDS 206R,A00,507332,Staff,0,4,30,30
1714611565353,EDS 206R,B00,507343,Staff,17,0,30,13
1714611566380,EDS 250,A00,507344,Hemans; Patricia Ann Benitez,22,0,40,18
1714611567404,EDS 281,A00,507345,Daly; Alan J.,18,0,18,0
1714611568430,EDS 284,A00,507350,Daly; Alan J.,16,0,16,0
1714611569455,EDS 286,A00,507359,Fine; Sarah,18,0,18,0
1714611570482,EDS 289C,A01,507361,Daly; Alan J.,18,0,18,0
1714611571508,EDS 290,A00,507366,Hofstetter; Carolyn,15,0,15,0
1714611572534,LIGM 5A,A00,507421,Fischer-Grunski; Eva K,18,0,20,2
1714611573560,LIGM 5B,A00,507423,Fischer-Grunski; Eva K,19,0,20,1
1714611574585,LIGM 5C,A00,507425,Fischer-Grunski; Eva K,19,0,20,1
1714611575611,LIIT 5AS,A00,507427,Carnelos; Chiara,20,0,20,0
1714611576641,LIIT 5BS,A00,507430,Carnelos; Chiara,20,0,20,0
1714611577670,LIIT 5CS,A00,507432,Carnelos; Chiara,20,0,20,0
1714611578695,LISP 5A,A00,507541,Munoz Sanchez; Alicia,11,0,20,9
1714611579725,LISP 5B,A00,507671,Munoz Sanchez; Alicia,8,0,20,12
1714611580754,LISP 5C,A00,507696,Munoz Sanchez; Alicia,9,0,20,11
1714611581781,MAE 197,001,528363,Boechler; Nicholas Sebastia,9998,0,9999,1
1714611582808,MATH 197,001,523477,Kedlaya; Kiran S.,9995,0,9999,4
1714611582808,MATH 197,002,563811,Zhang; Danna,9995,0,9999,4
1714611582808,MATH 197,003,628552,Dumitriu; Ioana,9998,0,9999,1
1714611583834,MCWP 40R,A00,518780,Staff,2,0,20,18
1714611583834,MCWP 40R,B00,518781,Staff,8,0,20,12
1714611583834,MCWP 40R,C00,518783,Staff,6,0,20,14
1714611584864,MCWP 50R,A00,518791,Staff,0,0,20,20
1714611584864,MCWP 50R,B00,518792,Staff,0,2,20,20
1714611584864,MCWP 50R,C00,518793,Staff,0,2,20,20
1714611584864,MCWP 50R,D00,518794,Staff,0,0,20,20
1714611584864,MCWP 50R,E00,518795,Staff,0,2,20,20
1714611584864,MCWP 50R,F00,518796,Staff,0,0,20,20
1714611584864,MCWP 50R,G00,518797,Staff,0,1,20,20
1714611585888,MMW 12R,A01,514034,Herbst; Matthew,0,0,16,16
1714611585888,MMW 12R,A02,514035,Herbst; Matthew,1,0,16,15
1714611586914,MMW 13R,A01,514037,Staff,0,4,16,16
1714611586914,MMW 13R,A02,514039,Staff,0,2,16,16
1714611586914,MMW 13R,A03,628519,Staff,0,2,16,16
1714611588967,SIO 295LS,A00,523233,Staff,10,0,30,20
1714611589991,SIO 295S,A00,523232,Staff,10,0,30,20
1714611591022,SIOC 290S,A01,637330,Merrifield; Mark A,23,0,30,7
1714611592048,SIOC 291S,A01,637333,Gabriel; Corey John,23,0,30,7
1714611593073,SOCI 117,A01,494376,Staff,0,4,5,5
1714611594100,WES 237B,A00,494380,Staff,9,0,20,11
1714611596169,AESE 279B,A00,494370,Wade; Jon P,0,0,33,33
1714611597197,AIP 197,001,627712,Vespa; Emanuel Ignacio,9998,0,9999,1
1714611598224,ANAR 135S,A00,494369,Braswell; Geoffrey E.,0,0,0,0
1714611599251,BENG 196,001,628496,Engler; Adam J.,9998,0,9999,1
1714611600276,CAT 124RS,A01,519847,Geibel; William,0,0,20,20
1714611601303,CAT 125RS,A01,515971,Geibel; William,0,0,20,20
1714611602329,CLRE 250,A00,511389,Morris; Sheldon,9993,0,9999,6
1714611603362,CLRE 251,A00,507176,Mehta; Ravindra L.,9993,0,9999,6
1714611603362,CLRE 251,B00,511410,Mehta; Ravindra L.,9998,0,9999,1
1714611604387,CLRE 252,A00,507189,Cuomo; Raphael Eduardo,9995,0,9999,4
1714611605416,CLRE 253,A00,507199,Vaida; Florin,9994,0,9999,5
1714611605416,CLRE 253,B00,507202,Vaida; Florin,9999,0,9999,0
1714611606443,CLRE 259,A00,507211,Patel; Hemal,9996,0,9999,3
1714611607484,CLRE 260,A00,507221,Cuomo; Raphael Eduardo,9999,0,9999,0
1714611608512,CLRE 297,001,507242,Cuomo; Raphael Eduardo,9999,0,9999,0
1714611609543,COGS 197,001,638244,Voytek; Bradley Thomas,9998,0,9999,1
1714611610571,CSE 191,A00,516875,Minnes Kemp; Mor Mia,9992,0,9999,7
1714611611599,CSE 197,001,637388,Minnes Kemp; Mor Mia,9998,0,9999,1
1714611612625,CSS 201S,A01,494383,Staff,35,0,35,0
1714611613649,CSS 202S,A01,494387,Staff,35,0,35,0
1714611614676,DSC 197,001,628532,Eldridge; Justin Matthew,9996,0,9999,3
1714611615703,EAP 100,A00,516065,Staff,9797,0,9999,202
1714611616733,ECE 45,A01,507414,Staff,33,0,60,27
1714611618788,ECE 111,A01,507420,Staff,15,0,50,35
1714611619815,ECE 197,001,548057,Sievenpiper; Daniel F.,9993,0,9999,6
1714611620841,EDS 115,A00,507243,Choi; Bailey Miyeon,10,0,28,18
1714611621869,EDS 117,A01,494379,Staff,1,5,30,29
1714611622897,EDS 125,A00,507246,Hopkins; Megan Beth,9,0,30,21
1714611623926,EDS 128A,A01,507264,Fargason; Sharon Gayle,8,0,26,18
1714611624957,EDS 128B,A01,507293,Pappas; Elizabeth,12,0,30,18
1714611625985,EDS 139,A00,507294,Fargason; Sharon Gayle,13,0,30,17
1714611625985,EDS 139,B00,507313,Pappas; Elizabeth,13,0,30,17
1714611627009,EDS 201,A00,507315,Staff,13,0,30,17
1714611628036,EDS 203,A01,507317,Halter; Christopher P.,12,0,30,18
1714611629062,EDS 204R,A01,507319,Halter; Christopher P.,0,3,30,30
1714611629062,EDS 204R,B01,507331,Heinzman; Erica M.,16,0,30,14
1714611630087,EDS 206R,A00,507332,Staff,0,4,30,30
1714611630087,EDS 206R,B00,507343,Staff,17,0,30,13
1714611631113,EDS 250,A00,507344,Hemans; Patricia Ann Benitez,22,0,40,18
1714611632137,EDS 281,A00,507345,Daly; Alan J.,18,0,18,0
1714611633164,EDS 284,A00,507350,Daly; Alan J.,16,0,16,0
1714611634189,EDS 286,A00,507359,Fine; Sarah,18,0,18,0
1714611635214,EDS 289C,A01,507361,Daly; Alan J.,18,0,18,0
1714611636239,EDS 290,A00,507366,Hofstetter; Carolyn,15,0,15,0
1714611637268,LIGM 5A,A00,507421,Fischer-Grunski; Eva K,18,0,20,2
1714611638294,LIGM 5B,A00,507423,Fischer-Grunski; Eva K,19,0,20,1
1714611639318,LIGM 5C,A00,507425,Fischer-Grunski; Eva K,19,0,20,1
1714611640347,LIIT 5AS,A00,507427,Carnelos; Chiara,20,0,20,0
1714611641375,LIIT 5BS,A00,507430,Carnelos; Chiara,20,0,20,0
1714611642401,LIIT 5CS,A00,507432,Carnelos; Chiara,20,0,20,0
1714611643431,LISP 5A,A00,507541,Munoz Sanchez; Alicia,11,0,20,9
1714611644459,LISP 5B,A00,507671,Munoz Sanchez; Alicia,8,0,20,12
1714611645484,LISP 5C,A00,507696,Munoz Sanchez; Alicia,9,0,20,11
1714611646512,MAE 197,001,528363,Boechler; Nicholas Sebastia,9998,0,9999,1
1714611647542,MATH 197,001,523477,Kedlaya; Kiran S.,9995,0,9999,4
1714611647542,MATH 197,002,563811,Zhang; Danna,9995,0,9999,4
1714611647542,MATH 197,003,628552,Dumitriu; Ioana,9998,0,9999,1
1714611648567,MCWP 40R,A00,518780,Staff,2,0,20,18
1714611648567,MCWP 40R,B00,518781,Staff,8,0,20,12
1714611648567,MCWP 40R,C00,518783,Staff,6,0,20,14
1714611649593,MCWP 50R,A00,518791,Staff,0,0,20,20
1714611649593,MCWP 50R,B00,518792,Staff,0,2,20,20
1714611649593,MCWP 50R,C00,518793,Staff,0,2,20,20
1714611649593,MCWP 50R,D00,518794,Staff,0,0,20,20
1714611649593,MCWP 50R,E00,518795,Staff,0,2,20,20
1714611649593,MCWP 50R,F00,518796,Staff,0,0,20,20
1714611649593,MCWP 50R,G00,518797,Staff,0,1,20,20
1714611650619,MMW 12R,A01,514034,Herbst; Matthew,0,0,16,16
1714611650619,MMW 12R,A02,514035,Herbst; Matthew,1,0,16,15
1714611651645,MMW 13R,A01,514037,Staff,0,4,16,16
1714611651645,MMW 13R,A02,514039,Staff,0,2,16,16
1714611651645,MMW 13R,A03,628519,Staff,0,2,16,16
1714611653696,SIO 295LS,A00,523233,Staff,10,0,30,20
1714611654775,SIO 295S,A00,523232,Staff,10,0,30,20
1714611655801,SIOC 290S,A01,637330,Merrifield; Mark A,23,0,30,7
1714611656827,SIOC 291S,A01,637333,Gabriel; Corey John,23,0,30,7
1714611657853,SOCI 117,A01,494376,Staff,0,4,5,5
1714611658879,WES 237B,A00,494380,Staff,9,0,20,11
1714611660956,AESE 279B,A00,494370,Wade; Jon P,0,0,33,33
1714611661985,AIP 197,001,627712,Vespa; Emanuel Ignacio,9998,0,9999,1
1714611663015,ANAR 135S,A00,494369,Braswell; Geoffrey E.,0,0,0,0
1714611664044,BENG 196,001,628496,Engler; Adam J.,9998,0,9999,1
1714611665069,CAT 124RS,A01,519847,Geibel; William,0,0,20,20
1714611666094,CAT 125RS,A01,515971,Geibel; William,0,0,20,20
1714611667127,CLRE 250,A00,511389,Morris; Sheldon,9993,0,9999,6
1714611668155,CLRE 251,A00,507176,Mehta; Ravindra L.,9993,0,9999,6
1714611668155,CLRE 251,B00,511410,Mehta; Ravindra L.,9998,0,9999,1
1714611669181,CLRE 252,A00,507189,Cuomo; Raphael Eduardo,9995,0,9999,4
1714611670207,CLRE 253,A00,507199,Vaida; Florin,9994,0,9999,5
1714611670207,CLRE 253,B00,507202,Vaida; Florin,9999,0,9999,0
1714611671232,CLRE 259,A00,507211,Patel; Hemal,9996,0,9999,3
1714611672256,CLRE 260,A00,507221,Cuomo; Raphael Eduardo,9999,0,9999,0
1714611673280,CLRE 297,001,507242,Cuomo; Raphael Eduardo,9999,0,9999,0
1714611674310,COGS 197,001,638244,Voytek; Bradley Thomas,9998,0,9999,1
1714611675337,CSE 191,A00,516875,Minnes Kemp; Mor Mia,9992,0,9999,7
1714611676366,CSE 197,001,637388,Minnes Kemp; Mor Mia,9998,0,9999,1
1714611677397,CSS 201S,A01,494383,Staff,35,0,35,0
1714611678425,CSS 202S,A01,494387,Staff,35,0,35,0
1714611679452,DSC 197,001,628532,Eldridge; Justin Matthew,9996,0,9999,3
1714611680476,EAP 100,A00,516065,Staff,9797,0,9999,202
1714611681501,ECE 45,A01,507414,Staff,33,0,60,27
1714611683553,ECE 111,A01,507420,Staff,15,0,50,35
1714611684581,ECE 197,001,548057,Sievenpiper; Daniel F.,9993,0,9999,6
1714611685606,EDS 115,A00,507243,Choi; Bailey Miyeon,10,0,28,18
1714611686631,EDS 117,A01,494379,Staff,1,5,30,29
1714611687659,EDS 125,A00,507246,Hopkins; Megan Beth,9,0,30,21
1714611688688,EDS 128A,A01,507264,Fargason; Sharon Gayle,8,0,26,18
1714611689718,EDS 128B,A01,507293,Pappas; Elizabeth,12,0,30,18
1714611690742,EDS 139,A00,507294,Fargason; Sharon Gayle,13,0,30,17
1714611690742,EDS 139,B00,507313,Pappas; Elizabeth,13,0,30,17
1714611691769,EDS 201,A00,507315,Staff,13,0,30,17
1714611692799,EDS 203,A01,507317,Halter; Christopher P.,12,0,30,18
1714611693823,EDS 204R,A01,507319,Halter; Christopher P.,0,3,30,30
1714611693823,EDS 204R,B01,507331,Heinzman; Erica M.,16,0,30,14
1714611694849,EDS 206R,A00,507332,Staff,0,4,30,30
1714611694849,EDS 206R,B00,507343,Staff,17,0,30,13
1714611695874,EDS 250,A00,507344,Hemans; Patricia Ann Benitez,22,0,40,18
1714611696900,EDS 281,A00,507345,Daly; Alan J.,18,0,18,0
1714611697924,EDS 284,A00,507350,Daly; Alan J.,16,0,16,0
1714611698952,EDS 286,A00,507359,Fine; Sarah,18,0,18,0
1714611699976,EDS 289C,A01,507361,Daly; Alan J.,18,0,18,0
1714611700999,EDS 290,A00,507366,Hofstetter; Carolyn,15,0,15,0
1714611702027,LIGM 5A,A00,507421,Fischer-Grunski; Eva K,18,0,20,2
1714611703056,LIGM 5B,A00,507423,Fischer-Grunski; Eva K,19,0,20,1
1714611704080,LIGM 5C,A00,507425,Fischer-Grunski; Eva K,19,0,20,1
1714611705104,LIIT 5AS,A00,507427,Carnelos; Chiara,20,0,20,0
1714611706129,LIIT 5BS,A00,507430,Carnelos; Chiara,20,0,20,0
1714611707157,LIIT 5CS,A00,507432,Carnelos; Chiara,20,0,20,0
1714611708183,LISP 5A,A00,507541,Munoz Sanchez; Alicia,11,0,20,9
1714611709208,LISP 5B,A00,507671,Munoz Sanchez; Alicia,8,0,20,12
1714611710237,LISP 5C,A00,507696,Munoz Sanchez; Alicia,9,0,20,11
1714611711262,MAE 197,001,528363,Boechler; Nicholas Sebastia,9998,0,9999,1
1714611712288,MATH 197,001,523477,Kedlaya; Kiran S.,9995,0,9999,4
1714611712288,MATH 197,002,563811,Zhang; Danna,9995,0,9999,4
1714611712288,MATH 197,003,628552,Dumitriu; Ioana,9998,0,9999,1
1714611713314,MCWP 40R,A00,518780,Staff,2,0,20,18
1714611713314,MCWP 40R,B00,518781,Staff,8,0,20,12
1714611713314,MCWP 40R,C00,518783,Staff,6,0,20,14
1714611714339,MCWP 50R,A00,518791,Staff,0,0,20,20
1714611714339,MCWP 50R,B00,518792,Staff,0,2,20,20
1714611714339,MCWP 50R,C00,518793,Staff,0,2,20,20
1714611714339,MCWP 50R,D00,518794,Staff,0,0,20,20
1714611714339,MCWP 50R,E00,518795,Staff,0,2,20,20
1714611714339,MCWP 50R,F00,518796,Staff,0,0,20,20
1714611714339,MCWP 50R,G00,518797,Staff,0,1,20,20
1714611715367,MMW 12R,A01,514034,Herbst; Matthew,0,0,16,16
1714611715367,MMW 12R,A02,514035,Herbst; Matthew,1,0,16,15
1714611716393,MMW 13R,A01,514037,Staff,0,4,16,16
1714611716393,MMW 13R,A02,514039,Staff,0,2,16,16
1714611716393,MMW 13R,A03,628519,Staff,0,2,16,16
1714611718446,SIO 295LS,A00,523233,Staff,10,0,30,20
1714611719471,SIO 295S,A00,523232,Staff,10,0,30,20
1714611720499,SIOC 290S,A01,637330,Merrifield; Mark A,23,0,30,7
1714611721531,SIOC 291S,A01,637333,Gabriel; Corey John,23,0,30,7
1714611722557,SOCI 117,A01,494376,Staff,0,4,5,5
1714611723583,WES 237B,A00,494380,Staff,9,0,20,11
1714611725650,AESE 279B,A00,494370,Wade; Jon P,0,0,33,33
1714611726676,AIP 197,001,627712,Vespa; Emanuel Ignacio,9998,0,9999,1
1714611727702,ANAR 135S,A00,494369,Braswell; Geoffrey E.,0,0,0,0
1714611728729,BENG 196,001,628496,Engler; Adam J.,9998,0,9999,1
1714611729755,CAT 124RS,A01,519847,Geibel; William,0,0,20,20
1714611730781,CAT 125RS,A01,515971,Geibel; William,0,0,20,20
1714611731808,CLRE 250,A00,511389,Morris; Sheldon,9993,0,9999,6
1714611732844,CLRE 251,A00,507176,Mehta; Ravindra L.,9993,0,9999,6
1714611732844,CLRE 251,B00,511410,Mehta; Ravindra L.,9998,0,9999,1
1714611733876,CLRE 252,A00,507189,Cuomo; Raphael Eduardo,9995,0,9999,4
1714611734903,CLRE 253,A00,507199,Vaida; Florin,9994,0,9999,5
1714611734903,CLRE 253,B00,507202,Vaida; Florin,9999,0,9999,0
1714611735929,CLRE 259,A00,507211,Patel; Hemal,9996,0,9999,3
1714611736953,CLRE 260,A00,507221,Cuomo; Raphael Eduardo,9999,0,9999,0
1714611737978,CLRE 297,001,507242,Cuomo; Raphael Eduardo,9999,0,9999,0
1714611739003,COGS 197,001,638244,Voytek; Bradley Thomas,9998,0,9999,1
1714611740033,CSE 191,A00,516875,Minnes Kemp; Mor Mia,9992,0,9999,7
1714611741061,CSE 197,001,637388,Minnes Kemp; Mor Mia,9998,0,9999,1
1714611742092,CSS 201S,A01,494383,Staff,35,0,35,0
1714611743123,CSS 202S,A01,494387,Staff,35,0,35,0
1714611744159,DSC 197,001,628532,Eldridge; Justin Matthew,9996,0,9999,3
1714611745184,EAP 100,A00,516065,Staff,9797,0,9999,202
1714611746216,ECE 45,A01,507414,Staff,33,0,60,27
1714611748267,ECE 111,A01,507420,Staff,15,0,50,35
1714611749292,ECE 197,001,548057,Sievenpiper; Daniel F.,9993,0,9999,6
1714611750318,EDS 115,A00,507243,Choi; Bailey Miyeon,10,0,28,18
1714611751345,EDS 117,A01,494379,Staff,1,5,30,29
1714611752369,EDS 125,A00,507246,Hopkins; Megan Beth,9,0,30,21
1714611753400,EDS 128A,A01,507264,Fargason; Sharon Gayle,8,0,26,18
1714611754424,EDS 128B,A01,507293,Pappas; Elizabeth,12,0,30,18
1714611755449,EDS 139,A00,507294,Fargason; Sharon Gayle,13,0,30,17
1714611755449,EDS 139,B00,507313,Pappas; Elizabeth,13,0,30,17
1714611756474,EDS 201,A00,507315,Staff,13,0,30,17
1714611757498,EDS 203,A01,507317,Halter; Christopher P.,12,0,30,18
1714611758581,EDS 204R,A01,507319,Halter; Christopher P.,0,3,30,30
1714611758581,EDS 204R,B01,507331,Heinzman; Erica M.,16,0,30,14
1714611759608,EDS 206R,A00,507332,Staff,0,4,30,30
1714611759608,EDS 206R,B00,507343,Staff,17,0,30,13
1714611760634,EDS 250,A00,507344,Hemans; Patricia Ann Benitez,22,0,40,18
1714611761658,EDS 281,A00,507345,Daly; Alan J.,18,0,18,0
1714611762683,EDS 284,A00,507350,Daly; Alan J.,16,0,16,0
1714611763711,EDS 286,A00,507359,Fine; Sarah,18,0,18,0
1714611764737,EDS 289C,A01,507361,Daly; Alan J.,18,0,18,0
1714611765763,EDS 290,A00,507366,Hofstetter; Carolyn,15,0,15,0
1714611766793,LIGM 5A,A00,507421,Fischer-Grunski; Eva K,18,0,20,2
1714611767818,LIGM 5B,A00,507423,Fischer-Grunski; Eva K,19,0,20,1
1714611768848,LIGM 5C,A00,507425,Fischer-Grunski; Eva K,19,0,20,1
1714611769872,LIIT 5AS,A00,507427,Carnelos; Chiara,20,0,20,0
1714611770900,LIIT 5BS,A00,507430,Carnelos; Chiara,20,0,20,0
1714611771924,LIIT 5CS,A00,507432,Carnelos; Chiara,20,0,20,0
1714611772952,LISP 5A,A00,507541,Munoz Sanchez; Alicia,11,0,20,9
1714611773981,LISP 5B,A00,507671,Munoz Sanchez; Alicia,8,0,20,12
1714611775006,LISP 5C,A00,507696,Munoz Sanchez; Alicia,9,0,20,11
1714611776033,MAE 197,001,528363,Boechler; Nicholas Sebastia,9998,0,9999,1
1714611777062,MATH 197,001,523477,Kedlaya; Kiran S.,9995,0,9999,4
1714611777062,MATH 197,002,563811,Zhang; Danna,9995,0,9999,4
1714611777062,MATH 197,003,628552,Dumitriu; Ioana,9998,0,9999,1
1714611778093,MCWP 40R,A00,518780,Staff,2,0,20,18
1714611778093,MCWP 40R,B00,518781,Staff,8,0,20,12
1714611778093,MCWP 40R,C00,518783,Staff,6,0,20,14
1714611779117,MCWP 50R,A00,518791,Staff,0,0,20,20
1714611779117,MCWP 50R,B00,518792,Staff,0,2,20,20
1714611779117,MCWP 50R,C00,518793,Staff,0,2,20,20
1714611779117,MCWP 50R,D00,518794,Staff,0,0,20,20
1714611779117,MCWP 50R,E00,518795,Staff,0,2,20,20
1714611779117,MCWP 50R,F00,518796,Staff,0,0,20,20
1714611779117,MCWP 50R,G00,518797,Staff,0,1,20,20
1714611780142,MMW 12R,A01,514034,Herbst; Matthew,0,0,16,16
1714611780142,MMW 12R,A02,514035,Herbst; Matthew,1,0,16,15
1714611781170,MMW 13R,A01,514037,Staff,0,4,16,16
1714611781170,MMW 13R,A02,514039,Staff,0,2,16,16
1714611781170,MMW 13R,A03,628519,Staff,0,2,16,16
1714611783226,SIO 295LS,A00,523233,Staff,10,0,30,20
1714611784252,SIO 295S,A00,523232,Staff,10,0,30,20
1714611785282,SIOC 290S,A01,637330,Merrifield; Mark A,23,0,30,7
1714611786308,SIOC 291S,A01,637333,Gabriel; Corey John,23,0,30,7
1714611787335,SOCI 117,A01,494376,Staff,0,4,5,5
1714611788360,WES 237B,A00,494380,Staff,9,0,20,11
1714611790431,AESE 279B,A00,494370,Wade; Jon P,0,0,33,33
1714611791457,AIP 197,001,627712,Vespa; Emanuel Ignacio,9998,0,9999,1
1714611792483,ANAR 135S,A00,494369,Braswell; Geoffrey E.,0,0,0,0
1714611793511,BENG 196,001,628496,Engler; Adam J.,9998,0,9999,1
1714611794535,CAT 124RS,A01,519847,Geibel; William,0,0,20,20
1714611795561,CAT 125RS,A01,515971,Geibel; William,0,0,20,20
1714611796586,CLRE 250,A00,511389,Morris; Sheldon,9993,0,9999,6
1714611797621,CLRE 251,A00,507176,Mehta; Ravindra L.,9993,0,9999,6
1714611797621,CLRE 251,B00,511410,Mehta; Ravindra L.,9998,0,9999,1
1714611798651,CLRE 252,A00,507189,Cuomo; Raphael Eduardo,9995,0,9999,4
1714611799676,CLRE 253,A00,507199,Vaida; Florin,9994,0,9999,5
1714611799676,CLRE 253,B00,507202,Vaida; Florin,9999,0,9999,0
1714611800704,CLRE 259,A00,507211,Patel; Hemal,9996,0,9999,3
1714611801729,CLRE 260,A00,507221,Cuomo; Raphael Eduardo,9999,0,9999,0
1714611802754,CLRE 297,001,507242,Cuomo; Raphael Eduardo,9999,0,9999,0
1714611803780,COGS 197,001,638244,Voytek; Bradley Thomas,9998,0,9999,1
1714611804810,CSE 191,A00,516875,Minnes Kemp; Mor Mia,9992,0,9999,7
1714611805835,CSE 197,001,637388,Minnes Kemp; Mor Mia,9998,0,9999,1
1714611806866,CSS 201S,A01,494383,Staff,35,0,35,0
1714611807892,CSS 202S,A01,494387,Staff,35,0,35,0
1714611808920,DSC 197,001,628532,Eldridge; Justin Matthew,9996,0,9999,3
1714611809948,EAP 100,A00,516065,Staff,9797,0,9999,202
1714611810977,ECE 45,A01,507414,Staff,33,0,60,27
1714611813029,ECE 111,A01,507420,Staff,15,0,50,35
1714611814057,ECE 197,001,548057,Sievenpiper; Daniel F.,9993,0,9999,6
1714611815084,EDS 115,A00,507243,Choi; Bailey Miyeon,10,0,28,18
1714611816109,EDS 117,A01,494379,Staff,1,5,30,29
1714611817134,EDS 125,A00,507246,Hopkins; Megan Beth,9,0,30,21
1714611818159,EDS 128A,A01,507264,Fargason; Sharon Gayle,8,0,26,18
1714611819187,EDS 128B,A01,507293,Pappas; Elizabeth,12,0,30,18
1714611820212,EDS 139,A00,507294,Fargason; Sharon Gayle,13,0,30,17
1714611820212,EDS 139,B00,507313,Pappas; Elizabeth,13,0,30,17
1714611821238,EDS 201,A00,507315,Staff,13,0,30,17
1714611822263,EDS 203,A01,507317,Halter; Christopher P.,12,0,30,18
1714611823293,EDS 204R,A01,507319,Halter; Christopher P.,0,3,30,30
1714611823293,EDS 204R,B01,507331,Heinzman; Erica M.,16,0,30,14
1714611824323,EDS 206R,A00,507332,Staff,0,4,30,30
1714611824323,EDS 206R,B00,507343,Staff,17,0,30,13
1714611825349,EDS 250,A00,507344,Hemans; Patricia Ann Benitez,22,0,40,18
1714611826373,EDS 281,A00,507345,Daly; Alan J.,18,0,18,0
1714611827399,EDS 284,A00,507350,Daly; Alan J.,16,0,16,0
1714611828426,EDS 286,A00,507359,Fine; Sarah,18,0,18,0
1714611829451,EDS 289C,A01,507361,Daly; Alan J.,18,0,18,0
1714611830476,EDS 290,A00,507366,Hofstetter; Carolyn,15,0,15,0
1714611831502,LIGM 5A,A00,507421,Fischer-Grunski; Eva K,18,0,20,2
1714611832527,LIGM 5B,A00,507423,Fischer-Grunski; Eva K,19,0,20,1
1714611833552,LIGM 5C,A00,507425,Fischer-Grunski; Eva K,19,0,20,1
1714611834576,LIIT 5AS,A00,507427,Carnelos; Chiara,20,0,20,0
1714611835600,LIIT 5BS,A00,507430,Carnelos; Chiara,20,0,20,0
1714611836628,LIIT 5CS,A00,507432,Carnelos; Chiara,20,0,20,0
1714611837657,LISP 5A,A00,507541,Munoz Sanchez; Alicia,11,0,20,9
1714611838685,LISP 5B,A00,507671,Munoz Sanchez; Alicia,8,0,20,12
1714611839708,LISP 5C,A00,507696,Munoz Sanchez; Alicia,9,0,20,11
1714611840733,MAE 197,001,528363,Boechler; Nicholas Sebastia,9998,0,9999,1
1714611841768,MATH 197,001,523477,Kedlaya; Kiran S.,9995,0,9999,4
1714611841768,MATH 197,002,563811,Zhang; Danna,9995,0,9999,4
1714611841768,MATH 197,003,628552,Dumitriu; Ioana,9998,0,9999,1
1714611842794,MCWP 40R,A00,518780,Staff,2,0,20,18
1714611842794,MCWP 40R,B00,518781,Staff,8,0,20,12
1714611842794,MCWP 40R,C00,518783,Staff,6,0,20,14
1714611843824,MCWP 50R,A00,518791,Staff,0,0,20,20
1714611843824,MCWP 50R,B00,518792,Staff,0,2,20,20
1714611843824,MCWP 50R,C00,518793,Staff,0,2,20,20
1714611843824,MCWP 50R,D00,518794,Staff,0,0,20,20
1714611843824,MCWP 50R,E00,518795,Staff,0,2,20,20
1714611843824,MCWP 50R,F00,518796,Staff,0,0,20,20
1714611843824,MCWP 50R,G00,518797,Staff,0,1,20,20
1714611844850,MMW 12R,A01,514034,Herbst; Matthew,0,0,16,16
1714611844850,MMW 12R,A02,514035,Herbst; Matthew,1,0,16,15
1714611845878,MMW 13R,A01,514037,Staff,0,4,16,16
1714611845878,MMW 13R,A02,514039,Staff,0,2,16,16
1714611845878,MMW 13R,A03,628519,Staff,0,2,16,16
1714611847932,SIO 295LS,A00,523233,Staff,10,0,30,20
1714611848959,SIO 295S,A00,523232,Staff,10,0,30,20
1714611849986,SIOC 290S,A01,637330,Merrifield; Mark A,23,0,30,7
1714611851016,SIOC 291S,A01,637333,Gabriel; Corey John,23,0,30,7
1714611852044,SOCI 117,A01,494376,Staff,0,4,5,5
1714611853072,WES 237B,A00,494380,Staff,9,0,20,11
1714611855157,AESE 279B,A00,494370,Wade; Jon P,0,0,33,33
1714611856182,AIP 197,001,627712,Vespa; Emanuel Ignacio,9998,0,9999,1
1714611857208,ANAR 135S,A00,494369,Braswell; Geoffrey E.,0,0,0,0
1714611858236,BENG 196,001,628496,Engler; Adam J.,9998,0,9999,1
1714611859263,CAT 124RS,A01,519847,Geibel; William,0,0,20,20
1714611860290,CAT 125RS,A01,515971,Geibel; William,0,0,20,20
1714611861316,CLRE 250,A00,511389,Morris; Sheldon,9993,0,9999,6
1714611862396,CLRE 251,A00,507176,Mehta; Ravindra L.,9993,0,9999,6
1714611862396,CLRE 251,B00,511410,Mehta; Ravindra L.,9998,0,9999,1
1714611863424,CLRE 252,A00,507189,Cuomo; Raphael Eduardo,9995,0,9999,4
1714611864452,CLRE 253,A00,507199,Vaida; Florin,9994,0,9999,5
1714611864452,CLRE 253,B00,507202,Vaida; Florin,9999,0,9999,0
1714611865476,CLRE 259,A00,507211,Patel; Hemal,9996,0,9999,3
1714611866502,CLRE 260,A00,507221,Cuomo; Raphael Eduardo,9999,0,9999,0
1714611867529,CLRE 297,001,507242,Cuomo; Raphael Eduardo,9999,0,9999,0
1714611868557,COGS 197,001,638244,Voytek; Bradley Thomas,9998,0,9999,1
1714611869581,CSE 191,A00,516875,Minnes Kemp; Mor Mia,9992,0,9999,7
1714611870609,CSE 197,001,637388,Minnes Kemp; Mor Mia,9998,0,9999,1
1714611871635,CSS 201S,A01,494383,Staff,35,0,35,0
1714611872664,CSS 202S,A01,494387,Staff,35,0,35,0
1714611873692,DSC 197,001,628532,Eldridge; Justin Matthew,9996,0,9999,3
1714611874718,EAP 100,A00,516065,Staff,9797,0,9999,202
1714611875747,ECE 45,A01,507414,Staff,33,0,60,27
1714611877796,ECE 111,A01,507420,Staff,15,0,50,35
1714611878864,ECE 197,001,548057,Sievenpiper; Daniel F.,9993,0,9999,6
1714611879891,EDS 115,A00,507243,Choi; Bailey Miyeon,10,0,28,18
1714611880918,EDS 117,A01,494379,Staff,1,5,30,29
1714611881948,EDS 125,A00,507246,Hopkins; Megan Beth,9,0,30,21
1714611882974,EDS 128A,A01,507264,Fargason; Sharon Gayle,8,0,26,18
1714611884003,EDS 128B,A01,507293,Pappas; Elizabeth,12,0,30,18
1714611885031,EDS 139,A00,507294,Fargason; Sharon Gayle,13,0,30,17
1714611885031,EDS 139,B00,507313,Pappas; Elizabeth,13,0,30,17
1714611886055,EDS 201,A00,507315,Staff,13,0,30,17
1714611887085,EDS 203,A01,507317,Halter; Christopher P.,12,0,30,18
1714611888111,EDS 204R,A01,507319,Halter; Christopher P.,0,3,30,30
1714611888111,EDS 204R,B01,507331,Heinzman; Erica M.,16,0,30,14
1714611889136,EDS 206R,A00,507332,Staff,0,4,30,30
1714611889136,EDS 206R,B00,507343,Staff,17,0,30,13
1714611890160,EDS 250,A00,507344,Hemans; Patricia Ann Benitez,22,0,40,18
1714611891190,EDS 281,A00,507345,Daly; Alan J.,18,0,18,0
1714611892216,EDS 284,A00,507350,Daly; Alan J.,16,0,16,0
1714611893243,EDS 286,A00,507359,Fine; Sarah,18,0,18,0
1714611894269,EDS 289C,A01,507361,Daly; Alan J.,18,0,18,0
1714611895295,EDS 290,A00,507366,Hofstetter; Carolyn,15,0,15,0
1714611896328,LIGM 5A,A00,507421,Fischer-Grunski; Eva K,18,0,20,2
1714611897356,LIGM 5B,A00,507423,Fischer-Grunski; Eva K,19,0,20,1
1714611898382,LIGM 5C,A00,507425,Fischer-Grunski; Eva K,19,0,20,1
1714611899413,LIIT 5AS,A00,507427,Carnelos; Chiara,20,0,20,0
1714611900439,LIIT 5BS,A00,507430,Carnelos; Chiara,20,0,20,0
1714611901464,LIIT 5CS,A00,507432,Carnelos; Chiara,20,0,20,0
1714611902490,LISP 5A,A00,507541,Munoz Sanchez; Alicia,11,0,20,9
1714611903520,LISP 5B,A00,507671,Munoz Sanchez; Alicia,8,0,20,12
1714611904547,LISP 5C,A00,507696,Munoz Sanchez; Alicia,9,0,20,11
1714611905575,MAE 197,001,528363,Boechler; Nicholas Sebastia,9998,0,9999,1
1714611906606,MATH 197,001,523477,Kedlaya; Kiran S.,9995,0,9999,4
1714611906606,MATH 197,002,563811,Zhang; Danna,9995,0,9999,4
1714611906606,MATH 197,003,628552,Dumitriu; Ioana,9998,0,9999,1
1714611907633,MCWP 40R,A00,518780,Staff,2,0,20,18
1714611907633,MCWP 40R,B00,518781,Staff,8,0,20,12
1714611907633,MCWP 40R,C00,518783,Staff,6,0,20,14
1714611908661,MCWP 50R,A00,518791,Staff,0,0,20,20
1714611908661,MCWP 50R,B00,518792,Staff,0,2,20,20
1714611908661,MCWP 50R,C00,518793,Staff,0,2,20,20
1714611908661,MCWP 50R,D00,518794,Staff,0,0,20,20
1714611908661,MCWP 50R,E00,518795,Staff,0,2,20,20
1714611908661,MCWP 50R,F00,518796,Staff,0,0,20,20
1714611908661,MCWP 50R,G00,518797,Staff,0,1,20,20
1714611909693,MMW 12R,A01,514034,Herbst; Matthew,0,0,16,16
1714611909693,MMW 12R,A02,514035,Herbst; Matthew,1,0,16,15
1714611910722,MMW 13R,A01,514037,Staff,0,4,16,16
1714611910722,MMW 13R,A02,514039,Staff,0,2,16,16
1714611910722,MMW 13R,A03,628519,Staff,0,2,16,16
1714611912777,SIO 295LS,A00,523233,Staff,10,0,30,20
1714611913801,SIO 295S,A00,523232,Staff,10,0,30,20
1714611914830,SIOC 290S,A01,637330,Merrifield; Mark A,23,0,30,7
1714611915857,SIOC 291S,A01,637333,Gabriel; Corey John,23,0,30,7
1714611916883,SOCI 117,A01,494376,Staff,0,4,5,5
1714611917908,WES 237B,A00,494380,Staff,9,0,20,11
1714611919990,AESE 279B,A00,494370,Wade; Jon P,0,0,33,33
1714611921018,AIP 197,001,627712,Vespa; Emanuel Ignacio,9998,0,9999,1
1714611922047,ANAR 135S,A00,494369,Braswell; Geoffrey E.,0,0,0,0
1714611923075,BENG 196,001,628496,Engler; Adam J.,9998,0,9999,1
1714611924105,CAT 124RS,A01,519847,Geibel; William,0,0,20,20
1714611925132,CAT 125RS,A01,515971,Geibel; William,0,0,20,20
1714611926158,CLRE 250,A00,511389,Morris; Sheldon,9993,0,9999,6
1714611927189,CLRE 251,A00,507176,Mehta; Ravindra L.,9993,0,9999,6
1714611927189,CLRE 251,B00,511410,Mehta; Ravindra L.,9998,0,9999,1
1714611928216,CLRE 252,A00,507189,Cuomo; Raphael Eduardo,9995,0,9999,4
1714611929244,CLRE 253,A00,507199,Vaida; Florin,9994,0,9999,5
1714611929244,CLRE 253,B00,507202,Vaida; Florin,9999,0,9999,0
1714611930269,CLRE 259,A00,507211,Patel; Hemal,9996,0,9999,3
1714611931296,CLRE 260,A00,507221,Cuomo; Raphael Eduardo,9999,0,9999,0
1714611932322,CLRE 297,001,507242,Cuomo; Raphael Eduardo,9999,0,9999,0
1714611933349,COGS 197,001,638244,Voytek; Bradley Thomas,9998,0,9999,1
1714611934373,CSE 191,A00,516875,Minnes Kemp; Mor Mia,9992,0,9999,7
1714611935399,CSE 197,001,637388,Minnes Kemp; Mor Mia,9998,0,9999,1
1714611936430,CSS 201S,A01,494383,Staff,35,0,35,0
1714611937454,CSS 202S,A01,494387,Staff,35,0,35,0
1714611938478,DSC 197,001,628532,Eldridge; Justin Matthew,9996,0,9999,3
1714611939506,EAP 100,A00,516065,Staff,9797,0,9999,202
1714611940531,ECE 45,A01,507414,Staff,33,0,60,27
1714611942581,ECE 111,A01,507420,Staff,15,0,50,35
1714611943607,ECE 197,001,548057,Sievenpiper; Daniel F.,9993,0,9999,6
1714611944634,EDS 115,A00,507243,Choi; Bailey Miyeon,10,0,28,18
1714611945661,EDS 117,A01,494379,Staff,1,5,30,29
1714611946685,EDS 125,A00,507246,Hopkins; Megan Beth,9,0,30,21
1714611947713,EDS 128A,A01,507264,Fargason; Sharon Gayle,8,0,26,18
1714611948739,EDS 128B,A01,507293,Pappas; Elizabeth,12,0,30,18
1714611949768,EDS 139,A00,507294,Fargason; Sharon Gayle,13,0,30,17
1714611949768,EDS 139,B00,507313,Pappas; Elizabeth,13,0,30,17
1714611950796,EDS 201,A00,507315,Staff,13,0,30,17
1714611951826,EDS 203,A01,507317,Halter; Christopher P.,12,0,30,18
1714611952851,EDS 204R,A01,507319,Halter; Christopher P.,0,3,30,30
1714611952851,EDS 204R,B01,507331,Heinzman; Erica M.,16,0,30,14
1714611953877,EDS 206R,A00,507332,Staff,0,4,30,30
1714611953877,EDS 206R,B00,507343,Staff,17,0,30,13
1714611954905,EDS 250,A00,507344,Hemans; Patricia Ann Benitez,22,0,40,18
1714611955930,EDS 281,A00,507345,Daly; Alan J.,18,0,18,0
1714611956956,EDS 284,A00,507350,Daly; Alan J.,16,0,16,0
1714611957983,EDS 286,A00,507359,Fine; Sarah,18,0,18,0
1714611959009,EDS 289C,A01,507361,Daly; Alan J.,18,0,18,0
1714611960036,EDS 290,A00,507366,Hofstetter; Carolyn,15,0,15,0
1714611961064,LIGM 5A,A00,507421,Fischer-Grunski; Eva K,18,0,20,2
1714611962093,LIGM 5B,A00,507423,Fischer-Grunski; Eva K,19,0,20,1
1714611963119,LIGM 5C,A00,507425,Fischer-Grunski; Eva K,19,0,20,1
1714611964147,LIIT 5AS,A00,507427,Carnelos; Chiara,20,0,20,0
1714611965173,LIIT 5BS,A00,507430,Carnelos; Chiara,20,0,20,0
1714611966201,LIIT 5CS,A00,507432,Carnelos; Chiara,20,0,20,0
1714611967227,LISP 5A,A00,507541,Munoz Sanchez; Alicia,11,0,20,9
1714611968257,LISP 5B,A00,507671,Munoz Sanchez; Alicia,8,0,20,12
1714611969282,LISP 5C,A00,507696,Munoz Sanchez; Alicia,9,0,20,11
1714611970310,MAE 197,001,528363,Boechler; Nicholas Sebastia,9998,0,9999,1
1714611971336,MATH 197,001,523477,Kedlaya; Kiran S.,9995,0,9999,4
1714611971336,MATH 197,002,563811,Zhang; Danna,9995,0,9999,4
1714611971336,MATH 197,003,628552,Dumitriu; Ioana,9998,0,9999,1
1714611972417,MCWP 40R,A00,518780,Staff,2,0,20,18
1714611972417,MCWP 40R,B00,518781,Staff,8,0,20,12
1714611972417,MCWP 40R,C00,518783,Staff,6,0,20,14
1714611973443,MCWP 50R,A00,518791,Staff,0,0,20,20
1714611973443,MCWP 50R,B00,518792,Staff,0,2,20,20
1714611973443,MCWP 50R,C00,518793,Staff,0,2,20,20
1714611973443,MCWP 50R,D00,518794,Staff,0,0,20,20
1714611973443,MCWP 50R,E00,518795,Staff,0,2,20,20
1714611973443,MCWP 50R,F00,518796,Staff,0,0,20,20
1714611973443,MCWP 50R,G00,518797,Staff,0,1,20,20
1714611974473,MMW 12R,A01,514034,Herbst; Matthew,0,0,16,16
1714611974473,MMW 12R,A02,514035,Herbst; Matthew,1,0,16,15
1714611975498,MMW 13R,A01,514037,Staff,0,4,16,16
1714611975498,MMW 13R,A02,514039,Staff,0,2,16,16
1714611975498,MMW 13R,A03,628519,Staff,0,2,16,16
1714611977551,SIO 295LS,A00,523233,Staff,10,0,30,20
1714611978576,SIO 295S,A00,523232,Staff,10,0,30,20
1714611979606,SIOC 290S,A01,637330,Merrifield; Mark A,23,0,30,7
1714611980637,SIOC 291S,A01,637333,Gabriel; Corey John,23,0,30,7
1714611981664,SOCI 117,A01,494376,Staff,0,4,5,5
1714611982693,WES 237B,A00,494380,Staff,9,0,20,11
1714611984764,AESE 279B,A00,494370,Wade; Jon P,0,0,33,33
1714611985791,AIP 197,001,627712,Vespa; Emanuel Ignacio,9998,0,9999,1
1714611986818,ANAR 135S,A00,494369,Braswell; Geoffrey E.,0,0,0,0
1714611987847,BENG 196,001,628496,Engler; Adam J.,9998,0,9999,1
1714611988872,CAT 124RS,A01,519847,Geibel; William,0,0,20,20
1714611989897,CAT 125RS,A01,515971,Geibel; William,0,0,20,20
1714611990922,CLRE 250,A00,511389,Morris; Sheldon,9993,0,9999,6
1714611991949,CLRE 251,A00,507176,Mehta; Ravindra L.,9993,0,9999,6
1714611991949,CLRE 251,B00,511410,Mehta; Ravindra L.,9998,0,9999,1
1714611992975,CLRE 252,A00,507189,Cuomo; Raphael Eduardo,9995,0,9999,4
1714611994007,CLRE 253,A00,507199,Vaida; Florin,9994,0,9999,5
1714611994007,CLRE 253,B00,507202,Vaida; Florin,9999,0,9999,0
1714611995034,CLRE 259,A00,507211,Patel; Hemal,9996,0,9999,3
1714611996059,CLRE 260,A00,507221,Cuomo; Raphael Eduardo,9999,0,9999,0
1714611997086,CLRE 297,001,507242,Cuomo; Raphael Eduardo,9999,0,9999,0
1714611998115,COGS 197,001,638244,Voytek; Bradley Thomas,9998,0,9999,1
1714611999143,CSE 191,A00,516875,Minnes Kemp; Mor Mia,9992,0,9999,7
1714612000170,CSE 197,001,637388,Minnes Kemp; Mor Mia,9998,0,9999,1
1714612001201,CSS 201S,A01,494383,Staff,35,0,35,0
1714612002232,CSS 202S,A01,494387,Staff,35,0,35,0
1714612003259,DSC 197,001,628532,Eldridge; Justin Matthew,9996,0,9999,3
1714612004283,EAP 100,A00,516065,Staff,9797,0,9999,202
1714612005330,ECE 45,A01,507414,Staff,33,0,60,27
1714612007381,ECE 111,A01,507420,Staff,15,0,50,35
1714612008406,ECE 197,001,548057,Sievenpiper; Daniel F.,9993,0,9999,6
1714612009433,EDS 115,A00,507243,Choi; Bailey Miyeon,10,0,28,18
1714612010460,EDS 117,A01,494379,Staff,1,5,30,29
1714612011485,EDS 125,A00,507246,Hopkins; Megan Beth,9,0,30,21
1714612012513,EDS 128A,A01,507264,Fargason; Sharon Gayle,8,0,26,18
1714612013538,EDS 128B,A01,507293,Pappas; Elizabeth,12,0,30,18
1714612014567,EDS 139,A00,507294,Fargason; Sharon Gayle,13,0,30,17
1714612014567,EDS 139,B00,507313,Pappas; Elizabeth,13,0,30,17
1714612015590,EDS 201,A00,507315,Staff,13,0,30,17
1714612016615,EDS 203,A01,507317,Halter; Christopher P.,12,0,30,18
1714612017642,EDS 204R,A01,507319,Halter; Christopher P.,0,3,30,30
1714612017642,EDS 204R,B01,507331,Heinzman; Erica M.,16,0,30,14
1714612018669,EDS 206R,A00,507332,Staff,0,4,30,30
1714612018669,EDS 206R,B00,507343,Staff,17,0,30,13
1714612019697,EDS 250,A00,507344,Hemans; Patricia Ann Benitez,22,0,40,18
1714612020722,EDS 281,A00,507345,Daly; Alan J.,18,0,18,0
1714612021748,EDS 284,A00,507350,Daly; Alan J.,16,0,16,0
1714612022774,EDS 286,A00,507359,Fine; Sarah,18,0,18,0
1714612023798,EDS 289C,A01,507361,Daly; Alan J.,18,0,18,0
1714612024827,EDS 290,A00,507366,Hofstetter; Carolyn,15,0,15,0
1714612025853,LIGM 5A,A00,507421,Fischer-Grunski; Eva K,18,0,20,2
1714612026880,LIGM 5B,A00,507423,Fischer-Grunski; Eva K,19,0,20,1
1714612027909,LIGM 5C,A00,507425,Fischer-Grunski; Eva K,19,0,20,1
1714612028934,LIIT 5AS,A00,507427,Carnelos; Chiara,20,0,20,0
1714612029966,LIIT 5BS,A00,507430,Carnelos; Chiara,20,0,20,0
1714612030990,LIIT 5CS,A00,507432,Carnelos; Chiara,20,0,20,0
1714612032015,LISP 5A,A00,507541,Munoz Sanchez; Alicia,11,0,20,9
1714612033040,LISP 5B,A00,507671,Munoz Sanchez; Alicia,8,0,20,12
1714612034066,LISP 5C,A00,507696,Munoz Sanchez; Alicia,9,0,20,11
1714612035092,MAE 197,001,528363,Boechler; Nicholas Sebastia,9998,0,9999,1
1714612036121,MATH 197,001,523477,Kedlaya; Kiran S.,9995,0,9999,4
1714612036121,MATH 197,002,563811,Zhang; Danna,9995,0,9999,4
1714612036121,MATH 197,003,628552,Dumitriu; Ioana,9998,0,9999,1
1714612037148,MCWP 40R,A00,518780,Staff,2,0,20,18
1714612037148,MCWP 40R,B00,518781,Staff,8,0,20,12
1714612037148,MCWP 40R,C00,518783,Staff,6,0,20,14
1714612038174,MCWP 50R,A00,518791,Staff,0,0,20,20
1714612038174,MCWP 50R,B00,518792,Staff,0,2,20,20
1714612038174,MCWP 50R,C00,518793,Staff,0,2,20,20
1714612038174,MCWP 50R,D00,518794,Staff,0,0,20,20
1714612038174,MCWP 50R,E00,518795,Staff,0,2,20,20
1714612038174,MCWP 50R,F00,518796,Staff,0,0,20,20
1714612038174,MCWP 50R,G00,518797,Staff,0,1,20,20
1714612039203,MMW 12R,A01,514034,Herbst; Matthew,0,0,16,16
1714612039203,MMW 12R,A02,514035,Herbst; Matthew,1,0,16,15
1714612040229,MMW 13R,A01,514037,Staff,0,4,16,16
1714612040229,MMW 13R,A02,514039,Staff,0,2,16,16
1714612040229,MMW 13R,A03,628519,Staff,0,2,16,16
1714612042281,SIO 295LS,A00,523233,Staff,10,0,30,20
1714612043306,SIO 295S,A00,523232,Staff,10,0,30,20
1714612044333,SIOC 290S,A01,637330,Merrifield; Mark A,23,0,30,7
1714612045362,SIOC 291S,A01,637333,Gabriel; Corey John,23,0,30,7
1714612046389,SOCI 117,A01,494376,Staff,0,4,5,5
1714612047417,WES 237B,A00,494380,Staff,9,0,20,11
1714612049489,AESE 279B,A00,494370,Wade; Jon P,0,0,33,33
1714612050516,AIP 197,001,627712,Vespa; Emanuel Ignacio,9998,0,9999,1
1714612051541,ANAR 135S,A00,494369,Braswell; Geoffrey E.,0,0,0,0
1714612052569,BENG 196,001,628496,Engler; Adam J.,9998,0,9999,1
1714612053593,CAT 124RS,A01,519847,Geibel; William,0,0,20,20
1714612054617,CAT 125RS,A01,515971,Geibel; William,0,0,20,20
1714612055645,CLRE 250,A00,511389,Morris; Sheldon,9993,0,9999,6
1714612056671,CLRE 251,A00,507176,Mehta; Ravindra L.,9993,0,9999,6
1714612056671,CLRE 251,B00,511410,Mehta; Ravindra L.,9998,0,9999,1
1714612057697,CLRE 252,A00,507189,Cuomo; Raphael Eduardo,9995,0,9999,4
1714612058726,CLRE 253,A00,507199,Vaida; Florin,9994,0,9999,5
1714612058726,CLRE 253,B00,507202,Vaida; Florin,9999,0,9999,0
1714612059753,CLRE 259,A00,507211,Patel; Hemal,9996,0,9999,3
1714612060781,CLRE 260,A00,507221,Cuomo; Raphael Eduardo,9999,0,9999,0
1714612061805,CLRE 297,001,507242,Cuomo; Raphael Eduardo,9999,0,9999,0
1714612062832,COGS 197,001,638244,Voytek; Bradley Thomas,9998,0,9999,1
1714612063856,CSE 191,A00,516875,Minnes Kemp; Mor Mia,9992,0,9999,7
1714612064880,CSE 197,001,637388,Minnes Kemp; Mor Mia,9998,0,9999,1
1714612065911,CSS 201S,A01,494383,Staff,35,0,35,0
1714612066939,CSS 202S,A01,494387,Staff,35,0,35,0
1714612067964,DSC 197,001,628532,Eldridge; Justin Matthew,9996,0,9999,3
1714612068989,EAP 100,A00,516065,Staff,9797,0,9999,202
1714612070022,ECE 45,A01,507414,Staff,33,0,60,27
1714612072077,ECE 111,A01,507420,Staff,15,0,50,35
1714612073102,ECE 197,001,548057,Sievenpiper; Daniel F.,9993,0,9999,6
1714612074133,EDS 115,A00,507243,Choi; Bailey Miyeon,10,0,28,18
1714612075159,EDS 117,A01,494379,Staff,1,5,30,29
1714612076186,EDS 125,A00,507246,Hopkins; Megan Beth,9,0,30,21
1714612077211,EDS 128A,A01,507264,Fargason; Sharon Gayle,8,0,26,18
1714612078239,EDS 128B,A01,507293,Pappas; Elizabeth,12,0,30,18
1714612079269,EDS 139,A00,507294,Fargason; Sharon Gayle,13,0,30,17
1714612079269,EDS 139,B00,507313,Pappas; Elizabeth,13,0,30,17
1714612080294,EDS 201,A00,507315,Staff,13,0,30,17
1714612081319,EDS 203,A01,507317,Halter; Christopher P.,12,0,30,18
1714612082349,EDS 204R,A01,507319,Halter; Christopher P.,0,3,30,30
1714612082349,EDS 204R,B01,507331,Heinzman; Erica M.,16,0,30,14
1714612083378,EDS 206R,A00,507332,Staff,0,4,30,30
1714612083378,EDS 206R,B00,507343,Staff,17,0,30,13
1714612084404,EDS 250,A00,507344,Hemans; Patricia Ann Benitez,22,0,40,18
1714612085429,EDS 281,A00,507345,Daly; Alan J.,18,0,18,0
1714612086456,EDS 284,A00,507350,Daly; Alan J.,16,0,16,0
1714612087484,EDS 286,A00,507359,Fine; Sarah,18,0,18,0
1714612088507,EDS 289C,A01,507361,Daly; Alan J.,18,0,18,0
1714612089556,EDS 290,A00,507366,Hofstetter; Carolyn,15,0,15,0
1714612090584,LIGM 5A,A00,507421,Fischer-Grunski; Eva K,18,0,20,2
1714612091614,LIGM 5B,A00,507423,Fischer-Grunski; Eva K,19,0,20,1
1714612092639,LIGM 5C,A00,507425,Fischer-Grunski; Eva K,19,0,20,1
1714612093666,LIIT 5AS,A00,507427,Carnelos; Chiara,20,0,20,0
1714612094690,LIIT 5BS,A00,507430,Carnelos; Chiara,20,0,20,0
1714612095715,LIIT 5CS,A00,507432,Carnelos; Chiara,20,0,20,0
1714612096746,LISP 5A,A00,507541,Munoz Sanchez; Alicia,11,0,20,9
1714612097774,LISP 5B,A00,507671,Munoz Sanchez; Alicia,8,0,20,12
1714612098800,LISP 5C,A00,507696,Munoz Sanchez; Alicia,9,0,20,11
1714612099825,MAE 197,001,528363,Boechler; Nicholas Sebastia,9998,0,9999,1
1714612100851,MATH 197,001,523477,Kedlaya; Kiran S.,9995,0,9999,4
1714612100851,MATH 197,002,563811,Zhang; Danna,9995,0,9999,4
1714612100851,MATH 197,003,628552,Dumitriu; Ioana,9998,0,9999,1
1714612101877,MCWP 40R,A00,518780,Staff,2,0,20,18
1714612101877,MCWP 40R,B00,518781,Staff,8,0,20,12
1714612101877,MCWP 40R,C00,518783,Staff,6,0,20,14
1714612102907,MCWP 50R,A00,518791,Staff,0,0,20,20
1714612102907,MCWP 50R,B00,518792,Staff,0,2,20,20
1714612102907,MCWP 50R,C00,518793,Staff,0,2,20,20
1714612102907,MCWP 50R,D00,518794,Staff,0,0,20,20
1714612102907,MCWP 50R,E00,518795,Staff,0,2,20,20
1714612102907,MCWP 50R,F00,518796,Staff,0,0,20,20
1714612102907,MCWP 50R,G00,518797,Staff,0,1,20,20
1714612103937,MMW 12R,A01,514034,Herbst; Matthew,0,0,16,16
1714612103937,MMW 12R,A02,514035,Herbst; Matthew,1,0,16,15
1714612104967,MMW 13R,A01,514037,Staff,0,4,16,16
1714612104967,MMW 13R,A02,514039,Staff,0,2,16,16
1714612104967,MMW 13R,A03,628519,Staff,0,2,16,16
1714612107020,SIO 295LS,A00,523233,Staff,10,0,30,20
1714612108045,SIO 295S,A00,523232,Staff,10,0,30,20
1714612109076,SIOC 290S,A01,637330,Merrifield; Mark A,23,0,30,7
1714612110106,SIOC 291S,A01,637333,Gabriel; Corey John,23,0,30,7
1714612111131,SOCI 117,A01,494376,Staff,0,4,5,5
1714612112159,WES 237B,A00,494380,Staff,9,0,20,11
1714612114223,AESE 279B,A00,494370,Wade; Jon P,0,0,33,33
1714612115248,AIP 197,001,627712,Vespa; Emanuel Ignacio,9998,0,9999,1
1714612116273,ANAR 135S,A00,494369,Braswell; Geoffrey E.,0,0,0,0
1714612117298,BENG 196,001,628496,Engler; Adam J.,9998,0,9999,1
1714612118326,CAT 124RS,A01,519847,Geibel; William,0,0,20,20
1714612119352,CAT 125RS,A01,515971,Geibel; William,0,0,20,20
1714612120375,CLRE 250,A00,511389,Morris; Sheldon,9993,0,9999,6
1714612121406,CLRE 251,A00,507176,Mehta; Ravindra L.,9993,0,9999,6
1714612121406,CLRE 251,B00,511410,Mehta; Ravindra L.,9998,0,9999,1
1714612122431,CLRE 252,A00,507189,Cuomo; Raphael Eduardo,9995,0,9999,4
1714612123455,CLRE 253,A00,507199,Vaida; Florin,9994,0,9999,5
1714612123455,CLRE 253,B00,507202,Vaida; Florin,9999,0,9999,0
1714612124481,CLRE 259,A00,507211,Patel; Hemal,9996,0,9999,3
1714612125511,CLRE 260,A00,507221,Cuomo; Raphael Eduardo,9999,0,9999,0
1714612126538,CLRE 297,001,507242,Cuomo; Raphael Eduardo,9999,0,9999,0
1714612127565,COGS 197,001,638244,Voytek; Bradley Thomas,9998,0,9999,1
1714612128591,CSE 191,A00,516875,Minnes Kemp; Mor Mia,9992,0,9999,7
1714612129616,CSE 197,001,637388,Minnes Kemp; Mor Mia,9998,0,9999,1
1714612130647,CSS 201S,A01,494383,Staff,35,0,35,0
1714612131671,CSS 202S,A01,494387,Staff,35,0,35,0
1714612132696,DSC 197,001,628532,Eldridge; Justin Matthew,9996,0,9999,3
1714612133721,EAP 100,A00,516065,Staff,9797,0,9999,202
1714612134751,ECE 45,A01,507414,Staff,33,0,60,27
1714612136804,ECE 111,A01,507420,Staff,15,0,50,35
1714612137833,ECE 197,001,548057,Sievenpiper; Daniel F.,9993,0,9999,6
1714612138860,EDS 115,A00,507243,Choi; Bailey Miyeon,10,0,28,18
1714612139886,EDS 117,A01,494379,Staff,1,5,30,29
1714612140915,EDS 125,A00,507246,Hopkins; Megan Beth,9,0,30,21
1714612141943,EDS 128A,A01,507264,Fargason; Sharon Gayle,8,0,26,18
1714612142974,EDS 128B,A01,507293,Pappas; Elizabeth,12,0,30,18
1714612144004,EDS 139,A00,507294,Fargason; Sharon Gayle,13,0,30,17
1714612144004,EDS 139,B00,507313,Pappas; Elizabeth,13,0,30,17
1714612145029,EDS 201,A00,507315,Staff,13,0,30,17
1714612146054,EDS 203,A01,507317,Halter; Christopher P.,12,0,30,18
1714612147079,EDS 204R,A01,507319,Halter; Christopher P.,0,3,30,30
1714612147079,EDS 204R,B01,507331,Heinzman; Erica M.,16,0,30,14
1714612148108,EDS 206R,A00,507332,Staff,0,4,30,30
1714612148108,EDS 206R,B00,507343,Staff,17,0,30,13
1714612149132,EDS 250,A00,507344,Hemans; Patricia Ann Benitez,22,0,40,18
1714612150160,EDS 281,A00,507345,Daly; Alan J.,18,0,18,0
1714612151187,EDS 284,A00,507350,Daly; Alan J.,16,0,16,0
1714612152216,EDS 286,A00,507359,Fine; Sarah,18,0,18,0
1714612153248,EDS 289C,A01,507361,Daly; Alan J.,18,0,18,0
1714612154273,EDS 290,A00,507366,Hofstetter; Carolyn,15,0,15,0
1714612155299,LIGM 5A,A00,507421,Fischer-Grunski; Eva K,18,0,20,2
1714612156324,LIGM 5B,A00,507423,Fischer-Grunski; Eva K,19,0,20,1
1714612157348,LIGM 5C,A00,507425,Fischer-Grunski; Eva K,19,0,20,1
1714612158374,LIIT 5AS,A00,507427,Carnelos; Chiara,20,0,20,0
1714612159401,LIIT 5BS,A00,507430,Carnelos; Chiara,20,0,20,0
1714612160426,LIIT 5CS,A00,507432,Carnelos; Chiara,20,0,20,0
1714612161452,LISP 5A,A00,507541,Munoz Sanchez; Alicia,11,0,20,9
1714612162479,LISP 5B,A00,507671,Munoz Sanchez; Alicia,8,0,20,12
1714612163505,LISP 5C,A00,507696,Munoz Sanchez; Alicia,9,0,20,11
1714612164534,MAE 197,001,528363,Boechler; Nicholas Sebastia,9998,0,9999,1
1714612165567,MATH 197,001,523477,Kedlaya; Kiran S.,9995,0,9999,4
1714612165567,MATH 197,002,563811,Zhang; Danna,9995,0,9999,4
1714612165567,MATH 197,003,628552,Dumitriu; Ioana,9998,0,9999,1
1714612166593,MCWP 40R,A00,518780,Staff,2,0,20,18
1714612166593,MCWP 40R,B00,518781,Staff,8,0,20,12
1714612166593,MCWP 40R,C00,518783,Staff,6,0,20,14
1714612167619,MCWP 50R,A00,518791,Staff,0,0,20,20
1714612167619,MCWP 50R,B00,518792,Staff,0,2,20,20
1714612167619,MCWP 50R,C00,518793,Staff,0,2,20,20
1714612167619,MCWP 50R,D00,518794,Staff,0,0,20,20
1714612167619,MCWP 50R,E00,518795,Staff,0,2,20,20
1714612167619,MCWP 50R,F00,518796,Staff,0,0,20,20
1714612167619,MCWP 50R,G00,518797,Staff,0,1,20,20
1714612168644,MMW 12R,A01,514034,Herbst; Matthew,0,0,16,16
1714612168644,MMW 12R,A02,514035,Herbst; Matthew,1,0,16,15
1714612169668,MMW 13R,A01,514037,Staff,0,4,16,16
1714612169668,MMW 13R,A02,514039,Staff,0,2,16,16
1714612169668,MMW 13R,A03,628519,Staff,0,2,16,16
1714612171719,SIO 295LS,A00,523233,Staff,10,0,30,20
1714612172745,SIO 295S,A00,523232,Staff,10,0,30,20
1714612173775,SIOC 290S,A01,637330,Merrifield; Mark A,23,0,30,7
1714612174801,SIOC 291S,A01,637333,Gabriel; Corey John,23,0,30,7
1714612175826,SOCI 117,A01,494376,Staff,0,4,5,5
1714612176852,WES 237B,A00,494380,Staff,9,0,20,11
1714612178926,AESE 279B,A00,494370,Wade; Jon P,0,0,33,33
1714612179952,AIP 197,001,627712,Vespa; Emanuel Ignacio,9998,0,9999,1
1714612180978,ANAR 135S,A00,494369,Braswell; Geoffrey E.,0,0,0,0
1714612182003,BENG 196,001,628496,Engler; Adam J.,9998,0,9999,1
1714612183034,CAT 124RS,A01,519847,Geibel; William,0,0,20,20
1714612184062,CAT 125RS,A01,515971,Geibel; William,0,0,20,20
1714612185088,CLRE 250,A00,511389,Morris; Sheldon,9993,0,9999,6
1714612186116,CLRE 251,A00,507176,Mehta; Ravindra L.,9993,0,9999,6
1714612186116,CLRE 251,B00,511410,Mehta; Ravindra L.,9998,0,9999,1
1714612187142,CLRE 252,A00,507189,Cuomo; Raphael Eduardo,9995,0,9999,4
1714612188169,CLRE 253,A00,507199,Vaida; Florin,9994,0,9999,5
1714612188169,CLRE 253,B00,507202,Vaida; Florin,9999,0,9999,0
1714612189201,CLRE 259,A00,507211,Patel; Hemal,9996,0,9999,3
1714612190226,CLRE 260,A00,507221,Cuomo; Raphael Eduardo,9999,0,9999,0
1714612191251,CLRE 297,001,507242,Cuomo; Raphael Eduardo,9999,0,9999,0
1714612192279,COGS 197,001,638244,Voytek; Bradley Thomas,9998,0,9999,1
1714612193304,CSE 191,A00,516875,Minnes Kemp; Mor Mia,9992,0,9999,7
1714612194330,CSE 197,001,637388,Minnes Kemp; Mor Mia,9998,0,9999,1
1714612195357,CSS 201S,A01,494383,Staff,35,0,35,0
1714612196383,CSS 202S,A01,494387,Staff,35,0,35,0
1714612197408,DSC 197,001,628532,Eldridge; Justin Matthew,9996,0,9999,3
1714612198435,EAP 100,A00,516065,Staff,9797,0,9999,202
1714612199463,ECE 45,A01,507414,Staff,33,0,60,27
1714612201521,ECE 111,A01,507420,Staff,15,0,50,35
1714612202545,ECE 197,001,548057,Sievenpiper; Daniel F.,9993,0,9999,6
1714612203571,EDS 115,A00,507243,Choi; Bailey Miyeon,10,0,28,18
1714612204601,EDS 117,A01,494379,Staff,1,5,30,29
1714612205631,EDS 125,A00,507246,Hopkins; Megan Beth,9,0,30,21
1714612206661,EDS 128A,A01,507264,Fargason; Sharon Gayle,8,0,26,18
1714612207687,EDS 128B,A01,507293,Pappas; Elizabeth,12,0,30,18
1714612208713,EDS 139,A00,507294,Fargason; Sharon Gayle,13,0,30,17
1714612208713,EDS 139,B00,507313,Pappas; Elizabeth,13,0,30,17
1714612209738,EDS 201,A00,507315,Staff,13,0,30,17
1714612210767,EDS 203,A01,507317,Halter; Christopher P.,12,0,30,18
1714612211796,EDS 204R,A01,507319,Halter; Christopher P.,0,3,30,30
1714612211796,EDS 204R,B01,507331,Heinzman; Erica M.,16,0,30,14
1714612212821,EDS 206R,A00,507332,Staff,0,4,30,30
1714612212821,EDS 206R,B00,507343,Staff,17,0,30,13
1714612213849,EDS 250,A00,507344,Hemans; Patricia Ann Benitez,22,0,40,18
1714612214874,EDS 281,A00,507345,Daly; Alan J.,18,0,18,0
1714612215898,EDS 284,A00,507350,Daly; Alan J.,16,0,16,0
1714612216926,EDS 286,A00,507359,Fine; Sarah,18,0,18,0
1714612217954,EDS 289C,A01,507361,Daly; Alan J.,18,0,18,0
1714612218978,EDS 290,A00,507366,Hofstetter; Carolyn,15,0,15,0
1714612220006,LIGM 5A,A00,507421,Fischer-Grunski; Eva K,18,0,20,2
1714612221033,LIGM 5B,A00,507423,Fischer-Grunski; Eva K,19,0,20,1
1714612222059,LIGM 5C,A00,507425,Fischer-Grunski; Eva K,19,0,20,1
1714612223084,LIIT 5AS,A00,507427,Carnelos; Chiara,20,0,20,0
1714612224109,LIIT 5BS,A00,507430,Carnelos; Chiara,20,0,20,0
1714612225135,LIIT 5CS,A00,507432,Carnelos; Chiara,20,0,20,0
1714612226160,LISP 5A,A00,507541,Munoz Sanchez; Alicia,11,0,20,9
1714612227187,LISP 5B,A00,507671,Munoz Sanchez; Alicia,8,0,20,12
1714612228211,LISP 5C,A00,507696,Munoz Sanchez; Alicia,9,0,20,11
1714612229240,MAE 197,001,528363,Boechler; Nicholas Sebastia,9998,0,9999,1
1714612230266,MATH 197,001,523477,Kedlaya; Kiran S.,9995,0,9999,4
1714612230266,MATH 197,002,563811,Zhang; Danna,9995,0,9999,4
1714612230266,MATH 197,003,628552,Dumitriu; Ioana,9998,0,9999,1
1714612231296,MCWP 40R,A00,518780,Staff,2,0,20,18
1714612231296,MCWP 40R,B00,518781,Staff,8,0,20,12
1714612231296,MCWP 40R,C00,518783,Staff,6,0,20,14
1714612232322,MCWP 50R,A00,518791,Staff,0,0,20,20
1714612232322,MCWP 50R,B00,518792,Staff,0,2,20,20
1714612232322,MCWP 50R,C00,518793,Staff,0,2,20,20
1714612232322,MCWP 50R,D00,518794,Staff,0,0,20,20
1714612232322,MCWP 50R,E00,518795,Staff,0,2,20,20
1714612232322,MCWP 50R,F00,518796,Staff,0,0,20,20
1714612232322,MCWP 50R,G00,518797,Staff,0,1,20,20
1714612233348,MMW 12R,A01,514034,Herbst; Matthew,0,0,16,16
1714612233348,MMW 12R,A02,514035,Herbst; Matthew,1,0,16,15
1714612234375,MMW 13R,A01,514037,Staff,0,4,16,16
1714612234375,MMW 13R,A02,514039,Staff,0,2,16,16
1714612234375,MMW 13R,A03,628519,Staff,0,2,16,16
1714612236429,SIO 295LS,A00,523233,Staff,10,0,30,20
1714612237454,SIO 295S,A00,523232,Staff,10,0,30,20
1714612238483,SIOC 290S,A01,637330,Merrifield; Mark A,23,0,30,7
1714612239513,SIOC 291S,A01,637333,Gabriel; Corey John,23,0,30,7
1714612240542,SOCI 117,A01,494376,Staff,0,4,5,5
1714612241567,WES 237B,A00,494380,Staff,9,0,20,11
1714612243634,AESE 279B,A00,494370,Wade; Jon P,0,0,33,33
1714612244659,AIP 197,001,627712,Vespa; Emanuel Ignacio,9998,0,9999,1
1714612245687,ANAR 135S,A00,494369,Braswell; Geoffrey E.,0,0,0,0
1714612246714,BENG 196,001,628496,Engler; Adam J.,9998,0,9999,1
1714612247739,CAT 124RS,A01,519847,Geibel; William,0,0,20,20
1714612248764,CAT 125RS,A01,515971,Geibel; William,0,0,20,20
1714612249791,CLRE 250,A00,511389,Morris; Sheldon,9993,0,9999,6
1714612250821,CLRE 251,A00,507176,Mehta; Ravindra L.,9993,0,9999,6
1714612250821,CLRE 251,B00,511410,Mehta; Ravindra L.,9998,0,9999,1
1714612251847,CLRE 252,A00,507189,Cuomo; Raphael Eduardo,9995,0,9999,4
1714612252876,CLRE 253,A00,507199,Vaida; Florin,9994,0,9999,5
1714612252876,CLRE 253,B00,507202,Vaida; Florin,9999,0,9999,0
1714612253905,CLRE 259,A00,507211,Patel; Hemal,9996,0,9999,3
1714612254931,CLRE 260,A00,507221,Cuomo; Raphael Eduardo,9999,0,9999,0
1714612255956,CLRE 297,001,507242,Cuomo; Raphael Eduardo,9999,0,9999,0
1714612256986,COGS 197,001,638244,Voytek; Bradley Thomas,9998,0,9999,1
1714612258013,CSE 191,A00,516875,Minnes Kemp; Mor Mia,9992,0,9999,7
1714612259040,CSE 197,001,637388,Minnes Kemp; Mor Mia,9998,0,9999,1
1714612260067,CSS 201S,A01,494383,Staff,35,0,35,0
1714612261094,CSS 202S,A01,494387,Staff,35,0,35,0
1714612262120,DSC 197,001,628532,Eldridge; Justin Matthew,9996,0,9999,3
1714612263149,EAP 100,A00,516065,Staff,9797,0,9999,202
1714612264175,ECE 45,A01,507414,Staff,33,0,60,27
1714612266228,ECE 111,A01,507420,Staff,15,0,50,35
1714612267255,ECE 197,001,548057,Sievenpiper; Daniel F.,9993,0,9999,6
1714612268281,EDS 115,A00,507243,Choi; Bailey Miyeon,10,0,28,18
1714612269311,EDS 117,A01,494379,Staff,1,5,30,29
1714612270335,EDS 125,A00,507246,Hopkins; Megan Beth,9,0,30,21
1714612271362,EDS 128A,A01,507264,Fargason; Sharon Gayle,8,0,26,18
1714612272391,EDS 128B,A01,507293,Pappas; Elizabeth,12,0,30,18
1714612273414,EDS 139,A00,507294,Fargason; Sharon Gayle,13,0,30,17
1714612273414,EDS 139,B00,507313,Pappas; Elizabeth,13,0,30,17
1714612274440,EDS 201,A00,507315,Staff,13,0,30,17
1714612275465,EDS 203,A01,507317,Halter; Christopher P.,12,0,30,18
1714612276491,EDS 204R,A01,507319,Halter; Christopher P.,0,3,30,30
1714612276491,EDS 204R,B01,507331,Heinzman; Erica M.,16,0,30,14
1714612277515,EDS 206R,A00,507332,Staff,0,4,30,30
1714612277515,EDS 206R,B00,507343,Staff,17,0,30,13
1714612278543,EDS 250,A00,507344,Hemans; Patricia Ann Benitez,22,0,40,18
1714612279568,EDS 281,A00,507345,Daly; Alan J.,18,0,18,0
1714612280596,EDS 284,A00,507350,Daly; Alan J.,16,0,16,0
1714612281626,EDS 286,A00,507359,Fine; Sarah,18,0,18,0
1714612282651,EDS 289C,A01,507361,Daly; Alan J.,18,0,18,0
1714612283681,EDS 290,A00,507366,Hofstetter; Carolyn,15,0,15,0
1714612284712,LIGM 5A,A00,507421,Fischer-Grunski; Eva K,18,0,20,2
1714612285738,LIGM 5B,A00,507423,Fischer-Grunski; Eva K,19,0,20,1
1714612286820,LIGM 5C,A00,507425,Fischer-Grunski; Eva K,19,0,20,1
1714612287845,LIIT 5AS,A00,507427,Carnelos; Chiara,20,0,20,0
1714612288869,LIIT 5BS,A00,507430,Carnelos; Chiara,20,0,20,0
1714612289894,LIIT 5CS,A00,507432,Carnelos; Chiara,20,0,20,0
1714612290920,LISP 5A,A00,507541,Munoz Sanchez; Alicia,11,0,20,9
1714612291946,LISP 5B,A00,507671,Munoz Sanchez; Alicia,8,0,20,12
1714612292970,LISP 5C,A00,507696,Munoz Sanchez; Alicia,9,0,20,11
1714612293999,MAE 197,001,528363,Boechler; Nicholas Sebastia,9998,0,9999,1
1714612295030,MATH 197,001,523477,Kedlaya; Kiran S.,9995,0,9999,4
1714612295030,MATH 197,002,563811,Zhang; Danna,9995,0,9999,4
1714612295030,MATH 197,003,628552,Dumitriu; Ioana,9998,0,9999,1
1714612296059,MCWP 40R,A00,518780,Staff,2,0,20,18
1714612296059,MCWP 40R,B00,518781,Staff,8,0,20,12
1714612296059,MCWP 40R,C00,518783,Staff,6,0,20,14
1714612297086,MCWP 50R,A00,518791,Staff,0,0,20,20
1714612297086,MCWP 50R,B00,518792,Staff,0,2,20,20
1714612297086,MCWP 50R,C00,518793,Staff,0,2,20,20
1714612297086,MCWP 50R,D00,518794,Staff,0,0,20,20
1714612297086,MCWP 50R,E00,518795,Staff,0,2,20,20
1714612297086,MCWP 50R,F00,518796,Staff,0,0,20,20
1714612297086,MCWP 50R,G00,518797,Staff,0,1,20,20
1714612298113,MMW 12R,A01,514034,Herbst; Matthew,0,0,16,16
1714612298113,MMW 12R,A02,514035,Herbst; Matthew,1,0,16,15
1714612299140,MMW 13R,A01,514037,Staff,0,4,16,16
1714612299140,MMW 13R,A02,514039,Staff,0,2,16,16
1714612299140,MMW 13R,A03,628519,Staff,0,2,16,16
1714612301192,SIO 295LS,A00,523233,Staff,10,0,30,20
1714612302219,SIO 295S,A00,523232,Staff,10,0,30,20
1714612303246,SIOC 290S,A01,637330,Merrifield; Mark A,23,0,30,7
1714612304272,SIOC 291S,A01,637333,Gabriel; Corey John,23,0,30,7
1714612305297,SOCI 117,A01,494376,Staff,0,4,5,5
1714612306323,WES 237B,A00,494380,Staff,9,0,20,11
1714612308392,AESE 279B,A00,494370,Wade; Jon P,0,0,33,33
1714612309421,AIP 197,001,627712,Vespa; Emanuel Ignacio,9998,0,9999,1
1714612310446,ANAR 135S,A00,494369,Braswell; Geoffrey E.,0,0,0,0
1714612311475,BENG 196,001,628496,Engler; Adam J.,9998,0,9999,1
1714612312500,CAT 124RS,A01,519847,Geibel; William,0,0,20,20
1714612313524,CAT 125RS,A01,515971,Geibel; William,0,0,20,20
1714612314551,CLRE 250,A00,511389,Morris; Sheldon,9993,0,9999,6
1714612315582,CLRE 251,A00,507176,Mehta; Ravindra L.,9993,0,9999,6
1714612315582,CLRE 251,B00,511410,Mehta; Ravindra L.,9998,0,9999,1
1714612316612,CLRE 252,A00,507189,Cuomo; Raphael Eduardo,9995,0,9999,4
1714612317639,CLRE 253,A00,507199,Vaida; Florin,9994,0,9999,5
1714612317639,CLRE 253,B00,507202,Vaida; Florin,9999,0,9999,0
1714612318664,CLRE 259,A00,507211,Patel; Hemal,9996,0,9999,3
1714612319691,CLRE 260,A00,507221,Cuomo; Raphael Eduardo,9999,0,9999,0
1714612320716,CLRE 297,001,507242,Cuomo; Raphael Eduardo,9999,0,9999,0
1714612321742,COGS 197,001,638244,Voytek; Bradley Thomas,9998,0,9999,1
1714612322767,CSE 191,A00,516875,Minnes Kemp; Mor Mia,9992,0,9999,7
1714612323793,CSE 197,001,637388,Minnes Kemp; Mor Mia,9998,0,9999,1
1714612324823,CSS 201S,A01,494383,Staff,35,0,35,0
1714612325848,CSS 202S,A01,494387,Staff,35,0,35,0
1714612326872,DSC 197,001,628532,Eldridge; Justin Matthew,9996,0,9999,3
1714612327898,EAP 100,A00,516065,Staff,9797,0,9999,202
1714612328925,ECE 45,A01,507414,Staff,33,0,60,27
1714612330977,ECE 111,A01,507420,Staff,15,0,50,35
1714612332004,ECE 197,001,548057,Sievenpiper; Daniel F.,9993,0,9999,6
1714612333042,EDS 115,A00,507243,Choi; Bailey Miyeon,10,0,28,18
1714612334071,EDS 117,A01,494379,Staff,1,5,30,29
1714612335100,EDS 125,A00,507246,Hopkins; Megan Beth,9,0,30,21
1714612336129,EDS 128A,A01,507264,Fargason; Sharon Gayle,8,0,26,18
1714612337157,EDS 128B,A01,507293,Pappas; Elizabeth,12,0,30,18
1714612338180,EDS 139,A00,507294,Fargason; Sharon Gayle,13,0,30,17
1714612338180,EDS 139,B00,507313,Pappas; Elizabeth,13,0,30,17
1714612339204,EDS 201,A00,507315,Staff,13,0,30,17
1714612340233,EDS 203,A01,507317,Halter; Christopher P.,12,0,30,18
1714612341259,EDS 204R,A01,507319,Halter; Christopher P.,0,3,30,30
1714612341259,EDS 204R,B01,507331,Heinzman; Erica M.,16,0,30,14
1714612342284,EDS 206R,A00,507332,Staff,0,4,30,30
1714612342284,EDS 206R,B00,507343,Staff,17,0,30,13
1714612343309,EDS 250,A00,507344,Hemans; Patricia Ann Benitez,22,0,40,18
1714612344334,EDS 281,A00,507345,Daly; Alan J.,18,0,18,0
1714612345358,EDS 284,A00,507350,Daly; Alan J.,16,0,16,0
1714612346385,EDS 286,A00,507359,Fine; Sarah,18,0,18,0
1714612347409,EDS 289C,A01,507361,Daly; Alan J.,18,0,18,0
1714612348435,EDS 290,A00,507366,Hofstetter; Carolyn,15,0,15,0
1714612349460,LIGM 5A,A00,507421,Fischer-Grunski; Eva K,18,0,20,2
1714612350484,LIGM 5B,A00,507423,Fischer-Grunski; Eva K,19,0,20,1
1714612351515,LIGM 5C,A00,507425,Fischer-Grunski; Eva K,19,0,20,1
1714612352546,LIIT 5AS,A00,507427,Carnelos; Chiara,20,0,20,0
1714612353575,LIIT 5BS,A00,507430,Carnelos; Chiara,20,0,20,0
1714612354601,LIIT 5CS,A00,507432,Carnelos; Chiara,20,0,20,0
1714612355633,LISP 5A,A00,507541,Munoz Sanchez; Alicia,11,0,20,9
1714612356660,LISP 5B,A00,507671,Munoz Sanchez; Alicia,8,0,20,12
1714612357684,LISP 5C,A00,507696,Munoz Sanchez; Alicia,9,0,20,11
1714612358711,MAE 197,001,528363,Boechler; Nicholas Sebastia,9998,0,9999,1
1714612359757,MATH 197,001,523477,Kedlaya; Kiran S.,9995,0,9999,4
1714612359757,MATH 197,002,563811,Zhang; Danna,9995,0,9999,4
1714612359757,MATH 197,003,628552,Dumitriu; Ioana,9998,0,9999,1
1714612360784,MCWP 40R,A00,518780,Staff,2,0,20,18
1714612360784,MCWP 40R,B00,518781,Staff,8,0,20,12
1714612360784,MCWP 40R,C00,518783,Staff,6,0,20,14
1714612361809,MCWP 50R,A00,518791,Staff,0,0,20,20
1714612361809,MCWP 50R,B00,518792,Staff,0,2,20,20
1714612361809,MCWP 50R,C00,518793,Staff,0,2,20,20
1714612361809,MCWP 50R,D00,518794,Staff,0,0,20,20
1714612361809,MCWP 50R,E00,518795,Staff,0,2,20,20
1714612361809,MCWP 50R,F00,518796,Staff,0,0,20,20
1714612361809,MCWP 50R,G00,518797,Staff,0,1,20,20
1714612362838,MMW 12R,A01,514034,Herbst; Matthew,0,0,16,16
1714612362838,MMW 12R,A02,514035,Herbst; Matthew,1,0,16,15
1714612363869,MMW 13R,A01,514037,Staff,0,4,16,16
1714612363869,MMW 13R,A02,514039,Staff,0,2,16,16
1714612363869,MMW 13R,A03,628519,Staff,0,2,16,16
1714612365920,SIO 295LS,A00,523233,Staff,10,0,30,20
1714612366947,SIO 295S,A00,523232,Staff,10,0,30,20
1714612367975,SIOC 290S,A01,637330,Merrifield; Mark A,23,0,30,7
1714612369003,SIOC 291S,A01,637333,Gabriel; Corey John,23,0,30,7
1714612370029,SOCI 117,A01,494376,Staff,0,4,5,5
1714612371054,WES 237B,A00,494380,Staff,9,0,20,11
1714612373125,AESE 279B,A00,494370,Wade; Jon P,0,0,33,33
1714612374154,AIP 197,001,627712,Vespa; Emanuel Ignacio,9998,0,9999,1
1714612375178,ANAR 135S,A00,494369,Braswell; Geoffrey E.,0,0,0,0
1714612376206,BENG 196,001,628496,Engler; Adam J.,9998,0,9999,1
1714612377236,CAT 124RS,A01,519847,Geibel; William,0,0,20,20
1714612378261,CAT 125RS,A01,515971,Geibel; William,0,0,20,20
1714612379287,CLRE 250,A00,511389,Morris; Sheldon,9993,0,9999,6
1714612380314,CLRE 251,A00,507176,Mehta; Ravindra L.,9993,0,9999,6
1714612380314,CLRE 251,B00,511410,Mehta; Ravindra L.,9998,0,9999,1
1714612381339,CLRE 252,A00,507189,Cuomo; Raphael Eduardo,9995,0,9999,4
1714612382370,CLRE 253,A00,507199,Vaida; Florin,9994,0,9999,5
1714612382370,CLRE 253,B00,507202,Vaida; Florin,9999,0,9999,0
1714612383397,CLRE 259,A00,507211,Patel; Hemal,9996,0,9999,3
1714612384423,CLRE 260,A00,507221,Cuomo; Raphael Eduardo,9999,0,9999,0
1714612385454,CLRE 297,001,507242,Cuomo; Raphael Eduardo,9999,0,9999,0
1714612386482,COGS 197,001,638244,Voytek; Bradley Thomas,9998,0,9999,1
1714612387506,CSE 191,A00,516875,Minnes Kemp; Mor Mia,9992,0,9999,7
1714612388530,CSE 197,001,637388,Minnes Kemp; Mor Mia,9998,0,9999,1
1714612389558,CSS 201S,A01,494383,Staff,35,0,35,0
1714612390582,CSS 202S,A01,494387,Staff,35,0,35,0
1714612391609,DSC 197,001,628532,Eldridge; Justin Matthew,9996,0,9999,3
1714612392633,EAP 100,A00,516065,Staff,9797,0,9999,202
1714612393662,ECE 45,A01,507414,Staff,33,0,60,27
1714612395717,ECE 111,A01,507420,Staff,15,0,50,35
1714612396743,ECE 197,001,548057,Sievenpiper; Daniel F.,9993,0,9999,6
1714612397768,EDS 115,A00,507243,Choi; Bailey Miyeon,10,0,28,18
1714612398796,EDS 117,A01,494379,Staff,1,5,30,29
1714612399826,EDS 125,A00,507246,Hopkins; Megan Beth,9,0,30,21
1714612400854,EDS 128A,A01,507264,Fargason; Sharon Gayle,8,0,26,18
1714612401881,EDS 128B,A01,507293,Pappas; Elizabeth,12,0,30,18
1714612402909,EDS 139,A00,507294,Fargason; Sharon Gayle,13,0,30,17
1714612402909,EDS 139,B00,507313,Pappas; Elizabeth,13,0,30,17
1714612403934,EDS 201,A00,507315,Staff,13,0,30,17
1714612404959,EDS 203,A01,507317,Halter; Christopher P.,12,0,30,18
1714612405988,EDS 204R,A01,507319,Halter; Christopher P.,0,3,30,30
1714612405988,EDS 204R,B01,507331,Heinzman; Erica M.,16,0,30,14
1714612407013,EDS 206R,A00,507332,Staff,0,4,30,30
1714612407013,EDS 206R,B00,507343,Staff,17,0,30,13
1714612408042,EDS 250,A00,507344,Hemans; Patricia Ann Benitez,22,0,40,18
1714612409070,EDS 281,A00,507345,Daly; Alan J.,18,0,18,0
1714612410095,EDS 284,A00,507350,Daly; Alan J.,16,0,16,0
1714612411121,EDS 286,A00,507359,Fine; Sarah,18,0,18,0
1714612412146,EDS 289C,A01,507361,Daly; Alan J.,18,0,18,0
1714612413172,EDS 290,A00,507366,Hofstetter; Carolyn,15,0,15,0
1714612414198,LIGM 5A,A00,507421,Fischer-Grunski; Eva K,18,0,20,2
1714612415223,LIGM 5B,A00,507423,Fischer-Grunski; Eva K,19,0,20,1
1714612416248,LIGM 5C,A00,507425,Fischer-Grunski; Eva K,19,0,20,1
1714612417273,LIIT 5AS,A00,507427,Carnelos; Chiara,20,0,20,0
1714612418301,LIIT 5BS,A00,507430,Carnelos; Chiara,20,0,20,0
1714612419329,LIIT 5CS,A00,507432,Carnelos; Chiara,20,0,20,0
1714612420353,LISP 5A,A00,507541,Munoz Sanchez; Alicia,11,0,20,9
1714612421382,LISP 5B,A00,507671,Munoz Sanchez; Alicia,8,0,20,12
1714612422408,LISP 5C,A00,507696,Munoz Sanchez; Alicia,9,0,20,11
1714612423437,MAE 197,001,528363,Boechler; Nicholas Sebastia,9998,0,9999,1
1714612424468,MATH 197,001,523477,Kedlaya; Kiran S.,9995,0,9999,4
1714612424468,MATH 197,002,563811,Zhang; Danna,9995,0,9999,4
1714612424468,MATH 197,003,628552,Dumitriu; Ioana,9998,0,9999,1
1714612425496,MCWP 40R,A00,518780,Staff,2,0,20,18
1714612425496,MCWP 40R,B00,518781,Staff,8,0,20,12
1714612425496,MCWP 40R,C00,518783,Staff,6,0,20,14
1714612426520,MCWP 50R,A00,518791,Staff,0,0,20,20
1714612426520,MCWP 50R,B00,518792,Staff,0,2,20,20
1714612426520,MCWP 50R,C00,518793,Staff,0,2,20,20
1714612426520,MCWP 50R,D00,518794,Staff,0,0,20,20
1714612426520,MCWP 50R,E00,518795,Staff,0,2,20,20
1714612426520,MCWP 50R,F00,518796,Staff,0,0,20,20
1714612426520,MCWP 50R,G00,518797,Staff,0,1,20,20
1714612427547,MMW 12R,A01,514034,Herbst; Matthew,0,0,16,16
1714612427547,MMW 12R,A02,514035,Herbst; Matthew,1,0,16,15
1714612428572,MMW 13R,A01,514037,Staff,0,4,16,16
1714612428572,MMW 13R,A02,514039,Staff,0,2,16,16
1714612428572,MMW 13R,A03,628519,Staff,0,2,16,16
1714612430622,SIO 295LS,A00,523233,Staff,10,0,30,20
1714612431647,SIO 295S,A00,523232,Staff,10,0,30,20
1714612432677,SIOC 290S,A01,637330,Merrifield; Mark A,23,0,30,7
1714612433704,SIOC 291S,A01,637333,Gabriel; Corey John,23,0,30,7
1714612434733,SOCI 117,A01,494376,Staff,0,4,5,5
1714612435765,WES 237B,A00,494380,Staff,9,0,20,11
1714612437841,AESE 279B,A00,494370,Wade; Jon P,0,0,33,33
1714612438871,AIP 197,001,627712,Vespa; Emanuel Ignacio,9998,0,9999,1
1714612439897,ANAR 135S,A00,494369,Braswell; Geoffrey E.,0,0,0,0
1714612440922,BENG 196,001,628496,Engler; Adam J.,9998,0,9999,1
1714612441952,CAT 124RS,A01,519847,Geibel; William,0,0,20,20
1714612442980,CAT 125RS,A01,515971,Geibel; William,0,0,20,20
1714612444007,CLRE 250,A00,511389,Morris; Sheldon,9993,0,9999,6
1714612445034,CLRE 251,A00,507176,Mehta; Ravindra L.,9993,0,9999,6
1714612445034,CLRE 251,B00,511410,Mehta; Ravindra L.,9998,0,9999,1
1714612446060,CLRE 252,A00,507189,Cuomo; Raphael Eduardo,9995,0,9999,4
1714612447093,CLRE 253,A00,507199,Vaida; Florin,9994,0,9999,5
1714612447093,CLRE 253,B00,507202,Vaida; Florin,9999,0,9999,0
1714612448119,CLRE 259,A00,507211,Patel; Hemal,9996,0,9999,3
1714612449143,CLRE 260,A00,507221,Cuomo; Raphael Eduardo,9999,0,9999,0
1714612450173,CLRE 297,001,507242,Cuomo; Raphael Eduardo,9999,0,9999,0
1714612451198,COGS 197,001,638244,Voytek; Bradley Thomas,9998,0,9999,1
1714612452224,CSE 191,A00,516875,Minnes Kemp; Mor Mia,9992,0,9999,7
1714612453252,CSE 197,001,637388,Minnes Kemp; Mor Mia,9998,0,9999,1
1714612454279,CSS 201S,A01,494383,Staff,35,0,35,0
1714612455303,CSS 202S,A01,494387,Staff,35,0,35,0
1714612456330,DSC 197,001,628532,Eldridge; Justin Matthew,9996,0,9999,3
1714612457357,EAP 100,A00,516065,Staff,9797,0,9999,202
1714612458517,ECE 45,A01,507414,Staff,33,0,60,27
1714612460568,ECE 111,A01,507420,Staff,15,0,50,35
1714612461594,ECE 197,001,548057,Sievenpiper; Daniel F.,9993,0,9999,6
1714612462620,EDS 115,A00,507243,Choi; Bailey Miyeon,10,0,28,18
1714612463646,EDS 117,A01,494379,Staff,1,5,30,29
1714612464675,EDS 125,A00,507246,Hopkins; Megan Beth,9,0,30,21
1714612465705,EDS 128A,A01,507264,Fargason; Sharon Gayle,8,0,26,18
1714612466730,EDS 128B,A01,507293,Pappas; Elizabeth,12,0,30,18
1714612467756,EDS 139,A00,507294,Fargason; Sharon Gayle,13,0,30,17
1714612467756,EDS 139,B00,507313,Pappas; Elizabeth,13,0,30,17
1714612468780,EDS 201,A00,507315,Staff,13,0,30,17
1714612469804,EDS 203,A01,507317,Halter; Christopher P.,12,0,30,18
1714612470835,EDS 204R,A01,507319,Halter; Christopher P.,0,3,30,30
1714612470835,EDS 204R,B01,507331,Heinzman; Erica M.,16,0,30,14
1714612471864,EDS 206R,A00,507332,Staff,0,4,30,30
1714612471864,EDS 206R,B00,507343,Staff,17,0,30,13
1714612472892,EDS 250,A00,507344,Hemans; Patricia Ann Benitez,22,0,40,18
1714612473919,EDS 281,A00,507345,Daly; Alan J.,18,0,18,0
1714612474947,EDS 284,A00,507350,Daly; Alan J.,16,0,16,0
1714612475976,EDS 286,A00,507359,Fine; Sarah,18,0,18,0
1714612477001,EDS 289C,A01,507361,Daly; Alan J.,18,0,18,0
1714612478026,EDS 290,A00,507366,Hofstetter; Carolyn,15,0,15,0
1714612479053,LIGM 5A,A00,507421,Fischer-Grunski; Eva K,18,0,20,2
1714612480085,LIGM 5B,A00,507423,Fischer-Grunski; Eva K,19,0,20,1
1714612481109,LIGM 5C,A00,507425,Fischer-Grunski; Eva K,19,0,20,1
1714612482135,LIIT 5AS,A00,507427,Carnelos; Chiara,20,0,20,0
1714612483165,LIIT 5BS,A00,507430,Carnelos; Chiara,20,0,20,0
1714612484190,LIIT 5CS,A00,507432,Carnelos; Chiara,20,0,20,0
1714612485219,LISP 5A,A00,507541,Munoz Sanchez; Alicia,11,0,20,9
1714612486244,LISP 5B,A00,507671,Munoz Sanchez; Alicia,8,0,20,12
1714612487269,LISP 5C,A00,507696,Munoz Sanchez; Alicia,9,0,20,11
1714612488296,MAE 197,001,528363,Boechler; Nicholas Sebastia,9998,0,9999,1
1714612489324,MATH 197,001,523477,Kedlaya; Kiran S.,9995,0,9999,4
1714612489324,MATH 197,002,563811,Zhang; Danna,9995,0,9999,4
1714612489324,MATH 197,003,628552,Dumitriu; Ioana,9998,0,9999,1
1714612490351,MCWP 40R,A00,518780,Staff,2,0,20,18
1714612490351,MCWP 40R,B00,518781,Staff,8,0,20,12
1714612490351,MCWP 40R,C00,518783,Staff,6,0,20,14
1714612491380,MCWP 50R,A00,518791,Staff,0,0,20,20
1714612491380,MCWP 50R,B00,518792,Staff,0,2,20,20
1714612491380,MCWP 50R,C00,518793,Staff,0,2,20,20
1714612491380,MCWP 50R,D00,518794,Staff,0,0,20,20
1714612491380,MCWP 50R,E00,518795,Staff,0,2,20,20
1714612491380,MCWP 50R,F00,518796,Staff,0,0,20,20
1714612491380,MCWP 50R,G00,518797,Staff,0,1,20,20
1714612492408,MMW 12R,A01,514034,Herbst; Matthew,0,0,16,16
1714612492408,MMW 12R,A02,514035,Herbst; Matthew,1,0,16,15
1714612493433,MMW 13R,A01,514037,Staff,0,4,16,16
1714612493433,MMW 13R,A02,514039,Staff,0,2,16,16
1714612493433,MMW 13R,A03,628519,Staff,0,2,16,16
1714612495483,SIO 295LS,A00,523233,Staff,10,0,30,20
1714612496510,SIO 295S,A00,523232,Staff,10,0,30,20
1714612497536,SIOC 290S,A01,637330,Merrifield; Mark A,23,0,30,7
1714612498564,SIOC 291S,A01,637333,Gabriel; Corey John,23,0,30,7
1714612499590,SOCI 117,A01,494376,Staff,0,4,5,5
1714612500616,WES 237B,A00,494380,Staff,9,0,20,11
1714612502683,AESE 279B,A00,494370,Wade; Jon P,0,0,33,33
1714612503708,AIP 197,001,627712,Vespa; Emanuel Ignacio,9998,0,9999,1
1714612504736,ANAR 135S,A00,494369,Braswell; Geoffrey E.,0,0,0,0
1714612505763,BENG 196,001,628496,Engler; Adam J.,9998,0,9999,1
1714612506789,CAT 124RS,A01,519847,Geibel; William,0,0,20,20
1714612507814,CAT 125RS,A01,515971,Geibel; William,0,0,20,20
1714612508840,CLRE 250,A00,511389,Morris; Sheldon,9993,0,9999,6
1714612509869,CLRE 251,A00,507176,Mehta; Ravindra L.,9993,0,9999,6
1714612509869,CLRE 251,B00,511410,Mehta; Ravindra L.,9998,0,9999,1
1714612510896,CLRE 252,A00,507189,Cuomo; Raphael Eduardo,9995,0,9999,4
1714612511924,CLRE 253,A00,507199,Vaida; Florin,9994,0,9999,5
1714612511924,CLRE 253,B00,507202,Vaida; Florin,9999,0,9999,0
1714612512952,CLRE 259,A00,507211,Patel; Hemal,9996,0,9999,3
1714612513975,CLRE 260,A00,507221,Cuomo; Raphael Eduardo,9999,0,9999,0
1714612515002,CLRE 297,001,507242,Cuomo; Raphael Eduardo,9999,0,9999,0
1714612516029,COGS 197,001,638244,Voytek; Bradley Thomas,9998,0,9999,1
1714612517057,CSE 191,A00,516875,Minnes Kemp; Mor Mia,9992,0,9999,7
1714612518083,CSE 197,001,637388,Minnes Kemp; Mor Mia,9998,0,9999,1
1714612519108,CSS 201S,A01,494383,Staff,35,0,35,0
1714612520134,CSS 202S,A01,494387,Staff,35,0,35,0
1714612521159,DSC 197,001,628532,Eldridge; Justin Matthew,9996,0,9999,3
1714612522240,EAP 100,A00,516065,Staff,9797,0,9999,202
1714612523267,ECE 45,A01,507414,Staff,33,0,60,27
1714612525325,ECE 111,A01,507420,Staff,15,0,50,35
1714612526353,ECE 197,001,548057,Sievenpiper; Daniel F.,9993,0,9999,6
1714612527380,EDS 115,A00,507243,Choi; Bailey Miyeon,10,0,28,18
1714612528406,EDS 117,A01,494379,Staff,1,5,30,29
1714612529431,EDS 125,A00,507246,Hopkins; Megan Beth,9,0,30,21
1714612530461,EDS 128A,A01,507264,Fargason; Sharon Gayle,8,0,26,18
1714612531489,EDS 128B,A01,507293,Pappas; Elizabeth,12,0,30,18
1714612532515,EDS 139,A00,507294,Fargason; Sharon Gayle,13,0,30,17
1714612532515,EDS 139,B00,507313,Pappas; Elizabeth,13,0,30,17
1714612533539,EDS 201,A00,507315,Staff,13,0,30,17
1714612534566,EDS 203,A01,507317,Halter; Christopher P.,12,0,30,18
1714612535590,EDS 204R,A01,507319,Halter; Christopher P.,0,3,30,30
1714612535590,EDS 204R,B01,507331,Heinzman; Erica M.,16,0,30,14
1714612536614,EDS 206R,A00,507332,Staff,0,4,30,30
1714612536614,EDS 206R,B00,507343,Staff,17,0,30,13
1714612537642,EDS 250,A00,507344,Hemans; Patricia Ann Benitez,22,0,40,18
1714612538668,EDS 281,A00,507345,Daly; Alan J.,18,0,18,0
1714612539697,EDS 284,A00,507350,Daly; Alan J.,16,0,16,0
1714612540722,EDS 286,A00,507359,Fine; Sarah,18,0,18,0
1714612541746,EDS 289C,A01,507361,Daly; Alan J.,18,0,18,0
1714612542770,EDS 290,A00,507366,Hofstetter; Carolyn,15,0,15,0
1714612543802,LIGM 5A,A00,507421,Fischer-Grunski; Eva K,18,0,20,2
1714612544826,LIGM 5B,A00,507423,Fischer-Grunski; Eva K,19,0,20,1
1714612545852,LIGM 5C,A00,507425,Fischer-Grunski; Eva K,19,0,20,1
1714612546878,LIIT 5AS,A00,507427,Carnelos; Chiara,20,0,20,0
1714612547905,LIIT 5BS,A00,507430,Carnelos; Chiara,20,0,20,0
1714612548933,LIIT 5CS,A00,507432,Carnelos; Chiara,20,0,20,0
1714612549964,LISP 5A,A00,507541,Munoz Sanchez; Alicia,11,0,20,9
1714612550989,LISP 5B,A00,507671,Munoz Sanchez; Alicia,8,0,20,12
1714612552016,LISP 5C,A00,507696,Munoz Sanchez; Alicia,9,0,20,11
1714612553045,MAE 197,001,528363,Boechler; Nicholas Sebastia,9998,0,9999,1
1714612554073,MATH 197,001,523477,Kedlaya; Kiran S.,9995,0,9999,4
1714612554073,MATH 197,002,563811,Zhang; Danna,9995,0,9999,4
1714612554073,MATH 197,003,628552,Dumitriu; Ioana,9998,0,9999,1
1714612555100,MCWP 40R,A00,518780,Staff,2,0,20,18
1714612555100,MCWP 40R,B00,518781,Staff,8,0,20,12
1714612555100,MCWP 40R,C00,518783,Staff,6,0,20,14
1714612556127,MCWP 50R,A00,518791,Staff,0,0,20,20
1714612556127,MCWP 50R,B00,518792,Staff,0,2,20,20
1714612556127,MCWP 50R,C00,518793,Staff,0,2,20,20
1714612556127,MCWP 50R,D00,518794,Staff,0,0,20,20
1714612556127,MCWP 50R,E00,518795,Staff,0,2,20,20
1714612556127,MCWP 50R,F00,518796,Staff,0,0,20,20
1714612556127,MCWP 50R,G00,518797,Staff,0,1,20,20
1714612557159,MMW 12R,A01,514034,Herbst; Matthew,0,0,16,16
1714612557159,MMW 12R,A02,514035,Herbst; Matthew,1,0,16,15
1714612558188,MMW 13R,A01,514037,Staff,0,4,16,16
1714612558188,MMW 13R,A02,514039,Staff,0,2,16,16
1714612558188,MMW 13R,A03,628519,Staff,0,2,16,16
1714612560238,SIO 295LS,A00,523233,Staff,10,0,30,20
1714612561263,SIO 295S,A00,523232,Staff,10,0,30,20
1714612562289,SIOC 290S,A01,637330,Merrifield; Mark A,23,0,30,7
1714612563322,SIOC 291S,A01,637333,Gabriel; Corey John,23,0,30,7
1714612564348,SOCI 117,A01,494376,Staff,0,4,5,5
1714612565376,WES 237B,A00,494380,Staff,9,0,20,11
1714612567446,AESE 279B,A00,494370,Wade; Jon P,0,0,33,33
1714612568472,AIP 197,001,627712,Vespa; Emanuel Ignacio,9998,0,9999,1
1714612569499,ANAR 135S,A00,494369,Braswell; Geoffrey E.,0,0,0,0
1714612570527,BENG 196,001,628496,Engler; Adam J.,9998,0,9999,1
1714612571554,CAT 124RS,A01,519847,Geibel; William,0,0,20,20
1714612572579,CAT 125RS,A01,515971,Geibel; William,0,0,20,20
1714612573604,CLRE 250,A00,511389,Morris; Sheldon,9993,0,9999,6
1714612574635,CLRE 251,A00,507176,Mehta; Ravindra L.,9993,0,9999,6
1714612574635,CLRE 251,B00,511410,Mehta; Ravindra L.,9998,0,9999,1
1714612575664,CLRE 252,A00,507189,Cuomo; Raphael Eduardo,9995,0,9999,4
1714612576689,CLRE 253,A00,507199,Vaida; Florin,9994,0,9999,5
1714612576689,CLRE 253,B00,507202,Vaida; Florin,9999,0,9999,0
1714612577714,CLRE 259,A00,507211,Patel; Hemal,9996,0,9999,3
1714612578740,CLRE 260,A00,507221,Cuomo; Raphael Eduardo,9999,0,9999,0
1714612579765,CLRE 297,001,507242,Cuomo; Raphael Eduardo,9999,0,9999,0
1714612580794,COGS 197,001,638244,Voytek; Bradley Thomas,9998,0,9999,1
1714612581819,CSE 191,A00,516875,Minnes Kemp; Mor Mia,9992,0,9999,7
1714612582845,CSE 197,001,637388,Minnes Kemp; Mor Mia,9998,0,9999,1
1714612583871,CSS 201S,A01,494383,Staff,35,0,35,0
1714612584898,CSS 202S,A01,494387,Staff,35,0,35,0
1714612585924,DSC 197,001,628532,Eldridge; Justin Matthew,9996,0,9999,3
1714612586952,EAP 100,A00,516065,Staff,9797,0,9999,202
1714612587977,ECE 45,A01,507414,Staff,33,0,60,27
1714612590029,ECE 111,A01,507420,Staff,15,0,50,35
1714612591055,ECE 197,001,548057,Sievenpiper; Daniel F.,9993,0,9999,6
1714612592084,EDS 115,A00,507243,Choi; Bailey Miyeon,10,0,28,18
1714612593110,EDS 117,A01,494379,Staff,1,5,30,29
1714612594136,EDS 125,A00,507246,Hopkins; Megan Beth,9,0,30,21
1714612595162,EDS 128A,A01,507264,Fargason; Sharon Gayle,8,0,26,18
1714612596187,EDS 128B,A01,507293,Pappas; Elizabeth,12,0,30,18
1714612597215,EDS 139,A00,507294,Fargason; Sharon Gayle,13,0,30,17
1714612597215,EDS 139,B00,507313,Pappas; Elizabeth,13,0,30,17
1714612598243,EDS 201,A00,507315,Staff,13,0,30,17
1714612599269,EDS 203,A01,507317,Halter; Christopher P.,12,0,30,18
1714612600296,EDS 204R,A01,507319,Halter; Christopher P.,0,3,30,30
1714612600296,EDS 204R,B01,507331,Heinzman; Erica M.,16,0,30,14
1714612601321,EDS 206R,A00,507332,Staff,0,4,30,30
1714612601321,EDS 206R,B00,507343,Staff,17,0,30,13
1714612602350,EDS 250,A00,507344,Hemans; Patricia Ann Benitez,22,0,40,18
1714612603379,EDS 281,A00,507345,Daly; Alan J.,18,0,18,0
1714612604402,EDS 284,A00,507350,Daly; Alan J.,16,0,16,0
1714612605428,EDS 286,A00,507359,Fine; Sarah,18,0,18,0
1714612606456,EDS 289C,A01,507361,Daly; Alan J.,18,0,18,0
1714612607483,EDS 290,A00,507366,Hofstetter; Carolyn,15,0,15,0
1714612608517,LIGM 5A,A00,507421,Fischer-Grunski; Eva K,18,0,20,2
1714612609543,LIGM 5B,A00,507423,Fischer-Grunski; Eva K,19,0,20,1
1714612610567,LIGM 5C,A00,507425,Fischer-Grunski; Eva K,19,0,20,1
1714612611596,LIIT 5AS,A00,507427,Carnelos; Chiara,20,0,20,0
1714612612622,LIIT 5BS,A00,507430,Carnelos; Chiara,20,0,20,0
1714612613647,LIIT 5CS,A00,507432,Carnelos; Chiara,20,0,20,0
1714612614673,LISP 5A,A00,507541,Munoz Sanchez; Alicia,11,0,20,9
1714612615699,LISP 5B,A00,507671,Munoz Sanchez; Alicia,8,0,20,12
1714612616728,LISP 5C,A00,507696,Munoz Sanchez; Alicia,9,0,20,11
1714612617752,MAE 197,001,528363,Boechler; Nicholas Sebastia,9998,0,9999,1
1714612618779,MATH 197,001,523477,Kedlaya; Kiran S.,9995,0,9999,4
1714612618779,MATH 197,002,563811,Zhang; Danna,9995,0,9999,4
1714612618779,MATH 197,003,628552,Dumitriu; Ioana,9998,0,9999,1
1714612619806,MCWP 40R,A00,518780,Staff,2,0,20,18
1714612619806,MCWP 40R,B00,518781,Staff,8,0,20,12
1714612619806,MCWP 40R,C00,518783,Staff,6,0,20,14
1714612620833,MCWP 50R,A00,518791,Staff,0,0,20,20
1714612620833,MCWP 50R,B00,518792,Staff,0,2,20,20
1714612620833,MCWP 50R,C00,518793,Staff,0,2,20,20
1714612620833,MCWP 50R,D00,518794,Staff,0,0,20,20
1714612620833,MCWP 50R,E00,518795,Staff,0,2,20,20
1714612620833,MCWP 50R,F00,518796,Staff,0,0,20,20
1714612620833,MCWP 50R,G00,518797,Staff,0,1,20,20
1714612621858,MMW 12R,A01,514034,Herbst; Matthew,0,0,16,16
1714612621858,MMW 12R,A02,514035,Herbst; Matthew,1,0,16,15
1714612622884,MMW 13R,A01,514037,Staff,0,4,16,16
1714612622884,MMW 13R,A02,514039,Staff,0,2,16,16
1714612622884,MMW 13R,A03,628519,Staff,0,2,16,16
1714612624939,SIO 295LS,A00,523233,Staff,10,0,30,20
1714612625966,SIO 295S,A00,523232,Staff,10,0,30,20
1714612626997,SIOC 290S,A01,637330,Merrifield; Mark A,23,0,30,7
1714612628026,SIOC 291S,A01,637333,Gabriel; Corey John,23,0,30,7
1714612629056,SOCI 117,A01,494376,Staff,0,4,5,5
1714612630082,WES 237B,A00,494380,Staff,9,0,20,11
1714612632157,AESE 279B,A00,494370,Wade; Jon P,0,0,33,33
1714612633183,AIP 197,001,627712,Vespa; Emanuel Ignacio,9998,0,9999,1
1714612634213,ANAR 135S,A00,494369,Braswell; Geoffrey E.,0,0,0,0
1714612635247,BENG 196,001,628496,Engler; Adam J.,9998,0,9999,1
1714612636273,CAT 124RS,A01,519847,Geibel; William,0,0,20,20
1714612637299,CAT 125RS,A01,515971,Geibel; William,0,0,20,20
1714612638327,CLRE 250,A00,511389,Morris; Sheldon,9993,0,9999,6
1714612639356,CLRE 251,A00,507176,Mehta; Ravindra L.,9993,0,9999,6
1714612639356,CLRE 251,B00,511410,Mehta; Ravindra L.,9998,0,9999,1
1714612640386,CLRE 252,A00,507189,Cuomo; Raphael Eduardo,9995,0,9999,4
1714612641412,CLRE 253,A00,507199,Vaida; Florin,9994,0,9999,5
1714612641412,CLRE 253,B00,507202,Vaida; Florin,9999,0,9999,0
1714612642438,CLRE 259,A00,507211,Patel; Hemal,9996,0,9999,3
1714612643466,CLRE 260,A00,507221,Cuomo; Raphael Eduardo,9999,0,9999,0
1714612644493,CLRE 297,001,507242,Cuomo; Raphael Eduardo,9999,0,9999,0
1714612645518,COGS 197,001,638244,Voytek; Bradley Thomas,9998,0,9999,1
1714612646543,CSE 191,A00,516875,Minnes Kemp; Mor Mia,9992,0,9999,7
1714612647567,CSE 197,001,637388,Minnes Kemp; Mor Mia,9998,0,9999,1
1714612648594,CSS 201S,A01,494383,Staff,35,0,35,0
1714612649688,CSS 202S,A01,494387,Staff,35,0,35,0
1714612650717,DSC 197,001,628532,Eldridge; Justin Matthew,9996,0,9999,3
1714612651743,EAP 100,A00,516065,Staff,9797,0,9999,202
1714612652773,ECE 45,A01,507414,Staff,33,0,60,27
1714612654826,ECE 111,A01,507420,Staff,15,0,50,35
1714612655855,ECE 197,001,548057,Sievenpiper; Daniel F.,9993,0,9999,6
1714612656911,EDS 115,A00,507243,Choi; Bailey Miyeon,10,0,28,18
1714612657940,EDS 117,A01,494379,Staff,1,5,30,29
1714612658965,EDS 125,A00,507246,Hopkins; Megan Beth,9,0,30,21
1714612659990,EDS 128A,A01,507264,Fargason; Sharon Gayle,8,0,26,18
1714612661015,EDS 128B,A01,507293,Pappas; Elizabeth,12,0,30,18
1714612662044,EDS 139,A00,507294,Fargason; Sharon Gayle,13,0,30,17
1714612662044,EDS 139,B00,507313,Pappas; Elizabeth,13,0,30,17
1714612663070,EDS 201,A00,507315,Staff,13,0,30,17
1714612664095,EDS 203,A01,507317,Halter; Christopher P.,12,0,30,18
1714612665121,EDS 204R,A01,507319,Halter; Christopher P.,0,3,30,30
1714612665121,EDS 204R,B01,507331,Heinzman; Erica M.,16,0,30,14
1714612666148,EDS 206R,A00,507332,Staff,0,4,30,30
1714612666148,EDS 206R,B00,507343,Staff,17,0,30,13
1714612667173,EDS 250,A00,507344,Hemans; Patricia Ann Benitez,22,0,40,18
1714612668198,EDS 281,A00,507345,Daly; Alan J.,18,0,18,0
1714612669226,EDS 284,A00,507350,Daly; Alan J.,16,0,16,0
1714612670253,EDS 286,A00,507359,Fine; Sarah,18,0,18,0
1714612671277,EDS 289C,A01,507361,Daly; Alan J.,18,0,18,0
1714612672304,EDS 290,A00,507366,Hofstetter; Carolyn,15,0,15,0
1714612673334,LIGM 5A,A00,507421,Fischer-Grunski; Eva K,18,0,20,2
1714612674359,LIGM 5B,A00,507423,Fischer-Grunski; Eva K,19,0,20,1
1714612675385,LIGM 5C,A00,507425,Fischer-Grunski; Eva K,19,0,20,1
1714612676416,LIIT 5AS,A00,507427,Carnelos; Chiara,20,0,20,0
1714612677441,LIIT 5BS,A00,507430,Carnelos; Chiara,20,0,20,0
1714612678467,LIIT 5CS,A00,507432,Carnelos; Chiara,20,0,20,0
1714612679496,LISP 5A,A00,507541,Munoz Sanchez; Alicia,11,0,20,9
1714612680523,LISP 5B,A00,507671,Munoz Sanchez; Alicia,8,0,20,12
1714612681551,LISP 5C,A00,507696,Munoz Sanchez; Alicia,9,0,20,11
1714612682577,MAE 197,001,528363,Boechler; Nicholas Sebastia,9998,0,9999,1
1714612683609,MATH 197,001,523477,Kedlaya; Kiran S.,9995,0,9999,4
1714612683609,MATH 197,002,563811,Zhang; Danna,9995,0,9999,4
1714612683609,MATH 197,003,628552,Dumitriu; Ioana,9998,0,9999,1
1714612684635,MCWP 40R,A00,518780,Staff,2,0,20,18
1714612684635,MCWP 40R,B00,518781,Staff,8,0,20,12
1714612684635,MCWP 40R,C00,518783,Staff,6,0,20,14
1714612685662,MCWP 50R,A00,518791,Staff,0,0,20,20
1714612685662,MCWP 50R,B00,518792,Staff,0,2,20,20
1714612685662,MCWP 50R,C00,518793,Staff,0,2,20,20
1714612685662,MCWP 50R,D00,518794,Staff,0,0,20,20
1714612685662,MCWP 50R,E00,518795,Staff,0,2,20,20
1714612685662,MCWP 50R,F00,518796,Staff,0,0,20,20
1714612685662,MCWP 50R,G00,518797,Staff,0,1,20,20
1714612686687,MMW 12R,A01,514034,Herbst; Matthew,0,0,16,16
1714612686687,MMW 12R,A02,514035,Herbst; Matthew,1,0,16,15
1714612687715,MMW 13R,A01,514037,Staff,0,4,16,16
1714612687715,MMW 13R,A02,514039,Staff,0,2,16,16
1714612687715,MMW 13R,A03,628519,Staff,0,2,16,16
1714612689771,SIO 295LS,A00,523233,Staff,10,0,30,20
1714612690799,SIO 295S,A00,523232,Staff,10,0,30,20
1714612691826,SIOC 290S,A01,637330,Merrifield; Mark A,23,0,30,7
1714612692851,SIOC 291S,A01,637333,Gabriel; Corey John,23,0,30,7
1714612693880,SOCI 117,A01,494376,Staff,0,4,5,5
1714612694907,WES 237B,A00,494380,Staff,9,0,20,11
1714612696990,AESE 279B,A00,494370,Wade; Jon P,0,0,33,33
1714612698015,AIP 197,001,627712,Vespa; Emanuel Ignacio,9998,0,9999,1
1714612699042,ANAR 135S,A00,494369,Braswell; Geoffrey E.,0,0,0,0
1714612700071,BENG 196,001,628496,Engler; Adam J.,9998,0,9999,1
1714612701096,CAT 124RS,A01,519847,Geibel; William,0,0,20,20
1714612702123,CAT 125RS,A01,515971,Geibel; William,0,0,20,20
1714612703149,CLRE 250,A00,511389,Morris; Sheldon,9993,0,9999,6
1714612704175,CLRE 251,A00,507176,Mehta; Ravindra L.,9993,0,9999,6
1714612704175,CLRE 251,B00,511410,Mehta; Ravindra L.,9998,0,9999,1
1714612705204,CLRE 252,A00,507189,Cuomo; Raphael Eduardo,9995,0,9999,4
1714612706232,CLRE 253,A00,507199,Vaida; Florin,9994,0,9999,5
1714612706232,CLRE 253,B00,507202,Vaida; Florin,9999,0,9999,0
1714612707258,CLRE 259,A00,507211,Patel; Hemal,9996,0,9999,3
1714612708285,CLRE 260,A00,507221,Cuomo; Raphael Eduardo,9999,0,9999,0
1714612709363,CLRE 297,001,507242,Cuomo; Raphael Eduardo,9999,0,9999,0
1714612710391,COGS 197,001,638244,Voytek; Bradley Thomas,9998,0,9999,1
1714612711418,CSE 191,A00,516875,Minnes Kemp; Mor Mia,9992,0,9999,7
1714612712443,CSE 197,001,637388,Minnes Kemp; Mor Mia,9998,0,9999,1
1714612713472,CSS 201S,A01,494383,Staff,35,0,35,0
1714612714501,CSS 202S,A01,494387,Staff,35,0,35,0
1714612715525,DSC 197,001,628532,Eldridge; Justin Matthew,9996,0,9999,3
1714612716549,EAP 100,A00,516065,Staff,9797,0,9999,202
1714612717573,ECE 45,A01,507414,Staff,33,0,60,27
1714612719623,ECE 111,A01,507420,Staff,15,0,50,35
1714612720647,ECE 197,001,548057,Sievenpiper; Daniel F.,9993,0,9999,6
1714612721675,EDS 115,A00,507243,Choi; Bailey Miyeon,10,0,28,18
1714612722700,EDS 117,A01,494379,Staff,1,5,30,29
1714612723724,EDS 125,A00,507246,Hopkins; Megan Beth,9,0,30,21
1714612724749,EDS 128A,A01,507264,Fargason; Sharon Gayle,8,0,26,18
1714612725777,EDS 128B,A01,507293,Pappas; Elizabeth,12,0,30,18
1714612726801,EDS 139,A00,507294,Fargason; Sharon Gayle,13,0,30,17
1714612726801,EDS 139,B00,507313,Pappas; Elizabeth,13,0,30,17
1714612727825,EDS 201,A00,507315,Staff,13,0,30,17
1714612728853,EDS 203,A01,507317,Halter; Christopher P.,12,0,30,18
1714612729878,EDS 204R,A01,507319,Halter; Christopher P.,0,3,30,30
1714612729878,EDS 204R,B01,507331,Heinzman; Erica M.,16,0,30,14
1714612730902,EDS 206R,A00,507332,Staff,0,4,30,30
1714612730902,EDS 206R,B00,507343,Staff,17,0,30,13
1714612731928,EDS 250,A00,507344,Hemans; Patricia Ann Benitez,22,0,40,18
1714612732956,EDS 281,A00,507345,Daly; Alan J.,18,0,18,0
1714612733981,EDS 284,A00,507350,Daly; Alan J.,16,0,16,0
1714612735008,EDS 286,A00,507359,Fine; Sarah,18,0,18,0
1714612736038,EDS 289C,A01,507361,Daly; Alan J.,18,0,18,0
1714612737063,EDS 290,A00,507366,Hofstetter; Carolyn,15,0,15,0
1714612738094,LIGM 5A,A00,507421,Fischer-Grunski; Eva K,18,0,20,2
1714612739123,LIGM 5B,A00,507423,Fischer-Grunski; Eva K,19,0,20,1
1714612740151,LIGM 5C,A00,507425,Fischer-Grunski; Eva K,19,0,20,1
1714612741182,LIIT 5AS,A00,507427,Carnelos; Chiara,20,0,20,0
1714612742207,LIIT 5BS,A00,507430,Carnelos; Chiara,20,0,20,0
1714612743238,LIIT 5CS,A00,507432,Carnelos; Chiara,20,0,20,0
1714612744268,LISP 5A,A00,507541,Munoz Sanchez; Alicia,11,0,20,9
1714612745295,LISP 5B,A00,507671,Munoz Sanchez; Alicia,8,0,20,12
1714612746319,LISP 5C,A00,507696,Munoz Sanchez; Alicia,9,0,20,11
1714612747344,MAE 197,001,528363,Boechler; Nicholas Sebastia,9998,0,9999,1
1714612748376,MATH 197,001,523477,Kedlaya; Kiran S.,9995,0,9999,4
1714612748376,MATH 197,002,563811,Zhang; Danna,9995,0,9999,4
1714612748376,MATH 197,003,628552,Dumitriu; Ioana,9998,0,9999,1
1714612749401,MCWP 40R,A00,518780,Staff,2,0,20,18
1714612749401,MCWP 40R,B00,518781,Staff,8,0,20,12
1714612749401,MCWP 40R,C00,518783,Staff,6,0,20,14
1714612750427,MCWP 50R,A00,518791,Staff,0,0,20,20
1714612750427,MCWP 50R,B00,518792,Staff,0,2,20,20
1714612750427,MCWP 50R,C00,518793,Staff,0,2,20,20
1714612750427,MCWP 50R,D00,518794,Staff,0,0,20,20
1714612750427,MCWP 50R,E00,518795,Staff,0,2,20,20
1714612750427,MCWP 50R,F00,518796,Staff,0,0,20,20
1714612750427,MCWP 50R,G00,518797,Staff,0,1,20,20
1714612751453,MMW 12R,A01,514034,Herbst; Matthew,0,0,16,16
1714612751453,MMW 12R,A02,514035,Herbst; Matthew,1,0,16,15
1714612752481,MMW 13R,A01,514037,Staff,0,4,16,16
1714612752481,MMW 13R,A02,514039,Staff,0,2,16,16
1714612752481,MMW 13R,A03,628519,Staff,0,2,16,16
1714612754533,SIO 295LS,A00,523233,Staff,10,0,30,20
1714612755558,SIO 295S,A00,523232,Staff,10,0,30,20
1714612756586,SIOC 290S,A01,637330,Merrifield; Mark A,23,0,30,7
1714612757616,SIOC 291S,A01,637333,Gabriel; Corey John,23,0,30,7
1714612758643,SOCI 117,A01,494376,Staff,0,4,5,5
1714612759668,WES 237B,A00,494380,Staff,9,0,20,11
1714612761733,AESE 279B,A00,494370,Wade; Jon P,0,0,33,33
1714612762761,AIP 197,001,627712,Vespa; Emanuel Ignacio,9998,0,9999,1
1714612763789,ANAR 135S,A00,494369,Braswell; Geoffrey E.,0,0,0,0
1714612764817,BENG 196,001,628496,Engler; Adam J.,9998,0,9999,1
1714612765840,CAT 124RS,A01,519847,Geibel; William,0,0,20,20
1714612766862,CAT 125RS,A01,515971,Geibel; William,0,0,20,20
1714612767917,CLRE 250,A00,511389,Morris; Sheldon,9993,0,9999,6
1714612768943,CLRE 251,A00,507176,Mehta; Ravindra L.,9993,0,9999,6
1714612768943,CLRE 251,B00,511410,Mehta; Ravindra L.,9998,0,9999,1
1714612769975,CLRE 252,A00,507189,Cuomo; Raphael Eduardo,9995,0,9999,4
1714612771003,CLRE 253,A00,507199,Vaida; Florin,9994,0,9999,5
1714612771003,CLRE 253,B00,507202,Vaida; Florin,9999,0,9999,0
1714612772032,CLRE 259,A00,507211,Patel; Hemal,9996,0,9999,3
1714612773057,CLRE 260,A00,507221,Cuomo; Raphael Eduardo,9999,0,9999,0
1714612774082,CLRE 297,001,507242,Cuomo; Raphael Eduardo,9999,0,9999,0
1714612775105,COGS 197,001,638244,Voytek; Bradley Thomas,9998,0,9999,1
1714612776131,CSE 191,A00,516875,Minnes Kemp; Mor Mia,9992,0,9999,7
1714612777189,CSE 197,001,637388,Minnes Kemp; Mor Mia,9998,0,9999,1
1714612778219,CSS 201S,A01,494383,Staff,35,0,35,0
1714612779246,CSS 202S,A01,494387,Staff,35,0,35,0
1714612780273,DSC 197,001,628532,Eldridge; Justin Matthew,9996,0,9999,3
1714612781297,EAP 100,A00,516065,Staff,9797,0,9999,202
1714612782323,ECE 45,A01,507414,Staff,33,0,60,27
1714612784378,ECE 111,A01,507420,Staff,15,0,50,35
1714612785404,ECE 197,001,548057,Sievenpiper; Daniel F.,9993,0,9999,6
1714612786434,EDS 115,A00,507243,Choi; Bailey Miyeon,10,0,28,18
1714612787460,EDS 117,A01,494379,Staff,1,5,30,29
1714612788488,EDS 125,A00,507246,Hopkins; Megan Beth,9,0,30,21
1714612789515,EDS 128A,A01,507264,Fargason; Sharon Gayle,8,0,26,18
1714612790543,EDS 128B,A01,507293,Pappas; Elizabeth,12,0,30,18
1714612791568,EDS 139,A00,507294,Fargason; Sharon Gayle,13,0,30,17
1714612791568,EDS 139,B00,507313,Pappas; Elizabeth,13,0,30,17
1714612792598,EDS 201,A00,507315,Staff,13,0,30,17
1714612793623,EDS 203,A01,507317,Halter; Christopher P.,12,0,30,18
1714612794650,EDS 204R,A01,507319,Halter; Christopher P.,0,3,30,30
1714612794650,EDS 204R,B01,507331,Heinzman; Erica M.,16,0,30,14
1714612795679,EDS 206R,A00,507332,Staff,0,4,30,30
1714612795679,EDS 206R,B00,507343,Staff,17,0,30,13
1714612796704,EDS 250,A00,507344,Hemans; Patricia Ann Benitez,22,0,40,18
1714612797732,EDS 281,A00,507345,Daly; Alan J.,18,0,18,0
1714612798759,EDS 284,A00,507350,Daly; Alan J.,16,0,16,0
1714612799785,EDS 286,A00,507359,Fine; Sarah,18,0,18,0
1714612800813,EDS 289C,A01,507361,Daly; Alan J.,18,0,18,0
1714612801839,EDS 290,A00,507366,Hofstetter; Carolyn,15,0,15,0
1714612802867,LIGM 5A,A00,507421,Fischer-Grunski; Eva K,18,0,20,2
1714612803903,LIGM 5B,A00,507423,Fischer-Grunski; Eva K,19,0,20,1
1714612804928,LIGM 5C,A00,507425,Fischer-Grunski; Eva K,19,0,20,1
1714612805957,LIIT 5AS,A00,507427,Carnelos; Chiara,20,0,20,0
1714612806983,LIIT 5BS,A00,507430,Carnelos; Chiara,20,0,20,0
1714612808007,LIIT 5CS,A00,507432,Carnelos; Chiara,20,0,20,0
1714612809035,LISP 5A,A00,507541,Munoz Sanchez; Alicia,11,0,20,9
1714612810059,LISP 5B,A00,507671,Munoz Sanchez; Alicia,8,0,20,12
1714612811084,LISP 5C,A00,507696,Munoz Sanchez; Alicia,9,0,20,11
1714612812109,MAE 197,001,528363,Boechler; Nicholas Sebastia,9998,0,9999,1
1714612813140,MATH 197,001,523477,Kedlaya; Kiran S.,9995,0,9999,4
1714612813140,MATH 197,002,563811,Zhang; Danna,9995,0,9999,4
1714612813140,MATH 197,003,628552,Dumitriu; Ioana,9998,0,9999,1
1714612814166,MCWP 40R,A00,518780,Staff,2,0,20,18
1714612814166,MCWP 40R,B00,518781,Staff,8,0,20,12
1714612814166,MCWP 40R,C00,518783,Staff,6,0,20,14
1714612815196,MCWP 50R,A00,518791,Staff,0,0,20,20
1714612815196,MCWP 50R,B00,518792,Staff,0,2,20,20
1714612815196,MCWP 50R,C00,518793,Staff,0,2,20,20
1714612815196,MCWP 50R,D00,518794,Staff,0,0,20,20
1714612815196,MCWP 50R,E00,518795,Staff,0,2,20,20
1714612815196,MCWP 50R,F00,518796,Staff,0,0,20,20
1714612815196,MCWP 50R,G00,518797,Staff,0,1,20,20
1714612816221,MMW 12R,A01,514034,Herbst; Matthew,0,0,16,16
1714612816221,MMW 12R,A02,514035,Herbst; Matthew,1,0,16,15
1714612817254,MMW 13R,A01,514037,Staff,0,4,16,16
1714612817254,MMW 13R,A02,514039,Staff,0,2,16,16
1714612817254,MMW 13R,A03,628519,Staff,0,2,16,16
1714612819308,SIO 295LS,A00,523233,Staff,10,0,30,20
1714612820337,SIO 295S,A00,523232,Staff,10,0,30,20
1714612821363,SIOC 290S,A01,637330,Merrifield; Mark A,23,0,30,7
1714612822390,SIOC 291S,A01,637333,Gabriel; Corey John,23,0,30,7
1714612823420,SOCI 117,A01,494376,Staff,0,4,5,5
1714612824446,WES 237B,A00,494380,Staff,9,0,20,11
1714612826514,AESE 279B,A00,494370,Wade; Jon P,0,0,33,33
1714612827542,AIP 197,001,627712,Vespa; Emanuel Ignacio,9998,0,9999,1
1714612828567,ANAR 135S,A00,494369,Braswell; Geoffrey E.,0,0,0,0
1714612829593,BENG 196,001,628496,Engler; Adam J.,9998,0,9999,1
1714612830618,CAT 124RS,A01,519847,Geibel; William,0,0,20,20
1714612831644,CAT 125RS,A01,515971,Geibel; William,0,0,20,20
1714612832672,CLRE 250,A00,511389,Morris; Sheldon,9993,0,9999,6
1714612833700,CLRE 251,A00,507176,Mehta; Ravindra L.,9993,0,9999,6
1714612833700,CLRE 251,B00,511410,Mehta; Ravindra L.,9998,0,9999,1
1714612834724,CLRE 252,A00,507189,Cuomo; Raphael Eduardo,9995,0,9999,4
1714612835751,CLRE 253,A00,507199,Vaida; Florin,9994,0,9999,5
1714612835751,CLRE 253,B00,507202,Vaida; Florin,9999,0,9999,0
1714612836779,CLRE 259,A00,507211,Patel; Hemal,9996,0,9999,3
1714612837808,CLRE 260,A00,507221,Cuomo; Raphael Eduardo,9999,0,9999,0
1714612838833,CLRE 297,001,507242,Cuomo; Raphael Eduardo,9999,0,9999,0
1714612839862,COGS 197,001,638244,Voytek; Bradley Thomas,9998,0,9999,1
1714612840887,CSE 191,A00,516875,Minnes Kemp; Mor Mia,9992,0,9999,7
1714612841912,CSE 197,001,637388,Minnes Kemp; Mor Mia,9998,0,9999,1
1714612842939,CSS 201S,A01,494383,Staff,35,0,35,0
1714612843968,CSS 202S,A01,494387,Staff,35,0,35,0
1714612844995,DSC 197,001,628532,Eldridge; Justin Matthew,9996,0,9999,3
1714612846021,EAP 100,A00,516065,Staff,9797,0,9999,202
1714612847047,ECE 45,A01,507414,Staff,33,0,60,27
1714612849100,ECE 111,A01,507420,Staff,15,0,50,35
1714612850126,ECE 197,001,548057,Sievenpiper; Daniel F.,9993,0,9999,6
1714612851156,EDS 115,A00,507243,Choi; Bailey Miyeon,10,0,28,18
1714612852183,EDS 117,A01,494379,Staff,1,5,30,29
1714612853212,EDS 125,A00,507246,Hopkins; Megan Beth,9,0,30,21
1714612854239,EDS 128A,A01,507264,Fargason; Sharon Gayle,8,0,26,18
1714612855270,EDS 128B,A01,507293,Pappas; Elizabeth,12,0,30,18
1714612856295,EDS 139,A00,507294,Fargason; Sharon Gayle,13,0,30,17
1714612856295,EDS 139,B00,507313,Pappas; Elizabeth,13,0,30,17
1714612857320,EDS 201,A00,507315,Staff,13,0,30,17
1714612858346,EDS 203,A01,507317,Halter; Christopher P.,12,0,30,18
1714612859372,EDS 204R,A01,507319,Halter; Christopher P.,0,3,30,30
1714612859372,EDS 204R,B01,507331,Heinzman; Erica M.,16,0,30,14
1714612860401,EDS 206R,A00,507332,Staff,0,4,30,30
1714612860401,EDS 206R,B00,507343,Staff,17,0,30,13
1714612861427,EDS 250,A00,507344,Hemans; Patricia Ann Benitez,22,0,40,18
1714612862456,EDS 281,A00,507345,Daly; Alan J.,18,0,18,0
1714612863485,EDS 284,A00,507350,Daly; Alan J.,16,0,16,0
1714612864510,EDS 286,A00,507359,Fine; Sarah,18,0,18,0
1714612865535,EDS 289C,A01,507361,Daly; Alan J.,18,0,18,0
1714612866564,EDS 290,A00,507366,Hofstetter; Carolyn,15,0,15,0
1714612867592,LIGM 5A,A00,507421,Fischer-Grunski; Eva K,18,0,20,2
1714612868617,LIGM 5B,A00,507423,Fischer-Grunski; Eva K,19,0,20,1
1714612869642,LIGM 5C,A00,507425,Fischer-Grunski; Eva K,19,0,20,1
1714612870668,LIIT 5AS,A00,507427,Carnelos; Chiara,20,0,20,0
1714612871693,LIIT 5BS,A00,507430,Carnelos; Chiara,20,0,20,0
1714612872717,LIIT 5CS,A00,507432,Carnelos; Chiara,20,0,20,0
1714612873816,LISP 5A,A00,507541,Munoz Sanchez; Alicia,11,0,20,9
1714612874846,LISP 5B,A00,507671,Munoz Sanchez; Alicia,8,0,20,12
1714612875870,LISP 5C,A00,507696,Munoz Sanchez; Alicia,9,0,20,11
1714612876895,MAE 197,001,528363,Boechler; Nicholas Sebastia,9998,0,9999,1
1714612877923,MATH 197,001,523477,Kedlaya; Kiran S.,9995,0,9999,4
1714612877923,MATH 197,002,563811,Zhang; Danna,9995,0,9999,4
1714612877923,MATH 197,003,628552,Dumitriu; Ioana,9998,0,9999,1
1714612878949,MCWP 40R,A00,518780,Staff,2,0,20,18
1714612878949,MCWP 40R,B00,518781,Staff,8,0,20,12
1714612878949,MCWP 40R,C00,518783,Staff,6,0,20,14
1714612879973,MCWP 50R,A00,518791,Staff,0,0,20,20
1714612879973,MCWP 50R,B00,518792,Staff,0,2,20,20
1714612879973,MCWP 50R,C00,518793,Staff,0,2,20,20
1714612879973,MCWP 50R,D00,518794,Staff,0,0,20,20
1714612879973,MCWP 50R,E00,518795,Staff,0,2,20,20
1714612879973,MCWP 50R,F00,518796,Staff,0,0,20,20
1714612879973,MCWP 50R,G00,518797,Staff,0,1,20,20
1714612881001,MMW 12R,A01,514034,Herbst; Matthew,0,0,16,16
1714612881001,MMW 12R,A02,514035,Herbst; Matthew,1,0,16,15
1714612882026,MMW 13R,A01,514037,Staff,0,4,16,16
1714612882026,MMW 13R,A02,514039,Staff,0,2,16,16
1714612882026,MMW 13R,A03,628519,Staff,0,2,16,16
1714612884078,SIO 295LS,A00,523233,Staff,10,0,30,20
1714612885103,SIO 295S,A00,523232,Staff,10,0,30,20
1714612886134,SIOC 290S,A01,637330,Merrifield; Mark A,23,0,30,7
1714612887161,SIOC 291S,A01,637333,Gabriel; Corey John,23,0,30,7
1714612888185,SOCI 117,A01,494376,Staff,0,4,5,5
1714612889212,WES 237B,A00,494380,Staff,9,0,20,11
1714612891293,AESE 279B,A00,494370,Wade; Jon P,0,0,33,33
1714612892321,AIP 197,001,627712,Vespa; Emanuel Ignacio,9998,0,9999,1
1714612893350,ANAR 135S,A00,494369,Braswell; Geoffrey E.,0,0,0,0
1714612894378,BENG 196,001,628496,Engler; Adam J.,9998,0,9999,1
1714612895407,CAT 124RS,A01,519847,Geibel; William,0,0,20,20
1714612896436,CAT 125RS,A01,515971,Geibel; William,0,0,20,20
1714612897461,CLRE 250,A00,511389,Morris; Sheldon,9993,0,9999,6
1714612898543,CLRE 251,A00,507176,Mehta; Ravindra L.,9993,0,9999,6
1714612898543,CLRE 251,B00,511410,Mehta; Ravindra L.,9998,0,9999,1
1714612899570,CLRE 252,A00,507189,Cuomo; Raphael Eduardo,9995,0,9999,4
1714612900594,CLRE 253,A00,507199,Vaida; Florin,9994,0,9999,5
1714612900594,CLRE 253,B00,507202,Vaida; Florin,9999,0,9999,0
1714612901620,CLRE 259,A00,507211,Patel; Hemal,9996,0,9999,3
1714612902645,CLRE 260,A00,507221,Cuomo; Raphael Eduardo,9999,0,9999,0
1714612903669,CLRE 297,001,507242,Cuomo; Raphael Eduardo,9999,0,9999,0
1714612904696,COGS 197,001,638244,Voytek; Bradley Thomas,9998,0,9999,1
1714612905722,CSE 191,A00,516875,Minnes Kemp; Mor Mia,9992,0,9999,7
1714612906749,CSE 197,001,637388,Minnes Kemp; Mor Mia,9998,0,9999,1
1714612907777,CSS 201S,A01,494383,Staff,35,0,35,0
1714612908802,CSS 202S,A01,494387,Staff,35,0,35,0
1714612909827,DSC 197,001,628532,Eldridge; Justin Matthew,9996,0,9999,3
1714612910851,EAP 100,A00,516065,Staff,9797,0,9999,202
1714612911883,ECE 45,A01,507414,Staff,33,0,60,27
1714612913934,ECE 111,A01,507420,Staff,15,0,50,35
1714612914960,ECE 197,001,548057,Sievenpiper; Daniel F.,9993,0,9999,6
1714612915989,EDS 115,A00,507243,Choi; Bailey Miyeon,10,0,28,18
1714612917015,EDS 117,A01,494379,Staff,1,5,30,29
1714612918044,EDS 125,A00,507246,Hopkins; Megan Beth,9,0,30,21
1714612919070,EDS 128A,A01,507264,Fargason; Sharon Gayle,8,0,26,18
1714612920097,EDS 128B,A01,507293,Pappas; Elizabeth,12,0,30,18
1714612921122,EDS 139,A00,507294,Fargason; Sharon Gayle,13,0,30,17
1714612921122,EDS 139,B00,507313,Pappas; Elizabeth,13,0,30,17
1714612922150,EDS 201,A00,507315,Staff,13,0,30,17
1714612923177,EDS 203,A01,507317,Halter; Christopher P.,12,0,30,18
1714612924207,EDS 204R,A01,507319,Halter; Christopher P.,0,3,30,30
1714612924207,EDS 204R,B01,507331,Heinzman; Erica M.,16,0,30,14
1714612925235,EDS 206R,A00,507332,Staff,0,4,30,30
1714612925235,EDS 206R,B00,507343,Staff,17,0,30,13
1714612926267,EDS 250,A00,507344,Hemans; Patricia Ann Benitez,22,0,40,18
1714612927292,EDS 281,A00,507345,Daly; Alan J.,18,0,18,0
1714612928317,EDS 284,A00,507350,Daly; Alan J.,16,0,16,0
1714612929343,EDS 286,A00,507359,Fine; Sarah,18,0,18,0
1714612930372,EDS 289C,A01,507361,Daly; Alan J.,18,0,18,0
1714612931396,EDS 290,A00,507366,Hofstetter; Carolyn,15,0,15,0
1714612932425,LIGM 5A,A00,507421,Fischer-Grunski; Eva K,18,0,20,2
1714612933453,LIGM 5B,A00,507423,Fischer-Grunski; Eva K,19,0,20,1
1714612934478,LIGM 5C,A00,507425,Fischer-Grunski; Eva K,19,0,20,1
1714612935509,LIIT 5AS,A00,507427,Carnelos; Chiara,20,0,20,0
1714612936538,LIIT 5BS,A00,507430,Carnelos; Chiara,20,0,20,0
1714612937564,LIIT 5CS,A00,507432,Carnelos; Chiara,20,0,20,0
1714612938645,LISP 5A,A00,507541,Munoz Sanchez; Alicia,11,0,20,9
1714612939671,LISP 5B,A00,507671,Munoz Sanchez; Alicia,8,0,20,12
1714612940699,LISP 5C,A00,507696,Munoz Sanchez; Alicia,9,0,20,11
1714612941725,MAE 197,001,528363,Boechler; Nicholas Sebastia,9998,0,9999,1
1714612942749,MATH 197,001,523477,Kedlaya; Kiran S.,9995,0,9999,4
1714612942749,MATH 197,002,563811,Zhang; Danna,9995,0,9999,4
1714612942749,MATH 197,003,628552,Dumitriu; Ioana,9998,0,9999,1
1714612943775,MCWP 40R,A00,518780,Staff,2,0,20,18
1714612943775,MCWP 40R,B00,518781,Staff,8,0,20,12
1714612943775,MCWP 40R,C00,518783,Staff,6,0,20,14
1714612944807,MCWP 50R,A00,518791,Staff,0,0,20,20
1714612944807,MCWP 50R,B00,518792,Staff,0,2,20,20
1714612944807,MCWP 50R,C00,518793,Staff,0,2,20,20
1714612944807,MCWP 50R,D00,518794,Staff,0,0,20,20
1714612944807,MCWP 50R,E00,518795,Staff,0,2,20,20
1714612944807,MCWP 50R,F00,518796,Staff,0,0,20,20
1714612944807,MCWP 50R,G00,518797,Staff,0,1,20,20
1714612945839,MMW 12R,A01,514034,Herbst; Matthew,0,0,16,16
1714612945839,MMW 12R,A02,514035,Herbst; Matthew,1,0,16,15
1714612946865,MMW 13R,A01,514037,Staff,0,4,16,16
1714612946865,MMW 13R,A02,514039,Staff,0,2,16,16
1714612946865,MMW 13R,A03,628519,Staff,0,2,16,16
1714612948920,SIO 295LS,A00,523233,Staff,10,0,30,20
1714612949950,SIO 295S,A00,523232,Staff,10,0,30,20
1714612950978,SIOC 290S,A01,637330,Merrifield; Mark A,23,0,30,7
1714612952007,SIOC 291S,A01,637333,Gabriel; Corey John,23,0,30,7
1714612953034,SOCI 117,A01,494376,Staff,0,4,5,5
1714612954061,WES 237B,A00,494380,Staff,9,0,20,11
1714612956131,AESE 279B,A00,494370,Wade; Jon P,0,0,33,33
1714612957157,AIP 197,001,627712,Vespa; Emanuel Ignacio,9998,0,9999,1
1714612958187,ANAR 135S,A00,494369,Braswell; Geoffrey E.,0,0,0,0
1714612959216,BENG 196,001,628496,Engler; Adam J.,9998,0,9999,1
1714612960246,CAT 124RS,A01,519847,Geibel; William,0,0,20,20
1714612961269,CAT 125RS,A01,515971,Geibel; William,0,0,20,20
1714612962296,CLRE 250,A00,511389,Morris; Sheldon,9993,0,9999,6
1714612963327,CLRE 251,A00,507176,Mehta; Ravindra L.,9993,0,9999,6
1714612963327,CLRE 251,B00,511410,Mehta; Ravindra L.,9998,0,9999,1
1714612964357,CLRE 252,A00,507189,Cuomo; Raphael Eduardo,9995,0,9999,4
1714612965385,CLRE 253,A00,507199,Vaida; Florin,9994,0,9999,5
1714612965385,CLRE 253,B00,507202,Vaida; Florin,9999,0,9999,0
1714612966410,CLRE 259,A00,507211,Patel; Hemal,9996,0,9999,3
1714612967432,CLRE 260,A00,507221,Cuomo; Raphael Eduardo,9999,0,9999,0
1714612968457,CLRE 297,001,507242,Cuomo; Raphael Eduardo,9999,0,9999,0
1714612969487,COGS 197,001,638244,Voytek; Bradley Thomas,9998,0,9999,1
1714612970511,CSE 191,A00,516875,Minnes Kemp; Mor Mia,9992,0,9999,7
1714612971537,CSE 197,001,637388,Minnes Kemp; Mor Mia,9998,0,9999,1
1714612972563,CSS 201S,A01,494383,Staff,35,0,35,0
1714612973590,CSS 202S,A01,494387,Staff,35,0,35,0
1714612974613,DSC 197,001,628532,Eldridge; Justin Matthew,9996,0,9999,3
1714612975640,EAP 100,A00,516065,Staff,9797,0,9999,202
1714612976665,ECE 45,A01,507414,Staff,33,0,60,27
1714612978720,ECE 111,A01,507420,Staff,15,0,50,35
1714612979745,ECE 197,001,548057,Sievenpiper; Daniel F.,9993,0,9999,6
1714612980770,EDS 115,A00,507243,Choi; Bailey Miyeon,10,0,28,18
1714612981796,EDS 117,A01,494379,Staff,1,5,30,29
1714612982829,EDS 125,A00,507246,Hopkins; Megan Beth,9,0,30,21
1714612983867,EDS 128A,A01,507264,Fargason; Sharon Gayle,8,0,26,18
1714612984894,EDS 128B,A01,507293,Pappas; Elizabeth,12,0,30,18
1714612985919,EDS 139,A00,507294,Fargason; Sharon Gayle,13,0,30,17
1714612985919,EDS 139,B00,507313,Pappas; Elizabeth,13,0,30,17
1714612986943,EDS 201,A00,507315,Staff,13,0,30,17
1714612987969,EDS 203,A01,507317,Halter; Christopher P.,12,0,30,18
1714612988998,EDS 204R,A01,507319,Halter; Christopher P.,0,3,30,30
1714612988998,EDS 204R,B01,507331,Heinzman; Erica M.,16,0,30,14
1714612990021,EDS 206R,A00,507332,Staff,0,4,30,30
1714612990021,EDS 206R,B00,507343,Staff,17,0,30,13
1714612991049,EDS 250,A00,507344,Hemans; Patricia Ann Benitez,22,0,40,18
1714612992076,EDS 281,A00,507345,Daly; Alan J.,18,0,18,0
1714612993102,EDS 284,A00,507350,Daly; Alan J.,16,0,16,0
1714612994128,EDS 286,A00,507359,Fine; Sarah,18,0,18,0
1714612995157,EDS 289C,A01,507361,Daly; Alan J.,18,0,18,0
1714612996182,EDS 290,A00,507366,Hofstetter; Carolyn,15,0,15,0
1714612997217,LIGM 5A,A00,507421,Fischer-Grunski; Eva K,18,0,20,2
1714612998242,LIGM 5B,A00,507423,Fischer-Grunski; Eva K,19,0,20,1
1714612999269,LIGM 5C,A00,507425,Fischer-Grunski; Eva K,19,0,20,1
1714613000299,LIIT 5AS,A00,507427,Carnelos; Chiara,20,0,20,0
1714613001330,LIIT 5BS,A00,507430,Carnelos; Chiara,20,0,20,0
1714613002354,LIIT 5CS,A00,507432,Carnelos; Chiara,20,0,20,0
1714613003380,LISP 5A,A00,507541,Munoz Sanchez; Alicia,11,0,20,9
1714613004408,LISP 5B,A00,507671,Munoz Sanchez; Alicia,8,0,20,12
1714613005437,LISP 5C,A00,507696,Munoz Sanchez; Alicia,9,0,20,11
1714613006465,MAE 197,001,528363,Boechler; Nicholas Sebastia,9998,0,9999,1
1714613007491,MATH 197,001,523477,Kedlaya; Kiran S.,9995,0,9999,4
1714613007491,MATH 197,002,563811,Zhang; Danna,9995,0,9999,4
1714613007491,MATH 197,003,628552,Dumitriu; Ioana,9998,0,9999,1
1714613008520,MCWP 40R,A00,518780,Staff,2,0,20,18
1714613008520,MCWP 40R,B00,518781,Staff,8,0,20,12
1714613008520,MCWP 40R,C00,518783,Staff,6,0,20,14
1714613009547,MCWP 50R,A00,518791,Staff,0,0,20,20
1714613009547,MCWP 50R,B00,518792,Staff,0,2,20,20
1714613009547,MCWP 50R,C00,518793,Staff,0,2,20,20
1714613009547,MCWP 50R,D00,518794,Staff,0,0,20,20
1714613009547,MCWP 50R,E00,518795,Staff,0,2,20,20
1714613009547,MCWP 50R,F00,518796,Staff,0,0,20,20
1714613009547,MCWP 50R,G00,518797,Staff,0,1,20,20
1714613010572,MMW 12R,A01,514034,Herbst; Matthew,0,0,16,16
1714613010572,MMW 12R,A02,514035,Herbst; Matthew,1,0,16,15
1714613011599,MMW 13R,A01,514037,Staff,0,4,16,16
1714613011599,MMW 13R,A02,514039,Staff,0,2,16,16
1714613011599,MMW 13R,A03,628519,Staff,0,2,16,16
1714613013647,SIO 295LS,A00,523233,Staff,10,0,30,20
1714613014671,SIO 295S,A00,523232,Staff,10,0,30,20
1714613015699,SIOC 290S,A01,637330,Merrifield; Mark A,23,0,30,7
1714613016728,SIOC 291S,A01,637333,Gabriel; Corey John,23,0,30,7
1714613017753,SOCI 117,A01,494376,Staff,0,4,5,5
1714613018796,WES 237B,A00,494380,Staff,9,0,20,11
1714613020866,AESE 279B,A00,494370,Wade; Jon P,0,0,33,33
1714613021891,AIP 197,001,627712,Vespa; Emanuel Ignacio,9998,0,9999,1
1714613022920,ANAR 135S,A00,494369,Braswell; Geoffrey E.,0,0,0,0
1714613023946,BENG 196,001,628496,Engler; Adam J.,9998,0,9999,1
1714613024976,CAT 124RS,A01,519847,Geibel; William,0,0,20,20
1714613026003,CAT 125RS,A01,515971,Geibel; William,0,0,20,20
1714613027027,CLRE 250,A00,511389,Morris; Sheldon,9993,0,9999,6
1714613028057,CLRE 251,A00,507176,Mehta; Ravindra L.,9993,0,9999,6
1714613028057,CLRE 251,B00,511410,Mehta; Ravindra L.,9998,0,9999,1
1714613029082,CLRE 252,A00,507189,Cuomo; Raphael Eduardo,9995,0,9999,4
1714613030107,CLRE 253,A00,507199,Vaida; Florin,9994,0,9999,5
1714613030107,CLRE 253,B00,507202,Vaida; Florin,9999,0,9999,0
1714613031136,CLRE 259,A00,507211,Patel; Hemal,9996,0,9999,3
1714613032162,CLRE 260,A00,507221,Cuomo; Raphael Eduardo,9999,0,9999,0
1714613033190,CLRE 297,001,507242,Cuomo; Raphael Eduardo,9999,0,9999,0
1714613034214,COGS 197,001,638244,Voytek; Bradley Thomas,9998,0,9999,1
1714613035239,CSE 191,A00,516875,Minnes Kemp; Mor Mia,9992,0,9999,7
1714613036264,CSE 197,001,637388,Minnes Kemp; Mor Mia,9998,0,9999,1
1714613037293,CSS 201S,A01,494383,Staff,35,0,35,0
1714613038323,CSS 202S,A01,494387,Staff,35,0,35,0
1714613039350,DSC 197,001,628532,Eldridge; Justin Matthew,9996,0,9999,3
1714613040376,EAP 100,A00,516065,Staff,9797,0,9999,202
1714613041401,ECE 45,A01,507414,Staff,33,0,60,27
1714613043456,ECE 111,A01,507420,Staff,15,0,50,35
1714613044484,ECE 197,001,548057,Sievenpiper; Daniel F.,9993,0,9999,6
1714613045510,EDS 115,A00,507243,Choi; Bailey Miyeon,10,0,28,18
1714613046536,EDS 117,A01,494379,Staff,1,5,30,29
1714613047564,EDS 125,A00,507246,Hopkins; Megan Beth,9,0,30,21
1714613048592,EDS 128A,A01,507264,Fargason; Sharon Gayle,8,0,26,18
1714613049619,EDS 128B,A01,507293,Pappas; Elizabeth,12,0,30,18
1714613050645,EDS 139,A00,507294,Fargason; Sharon Gayle,13,0,30,17
1714613050645,EDS 139,B00,507313,Pappas; Elizabeth,13,0,30,17
1714613051671,EDS 201,A00,507315,Staff,13,0,30,17
1714613052697,EDS 203,A01,507317,Halter; Christopher P.,12,0,30,18
1714613053721,EDS 204R,A01,507319,Halter; Christopher P.,0,3,30,30
1714613053721,EDS 204R,B01,507331,Heinzman; Erica M.,16,0,30,14
1714613054750,EDS 206R,A00,507332,Staff,0,4,30,30
1714613054750,EDS 206R,B00,507343,Staff,17,0,30,13
1714613055774,EDS 250,A00,507344,Hemans; Patricia Ann Benitez,22,0,40,18
1714613056798,EDS 281,A00,507345,Daly; Alan J.,18,0,18,0
1714613057824,EDS 284,A00,507350,Daly; Alan J.,16,0,16,0
1714613058852,EDS 286,A00,507359,Fine; Sarah,18,0,18,0
1714613059880,EDS 289C,A01,507361,Daly; Alan J.,18,0,18,0
1714613060904,EDS 290,A00,507366,Hofstetter; Carolyn,15,0,15,0
1714613061933,LIGM 5A,A00,507421,Fischer-Grunski; Eva K,18,0,20,2
1714613062961,LIGM 5B,A00,507423,Fischer-Grunski; Eva K,19,0,20,1
1714613063989,LIGM 5C,A00,507425,Fischer-Grunski; Eva K,19,0,20,1
1714613065018,LIIT 5AS,A00,507427,Carnelos; Chiara,20,0,20,0
1714613066047,LIIT 5BS,A00,507430,Carnelos; Chiara,20,0,20,0
1714613067074,LIIT 5CS,A00,507432,Carnelos; Chiara,20,0,20,0
1714613068125,LISP 5A,A00,507541,Munoz Sanchez; Alicia,11,0,20,9
1714613069149,LISP 5B,A00,507671,Munoz Sanchez; Alicia,8,0,20,12
1714613070177,LISP 5C,A00,507696,Munoz Sanchez; Alicia,9,0,20,11
1714613071206,MAE 197,001,528363,Boechler; Nicholas Sebastia,9998,0,9999,1
1714613072233,MATH 197,001,523477,Kedlaya; Kiran S.,9995,0,9999,4
1714613072233,MATH 197,002,563811,Zhang; Danna,9995,0,9999,4
1714613072233,MATH 197,003,628552,Dumitriu; Ioana,9998,0,9999,1
1714613073259,MCWP 40R,A00,518780,Staff,2,0,20,18
1714613073259,MCWP 40R,B00,518781,Staff,8,0,20,12
1714613073259,MCWP 40R,C00,518783,Staff,6,0,20,14
1714613074289,MCWP 50R,A00,518791,Staff,0,0,20,20
1714613074289,MCWP 50R,B00,518792,Staff,0,2,20,20
1714613074289,MCWP 50R,C00,518793,Staff,0,2,20,20
1714613074289,MCWP 50R,D00,518794,Staff,0,0,20,20
1714613074289,MCWP 50R,E00,518795,Staff,0,2,20,20
1714613074289,MCWP 50R,F00,518796,Staff,0,0,20,20
1714613074289,MCWP 50R,G00,518797,Staff,0,1,20,20
1714613075314,MMW 12R,A01,514034,Herbst; Matthew,0,0,16,16
1714613075314,MMW 12R,A02,514035,Herbst; Matthew,1,0,16,15
1714613076340,MMW 13R,A01,514037,Staff,0,4,16,16
1714613076340,MMW 13R,A02,514039,Staff,0,2,16,16
1714613076340,MMW 13R,A03,628519,Staff,0,2,16,16
1714613078390,SIO 295LS,A00,523233,Staff,10,0,30,20
1714613079415,SIO 295S,A00,523232,Staff,10,0,30,20
1714613080445,SIOC 290S,A01,637330,Merrifield; Mark A,23,0,30,7
1714613081476,SIOC 291S,A01,637333,Gabriel; Corey John,23,0,30,7
1714613082501,SOCI 117,A01,494376,Staff,0,4,5,5
1714613083527,WES 237B,A00,494380,Staff,9,0,20,11
1714613085590,AESE 279B,A00,494370,Wade; Jon P,0,0,33,33
1714613086614,AIP 197,001,627712,Vespa; Emanuel Ignacio,9998,0,9999,1
1714613087644,ANAR 135S,A00,494369,Braswell; Geoffrey E.,0,0,0,0
1714613088668,BENG 196,001,628496,Engler; Adam J.,9998,0,9999,1
1714613089694,CAT 124RS,A01,519847,Geibel; William,0,0,20,20
1714613090717,CAT 125RS,A01,515971,Geibel; William,0,0,20,20
1714613091742,CLRE 250,A00,511389,Morris; Sheldon,9993,0,9999,6
1714613092768,CLRE 251,A00,507176,Mehta; Ravindra L.,9993,0,9999,6
1714613092768,CLRE 251,B00,511410,Mehta; Ravindra L.,9998,0,9999,1
1714613093793,CLRE 252,A00,507189,Cuomo; Raphael Eduardo,9995,0,9999,4
1714613094823,CLRE 253,A00,507199,Vaida; Florin,9994,0,9999,5
1714613094823,CLRE 253,B00,507202,Vaida; Florin,9999,0,9999,0
1714613095847,CLRE 259,A00,507211,Patel; Hemal,9996,0,9999,3
1714613096873,CLRE 260,A00,507221,Cuomo; Raphael Eduardo,9999,0,9999,0
1714613097895,CLRE 297,001,507242,Cuomo; Raphael Eduardo,9999,0,9999,0
1714613098920,COGS 197,001,638244,Voytek; Bradley Thomas,9998,0,9999,1
1714613099942,CSE 191,A00,516875,Minnes Kemp; Mor Mia,9992,0,9999,7
1714613100965,CSE 197,001,637388,Minnes Kemp; Mor Mia,9998,0,9999,1
1714613101993,CSS 201S,A01,494383,Staff,35,0,35,0
1714613103021,CSS 202S,A01,494387,Staff,35,0,35,0
1714613104050,DSC 197,001,628532,Eldridge; Justin Matthew,9996,0,9999,3
1714613105077,EAP 100,A00,516065,Staff,9797,0,9999,202
1714613106102,ECE 45,A01,507414,Staff,33,0,60,27
1714613108156,ECE 111,A01,507420,Staff,15,0,50,35
1714613109186,ECE 197,001,548057,Sievenpiper; Daniel F.,9993,0,9999,6
1714613110214,EDS 115,A00,507243,Choi; Bailey Miyeon,10,0,28,18
1714613111242,EDS 117,A01,494379,Staff,1,5,30,29
1714613112270,EDS 125,A00,507246,Hopkins; Megan Beth,9,0,30,21
1714613113295,EDS 128A,A01,507264,Fargason; Sharon Gayle,8,0,26,18
1714613114323,EDS 128B,A01,507293,Pappas; Elizabeth,12,0,30,18
1714613115350,EDS 139,A00,507294,Fargason; Sharon Gayle,13,0,30,17
1714613115350,EDS 139,B00,507313,Pappas; Elizabeth,13,0,30,17
1714613116374,EDS 201,A00,507315,Staff,13,0,30,17
1714613117399,EDS 203,A01,507317,Halter; Christopher P.,12,0,30,18
1714613118425,EDS 204R,A01,507319,Halter; Christopher P.,0,3,30,30
1714613118425,EDS 204R,B01,507331,Heinzman; Erica M.,16,0,30,14
1714613119454,EDS 206R,A00,507332,Staff,0,4,30,30
1714613119454,EDS 206R,B00,507343,Staff,17,0,30,13
1714613120483,EDS 250,A00,507344,Hemans; Patricia Ann Benitez,22,0,40,18
1714613121511,EDS 281,A00,507345,Daly; Alan J.,18,0,18,0
1714613122533,EDS 284,A00,507350,Daly; Alan J.,16,0,16,0
1714613123559,EDS 286,A00,507359,Fine; Sarah,18,0,18,0
1714613124587,EDS 289C,A01,507361,Daly; Alan J.,18,0,18,0
1714613125612,EDS 290,A00,507366,Hofstetter; Carolyn,15,0,15,0
1714613126640,LIGM 5A,A00,507421,Fischer-Grunski; Eva K,18,0,20,2
1714613127667,LIGM 5B,A00,507423,Fischer-Grunski; Eva K,19,0,20,1
1714613128691,LIGM 5C,A00,507425,Fischer-Grunski; Eva K,19,0,20,1
1714613129722,LIIT 5AS,A00,507427,Carnelos; Chiara,20,0,20,0
1714613130752,LIIT 5BS,A00,507430,Carnelos; Chiara,20,0,20,0
1714613131780,LIIT 5CS,A00,507432,Carnelos; Chiara,20,0,20,0
1714613132809,LISP 5A,A00,507541,Munoz Sanchez; Alicia,11,0,20,9
1714613133833,LISP 5B,A00,507671,Munoz Sanchez; Alicia,8,0,20,12
1714613134859,LISP 5C,A00,507696,Munoz Sanchez; Alicia,9,0,20,11
1714613135887,MAE 197,001,528363,Boechler; Nicholas Sebastia,9998,0,9999,1
1714613136915,MATH 197,001,523477,Kedlaya; Kiran S.,9995,0,9999,4
1714613136915,MATH 197,002,563811,Zhang; Danna,9995,0,9999,4
1714613136915,MATH 197,003,628552,Dumitriu; Ioana,9998,0,9999,1
1714613137939,MCWP 40R,A00,518780,Staff,2,0,20,18
1714613137939,MCWP 40R,B00,518781,Staff,8,0,20,12
1714613137939,MCWP 40R,C00,518783,Staff,6,0,20,14
1714613138966,MCWP 50R,A00,518791,Staff,0,0,20,20
1714613138966,MCWP 50R,B00,518792,Staff,0,2,20,20
1714613138966,MCWP 50R,C00,518793,Staff,0,2,20,20
1714613138966,MCWP 50R,D00,518794,Staff,0,0,20,20
1714613138966,MCWP 50R,E00,518795,Staff,0,2,20,20
1714613138966,MCWP 50R,F00,518796,Staff,0,0,20,20
1714613138966,MCWP 50R,G00,518797,Staff,0,1,20,20
1714613139994,MMW 12R,A01,514034,Herbst; Matthew,0,0,16,16
1714613139994,MMW 12R,A02,514035,Herbst; Matthew,1,0,16,15
1714613141017,MMW 13R,A01,514037,Staff,0,4,16,16
1714613141017,MMW 13R,A02,514039,Staff,0,2,16,16
1714613141017,MMW 13R,A03,628519,Staff,0,2,16,16
1714613143065,SIO 295LS,A00,523233,Staff,10,0,30,20
1714613144089,SIO 295S,A00,523232,Staff,10,0,30,20
1714613145113,SIOC 290S,A01,637330,Merrifield; Mark A,23,0,30,7
1714613146140,SIOC 291S,A01,637333,Gabriel; Corey John,23,0,30,7
1714613147167,SOCI 117,A01,494376,Staff,0,4,5,5
1714613148192,WES 237B,A00,494380,Staff,9,0,20,11
1714613150260,AESE 279B,A00,494370,Wade; Jon P,0,0,33,33
1714613151285,AIP 197,001,627712,Vespa; Emanuel Ignacio,9998,0,9999,1
1714613152318,ANAR 135S,A00,494369,Braswell; Geoffrey E.,0,0,0,0
1714613153345,BENG 196,001,628496,Engler; Adam J.,9998,0,9999,1
1714613154372,CAT 124RS,A01,519847,Geibel; William,0,0,20,20
1714613155396,CAT 125RS,A01,515971,Geibel; William,0,0,20,20
1714613156424,CLRE 250,A00,511389,Morris; Sheldon,9993,0,9999,6
1714613157450,CLRE 251,A00,507176,Mehta; Ravindra L.,9993,0,9999,6
1714613157450,CLRE 251,B00,511410,Mehta; Ravindra L.,9998,0,9999,1
1714613158479,CLRE 252,A00,507189,Cuomo; Raphael Eduardo,9995,0,9999,4
1714613159504,CLRE 253,A00,507199,Vaida; Florin,9994,0,9999,5
1714613159504,CLRE 253,B00,507202,Vaida; Florin,9999,0,9999,0
1714613160532,CLRE 259,A00,507211,Patel; Hemal,9996,0,9999,3
1714613161557,CLRE 260,A00,507221,Cuomo; Raphael Eduardo,9999,0,9999,0
1714613162580,CLRE 297,001,507242,Cuomo; Raphael Eduardo,9999,0,9999,0
1714613163605,COGS 197,001,638244,Voytek; Bradley Thomas,9998,0,9999,1
1714613164629,CSE 191,A00,516875,Minnes Kemp; Mor Mia,9992,0,9999,7
1714613165656,CSE 197,001,637388,Minnes Kemp; Mor Mia,9998,0,9999,1
1714613166685,CSS 201S,A01,494383,Staff,35,0,35,0
1714613167713,CSS 202S,A01,494387,Staff,35,0,35,0
1714613168738,DSC 197,001,628532,Eldridge; Justin Matthew,9996,0,9999,3
1714613169762,EAP 100,A00,516065,Staff,9797,0,9999,202
1714613170806,ECE 45,A01,507414,Staff,33,0,60,27
1714613172860,ECE 111,A01,507420,Staff,15,0,50,35
1714613173897,ECE 197,001,548057,Sievenpiper; Daniel F.,9993,0,9999,6
1714613174926,EDS 115,A00,507243,Choi; Bailey Miyeon,10,0,28,18
1714613175951,EDS 117,A01,494379,Staff,1,5,30,29
1714613176977,EDS 125,A00,507246,Hopkins; Megan Beth,9,0,30,21
1714613178006,EDS 128A,A01,507264,Fargason; Sharon Gayle,8,0,26,18
1714613179032,EDS 128B,A01,507293,Pappas; Elizabeth,12,0,30,18
1714613180060,EDS 139,A00,507294,Fargason; Sharon Gayle,13,0,30,17
1714613180060,EDS 139,B00,507313,Pappas; Elizabeth,13,0,30,17
1714613181085,EDS 201,A00,507315,Staff,13,0,30,17
1714613182110,EDS 203,A01,507317,Halter; Christopher P.,12,0,30,18
1714613183138,EDS 204R,A01,507319,Halter; Christopher P.,0,3,30,30
1714613183138,EDS 204R,B01,507331,Heinzman; Erica M.,16,0,30,14
1714613184163,EDS 206R,A00,507332,Staff,0,4,30,30
1714613184163,EDS 206R,B00,507343,Staff,17,0,30,13
1714613185191,EDS 250,A00,507344,Hemans; Patricia Ann Benitez,22,0,40,18
1714613186220,EDS 281,A00,507345,Daly; Alan J.,18,0,18,0
1714613187246,EDS 284,A00,507350,Daly; Alan J.,16,0,16,0
1714613188273,EDS 286,A00,507359,Fine; Sarah,18,0,18,0
1714613189297,EDS 289C,A01,507361,Daly; Alan J.,18,0,18,0
1714613190325,EDS 290,A00,507366,Hofstetter; Carolyn,15,0,15,0
1714613191352,LIGM 5A,A00,507421,Fischer-Grunski; Eva K,18,0,20,2
1714613192381,LIGM 5B,A00,507423,Fischer-Grunski; Eva K,19,0,20,1
1714613193410,LIGM 5C,A00,507425,Fischer-Grunski; Eva K,19,0,20,1
1714613194441,LIIT 5AS,A00,507427,Carnelos; Chiara,20,0,20,0
1714613195467,LIIT 5BS,A00,507430,Carnelos; Chiara,20,0,20,0
1714613196492,LIIT 5CS,A00,507432,Carnelos; Chiara,20,0,20,0
1714613197517,LISP 5A,A00,507541,Munoz Sanchez; Alicia,11,0,20,9
1714613198541,LISP 5B,A00,507671,Munoz Sanchez; Alicia,8,0,20,12
1714613199567,LISP 5C,A00,507696,Munoz Sanchez; Alicia,9,0,20,11
1714613200596,MAE 197,001,528363,Boechler; Nicholas Sebastia,9998,0,9999,1
1714613201622,MATH 197,001,523477,Kedlaya; Kiran S.,9995,0,9999,4
1714613201622,MATH 197,002,563811,Zhang; Danna,9995,0,9999,4
1714613201622,MATH 197,003,628552,Dumitriu; Ioana,9998,0,9999,1
1714613202648,MCWP 40R,A00,518780,Staff,2,0,20,18
1714613202648,MCWP 40R,B00,518781,Staff,8,0,20,12
1714613202648,MCWP 40R,C00,518783,Staff,6,0,20,14
1714613203676,MCWP 50R,A00,518791,Staff,0,0,20,20
1714613203676,MCWP 50R,B00,518792,Staff,0,2,20,20
1714613203676,MCWP 50R,C00,518793,Staff,0,2,20,20
1714613203676,MCWP 50R,D00,518794,Staff,0,0,20,20
1714613203676,MCWP 50R,E00,518795,Staff,0,2,20,20
1714613203676,MCWP 50R,F00,518796,Staff,0,0,20,20
1714613203676,MCWP 50R,G00,518797,Staff,0,1,20,20
1714613204701,MMW 12R,A01,514034,Herbst; Matthew,0,0,16,16
1714613204701,MMW 12R,A02,514035,Herbst; Matthew,1,0,16,15
1714613205729,MMW 13R,A01,514037,Staff,0,4,16,16
1714613205729,MMW 13R,A02,514039,Staff,0,2,16,16
1714613205729,MMW 13R,A03,628519,Staff,0,2,16,16
1714613207783,SIO 295LS,A00,523233,Staff,10,0,30,20
1714613208808,SIO 295S,A00,523232,Staff,10,0,30,20
1714613209838,SIOC 290S,A01,637330,Merrifield; Mark A,23,0,30,7
1714613210864,SIOC 291S,A01,637333,Gabriel; Corey John,23,0,30,7
1714613211891,SOCI 117,A01,494376,Staff,0,4,5,5
1714613212917,WES 237B,A00,494380,Staff,9,0,20,11
1714613214982,AESE 279B,A00,494370,Wade; Jon P,0,0,33,33
1714613216008,AIP 197,001,627712,Vespa; Emanuel Ignacio,9998,0,9999,1
1714613217035,ANAR 135S,A00,494369,Braswell; Geoffrey E.,0,0,0,0
1714613218060,BENG 196,001,628496,Engler; Adam J.,9998,0,9999,1
1714613219085,CAT 124RS,A01,519847,Geibel; William,0,0,20,20
1714613220115,CAT 125RS,A01,515971,Geibel; William,0,0,20,20
1714613221144,CLRE 250,A00,511389,Morris; Sheldon,9993,0,9999,6
1714613222171,CLRE 251,A00,507176,Mehta; Ravindra L.,9993,0,9999,6
1714613222171,CLRE 251,B00,511410,Mehta; Ravindra L.,9998,0,9999,1
1714613223200,CLRE 252,A00,507189,Cuomo; Raphael Eduardo,9995,0,9999,4
1714613224230,CLRE 253,A00,507199,Vaida; Florin,9994,0,9999,5
1714613224230,CLRE 253,B00,507202,Vaida; Florin,9999,0,9999,0
1714613225259,CLRE 259,A00,507211,Patel; Hemal,9996,0,9999,3
1714613226288,CLRE 260,A00,507221,Cuomo; Raphael Eduardo,9999,0,9999,0
1714613227368,CLRE 297,001,507242,Cuomo; Raphael Eduardo,9999,0,9999,0
1714613228393,COGS 197,001,638244,Voytek; Bradley Thomas,9998,0,9999,1
1714613229420,CSE 191,A00,516875,Minnes Kemp; Mor Mia,9992,0,9999,7
1714613230445,CSE 197,001,637388,Minnes Kemp; Mor Mia,9998,0,9999,1
1714613231472,CSS 201S,A01,494383,Staff,35,0,35,0
1714613232499,CSS 202S,A01,494387,Staff,35,0,35,0
1714613233527,DSC 197,001,628532,Eldridge; Justin Matthew,9996,0,9999,3
1714613234553,EAP 100,A00,516065,Staff,9797,0,9999,202
1714613235578,ECE 45,A01,507414,Staff,33,0,60,27
1714613237628,ECE 111,A01,507420,Staff,15,0,50,35
1714613238656,ECE 197,001,548057,Sievenpiper; Daniel F.,9993,0,9999,6
1714613239682,EDS 115,A00,507243,Choi; Bailey Miyeon,10,0,28,18
1714613240708,EDS 117,A01,494379,Staff,1,5,30,29
1714613241737,EDS 125,A00,507246,Hopkins; Megan Beth,9,0,30,21
1714613242763,EDS 128A,A01,507264,Fargason; Sharon Gayle,8,0,26,18
1714613243788,EDS 128B,A01,507293,Pappas; Elizabeth,12,0,30,18
1714613244815,EDS 139,A00,507294,Fargason; Sharon Gayle,13,0,30,17
1714613244815,EDS 139,B00,507313,Pappas; Elizabeth,13,0,30,17
1714613245848,EDS 201,A00,507315,Staff,13,0,30,17
1714613246875,EDS 203,A01,507317,Halter; Christopher P.,12,0,30,18
1714613247900,EDS 204R,A01,507319,Halter; Christopher P.,0,3,30,30
1714613247900,EDS 204R,B01,507331,Heinzman; Erica M.,16,0,30,14
1714613248927,EDS 206R,A00,507332,Staff,0,4,30,30
1714613248927,EDS 206R,B00,507343,Staff,17,0,30,13
1714613249955,EDS 250,A00,507344,Hemans; Patricia Ann Benitez,22,0,40,18
1714613250979,EDS 281,A00,507345,Daly; Alan J.,18,0,18,0
1714613252005,EDS 284,A00,507350,Daly; Alan J.,16,0,16,0
1714613253031,EDS 286,A00,507359,Fine; Sarah,18,0,18,0
1714613254055,EDS 289C,A01,507361,Daly; Alan J.,18,0,18,0
1714613255083,EDS 290,A00,507366,Hofstetter; Carolyn,15,0,15,0
1714613256114,LIGM 5A,A00,507421,Fischer-Grunski; Eva K,18,0,20,2
1714613257142,LIGM 5B,A00,507423,Fischer-Grunski; Eva K,19,0,20,1
1714613258167,LIGM 5C,A00,507425,Fischer-Grunski; Eva K,19,0,20,1
1714613259192,LIIT 5AS,A00,507427,Carnelos; Chiara,20,0,20,0
1714613260221,LIIT 5BS,A00,507430,Carnelos; Chiara,20,0,20,0
1714613261245,LIIT 5CS,A00,507432,Carnelos; Chiara,20,0,20,0
1714613262300,LISP 5A,A00,507541,Munoz Sanchez; Alicia,11,0,20,9
1714613263325,LISP 5B,A00,507671,Munoz Sanchez; Alicia,8,0,20,12
1714613264350,LISP 5C,A00,507696,Munoz Sanchez; Alicia,9,0,20,11
1714613265379,MAE 197,001,528363,Boechler; Nicholas Sebastia,9998,0,9999,1
1714613266408,MATH 197,001,523477,Kedlaya; Kiran S.,9995,0,9999,4
1714613266408,MATH 197,002,563811,Zhang; Danna,9995,0,9999,4
1714613266408,MATH 197,003,628552,Dumitriu; Ioana,9998,0,9999,1
1714613267432,MCWP 40R,A00,518780,Staff,2,0,20,18
1714613267432,MCWP 40R,B00,518781,Staff,8,0,20,12
1714613267432,MCWP 40R,C00,518783,Staff,6,0,20,14
1714613268457,MCWP 50R,A00,518791,Staff,0,0,20,20
1714613268457,MCWP 50R,B00,518792,Staff,0,2,20,20
1714613268457,MCWP 50R,C00,518793,Staff,0,2,20,20
1714613268457,MCWP 50R,D00,518794,Staff,0,0,20,20
1714613268457,MCWP 50R,E00,518795,Staff,0,2,20,20
1714613268457,MCWP 50R,F00,518796,Staff,0,0,20,20
1714613268457,MCWP 50R,G00,518797,Staff,0,1,20,20
1714613269482,MMW 12R,A01,514034,Herbst; Matthew,0,0,16,16
1714613269482,MMW 12R,A02,514035,Herbst; Matthew,1,0,16,15
1714613270512,MMW 13R,A01,514037,Staff,0,4,16,16
1714613270512,MMW 13R,A02,514039,Staff,0,2,16,16
1714613270512,MMW 13R,A03,628519,Staff,0,2,16,16
1714613272562,SIO 295LS,A00,523233,Staff,10,0,30,20
1714613273586,SIO 295S,A00,523232,Staff,10,0,30,20
1714613274612,SIOC 290S,A01,637330,Merrifield; Mark A,23,0,30,7
1714613275636,SIOC 291S,A01,637333,Gabriel; Corey John,23,0,30,7
1714613276664,SOCI 117,A01,494376,Staff,0,4,5,5
1714613277691,WES 237B,A00,494380,Staff,9,0,20,11
1714613279762,AESE 279B,A00,494370,Wade; Jon P,0,0,33,33
1714613280787,AIP 197,001,627712,Vespa; Emanuel Ignacio,9998,0,9999,1
1714613281815,ANAR 135S,A00,494369,Braswell; Geoffrey E.,0,0,0,0
1714613282845,BENG 196,001,628496,Engler; Adam J.,9998,0,9999,1
1714613283875,CAT 124RS,A01,519847,Geibel; William,0,0,20,20
1714613284901,CAT 125RS,A01,515971,Geibel; William,0,0,20,20
1714613285930,CLRE 250,A00,511389,Morris; Sheldon,9993,0,9999,6
1714613286955,CLRE 251,A00,507176,Mehta; Ravindra L.,9993,0,9999,6
1714613286955,CLRE 251,B00,511410,Mehta; Ravindra L.,9998,0,9999,1
1714613287982,CLRE 252,A00,507189,Cuomo; Raphael Eduardo,9995,0,9999,4
1714613289011,CLRE 253,A00,507199,Vaida; Florin,9994,0,9999,5
1714613289011,CLRE 253,B00,507202,Vaida; Florin,9999,0,9999,0
1714613290036,CLRE 259,A00,507211,Patel; Hemal,9996,0,9999,3
1714613291061,CLRE 260,A00,507221,Cuomo; Raphael Eduardo,9999,0,9999,0
1714613292089,CLRE 297,001,507242,Cuomo; Raphael Eduardo,9999,0,9999,0
1714613293115,COGS 197,001,638244,Voytek; Bradley Thomas,9998,0,9999,1
1714613294144,CSE 191,A00,516875,Minnes Kemp; Mor Mia,9992,0,9999,7
1714613295169,CSE 197,001,637388,Minnes Kemp; Mor Mia,9998,0,9999,1
1714613296195,CSS 201S,A01,494383,Staff,35,0,35,0
1714613297223,CSS 202S,A01,494387,Staff,35,0,35,0
1714613298247,DSC 197,001,628532,Eldridge; Justin Matthew,9996,0,9999,3
1714613299273,EAP 100,A00,516065,Staff,9797,0,9999,202
1714613300302,ECE 45,A01,507414,Staff,33,0,60,27
1714613302352,ECE 111,A01,507420,Staff,15,0,50,35
1714613303378,ECE 197,001,548057,Sievenpiper; Daniel F.,9993,0,9999,6
1714613304404,EDS 115,A00,507243,Choi; Bailey Miyeon,10,0,28,18
1714613305430,EDS 117,A01,494379,Staff,1,5,30,29
1714613306455,EDS 125,A00,507246,Hopkins; Megan Beth,9,0,30,21
1714613307487,EDS 128A,A01,507264,Fargason; Sharon Gayle,8,0,26,18
1714613308511,EDS 128B,A01,507293,Pappas; Elizabeth,12,0,30,18
1714613309539,EDS 139,A00,507294,Fargason; Sharon Gayle,13,0,30,17
1714613309539,EDS 139,B00,507313,Pappas; Elizabeth,13,0,30,17
1714613310567,EDS 201,A00,507315,Staff,13,0,30,17
1714613311599,EDS 203,A01,507317,Halter; Christopher P.,12,0,30,18
1714613312625,EDS 204R,A01,507319,Halter; Christopher P.,0,3,30,30
1714613312625,EDS 204R,B01,507331,Heinzman; Erica M.,16,0,30,14
1714613313652,EDS 206R,A00,507332,Staff,0,4,30,30
1714613313652,EDS 206R,B00,507343,Staff,17,0,30,13
1714613314678,EDS 250,A00,507344,Hemans; Patricia Ann Benitez,22,0,40,18
1714613315706,EDS 281,A00,507345,Daly; Alan J.,18,0,18,0
1714613316732,EDS 284,A00,507350,Daly; Alan J.,16,0,16,0
1714613317757,EDS 286,A00,507359,Fine; Sarah,18,0,18,0
1714613318782,EDS 289C,A01,507361,Daly; Alan J.,18,0,18,0
1714613319808,EDS 290,A00,507366,Hofstetter; Carolyn,15,0,15,0
1714613320840,LIGM 5A,A00,507421,Fischer-Grunski; Eva K,18,0,20,2
1714613321867,LIGM 5B,A00,507423,Fischer-Grunski; Eva K,19,0,20,1
1714613322893,LIGM 5C,A00,507425,Fischer-Grunski; Eva K,19,0,20,1
1714613323923,LIIT 5AS,A00,507427,Carnelos; Chiara,20,0,20,0
1714613324951,LIIT 5BS,A00,507430,Carnelos; Chiara,20,0,20,0
1714613325977,LIIT 5CS,A00,507432,Carnelos; Chiara,20,0,20,0
1714613327009,LISP 5A,A00,507541,Munoz Sanchez; Alicia,11,0,20,9
1714613328033,LISP 5B,A00,507671,Munoz Sanchez; Alicia,8,0,20,12
1714613329061,LISP 5C,A00,507696,Munoz Sanchez; Alicia,9,0,20,11
1714613330087,MAE 197,001,528363,Boechler; Nicholas Sebastia,9998,0,9999,1
1714613331115,MATH 197,001,523477,Kedlaya; Kiran S.,9995,0,9999,4
1714613331115,MATH 197,002,563811,Zhang; Danna,9995,0,9999,4
1714613331115,MATH 197,003,628552,Dumitriu; Ioana,9998,0,9999,1
1714613332140,MCWP 40R,A00,518780,Staff,2,0,20,18
1714613332140,MCWP 40R,B00,518781,Staff,8,0,20,12
1714613332140,MCWP 40R,C00,518783,Staff,6,0,20,14
1714613333171,MCWP 50R,A00,518791,Staff,0,0,20,20
1714613333171,MCWP 50R,B00,518792,Staff,0,2,20,20
1714613333171,MCWP 50R,C00,518793,Staff,0,2,20,20
1714613333171,MCWP 50R,D00,518794,Staff,0,0,20,20
1714613333171,MCWP 50R,E00,518795,Staff,0,2,20,20
1714613333171,MCWP 50R,F00,518796,Staff,0,0,20,20
1714613333171,MCWP 50R,G00,518797,Staff,0,1,20,20
1714613334195,MMW 12R,A01,514034,Herbst; Matthew,0,0,16,16
1714613334195,MMW 12R,A02,514035,Herbst; Matthew,1,0,16,15
1714613335219,MMW 13R,A01,514037,Staff,0,4,16,16
1714613335219,MMW 13R,A02,514039,Staff,0,2,16,16
1714613335219,MMW 13R,A03,628519,Staff,0,2,16,16
1714613337273,SIO 295LS,A00,523233,Staff,10,0,30,20
1714613338298,SIO 295S,A00,523232,Staff,10,0,30,20
1714613339323,SIOC 290S,A01,637330,Merrifield; Mark A,23,0,30,7
1714613340375,SIOC 291S,A01,637333,Gabriel; Corey John,23,0,30,7
1714613341402,SOCI 117,A01,494376,Staff,0,4,5,5
1714613342429,WES 237B,A00,494380,Staff,9,0,20,11
1714613344498,AESE 279B,A00,494370,Wade; Jon P,0,0,33,33
1714613345527,AIP 197,001,627712,Vespa; Emanuel Ignacio,9998,0,9999,1
1714613346552,ANAR 135S,A00,494369,Braswell; Geoffrey E.,0,0,0,0
1714613347578,BENG 196,001,628496,Engler; Adam J.,9998,0,9999,1
1714613348608,CAT 124RS,A01,519847,Geibel; William,0,0,20,20
1714613349637,CAT 125RS,A01,515971,Geibel; William,0,0,20,20
1714613350662,CLRE 250,A00,511389,Morris; Sheldon,9993,0,9999,6
1714613351693,CLRE 251,A00,507176,Mehta; Ravindra L.,9993,0,9999,6
1714613351693,CLRE 251,B00,511410,Mehta; Ravindra L.,9998,0,9999,1
1714613352719,CLRE 252,A00,507189,Cuomo; Raphael Eduardo,9995,0,9999,4
1714613353745,CLRE 253,A00,507199,Vaida; Florin,9994,0,9999,5
1714613353745,CLRE 253,B00,507202,Vaida; Florin,9999,0,9999,0
1714613354772,CLRE 259,A00,507211,Patel; Hemal,9996,0,9999,3
1714613355798,CLRE 260,A00,507221,Cuomo; Raphael Eduardo,9999,0,9999,0
1714613356825,CLRE 297,001,507242,Cuomo; Raphael Eduardo,9999,0,9999,0
1714613357851,COGS 197,001,638244,Voytek; Bradley Thomas,9998,0,9999,1
1714613358877,CSE 191,A00,516875,Minnes Kemp; Mor Mia,9992,0,9999,7
1714613359903,CSE 197,001,637388,Minnes Kemp; Mor Mia,9998,0,9999,1
1714613360930,CSS 201S,A01,494383,Staff,35,0,35,0
1714613361955,CSS 202S,A01,494387,Staff,35,0,35,0
1714613362979,DSC 197,001,628532,Eldridge; Justin Matthew,9996,0,9999,3
1714613364003,EAP 100,A00,516065,Staff,9797,0,9999,202
1714613365031,ECE 45,A01,507414,Staff,33,0,60,27
1714613367081,ECE 111,A01,507420,Staff,15,0,50,35
1714613368108,ECE 197,001,548057,Sievenpiper; Daniel F.,9993,0,9999,6
1714613369133,EDS 115,A00,507243,Choi; Bailey Miyeon,10,0,28,18
1714613370163,EDS 117,A01,494379,Staff,1,5,30,29
1714613371190,EDS 125,A00,507246,Hopkins; Megan Beth,9,0,30,21
1714613372215,EDS 128A,A01,507264,Fargason; Sharon Gayle,8,0,26,18
1714613373241,EDS 128B,A01,507293,Pappas; Elizabeth,12,0,30,18
1714613374269,EDS 139,A00,507294,Fargason; Sharon Gayle,13,0,30,17
1714613374269,EDS 139,B00,507313,Pappas; Elizabeth,13,0,30,17
1714613375295,EDS 201,A00,507315,Staff,13,0,30,17
1714613376320,EDS 203,A01,507317,Halter; Christopher P.,12,0,30,18
1714613377344,EDS 204R,A01,507319,Halter; Christopher P.,0,3,30,30
1714613377344,EDS 204R,B01,507331,Heinzman; Erica M.,16,0,30,14
1714613378368,EDS 206R,A00,507332,Staff,0,4,30,30
1714613378368,EDS 206R,B00,507343,Staff,17,0,30,13
1714613379395,EDS 250,A00,507344,Hemans; Patricia Ann Benitez,22,0,40,18
1714613380421,EDS 281,A00,507345,Daly; Alan J.,18,0,18,0
1714613381445,EDS 284,A00,507350,Daly; Alan J.,16,0,16,0
1714613382475,EDS 286,A00,507359,Fine; Sarah,18,0,18,0
1714613383500,EDS 289C,A01,507361,Daly; Alan J.,18,0,18,0
1714613384524,EDS 290,A00,507366,Hofstetter; Carolyn,15,0,15,0
1714613385552,LIGM 5A,A00,507421,Fischer-Grunski; Eva K,18,0,20,2
1714613386577,LIGM 5B,A00,507423,Fischer-Grunski; Eva K,19,0,20,1
1714613387604,LIGM 5C,A00,507425,Fischer-Grunski; Eva K,19,0,20,1
1714613388630,LIIT 5AS,A00,507427,Carnelos; Chiara,20,0,20,0
1714613389657,LIIT 5BS,A00,507430,Carnelos; Chiara,20,0,20,0
1714613390686,LIIT 5CS,A00,507432,Carnelos; Chiara,20,0,20,0
1714613391715,LISP 5A,A00,507541,Munoz Sanchez; Alicia,11,0,20,9
1714613392739,LISP 5B,A00,507671,Munoz Sanchez; Alicia,8,0,20,12
1714613393767,LISP 5C,A00,507696,Munoz Sanchez; Alicia,9,0,20,11
1714613394792,MAE 197,001,528363,Boechler; Nicholas Sebastia,9998,0,9999,1
1714613395825,MATH 197,001,523477,Kedlaya; Kiran S.,9995,0,9999,4
1714613395825,MATH 197,002,563811,Zhang; Danna,9995,0,9999,4
1714613395825,MATH 197,003,628552,Dumitriu; Ioana,9998,0,9999,1
1714613396854,MCWP 40R,A00,518780,Staff,2,0,20,18
1714613396854,MCWP 40R,B00,518781,Staff,8,0,20,12
1714613396854,MCWP 40R,C00,518783,Staff,6,0,20,14
1714613397883,MCWP 50R,A00,518791,Staff,0,0,20,20
1714613397883,MCWP 50R,B00,518792,Staff,0,2,20,20
1714613397883,MCWP 50R,C00,518793,Staff,0,2,20,20
1714613397883,MCWP 50R,D00,518794,Staff,0,0,20,20
1714613397883,MCWP 50R,E00,518795,Staff,0,2,20,20
1714613397883,MCWP 50R,F00,518796,Staff,0,0,20,20
1714613397883,MCWP 50R,G00,518797,Staff,0,1,20,20
1714613398910,MMW 12R,A01,514034,Herbst; Matthew,0,0,16,16
1714613398910,MMW 12R,A02,514035,Herbst; Matthew,1,0,16,15
1714613399939,MMW 13R,A01,514037,Staff,0,4,16,16
1714613399939,MMW 13R,A02,514039,Staff,0,2,16,16
1714613399939,MMW 13R,A03,628519,Staff,0,2,16,16
1714613401990,SIO 295LS,A00,523233,Staff,10,0,30,20
1714613403015,SIO 295S,A00,523232,Staff,10,0,30,20
1714613404041,SIOC 290S,A01,637330,Merrifield; Mark A,23,0,30,7
1714613405067,SIOC 291S,A01,637333,Gabriel; Corey John,23,0,30,7
1714613406091,SOCI 117,A01,494376,Staff,0,4,5,5
1714613407118,WES 237B,A00,494380,Staff,9,0,20,11
1714613409197,AESE 279B,A00,494370,Wade; Jon P,0,0,33,33
1714613410222,AIP 197,001,627712,Vespa; Emanuel Ignacio,9998,0,9999,1
1714613411250,ANAR 135S,A00,494369,Braswell; Geoffrey E.,0,0,0,0
1714613412278,BENG 196,001,628496,Engler; Adam J.,9998,0,9999,1
1714613413307,CAT 124RS,A01,519847,Geibel; William,0,0,20,20
1714613414332,CAT 125RS,A01,515971,Geibel; William,0,0,20,20
1714613415358,CLRE 250,A00,511389,Morris; Sheldon,9993,0,9999,6
1714613416388,CLRE 251,A00,507176,Mehta; Ravindra L.,9993,0,9999,6
1714613416388,CLRE 251,B00,511410,Mehta; Ravindra L.,9998,0,9999,1
1714613417414,CLRE 252,A00,507189,Cuomo; Raphael Eduardo,9995,0,9999,4
1714613418440,CLRE 253,A00,507199,Vaida; Florin,9994,0,9999,5
1714613418440,CLRE 253,B00,507202,Vaida; Florin,9999,0,9999,0
1714613419464,CLRE 259,A00,507211,Patel; Hemal,9996,0,9999,3
1714613420490,CLRE 260,A00,507221,Cuomo; Raphael Eduardo,9999,0,9999,0
1714613421517,CLRE 297,001,507242,Cuomo; Raphael Eduardo,9999,0,9999,0
1714613422545,COGS 197,001,638244,Voytek; Bradley Thomas,9998,0,9999,1
1714613423573,CSE 191,A00,516875,Minnes Kemp; Mor Mia,9992,0,9999,7
1714613424600,CSE 197,001,637388,Minnes Kemp; Mor Mia,9998,0,9999,1
1714613425627,CSS 201S,A01,494383,Staff,35,0,35,0
1714613426651,CSS 202S,A01,494387,Staff,35,0,35,0
1714613427677,DSC 197,001,628532,Eldridge; Justin Matthew,9996,0,9999,3
1714613428703,EAP 100,A00,516065,Staff,9797,0,9999,202
1714613429730,ECE 45,A01,507414,Staff,33,0,60,27
1714613431782,ECE 111,A01,507420,Staff,15,0,50,35
1714613432808,ECE 197,001,548057,Sievenpiper; Daniel F.,9993,0,9999,6
1714613433834,EDS 115,A00,507243,Choi; Bailey Miyeon,10,0,28,18
1714613434860,EDS 117,A01,494379,Staff,1,5,30,29
1714613435886,EDS 125,A00,507246,Hopkins; Megan Beth,9,0,30,21
1714613436913,EDS 128A,A01,507264,Fargason; Sharon Gayle,8,0,26,18
1714613437939,EDS 128B,A01,507293,Pappas; Elizabeth,12,0,30,18
1714613438966,EDS 139,A00,507294,Fargason; Sharon Gayle,13,0,30,17
1714613438966,EDS 139,B00,507313,Pappas; Elizabeth,13,0,30,17
1714613439992,EDS 201,A00,507315,Staff,13,0,30,17
1714613441017,EDS 203,A01,507317,Halter; Christopher P.,12,0,30,18
1714613442043,EDS 204R,A01,507319,Halter; Christopher P.,0,3,30,30
1714613442043,EDS 204R,B01,507331,Heinzman; Erica M.,16,0,30,14
1714613443073,EDS 206R,A00,507332,Staff,0,4,30,30
1714613443073,EDS 206R,B00,507343,Staff,17,0,30,13
1714613444097,EDS 250,A00,507344,Hemans; Patricia Ann Benitez,22,0,40,18
1714613445125,EDS 281,A00,507345,Daly; Alan J.,18,0,18,0
1714613446151,EDS 284,A00,507350,Daly; Alan J.,16,0,16,0
1714613447176,EDS 286,A00,507359,Fine; Sarah,18,0,18,0
1714613448201,EDS 289C,A01,507361,Daly; Alan J.,18,0,18,0
1714613449230,EDS 290,A00,507366,Hofstetter; Carolyn,15,0,15,0
1714613450264,LIGM 5A,A00,507421,Fischer-Grunski; Eva K,18,0,20,2
1714613451291,LIGM 5B,A00,507423,Fischer-Grunski; Eva K,19,0,20,1
1714613452317,LIGM 5C,A00,507425,Fischer-Grunski; Eva K,19,0,20,1
1714613453347,LIIT 5AS,A00,507427,Carnelos; Chiara,20,0,20,0
1714613454375,LIIT 5BS,A00,507430,Carnelos; Chiara,20,0,20,0
1714613455403,LIIT 5CS,A00,507432,Carnelos; Chiara,20,0,20,0
1714613456433,LISP 5A,A00,507541,Munoz Sanchez; Alicia,11,0,20,9
1714613457461,LISP 5B,A00,507671,Munoz Sanchez; Alicia,8,0,20,12
1714613458487,LISP 5C,A00,507696,Munoz Sanchez; Alicia,9,0,20,11
1714613459512,MAE 197,001,528363,Boechler; Nicholas Sebastia,9998,0,9999,1
1714613460540,MATH 197,001,523477,Kedlaya; Kiran S.,9995,0,9999,4
1714613460540,MATH 197,002,563811,Zhang; Danna,9995,0,9999,4
1714613460540,MATH 197,003,628552,Dumitriu; Ioana,9998,0,9999,1
1714613461566,MCWP 40R,A00,518780,Staff,2,0,20,18
1714613461566,MCWP 40R,B00,518781,Staff,8,0,20,12
1714613461566,MCWP 40R,C00,518783,Staff,6,0,20,14
1714613462591,MCWP 50R,A00,518791,Staff,0,0,20,20
1714613462591,MCWP 50R,B00,518792,Staff,0,2,20,20
1714613462591,MCWP 50R,C00,518793,Staff,0,2,20,20
1714613462591,MCWP 50R,D00,518794,Staff,0,0,20,20
1714613462591,MCWP 50R,E00,518795,Staff,0,2,20,20
1714613462591,MCWP 50R,F00,518796,Staff,0,0,20,20
1714613462591,MCWP 50R,G00,518797,Staff,0,1,20,20
1714613463620,MMW 12R,A01,514034,Herbst; Matthew,0,0,16,16
1714613463620,MMW 12R,A02,514035,Herbst; Matthew,1,0,16,15
1714613464645,MMW 13R,A01,514037,Staff,0,4,16,16
1714613464645,MMW 13R,A02,514039,Staff,0,2,16,16
1714613464645,MMW 13R,A03,628519,Staff,0,2,16,16
1714613466700,SIO 295LS,A00,523233,Staff,10,0,30,20
1714613467725,SIO 295S,A00,523232,Staff,10,0,30,20
1714613468760,SIOC 290S,A01,637330,Merrifield; Mark A,23,0,30,7
1714613469785,SIOC 291S,A01,637333,Gabriel; Corey John,23,0,30,7
1714613470816,SOCI 117,A01,494376,Staff,0,4,5,5
1714613471843,WES 237B,A00,494380,Staff,9,0,20,11
1714613473925,AESE 279B,A00,494370,Wade; Jon P,0,0,33,33
1714613474951,AIP 197,001,627712,Vespa; Emanuel Ignacio,9998,0,9999,1
1714613475976,ANAR 135S,A00,494369,Braswell; Geoffrey E.,0,0,0,0
1714613477001,BENG 196,001,628496,Engler; Adam J.,9998,0,9999,1
1714613478032,CAT 124RS,A01,519847,Geibel; William,0,0,20,20
1714613479057,CAT 125RS,A01,515971,Geibel; William,0,0,20,20
1714613480139,CLRE 250,A00,511389,Morris; Sheldon,9993,0,9999,6
1714613481166,CLRE 251,A00,507176,Mehta; Ravindra L.,9993,0,9999,6
1714613481166,CLRE 251,B00,511410,Mehta; Ravindra L.,9998,0,9999,1
1714613482195,CLRE 252,A00,507189,Cuomo; Raphael Eduardo,9995,0,9999,4
1714613483220,CLRE 253,A00,507199,Vaida; Florin,9994,0,9999,5
1714613483220,CLRE 253,B00,507202,Vaida; Florin,9999,0,9999,0
1714613484246,CLRE 259,A00,507211,Patel; Hemal,9996,0,9999,3
1714613485275,CLRE 260,A00,507221,Cuomo; Raphael Eduardo,9999,0,9999,0
1714613486300,CLRE 297,001,507242,Cuomo; Raphael Eduardo,9999,0,9999,0
1714613487326,COGS 197,001,638244,Voytek; Bradley Thomas,9998,0,9999,1
1714613488350,CSE 191,A00,516875,Minnes Kemp; Mor Mia,9992,0,9999,7
1714613489374,CSE 197,001,637388,Minnes Kemp; Mor Mia,9998,0,9999,1
1714613490400,CSS 201S,A01,494383,Staff,35,0,35,0
1714613491428,CSS 202S,A01,494387,Staff,35,0,35,0
1714613492452,DSC 197,001,628532,Eldridge; Justin Matthew,9996,0,9999,3
1714613493479,EAP 100,A00,516065,Staff,9797,0,9999,202
1714613494508,ECE 45,A01,507414,Staff,33,0,60,27
1714613496562,ECE 111,A01,507420,Staff,15,0,50,35
1714613497590,ECE 197,001,548057,Sievenpiper; Daniel F.,9993,0,9999,6
1714613498619,EDS 115,A00,507243,Choi; Bailey Miyeon,10,0,28,18
1714613499649,EDS 117,A01,494379,Staff,1,5,30,29
1714613500676,EDS 125,A00,507246,Hopkins; Megan Beth,9,0,30,21
1714613501701,EDS 128A,A01,507264,Fargason; Sharon Gayle,8,0,26,18
1714613502726,EDS 128B,A01,507293,Pappas; Elizabeth,12,0,30,18
1714613503750,EDS 139,A00,507294,Fargason; Sharon Gayle,13,0,30,17
1714613503750,EDS 139,B00,507313,Pappas; Elizabeth,13,0,30,17
1714613504779,EDS 201,A00,507315,Staff,13,0,30,17
1714613505804,EDS 203,A01,507317,Halter; Christopher P.,12,0,30,18
1714613506831,EDS 204R,A01,507319,Halter; Christopher P.,0,3,30,30
1714613506831,EDS 204R,B01,507331,Heinzman; Erica M.,16,0,30,14
1714613507859,EDS 206R,A00,507332,Staff,0,4,30,30
1714613507859,EDS 206R,B00,507343,Staff,17,0,30,13
1714613508885,EDS 250,A00,507344,Hemans; Patricia Ann Benitez,22,0,40,18
1714613509913,EDS 281,A00,507345,Daly; Alan J.,18,0,18,0
1714613510943,EDS 284,A00,507350,Daly; Alan J.,16,0,16,0
1714613511968,EDS 286,A00,507359,Fine; Sarah,18,0,18,0
1714613512994,EDS 289C,A01,507361,Daly; Alan J.,18,0,18,0
1714613514019,EDS 290,A00,507366,Hofstetter; Carolyn,15,0,15,0
1714613515048,LIGM 5A,A00,507421,Fischer-Grunski; Eva K,18,0,20,2
1714613516073,LIGM 5B,A00,507423,Fischer-Grunski; Eva K,19,0,20,1
1714613517101,LIGM 5C,A00,507425,Fischer-Grunski; Eva K,19,0,20,1
1714613518128,LIIT 5AS,A00,507427,Carnelos; Chiara,20,0,20,0
1714613519154,LIIT 5BS,A00,507430,Carnelos; Chiara,20,0,20,0
1714613520184,LIIT 5CS,A00,507432,Carnelos; Chiara,20,0,20,0
1714613521210,LISP 5A,A00,507541,Munoz Sanchez; Alicia,11,0,20,9
1714613522242,LISP 5B,A00,507671,Munoz Sanchez; Alicia,8,0,20,12
1714613523272,LISP 5C,A00,507696,Munoz Sanchez; Alicia,9,0,20,11
1714613524301,MAE 197,001,528363,Boechler; Nicholas Sebastia,9998,0,9999,1
1714613525327,MATH 197,001,523477,Kedlaya; Kiran S.,9995,0,9999,4
1714613525327,MATH 197,002,563811,Zhang; Danna,9995,0,9999,4
1714613525327,MATH 197,003,628552,Dumitriu; Ioana,9998,0,9999,1
1714613526356,MCWP 40R,A00,518780,Staff,2,0,20,18
1714613526356,MCWP 40R,B00,518781,Staff,8,0,20,12
1714613526356,MCWP 40R,C00,518783,Staff,6,0,20,14
1714613527381,MCWP 50R,A00,518791,Staff,0,0,20,20
1714613527381,MCWP 50R,B00,518792,Staff,0,2,20,20
1714613527381,MCWP 50R,C00,518793,Staff,0,2,20,20
1714613527381,MCWP 50R,D00,518794,Staff,0,0,20,20
1714613527381,MCWP 50R,E00,518795,Staff,0,2,20,20
1714613527381,MCWP 50R,F00,518796,Staff,0,0,20,20
1714613527381,MCWP 50R,G00,518797,Staff,0,1,20,20
1714613528406,MMW 12R,A01,514034,Herbst; Matthew,0,0,16,16
1714613528406,MMW 12R,A02,514035,Herbst; Matthew,1,0,16,15
1714613529431,MMW 13R,A01,514037,Staff,0,4,16,16
1714613529431,MMW 13R,A02,514039,Staff,0,2,16,16
1714613529431,MMW 13R,A03,628519,Staff,0,2,16,16
1714613531483,SIO 295LS,A00,523233,Staff,10,0,30,20
1714613532512,SIO 295S,A00,523232,Staff,10,0,30,20
1714613533541,SIOC 290S,A01,637330,Merrifield; Mark A,23,0,30,7
1714613534571,SIOC 291S,A01,637333,Gabriel; Corey John,23,0,30,7
1714613535596,SOCI 117,A01,494376,Staff,0,4,5,5
1714613536625,WES 237B,A00,494380,Staff,9,0,20,11
1714613538694,AESE 279B,A00,494370,Wade; Jon P,0,0,33,33
1714613539720,AIP 197,001,627712,Vespa; Emanuel Ignacio,9998,0,9999,1
1714613540748,ANAR 135S,A00,494369,Braswell; Geoffrey E.,0,0,0,0
1714613541775,BENG 196,001,628496,Engler; Adam J.,9998,0,9999,1
1714613542801,CAT 124RS,A01,519847,Geibel; William,0,0,20,20
1714613543828,CAT 125RS,A01,515971,Geibel; William,0,0,20,20
1714613544856,CLRE 250,A00,511389,Morris; Sheldon,9993,0,9999,6
1714613545883,CLRE 251,A00,507176,Mehta; Ravindra L.,9993,0,9999,6
1714613545883,CLRE 251,B00,511410,Mehta; Ravindra L.,9998,0,9999,1
1714613546908,CLRE 252,A00,507189,Cuomo; Raphael Eduardo,9995,0,9999,4
1714613547935,CLRE 253,A00,507199,Vaida; Florin,9994,0,9999,5
1714613547935,CLRE 253,B00,507202,Vaida; Florin,9999,0,9999,0
1714613548961,CLRE 259,A00,507211,Patel; Hemal,9996,0,9999,3
1714613549987,CLRE 260,A00,507221,Cuomo; Raphael Eduardo,9999,0,9999,0
1714613551012,CLRE 297,001,507242,Cuomo; Raphael Eduardo,9999,0,9999,0
1714613552039,COGS 197,001,638244,Voytek; Bradley Thomas,9998,0,9999,1
1714613553063,CSE 191,A00,516875,Minnes Kemp; Mor Mia,9992,0,9999,7
1714613554088,CSE 197,001,637388,Minnes Kemp; Mor Mia,9998,0,9999,1
1714613555115,CSS 201S,A01,494383,Staff,35,0,35,0
1714613556143,CSS 202S,A01,494387,Staff,35,0,35,0
1714613557169,DSC 197,001,628532,Eldridge; Justin Matthew,9996,0,9999,3
1714613558196,EAP 100,A00,516065,Staff,9797,0,9999,202
1714613559221,ECE 45,A01,507414,Staff,33,0,60,27
1714613561280,ECE 111,A01,507420,Staff,15,0,50,35
1714613562306,ECE 197,001,548057,Sievenpiper; Daniel F.,9993,0,9999,6
1714613563332,EDS 115,A00,507243,Choi; Bailey Miyeon,10,0,28,18
1714613564357,EDS 117,A01,494379,Staff,1,5,30,29
1714613565382,EDS 125,A00,507246,Hopkins; Megan Beth,9,0,30,21
1714613566411,EDS 128A,A01,507264,Fargason; Sharon Gayle,8,0,26,18
1714613567439,EDS 128B,A01,507293,Pappas; Elizabeth,12,0,30,18
1714613568465,EDS 139,A00,507294,Fargason; Sharon Gayle,13,0,30,17
1714613568465,EDS 139,B00,507313,Pappas; Elizabeth,13,0,30,17
1714613569490,EDS 201,A00,507315,Staff,13,0,30,17
1714613570522,EDS 203,A01,507317,Halter; Christopher P.,12,0,30,18
1714613571548,EDS 204R,A01,507319,Halter; Christopher P.,0,3,30,30
1714613571548,EDS 204R,B01,507331,Heinzman; Erica M.,16,0,30,14
1714613572573,EDS 206R,A00,507332,Staff,0,4,30,30
1714613572573,EDS 206R,B00,507343,Staff,17,0,30,13
1714613573597,EDS 250,A00,507344,Hemans; Patricia Ann Benitez,22,0,40,18
1714613574625,EDS 281,A00,507345,Daly; Alan J.,18,0,18,0
1714613575650,EDS 284,A00,507350,Daly; Alan J.,16,0,16,0
1714613576680,EDS 286,A00,507359,Fine; Sarah,18,0,18,0
1714613577708,EDS 289C,A01,507361,Daly; Alan J.,18,0,18,0
1714613578733,EDS 290,A00,507366,Hofstetter; Carolyn,15,0,15,0
1714613579764,LIGM 5A,A00,507421,Fischer-Grunski; Eva K,18,0,20,2
1714613580793,LIGM 5B,A00,507423,Fischer-Grunski; Eva K,19,0,20,1
1714613581819,LIGM 5C,A00,507425,Fischer-Grunski; Eva K,19,0,20,1
1714613582849,LIIT 5AS,A00,507427,Carnelos; Chiara,20,0,20,0
1714613583929,LIIT 5BS,A00,507430,Carnelos; Chiara,20,0,20,0
1714613584954,LIIT 5CS,A00,507432,Carnelos; Chiara,20,0,20,0
1714613585982,LISP 5A,A00,507541,Munoz Sanchez; Alicia,11,0,20,9
1714613587007,LISP 5B,A00,507671,Munoz Sanchez; Alicia,8,0,20,12
1714613588031,LISP 5C,A00,507696,Munoz Sanchez; Alicia,9,0,20,11
1714613589056,MAE 197,001,528363,Boechler; Nicholas Sebastia,9998,0,9999,1
1714613590085,MATH 197,001,523477,Kedlaya; Kiran S.,9995,0,9999,4
1714613590085,MATH 197,002,563811,Zhang; Danna,9995,0,9999,4
1714613590085,MATH 197,003,628552,Dumitriu; Ioana,9998,0,9999,1
1714613591112,MCWP 40R,A00,518780,Staff,2,0,20,18
1714613591112,MCWP 40R,B00,518781,Staff,8,0,20,12
1714613591112,MCWP 40R,C00,518783,Staff,6,0,20,14
1714613592143,MCWP 50R,A00,518791,Staff,0,0,20,20
1714613592143,MCWP 50R,B00,518792,Staff,0,2,20,20
1714613592143,MCWP 50R,C00,518793,Staff,0,2,20,20
1714613592143,MCWP 50R,D00,518794,Staff,0,0,20,20
1714613592143,MCWP 50R,E00,518795,Staff,0,2,20,20
1714613592143,MCWP 50R,F00,518796,Staff,0,0,20,20
1714613592143,MCWP 50R,G00,518797,Staff,0,1,20,20
1714613593172,MMW 12R,A01,514034,Herbst; Matthew,0,0,16,16
1714613593172,MMW 12R,A02,514035,Herbst; Matthew,1,0,16,15
1714613594196,MMW 13R,A01,514037,Staff,0,4,16,16
1714613594196,MMW 13R,A02,514039,Staff,0,2,16,16
1714613594196,MMW 13R,A03,628519,Staff,0,2,16,16
1714613596249,SIO 295LS,A00,523233,Staff,10,0,30,20
1714613597273,SIO 295S,A00,523232,Staff,10,0,30,20
1714613598299,SIOC 290S,A01,637330,Merrifield; Mark A,23,0,30,7
1714613599325,SIOC 291S,A01,637333,Gabriel; Corey John,23,0,30,7
1714613600349,SOCI 117,A01,494376,Staff,0,4,5,5
1714613601375,WES 237B,A00,494380,Staff,9,0,20,11
1714613603458,AESE 279B,A00,494370,Wade; Jon P,0,0,33,33
1714613604483,AIP 197,001,627712,Vespa; Emanuel Ignacio,9998,0,9999,1
1714613605513,ANAR 135S,A00,494369,Braswell; Geoffrey E.,0,0,0,0
1714613606538,BENG 196,001,628496,Engler; Adam J.,9998,0,9999,1
1714613607562,CAT 124RS,A01,519847,Geibel; William,0,0,20,20
1714613608588,CAT 125RS,A01,515971,Geibel; William,0,0,20,20
1714613609617,CLRE 250,A00,511389,Morris; Sheldon,9993,0,9999,6
1714613610645,CLRE 251,A00,507176,Mehta; Ravindra L.,9993,0,9999,6
1714613610645,CLRE 251,B00,511410,Mehta; Ravindra L.,9998,0,9999,1
1714613611670,CLRE 252,A00,507189,Cuomo; Raphael Eduardo,9995,0,9999,4
1714613612696,CLRE 253,A00,507199,Vaida; Florin,9994,0,9999,5
1714613612696,CLRE 253,B00,507202,Vaida; Florin,9999,0,9999,0
1714613613726,CLRE 259,A00,507211,Patel; Hemal,9996,0,9999,3
1714613614755,CLRE 260,A00,507221,Cuomo; Raphael Eduardo,9999,0,9999,0
1714613615781,CLRE 297,001,507242,Cuomo; Raphael Eduardo,9999,0,9999,0
1714613616810,COGS 197,001,638244,Voytek; Bradley Thomas,9998,0,9999,1
1714613617835,CSE 191,A00,516875,Minnes Kemp; Mor Mia,9992,0,9999,7
1714613618863,CSE 197,001,637388,Minnes Kemp; Mor Mia,9998,0,9999,1
1714613619889,CSS 201S,A01,494383,Staff,35,0,35,0
1714613620918,CSS 202S,A01,494387,Staff,35,0,35,0
1714613621945,DSC 197,001,628532,Eldridge; Justin Matthew,9996,0,9999,3
1714613622970,EAP 100,A00,516065,Staff,9797,0,9999,202
1714613623995,ECE 45,A01,507414,Staff,33,0,60,27
1714613626049,ECE 111,A01,507420,Staff,15,0,50,35
1714613627078,ECE 197,001,548057,Sievenpiper; Daniel F.,9993,0,9999,6
1714613628104,EDS 115,A00,507243,Choi; Bailey Miyeon,10,0,28,18
1714613629130,EDS 117,A01,494379,Staff,1,5,30,29
1714613630156,EDS 125,A00,507246,Hopkins; Megan Beth,9,0,30,21
1714613631182,EDS 128A,A01,507264,Fargason; Sharon Gayle,8,0,26,18
1714613632209,EDS 128B,A01,507293,Pappas; Elizabeth,12,0,30,18
1714613633234,EDS 139,A00,507294,Fargason; Sharon Gayle,13,0,30,17
1714613633234,EDS 139,B00,507313,Pappas; Elizabeth,13,0,30,17
1714613634261,EDS 201,A00,507315,Staff,13,0,30,17
1714613635290,EDS 203,A01,507317,Halter; Christopher P.,12,0,30,18
1714613636318,EDS 204R,A01,507319,Halter; Christopher P.,0,3,30,30
1714613636318,EDS 204R,B01,507331,Heinzman; Erica M.,16,0,30,14
1714613637344,EDS 206R,A00,507332,Staff,0,4,30,30
1714613637344,EDS 206R,B00,507343,Staff,17,0,30,13
1714613638368,EDS 250,A00,507344,Hemans; Patricia Ann Benitez,22,0,40,18
1714613639394,EDS 281,A00,507345,Daly; Alan J.,18,0,18,0
1714613640420,EDS 284,A00,507350,Daly; Alan J.,16,0,16,0
1714613641449,EDS 286,A00,507359,Fine; Sarah,18,0,18,0
1714613642475,EDS 289C,A01,507361,Daly; Alan J.,18,0,18,0
1714613643500,EDS 290,A00,507366,Hofstetter; Carolyn,15,0,15,0
1714613644530,LIGM 5A,A00,507421,Fischer-Grunski; Eva K,18,0,20,2
1714613645558,LIGM 5B,A00,507423,Fischer-Grunski; Eva K,19,0,20,1
1714613646585,LIGM 5C,A00,507425,Fischer-Grunski; Eva K,19,0,20,1
1714613647609,LIIT 5AS,A00,507427,Carnelos; Chiara,20,0,20,0
1714613648637,LIIT 5BS,A00,507430,Carnelos; Chiara,20,0,20,0
1714613649664,LIIT 5CS,A00,507432,Carnelos; Chiara,20,0,20,0
1714613650694,LISP 5A,A00,507541,Munoz Sanchez; Alicia,11,0,20,9
1714613651720,LISP 5B,A00,507671,Munoz Sanchez; Alicia,8,0,20,12
1714613652748,LISP 5C,A00,507696,Munoz Sanchez; Alicia,9,0,20,11
1714613653777,MAE 197,001,528363,Boechler; Nicholas Sebastia,9998,0,9999,1
1714613654806,MATH 197,001,523477,Kedlaya; Kiran S.,9995,0,9999,4
1714613654806,MATH 197,002,563811,Zhang; Danna,9995,0,9999,4
1714613654806,MATH 197,003,628552,Dumitriu; Ioana,9998,0,9999,1
1714613655831,MCWP 40R,A00,518780,Staff,2,0,20,18
1714613655831,MCWP 40R,B00,518781,Staff,8,0,20,12
1714613655831,MCWP 40R,C00,518783,Staff,6,0,20,14
1714613656855,MCWP 50R,A00,518791,Staff,0,0,20,20
1714613656855,MCWP 50R,B00,518792,Staff,0,2,20,20
1714613656855,MCWP 50R,C00,518793,Staff,0,2,20,20
1714613656855,MCWP 50R,D00,518794,Staff,0,0,20,20
1714613656855,MCWP 50R,E00,518795,Staff,0,2,20,20
1714613656855,MCWP 50R,F00,518796,Staff,0,0,20,20
1714613656855,MCWP 50R,G00,518797,Staff,0,1,20,20
1714613657878,MMW 12R,A01,514034,Herbst; Matthew,0,0,16,16
1714613657878,MMW 12R,A02,514035,Herbst; Matthew,1,0,16,15
1714613658907,MMW 13R,A01,514037,Staff,0,4,16,16
1714613658907,MMW 13R,A02,514039,Staff,0,2,16,16
1714613658907,MMW 13R,A03,628519,Staff,0,2,16,16
1714613660958,SIO 295LS,A00,523233,Staff,10,0,30,20
1714613661982,SIO 295S,A00,523232,Staff,10,0,30,20
1714613663013,SIOC 290S,A01,637330,Merrifield; Mark A,23,0,30,7
1714613664038,SIOC 291S,A01,637333,Gabriel; Corey John,23,0,30,7
1714613665066,SOCI 117,A01,494376,Staff,0,4,5,5
1714613666094,WES 237B,A00,494380,Staff,9,0,20,11
1714613668172,AESE 279B,A00,494370,Wade; Jon P,0,0,33,33
1714613669197,AIP 197,001,627712,Vespa; Emanuel Ignacio,9998,0,9999,1
1714613670221,ANAR 135S,A00,494369,Braswell; Geoffrey E.,0,0,0,0
1714613671246,BENG 196,001,628496,Engler; Adam J.,9998,0,9999,1
1714613672271,CAT 124RS,A01,519847,Geibel; William,0,0,20,20
1714613673301,CAT 125RS,A01,515971,Geibel; William,0,0,20,20
1714613674332,CLRE 250,A00,511389,Morris; Sheldon,9993,0,9999,6
1714613675361,CLRE 251,A00,507176,Mehta; Ravindra L.,9993,0,9999,6
1714613675361,CLRE 251,B00,511410,Mehta; Ravindra L.,9998,0,9999,1
1714613676387,CLRE 252,A00,507189,Cuomo; Raphael Eduardo,9995,0,9999,4
1714613677411,CLRE 253,A00,507199,Vaida; Florin,9994,0,9999,5
1714613677411,CLRE 253,B00,507202,Vaida; Florin,9999,0,9999,0
1714613678437,CLRE 259,A00,507211,Patel; Hemal,9996,0,9999,3
1714613679463,CLRE 260,A00,507221,Cuomo; Raphael Eduardo,9999,0,9999,0
1714613680488,CLRE 297,001,507242,Cuomo; Raphael Eduardo,9999,0,9999,0
1714613681517,COGS 197,001,638244,Voytek; Bradley Thomas,9998,0,9999,1
1714613682543,CSE 191,A00,516875,Minnes Kemp; Mor Mia,9992,0,9999,7
1714613683573,CSE 197,001,637388,Minnes Kemp; Mor Mia,9998,0,9999,1
1714613684598,CSS 201S,A01,494383,Staff,35,0,35,0
1714613685624,CSS 202S,A01,494387,Staff,35,0,35,0
1714613686648,DSC 197,001,628532,Eldridge; Justin Matthew,9996,0,9999,3
1714613687730,EAP 100,A00,516065,Staff,9797,0,9999,202
1714613688758,ECE 45,A01,507414,Staff,33,0,60,27
1714613690814,ECE 111,A01,507420,Staff,15,0,50,35
1714613691842,ECE 197,001,548057,Sievenpiper; Daniel F.,9993,0,9999,6
1714613692867,EDS 115,A00,507243,Choi; Bailey Miyeon,10,0,28,18
1714613693905,EDS 117,A01,494379,Staff,1,5,30,29
1714613694930,EDS 125,A00,507246,Hopkins; Megan Beth,9,0,30,21
1714613695960,EDS 128A,A01,507264,Fargason; Sharon Gayle,8,0,26,18
1714613696985,EDS 128B,A01,507293,Pappas; Elizabeth,12,0,30,18
1714613698011,EDS 139,A00,507294,Fargason; Sharon Gayle,13,0,30,17
1714613698011,EDS 139,B00,507313,Pappas; Elizabeth,13,0,30,17
1714613699038,EDS 201,A00,507315,Staff,13,0,30,17
1714613700063,EDS 203,A01,507317,Halter; Christopher P.,12,0,30,18
1714613701090,EDS 204R,A01,507319,Halter; Christopher P.,0,3,30,30
1714613701090,EDS 204R,B01,507331,Heinzman; Erica M.,16,0,30,14
1714613702119,EDS 206R,A00,507332,Staff,0,4,30,30
1714613702119,EDS 206R,B00,507343,Staff,17,0,30,13
1714613703147,EDS 250,A00,507344,Hemans; Patricia Ann Benitez,22,0,40,18
1714613704173,EDS 281,A00,507345,Daly; Alan J.,18,0,18,0
1714613705199,EDS 284,A00,507350,Daly; Alan J.,16,0,16,0
1714613706224,EDS 286,A00,507359,Fine; Sarah,18,0,18,0
1714613707252,EDS 289C,A01,507361,Daly; Alan J.,18,0,18,0
1714613708277,EDS 290,A00,507366,Hofstetter; Carolyn,15,0,15,0
1714613709306,LIGM 5A,A00,507421,Fischer-Grunski; Eva K,18,0,20,2
1714613710331,LIGM 5B,A00,507423,Fischer-Grunski; Eva K,19,0,20,1
1714613711361,LIGM 5C,A00,507425,Fischer-Grunski; Eva K,19,0,20,1
1714613712387,LIIT 5AS,A00,507427,Carnelos; Chiara,20,0,20,0
1714613713412,LIIT 5BS,A00,507430,Carnelos; Chiara,20,0,20,0
1714613714436,LIIT 5CS,A00,507432,Carnelos; Chiara,20,0,20,0
1714613715461,LISP 5A,A00,507541,Munoz Sanchez; Alicia,11,0,20,9
1714613716486,LISP 5B,A00,507671,Munoz Sanchez; Alicia,8,0,20,12
1714613717512,LISP 5C,A00,507696,Munoz Sanchez; Alicia,9,0,20,11
1714613718538,MAE 197,001,528363,Boechler; Nicholas Sebastia,9998,0,9999,1
1714613719567,MATH 197,001,523477,Kedlaya; Kiran S.,9995,0,9999,4
1714613719567,MATH 197,002,563811,Zhang; Danna,9995,0,9999,4
1714613719567,MATH 197,003,628552,Dumitriu; Ioana,9998,0,9999,1
1714613720592,MCWP 40R,A00,518780,Staff,2,0,20,18
1714613720592,MCWP 40R,B00,518781,Staff,8,0,20,12
1714613720592,MCWP 40R,C00,518783,Staff,6,0,20,14
1714613721618,MCWP 50R,A00,518791,Staff,0,0,20,20
1714613721618,MCWP 50R,B00,518792,Staff,0,2,20,20
1714613721618,MCWP 50R,C00,518793,Staff,0,2,20,20
1714613721618,MCWP 50R,D00,518794,Staff,0,0,20,20
1714613721618,MCWP 50R,E00,518795,Staff,0,2,20,20
1714613721618,MCWP 50R,F00,518796,Staff,0,0,20,20
1714613721618,MCWP 50R,G00,518797,Staff,0,1,20,20
1714613722645,MMW 12R,A01,514034,Herbst; Matthew,0,0,16,16
1714613722645,MMW 12R,A02,514035,Herbst; Matthew,1,0,16,15
1714613723669,MMW 13R,A01,514037,Staff,0,4,16,16
1714613723669,MMW 13R,A02,514039,Staff,0,2,16,16
1714613723669,MMW 13R,A03,628519,Staff,0,2,16,16
1714613725719,SIO 295LS,A00,523233,Staff,10,0,30,20
1714613726748,SIO 295S,A00,523232,Staff,10,0,30,20
1714613727776,SIOC 290S,A01,637330,Merrifield; Mark A,23,0,30,7
1714613728805,SIOC 291S,A01,637333,Gabriel; Corey John,23,0,30,7
1714613729831,SOCI 117,A01,494376,Staff,0,4,5,5
1714613730855,WES 237B,A00,494380,Staff,9,0,20,11
1714613732934,AESE 279B,A00,494370,Wade; Jon P,0,0,33,33
1714613733959,AIP 197,001,627712,Vespa; Emanuel Ignacio,9998,0,9999,1
1714613734987,ANAR 135S,A00,494369,Braswell; Geoffrey E.,0,0,0,0
1714613736015,BENG 196,001,628496,Engler; Adam J.,9998,0,9999,1
1714613737042,CAT 124RS,A01,519847,Geibel; William,0,0,20,20
1714613738066,CAT 125RS,A01,515971,Geibel; William,0,0,20,20
1714613739092,CLRE 250,A00,511389,Morris; Sheldon,9993,0,9999,6
1714613740119,CLRE 251,A00,507176,Mehta; Ravindra L.,9993,0,9999,6
1714613740119,CLRE 251,B00,511410,Mehta; Ravindra L.,9998,0,9999,1
1714613741149,CLRE 252,A00,507189,Cuomo; Raphael Eduardo,9995,0,9999,4
1714613742178,CLRE 253,A00,507199,Vaida; Florin,9994,0,9999,5
1714613742178,CLRE 253,B00,507202,Vaida; Florin,9999,0,9999,0
1714613743208,CLRE 259,A00,507211,Patel; Hemal,9996,0,9999,3
1714613744234,CLRE 260,A00,507221,Cuomo; Raphael Eduardo,9999,0,9999,0
1714613745259,CLRE 297,001,507242,Cuomo; Raphael Eduardo,9999,0,9999,0
1714613746285,COGS 197,001,638244,Voytek; Bradley Thomas,9998,0,9999,1
1714613747312,CSE 191,A00,516875,Minnes Kemp; Mor Mia,9992,0,9999,7
1714613748339,CSE 197,001,637388,Minnes Kemp; Mor Mia,9998,0,9999,1
1714613749371,CSS 201S,A01,494383,Staff,35,0,35,0
1714613750401,CSS 202S,A01,494387,Staff,35,0,35,0
1714613751426,DSC 197,001,628532,Eldridge; Justin Matthew,9996,0,9999,3
1714613752451,EAP 100,A00,516065,Staff,9797,0,9999,202
1714613753479,ECE 45,A01,507414,Staff,33,0,60,27
1714613755532,ECE 111,A01,507420,Staff,15,0,50,35
1714613756562,ECE 197,001,548057,Sievenpiper; Daniel F.,9993,0,9999,6
1714613757591,EDS 115,A00,507243,Choi; Bailey Miyeon,10,0,28,18
1714613758621,EDS 117,A01,494379,Staff,1,5,30,29
1714613759646,EDS 125,A00,507246,Hopkins; Megan Beth,9,0,30,21
1714613760672,EDS 128A,A01,507264,Fargason; Sharon Gayle,8,0,26,18
1714613761700,EDS 128B,A01,507293,Pappas; Elizabeth,12,0,30,18
1714613762727,EDS 139,A00,507294,Fargason; Sharon Gayle,13,0,30,17
1714613762727,EDS 139,B00,507313,Pappas; Elizabeth,13,0,30,17
1714613763755,EDS 201,A00,507315,Staff,13,0,30,17
1714613764783,EDS 203,A01,507317,Halter; Christopher P.,12,0,30,18
1714613765812,EDS 204R,A01,507319,Halter; Christopher P.,0,3,30,30
1714613765812,EDS 204R,B01,507331,Heinzman; Erica M.,16,0,30,14
1714613766840,EDS 206R,A00,507332,Staff,0,4,30,30
1714613766840,EDS 206R,B00,507343,Staff,17,0,30,13
1714613767864,EDS 250,A00,507344,Hemans; Patricia Ann Benitez,22,0,40,18
1714613768892,EDS 281,A00,507345,Daly; Alan J.,18,0,18,0
1714613769918,EDS 284,A00,507350,Daly; Alan J.,16,0,16,0
1714613770943,EDS 286,A00,507359,Fine; Sarah,18,0,18,0
1714613771972,EDS 289C,A01,507361,Daly; Alan J.,18,0,18,0
1714613772998,EDS 290,A00,507366,Hofstetter; Carolyn,15,0,15,0
1714613774023,LIGM 5A,A00,507421,Fischer-Grunski; Eva K,18,0,20,2
1714613775047,LIGM 5B,A00,507423,Fischer-Grunski; Eva K,19,0,20,1
1714613776076,LIGM 5C,A00,507425,Fischer-Grunski; Eva K,19,0,20,1
1714613777106,LIIT 5AS,A00,507427,Carnelos; Chiara,20,0,20,0
1714613778130,LIIT 5BS,A00,507430,Carnelos; Chiara,20,0,20,0
1714613779155,LIIT 5CS,A00,507432,Carnelos; Chiara,20,0,20,0
1714613780185,LISP 5A,A00,507541,Munoz Sanchez; Alicia,11,0,20,9
1714613781212,LISP 5B,A00,507671,Munoz Sanchez; Alicia,8,0,20,12
1714613782241,LISP 5C,A00,507696,Munoz Sanchez; Alicia,9,0,20,11
1714613783267,MAE 197,001,528363,Boechler; Nicholas Sebastia,9998,0,9999,1
1714613784298,MATH 197,001,523477,Kedlaya; Kiran S.,9995,0,9999,4
1714613784298,MATH 197,002,563811,Zhang; Danna,9995,0,9999,4
1714613784298,MATH 197,003,628552,Dumitriu; Ioana,9998,0,9999,1
1714613785323,MCWP 40R,A00,518780,Staff,2,0,20,18
1714613785323,MCWP 40R,B00,518781,Staff,8,0,20,12
1714613785323,MCWP 40R,C00,518783,Staff,6,0,20,14
1714613786350,MCWP 50R,A00,518791,Staff,0,0,20,20
1714613786350,MCWP 50R,B00,518792,Staff,0,2,20,20
1714613786350,MCWP 50R,C00,518793,Staff,0,2,20,20
1714613786350,MCWP 50R,D00,518794,Staff,0,0,20,20
1714613786350,MCWP 50R,E00,518795,Staff,0,2,20,20
1714613786350,MCWP 50R,F00,518796,Staff,0,0,20,20
1714613786350,MCWP 50R,G00,518797,Staff,0,1,20,20
1714613787379,MMW 12R,A01,514034,Herbst; Matthew,0,0,16,16
1714613787379,MMW 12R,A02,514035,Herbst; Matthew,1,0,16,15
1714613788406,MMW 13R,A01,514037,Staff,0,4,16,16
1714613788406,MMW 13R,A02,514039,Staff,0,2,16,16
1714613788406,MMW 13R,A03,628519,Staff,0,2,16,16
1714613790458,SIO 295LS,A00,523233,Staff,10,0,30,20
1714613791539,SIO 295S,A00,523232,Staff,10,0,30,20
1714613792566,SIOC 290S,A01,637330,Merrifield; Mark A,23,0,30,7
1714613793592,SIOC 291S,A01,637333,Gabriel; Corey John,23,0,30,7
1714613794621,SOCI 117,A01,494376,Staff,0,4,5,5
1714613795647,WES 237B,A00,494380,Staff,9,0,20,11
1714613797732,AESE 279B,A00,494370,Wade; Jon P,0,0,33,33
1714613798757,AIP 197,001,627712,Vespa; Emanuel Ignacio,9998,0,9999,1
1714613799782,ANAR 135S,A00,494369,Braswell; Geoffrey E.,0,0,0,0
1714613800807,BENG 196,001,628496,Engler; Adam J.,9998,0,9999,1
1714613801836,CAT 124RS,A01,519847,Geibel; William,0,0,20,20
1714613802862,CAT 125RS,A01,515971,Geibel; William,0,0,20,20
1714613803888,CLRE 250,A00,511389,Morris; Sheldon,9993,0,9999,6
1714613804918,CLRE 251,A00,507176,Mehta; Ravindra L.,9993,0,9999,6
1714613804918,CLRE 251,B00,511410,Mehta; Ravindra L.,9998,0,9999,1
1714613805947,CLRE 252,A00,507189,Cuomo; Raphael Eduardo,9995,0,9999,4
1714613806976,CLRE 253,A00,507199,Vaida; Florin,9994,0,9999,5
1714613806976,CLRE 253,B00,507202,Vaida; Florin,9999,0,9999,0
1714613808002,CLRE 259,A00,507211,Patel; Hemal,9996,0,9999,3
1714613809027,CLRE 260,A00,507221,Cuomo; Raphael Eduardo,9999,0,9999,0
1714613810050,CLRE 297,001,507242,Cuomo; Raphael Eduardo,9999,0,9999,0
1714613811078,COGS 197,001,638244,Voytek; Bradley Thomas,9998,0,9999,1
1714613812105,CSE 191,A00,516875,Minnes Kemp; Mor Mia,9992,0,9999,7
1714613813131,CSE 197,001,637388,Minnes Kemp; Mor Mia,9998,0,9999,1
1714613814156,CSS 201S,A01,494383,Staff,35,0,35,0
1714613815182,CSS 202S,A01,494387,Staff,35,0,35,0
1714613816209,DSC 197,001,628532,Eldridge; Justin Matthew,9996,0,9999,3
1714613817233,EAP 100,A00,516065,Staff,9797,0,9999,202
1714613818263,ECE 45,A01,507414,Staff,33,0,60,27
1714613820322,ECE 111,A01,507420,Staff,15,0,50,35
1714613821349,ECE 197,001,548057,Sievenpiper; Daniel F.,9993,0,9999,6
1714613822378,EDS 115,A00,507243,Choi; Bailey Miyeon,10,0,28,18
1714613823404,EDS 117,A01,494379,Staff,1,5,30,29
1714613824433,EDS 125,A00,507246,Hopkins; Megan Beth,9,0,30,21
1714613825458,EDS 128A,A01,507264,Fargason; Sharon Gayle,8,0,26,18
1714613826483,EDS 128B,A01,507293,Pappas; Elizabeth,12,0,30,18
1714613827508,EDS 139,A00,507294,Fargason; Sharon Gayle,13,0,30,17
1714613827508,EDS 139,B00,507313,Pappas; Elizabeth,13,0,30,17
1714613828534,EDS 201,A00,507315,Staff,13,0,30,17
1714613829561,EDS 203,A01,507317,Halter; Christopher P.,12,0,30,18
1714613830589,EDS 204R,A01,507319,Halter; Christopher P.,0,3,30,30
1714613830589,EDS 204R,B01,507331,Heinzman; Erica M.,16,0,30,14
1714613831614,EDS 206R,A00,507332,Staff,0,4,30,30
1714613831614,EDS 206R,B00,507343,Staff,17,0,30,13
1714613832642,EDS 250,A00,507344,Hemans; Patricia Ann Benitez,22,0,40,18
1714613833666,EDS 281,A00,507345,Daly; Alan J.,18,0,18,0
1714613834691,EDS 284,A00,507350,Daly; Alan J.,16,0,16,0
1714613835716,EDS 286,A00,507359,Fine; Sarah,18,0,18,0
1714613836741,EDS 289C,A01,507361,Daly; Alan J.,18,0,18,0
1714613837768,EDS 290,A00,507366,Hofstetter; Carolyn,15,0,15,0
1714613838794,LIGM 5A,A00,507421,Fischer-Grunski; Eva K,18,0,20,2
1714613839820,LIGM 5B,A00,507423,Fischer-Grunski; Eva K,19,0,20,1
1714613840844,LIGM 5C,A00,507425,Fischer-Grunski; Eva K,19,0,20,1
1714613841873,LIIT 5AS,A00,507427,Carnelos; Chiara,20,0,20,0
1714613842898,LIIT 5BS,A00,507430,Carnelos; Chiara,20,0,20,0
1714613843927,LIIT 5CS,A00,507432,Carnelos; Chiara,20,0,20,0
1714613844960,LISP 5A,A00,507541,Munoz Sanchez; Alicia,11,0,20,9
1714613845991,LISP 5B,A00,507671,Munoz Sanchez; Alicia,8,0,20,12
1714613847021,LISP 5C,A00,507696,Munoz Sanchez; Alicia,9,0,20,11
1714613848047,MAE 197,001,528363,Boechler; Nicholas Sebastia,9998,0,9999,1
1714613849073,MATH 197,001,523477,Kedlaya; Kiran S.,9995,0,9999,4
1714613849073,MATH 197,002,563811,Zhang; Danna,9995,0,9999,4
1714613849073,MATH 197,003,628552,Dumitriu; Ioana,9998,0,9999,1
1714613850101,MCWP 40R,A00,518780,Staff,2,0,20,18
1714613850101,MCWP 40R,B00,518781,Staff,8,0,20,12
1714613850101,MCWP 40R,C00,518783,Staff,6,0,20,14
1714613851127,MCWP 50R,A00,518791,Staff,0,0,20,20
1714613851127,MCWP 50R,B00,518792,Staff,0,2,20,20
1714613851127,MCWP 50R,C00,518793,Staff,0,2,20,20
1714613851127,MCWP 50R,D00,518794,Staff,0,0,20,20
1714613851127,MCWP 50R,E00,518795,Staff,0,2,20,20
1714613851127,MCWP 50R,F00,518796,Staff,0,0,20,20
1714613851127,MCWP 50R,G00,518797,Staff,0,1,20,20
1714613852153,MMW 12R,A01,514034,Herbst; Matthew,0,0,16,16
1714613852153,MMW 12R,A02,514035,Herbst; Matthew,1,0,16,15
1714613853182,MMW 13R,A01,514037,Staff,0,4,16,16
1714613853182,MMW 13R,A02,514039,Staff,0,2,16,16
1714613853182,MMW 13R,A03,628519,Staff,0,2,16,16
1714613855234,SIO 295LS,A00,523233,Staff,10,0,30,20
1714613856259,SIO 295S,A00,523232,Staff,10,0,30,20
1714613857291,SIOC 290S,A01,637330,Merrifield; Mark A,23,0,30,7
1714613858320,SIOC 291S,A01,637333,Gabriel; Corey John,23,0,30,7
1714613859349,SOCI 117,A01,494376,Staff,0,4,5,5
1714613860377,WES 237B,A00,494380,Staff,9,0,20,11
1714613862453,AESE 279B,A00,494370,Wade; Jon P,0,0,33,33
1714613863482,AIP 197,001,627712,Vespa; Emanuel Ignacio,9998,0,9999,1
1714613864508,ANAR 135S,A00,494369,Braswell; Geoffrey E.,0,0,0,0
1714613865534,BENG 196,001,628496,Engler; Adam J.,9998,0,9999,1
1714613866559,CAT 124RS,A01,519847,Geibel; William,0,0,20,20
1714613867586,CAT 125RS,A01,515971,Geibel; William,0,0,20,20
1714613868614,CLRE 250,A00,511389,Morris; Sheldon,9993,0,9999,6
1714613869645,CLRE 251,A00,507176,Mehta; Ravindra L.,9993,0,9999,6
1714613869645,CLRE 251,B00,511410,Mehta; Ravindra L.,9998,0,9999,1
1714613870697,CLRE 252,A00,507189,Cuomo; Raphael Eduardo,9995,0,9999,4
1714613871726,CLRE 253,A00,507199,Vaida; Florin,9994,0,9999,5
1714613871726,CLRE 253,B00,507202,Vaida; Florin,9999,0,9999,0
1714613872754,CLRE 259,A00,507211,Patel; Hemal,9996,0,9999,3
1714613873778,CLRE 260,A00,507221,Cuomo; Raphael Eduardo,9999,0,9999,0
1714613874803,CLRE 297,001,507242,Cuomo; Raphael Eduardo,9999,0,9999,0
1714613875834,COGS 197,001,638244,Voytek; Bradley Thomas,9998,0,9999,1
1714613876861,CSE 191,A00,516875,Minnes Kemp; Mor Mia,9992,0,9999,7
1714613877887,CSE 197,001,637388,Minnes Kemp; Mor Mia,9998,0,9999,1
1714613878913,CSS 201S,A01,494383,Staff,35,0,35,0
1714613879939,CSS 202S,A01,494387,Staff,35,0,35,0
1714613880965,DSC 197,001,628532,Eldridge; Justin Matthew,9996,0,9999,3
1714613881999,EAP 100,A00,516065,Staff,9797,0,9999,202
1714613883024,ECE 45,A01,507414,Staff,33,0,60,27
1714613885073,ECE 111,A01,507420,Staff,15,0,50,35
1714613886097,ECE 197,001,548057,Sievenpiper; Daniel F.,9993,0,9999,6
1714613887129,EDS 115,A00,507243,Choi; Bailey Miyeon,10,0,28,18
1714613888157,EDS 117,A01,494379,Staff,1,5,30,29
1714613889183,EDS 125,A00,507246,Hopkins; Megan Beth,9,0,30,21
1714613890209,EDS 128A,A01,507264,Fargason; Sharon Gayle,8,0,26,18
1714613891233,EDS 128B,A01,507293,Pappas; Elizabeth,12,0,30,18
1714613892263,EDS 139,A00,507294,Fargason; Sharon Gayle,13,0,30,17
1714613892263,EDS 139,B00,507313,Pappas; Elizabeth,13,0,30,17
1714613893288,EDS 201,A00,507315,Staff,13,0,30,17
1714613894316,EDS 203,A01,507317,Halter; Christopher P.,12,0,30,18
1714613895405,EDS 204R,A01,507319,Halter; Christopher P.,0,3,30,30
1714613895405,EDS 204R,B01,507331,Heinzman; Erica M.,16,0,30,14
1714613896433,EDS 206R,A00,507332,Staff,0,4,30,30
1714613896433,EDS 206R,B00,507343,Staff,17,0,30,13
1714613897462,EDS 250,A00,507344,Hemans; Patricia Ann Benitez,22,0,40,18
1714613898487,EDS 281,A00,507345,Daly; Alan J.,18,0,18,0
1714613899517,EDS 284,A00,507350,Daly; Alan J.,16,0,16,0
1714613900543,EDS 286,A00,507359,Fine; Sarah,18,0,18,0
1714613901570,EDS 289C,A01,507361,Daly; Alan J.,18,0,18,0
1714613902598,EDS 290,A00,507366,Hofstetter; Carolyn,15,0,15,0
1714613903625,LIGM 5A,A00,507421,Fischer-Grunski; Eva K,18,0,20,2
1714613904650,LIGM 5B,A00,507423,Fischer-Grunski; Eva K,19,0,20,1
1714613905674,LIGM 5C,A00,507425,Fischer-Grunski; Eva K,19,0,20,1
1714613906704,LIIT 5AS,A00,507427,Carnelos; Chiara,20,0,20,0
1714613907731,LIIT 5BS,A00,507430,Carnelos; Chiara,20,0,20,0
1714613908756,LIIT 5CS,A00,507432,Carnelos; Chiara,20,0,20,0
1714613909781,LISP 5A,A00,507541,Munoz Sanchez; Alicia,11,0,20,9
1714613910810,LISP 5B,A00,507671,Munoz Sanchez; Alicia,8,0,20,12
1714613911839,LISP 5C,A00,507696,Munoz Sanchez; Alicia,9,0,20,11
1714613912863,MAE 197,001,528363,Boechler; Nicholas Sebastia,9998,0,9999,1
1714613913892,MATH 197,001,523477,Kedlaya; Kiran S.,9995,0,9999,4
1714613913892,MATH 197,002,563811,Zhang; Danna,9995,0,9999,4
1714613913892,MATH 197,003,628552,Dumitriu; Ioana,9998,0,9999,1
1714613914918,MCWP 40R,A00,518780,Staff,2,0,20,18
1714613914918,MCWP 40R,B00,518781,Staff,8,0,20,12
1714613914918,MCWP 40R,C00,518783,Staff,6,0,20,14
1714613915948,MCWP 50R,A00,518791,Staff,0,0,20,20
1714613915948,MCWP 50R,B00,518792,Staff,0,2,20,20
1714613915948,MCWP 50R,C00,518793,Staff,0,2,20,20
1714613915948,MCWP 50R,D00,518794,Staff,0,0,20,20
1714613915948,MCWP 50R,E00,518795,Staff,0,2,20,20
1714613915948,MCWP 50R,F00,518796,Staff,0,0,20,20
1714613915948,MCWP 50R,G00,518797,Staff,0,1,20,20
1714613916977,MMW 12R,A01,514034,Herbst; Matthew,0,0,16,16
1714613916977,MMW 12R,A02,514035,Herbst; Matthew,1,0,16,15
1714613918003,MMW 13R,A01,514037,Staff,0,4,16,16
1714613918003,MMW 13R,A02,514039,Staff,0,2,16,16
1714613918003,MMW 13R,A03,628519,Staff,0,2,16,16
1714613920055,SIO 295LS,A00,523233,Staff,10,0,30,20
1714613921082,SIO 295S,A00,523232,Staff,10,0,30,20
1714613922115,SIOC 290S,A01,637330,Merrifield; Mark A,23,0,30,7
1714613923142,SIOC 291S,A01,637333,Gabriel; Corey John,23,0,30,7
1714613924167,SOCI 117,A01,494376,Staff,0,4,5,5
1714613925193,WES 237B,A00,494380,Staff,9,0,20,11
1714613927257,AESE 279B,A00,494370,Wade; Jon P,0,0,33,33
1714613928283,AIP 197,001,627712,Vespa; Emanuel Ignacio,9998,0,9999,1
1714613929309,ANAR 135S,A00,494369,Braswell; Geoffrey E.,0,0,0,0
1714613930334,BENG 196,001,628496,Engler; Adam J.,9998,0,9999,1
1714613931363,CAT 124RS,A01,519847,Geibel; William,0,0,20,20
1714613932390,CAT 125RS,A01,515971,Geibel; William,0,0,20,20
1714613933418,CLRE 250,A00,511389,Morris; Sheldon,9993,0,9999,6
1714613934444,CLRE 251,A00,507176,Mehta; Ravindra L.,9993,0,9999,6
1714613934444,CLRE 251,B00,511410,Mehta; Ravindra L.,9998,0,9999,1
1714613935469,CLRE 252,A00,507189,Cuomo; Raphael Eduardo,9995,0,9999,4
1714613936497,CLRE 253,A00,507199,Vaida; Florin,9994,0,9999,5
1714613936497,CLRE 253,B00,507202,Vaida; Florin,9999,0,9999,0
1714613937523,CLRE 259,A00,507211,Patel; Hemal,9996,0,9999,3
1714613938548,CLRE 260,A00,507221,Cuomo; Raphael Eduardo,9999,0,9999,0
1714613939573,CLRE 297,001,507242,Cuomo; Raphael Eduardo,9999,0,9999,0
1714613940599,COGS 197,001,638244,Voytek; Bradley Thomas,9998,0,9999,1
1714613941626,CSE 191,A00,516875,Minnes Kemp; Mor Mia,9992,0,9999,7
1714613942651,CSE 197,001,637388,Minnes Kemp; Mor Mia,9998,0,9999,1
1714613943679,CSS 201S,A01,494383,Staff,35,0,35,0
1714613944707,CSS 202S,A01,494387,Staff,35,0,35,0
1714613945735,DSC 197,001,628532,Eldridge; Justin Matthew,9996,0,9999,3
1714613946759,EAP 100,A00,516065,Staff,9797,0,9999,202
1714613947783,ECE 45,A01,507414,Staff,33,0,60,27
1714613949834,ECE 111,A01,507420,Staff,15,0,50,35
1714613950860,ECE 197,001,548057,Sievenpiper; Daniel F.,9993,0,9999,6
1714613951886,EDS 115,A00,507243,Choi; Bailey Miyeon,10,0,28,18
1714613952914,EDS 117,A01,494379,Staff,1,5,30,29
1714613953939,EDS 125,A00,507246,Hopkins; Megan Beth,9,0,30,21
1714613954969,EDS 128A,A01,507264,Fargason; Sharon Gayle,8,0,26,18
1714613955994,EDS 128B,A01,507293,Pappas; Elizabeth,12,0,30,18
1714613957023,EDS 139,A00,507294,Fargason; Sharon Gayle,13,0,30,17
1714613957023,EDS 139,B00,507313,Pappas; Elizabeth,13,0,30,17
1714613958051,EDS 201,A00,507315,Staff,13,0,30,17
1714613959078,EDS 203,A01,507317,Halter; Christopher P.,12,0,30,18
1714613960104,EDS 204R,A01,507319,Halter; Christopher P.,0,3,30,30
1714613960104,EDS 204R,B01,507331,Heinzman; Erica M.,16,0,30,14
1714613961130,EDS 206R,A00,507332,Staff,0,4,30,30
1714613961130,EDS 206R,B00,507343,Staff,17,0,30,13
1714613962155,EDS 250,A00,507344,Hemans; Patricia Ann Benitez,22,0,40,18
1714613963185,EDS 281,A00,507345,Daly; Alan J.,18,0,18,0
1714613964263,EDS 284,A00,507350,Daly; Alan J.,16,0,16,0
1714613965291,EDS 286,A00,507359,Fine; Sarah,18,0,18,0
1714613966316,EDS 289C,A01,507361,Daly; Alan J.,18,0,18,0
1714613967344,EDS 290,A00,507366,Hofstetter; Carolyn,15,0,15,0
1714613968371,LIGM 5A,A00,507421,Fischer-Grunski; Eva K,18,0,20,2
1714613969399,LIGM 5B,A00,507423,Fischer-Grunski; Eva K,19,0,20,1
1714613970423,LIGM 5C,A00,507425,Fischer-Grunski; Eva K,19,0,20,1
1714613971451,LIIT 5AS,A00,507427,Carnelos; Chiara,20,0,20,0
1714613972476,LIIT 5BS,A00,507430,Carnelos; Chiara,20,0,20,0
1714613973500,LIIT 5CS,A00,507432,Carnelos; Chiara,20,0,20,0
1714613974525,LISP 5A,A00,507541,Munoz Sanchez; Alicia,11,0,20,9
1714613975554,LISP 5B,A00,507671,Munoz Sanchez; Alicia,8,0,20,12
1714613976579,LISP 5C,A00,507696,Munoz Sanchez; Alicia,9,0,20,11
1714613977604,MAE 197,001,528363,Boechler; Nicholas Sebastia,9998,0,9999,1
1714613978630,MATH 197,001,523477,Kedlaya; Kiran S.,9995,0,9999,4
1714613978630,MATH 197,002,563811,Zhang; Danna,9995,0,9999,4
1714613978630,MATH 197,003,628552,Dumitriu; Ioana,9998,0,9999,1
1714613979658,MCWP 40R,A00,518780,Staff,2,0,20,18
1714613979658,MCWP 40R,B00,518781,Staff,8,0,20,12
1714613979658,MCWP 40R,C00,518783,Staff,6,0,20,14
1714613980682,MCWP 50R,A00,518791,Staff,0,0,20,20
1714613980682,MCWP 50R,B00,518792,Staff,0,2,20,20
1714613980682,MCWP 50R,C00,518793,Staff,0,2,20,20
1714613980682,MCWP 50R,D00,518794,Staff,0,0,20,20
1714613980682,MCWP 50R,E00,518795,Staff,0,2,20,20
1714613980682,MCWP 50R,F00,518796,Staff,0,0,20,20
1714613980682,MCWP 50R,G00,518797,Staff,0,1,20,20
1714613981708,MMW 12R,A01,514034,Herbst; Matthew,0,0,16,16
1714613981708,MMW 12R,A02,514035,Herbst; Matthew,1,0,16,15
1714613982736,MMW 13R,A01,514037,Staff,0,4,16,16
1714613982736,MMW 13R,A02,514039,Staff,0,2,16,16
1714613982736,MMW 13R,A03,628519,Staff,0,2,16,16
1714613984792,SIO 295LS,A00,523233,Staff,10,0,30,20
1714613985819,SIO 295S,A00,523232,Staff,10,0,30,20
1714613986848,SIOC 290S,A01,637330,Merrifield; Mark A,23,0,30,7
1714613987879,SIOC 291S,A01,637333,Gabriel; Corey John,23,0,30,7
1714613988907,SOCI 117,A01,494376,Staff,0,4,5,5
1714613989933,WES 237B,A00,494380,Staff,9,0,20,11
1714613992006,AESE 279B,A00,494370,Wade; Jon P,0,0,33,33
1714613993032,AIP 197,001,627712,Vespa; Emanuel Ignacio,9998,0,9999,1
1714613994059,ANAR 135S,A00,494369,Braswell; Geoffrey E.,0,0,0,0
1714613995086,BENG 196,001,628496,Engler; Adam J.,9998,0,9999,1
1714613996111,CAT 124RS,A01,519847,Geibel; William,0,0,20,20
1714613997139,CAT 125RS,A01,515971,Geibel; William,0,0,20,20
1714613998164,CLRE 250,A00,511389,Morris; Sheldon,9993,0,9999,6
1714613999190,CLRE 251,A00,507176,Mehta; Ravindra L.,9993,0,9999,6
1714613999190,CLRE 251,B00,511410,Mehta; Ravindra L.,9998,0,9999,1
1714614000218,CLRE 252,A00,507189,Cuomo; Raphael Eduardo,9995,0,9999,4
1714614001242,CLRE 253,A00,507199,Vaida; Florin,9994,0,9999,5
1714614001242,CLRE 253,B00,507202,Vaida; Florin,9999,0,9999,0
1714614002268,CLRE 259,A00,507211,Patel; Hemal,9996,0,9999,3
1714614003294,CLRE 260,A00,507221,Cuomo; Raphael Eduardo,9999,0,9999,0
1714614004317,CLRE 297,001,507242,Cuomo; Raphael Eduardo,9999,0,9999,0
1714614005348,COGS 197,001,638244,Voytek; Bradley Thomas,9998,0,9999,1
1714614006374,CSE 191,A00,516875,Minnes Kemp; Mor Mia,9992,0,9999,7
1714614007399,CSE 197,001,637388,Minnes Kemp; Mor Mia,9998,0,9999,1
1714614008428,CSS 201S,A01,494383,Staff,35,0,35,0
1714614009453,CSS 202S,A01,494387,Staff,35,0,35,0
1714614010480,DSC 197,001,628532,Eldridge; Justin Matthew,9996,0,9999,3
1714614011505,EAP 100,A00,516065,Staff,9797,0,9999,202
1714614012536,ECE 45,A01,507414,Staff,33,0,60,27
1714614014585,ECE 111,A01,507420,Staff,15,0,50,35
1714614015613,ECE 197,001,548057,Sievenpiper; Daniel F.,9993,0,9999,6
1714614016637,EDS 115,A00,507243,Choi; Bailey Miyeon,10,0,28,18
1714614017662,EDS 117,A01,494379,Staff,1,5,30,29
1714614018690,EDS 125,A00,507246,Hopkins; Megan Beth,9,0,30,21
1714614019717,EDS 128A,A01,507264,Fargason; Sharon Gayle,8,0,26,18
1714614020746,EDS 128B,A01,507293,Pappas; Elizabeth,12,0,30,18
1714614021773,EDS 139,A00,507294,Fargason; Sharon Gayle,13,0,30,17
1714614021773,EDS 139,B00,507313,Pappas; Elizabeth,13,0,30,17
1714614022800,EDS 201,A00,507315,Staff,13,0,30,17
1714614023825,EDS 203,A01,507317,Halter; Christopher P.,12,0,30,18
1714614024852,EDS 204R,A01,507319,Halter; Christopher P.,0,3,30,30
1714614024852,EDS 204R,B01,507331,Heinzman; Erica M.,16,0,30,14
1714614025877,EDS 206R,A00,507332,Staff,0,4,30,30
1714614025877,EDS 206R,B00,507343,Staff,17,0,30,13
1714614026903,EDS 250,A00,507344,Hemans; Patricia Ann Benitez,22,0,40,18
1714614027927,EDS 281,A00,507345,Daly; Alan J.,18,0,18,0
1714614028955,EDS 284,A00,507350,Daly; Alan J.,16,0,16,0
1714614029982,EDS 286,A00,507359,Fine; Sarah,18,0,18,0
1714614031007,EDS 289C,A01,507361,Daly; Alan J.,18,0,18,0
1714614032031,EDS 290,A00,507366,Hofstetter; Carolyn,15,0,15,0
1714614033059,LIGM 5A,A00,507421,Fischer-Grunski; Eva K,18,0,20,2
1714614034083,LIGM 5B,A00,507423,Fischer-Grunski; Eva K,19,0,20,1
1714614035110,LIGM 5C,A00,507425,Fischer-Grunski; Eva K,19,0,20,1
1714614036135,LIIT 5AS,A00,507427,Carnelos; Chiara,20,0,20,0
1714614037163,LIIT 5BS,A00,507430,Carnelos; Chiara,20,0,20,0
1714614038193,LIIT 5CS,A00,507432,Carnelos; Chiara,20,0,20,0
1714614039218,LISP 5A,A00,507541,Munoz Sanchez; Alicia,11,0,20,9
1714614040243,LISP 5B,A00,507671,Munoz Sanchez; Alicia,8,0,20,12
1714614041268,LISP 5C,A00,507696,Munoz Sanchez; Alicia,9,0,20,11
1714614042294,MAE 197,001,528363,Boechler; Nicholas Sebastia,9998,0,9999,1
1714614043326,MATH 197,001,523477,Kedlaya; Kiran S.,9995,0,9999,4
1714614043326,MATH 197,002,563811,Zhang; Danna,9995,0,9999,4
1714614043326,MATH 197,003,628552,Dumitriu; Ioana,9998,0,9999,1
1714614044355,MCWP 40R,A00,518780,Staff,2,0,20,18
1714614044355,MCWP 40R,B00,518781,Staff,8,0,20,12
1714614044355,MCWP 40R,C00,518783,Staff,6,0,20,14
1714614045381,MCWP 50R,A00,518791,Staff,0,0,20,20
1714614045381,MCWP 50R,B00,518792,Staff,0,2,20,20
1714614045381,MCWP 50R,C00,518793,Staff,0,2,20,20
1714614045381,MCWP 50R,D00,518794,Staff,0,0,20,20
1714614045381,MCWP 50R,E00,518795,Staff,0,2,20,20
1714614045381,MCWP 50R,F00,518796,Staff,0,0,20,20
1714614045381,MCWP 50R,G00,518797,Staff,0,1,20,20
1714614046406,MMW 12R,A01,514034,Herbst; Matthew,0,0,16,16
1714614046406,MMW 12R,A02,514035,Herbst; Matthew,1,0,16,15
1714614047435,MMW 13R,A01,514037,Staff,0,4,16,16
1714614047435,MMW 13R,A02,514039,Staff,0,2,16,16
1714614047435,MMW 13R,A03,628519,Staff,0,2,16,16
1714614049485,SIO 295LS,A00,523233,Staff,10,0,30,20
1714614050512,SIO 295S,A00,523232,Staff,10,0,30,20
1714614051539,SIOC 290S,A01,637330,Merrifield; Mark A,23,0,30,7
1714614052569,SIOC 291S,A01,637333,Gabriel; Corey John,23,0,30,7
1714614053595,SOCI 117,A01,494376,Staff,0,4,5,5
1714614054620,WES 237B,A00,494380,Staff,9,0,20,11
1714614056690,AESE 279B,A00,494370,Wade; Jon P,0,0,33,33
1714614057716,AIP 197,001,627712,Vespa; Emanuel Ignacio,9998,0,9999,1
1714614058741,ANAR 135S,A00,494369,Braswell; Geoffrey E.,0,0,0,0
1714614059769,BENG 196,001,628496,Engler; Adam J.,9998,0,9999,1
1714614060794,CAT 124RS,A01,519847,Geibel; William,0,0,20,20
1714614061824,CAT 125RS,A01,515971,Geibel; William,0,0,20,20
1714614062851,CLRE 250,A00,511389,Morris; Sheldon,9993,0,9999,6
1714614063884,CLRE 251,A00,507176,Mehta; Ravindra L.,9993,0,9999,6
1714614063884,CLRE 251,B00,511410,Mehta; Ravindra L.,9998,0,9999,1
1714614064911,CLRE 252,A00,507189,Cuomo; Raphael Eduardo,9995,0,9999,4
1714614065938,CLRE 253,A00,507199,Vaida; Florin,9994,0,9999,5
1714614065938,CLRE 253,B00,507202,Vaida; Florin,9999,0,9999,0
1714614066964,CLRE 259,A00,507211,Patel; Hemal,9996,0,9999,3
1714614067991,CLRE 260,A00,507221,Cuomo; Raphael Eduardo,9999,0,9999,0
1714614069016,CLRE 297,001,507242,Cuomo; Raphael Eduardo,9999,0,9999,0
1714614070041,COGS 197,001,638244,Voytek; Bradley Thomas,9998,0,9999,1
1714614071066,CSE 191,A00,516875,Minnes Kemp; Mor Mia,9992,0,9999,7
1714614072093,CSE 197,001,637388,Minnes Kemp; Mor Mia,9998,0,9999,1
1714614073120,CSS 201S,A01,494383,Staff,35,0,35,0
1714614074145,CSS 202S,A01,494387,Staff,35,0,35,0
1714614075174,DSC 197,001,628532,Eldridge; Justin Matthew,9996,0,9999,3
1714614076202,EAP 100,A00,516065,Staff,9797,0,9999,202
1714614077231,ECE 45,A01,507414,Staff,33,0,60,27
1714614079284,ECE 111,A01,507420,Staff,15,0,50,35
1714614080312,ECE 197,001,548057,Sievenpiper; Daniel F.,9993,0,9999,6
1714614081339,EDS 115,A00,507243,Choi; Bailey Miyeon,10,0,28,18
1714614082371,EDS 117,A01,494379,Staff,1,5,30,29
1714614083395,EDS 125,A00,507246,Hopkins; Megan Beth,9,0,30,21
1714614084420,EDS 128A,A01,507264,Fargason; Sharon Gayle,8,0,26,18
1714614085449,EDS 128B,A01,507293,Pappas; Elizabeth,12,0,30,18
1714614086474,EDS 139,A00,507294,Fargason; Sharon Gayle,13,0,30,17
1714614086474,EDS 139,B00,507313,Pappas; Elizabeth,13,0,30,17
1714614087501,EDS 201,A00,507315,Staff,13,0,30,17
1714614088528,EDS 203,A01,507317,Halter; Christopher P.,12,0,30,18
1714614089554,EDS 204R,A01,507319,Halter; Christopher P.,0,3,30,30
1714614089554,EDS 204R,B01,507331,Heinzman; Erica M.,16,0,30,14
1714614090579,EDS 206R,A00,507332,Staff,0,4,30,30
1714614090579,EDS 206R,B00,507343,Staff,17,0,30,13
1714614091607,EDS 250,A00,507344,Hemans; Patricia Ann Benitez,22,0,40,18
1714614092633,EDS 281,A00,507345,Daly; Alan J.,18,0,18,0
1714614093663,EDS 284,A00,507350,Daly; Alan J.,16,0,16,0
1714614094691,EDS 286,A00,507359,Fine; Sarah,18,0,18,0
1714614095719,EDS 289C,A01,507361,Daly; Alan J.,18,0,18,0
1714614096746,EDS 290,A00,507366,Hofstetter; Carolyn,15,0,15,0
1714614097776,LIGM 5A,A00,507421,Fischer-Grunski; Eva K,18,0,20,2
1714614098803,LIGM 5B,A00,507423,Fischer-Grunski; Eva K,19,0,20,1
1714614099828,LIGM 5C,A00,507425,Fischer-Grunski; Eva K,19,0,20,1
1714614100855,LIIT 5AS,A00,507427,Carnelos; Chiara,20,0,20,0
1714614101883,LIIT 5BS,A00,507430,Carnelos; Chiara,20,0,20,0
1714614102908,LIIT 5CS,A00,507432,Carnelos; Chiara,20,0,20,0
1714614103932,LISP 5A,A00,507541,Munoz Sanchez; Alicia,11,0,20,9
1714614104957,LISP 5B,A00,507671,Munoz Sanchez; Alicia,8,0,20,12
1714614105984,LISP 5C,A00,507696,Munoz Sanchez; Alicia,9,0,20,11
1714614107011,MAE 197,001,528363,Boechler; Nicholas Sebastia,9998,0,9999,1
1714614108038,MATH 197,001,523477,Kedlaya; Kiran S.,9995,0,9999,4
1714614108038,MATH 197,002,563811,Zhang; Danna,9995,0,9999,4
1714614108038,MATH 197,003,628552,Dumitriu; Ioana,9998,0,9999,1
1714614109064,MCWP 40R,A00,518780,Staff,2,0,20,18
1714614109064,MCWP 40R,B00,518781,Staff,8,0,20,12
1714614109064,MCWP 40R,C00,518783,Staff,6,0,20,14
1714614110089,MCWP 50R,A00,518791,Staff,0,0,20,20
1714614110089,MCWP 50R,B00,518792,Staff,0,2,20,20
1714614110089,MCWP 50R,C00,518793,Staff,0,2,20,20
1714614110089,MCWP 50R,D00,518794,Staff,0,0,20,20
1714614110089,MCWP 50R,E00,518795,Staff,0,2,20,20
1714614110089,MCWP 50R,F00,518796,Staff,0,0,20,20
1714614110089,MCWP 50R,G00,518797,Staff,0,1,20,20
1714614111115,MMW 12R,A01,514034,Herbst; Matthew,0,0,16,16
1714614111115,MMW 12R,A02,514035,Herbst; Matthew,1,0,16,15
1714614112139,MMW 13R,A01,514037,Staff,0,4,16,16
1714614112139,MMW 13R,A02,514039,Staff,0,2,16,16
1714614112139,MMW 13R,A03,628519,Staff,0,2,16,16
1714614114194,SIO 295LS,A00,523233,Staff,10,0,30,20
1714614115217,SIO 295S,A00,523232,Staff,10,0,30,20
1714614116245,SIOC 290S,A01,637330,Merrifield; Mark A,23,0,30,7
1714614117277,SIOC 291S,A01,637333,Gabriel; Corey John,23,0,30,7
1714614118306,SOCI 117,A01,494376,Staff,0,4,5,5
1714614119333,WES 237B,A00,494380,Staff,9,0,20,11
1714614121405,AESE 279B,A00,494370,Wade; Jon P,0,0,33,33
1714614122433,AIP 197,001,627712,Vespa; Emanuel Ignacio,9998,0,9999,1
1714614123458,ANAR 135S,A00,494369,Braswell; Geoffrey E.,0,0,0,0
1714614124483,BENG 196,001,628496,Engler; Adam J.,9998,0,9999,1
1714614125510,CAT 124RS,A01,519847,Geibel; William,0,0,20,20
1714614126538,CAT 125RS,A01,515971,Geibel; William,0,0,20,20
1714614127563,CLRE 250,A00,511389,Morris; Sheldon,9993,0,9999,6
1714614128592,CLRE 251,A00,507176,Mehta; Ravindra L.,9993,0,9999,6
1714614128592,CLRE 251,B00,511410,Mehta; Ravindra L.,9998,0,9999,1
1714614129618,CLRE 252,A00,507189,Cuomo; Raphael Eduardo,9995,0,9999,4
1714614130643,CLRE 253,A00,507199,Vaida; Florin,9994,0,9999,5
1714614130643,CLRE 253,B00,507202,Vaida; Florin,9999,0,9999,0
1714614131672,CLRE 259,A00,507211,Patel; Hemal,9996,0,9999,3
1714614132697,CLRE 260,A00,507221,Cuomo; Raphael Eduardo,9999,0,9999,0
1714614133726,CLRE 297,001,507242,Cuomo; Raphael Eduardo,9999,0,9999,0
1714614134750,COGS 197,001,638244,Voytek; Bradley Thomas,9998,0,9999,1
1714614135774,CSE 191,A00,516875,Minnes Kemp; Mor Mia,9992,0,9999,7
1714614136799,CSE 197,001,637388,Minnes Kemp; Mor Mia,9998,0,9999,1
1714614137829,CSS 201S,A01,494383,Staff,35,0,35,0
1714614138856,CSS 202S,A01,494387,Staff,35,0,35,0
1714614139885,DSC 197,001,628532,Eldridge; Justin Matthew,9996,0,9999,3
1714614140911,EAP 100,A00,516065,Staff,9797,0,9999,202
1714614141937,ECE 45,A01,507414,Staff,33,0,60,27
1714614143991,ECE 111,A01,507420,Staff,15,0,50,35
1714614145019,ECE 197,001,548057,Sievenpiper; Daniel F.,9993,0,9999,6
1714614146046,EDS 115,A00,507243,Choi; Bailey Miyeon,10,0,28,18
1714614147075,EDS 117,A01,494379,Staff,1,5,30,29
1714614148100,EDS 125,A00,507246,Hopkins; Megan Beth,9,0,30,21
1714614149126,EDS 128A,A01,507264,Fargason; Sharon Gayle,8,0,26,18
1714614150154,EDS 128B,A01,507293,Pappas; Elizabeth,12,0,30,18
1714614151179,EDS 139,A00,507294,Fargason; Sharon Gayle,13,0,30,17
1714614151179,EDS 139,B00,507313,Pappas; Elizabeth,13,0,30,17
1714614152259,EDS 201,A00,507315,Staff,13,0,30,17
1714614153289,EDS 203,A01,507317,Halter; Christopher P.,12,0,30,18
1714614154314,EDS 204R,A01,507319,Halter; Christopher P.,0,3,30,30
1714614154314,EDS 204R,B01,507331,Heinzman; Erica M.,16,0,30,14
1714614155342,EDS 206R,A00,507332,Staff,0,4,30,30
1714614155342,EDS 206R,B00,507343,Staff,17,0,30,13
1714614156372,EDS 250,A00,507344,Hemans; Patricia Ann Benitez,22,0,40,18
1714614157399,EDS 281,A00,507345,Daly; Alan J.,18,0,18,0
1714614158423,EDS 284,A00,507350,Daly; Alan J.,16,0,16,0
1714614159458,EDS 286,A00,507359,Fine; Sarah,18,0,18,0
1714614160486,EDS 289C,A01,507361,Daly; Alan J.,18,0,18,0
1714614161511,EDS 290,A00,507366,Hofstetter; Carolyn,15,0,15,0
1714614162540,LIGM 5A,A00,507421,Fischer-Grunski; Eva K,18,0,20,2
1714614163564,LIGM 5B,A00,507423,Fischer-Grunski; Eva K,19,0,20,1
1714614164589,LIGM 5C,A00,507425,Fischer-Grunski; Eva K,19,0,20,1
1714614165615,LIIT 5AS,A00,507427,Carnelos; Chiara,20,0,20,0
1714614166643,LIIT 5BS,A00,507430,Carnelos; Chiara,20,0,20,0
1714614167669,LIIT 5CS,A00,507432,Carnelos; Chiara,20,0,20,0
1714614168694,LISP 5A,A00,507541,Munoz Sanchez; Alicia,11,0,20,9
1714614169719,LISP 5B,A00,507671,Munoz Sanchez; Alicia,8,0,20,12
1714614170745,LISP 5C,A00,507696,Munoz Sanchez; Alicia,9,0,20,11
1714614171772,MAE 197,001,528363,Boechler; Nicholas Sebastia,9998,0,9999,1
1714614172800,MATH 197,001,523477,Kedlaya; Kiran S.,9995,0,9999,4
1714614172800,MATH 197,002,563811,Zhang; Danna,9995,0,9999,4
1714614172800,MATH 197,003,628552,Dumitriu; Ioana,9998,0,9999,1
1714614173829,MCWP 40R,A00,518780,Staff,2,0,20,18
1714614173829,MCWP 40R,B00,518781,Staff,8,0,20,12
1714614173829,MCWP 40R,C00,518783,Staff,6,0,20,14
1714614174855,MCWP 50R,A00,518791,Staff,0,0,20,20
1714614174855,MCWP 50R,B00,518792,Staff,0,2,20,20
1714614174855,MCWP 50R,C00,518793,Staff,0,2,20,20
1714614174855,MCWP 50R,D00,518794,Staff,0,0,20,20
1714614174855,MCWP 50R,E00,518795,Staff,0,2,20,20
1714614174855,MCWP 50R,F00,518796,Staff,0,0,20,20
1714614174855,MCWP 50R,G00,518797,Staff,0,1,20,20
1714614175882,MMW 12R,A01,514034,Herbst; Matthew,0,0,16,16
1714614175882,MMW 12R,A02,514035,Herbst; Matthew,1,0,16,15
1714614176909,MMW 13R,A01,514037,Staff,0,4,16,16
1714614176909,MMW 13R,A02,514039,Staff,0,2,16,16
1714614176909,MMW 13R,A03,628519,Staff,0,2,16,16
1714614178963,SIO 295LS,A00,523233,Staff,10,0,30,20
1714614179990,SIO 295S,A00,523232,Staff,10,0,30,20
1714614181017,SIOC 290S,A01,637330,Merrifield; Mark A,23,0,30,7
1714614182046,SIOC 291S,A01,637333,Gabriel; Corey John,23,0,30,7
1714614183076,SOCI 117,A01,494376,Staff,0,4,5,5
1714614184101,WES 237B,A00,494380,Staff,9,0,20,11
1714614186167,AESE 279B,A00,494370,Wade; Jon P,0,0,33,33
1714614187191,AIP 197,001,627712,Vespa; Emanuel Ignacio,9998,0,9999,1
1714614188219,ANAR 135S,A00,494369,Braswell; Geoffrey E.,0,0,0,0
1714614189247,BENG 196,001,628496,Engler; Adam J.,9998,0,9999,1
1714614190272,CAT 124RS,A01,519847,Geibel; William,0,0,20,20
1714614191298,CAT 125RS,A01,515971,Geibel; William,0,0,20,20
1714614192324,CLRE 250,A00,511389,Morris; Sheldon,9993,0,9999,6
1714614193351,CLRE 251,A00,507176,Mehta; Ravindra L.,9993,0,9999,6
1714614193351,CLRE 251,B00,511410,Mehta; Ravindra L.,9998,0,9999,1
1714614194376,CLRE 252,A00,507189,Cuomo; Raphael Eduardo,9995,0,9999,4
1714614195403,CLRE 253,A00,507199,Vaida; Florin,9994,0,9999,5
1714614195403,CLRE 253,B00,507202,Vaida; Florin,9999,0,9999,0
1714614196428,CLRE 259,A00,507211,Patel; Hemal,9996,0,9999,3
1714614197452,CLRE 260,A00,507221,Cuomo; Raphael Eduardo,9999,0,9999,0
1714614198476,CLRE 297,001,507242,Cuomo; Raphael Eduardo,9999,0,9999,0
1714614199501,COGS 197,001,638244,Voytek; Bradley Thomas,9998,0,9999,1
1714614200530,CSE 191,A00,516875,Minnes Kemp; Mor Mia,9992,0,9999,7
1714614201554,CSE 197,001,637388,Minnes Kemp; Mor Mia,9998,0,9999,1
1714614202584,CSS 201S,A01,494383,Staff,35,0,35,0
1714614203613,CSS 202S,A01,494387,Staff,35,0,35,0
1714614204638,DSC 197,001,628532,Eldridge; Justin Matthew,9996,0,9999,3
1714614205661,EAP 100,A00,516065,Staff,9797,0,9999,202
1714614206688,ECE 45,A01,507414,Staff,33,0,60,27
1714614208741,ECE 111,A01,507420,Staff,15,0,50,35
1714614209766,ECE 197,001,548057,Sievenpiper; Daniel F.,9993,0,9999,6
1714614210792,EDS 115,A00,507243,Choi; Bailey Miyeon,10,0,28,18
1714614211820,EDS 117,A01,494379,Staff,1,5,30,29
1714614212850,EDS 125,A00,507246,Hopkins; Megan Beth,9,0,30,21
1714614213877,EDS 128A,A01,507264,Fargason; Sharon Gayle,8,0,26,18
1714614214901,EDS 128B,A01,507293,Pappas; Elizabeth,12,0,30,18
1714614215927,EDS 139,A00,507294,Fargason; Sharon Gayle,13,0,30,17
1714614215927,EDS 139,B00,507313,Pappas; Elizabeth,13,0,30,17
1714614216951,EDS 201,A00,507315,Staff,13,0,30,17
1714614217979,EDS 203,A01,507317,Halter; Christopher P.,12,0,30,18
1714614219006,EDS 204R,A01,507319,Halter; Christopher P.,0,3,30,30
1714614219006,EDS 204R,B01,507331,Heinzman; Erica M.,16,0,30,14
1714614220035,EDS 206R,A00,507332,Staff,0,4,30,30
1714614220035,EDS 206R,B00,507343,Staff,17,0,30,13
1714614221064,EDS 250,A00,507344,Hemans; Patricia Ann Benitez,22,0,40,18
1714614222091,EDS 281,A00,507345,Daly; Alan J.,18,0,18,0
1714614223115,EDS 284,A00,507350,Daly; Alan J.,16,0,16,0
1714614224140,EDS 286,A00,507359,Fine; Sarah,18,0,18,0
1714614225164,EDS 289C,A01,507361,Daly; Alan J.,18,0,18,0
1714614226191,EDS 290,A00,507366,Hofstetter; Carolyn,15,0,15,0
1714614227216,LIGM 5A,A00,507421,Fischer-Grunski; Eva K,18,0,20,2
1714614228242,LIGM 5B,A00,507423,Fischer-Grunski; Eva K,19,0,20,1
1714614229272,LIGM 5C,A00,507425,Fischer-Grunski; Eva K,19,0,20,1
1714614230298,LIIT 5AS,A00,507427,Carnelos; Chiara,20,0,20,0
1714614231324,LIIT 5BS,A00,507430,Carnelos; Chiara,20,0,20,0
1714614232348,LIIT 5CS,A00,507432,Carnelos; Chiara,20,0,20,0
1714614233378,LISP 5A,A00,507541,Munoz Sanchez; Alicia,11,0,20,9
1714614234406,LISP 5B,A00,507671,Munoz Sanchez; Alicia,8,0,20,12
1714614235434,LISP 5C,A00,507696,Munoz Sanchez; Alicia,9,0,20,11
1714614236459,MAE 197,001,528363,Boechler; Nicholas Sebastia,9998,0,9999,1
1714614237488,MATH 197,001,523477,Kedlaya; Kiran S.,9995,0,9999,4
1714614237488,MATH 197,002,563811,Zhang; Danna,9995,0,9999,4
1714614237488,MATH 197,003,628552,Dumitriu; Ioana,9998,0,9999,1
1714614238515,MCWP 40R,A00,518780,Staff,2,0,20,18
1714614238515,MCWP 40R,B00,518781,Staff,8,0,20,12
1714614238515,MCWP 40R,C00,518783,Staff,6,0,20,14
1714614239542,MCWP 50R,A00,518791,Staff,0,0,20,20
1714614239542,MCWP 50R,B00,518792,Staff,0,2,20,20
1714614239542,MCWP 50R,C00,518793,Staff,0,2,20,20
1714614239542,MCWP 50R,D00,518794,Staff,0,0,20,20
1714614239542,MCWP 50R,E00,518795,Staff,0,2,20,20
1714614239542,MCWP 50R,F00,518796,Staff,0,0,20,20
1714614239542,MCWP 50R,G00,518797,Staff,0,1,20,20
1714614240568,MMW 12R,A01,514034,Herbst; Matthew,0,0,16,16
1714614240568,MMW 12R,A02,514035,Herbst; Matthew,1,0,16,15
1714614241596,MMW 13R,A01,514037,Staff,0,4,16,16
1714614241596,MMW 13R,A02,514039,Staff,0,2,16,16
1714614241596,MMW 13R,A03,628519,Staff,0,2,16,16
1714614243648,SIO 295LS,A00,523233,Staff,10,0,30,20
1714614244673,SIO 295S,A00,523232,Staff,10,0,30,20
1714614245704,SIOC 290S,A01,637330,Merrifield; Mark A,23,0,30,7
1714614246731,SIOC 291S,A01,637333,Gabriel; Corey John,23,0,30,7
1714614247761,SOCI 117,A01,494376,Staff,0,4,5,5
1714614248788,WES 237B,A00,494380,Staff,9,0,20,11
1714614250860,AESE 279B,A00,494370,Wade; Jon P,0,0,33,33
1714614251885,AIP 197,001,627712,Vespa; Emanuel Ignacio,9998,0,9999,1
1714614252909,ANAR 135S,A00,494369,Braswell; Geoffrey E.,0,0,0,0
1714614253936,BENG 196,001,628496,Engler; Adam J.,9998,0,9999,1
1714614254966,CAT 124RS,A01,519847,Geibel; William,0,0,20,20
1714614255993,CAT 125RS,A01,515971,Geibel; William,0,0,20,20
1714614257019,CLRE 250,A00,511389,Morris; Sheldon,9993,0,9999,6
1714614258050,CLRE 251,A00,507176,Mehta; Ravindra L.,9993,0,9999,6
1714614258050,CLRE 251,B00,511410,Mehta; Ravindra L.,9998,0,9999,1
1714614259080,CLRE 252,A00,507189,Cuomo; Raphael Eduardo,9995,0,9999,4
1714614260106,CLRE 253,A00,507199,Vaida; Florin,9994,0,9999,5
1714614260106,CLRE 253,B00,507202,Vaida; Florin,9999,0,9999,0
1714614261132,CLRE 259,A00,507211,Patel; Hemal,9996,0,9999,3
1714614262161,CLRE 260,A00,507221,Cuomo; Raphael Eduardo,9999,0,9999,0
1714614263189,CLRE 297,001,507242,Cuomo; Raphael Eduardo,9999,0,9999,0
1714614264216,COGS 197,001,638244,Voytek; Bradley Thomas,9998,0,9999,1
1714614265242,CSE 191,A00,516875,Minnes Kemp; Mor Mia,9992,0,9999,7
1714614266267,CSE 197,001,637388,Minnes Kemp; Mor Mia,9998,0,9999,1
1714614267297,CSS 201S,A01,494383,Staff,35,0,35,0
1714614268323,CSS 202S,A01,494387,Staff,35,0,35,0
1714614269350,DSC 197,001,628532,Eldridge; Justin Matthew,9996,0,9999,3
1714614270375,EAP 100,A00,516065,Staff,9797,0,9999,202
1714614271402,ECE 45,A01,507414,Staff,33,0,60,27
1714614273453,ECE 111,A01,507420,Staff,15,0,50,35
1714614274476,ECE 197,001,548057,Sievenpiper; Daniel F.,9993,0,9999,6
1714614275502,EDS 115,A00,507243,Choi; Bailey Miyeon,10,0,28,18
1714614276529,EDS 117,A01,494379,Staff,1,5,30,29
1714614277555,EDS 125,A00,507246,Hopkins; Megan Beth,9,0,30,21
1714614278584,EDS 128A,A01,507264,Fargason; Sharon Gayle,8,0,26,18
1714614279610,EDS 128B,A01,507293,Pappas; Elizabeth,12,0,30,18
1714614280634,EDS 139,A00,507294,Fargason; Sharon Gayle,13,0,30,17
1714614280634,EDS 139,B00,507313,Pappas; Elizabeth,13,0,30,17
1714614281662,EDS 201,A00,507315,Staff,13,0,30,17
1714614282688,EDS 203,A01,507317,Halter; Christopher P.,12,0,30,18
1714614283715,EDS 204R,A01,507319,Halter; Christopher P.,0,3,30,30
1714614283715,EDS 204R,B01,507331,Heinzman; Erica M.,16,0,30,14
1714614284739,EDS 206R,A00,507332,Staff,0,4,30,30
1714614284739,EDS 206R,B00,507343,Staff,17,0,30,13
1714614285765,EDS 250,A00,507344,Hemans; Patricia Ann Benitez,22,0,40,18
1714614286790,EDS 281,A00,507345,Daly; Alan J.,18,0,18,0
1714614287814,EDS 284,A00,507350,Daly; Alan J.,16,0,16,0
1714614288843,EDS 286,A00,507359,Fine; Sarah,18,0,18,0
1714614289872,EDS 289C,A01,507361,Daly; Alan J.,18,0,18,0
1714614290897,EDS 290,A00,507366,Hofstetter; Carolyn,15,0,15,0
1714614291922,LIGM 5A,A00,507421,Fischer-Grunski; Eva K,18,0,20,2
1714614292950,LIGM 5B,A00,507423,Fischer-Grunski; Eva K,19,0,20,1
1714614293974,LIGM 5C,A00,507425,Fischer-Grunski; Eva K,19,0,20,1
1714614295002,LIIT 5AS,A00,507427,Carnelos; Chiara,20,0,20,0
1714614296030,LIIT 5BS,A00,507430,Carnelos; Chiara,20,0,20,0
1714614297058,LIIT 5CS,A00,507432,Carnelos; Chiara,20,0,20,0
1714614298084,LISP 5A,A00,507541,Munoz Sanchez; Alicia,11,0,20,9
1714614299110,LISP 5B,A00,507671,Munoz Sanchez; Alicia,8,0,20,12
1714614300138,LISP 5C,A00,507696,Munoz Sanchez; Alicia,9,0,20,11
1714614301168,MAE 197,001,528363,Boechler; Nicholas Sebastia,9998,0,9999,1
1714614302193,MATH 197,001,523477,Kedlaya; Kiran S.,9995,0,9999,4
1714614302193,MATH 197,002,563811,Zhang; Danna,9995,0,9999,4
1714614302193,MATH 197,003,628552,Dumitriu; Ioana,9998,0,9999,1
1714614303218,MCWP 40R,A00,518780,Staff,2,0,20,18
1714614303218,MCWP 40R,B00,518781,Staff,8,0,20,12
1714614303218,MCWP 40R,C00,518783,Staff,6,0,20,14
1714614304242,MCWP 50R,A00,518791,Staff,0,0,20,20
1714614304242,MCWP 50R,B00,518792,Staff,0,2,20,20
1714614304242,MCWP 50R,C00,518793,Staff,0,2,20,20
1714614304242,MCWP 50R,D00,518794,Staff,0,0,20,20
1714614304242,MCWP 50R,E00,518795,Staff,0,2,20,20
1714614304242,MCWP 50R,F00,518796,Staff,0,0,20,20
1714614304242,MCWP 50R,G00,518797,Staff,0,1,20,20
1714614305269,MMW 12R,A01,514034,Herbst; Matthew,0,0,16,16
1714614305269,MMW 12R,A02,514035,Herbst; Matthew,1,0,16,15
1714614306294,MMW 13R,A01,514037,Staff,0,4,16,16
1714614306294,MMW 13R,A02,514039,Staff,0,2,16,16
1714614306294,MMW 13R,A03,628519,Staff,0,2,16,16
1714614308346,SIO 295LS,A00,523233,Staff,10,0,30,20
1714614309370,SIO 295S,A00,523232,Staff,10,0,30,20
1714614310400,SIOC 290S,A01,637330,Merrifield; Mark A,23,0,30,7
1714614311429,SIOC 291S,A01,637333,Gabriel; Corey John,23,0,30,7
1714614312453,SOCI 117,A01,494376,Staff,0,4,5,5
1714614313478,WES 237B,A00,494380,Staff,9,0,20,11
1714614315558,AESE 279B,A00,494370,Wade; Jon P,0,0,33,33
1714614316584,AIP 197,001,627712,Vespa; Emanuel Ignacio,9998,0,9999,1
1714614317611,ANAR 135S,A00,494369,Braswell; Geoffrey E.,0,0,0,0
1714614318636,BENG 196,001,628496,Engler; Adam J.,9998,0,9999,1
1714614319660,CAT 124RS,A01,519847,Geibel; William,0,0,20,20
1714614320685,CAT 125RS,A01,515971,Geibel; William,0,0,20,20
1714614321716,CLRE 250,A00,511389,Morris; Sheldon,9993,0,9999,6
1714614322743,CLRE 251,A00,507176,Mehta; Ravindra L.,9993,0,9999,6
1714614322743,CLRE 251,B00,511410,Mehta; Ravindra L.,9998,0,9999,1
1714614323770,CLRE 252,A00,507189,Cuomo; Raphael Eduardo,9995,0,9999,4
1714614324798,CLRE 253,A00,507199,Vaida; Florin,9994,0,9999,5
1714614324798,CLRE 253,B00,507202,Vaida; Florin,9999,0,9999,0
1714614325823,CLRE 259,A00,507211,Patel; Hemal,9996,0,9999,3
1714614326851,CLRE 260,A00,507221,Cuomo; Raphael Eduardo,9999,0,9999,0
1714614327878,CLRE 297,001,507242,Cuomo; Raphael Eduardo,9999,0,9999,0
1714614328902,COGS 197,001,638244,Voytek; Bradley Thomas,9998,0,9999,1
1714614329929,CSE 191,A00,516875,Minnes Kemp; Mor Mia,9992,0,9999,7
1714614330953,CSE 197,001,637388,Minnes Kemp; Mor Mia,9998,0,9999,1
1714614331979,CSS 201S,A01,494383,Staff,35,0,35,0
1714614333007,CSS 202S,A01,494387,Staff,35,0,35,0
1714614334030,DSC 197,001,628532,Eldridge; Justin Matthew,9996,0,9999,3
1714614335056,EAP 100,A00,516065,Staff,9797,0,9999,202
1714614336084,ECE 45,A01,507414,Staff,33,0,60,27
1714614338133,ECE 111,A01,507420,Staff,15,0,50,35
1714614339161,ECE 197,001,548057,Sievenpiper; Daniel F.,9993,0,9999,6
1714614340186,EDS 115,A00,507243,Choi; Bailey Miyeon,10,0,28,18
1714614341213,EDS 117,A01,494379,Staff,1,5,30,29
1714614342239,EDS 125,A00,507246,Hopkins; Megan Beth,9,0,30,21
1714614343265,EDS 128A,A01,507264,Fargason; Sharon Gayle,8,0,26,18
1714614344294,EDS 128B,A01,507293,Pappas; Elizabeth,12,0,30,18
1714614345322,EDS 139,A00,507294,Fargason; Sharon Gayle,13,0,30,17
1714614345322,EDS 139,B00,507313,Pappas; Elizabeth,13,0,30,17
1714614346348,EDS 201,A00,507315,Staff,13,0,30,17
1714614347372,EDS 203,A01,507317,Halter; Christopher P.,12,0,30,18
1714614348398,EDS 204R,A01,507319,Halter; Christopher P.,0,3,30,30
1714614348398,EDS 204R,B01,507331,Heinzman; Erica M.,16,0,30,14
1714614349427,EDS 206R,A00,507332,Staff,0,4,30,30
1714614349427,EDS 206R,B00,507343,Staff,17,0,30,13
1714614350453,EDS 250,A00,507344,Hemans; Patricia Ann Benitez,22,0,40,18
1714614351482,EDS 281,A00,507345,Daly; Alan J.,18,0,18,0
1714614352507,EDS 284,A00,507350,Daly; Alan J.,16,0,16,0
1714614353535,EDS 286,A00,507359,Fine; Sarah,18,0,18,0
1714614354561,EDS 289C,A01,507361,Daly; Alan J.,18,0,18,0
1714614355587,EDS 290,A00,507366,Hofstetter; Carolyn,15,0,15,0
1714614356617,LIGM 5A,A00,507421,Fischer-Grunski; Eva K,18,0,20,2
1714614357644,LIGM 5B,A00,507423,Fischer-Grunski; Eva K,19,0,20,1
1714614358668,LIGM 5C,A00,507425,Fischer-Grunski; Eva K,19,0,20,1
1714614359697,LIIT 5AS,A00,507427,Carnelos; Chiara,20,0,20,0
1714614360726,LIIT 5BS,A00,507430,Carnelos; Chiara,20,0,20,0
1714614361754,LIIT 5CS,A00,507432,Carnelos; Chiara,20,0,20,0
1714614362779,LISP 5A,A00,507541,Munoz Sanchez; Alicia,11,0,20,9
1714614363808,LISP 5B,A00,507671,Munoz Sanchez; Alicia,8,0,20,12
1714614364833,LISP 5C,A00,507696,Munoz Sanchez; Alicia,9,0,20,11
1714614365858,MAE 197,001,528363,Boechler; Nicholas Sebastia,9998,0,9999,1
1714614366888,MATH 197,001,523477,Kedlaya; Kiran S.,9995,0,9999,4
1714614366888,MATH 197,002,563811,Zhang; Danna,9995,0,9999,4
1714614366888,MATH 197,003,628552,Dumitriu; Ioana,9998,0,9999,1
1714614367915,MCWP 40R,A00,518780,Staff,2,0,20,18
1714614367915,MCWP 40R,B00,518781,Staff,8,0,20,12
1714614367915,MCWP 40R,C00,518783,Staff,6,0,20,14
1714614368942,MCWP 50R,A00,518791,Staff,0,0,20,20
1714614368942,MCWP 50R,B00,518792,Staff,0,2,20,20
1714614368942,MCWP 50R,C00,518793,Staff,0,2,20,20
1714614368942,MCWP 50R,D00,518794,Staff,0,0,20,20
1714614368942,MCWP 50R,E00,518795,Staff,0,2,20,20
1714614368942,MCWP 50R,F00,518796,Staff,0,0,20,20
1714614368942,MCWP 50R,G00,518797,Staff,0,1,20,20
1714614369966,MMW 12R,A01,514034,Herbst; Matthew,0,0,16,16
1714614369966,MMW 12R,A02,514035,Herbst; Matthew,1,0,16,15
1714614370996,MMW 13R,A01,514037,Staff,0,4,16,16
1714614370996,MMW 13R,A02,514039,Staff,0,2,16,16
1714614370996,MMW 13R,A03,628519,Staff,0,2,16,16
1714614373053,SIO 295LS,A00,523233,Staff,10,0,30,20
1714614374077,SIO 295S,A00,523232,Staff,10,0,30,20
1714614375103,SIOC 290S,A01,637330,Merrifield; Mark A,23,0,30,7
1714614376133,SIOC 291S,A01,637333,Gabriel; Corey John,23,0,30,7
1714614377159,SOCI 117,A01,494376,Staff,0,4,5,5
1714614378185,WES 237B,A00,494380,Staff,9,0,20,11
1714614380262,AESE 279B,A00,494370,Wade; Jon P,0,0,33,33
1714614381288,AIP 197,001,627712,Vespa; Emanuel Ignacio,9998,0,9999,1
1714614382316,ANAR 135S,A00,494369,Braswell; Geoffrey E.,0,0,0,0
1714614383343,BENG 196,001,628496,Engler; Adam J.,9998,0,9999,1
1714614384369,CAT 124RS,A01,519847,Geibel; William,0,0,20,20
1714614385395,CAT 125RS,A01,515971,Geibel; William,0,0,20,20
1714614386421,CLRE 250,A00,511389,Morris; Sheldon,9993,0,9999,6
1714614387447,CLRE 251,A00,507176,Mehta; Ravindra L.,9993,0,9999,6
1714614387447,CLRE 251,B00,511410,Mehta; Ravindra L.,9998,0,9999,1
1714614388475,CLRE 252,A00,507189,Cuomo; Raphael Eduardo,9995,0,9999,4
1714614389500,CLRE 253,A00,507199,Vaida; Florin,9994,0,9999,5
1714614389500,CLRE 253,B00,507202,Vaida; Florin,9999,0,9999,0
1714614390527,CLRE 259,A00,507211,Patel; Hemal,9996,0,9999,3
1714614391552,CLRE 260,A00,507221,Cuomo; Raphael Eduardo,9999,0,9999,0
1714614392581,CLRE 297,001,507242,Cuomo; Raphael Eduardo,9999,0,9999,0
1714614393607,COGS 197,001,638244,Voytek; Bradley Thomas,9998,0,9999,1
1714614394632,CSE 191,A00,516875,Minnes Kemp; Mor Mia,9992,0,9999,7
1714614395657,CSE 197,001,637388,Minnes Kemp; Mor Mia,9998,0,9999,1
1714614396688,CSS 201S,A01,494383,Staff,35,0,35,0
1714614397717,CSS 202S,A01,494387,Staff,35,0,35,0
1714614398742,DSC 197,001,628532,Eldridge; Justin Matthew,9996,0,9999,3
1714614399770,EAP 100,A00,516065,Staff,9797,0,9999,202
1714614400794,ECE 45,A01,507414,Staff,33,0,60,27
1714614402842,ECE 111,A01,507420,Staff,15,0,50,35
1714614403870,ECE 197,001,548057,Sievenpiper; Daniel F.,9993,0,9999,6
1714614404897,EDS 115,A00,507243,Choi; Bailey Miyeon,10,0,28,18
1714614405926,EDS 117,A01,494379,Staff,1,5,30,29
1714614406951,EDS 125,A00,507246,Hopkins; Megan Beth,9,0,30,21
1714614407982,EDS 128A,A01,507264,Fargason; Sharon Gayle,8,0,26,18
1714614409007,EDS 128B,A01,507293,Pappas; Elizabeth,12,0,30,18
1714614410032,EDS 139,A00,507294,Fargason; Sharon Gayle,13,0,30,17
1714614410032,EDS 139,B00,507313,Pappas; Elizabeth,13,0,30,17
1714614411056,EDS 201,A00,507315,Staff,13,0,30,17
1714614412097,EDS 203,A01,507317,Halter; Christopher P.,12,0,30,18
1714614413126,EDS 204R,A01,507319,Halter; Christopher P.,0,3,30,30
1714614413126,EDS 204R,B01,507331,Heinzman; Erica M.,16,0,30,14
1714614414151,EDS 206R,A00,507332,Staff,0,4,30,30
1714614414151,EDS 206R,B00,507343,Staff,17,0,30,13
1714614415175,EDS 250,A00,507344,Hemans; Patricia Ann Benitez,22,0,40,18
1714614416205,EDS 281,A00,507345,Daly; Alan J.,18,0,18,0
1714614417232,EDS 284,A00,507350,Daly; Alan J.,16,0,16,0
1714614418259,EDS 286,A00,507359,Fine; Sarah,18,0,18,0
1714614419288,EDS 289C,A01,507361,Daly; Alan J.,18,0,18,0
1714614420314,EDS 290,A00,507366,Hofstetter; Carolyn,15,0,15,0
1714614421344,LIGM 5A,A00,507421,Fischer-Grunski; Eva K,18,0,20,2
1714614422371,LIGM 5B,A00,507423,Fischer-Grunski; Eva K,19,0,20,1
1714614423400,LIGM 5C,A00,507425,Fischer-Grunski; Eva K,19,0,20,1
1714614424430,LIIT 5AS,A00,507427,Carnelos; Chiara,20,0,20,0
1714614425456,LIIT 5BS,A00,507430,Carnelos; Chiara,20,0,20,0
1714614426481,LIIT 5CS,A00,507432,Carnelos; Chiara,20,0,20,0
1714614427507,LISP 5A,A00,507541,Munoz Sanchez; Alicia,11,0,20,9
1714614428530,LISP 5B,A00,507671,Munoz Sanchez; Alicia,8,0,20,12
1714614429560,LISP 5C,A00,507696,Munoz Sanchez; Alicia,9,0,20,11
1714614430586,MAE 197,001,528363,Boechler; Nicholas Sebastia,9998,0,9999,1
1714614431615,MATH 197,001,523477,Kedlaya; Kiran S.,9995,0,9999,4
1714614431615,MATH 197,002,563811,Zhang; Danna,9995,0,9999,4
1714614431615,MATH 197,003,628552,Dumitriu; Ioana,9998,0,9999,1
1714614432645,MCWP 40R,A00,518780,Staff,2,0,20,18
1714614432645,MCWP 40R,B00,518781,Staff,8,0,20,12
1714614432645,MCWP 40R,C00,518783,Staff,6,0,20,14
1714614433671,MCWP 50R,A00,518791,Staff,0,0,20,20
1714614433671,MCWP 50R,B00,518792,Staff,0,2,20,20
1714614433671,MCWP 50R,C00,518793,Staff,0,2,20,20
1714614433671,MCWP 50R,D00,518794,Staff,0,0,20,20
1714614433671,MCWP 50R,E00,518795,Staff,0,2,20,20
1714614433671,MCWP 50R,F00,518796,Staff,0,0,20,20
1714614433671,MCWP 50R,G00,518797,Staff,0,1,20,20
1714614434699,MMW 12R,A01,514034,Herbst; Matthew,0,0,16,16
1714614434699,MMW 12R,A02,514035,Herbst; Matthew,1,0,16,15
1714614435725,MMW 13R,A01,514037,Staff,0,4,16,16
1714614435725,MMW 13R,A02,514039,Staff,0,2,16,16
1714614435725,MMW 13R,A03,628519,Staff,0,2,16,16
1714614437778,SIO 295LS,A00,523233,Staff,10,0,30,20
1714614438804,SIO 295S,A00,523232,Staff,10,0,30,20
1714614439833,SIOC 290S,A01,637330,Merrifield; Mark A,23,0,30,7
1714614440861,SIOC 291S,A01,637333,Gabriel; Corey John,23,0,30,7
1714614441888,SOCI 117,A01,494376,Staff,0,4,5,5
1714614442912,WES 237B,A00,494380,Staff,9,0,20,11
1714614444983,AESE 279B,A00,494370,Wade; Jon P,0,0,33,33
1714614446011,AIP 197,001,627712,Vespa; Emanuel Ignacio,9998,0,9999,1
1714614447035,ANAR 135S,A00,494369,Braswell; Geoffrey E.,0,0,0,0
1714614448062,BENG 196,001,628496,Engler; Adam J.,9998,0,9999,1
1714614449089,CAT 124RS,A01,519847,Geibel; William,0,0,20,20
1714614450115,CAT 125RS,A01,515971,Geibel; William,0,0,20,20
1714614451140,CLRE 250,A00,511389,Morris; Sheldon,9993,0,9999,6
1714614452168,CLRE 251,A00,507176,Mehta; Ravindra L.,9993,0,9999,6
1714614452168,CLRE 251,B00,511410,Mehta; Ravindra L.,9998,0,9999,1
1714614453193,CLRE 252,A00,507189,Cuomo; Raphael Eduardo,9995,0,9999,4
1714614454219,CLRE 253,A00,507199,Vaida; Florin,9994,0,9999,5
1714614454219,CLRE 253,B00,507202,Vaida; Florin,9999,0,9999,0
1714614455250,CLRE 259,A00,507211,Patel; Hemal,9996,0,9999,3
1714614456276,CLRE 260,A00,507221,Cuomo; Raphael Eduardo,9999,0,9999,0
1714614457304,CLRE 297,001,507242,Cuomo; Raphael Eduardo,9999,0,9999,0
1714614458329,COGS 197,001,638244,Voytek; Bradley Thomas,9998,0,9999,1
1714614459355,CSE 191,A00,516875,Minnes Kemp; Mor Mia,9992,0,9999,7
1714614460379,CSE 197,001,637388,Minnes Kemp; Mor Mia,9998,0,9999,1
1714614461404,CSS 201S,A01,494383,Staff,35,0,35,0
1714614462429,CSS 202S,A01,494387,Staff,35,0,35,0
1714614463456,DSC 197,001,628532,Eldridge; Justin Matthew,9996,0,9999,3
1714614464481,EAP 100,A00,516065,Staff,9797,0,9999,202
1714614465506,ECE 45,A01,507414,Staff,33,0,60,27
1714614467555,ECE 111,A01,507420,Staff,15,0,50,35
1714614468581,ECE 197,001,548057,Sievenpiper; Daniel F.,9993,0,9999,6
1714614469609,EDS 115,A00,507243,Choi; Bailey Miyeon,10,0,28,18
1714614470635,EDS 117,A01,494379,Staff,1,5,30,29
1714614471660,EDS 125,A00,507246,Hopkins; Megan Beth,9,0,30,21
1714614472689,EDS 128A,A01,507264,Fargason; Sharon Gayle,8,0,26,18
1714614473714,EDS 128B,A01,507293,Pappas; Elizabeth,12,0,30,18
1714614474741,EDS 139,A00,507294,Fargason; Sharon Gayle,13,0,30,17
1714614474741,EDS 139,B00,507313,Pappas; Elizabeth,13,0,30,17
1714614475767,EDS 201,A00,507315,Staff,13,0,30,17
1714614476794,EDS 203,A01,507317,Halter; Christopher P.,12,0,30,18
1714614477823,EDS 204R,A01,507319,Halter; Christopher P.,0,3,30,30
1714614477823,EDS 204R,B01,507331,Heinzman; Erica M.,16,0,30,14
1714614478847,EDS 206R,A00,507332,Staff,0,4,30,30
1714614478847,EDS 206R,B00,507343,Staff,17,0,30,13
1714614479873,EDS 250,A00,507344,Hemans; Patricia Ann Benitez,22,0,40,18
1714614480900,EDS 281,A00,507345,Daly; Alan J.,18,0,18,0
1714614481923,EDS 284,A00,507350,Daly; Alan J.,16,0,16,0
1714614482949,EDS 286,A00,507359,Fine; Sarah,18,0,18,0
1714614483974,EDS 289C,A01,507361,Daly; Alan J.,18,0,18,0
1714614484999,EDS 290,A00,507366,Hofstetter; Carolyn,15,0,15,0
1714614486024,LIGM 5A,A00,507421,Fischer-Grunski; Eva K,18,0,20,2
1714614487047,LIGM 5B,A00,507423,Fischer-Grunski; Eva K,19,0,20,1
1714614488075,LIGM 5C,A00,507425,Fischer-Grunski; Eva K,19,0,20,1
1714614489103,LIIT 5AS,A00,507427,Carnelos; Chiara,20,0,20,0
1714614490132,LIIT 5BS,A00,507430,Carnelos; Chiara,20,0,20,0
1714614491158,LIIT 5CS,A00,507432,Carnelos; Chiara,20,0,20,0
1714614492183,LISP 5A,A00,507541,Munoz Sanchez; Alicia,11,0,20,9
1714614493208,LISP 5B,A00,507671,Munoz Sanchez; Alicia,8,0,20,12
1714614494235,LISP 5C,A00,507696,Munoz Sanchez; Alicia,9,0,20,11
1714614495259,MAE 197,001,528363,Boechler; Nicholas Sebastia,9998,0,9999,1
1714614496291,MATH 197,001,523477,Kedlaya; Kiran S.,9995,0,9999,4
1714614496291,MATH 197,002,563811,Zhang; Danna,9995,0,9999,4
1714614496291,MATH 197,003,628552,Dumitriu; Ioana,9998,0,9999,1
1714614497370,MCWP 40R,A00,518780,Staff,2,0,20,18
1714614497370,MCWP 40R,B00,518781,Staff,8,0,20,12
1714614497370,MCWP 40R,C00,518783,Staff,6,0,20,14
1714614498395,MCWP 50R,A00,518791,Staff,0,0,20,20
1714614498395,MCWP 50R,B00,518792,Staff,0,2,20,20
1714614498395,MCWP 50R,C00,518793,Staff,0,2,20,20
1714614498395,MCWP 50R,D00,518794,Staff,0,0,20,20
1714614498395,MCWP 50R,E00,518795,Staff,0,2,20,20
1714614498395,MCWP 50R,F00,518796,Staff,0,0,20,20
1714614498395,MCWP 50R,G00,518797,Staff,0,1,20,20
1714614499421,MMW 12R,A01,514034,Herbst; Matthew,0,0,16,16
1714614499421,MMW 12R,A02,514035,Herbst; Matthew,1,0,16,15
1714614500446,MMW 13R,A01,514037,Staff,0,4,16,16
1714614500446,MMW 13R,A02,514039,Staff,0,2,16,16
1714614500446,MMW 13R,A03,628519,Staff,0,2,16,16
1714614502497,SIO 295LS,A00,523233,Staff,10,0,30,20
1714614503523,SIO 295S,A00,523232,Staff,10,0,30,20
1714614504552,SIOC 290S,A01,637330,Merrifield; Mark A,23,0,30,7
1714614505581,SIOC 291S,A01,637333,Gabriel; Corey John,23,0,30,7
1714614506606,SOCI 117,A01,494376,Staff,0,4,5,5
1714614507632,WES 237B,A00,494380,Staff,9,0,20,11
1714614509701,AESE 279B,A00,494370,Wade; Jon P,0,0,33,33
1714614510728,AIP 197,001,627712,Vespa; Emanuel Ignacio,9998,0,9999,1
1714614511753,ANAR 135S,A00,494369,Braswell; Geoffrey E.,0,0,0,0
1714614512777,BENG 196,001,628496,Engler; Adam J.,9998,0,9999,1
1714614513807,CAT 124RS,A01,519847,Geibel; William,0,0,20,20
1714614514832,CAT 125RS,A01,515971,Geibel; William,0,0,20,20
1714614515856,CLRE 250,A00,511389,Morris; Sheldon,9993,0,9999,6
1714614516884,CLRE 251,A00,507176,Mehta; Ravindra L.,9993,0,9999,6
1714614516884,CLRE 251,B00,511410,Mehta; Ravindra L.,9998,0,9999,1
1714614517909,CLRE 252,A00,507189,Cuomo; Raphael Eduardo,9995,0,9999,4
1714614518934,CLRE 253,A00,507199,Vaida; Florin,9994,0,9999,5
1714614518934,CLRE 253,B00,507202,Vaida; Florin,9999,0,9999,0
1714614519959,CLRE 259,A00,507211,Patel; Hemal,9996,0,9999,3
1714614520985,CLRE 260,A00,507221,Cuomo; Raphael Eduardo,9999,0,9999,0
1714614522012,CLRE 297,001,507242,Cuomo; Raphael Eduardo,9999,0,9999,0
1714614523038,COGS 197,001,638244,Voytek; Bradley Thomas,9998,0,9999,1
1714614524066,CSE 191,A00,516875,Minnes Kemp; Mor Mia,9992,0,9999,7
1714614525094,CSE 197,001,637388,Minnes Kemp; Mor Mia,9998,0,9999,1
1714614526123,CSS 201S,A01,494383,Staff,35,0,35,0
1714614527150,CSS 202S,A01,494387,Staff,35,0,35,0
1714614528176,DSC 197,001,628532,Eldridge; Justin Matthew,9996,0,9999,3
1714614529199,EAP 100,A00,516065,Staff,9797,0,9999,202
1714614530225,ECE 45,A01,507414,Staff,33,0,60,27
1714614532275,ECE 111,A01,507420,Staff,15,0,50,35
1714614533299,ECE 197,001,548057,Sievenpiper; Daniel F.,9993,0,9999,6
1714614534330,EDS 115,A00,507243,Choi; Bailey Miyeon,10,0,28,18
1714614535356,EDS 117,A01,494379,Staff,1,5,30,29
1714614536383,EDS 125,A00,507246,Hopkins; Megan Beth,9,0,30,21
1714614537412,EDS 128A,A01,507264,Fargason; Sharon Gayle,8,0,26,18
1714614538438,EDS 128B,A01,507293,Pappas; Elizabeth,12,0,30,18
1714614539466,EDS 139,A00,507294,Fargason; Sharon Gayle,13,0,30,17
1714614539466,EDS 139,B00,507313,Pappas; Elizabeth,13,0,30,17
1714614540492,EDS 201,A00,507315,Staff,13,0,30,17
1714614541516,EDS 203,A01,507317,Halter; Christopher P.,12,0,30,18
1714614542541,EDS 204R,A01,507319,Halter; Christopher P.,0,3,30,30
1714614542541,EDS 204R,B01,507331,Heinzman; Erica M.,16,0,30,14
1714614543566,EDS 206R,A00,507332,Staff,0,4,30,30
1714614543566,EDS 206R,B00,507343,Staff,17,0,30,13
1714614544594,EDS 250,A00,507344,Hemans; Patricia Ann Benitez,22,0,40,18
1714614545619,EDS 281,A00,507345,Daly; Alan J.,18,0,18,0
1714614546644,EDS 284,A00,507350,Daly; Alan J.,16,0,16,0
1714614547669,EDS 286,A00,507359,Fine; Sarah,18,0,18,0
1714614548693,EDS 289C,A01,507361,Daly; Alan J.,18,0,18,0
1714614549721,EDS 290,A00,507366,Hofstetter; Carolyn,15,0,15,0
1714614550747,LIGM 5A,A00,507421,Fischer-Grunski; Eva K,18,0,20,2
1714614551773,LIGM 5B,A00,507423,Fischer-Grunski; Eva K,19,0,20,1
1714614552801,LIGM 5C,A00,507425,Fischer-Grunski; Eva K,19,0,20,1
1714614553833,LIIT 5AS,A00,507427,Carnelos; Chiara,20,0,20,0
1714614554863,LIIT 5BS,A00,507430,Carnelos; Chiara,20,0,20,0
1714614555889,LIIT 5CS,A00,507432,Carnelos; Chiara,20,0,20,0
1714614556915,LISP 5A,A00,507541,Munoz Sanchez; Alicia,11,0,20,9
1714614557940,LISP 5B,A00,507671,Munoz Sanchez; Alicia,8,0,20,12
1714614558967,LISP 5C,A00,507696,Munoz Sanchez; Alicia,9,0,20,11
1714614559994,MAE 197,001,528363,Boechler; Nicholas Sebastia,9998,0,9999,1
1714614561023,MATH 197,001,523477,Kedlaya; Kiran S.,9995,0,9999,4
1714614561023,MATH 197,002,563811,Zhang; Danna,9995,0,9999,4
1714614561023,MATH 197,003,628552,Dumitriu; Ioana,9998,0,9999,1
1714614562057,MCWP 40R,A00,518780,Staff,2,0,20,18
1714614562057,MCWP 40R,B00,518781,Staff,8,0,20,12
1714614562057,MCWP 40R,C00,518783,Staff,6,0,20,14
1714614563082,MCWP 50R,A00,518791,Staff,0,0,20,20
1714614563082,MCWP 50R,B00,518792,Staff,0,2,20,20
1714614563082,MCWP 50R,C00,518793,Staff,0,2,20,20
1714614563082,MCWP 50R,D00,518794,Staff,0,0,20,20
1714614563082,MCWP 50R,E00,518795,Staff,0,2,20,20
1714614563082,MCWP 50R,F00,518796,Staff,0,0,20,20
1714614563082,MCWP 50R,G00,518797,Staff,0,1,20,20
1714614564110,MMW 12R,A01,514034,Herbst; Matthew,0,0,16,16
1714614564110,MMW 12R,A02,514035,Herbst; Matthew,1,0,16,15
1714614565134,MMW 13R,A01,514037,Staff,0,4,16,16
1714614565134,MMW 13R,A02,514039,Staff,0,2,16,16
1714614565134,MMW 13R,A03,628519,Staff,0,2,16,16
1714614567186,SIO 295LS,A00,523233,Staff,10,0,30,20
1714614568211,SIO 295S,A00,523232,Staff,10,0,30,20
1714614569237,SIOC 290S,A01,637330,Merrifield; Mark A,23,0,30,7
1714614570268,SIOC 291S,A01,637333,Gabriel; Corey John,23,0,30,7
1714614571293,SOCI 117,A01,494376,Staff,0,4,5,5
1714614572320,WES 237B,A00,494380,Staff,9,0,20,11
1714614574393,AESE 279B,A00,494370,Wade; Jon P,0,0,33,33
1714614575418,AIP 197,001,627712,Vespa; Emanuel Ignacio,9998,0,9999,1
1714614576444,ANAR 135S,A00,494369,Braswell; Geoffrey E.,0,0,0,0
1714614577469,BENG 196,001,628496,Engler; Adam J.,9998,0,9999,1
1714614578494,CAT 124RS,A01,519847,Geibel; William,0,0,20,20
1714614579524,CAT 125RS,A01,515971,Geibel; William,0,0,20,20
1714614580549,CLRE 250,A00,511389,Morris; Sheldon,9993,0,9999,6
1714614581575,CLRE 251,A00,507176,Mehta; Ravindra L.,9993,0,9999,6
1714614581575,CLRE 251,B00,511410,Mehta; Ravindra L.,9998,0,9999,1
1714614582603,CLRE 252,A00,507189,Cuomo; Raphael Eduardo,9995,0,9999,4
1714614583628,CLRE 253,A00,507199,Vaida; Florin,9994,0,9999,5
1714614583628,CLRE 253,B00,507202,Vaida; Florin,9999,0,9999,0
1714614584655,CLRE 259,A00,507211,Patel; Hemal,9996,0,9999,3
1714614585682,CLRE 260,A00,507221,Cuomo; Raphael Eduardo,9999,0,9999,0
1714614586708,CLRE 297,001,507242,Cuomo; Raphael Eduardo,9999,0,9999,0
1714614587734,COGS 197,001,638244,Voytek; Bradley Thomas,9998,0,9999,1
1714614588762,CSE 191,A00,516875,Minnes Kemp; Mor Mia,9992,0,9999,7
1714614589787,CSE 197,001,637388,Minnes Kemp; Mor Mia,9998,0,9999,1
1714614590818,CSS 201S,A01,494383,Staff,35,0,35,0
1714614591844,CSS 202S,A01,494387,Staff,35,0,35,0
1714614592872,DSC 197,001,628532,Eldridge; Justin Matthew,9996,0,9999,3
1714614593905,EAP 100,A00,516065,Staff,9797,0,9999,202
1714614594931,ECE 45,A01,507414,Staff,33,0,60,27
1714614596986,ECE 111,A01,507420,Staff,15,0,50,35
1714614598011,ECE 197,001,548057,Sievenpiper; Daniel F.,9993,0,9999,6
1714614599036,EDS 115,A00,507243,Choi; Bailey Miyeon,10,0,28,18
1714614600066,EDS 117,A01,494379,Staff,1,5,30,29
1714614601094,EDS 125,A00,507246,Hopkins; Megan Beth,9,0,30,21
1714614602120,EDS 128A,A01,507264,Fargason; Sharon Gayle,8,0,26,18
1714614603145,EDS 128B,A01,507293,Pappas; Elizabeth,12,0,30,18
1714614604171,EDS 139,A00,507294,Fargason; Sharon Gayle,13,0,30,17
1714614604171,EDS 139,B00,507313,Pappas; Elizabeth,13,0,30,17
1714614605202,EDS 201,A00,507315,Staff,13,0,30,17
1714614606231,EDS 203,A01,507317,Halter; Christopher P.,12,0,30,18
1714614607256,EDS 204R,A01,507319,Halter; Christopher P.,0,3,30,30
1714614607256,EDS 204R,B01,507331,Heinzman; Erica M.,16,0,30,14
1714614608284,EDS 206R,A00,507332,Staff,0,4,30,30
1714614608284,EDS 206R,B00,507343,Staff,17,0,30,13
1714614609308,EDS 250,A00,507344,Hemans; Patricia Ann Benitez,22,0,40,18
1714614610336,EDS 281,A00,507345,Daly; Alan J.,18,0,18,0
1714614611361,EDS 284,A00,507350,Daly; Alan J.,16,0,16,0
1714614612386,EDS 286,A00,507359,Fine; Sarah,18,0,18,0
1714614613410,EDS 289C,A01,507361,Daly; Alan J.,18,0,18,0
1714614614439,EDS 290,A00,507366,Hofstetter; Carolyn,15,0,15,0
1714614615468,LIGM 5A,A00,507421,Fischer-Grunski; Eva K,18,0,20,2
1714614616492,LIGM 5B,A00,507423,Fischer-Grunski; Eva K,19,0,20,1
1714614617518,LIGM 5C,A00,507425,Fischer-Grunski; Eva K,19,0,20,1
1714614618544,LIIT 5AS,A00,507427,Carnelos; Chiara,20,0,20,0
1714614619570,LIIT 5BS,A00,507430,Carnelos; Chiara,20,0,20,0
1714614620594,LIIT 5CS,A00,507432,Carnelos; Chiara,20,0,20,0
1714614621619,LISP 5A,A00,507541,Munoz Sanchez; Alicia,11,0,20,9
1714614622648,LISP 5B,A00,507671,Munoz Sanchez; Alicia,8,0,20,12
1714614623673,LISP 5C,A00,507696,Munoz Sanchez; Alicia,9,0,20,11
1714614624702,MAE 197,001,528363,Boechler; Nicholas Sebastia,9998,0,9999,1
1714614625729,MATH 197,001,523477,Kedlaya; Kiran S.,9995,0,9999,4
1714614625729,MATH 197,002,563811,Zhang; Danna,9995,0,9999,4
1714614625729,MATH 197,003,628552,Dumitriu; Ioana,9998,0,9999,1
1714614626755,MCWP 40R,A00,518780,Staff,2,0,20,18
1714614626755,MCWP 40R,B00,518781,Staff,8,0,20,12
1714614626755,MCWP 40R,C00,518783,Staff,6,0,20,14
1714614627837,MCWP 50R,A00,518791,Staff,0,0,20,20
1714614627837,MCWP 50R,B00,518792,Staff,0,2,20,20
1714614627837,MCWP 50R,C00,518793,Staff,0,2,20,20
1714614627837,MCWP 50R,D00,518794,Staff,0,0,20,20
1714614627837,MCWP 50R,E00,518795,Staff,0,2,20,20
1714614627837,MCWP 50R,F00,518796,Staff,0,0,20,20
1714614627837,MCWP 50R,G00,518797,Staff,0,1,20,20
1714614628862,MMW 12R,A01,514034,Herbst; Matthew,0,0,16,16
1714614628862,MMW 12R,A02,514035,Herbst; Matthew,1,0,16,15
1714614629892,MMW 13R,A01,514037,Staff,0,4,16,16
1714614629892,MMW 13R,A02,514039,Staff,0,2,16,16
1714614629892,MMW 13R,A03,628519,Staff,0,2,16,16
1714614631946,SIO 295LS,A00,523233,Staff,10,0,30,20
1714614632979,SIO 295S,A00,523232,Staff,10,0,30,20
1714614634006,SIOC 290S,A01,637330,Merrifield; Mark A,23,0,30,7
1714614635034,SIOC 291S,A01,637333,Gabriel; Corey John,23,0,30,7
1714614636058,SOCI 117,A01,494376,Staff,0,4,5,5
1714614637085,WES 237B,A00,494380,Staff,9,0,20,11
1714614639187,AESE 279B,A00,494370,Wade; Jon P,0,0,33,33
1714614640212,AIP 197,001,627712,Vespa; Emanuel Ignacio,9998,0,9999,1
1714614641240,ANAR 135S,A00,494369,Braswell; Geoffrey E.,0,0,0,0
1714614642265,BENG 196,001,628496,Engler; Adam J.,9998,0,9999,1
1714614643292,CAT 124RS,A01,519847,Geibel; William,0,0,20,20
1714614644316,CAT 125RS,A01,515971,Geibel; William,0,0,20,20
1714614645347,CLRE 250,A00,511389,Morris; Sheldon,9993,0,9999,6
1714614646379,CLRE 251,A00,507176,Mehta; Ravindra L.,9993,0,9999,6
1714614646379,CLRE 251,B00,511410,Mehta; Ravindra L.,9998,0,9999,1
1714614647409,CLRE 252,A00,507189,Cuomo; Raphael Eduardo,9995,0,9999,4
1714614648438,CLRE 253,A00,507199,Vaida; Florin,9994,0,9999,5
1714614648438,CLRE 253,B00,507202,Vaida; Florin,9999,0,9999,0
1714614649465,CLRE 259,A00,507211,Patel; Hemal,9996,0,9999,3
1714614650489,CLRE 260,A00,507221,Cuomo; Raphael Eduardo,9999,0,9999,0
1714614651516,CLRE 297,001,507242,Cuomo; Raphael Eduardo,9999,0,9999,0
1714614652544,COGS 197,001,638244,Voytek; Bradley Thomas,9998,0,9999,1
1714614653569,CSE 191,A00,516875,Minnes Kemp; Mor Mia,9992,0,9999,7
1714614654598,CSE 197,001,637388,Minnes Kemp; Mor Mia,9998,0,9999,1
1714614655624,CSS 201S,A01,494383,Staff,35,0,35,0
1714614656651,CSS 202S,A01,494387,Staff,35,0,35,0
1714614657675,DSC 197,001,628532,Eldridge; Justin Matthew,9996,0,9999,3
1714614658702,EAP 100,A00,516065,Staff,9797,0,9999,202
1714614659731,ECE 45,A01,507414,Staff,33,0,60,27
1714614661785,ECE 111,A01,507420,Staff,15,0,50,35
1714614662812,ECE 197,001,548057,Sievenpiper; Daniel F.,9993,0,9999,6
1714614663841,EDS 115,A00,507243,Choi; Bailey Miyeon,10,0,28,18
1714614664867,EDS 117,A01,494379,Staff,1,5,30,29
1714614665893,EDS 125,A00,507246,Hopkins; Megan Beth,9,0,30,21
1714614666922,EDS 128A,A01,507264,Fargason; Sharon Gayle,8,0,26,18
1714614667948,EDS 128B,A01,507293,Pappas; Elizabeth,12,0,30,18
1714614668972,EDS 139,A00,507294,Fargason; Sharon Gayle,13,0,30,17
1714614668972,EDS 139,B00,507313,Pappas; Elizabeth,13,0,30,17
1714614669998,EDS 201,A00,507315,Staff,13,0,30,17
1714614671030,EDS 203,A01,507317,Halter; Christopher P.,12,0,30,18
1714614672064,EDS 204R,A01,507319,Halter; Christopher P.,0,3,30,30
1714614672064,EDS 204R,B01,507331,Heinzman; Erica M.,16,0,30,14
1714614673089,EDS 206R,A00,507332,Staff,0,4,30,30
1714614673089,EDS 206R,B00,507343,Staff,17,0,30,13
1714614674115,EDS 250,A00,507344,Hemans; Patricia Ann Benitez,22,0,40,18
1714614675143,EDS 281,A00,507345,Daly; Alan J.,18,0,18,0
1714614676168,EDS 284,A00,507350,Daly; Alan J.,16,0,16,0
1714614677194,EDS 286,A00,507359,Fine; Sarah,18,0,18,0
1714614678220,EDS 289C,A01,507361,Daly; Alan J.,18,0,18,0
1714614679246,EDS 290,A00,507366,Hofstetter; Carolyn,15,0,15,0
1714614680277,LIGM 5A,A00,507421,Fischer-Grunski; Eva K,18,0,20,2
1714614681306,LIGM 5B,A00,507423,Fischer-Grunski; Eva K,19,0,20,1
1714614682331,LIGM 5C,A00,507425,Fischer-Grunski; Eva K,19,0,20,1
1714614683357,LIIT 5AS,A00,507427,Carnelos; Chiara,20,0,20,0
1714614684381,LIIT 5BS,A00,507430,Carnelos; Chiara,20,0,20,0
1714614685406,LIIT 5CS,A00,507432,Carnelos; Chiara,20,0,20,0
1714614686435,LISP 5A,A00,507541,Munoz Sanchez; Alicia,11,0,20,9
1714614687463,LISP 5B,A00,507671,Munoz Sanchez; Alicia,8,0,20,12
1714614688487,LISP 5C,A00,507696,Munoz Sanchez; Alicia,9,0,20,11
1714614689512,MAE 197,001,528363,Boechler; Nicholas Sebastia,9998,0,9999,1
1714614690540,MATH 197,001,523477,Kedlaya; Kiran S.,9995,0,9999,4
1714614690540,MATH 197,002,563811,Zhang; Danna,9995,0,9999,4
1714614690540,MATH 197,003,628552,Dumitriu; Ioana,9998,0,9999,1
1714614691565,MCWP 40R,A00,518780,Staff,2,0,20,18
1714614691565,MCWP 40R,B00,518781,Staff,8,0,20,12
1714614691565,MCWP 40R,C00,518783,Staff,6,0,20,14
1714614692594,MCWP 50R,A00,518791,Staff,0,0,20,20
1714614692594,MCWP 50R,B00,518792,Staff,0,2,20,20
1714614692594,MCWP 50R,C00,518793,Staff,0,2,20,20
1714614692594,MCWP 50R,D00,518794,Staff,0,0,20,20
1714614692594,MCWP 50R,E00,518795,Staff,0,2,20,20
1714614692594,MCWP 50R,F00,518796,Staff,0,0,20,20
1714614692594,MCWP 50R,G00,518797,Staff,0,1,20,20
1714614693619,MMW 12R,A01,514034,Herbst; Matthew,0,0,16,16
1714614693619,MMW 12R,A02,514035,Herbst; Matthew,1,0,16,15
1714614694644,MMW 13R,A01,514037,Staff,0,4,16,16
1714614694644,MMW 13R,A02,514039,Staff,0,2,16,16
1714614694644,MMW 13R,A03,628519,Staff,0,2,16,16
1714614696699,SIO 295LS,A00,523233,Staff,10,0,30,20
1714614697724,SIO 295S,A00,523232,Staff,10,0,30,20
1714614698752,SIOC 290S,A01,637330,Merrifield; Mark A,23,0,30,7
1714614699780,SIOC 291S,A01,637333,Gabriel; Corey John,23,0,30,7
1714614700808,SOCI 117,A01,494376,Staff,0,4,5,5
1714614701835,WES 237B,A00,494380,Staff,9,0,20,11
1714614703905,AESE 279B,A00,494370,Wade; Jon P,0,0,33,33
1714614704932,AIP 197,001,627712,Vespa; Emanuel Ignacio,9998,0,9999,1
1714614705959,ANAR 135S,A00,494369,Braswell; Geoffrey E.,0,0,0,0
1714614706984,BENG 196,001,628496,Engler; Adam J.,9998,0,9999,1
1714614708010,CAT 124RS,A01,519847,Geibel; William,0,0,20,20
1714614709035,CAT 125RS,A01,515971,Geibel; William,0,0,20,20
1714614710063,CLRE 250,A00,511389,Morris; Sheldon,9993,0,9999,6
1714614711089,CLRE 251,A00,507176,Mehta; Ravindra L.,9993,0,9999,6
1714614711089,CLRE 251,B00,511410,Mehta; Ravindra L.,9998,0,9999,1
1714614712120,CLRE 252,A00,507189,Cuomo; Raphael Eduardo,9995,0,9999,4
1714614713146,CLRE 253,A00,507199,Vaida; Florin,9994,0,9999,5
1714614713146,CLRE 253,B00,507202,Vaida; Florin,9999,0,9999,0
1714614714171,CLRE 259,A00,507211,Patel; Hemal,9996,0,9999,3
1714614715197,CLRE 260,A00,507221,Cuomo; Raphael Eduardo,9999,0,9999,0
1714614716225,CLRE 297,001,507242,Cuomo; Raphael Eduardo,9999,0,9999,0
1714614717252,COGS 197,001,638244,Voytek; Bradley Thomas,9998,0,9999,1
1714614718280,CSE 191,A00,516875,Minnes Kemp; Mor Mia,9992,0,9999,7
1714614719305,CSE 197,001,637388,Minnes Kemp; Mor Mia,9998,0,9999,1
1714614720335,CSS 201S,A01,494383,Staff,35,0,35,0
1714614721361,CSS 202S,A01,494387,Staff,35,0,35,0
1714614722387,DSC 197,001,628532,Eldridge; Justin Matthew,9996,0,9999,3
1714614723412,EAP 100,A00,516065,Staff,9797,0,9999,202
1714614724441,ECE 45,A01,507414,Staff,33,0,60,27
1714614726494,ECE 111,A01,507420,Staff,15,0,50,35
1714614727519,ECE 197,001,548057,Sievenpiper; Daniel F.,9993,0,9999,6
1714614728545,EDS 115,A00,507243,Choi; Bailey Miyeon,10,0,28,18
1714614729571,EDS 117,A01,494379,Staff,1,5,30,29
1714614730599,EDS 125,A00,507246,Hopkins; Megan Beth,9,0,30,21
1714614731683,EDS 128A,A01,507264,Fargason; Sharon Gayle,8,0,26,18
1714614732711,EDS 128B,A01,507293,Pappas; Elizabeth,12,0,30,18
1714614733739,EDS 139,A00,507294,Fargason; Sharon Gayle,13,0,30,17
1714614733739,EDS 139,B00,507313,Pappas; Elizabeth,13,0,30,17
1714614734767,EDS 201,A00,507315,Staff,13,0,30,17
1714614735793,EDS 203,A01,507317,Halter; Christopher P.,12,0,30,18
1714614736818,EDS 204R,A01,507319,Halter; Christopher P.,0,3,30,30
1714614736818,EDS 204R,B01,507331,Heinzman; Erica M.,16,0,30,14
1714614737845,EDS 206R,A00,507332,Staff,0,4,30,30
1714614737845,EDS 206R,B00,507343,Staff,17,0,30,13
1714614738869,EDS 250,A00,507344,Hemans; Patricia Ann Benitez,22,0,40,18
1714614739893,EDS 281,A00,507345,Daly; Alan J.,18,0,18,0
1714614740917,EDS 284,A00,507350,Daly; Alan J.,16,0,16,0
1714614741944,EDS 286,A00,507359,Fine; Sarah,18,0,18,0
1714614742970,EDS 289C,A01,507361,Daly; Alan J.,18,0,18,0
1714614743995,EDS 290,A00,507366,Hofstetter; Carolyn,15,0,15,0
1714614745024,LIGM 5A,A00,507421,Fischer-Grunski; Eva K,18,0,20,2
1714614746049,LIGM 5B,A00,507423,Fischer-Grunski; Eva K,19,0,20,1
1714614747074,LIGM 5C,A00,507425,Fischer-Grunski; Eva K,19,0,20,1
1714614748098,LIIT 5AS,A00,507427,Carnelos; Chiara,20,0,20,0
1714614749124,LIIT 5BS,A00,507430,Carnelos; Chiara,20,0,20,0
1714614750152,LIIT 5CS,A00,507432,Carnelos; Chiara,20,0,20,0
1714614751178,LISP 5A,A00,507541,Munoz Sanchez; Alicia,11,0,20,9
1714614752207,LISP 5B,A00,507671,Munoz Sanchez; Alicia,8,0,20,12
1714614753232,LISP 5C,A00,507696,Munoz Sanchez; Alicia,9,0,20,11
1714614754257,MAE 197,001,528363,Boechler; Nicholas Sebastia,9998,0,9999,1
1714614755290,MATH 197,001,523477,Kedlaya; Kiran S.,9995,0,9999,4
1714614755290,MATH 197,002,563811,Zhang; Danna,9995,0,9999,4
1714614755290,MATH 197,003,628552,Dumitriu; Ioana,9998,0,9999,1
1714614756317,MCWP 40R,A00,518780,Staff,2,0,20,18
1714614756317,MCWP 40R,B00,518781,Staff,8,0,20,12
1714614756317,MCWP 40R,C00,518783,Staff,6,0,20,14
1714614757348,MCWP 50R,A00,518791,Staff,0,0,20,20
1714614757348,MCWP 50R,B00,518792,Staff,0,2,20,20
1714614757348,MCWP 50R,C00,518793,Staff,0,2,20,20
1714614757348,MCWP 50R,D00,518794,Staff,0,0,20,20
1714614757348,MCWP 50R,E00,518795,Staff,0,2,20,20
1714614757348,MCWP 50R,F00,518796,Staff,0,0,20,20
1714614757348,MCWP 50R,G00,518797,Staff,0,1,20,20
1714614758374,MMW 12R,A01,514034,Herbst; Matthew,0,0,16,16
1714614758374,MMW 12R,A02,514035,Herbst; Matthew,1,0,16,15
1714614759399,MMW 13R,A01,514037,Staff,0,4,16,16
1714614759399,MMW 13R,A02,514039,Staff,0,2,16,16
1714614759399,MMW 13R,A03,628519,Staff,0,2,16,16
1714614761451,SIO 295LS,A00,523233,Staff,10,0,30,20
1714614762478,SIO 295S,A00,523232,Staff,10,0,30,20
1714614763503,SIOC 290S,A01,637330,Merrifield; Mark A,23,0,30,7
1714614764528,SIOC 291S,A01,637333,Gabriel; Corey John,23,0,30,7
1714614765556,SOCI 117,A01,494376,Staff,0,4,5,5
1714614766581,WES 237B,A00,494380,Staff,9,0,20,11
1714614768659,AESE 279B,A00,494370,Wade; Jon P,0,0,33,33
1714614769684,AIP 197,001,627712,Vespa; Emanuel Ignacio,9998,0,9999,1
1714614770712,ANAR 135S,A00,494369,Braswell; Geoffrey E.,0,0,0,0
1714614771741,BENG 196,001,628496,Engler; Adam J.,9998,0,9999,1
1714614772770,CAT 124RS,A01,519847,Geibel; William,0,0,20,20
1714614773794,CAT 125RS,A01,515971,Geibel; William,0,0,20,20
1714614774822,CLRE 250,A00,511389,Morris; Sheldon,9993,0,9999,6
1714614775848,CLRE 251,A00,507176,Mehta; Ravindra L.,9993,0,9999,6
1714614775848,CLRE 251,B00,511410,Mehta; Ravindra L.,9998,0,9999,1
1714614776873,CLRE 252,A00,507189,Cuomo; Raphael Eduardo,9995,0,9999,4
1714614777902,CLRE 253,A00,507199,Vaida; Florin,9994,0,9999,5
1714614777902,CLRE 253,B00,507202,Vaida; Florin,9999,0,9999,0
1714614778927,CLRE 259,A00,507211,Patel; Hemal,9996,0,9999,3
1714614779955,CLRE 260,A00,507221,Cuomo; Raphael Eduardo,9999,0,9999,0
1714614780984,CLRE 297,001,507242,Cuomo; Raphael Eduardo,9999,0,9999,0
1714614782015,COGS 197,001,638244,Voytek; Bradley Thomas,9998,0,9999,1
1714614783038,CSE 191,A00,516875,Minnes Kemp; Mor Mia,9992,0,9999,7
1714614784063,CSE 197,001,637388,Minnes Kemp; Mor Mia,9998,0,9999,1
1714614785089,CSS 201S,A01,494383,Staff,35,0,35,0
1714614786118,CSS 202S,A01,494387,Staff,35,0,35,0
1714614787144,DSC 197,001,628532,Eldridge; Justin Matthew,9996,0,9999,3
1714614788169,EAP 100,A00,516065,Staff,9797,0,9999,202
1714614789195,ECE 45,A01,507414,Staff,33,0,60,27
1714614791245,ECE 111,A01,507420,Staff,15,0,50,35
1714614792276,ECE 197,001,548057,Sievenpiper; Daniel F.,9993,0,9999,6
1714614793304,EDS 115,A00,507243,Choi; Bailey Miyeon,10,0,28,18
1714614794335,EDS 117,A01,494379,Staff,1,5,30,29
1714614795360,EDS 125,A00,507246,Hopkins; Megan Beth,9,0,30,21
1714614796385,EDS 128A,A01,507264,Fargason; Sharon Gayle,8,0,26,18
1714614797411,EDS 128B,A01,507293,Pappas; Elizabeth,12,0,30,18
1714614798436,EDS 139,A00,507294,Fargason; Sharon Gayle,13,0,30,17
1714614798436,EDS 139,B00,507313,Pappas; Elizabeth,13,0,30,17
1714614799463,EDS 201,A00,507315,Staff,13,0,30,17
1714614800492,EDS 203,A01,507317,Halter; Christopher P.,12,0,30,18
1714614801523,EDS 204R,A01,507319,Halter; Christopher P.,0,3,30,30
1714614801523,EDS 204R,B01,507331,Heinzman; Erica M.,16,0,30,14
1714614802548,EDS 206R,A00,507332,Staff,0,4,30,30
1714614802548,EDS 206R,B00,507343,Staff,17,0,30,13
1714614803572,EDS 250,A00,507344,Hemans; Patricia Ann Benitez,22,0,40,18
1714614804597,EDS 281,A00,507345,Daly; Alan J.,18,0,18,0
1714614805622,EDS 284,A00,507350,Daly; Alan J.,16,0,16,0
1714614806650,EDS 286,A00,507359,Fine; Sarah,18,0,18,0
1714614807678,EDS 289C,A01,507361,Daly; Alan J.,18,0,18,0
1714614808706,EDS 290,A00,507366,Hofstetter; Carolyn,15,0,15,0
1714614809735,LIGM 5A,A00,507421,Fischer-Grunski; Eva K,18,0,20,2
1714614810764,LIGM 5B,A00,507423,Fischer-Grunski; Eva K,19,0,20,1
1714614811792,LIGM 5C,A00,507425,Fischer-Grunski; Eva K,19,0,20,1
1714614812818,LIIT 5AS,A00,507427,Carnelos; Chiara,20,0,20,0
1714614813843,LIIT 5BS,A00,507430,Carnelos; Chiara,20,0,20,0
1714614814871,LIIT 5CS,A00,507432,Carnelos; Chiara,20,0,20,0
1714614815895,LISP 5A,A00,507541,Munoz Sanchez; Alicia,11,0,20,9
1714614816920,LISP 5B,A00,507671,Munoz Sanchez; Alicia,8,0,20,12
1714614817951,LISP 5C,A00,507696,Munoz Sanchez; Alicia,9,0,20,11
1714614818976,MAE 197,001,528363,Boechler; Nicholas Sebastia,9998,0,9999,1
1714614820004,MATH 197,001,523477,Kedlaya; Kiran S.,9995,0,9999,4
1714614820004,MATH 197,002,563811,Zhang; Danna,9995,0,9999,4
1714614820004,MATH 197,003,628552,Dumitriu; Ioana,9998,0,9999,1
1714614821029,MCWP 40R,A00,518780,Staff,2,0,20,18
1714614821029,MCWP 40R,B00,518781,Staff,8,0,20,12
1714614821029,MCWP 40R,C00,518783,Staff,6,0,20,14
1714614822060,MCWP 50R,A00,518791,Staff,0,0,20,20
1714614822060,MCWP 50R,B00,518792,Staff,0,2,20,20
1714614822060,MCWP 50R,C00,518793,Staff,0,2,20,20
1714614822060,MCWP 50R,D00,518794,Staff,0,0,20,20
1714614822060,MCWP 50R,E00,518795,Staff,0,2,20,20
1714614822060,MCWP 50R,F00,518796,Staff,0,0,20,20
1714614822060,MCWP 50R,G00,518797,Staff,0,1,20,20
1714614823085,MMW 12R,A01,514034,Herbst; Matthew,0,0,16,16
1714614823085,MMW 12R,A02,514035,Herbst; Matthew,1,0,16,15
1714614824108,MMW 13R,A01,514037,Staff,0,4,16,16
1714614824108,MMW 13R,A02,514039,Staff,0,2,16,16
1714614824108,MMW 13R,A03,628519,Staff,0,2,16,16
1714614826159,SIO 295LS,A00,523233,Staff,10,0,30,20
1714614827183,SIO 295S,A00,523232,Staff,10,0,30,20
1714614828210,SIOC 290S,A01,637330,Merrifield; Mark A,23,0,30,7
1714614829241,SIOC 291S,A01,637333,Gabriel; Corey John,23,0,30,7
1714614830269,SOCI 117,A01,494376,Staff,0,4,5,5
1714614831298,WES 237B,A00,494380,Staff,9,0,20,11
1714614833376,AESE 279B,A00,494370,Wade; Jon P,0,0,33,33
1714614834402,AIP 197,001,627712,Vespa; Emanuel Ignacio,9998,0,9999,1
1714614835502,ANAR 135S,A00,494369,Braswell; Geoffrey E.,0,0,0,0
1714614836527,BENG 196,001,628496,Engler; Adam J.,9998,0,9999,1
1714614837557,CAT 124RS,A01,519847,Geibel; William,0,0,20,20
1714614838585,CAT 125RS,A01,515971,Geibel; William,0,0,20,20
1714614839609,CLRE 250,A00,511389,Morris; Sheldon,9993,0,9999,6
1714614840642,CLRE 251,A00,507176,Mehta; Ravindra L.,9993,0,9999,6
1714614840642,CLRE 251,B00,511410,Mehta; Ravindra L.,9998,0,9999,1
1714614841666,CLRE 252,A00,507189,Cuomo; Raphael Eduardo,9995,0,9999,4
1714614842696,CLRE 253,A00,507199,Vaida; Florin,9994,0,9999,5
1714614842696,CLRE 253,B00,507202,Vaida; Florin,9999,0,9999,0
1714614843721,CLRE 259,A00,507211,Patel; Hemal,9996,0,9999,3
1714614844747,CLRE 260,A00,507221,Cuomo; Raphael Eduardo,9999,0,9999,0
1714614845773,CLRE 297,001,507242,Cuomo; Raphael Eduardo,9999,0,9999,0
1714614846801,COGS 197,001,638244,Voytek; Bradley Thomas,9998,0,9999,1
1714614847828,CSE 191,A00,516875,Minnes Kemp; Mor Mia,9992,0,9999,7
1714614848858,CSE 197,001,637388,Minnes Kemp; Mor Mia,9998,0,9999,1
1714614849888,CSS 201S,A01,494383,Staff,35,0,35,0
1714614850918,CSS 202S,A01,494387,Staff,35,0,35,0
1714614851947,DSC 197,001,628532,Eldridge; Justin Matthew,9996,0,9999,3
1714614852971,EAP 100,A00,516065,Staff,9797,0,9999,202
1714614853996,ECE 45,A01,507414,Staff,33,0,60,27
1714614856049,ECE 111,A01,507420,Staff,15,0,50,35
1714614857074,ECE 197,001,548057,Sievenpiper; Daniel F.,9993,0,9999,6
1714614858099,EDS 115,A00,507243,Choi; Bailey Miyeon,10,0,28,18
1714614859125,EDS 117,A01,494379,Staff,1,5,30,29
1714614860152,EDS 125,A00,507246,Hopkins; Megan Beth,9,0,30,21
1714614861178,EDS 128A,A01,507264,Fargason; Sharon Gayle,8,0,26,18
1714614862207,EDS 128B,A01,507293,Pappas; Elizabeth,12,0,30,18
1714614863234,EDS 139,A00,507294,Fargason; Sharon Gayle,13,0,30,17
1714614863234,EDS 139,B00,507313,Pappas; Elizabeth,13,0,30,17
1714614864258,EDS 201,A00,507315,Staff,13,0,30,17
1714614865283,EDS 203,A01,507317,Halter; Christopher P.,12,0,30,18
1714614866312,EDS 204R,A01,507319,Halter; Christopher P.,0,3,30,30
1714614866312,EDS 204R,B01,507331,Heinzman; Erica M.,16,0,30,14
1714614867338,EDS 206R,A00,507332,Staff,0,4,30,30
1714614867338,EDS 206R,B00,507343,Staff,17,0,30,13
1714614868362,EDS 250,A00,507344,Hemans; Patricia Ann Benitez,22,0,40,18
1714614869386,EDS 281,A00,507345,Daly; Alan J.,18,0,18,0
1714614870413,EDS 284,A00,507350,Daly; Alan J.,16,0,16,0
1714614871437,EDS 286,A00,507359,Fine; Sarah,18,0,18,0
1714614872463,EDS 289C,A01,507361,Daly; Alan J.,18,0,18,0
1714614873488,EDS 290,A00,507366,Hofstetter; Carolyn,15,0,15,0
1714614874518,LIGM 5A,A00,507421,Fischer-Grunski; Eva K,18,0,20,2
1714614875546,LIGM 5B,A00,507423,Fischer-Grunski; Eva K,19,0,20,1
1714614876571,LIGM 5C,A00,507425,Fischer-Grunski; Eva K,19,0,20,1
1714614877600,LIIT 5AS,A00,507427,Carnelos; Chiara,20,0,20,0
1714614878624,LIIT 5BS,A00,507430,Carnelos; Chiara,20,0,20,0
1714614879650,LIIT 5CS,A00,507432,Carnelos; Chiara,20,0,20,0
1714614880675,LISP 5A,A00,507541,Munoz Sanchez; Alicia,11,0,20,9
1714614881701,LISP 5B,A00,507671,Munoz Sanchez; Alicia,8,0,20,12
1714614882725,LISP 5C,A00,507696,Munoz Sanchez; Alicia,9,0,20,11
1714614883752,MAE 197,001,528363,Boechler; Nicholas Sebastia,9998,0,9999,1
1714614884780,MATH 197,001,523477,Kedlaya; Kiran S.,9995,0,9999,4
1714614884780,MATH 197,002,563811,Zhang; Danna,9995,0,9999,4
1714614884780,MATH 197,003,628552,Dumitriu; Ioana,9998,0,9999,1
1714614885805,MCWP 40R,A00,518780,Staff,2,0,20,18
1714614885805,MCWP 40R,B00,518781,Staff,8,0,20,12
1714614885805,MCWP 40R,C00,518783,Staff,6,0,20,14
1714614886834,MCWP 50R,A00,518791,Staff,0,0,20,20
1714614886834,MCWP 50R,B00,518792,Staff,0,2,20,20
1714614886834,MCWP 50R,C00,518793,Staff,0,2,20,20
1714614886834,MCWP 50R,D00,518794,Staff,0,0,20,20
1714614886834,MCWP 50R,E00,518795,Staff,0,2,20,20
1714614886834,MCWP 50R,F00,518796,Staff,0,0,20,20
1714614886834,MCWP 50R,G00,518797,Staff,0,1,20,20
1714614887862,MMW 12R,A01,514034,Herbst; Matthew,0,0,16,16
1714614887862,MMW 12R,A02,514035,Herbst; Matthew,1,0,16,15
1714614888887,MMW 13R,A01,514037,Staff,0,4,16,16
1714614888887,MMW 13R,A02,514039,Staff,0,2,16,16
1714614888887,MMW 13R,A03,628519,Staff,0,2,16,16
1714614890940,SIO 295LS,A00,523233,Staff,10,0,30,20
1714614891968,SIO 295S,A00,523232,Staff,10,0,30,20
1714614892993,SIOC 290S,A01,637330,Merrifield; Mark A,23,0,30,7
1714614894016,SIOC 291S,A01,637333,Gabriel; Corey John,23,0,30,7
1714614895046,SOCI 117,A01,494376,Staff,0,4,5,5
1714614896074,WES 237B,A00,494380,Staff,9,0,20,11
1714614898142,AESE 279B,A00,494370,Wade; Jon P,0,0,33,33
1714614899167,AIP 197,001,627712,Vespa; Emanuel Ignacio,9998,0,9999,1
1714614900199,ANAR 135S,A00,494369,Braswell; Geoffrey E.,0,0,0,0
1714614901224,BENG 196,001,628496,Engler; Adam J.,9998,0,9999,1
1714614902249,CAT 124RS,A01,519847,Geibel; William,0,0,20,20
1714614903279,CAT 125RS,A01,515971,Geibel; William,0,0,20,20
1714614904306,CLRE 250,A00,511389,Morris; Sheldon,9993,0,9999,6
1714614905334,CLRE 251,A00,507176,Mehta; Ravindra L.,9993,0,9999,6
1714614905334,CLRE 251,B00,511410,Mehta; Ravindra L.,9998,0,9999,1
1714614906358,CLRE 252,A00,507189,Cuomo; Raphael Eduardo,9995,0,9999,4
1714614907384,CLRE 253,A00,507199,Vaida; Florin,9994,0,9999,5
1714614907384,CLRE 253,B00,507202,Vaida; Florin,9999,0,9999,0
1714614908411,CLRE 259,A00,507211,Patel; Hemal,9996,0,9999,3
1714614909436,CLRE 260,A00,507221,Cuomo; Raphael Eduardo,9999,0,9999,0
1714614910459,CLRE 297,001,507242,Cuomo; Raphael Eduardo,9999,0,9999,0
1714614911484,COGS 197,001,638244,Voytek; Bradley Thomas,9998,0,9999,1
1714614912508,CSE 191,A00,516875,Minnes Kemp; Mor Mia,9992,0,9999,7
1714614913536,CSE 197,001,637388,Minnes Kemp; Mor Mia,9998,0,9999,1
1714614914618,CSS 201S,A01,494383,Staff,35,0,35,0
1714614915646,CSS 202S,A01,494387,Staff,35,0,35,0
1714614916670,DSC 197,001,628532,Eldridge; Justin Matthew,9996,0,9999,3
1714614917699,EAP 100,A00,516065,Staff,9797,0,9999,202
1714614918728,ECE 45,A01,507414,Staff,33,0,60,27
1714614920779,ECE 111,A01,507420,Staff,15,0,50,35
1714614921809,ECE 197,001,548057,Sievenpiper; Daniel F.,9993,0,9999,6
1714614922835,EDS 115,A00,507243,Choi; Bailey Miyeon,10,0,28,18
1714614923864,EDS 117,A01,494379,Staff,1,5,30,29
1714614924891,EDS 125,A00,507246,Hopkins; Megan Beth,9,0,30,21
1714614925918,EDS 128A,A01,507264,Fargason; Sharon Gayle,8,0,26,18
1714614926944,EDS 128B,A01,507293,Pappas; Elizabeth,12,0,30,18
1714614927971,EDS 139,A00,507294,Fargason; Sharon Gayle,13,0,30,17
1714614927971,EDS 139,B00,507313,Pappas; Elizabeth,13,0,30,17
1714614928995,EDS 201,A00,507315,Staff,13,0,30,17
1714614930019,EDS 203,A01,507317,Halter; Christopher P.,12,0,30,18
1714614931049,EDS 204R,A01,507319,Halter; Christopher P.,0,3,30,30
1714614931049,EDS 204R,B01,507331,Heinzman; Erica M.,16,0,30,14
1714614932075,EDS 206R,A00,507332,Staff,0,4,30,30
1714614932075,EDS 206R,B00,507343,Staff,17,0,30,13
1714614933101,EDS 250,A00,507344,Hemans; Patricia Ann Benitez,22,0,40,18
1714614934129,EDS 281,A00,507345,Daly; Alan J.,18,0,18,0
1714614935157,EDS 284,A00,507350,Daly; Alan J.,16,0,16,0
1714614936183,EDS 286,A00,507359,Fine; Sarah,18,0,18,0
1714614937207,EDS 289C,A01,507361,Daly; Alan J.,18,0,18,0
1714614938235,EDS 290,A00,507366,Hofstetter; Carolyn,15,0,15,0
1714614939261,LIGM 5A,A00,507421,Fischer-Grunski; Eva K,18,0,20,2
1714614940287,LIGM 5B,A00,507423,Fischer-Grunski; Eva K,19,0,20,1
1714614941313,LIGM 5C,A00,507425,Fischer-Grunski; Eva K,19,0,20,1
1714614942338,LIIT 5AS,A00,507427,Carnelos; Chiara,20,0,20,0
1714614943365,LIIT 5BS,A00,507430,Carnelos; Chiara,20,0,20,0
1714614944394,LIIT 5CS,A00,507432,Carnelos; Chiara,20,0,20,0
1714614945421,LISP 5A,A00,507541,Munoz Sanchez; Alicia,11,0,20,9
1714614946450,LISP 5B,A00,507671,Munoz Sanchez; Alicia,8,0,20,12
1714614947474,LISP 5C,A00,507696,Munoz Sanchez; Alicia,9,0,20,11
1714614948502,MAE 197,001,528363,Boechler; Nicholas Sebastia,9998,0,9999,1
1714614949533,MATH 197,001,523477,Kedlaya; Kiran S.,9995,0,9999,4
1714614949533,MATH 197,002,563811,Zhang; Danna,9995,0,9999,4
1714614949533,MATH 197,003,628552,Dumitriu; Ioana,9998,0,9999,1
1714614950561,MCWP 40R,A00,518780,Staff,2,0,20,18
1714614950561,MCWP 40R,B00,518781,Staff,8,0,20,12
1714614950561,MCWP 40R,C00,518783,Staff,6,0,20,14
1714614951587,MCWP 50R,A00,518791,Staff,0,0,20,20
1714614951587,MCWP 50R,B00,518792,Staff,0,2,20,20
1714614951587,MCWP 50R,C00,518793,Staff,0,2,20,20
1714614951587,MCWP 50R,D00,518794,Staff,0,0,20,20
1714614951587,MCWP 50R,E00,518795,Staff,0,2,20,20
1714614951587,MCWP 50R,F00,518796,Staff,0,0,20,20
1714614951587,MCWP 50R,G00,518797,Staff,0,1,20,20
1714614952612,MMW 12R,A01,514034,Herbst; Matthew,0,0,16,16
1714614952612,MMW 12R,A02,514035,Herbst; Matthew,1,0,16,15
1714614953641,MMW 13R,A01,514037,Staff,0,4,16,16
1714614953641,MMW 13R,A02,514039,Staff,0,2,16,16
1714614953641,MMW 13R,A03,628519,Staff,0,2,16,16
1714614955692,SIO 295LS,A00,523233,Staff,10,0,30,20
1714614956719,SIO 295S,A00,523232,Staff,10,0,30,20
1714614957745,SIOC 290S,A01,637330,Merrifield; Mark A,23,0,30,7
1714614958771,SIOC 291S,A01,637333,Gabriel; Corey John,23,0,30,7
1714614959796,SOCI 117,A01,494376,Staff,0,4,5,5
1714614960821,WES 237B,A00,494380,Staff,9,0,20,11
1714614962904,AESE 279B,A00,494370,Wade; Jon P,0,0,33,33
1714614963932,AIP 197,001,627712,Vespa; Emanuel Ignacio,9998,0,9999,1
1714614964957,ANAR 135S,A00,494369,Braswell; Geoffrey E.,0,0,0,0
1714614965981,BENG 196,001,628496,Engler; Adam J.,9998,0,9999,1
1714614967005,CAT 124RS,A01,519847,Geibel; William,0,0,20,20
1714614968032,CAT 125RS,A01,515971,Geibel; William,0,0,20,20
1714614969062,CLRE 250,A00,511389,Morris; Sheldon,9993,0,9999,6
1714614970092,CLRE 251,A00,507176,Mehta; Ravindra L.,9993,0,9999,6
1714614970092,CLRE 251,B00,511410,Mehta; Ravindra L.,9998,0,9999,1
1714614971122,CLRE 252,A00,507189,Cuomo; Raphael Eduardo,9995,0,9999,4
1714614972149,CLRE 253,A00,507199,Vaida; Florin,9994,0,9999,5
1714614972149,CLRE 253,B00,507202,Vaida; Florin,9999,0,9999,0
1714614973178,CLRE 259,A00,507211,Patel; Hemal,9996,0,9999,3
1714614974203,CLRE 260,A00,507221,Cuomo; Raphael Eduardo,9999,0,9999,0
1714614975229,CLRE 297,001,507242,Cuomo; Raphael Eduardo,9999,0,9999,0
1714614976253,COGS 197,001,638244,Voytek; Bradley Thomas,9998,0,9999,1
1714614977277,CSE 191,A00,516875,Minnes Kemp; Mor Mia,9992,0,9999,7
1714614978302,CSE 197,001,637388,Minnes Kemp; Mor Mia,9998,0,9999,1
1714614979328,CSS 201S,A01,494383,Staff,35,0,35,0
1714614980357,CSS 202S,A01,494387,Staff,35,0,35,0
1714614981386,DSC 197,001,628532,Eldridge; Justin Matthew,9996,0,9999,3
1714614982412,EAP 100,A00,516065,Staff,9797,0,9999,202
1714614983437,ECE 45,A01,507414,Staff,33,0,60,27
1714614985493,ECE 111,A01,507420,Staff,15,0,50,35
1714614986519,ECE 197,001,548057,Sievenpiper; Daniel F.,9993,0,9999,6
1714614987545,EDS 115,A00,507243,Choi; Bailey Miyeon,10,0,28,18
1714614988574,EDS 117,A01,494379,Staff,1,5,30,29
1714614989598,EDS 125,A00,507246,Hopkins; Megan Beth,9,0,30,21
1714614990626,EDS 128A,A01,507264,Fargason; Sharon Gayle,8,0,26,18
1714614991650,EDS 128B,A01,507293,Pappas; Elizabeth,12,0,30,18
1714614992674,EDS 139,A00,507294,Fargason; Sharon Gayle,13,0,30,17
1714614992674,EDS 139,B00,507313,Pappas; Elizabeth,13,0,30,17
1714614993700,EDS 201,A00,507315,Staff,13,0,30,17
1714614994728,EDS 203,A01,507317,Halter; Christopher P.,12,0,30,18
1714614995754,EDS 204R,A01,507319,Halter; Christopher P.,0,3,30,30
1714614995754,EDS 204R,B01,507331,Heinzman; Erica M.,16,0,30,14
1714614996782,EDS 206R,A00,507332,Staff,0,4,30,30
1714614996782,EDS 206R,B00,507343,Staff,17,0,30,13
1714614997809,EDS 250,A00,507344,Hemans; Patricia Ann Benitez,22,0,40,18
1714614998833,EDS 281,A00,507345,Daly; Alan J.,18,0,18,0
1714614999860,EDS 284,A00,507350,Daly; Alan J.,16,0,16,0
1714615000888,EDS 286,A00,507359,Fine; Sarah,18,0,18,0
1714615001915,EDS 289C,A01,507361,Daly; Alan J.,18,0,18,0
1714615002941,EDS 290,A00,507366,Hofstetter; Carolyn,15,0,15,0
1714615003970,LIGM 5A,A00,507421,Fischer-Grunski; Eva K,18,0,20,2
1714615004997,LIGM 5B,A00,507423,Fischer-Grunski; Eva K,19,0,20,1
1714615006021,LIGM 5C,A00,507425,Fischer-Grunski; Eva K,19,0,20,1
1714615007048,LIIT 5AS,A00,507427,Carnelos; Chiara,20,0,20,0
1714615008078,LIIT 5BS,A00,507430,Carnelos; Chiara,20,0,20,0
1714615009106,LIIT 5CS,A00,507432,Carnelos; Chiara,20,0,20,0
1714615010134,LISP 5A,A00,507541,Munoz Sanchez; Alicia,11,0,20,9
1714615011158,LISP 5B,A00,507671,Munoz Sanchez; Alicia,8,0,20,12
1714615012187,LISP 5C,A00,507696,Munoz Sanchez; Alicia,9,0,20,11
1714615013227,MAE 197,001,528363,Boechler; Nicholas Sebastia,9998,0,9999,1
1714615014254,MATH 197,001,523477,Kedlaya; Kiran S.,9995,0,9999,4
1714615014254,MATH 197,002,563811,Zhang; Danna,9995,0,9999,4
1714615014254,MATH 197,003,628552,Dumitriu; Ioana,9998,0,9999,1
1714615015298,MCWP 40R,A00,518780,Staff,2,0,20,18
1714615015298,MCWP 40R,B00,518781,Staff,8,0,20,12
1714615015298,MCWP 40R,C00,518783,Staff,6,0,20,14
1714615016327,MCWP 50R,A00,518791,Staff,0,0,20,20
1714615016327,MCWP 50R,B00,518792,Staff,0,2,20,20
1714615016327,MCWP 50R,C00,518793,Staff,0,2,20,20
1714615016327,MCWP 50R,D00,518794,Staff,0,0,20,20
1714615016327,MCWP 50R,E00,518795,Staff,0,2,20,20
1714615016327,MCWP 50R,F00,518796,Staff,0,0,20,20
1714615016327,MCWP 50R,G00,518797,Staff,0,1,20,20
1714615017351,MMW 12R,A01,514034,Herbst; Matthew,0,0,16,16
1714615017351,MMW 12R,A02,514035,Herbst; Matthew,1,0,16,15
1714615018375,MMW 13R,A01,514037,Staff,0,4,16,16
1714615018375,MMW 13R,A02,514039,Staff,0,2,16,16
1714615018375,MMW 13R,A03,628519,Staff,0,2,16,16
1714615020430,SIO 295LS,A00,523233,Staff,10,0,30,20
1714615021454,SIO 295S,A00,523232,Staff,10,0,30,20
1714615022539,SIOC 290S,A01,637330,Merrifield; Mark A,23,0,30,7
1714615023564,SIOC 291S,A01,637333,Gabriel; Corey John,23,0,30,7
1714615024594,SOCI 117,A01,494376,Staff,0,4,5,5
1714615025622,WES 237B,A00,494380,Staff,9,0,20,11
1714615027701,AESE 279B,A00,494370,Wade; Jon P,0,0,33,33
1714615028725,AIP 197,001,627712,Vespa; Emanuel Ignacio,9998,0,9999,1
1714615029750,ANAR 135S,A00,494369,Braswell; Geoffrey E.,0,0,0,0
1714615030777,BENG 196,001,628496,Engler; Adam J.,9998,0,9999,1
1714615031804,CAT 124RS,A01,519847,Geibel; William,0,0,20,20
1714615032831,CAT 125RS,A01,515971,Geibel; William,0,0,20,20
1714615033860,CLRE 250,A00,511389,Morris; Sheldon,9993,0,9999,6
1714615034892,CLRE 251,A00,507176,Mehta; Ravindra L.,9993,0,9999,6
1714615034892,CLRE 251,B00,511410,Mehta; Ravindra L.,9998,0,9999,1
1714615035921,CLRE 252,A00,507189,Cuomo; Raphael Eduardo,9995,0,9999,4
1714615036946,CLRE 253,A00,507199,Vaida; Florin,9994,0,9999,5
1714615036946,CLRE 253,B00,507202,Vaida; Florin,9999,0,9999,0
1714615037973,CLRE 259,A00,507211,Patel; Hemal,9996,0,9999,3
1714615038997,CLRE 260,A00,507221,Cuomo; Raphael Eduardo,9999,0,9999,0
1714615040022,CLRE 297,001,507242,Cuomo; Raphael Eduardo,9999,0,9999,0
1714615041048,COGS 197,001,638244,Voytek; Bradley Thomas,9998,0,9999,1
1714615042076,CSE 191,A00,516875,Minnes Kemp; Mor Mia,9992,0,9999,7
1714615043104,CSE 197,001,637388,Minnes Kemp; Mor Mia,9998,0,9999,1
1714615044133,CSS 201S,A01,494383,Staff,35,0,35,0
1714615045159,CSS 202S,A01,494387,Staff,35,0,35,0
1714615046185,DSC 197,001,628532,Eldridge; Justin Matthew,9996,0,9999,3
1714615047210,EAP 100,A00,516065,Staff,9797,0,9999,202
1714615048235,ECE 45,A01,507414,Staff,33,0,60,27
1714615050287,ECE 111,A01,507420,Staff,15,0,50,35
1714615051312,ECE 197,001,548057,Sievenpiper; Daniel F.,9993,0,9999,6
1714615052338,EDS 115,A00,507243,Choi; Bailey Miyeon,10,0,28,18
1714615053365,EDS 117,A01,494379,Staff,1,5,30,29
1714615054395,EDS 125,A00,507246,Hopkins; Megan Beth,9,0,30,21
1714615055420,EDS 128A,A01,507264,Fargason; Sharon Gayle,8,0,26,18
1714615056447,EDS 128B,A01,507293,Pappas; Elizabeth,12,0,30,18
1714615057472,EDS 139,A00,507294,Fargason; Sharon Gayle,13,0,30,17
1714615057472,EDS 139,B00,507313,Pappas; Elizabeth,13,0,30,17
1714615058499,EDS 201,A00,507315,Staff,13,0,30,17
1714615059526,EDS 203,A01,507317,Halter; Christopher P.,12,0,30,18
1714615060553,EDS 204R,A01,507319,Halter; Christopher P.,0,3,30,30
1714615060553,EDS 204R,B01,507331,Heinzman; Erica M.,16,0,30,14
1714615061580,EDS 206R,A00,507332,Staff,0,4,30,30
1714615061580,EDS 206R,B00,507343,Staff,17,0,30,13
1714615062606,EDS 250,A00,507344,Hemans; Patricia Ann Benitez,22,0,40,18
1714615063634,EDS 281,A00,507345,Daly; Alan J.,18,0,18,0
1714615064659,EDS 284,A00,507350,Daly; Alan J.,16,0,16,0
1714615065683,EDS 286,A00,507359,Fine; Sarah,18,0,18,0
1714615066712,EDS 289C,A01,507361,Daly; Alan J.,18,0,18,0
1714615067737,EDS 290,A00,507366,Hofstetter; Carolyn,15,0,15,0
1714615068768,LIGM 5A,A00,507421,Fischer-Grunski; Eva K,18,0,20,2
1714615069796,LIGM 5B,A00,507423,Fischer-Grunski; Eva K,19,0,20,1
1714615070821,LIGM 5C,A00,507425,Fischer-Grunski; Eva K,19,0,20,1
1714615071848,LIIT 5AS,A00,507427,Carnelos; Chiara,20,0,20,0
1714615072874,LIIT 5BS,A00,507430,Carnelos; Chiara,20,0,20,0
1714615073903,LIIT 5CS,A00,507432,Carnelos; Chiara,20,0,20,0
1714615074929,LISP 5A,A00,507541,Munoz Sanchez; Alicia,11,0,20,9
1714615075958,LISP 5B,A00,507671,Munoz Sanchez; Alicia,8,0,20,12
1714615076987,LISP 5C,A00,507696,Munoz Sanchez; Alicia,9,0,20,11
1714615078014,MAE 197,001,528363,Boechler; Nicholas Sebastia,9998,0,9999,1
1714615079042,MATH 197,001,523477,Kedlaya; Kiran S.,9995,0,9999,4
1714615079042,MATH 197,002,563811,Zhang; Danna,9995,0,9999,4
1714615079042,MATH 197,003,628552,Dumitriu; Ioana,9998,0,9999,1
1714615080067,MCWP 40R,A00,518780,Staff,2,0,20,18
1714615080067,MCWP 40R,B00,518781,Staff,8,0,20,12
1714615080067,MCWP 40R,C00,518783,Staff,6,0,20,14
1714615081093,MCWP 50R,A00,518791,Staff,0,0,20,20
1714615081093,MCWP 50R,B00,518792,Staff,0,2,20,20
1714615081093,MCWP 50R,C00,518793,Staff,0,2,20,20
1714615081093,MCWP 50R,D00,518794,Staff,0,0,20,20
1714615081093,MCWP 50R,E00,518795,Staff,0,2,20,20
1714615081093,MCWP 50R,F00,518796,Staff,0,0,20,20
1714615081093,MCWP 50R,G00,518797,Staff,0,1,20,20
1714615082118,MMW 12R,A01,514034,Herbst; Matthew,0,0,16,16
1714615082118,MMW 12R,A02,514035,Herbst; Matthew,1,0,16,15
1714615083141,MMW 13R,A01,514037,Staff,0,4,16,16
1714615083141,MMW 13R,A02,514039,Staff,0,2,16,16
1714615083141,MMW 13R,A03,628519,Staff,0,2,16,16
1714615085196,SIO 295LS,A00,523233,Staff,10,0,30,20
1714615086226,SIO 295S,A00,523232,Staff,10,0,30,20
1714615087250,SIOC 290S,A01,637330,Merrifield; Mark A,23,0,30,7
1714615088278,SIOC 291S,A01,637333,Gabriel; Corey John,23,0,30,7
1714615089308,SOCI 117,A01,494376,Staff,0,4,5,5
1714615090332,WES 237B,A00,494380,Staff,9,0,20,11
1714615092423,AESE 279B,A00,494370,Wade; Jon P,0,0,33,33
1714615093448,AIP 197,001,627712,Vespa; Emanuel Ignacio,9998,0,9999,1
1714615094475,ANAR 135S,A00,494369,Braswell; Geoffrey E.,0,0,0,0
1714615095517,BENG 196,001,628496,Engler; Adam J.,9998,0,9999,1
1714615096542,CAT 124RS,A01,519847,Geibel; William,0,0,20,20
1714615097566,CAT 125RS,A01,515971,Geibel; William,0,0,20,20
1714615098594,CLRE 250,A00,511389,Morris; Sheldon,9993,0,9999,6
1714615099619,CLRE 251,A00,507176,Mehta; Ravindra L.,9993,0,9999,6
1714615099619,CLRE 251,B00,511410,Mehta; Ravindra L.,9998,0,9999,1
1714615100644,CLRE 252,A00,507189,Cuomo; Raphael Eduardo,9995,0,9999,4
1714615101670,CLRE 253,A00,507199,Vaida; Florin,9994,0,9999,5
1714615101670,CLRE 253,B00,507202,Vaida; Florin,9999,0,9999,0
1714615102697,CLRE 259,A00,507211,Patel; Hemal,9996,0,9999,3
1714615103726,CLRE 260,A00,507221,Cuomo; Raphael Eduardo,9999,0,9999,0
1714615104754,CLRE 297,001,507242,Cuomo; Raphael Eduardo,9999,0,9999,0
1714615105779,COGS 197,001,638244,Voytek; Bradley Thomas,9998,0,9999,1
1714615106808,CSE 191,A00,516875,Minnes Kemp; Mor Mia,9992,0,9999,7
1714615107833,CSE 197,001,637388,Minnes Kemp; Mor Mia,9998,0,9999,1
1714615108860,CSS 201S,A01,494383,Staff,35,0,35,0
1714615109890,CSS 202S,A01,494387,Staff,35,0,35,0
1714615110922,DSC 197,001,628532,Eldridge; Justin Matthew,9996,0,9999,3
1714615111945,EAP 100,A00,516065,Staff,9797,0,9999,202
1714615112972,ECE 45,A01,507414,Staff,33,0,60,27
1714615115025,ECE 111,A01,507420,Staff,15,0,50,35
1714615116050,ECE 197,001,548057,Sievenpiper; Daniel F.,9993,0,9999,6
1714615117077,EDS 115,A00,507243,Choi; Bailey Miyeon,10,0,28,18
1714615118116,EDS 117,A01,494379,Staff,1,5,30,29
1714615119144,EDS 125,A00,507246,Hopkins; Megan Beth,9,0,30,21
1714615120172,EDS 128A,A01,507264,Fargason; Sharon Gayle,8,0,26,18
1714615121198,EDS 128B,A01,507293,Pappas; Elizabeth,12,0,30,18
1714615122225,EDS 139,A00,507294,Fargason; Sharon Gayle,13,0,30,17
1714615122225,EDS 139,B00,507313,Pappas; Elizabeth,13,0,30,17
1714615123252,EDS 201,A00,507315,Staff,13,0,30,17
1714615124279,EDS 203,A01,507317,Halter; Christopher P.,12,0,30,18
1714615125310,EDS 204R,A01,507319,Halter; Christopher P.,0,3,30,30
1714615125310,EDS 204R,B01,507331,Heinzman; Erica M.,16,0,30,14
1714615126335,EDS 206R,A00,507332,Staff,0,4,30,30
1714615126335,EDS 206R,B00,507343,Staff,17,0,30,13
1714615127365,EDS 250,A00,507344,Hemans; Patricia Ann Benitez,22,0,40,18
1714615128387,EDS 281,A00,507345,Daly; Alan J.,18,0,18,0
1714615129413,EDS 284,A00,507350,Daly; Alan J.,16,0,16,0
1714615130442,EDS 286,A00,507359,Fine; Sarah,18,0,18,0
1714615131467,EDS 289C,A01,507361,Daly; Alan J.,18,0,18,0
1714615132495,EDS 290,A00,507366,Hofstetter; Carolyn,15,0,15,0
1714615133522,LIGM 5A,A00,507421,Fischer-Grunski; Eva K,18,0,20,2
1714615134547,LIGM 5B,A00,507423,Fischer-Grunski; Eva K,19,0,20,1
1714615135574,LIGM 5C,A00,507425,Fischer-Grunski; Eva K,19,0,20,1
1714615136601,LIIT 5AS,A00,507427,Carnelos; Chiara,20,0,20,0
1714615137627,LIIT 5BS,A00,507430,Carnelos; Chiara,20,0,20,0
1714615138651,LIIT 5CS,A00,507432,Carnelos; Chiara,20,0,20,0
1714615139676,LISP 5A,A00,507541,Munoz Sanchez; Alicia,11,0,20,9
1714615140699,LISP 5B,A00,507671,Munoz Sanchez; Alicia,8,0,20,12
1714615141727,LISP 5C,A00,507696,Munoz Sanchez; Alicia,9,0,20,11
1714615142753,MAE 197,001,528363,Boechler; Nicholas Sebastia,9998,0,9999,1
1714615143781,MATH 197,001,523477,Kedlaya; Kiran S.,9995,0,9999,4
1714615143781,MATH 197,002,563811,Zhang; Danna,9995,0,9999,4
1714615143781,MATH 197,003,628552,Dumitriu; Ioana,9998,0,9999,1
1714615144808,MCWP 40R,A00,518780,Staff,2,0,20,18
1714615144808,MCWP 40R,B00,518781,Staff,8,0,20,12
1714615144808,MCWP 40R,C00,518783,Staff,6,0,20,14
1714615145833,MCWP 50R,A00,518791,Staff,0,0,20,20
1714615145833,MCWP 50R,B00,518792,Staff,0,2,20,20
1714615145833,MCWP 50R,C00,518793,Staff,0,2,20,20
1714615145833,MCWP 50R,D00,518794,Staff,0,0,20,20
1714615145833,MCWP 50R,E00,518795,Staff,0,2,20,20
1714615145833,MCWP 50R,F00,518796,Staff,0,0,20,20
1714615145833,MCWP 50R,G00,518797,Staff,0,1,20,20
1714615146858,MMW 12R,A01,514034,Herbst; Matthew,0,0,16,16
1714615146858,MMW 12R,A02,514035,Herbst; Matthew,1,0,16,15
1714615147884,MMW 13R,A01,514037,Staff,0,4,16,16
1714615147884,MMW 13R,A02,514039,Staff,0,2,16,16
1714615147884,MMW 13R,A03,628519,Staff,0,2,16,16
1714615149934,SIO 295LS,A00,523233,Staff,10,0,30,20
1714615150959,SIO 295S,A00,523232,Staff,10,0,30,20
1714615151984,SIOC 290S,A01,637330,Merrifield; Mark A,23,0,30,7
1714615153009,SIOC 291S,A01,637333,Gabriel; Corey John,23,0,30,7
1714615154034,SOCI 117,A01,494376,Staff,0,4,5,5
1714615155060,WES 237B,A00,494380,Staff,9,0,20,11
1714615157126,AESE 279B,A00,494370,Wade; Jon P,0,0,33,33
1714615158151,AIP 197,001,627712,Vespa; Emanuel Ignacio,9998,0,9999,1
1714615159178,ANAR 135S,A00,494369,Braswell; Geoffrey E.,0,0,0,0
1714615160203,BENG 196,001,628496,Engler; Adam J.,9998,0,9999,1
1714615161228,CAT 124RS,A01,519847,Geibel; William,0,0,20,20
1714615162256,CAT 125RS,A01,515971,Geibel; William,0,0,20,20
1714615163282,CLRE 250,A00,511389,Morris; Sheldon,9993,0,9999,6
1714615164314,CLRE 251,A00,507176,Mehta; Ravindra L.,9993,0,9999,6
1714615164314,CLRE 251,B00,511410,Mehta; Ravindra L.,9998,0,9999,1
1714615165343,CLRE 252,A00,507189,Cuomo; Raphael Eduardo,9995,0,9999,4
1714615166372,CLRE 253,A00,507199,Vaida; Florin,9994,0,9999,5
1714615166372,CLRE 253,B00,507202,Vaida; Florin,9999,0,9999,0
1714615167397,CLRE 259,A00,507211,Patel; Hemal,9996,0,9999,3
1714615168420,CLRE 260,A00,507221,Cuomo; Raphael Eduardo,9999,0,9999,0
1714615169446,CLRE 297,001,507242,Cuomo; Raphael Eduardo,9999,0,9999,0
1714615170472,COGS 197,001,638244,Voytek; Bradley Thomas,9998,0,9999,1
1714615171501,CSE 191,A00,516875,Minnes Kemp; Mor Mia,9992,0,9999,7
1714615172527,CSE 197,001,637388,Minnes Kemp; Mor Mia,9998,0,9999,1
1714615173553,CSS 201S,A01,494383,Staff,35,0,35,0
1714615174578,CSS 202S,A01,494387,Staff,35,0,35,0
1714615175607,DSC 197,001,628532,Eldridge; Justin Matthew,9996,0,9999,3
1714615176631,EAP 100,A00,516065,Staff,9797,0,9999,202
1714615177660,ECE 45,A01,507414,Staff,33,0,60,27
1714615179708,ECE 111,A01,507420,Staff,15,0,50,35
1714615180738,ECE 197,001,548057,Sievenpiper; Daniel F.,9993,0,9999,6
1714615181768,EDS 115,A00,507243,Choi; Bailey Miyeon,10,0,28,18
1714615182794,EDS 117,A01,494379,Staff,1,5,30,29
1714615183822,EDS 125,A00,507246,Hopkins; Megan Beth,9,0,30,21
1714615184847,EDS 128A,A01,507264,Fargason; Sharon Gayle,8,0,26,18
1714615185875,EDS 128B,A01,507293,Pappas; Elizabeth,12,0,30,18
1714615186902,EDS 139,A00,507294,Fargason; Sharon Gayle,13,0,30,17
1714615186902,EDS 139,B00,507313,Pappas; Elizabeth,13,0,30,17
1714615187930,EDS 201,A00,507315,Staff,13,0,30,17
1714615188957,EDS 203,A01,507317,Halter; Christopher P.,12,0,30,18
1714615189983,EDS 204R,A01,507319,Halter; Christopher P.,0,3,30,30
1714615189983,EDS 204R,B01,507331,Heinzman; Erica M.,16,0,30,14
1714615191011,EDS 206R,A00,507332,Staff,0,4,30,30
1714615191011,EDS 206R,B00,507343,Staff,17,0,30,13
1714615192037,EDS 250,A00,507344,Hemans; Patricia Ann Benitez,22,0,40,18
1714615193064,EDS 281,A00,507345,Daly; Alan J.,18,0,18,0
1714615194091,EDS 284,A00,507350,Daly; Alan J.,16,0,16,0
1714615195118,EDS 286,A00,507359,Fine; Sarah,18,0,18,0
1714615196142,EDS 289C,A01,507361,Daly; Alan J.,18,0,18,0
1714615197167,EDS 290,A00,507366,Hofstetter; Carolyn,15,0,15,0
1714615198195,LIGM 5A,A00,507421,Fischer-Grunski; Eva K,18,0,20,2
1714615199221,LIGM 5B,A00,507423,Fischer-Grunski; Eva K,19,0,20,1
1714615200246,LIGM 5C,A00,507425,Fischer-Grunski; Eva K,19,0,20,1
1714615201275,LIIT 5AS,A00,507427,Carnelos; Chiara,20,0,20,0
1714615202301,LIIT 5BS,A00,507430,Carnelos; Chiara,20,0,20,0
1714615203325,LIIT 5CS,A00,507432,Carnelos; Chiara,20,0,20,0
1714615204352,LISP 5A,A00,507541,Munoz Sanchez; Alicia,11,0,20,9
1714615205385,LISP 5B,A00,507671,Munoz Sanchez; Alicia,8,0,20,12
1714615206415,LISP 5C,A00,507696,Munoz Sanchez; Alicia,9,0,20,11
1714615207439,MAE 197,001,528363,Boechler; Nicholas Sebastia,9998,0,9999,1
1714615208468,MATH 197,001,523477,Kedlaya; Kiran S.,9995,0,9999,4
1714615208468,MATH 197,002,563811,Zhang; Danna,9995,0,9999,4
1714615208468,MATH 197,003,628552,Dumitriu; Ioana,9998,0,9999,1
1714615209495,MCWP 40R,A00,518780,Staff,2,0,20,18
1714615209495,MCWP 40R,B00,518781,Staff,8,0,20,12
1714615209495,MCWP 40R,C00,518783,Staff,6,0,20,14
1714615210520,MCWP 50R,A00,518791,Staff,0,0,20,20
1714615210520,MCWP 50R,B00,518792,Staff,0,2,20,20
1714615210520,MCWP 50R,C00,518793,Staff,0,2,20,20
1714615210520,MCWP 50R,D00,518794,Staff,0,0,20,20
1714615210520,MCWP 50R,E00,518795,Staff,0,2,20,20
1714615210520,MCWP 50R,F00,518796,Staff,0,0,20,20
1714615210520,MCWP 50R,G00,518797,Staff,0,1,20,20
1714615211548,MMW 12R,A01,514034,Herbst; Matthew,0,0,16,16
1714615211548,MMW 12R,A02,514035,Herbst; Matthew,1,0,16,15
1714615212573,MMW 13R,A01,514037,Staff,0,4,16,16
1714615212573,MMW 13R,A02,514039,Staff,0,2,16,16
1714615212573,MMW 13R,A03,628519,Staff,0,2,16,16
1714615214626,SIO 295LS,A00,523233,Staff,10,0,30,20
1714615215651,SIO 295S,A00,523232,Staff,10,0,30,20
1714615216679,SIOC 290S,A01,637330,Merrifield; Mark A,23,0,30,7
1714615217706,SIOC 291S,A01,637333,Gabriel; Corey John,23,0,30,7
1714615218733,SOCI 117,A01,494376,Staff,0,4,5,5
1714615219760,WES 237B,A00,494380,Staff,9,0,20,11
1714615221846,AESE 279B,A00,494370,Wade; Jon P,0,0,33,33
1714615222873,AIP 197,001,627712,Vespa; Emanuel Ignacio,9998,0,9999,1
1714615223904,ANAR 135S,A00,494369,Braswell; Geoffrey E.,0,0,0,0
1714615224930,BENG 196,001,628496,Engler; Adam J.,9998,0,9999,1
1714615225960,CAT 124RS,A01,519847,Geibel; William,0,0,20,20
1714615226990,CAT 125RS,A01,515971,Geibel; William,0,0,20,20
1714615228020,CLRE 250,A00,511389,Morris; Sheldon,9993,0,9999,6
1714615229048,CLRE 251,A00,507176,Mehta; Ravindra L.,9993,0,9999,6
1714615229048,CLRE 251,B00,511410,Mehta; Ravindra L.,9998,0,9999,1
1714615230074,CLRE 252,A00,507189,Cuomo; Raphael Eduardo,9995,0,9999,4
1714615231104,CLRE 253,A00,507199,Vaida; Florin,9994,0,9999,5
1714615231104,CLRE 253,B00,507202,Vaida; Florin,9999,0,9999,0
1714615232130,CLRE 259,A00,507211,Patel; Hemal,9996,0,9999,3
1714615233154,CLRE 260,A00,507221,Cuomo; Raphael Eduardo,9999,0,9999,0
1714615234179,CLRE 297,001,507242,Cuomo; Raphael Eduardo,9999,0,9999,0
1714615235208,COGS 197,001,638244,Voytek; Bradley Thomas,9998,0,9999,1
1714615236235,CSE 191,A00,516875,Minnes Kemp; Mor Mia,9992,0,9999,7
1714615237261,CSE 197,001,637388,Minnes Kemp; Mor Mia,9998,0,9999,1
1714615238285,CSS 201S,A01,494383,Staff,35,0,35,0
1714615239311,CSS 202S,A01,494387,Staff,35,0,35,0
1714615240340,DSC 197,001,628532,Eldridge; Justin Matthew,9996,0,9999,3
1714615241363,EAP 100,A00,516065,Staff,9797,0,9999,202
1714615242388,ECE 45,A01,507414,Staff,33,0,60,27
1714615244440,ECE 111,A01,507420,Staff,15,0,50,35
1714615245466,ECE 197,001,548057,Sievenpiper; Daniel F.,9993,0,9999,6
1714615246544,EDS 115,A00,507243,Choi; Bailey Miyeon,10,0,28,18
1714615247574,EDS 117,A01,494379,Staff,1,5,30,29
1714615248599,EDS 125,A00,507246,Hopkins; Megan Beth,9,0,30,21
1714615249626,EDS 128A,A01,507264,Fargason; Sharon Gayle,8,0,26,18
1714615250654,EDS 128B,A01,507293,Pappas; Elizabeth,12,0,30,18
1714615251681,EDS 139,A00,507294,Fargason; Sharon Gayle,13,0,30,17
1714615251681,EDS 139,B00,507313,Pappas; Elizabeth,13,0,30,17
1714615252708,EDS 201,A00,507315,Staff,13,0,30,17
1714615253735,EDS 203,A01,507317,Halter; Christopher P.,12,0,30,18
1714615254764,EDS 204R,A01,507319,Halter; Christopher P.,0,3,30,30
1714615254764,EDS 204R,B01,507331,Heinzman; Erica M.,16,0,30,14
1714615255791,EDS 206R,A00,507332,Staff,0,4,30,30
1714615255791,EDS 206R,B00,507343,Staff,17,0,30,13
1714615256820,EDS 250,A00,507344,Hemans; Patricia Ann Benitez,22,0,40,18
1714615257845,EDS 281,A00,507345,Daly; Alan J.,18,0,18,0
1714615258870,EDS 284,A00,507350,Daly; Alan J.,16,0,16,0
1714615259896,EDS 286,A00,507359,Fine; Sarah,18,0,18,0
1714615260922,EDS 289C,A01,507361,Daly; Alan J.,18,0,18,0
1714615261951,EDS 290,A00,507366,Hofstetter; Carolyn,15,0,15,0
1714615262976,LIGM 5A,A00,507421,Fischer-Grunski; Eva K,18,0,20,2
1714615264001,LIGM 5B,A00,507423,Fischer-Grunski; Eva K,19,0,20,1
1714615265026,LIGM 5C,A00,507425,Fischer-Grunski; Eva K,19,0,20,1
1714615266057,LIIT 5AS,A00,507427,Carnelos; Chiara,20,0,20,0
1714615267081,LIIT 5BS,A00,507430,Carnelos; Chiara,20,0,20,0
1714615268106,LIIT 5CS,A00,507432,Carnelos; Chiara,20,0,20,0
1714615269131,LISP 5A,A00,507541,Munoz Sanchez; Alicia,11,0,20,9
1714615270156,LISP 5B,A00,507671,Munoz Sanchez; Alicia,8,0,20,12
1714615271185,LISP 5C,A00,507696,Munoz Sanchez; Alicia,9,0,20,11
1714615272210,MAE 197,001,528363,Boechler; Nicholas Sebastia,9998,0,9999,1
1714615273238,MATH 197,001,523477,Kedlaya; Kiran S.,9995,0,9999,4
1714615273238,MATH 197,002,563811,Zhang; Danna,9995,0,9999,4
1714615273238,MATH 197,003,628552,Dumitriu; Ioana,9998,0,9999,1
1714615274263,MCWP 40R,A00,518780,Staff,2,0,20,18
1714615274263,MCWP 40R,B00,518781,Staff,8,0,20,12
1714615274263,MCWP 40R,C00,518783,Staff,6,0,20,14
1714615275291,MCWP 50R,A00,518791,Staff,0,0,20,20
1714615275291,MCWP 50R,B00,518792,Staff,0,2,20,20
1714615275291,MCWP 50R,C00,518793,Staff,0,2,20,20
1714615275291,MCWP 50R,D00,518794,Staff,0,0,20,20
1714615275291,MCWP 50R,E00,518795,Staff,0,2,20,20
1714615275291,MCWP 50R,F00,518796,Staff,0,0,20,20
1714615275291,MCWP 50R,G00,518797,Staff,0,1,20,20
1714615276320,MMW 12R,A01,514034,Herbst; Matthew,0,0,16,16
1714615276320,MMW 12R,A02,514035,Herbst; Matthew,1,0,16,15
1714615277349,MMW 13R,A01,514037,Staff,0,4,16,16
1714615277349,MMW 13R,A02,514039,Staff,0,2,16,16
1714615277349,MMW 13R,A03,628519,Staff,0,2,16,16
1714615279404,SIO 295LS,A00,523233,Staff,10,0,30,20
1714615280428,SIO 295S,A00,523232,Staff,10,0,30,20
1714615281497,SIOC 290S,A01,637330,Merrifield; Mark A,23,0,30,7
1714615282525,SIOC 291S,A01,637333,Gabriel; Corey John,23,0,30,7
1714615283550,SOCI 117,A01,494376,Staff,0,4,5,5
1714615284579,WES 237B,A00,494380,Staff,9,0,20,11
1714615286643,AESE 279B,A00,494370,Wade; Jon P,0,0,33,33
1714615287670,AIP 197,001,627712,Vespa; Emanuel Ignacio,9998,0,9999,1
1714615288695,ANAR 135S,A00,494369,Braswell; Geoffrey E.,0,0,0,0
1714615289721,BENG 196,001,628496,Engler; Adam J.,9998,0,9999,1
1714615290745,CAT 124RS,A01,519847,Geibel; William,0,0,20,20
1714615291771,CAT 125RS,A01,515971,Geibel; William,0,0,20,20
1714615292800,CLRE 250,A00,511389,Morris; Sheldon,9993,0,9999,6
1714615293830,CLRE 251,A00,507176,Mehta; Ravindra L.,9993,0,9999,6
1714615293830,CLRE 251,B00,511410,Mehta; Ravindra L.,9998,0,9999,1
1714615294856,CLRE 252,A00,507189,Cuomo; Raphael Eduardo,9995,0,9999,4
1714615295885,CLRE 253,A00,507199,Vaida; Florin,9994,0,9999,5
1714615295885,CLRE 253,B00,507202,Vaida; Florin,9999,0,9999,0
1714615296910,CLRE 259,A00,507211,Patel; Hemal,9996,0,9999,3
1714615297935,CLRE 260,A00,507221,Cuomo; Raphael Eduardo,9999,0,9999,0
1714615298975,CLRE 297,001,507242,Cuomo; Raphael Eduardo,9999,0,9999,0
1714615300003,COGS 197,001,638244,Voytek; Bradley Thomas,9998,0,9999,1
1714615301028,CSE 191,A00,516875,Minnes Kemp; Mor Mia,9992,0,9999,7
1714615302053,CSE 197,001,637388,Minnes Kemp; Mor Mia,9998,0,9999,1
1714615303083,CSS 201S,A01,494383,Staff,35,0,35,0
1714615304111,CSS 202S,A01,494387,Staff,35,0,35,0
1714615305135,DSC 197,001,628532,Eldridge; Justin Matthew,9996,0,9999,3
1714615306160,EAP 100,A00,516065,Staff,9797,0,9999,202
1714615307185,ECE 45,A01,507414,Staff,33,0,60,27
1714615309238,ECE 111,A01,507420,Staff,15,0,50,35
1714615310263,ECE 197,001,548057,Sievenpiper; Daniel F.,9993,0,9999,6
1714615311290,EDS 115,A00,507243,Choi; Bailey Miyeon,10,0,28,18
1714615312315,EDS 117,A01,494379,Staff,1,5,30,29
1714615313340,EDS 125,A00,507246,Hopkins; Megan Beth,9,0,30,21
1714615314365,EDS 128A,A01,507264,Fargason; Sharon Gayle,8,0,26,18
1714615315389,EDS 128B,A01,507293,Pappas; Elizabeth,12,0,30,18
1714615316416,EDS 139,A00,507294,Fargason; Sharon Gayle,13,0,30,17
1714615316416,EDS 139,B00,507313,Pappas; Elizabeth,13,0,30,17
1714615317440,EDS 201,A00,507315,Staff,13,0,30,17
1714615318464,EDS 203,A01,507317,Halter; Christopher P.,12,0,30,18
1714615319494,EDS 204R,A01,507319,Halter; Christopher P.,0,3,30,30
1714615319494,EDS 204R,B01,507331,Heinzman; Erica M.,16,0,30,14
1714615320522,EDS 206R,A00,507332,Staff,0,4,30,30
1714615320522,EDS 206R,B00,507343,Staff,17,0,30,13
1714615321546,EDS 250,A00,507344,Hemans; Patricia Ann Benitez,22,0,40,18
1714615322573,EDS 281,A00,507345,Daly; Alan J.,18,0,18,0
1714615323600,EDS 284,A00,507350,Daly; Alan J.,16,0,16,0
1714615324626,EDS 286,A00,507359,Fine; Sarah,18,0,18,0
1714615325651,EDS 289C,A01,507361,Daly; Alan J.,18,0,18,0
1714615326676,EDS 290,A00,507366,Hofstetter; Carolyn,15,0,15,0
1714615327706,LIGM 5A,A00,507421,Fischer-Grunski; Eva K,18,0,20,2
1714615328730,LIGM 5B,A00,507423,Fischer-Grunski; Eva K,19,0,20,1
1714615329759,LIGM 5C,A00,507425,Fischer-Grunski; Eva K,19,0,20,1
1714615330783,LIIT 5AS,A00,507427,Carnelos; Chiara,20,0,20,0
1714615331809,LIIT 5BS,A00,507430,Carnelos; Chiara,20,0,20,0
1714615332839,LIIT 5CS,A00,507432,Carnelos; Chiara,20,0,20,0
1714615333877,LISP 5A,A00,507541,Munoz Sanchez; Alicia,11,0,20,9
1714615334930,LISP 5B,A00,507671,Munoz Sanchez; Alicia,8,0,20,12
1714615335955,LISP 5C,A00,507696,Munoz Sanchez; Alicia,9,0,20,11
1714615336980,MAE 197,001,528363,Boechler; Nicholas Sebastia,9998,0,9999,1
1714615338006,MATH 197,001,523477,Kedlaya; Kiran S.,9995,0,9999,4
1714615338006,MATH 197,002,563811,Zhang; Danna,9995,0,9999,4
1714615338006,MATH 197,003,628552,Dumitriu; Ioana,9998,0,9999,1
1714615339033,MCWP 40R,A00,518780,Staff,2,0,20,18
1714615339033,MCWP 40R,B00,518781,Staff,8,0,20,12
1714615339033,MCWP 40R,C00,518783,Staff,6,0,20,14
1714615340059,MCWP 50R,A00,518791,Staff,0,0,20,20
1714615340059,MCWP 50R,B00,518792,Staff,0,2,20,20
1714615340059,MCWP 50R,C00,518793,Staff,0,2,20,20
1714615340059,MCWP 50R,D00,518794,Staff,0,0,20,20
1714615340059,MCWP 50R,E00,518795,Staff,0,2,20,20
1714615340059,MCWP 50R,F00,518796,Staff,0,0,20,20
1714615340059,MCWP 50R,G00,518797,Staff,0,1,20,20
1714615341083,MMW 12R,A01,514034,Herbst; Matthew,0,0,16,16
1714615341083,MMW 12R,A02,514035,Herbst; Matthew,1,0,16,15
1714615342108,MMW 13R,A01,514037,Staff,0,4,16,16
1714615342108,MMW 13R,A02,514039,Staff,0,2,16,16
1714615342108,MMW 13R,A03,628519,Staff,0,2,16,16
1714615344158,SIO 295LS,A00,523233,Staff,10,0,30,20
1714615345186,SIO 295S,A00,523232,Staff,10,0,30,20
1714615346211,SIOC 290S,A01,637330,Merrifield; Mark A,23,0,30,7
1714615347240,SIOC 291S,A01,637333,Gabriel; Corey John,23,0,30,7
1714615348269,SOCI 117,A01,494376,Staff,0,4,5,5
1714615349295,WES 237B,A00,494380,Staff,9,0,20,11
1714615351360,AESE 279B,A00,494370,Wade; Jon P,0,0,33,33
1714615352384,AIP 197,001,627712,Vespa; Emanuel Ignacio,9998,0,9999,1
1714615353416,ANAR 135S,A00,494369,Braswell; Geoffrey E.,0,0,0,0
1714615354442,BENG 196,001,628496,Engler; Adam J.,9998,0,9999,1
1714615355469,CAT 124RS,A01,519847,Geibel; William,0,0,20,20
1714615356500,CAT 125RS,A01,515971,Geibel; William,0,0,20,20
1714615357527,CLRE 250,A00,511389,Morris; Sheldon,9993,0,9999,6
1714615358555,CLRE 251,A00,507176,Mehta; Ravindra L.,9993,0,9999,6
1714615358555,CLRE 251,B00,511410,Mehta; Ravindra L.,9998,0,9999,1
1714615359584,CLRE 252,A00,507189,Cuomo; Raphael Eduardo,9995,0,9999,4
1714615360610,CLRE 253,A00,507199,Vaida; Florin,9994,0,9999,5
1714615360610,CLRE 253,B00,507202,Vaida; Florin,9999,0,9999,0
1714615361634,CLRE 259,A00,507211,Patel; Hemal,9996,0,9999,3
1714615362658,CLRE 260,A00,507221,Cuomo; Raphael Eduardo,9999,0,9999,0
1714615363683,CLRE 297,001,507242,Cuomo; Raphael Eduardo,9999,0,9999,0
1714615364709,COGS 197,001,638244,Voytek; Bradley Thomas,9998,0,9999,1
1714615365736,CSE 191,A00,516875,Minnes Kemp; Mor Mia,9992,0,9999,7
1714615366760,CSE 197,001,637388,Minnes Kemp; Mor Mia,9998,0,9999,1
1714615367787,CSS 201S,A01,494383,Staff,35,0,35,0
1714615368816,CSS 202S,A01,494387,Staff,35,0,35,0
1714615369843,DSC 197,001,628532,Eldridge; Justin Matthew,9996,0,9999,3
1714615370870,EAP 100,A00,516065,Staff,9797,0,9999,202
1714615371899,ECE 45,A01,507414,Staff,33,0,60,27
1714615373949,ECE 111,A01,507420,Staff,15,0,50,35
1714615374976,ECE 197,001,548057,Sievenpiper; Daniel F.,9993,0,9999,6
1714615376005,EDS 115,A00,507243,Choi; Bailey Miyeon,10,0,28,18
1714615377032,EDS 117,A01,494379,Staff,1,5,30,29
1714615378055,EDS 125,A00,507246,Hopkins; Megan Beth,9,0,30,21
1714615379081,EDS 128A,A01,507264,Fargason; Sharon Gayle,8,0,26,18
1714615380108,EDS 128B,A01,507293,Pappas; Elizabeth,12,0,30,18
1714615381132,EDS 139,A00,507294,Fargason; Sharon Gayle,13,0,30,17
1714615381132,EDS 139,B00,507313,Pappas; Elizabeth,13,0,30,17
1714615382158,EDS 201,A00,507315,Staff,13,0,30,17
1714615383184,EDS 203,A01,507317,Halter; Christopher P.,12,0,30,18
1714615384213,EDS 204R,A01,507319,Halter; Christopher P.,0,3,30,30
1714615384213,EDS 204R,B01,507331,Heinzman; Erica M.,16,0,30,14
1714615385237,EDS 206R,A00,507332,Staff,0,4,30,30
1714615385237,EDS 206R,B00,507343,Staff,17,0,30,13
1714615386263,EDS 250,A00,507344,Hemans; Patricia Ann Benitez,22,0,40,18
1714615387290,EDS 281,A00,507345,Daly; Alan J.,18,0,18,0
1714615388314,EDS 284,A00,507350,Daly; Alan J.,16,0,16,0
1714615389345,EDS 286,A00,507359,Fine; Sarah,18,0,18,0
1714615390368,EDS 289C,A01,507361,Daly; Alan J.,18,0,18,0
1714615391399,EDS 290,A00,507366,Hofstetter; Carolyn,15,0,15,0
1714615392429,LIGM 5A,A00,507421,Fischer-Grunski; Eva K,18,0,20,2
1714615393452,LIGM 5B,A00,507423,Fischer-Grunski; Eva K,19,0,20,1
1714615394478,LIGM 5C,A00,507425,Fischer-Grunski; Eva K,19,0,20,1
1714615395503,LIIT 5AS,A00,507427,Carnelos; Chiara,20,0,20,0
1714615396530,LIIT 5BS,A00,507430,Carnelos; Chiara,20,0,20,0
1714615397560,LIIT 5CS,A00,507432,Carnelos; Chiara,20,0,20,0
1714615398586,LISP 5A,A00,507541,Munoz Sanchez; Alicia,11,0,20,9
1714615399609,LISP 5B,A00,507671,Munoz Sanchez; Alicia,8,0,20,12
1714615400634,LISP 5C,A00,507696,Munoz Sanchez; Alicia,9,0,20,11
1714615401660,MAE 197,001,528363,Boechler; Nicholas Sebastia,9998,0,9999,1
1714615402688,MATH 197,001,523477,Kedlaya; Kiran S.,9995,0,9999,4
1714615402688,MATH 197,002,563811,Zhang; Danna,9995,0,9999,4
1714615402688,MATH 197,003,628552,Dumitriu; Ioana,9998,0,9999,1
1714615403713,MCWP 40R,A00,518780,Staff,2,0,20,18
1714615403713,MCWP 40R,B00,518781,Staff,8,0,20,12
1714615403713,MCWP 40R,C00,518783,Staff,6,0,20,14
1714615404740,MCWP 50R,A00,518791,Staff,0,0,20,20
1714615404740,MCWP 50R,B00,518792,Staff,0,2,20,20
1714615404740,MCWP 50R,C00,518793,Staff,0,2,20,20
1714615404740,MCWP 50R,D00,518794,Staff,0,0,20,20
1714615404740,MCWP 50R,E00,518795,Staff,0,2,20,20
1714615404740,MCWP 50R,F00,518796,Staff,0,0,20,20
1714615404740,MCWP 50R,G00,518797,Staff,0,1,20,20
1714615405764,MMW 12R,A01,514034,Herbst; Matthew,0,0,16,16
1714615405764,MMW 12R,A02,514035,Herbst; Matthew,1,0,16,15
1714615406793,MMW 13R,A01,514037,Staff,0,4,16,16
1714615406793,MMW 13R,A02,514039,Staff,0,2,16,16
1714615406793,MMW 13R,A03,628519,Staff,0,2,16,16
1714615408849,SIO 295LS,A00,523233,Staff,10,0,30,20
1714615409875,SIO 295S,A00,523232,Staff,10,0,30,20
1714615410901,SIOC 290S,A01,637330,Merrifield; Mark A,23,0,30,7
1714615411931,SIOC 291S,A01,637333,Gabriel; Corey John,23,0,30,7
1714615412958,SOCI 117,A01,494376,Staff,0,4,5,5
1714615413983,WES 237B,A00,494380,Staff,9,0,20,11
1714615416061,AESE 279B,A00,494370,Wade; Jon P,0,0,33,33
1714615417088,AIP 197,001,627712,Vespa; Emanuel Ignacio,9998,0,9999,1
1714615418114,ANAR 135S,A00,494369,Braswell; Geoffrey E.,0,0,0,0
1714615419143,BENG 196,001,628496,Engler; Adam J.,9998,0,9999,1
1714615420168,CAT 124RS,A01,519847,Geibel; William,0,0,20,20
1714615421198,CAT 125RS,A01,515971,Geibel; William,0,0,20,20
1714615422223,CLRE 250,A00,511389,Morris; Sheldon,9993,0,9999,6
1714615423251,CLRE 251,A00,507176,Mehta; Ravindra L.,9993,0,9999,6
1714615423251,CLRE 251,B00,511410,Mehta; Ravindra L.,9998,0,9999,1
1714615424277,CLRE 252,A00,507189,Cuomo; Raphael Eduardo,9995,0,9999,4
1714615425302,CLRE 253,A00,507199,Vaida; Florin,9994,0,9999,5
1714615425302,CLRE 253,B00,507202,Vaida; Florin,9999,0,9999,0
1714615426329,CLRE 259,A00,507211,Patel; Hemal,9996,0,9999,3
1714615427355,CLRE 260,A00,507221,Cuomo; Raphael Eduardo,9999,0,9999,0
1714615428383,CLRE 297,001,507242,Cuomo; Raphael Eduardo,9999,0,9999,0
1714615429407,COGS 197,001,638244,Voytek; Bradley Thomas,9998,0,9999,1
1714615430432,CSE 191,A00,516875,Minnes Kemp; Mor Mia,9992,0,9999,7
1714615431457,CSE 197,001,637388,Minnes Kemp; Mor Mia,9998,0,9999,1
1714615432489,CSS 201S,A01,494383,Staff,35,0,35,0
1714615433514,CSS 202S,A01,494387,Staff,35,0,35,0
1714615434544,DSC 197,001,628532,Eldridge; Justin Matthew,9996,0,9999,3
1714615435569,EAP 100,A00,516065,Staff,9797,0,9999,202
1714615436594,ECE 45,A01,507414,Staff,33,0,60,27
1714615438646,ECE 111,A01,507420,Staff,15,0,50,35
1714615439674,ECE 197,001,548057,Sievenpiper; Daniel F.,9993,0,9999,6
1714615440701,EDS 115,A00,507243,Choi; Bailey Miyeon,10,0,28,18
1714615441726,EDS 117,A01,494379,Staff,1,5,30,29
1714615442752,EDS 125,A00,507246,Hopkins; Megan Beth,9,0,30,21
1714615443779,EDS 128A,A01,507264,Fargason; Sharon Gayle,8,0,26,18
1714615444805,EDS 128B,A01,507293,Pappas; Elizabeth,12,0,30,18
1714615445830,EDS 139,A00,507294,Fargason; Sharon Gayle,13,0,30,17
1714615445830,EDS 139,B00,507313,Pappas; Elizabeth,13,0,30,17
1714615446858,EDS 201,A00,507315,Staff,13,0,30,17
1714615447886,EDS 203,A01,507317,Halter; Christopher P.,12,0,30,18
1714615448912,EDS 204R,A01,507319,Halter; Christopher P.,0,3,30,30
1714615448912,EDS 204R,B01,507331,Heinzman; Erica M.,16,0,30,14
1714615449940,EDS 206R,A00,507332,Staff,0,4,30,30
1714615449940,EDS 206R,B00,507343,Staff,17,0,30,13
1714615450969,EDS 250,A00,507344,Hemans; Patricia Ann Benitez,22,0,40,18
1714615451997,EDS 281,A00,507345,Daly; Alan J.,18,0,18,0
1714615453025,EDS 284,A00,507350,Daly; Alan J.,16,0,16,0
1714615454105,EDS 286,A00,507359,Fine; Sarah,18,0,18,0
1714615455130,EDS 289C,A01,507361,Daly; Alan J.,18,0,18,0
1714615456155,EDS 290,A00,507366,Hofstetter; Carolyn,15,0,15,0
1714615457182,LIGM 5A,A00,507421,Fischer-Grunski; Eva K,18,0,20,2
1714615458210,LIGM 5B,A00,507423,Fischer-Grunski; Eva K,19,0,20,1
1714615459238,LIGM 5C,A00,507425,Fischer-Grunski; Eva K,19,0,20,1
1714615460266,LIIT 5AS,A00,507427,Carnelos; Chiara,20,0,20,0
1714615461294,LIIT 5BS,A00,507430,Carnelos; Chiara,20,0,20,0
1714615462321,LIIT 5CS,A00,507432,Carnelos; Chiara,20,0,20,0
1714615463347,LISP 5A,A00,507541,Munoz Sanchez; Alicia,11,0,20,9
1714615464372,LISP 5B,A00,507671,Munoz Sanchez; Alicia,8,0,20,12
1714615465396,LISP 5C,A00,507696,Munoz Sanchez; Alicia,9,0,20,11
1714615466426,MAE 197,001,528363,Boechler; Nicholas Sebastia,9998,0,9999,1
1714615467457,MATH 197,001,523477,Kedlaya; Kiran S.,9995,0,9999,4
1714615467457,MATH 197,002,563811,Zhang; Danna,9995,0,9999,4
1714615467457,MATH 197,003,628552,Dumitriu; Ioana,9998,0,9999,1
1714615468482,MCWP 40R,A00,518780,Staff,2,0,20,18
1714615468482,MCWP 40R,B00,518781,Staff,8,0,20,12
1714615468482,MCWP 40R,C00,518783,Staff,6,0,20,14
1714615469514,MCWP 50R,A00,518791,Staff,0,0,20,20
1714615469514,MCWP 50R,B00,518792,Staff,0,2,20,20
1714615469514,MCWP 50R,C00,518793,Staff,0,2,20,20
1714615469514,MCWP 50R,D00,518794,Staff,0,0,20,20
1714615469514,MCWP 50R,E00,518795,Staff,0,2,20,20
1714615469514,MCWP 50R,F00,518796,Staff,0,0,20,20
1714615469514,MCWP 50R,G00,518797,Staff,0,1,20,20
1714615470541,MMW 12R,A01,514034,Herbst; Matthew,0,0,16,16
1714615470541,MMW 12R,A02,514035,Herbst; Matthew,1,0,16,15
1714615471571,MMW 13R,A01,514037,Staff,0,4,16,16
1714615471571,MMW 13R,A02,514039,Staff,0,2,16,16
1714615471571,MMW 13R,A03,628519,Staff,0,2,16,16
1714615473626,SIO 295LS,A00,523233,Staff,10,0,30,20
1714615474650,SIO 295S,A00,523232,Staff,10,0,30,20
1714615475681,SIOC 290S,A01,637330,Merrifield; Mark A,23,0,30,7
1714615476709,SIOC 291S,A01,637333,Gabriel; Corey John,23,0,30,7
1714615477734,SOCI 117,A01,494376,Staff,0,4,5,5
1714615478760,WES 237B,A00,494380,Staff,9,0,20,11
1714615480833,AESE 279B,A00,494370,Wade; Jon P,0,0,33,33
1714615481857,AIP 197,001,627712,Vespa; Emanuel Ignacio,9998,0,9999,1
1714615482885,ANAR 135S,A00,494369,Braswell; Geoffrey E.,0,0,0,0
1714615483909,BENG 196,001,628496,Engler; Adam J.,9998,0,9999,1
1714615484938,CAT 124RS,A01,519847,Geibel; William,0,0,20,20
1714615485961,CAT 125RS,A01,515971,Geibel; William,0,0,20,20
1714615486992,CLRE 250,A00,511389,Morris; Sheldon,9993,0,9999,6
1714615488024,CLRE 251,A00,507176,Mehta; Ravindra L.,9993,0,9999,6
1714615488024,CLRE 251,B00,511410,Mehta; Ravindra L.,9998,0,9999,1
1714615489054,CLRE 252,A00,507189,Cuomo; Raphael Eduardo,9995,0,9999,4
1714615490135,CLRE 253,A00,507199,Vaida; Florin,9994,0,9999,5
1714615490135,CLRE 253,B00,507202,Vaida; Florin,9999,0,9999,0
1714615491160,CLRE 259,A00,507211,Patel; Hemal,9996,0,9999,3
1714615492185,CLRE 260,A00,507221,Cuomo; Raphael Eduardo,9999,0,9999,0
1714615493210,CLRE 297,001,507242,Cuomo; Raphael Eduardo,9999,0,9999,0
1714615494240,COGS 197,001,638244,Voytek; Bradley Thomas,9998,0,9999,1
1714615495266,CSE 191,A00,516875,Minnes Kemp; Mor Mia,9992,0,9999,7
1714615496294,CSE 197,001,637388,Minnes Kemp; Mor Mia,9998,0,9999,1
1714615497319,CSS 201S,A01,494383,Staff,35,0,35,0
1714615498345,CSS 202S,A01,494387,Staff,35,0,35,0
1714615499372,DSC 197,001,628532,Eldridge; Justin Matthew,9996,0,9999,3
1714615500396,EAP 100,A00,516065,Staff,9797,0,9999,202
1714615501422,ECE 45,A01,507414,Staff,33,0,60,27
1714615503477,ECE 111,A01,507420,Staff,15,0,50,35
1714615504502,ECE 197,001,548057,Sievenpiper; Daniel F.,9993,0,9999,6
1714615505529,EDS 115,A00,507243,Choi; Bailey Miyeon,10,0,28,18
1714615506554,EDS 117,A01,494379,Staff,1,5,30,29
1714615507583,EDS 125,A00,507246,Hopkins; Megan Beth,9,0,30,21
1714615508610,EDS 128A,A01,507264,Fargason; Sharon Gayle,8,0,26,18
1714615509636,EDS 128B,A01,507293,Pappas; Elizabeth,12,0,30,18
1714615510662,EDS 139,A00,507294,Fargason; Sharon Gayle,13,0,30,17
1714615510662,EDS 139,B00,507313,Pappas; Elizabeth,13,0,30,17
1714615511687,EDS 201,A00,507315,Staff,13,0,30,17
1714615512711,EDS 203,A01,507317,Halter; Christopher P.,12,0,30,18
1714615513740,EDS 204R,A01,507319,Halter; Christopher P.,0,3,30,30
1714615513740,EDS 204R,B01,507331,Heinzman; Erica M.,16,0,30,14
1714615514765,EDS 206R,A00,507332,Staff,0,4,30,30
1714615514765,EDS 206R,B00,507343,Staff,17,0,30,13
1714615515791,EDS 250,A00,507344,Hemans; Patricia Ann Benitez,22,0,40,18
1714615516816,EDS 281,A00,507345,Daly; Alan J.,18,0,18,0
1714615517841,EDS 284,A00,507350,Daly; Alan J.,16,0,16,0
1714615518869,EDS 286,A00,507359,Fine; Sarah,18,0,18,0
1714615519895,EDS 289C,A01,507361,Daly; Alan J.,18,0,18,0
1714615520920,EDS 290,A00,507366,Hofstetter; Carolyn,15,0,15,0
1714615521947,LIGM 5A,A00,507421,Fischer-Grunski; Eva K,18,0,20,2
1714615522972,LIGM 5B,A00,507423,Fischer-Grunski; Eva K,19,0,20,1
1714615523997,LIGM 5C,A00,507425,Fischer-Grunski; Eva K,19,0,20,1
1714615525022,LIIT 5AS,A00,507427,Carnelos; Chiara,20,0,20,0
1714615526049,LIIT 5BS,A00,507430,Carnelos; Chiara,20,0,20,0
1714615527074,LIIT 5CS,A00,507432,Carnelos; Chiara,20,0,20,0
1714615528103,LISP 5A,A00,507541,Munoz Sanchez; Alicia,11,0,20,9
1714615529127,LISP 5B,A00,507671,Munoz Sanchez; Alicia,8,0,20,12
1714615530156,LISP 5C,A00,507696,Munoz Sanchez; Alicia,9,0,20,11
1714615531182,MAE 197,001,528363,Boechler; Nicholas Sebastia,9998,0,9999,1
1714615532209,MATH 197,001,523477,Kedlaya; Kiran S.,9995,0,9999,4
1714615532209,MATH 197,002,563811,Zhang; Danna,9995,0,9999,4
1714615532209,MATH 197,003,628552,Dumitriu; Ioana,9998,0,9999,1
1714615533234,MCWP 40R,A00,518780,Staff,2,0,20,18
1714615533234,MCWP 40R,B00,518781,Staff,8,0,20,12
1714615533234,MCWP 40R,C00,518783,Staff,6,0,20,14
1714615534261,MCWP 50R,A00,518791,Staff,0,0,20,20
1714615534261,MCWP 50R,B00,518792,Staff,0,2,20,20
1714615534261,MCWP 50R,C00,518793,Staff,0,2,20,20
1714615534261,MCWP 50R,D00,518794,Staff,0,0,20,20
1714615534261,MCWP 50R,E00,518795,Staff,0,2,20,20
1714615534261,MCWP 50R,F00,518796,Staff,0,0,20,20
1714615534261,MCWP 50R,G00,518797,Staff,0,1,20,20
1714615535292,MMW 12R,A01,514034,Herbst; Matthew,0,0,16,16
1714615535292,MMW 12R,A02,514035,Herbst; Matthew,1,0,16,15
1714615536322,MMW 13R,A01,514037,Staff,0,4,16,16
1714615536322,MMW 13R,A02,514039,Staff,0,2,16,16
1714615536322,MMW 13R,A03,628519,Staff,0,2,16,16
1714615538373,SIO 295LS,A00,523233,Staff,10,0,30,20
1714615539400,SIO 295S,A00,523232,Staff,10,0,30,20
1714615540424,SIOC 290S,A01,637330,Merrifield; Mark A,23,0,30,7
1714615541454,SIOC 291S,A01,637333,Gabriel; Corey John,23,0,30,7
1714615542482,SOCI 117,A01,494376,Staff,0,4,5,5
1714615543508,WES 237B,A00,494380,Staff,9,0,20,11
1714615545577,AESE 279B,A00,494370,Wade; Jon P,0,0,33,33
1714615546607,AIP 197,001,627712,Vespa; Emanuel Ignacio,9998,0,9999,1
1714615547633,ANAR 135S,A00,494369,Braswell; Geoffrey E.,0,0,0,0
1714615548660,BENG 196,001,628496,Engler; Adam J.,9998,0,9999,1
1714615549689,CAT 124RS,A01,519847,Geibel; William,0,0,20,20
1714615550717,CAT 125RS,A01,515971,Geibel; William,0,0,20,20
1714615551742,CLRE 250,A00,511389,Morris; Sheldon,9993,0,9999,6
1714615552767,CLRE 251,A00,507176,Mehta; Ravindra L.,9993,0,9999,6
1714615552767,CLRE 251,B00,511410,Mehta; Ravindra L.,9998,0,9999,1
1714615553795,CLRE 252,A00,507189,Cuomo; Raphael Eduardo,9995,0,9999,4
1714615554821,CLRE 253,A00,507199,Vaida; Florin,9994,0,9999,5
1714615554821,CLRE 253,B00,507202,Vaida; Florin,9999,0,9999,0
1714615555848,CLRE 259,A00,507211,Patel; Hemal,9996,0,9999,3
1714615556876,CLRE 260,A00,507221,Cuomo; Raphael Eduardo,9999,0,9999,0
1714615557903,CLRE 297,001,507242,Cuomo; Raphael Eduardo,9999,0,9999,0
1714615558984,COGS 197,001,638244,Voytek; Bradley Thomas,9998,0,9999,1
1714615560011,CSE 191,A00,516875,Minnes Kemp; Mor Mia,9992,0,9999,7
1714615561040,CSE 197,001,637388,Minnes Kemp; Mor Mia,9998,0,9999,1
1714615562071,CSS 201S,A01,494383,Staff,35,0,35,0
1714615563102,CSS 202S,A01,494387,Staff,35,0,35,0
1714615564128,DSC 197,001,628532,Eldridge; Justin Matthew,9996,0,9999,3
1714615565152,EAP 100,A00,516065,Staff,9797,0,9999,202
1714615566178,ECE 45,A01,507414,Staff,33,0,60,27
1714615568231,ECE 111,A01,507420,Staff,15,0,50,35
1714615569257,ECE 197,001,548057,Sievenpiper; Daniel F.,9993,0,9999,6
1714615570285,EDS 115,A00,507243,Choi; Bailey Miyeon,10,0,28,18
1714615571311,EDS 117,A01,494379,Staff,1,5,30,29
1714615572339,EDS 125,A00,507246,Hopkins; Megan Beth,9,0,30,21
1714615573367,EDS 128A,A01,507264,Fargason; Sharon Gayle,8,0,26,18
1714615574394,EDS 128B,A01,507293,Pappas; Elizabeth,12,0,30,18
1714615575419,EDS 139,A00,507294,Fargason; Sharon Gayle,13,0,30,17
1714615575419,EDS 139,B00,507313,Pappas; Elizabeth,13,0,30,17
1714615576447,EDS 201,A00,507315,Staff,13,0,30,17
1714615577473,EDS 203,A01,507317,Halter; Christopher P.,12,0,30,18
1714615578503,EDS 204R,A01,507319,Halter; Christopher P.,0,3,30,30
1714615578503,EDS 204R,B01,507331,Heinzman; Erica M.,16,0,30,14
1714615579528,EDS 206R,A00,507332,Staff,0,4,30,30
1714615579528,EDS 206R,B00,507343,Staff,17,0,30,13
1714615580554,EDS 250,A00,507344,Hemans; Patricia Ann Benitez,22,0,40,18
1714615581579,EDS 281,A00,507345,Daly; Alan J.,18,0,18,0
1714615582604,EDS 284,A00,507350,Daly; Alan J.,16,0,16,0
1714615583631,EDS 286,A00,507359,Fine; Sarah,18,0,18,0
1714615584659,EDS 289C,A01,507361,Daly; Alan J.,18,0,18,0
1714615585683,EDS 290,A00,507366,Hofstetter; Carolyn,15,0,15,0
1714615586709,LIGM 5A,A00,507421,Fischer-Grunski; Eva K,18,0,20,2
1714615587734,LIGM 5B,A00,507423,Fischer-Grunski; Eva K,19,0,20,1
1714615588762,LIGM 5C,A00,507425,Fischer-Grunski; Eva K,19,0,20,1
1714615589792,LIIT 5AS,A00,507427,Carnelos; Chiara,20,0,20,0
1714615590819,LIIT 5BS,A00,507430,Carnelos; Chiara,20,0,20,0
1714615591844,LIIT 5CS,A00,507432,Carnelos; Chiara,20,0,20,0
1714615592870,LISP 5A,A00,507541,Munoz Sanchez; Alicia,11,0,20,9
1714615593895,LISP 5B,A00,507671,Munoz Sanchez; Alicia,8,0,20,12
1714615594920,LISP 5C,A00,507696,Munoz Sanchez; Alicia,9,0,20,11
1714615595950,MAE 197,001,528363,Boechler; Nicholas Sebastia,9998,0,9999,1
1714615596981,MATH 197,001,523477,Kedlaya; Kiran S.,9995,0,9999,4
1714615596981,MATH 197,002,563811,Zhang; Danna,9995,0,9999,4
1714615596981,MATH 197,003,628552,Dumitriu; Ioana,9998,0,9999,1
1714615598008,MCWP 40R,A00,518780,Staff,2,0,20,18
1714615598008,MCWP 40R,B00,518781,Staff,8,0,20,12
1714615598008,MCWP 40R,C00,518783,Staff,6,0,20,14
1714615599036,MCWP 50R,A00,518791,Staff,0,0,20,20
1714615599036,MCWP 50R,B00,518792,Staff,0,2,20,20
1714615599036,MCWP 50R,C00,518793,Staff,0,2,20,20
1714615599036,MCWP 50R,D00,518794,Staff,0,0,20,20
1714615599036,MCWP 50R,E00,518795,Staff,0,2,20,20
1714615599036,MCWP 50R,F00,518796,Staff,0,0,20,20
1714615599036,MCWP 50R,G00,518797,Staff,0,1,20,20
1714615600065,MMW 12R,A01,514034,Herbst; Matthew,0,0,16,16
1714615600065,MMW 12R,A02,514035,Herbst; Matthew,1,0,16,15
1714615601090,MMW 13R,A01,514037,Staff,0,4,16,16
1714615601090,MMW 13R,A02,514039,Staff,0,2,16,16
1714615601090,MMW 13R,A03,628519,Staff,0,2,16,16
1714615603142,SIO 295LS,A00,523233,Staff,10,0,30,20
1714615604170,SIO 295S,A00,523232,Staff,10,0,30,20
1714615605197,SIOC 290S,A01,637330,Merrifield; Mark A,23,0,30,7
1714615606223,SIOC 291S,A01,637333,Gabriel; Corey John,23,0,30,7
1714615607250,SOCI 117,A01,494376,Staff,0,4,5,5
1714615608274,WES 237B,A00,494380,Staff,9,0,20,11
1714615610343,AESE 279B,A00,494370,Wade; Jon P,0,0,33,33
1714615611371,AIP 197,001,627712,Vespa; Emanuel Ignacio,9998,0,9999,1
1714615612395,ANAR 135S,A00,494369,Braswell; Geoffrey E.,0,0,0,0
1714615613420,BENG 196,001,628496,Engler; Adam J.,9998,0,9999,1
1714615614446,CAT 124RS,A01,519847,Geibel; William,0,0,20,20
1714615615469,CAT 125RS,A01,515971,Geibel; William,0,0,20,20
1714615616499,CLRE 250,A00,511389,Morris; Sheldon,9993,0,9999,6
1714615617527,CLRE 251,A00,507176,Mehta; Ravindra L.,9993,0,9999,6
1714615617527,CLRE 251,B00,511410,Mehta; Ravindra L.,9998,0,9999,1
1714615618552,CLRE 252,A00,507189,Cuomo; Raphael Eduardo,9995,0,9999,4
1714615619577,CLRE 253,A00,507199,Vaida; Florin,9994,0,9999,5
1714615619577,CLRE 253,B00,507202,Vaida; Florin,9999,0,9999,0
1714615620602,CLRE 259,A00,507211,Patel; Hemal,9996,0,9999,3
1714615621630,CLRE 260,A00,507221,Cuomo; Raphael Eduardo,9999,0,9999,0
1714615622657,CLRE 297,001,507242,Cuomo; Raphael Eduardo,9999,0,9999,0
1714615623683,COGS 197,001,638244,Voytek; Bradley Thomas,9998,0,9999,1
1714615624707,CSE 191,A00,516875,Minnes Kemp; Mor Mia,9992,0,9999,7
1714615625735,CSE 197,001,637388,Minnes Kemp; Mor Mia,9998,0,9999,1
1714615626764,CSS 201S,A01,494383,Staff,35,0,35,0
1714615627793,CSS 202S,A01,494387,Staff,35,0,35,0
1714615628818,DSC 197,001,628532,Eldridge; Justin Matthew,9996,0,9999,3
1714615629845,EAP 100,A00,516065,Staff,9797,0,9999,202
1714615630875,ECE 45,A01,507414,Staff,33,0,60,27
1714615632929,ECE 111,A01,507420,Staff,15,0,50,35
1714615633958,ECE 197,001,548057,Sievenpiper; Daniel F.,9993,0,9999,6
1714615634985,EDS 115,A00,507243,Choi; Bailey Miyeon,10,0,28,18
1714615636010,EDS 117,A01,494379,Staff,1,5,30,29
1714615637037,EDS 125,A00,507246,Hopkins; Megan Beth,9,0,30,21
1714615638065,EDS 128A,A01,507264,Fargason; Sharon Gayle,8,0,26,18
1714615639094,EDS 128B,A01,507293,Pappas; Elizabeth,12,0,30,18
1714615640120,EDS 139,A00,507294,Fargason; Sharon Gayle,13,0,30,17
1714615640120,EDS 139,B00,507313,Pappas; Elizabeth,13,0,30,17
1714615641146,EDS 201,A00,507315,Staff,13,0,30,17
1714615642171,EDS 203,A01,507317,Halter; Christopher P.,12,0,30,18
1714615643197,EDS 204R,A01,507319,Halter; Christopher P.,0,3,30,30
1714615643197,EDS 204R,B01,507331,Heinzman; Erica M.,16,0,30,14
1714615644223,EDS 206R,A00,507332,Staff,0,4,30,30
1714615644223,EDS 206R,B00,507343,Staff,17,0,30,13
1714615645247,EDS 250,A00,507344,Hemans; Patricia Ann Benitez,22,0,40,18
1714615646272,EDS 281,A00,507345,Daly; Alan J.,18,0,18,0
1714615647298,EDS 284,A00,507350,Daly; Alan J.,16,0,16,0
1714615648323,EDS 286,A00,507359,Fine; Sarah,18,0,18,0
1714615649348,EDS 289C,A01,507361,Daly; Alan J.,18,0,18,0
1714615650374,EDS 290,A00,507366,Hofstetter; Carolyn,15,0,15,0
1714615651405,LIGM 5A,A00,507421,Fischer-Grunski; Eva K,18,0,20,2
1714615652430,LIGM 5B,A00,507423,Fischer-Grunski; Eva K,19,0,20,1
1714615653455,LIGM 5C,A00,507425,Fischer-Grunski; Eva K,19,0,20,1
1714615654485,LIIT 5AS,A00,507427,Carnelos; Chiara,20,0,20,0
1714615655514,LIIT 5BS,A00,507430,Carnelos; Chiara,20,0,20,0
1714615656543,LIIT 5CS,A00,507432,Carnelos; Chiara,20,0,20,0
1714615657572,LISP 5A,A00,507541,Munoz Sanchez; Alicia,11,0,20,9
1714615658596,LISP 5B,A00,507671,Munoz Sanchez; Alicia,8,0,20,12
1714615659626,LISP 5C,A00,507696,Munoz Sanchez; Alicia,9,0,20,11
1714615660651,MAE 197,001,528363,Boechler; Nicholas Sebastia,9998,0,9999,1
1714615661691,MATH 197,001,523477,Kedlaya; Kiran S.,9995,0,9999,4
1714615661691,MATH 197,002,563811,Zhang; Danna,9995,0,9999,4
1714615661691,MATH 197,003,628552,Dumitriu; Ioana,9998,0,9999,1
1714615662769,MCWP 40R,A00,518780,Staff,2,0,20,18
1714615662769,MCWP 40R,B00,518781,Staff,8,0,20,12
1714615662769,MCWP 40R,C00,518783,Staff,6,0,20,14
1714615663795,MCWP 50R,A00,518791,Staff,0,0,20,20
1714615663795,MCWP 50R,B00,518792,Staff,0,2,20,20
1714615663795,MCWP 50R,C00,518793,Staff,0,2,20,20
1714615663795,MCWP 50R,D00,518794,Staff,0,0,20,20
1714615663795,MCWP 50R,E00,518795,Staff,0,2,20,20
1714615663795,MCWP 50R,F00,518796,Staff,0,0,20,20
1714615663795,MCWP 50R,G00,518797,Staff,0,1,20,20
1714615664822,MMW 12R,A01,514034,Herbst; Matthew,0,0,16,16
1714615664822,MMW 12R,A02,514035,Herbst; Matthew,1,0,16,15
1714615665845,MMW 13R,A01,514037,Staff,0,4,16,16
1714615665845,MMW 13R,A02,514039,Staff,0,2,16,16
1714615665845,MMW 13R,A03,628519,Staff,0,2,16,16
1714615667900,SIO 295LS,A00,523233,Staff,10,0,30,20
1714615668924,SIO 295S,A00,523232,Staff,10,0,30,20
1714615669949,SIOC 290S,A01,637330,Merrifield; Mark A,23,0,30,7
1714615670977,SIOC 291S,A01,637333,Gabriel; Corey John,23,0,30,7
1714615672006,SOCI 117,A01,494376,Staff,0,4,5,5
1714615673030,WES 237B,A00,494380,Staff,9,0,20,11
1714615675094,AESE 279B,A00,494370,Wade; Jon P,0,0,33,33
1714615676124,AIP 197,001,627712,Vespa; Emanuel Ignacio,9998,0,9999,1
1714615677152,ANAR 135S,A00,494369,Braswell; Geoffrey E.,0,0,0,0
1714615678176,BENG 196,001,628496,Engler; Adam J.,9998,0,9999,1
1714615679205,CAT 124RS,A01,519847,Geibel; William,0,0,20,20
1714615680230,CAT 125RS,A01,515971,Geibel; William,0,0,20,20
1714615681257,CLRE 250,A00,511389,Morris; Sheldon,9993,0,9999,6
1714615682284,CLRE 251,A00,507176,Mehta; Ravindra L.,9993,0,9999,6
1714615682284,CLRE 251,B00,511410,Mehta; Ravindra L.,9998,0,9999,1
1714615683310,CLRE 252,A00,507189,Cuomo; Raphael Eduardo,9995,0,9999,4
1714615684335,CLRE 253,A00,507199,Vaida; Florin,9994,0,9999,5
1714615684335,CLRE 253,B00,507202,Vaida; Florin,9999,0,9999,0
1714615685360,CLRE 259,A00,507211,Patel; Hemal,9996,0,9999,3
1714615686387,CLRE 260,A00,507221,Cuomo; Raphael Eduardo,9999,0,9999,0
1714615687410,CLRE 297,001,507242,Cuomo; Raphael Eduardo,9999,0,9999,0
1714615688436,COGS 197,001,638244,Voytek; Bradley Thomas,9998,0,9999,1
1714615689464,CSE 191,A00,516875,Minnes Kemp; Mor Mia,9992,0,9999,7
1714615690490,CSE 197,001,637388,Minnes Kemp; Mor Mia,9998,0,9999,1
1714615691518,CSS 201S,A01,494383,Staff,35,0,35,0
1714615692544,CSS 202S,A01,494387,Staff,35,0,35,0
1714615693569,DSC 197,001,628532,Eldridge; Justin Matthew,9996,0,9999,3
1714615694594,EAP 100,A00,516065,Staff,9797,0,9999,202
1714615695619,ECE 45,A01,507414,Staff,33,0,60,27
1714615697670,ECE 111,A01,507420,Staff,15,0,50,35
1714615698700,ECE 197,001,548057,Sievenpiper; Daniel F.,9993,0,9999,6
1714615699726,EDS 115,A00,507243,Choi; Bailey Miyeon,10,0,28,18
1714615700754,EDS 117,A01,494379,Staff,1,5,30,29
1714615701781,EDS 125,A00,507246,Hopkins; Megan Beth,9,0,30,21
1714615702810,EDS 128A,A01,507264,Fargason; Sharon Gayle,8,0,26,18
1714615703836,EDS 128B,A01,507293,Pappas; Elizabeth,12,0,30,18
1714615704862,EDS 139,A00,507294,Fargason; Sharon Gayle,13,0,30,17
1714615704862,EDS 139,B00,507313,Pappas; Elizabeth,13,0,30,17
1714615705887,EDS 201,A00,507315,Staff,13,0,30,17
1714615706915,EDS 203,A01,507317,Halter; Christopher P.,12,0,30,18
1714615707940,EDS 204R,A01,507319,Halter; Christopher P.,0,3,30,30
1714615707940,EDS 204R,B01,507331,Heinzman; Erica M.,16,0,30,14
1714615708966,EDS 206R,A00,507332,Staff,0,4,30,30
1714615708966,EDS 206R,B00,507343,Staff,17,0,30,13
1714615709993,EDS 250,A00,507344,Hemans; Patricia Ann Benitez,22,0,40,18
1714615711018,EDS 281,A00,507345,Daly; Alan J.,18,0,18,0
1714615712042,EDS 284,A00,507350,Daly; Alan J.,16,0,16,0
1714615713067,EDS 286,A00,507359,Fine; Sarah,18,0,18,0
1714615714097,EDS 289C,A01,507361,Daly; Alan J.,18,0,18,0
1714615715124,EDS 290,A00,507366,Hofstetter; Carolyn,15,0,15,0
1714615716153,LIGM 5A,A00,507421,Fischer-Grunski; Eva K,18,0,20,2
1714615717180,LIGM 5B,A00,507423,Fischer-Grunski; Eva K,19,0,20,1
1714615718204,LIGM 5C,A00,507425,Fischer-Grunski; Eva K,19,0,20,1
1714615719230,LIIT 5AS,A00,507427,Carnelos; Chiara,20,0,20,0
1714615720254,LIIT 5BS,A00,507430,Carnelos; Chiara,20,0,20,0
1714615721283,LIIT 5CS,A00,507432,Carnelos; Chiara,20,0,20,0
1714615722310,LISP 5A,A00,507541,Munoz Sanchez; Alicia,11,0,20,9
1714615723339,LISP 5B,A00,507671,Munoz Sanchez; Alicia,8,0,20,12
1714615724365,LISP 5C,A00,507696,Munoz Sanchez; Alicia,9,0,20,11
1714615725391,MAE 197,001,528363,Boechler; Nicholas Sebastia,9998,0,9999,1
1714615726422,MATH 197,001,523477,Kedlaya; Kiran S.,9995,0,9999,4
1714615726422,MATH 197,002,563811,Zhang; Danna,9995,0,9999,4
1714615726422,MATH 197,003,628552,Dumitriu; Ioana,9998,0,9999,1
1714615727448,MCWP 40R,A00,518780,Staff,2,0,20,18
1714615727448,MCWP 40R,B00,518781,Staff,8,0,20,12
1714615727448,MCWP 40R,C00,518783,Staff,6,0,20,14
1714615728472,MCWP 50R,A00,518791,Staff,0,0,20,20
1714615728472,MCWP 50R,B00,518792,Staff,0,2,20,20
1714615728472,MCWP 50R,C00,518793,Staff,0,2,20,20
1714615728472,MCWP 50R,D00,518794,Staff,0,0,20,20
1714615728472,MCWP 50R,E00,518795,Staff,0,2,20,20
1714615728472,MCWP 50R,F00,518796,Staff,0,0,20,20
1714615728472,MCWP 50R,G00,518797,Staff,0,1,20,20
1714615729500,MMW 12R,A01,514034,Herbst; Matthew,0,0,16,16
1714615729500,MMW 12R,A02,514035,Herbst; Matthew,1,0,16,15
1714615730527,MMW 13R,A01,514037,Staff,0,4,16,16
1714615730527,MMW 13R,A02,514039,Staff,0,2,16,16
1714615730527,MMW 13R,A03,628519,Staff,0,2,16,16
1714615732577,SIO 295LS,A00,523233,Staff,10,0,30,20
1714615733604,SIO 295S,A00,523232,Staff,10,0,30,20
1714615734634,SIOC 290S,A01,637330,Merrifield; Mark A,23,0,30,7
1714615735659,SIOC 291S,A01,637333,Gabriel; Corey John,23,0,30,7
1714615736687,SOCI 117,A01,494376,Staff,0,4,5,5
1714615737716,WES 237B,A00,494380,Staff,9,0,20,11
1714615739785,AESE 279B,A00,494370,Wade; Jon P,0,0,33,33
1714615740816,AIP 197,001,627712,Vespa; Emanuel Ignacio,9998,0,9999,1
1714615741844,ANAR 135S,A00,494369,Braswell; Geoffrey E.,0,0,0,0
1714615742870,BENG 196,001,628496,Engler; Adam J.,9998,0,9999,1
1714615743895,CAT 124RS,A01,519847,Geibel; William,0,0,20,20
1714615744920,CAT 125RS,A01,515971,Geibel; William,0,0,20,20
1714615745947,CLRE 250,A00,511389,Morris; Sheldon,9993,0,9999,6
1714615746975,CLRE 251,A00,507176,Mehta; Ravindra L.,9993,0,9999,6
1714615746975,CLRE 251,B00,511410,Mehta; Ravindra L.,9998,0,9999,1
1714615748005,CLRE 252,A00,507189,Cuomo; Raphael Eduardo,9995,0,9999,4
1714615749035,CLRE 253,A00,507199,Vaida; Florin,9994,0,9999,5
1714615749035,CLRE 253,B00,507202,Vaida; Florin,9999,0,9999,0
1714615750061,CLRE 259,A00,507211,Patel; Hemal,9996,0,9999,3
1714615751090,CLRE 260,A00,507221,Cuomo; Raphael Eduardo,9999,0,9999,0
1714615752115,CLRE 297,001,507242,Cuomo; Raphael Eduardo,9999,0,9999,0
1714615753142,COGS 197,001,638244,Voytek; Bradley Thomas,9998,0,9999,1
1714615754169,CSE 191,A00,516875,Minnes Kemp; Mor Mia,9992,0,9999,7
1714615755197,CSE 197,001,637388,Minnes Kemp; Mor Mia,9998,0,9999,1
1714615756223,CSS 201S,A01,494383,Staff,35,0,35,0
1714615757251,CSS 202S,A01,494387,Staff,35,0,35,0
1714615758278,DSC 197,001,628532,Eldridge; Justin Matthew,9996,0,9999,3
1714615759307,EAP 100,A00,516065,Staff,9797,0,9999,202
1714615760333,ECE 45,A01,507414,Staff,33,0,60,27
1714615762382,ECE 111,A01,507420,Staff,15,0,50,35
1714615763407,ECE 197,001,548057,Sievenpiper; Daniel F.,9993,0,9999,6
1714615764435,EDS 115,A00,507243,Choi; Bailey Miyeon,10,0,28,18
1714615765460,EDS 117,A01,494379,Staff,1,5,30,29
1714615766489,EDS 125,A00,507246,Hopkins; Megan Beth,9,0,30,21
1714615767516,EDS 128A,A01,507264,Fargason; Sharon Gayle,8,0,26,18
1714615768543,EDS 128B,A01,507293,Pappas; Elizabeth,12,0,30,18
1714615769569,EDS 139,A00,507294,Fargason; Sharon Gayle,13,0,30,17
1714615769569,EDS 139,B00,507313,Pappas; Elizabeth,13,0,30,17
1714615770597,EDS 201,A00,507315,Staff,13,0,30,17
1714615771623,EDS 203,A01,507317,Halter; Christopher P.,12,0,30,18
1714615772649,EDS 204R,A01,507319,Halter; Christopher P.,0,3,30,30
1714615772649,EDS 204R,B01,507331,Heinzman; Erica M.,16,0,30,14
1714615773678,EDS 206R,A00,507332,Staff,0,4,30,30
1714615773678,EDS 206R,B00,507343,Staff,17,0,30,13
1714615774703,EDS 250,A00,507344,Hemans; Patricia Ann Benitez,22,0,40,18
1714615775728,EDS 281,A00,507345,Daly; Alan J.,18,0,18,0
1714615776756,EDS 284,A00,507350,Daly; Alan J.,16,0,16,0
1714615777784,EDS 286,A00,507359,Fine; Sarah,18,0,18,0
1714615778810,EDS 289C,A01,507361,Daly; Alan J.,18,0,18,0
1714615779841,EDS 290,A00,507366,Hofstetter; Carolyn,15,0,15,0
1714615780871,LIGM 5A,A00,507421,Fischer-Grunski; Eva K,18,0,20,2
1714615781899,LIGM 5B,A00,507423,Fischer-Grunski; Eva K,19,0,20,1
1714615782925,LIGM 5C,A00,507425,Fischer-Grunski; Eva K,19,0,20,1
1714615783951,LIIT 5AS,A00,507427,Carnelos; Chiara,20,0,20,0
1714615784980,LIIT 5BS,A00,507430,Carnelos; Chiara,20,0,20,0
1714615786010,LIIT 5CS,A00,507432,Carnelos; Chiara,20,0,20,0
1714615787043,LISP 5A,A00,507541,Munoz Sanchez; Alicia,11,0,20,9
1714615788067,LISP 5B,A00,507671,Munoz Sanchez; Alicia,8,0,20,12
1714615789094,LISP 5C,A00,507696,Munoz Sanchez; Alicia,9,0,20,11
1714615790122,MAE 197,001,528363,Boechler; Nicholas Sebastia,9998,0,9999,1
1714615791148,MATH 197,001,523477,Kedlaya; Kiran S.,9995,0,9999,4
1714615791148,MATH 197,002,563811,Zhang; Danna,9995,0,9999,4
1714615791148,MATH 197,003,628552,Dumitriu; Ioana,9998,0,9999,1
1714615792175,MCWP 40R,A00,518780,Staff,2,0,20,18
1714615792175,MCWP 40R,B00,518781,Staff,8,0,20,12
1714615792175,MCWP 40R,C00,518783,Staff,6,0,20,14
1714615793206,MCWP 50R,A00,518791,Staff,0,0,20,20
1714615793206,MCWP 50R,B00,518792,Staff,0,2,20,20
1714615793206,MCWP 50R,C00,518793,Staff,0,2,20,20
1714615793206,MCWP 50R,D00,518794,Staff,0,0,20,20
1714615793206,MCWP 50R,E00,518795,Staff,0,2,20,20
1714615793206,MCWP 50R,F00,518796,Staff,0,0,20,20
1714615793206,MCWP 50R,G00,518797,Staff,0,1,20,20
1714615794233,MMW 12R,A01,514034,Herbst; Matthew,0,0,16,16
1714615794233,MMW 12R,A02,514035,Herbst; Matthew,1,0,16,15
1714615795258,MMW 13R,A01,514037,Staff,0,4,16,16
1714615795258,MMW 13R,A02,514039,Staff,0,2,16,16
1714615795258,MMW 13R,A03,628519,Staff,0,2,16,16
1714615797306,SIO 295LS,A00,523233,Staff,10,0,30,20
1714615798334,SIO 295S,A00,523232,Staff,10,0,30,20
1714615799367,SIOC 290S,A01,637330,Merrifield; Mark A,23,0,30,7
1714615800392,SIOC 291S,A01,637333,Gabriel; Corey John,23,0,30,7
1714615801422,SOCI 117,A01,494376,Staff,0,4,5,5
1714615802447,WES 237B,A00,494380,Staff,9,0,20,11
1714615804517,AESE 279B,A00,494370,Wade; Jon P,0,0,33,33
1714615805547,AIP 197,001,627712,Vespa; Emanuel Ignacio,9998,0,9999,1
1714615806573,ANAR 135S,A00,494369,Braswell; Geoffrey E.,0,0,0,0
1714615807598,BENG 196,001,628496,Engler; Adam J.,9998,0,9999,1
1714615808624,CAT 124RS,A01,519847,Geibel; William,0,0,20,20
1714615809651,CAT 125RS,A01,515971,Geibel; William,0,0,20,20
1714615810678,CLRE 250,A00,511389,Morris; Sheldon,9993,0,9999,6
1714615811707,CLRE 251,A00,507176,Mehta; Ravindra L.,9993,0,9999,6
1714615811707,CLRE 251,B00,511410,Mehta; Ravindra L.,9998,0,9999,1
1714615812736,CLRE 252,A00,507189,Cuomo; Raphael Eduardo,9995,0,9999,4
1714615813763,CLRE 253,A00,507199,Vaida; Florin,9994,0,9999,5
1714615813763,CLRE 253,B00,507202,Vaida; Florin,9999,0,9999,0
1714615814788,CLRE 259,A00,507211,Patel; Hemal,9996,0,9999,3
1714615815813,CLRE 260,A00,507221,Cuomo; Raphael Eduardo,9999,0,9999,0
1714615816844,CLRE 297,001,507242,Cuomo; Raphael Eduardo,9999,0,9999,0
1714615817872,COGS 197,001,638244,Voytek; Bradley Thomas,9998,0,9999,1
1714615818897,CSE 191,A00,516875,Minnes Kemp; Mor Mia,9992,0,9999,7
1714615819922,CSE 197,001,637388,Minnes Kemp; Mor Mia,9998,0,9999,1
1714615820955,CSS 201S,A01,494383,Staff,35,0,35,0
1714615821984,CSS 202S,A01,494387,Staff,35,0,35,0
1714615823008,DSC 197,001,628532,Eldridge; Justin Matthew,9996,0,9999,3
1714615824034,EAP 100,A00,516065,Staff,9797,0,9999,202
1714615825063,ECE 45,A01,507414,Staff,33,0,60,27
1714615827115,ECE 111,A01,507420,Staff,15,0,50,35
1714615828143,ECE 197,001,548057,Sievenpiper; Daniel F.,9993,0,9999,6
1714615829169,EDS 115,A00,507243,Choi; Bailey Miyeon,10,0,28,18
1714615830195,EDS 117,A01,494379,Staff,1,5,30,29
1714615831219,EDS 125,A00,507246,Hopkins; Megan Beth,9,0,30,21
1714615832245,EDS 128A,A01,507264,Fargason; Sharon Gayle,8,0,26,18
1714615833275,EDS 128B,A01,507293,Pappas; Elizabeth,12,0,30,18
1714615834301,EDS 139,A00,507294,Fargason; Sharon Gayle,13,0,30,17
1714615834301,EDS 139,B00,507313,Pappas; Elizabeth,13,0,30,17
1714615835325,EDS 201,A00,507315,Staff,13,0,30,17
1714615836350,EDS 203,A01,507317,Halter; Christopher P.,12,0,30,18
1714615837375,EDS 204R,A01,507319,Halter; Christopher P.,0,3,30,30
1714615837375,EDS 204R,B01,507331,Heinzman; Erica M.,16,0,30,14
1714615838401,EDS 206R,A00,507332,Staff,0,4,30,30
1714615838401,EDS 206R,B00,507343,Staff,17,0,30,13
1714615839427,EDS 250,A00,507344,Hemans; Patricia Ann Benitez,22,0,40,18
1714615840454,EDS 281,A00,507345,Daly; Alan J.,18,0,18,0
1714615841480,EDS 284,A00,507350,Daly; Alan J.,16,0,16,0
1714615842505,EDS 286,A00,507359,Fine; Sarah,18,0,18,0
1714615843534,EDS 289C,A01,507361,Daly; Alan J.,18,0,18,0
1714615844560,EDS 290,A00,507366,Hofstetter; Carolyn,15,0,15,0
1714615845586,LIGM 5A,A00,507421,Fischer-Grunski; Eva K,18,0,20,2
1714615846610,LIGM 5B,A00,507423,Fischer-Grunski; Eva K,19,0,20,1
1714615847637,LIGM 5C,A00,507425,Fischer-Grunski; Eva K,19,0,20,1
1714615848663,LIIT 5AS,A00,507427,Carnelos; Chiara,20,0,20,0
1714615849687,LIIT 5BS,A00,507430,Carnelos; Chiara,20,0,20,0
1714615850714,LIIT 5CS,A00,507432,Carnelos; Chiara,20,0,20,0
1714615851742,LISP 5A,A00,507541,Munoz Sanchez; Alicia,11,0,20,9
1714615852771,LISP 5B,A00,507671,Munoz Sanchez; Alicia,8,0,20,12
1714615853799,LISP 5C,A00,507696,Munoz Sanchez; Alicia,9,0,20,11
1714615854825,MAE 197,001,528363,Boechler; Nicholas Sebastia,9998,0,9999,1
1714615855861,MATH 197,001,523477,Kedlaya; Kiran S.,9995,0,9999,4
1714615855861,MATH 197,002,563811,Zhang; Danna,9995,0,9999,4
1714615855861,MATH 197,003,628552,Dumitriu; Ioana,9998,0,9999,1
1714615856889,MCWP 40R,A00,518780,Staff,2,0,20,18
1714615856889,MCWP 40R,B00,518781,Staff,8,0,20,12
1714615856889,MCWP 40R,C00,518783,Staff,6,0,20,14
1714615857915,MCWP 50R,A00,518791,Staff,0,0,20,20
1714615857915,MCWP 50R,B00,518792,Staff,0,2,20,20
1714615857915,MCWP 50R,C00,518793,Staff,0,2,20,20
1714615857915,MCWP 50R,D00,518794,Staff,0,0,20,20
1714615857915,MCWP 50R,E00,518795,Staff,0,2,20,20
1714615857915,MCWP 50R,F00,518796,Staff,0,0,20,20
1714615857915,MCWP 50R,G00,518797,Staff,0,1,20,20
1714615858941,MMW 12R,A01,514034,Herbst; Matthew,0,0,16,16
1714615858941,MMW 12R,A02,514035,Herbst; Matthew,1,0,16,15
1714615859966,MMW 13R,A01,514037,Staff,0,4,16,16
1714615859966,MMW 13R,A02,514039,Staff,0,2,16,16
1714615859966,MMW 13R,A03,628519,Staff,0,2,16,16
1714615862076,SIO 295LS,A00,523233,Staff,10,0,30,20
1714615863103,SIO 295S,A00,523232,Staff,10,0,30,20
1714615864135,SIOC 290S,A01,637330,Merrifield; Mark A,23,0,30,7
1714615865166,SIOC 291S,A01,637333,Gabriel; Corey John,23,0,30,7
1714615866190,SOCI 117,A01,494376,Staff,0,4,5,5
1714615867219,WES 237B,A00,494380,Staff,9,0,20,11
1714615869290,AESE 279B,A00,494370,Wade; Jon P,0,0,33,33
1714615870316,AIP 197,001,627712,Vespa; Emanuel Ignacio,9998,0,9999,1
1714615871342,ANAR 135S,A00,494369,Braswell; Geoffrey E.,0,0,0,0
1714615872368,BENG 196,001,628496,Engler; Adam J.,9998,0,9999,1
1714615873400,CAT 124RS,A01,519847,Geibel; William,0,0,20,20
1714615874429,CAT 125RS,A01,515971,Geibel; William,0,0,20,20
1714615875457,CLRE 250,A00,511389,Morris; Sheldon,9993,0,9999,6
1714615876486,CLRE 251,A00,507176,Mehta; Ravindra L.,9993,0,9999,6
1714615876486,CLRE 251,B00,511410,Mehta; Ravindra L.,9998,0,9999,1
1714615877512,CLRE 252,A00,507189,Cuomo; Raphael Eduardo,9995,0,9999,4
1714615878541,CLRE 253,A00,507199,Vaida; Florin,9994,0,9999,5
1714615878541,CLRE 253,B00,507202,Vaida; Florin,9999,0,9999,0
1714615879570,CLRE 259,A00,507211,Patel; Hemal,9996,0,9999,3
1714615880595,CLRE 260,A00,507221,Cuomo; Raphael Eduardo,9999,0,9999,0
1714615881619,CLRE 297,001,507242,Cuomo; Raphael Eduardo,9999,0,9999,0
1714615882648,COGS 197,001,638244,Voytek; Bradley Thomas,9998,0,9999,1
1714615883672,CSE 191,A00,516875,Minnes Kemp; Mor Mia,9992,0,9999,7
1714615884700,CSE 197,001,637388,Minnes Kemp; Mor Mia,9998,0,9999,1
1714615885729,CSS 201S,A01,494383,Staff,35,0,35,0
1714615886757,CSS 202S,A01,494387,Staff,35,0,35,0
1714615887784,DSC 197,001,628532,Eldridge; Justin Matthew,9996,0,9999,3
1714615888812,EAP 100,A00,516065,Staff,9797,0,9999,202
1714615889837,ECE 45,A01,507414,Staff,33,0,60,27
1714615891893,ECE 111,A01,507420,Staff,15,0,50,35
1714615892917,ECE 197,001,548057,Sievenpiper; Daniel F.,9993,0,9999,6
1714615893943,EDS 115,A00,507243,Choi; Bailey Miyeon,10,0,28,18
1714615894969,EDS 117,A01,494379,Staff,1,5,30,29
1714615895998,EDS 125,A00,507246,Hopkins; Megan Beth,9,0,30,21
1714615897022,EDS 128A,A01,507264,Fargason; Sharon Gayle,8,0,26,18
1714615898051,EDS 128B,A01,507293,Pappas; Elizabeth,12,0,30,18
1714615899076,EDS 139,A00,507294,Fargason; Sharon Gayle,13,0,30,17
1714615899076,EDS 139,B00,507313,Pappas; Elizabeth,13,0,30,17
1714615900105,EDS 201,A00,507315,Staff,13,0,30,17
1714615901130,EDS 203,A01,507317,Halter; Christopher P.,12,0,30,18
1714615902157,EDS 204R,A01,507319,Halter; Christopher P.,0,3,30,30
1714615902157,EDS 204R,B01,507331,Heinzman; Erica M.,16,0,30,14
1714615903182,EDS 206R,A00,507332,Staff,0,4,30,30
1714615903182,EDS 206R,B00,507343,Staff,17,0,30,13
1714615904207,EDS 250,A00,507344,Hemans; Patricia Ann Benitez,22,0,40,18
1714615905235,EDS 281,A00,507345,Daly; Alan J.,18,0,18,0
1714615906260,EDS 284,A00,507350,Daly; Alan J.,16,0,16,0
1714615907286,EDS 286,A00,507359,Fine; Sarah,18,0,18,0
1714615908310,EDS 289C,A01,507361,Daly; Alan J.,18,0,18,0
1714615909336,EDS 290,A00,507366,Hofstetter; Carolyn,15,0,15,0
1714615910363,LIGM 5A,A00,507421,Fischer-Grunski; Eva K,18,0,20,2
1714615911390,LIGM 5B,A00,507423,Fischer-Grunski; Eva K,19,0,20,1
1714615912414,LIGM 5C,A00,507425,Fischer-Grunski; Eva K,19,0,20,1
1714615913443,LIIT 5AS,A00,507427,Carnelos; Chiara,20,0,20,0
1714615914467,LIIT 5BS,A00,507430,Carnelos; Chiara,20,0,20,0
1714615915496,LIIT 5CS,A00,507432,Carnelos; Chiara,20,0,20,0
1714615916522,LISP 5A,A00,507541,Munoz Sanchez; Alicia,11,0,20,9
1714615917547,LISP 5B,A00,507671,Munoz Sanchez; Alicia,8,0,20,12
1714615918575,LISP 5C,A00,507696,Munoz Sanchez; Alicia,9,0,20,11
1714615919605,MAE 197,001,528363,Boechler; Nicholas Sebastia,9998,0,9999,1
1714615920631,MATH 197,001,523477,Kedlaya; Kiran S.,9995,0,9999,4
1714615920631,MATH 197,002,563811,Zhang; Danna,9995,0,9999,4
1714615920631,MATH 197,003,628552,Dumitriu; Ioana,9998,0,9999,1
1714615921666,MCWP 40R,A00,518780,Staff,2,0,20,18
1714615921666,MCWP 40R,B00,518781,Staff,8,0,20,12
1714615921666,MCWP 40R,C00,518783,Staff,6,0,20,14
1714615922691,MCWP 50R,A00,518791,Staff,0,0,20,20
1714615922691,MCWP 50R,B00,518792,Staff,0,2,20,20
1714615922691,MCWP 50R,C00,518793,Staff,0,2,20,20
1714615922691,MCWP 50R,D00,518794,Staff,0,0,20,20
1714615922691,MCWP 50R,E00,518795,Staff,0,2,20,20
1714615922691,MCWP 50R,F00,518796,Staff,0,0,20,20
1714615922691,MCWP 50R,G00,518797,Staff,0,1,20,20
1714615923720,MMW 12R,A01,514034,Herbst; Matthew,0,0,16,16
1714615923720,MMW 12R,A02,514035,Herbst; Matthew,1,0,16,15
1714615924745,MMW 13R,A01,514037,Staff,0,4,16,16
1714615924745,MMW 13R,A02,514039,Staff,0,2,16,16
1714615924745,MMW 13R,A03,628519,Staff,0,2,16,16
1714615926799,SIO 295LS,A00,523233,Staff,10,0,30,20
1714615927827,SIO 295S,A00,523232,Staff,10,0,30,20
1714615928855,SIOC 290S,A01,637330,Merrifield; Mark A,23,0,30,7
1714615929886,SIOC 291S,A01,637333,Gabriel; Corey John,23,0,30,7
1714615930912,SOCI 117,A01,494376,Staff,0,4,5,5
1714615931940,WES 237B,A00,494380,Staff,9,0,20,11
1714615934020,AESE 279B,A00,494370,Wade; Jon P,0,0,33,33
1714615935048,AIP 197,001,627712,Vespa; Emanuel Ignacio,9998,0,9999,1
1714615936075,ANAR 135S,A00,494369,Braswell; Geoffrey E.,0,0,0,0
1714615937102,BENG 196,001,628496,Engler; Adam J.,9998,0,9999,1
1714615938133,CAT 124RS,A01,519847,Geibel; William,0,0,20,20
1714615939157,CAT 125RS,A01,515971,Geibel; William,0,0,20,20
1714615940183,CLRE 250,A00,511389,Morris; Sheldon,9993,0,9999,6
1714615941211,CLRE 251,A00,507176,Mehta; Ravindra L.,9993,0,9999,6
1714615941211,CLRE 251,B00,511410,Mehta; Ravindra L.,9998,0,9999,1
1714615942239,CLRE 252,A00,507189,Cuomo; Raphael Eduardo,9995,0,9999,4
1714615943266,CLRE 253,A00,507199,Vaida; Florin,9994,0,9999,5
1714615943266,CLRE 253,B00,507202,Vaida; Florin,9999,0,9999,0
1714615944289,CLRE 259,A00,507211,Patel; Hemal,9996,0,9999,3
1714615945315,CLRE 260,A00,507221,Cuomo; Raphael Eduardo,9999,0,9999,0
1714615946342,CLRE 297,001,507242,Cuomo; Raphael Eduardo,9999,0,9999,0
1714615947367,COGS 197,001,638244,Voytek; Bradley Thomas,9998,0,9999,1
1714615948393,CSE 191,A00,516875,Minnes Kemp; Mor Mia,9992,0,9999,7
1714615949417,CSE 197,001,637388,Minnes Kemp; Mor Mia,9998,0,9999,1
1714615950443,CSS 201S,A01,494383,Staff,35,0,35,0
1714615951468,CSS 202S,A01,494387,Staff,35,0,35,0
1714615952495,DSC 197,001,628532,Eldridge; Justin Matthew,9996,0,9999,3
1714615953524,EAP 100,A00,516065,Staff,9797,0,9999,202
1714615954553,ECE 45,A01,507414,Staff,33,0,60,27
1714615956605,ECE 111,A01,507420,Staff,15,0,50,35
1714615957632,ECE 197,001,548057,Sievenpiper; Daniel F.,9993,0,9999,6
1714615958657,EDS 115,A00,507243,Choi; Bailey Miyeon,10,0,28,18
1714615959684,EDS 117,A01,494379,Staff,1,5,30,29
1714615960711,EDS 125,A00,507246,Hopkins; Megan Beth,9,0,30,21
1714615961739,EDS 128A,A01,507264,Fargason; Sharon Gayle,8,0,26,18
1714615962764,EDS 128B,A01,507293,Pappas; Elizabeth,12,0,30,18
1714615963790,EDS 139,A00,507294,Fargason; Sharon Gayle,13,0,30,17
1714615963790,EDS 139,B00,507313,Pappas; Elizabeth,13,0,30,17
1714615964870,EDS 201,A00,507315,Staff,13,0,30,17
1714615965900,EDS 203,A01,507317,Halter; Christopher P.,12,0,30,18
1714615966924,EDS 204R,A01,507319,Halter; Christopher P.,0,3,30,30
1714615966924,EDS 204R,B01,507331,Heinzman; Erica M.,16,0,30,14
1714615967948,EDS 206R,A00,507332,Staff,0,4,30,30
1714615967948,EDS 206R,B00,507343,Staff,17,0,30,13
1714615968973,EDS 250,A00,507344,Hemans; Patricia Ann Benitez,22,0,40,18
1714615969999,EDS 281,A00,507345,Daly; Alan J.,18,0,18,0
1714615971025,EDS 284,A00,507350,Daly; Alan J.,16,0,16,0
1714615972053,EDS 286,A00,507359,Fine; Sarah,18,0,18,0
1714615973080,EDS 289C,A01,507361,Daly; Alan J.,18,0,18,0
1714615974106,EDS 290,A00,507366,Hofstetter; Carolyn,15,0,15,0
1714615975134,LIGM 5A,A00,507421,Fischer-Grunski; Eva K,18,0,20,2
1714615976160,LIGM 5B,A00,507423,Fischer-Grunski; Eva K,19,0,20,1
1714615977185,LIGM 5C,A00,507425,Fischer-Grunski; Eva K,19,0,20,1
1714615978211,LIIT 5AS,A00,507427,Carnelos; Chiara,20,0,20,0
1714615979240,LIIT 5BS,A00,507430,Carnelos; Chiara,20,0,20,0
1714615980263,LIIT 5CS,A00,507432,Carnelos; Chiara,20,0,20,0
1714615981290,LISP 5A,A00,507541,Munoz Sanchez; Alicia,11,0,20,9
1714615982316,LISP 5B,A00,507671,Munoz Sanchez; Alicia,8,0,20,12
1714615983345,LISP 5C,A00,507696,Munoz Sanchez; Alicia,9,0,20,11
1714615984373,MAE 197,001,528363,Boechler; Nicholas Sebastia,9998,0,9999,1
1714615985405,MATH 197,001,523477,Kedlaya; Kiran S.,9995,0,9999,4
1714615985405,MATH 197,002,563811,Zhang; Danna,9995,0,9999,4
1714615985405,MATH 197,003,628552,Dumitriu; Ioana,9998,0,9999,1
1714615986432,MCWP 40R,A00,518780,Staff,2,0,20,18
1714615986432,MCWP 40R,B00,518781,Staff,8,0,20,12
1714615986432,MCWP 40R,C00,518783,Staff,6,0,20,14
1714615987461,MCWP 50R,A00,518791,Staff,0,0,20,20
1714615987461,MCWP 50R,B00,518792,Staff,0,2,20,20
1714615987461,MCWP 50R,C00,518793,Staff,0,2,20,20
1714615987461,MCWP 50R,D00,518794,Staff,0,0,20,20
1714615987461,MCWP 50R,E00,518795,Staff,0,2,20,20
1714615987461,MCWP 50R,F00,518796,Staff,0,0,20,20
1714615987461,MCWP 50R,G00,518797,Staff,0,1,20,20
1714615988490,MMW 12R,A01,514034,Herbst; Matthew,0,0,16,16
1714615988490,MMW 12R,A02,514035,Herbst; Matthew,1,0,16,15
1714615989518,MMW 13R,A01,514037,Staff,0,4,16,16
1714615989518,MMW 13R,A02,514039,Staff,0,2,16,16
1714615989518,MMW 13R,A03,628519,Staff,0,2,16,16
1714615991568,SIO 295LS,A00,523233,Staff,10,0,30,20
1714615992593,SIO 295S,A00,523232,Staff,10,0,30,20
1714615993619,SIOC 290S,A01,637330,Merrifield; Mark A,23,0,30,7
1714615994649,SIOC 291S,A01,637333,Gabriel; Corey John,23,0,30,7
1714615995673,SOCI 117,A01,494376,Staff,0,4,5,5
1714615996698,WES 237B,A00,494380,Staff,9,0,20,11
1714615998776,AESE 279B,A00,494370,Wade; Jon P,0,0,33,33
1714615999804,AIP 197,001,627712,Vespa; Emanuel Ignacio,9998,0,9999,1
1714616000828,ANAR 135S,A00,494369,Braswell; Geoffrey E.,0,0,0,0
1714616001855,BENG 196,001,628496,Engler; Adam J.,9998,0,9999,1
1714616002882,CAT 124RS,A01,519847,Geibel; William,0,0,20,20
1714616003910,CAT 125RS,A01,515971,Geibel; William,0,0,20,20
1714616004935,CLRE 250,A00,511389,Morris; Sheldon,9993,0,9999,6
1714616005966,CLRE 251,A00,507176,Mehta; Ravindra L.,9993,0,9999,6
1714616005966,CLRE 251,B00,511410,Mehta; Ravindra L.,9998,0,9999,1
1714616006992,CLRE 252,A00,507189,Cuomo; Raphael Eduardo,9995,0,9999,4
1714616008017,CLRE 253,A00,507199,Vaida; Florin,9994,0,9999,5
1714616008017,CLRE 253,B00,507202,Vaida; Florin,9999,0,9999,0
1714616009042,CLRE 259,A00,507211,Patel; Hemal,9996,0,9999,3
1714616010066,CLRE 260,A00,507221,Cuomo; Raphael Eduardo,9999,0,9999,0
1714616011090,CLRE 297,001,507242,Cuomo; Raphael Eduardo,9999,0,9999,0
1714616012115,COGS 197,001,638244,Voytek; Bradley Thomas,9998,0,9999,1
1714616013139,CSE 191,A00,516875,Minnes Kemp; Mor Mia,9992,0,9999,7
1714616014165,CSE 197,001,637388,Minnes Kemp; Mor Mia,9998,0,9999,1
1714616015193,CSS 201S,A01,494383,Staff,35,0,35,0
1714616016218,CSS 202S,A01,494387,Staff,35,0,35,0
1714616017243,DSC 197,001,628532,Eldridge; Justin Matthew,9996,0,9999,3
1714616018267,EAP 100,A00,516065,Staff,9797,0,9999,202
1714616019298,ECE 45,A01,507414,Staff,33,0,60,27
1714616021350,ECE 111,A01,507420,Staff,15,0,50,35
1714616022374,ECE 197,001,548057,Sievenpiper; Daniel F.,9993,0,9999,6
1714616023400,EDS 115,A00,507243,Choi; Bailey Miyeon,10,0,28,18
1714616024426,EDS 117,A01,494379,Staff,1,5,30,29
1714616025451,EDS 125,A00,507246,Hopkins; Megan Beth,9,0,30,21
1714616026479,EDS 128A,A01,507264,Fargason; Sharon Gayle,8,0,26,18
1714616027509,EDS 128B,A01,507293,Pappas; Elizabeth,12,0,30,18
1714616028534,EDS 139,A00,507294,Fargason; Sharon Gayle,13,0,30,17
1714616028534,EDS 139,B00,507313,Pappas; Elizabeth,13,0,30,17
1714616029558,EDS 201,A00,507315,Staff,13,0,30,17
1714616030589,EDS 203,A01,507317,Halter; Christopher P.,12,0,30,18
1714616031615,EDS 204R,A01,507319,Halter; Christopher P.,0,3,30,30
1714616031615,EDS 204R,B01,507331,Heinzman; Erica M.,16,0,30,14
1714616032639,EDS 206R,A00,507332,Staff,0,4,30,30
1714616032639,EDS 206R,B00,507343,Staff,17,0,30,13
1714616033664,EDS 250,A00,507344,Hemans; Patricia Ann Benitez,22,0,40,18
1714616034690,EDS 281,A00,507345,Daly; Alan J.,18,0,18,0
1714616035713,EDS 284,A00,507350,Daly; Alan J.,16,0,16,0
1714616036741,EDS 286,A00,507359,Fine; Sarah,18,0,18,0
1714616037768,EDS 289C,A01,507361,Daly; Alan J.,18,0,18,0
1714616038792,EDS 290,A00,507366,Hofstetter; Carolyn,15,0,15,0
1714616039818,LIGM 5A,A00,507421,Fischer-Grunski; Eva K,18,0,20,2
1714616040845,LIGM 5B,A00,507423,Fischer-Grunski; Eva K,19,0,20,1
1714616041873,LIGM 5C,A00,507425,Fischer-Grunski; Eva K,19,0,20,1
1714616042899,LIIT 5AS,A00,507427,Carnelos; Chiara,20,0,20,0
1714616043924,LIIT 5BS,A00,507430,Carnelos; Chiara,20,0,20,0
1714616044950,LIIT 5CS,A00,507432,Carnelos; Chiara,20,0,20,0
1714616045977,LISP 5A,A00,507541,Munoz Sanchez; Alicia,11,0,20,9
1714616047007,LISP 5B,A00,507671,Munoz Sanchez; Alicia,8,0,20,12
1714616048036,LISP 5C,A00,507696,Munoz Sanchez; Alicia,9,0,20,11
1714616049063,MAE 197,001,528363,Boechler; Nicholas Sebastia,9998,0,9999,1
1714616050090,MATH 197,001,523477,Kedlaya; Kiran S.,9995,0,9999,4
1714616050090,MATH 197,002,563811,Zhang; Danna,9995,0,9999,4
1714616050090,MATH 197,003,628552,Dumitriu; Ioana,9998,0,9999,1
1714616051115,MCWP 40R,A00,518780,Staff,2,0,20,18
1714616051115,MCWP 40R,B00,518781,Staff,8,0,20,12
1714616051115,MCWP 40R,C00,518783,Staff,6,0,20,14
1714616052141,MCWP 50R,A00,518791,Staff,0,0,20,20
1714616052141,MCWP 50R,B00,518792,Staff,0,2,20,20
1714616052141,MCWP 50R,C00,518793,Staff,0,2,20,20
1714616052141,MCWP 50R,D00,518794,Staff,0,0,20,20
1714616052141,MCWP 50R,E00,518795,Staff,0,2,20,20
1714616052141,MCWP 50R,F00,518796,Staff,0,0,20,20
1714616052141,MCWP 50R,G00,518797,Staff,0,1,20,20
1714616053167,MMW 12R,A01,514034,Herbst; Matthew,0,0,16,16
1714616053167,MMW 12R,A02,514035,Herbst; Matthew,1,0,16,15
1714616054191,MMW 13R,A01,514037,Staff,0,4,16,16
1714616054191,MMW 13R,A02,514039,Staff,0,2,16,16
1714616054191,MMW 13R,A03,628519,Staff,0,2,16,16
1714616056243,SIO 295LS,A00,523233,Staff,10,0,30,20
1714616057267,SIO 295S,A00,523232,Staff,10,0,30,20
1714616058291,SIOC 290S,A01,637330,Merrifield; Mark A,23,0,30,7
1714616059318,SIOC 291S,A01,637333,Gabriel; Corey John,23,0,30,7
1714616060344,SOCI 117,A01,494376,Staff,0,4,5,5
1714616061367,WES 237B,A00,494380,Staff,9,0,20,11
1714616063446,AESE 279B,A00,494370,Wade; Jon P,0,0,33,33
1714616064474,AIP 197,001,627712,Vespa; Emanuel Ignacio,9998,0,9999,1
1714616065502,ANAR 135S,A00,494369,Braswell; Geoffrey E.,0,0,0,0
1714616066526,BENG 196,001,628496,Engler; Adam J.,9998,0,9999,1
1714616067552,CAT 124RS,A01,519847,Geibel; William,0,0,20,20
1714616068632,CAT 125RS,A01,515971,Geibel; William,0,0,20,20
1714616069658,CLRE 250,A00,511389,Morris; Sheldon,9993,0,9999,6
1714616070687,CLRE 251,A00,507176,Mehta; Ravindra L.,9993,0,9999,6
1714616070687,CLRE 251,B00,511410,Mehta; Ravindra L.,9998,0,9999,1
1714616071716,CLRE 252,A00,507189,Cuomo; Raphael Eduardo,9995,0,9999,4
1714616072746,CLRE 253,A00,507199,Vaida; Florin,9994,0,9999,5
1714616072746,CLRE 253,B00,507202,Vaida; Florin,9999,0,9999,0
1714616073772,CLRE 259,A00,507211,Patel; Hemal,9996,0,9999,3
1714616074798,CLRE 260,A00,507221,Cuomo; Raphael Eduardo,9999,0,9999,0
1714616075823,CLRE 297,001,507242,Cuomo; Raphael Eduardo,9999,0,9999,0
1714616076851,COGS 197,001,638244,Voytek; Bradley Thomas,9998,0,9999,1
1714616077878,CSE 191,A00,516875,Minnes Kemp; Mor Mia,9992,0,9999,7
1714616078904,CSE 197,001,637388,Minnes Kemp; Mor Mia,9998,0,9999,1
1714616079930,CSS 201S,A01,494383,Staff,35,0,35,0
1714616080958,CSS 202S,A01,494387,Staff,35,0,35,0
1714616081983,DSC 197,001,628532,Eldridge; Justin Matthew,9996,0,9999,3
1714616083010,EAP 100,A00,516065,Staff,9797,0,9999,202
1714616084036,ECE 45,A01,507414,Staff,33,0,60,27
1714616086089,ECE 111,A01,507420,Staff,15,0,50,35
1714616087113,ECE 197,001,548057,Sievenpiper; Daniel F.,9993,0,9999,6
1714616088140,EDS 115,A00,507243,Choi; Bailey Miyeon,10,0,28,18
1714616089170,EDS 117,A01,494379,Staff,1,5,30,29
1714616090200,EDS 125,A00,507246,Hopkins; Megan Beth,9,0,30,21
1714616091228,EDS 128A,A01,507264,Fargason; Sharon Gayle,8,0,26,18
1714616092256,EDS 128B,A01,507293,Pappas; Elizabeth,12,0,30,18
1714616093282,EDS 139,A00,507294,Fargason; Sharon Gayle,13,0,30,17
1714616093282,EDS 139,B00,507313,Pappas; Elizabeth,13,0,30,17
1714616094306,EDS 201,A00,507315,Staff,13,0,30,17
1714616095332,EDS 203,A01,507317,Halter; Christopher P.,12,0,30,18
1714616096364,EDS 204R,A01,507319,Halter; Christopher P.,0,3,30,30
1714616096364,EDS 204R,B01,507331,Heinzman; Erica M.,16,0,30,14
1714616097392,EDS 206R,A00,507332,Staff,0,4,30,30
1714616097392,EDS 206R,B00,507343,Staff,17,0,30,13
1714616098422,EDS 250,A00,507344,Hemans; Patricia Ann Benitez,22,0,40,18
1714616099447,EDS 281,A00,507345,Daly; Alan J.,18,0,18,0
1714616100472,EDS 284,A00,507350,Daly; Alan J.,16,0,16,0
1714616101496,EDS 286,A00,507359,Fine; Sarah,18,0,18,0
1714616102521,EDS 289C,A01,507361,Daly; Alan J.,18,0,18,0
1714616103545,EDS 290,A00,507366,Hofstetter; Carolyn,15,0,15,0
1714616104570,LIGM 5A,A00,507421,Fischer-Grunski; Eva K,18,0,20,2
1714616105596,LIGM 5B,A00,507423,Fischer-Grunski; Eva K,19,0,20,1
1714616106619,LIGM 5C,A00,507425,Fischer-Grunski; Eva K,19,0,20,1
1714616107644,LIIT 5AS,A00,507427,Carnelos; Chiara,20,0,20,0
1714616108668,LIIT 5BS,A00,507430,Carnelos; Chiara,20,0,20,0
1714616109697,LIIT 5CS,A00,507432,Carnelos; Chiara,20,0,20,0
1714616110725,LISP 5A,A00,507541,Munoz Sanchez; Alicia,11,0,20,9
1714616111752,LISP 5B,A00,507671,Munoz Sanchez; Alicia,8,0,20,12
1714616112779,LISP 5C,A00,507696,Munoz Sanchez; Alicia,9,0,20,11
1714616113803,MAE 197,001,528363,Boechler; Nicholas Sebastia,9998,0,9999,1
1714616114832,MATH 197,001,523477,Kedlaya; Kiran S.,9995,0,9999,4
1714616114832,MATH 197,002,563811,Zhang; Danna,9995,0,9999,4
1714616114832,MATH 197,003,628552,Dumitriu; Ioana,9998,0,9999,1
1714616115858,MCWP 40R,A00,518780,Staff,2,0,20,18
1714616115858,MCWP 40R,B00,518781,Staff,8,0,20,12
1714616115858,MCWP 40R,C00,518783,Staff,6,0,20,14
1714616116887,MCWP 50R,A00,518791,Staff,0,0,20,20
1714616116887,MCWP 50R,B00,518792,Staff,0,2,20,20
1714616116887,MCWP 50R,C00,518793,Staff,0,2,20,20
1714616116887,MCWP 50R,D00,518794,Staff,0,0,20,20
1714616116887,MCWP 50R,E00,518795,Staff,0,2,20,20
1714616116887,MCWP 50R,F00,518796,Staff,0,0,20,20
1714616116887,MCWP 50R,G00,518797,Staff,0,1,20,20
1714616117912,MMW 12R,A01,514034,Herbst; Matthew,0,0,16,16
1714616117912,MMW 12R,A02,514035,Herbst; Matthew,1,0,16,15
1714616118942,MMW 13R,A01,514037,Staff,0,4,16,16
1714616118942,MMW 13R,A02,514039,Staff,0,2,16,16
1714616118942,MMW 13R,A03,628519,Staff,0,2,16,16
1714616120997,SIO 295LS,A00,523233,Staff,10,0,30,20
1714616122024,SIO 295S,A00,523232,Staff,10,0,30,20
1714616123051,SIOC 290S,A01,637330,Merrifield; Mark A,23,0,30,7
1714616124082,SIOC 291S,A01,637333,Gabriel; Corey John,23,0,30,7
1714616125112,SOCI 117,A01,494376,Staff,0,4,5,5
1714616126138,WES 237B,A00,494380,Staff,9,0,20,11
1714616128211,AESE 279B,A00,494370,Wade; Jon P,0,0,33,33
1714616129235,AIP 197,001,627712,Vespa; Emanuel Ignacio,9998,0,9999,1
1714616130264,ANAR 135S,A00,494369,Braswell; Geoffrey E.,0,0,0,0
1714616131288,BENG 196,001,628496,Engler; Adam J.,9998,0,9999,1
1714616132313,CAT 124RS,A01,519847,Geibel; William,0,0,20,20
1714616133338,CAT 125RS,A01,515971,Geibel; William,0,0,20,20
1714616134363,CLRE 250,A00,511389,Morris; Sheldon,9993,0,9999,6
1714616135392,CLRE 251,A00,507176,Mehta; Ravindra L.,9993,0,9999,6
1714616135392,CLRE 251,B00,511410,Mehta; Ravindra L.,9998,0,9999,1
1714616136420,CLRE 252,A00,507189,Cuomo; Raphael Eduardo,9995,0,9999,4
1714616137446,CLRE 253,A00,507199,Vaida; Florin,9994,0,9999,5
1714616137446,CLRE 253,B00,507202,Vaida; Florin,9999,0,9999,0
1714616138472,CLRE 259,A00,507211,Patel; Hemal,9996,0,9999,3
1714616139496,CLRE 260,A00,507221,Cuomo; Raphael Eduardo,9999,0,9999,0
1714616140521,CLRE 297,001,507242,Cuomo; Raphael Eduardo,9999,0,9999,0
1714616141549,COGS 197,001,638244,Voytek; Bradley Thomas,9998,0,9999,1
1714616142575,CSE 191,A00,516875,Minnes Kemp; Mor Mia,9992,0,9999,7
1714616143654,CSE 197,001,637388,Minnes Kemp; Mor Mia,9998,0,9999,1
1714616144682,CSS 201S,A01,494383,Staff,35,0,35,0
1714616145708,CSS 202S,A01,494387,Staff,35,0,35,0
1714616146734,DSC 197,001,628532,Eldridge; Justin Matthew,9996,0,9999,3
1714616147761,EAP 100,A00,516065,Staff,9797,0,9999,202
1714616148788,ECE 45,A01,507414,Staff,33,0,60,27
1714616150841,ECE 111,A01,507420,Staff,15,0,50,35
1714616151867,ECE 197,001,548057,Sievenpiper; Daniel F.,9993,0,9999,6
1714616152894,EDS 115,A00,507243,Choi; Bailey Miyeon,10,0,28,18
1714616153919,EDS 117,A01,494379,Staff,1,5,30,29
1714616154944,EDS 125,A00,507246,Hopkins; Megan Beth,9,0,30,21
1714616155969,EDS 128A,A01,507264,Fargason; Sharon Gayle,8,0,26,18
1714616156996,EDS 128B,A01,507293,Pappas; Elizabeth,12,0,30,18
1714616158024,EDS 139,A00,507294,Fargason; Sharon Gayle,13,0,30,17
1714616158024,EDS 139,B00,507313,Pappas; Elizabeth,13,0,30,17
1714616159051,EDS 201,A00,507315,Staff,13,0,30,17
1714616160082,EDS 203,A01,507317,Halter; Christopher P.,12,0,30,18
1714616161108,EDS 204R,A01,507319,Halter; Christopher P.,0,3,30,30
1714616161108,EDS 204R,B01,507331,Heinzman; Erica M.,16,0,30,14
1714616162135,EDS 206R,A00,507332,Staff,0,4,30,30
1714616162135,EDS 206R,B00,507343,Staff,17,0,30,13
1714616163162,EDS 250,A00,507344,Hemans; Patricia Ann Benitez,22,0,40,18
1714616164187,EDS 281,A00,507345,Daly; Alan J.,18,0,18,0
1714616165214,EDS 284,A00,507350,Daly; Alan J.,16,0,16,0
1714616166240,EDS 286,A00,507359,Fine; Sarah,18,0,18,0
1714616167266,EDS 289C,A01,507361,Daly; Alan J.,18,0,18,0
1714616168291,EDS 290,A00,507366,Hofstetter; Carolyn,15,0,15,0
1714616169314,LIGM 5A,A00,507421,Fischer-Grunski; Eva K,18,0,20,2
1714616170339,LIGM 5B,A00,507423,Fischer-Grunski; Eva K,19,0,20,1
1714616171367,LIGM 5C,A00,507425,Fischer-Grunski; Eva K,19,0,20,1
1714616172448,LIIT 5AS,A00,507427,Carnelos; Chiara,20,0,20,0
1714616173475,LIIT 5BS,A00,507430,Carnelos; Chiara,20,0,20,0
1714616174499,LIIT 5CS,A00,507432,Carnelos; Chiara,20,0,20,0
1714616175525,LISP 5A,A00,507541,Munoz Sanchez; Alicia,11,0,20,9
1714616176550,LISP 5B,A00,507671,Munoz Sanchez; Alicia,8,0,20,12
1714616177575,LISP 5C,A00,507696,Munoz Sanchez; Alicia,9,0,20,11
1714616178602,MAE 197,001,528363,Boechler; Nicholas Sebastia,9998,0,9999,1
1714616179631,MATH 197,001,523477,Kedlaya; Kiran S.,9995,0,9999,4
1714616179631,MATH 197,002,563811,Zhang; Danna,9995,0,9999,4
1714616179631,MATH 197,003,628552,Dumitriu; Ioana,9998,0,9999,1
1714616180656,MCWP 40R,A00,518780,Staff,2,0,20,18
1714616180656,MCWP 40R,B00,518781,Staff,8,0,20,12
1714616180656,MCWP 40R,C00,518783,Staff,6,0,20,14
1714616181682,MCWP 50R,A00,518791,Staff,0,0,20,20
1714616181682,MCWP 50R,B00,518792,Staff,0,2,20,20
1714616181682,MCWP 50R,C00,518793,Staff,0,2,20,20
1714616181682,MCWP 50R,D00,518794,Staff,0,0,20,20
1714616181682,MCWP 50R,E00,518795,Staff,0,2,20,20
1714616181682,MCWP 50R,F00,518796,Staff,0,0,20,20
1714616181682,MCWP 50R,G00,518797,Staff,0,1,20,20
1714616182708,MMW 12R,A01,514034,Herbst; Matthew,0,0,16,16
1714616182708,MMW 12R,A02,514035,Herbst; Matthew,1,0,16,15
1714616183738,MMW 13R,A01,514037,Staff,0,4,16,16
1714616183738,MMW 13R,A02,514039,Staff,0,2,16,16
1714616183738,MMW 13R,A03,628519,Staff,0,2,16,16
1714616185791,SIO 295LS,A00,523233,Staff,10,0,30,20
1714616186819,SIO 295S,A00,523232,Staff,10,0,30,20
1714616187846,SIOC 290S,A01,637330,Merrifield; Mark A,23,0,30,7
1714616188871,SIOC 291S,A01,637333,Gabriel; Corey John,23,0,30,7
1714616189897,SOCI 117,A01,494376,Staff,0,4,5,5
1714616190923,WES 237B,A00,494380,Staff,9,0,20,11
1714616193000,AESE 279B,A00,494370,Wade; Jon P,0,0,33,33
1714616194026,AIP 197,001,627712,Vespa; Emanuel Ignacio,9998,0,9999,1
1714616195051,ANAR 135S,A00,494369,Braswell; Geoffrey E.,0,0,0,0
1714616196075,BENG 196,001,628496,Engler; Adam J.,9998,0,9999,1
1714616197104,CAT 124RS,A01,519847,Geibel; William,0,0,20,20
1714616198128,CAT 125RS,A01,515971,Geibel; William,0,0,20,20
1714616199154,CLRE 250,A00,511389,Morris; Sheldon,9993,0,9999,6
1714616200185,CLRE 251,A00,507176,Mehta; Ravindra L.,9993,0,9999,6
1714616200185,CLRE 251,B00,511410,Mehta; Ravindra L.,9998,0,9999,1
1714616201212,CLRE 252,A00,507189,Cuomo; Raphael Eduardo,9995,0,9999,4
1714616202242,CLRE 253,A00,507199,Vaida; Florin,9994,0,9999,5
1714616202242,CLRE 253,B00,507202,Vaida; Florin,9999,0,9999,0
1714616203270,CLRE 259,A00,507211,Patel; Hemal,9996,0,9999,3
1714616204295,CLRE 260,A00,507221,Cuomo; Raphael Eduardo,9999,0,9999,0
1714616205321,CLRE 297,001,507242,Cuomo; Raphael Eduardo,9999,0,9999,0
1714616206348,COGS 197,001,638244,Voytek; Bradley Thomas,9998,0,9999,1
1714616207373,CSE 191,A00,516875,Minnes Kemp; Mor Mia,9992,0,9999,7
1714616208397,CSE 197,001,637388,Minnes Kemp; Mor Mia,9998,0,9999,1
1714616209426,CSS 201S,A01,494383,Staff,35,0,35,0
1714616210451,CSS 202S,A01,494387,Staff,35,0,35,0
1714616211476,DSC 197,001,628532,Eldridge; Justin Matthew,9996,0,9999,3
1714616212500,EAP 100,A00,516065,Staff,9797,0,9999,202
1714616213525,ECE 45,A01,507414,Staff,33,0,60,27
1714616215577,ECE 111,A01,507420,Staff,15,0,50,35
1714616216602,ECE 197,001,548057,Sievenpiper; Daniel F.,9993,0,9999,6
1714616217628,EDS 115,A00,507243,Choi; Bailey Miyeon,10,0,28,18
1714616218653,EDS 117,A01,494379,Staff,1,5,30,29
1714616219677,EDS 125,A00,507246,Hopkins; Megan Beth,9,0,30,21
1714616220711,EDS 128A,A01,507264,Fargason; Sharon Gayle,8,0,26,18
1714616221736,EDS 128B,A01,507293,Pappas; Elizabeth,12,0,30,18
1714616222761,EDS 139,A00,507294,Fargason; Sharon Gayle,13,0,30,17
1714616222761,EDS 139,B00,507313,Pappas; Elizabeth,13,0,30,17
1714616223788,EDS 201,A00,507315,Staff,13,0,30,17
1714616224814,EDS 203,A01,507317,Halter; Christopher P.,12,0,30,18
1714616225843,EDS 204R,A01,507319,Halter; Christopher P.,0,3,30,30
1714616225843,EDS 204R,B01,507331,Heinzman; Erica M.,16,0,30,14
1714616226870,EDS 206R,A00,507332,Staff,0,4,30,30
1714616226870,EDS 206R,B00,507343,Staff,17,0,30,13
1714616227895,EDS 250,A00,507344,Hemans; Patricia Ann Benitez,22,0,40,18
1714616228923,EDS 281,A00,507345,Daly; Alan J.,18,0,18,0
1714616229950,EDS 284,A00,507350,Daly; Alan J.,16,0,16,0
1714616230975,EDS 286,A00,507359,Fine; Sarah,18,0,18,0
1714616231999,EDS 289C,A01,507361,Daly; Alan J.,18,0,18,0
1714616233023,EDS 290,A00,507366,Hofstetter; Carolyn,15,0,15,0
1714616234049,LIGM 5A,A00,507421,Fischer-Grunski; Eva K,18,0,20,2
1714616235077,LIGM 5B,A00,507423,Fischer-Grunski; Eva K,19,0,20,1
1714616236102,LIGM 5C,A00,507425,Fischer-Grunski; Eva K,19,0,20,1
1714616237126,LIIT 5AS,A00,507427,Carnelos; Chiara,20,0,20,0
1714616238155,LIIT 5BS,A00,507430,Carnelos; Chiara,20,0,20,0
1714616239180,LIIT 5CS,A00,507432,Carnelos; Chiara,20,0,20,0
1714616240205,LISP 5A,A00,507541,Munoz Sanchez; Alicia,11,0,20,9
1714616241234,LISP 5B,A00,507671,Munoz Sanchez; Alicia,8,0,20,12
1714616242264,LISP 5C,A00,507696,Munoz Sanchez; Alicia,9,0,20,11
1714616243289,MAE 197,001,528363,Boechler; Nicholas Sebastia,9998,0,9999,1
1714616244318,MATH 197,001,523477,Kedlaya; Kiran S.,9995,0,9999,4
1714616244318,MATH 197,002,563811,Zhang; Danna,9995,0,9999,4
1714616244318,MATH 197,003,628552,Dumitriu; Ioana,9998,0,9999,1
1714616245343,MCWP 40R,A00,518780,Staff,2,0,20,18
1714616245343,MCWP 40R,B00,518781,Staff,8,0,20,12
1714616245343,MCWP 40R,C00,518783,Staff,6,0,20,14
1714616246372,MCWP 50R,A00,518791,Staff,0,0,20,20
1714616246372,MCWP 50R,B00,518792,Staff,0,2,20,20
1714616246372,MCWP 50R,C00,518793,Staff,0,2,20,20
1714616246372,MCWP 50R,D00,518794,Staff,0,0,20,20
1714616246372,MCWP 50R,E00,518795,Staff,0,2,20,20
1714616246372,MCWP 50R,F00,518796,Staff,0,0,20,20
1714616246372,MCWP 50R,G00,518797,Staff,0,1,20,20
1714616247399,MMW 12R,A01,514034,Herbst; Matthew,0,0,16,16
1714616247399,MMW 12R,A02,514035,Herbst; Matthew,1,0,16,15
1714616248429,MMW 13R,A01,514037,Staff,0,4,16,16
1714616248429,MMW 13R,A02,514039,Staff,0,2,16,16
1714616248429,MMW 13R,A03,628519,Staff,0,2,16,16
1714616250481,SIO 295LS,A00,523233,Staff,10,0,30,20
1714616251508,SIO 295S,A00,523232,Staff,10,0,30,20
1714616252536,SIOC 290S,A01,637330,Merrifield; Mark A,23,0,30,7
1714616253563,SIOC 291S,A01,637333,Gabriel; Corey John,23,0,30,7
1714616254590,SOCI 117,A01,494376,Staff,0,4,5,5
1714616255616,WES 237B,A00,494380,Staff,9,0,20,11
1714616257683,AESE 279B,A00,494370,Wade; Jon P,0,0,33,33
1714616258708,AIP 197,001,627712,Vespa; Emanuel Ignacio,9998,0,9999,1
1714616259733,ANAR 135S,A00,494369,Braswell; Geoffrey E.,0,0,0,0
1714616260761,BENG 196,001,628496,Engler; Adam J.,9998,0,9999,1
1714616261788,CAT 124RS,A01,519847,Geibel; William,0,0,20,20
1714616262813,CAT 125RS,A01,515971,Geibel; William,0,0,20,20
1714616263842,CLRE 250,A00,511389,Morris; Sheldon,9993,0,9999,6
1714616264875,CLRE 251,A00,507176,Mehta; Ravindra L.,9993,0,9999,6
1714616264875,CLRE 251,B00,511410,Mehta; Ravindra L.,9998,0,9999,1
1714616265904,CLRE 252,A00,507189,Cuomo; Raphael Eduardo,9995,0,9999,4
1714616266936,CLRE 253,A00,507199,Vaida; Florin,9994,0,9999,5
1714616266936,CLRE 253,B00,507202,Vaida; Florin,9999,0,9999,0
1714616267964,CLRE 259,A00,507211,Patel; Hemal,9996,0,9999,3
1714616268990,CLRE 260,A00,507221,Cuomo; Raphael Eduardo,9999,0,9999,0
1714616270017,CLRE 297,001,507242,Cuomo; Raphael Eduardo,9999,0,9999,0
1714616271046,COGS 197,001,638244,Voytek; Bradley Thomas,9998,0,9999,1
1714616272072,CSE 191,A00,516875,Minnes Kemp; Mor Mia,9992,0,9999,7
1714616273098,CSE 197,001,637388,Minnes Kemp; Mor Mia,9998,0,9999,1
1714616274122,CSS 201S,A01,494383,Staff,35,0,35,0
1714616275149,CSS 202S,A01,494387,Staff,35,0,35,0
1714616276230,DSC 197,001,628532,Eldridge; Justin Matthew,9996,0,9999,3
1714616277256,EAP 100,A00,516065,Staff,9797,0,9999,202
1714616278285,ECE 45,A01,507414,Staff,33,0,60,27
1714616280336,ECE 111,A01,507420,Staff,15,0,50,35
1714616281362,ECE 197,001,548057,Sievenpiper; Daniel F.,9993,0,9999,6
1714616282387,EDS 115,A00,507243,Choi; Bailey Miyeon,10,0,28,18
1714616283411,EDS 117,A01,494379,Staff,1,5,30,29
1714616284435,EDS 125,A00,507246,Hopkins; Megan Beth,9,0,30,21
1714616285461,EDS 128A,A01,507264,Fargason; Sharon Gayle,8,0,26,18
1714616286492,EDS 128B,A01,507293,Pappas; Elizabeth,12,0,30,18
1714616287517,EDS 139,A00,507294,Fargason; Sharon Gayle,13,0,30,17
1714616287517,EDS 139,B00,507313,Pappas; Elizabeth,13,0,30,17
1714616288541,EDS 201,A00,507315,Staff,13,0,30,17
1714616289569,EDS 203,A01,507317,Halter; Christopher P.,12,0,30,18
1714616290595,EDS 204R,A01,507319,Halter; Christopher P.,0,3,30,30
1714616290595,EDS 204R,B01,507331,Heinzman; Erica M.,16,0,30,14
1714616291623,EDS 206R,A00,507332,Staff,0,4,30,30
1714616291623,EDS 206R,B00,507343,Staff,17,0,30,13
1714616292648,EDS 250,A00,507344,Hemans; Patricia Ann Benitez,22,0,40,18
1714616293672,EDS 281,A00,507345,Daly; Alan J.,18,0,18,0
1714616294697,EDS 284,A00,507350,Daly; Alan J.,16,0,16,0
1714616295723,EDS 286,A00,507359,Fine; Sarah,18,0,18,0
1714616296749,EDS 289C,A01,507361,Daly; Alan J.,18,0,18,0
1714616297774,EDS 290,A00,507366,Hofstetter; Carolyn,15,0,15,0
1714616298804,LIGM 5A,A00,507421,Fischer-Grunski; Eva K,18,0,20,2
1714616299828,LIGM 5B,A00,507423,Fischer-Grunski; Eva K,19,0,20,1
1714616300856,LIGM 5C,A00,507425,Fischer-Grunski; Eva K,19,0,20,1
1714616301886,LIIT 5AS,A00,507427,Carnelos; Chiara,20,0,20,0
1714616302916,LIIT 5BS,A00,507430,Carnelos; Chiara,20,0,20,0
1714616303941,LIIT 5CS,A00,507432,Carnelos; Chiara,20,0,20,0
1714616304968,LISP 5A,A00,507541,Munoz Sanchez; Alicia,11,0,20,9
1714616305994,LISP 5B,A00,507671,Munoz Sanchez; Alicia,8,0,20,12
1714616307019,LISP 5C,A00,507696,Munoz Sanchez; Alicia,9,0,20,11
1714616308044,MAE 197,001,528363,Boechler; Nicholas Sebastia,9998,0,9999,1
1714616309076,MATH 197,001,523477,Kedlaya; Kiran S.,9995,0,9999,4
1714616309076,MATH 197,002,563811,Zhang; Danna,9995,0,9999,4
1714616309076,MATH 197,003,628552,Dumitriu; Ioana,9998,0,9999,1
1714616310101,MCWP 40R,A00,518780,Staff,2,0,20,18
1714616310101,MCWP 40R,B00,518781,Staff,8,0,20,12
1714616310101,MCWP 40R,C00,518783,Staff,6,0,20,14
1714616311126,MCWP 50R,A00,518791,Staff,0,0,20,20
1714616311126,MCWP 50R,B00,518792,Staff,0,2,20,20
1714616311126,MCWP 50R,C00,518793,Staff,0,2,20,20
1714616311126,MCWP 50R,D00,518794,Staff,0,0,20,20
1714616311126,MCWP 50R,E00,518795,Staff,0,2,20,20
1714616311126,MCWP 50R,F00,518796,Staff,0,0,20,20
1714616311126,MCWP 50R,G00,518797,Staff,0,1,20,20
1714616312151,MMW 12R,A01,514034,Herbst; Matthew,0,0,16,16
1714616312151,MMW 12R,A02,514035,Herbst; Matthew,1,0,16,15
1714616313175,MMW 13R,A01,514037,Staff,0,4,16,16
1714616313175,MMW 13R,A02,514039,Staff,0,2,16,16
1714616313175,MMW 13R,A03,628519,Staff,0,2,16,16
1714616315225,SIO 295LS,A00,523233,Staff,10,0,30,20
1714616316253,SIO 295S,A00,523232,Staff,10,0,30,20
1714616317278,SIOC 290S,A01,637330,Merrifield; Mark A,23,0,30,7
1714616318304,SIOC 291S,A01,637333,Gabriel; Corey John,23,0,30,7
1714616319332,SOCI 117,A01,494376,Staff,0,4,5,5
1714616320357,WES 237B,A00,494380,Staff,9,0,20,11
1714616322420,AESE 279B,A00,494370,Wade; Jon P,0,0,33,33
1714616323445,AIP 197,001,627712,Vespa; Emanuel Ignacio,9998,0,9999,1
1714616324470,ANAR 135S,A00,494369,Braswell; Geoffrey E.,0,0,0,0
1714616325494,BENG 196,001,628496,Engler; Adam J.,9998,0,9999,1
1714616326522,CAT 124RS,A01,519847,Geibel; William,0,0,20,20
1714616327549,CAT 125RS,A01,515971,Geibel; William,0,0,20,20
1714616328578,CLRE 250,A00,511389,Morris; Sheldon,9993,0,9999,6
1714616329609,CLRE 251,A00,507176,Mehta; Ravindra L.,9993,0,9999,6
1714616329609,CLRE 251,B00,511410,Mehta; Ravindra L.,9998,0,9999,1
1714616330635,CLRE 252,A00,507189,Cuomo; Raphael Eduardo,9995,0,9999,4
1714616331661,CLRE 253,A00,507199,Vaida; Florin,9994,0,9999,5
1714616331661,CLRE 253,B00,507202,Vaida; Florin,9999,0,9999,0
1714616332686,CLRE 259,A00,507211,Patel; Hemal,9996,0,9999,3
1714616333710,CLRE 260,A00,507221,Cuomo; Raphael Eduardo,9999,0,9999,0
1714616334735,CLRE 297,001,507242,Cuomo; Raphael Eduardo,9999,0,9999,0
1714616335763,COGS 197,001,638244,Voytek; Bradley Thomas,9998,0,9999,1
1714616336789,CSE 191,A00,516875,Minnes Kemp; Mor Mia,9992,0,9999,7
1714616337818,CSE 197,001,637388,Minnes Kemp; Mor Mia,9998,0,9999,1
1714616338845,CSS 201S,A01,494383,Staff,35,0,35,0
1714616339873,CSS 202S,A01,494387,Staff,35,0,35,0
1714616340902,DSC 197,001,628532,Eldridge; Justin Matthew,9996,0,9999,3
1714616341927,EAP 100,A00,516065,Staff,9797,0,9999,202
1714616342954,ECE 45,A01,507414,Staff,33,0,60,27
1714616345005,ECE 111,A01,507420,Staff,15,0,50,35
1714616346033,ECE 197,001,548057,Sievenpiper; Daniel F.,9993,0,9999,6
1714616347060,EDS 115,A00,507243,Choi; Bailey Miyeon,10,0,28,18
1714616348089,EDS 117,A01,494379,Staff,1,5,30,29
1714616349119,EDS 125,A00,507246,Hopkins; Megan Beth,9,0,30,21
1714616350145,EDS 128A,A01,507264,Fargason; Sharon Gayle,8,0,26,18
1714616351170,EDS 128B,A01,507293,Pappas; Elizabeth,12,0,30,18
1714616352195,EDS 139,A00,507294,Fargason; Sharon Gayle,13,0,30,17
1714616352195,EDS 139,B00,507313,Pappas; Elizabeth,13,0,30,17
1714616353222,EDS 201,A00,507315,Staff,13,0,30,17
1714616354248,EDS 203,A01,507317,Halter; Christopher P.,12,0,30,18
1714616355277,EDS 204R,A01,507319,Halter; Christopher P.,0,3,30,30
1714616355277,EDS 204R,B01,507331,Heinzman; Erica M.,16,0,30,14
1714616356305,EDS 206R,A00,507332,Staff,0,4,30,30
1714616356305,EDS 206R,B00,507343,Staff,17,0,30,13
1714616357330,EDS 250,A00,507344,Hemans; Patricia Ann Benitez,22,0,40,18
1714616358355,EDS 281,A00,507345,Daly; Alan J.,18,0,18,0
1714616359380,EDS 284,A00,507350,Daly; Alan J.,16,0,16,0
1714616360409,EDS 286,A00,507359,Fine; Sarah,18,0,18,0
1714616361435,EDS 289C,A01,507361,Daly; Alan J.,18,0,18,0
1714616362460,EDS 290,A00,507366,Hofstetter; Carolyn,15,0,15,0
1714616363486,LIGM 5A,A00,507421,Fischer-Grunski; Eva K,18,0,20,2
1714616364512,LIGM 5B,A00,507423,Fischer-Grunski; Eva K,19,0,20,1
1714616365539,LIGM 5C,A00,507425,Fischer-Grunski; Eva K,19,0,20,1
1714616366564,LIIT 5AS,A00,507427,Carnelos; Chiara,20,0,20,0
1714616367594,LIIT 5BS,A00,507430,Carnelos; Chiara,20,0,20,0
1714616368619,LIIT 5CS,A00,507432,Carnelos; Chiara,20,0,20,0
1714616369643,LISP 5A,A00,507541,Munoz Sanchez; Alicia,11,0,20,9
1714616370669,LISP 5B,A00,507671,Munoz Sanchez; Alicia,8,0,20,12
1714616371694,LISP 5C,A00,507696,Munoz Sanchez; Alicia,9,0,20,11
1714616372720,MAE 197,001,528363,Boechler; Nicholas Sebastia,9998,0,9999,1
1714616373747,MATH 197,001,523477,Kedlaya; Kiran S.,9995,0,9999,4
1714616373747,MATH 197,002,563811,Zhang; Danna,9995,0,9999,4
1714616373747,MATH 197,003,628552,Dumitriu; Ioana,9998,0,9999,1
1714616374774,MCWP 40R,A00,518780,Staff,2,0,20,18
1714616374774,MCWP 40R,B00,518781,Staff,8,0,20,12
1714616374774,MCWP 40R,C00,518783,Staff,6,0,20,14
1714616375800,MCWP 50R,A00,518791,Staff,0,0,20,20
1714616375800,MCWP 50R,B00,518792,Staff,0,2,20,20
1714616375800,MCWP 50R,C00,518793,Staff,0,2,20,20
1714616375800,MCWP 50R,D00,518794,Staff,0,0,20,20
1714616375800,MCWP 50R,E00,518795,Staff,0,2,20,20
1714616375800,MCWP 50R,F00,518796,Staff,0,0,20,20
1714616375800,MCWP 50R,G00,518797,Staff,0,1,20,20
1714616376828,MMW 12R,A01,514034,Herbst; Matthew,0,0,16,16
1714616376828,MMW 12R,A02,514035,Herbst; Matthew,1,0,16,15
1714616377854,MMW 13R,A01,514037,Staff,0,4,16,16
1714616377854,MMW 13R,A02,514039,Staff,0,2,16,16
1714616377854,MMW 13R,A03,628519,Staff,0,2,16,16
1714616379960,SIO 295LS,A00,523233,Staff,10,0,30,20
1714616380983,SIO 295S,A00,523232,Staff,10,0,30,20
1714616382010,SIOC 290S,A01,637330,Merrifield; Mark A,23,0,30,7
1714616383037,SIOC 291S,A01,637333,Gabriel; Corey John,23,0,30,7
1714616384061,SOCI 117,A01,494376,Staff,0,4,5,5
1714616385086,WES 237B,A00,494380,Staff,9,0,20,11
1714616387173,AESE 279B,A00,494370,Wade; Jon P,0,0,33,33
1714616388198,AIP 197,001,627712,Vespa; Emanuel Ignacio,9998,0,9999,1
1714616389227,ANAR 135S,A00,494369,Braswell; Geoffrey E.,0,0,0,0
1714616390256,BENG 196,001,628496,Engler; Adam J.,9998,0,9999,1
1714616391282,CAT 124RS,A01,519847,Geibel; William,0,0,20,20
1714616392310,CAT 125RS,A01,515971,Geibel; William,0,0,20,20
1714616393341,CLRE 250,A00,511389,Morris; Sheldon,9993,0,9999,6
1714616394369,CLRE 251,A00,507176,Mehta; Ravindra L.,9993,0,9999,6
1714616394369,CLRE 251,B00,511410,Mehta; Ravindra L.,9998,0,9999,1
1714616395397,CLRE 252,A00,507189,Cuomo; Raphael Eduardo,9995,0,9999,4
1714616396422,CLRE 253,A00,507199,Vaida; Florin,9994,0,9999,5
1714616396422,CLRE 253,B00,507202,Vaida; Florin,9999,0,9999,0
1714616397448,CLRE 259,A00,507211,Patel; Hemal,9996,0,9999,3
1714616398474,CLRE 260,A00,507221,Cuomo; Raphael Eduardo,9999,0,9999,0
1714616399501,CLRE 297,001,507242,Cuomo; Raphael Eduardo,9999,0,9999,0
1714616400526,COGS 197,001,638244,Voytek; Bradley Thomas,9998,0,9999,1
1714616401555,CSE 191,A00,516875,Minnes Kemp; Mor Mia,9992,0,9999,7
1714616402579,CSE 197,001,637388,Minnes Kemp; Mor Mia,9998,0,9999,1
1714616403626,CSS 201S,A01,494383,Staff,35,0,35,0
1714616404655,CSS 202S,A01,494387,Staff,35,0,35,0
1714616405682,DSC 197,001,628532,Eldridge; Justin Matthew,9996,0,9999,3
1714616406708,EAP 100,A00,516065,Staff,9797,0,9999,202
1714616407734,ECE 45,A01,507414,Staff,33,0,60,27
1714616409787,ECE 111,A01,507420,Staff,15,0,50,35
1714616410815,ECE 197,001,548057,Sievenpiper; Daniel F.,9993,0,9999,6
1714616411842,EDS 115,A00,507243,Choi; Bailey Miyeon,10,0,28,18
1714616412873,EDS 117,A01,494379,Staff,1,5,30,29
1714616413900,EDS 125,A00,507246,Hopkins; Megan Beth,9,0,30,21
1714616414929,EDS 128A,A01,507264,Fargason; Sharon Gayle,8,0,26,18
1714616415955,EDS 128B,A01,507293,Pappas; Elizabeth,12,0,30,18
1714616416983,EDS 139,A00,507294,Fargason; Sharon Gayle,13,0,30,17
1714616416983,EDS 139,B00,507313,Pappas; Elizabeth,13,0,30,17
1714616418006,EDS 201,A00,507315,Staff,13,0,30,17
1714616419036,EDS 203,A01,507317,Halter; Christopher P.,12,0,30,18
1714616420066,EDS 204R,A01,507319,Halter; Christopher P.,0,3,30,30
1714616420066,EDS 204R,B01,507331,Heinzman; Erica M.,16,0,30,14
1714616421094,EDS 206R,A00,507332,Staff,0,4,30,30
1714616421094,EDS 206R,B00,507343,Staff,17,0,30,13
1714616422122,EDS 250,A00,507344,Hemans; Patricia Ann Benitez,22,0,40,18
1714616423147,EDS 281,A00,507345,Daly; Alan J.,18,0,18,0
1714616424171,EDS 284,A00,507350,Daly; Alan J.,16,0,16,0
1714616425198,EDS 286,A00,507359,Fine; Sarah,18,0,18,0
1714616426225,EDS 289C,A01,507361,Daly; Alan J.,18,0,18,0
1714616427253,EDS 290,A00,507366,Hofstetter; Carolyn,15,0,15,0
1714616428283,LIGM 5A,A00,507421,Fischer-Grunski; Eva K,18,0,20,2
1714616429312,LIGM 5B,A00,507423,Fischer-Grunski; Eva K,19,0,20,1
1714616430340,LIGM 5C,A00,507425,Fischer-Grunski; Eva K,19,0,20,1
1714616431366,LIIT 5AS,A00,507427,Carnelos; Chiara,20,0,20,0
1714616432395,LIIT 5BS,A00,507430,Carnelos; Chiara,20,0,20,0
1714616433423,LIIT 5CS,A00,507432,Carnelos; Chiara,20,0,20,0
1714616434453,LISP 5A,A00,507541,Munoz Sanchez; Alicia,11,0,20,9
1714616435478,LISP 5B,A00,507671,Munoz Sanchez; Alicia,8,0,20,12
1714616436504,LISP 5C,A00,507696,Munoz Sanchez; Alicia,9,0,20,11
1714616437532,MAE 197,001,528363,Boechler; Nicholas Sebastia,9998,0,9999,1
1714616438561,MATH 197,001,523477,Kedlaya; Kiran S.,9995,0,9999,4
1714616438561,MATH 197,002,563811,Zhang; Danna,9995,0,9999,4
1714616438561,MATH 197,003,628552,Dumitriu; Ioana,9998,0,9999,1
1714616439587,MCWP 40R,A00,518780,Staff,2,0,20,18
1714616439587,MCWP 40R,B00,518781,Staff,8,0,20,12
1714616439587,MCWP 40R,C00,518783,Staff,6,0,20,14
1714616440613,MCWP 50R,A00,518791,Staff,0,0,20,20
1714616440613,MCWP 50R,B00,518792,Staff,0,2,20,20
1714616440613,MCWP 50R,C00,518793,Staff,0,2,20,20
1714616440613,MCWP 50R,D00,518794,Staff,0,0,20,20
1714616440613,MCWP 50R,E00,518795,Staff,0,2,20,20
1714616440613,MCWP 50R,F00,518796,Staff,0,0,20,20
1714616440613,MCWP 50R,G00,518797,Staff,0,1,20,20
1714616441643,MMW 12R,A01,514034,Herbst; Matthew,0,0,16,16
1714616441643,MMW 12R,A02,514035,Herbst; Matthew,1,0,16,15
1714616442669,MMW 13R,A01,514037,Staff,0,4,16,16
1714616442669,MMW 13R,A02,514039,Staff,0,2,16,16
1714616442669,MMW 13R,A03,628519,Staff,0,2,16,16
1714616444721,SIO 295LS,A00,523233,Staff,10,0,30,20
1714616445749,SIO 295S,A00,523232,Staff,10,0,30,20
1714616446779,SIOC 290S,A01,637330,Merrifield; Mark A,23,0,30,7
1714616447806,SIOC 291S,A01,637333,Gabriel; Corey John,23,0,30,7
1714616448834,SOCI 117,A01,494376,Staff,0,4,5,5
1714616449862,WES 237B,A00,494380,Staff,9,0,20,11
1714616451943,AESE 279B,A00,494370,Wade; Jon P,0,0,33,33
1714616452966,AIP 197,001,627712,Vespa; Emanuel Ignacio,9998,0,9999,1
1714616454046,ANAR 135S,A00,494369,Braswell; Geoffrey E.,0,0,0,0
1714616455071,BENG 196,001,628496,Engler; Adam J.,9998,0,9999,1
1714616456097,CAT 124RS,A01,519847,Geibel; William,0,0,20,20
1714616457126,CAT 125RS,A01,515971,Geibel; William,0,0,20,20
1714616458154,CLRE 250,A00,511389,Morris; Sheldon,9993,0,9999,6
1714616459183,CLRE 251,A00,507176,Mehta; Ravindra L.,9993,0,9999,6
1714616459183,CLRE 251,B00,511410,Mehta; Ravindra L.,9998,0,9999,1
1714616460219,CLRE 252,A00,507189,Cuomo; Raphael Eduardo,9995,0,9999,4
1714616461249,CLRE 253,A00,507199,Vaida; Florin,9994,0,9999,5
1714616461249,CLRE 253,B00,507202,Vaida; Florin,9999,0,9999,0
1714616462274,CLRE 259,A00,507211,Patel; Hemal,9996,0,9999,3
1714616463304,CLRE 260,A00,507221,Cuomo; Raphael Eduardo,9999,0,9999,0
1714616464330,CLRE 297,001,507242,Cuomo; Raphael Eduardo,9999,0,9999,0
1714616465356,COGS 197,001,638244,Voytek; Bradley Thomas,9998,0,9999,1
1714616466381,CSE 191,A00,516875,Minnes Kemp; Mor Mia,9992,0,9999,7
1714616467409,CSE 197,001,637388,Minnes Kemp; Mor Mia,9998,0,9999,1
1714616468434,CSS 201S,A01,494383,Staff,35,0,35,0
1714616469461,CSS 202S,A01,494387,Staff,35,0,35,0
1714616470486,DSC 197,001,628532,Eldridge; Justin Matthew,9996,0,9999,3
1714616471510,EAP 100,A00,516065,Staff,9797,0,9999,202
1714616472540,ECE 45,A01,507414,Staff,33,0,60,27
1714616474599,ECE 111,A01,507420,Staff,15,0,50,35
1714616475627,ECE 197,001,548057,Sievenpiper; Daniel F.,9993,0,9999,6
1714616476651,EDS 115,A00,507243,Choi; Bailey Miyeon,10,0,28,18
1714616477678,EDS 117,A01,494379,Staff,1,5,30,29
1714616478707,EDS 125,A00,507246,Hopkins; Megan Beth,9,0,30,21
1714616479732,EDS 128A,A01,507264,Fargason; Sharon Gayle,8,0,26,18
1714616480760,EDS 128B,A01,507293,Pappas; Elizabeth,12,0,30,18
1714616481783,EDS 139,A00,507294,Fargason; Sharon Gayle,13,0,30,17
1714616481783,EDS 139,B00,507313,Pappas; Elizabeth,13,0,30,17
1714616482812,EDS 201,A00,507315,Staff,13,0,30,17
1714616483837,EDS 203,A01,507317,Halter; Christopher P.,12,0,30,18
1714616484865,EDS 204R,A01,507319,Halter; Christopher P.,0,3,30,30
1714616484865,EDS 204R,B01,507331,Heinzman; Erica M.,16,0,30,14
1714616485892,EDS 206R,A00,507332,Staff,0,4,30,30
1714616485892,EDS 206R,B00,507343,Staff,17,0,30,13
1714616486918,EDS 250,A00,507344,Hemans; Patricia Ann Benitez,22,0,40,18
1714616487946,EDS 281,A00,507345,Daly; Alan J.,18,0,18,0
1714616488970,EDS 284,A00,507350,Daly; Alan J.,16,0,16,0
1714616490077,EDS 286,A00,507359,Fine; Sarah,18,0,18,0
1714616491101,EDS 289C,A01,507361,Daly; Alan J.,18,0,18,0
1714616492126,EDS 290,A00,507366,Hofstetter; Carolyn,15,0,15,0
1714616493156,LIGM 5A,A00,507421,Fischer-Grunski; Eva K,18,0,20,2
1714616494184,LIGM 5B,A00,507423,Fischer-Grunski; Eva K,19,0,20,1
1714616495213,LIGM 5C,A00,507425,Fischer-Grunski; Eva K,19,0,20,1
1714616496243,LIIT 5AS,A00,507427,Carnelos; Chiara,20,0,20,0
1714616497268,LIIT 5BS,A00,507430,Carnelos; Chiara,20,0,20,0
1714616498298,LIIT 5CS,A00,507432,Carnelos; Chiara,20,0,20,0
1714616499326,LISP 5A,A00,507541,Munoz Sanchez; Alicia,11,0,20,9
1714616500353,LISP 5B,A00,507671,Munoz Sanchez; Alicia,8,0,20,12
1714616501379,LISP 5C,A00,507696,Munoz Sanchez; Alicia,9,0,20,11
1714616502405,MAE 197,001,528363,Boechler; Nicholas Sebastia,9998,0,9999,1
1714616503431,MATH 197,001,523477,Kedlaya; Kiran S.,9995,0,9999,4
1714616503431,MATH 197,002,563811,Zhang; Danna,9995,0,9999,4
1714616503431,MATH 197,003,628552,Dumitriu; Ioana,9998,0,9999,1
1714616504458,MCWP 40R,A00,518780,Staff,2,0,20,18
1714616504458,MCWP 40R,B00,518781,Staff,8,0,20,12
1714616504458,MCWP 40R,C00,518783,Staff,6,0,20,14
1714616505487,MCWP 50R,A00,518791,Staff,0,0,20,20
1714616505487,MCWP 50R,B00,518792,Staff,0,2,20,20
1714616505487,MCWP 50R,C00,518793,Staff,0,2,20,20
1714616505487,MCWP 50R,D00,518794,Staff,0,0,20,20
1714616505487,MCWP 50R,E00,518795,Staff,0,2,20,20
1714616505487,MCWP 50R,F00,518796,Staff,0,0,20,20
1714616505487,MCWP 50R,G00,518797,Staff,0,1,20,20
1714616506516,MMW 12R,A01,514034,Herbst; Matthew,0,0,16,16
1714616506516,MMW 12R,A02,514035,Herbst; Matthew,1,0,16,15
1714616507544,MMW 13R,A01,514037,Staff,0,4,16,16
1714616507544,MMW 13R,A02,514039,Staff,0,2,16,16
1714616507544,MMW 13R,A03,628519,Staff,0,2,16,16
1714616509669,SIO 295LS,A00,523233,Staff,10,0,30,20
1714616510695,SIO 295S,A00,523232,Staff,10,0,30,20
1714616511721,SIOC 290S,A01,637330,Merrifield; Mark A,23,0,30,7
1714616512748,SIOC 291S,A01,637333,Gabriel; Corey John,23,0,30,7
1714616513774,SOCI 117,A01,494376,Staff,0,4,5,5
1714616514805,WES 237B,A00,494380,Staff,9,0,20,11
1714616516873,AESE 279B,A00,494370,Wade; Jon P,0,0,33,33
1714616517898,AIP 197,001,627712,Vespa; Emanuel Ignacio,9998,0,9999,1
1714616518926,ANAR 135S,A00,494369,Braswell; Geoffrey E.,0,0,0,0
1714616519954,BENG 196,001,628496,Engler; Adam J.,9998,0,9999,1
1714616520985,CAT 124RS,A01,519847,Geibel; William,0,0,20,20
1714616522011,CAT 125RS,A01,515971,Geibel; William,0,0,20,20
1714616523037,CLRE 250,A00,511389,Morris; Sheldon,9993,0,9999,6
1714616524064,CLRE 251,A00,507176,Mehta; Ravindra L.,9993,0,9999,6
1714616524064,CLRE 251,B00,511410,Mehta; Ravindra L.,9998,0,9999,1
1714616525094,CLRE 252,A00,507189,Cuomo; Raphael Eduardo,9995,0,9999,4
1714616526121,CLRE 253,A00,507199,Vaida; Florin,9994,0,9999,5
1714616526121,CLRE 253,B00,507202,Vaida; Florin,9999,0,9999,0
1714616527150,CLRE 259,A00,507211,Patel; Hemal,9996,0,9999,3
1714616528175,CLRE 260,A00,507221,Cuomo; Raphael Eduardo,9999,0,9999,0
1714616529202,CLRE 297,001,507242,Cuomo; Raphael Eduardo,9999,0,9999,0
1714616530227,COGS 197,001,638244,Voytek; Bradley Thomas,9998,0,9999,1
1714616531253,CSE 191,A00,516875,Minnes Kemp; Mor Mia,9992,0,9999,7
1714616532277,CSE 197,001,637388,Minnes Kemp; Mor Mia,9998,0,9999,1
1714616533301,CSS 201S,A01,494383,Staff,35,0,35,0
1714616534332,CSS 202S,A01,494387,Staff,35,0,35,0
1714616535358,DSC 197,001,628532,Eldridge; Justin Matthew,9996,0,9999,3
1714616536387,EAP 100,A00,516065,Staff,9797,0,9999,202
1714616537416,ECE 45,A01,507414,Staff,33,0,60,27
1714616540095,ECE 111,A01,507420,Staff,15,0,50,35
1714616541120,ECE 197,001,548057,Sievenpiper; Daniel F.,9993,0,9999,6
1714616542144,EDS 115,A00,507243,Choi; Bailey Miyeon,10,0,28,18
1714616543170,EDS 117,A01,494379,Staff,1,5,30,29
1714616544194,EDS 125,A00,507246,Hopkins; Megan Beth,9,0,30,21
1714616545224,EDS 128A,A01,507264,Fargason; Sharon Gayle,8,0,26,18
1714616546249,EDS 128B,A01,507293,Pappas; Elizabeth,12,0,30,18
1714616547273,EDS 139,A00,507294,Fargason; Sharon Gayle,13,0,30,17
1714616547273,EDS 139,B00,507313,Pappas; Elizabeth,13,0,30,17
1714616548302,EDS 201,A00,507315,Staff,13,0,30,17
1714616549331,EDS 203,A01,507317,Halter; Christopher P.,12,0,30,18
1714616550363,EDS 204R,A01,507319,Halter; Christopher P.,0,3,30,30
1714616550363,EDS 204R,B01,507331,Heinzman; Erica M.,16,0,30,14
1714616551388,EDS 206R,A00,507332,Staff,0,4,30,30
1714616551388,EDS 206R,B00,507343,Staff,17,0,30,13
1714616552416,EDS 250,A00,507344,Hemans; Patricia Ann Benitez,22,0,40,18
1714616553444,EDS 281,A00,507345,Daly; Alan J.,18,0,18,0
1714616554467,EDS 284,A00,507350,Daly; Alan J.,16,0,16,0
1714616555493,EDS 286,A00,507359,Fine; Sarah,18,0,18,0
1714616556520,EDS 289C,A01,507361,Daly; Alan J.,18,0,18,0
1714616557546,EDS 290,A00,507366,Hofstetter; Carolyn,15,0,15,0
1714616558572,LIGM 5A,A00,507421,Fischer-Grunski; Eva K,18,0,20,2
1714616559601,LIGM 5B,A00,507423,Fischer-Grunski; Eva K,19,0,20,1
1714616560626,LIGM 5C,A00,507425,Fischer-Grunski; Eva K,19,0,20,1
1714616561655,LIIT 5AS,A00,507427,Carnelos; Chiara,20,0,20,0
1714616562681,LIIT 5BS,A00,507430,Carnelos; Chiara,20,0,20,0
1714616563710,LIIT 5CS,A00,507432,Carnelos; Chiara,20,0,20,0
1714616564736,LISP 5A,A00,507541,Munoz Sanchez; Alicia,11,0,20,9
1714616565762,LISP 5B,A00,507671,Munoz Sanchez; Alicia,8,0,20,12
1714616566789,LISP 5C,A00,507696,Munoz Sanchez; Alicia,9,0,20,11
1714616567815,MAE 197,001,528363,Boechler; Nicholas Sebastia,9998,0,9999,1
1714616568846,MATH 197,001,523477,Kedlaya; Kiran S.,9995,0,9999,4
1714616568846,MATH 197,002,563811,Zhang; Danna,9995,0,9999,4
1714616568846,MATH 197,003,628552,Dumitriu; Ioana,9998,0,9999,1
1714616569873,MCWP 40R,A00,518780,Staff,2,0,20,18
1714616569873,MCWP 40R,B00,518781,Staff,8,0,20,12
1714616569873,MCWP 40R,C00,518783,Staff,6,0,20,14
1714616570898,MCWP 50R,A00,518791,Staff,0,0,20,20
1714616570898,MCWP 50R,B00,518792,Staff,0,2,20,20
1714616570898,MCWP 50R,C00,518793,Staff,0,2,20,20
1714616570898,MCWP 50R,D00,518794,Staff,0,0,20,20
1714616570898,MCWP 50R,E00,518795,Staff,0,2,20,20
1714616570898,MCWP 50R,F00,518796,Staff,0,0,20,20
1714616570898,MCWP 50R,G00,518797,Staff,0,1,20,20
1714616571925,MMW 12R,A01,514034,Herbst; Matthew,0,0,16,16
1714616571925,MMW 12R,A02,514035,Herbst; Matthew,1,0,16,15
1714616572954,MMW 13R,A01,514037,Staff,0,4,16,16
1714616572954,MMW 13R,A02,514039,Staff,0,2,16,16
1714616572954,MMW 13R,A03,628519,Staff,0,2,16,16
1714616575004,SIO 295LS,A00,523233,Staff,10,0,30,20
1714616576028,SIO 295S,A00,523232,Staff,10,0,30,20
1714616577054,SIOC 290S,A01,637330,Merrifield; Mark A,23,0,30,7
1714616578079,SIOC 291S,A01,637333,Gabriel; Corey John,23,0,30,7
1714616579105,SOCI 117,A01,494376,Staff,0,4,5,5
1714616580133,WES 237B,A00,494380,Staff,9,0,20,11
1714616582209,AESE 279B,A00,494370,Wade; Jon P,0,0,33,33
1714616583234,AIP 197,001,627712,Vespa; Emanuel Ignacio,9998,0,9999,1
1714616584261,ANAR 135S,A00,494369,Braswell; Geoffrey E.,0,0,0,0
1714616585286,BENG 196,001,628496,Engler; Adam J.,9998,0,9999,1
1714616586312,CAT 124RS,A01,519847,Geibel; William,0,0,20,20
1714616587339,CAT 125RS,A01,515971,Geibel; William,0,0,20,20
1714616588370,CLRE 250,A00,511389,Morris; Sheldon,9993,0,9999,6
1714616589398,CLRE 251,A00,507176,Mehta; Ravindra L.,9993,0,9999,6
1714616589398,CLRE 251,B00,511410,Mehta; Ravindra L.,9998,0,9999,1
1714616590427,CLRE 252,A00,507189,Cuomo; Raphael Eduardo,9995,0,9999,4
1714616591455,CLRE 253,A00,507199,Vaida; Florin,9994,0,9999,5
1714616591455,CLRE 253,B00,507202,Vaida; Florin,9999,0,9999,0
1714616592482,CLRE 259,A00,507211,Patel; Hemal,9996,0,9999,3
1714616593509,CLRE 260,A00,507221,Cuomo; Raphael Eduardo,9999,0,9999,0
1714616594534,CLRE 297,001,507242,Cuomo; Raphael Eduardo,9999,0,9999,0
1714616595560,COGS 197,001,638244,Voytek; Bradley Thomas,9998,0,9999,1
1714616596589,CSE 191,A00,516875,Minnes Kemp; Mor Mia,9992,0,9999,7
1714616597614,CSE 197,001,637388,Minnes Kemp; Mor Mia,9998,0,9999,1
1714616598643,CSS 201S,A01,494383,Staff,35,0,35,0
1714616599668,CSS 202S,A01,494387,Staff,35,0,35,0
1714616600694,DSC 197,001,628532,Eldridge; Justin Matthew,9996,0,9999,3
1714616601720,EAP 100,A00,516065,Staff,9797,0,9999,202
1714616602748,ECE 45,A01,507414,Staff,33,0,60,27
1714616604802,ECE 111,A01,507420,Staff,15,0,50,35
1714616605829,ECE 197,001,548057,Sievenpiper; Daniel F.,9993,0,9999,6
1714616606855,EDS 115,A00,507243,Choi; Bailey Miyeon,10,0,28,18
1714616607884,EDS 117,A01,494379,Staff,1,5,30,29
1714616608910,EDS 125,A00,507246,Hopkins; Megan Beth,9,0,30,21
1714616609939,EDS 128A,A01,507264,Fargason; Sharon Gayle,8,0,26,18
1714616610967,EDS 128B,A01,507293,Pappas; Elizabeth,12,0,30,18
1714616611991,EDS 139,A00,507294,Fargason; Sharon Gayle,13,0,30,17
1714616611991,EDS 139,B00,507313,Pappas; Elizabeth,13,0,30,17
1714616613016,EDS 201,A00,507315,Staff,13,0,30,17
1714616614041,EDS 203,A01,507317,Halter; Christopher P.,12,0,30,18
1714616615066,EDS 204R,A01,507319,Halter; Christopher P.,0,3,30,30
1714616615066,EDS 204R,B01,507331,Heinzman; Erica M.,16,0,30,14
1714616616089,EDS 206R,A00,507332,Staff,0,4,30,30
1714616616089,EDS 206R,B00,507343,Staff,17,0,30,13
1714616617116,EDS 250,A00,507344,Hemans; Patricia Ann Benitez,22,0,40,18
1714616618144,EDS 281,A00,507345,Daly; Alan J.,18,0,18,0
1714616619168,EDS 284,A00,507350,Daly; Alan J.,16,0,16,0
1714616620192,EDS 286,A00,507359,Fine; Sarah,18,0,18,0
1714616621218,EDS 289C,A01,507361,Daly; Alan J.,18,0,18,0
1714616622246,EDS 290,A00,507366,Hofstetter; Carolyn,15,0,15,0
1714616623270,LIGM 5A,A00,507421,Fischer-Grunski; Eva K,18,0,20,2
1714616624297,LIGM 5B,A00,507423,Fischer-Grunski; Eva K,19,0,20,1
1714616625322,LIGM 5C,A00,507425,Fischer-Grunski; Eva K,19,0,20,1
1714616626347,LIIT 5AS,A00,507427,Carnelos; Chiara,20,0,20,0
1714616627372,LIIT 5BS,A00,507430,Carnelos; Chiara,20,0,20,0
1714616628401,LIIT 5CS,A00,507432,Carnelos; Chiara,20,0,20,0
1714616629425,LISP 5A,A00,507541,Munoz Sanchez; Alicia,11,0,20,9
1714616630451,LISP 5B,A00,507671,Munoz Sanchez; Alicia,8,0,20,12
1714616631477,LISP 5C,A00,507696,Munoz Sanchez; Alicia,9,0,20,11
1714616632504,MAE 197,001,528363,Boechler; Nicholas Sebastia,9998,0,9999,1
1714616633531,MATH 197,001,523477,Kedlaya; Kiran S.,9995,0,9999,4
1714616633531,MATH 197,002,563811,Zhang; Danna,9995,0,9999,4
1714616633531,MATH 197,003,628552,Dumitriu; Ioana,9998,0,9999,1
1714616634559,MCWP 40R,A00,518780,Staff,2,0,20,18
1714616634559,MCWP 40R,B00,518781,Staff,8,0,20,12
1714616634559,MCWP 40R,C00,518783,Staff,6,0,20,14
1714616635586,MCWP 50R,A00,518791,Staff,0,0,20,20
1714616635586,MCWP 50R,B00,518792,Staff,0,2,20,20
1714616635586,MCWP 50R,C00,518793,Staff,0,2,20,20
1714616635586,MCWP 50R,D00,518794,Staff,0,0,20,20
1714616635586,MCWP 50R,E00,518795,Staff,0,2,20,20
1714616635586,MCWP 50R,F00,518796,Staff,0,0,20,20
1714616635586,MCWP 50R,G00,518797,Staff,0,1,20,20
1714616636611,MMW 12R,A01,514034,Herbst; Matthew,0,0,16,16
1714616636611,MMW 12R,A02,514035,Herbst; Matthew,1,0,16,15
1714616637636,MMW 13R,A01,514037,Staff,0,4,16,16
1714616637636,MMW 13R,A02,514039,Staff,0,2,16,16
1714616637636,MMW 13R,A03,628519,Staff,0,2,16,16
1714616639691,SIO 295LS,A00,523233,Staff,10,0,30,20
1714616640718,SIO 295S,A00,523232,Staff,10,0,30,20
1714616641745,SIOC 290S,A01,637330,Merrifield; Mark A,23,0,30,7
1714616642774,SIOC 291S,A01,637333,Gabriel; Corey John,23,0,30,7
1714616643799,SOCI 117,A01,494376,Staff,0,4,5,5
1714616644824,WES 237B,A00,494380,Staff,9,0,20,11
1714616646894,AESE 279B,A00,494370,Wade; Jon P,0,0,33,33
1714616647919,AIP 197,001,627712,Vespa; Emanuel Ignacio,9998,0,9999,1
1714616648945,ANAR 135S,A00,494369,Braswell; Geoffrey E.,0,0,0,0
1714616649971,BENG 196,001,628496,Engler; Adam J.,9998,0,9999,1
1714616651001,CAT 124RS,A01,519847,Geibel; William,0,0,20,20
1714616652027,CAT 125RS,A01,515971,Geibel; William,0,0,20,20
1714616653053,CLRE 250,A00,511389,Morris; Sheldon,9993,0,9999,6
1714616654081,CLRE 251,A00,507176,Mehta; Ravindra L.,9993,0,9999,6
1714616654081,CLRE 251,B00,511410,Mehta; Ravindra L.,9998,0,9999,1
1714616655107,CLRE 252,A00,507189,Cuomo; Raphael Eduardo,9995,0,9999,4
1714616656135,CLRE 253,A00,507199,Vaida; Florin,9994,0,9999,5
1714616656135,CLRE 253,B00,507202,Vaida; Florin,9999,0,9999,0
1714616657161,CLRE 259,A00,507211,Patel; Hemal,9996,0,9999,3
1714616658186,CLRE 260,A00,507221,Cuomo; Raphael Eduardo,9999,0,9999,0
1714616659213,CLRE 297,001,507242,Cuomo; Raphael Eduardo,9999,0,9999,0
1714616660238,COGS 197,001,638244,Voytek; Bradley Thomas,9998,0,9999,1
1714616661263,CSE 191,A00,516875,Minnes Kemp; Mor Mia,9992,0,9999,7
1714616662292,CSE 197,001,637388,Minnes Kemp; Mor Mia,9998,0,9999,1
1714616663317,CSS 201S,A01,494383,Staff,35,0,35,0
1714616664346,CSS 202S,A01,494387,Staff,35,0,35,0
1714616665374,DSC 197,001,628532,Eldridge; Justin Matthew,9996,0,9999,3
1714616666398,EAP 100,A00,516065,Staff,9797,0,9999,202
1714616667424,ECE 45,A01,507414,Staff,33,0,60,27
1714616669476,ECE 111,A01,507420,Staff,15,0,50,35
1714616670501,ECE 197,001,548057,Sievenpiper; Daniel F.,9993,0,9999,6
1714616671529,EDS 115,A00,507243,Choi; Bailey Miyeon,10,0,28,18
1714616672555,EDS 117,A01,494379,Staff,1,5,30,29
1714616673580,EDS 125,A00,507246,Hopkins; Megan Beth,9,0,30,21
1714616674605,EDS 128A,A01,507264,Fargason; Sharon Gayle,8,0,26,18
1714616675632,EDS 128B,A01,507293,Pappas; Elizabeth,12,0,30,18
1714616676657,EDS 139,A00,507294,Fargason; Sharon Gayle,13,0,30,17
1714616676657,EDS 139,B00,507313,Pappas; Elizabeth,13,0,30,17
1714616677679,EDS 201,A00,507315,Staff,13,0,30,17
1714616678708,EDS 203,A01,507317,Halter; Christopher P.,12,0,30,18
1714616679733,EDS 204R,A01,507319,Halter; Christopher P.,0,3,30,30
1714616679733,EDS 204R,B01,507331,Heinzman; Erica M.,16,0,30,14
1714616680758,EDS 206R,A00,507332,Staff,0,4,30,30
1714616680758,EDS 206R,B00,507343,Staff,17,0,30,13
1714616681783,EDS 250,A00,507344,Hemans; Patricia Ann Benitez,22,0,40,18
1714616682811,EDS 281,A00,507345,Daly; Alan J.,18,0,18,0
1714616683839,EDS 284,A00,507350,Daly; Alan J.,16,0,16,0
1714616684864,EDS 286,A00,507359,Fine; Sarah,18,0,18,0
1714616685890,EDS 289C,A01,507361,Daly; Alan J.,18,0,18,0
1714616686916,EDS 290,A00,507366,Hofstetter; Carolyn,15,0,15,0
1714616687942,LIGM 5A,A00,507421,Fischer-Grunski; Eva K,18,0,20,2
1714616688967,LIGM 5B,A00,507423,Fischer-Grunski; Eva K,19,0,20,1
1714616689992,LIGM 5C,A00,507425,Fischer-Grunski; Eva K,19,0,20,1
1714616691020,LIIT 5AS,A00,507427,Carnelos; Chiara,20,0,20,0
1714616692045,LIIT 5BS,A00,507430,Carnelos; Chiara,20,0,20,0
1714616693071,LIIT 5CS,A00,507432,Carnelos; Chiara,20,0,20,0
1714616694097,LISP 5A,A00,507541,Munoz Sanchez; Alicia,11,0,20,9
1714616695126,LISP 5B,A00,507671,Munoz Sanchez; Alicia,8,0,20,12
1714616696156,LISP 5C,A00,507696,Munoz Sanchez; Alicia,9,0,20,11
1714616697182,MAE 197,001,528363,Boechler; Nicholas Sebastia,9998,0,9999,1
1714616698214,MATH 197,001,523477,Kedlaya; Kiran S.,9995,0,9999,4
1714616698214,MATH 197,002,563811,Zhang; Danna,9995,0,9999,4
1714616698214,MATH 197,003,628552,Dumitriu; Ioana,9998,0,9999,1
1714616699243,MCWP 40R,A00,518780,Staff,2,0,20,18
1714616699243,MCWP 40R,B00,518781,Staff,8,0,20,12
1714616699243,MCWP 40R,C00,518783,Staff,6,0,20,14
1714616700269,MCWP 50R,A00,518791,Staff,0,0,20,20
1714616700269,MCWP 50R,B00,518792,Staff,0,2,20,20
1714616700269,MCWP 50R,C00,518793,Staff,0,2,20,20
1714616700269,MCWP 50R,D00,518794,Staff,0,0,20,20
1714616700269,MCWP 50R,E00,518795,Staff,0,2,20,20
1714616700269,MCWP 50R,F00,518796,Staff,0,0,20,20
1714616700269,MCWP 50R,G00,518797,Staff,0,1,20,20
1714616701295,MMW 12R,A01,514034,Herbst; Matthew,0,0,16,16
1714616701295,MMW 12R,A02,514035,Herbst; Matthew,1,0,16,15
1714616702357,MMW 13R,A01,514037,Staff,0,4,16,16
1714616702357,MMW 13R,A02,514039,Staff,0,2,16,16
1714616702357,MMW 13R,A03,628519,Staff,0,2,16,16
1714616704406,SIO 295LS,A00,523233,Staff,10,0,30,20
1714616705432,SIO 295S,A00,523232,Staff,10,0,30,20
1714616706461,SIOC 290S,A01,637330,Merrifield; Mark A,23,0,30,7
1714616707485,SIOC 291S,A01,637333,Gabriel; Corey John,23,0,30,7
1714616708511,SOCI 117,A01,494376,Staff,0,4,5,5
1714616709536,WES 237B,A00,494380,Staff,9,0,20,11
1714616711606,AESE 279B,A00,494370,Wade; Jon P,0,0,33,33
1714616712648,AIP 197,001,627712,Vespa; Emanuel Ignacio,9998,0,9999,1
1714616713674,ANAR 135S,A00,494369,Braswell; Geoffrey E.,0,0,0,0
1714616714702,BENG 196,001,628496,Engler; Adam J.,9998,0,9999,1
1714616715727,CAT 124RS,A01,519847,Geibel; William,0,0,20,20
1714616716755,CAT 125RS,A01,515971,Geibel; William,0,0,20,20
1714616717780,CLRE 250,A00,511389,Morris; Sheldon,9993,0,9999,6
1714616718811,CLRE 251,A00,507176,Mehta; Ravindra L.,9993,0,9999,6
1714616718811,CLRE 251,B00,511410,Mehta; Ravindra L.,9998,0,9999,1
1714616719841,CLRE 252,A00,507189,Cuomo; Raphael Eduardo,9995,0,9999,4
1714616720866,CLRE 253,A00,507199,Vaida; Florin,9994,0,9999,5
1714616720866,CLRE 253,B00,507202,Vaida; Florin,9999,0,9999,0
1714616721894,CLRE 259,A00,507211,Patel; Hemal,9996,0,9999,3
1714616722923,CLRE 260,A00,507221,Cuomo; Raphael Eduardo,9999,0,9999,0
1714616723948,CLRE 297,001,507242,Cuomo; Raphael Eduardo,9999,0,9999,0
1714616724974,COGS 197,001,638244,Voytek; Bradley Thomas,9998,0,9999,1
1714616726002,CSE 191,A00,516875,Minnes Kemp; Mor Mia,9992,0,9999,7
1714616727030,CSE 197,001,637388,Minnes Kemp; Mor Mia,9998,0,9999,1
1714616728055,CSS 201S,A01,494383,Staff,35,0,35,0
1714616729080,CSS 202S,A01,494387,Staff,35,0,35,0
1714616730106,DSC 197,001,628532,Eldridge; Justin Matthew,9996,0,9999,3
1714616731134,EAP 100,A00,516065,Staff,9797,0,9999,202
1714616732159,ECE 45,A01,507414,Staff,33,0,60,27
1714616734207,ECE 111,A01,507420,Staff,15,0,50,35
1714616735235,ECE 197,001,548057,Sievenpiper; Daniel F.,9993,0,9999,6
1714616736261,EDS 115,A00,507243,Choi; Bailey Miyeon,10,0,28,18
1714616737286,EDS 117,A01,494379,Staff,1,5,30,29
1714616738316,EDS 125,A00,507246,Hopkins; Megan Beth,9,0,30,21
1714616739341,EDS 128A,A01,507264,Fargason; Sharon Gayle,8,0,26,18
1714616740370,EDS 128B,A01,507293,Pappas; Elizabeth,12,0,30,18
1714616741395,EDS 139,A00,507294,Fargason; Sharon Gayle,13,0,30,17
1714616741395,EDS 139,B00,507313,Pappas; Elizabeth,13,0,30,17
1714616742420,EDS 201,A00,507315,Staff,13,0,30,17
1714616743450,EDS 203,A01,507317,Halter; Christopher P.,12,0,30,18
1714616744475,EDS 204R,A01,507319,Halter; Christopher P.,0,3,30,30
1714616744475,EDS 204R,B01,507331,Heinzman; Erica M.,16,0,30,14
1714616745501,EDS 206R,A00,507332,Staff,0,4,30,30
1714616745501,EDS 206R,B00,507343,Staff,17,0,30,13
1714616746530,EDS 250,A00,507344,Hemans; Patricia Ann Benitez,22,0,40,18
1714616747559,EDS 281,A00,507345,Daly; Alan J.,18,0,18,0
1714616748586,EDS 284,A00,507350,Daly; Alan J.,16,0,16,0
1714616749616,EDS 286,A00,507359,Fine; Sarah,18,0,18,0
1714616750644,EDS 289C,A01,507361,Daly; Alan J.,18,0,18,0
1714616751669,EDS 290,A00,507366,Hofstetter; Carolyn,15,0,15,0
1714616752694,LIGM 5A,A00,507421,Fischer-Grunski; Eva K,18,0,20,2
1714616753719,LIGM 5B,A00,507423,Fischer-Grunski; Eva K,19,0,20,1
1714616754744,LIGM 5C,A00,507425,Fischer-Grunski; Eva K,19,0,20,1
1714616755771,LIIT 5AS,A00,507427,Carnelos; Chiara,20,0,20,0
1714616756797,LIIT 5BS,A00,507430,Carnelos; Chiara,20,0,20,0
1714616757826,LIIT 5CS,A00,507432,Carnelos; Chiara,20,0,20,0
1714616758853,LISP 5A,A00,507541,Munoz Sanchez; Alicia,11,0,20,9
1714616759879,LISP 5B,A00,507671,Munoz Sanchez; Alicia,8,0,20,12
1714616760905,LISP 5C,A00,507696,Munoz Sanchez; Alicia,9,0,20,11
1714616761931,MAE 197,001,528363,Boechler; Nicholas Sebastia,9998,0,9999,1
1714616762958,MATH 197,001,523477,Kedlaya; Kiran S.,9995,0,9999,4
1714616762958,MATH 197,002,563811,Zhang; Danna,9995,0,9999,4
1714616762958,MATH 197,003,628552,Dumitriu; Ioana,9998,0,9999,1
1714616763985,MCWP 40R,A00,518780,Staff,2,0,20,18
1714616763985,MCWP 40R,B00,518781,Staff,8,0,20,12
1714616763985,MCWP 40R,C00,518783,Staff,6,0,20,14
1714616765011,MCWP 50R,A00,518791,Staff,0,0,20,20
1714616765011,MCWP 50R,B00,518792,Staff,0,2,20,20
1714616765011,MCWP 50R,C00,518793,Staff,0,2,20,20
1714616765011,MCWP 50R,D00,518794,Staff,0,0,20,20
1714616765011,MCWP 50R,E00,518795,Staff,0,2,20,20
1714616765011,MCWP 50R,F00,518796,Staff,0,0,20,20
1714616765011,MCWP 50R,G00,518797,Staff,0,1,20,20
1714616766037,MMW 12R,A01,514034,Herbst; Matthew,0,0,16,16
1714616766037,MMW 12R,A02,514035,Herbst; Matthew,1,0,16,15
1714616767066,MMW 13R,A01,514037,Staff,0,4,16,16
1714616767066,MMW 13R,A02,514039,Staff,0,2,16,16
1714616767066,MMW 13R,A03,628519,Staff,0,2,16,16
1714616769119,SIO 295LS,A00,523233,Staff,10,0,30,20
1714616770144,SIO 295S,A00,523232,Staff,10,0,30,20
1714616771170,SIOC 290S,A01,637330,Merrifield; Mark A,23,0,30,7
1714616772196,SIOC 291S,A01,637333,Gabriel; Corey John,23,0,30,7
1714616773223,SOCI 117,A01,494376,Staff,0,4,5,5
1714616774248,WES 237B,A00,494380,Staff,9,0,20,11
1714616776323,AESE 279B,A00,494370,Wade; Jon P,0,0,33,33
1714616777349,AIP 197,001,627712,Vespa; Emanuel Ignacio,9998,0,9999,1
1714616778373,ANAR 135S,A00,494369,Braswell; Geoffrey E.,0,0,0,0
1714616779400,BENG 196,001,628496,Engler; Adam J.,9998,0,9999,1
1714616780425,CAT 124RS,A01,519847,Geibel; William,0,0,20,20
1714616781452,CAT 125RS,A01,515971,Geibel; William,0,0,20,20
1714616782480,CLRE 250,A00,511389,Morris; Sheldon,9993,0,9999,6
1714616783506,CLRE 251,A00,507176,Mehta; Ravindra L.,9993,0,9999,6
1714616783506,CLRE 251,B00,511410,Mehta; Ravindra L.,9998,0,9999,1
1714616784534,CLRE 252,A00,507189,Cuomo; Raphael Eduardo,9995,0,9999,4
1714616785559,CLRE 253,A00,507199,Vaida; Florin,9994,0,9999,5
1714616785559,CLRE 253,B00,507202,Vaida; Florin,9999,0,9999,0
1714616786584,CLRE 259,A00,507211,Patel; Hemal,9996,0,9999,3
1714616787609,CLRE 260,A00,507221,Cuomo; Raphael Eduardo,9999,0,9999,0
1714616788632,CLRE 297,001,507242,Cuomo; Raphael Eduardo,9999,0,9999,0
1714616789657,COGS 197,001,638244,Voytek; Bradley Thomas,9998,0,9999,1
1714616790684,CSE 191,A00,516875,Minnes Kemp; Mor Mia,9992,0,9999,7
1714616791710,CSE 197,001,637388,Minnes Kemp; Mor Mia,9998,0,9999,1
1714616792739,CSS 201S,A01,494383,Staff,35,0,35,0
1714616793766,CSS 202S,A01,494387,Staff,35,0,35,0
1714616794795,DSC 197,001,628532,Eldridge; Justin Matthew,9996,0,9999,3
1714616795820,EAP 100,A00,516065,Staff,9797,0,9999,202
1714616796846,ECE 45,A01,507414,Staff,33,0,60,27
1714616798901,ECE 111,A01,507420,Staff,15,0,50,35
1714616799927,ECE 197,001,548057,Sievenpiper; Daniel F.,9993,0,9999,6
1714616800954,EDS 115,A00,507243,Choi; Bailey Miyeon,10,0,28,18
1714616801980,EDS 117,A01,494379,Staff,1,5,30,29
1714616803006,EDS 125,A00,507246,Hopkins; Megan Beth,9,0,30,21
1714616804031,EDS 128A,A01,507264,Fargason; Sharon Gayle,8,0,26,18
1714616805060,EDS 128B,A01,507293,Pappas; Elizabeth,12,0,30,18
1714616806086,EDS 139,A00,507294,Fargason; Sharon Gayle,13,0,30,17
1714616806086,EDS 139,B00,507313,Pappas; Elizabeth,13,0,30,17
1714616807110,EDS 201,A00,507315,Staff,13,0,30,17
1714616808135,EDS 203,A01,507317,Halter; Christopher P.,12,0,30,18
1714616809164,EDS 204R,A01,507319,Halter; Christopher P.,0,3,30,30
1714616809164,EDS 204R,B01,507331,Heinzman; Erica M.,16,0,30,14
1714616810190,EDS 206R,A00,507332,Staff,0,4,30,30
1714616810190,EDS 206R,B00,507343,Staff,17,0,30,13
1714616811217,EDS 250,A00,507344,Hemans; Patricia Ann Benitez,22,0,40,18
1714616812243,EDS 281,A00,507345,Daly; Alan J.,18,0,18,0
1714616813271,EDS 284,A00,507350,Daly; Alan J.,16,0,16,0
1714616814300,EDS 286,A00,507359,Fine; Sarah,18,0,18,0
1714616815328,EDS 289C,A01,507361,Daly; Alan J.,18,0,18,0
1714616816354,EDS 290,A00,507366,Hofstetter; Carolyn,15,0,15,0
1714616817384,LIGM 5A,A00,507421,Fischer-Grunski; Eva K,18,0,20,2
1714616818410,LIGM 5B,A00,507423,Fischer-Grunski; Eva K,19,0,20,1
1714616819437,LIGM 5C,A00,507425,Fischer-Grunski; Eva K,19,0,20,1
1714616820469,LIIT 5AS,A00,507427,Carnelos; Chiara,20,0,20,0
1714616821495,LIIT 5BS,A00,507430,Carnelos; Chiara,20,0,20,0
1714616822522,LIIT 5CS,A00,507432,Carnelos; Chiara,20,0,20,0
1714616823550,LISP 5A,A00,507541,Munoz Sanchez; Alicia,11,0,20,9
1714616824578,LISP 5B,A00,507671,Munoz Sanchez; Alicia,8,0,20,12
1714616825605,LISP 5C,A00,507696,Munoz Sanchez; Alicia,9,0,20,11
1714616826630,MAE 197,001,528363,Boechler; Nicholas Sebastia,9998,0,9999,1
1714616827658,MATH 197,001,523477,Kedlaya; Kiran S.,9995,0,9999,4
1714616827658,MATH 197,002,563811,Zhang; Danna,9995,0,9999,4
1714616827658,MATH 197,003,628552,Dumitriu; Ioana,9998,0,9999,1
1714616828688,MCWP 40R,A00,518780,Staff,2,0,20,18
1714616828688,MCWP 40R,B00,518781,Staff,8,0,20,12
1714616828688,MCWP 40R,C00,518783,Staff,6,0,20,14
1714616829715,MCWP 50R,A00,518791,Staff,0,0,20,20
1714616829715,MCWP 50R,B00,518792,Staff,0,2,20,20
1714616829715,MCWP 50R,C00,518793,Staff,0,2,20,20
1714616829715,MCWP 50R,D00,518794,Staff,0,0,20,20
1714616829715,MCWP 50R,E00,518795,Staff,0,2,20,20
1714616829715,MCWP 50R,F00,518796,Staff,0,0,20,20
1714616829715,MCWP 50R,G00,518797,Staff,0,1,20,20
1714616830746,MMW 12R,A01,514034,Herbst; Matthew,0,0,16,16
1714616830746,MMW 12R,A02,514035,Herbst; Matthew,1,0,16,15
1714616831770,MMW 13R,A01,514037,Staff,0,4,16,16
1714616831770,MMW 13R,A02,514039,Staff,0,2,16,16
1714616831770,MMW 13R,A03,628519,Staff,0,2,16,16
1714616833819,SIO 295LS,A00,523233,Staff,10,0,30,20
1714616834844,SIO 295S,A00,523232,Staff,10,0,30,20
1714616835871,SIOC 290S,A01,637330,Merrifield; Mark A,23,0,30,7
1714616836897,SIOC 291S,A01,637333,Gabriel; Corey John,23,0,30,7
1714616837924,SOCI 117,A01,494376,Staff,0,4,5,5
1714616838955,WES 237B,A00,494380,Staff,9,0,20,11
1714616841035,AESE 279B,A00,494370,Wade; Jon P,0,0,33,33
1714616842062,AIP 197,001,627712,Vespa; Emanuel Ignacio,9998,0,9999,1
1714616843090,ANAR 135S,A00,494369,Braswell; Geoffrey E.,0,0,0,0
1714616844117,BENG 196,001,628496,Engler; Adam J.,9998,0,9999,1
1714616845144,CAT 124RS,A01,519847,Geibel; William,0,0,20,20
1714616846169,CAT 125RS,A01,515971,Geibel; William,0,0,20,20
1714616847194,CLRE 250,A00,511389,Morris; Sheldon,9993,0,9999,6
1714616848221,CLRE 251,A00,507176,Mehta; Ravindra L.,9993,0,9999,6
1714616848221,CLRE 251,B00,511410,Mehta; Ravindra L.,9998,0,9999,1
1714616849250,CLRE 252,A00,507189,Cuomo; Raphael Eduardo,9995,0,9999,4
1714616850281,CLRE 253,A00,507199,Vaida; Florin,9994,0,9999,5
1714616850281,CLRE 253,B00,507202,Vaida; Florin,9999,0,9999,0
1714616851308,CLRE 259,A00,507211,Patel; Hemal,9996,0,9999,3
1714616852334,CLRE 260,A00,507221,Cuomo; Raphael Eduardo,9999,0,9999,0
1714616853358,CLRE 297,001,507242,Cuomo; Raphael Eduardo,9999,0,9999,0
1714616854384,COGS 197,001,638244,Voytek; Bradley Thomas,9998,0,9999,1
1714616855413,CSE 191,A00,516875,Minnes Kemp; Mor Mia,9992,0,9999,7
1714616856441,CSE 197,001,637388,Minnes Kemp; Mor Mia,9998,0,9999,1
1714616857464,CSS 201S,A01,494383,Staff,35,0,35,0
1714616858490,CSS 202S,A01,494387,Staff,35,0,35,0
1714616859515,DSC 197,001,628532,Eldridge; Justin Matthew,9996,0,9999,3
1714616860543,EAP 100,A00,516065,Staff,9797,0,9999,202
1714616861571,ECE 45,A01,507414,Staff,32,0,60,28
1714616863620,ECE 111,A01,507420,Staff,15,0,50,35
1714616864646,ECE 197,001,548057,Sievenpiper; Daniel F.,9993,0,9999,6
1714616865670,EDS 115,A00,507243,Choi; Bailey Miyeon,10,0,28,18
1714616866696,EDS 117,A01,494379,Staff,1,5,30,29
1714616867725,EDS 125,A00,507246,Hopkins; Megan Beth,9,0,30,21
1714616868753,EDS 128A,A01,507264,Fargason; Sharon Gayle,8,0,26,18
1714616869780,EDS 128B,A01,507293,Pappas; Elizabeth,12,0,30,18
1714616870804,EDS 139,A00,507294,Fargason; Sharon Gayle,13,0,30,17
1714616870804,EDS 139,B00,507313,Pappas; Elizabeth,13,0,30,17
1714616871833,EDS 201,A00,507315,Staff,13,0,30,17
1714616872862,EDS 203,A01,507317,Halter; Christopher P.,12,0,30,18
1714616873896,EDS 204R,A01,507319,Halter; Christopher P.,0,3,30,30
1714616873896,EDS 204R,B01,507331,Heinzman; Erica M.,16,0,30,14
1714616874923,EDS 206R,A00,507332,Staff,0,4,30,30
1714616874923,EDS 206R,B00,507343,Staff,17,0,30,13
1714616875950,EDS 250,A00,507344,Hemans; Patricia Ann Benitez,22,0,40,18
1714616876975,EDS 281,A00,507345,Daly; Alan J.,18,0,18,0
1714616877999,EDS 284,A00,507350,Daly; Alan J.,16,0,16,0
1714616879024,EDS 286,A00,507359,Fine; Sarah,18,0,18,0
1714616880047,EDS 289C,A01,507361,Daly; Alan J.,18,0,18,0
1714616881072,EDS 290,A00,507366,Hofstetter; Carolyn,15,0,15,0
1714616882102,LIGM 5A,A00,507421,Fischer-Grunski; Eva K,18,0,20,2
1714616883126,LIGM 5B,A00,507423,Fischer-Grunski; Eva K,19,0,20,1
1714616884155,LIGM 5C,A00,507425,Fischer-Grunski; Eva K,19,0,20,1
1714616885183,LIIT 5AS,A00,507427,Carnelos; Chiara,20,0,20,0
1714616886208,LIIT 5BS,A00,507430,Carnelos; Chiara,20,0,20,0
1714616887235,LIIT 5CS,A00,507432,Carnelos; Chiara,20,0,20,0
1714616888261,LISP 5A,A00,507541,Munoz Sanchez; Alicia,11,0,20,9
1714616889290,LISP 5B,A00,507671,Munoz Sanchez; Alicia,8,0,20,12
1714616890314,LISP 5C,A00,507696,Munoz Sanchez; Alicia,9,0,20,11
1714616891340,MAE 197,001,528363,Boechler; Nicholas Sebastia,9998,0,9999,1
1714616892369,MATH 197,001,523477,Kedlaya; Kiran S.,9995,0,9999,4
1714616892369,MATH 197,002,563811,Zhang; Danna,9995,0,9999,4
1714616892369,MATH 197,003,628552,Dumitriu; Ioana,9998,0,9999,1
1714616893392,MCWP 40R,A00,518780,Staff,2,0,20,18
1714616893392,MCWP 40R,B00,518781,Staff,8,0,20,12
1714616893392,MCWP 40R,C00,518783,Staff,6,0,20,14
1714616894416,MCWP 50R,A00,518791,Staff,0,0,20,20
1714616894416,MCWP 50R,B00,518792,Staff,0,2,20,20
1714616894416,MCWP 50R,C00,518793,Staff,0,2,20,20
1714616894416,MCWP 50R,D00,518794,Staff,0,0,20,20
1714616894416,MCWP 50R,E00,518795,Staff,0,2,20,20
1714616894416,MCWP 50R,F00,518796,Staff,0,0,20,20
1714616894416,MCWP 50R,G00,518797,Staff,0,1,20,20
1714616895442,MMW 12R,A01,514034,Herbst; Matthew,0,0,16,16
1714616895442,MMW 12R,A02,514035,Herbst; Matthew,1,0,16,15
1714616896468,MMW 13R,A01,514037,Staff,0,4,16,16
1714616896468,MMW 13R,A02,514039,Staff,0,2,16,16
1714616896468,MMW 13R,A03,628519,Staff,0,2,16,16
1714616898521,SIO 295LS,A00,523233,Staff,10,0,30,20
1714616899547,SIO 295S,A00,523232,Staff,10,0,30,20
1714616900580,SIOC 290S,A01,637330,Merrifield; Mark A,23,0,30,7
1714616901604,SIOC 291S,A01,637333,Gabriel; Corey John,23,0,30,7
1714616902630,SOCI 117,A01,494376,Staff,0,4,5,5
1714616903657,WES 237B,A00,494380,Staff,9,0,20,11
1714616905736,AESE 279B,A00,494370,Wade; Jon P,0,0,33,33
1714616906761,AIP 197,001,627712,Vespa; Emanuel Ignacio,9998,0,9999,1
1714616907787,ANAR 135S,A00,494369,Braswell; Geoffrey E.,0,0,0,0
1714616908813,BENG 196,001,628496,Engler; Adam J.,9998,0,9999,1
1714616909838,CAT 124RS,A01,519847,Geibel; William,0,0,20,20
1714616910865,CAT 125RS,A01,515971,Geibel; William,0,0,20,20
1714616911896,CLRE 250,A00,511389,Morris; Sheldon,9993,0,9999,6
1714616912932,CLRE 251,A00,507176,Mehta; Ravindra L.,9993,0,9999,6
1714616912932,CLRE 251,B00,511410,Mehta; Ravindra L.,9998,0,9999,1
1714616913957,CLRE 252,A00,507189,Cuomo; Raphael Eduardo,9995,0,9999,4
1714616914982,CLRE 253,A00,507199,Vaida; Florin,9994,0,9999,5
1714616914982,CLRE 253,B00,507202,Vaida; Florin,9999,0,9999,0
1714616916010,CLRE 259,A00,507211,Patel; Hemal,9996,0,9999,3
1714616917035,CLRE 260,A00,507221,Cuomo; Raphael Eduardo,9999,0,9999,0
1714616918058,CLRE 297,001,507242,Cuomo; Raphael Eduardo,9999,0,9999,0
1714616919087,COGS 197,001,638244,Voytek; Bradley Thomas,9998,0,9999,1
1714616920114,CSE 191,A00,516875,Minnes Kemp; Mor Mia,9992,0,9999,7
1714616921138,CSE 197,001,637388,Minnes Kemp; Mor Mia,9998,0,9999,1
1714616922163,CSS 201S,A01,494383,Staff,35,0,35,0
1714616923192,CSS 202S,A01,494387,Staff,35,0,35,0
1714616924218,DSC 197,001,628532,Eldridge; Justin Matthew,9996,0,9999,3
1714616925243,EAP 100,A00,516065,Staff,9797,0,9999,202
1714616926269,ECE 45,A01,507414,Staff,32,0,60,28
1714616928324,ECE 111,A01,507420,Staff,15,0,50,35
1714616929349,ECE 197,001,548057,Sievenpiper; Daniel F.,9993,0,9999,6
1714616930379,EDS 115,A00,507243,Choi; Bailey Miyeon,10,0,28,18
1714616931404,EDS 117,A01,494379,Staff,1,5,30,29
1714616932430,EDS 125,A00,507246,Hopkins; Megan Beth,9,0,30,21
1714616933454,EDS 128A,A01,507264,Fargason; Sharon Gayle,8,0,26,18
1714616934482,EDS 128B,A01,507293,Pappas; Elizabeth,12,0,30,18
1714616935508,EDS 139,A00,507294,Fargason; Sharon Gayle,13,0,30,17
1714616935508,EDS 139,B00,507313,Pappas; Elizabeth,13,0,30,17
1714616936535,EDS 201,A00,507315,Staff,13,0,30,17
1714616937564,EDS 203,A01,507317,Halter; Christopher P.,12,0,30,18
1714616938588,EDS 204R,A01,507319,Halter; Christopher P.,0,3,30,30
1714616938588,EDS 204R,B01,507331,Heinzman; Erica M.,16,0,30,14
1714616939615,EDS 206R,A00,507332,Staff,0,4,30,30
1714616939615,EDS 206R,B00,507343,Staff,17,0,30,13
1714616940642,EDS 250,A00,507344,Hemans; Patricia Ann Benitez,22,0,40,18
1714616941670,EDS 281,A00,507345,Daly; Alan J.,18,0,18,0
1714616942693,EDS 284,A00,507350,Daly; Alan J.,16,0,16,0
1714616943718,EDS 286,A00,507359,Fine; Sarah,18,0,18,0
1714616944745,EDS 289C,A01,507361,Daly; Alan J.,18,0,18,0
1714616945773,EDS 290,A00,507366,Hofstetter; Carolyn,15,0,15,0
1714616946799,LIGM 5A,A00,507421,Fischer-Grunski; Eva K,18,0,20,2
1714616947827,LIGM 5B,A00,507423,Fischer-Grunski; Eva K,19,0,20,1
1714616948851,LIGM 5C,A00,507425,Fischer-Grunski; Eva K,19,0,20,1
1714616949876,LIIT 5AS,A00,507427,Carnelos; Chiara,20,0,20,0
1714616950905,LIIT 5BS,A00,507430,Carnelos; Chiara,20,0,20,0
1714616951935,LIIT 5CS,A00,507432,Carnelos; Chiara,20,0,20,0
1714616952974,LISP 5A,A00,507541,Munoz Sanchez; Alicia,11,0,20,9
1714616954001,LISP 5B,A00,507671,Munoz Sanchez; Alicia,8,0,20,12
1714616955030,LISP 5C,A00,507696,Munoz Sanchez; Alicia,9,0,20,11
1714616956058,MAE 197,001,528363,Boechler; Nicholas Sebastia,9998,0,9999,1
1714616957085,MATH 197,001,523477,Kedlaya; Kiran S.,9995,0,9999,4
1714616957085,MATH 197,002,563811,Zhang; Danna,9995,0,9999,4
1714616957085,MATH 197,003,628552,Dumitriu; Ioana,9998,0,9999,1
1714616958110,MCWP 40R,A00,518780,Staff,2,0,20,18
1714616958110,MCWP 40R,B00,518781,Staff,8,0,20,12
1714616958110,MCWP 40R,C00,518783,Staff,6,0,20,14
1714616959139,MCWP 50R,A00,518791,Staff,0,0,20,20
1714616959139,MCWP 50R,B00,518792,Staff,0,2,20,20
1714616959139,MCWP 50R,C00,518793,Staff,0,2,20,20
1714616959139,MCWP 50R,D00,518794,Staff,0,0,20,20
1714616959139,MCWP 50R,E00,518795,Staff,0,2,20,20
1714616959139,MCWP 50R,F00,518796,Staff,0,0,20,20
1714616959139,MCWP 50R,G00,518797,Staff,0,1,20,20
1714616960166,MMW 12R,A01,514034,Herbst; Matthew,0,0,16,16
1714616960166,MMW 12R,A02,514035,Herbst; Matthew,1,0,16,15
1714616961191,MMW 13R,A01,514037,Staff,0,4,16,16
1714616961191,MMW 13R,A02,514039,Staff,0,2,16,16
1714616961191,MMW 13R,A03,628519,Staff,0,2,16,16
1714616963244,SIO 295LS,A00,523233,Staff,10,0,30,20
1714616964268,SIO 295S,A00,523232,Staff,10,0,30,20
1714616965296,SIOC 290S,A01,637330,Merrifield; Mark A,23,0,30,7
1714616966321,SIOC 291S,A01,637333,Gabriel; Corey John,23,0,30,7
1714616967347,SOCI 117,A01,494376,Staff,0,4,5,5
1714616968371,WES 237B,A00,494380,Staff,9,0,20,11
1714616970437,AESE 279B,A00,494370,Wade; Jon P,0,0,33,33
1714616971462,AIP 197,001,627712,Vespa; Emanuel Ignacio,9998,0,9999,1
1714616972500,ANAR 135S,A00,494369,Braswell; Geoffrey E.,0,0,0,0
1714616973526,BENG 196,001,628496,Engler; Adam J.,9998,0,9999,1
1714616974551,CAT 124RS,A01,519847,Geibel; William,0,0,20,20
1714616975576,CAT 125RS,A01,515971,Geibel; William,0,0,20,20
1714616976602,CLRE 250,A00,511389,Morris; Sheldon,9993,0,9999,6
1714616977629,CLRE 251,A00,507176,Mehta; Ravindra L.,9993,0,9999,6
1714616977629,CLRE 251,B00,511410,Mehta; Ravindra L.,9998,0,9999,1
1714616978656,CLRE 252,A00,507189,Cuomo; Raphael Eduardo,9995,0,9999,4
1714616979686,CLRE 253,A00,507199,Vaida; Florin,9994,0,9999,5
1714616979686,CLRE 253,B00,507202,Vaida; Florin,9999,0,9999,0
1714616980711,CLRE 259,A00,507211,Patel; Hemal,9996,0,9999,3
1714616981737,CLRE 260,A00,507221,Cuomo; Raphael Eduardo,9999,0,9999,0
1714616982762,CLRE 297,001,507242,Cuomo; Raphael Eduardo,9999,0,9999,0
1714616983787,COGS 197,001,638244,Voytek; Bradley Thomas,9998,0,9999,1
1714616984816,CSE 191,A00,516875,Minnes Kemp; Mor Mia,9992,0,9999,7
1714616985840,CSE 197,001,637388,Minnes Kemp; Mor Mia,9998,0,9999,1
1714616986866,CSS 201S,A01,494383,Staff,35,0,35,0
1714616987892,CSS 202S,A01,494387,Staff,35,0,35,0
1714616988919,DSC 197,001,628532,Eldridge; Justin Matthew,9996,0,9999,3
1714616989944,EAP 100,A00,516065,Staff,9797,0,9999,202
1714616990970,ECE 45,A01,507414,Staff,33,0,60,27
1714616993022,ECE 111,A01,507420,Staff,15,0,50,35
1714616994047,ECE 197,001,548057,Sievenpiper; Daniel F.,9993,0,9999,6
1714616995081,EDS 115,A00,507243,Choi; Bailey Miyeon,10,0,28,18
1714616996108,EDS 117,A01,494379,Staff,1,5,30,29
1714616997135,EDS 125,A00,507246,Hopkins; Megan Beth,9,0,30,21
1714616998160,EDS 128A,A01,507264,Fargason; Sharon Gayle,8,0,26,18
1714616999187,EDS 128B,A01,507293,Pappas; Elizabeth,12,0,30,18
1714617000212,EDS 139,A00,507294,Fargason; Sharon Gayle,13,0,30,17
1714617000212,EDS 139,B00,507313,Pappas; Elizabeth,13,0,30,17
1714617001240,EDS 201,A00,507315,Staff,13,0,30,17
1714617002267,EDS 203,A01,507317,Halter; Christopher P.,12,0,30,18
1714617003291,EDS 204R,A01,507319,Halter; Christopher P.,0,3,30,30
1714617003291,EDS 204R,B01,507331,Heinzman; Erica M.,16,0,30,14
1714617004370,EDS 206R,A00,507332,Staff,0,4,30,30
1714617004370,EDS 206R,B00,507343,Staff,17,0,30,13
1714617005394,EDS 250,A00,507344,Hemans; Patricia Ann Benitez,22,0,40,18
1714617006419,EDS 281,A00,507345,Daly; Alan J.,18,0,18,0
1714617007443,EDS 284,A00,507350,Daly; Alan J.,16,0,16,0
1714617008469,EDS 286,A00,507359,Fine; Sarah,18,0,18,0
1714617009496,EDS 289C,A01,507361,Daly; Alan J.,18,0,18,0
1714617010520,EDS 290,A00,507366,Hofstetter; Carolyn,15,0,15,0
1714617011550,LIGM 5A,A00,507421,Fischer-Grunski; Eva K,18,0,20,2
1714617012577,LIGM 5B,A00,507423,Fischer-Grunski; Eva K,19,0,20,1
1714617013603,LIGM 5C,A00,507425,Fischer-Grunski; Eva K,19,0,20,1
1714617014629,LIIT 5AS,A00,507427,Carnelos; Chiara,20,0,20,0
1714617015654,LIIT 5BS,A00,507430,Carnelos; Chiara,20,0,20,0
1714617016678,LIIT 5CS,A00,507432,Carnelos; Chiara,20,0,20,0
1714617017705,LISP 5A,A00,507541,Munoz Sanchez; Alicia,11,0,20,9
1714617018733,LISP 5B,A00,507671,Munoz Sanchez; Alicia,8,0,20,12
1714617019761,LISP 5C,A00,507696,Munoz Sanchez; Alicia,9,0,20,11
1714617020789,MAE 197,001,528363,Boechler; Nicholas Sebastia,9998,0,9999,1
1714617021815,MATH 197,001,523477,Kedlaya; Kiran S.,9995,0,9999,4
1714617021815,MATH 197,002,563811,Zhang; Danna,9995,0,9999,4
1714617021815,MATH 197,003,628552,Dumitriu; Ioana,9998,0,9999,1
1714617022842,MCWP 40R,A00,518780,Staff,2,0,20,18
1714617022842,MCWP 40R,B00,518781,Staff,8,0,20,12
1714617022842,MCWP 40R,C00,518783,Staff,6,0,20,14
1714617023871,MCWP 50R,A00,518791,Staff,0,0,20,20
1714617023871,MCWP 50R,B00,518792,Staff,0,2,20,20
1714617023871,MCWP 50R,C00,518793,Staff,0,2,20,20
1714617023871,MCWP 50R,D00,518794,Staff,0,0,20,20
1714617023871,MCWP 50R,E00,518795,Staff,0,2,20,20
1714617023871,MCWP 50R,F00,518796,Staff,0,0,20,20
1714617023871,MCWP 50R,G00,518797,Staff,0,1,20,20
1714617024898,MMW 12R,A01,514034,Herbst; Matthew,0,0,16,16
1714617024898,MMW 12R,A02,514035,Herbst; Matthew,1,0,16,15
1714617025923,MMW 13R,A01,514037,Staff,0,4,16,16
1714617025923,MMW 13R,A02,514039,Staff,0,2,16,16
1714617025923,MMW 13R,A03,628519,Staff,0,2,16,16
1714617027975,SIO 295LS,A00,523233,Staff,10,0,30,20
1714617029000,SIO 295S,A00,523232,Staff,10,0,30,20
1714617030033,SIOC 290S,A01,637330,Merrifield; Mark A,23,0,30,7
1714617031058,SIOC 291S,A01,637333,Gabriel; Corey John,23,0,30,7
1714617032086,SOCI 117,A01,494376,Staff,0,4,5,5
1714617033112,WES 237B,A00,494380,Staff,9,0,20,11
1714617035175,AESE 279B,A00,494370,Wade; Jon P,0,0,33,33
1714617036203,AIP 197,001,627712,Vespa; Emanuel Ignacio,9998,0,9999,1
1714617037231,ANAR 135S,A00,494369,Braswell; Geoffrey E.,0,0,0,0
1714617038257,BENG 196,001,628496,Engler; Adam J.,9998,0,9999,1
1714617039283,CAT 124RS,A01,519847,Geibel; William,0,0,20,20
1714617040311,CAT 125RS,A01,515971,Geibel; William,0,0,20,20
1714617041337,CLRE 250,A00,511389,Morris; Sheldon,9993,0,9999,6
1714617042366,CLRE 251,A00,507176,Mehta; Ravindra L.,9993,0,9999,6
1714617042366,CLRE 251,B00,511410,Mehta; Ravindra L.,9998,0,9999,1
1714617043392,CLRE 252,A00,507189,Cuomo; Raphael Eduardo,9995,0,9999,4
1714617044420,CLRE 253,A00,507199,Vaida; Florin,9994,0,9999,5
1714617044420,CLRE 253,B00,507202,Vaida; Florin,9999,0,9999,0
1714617045449,CLRE 259,A00,507211,Patel; Hemal,9996,0,9999,3
1714617046474,CLRE 260,A00,507221,Cuomo; Raphael Eduardo,9999,0,9999,0
1714617047498,CLRE 297,001,507242,Cuomo; Raphael Eduardo,9999,0,9999,0
1714617048523,COGS 197,001,638244,Voytek; Bradley Thomas,9998,0,9999,1
1714617049547,CSE 191,A00,516875,Minnes Kemp; Mor Mia,9992,0,9999,7
1714617050577,CSE 197,001,637388,Minnes Kemp; Mor Mia,9998,0,9999,1
1714617051609,CSS 201S,A01,494383,Staff,35,0,35,0
1714617052637,CSS 202S,A01,494387,Staff,35,0,35,0
1714617053662,DSC 197,001,628532,Eldridge; Justin Matthew,9996,0,9999,3
1714617054686,EAP 100,A00,516065,Staff,9797,0,9999,202
1714617055713,ECE 45,A01,507414,Staff,33,0,60,27
1714617057769,ECE 111,A01,507420,Staff,15,0,50,35
1714617058797,ECE 197,001,548057,Sievenpiper; Daniel F.,9993,0,9999,6
1714617059822,EDS 115,A00,507243,Choi; Bailey Miyeon,10,0,28,18
1714617060855,EDS 117,A01,494379,Staff,1,5,30,29
1714617061881,EDS 125,A00,507246,Hopkins; Megan Beth,9,0,30,21
1714617062906,EDS 128A,A01,507264,Fargason; Sharon Gayle,8,0,26,18
1714617063931,EDS 128B,A01,507293,Pappas; Elizabeth,12,0,30,18
1714617064959,EDS 139,A00,507294,Fargason; Sharon Gayle,13,0,30,17
1714617064959,EDS 139,B00,507313,Pappas; Elizabeth,13,0,30,17
1714617065990,EDS 201,A00,507315,Staff,13,0,30,17
1714617067015,EDS 203,A01,507317,Halter; Christopher P.,12,0,30,18
1714617068041,EDS 204R,A01,507319,Halter; Christopher P.,0,3,30,30
1714617068041,EDS 204R,B01,507331,Heinzman; Erica M.,16,0,30,14
1714617069066,EDS 206R,A00,507332,Staff,0,4,30,30
1714617069066,EDS 206R,B00,507343,Staff,17,0,30,13
1714617070093,EDS 250,A00,507344,Hemans; Patricia Ann Benitez,22,0,40,18
1714617071119,EDS 281,A00,507345,Daly; Alan J.,18,0,18,0
1714617072142,EDS 284,A00,507350,Daly; Alan J.,16,0,16,0
1714617073172,EDS 286,A00,507359,Fine; Sarah,18,0,18,0
1714617074198,EDS 289C,A01,507361,Daly; Alan J.,18,0,18,0
1714617075224,EDS 290,A00,507366,Hofstetter; Carolyn,15,0,15,0
1714617076251,LIGM 5A,A00,507421,Fischer-Grunski; Eva K,18,0,20,2
1714617077281,LIGM 5B,A00,507423,Fischer-Grunski; Eva K,19,0,20,1
1714617078306,LIGM 5C,A00,507425,Fischer-Grunski; Eva K,19,0,20,1
1714617079335,LIIT 5AS,A00,507427,Carnelos; Chiara,20,0,20,0
1714617080360,LIIT 5BS,A00,507430,Carnelos; Chiara,20,0,20,0
1714617081386,LIIT 5CS,A00,507432,Carnelos; Chiara,20,0,20,0
1714617082411,LISP 5A,A00,507541,Munoz Sanchez; Alicia,11,0,20,9
1714617083438,LISP 5B,A00,507671,Munoz Sanchez; Alicia,8,0,20,12
1714617084464,LISP 5C,A00,507696,Munoz Sanchez; Alicia,9,0,20,11
1714617085489,MAE 197,001,528363,Boechler; Nicholas Sebastia,9998,0,9999,1
1714617086518,MATH 197,001,523477,Kedlaya; Kiran S.,9995,0,9999,4
1714617086518,MATH 197,002,563811,Zhang; Danna,9995,0,9999,4
1714617086518,MATH 197,003,628552,Dumitriu; Ioana,9998,0,9999,1
1714617087546,MCWP 40R,A00,518780,Staff,2,0,20,18
1714617087546,MCWP 40R,B00,518781,Staff,8,0,20,12
1714617087546,MCWP 40R,C00,518783,Staff,6,0,20,14
1714617088571,MCWP 50R,A00,518791,Staff,0,0,20,20
1714617088571,MCWP 50R,B00,518792,Staff,0,2,20,20
1714617088571,MCWP 50R,C00,518793,Staff,0,2,20,20
1714617088571,MCWP 50R,D00,518794,Staff,0,0,20,20
1714617088571,MCWP 50R,E00,518795,Staff,0,2,20,20
1714617088571,MCWP 50R,F00,518796,Staff,0,0,20,20
1714617088571,MCWP 50R,G00,518797,Staff,0,1,20,20
1714617089597,MMW 12R,A01,514034,Herbst; Matthew,0,0,16,16
1714617089597,MMW 12R,A02,514035,Herbst; Matthew,1,0,16,15
1714617090624,MMW 13R,A01,514037,Staff,0,4,16,16
1714617090624,MMW 13R,A02,514039,Staff,0,2,16,16
1714617090624,MMW 13R,A03,628519,Staff,0,2,16,16
1714617092675,SIO 295LS,A00,523233,Staff,10,0,30,20
1714617102501,SIO 295S,A00,523232,Staff,10,0,30,20
1714617103528,SIOC 290S,A01,637330,Merrifield; Mark A,23,0,30,7
1714617104561,SIOC 291S,A01,637333,Gabriel; Corey John,23,0,30,7
1714617105588,SOCI 117,A01,494376,Staff,0,4,5,5
1714617106612,WES 237B,A00,494380,Staff,9,0,20,11
1714617108670,AESE 279B,A00,494370,Wade; Jon P,0,0,33,33
1714617109695,AIP 197,001,627712,Vespa; Emanuel Ignacio,9998,0,9999,1
1714617110720,ANAR 135S,A00,494369,Braswell; Geoffrey E.,0,0,0,0
1714617111746,BENG 196,001,628496,Engler; Adam J.,9998,0,9999,1
1714617112770,CAT 124RS,A01,519847,Geibel; William,0,0,20,20
1714617113796,CAT 125RS,A01,515971,Geibel; William,0,0,20,20
1714617114826,CLRE 250,A00,511389,Morris; Sheldon,9993,0,9999,6
1714617115858,CLRE 251,A00,507176,Mehta; Ravindra L.,9993,0,9999,6
1714617115858,CLRE 251,B00,511410,Mehta; Ravindra L.,9998,0,9999,1
1714617116887,CLRE 252,A00,507189,Cuomo; Raphael Eduardo,9995,0,9999,4
1714617117911,CLRE 253,A00,507199,Vaida; Florin,9994,0,9999,5
1714617117911,CLRE 253,B00,507202,Vaida; Florin,9999,0,9999,0
1714617118937,CLRE 259,A00,507211,Patel; Hemal,9996,0,9999,3
1714617119966,CLRE 260,A00,507221,Cuomo; Raphael Eduardo,9999,0,9999,0
1714617120995,CLRE 297,001,507242,Cuomo; Raphael Eduardo,9999,0,9999,0
1714617122019,COGS 197,001,638244,Voytek; Bradley Thomas,9998,0,9999,1
1714617123046,CSE 191,A00,516875,Minnes Kemp; Mor Mia,9992,0,9999,7
1714617124074,CSE 197,001,637388,Minnes Kemp; Mor Mia,9998,0,9999,1
1714617125101,CSS 201S,A01,494383,Staff,35,0,35,0
1714617126126,CSS 202S,A01,494387,Staff,35,0,35,0
1714617127151,DSC 197,001,628532,Eldridge; Justin Matthew,9996,0,9999,3
1714617128177,EAP 100,A00,516065,Staff,9797,0,9999,202
1714617129203,ECE 45,A01,507414,Staff,33,0,60,27
1714617131258,ECE 111,A01,507420,Staff,15,0,50,35
1714617132288,ECE 197,001,548057,Sievenpiper; Daniel F.,9993,0,9999,6
1714617133319,EDS 115,A00,507243,Choi; Bailey Miyeon,10,0,28,18
1714617134343,EDS 117,A01,494379,Staff,1,5,30,29
1714617135368,EDS 125,A00,507246,Hopkins; Megan Beth,9,0,30,21
1714617136398,EDS 128A,A01,507264,Fargason; Sharon Gayle,8,0,26,18
1714617137424,EDS 128B,A01,507293,Pappas; Elizabeth,12,0,30,18
1714617138451,EDS 139,A00,507294,Fargason; Sharon Gayle,13,0,30,17
1714617138451,EDS 139,B00,507313,Pappas; Elizabeth,13,0,30,17
1714617139478,EDS 201,A00,507315,Staff,13,0,30,17
1714617140506,EDS 203,A01,507317,Halter; Christopher P.,12,0,30,18
1714617141535,EDS 204R,A01,507319,Halter; Christopher P.,0,3,30,30
1714617141535,EDS 204R,B01,507331,Heinzman; Erica M.,16,0,30,14
1714617142562,EDS 206R,A00,507332,Staff,0,4,30,30
1714617142562,EDS 206R,B00,507343,Staff,17,0,30,13
1714617143587,EDS 250,A00,507344,Hemans; Patricia Ann Benitez,22,0,40,18
1714617144612,EDS 281,A00,507345,Daly; Alan J.,18,0,18,0
1714617145634,EDS 284,A00,507350,Daly; Alan J.,16,0,16,0
1714617146659,EDS 286,A00,507359,Fine; Sarah,18,0,18,0
1714617147686,EDS 289C,A01,507361,Daly; Alan J.,18,0,18,0
1714617148711,EDS 290,A00,507366,Hofstetter; Carolyn,15,0,15,0
1714617149738,LIGM 5A,A00,507421,Fischer-Grunski; Eva K,18,0,20,2
1714617150766,LIGM 5B,A00,507423,Fischer-Grunski; Eva K,19,0,20,1
1714617151795,LIGM 5C,A00,507425,Fischer-Grunski; Eva K,19,0,20,1
1714617152821,LIIT 5AS,A00,507427,Carnelos; Chiara,20,0,20,0
1714617153849,LIIT 5BS,A00,507430,Carnelos; Chiara,20,0,20,0
1714617154876,LIIT 5CS,A00,507432,Carnelos; Chiara,20,0,20,0
1714617155902,LISP 5A,A00,507541,Munoz Sanchez; Alicia,11,0,20,9
1714617156931,LISP 5B,A00,507671,Munoz Sanchez; Alicia,8,0,20,12
1714617157958,LISP 5C,A00,507696,Munoz Sanchez; Alicia,9,0,20,11
1714617158986,MAE 197,001,528363,Boechler; Nicholas Sebastia,9998,0,9999,1
1714617160014,MATH 197,001,523477,Kedlaya; Kiran S.,9995,0,9999,4
1714617160014,MATH 197,002,563811,Zhang; Danna,9995,0,9999,4
1714617160014,MATH 197,003,628552,Dumitriu; Ioana,9998,0,9999,1
1714617161042,MCWP 40R,A00,518780,Staff,2,0,20,18
1714617161042,MCWP 40R,B00,518781,Staff,8,0,20,12
1714617161042,MCWP 40R,C00,518783,Staff,6,0,20,14
1714617162068,MCWP 50R,A00,518791,Staff,0,0,20,20
1714617162068,MCWP 50R,B00,518792,Staff,0,2,20,20
1714617162068,MCWP 50R,C00,518793,Staff,0,2,20,20
1714617162068,MCWP 50R,D00,518794,Staff,0,0,20,20
1714617162068,MCWP 50R,E00,518795,Staff,0,2,20,20
1714617162068,MCWP 50R,F00,518796,Staff,0,0,20,20
1714617162068,MCWP 50R,G00,518797,Staff,0,1,20,20
1714617163092,MMW 12R,A01,514034,Herbst; Matthew,0,0,16,16
1714617163092,MMW 12R,A02,514035,Herbst; Matthew,1,0,16,15
1714617164117,MMW 13R,A01,514037,Staff,0,4,16,16
1714617164117,MMW 13R,A02,514039,Staff,0,2,16,16
1714617164117,MMW 13R,A03,628519,Staff,0,2,16,16
1714617166164,SIO 295LS,A00,523233,Staff,10,0,30,20
1714617167188,SIO 295S,A00,523232,Staff,10,0,30,20
1714617168217,SIOC 290S,A01,637330,Merrifield; Mark A,23,0,30,7
1714617169246,SIOC 291S,A01,637333,Gabriel; Corey John,23,0,30,7
1714617170272,SOCI 117,A01,494376,Staff,0,4,5,5
1714617171299,WES 237B,A00,494380,Staff,9,0,20,11
1714617173374,AESE 279B,A00,494370,Wade; Jon P,0,0,33,33
1714617174404,AIP 197,001,627712,Vespa; Emanuel Ignacio,9998,0,9999,1
1714617175431,ANAR 135S,A00,494369,Braswell; Geoffrey E.,0,0,0,0
1714617176455,BENG 196,001,628496,Engler; Adam J.,9998,0,9999,1
1714617177485,CAT 124RS,A01,519847,Geibel; William,0,0,20,20
1714617178508,CAT 125RS,A01,515971,Geibel; William,0,0,20,20
1714617179540,CLRE 250,A00,511389,Morris; Sheldon,9993,0,9999,6
1714617180586,CLRE 251,A00,507176,Mehta; Ravindra L.,9993,0,9999,6
1714617180586,CLRE 251,B00,511410,Mehta; Ravindra L.,9998,0,9999,1
1714617181614,CLRE 252,A00,507189,Cuomo; Raphael Eduardo,9995,0,9999,4
1714617182640,CLRE 253,A00,507199,Vaida; Florin,9994,0,9999,5
1714617182640,CLRE 253,B00,507202,Vaida; Florin,9999,0,9999,0
1714617183666,CLRE 259,A00,507211,Patel; Hemal,9996,0,9999,3
1714617184693,CLRE 260,A00,507221,Cuomo; Raphael Eduardo,9999,0,9999,0
1714617185715,CLRE 297,001,507242,Cuomo; Raphael Eduardo,9999,0,9999,0
1714617186742,COGS 197,001,638244,Voytek; Bradley Thomas,9998,0,9999,1
1714617187820,CSE 191,A00,516875,Minnes Kemp; Mor Mia,9992,0,9999,7
1714617188845,CSE 197,001,637388,Minnes Kemp; Mor Mia,9998,0,9999,1
1714617189876,CSS 201S,A01,494383,Staff,35,0,35,0
1714617190902,CSS 202S,A01,494387,Staff,35,0,35,0
1714617191927,DSC 197,001,628532,Eldridge; Justin Matthew,9996,0,9999,3
1714617192951,EAP 100,A00,516065,Staff,9797,0,9999,202
1714617193975,ECE 45,A01,507414,Staff,33,0,60,27
1714617196027,ECE 111,A01,507420,Staff,15,0,50,35
1714617197051,ECE 197,001,548057,Sievenpiper; Daniel F.,9993,0,9999,6
1714617198082,EDS 115,A00,507243,Choi; Bailey Miyeon,10,0,28,18
1714617199110,EDS 117,A01,494379,Staff,1,5,30,29
1714617200137,EDS 125,A00,507246,Hopkins; Megan Beth,9,0,30,21
1714617201164,EDS 128A,A01,507264,Fargason; Sharon Gayle,8,0,26,18
1714617202191,EDS 128B,A01,507293,Pappas; Elizabeth,12,0,30,18
1714617203215,EDS 139,A00,507294,Fargason; Sharon Gayle,13,0,30,17
1714617203215,EDS 139,B00,507313,Pappas; Elizabeth,13,0,30,17
1714617204241,EDS 201,A00,507315,Staff,13,0,30,17
1714617205267,EDS 203,A01,507317,Halter; Christopher P.,12,0,30,18
1714617206293,EDS 204R,A01,507319,Halter; Christopher P.,0,3,30,30
1714617206293,EDS 204R,B01,507331,Heinzman; Erica M.,16,0,30,14
1714617207317,EDS 206R,A00,507332,Staff,0,4,30,30
1714617207317,EDS 206R,B00,507343,Staff,17,0,30,13
1714617208342,EDS 250,A00,507344,Hemans; Patricia Ann Benitez,22,0,40,18
1714617209367,EDS 281,A00,507345,Daly; Alan J.,18,0,18,0
1714617210394,EDS 284,A00,507350,Daly; Alan J.,16,0,16,0
1714617211421,EDS 286,A00,507359,Fine; Sarah,18,0,18,0
1714617212445,EDS 289C,A01,507361,Daly; Alan J.,18,0,18,0
1714617213471,EDS 290,A00,507366,Hofstetter; Carolyn,15,0,15,0
1714617214499,LIGM 5A,A00,507421,Fischer-Grunski; Eva K,18,0,20,2
1714617215524,LIGM 5B,A00,507423,Fischer-Grunski; Eva K,19,0,20,1
1714617216548,LIGM 5C,A00,507425,Fischer-Grunski; Eva K,19,0,20,1
1714617217573,LIIT 5AS,A00,507427,Carnelos; Chiara,20,0,20,0
1714617218602,LIIT 5BS,A00,507430,Carnelos; Chiara,20,0,20,0
1714617219627,LIIT 5CS,A00,507432,Carnelos; Chiara,20,0,20,0
1714617220652,LISP 5A,A00,507541,Munoz Sanchez; Alicia,11,0,20,9
1714617221676,LISP 5B,A00,507671,Munoz Sanchez; Alicia,8,0,20,12
1714617222706,LISP 5C,A00,507696,Munoz Sanchez; Alicia,9,0,20,11
1714617223731,MAE 197,001,528363,Boechler; Nicholas Sebastia,9998,0,9999,1
1714617224757,MATH 197,001,523477,Kedlaya; Kiran S.,9995,0,9999,4
1714617224757,MATH 197,002,563811,Zhang; Danna,9995,0,9999,4
1714617224757,MATH 197,003,628552,Dumitriu; Ioana,9998,0,9999,1
1714617225784,MCWP 40R,A00,518780,Staff,2,0,20,18
1714617225784,MCWP 40R,B00,518781,Staff,8,0,20,12
1714617225784,MCWP 40R,C00,518783,Staff,6,0,20,14
1714617226810,MCWP 50R,A00,518791,Staff,0,0,20,20
1714617226810,MCWP 50R,B00,518792,Staff,0,2,20,20
1714617226810,MCWP 50R,C00,518793,Staff,0,2,20,20
1714617226810,MCWP 50R,D00,518794,Staff,0,0,20,20
1714617226810,MCWP 50R,E00,518795,Staff,0,2,20,20
1714617226810,MCWP 50R,F00,518796,Staff,0,0,20,20
1714617226810,MCWP 50R,G00,518797,Staff,0,1,20,20
1714617227843,MMW 12R,A01,514034,Herbst; Matthew,0,0,16,16
1714617227843,MMW 12R,A02,514035,Herbst; Matthew,1,0,16,15
1714617228871,MMW 13R,A01,514037,Staff,0,4,16,16
1714617228871,MMW 13R,A02,514039,Staff,0,2,16,16
1714617228871,MMW 13R,A03,628519,Staff,0,2,16,16
1714617230921,SIO 295LS,A00,523233,Staff,10,0,30,20
1714617231945,SIO 295S,A00,523232,Staff,10,0,30,20
1714617232972,SIOC 290S,A01,637330,Merrifield; Mark A,23,0,30,7
1714617234002,SIOC 291S,A01,637333,Gabriel; Corey John,23,0,30,7
1714617235030,SOCI 117,A01,494376,Staff,0,4,5,5
1714617236057,WES 237B,A00,494380,Staff,9,0,20,11
1714617238126,AESE 279B,A00,494370,Wade; Jon P,0,0,33,33
1714617239154,AIP 197,001,627712,Vespa; Emanuel Ignacio,9998,0,9999,1
1714617240180,ANAR 135S,A00,494369,Braswell; Geoffrey E.,0,0,0,0
1714617241206,BENG 196,001,628496,Engler; Adam J.,9998,0,9999,1
1714617242231,CAT 124RS,A01,519847,Geibel; William,0,0,20,20
1714617243256,CAT 125RS,A01,515971,Geibel; William,0,0,20,20
1714617244283,CLRE 250,A00,511389,Morris; Sheldon,9993,0,9999,6
1714617245312,CLRE 251,A00,507176,Mehta; Ravindra L.,9993,0,9999,6
1714617245312,CLRE 251,B00,511410,Mehta; Ravindra L.,9998,0,9999,1
1714617246337,CLRE 252,A00,507189,Cuomo; Raphael Eduardo,9995,0,9999,4
1714617247362,CLRE 253,A00,507199,Vaida; Florin,9994,0,9999,5
1714617247362,CLRE 253,B00,507202,Vaida; Florin,9999,0,9999,0
1714617248388,CLRE 259,A00,507211,Patel; Hemal,9996,0,9999,3
1714617249415,CLRE 260,A00,507221,Cuomo; Raphael Eduardo,9999,0,9999,0
1714617250440,CLRE 297,001,507242,Cuomo; Raphael Eduardo,9999,0,9999,0
1714617251467,COGS 197,001,638244,Voytek; Bradley Thomas,9998,0,9999,1
1714617252494,CSE 191,A00,516875,Minnes Kemp; Mor Mia,9992,0,9999,7
1714617253519,CSE 197,001,637388,Minnes Kemp; Mor Mia,9998,0,9999,1
1714617254544,CSS 201S,A01,494383,Staff,35,0,35,0
1714617255569,CSS 202S,A01,494387,Staff,35,0,35,0
1714617256597,DSC 197,001,628532,Eldridge; Justin Matthew,9996,0,9999,3
1714617257623,EAP 100,A00,516065,Staff,9797,0,9999,202
1714617258651,ECE 45,A01,507414,Staff,33,0,60,27
1714617260703,ECE 111,A01,507420,Staff,15,0,50,35
1714617261729,ECE 197,001,548057,Sievenpiper; Daniel F.,9993,0,9999,6
1714617262754,EDS 115,A00,507243,Choi; Bailey Miyeon,10,0,28,18
1714617263782,EDS 117,A01,494379,Staff,1,5,30,29
1714617264809,EDS 125,A00,507246,Hopkins; Megan Beth,9,0,30,21
1714617265839,EDS 128A,A01,507264,Fargason; Sharon Gayle,8,0,26,18
1714617266864,EDS 128B,A01,507293,Pappas; Elizabeth,12,0,30,18
1714617267887,EDS 139,A00,507294,Fargason; Sharon Gayle,13,0,30,17
1714617267887,EDS 139,B00,507313,Pappas; Elizabeth,13,0,30,17
1714617268915,EDS 201,A00,507315,Staff,13,0,30,17
1714617269940,EDS 203,A01,507317,Halter; Christopher P.,12,0,30,18
1714617270966,EDS 204R,A01,507319,Halter; Christopher P.,0,3,30,30
1714617270966,EDS 204R,B01,507331,Heinzman; Erica M.,16,0,30,14
1714617271994,EDS 206R,A00,507332,Staff,0,4,30,30
1714617271994,EDS 206R,B00,507343,Staff,17,0,30,13
1714617273020,EDS 250,A00,507344,Hemans; Patricia Ann Benitez,22,0,40,18
1714617274047,EDS 281,A00,507345,Daly; Alan J.,18,0,18,0
1714617275071,EDS 284,A00,507350,Daly; Alan J.,16,0,16,0
1714617276100,EDS 286,A00,507359,Fine; Sarah,18,0,18,0
1714617277124,EDS 289C,A01,507361,Daly; Alan J.,18,0,18,0
1714617278150,EDS 290,A00,507366,Hofstetter; Carolyn,15,0,15,0
1714617279176,LIGM 5A,A00,507421,Fischer-Grunski; Eva K,18,0,20,2
1714617280205,LIGM 5B,A00,507423,Fischer-Grunski; Eva K,19,0,20,1
1714617281232,LIGM 5C,A00,507425,Fischer-Grunski; Eva K,19,0,20,1
1714617282260,LIIT 5AS,A00,507427,Carnelos; Chiara,20,0,20,0
1714617283285,LIIT 5BS,A00,507430,Carnelos; Chiara,20,0,20,0
1714617284310,LIIT 5CS,A00,507432,Carnelos; Chiara,20,0,20,0
1714617285337,LISP 5A,A00,507541,Munoz Sanchez; Alicia,11,0,20,9
1714617286367,LISP 5B,A00,507671,Munoz Sanchez; Alicia,8,0,20,12
1714617287394,LISP 5C,A00,507696,Munoz Sanchez; Alicia,9,0,20,11
1714617288417,MAE 197,001,528363,Boechler; Nicholas Sebastia,9998,0,9999,1
1714617289449,MATH 197,001,523477,Kedlaya; Kiran S.,9995,0,9999,4
1714617289449,MATH 197,002,563811,Zhang; Danna,9995,0,9999,4
1714617289449,MATH 197,003,628552,Dumitriu; Ioana,9998,0,9999,1
1714617290472,MCWP 40R,A00,518780,Staff,2,0,20,18
1714617290472,MCWP 40R,B00,518781,Staff,8,0,20,12
1714617290472,MCWP 40R,C00,518783,Staff,6,0,20,14
1714617291499,MCWP 50R,A00,518791,Staff,0,0,20,20
1714617291499,MCWP 50R,B00,518792,Staff,0,2,20,20
1714617291499,MCWP 50R,C00,518793,Staff,0,2,20,20
1714617291499,MCWP 50R,D00,518794,Staff,0,0,20,20
1714617291499,MCWP 50R,E00,518795,Staff,0,2,20,20
1714617291499,MCWP 50R,F00,518796,Staff,0,0,20,20
1714617291499,MCWP 50R,G00,518797,Staff,0,1,20,20
1714617292525,MMW 12R,A01,514034,Herbst; Matthew,0,0,16,16
1714617292525,MMW 12R,A02,514035,Herbst; Matthew,1,0,16,15
1714617293551,MMW 13R,A01,514037,Staff,0,4,16,16
1714617293551,MMW 13R,A02,514039,Staff,0,2,16,16
1714617293551,MMW 13R,A03,628519,Staff,0,2,16,16
1714617295602,SIO 295LS,A00,523233,Staff,10,0,30,20
1714617296627,SIO 295S,A00,523232,Staff,10,0,30,20
1714617297655,SIOC 290S,A01,637330,Merrifield; Mark A,23,0,30,7
1714617298680,SIOC 291S,A01,637333,Gabriel; Corey John,23,0,30,7
1714617299705,SOCI 117,A01,494376,Staff,0,4,5,5
1714617300740,WES 237B,A00,494380,Staff,9,0,20,11
1714617302809,AESE 279B,A00,494370,Wade; Jon P,0,0,33,33
1714617303833,AIP 197,001,627712,Vespa; Emanuel Ignacio,9998,0,9999,1
1714617304862,ANAR 135S,A00,494369,Braswell; Geoffrey E.,0,0,0,0
1714617305887,BENG 196,001,628496,Engler; Adam J.,9998,0,9999,1
1714617306911,CAT 124RS,A01,519847,Geibel; William,0,0,20,20
1714617307935,CAT 125RS,A01,515971,Geibel; William,0,0,20,20
1714617308962,CLRE 250,A00,511389,Morris; Sheldon,9993,0,9999,6
1714617309989,CLRE 251,A00,507176,Mehta; Ravindra L.,9993,0,9999,6
1714617309989,CLRE 251,B00,511410,Mehta; Ravindra L.,9998,0,9999,1
1714617311018,CLRE 252,A00,507189,Cuomo; Raphael Eduardo,9995,0,9999,4
1714617312044,CLRE 253,A00,507199,Vaida; Florin,9994,0,9999,5
1714617312044,CLRE 253,B00,507202,Vaida; Florin,9999,0,9999,0
1714617313074,CLRE 259,A00,507211,Patel; Hemal,9996,0,9999,3
1714617314098,CLRE 260,A00,507221,Cuomo; Raphael Eduardo,9999,0,9999,0
1714617315122,CLRE 297,001,507242,Cuomo; Raphael Eduardo,9999,0,9999,0
1714617316146,COGS 197,001,638244,Voytek; Bradley Thomas,9998,0,9999,1
1714617317174,CSE 191,A00,516875,Minnes Kemp; Mor Mia,9992,0,9999,7
1714617318198,CSE 197,001,637388,Minnes Kemp; Mor Mia,9998,0,9999,1
1714617319227,CSS 201S,A01,494383,Staff,35,0,35,0
1714617320254,CSS 202S,A01,494387,Staff,35,0,35,0
1714617321278,DSC 197,001,628532,Eldridge; Justin Matthew,9996,0,9999,3
1714617322302,EAP 100,A00,516065,Staff,9797,0,9999,202
1714617323327,ECE 45,A01,507414,Staff,33,0,60,27
1714617325380,ECE 111,A01,507420,Staff,15,0,50,35
1714617326405,ECE 197,001,548057,Sievenpiper; Daniel F.,9993,0,9999,6
1714617327433,EDS 115,A00,507243,Choi; Bailey Miyeon,10,0,28,18
1714617328460,EDS 117,A01,494379,Staff,1,5,30,29
1714617329486,EDS 125,A00,507246,Hopkins; Megan Beth,9,0,30,21
1714617330511,EDS 128A,A01,507264,Fargason; Sharon Gayle,8,0,26,18
1714617331540,EDS 128B,A01,507293,Pappas; Elizabeth,12,0,30,18
1714617332568,EDS 139,A00,507294,Fargason; Sharon Gayle,13,0,30,17
1714617332568,EDS 139,B00,507313,Pappas; Elizabeth,13,0,30,17
1714617333595,EDS 201,A00,507315,Staff,13,0,30,17
1714617334620,EDS 203,A01,507317,Halter; Christopher P.,12,0,30,18
1714617335644,EDS 204R,A01,507319,Halter; Christopher P.,0,3,30,30
1714617335644,EDS 204R,B01,507331,Heinzman; Erica M.,16,0,30,14
1714617336670,EDS 206R,A00,507332,Staff,0,4,30,30
1714617336670,EDS 206R,B00,507343,Staff,17,0,30,13
1714617337694,EDS 250,A00,507344,Hemans; Patricia Ann Benitez,22,0,40,18
1714617338724,EDS 281,A00,507345,Daly; Alan J.,18,0,18,0
1714617339751,EDS 284,A00,507350,Daly; Alan J.,16,0,16,0
1714617340778,EDS 286,A00,507359,Fine; Sarah,18,0,18,0
1714617341806,EDS 289C,A01,507361,Daly; Alan J.,18,0,18,0
1714617342831,EDS 290,A00,507366,Hofstetter; Carolyn,15,0,15,0
1714617343866,LIGM 5A,A00,507421,Fischer-Grunski; Eva K,18,0,20,2
1714617344893,LIGM 5B,A00,507423,Fischer-Grunski; Eva K,19,0,20,1
1714617345921,LIGM 5C,A00,507425,Fischer-Grunski; Eva K,19,0,20,1
1714617346947,LIIT 5AS,A00,507427,Carnelos; Chiara,20,0,20,0
1714617347972,LIIT 5BS,A00,507430,Carnelos; Chiara,20,0,20,0
1714617349002,LIIT 5CS,A00,507432,Carnelos; Chiara,20,0,20,0
1714617350030,LISP 5A,A00,507541,Munoz Sanchez; Alicia,11,0,20,9
1714617351060,LISP 5B,A00,507671,Munoz Sanchez; Alicia,8,0,20,12
1714617352089,LISP 5C,A00,507696,Munoz Sanchez; Alicia,9,0,20,11
1714617353114,MAE 197,001,528363,Boechler; Nicholas Sebastia,9998,0,9999,1
1714617354142,MATH 197,001,523477,Kedlaya; Kiran S.,9995,0,9999,4
1714617354142,MATH 197,002,563811,Zhang; Danna,9995,0,9999,4
1714617354142,MATH 197,003,628552,Dumitriu; Ioana,9998,0,9999,1
1714617355171,MCWP 40R,A00,518780,Staff,2,0,20,18
1714617355171,MCWP 40R,B00,518781,Staff,8,0,20,12
1714617355171,MCWP 40R,C00,518783,Staff,6,0,20,14
1714617356200,MCWP 50R,A00,518791,Staff,0,0,20,20
1714617356200,MCWP 50R,B00,518792,Staff,0,2,20,20
1714617356200,MCWP 50R,C00,518793,Staff,0,2,20,20
1714617356200,MCWP 50R,D00,518794,Staff,0,0,20,20
1714617356200,MCWP 50R,E00,518795,Staff,0,2,20,20
1714617356200,MCWP 50R,F00,518796,Staff,0,0,20,20
1714617356200,MCWP 50R,G00,518797,Staff,0,1,20,20
1714617357227,MMW 12R,A01,514034,Herbst; Matthew,0,0,16,16
1714617357227,MMW 12R,A02,514035,Herbst; Matthew,1,0,16,15
1714617358253,MMW 13R,A01,514037,Staff,0,4,16,16
1714617358253,MMW 13R,A02,514039,Staff,0,2,16,16
1714617358253,MMW 13R,A03,628519,Staff,0,2,16,16
1714617360305,SIO 295LS,A00,523233,Staff,10,0,30,20
1714617361330,SIO 295S,A00,523232,Staff,10,0,30,20
1714617362357,SIOC 290S,A01,637330,Merrifield; Mark A,23,0,30,7
1714617363382,SIOC 291S,A01,637333,Gabriel; Corey John,23,0,30,7
1714617364407,SOCI 117,A01,494376,Staff,0,4,5,5
1714617365434,WES 237B,A00,494380,Staff,9,0,20,11
1714617367510,AESE 279B,A00,494370,Wade; Jon P,0,0,33,33
1714617368536,AIP 197,001,627712,Vespa; Emanuel Ignacio,9998,0,9999,1
1714617369563,ANAR 135S,A00,494369,Braswell; Geoffrey E.,0,0,0,0
1714617370592,BENG 196,001,628496,Engler; Adam J.,9998,0,9999,1
1714617371619,CAT 124RS,A01,519847,Geibel; William,0,0,20,20
1714617372642,CAT 125RS,A01,515971,Geibel; William,0,0,20,20
1714617373667,CLRE 250,A00,511389,Morris; Sheldon,9993,0,9999,6
1714617374692,CLRE 251,A00,507176,Mehta; Ravindra L.,9993,0,9999,6
1714617374692,CLRE 251,B00,511410,Mehta; Ravindra L.,9998,0,9999,1
1714617375717,CLRE 252,A00,507189,Cuomo; Raphael Eduardo,9995,0,9999,4
1714617376747,CLRE 253,A00,507199,Vaida; Florin,9994,0,9999,5
1714617376747,CLRE 253,B00,507202,Vaida; Florin,9999,0,9999,0
1714617377777,CLRE 259,A00,507211,Patel; Hemal,9996,0,9999,3
1714617378802,CLRE 260,A00,507221,Cuomo; Raphael Eduardo,9999,0,9999,0
1714617379830,CLRE 297,001,507242,Cuomo; Raphael Eduardo,9999,0,9999,0
1714617380855,COGS 197,001,638244,Voytek; Bradley Thomas,9998,0,9999,1
1714617381884,CSE 191,A00,516875,Minnes Kemp; Mor Mia,9992,0,9999,7
1714617382910,CSE 197,001,637388,Minnes Kemp; Mor Mia,9998,0,9999,1
1714617383936,CSS 201S,A01,494383,Staff,35,0,35,0
1714617384964,CSS 202S,A01,494387,Staff,35,0,35,0
1714617385990,DSC 197,001,628532,Eldridge; Justin Matthew,9996,0,9999,3
1714617387018,EAP 100,A00,516065,Staff,9797,0,9999,202
1714617388045,ECE 45,A01,507414,Staff,33,0,60,27
1714617390096,ECE 111,A01,507420,Staff,15,0,50,35
1714617391121,ECE 197,001,548057,Sievenpiper; Daniel F.,9993,0,9999,6
1714617392147,EDS 115,A00,507243,Choi; Bailey Miyeon,10,0,28,18
1714617393173,EDS 117,A01,494379,Staff,1,5,30,29
1714617394198,EDS 125,A00,507246,Hopkins; Megan Beth,9,0,30,21
1714617395225,EDS 128A,A01,507264,Fargason; Sharon Gayle,8,0,26,18
1714617396252,EDS 128B,A01,507293,Pappas; Elizabeth,12,0,30,18
1714617397278,EDS 139,A00,507294,Fargason; Sharon Gayle,13,0,30,17
1714617397278,EDS 139,B00,507313,Pappas; Elizabeth,13,0,30,17
1714617398306,EDS 201,A00,507315,Staff,13,0,30,17
1714617399335,EDS 203,A01,507317,Halter; Christopher P.,12,0,30,18
1714617400364,EDS 204R,A01,507319,Halter; Christopher P.,0,3,30,30
1714617400364,EDS 204R,B01,507331,Heinzman; Erica M.,16,0,30,14
1714617401389,EDS 206R,A00,507332,Staff,0,4,30,30
1714617401389,EDS 206R,B00,507343,Staff,17,0,30,13
1714617402414,EDS 250,A00,507344,Hemans; Patricia Ann Benitez,22,0,40,18
1714617403438,EDS 281,A00,507345,Daly; Alan J.,18,0,18,0
1714617404464,EDS 284,A00,507350,Daly; Alan J.,16,0,16,0
1714617405488,EDS 286,A00,507359,Fine; Sarah,18,0,18,0
1714617406512,EDS 289C,A01,507361,Daly; Alan J.,18,0,18,0
1714617407537,EDS 290,A00,507366,Hofstetter; Carolyn,15,0,15,0
1714617408563,LIGM 5A,A00,507421,Fischer-Grunski; Eva K,18,0,20,2
1714617409591,LIGM 5B,A00,507423,Fischer-Grunski; Eva K,19,0,20,1
1714617410615,LIGM 5C,A00,507425,Fischer-Grunski; Eva K,19,0,20,1
1714617411640,LIIT 5AS,A00,507427,Carnelos; Chiara,20,0,20,0
1714617412664,LIIT 5BS,A00,507430,Carnelos; Chiara,20,0,20,0
1714617413688,LIIT 5CS,A00,507432,Carnelos; Chiara,20,0,20,0
1714617414714,LISP 5A,A00,507541,Munoz Sanchez; Alicia,11,0,20,9
1714617415745,LISP 5B,A00,507671,Munoz Sanchez; Alicia,8,0,20,12
1714617416771,LISP 5C,A00,507696,Munoz Sanchez; Alicia,9,0,20,11
1714617417799,MAE 197,001,528363,Boechler; Nicholas Sebastia,9998,0,9999,1
1714617418830,MATH 197,001,523477,Kedlaya; Kiran S.,9995,0,9999,4
1714617418830,MATH 197,002,563811,Zhang; Danna,9995,0,9999,4
1714617418830,MATH 197,003,628552,Dumitriu; Ioana,9998,0,9999,1
1714617419857,MCWP 40R,A00,518780,Staff,2,0,20,18
1714617419857,MCWP 40R,B00,518781,Staff,8,0,20,12
1714617419857,MCWP 40R,C00,518783,Staff,6,0,20,14
1714617420883,MCWP 50R,A00,518791,Staff,0,0,20,20
1714617420883,MCWP 50R,B00,518792,Staff,0,2,20,20
1714617420883,MCWP 50R,C00,518793,Staff,0,2,20,20
1714617420883,MCWP 50R,D00,518794,Staff,0,0,20,20
1714617420883,MCWP 50R,E00,518795,Staff,0,2,20,20
1714617420883,MCWP 50R,F00,518796,Staff,0,0,20,20
1714617420883,MCWP 50R,G00,518797,Staff,0,1,20,20
1714617421908,MMW 12R,A01,514034,Herbst; Matthew,0,0,16,16
1714617421908,MMW 12R,A02,514035,Herbst; Matthew,1,0,16,15
1714617422935,MMW 13R,A01,514037,Staff,0,4,16,16
1714617422935,MMW 13R,A02,514039,Staff,0,2,16,16
1714617422935,MMW 13R,A03,628519,Staff,0,2,16,16
1714617424987,SIO 295LS,A00,523233,Staff,10,0,30,20
1714617426011,SIO 295S,A00,523232,Staff,10,0,30,20
1714617427051,SIOC 290S,A01,637330,Merrifield; Mark A,23,0,30,7
1714617428079,SIOC 291S,A01,637333,Gabriel; Corey John,23,0,30,7
1714617429104,SOCI 117,A01,494376,Staff,0,4,5,5
1714617430134,WES 237B,A00,494380,Staff,9,0,20,11
1714617432214,AESE 279B,A00,494370,Wade; Jon P,0,0,33,33
1714617433238,AIP 197,001,627712,Vespa; Emanuel Ignacio,9998,0,9999,1
1714617434265,ANAR 135S,A00,494369,Braswell; Geoffrey E.,0,0,0,0
1714617435290,BENG 196,001,628496,Engler; Adam J.,9998,0,9999,1
1714617436315,CAT 124RS,A01,519847,Geibel; William,0,0,20,20
1714617437341,CAT 125RS,A01,515971,Geibel; William,0,0,20,20
1714617438366,CLRE 250,A00,511389,Morris; Sheldon,9993,0,9999,6
1714617439396,CLRE 251,A00,507176,Mehta; Ravindra L.,9993,0,9999,6
1714617439396,CLRE 251,B00,511410,Mehta; Ravindra L.,9998,0,9999,1
1714617440421,CLRE 252,A00,507189,Cuomo; Raphael Eduardo,9995,0,9999,4
1714617441451,CLRE 253,A00,507199,Vaida; Florin,9994,0,9999,5
1714617441451,CLRE 253,B00,507202,Vaida; Florin,9999,0,9999,0
1714617442476,CLRE 259,A00,507211,Patel; Hemal,9996,0,9999,3
1714617443503,CLRE 260,A00,507221,Cuomo; Raphael Eduardo,9999,0,9999,0
1714617444528,CLRE 297,001,507242,Cuomo; Raphael Eduardo,9999,0,9999,0
1714617445557,COGS 197,001,638244,Voytek; Bradley Thomas,9998,0,9999,1
1714617446581,CSE 191,A00,516875,Minnes Kemp; Mor Mia,9992,0,9999,7
1714617447606,CSE 197,001,637388,Minnes Kemp; Mor Mia,9998,0,9999,1
1714617448632,CSS 201S,A01,494383,Staff,35,0,35,0
1714617449656,CSS 202S,A01,494387,Staff,35,0,35,0
1714617450681,DSC 197,001,628532,Eldridge; Justin Matthew,9996,0,9999,3
1714617451706,EAP 100,A00,516065,Staff,9797,0,9999,202
1714617452752,ECE 45,A01,507414,Staff,33,0,60,27
1714617454809,ECE 111,A01,507420,Staff,15,0,50,35
1714617455838,ECE 197,001,548057,Sievenpiper; Daniel F.,9993,0,9999,6
1714617456864,EDS 115,A00,507243,Choi; Bailey Miyeon,10,0,28,18
1714617457893,EDS 117,A01,494379,Staff,1,5,30,29
1714617458922,EDS 125,A00,507246,Hopkins; Megan Beth,9,0,30,21
1714617459947,EDS 128A,A01,507264,Fargason; Sharon Gayle,8,0,26,18
1714617460974,EDS 128B,A01,507293,Pappas; Elizabeth,12,0,30,18
1714617462000,EDS 139,A00,507294,Fargason; Sharon Gayle,13,0,30,17
1714617462000,EDS 139,B00,507313,Pappas; Elizabeth,13,0,30,17
1714617463025,EDS 201,A00,507315,Staff,13,0,30,17
1714617464057,EDS 203,A01,507317,Halter; Christopher P.,12,0,30,18
1714617465086,EDS 204R,A01,507319,Halter; Christopher P.,0,3,30,30
1714617465086,EDS 204R,B01,507331,Heinzman; Erica M.,16,0,30,14
1714617466116,EDS 206R,A00,507332,Staff,0,4,30,30
1714617466116,EDS 206R,B00,507343,Staff,17,0,30,13
1714617467145,EDS 250,A00,507344,Hemans; Patricia Ann Benitez,22,0,40,18
1714617468173,EDS 281,A00,507345,Daly; Alan J.,18,0,18,0
1714617469199,EDS 284,A00,507350,Daly; Alan J.,16,0,16,0
1714617470226,EDS 286,A00,507359,Fine; Sarah,18,0,18,0
1714617471252,EDS 289C,A01,507361,Daly; Alan J.,18,0,18,0
1714617472280,EDS 290,A00,507366,Hofstetter; Carolyn,15,0,15,0
1714617473311,LIGM 5A,A00,507421,Fischer-Grunski; Eva K,18,0,20,2
1714617474393,LIGM 5B,A00,507423,Fischer-Grunski; Eva K,19,0,20,1
1714617475420,LIGM 5C,A00,507425,Fischer-Grunski; Eva K,19,0,20,1
1714617476447,LIIT 5AS,A00,507427,Carnelos; Chiara,20,0,20,0
1714617477477,LIIT 5BS,A00,507430,Carnelos; Chiara,20,0,20,0
1714617478500,LIIT 5CS,A00,507432,Carnelos; Chiara,20,0,20,0
1714617479531,LISP 5A,A00,507541,Munoz Sanchez; Alicia,11,0,20,9
1714617480560,LISP 5B,A00,507671,Munoz Sanchez; Alicia,8,0,20,12
1714617481588,LISP 5C,A00,507696,Munoz Sanchez; Alicia,9,0,20,11
1714617482617,MAE 197,001,528363,Boechler; Nicholas Sebastia,9998,0,9999,1
1714617483648,MATH 197,001,523477,Kedlaya; Kiran S.,9995,0,9999,4
1714617483648,MATH 197,002,563811,Zhang; Danna,9995,0,9999,4
1714617483648,MATH 197,003,628552,Dumitriu; Ioana,9998,0,9999,1
1714617484673,MCWP 40R,A00,518780,Staff,2,0,20,18
1714617484673,MCWP 40R,B00,518781,Staff,8,0,20,12
1714617484673,MCWP 40R,C00,518783,Staff,6,0,20,14
1714617485697,MCWP 50R,A00,518791,Staff,0,0,20,20
1714617485697,MCWP 50R,B00,518792,Staff,0,2,20,20
1714617485697,MCWP 50R,C00,518793,Staff,0,2,20,20
1714617485697,MCWP 50R,D00,518794,Staff,0,0,20,20
1714617485697,MCWP 50R,E00,518795,Staff,0,2,20,20
1714617485697,MCWP 50R,F00,518796,Staff,0,0,20,20
1714617485697,MCWP 50R,G00,518797,Staff,0,1,20,20
1714617486727,MMW 12R,A01,514034,Herbst; Matthew,0,0,16,16
1714617486727,MMW 12R,A02,514035,Herbst; Matthew,1,0,16,15
1714617487751,MMW 13R,A01,514037,Staff,0,4,16,16
1714617487751,MMW 13R,A02,514039,Staff,0,2,16,16
1714617487751,MMW 13R,A03,628519,Staff,0,2,16,16
1714617489803,SIO 295LS,A00,523233,Staff,10,0,30,20
1714617490829,SIO 295S,A00,523232,Staff,10,0,30,20
1714617491859,SIOC 290S,A01,637330,Merrifield; Mark A,23,0,30,7
1714617492886,SIOC 291S,A01,637333,Gabriel; Corey John,23,0,30,7
1714617493915,SOCI 117,A01,494376,Staff,0,4,5,5
1714617494939,WES 237B,A00,494380,Staff,9,0,20,11
1714617497023,AESE 279B,A00,494370,Wade; Jon P,0,0,33,33
1714617498051,AIP 197,001,627712,Vespa; Emanuel Ignacio,9998,0,9999,1
1714617499076,ANAR 135S,A00,494369,Braswell; Geoffrey E.,0,0,0,0
1714617500103,BENG 196,001,628496,Engler; Adam J.,9998,0,9999,1
1714617501129,CAT 124RS,A01,519847,Geibel; William,0,0,20,20
1714617502155,CAT 125RS,A01,515971,Geibel; William,0,0,20,20
1714617503180,CLRE 250,A00,511389,Morris; Sheldon,9993,0,9999,6
1714617504212,CLRE 251,A00,507176,Mehta; Ravindra L.,9993,0,9999,6
1714617504212,CLRE 251,B00,511410,Mehta; Ravindra L.,9998,0,9999,1
1714617505240,CLRE 252,A00,507189,Cuomo; Raphael Eduardo,9995,0,9999,4
1714617506267,CLRE 253,A00,507199,Vaida; Florin,9994,0,9999,5
1714617506267,CLRE 253,B00,507202,Vaida; Florin,9999,0,9999,0
1714617507292,CLRE 259,A00,507211,Patel; Hemal,9996,0,9999,3
1714617508318,CLRE 260,A00,507221,Cuomo; Raphael Eduardo,9999,0,9999,0
1714617509344,CLRE 297,001,507242,Cuomo; Raphael Eduardo,9999,0,9999,0
1714617510369,COGS 197,001,638244,Voytek; Bradley Thomas,9998,0,9999,1
1714617511398,CSE 191,A00,516875,Minnes Kemp; Mor Mia,9992,0,9999,7
1714617512426,CSE 197,001,637388,Minnes Kemp; Mor Mia,9998,0,9999,1
1714617513456,CSS 201S,A01,494383,Staff,35,0,35,0
1714617514481,CSS 202S,A01,494387,Staff,35,0,35,0
1714617515507,DSC 197,001,628532,Eldridge; Justin Matthew,9996,0,9999,3
1714617516532,EAP 100,A00,516065,Staff,9797,0,9999,202
1714617517555,ECE 45,A01,507414,Staff,33,0,60,27
1714617519604,ECE 111,A01,507420,Staff,15,0,50,35
1714617520631,ECE 197,001,548057,Sievenpiper; Daniel F.,9993,0,9999,6
1714617521663,EDS 115,A00,507243,Choi; Bailey Miyeon,10,0,28,18
1714617522692,EDS 117,A01,494379,Staff,1,5,30,29
1714617523720,EDS 125,A00,507246,Hopkins; Megan Beth,9,0,30,21
1714617524751,EDS 128A,A01,507264,Fargason; Sharon Gayle,8,0,26,18
1714617525776,EDS 128B,A01,507293,Pappas; Elizabeth,12,0,30,18
1714617526800,EDS 139,A00,507294,Fargason; Sharon Gayle,13,0,30,17
1714617526800,EDS 139,B00,507313,Pappas; Elizabeth,13,0,30,17
1714617527829,EDS 201,A00,507315,Staff,13,0,30,17
1714617528859,EDS 203,A01,507317,Halter; Christopher P.,12,0,30,18
1714617529886,EDS 204R,A01,507319,Halter; Christopher P.,0,3,30,30
1714617529886,EDS 204R,B01,507331,Heinzman; Erica M.,16,0,30,14
1714617530915,EDS 206R,A00,507332,Staff,0,4,30,30
1714617530915,EDS 206R,B00,507343,Staff,17,0,30,13
1714617531944,EDS 250,A00,507344,Hemans; Patricia Ann Benitez,22,0,40,18
1714617532972,EDS 281,A00,507345,Daly; Alan J.,18,0,18,0
1714617534000,EDS 284,A00,507350,Daly; Alan J.,16,0,16,0
1714617535026,EDS 286,A00,507359,Fine; Sarah,18,0,18,0
1714617536054,EDS 289C,A01,507361,Daly; Alan J.,18,0,18,0
1714617537079,EDS 290,A00,507366,Hofstetter; Carolyn,15,0,15,0
1714617538108,LIGM 5A,A00,507421,Fischer-Grunski; Eva K,18,0,20,2
1714617539134,LIGM 5B,A00,507423,Fischer-Grunski; Eva K,19,0,20,1
1714617540160,LIGM 5C,A00,507425,Fischer-Grunski; Eva K,19,0,20,1
1714617541186,LIIT 5AS,A00,507427,Carnelos; Chiara,20,0,20,0
1714617542213,LIIT 5BS,A00,507430,Carnelos; Chiara,20,0,20,0
1714617543241,LIIT 5CS,A00,507432,Carnelos; Chiara,20,0,20,0
1714617544267,LISP 5A,A00,507541,Munoz Sanchez; Alicia,11,0,20,9
1714617545292,LISP 5B,A00,507671,Munoz Sanchez; Alicia,8,0,20,12
1714617546321,LISP 5C,A00,507696,Munoz Sanchez; Alicia,9,0,20,11
1714617547350,MAE 197,001,528363,Boechler; Nicholas Sebastia,9998,0,9999,1
1714617548382,MATH 197,001,523477,Kedlaya; Kiran S.,9995,0,9999,4
1714617548382,MATH 197,002,563811,Zhang; Danna,9995,0,9999,4
1714617548382,MATH 197,003,628552,Dumitriu; Ioana,9998,0,9999,1
1714617549408,MCWP 40R,A00,518780,Staff,2,0,20,18
1714617549408,MCWP 40R,B00,518781,Staff,8,0,20,12
1714617549408,MCWP 40R,C00,518783,Staff,6,0,20,14
1714617550434,MCWP 50R,A00,518791,Staff,0,0,20,20
1714617550434,MCWP 50R,B00,518792,Staff,0,2,20,20
1714617550434,MCWP 50R,C00,518793,Staff,0,2,20,20
1714617550434,MCWP 50R,D00,518794,Staff,0,0,20,20
1714617550434,MCWP 50R,E00,518795,Staff,0,2,20,20
1714617550434,MCWP 50R,F00,518796,Staff,0,0,20,20
1714617550434,MCWP 50R,G00,518797,Staff,0,1,20,20
1714617551460,MMW 12R,A01,514034,Herbst; Matthew,0,0,16,16
1714617551460,MMW 12R,A02,514035,Herbst; Matthew,1,0,16,15
1714617552487,MMW 13R,A01,514037,Staff,0,4,16,16
1714617552487,MMW 13R,A02,514039,Staff,0,2,16,16
1714617552487,MMW 13R,A03,628519,Staff,0,2,16,16
1714617554588,SIO 295LS,A00,523233,Staff,10,0,30,20
1714617555613,SIO 295S,A00,523232,Staff,10,0,30,20
1714617556640,SIOC 290S,A01,637330,Merrifield; Mark A,23,0,30,7
1714617557670,SIOC 291S,A01,637333,Gabriel; Corey John,23,0,30,7
1714617558695,SOCI 117,A01,494376,Staff,0,4,5,5
1714617559722,WES 237B,A00,494380,Staff,9,0,20,11
1714617561800,AESE 279B,A00,494370,Wade; Jon P,0,0,33,33
1714617562826,AIP 197,001,627712,Vespa; Emanuel Ignacio,9998,0,9999,1
1714617563855,ANAR 135S,A00,494369,Braswell; Geoffrey E.,0,0,0,0
1714617564882,BENG 196,001,628496,Engler; Adam J.,9998,0,9999,1
1714617565908,CAT 124RS,A01,519847,Geibel; William,0,0,20,20
1714617566935,CAT 125RS,A01,515971,Geibel; William,0,0,20,20
1714617567964,CLRE 250,A00,511389,Morris; Sheldon,9993,0,9999,6
1714617568997,CLRE 251,A00,507176,Mehta; Ravindra L.,9993,0,9999,6
1714617568997,CLRE 251,B00,511410,Mehta; Ravindra L.,9998,0,9999,1
1714617570028,CLRE 252,A00,507189,Cuomo; Raphael Eduardo,9995,0,9999,4
1714617571058,CLRE 253,A00,507199,Vaida; Florin,9994,0,9999,5
1714617571058,CLRE 253,B00,507202,Vaida; Florin,9999,0,9999,0
1714617572084,CLRE 259,A00,507211,Patel; Hemal,9996,0,9999,3
1714617573110,CLRE 260,A00,507221,Cuomo; Raphael Eduardo,9999,0,9999,0
1714617574136,CLRE 297,001,507242,Cuomo; Raphael Eduardo,9999,0,9999,0
1714617575162,COGS 197,001,638244,Voytek; Bradley Thomas,9998,0,9999,1
1714617576189,CSE 191,A00,516875,Minnes Kemp; Mor Mia,9992,0,9999,7
1714617577214,CSE 197,001,637388,Minnes Kemp; Mor Mia,9998,0,9999,1
1714617578295,CSS 201S,A01,494383,Staff,35,0,35,0
1714617579322,CSS 202S,A01,494387,Staff,35,0,35,0
1714617580349,DSC 197,001,628532,Eldridge; Justin Matthew,9996,0,9999,3
1714617581375,EAP 100,A00,516065,Staff,9797,0,9999,202
1714617582404,ECE 45,A01,507414,Staff,33,0,60,27
1714617584455,ECE 111,A01,507420,Staff,15,0,50,35
1714617585481,ECE 197,001,548057,Sievenpiper; Daniel F.,9993,0,9999,6
1714617586512,EDS 115,A00,507243,Choi; Bailey Miyeon,10,0,28,18
1714617587543,EDS 117,A01,494379,Staff,1,5,30,29
1714617588568,EDS 125,A00,507246,Hopkins; Megan Beth,9,0,30,21
1714617589598,EDS 128A,A01,507264,Fargason; Sharon Gayle,8,0,26,18
1714617590626,EDS 128B,A01,507293,Pappas; Elizabeth,12,0,30,18
1714617591653,EDS 139,A00,507294,Fargason; Sharon Gayle,13,0,30,17
1714617591653,EDS 139,B00,507313,Pappas; Elizabeth,13,0,30,17
1714617592678,EDS 201,A00,507315,Staff,13,0,30,17
1714617593707,EDS 203,A01,507317,Halter; Christopher P.,12,0,30,18
1714617594732,EDS 204R,A01,507319,Halter; Christopher P.,0,3,30,30
1714617594732,EDS 204R,B01,507331,Heinzman; Erica M.,16,0,30,14
1714617595756,EDS 206R,A00,507332,Staff,0,4,30,30
1714617595756,EDS 206R,B00,507343,Staff,17,0,30,13
1714617596782,EDS 250,A00,507344,Hemans; Patricia Ann Benitez,22,0,40,18
1714617597806,EDS 281,A00,507345,Daly; Alan J.,18,0,18,0
1714617598834,EDS 284,A00,507350,Daly; Alan J.,16,0,16,0
1714617599860,EDS 286,A00,507359,Fine; Sarah,18,0,18,0
1714617600884,EDS 289C,A01,507361,Daly; Alan J.,18,0,18,0
1714617601911,EDS 290,A00,507366,Hofstetter; Carolyn,15,0,15,0
1714617602943,LIGM 5A,A00,507421,Fischer-Grunski; Eva K,18,0,20,2
1714617603968,LIGM 5B,A00,507423,Fischer-Grunski; Eva K,19,0,20,1
1714617604994,LIGM 5C,A00,507425,Fischer-Grunski; Eva K,19,0,20,1
1714617606021,LIIT 5AS,A00,507427,Carnelos; Chiara,20,0,20,0
1714617607046,LIIT 5BS,A00,507430,Carnelos; Chiara,20,0,20,0
1714617608071,LIIT 5CS,A00,507432,Carnelos; Chiara,20,0,20,0
1714617609103,LISP 5A,A00,507541,Munoz Sanchez; Alicia,11,0,20,9
1714617610131,LISP 5B,A00,507671,Munoz Sanchez; Alicia,8,0,20,12
1714617611157,LISP 5C,A00,507696,Munoz Sanchez; Alicia,9,0,20,11
1714617612183,MAE 197,001,528363,Boechler; Nicholas Sebastia,9998,0,9999,1
1714617613210,MATH 197,001,523477,Kedlaya; Kiran S.,9995,0,9999,4
1714617613210,MATH 197,002,563811,Zhang; Danna,9995,0,9999,4
1714617613210,MATH 197,003,628552,Dumitriu; Ioana,9998,0,9999,1
1714617614236,MCWP 40R,A00,518780,Staff,2,0,20,18
1714617614236,MCWP 40R,B00,518781,Staff,8,0,20,12
1714617614236,MCWP 40R,C00,518783,Staff,6,0,20,14
1714617615264,MCWP 50R,A00,518791,Staff,0,0,20,20
1714617615264,MCWP 50R,B00,518792,Staff,0,2,20,20
1714617615264,MCWP 50R,C00,518793,Staff,0,2,20,20
1714617615264,MCWP 50R,D00,518794,Staff,0,0,20,20
1714617615264,MCWP 50R,E00,518795,Staff,0,2,20,20
1714617615264,MCWP 50R,F00,518796,Staff,0,0,20,20
1714617615264,MCWP 50R,G00,518797,Staff,0,1,20,20
1714617616289,MMW 12R,A01,514034,Herbst; Matthew,0,0,16,16
1714617616289,MMW 12R,A02,514035,Herbst; Matthew,1,0,16,15
1714617617315,MMW 13R,A01,514037,Staff,0,4,16,16
1714617617315,MMW 13R,A02,514039,Staff,0,2,16,16
1714617617315,MMW 13R,A03,628519,Staff,0,2,16,16
1714617619368,SIO 295LS,A00,523233,Staff,10,0,30,20
1714617620393,SIO 295S,A00,523232,Staff,10,0,30,20
1714617621420,SIOC 290S,A01,637330,Merrifield; Mark A,23,0,30,7
1714617622445,SIOC 291S,A01,637333,Gabriel; Corey John,23,0,30,7
1714617623472,SOCI 117,A01,494376,Staff,0,4,5,5
1714617624497,WES 237B,A00,494380,Staff,9,0,20,11
1714617626564,AESE 279B,A00,494370,Wade; Jon P,0,0,33,33
1714617627591,AIP 197,001,627712,Vespa; Emanuel Ignacio,9998,0,9999,1
1714617628618,ANAR 135S,A00,494369,Braswell; Geoffrey E.,0,0,0,0
1714617629644,BENG 196,001,628496,Engler; Adam J.,9998,0,9999,1
1714617630670,CAT 124RS,A01,519847,Geibel; William,0,0,20,20
1714617631694,CAT 125RS,A01,515971,Geibel; William,0,0,20,20
1714617632723,CLRE 250,A00,511389,Morris; Sheldon,9993,0,9999,6
1714617633755,CLRE 251,A00,507176,Mehta; Ravindra L.,9993,0,9999,6
1714617633755,CLRE 251,B00,511410,Mehta; Ravindra L.,9998,0,9999,1
1714617634993,CLRE 252,A00,507189,Cuomo; Raphael Eduardo,9995,0,9999,4
1714617636023,CLRE 253,A00,507199,Vaida; Florin,9994,0,9999,5
1714617636023,CLRE 253,B00,507202,Vaida; Florin,9999,0,9999,0
1714617637049,CLRE 259,A00,507211,Patel; Hemal,9996,0,9999,3
1714617638075,CLRE 260,A00,507221,Cuomo; Raphael Eduardo,9999,0,9999,0
1714617639101,CLRE 297,001,507242,Cuomo; Raphael Eduardo,9999,0,9999,0
1714617640127,COGS 197,001,638244,Voytek; Bradley Thomas,9998,0,9999,1
1714617641152,CSE 191,A00,516875,Minnes Kemp; Mor Mia,9992,0,9999,7
1714617642179,CSE 197,001,637388,Minnes Kemp; Mor Mia,9998,0,9999,1
1714617643209,CSS 201S,A01,494383,Staff,35,0,35,0
1714617644236,CSS 202S,A01,494387,Staff,35,0,35,0
1714617645263,DSC 197,001,628532,Eldridge; Justin Matthew,9996,0,9999,3
1714617646288,EAP 100,A00,516065,Staff,9797,0,9999,202
1714617647314,ECE 45,A01,507414,Staff,33,0,60,27
1714617649367,ECE 111,A01,507420,Staff,15,0,50,35
1714617650392,ECE 197,001,548057,Sievenpiper; Daniel F.,9993,0,9999,6
1714617651426,EDS 115,A00,507243,Choi; Bailey Miyeon,10,0,28,18
1714617652450,EDS 117,A01,494379,Staff,1,5,30,29
1714617653476,EDS 125,A00,507246,Hopkins; Megan Beth,9,0,30,21
1714617654506,EDS 128A,A01,507264,Fargason; Sharon Gayle,8,0,26,18
1714617655533,EDS 128B,A01,507293,Pappas; Elizabeth,12,0,30,18
1714617656560,EDS 139,A00,507294,Fargason; Sharon Gayle,13,0,30,17
1714617656560,EDS 139,B00,507313,Pappas; Elizabeth,13,0,30,17
1714617657588,EDS 201,A00,507315,Staff,13,0,30,17
1714617658617,EDS 203,A01,507317,Halter; Christopher P.,12,0,30,18
1714617659642,EDS 204R,A01,507319,Halter; Christopher P.,0,3,30,30
1714617659642,EDS 204R,B01,507331,Heinzman; Erica M.,16,0,30,14
1714617660667,EDS 206R,A00,507332,Staff,0,4,30,30
1714617660667,EDS 206R,B00,507343,Staff,17,0,30,13
1714617661698,EDS 250,A00,507344,Hemans; Patricia Ann Benitez,22,0,40,18
1714617662723,EDS 281,A00,507345,Daly; Alan J.,18,0,18,0
1714617663747,EDS 284,A00,507350,Daly; Alan J.,16,0,16,0
1714617664772,EDS 286,A00,507359,Fine; Sarah,18,0,18,0
1714617665800,EDS 289C,A01,507361,Daly; Alan J.,18,0,18,0
1714617666827,EDS 290,A00,507366,Hofstetter; Carolyn,15,0,15,0
1714617667852,LIGM 5A,A00,507421,Fischer-Grunski; Eva K,18,0,20,2
1714617668882,LIGM 5B,A00,507423,Fischer-Grunski; Eva K,19,0,20,1
1714617669914,LIGM 5C,A00,507425,Fischer-Grunski; Eva K,19,0,20,1
1714617670939,LIIT 5AS,A00,507427,Carnelos; Chiara,20,0,20,0
1714617671963,LIIT 5BS,A00,507430,Carnelos; Chiara,20,0,20,0
1714617672989,LIIT 5CS,A00,507432,Carnelos; Chiara,20,0,20,0
1714617674015,LISP 5A,A00,507541,Munoz Sanchez; Alicia,11,0,20,9
1714617675039,LISP 5B,A00,507671,Munoz Sanchez; Alicia,8,0,20,12
1714617676066,LISP 5C,A00,507696,Munoz Sanchez; Alicia,9,0,20,11
1714617677096,MAE 197,001,528363,Boechler; Nicholas Sebastia,9998,0,9999,1
1714617678124,MATH 197,001,523477,Kedlaya; Kiran S.,9995,0,9999,4
1714617678124,MATH 197,002,563811,Zhang; Danna,9995,0,9999,4
1714617678124,MATH 197,003,628552,Dumitriu; Ioana,9998,0,9999,1
1714617679151,MCWP 40R,A00,518780,Staff,2,0,20,18
1714617679151,MCWP 40R,B00,518781,Staff,8,0,20,12
1714617679151,MCWP 40R,C00,518783,Staff,6,0,20,14
1714617680182,MCWP 50R,A00,518791,Staff,0,0,20,20
1714617680182,MCWP 50R,B00,518792,Staff,0,2,20,20
1714617680182,MCWP 50R,C00,518793,Staff,0,2,20,20
1714617680182,MCWP 50R,D00,518794,Staff,0,0,20,20
1714617680182,MCWP 50R,E00,518795,Staff,0,2,20,20
1714617680182,MCWP 50R,F00,518796,Staff,0,0,20,20
1714617680182,MCWP 50R,G00,518797,Staff,0,1,20,20
1714617681210,MMW 12R,A01,514034,Herbst; Matthew,0,0,16,16
1714617681210,MMW 12R,A02,514035,Herbst; Matthew,1,0,16,15
1714617682235,MMW 13R,A01,514037,Staff,0,4,16,16
1714617682235,MMW 13R,A02,514039,Staff,0,2,16,16
1714617682235,MMW 13R,A03,628519,Staff,0,2,16,16
1714617684287,SIO 295LS,A00,523233,Staff,10,0,30,20
1714617685316,SIO 295S,A00,523232,Staff,10,0,30,20
1714617686341,SIOC 290S,A01,637330,Merrifield; Mark A,23,0,30,7
1714617687367,SIOC 291S,A01,637333,Gabriel; Corey John,23,0,30,7
1714617688392,SOCI 117,A01,494376,Staff,0,4,5,5
1714617689415,WES 237B,A00,494380,Staff,9,0,20,11
1714617691480,AESE 279B,A00,494370,Wade; Jon P,0,0,33,33
1714617692506,AIP 197,001,627712,Vespa; Emanuel Ignacio,9998,0,9999,1
1714617693531,ANAR 135S,A00,494369,Braswell; Geoffrey E.,0,0,0,0
1714617694558,BENG 196,001,628496,Engler; Adam J.,9998,0,9999,1
1714617695584,CAT 124RS,A01,519847,Geibel; William,0,0,20,20
1714617696612,CAT 125RS,A01,515971,Geibel; William,0,0,20,20
1714617697638,CLRE 250,A00,511389,Morris; Sheldon,9993,0,9999,6
1714617698664,CLRE 251,A00,507176,Mehta; Ravindra L.,9993,0,9999,6
1714617698664,CLRE 251,B00,511410,Mehta; Ravindra L.,9998,0,9999,1
1714617699693,CLRE 252,A00,507189,Cuomo; Raphael Eduardo,9995,0,9999,4
1714617700717,CLRE 253,A00,507199,Vaida; Florin,9994,0,9999,5
1714617700717,CLRE 253,B00,507202,Vaida; Florin,9999,0,9999,0
1714617701742,CLRE 259,A00,507211,Patel; Hemal,9996,0,9999,3
1714617702766,CLRE 260,A00,507221,Cuomo; Raphael Eduardo,9999,0,9999,0
1714617703793,CLRE 297,001,507242,Cuomo; Raphael Eduardo,9999,0,9999,0
1714617704819,COGS 197,001,638244,Voytek; Bradley Thomas,9998,0,9999,1
1714617705844,CSE 191,A00,516875,Minnes Kemp; Mor Mia,9992,0,9999,7
1714617706870,CSE 197,001,637388,Minnes Kemp; Mor Mia,9998,0,9999,1
1714617707895,CSS 201S,A01,494383,Staff,35,0,35,0
1714617708922,CSS 202S,A01,494387,Staff,35,0,35,0
1714617709950,DSC 197,001,628532,Eldridge; Justin Matthew,9996,0,9999,3
1714617710975,EAP 100,A00,516065,Staff,9797,0,9999,202
1714617712000,ECE 45,A01,507414,Staff,33,0,60,27
1714617714049,ECE 111,A01,507420,Staff,15,0,50,35
1714617715080,ECE 197,001,548057,Sievenpiper; Daniel F.,9993,0,9999,6
1714617716108,EDS 115,A00,507243,Choi; Bailey Miyeon,10,0,28,18
1714617717133,EDS 117,A01,494379,Staff,1,5,30,29
1714617718160,EDS 125,A00,507246,Hopkins; Megan Beth,9,0,30,21
1714617719187,EDS 128A,A01,507264,Fargason; Sharon Gayle,8,0,26,18
1714617720216,EDS 128B,A01,507293,Pappas; Elizabeth,12,0,30,18
1714617721241,EDS 139,A00,507294,Fargason; Sharon Gayle,13,0,30,17
1714617721241,EDS 139,B00,507313,Pappas; Elizabeth,13,0,30,17
1714617722267,EDS 201,A00,507315,Staff,13,0,30,17
1714617723297,EDS 203,A01,507317,Halter; Christopher P.,12,0,30,18
1714617724326,EDS 204R,A01,507319,Halter; Christopher P.,0,3,30,30
1714617724326,EDS 204R,B01,507331,Heinzman; Erica M.,16,0,30,14
1714617725353,EDS 206R,A00,507332,Staff,0,4,30,30
1714617725353,EDS 206R,B00,507343,Staff,17,0,30,13
1714617726377,EDS 250,A00,507344,Hemans; Patricia Ann Benitez,22,0,40,18
1714617727405,EDS 281,A00,507345,Daly; Alan J.,18,0,18,0
1714617728430,EDS 284,A00,507350,Daly; Alan J.,16,0,16,0
1714617729460,EDS 286,A00,507359,Fine; Sarah,18,0,18,0
1714617730486,EDS 289C,A01,507361,Daly; Alan J.,18,0,18,0
1714617731512,EDS 290,A00,507366,Hofstetter; Carolyn,15,0,15,0
1714617732539,LIGM 5A,A00,507421,Fischer-Grunski; Eva K,18,0,20,2
1714617733566,LIGM 5B,A00,507423,Fischer-Grunski; Eva K,19,0,20,1
1714617734596,LIGM 5C,A00,507425,Fischer-Grunski; Eva K,19,0,20,1
1714617735623,LIIT 5AS,A00,507427,Carnelos; Chiara,20,0,20,0
1714617736646,LIIT 5BS,A00,507430,Carnelos; Chiara,20,0,20,0
1714617737670,LIIT 5CS,A00,507432,Carnelos; Chiara,20,0,20,0
1714617738700,LISP 5A,A00,507541,Munoz Sanchez; Alicia,11,0,20,9
1714617739728,LISP 5B,A00,507671,Munoz Sanchez; Alicia,8,0,20,12
1714617740757,LISP 5C,A00,507696,Munoz Sanchez; Alicia,9,0,20,11
1714617741783,MAE 197,001,528363,Boechler; Nicholas Sebastia,9998,0,9999,1
1714617742811,MATH 197,001,523477,Kedlaya; Kiran S.,9995,0,9999,4
1714617742811,MATH 197,002,563811,Zhang; Danna,9995,0,9999,4
1714617742811,MATH 197,003,628552,Dumitriu; Ioana,9998,0,9999,1
1714617743835,MCWP 40R,A00,518780,Staff,2,0,20,18
1714617743835,MCWP 40R,B00,518781,Staff,8,0,20,12
1714617743835,MCWP 40R,C00,518783,Staff,6,0,20,14
1714617744862,MCWP 50R,A00,518791,Staff,0,0,20,20
1714617744862,MCWP 50R,B00,518792,Staff,0,2,20,20
1714617744862,MCWP 50R,C00,518793,Staff,0,2,20,20
1714617744862,MCWP 50R,D00,518794,Staff,0,0,20,20
1714617744862,MCWP 50R,E00,518795,Staff,0,2,20,20
1714617744862,MCWP 50R,F00,518796,Staff,0,0,20,20
1714617744862,MCWP 50R,G00,518797,Staff,0,1,20,20
1714617745890,MMW 12R,A01,514034,Herbst; Matthew,0,0,16,16
1714617745890,MMW 12R,A02,514035,Herbst; Matthew,1,0,16,15
1714617746916,MMW 13R,A01,514037,Staff,0,4,16,16
1714617746916,MMW 13R,A02,514039,Staff,0,2,16,16
1714617746916,MMW 13R,A03,628519,Staff,0,2,16,16
1714617748967,SIO 295LS,A00,523233,Staff,10,0,30,20
1714617749996,SIO 295S,A00,523232,Staff,10,0,30,20
1714617751024,SIOC 290S,A01,637330,Merrifield; Mark A,23,0,30,7
1714617752054,SIOC 291S,A01,637333,Gabriel; Corey John,23,0,30,7
1714617753080,SOCI 117,A01,494376,Staff,0,4,5,5
1714617754108,WES 237B,A00,494380,Staff,9,0,20,11
1714617756173,AESE 279B,A00,494370,Wade; Jon P,0,0,33,33
1714617757200,AIP 197,001,627712,Vespa; Emanuel Ignacio,9998,0,9999,1
1714617758227,ANAR 135S,A00,494369,Braswell; Geoffrey E.,0,0,0,0
1714617759257,BENG 196,001,628496,Engler; Adam J.,9998,0,9999,1
1714617760281,CAT 124RS,A01,519847,Geibel; William,0,0,20,20
1714617761309,CAT 125RS,A01,515971,Geibel; William,0,0,20,20
1714617762337,CLRE 250,A00,511389,Morris; Sheldon,9993,0,9999,6
1714617763362,CLRE 251,A00,507176,Mehta; Ravindra L.,9993,0,9999,6
1714617763362,CLRE 251,B00,511410,Mehta; Ravindra L.,9998,0,9999,1
1714617764390,CLRE 252,A00,507189,Cuomo; Raphael Eduardo,9995,0,9999,4
1714617765416,CLRE 253,A00,507199,Vaida; Florin,9994,0,9999,5
1714617765416,CLRE 253,B00,507202,Vaida; Florin,9999,0,9999,0
1714617766443,CLRE 259,A00,507211,Patel; Hemal,9996,0,9999,3
1714617767472,CLRE 260,A00,507221,Cuomo; Raphael Eduardo,9999,0,9999,0
1714617768497,CLRE 297,001,507242,Cuomo; Raphael Eduardo,9999,0,9999,0
1714617769522,COGS 197,001,638244,Voytek; Bradley Thomas,9998,0,9999,1
1714617770550,CSE 191,A00,516875,Minnes Kemp; Mor Mia,9992,0,9999,7
1714617771575,CSE 197,001,637388,Minnes Kemp; Mor Mia,9998,0,9999,1
1714617772600,CSS 201S,A01,494383,Staff,35,0,35,0
1714617773626,CSS 202S,A01,494387,Staff,35,0,35,0
1714617774653,DSC 197,001,628532,Eldridge; Justin Matthew,9996,0,9999,3
1714617775676,EAP 100,A00,516065,Staff,9797,0,9999,202
1714617776701,ECE 45,A01,507414,Staff,33,0,60,27
1714617778754,ECE 111,A01,507420,Staff,15,0,50,35
1714617779781,ECE 197,001,548057,Sievenpiper; Daniel F.,9993,0,9999,6
1714617780807,EDS 115,A00,507243,Choi; Bailey Miyeon,10,0,28,18
1714617781833,EDS 117,A01,494379,Staff,1,5,30,29
1714617782863,EDS 125,A00,507246,Hopkins; Megan Beth,9,0,30,21
1714617783909,EDS 128A,A01,507264,Fargason; Sharon Gayle,8,0,26,18
1714617784933,EDS 128B,A01,507293,Pappas; Elizabeth,12,0,30,18
1714617785958,EDS 139,A00,507294,Fargason; Sharon Gayle,13,0,30,17
1714617785958,EDS 139,B00,507313,Pappas; Elizabeth,13,0,30,17
1714617786983,EDS 201,A00,507315,Staff,13,0,30,17
1714617788010,EDS 203,A01,507317,Halter; Christopher P.,12,0,30,18
1714617789036,EDS 204R,A01,507319,Halter; Christopher P.,0,3,30,30
1714617789036,EDS 204R,B01,507331,Heinzman; Erica M.,16,0,30,14
1714617790062,EDS 206R,A00,507332,Staff,0,4,30,30
1714617790062,EDS 206R,B00,507343,Staff,17,0,30,13
1714617791091,EDS 250,A00,507344,Hemans; Patricia Ann Benitez,22,0,40,18
1714617792118,EDS 281,A00,507345,Daly; Alan J.,18,0,18,0
1714617793143,EDS 284,A00,507350,Daly; Alan J.,16,0,16,0
1714617794169,EDS 286,A00,507359,Fine; Sarah,18,0,18,0
1714617795195,EDS 289C,A01,507361,Daly; Alan J.,18,0,18,0
1714617796221,EDS 290,A00,507366,Hofstetter; Carolyn,15,0,15,0
1714617797250,LIGM 5A,A00,507421,Fischer-Grunski; Eva K,18,0,20,2
1714617798276,LIGM 5B,A00,507423,Fischer-Grunski; Eva K,19,0,20,1
1714617799304,LIGM 5C,A00,507425,Fischer-Grunski; Eva K,19,0,20,1
1714617800334,LIIT 5AS,A00,507427,Carnelos; Chiara,20,0,20,0
1714617801358,LIIT 5BS,A00,507430,Carnelos; Chiara,20,0,20,0
1714617802386,LIIT 5CS,A00,507432,Carnelos; Chiara,20,0,20,0
1714617803411,LISP 5A,A00,507541,Munoz Sanchez; Alicia,11,0,20,9
1714617804440,LISP 5B,A00,507671,Munoz Sanchez; Alicia,8,0,20,12
1714617805469,LISP 5C,A00,507696,Munoz Sanchez; Alicia,9,0,20,11
1714617806498,MAE 197,001,528363,Boechler; Nicholas Sebastia,9998,0,9999,1
1714617807526,MATH 197,001,523477,Kedlaya; Kiran S.,9995,0,9999,4
1714617807526,MATH 197,002,563811,Zhang; Danna,9995,0,9999,4
1714617807526,MATH 197,003,628552,Dumitriu; Ioana,9998,0,9999,1
1714617808555,MCWP 40R,A00,518780,Staff,2,0,20,18
1714617808555,MCWP 40R,B00,518781,Staff,8,0,20,12
1714617808555,MCWP 40R,C00,518783,Staff,6,0,20,14
1714617809586,MCWP 50R,A00,518791,Staff,0,0,20,20
1714617809586,MCWP 50R,B00,518792,Staff,0,2,20,20
1714617809586,MCWP 50R,C00,518793,Staff,0,2,20,20
1714617809586,MCWP 50R,D00,518794,Staff,0,0,20,20
1714617809586,MCWP 50R,E00,518795,Staff,0,2,20,20
1714617809586,MCWP 50R,F00,518796,Staff,0,0,20,20
1714617809586,MCWP 50R,G00,518797,Staff,0,1,20,20
1714617810611,MMW 12R,A01,514034,Herbst; Matthew,0,0,16,16
1714617810611,MMW 12R,A02,514035,Herbst; Matthew,1,0,16,15
1714617811639,MMW 13R,A01,514037,Staff,0,4,16,16
1714617811639,MMW 13R,A02,514039,Staff,0,2,16,16
1714617811639,MMW 13R,A03,628519,Staff,0,2,16,16
1714617813692,SIO 295LS,A00,523233,Staff,10,0,30,20
1714617814717,SIO 295S,A00,523232,Staff,10,0,30,20
1714617815742,SIOC 290S,A01,637330,Merrifield; Mark A,23,0,30,7
1714617816767,SIOC 291S,A01,637333,Gabriel; Corey John,23,0,30,7
1714617817795,SOCI 117,A01,494376,Staff,0,4,5,5
1714617818821,WES 237B,A00,494380,Staff,9,0,20,11
1714617820909,AESE 279B,A00,494370,Wade; Jon P,0,0,33,33
1714617821934,AIP 197,001,627712,Vespa; Emanuel Ignacio,9998,0,9999,1
1714617822973,ANAR 135S,A00,494369,Braswell; Geoffrey E.,0,0,0,0
1714617823999,BENG 196,001,628496,Engler; Adam J.,9998,0,9999,1
1714617825024,CAT 124RS,A01,519847,Geibel; William,0,0,20,20
1714617826048,CAT 125RS,A01,515971,Geibel; William,0,0,20,20
1714617827075,CLRE 250,A00,511389,Morris; Sheldon,9993,0,9999,6
1714617828104,CLRE 251,A00,507176,Mehta; Ravindra L.,9993,0,9999,6
1714617828104,CLRE 251,B00,511410,Mehta; Ravindra L.,9998,0,9999,1
1714617829132,CLRE 252,A00,507189,Cuomo; Raphael Eduardo,9995,0,9999,4
1714617830164,CLRE 253,A00,507199,Vaida; Florin,9994,0,9999,5
1714617830164,CLRE 253,B00,507202,Vaida; Florin,9999,0,9999,0
1714617831191,CLRE 259,A00,507211,Patel; Hemal,9996,0,9999,3
1714617832216,CLRE 260,A00,507221,Cuomo; Raphael Eduardo,9999,0,9999,0
1714617833240,CLRE 297,001,507242,Cuomo; Raphael Eduardo,9999,0,9999,0
1714617834269,COGS 197,001,638244,Voytek; Bradley Thomas,9998,0,9999,1
1714617835294,CSE 191,A00,516875,Minnes Kemp; Mor Mia,9992,0,9999,7
1714617836320,CSE 197,001,637388,Minnes Kemp; Mor Mia,9998,0,9999,1
1714617837346,CSS 201S,A01,494383,Staff,35,0,35,0
1714617838375,CSS 202S,A01,494387,Staff,35,0,35,0
1714617839400,DSC 197,001,628532,Eldridge; Justin Matthew,9996,0,9999,3
1714617840425,EAP 100,A00,516065,Staff,9797,0,9999,202
1714617841453,ECE 45,A01,507414,Staff,33,0,60,27
1714617843510,ECE 111,A01,507420,Staff,15,0,50,35
1714617844536,ECE 197,001,548057,Sievenpiper; Daniel F.,9993,0,9999,6
1714617845566,EDS 115,A00,507243,Choi; Bailey Miyeon,10,0,28,18
1714617846592,EDS 117,A01,494379,Staff,1,5,30,29
1714617847618,EDS 125,A00,507246,Hopkins; Megan Beth,9,0,30,21
1714617848647,EDS 128A,A01,507264,Fargason; Sharon Gayle,8,0,26,18
1714617849678,EDS 128B,A01,507293,Pappas; Elizabeth,12,0,30,18
1714617850703,EDS 139,A00,507294,Fargason; Sharon Gayle,13,0,30,17
1714617850703,EDS 139,B00,507313,Pappas; Elizabeth,13,0,30,17
1714617851731,EDS 201,A00,507315,Staff,13,0,30,17
1714617852758,EDS 203,A01,507317,Halter; Christopher P.,12,0,30,18
1714617853784,EDS 204R,A01,507319,Halter; Christopher P.,0,3,30,30
1714617853784,EDS 204R,B01,507331,Heinzman; Erica M.,16,0,30,14
1714617854808,EDS 206R,A00,507332,Staff,0,4,30,30
1714617854808,EDS 206R,B00,507343,Staff,17,0,30,13
1714617855837,EDS 250,A00,507344,Hemans; Patricia Ann Benitez,22,0,40,18
1714617856865,EDS 281,A00,507345,Daly; Alan J.,18,0,18,0
1714617857892,EDS 284,A00,507350,Daly; Alan J.,16,0,16,0
1714617858918,EDS 286,A00,507359,Fine; Sarah,18,0,18,0
1714617859947,EDS 289C,A01,507361,Daly; Alan J.,18,0,18,0
1714617860973,EDS 290,A00,507366,Hofstetter; Carolyn,15,0,15,0
1714617861998,LIGM 5A,A00,507421,Fischer-Grunski; Eva K,18,0,20,2
1714617863028,LIGM 5B,A00,507423,Fischer-Grunski; Eva K,19,0,20,1
1714617864055,LIGM 5C,A00,507425,Fischer-Grunski; Eva K,19,0,20,1
1714617865084,LIIT 5AS,A00,507427,Carnelos; Chiara,20,0,20,0
1714617866116,LIIT 5BS,A00,507430,Carnelos; Chiara,20,0,20,0
1714617867142,LIIT 5CS,A00,507432,Carnelos; Chiara,20,0,20,0
1714617868169,LISP 5A,A00,507541,Munoz Sanchez; Alicia,11,0,20,9
1714617869194,LISP 5B,A00,507671,Munoz Sanchez; Alicia,8,0,20,12
1714617870220,LISP 5C,A00,507696,Munoz Sanchez; Alicia,9,0,20,11
1714617871248,MAE 197,001,528363,Boechler; Nicholas Sebastia,9998,0,9999,1
1714617872279,MATH 197,001,523477,Kedlaya; Kiran S.,9995,0,9999,4
1714617872279,MATH 197,002,563811,Zhang; Danna,9995,0,9999,4
1714617872279,MATH 197,003,628552,Dumitriu; Ioana,9998,0,9999,1
1714617873305,MCWP 40R,A00,518780,Staff,2,0,20,18
1714617873305,MCWP 40R,B00,518781,Staff,8,0,20,12
1714617873305,MCWP 40R,C00,518783,Staff,6,0,20,14
1714617874330,MCWP 50R,A00,518791,Staff,0,0,20,20
1714617874330,MCWP 50R,B00,518792,Staff,0,2,20,20
1714617874330,MCWP 50R,C00,518793,Staff,0,2,20,20
1714617874330,MCWP 50R,D00,518794,Staff,0,0,20,20
1714617874330,MCWP 50R,E00,518795,Staff,0,2,20,20
1714617874330,MCWP 50R,F00,518796,Staff,0,0,20,20
1714617874330,MCWP 50R,G00,518797,Staff,0,1,20,20
1714617875355,MMW 12R,A01,514034,Herbst; Matthew,0,0,16,16
1714617875355,MMW 12R,A02,514035,Herbst; Matthew,1,0,16,15
1714617876384,MMW 13R,A01,514037,Staff,0,4,16,16
1714617876384,MMW 13R,A02,514039,Staff,0,2,16,16
1714617876384,MMW 13R,A03,628519,Staff,0,2,16,16
1714617878438,SIO 295LS,A00,523233,Staff,10,0,30,20
1714617879463,SIO 295S,A00,523232,Staff,10,0,30,20
1714617880492,SIOC 290S,A01,637330,Merrifield; Mark A,23,0,30,7
1714617881516,SIOC 291S,A01,637333,Gabriel; Corey John,23,0,30,7
1714617882539,SOCI 117,A01,494376,Staff,0,4,5,5
1714617883565,WES 237B,A00,494380,Staff,9,0,20,11
1714617885636,AESE 279B,A00,494370,Wade; Jon P,0,0,33,33
1714617886659,AIP 197,001,627712,Vespa; Emanuel Ignacio,9998,0,9999,1
1714617887683,ANAR 135S,A00,494369,Braswell; Geoffrey E.,0,0,0,0
1714617888711,BENG 196,001,628496,Engler; Adam J.,9998,0,9999,1
1714617889738,CAT 124RS,A01,519847,Geibel; William,0,0,20,20
1714617890762,CAT 125RS,A01,515971,Geibel; William,0,0,20,20
1714617891788,CLRE 250,A00,511389,Morris; Sheldon,9993,0,9999,6
1714617892870,CLRE 251,A00,507176,Mehta; Ravindra L.,9993,0,9999,6
1714617892870,CLRE 251,B00,511410,Mehta; Ravindra L.,9998,0,9999,1
1714617893901,CLRE 252,A00,507189,Cuomo; Raphael Eduardo,9995,0,9999,4
1714617894930,CLRE 253,A00,507199,Vaida; Florin,9994,0,9999,5
1714617894930,CLRE 253,B00,507202,Vaida; Florin,9999,0,9999,0
1714617895957,CLRE 259,A00,507211,Patel; Hemal,9996,0,9999,3
1714617896982,CLRE 260,A00,507221,Cuomo; Raphael Eduardo,9999,0,9999,0
1714617898008,CLRE 297,001,507242,Cuomo; Raphael Eduardo,9999,0,9999,0
1714617899034,COGS 197,001,638244,Voytek; Bradley Thomas,9998,0,9999,1
1714617900059,CSE 191,A00,516875,Minnes Kemp; Mor Mia,9992,0,9999,7
1714617901085,CSE 197,001,637388,Minnes Kemp; Mor Mia,9998,0,9999,1
1714617902110,CSS 201S,A01,494383,Staff,35,0,35,0
1714617903137,CSS 202S,A01,494387,Staff,35,0,35,0
1714617904166,DSC 197,001,628532,Eldridge; Justin Matthew,9996,0,9999,3
1714617905191,EAP 100,A00,516065,Staff,9797,0,9999,202
1714617906277,ECE 45,A01,507414,Staff,33,0,60,27
1714617908334,ECE 111,A01,507420,Staff,15,0,50,35
1714617909360,ECE 197,001,548057,Sievenpiper; Daniel F.,9993,0,9999,6
1714617910386,EDS 115,A00,507243,Choi; Bailey Miyeon,10,0,28,18
1714617911423,EDS 117,A01,494379,Staff,1,5,30,29
1714617912452,EDS 125,A00,507246,Hopkins; Megan Beth,9,0,30,21
1714617913478,EDS 128A,A01,507264,Fargason; Sharon Gayle,8,0,26,18
1714617914507,EDS 128B,A01,507293,Pappas; Elizabeth,12,0,30,18
1714617915537,EDS 139,A00,507294,Fargason; Sharon Gayle,13,0,30,17
1714617915537,EDS 139,B00,507313,Pappas; Elizabeth,13,0,30,17
1714617916563,EDS 201,A00,507315,Staff,13,0,30,17
1714617917588,EDS 203,A01,507317,Halter; Christopher P.,12,0,30,18
1714617918615,EDS 204R,A01,507319,Halter; Christopher P.,0,3,30,30
1714617918615,EDS 204R,B01,507331,Heinzman; Erica M.,16,0,30,14
1714617919640,EDS 206R,A00,507332,Staff,0,4,30,30
1714617919640,EDS 206R,B00,507343,Staff,17,0,30,13
1714617920665,EDS 250,A00,507344,Hemans; Patricia Ann Benitez,22,0,40,18
1714617921691,EDS 281,A00,507345,Daly; Alan J.,18,0,18,0
1714617922719,EDS 284,A00,507350,Daly; Alan J.,16,0,16,0
1714617923745,EDS 286,A00,507359,Fine; Sarah,18,0,18,0
1714617924774,EDS 289C,A01,507361,Daly; Alan J.,18,0,18,0
1714617925801,EDS 290,A00,507366,Hofstetter; Carolyn,15,0,15,0
1714617926829,LIGM 5A,A00,507421,Fischer-Grunski; Eva K,18,0,20,2
1714617927860,LIGM 5B,A00,507423,Fischer-Grunski; Eva K,19,0,20,1
1714617928903,LIGM 5C,A00,507425,Fischer-Grunski; Eva K,19,0,20,1
1714617929931,LIIT 5AS,A00,507427,Carnelos; Chiara,20,0,20,0
1714617930961,LIIT 5BS,A00,507430,Carnelos; Chiara,20,0,20,0
1714617931985,LIIT 5CS,A00,507432,Carnelos; Chiara,20,0,20,0
1714617933025,LISP 5A,A00,507541,Munoz Sanchez; Alicia,11,0,20,9
1714617934050,LISP 5B,A00,507671,Munoz Sanchez; Alicia,8,0,20,12
1714617935074,LISP 5C,A00,507696,Munoz Sanchez; Alicia,9,0,20,11
1714617936100,MAE 197,001,528363,Boechler; Nicholas Sebastia,9998,0,9999,1
1714617937126,MATH 197,001,523477,Kedlaya; Kiran S.,9995,0,9999,4
1714617937126,MATH 197,002,563811,Zhang; Danna,9995,0,9999,4
1714617937126,MATH 197,003,628552,Dumitriu; Ioana,9998,0,9999,1
1714617938155,MCWP 40R,A00,518780,Staff,2,0,20,18
1714617938155,MCWP 40R,B00,518781,Staff,8,0,20,12
1714617938155,MCWP 40R,C00,518783,Staff,6,0,20,14
1714617939182,MCWP 50R,A00,518791,Staff,0,0,20,20
1714617939182,MCWP 50R,B00,518792,Staff,0,2,20,20
1714617939182,MCWP 50R,C00,518793,Staff,0,2,20,20
1714617939182,MCWP 50R,D00,518794,Staff,0,0,20,20
1714617939182,MCWP 50R,E00,518795,Staff,0,2,20,20
1714617939182,MCWP 50R,F00,518796,Staff,0,0,20,20
1714617939182,MCWP 50R,G00,518797,Staff,0,1,20,20
1714617940208,MMW 12R,A01,514034,Herbst; Matthew,0,0,16,16
1714617940208,MMW 12R,A02,514035,Herbst; Matthew,1,0,16,15
1714617941233,MMW 13R,A01,514037,Staff,0,4,16,16
1714617941233,MMW 13R,A02,514039,Staff,0,2,16,16
1714617941233,MMW 13R,A03,628519,Staff,0,2,16,16
1714617943285,SIO 295LS,A00,523233,Staff,10,0,30,20
1714617944310,SIO 295S,A00,523232,Staff,10,0,30,20
1714617945337,SIOC 290S,A01,637330,Merrifield; Mark A,23,0,30,7
1714617946362,SIOC 291S,A01,637333,Gabriel; Corey John,23,0,30,7
1714617947390,SOCI 117,A01,494376,Staff,0,4,5,5
1714617948415,WES 237B,A00,494380,Staff,9,0,20,11
1714617950486,AESE 279B,A00,494370,Wade; Jon P,0,0,33,33
1714617951512,AIP 197,001,627712,Vespa; Emanuel Ignacio,9998,0,9999,1
1714617952537,ANAR 135S,A00,494369,Braswell; Geoffrey E.,0,0,0,0
1714617953563,BENG 196,001,628496,Engler; Adam J.,9998,0,9999,1
1714617954590,CAT 124RS,A01,519847,Geibel; William,0,0,20,20
1714617955617,CAT 125RS,A01,515971,Geibel; William,0,0,20,20
1714617956642,CLRE 250,A00,511389,Morris; Sheldon,9993,0,9999,6
1714617957671,CLRE 251,A00,507176,Mehta; Ravindra L.,9993,0,9999,6
1714617957671,CLRE 251,B00,511410,Mehta; Ravindra L.,9998,0,9999,1
1714617958698,CLRE 252,A00,507189,Cuomo; Raphael Eduardo,9995,0,9999,4
1714617959728,CLRE 253,A00,507199,Vaida; Florin,9994,0,9999,5
1714617959728,CLRE 253,B00,507202,Vaida; Florin,9999,0,9999,0
1714617960759,CLRE 259,A00,507211,Patel; Hemal,9996,0,9999,3
1714617961786,CLRE 260,A00,507221,Cuomo; Raphael Eduardo,9999,0,9999,0
1714617962811,CLRE 297,001,507242,Cuomo; Raphael Eduardo,9999,0,9999,0
1714617963838,COGS 197,001,638244,Voytek; Bradley Thomas,9998,0,9999,1
1714617964865,CSE 191,A00,516875,Minnes Kemp; Mor Mia,9992,0,9999,7
1714617965890,CSE 197,001,637388,Minnes Kemp; Mor Mia,9998,0,9999,1
1714617966917,CSS 201S,A01,494383,Staff,35,0,35,0
1714617967945,CSS 202S,A01,494387,Staff,35,0,35,0
1714617968970,DSC 197,001,628532,Eldridge; Justin Matthew,9996,0,9999,3
1714617969997,EAP 100,A00,516065,Staff,9797,0,9999,202
1714617971021,ECE 45,A01,507414,Staff,33,0,60,27
1714617973077,ECE 111,A01,507420,Staff,15,0,50,35
1714617974106,ECE 197,001,548057,Sievenpiper; Daniel F.,9993,0,9999,6
1714617975133,EDS 115,A00,507243,Choi; Bailey Miyeon,10,0,28,18
1714617976160,EDS 117,A01,494379,Staff,1,5,30,29
1714617977184,EDS 125,A00,507246,Hopkins; Megan Beth,9,0,30,21
1714617978210,EDS 128A,A01,507264,Fargason; Sharon Gayle,8,0,26,18
1714617979236,EDS 128B,A01,507293,Pappas; Elizabeth,12,0,30,18
1714617980267,EDS 139,A00,507294,Fargason; Sharon Gayle,13,0,30,17
1714617980267,EDS 139,B00,507313,Pappas; Elizabeth,13,0,30,17
1714617981296,EDS 201,A00,507315,Staff,13,0,30,17
1714617982321,EDS 203,A01,507317,Halter; Christopher P.,12,0,30,18
1714617983348,EDS 204R,A01,507319,Halter; Christopher P.,0,3,30,30
1714617983348,EDS 204R,B01,507331,Heinzman; Erica M.,16,0,30,14
1714617984377,EDS 206R,A00,507332,Staff,0,4,30,30
1714617984377,EDS 206R,B00,507343,Staff,17,0,30,13
1714617985402,EDS 250,A00,507344,Hemans; Patricia Ann Benitez,22,0,40,18
1714617986426,EDS 281,A00,507345,Daly; Alan J.,18,0,18,0
1714617987453,EDS 284,A00,507350,Daly; Alan J.,16,0,16,0
1714617988478,EDS 286,A00,507359,Fine; Sarah,18,0,18,0
1714617989503,EDS 289C,A01,507361,Daly; Alan J.,18,0,18,0
1714617990529,EDS 290,A00,507366,Hofstetter; Carolyn,15,0,15,0
1714617991557,LIGM 5A,A00,507421,Fischer-Grunski; Eva K,18,0,20,2
1714617992582,LIGM 5B,A00,507423,Fischer-Grunski; Eva K,19,0,20,1
1714617993611,LIGM 5C,A00,507425,Fischer-Grunski; Eva K,19,0,20,1
1714617994636,LIIT 5AS,A00,507427,Carnelos; Chiara,20,0,20,0
1714617995660,LIIT 5BS,A00,507430,Carnelos; Chiara,20,0,20,0
1714617996741,LIIT 5CS,A00,507432,Carnelos; Chiara,20,0,20,0
1714617997772,LISP 5A,A00,507541,Munoz Sanchez; Alicia,11,0,20,9
1714617998796,LISP 5B,A00,507671,Munoz Sanchez; Alicia,8,0,20,12
1714617999825,LISP 5C,A00,507696,Munoz Sanchez; Alicia,9,0,20,11
1714618000849,MAE 197,001,528363,Boechler; Nicholas Sebastia,9998,0,9999,1
1714618001876,MATH 197,001,523477,Kedlaya; Kiran S.,9995,0,9999,4
1714618001876,MATH 197,002,563811,Zhang; Danna,9995,0,9999,4
1714618001876,MATH 197,003,628552,Dumitriu; Ioana,9998,0,9999,1
1714618002903,MCWP 40R,A00,518780,Staff,2,0,20,18
1714618002903,MCWP 40R,B00,518781,Staff,8,0,20,12
1714618002903,MCWP 40R,C00,518783,Staff,6,0,20,14
1714618003929,MCWP 50R,A00,518791,Staff,0,0,20,20
1714618003929,MCWP 50R,B00,518792,Staff,0,2,20,20
1714618003929,MCWP 50R,C00,518793,Staff,0,2,20,20
1714618003929,MCWP 50R,D00,518794,Staff,0,0,20,20
1714618003929,MCWP 50R,E00,518795,Staff,0,2,20,20
1714618003929,MCWP 50R,F00,518796,Staff,0,0,20,20
1714618003929,MCWP 50R,G00,518797,Staff,0,1,20,20
1714618004958,MMW 12R,A01,514034,Herbst; Matthew,0,0,16,16
1714618004958,MMW 12R,A02,514035,Herbst; Matthew,1,0,16,15
1714618005984,MMW 13R,A01,514037,Staff,0,4,16,16
1714618005984,MMW 13R,A02,514039,Staff,0,2,16,16
1714618005984,MMW 13R,A03,628519,Staff,0,2,16,16
1714618008039,SIO 295LS,A00,523233,Staff,10,0,30,20
1714618009065,SIO 295S,A00,523232,Staff,10,0,30,20
1714618010095,SIOC 290S,A01,637330,Merrifield; Mark A,23,0,30,7
1714618011124,SIOC 291S,A01,637333,Gabriel; Corey John,23,0,30,7
1714618012152,SOCI 117,A01,494376,Staff,0,4,5,5
1714618013177,WES 237B,A00,494380,Staff,9,0,20,11
1714618015251,AESE 279B,A00,494370,Wade; Jon P,0,0,33,33
1714618016278,AIP 197,001,627712,Vespa; Emanuel Ignacio,9998,0,9999,1
1714618017305,ANAR 135S,A00,494369,Braswell; Geoffrey E.,0,0,0,0
1714618018332,BENG 196,001,628496,Engler; Adam J.,9998,0,9999,1
1714618019360,CAT 124RS,A01,519847,Geibel; William,0,0,20,20
1714618020386,CAT 125RS,A01,515971,Geibel; William,0,0,20,20
1714618021413,CLRE 250,A00,511389,Morris; Sheldon,9993,0,9999,6
1714618022440,CLRE 251,A00,507176,Mehta; Ravindra L.,9993,0,9999,6
1714618022440,CLRE 251,B00,511410,Mehta; Ravindra L.,9998,0,9999,1
1714618023470,CLRE 252,A00,507189,Cuomo; Raphael Eduardo,9995,0,9999,4
1714618024494,CLRE 253,A00,507199,Vaida; Florin,9994,0,9999,5
1714618024494,CLRE 253,B00,507202,Vaida; Florin,9999,0,9999,0
1714618025519,CLRE 259,A00,507211,Patel; Hemal,9996,0,9999,3
1714618026545,CLRE 260,A00,507221,Cuomo; Raphael Eduardo,9999,0,9999,0
1714618027570,CLRE 297,001,507242,Cuomo; Raphael Eduardo,9999,0,9999,0
1714618028598,COGS 197,001,638244,Voytek; Bradley Thomas,9998,0,9999,1
1714618029623,CSE 191,A00,516875,Minnes Kemp; Mor Mia,9992,0,9999,7
1714618030652,CSE 197,001,637388,Minnes Kemp; Mor Mia,9998,0,9999,1
1714618031677,CSS 201S,A01,494383,Staff,35,0,35,0
1714618032702,CSS 202S,A01,494387,Staff,35,0,35,0
1714618033727,DSC 197,001,628532,Eldridge; Justin Matthew,9996,0,9999,3
1714618034751,EAP 100,A00,516065,Staff,9797,0,9999,202
1714618035837,ECE 45,A01,507414,Staff,33,0,60,27
1714618037887,ECE 111,A01,507420,Staff,15,0,50,35
1714618038913,ECE 197,001,548057,Sievenpiper; Daniel F.,9993,0,9999,6
1714618039938,EDS 115,A00,507243,Choi; Bailey Miyeon,10,0,28,18
1714618040965,EDS 117,A01,494379,Staff,1,5,30,29
1714618041990,EDS 125,A00,507246,Hopkins; Megan Beth,9,0,30,21
1714618043015,EDS 128A,A01,507264,Fargason; Sharon Gayle,8,0,26,18
1714618044043,EDS 128B,A01,507293,Pappas; Elizabeth,12,0,30,18
1714618045072,EDS 139,A00,507294,Fargason; Sharon Gayle,13,0,30,17
1714618045072,EDS 139,B00,507313,Pappas; Elizabeth,13,0,30,17
1714618046097,EDS 201,A00,507315,Staff,13,0,30,17
1714618047121,EDS 203,A01,507317,Halter; Christopher P.,12,0,30,18
1714618048149,EDS 204R,A01,507319,Halter; Christopher P.,0,3,30,30
1714618048149,EDS 204R,B01,507331,Heinzman; Erica M.,16,0,30,14
1714618049178,EDS 206R,A00,507332,Staff,0,4,30,30
1714618049178,EDS 206R,B00,507343,Staff,17,0,30,13
1714618050204,EDS 250,A00,507344,Hemans; Patricia Ann Benitez,22,0,40,18
1714618051232,EDS 281,A00,507345,Daly; Alan J.,18,0,18,0
1714618052258,EDS 284,A00,507350,Daly; Alan J.,16,0,16,0
1714618053286,EDS 286,A00,507359,Fine; Sarah,18,0,18,0
1714618054314,EDS 289C,A01,507361,Daly; Alan J.,18,0,18,0
1714618055342,EDS 290,A00,507366,Hofstetter; Carolyn,15,0,15,0
1714618056369,LIGM 5A,A00,507421,Fischer-Grunski; Eva K,18,0,20,2
1714618057392,LIGM 5B,A00,507423,Fischer-Grunski; Eva K,19,0,20,1
1714618058422,LIGM 5C,A00,507425,Fischer-Grunski; Eva K,19,0,20,1
1714618059450,LIIT 5AS,A00,507427,Carnelos; Chiara,20,0,20,0
1714618060481,LIIT 5BS,A00,507430,Carnelos; Chiara,20,0,20,0
1714618061509,LIIT 5CS,A00,507432,Carnelos; Chiara,20,0,20,0
1714618062537,LISP 5A,A00,507541,Munoz Sanchez; Alicia,11,0,20,9
1714618063566,LISP 5B,A00,507671,Munoz Sanchez; Alicia,8,0,20,12
1714618064590,LISP 5C,A00,507696,Munoz Sanchez; Alicia,9,0,20,11
1714618065617,MAE 197,001,528363,Boechler; Nicholas Sebastia,9998,0,9999,1
1714618066644,MATH 197,001,523477,Kedlaya; Kiran S.,9995,0,9999,4
1714618066644,MATH 197,002,563811,Zhang; Danna,9995,0,9999,4
1714618066644,MATH 197,003,628552,Dumitriu; Ioana,9998,0,9999,1
1714618067673,MCWP 40R,A00,518780,Staff,2,0,20,18
1714618067673,MCWP 40R,B00,518781,Staff,8,0,20,12
1714618067673,MCWP 40R,C00,518783,Staff,6,0,20,14
1714618068699,MCWP 50R,A00,518791,Staff,0,0,20,20
1714618068699,MCWP 50R,B00,518792,Staff,0,2,20,20
1714618068699,MCWP 50R,C00,518793,Staff,0,2,20,20
1714618068699,MCWP 50R,D00,518794,Staff,0,0,20,20
1714618068699,MCWP 50R,E00,518795,Staff,0,2,20,20
1714618068699,MCWP 50R,F00,518796,Staff,0,0,20,20
1714618068699,MCWP 50R,G00,518797,Staff,0,1,20,20
1714618069725,MMW 12R,A01,514034,Herbst; Matthew,0,0,16,16
1714618069725,MMW 12R,A02,514035,Herbst; Matthew,1,0,16,15
1714618070752,MMW 13R,A01,514037,Staff,0,4,16,16
1714618070752,MMW 13R,A02,514039,Staff,0,2,16,16
1714618070752,MMW 13R,A03,628519,Staff,0,2,16,16
1714618072809,SIO 295LS,A00,523233,Staff,10,0,30,20
1714618073833,SIO 295S,A00,523232,Staff,10,0,30,20
1714618074864,SIOC 290S,A01,637330,Merrifield; Mark A,23,0,30,7
1714618075890,SIOC 291S,A01,637333,Gabriel; Corey John,23,0,30,7
1714618076915,SOCI 117,A01,494376,Staff,0,4,5,5
1714618077941,WES 237B,A00,494380,Staff,9,0,20,11
1714618080008,AESE 279B,A00,494370,Wade; Jon P,0,0,33,33
1714618081045,AIP 197,001,627712,Vespa; Emanuel Ignacio,9998,0,9999,1
1714618082072,ANAR 135S,A00,494369,Braswell; Geoffrey E.,0,0,0,0
1714618083139,BENG 196,001,628496,Engler; Adam J.,9998,0,9999,1
1714618084164,CAT 124RS,A01,519847,Geibel; William,0,0,20,20
1714618085189,CAT 125RS,A01,515971,Geibel; William,0,0,20,20
1714618086215,CLRE 250,A00,511389,Morris; Sheldon,9993,0,9999,6
1714618087245,CLRE 251,A00,507176,Mehta; Ravindra L.,9993,0,9999,6
1714618087245,CLRE 251,B00,511410,Mehta; Ravindra L.,9998,0,9999,1
1714618088274,CLRE 252,A00,507189,Cuomo; Raphael Eduardo,9995,0,9999,4
1714618089304,CLRE 253,A00,507199,Vaida; Florin,9994,0,9999,5
1714618089304,CLRE 253,B00,507202,Vaida; Florin,9999,0,9999,0
1714618090332,CLRE 259,A00,507211,Patel; Hemal,9996,0,9999,3
1714618091358,CLRE 260,A00,507221,Cuomo; Raphael Eduardo,9999,0,9999,0
1714618092385,CLRE 297,001,507242,Cuomo; Raphael Eduardo,9999,0,9999,0
1714618093409,COGS 197,001,638244,Voytek; Bradley Thomas,9998,0,9999,1
1714618094435,CSE 191,A00,516875,Minnes Kemp; Mor Mia,9992,0,9999,7
1714618095459,CSE 197,001,637388,Minnes Kemp; Mor Mia,9998,0,9999,1
1714618096487,CSS 201S,A01,494383,Staff,35,0,35,0
1714618097514,CSS 202S,A01,494387,Staff,35,0,35,0
1714618098540,DSC 197,001,628532,Eldridge; Justin Matthew,9996,0,9999,3
1714618099563,EAP 100,A00,516065,Staff,9797,0,9999,202
1714618100646,ECE 45,A01,507414,Staff,33,0,60,27
1714618102700,ECE 111,A01,507420,Staff,15,0,50,35
1714618103730,ECE 197,001,548057,Sievenpiper; Daniel F.,9993,0,9999,6
1714618104757,EDS 115,A00,507243,Choi; Bailey Miyeon,10,0,28,18
1714618105787,EDS 117,A01,494379,Staff,1,5,30,29
1714618106817,EDS 125,A00,507246,Hopkins; Megan Beth,9,0,30,21
1714618107845,EDS 128A,A01,507264,Fargason; Sharon Gayle,8,0,26,18
1714618108875,EDS 128B,A01,507293,Pappas; Elizabeth,12,0,30,18
1714618109900,EDS 139,A00,507294,Fargason; Sharon Gayle,13,0,30,17
1714618109900,EDS 139,B00,507313,Pappas; Elizabeth,13,0,30,17
1714618110926,EDS 201,A00,507315,Staff,13,0,30,17
1714618111952,EDS 203,A01,507317,Halter; Christopher P.,12,0,30,18
1714618112979,EDS 204R,A01,507319,Halter; Christopher P.,0,3,30,30
1714618112979,EDS 204R,B01,507331,Heinzman; Erica M.,16,0,30,14
1714618114004,EDS 206R,A00,507332,Staff,0,4,30,30
1714618114004,EDS 206R,B00,507343,Staff,17,0,30,13
1714618115031,EDS 250,A00,507344,Hemans; Patricia Ann Benitez,22,0,40,18
1714618116057,EDS 281,A00,507345,Daly; Alan J.,18,0,18,0
1714618117080,EDS 284,A00,507350,Daly; Alan J.,16,0,16,0
1714618118107,EDS 286,A00,507359,Fine; Sarah,18,0,18,0
1714618119131,EDS 289C,A01,507361,Daly; Alan J.,18,0,18,0
1714618120155,EDS 290,A00,507366,Hofstetter; Carolyn,15,0,15,0
1714618121185,LIGM 5A,A00,507421,Fischer-Grunski; Eva K,18,0,20,2
1714618122211,LIGM 5B,A00,507423,Fischer-Grunski; Eva K,19,0,20,1
1714618123236,LIGM 5C,A00,507425,Fischer-Grunski; Eva K,19,0,20,1
1714618124262,LIIT 5AS,A00,507427,Carnelos; Chiara,20,0,20,0
1714618125294,LIIT 5BS,A00,507430,Carnelos; Chiara,20,0,20,0
1714618126319,LIIT 5CS,A00,507432,Carnelos; Chiara,20,0,20,0
1714618127346,LISP 5A,A00,507541,Munoz Sanchez; Alicia,11,0,20,9
1714618128374,LISP 5B,A00,507671,Munoz Sanchez; Alicia,8,0,20,12
1714618129403,LISP 5C,A00,507696,Munoz Sanchez; Alicia,9,0,20,11
1714618130429,MAE 197,001,528363,Boechler; Nicholas Sebastia,9998,0,9999,1
1714618131463,MATH 197,001,523477,Kedlaya; Kiran S.,9995,0,9999,4
1714618131463,MATH 197,002,563811,Zhang; Danna,9995,0,9999,4
1714618131463,MATH 197,003,628552,Dumitriu; Ioana,9998,0,9999,1
1714618132487,MCWP 40R,A00,518780,Staff,2,0,20,18
1714618132487,MCWP 40R,B00,518781,Staff,8,0,20,12
1714618132487,MCWP 40R,C00,518783,Staff,6,0,20,14
1714618133512,MCWP 50R,A00,518791,Staff,0,0,20,20
1714618133512,MCWP 50R,B00,518792,Staff,0,2,20,20
1714618133512,MCWP 50R,C00,518793,Staff,0,2,20,20
1714618133512,MCWP 50R,D00,518794,Staff,0,0,20,20
1714618133512,MCWP 50R,E00,518795,Staff,0,2,20,20
1714618133512,MCWP 50R,F00,518796,Staff,0,0,20,20
1714618133512,MCWP 50R,G00,518797,Staff,0,1,20,20
1714618134537,MMW 12R,A01,514034,Herbst; Matthew,0,0,16,16
1714618134537,MMW 12R,A02,514035,Herbst; Matthew,1,0,16,15
1714618135563,MMW 13R,A01,514037,Staff,0,4,16,16
1714618135563,MMW 13R,A02,514039,Staff,0,2,16,16
1714618135563,MMW 13R,A03,628519,Staff,0,2,16,16
1714618137612,SIO 295LS,A00,523233,Staff,10,0,30,20
1714618138638,SIO 295S,A00,523232,Staff,10,0,30,20
1714618139664,SIOC 290S,A01,637330,Merrifield; Mark A,23,0,30,7
1714618140692,SIOC 291S,A01,637333,Gabriel; Corey John,23,0,30,7
1714618141718,SOCI 117,A01,494376,Staff,0,4,5,5
1714618142743,WES 237B,A00,494380,Staff,9,0,20,11
1714618144811,AESE 279B,A00,494370,Wade; Jon P,0,0,33,33
1714618145836,AIP 197,001,627712,Vespa; Emanuel Ignacio,9998,0,9999,1
1714618146862,ANAR 135S,A00,494369,Braswell; Geoffrey E.,0,0,0,0
1714618147886,BENG 196,001,628496,Engler; Adam J.,9998,0,9999,1
1714618148914,CAT 124RS,A01,519847,Geibel; William,0,0,20,20
1714618149941,CAT 125RS,A01,515971,Geibel; William,0,0,20,20
1714618150967,CLRE 250,A00,511389,Morris; Sheldon,9993,0,9999,6
1714618151992,CLRE 251,A00,507176,Mehta; Ravindra L.,9993,0,9999,6
1714618151992,CLRE 251,B00,511410,Mehta; Ravindra L.,9998,0,9999,1
1714618153018,CLRE 252,A00,507189,Cuomo; Raphael Eduardo,9995,0,9999,4
1714618154047,CLRE 253,A00,507199,Vaida; Florin,9994,0,9999,5
1714618154047,CLRE 253,B00,507202,Vaida; Florin,9999,0,9999,0
1714618155074,CLRE 259,A00,507211,Patel; Hemal,9996,0,9999,3
1714618156100,CLRE 260,A00,507221,Cuomo; Raphael Eduardo,9999,0,9999,0
1714618157125,CLRE 297,001,507242,Cuomo; Raphael Eduardo,9999,0,9999,0
1714618158154,COGS 197,001,638244,Voytek; Bradley Thomas,9998,0,9999,1
1714618159179,CSE 191,A00,516875,Minnes Kemp; Mor Mia,9992,0,9999,7
1714618160203,CSE 197,001,637388,Minnes Kemp; Mor Mia,9998,0,9999,1
1714618161230,CSS 201S,A01,494383,Staff,35,0,35,0
1714618162258,CSS 202S,A01,494387,Staff,35,0,35,0
1714618163285,DSC 197,001,628532,Eldridge; Justin Matthew,9996,0,9999,3
1714618164310,EAP 100,A00,516065,Staff,9797,0,9999,202
1714618165335,ECE 45,A01,507414,Staff,33,0,60,27
1714618167388,ECE 111,A01,507420,Staff,15,0,50,35
1714618168416,ECE 197,001,548057,Sievenpiper; Daniel F.,9993,0,9999,6
1714618169443,EDS 115,A00,507243,Choi; Bailey Miyeon,10,0,28,18
1714618170468,EDS 117,A01,494379,Staff,1,5,30,29
1714618171493,EDS 125,A00,507246,Hopkins; Megan Beth,9,0,30,21
1714618172521,EDS 128A,A01,507264,Fargason; Sharon Gayle,8,0,26,18
1714618173547,EDS 128B,A01,507293,Pappas; Elizabeth,12,0,30,18
1714618174572,EDS 139,A00,507294,Fargason; Sharon Gayle,13,0,30,17
1714618174572,EDS 139,B00,507313,Pappas; Elizabeth,13,0,30,17
1714618175597,EDS 201,A00,507315,Staff,13,0,30,17
1714618176628,EDS 203,A01,507317,Halter; Christopher P.,12,0,30,18
1714618177657,EDS 204R,A01,507319,Halter; Christopher P.,0,3,30,30
1714618177657,EDS 204R,B01,507331,Heinzman; Erica M.,16,0,30,14
1714618178684,EDS 206R,A00,507332,Staff,0,4,30,30
1714618178684,EDS 206R,B00,507343,Staff,17,0,30,13
1714618179714,EDS 250,A00,507344,Hemans; Patricia Ann Benitez,22,0,40,18
1714618180741,EDS 281,A00,507345,Daly; Alan J.,18,0,18,0
1714618181765,EDS 284,A00,507350,Daly; Alan J.,16,0,16,0
1714618182793,EDS 286,A00,507359,Fine; Sarah,18,0,18,0
1714618183819,EDS 289C,A01,507361,Daly; Alan J.,18,0,18,0
1714618184848,EDS 290,A00,507366,Hofstetter; Carolyn,15,0,15,0
1714618185875,LIGM 5A,A00,507421,Fischer-Grunski; Eva K,18,0,20,2
1714618186903,LIGM 5B,A00,507423,Fischer-Grunski; Eva K,19,0,20,1
1714618187932,LIGM 5C,A00,507425,Fischer-Grunski; Eva K,19,0,20,1
1714618188963,LIIT 5AS,A00,507427,Carnelos; Chiara,20,0,20,0
1714618189993,LIIT 5BS,A00,507430,Carnelos; Chiara,20,0,20,0
1714618191019,LIIT 5CS,A00,507432,Carnelos; Chiara,20,0,20,0
1714618192045,LISP 5A,A00,507541,Munoz Sanchez; Alicia,11,0,20,9
1714618193071,LISP 5B,A00,507671,Munoz Sanchez; Alicia,8,0,20,12
1714618194100,LISP 5C,A00,507696,Munoz Sanchez; Alicia,9,0,20,11
1714618195126,MAE 197,001,528363,Boechler; Nicholas Sebastia,9998,0,9999,1
1714618196155,MATH 197,001,523477,Kedlaya; Kiran S.,9995,0,9999,4
1714618196155,MATH 197,002,563811,Zhang; Danna,9995,0,9999,4
1714618196155,MATH 197,003,628552,Dumitriu; Ioana,9998,0,9999,1
1714618197183,MCWP 40R,A00,518780,Staff,2,0,20,18
1714618197183,MCWP 40R,B00,518781,Staff,8,0,20,12
1714618197183,MCWP 40R,C00,518783,Staff,6,0,20,14
1714618198209,MCWP 50R,A00,518791,Staff,0,0,20,20
1714618198209,MCWP 50R,B00,518792,Staff,0,2,20,20
1714618198209,MCWP 50R,C00,518793,Staff,0,2,20,20
1714618198209,MCWP 50R,D00,518794,Staff,0,0,20,20
1714618198209,MCWP 50R,E00,518795,Staff,0,2,20,20
1714618198209,MCWP 50R,F00,518796,Staff,0,0,20,20
1714618198209,MCWP 50R,G00,518797,Staff,0,1,20,20
1714618199237,MMW 12R,A01,514034,Herbst; Matthew,0,0,16,16
1714618199237,MMW 12R,A02,514035,Herbst; Matthew,1,0,16,15
1714618200264,MMW 13R,A01,514037,Staff,0,4,16,16
1714618200264,MMW 13R,A02,514039,Staff,0,2,16,16
1714618200264,MMW 13R,A03,628519,Staff,0,2,16,16
1714618202330,SIO 295LS,A00,523233,Staff,10,0,30,20
1714618203354,SIO 295S,A00,523232,Staff,10,0,30,20
1714618204441,SIOC 290S,A01,637330,Merrifield; Mark A,23,0,30,7
1714618205467,SIOC 291S,A01,637333,Gabriel; Corey John,23,0,30,7
1714618206494,SOCI 117,A01,494376,Staff,0,4,5,5
1714618207518,WES 237B,A00,494380,Staff,9,0,20,11
1714618209596,AESE 279B,A00,494370,Wade; Jon P,0,0,33,33
1714618210620,AIP 197,001,627712,Vespa; Emanuel Ignacio,9998,0,9999,1
1714618211644,ANAR 135S,A00,494369,Braswell; Geoffrey E.,0,0,0,0
1714618212670,BENG 196,001,628496,Engler; Adam J.,9998,0,9999,1
1714618213695,CAT 124RS,A01,519847,Geibel; William,0,0,20,20
1714618214720,CAT 125RS,A01,515971,Geibel; William,0,0,20,20
1714618215746,CLRE 250,A00,511389,Morris; Sheldon,9993,0,9999,6
1714618216774,CLRE 251,A00,507176,Mehta; Ravindra L.,9993,0,9999,6
1714618216774,CLRE 251,B00,511410,Mehta; Ravindra L.,9998,0,9999,1
1714618217799,CLRE 252,A00,507189,Cuomo; Raphael Eduardo,9995,0,9999,4
1714618218828,CLRE 253,A00,507199,Vaida; Florin,9994,0,9999,5
1714618218828,CLRE 253,B00,507202,Vaida; Florin,9999,0,9999,0
1714618219856,CLRE 259,A00,507211,Patel; Hemal,9996,0,9999,3
1714618220885,CLRE 260,A00,507221,Cuomo; Raphael Eduardo,9999,0,9999,0
1714618221912,CLRE 297,001,507242,Cuomo; Raphael Eduardo,9999,0,9999,0
1714618222942,COGS 197,001,638244,Voytek; Bradley Thomas,9998,0,9999,1
1714618223967,CSE 191,A00,516875,Minnes Kemp; Mor Mia,9992,0,9999,7
1714618224992,CSE 197,001,637388,Minnes Kemp; Mor Mia,9998,0,9999,1
1714618226022,CSS 201S,A01,494383,Staff,35,0,35,0
1714618227049,CSS 202S,A01,494387,Staff,35,0,35,0
1714618228074,DSC 197,001,628532,Eldridge; Justin Matthew,9996,0,9999,3
1714618229101,EAP 100,A00,516065,Staff,9797,0,9999,202
1714618230130,ECE 45,A01,507414,Staff,33,0,60,27
1714618232184,ECE 111,A01,507420,Staff,15,0,50,35
1714618233211,ECE 197,001,548057,Sievenpiper; Daniel F.,9993,0,9999,6
1714618234238,EDS 115,A00,507243,Choi; Bailey Miyeon,10,0,28,18
1714618235263,EDS 117,A01,494379,Staff,1,5,30,29
1714618236292,EDS 125,A00,507246,Hopkins; Megan Beth,9,0,30,21
1714618237317,EDS 128A,A01,507264,Fargason; Sharon Gayle,8,0,26,18
1714618238342,EDS 128B,A01,507293,Pappas; Elizabeth,12,0,30,18
1714618239367,EDS 139,A00,507294,Fargason; Sharon Gayle,13,0,30,17
1714618239367,EDS 139,B00,507313,Pappas; Elizabeth,13,0,30,17
1714618240392,EDS 201,A00,507315,Staff,13,0,30,17
1714618241418,EDS 203,A01,507317,Halter; Christopher P.,12,0,30,18
1714618242442,EDS 204R,A01,507319,Halter; Christopher P.,0,3,30,30
1714618242442,EDS 204R,B01,507331,Heinzman; Erica M.,16,0,30,14
1714618243470,EDS 206R,A00,507332,Staff,0,4,30,30
1714618243470,EDS 206R,B00,507343,Staff,17,0,30,13
1714618244498,EDS 250,A00,507344,Hemans; Patricia Ann Benitez,22,0,40,18
1714618245525,EDS 281,A00,507345,Daly; Alan J.,18,0,18,0
1714618246552,EDS 284,A00,507350,Daly; Alan J.,16,0,16,0
1714618247577,EDS 286,A00,507359,Fine; Sarah,18,0,18,0
1714618248602,EDS 289C,A01,507361,Daly; Alan J.,18,0,18,0
1714618249628,EDS 290,A00,507366,Hofstetter; Carolyn,15,0,15,0
1714618250661,LIGM 5A,A00,507421,Fischer-Grunski; Eva K,18,0,20,2
1714618251692,LIGM 5B,A00,507423,Fischer-Grunski; Eva K,19,0,20,1
1714618252716,LIGM 5C,A00,507425,Fischer-Grunski; Eva K,19,0,20,1
1714618253741,LIIT 5AS,A00,507427,Carnelos; Chiara,20,0,20,0
1714618254766,LIIT 5BS,A00,507430,Carnelos; Chiara,20,0,20,0
1714618255792,LIIT 5CS,A00,507432,Carnelos; Chiara,20,0,20,0
1714618256819,LISP 5A,A00,507541,Munoz Sanchez; Alicia,11,0,20,9
1714618257848,LISP 5B,A00,507671,Munoz Sanchez; Alicia,8,0,20,12
1714618258879,LISP 5C,A00,507696,Munoz Sanchez; Alicia,9,0,20,11
1714618259904,MAE 197,001,528363,Boechler; Nicholas Sebastia,9998,0,9999,1
1714618260930,MATH 197,001,523477,Kedlaya; Kiran S.,9995,0,9999,4
1714618260930,MATH 197,002,563811,Zhang; Danna,9995,0,9999,4
1714618260930,MATH 197,003,628552,Dumitriu; Ioana,9998,0,9999,1
1714618261957,MCWP 40R,A00,518780,Staff,2,0,20,18
1714618261957,MCWP 40R,B00,518781,Staff,8,0,20,12
1714618261957,MCWP 40R,C00,518783,Staff,6,0,20,14
1714618262986,MCWP 50R,A00,518791,Staff,0,0,20,20
1714618262986,MCWP 50R,B00,518792,Staff,0,2,20,20
1714618262986,MCWP 50R,C00,518793,Staff,0,2,20,20
1714618262986,MCWP 50R,D00,518794,Staff,0,0,20,20
1714618262986,MCWP 50R,E00,518795,Staff,0,2,20,20
1714618262986,MCWP 50R,F00,518796,Staff,0,0,20,20
1714618262986,MCWP 50R,G00,518797,Staff,0,1,20,20
1714618264015,MMW 12R,A01,514034,Herbst; Matthew,0,0,16,16
1714618264015,MMW 12R,A02,514035,Herbst; Matthew,1,0,16,15
1714618265040,MMW 13R,A01,514037,Staff,0,4,16,16
1714618265040,MMW 13R,A02,514039,Staff,0,2,16,16
1714618265040,MMW 13R,A03,628519,Staff,0,2,16,16
1714618267091,SIO 295LS,A00,523233,Staff,10,0,30,20
1714618268116,SIO 295S,A00,523232,Staff,10,0,30,20
1714618269143,SIOC 290S,A01,637330,Merrifield; Mark A,23,0,30,7
1714618270183,SIOC 291S,A01,637333,Gabriel; Corey John,23,0,30,7
1714618271214,SOCI 117,A01,494376,Staff,0,4,5,5
1714618272242,WES 237B,A00,494380,Staff,9,0,20,11
1714618274321,AESE 279B,A00,494370,Wade; Jon P,0,0,33,33
1714618275347,AIP 197,001,627712,Vespa; Emanuel Ignacio,9998,0,9999,1
1714618276371,ANAR 135S,A00,494369,Braswell; Geoffrey E.,0,0,0,0
1714618277396,BENG 196,001,628496,Engler; Adam J.,9998,0,9999,1
1714618278420,CAT 124RS,A01,519847,Geibel; William,0,0,20,20
1714618279447,CAT 125RS,A01,515971,Geibel; William,0,0,20,20
1714618280472,CLRE 250,A00,511389,Morris; Sheldon,9993,0,9999,6
1714618281503,CLRE 251,A00,507176,Mehta; Ravindra L.,9993,0,9999,6
1714618281503,CLRE 251,B00,511410,Mehta; Ravindra L.,9998,0,9999,1
1714618282527,CLRE 252,A00,507189,Cuomo; Raphael Eduardo,9995,0,9999,4
1714618283555,CLRE 253,A00,507199,Vaida; Florin,9994,0,9999,5
1714618283555,CLRE 253,B00,507202,Vaida; Florin,9999,0,9999,0
1714618284583,CLRE 259,A00,507211,Patel; Hemal,9996,0,9999,3
1714618285611,CLRE 260,A00,507221,Cuomo; Raphael Eduardo,9999,0,9999,0
1714618286636,CLRE 297,001,507242,Cuomo; Raphael Eduardo,9999,0,9999,0
1714618287661,COGS 197,001,638244,Voytek; Bradley Thomas,9998,0,9999,1
1714618288686,CSE 191,A00,516875,Minnes Kemp; Mor Mia,9992,0,9999,7
1714618289711,CSE 197,001,637388,Minnes Kemp; Mor Mia,9998,0,9999,1
1714618290741,CSS 201S,A01,494383,Staff,35,0,35,0
1714618291769,CSS 202S,A01,494387,Staff,35,0,35,0
1714618292795,DSC 197,001,628532,Eldridge; Justin Matthew,9996,0,9999,3
1714618293820,EAP 100,A00,516065,Staff,9797,0,9999,202
1714618294844,ECE 45,A01,507414,Staff,33,0,60,27
1714618296898,ECE 111,A01,507420,Staff,15,0,50,35
1714618297924,ECE 197,001,548057,Sievenpiper; Daniel F.,9993,0,9999,6
1714618298951,EDS 115,A00,507243,Choi; Bailey Miyeon,10,0,28,18
1714618299976,EDS 117,A01,494379,Staff,1,5,30,29
1714618301002,EDS 125,A00,507246,Hopkins; Megan Beth,9,0,30,21
1714618302034,EDS 128A,A01,507264,Fargason; Sharon Gayle,8,0,26,18
1714618303060,EDS 128B,A01,507293,Pappas; Elizabeth,12,0,30,18
1714618304087,EDS 139,A00,507294,Fargason; Sharon Gayle,13,0,30,17
1714618304087,EDS 139,B00,507313,Pappas; Elizabeth,13,0,30,17
1714618305111,EDS 201,A00,507315,Staff,13,0,30,17
1714618306140,EDS 203,A01,507317,Halter; Christopher P.,12,0,30,18
1714618307166,EDS 204R,A01,507319,Halter; Christopher P.,0,3,30,30
1714618307166,EDS 204R,B01,507331,Heinzman; Erica M.,16,0,30,14
1714618308245,EDS 206R,A00,507332,Staff,0,4,30,30
1714618308245,EDS 206R,B00,507343,Staff,17,0,30,13
1714618309270,EDS 250,A00,507344,Hemans; Patricia Ann Benitez,22,0,40,18
1714618310295,EDS 281,A00,507345,Daly; Alan J.,18,0,18,0
1714618311322,EDS 284,A00,507350,Daly; Alan J.,16,0,16,0
1714618312347,EDS 286,A00,507359,Fine; Sarah,18,0,18,0
1714618313377,EDS 289C,A01,507361,Daly; Alan J.,18,0,18,0
1714618314402,EDS 290,A00,507366,Hofstetter; Carolyn,15,0,15,0
1714618315429,LIGM 5A,A00,507421,Fischer-Grunski; Eva K,18,0,20,2
1714618316454,LIGM 5B,A00,507423,Fischer-Grunski; Eva K,19,0,20,1
1714618317479,LIGM 5C,A00,507425,Fischer-Grunski; Eva K,19,0,20,1
1714618318505,LIIT 5AS,A00,507427,Carnelos; Chiara,20,0,20,0
1714618319531,LIIT 5BS,A00,507430,Carnelos; Chiara,20,0,20,0
1714618320555,LIIT 5CS,A00,507432,Carnelos; Chiara,20,0,20,0
1714618321585,LISP 5A,A00,507541,Munoz Sanchez; Alicia,11,0,20,9
1714618322614,LISP 5B,A00,507671,Munoz Sanchez; Alicia,8,0,20,12
1714618323639,LISP 5C,A00,507696,Munoz Sanchez; Alicia,9,0,20,11
1714618324667,MAE 197,001,528363,Boechler; Nicholas Sebastia,9998,0,9999,1
1714618325697,MATH 197,001,523477,Kedlaya; Kiran S.,9995,0,9999,4
1714618325697,MATH 197,002,563811,Zhang; Danna,9995,0,9999,4
1714618325697,MATH 197,003,628552,Dumitriu; Ioana,9998,0,9999,1
1714618326723,MCWP 40R,A00,518780,Staff,2,0,20,18
1714618326723,MCWP 40R,B00,518781,Staff,8,0,20,12
1714618326723,MCWP 40R,C00,518783,Staff,6,0,20,14
1714618327748,MCWP 50R,A00,518791,Staff,0,0,20,20
1714618327748,MCWP 50R,B00,518792,Staff,0,2,20,20
1714618327748,MCWP 50R,C00,518793,Staff,0,2,20,20
1714618327748,MCWP 50R,D00,518794,Staff,0,0,20,20
1714618327748,MCWP 50R,E00,518795,Staff,0,2,20,20
1714618327748,MCWP 50R,F00,518796,Staff,0,0,20,20
1714618327748,MCWP 50R,G00,518797,Staff,0,1,20,20
1714618328772,MMW 12R,A01,514034,Herbst; Matthew,0,0,16,16
1714618328772,MMW 12R,A02,514035,Herbst; Matthew,1,0,16,15
1714618329797,MMW 13R,A01,514037,Staff,0,4,16,16
1714618329797,MMW 13R,A02,514039,Staff,0,2,16,16
1714618329797,MMW 13R,A03,628519,Staff,0,2,16,16
1714618331852,SIO 295LS,A00,523233,Staff,10,0,30,20
1714618332877,SIO 295S,A00,523232,Staff,10,0,30,20
1714618333909,SIOC 290S,A01,637330,Merrifield; Mark A,23,0,30,7
1714618334938,SIOC 291S,A01,637333,Gabriel; Corey John,23,0,30,7
1714618335965,SOCI 117,A01,494376,Staff,0,4,5,5
1714618336988,WES 237B,A00,494380,Staff,9,0,20,11
1714618339061,AESE 279B,A00,494370,Wade; Jon P,0,0,33,33
1714618340089,AIP 197,001,627712,Vespa; Emanuel Ignacio,9998,0,9999,1
1714618341117,ANAR 135S,A00,494369,Braswell; Geoffrey E.,0,0,0,0
1714618342142,BENG 196,001,628496,Engler; Adam J.,9998,0,9999,1
1714618343172,CAT 124RS,A01,519847,Geibel; William,0,0,20,20
1714618344198,CAT 125RS,A01,515971,Geibel; William,0,0,20,20
1714618345224,CLRE 250,A00,511389,Morris; Sheldon,9993,0,9999,6
1714618346253,CLRE 251,A00,507176,Mehta; Ravindra L.,9993,0,9999,6
1714618346253,CLRE 251,B00,511410,Mehta; Ravindra L.,9998,0,9999,1
1714618347278,CLRE 252,A00,507189,Cuomo; Raphael Eduardo,9995,0,9999,4
1714618348303,CLRE 253,A00,507199,Vaida; Florin,9994,0,9999,5
1714618348303,CLRE 253,B00,507202,Vaida; Florin,9999,0,9999,0
1714618349328,CLRE 259,A00,507211,Patel; Hemal,9996,0,9999,3
1714618350353,CLRE 260,A00,507221,Cuomo; Raphael Eduardo,9999,0,9999,0
1714618351378,CLRE 297,001,507242,Cuomo; Raphael Eduardo,9999,0,9999,0
1714618352405,COGS 197,001,638244,Voytek; Bradley Thomas,9998,0,9999,1
1714618353430,CSE 191,A00,516875,Minnes Kemp; Mor Mia,9992,0,9999,7
1714618354453,CSE 197,001,637388,Minnes Kemp; Mor Mia,9998,0,9999,1
1714618355482,CSS 201S,A01,494383,Staff,35,0,35,0
1714618356509,CSS 202S,A01,494387,Staff,35,0,35,0
1714618357533,DSC 197,001,628532,Eldridge; Justin Matthew,9996,0,9999,3
1714618358560,EAP 100,A00,516065,Staff,9797,0,9999,202
1714618359587,ECE 45,A01,507414,Staff,33,0,60,27
1714618361641,ECE 111,A01,507420,Staff,15,0,50,35
1714618362667,ECE 197,001,548057,Sievenpiper; Daniel F.,9993,0,9999,6
1714618363692,EDS 115,A00,507243,Choi; Bailey Miyeon,10,0,28,18
1714618364717,EDS 117,A01,494379,Staff,1,5,30,29
1714618365745,EDS 125,A00,507246,Hopkins; Megan Beth,9,0,30,21
1714618366770,EDS 128A,A01,507264,Fargason; Sharon Gayle,8,0,26,18
1714618367799,EDS 128B,A01,507293,Pappas; Elizabeth,12,0,30,18
1714618368824,EDS 139,A00,507294,Fargason; Sharon Gayle,13,0,30,17
1714618368824,EDS 139,B00,507313,Pappas; Elizabeth,13,0,30,17
1714618369850,EDS 201,A00,507315,Staff,13,0,30,17
1714618370880,EDS 203,A01,507317,Halter; Christopher P.,12,0,30,18
1714618371911,EDS 204R,A01,507319,Halter; Christopher P.,0,3,30,30
1714618371911,EDS 204R,B01,507331,Heinzman; Erica M.,16,0,30,14
1714618372940,EDS 206R,A00,507332,Staff,0,4,30,30
1714618372940,EDS 206R,B00,507343,Staff,17,0,30,13
1714618373967,EDS 250,A00,507344,Hemans; Patricia Ann Benitez,22,0,40,18
1714618374992,EDS 281,A00,507345,Daly; Alan J.,18,0,18,0
1714618376018,EDS 284,A00,507350,Daly; Alan J.,16,0,16,0
1714618377044,EDS 286,A00,507359,Fine; Sarah,18,0,18,0
1714618378072,EDS 289C,A01,507361,Daly; Alan J.,18,0,18,0
1714618379098,EDS 290,A00,507366,Hofstetter; Carolyn,15,0,15,0
1714618380125,LIGM 5A,A00,507421,Fischer-Grunski; Eva K,18,0,20,2
1714618381155,LIGM 5B,A00,507423,Fischer-Grunski; Eva K,19,0,20,1
1714618382186,LIGM 5C,A00,507425,Fischer-Grunski; Eva K,19,0,20,1
1714618383212,LIIT 5AS,A00,507427,Carnelos; Chiara,20,0,20,0
1714618384238,LIIT 5BS,A00,507430,Carnelos; Chiara,20,0,20,0
1714618385263,LIIT 5CS,A00,507432,Carnelos; Chiara,20,0,20,0
1714618386288,LISP 5A,A00,507541,Munoz Sanchez; Alicia,11,0,20,9
1714618387313,LISP 5B,A00,507671,Munoz Sanchez; Alicia,8,0,20,12
1714618388344,LISP 5C,A00,507696,Munoz Sanchez; Alicia,9,0,20,11
1714618389372,MAE 197,001,528363,Boechler; Nicholas Sebastia,9998,0,9999,1
1714618390399,MATH 197,001,523477,Kedlaya; Kiran S.,9995,0,9999,4
1714618390399,MATH 197,002,563811,Zhang; Danna,9995,0,9999,4
1714618390399,MATH 197,003,628552,Dumitriu; Ioana,9998,0,9999,1
1714618391426,MCWP 40R,A00,518780,Staff,2,0,20,18
1714618391426,MCWP 40R,B00,518781,Staff,8,0,20,12
1714618391426,MCWP 40R,C00,518783,Staff,6,0,20,14
1714618392452,MCWP 50R,A00,518791,Staff,0,0,20,20
1714618392452,MCWP 50R,B00,518792,Staff,0,2,20,20
1714618392452,MCWP 50R,C00,518793,Staff,0,2,20,20
1714618392452,MCWP 50R,D00,518794,Staff,0,0,20,20
1714618392452,MCWP 50R,E00,518795,Staff,0,2,20,20
1714618392452,MCWP 50R,F00,518796,Staff,0,0,20,20
1714618392452,MCWP 50R,G00,518797,Staff,0,1,20,20
1714618393477,MMW 12R,A01,514034,Herbst; Matthew,0,0,16,16
1714618393477,MMW 12R,A02,514035,Herbst; Matthew,1,0,16,15
1714618394506,MMW 13R,A01,514037,Staff,0,4,16,16
1714618394506,MMW 13R,A02,514039,Staff,0,2,16,16
1714618394506,MMW 13R,A03,628519,Staff,0,2,16,16
1714618396554,SIO 295LS,A00,523233,Staff,10,0,30,20
1714618397581,SIO 295S,A00,523232,Staff,10,0,30,20
1714618398606,SIOC 290S,A01,637330,Merrifield; Mark A,23,0,30,7
1714618399631,SIOC 291S,A01,637333,Gabriel; Corey John,23,0,30,7
1714618400657,SOCI 117,A01,494376,Staff,0,4,5,5
1714618401685,WES 237B,A00,494380,Staff,9,0,20,11
1714618403751,AESE 279B,A00,494370,Wade; Jon P,0,0,33,33
1714618404777,AIP 197,001,627712,Vespa; Emanuel Ignacio,9998,0,9999,1
1714618405805,ANAR 135S,A00,494369,Braswell; Geoffrey E.,0,0,0,0
1714618406830,BENG 196,001,628496,Engler; Adam J.,9998,0,9999,1
1714618407857,CAT 124RS,A01,519847,Geibel; William,0,0,20,20
1714618408884,CAT 125RS,A01,515971,Geibel; William,0,0,20,20
1714618409910,CLRE 250,A00,511389,Morris; Sheldon,9993,0,9999,6
1714618410936,CLRE 251,A00,507176,Mehta; Ravindra L.,9993,0,9999,6
1714618410936,CLRE 251,B00,511410,Mehta; Ravindra L.,9998,0,9999,1
1714618412018,CLRE 252,A00,507189,Cuomo; Raphael Eduardo,9995,0,9999,4
1714618413046,CLRE 253,A00,507199,Vaida; Florin,9994,0,9999,5
1714618413046,CLRE 253,B00,507202,Vaida; Florin,9999,0,9999,0
1714618414076,CLRE 259,A00,507211,Patel; Hemal,9996,0,9999,3
1714618415103,CLRE 260,A00,507221,Cuomo; Raphael Eduardo,9999,0,9999,0
1714618416130,CLRE 297,001,507242,Cuomo; Raphael Eduardo,9999,0,9999,0
1714618417159,COGS 197,001,638244,Voytek; Bradley Thomas,9998,0,9999,1
1714618418187,CSE 191,A00,516875,Minnes Kemp; Mor Mia,9992,0,9999,7
1714618419212,CSE 197,001,637388,Minnes Kemp; Mor Mia,9998,0,9999,1
1714618420238,CSS 201S,A01,494383,Staff,35,0,35,0
1714618421267,CSS 202S,A01,494387,Staff,35,0,35,0
1714618422291,DSC 197,001,628532,Eldridge; Justin Matthew,9996,0,9999,3
1714618423347,EAP 100,A00,516065,Staff,9797,0,9999,202
1714618424374,ECE 45,A01,507414,Staff,33,0,60,27
1714618426426,ECE 111,A01,507420,Staff,15,0,50,35
1714618427452,ECE 197,001,548057,Sievenpiper; Daniel F.,9993,0,9999,6
1714618428478,EDS 115,A00,507243,Choi; Bailey Miyeon,10,0,28,18
1714618429506,EDS 117,A01,494379,Staff,1,5,30,29
1714618430532,EDS 125,A00,507246,Hopkins; Megan Beth,9,0,30,21
1714618431559,EDS 128A,A01,507264,Fargason; Sharon Gayle,8,0,26,18
1714618432586,EDS 128B,A01,507293,Pappas; Elizabeth,12,0,30,18
1714618433615,EDS 139,A00,507294,Fargason; Sharon Gayle,13,0,30,17
1714618433615,EDS 139,B00,507313,Pappas; Elizabeth,13,0,30,17
1714618434641,EDS 201,A00,507315,Staff,13,0,30,17
1714618435669,EDS 203,A01,507317,Halter; Christopher P.,12,0,30,18
1714618436694,EDS 204R,A01,507319,Halter; Christopher P.,0,3,30,30
1714618436694,EDS 204R,B01,507331,Heinzman; Erica M.,16,0,30,14
1714618437720,EDS 206R,A00,507332,Staff,0,4,30,30
1714618437720,EDS 206R,B00,507343,Staff,17,0,30,13
1714618438744,EDS 250,A00,507344,Hemans; Patricia Ann Benitez,22,0,40,18
1714618439770,EDS 281,A00,507345,Daly; Alan J.,18,0,18,0
1714618440798,EDS 284,A00,507350,Daly; Alan J.,16,0,16,0
1714618441823,EDS 286,A00,507359,Fine; Sarah,18,0,18,0
1714618442851,EDS 289C,A01,507361,Daly; Alan J.,18,0,18,0
1714618443876,EDS 290,A00,507366,Hofstetter; Carolyn,15,0,15,0
1714618444902,LIGM 5A,A00,507421,Fischer-Grunski; Eva K,18,0,20,2
1714618445928,LIGM 5B,A00,507423,Fischer-Grunski; Eva K,19,0,20,1
1714618446957,LIGM 5C,A00,507425,Fischer-Grunski; Eva K,19,0,20,1
1714618447983,LIIT 5AS,A00,507427,Carnelos; Chiara,20,0,20,0
1714618449006,LIIT 5BS,A00,507430,Carnelos; Chiara,20,0,20,0
1714618450032,LIIT 5CS,A00,507432,Carnelos; Chiara,20,0,20,0
1714618451060,LISP 5A,A00,507541,Munoz Sanchez; Alicia,11,0,20,9
1714618452086,LISP 5B,A00,507671,Munoz Sanchez; Alicia,8,0,20,12
1714618453113,LISP 5C,A00,507696,Munoz Sanchez; Alicia,9,0,20,11
1714618454138,MAE 197,001,528363,Boechler; Nicholas Sebastia,9998,0,9999,1
1714618455163,MATH 197,001,523477,Kedlaya; Kiran S.,9995,0,9999,4
1714618455163,MATH 197,002,563811,Zhang; Danna,9995,0,9999,4
1714618455163,MATH 197,003,628552,Dumitriu; Ioana,9998,0,9999,1
1714618456190,MCWP 40R,A00,518780,Staff,2,0,20,18
1714618456190,MCWP 40R,B00,518781,Staff,8,0,20,12
1714618456190,MCWP 40R,C00,518783,Staff,6,0,20,14
1714618457216,MCWP 50R,A00,518791,Staff,0,0,20,20
1714618457216,MCWP 50R,B00,518792,Staff,0,2,20,20
1714618457216,MCWP 50R,C00,518793,Staff,0,2,20,20
1714618457216,MCWP 50R,D00,518794,Staff,0,0,20,20
1714618457216,MCWP 50R,E00,518795,Staff,0,2,20,20
1714618457216,MCWP 50R,F00,518796,Staff,0,0,20,20
1714618457216,MCWP 50R,G00,518797,Staff,0,1,20,20
1714618458241,MMW 12R,A01,514034,Herbst; Matthew,0,0,16,16
1714618458241,MMW 12R,A02,514035,Herbst; Matthew,1,0,16,15
1714618459268,MMW 13R,A01,514037,Staff,0,4,16,16
1714618459268,MMW 13R,A02,514039,Staff,0,2,16,16
1714618459268,MMW 13R,A03,628519,Staff,0,2,16,16
1714618461321,SIO 295LS,A00,523233,Staff,10,0,30,20
1714618462349,SIO 295S,A00,523232,Staff,10,0,30,20
1714618463376,SIOC 290S,A01,637330,Merrifield; Mark A,23,0,30,7
1714618464402,SIOC 291S,A01,637333,Gabriel; Corey John,23,0,30,7
1714618465430,SOCI 117,A01,494376,Staff,0,4,5,5
1714618466457,WES 237B,A00,494380,Staff,9,0,20,11
1714618468523,AESE 279B,A00,494370,Wade; Jon P,0,0,33,33
1714618469546,AIP 197,001,627712,Vespa; Emanuel Ignacio,9998,0,9999,1
1714618470569,ANAR 135S,A00,494369,Braswell; Geoffrey E.,0,0,0,0
1714618471598,BENG 196,001,628496,Engler; Adam J.,9998,0,9999,1
1714618472624,CAT 124RS,A01,519847,Geibel; William,0,0,20,20
1714618473648,CAT 125RS,A01,515971,Geibel; William,0,0,20,20
1714618474680,CLRE 250,A00,511389,Morris; Sheldon,9993,0,9999,6
1714618475706,CLRE 251,A00,507176,Mehta; Ravindra L.,9993,0,9999,6
1714618475706,CLRE 251,B00,511410,Mehta; Ravindra L.,9998,0,9999,1
1714618476736,CLRE 252,A00,507189,Cuomo; Raphael Eduardo,9995,0,9999,4
1714618477763,CLRE 253,A00,507199,Vaida; Florin,9994,0,9999,5
1714618477763,CLRE 253,B00,507202,Vaida; Florin,9999,0,9999,0
1714618478792,CLRE 259,A00,507211,Patel; Hemal,9996,0,9999,3
1714618479821,CLRE 260,A00,507221,Cuomo; Raphael Eduardo,9999,0,9999,0
1714618480846,CLRE 297,001,507242,Cuomo; Raphael Eduardo,9999,0,9999,0
1714618481874,COGS 197,001,638244,Voytek; Bradley Thomas,9998,0,9999,1
1714618482901,CSE 191,A00,516875,Minnes Kemp; Mor Mia,9992,0,9999,7
1714618483926,CSE 197,001,637388,Minnes Kemp; Mor Mia,9998,0,9999,1
1714618484954,CSS 201S,A01,494383,Staff,35,0,35,0
1714618485978,CSS 202S,A01,494387,Staff,35,0,35,0
1714618487006,DSC 197,001,628532,Eldridge; Justin Matthew,9996,0,9999,3
1714618488030,EAP 100,A00,516065,Staff,9797,0,9999,202
1714618489057,ECE 45,A01,507414,Staff,33,0,60,27
1714618491108,ECE 111,A01,507420,Staff,15,0,50,35
1714618492138,ECE 197,001,548057,Sievenpiper; Daniel F.,9993,0,9999,6
1714618493163,EDS 115,A00,507243,Choi; Bailey Miyeon,10,0,28,18
1714618494189,EDS 117,A01,494379,Staff,1,5,30,29
1714618495218,EDS 125,A00,507246,Hopkins; Megan Beth,9,0,30,21
1714618496246,EDS 128A,A01,507264,Fargason; Sharon Gayle,8,0,26,18
1714618497270,EDS 128B,A01,507293,Pappas; Elizabeth,12,0,30,18
1714618498294,EDS 139,A00,507294,Fargason; Sharon Gayle,13,0,30,17
1714618498294,EDS 139,B00,507313,Pappas; Elizabeth,13,0,30,17
1714618499320,EDS 201,A00,507315,Staff,13,0,30,17
1714618500345,EDS 203,A01,507317,Halter; Christopher P.,12,0,30,18
1714618501370,EDS 204R,A01,507319,Halter; Christopher P.,0,3,30,30
1714618501370,EDS 204R,B01,507331,Heinzman; Erica M.,16,0,30,14
1714618502394,EDS 206R,A00,507332,Staff,0,4,30,30
1714618502394,EDS 206R,B00,507343,Staff,17,0,30,13
1714618503421,EDS 250,A00,507344,Hemans; Patricia Ann Benitez,22,0,40,18
1714618504445,EDS 281,A00,507345,Daly; Alan J.,18,0,18,0
1714618505473,EDS 284,A00,507350,Daly; Alan J.,16,0,16,0
1714618506502,EDS 286,A00,507359,Fine; Sarah,18,0,18,0
1714618507525,EDS 289C,A01,507361,Daly; Alan J.,18,0,18,0
1714618508550,EDS 290,A00,507366,Hofstetter; Carolyn,15,0,15,0
1714618509576,LIGM 5A,A00,507421,Fischer-Grunski; Eva K,18,0,20,2
1714618510604,LIGM 5B,A00,507423,Fischer-Grunski; Eva K,19,0,20,1
1714618511631,LIGM 5C,A00,507425,Fischer-Grunski; Eva K,19,0,20,1
1714618512655,LIIT 5AS,A00,507427,Carnelos; Chiara,20,0,20,0
1714618513679,LIIT 5BS,A00,507430,Carnelos; Chiara,20,0,20,0
1714618514705,LIIT 5CS,A00,507432,Carnelos; Chiara,20,0,20,0
1714618515786,LISP 5A,A00,507541,Munoz Sanchez; Alicia,11,0,20,9
1714618516815,LISP 5B,A00,507671,Munoz Sanchez; Alicia,8,0,20,12
1714618517841,LISP 5C,A00,507696,Munoz Sanchez; Alicia,9,0,20,11
1714618518866,MAE 197,001,528363,Boechler; Nicholas Sebastia,9998,0,9999,1
1714618519894,MATH 197,001,523477,Kedlaya; Kiran S.,9995,0,9999,4
1714618519894,MATH 197,002,563811,Zhang; Danna,9995,0,9999,4
1714618519894,MATH 197,003,628552,Dumitriu; Ioana,9998,0,9999,1
1714618520918,MCWP 40R,A00,518780,Staff,2,0,20,18
1714618520918,MCWP 40R,B00,518781,Staff,8,0,20,12
1714618520918,MCWP 40R,C00,518783,Staff,6,0,20,14
1714618521948,MCWP 50R,A00,518791,Staff,0,0,20,20
1714618521948,MCWP 50R,B00,518792,Staff,0,2,20,20
1714618521948,MCWP 50R,C00,518793,Staff,0,2,20,20
1714618521948,MCWP 50R,D00,518794,Staff,0,0,20,20
1714618521948,MCWP 50R,E00,518795,Staff,0,2,20,20
1714618521948,MCWP 50R,F00,518796,Staff,0,0,20,20
1714618521948,MCWP 50R,G00,518797,Staff,0,1,20,20
1714618522976,MMW 12R,A01,514034,Herbst; Matthew,0,0,16,16
1714618522976,MMW 12R,A02,514035,Herbst; Matthew,1,0,16,15
1714618524006,MMW 13R,A01,514037,Staff,0,4,16,16
1714618524006,MMW 13R,A02,514039,Staff,0,2,16,16
1714618524006,MMW 13R,A03,628519,Staff,0,2,16,16
1714618526064,SIO 295LS,A00,523233,Staff,10,0,30,20
1714618527090,SIO 295S,A00,523232,Staff,10,0,30,20
1714618528115,SIOC 290S,A01,637330,Merrifield; Mark A,23,0,30,7
1714618529142,SIOC 291S,A01,637333,Gabriel; Corey John,23,0,30,7
1714618530170,SOCI 117,A01,494376,Staff,0,4,5,5
1714618531198,WES 237B,A00,494380,Staff,9,0,20,11
1714618533263,AESE 279B,A00,494370,Wade; Jon P,0,0,33,33
1714618534287,AIP 197,001,627712,Vespa; Emanuel Ignacio,9998,0,9999,1
1714618535312,ANAR 135S,A00,494369,Braswell; Geoffrey E.,0,0,0,0
1714618536342,BENG 196,001,628496,Engler; Adam J.,9998,0,9999,1
1714618537371,CAT 124RS,A01,519847,Geibel; William,0,0,20,20
1714618538398,CAT 125RS,A01,515971,Geibel; William,0,0,20,20
1714618539426,CLRE 250,A00,511389,Morris; Sheldon,9993,0,9999,6
1714618540452,CLRE 251,A00,507176,Mehta; Ravindra L.,9993,0,9999,6
1714618540452,CLRE 251,B00,511410,Mehta; Ravindra L.,9998,0,9999,1
1714618541478,CLRE 252,A00,507189,Cuomo; Raphael Eduardo,9995,0,9999,4
1714618542507,CLRE 253,A00,507199,Vaida; Florin,9994,0,9999,5
1714618542507,CLRE 253,B00,507202,Vaida; Florin,9999,0,9999,0
1714618543534,CLRE 259,A00,507211,Patel; Hemal,9996,0,9999,3
1714618544559,CLRE 260,A00,507221,Cuomo; Raphael Eduardo,9999,0,9999,0
1714618545584,CLRE 297,001,507242,Cuomo; Raphael Eduardo,9999,0,9999,0
1714618546610,COGS 197,001,638244,Voytek; Bradley Thomas,9998,0,9999,1
1714618547639,CSE 191,A00,516875,Minnes Kemp; Mor Mia,9992,0,9999,7
1714618548665,CSE 197,001,637388,Minnes Kemp; Mor Mia,9998,0,9999,1
1714618549691,CSS 201S,A01,494383,Staff,35,0,35,0
1714618550716,CSS 202S,A01,494387,Staff,35,0,35,0
1714618551741,DSC 197,001,628532,Eldridge; Justin Matthew,9996,0,9999,3
1714618552768,EAP 100,A00,516065,Staff,9797,0,9999,202
1714618553794,ECE 45,A01,507414,Staff,33,0,60,27
1714618555846,ECE 111,A01,507420,Staff,15,0,50,35
1714618556872,ECE 197,001,548057,Sievenpiper; Daniel F.,9993,0,9999,6
1714618557898,EDS 115,A00,507243,Choi; Bailey Miyeon,10,0,28,18
1714618558925,EDS 117,A01,494379,Staff,1,5,30,29
1714618559950,EDS 125,A00,507246,Hopkins; Megan Beth,9,0,30,21
1714618560979,EDS 128A,A01,507264,Fargason; Sharon Gayle,8,0,26,18
1714618562008,EDS 128B,A01,507293,Pappas; Elizabeth,12,0,30,18
1714618563034,EDS 139,A00,507294,Fargason; Sharon Gayle,13,0,30,17
1714618563034,EDS 139,B00,507313,Pappas; Elizabeth,13,0,30,17
1714618564060,EDS 201,A00,507315,Staff,13,0,30,17
1714618565088,EDS 203,A01,507317,Halter; Christopher P.,12,0,30,18
1714618566113,EDS 204R,A01,507319,Halter; Christopher P.,0,3,30,30
1714618566113,EDS 204R,B01,507331,Heinzman; Erica M.,16,0,30,14
1714618567141,EDS 206R,A00,507332,Staff,0,4,30,30
1714618567141,EDS 206R,B00,507343,Staff,17,0,30,13
1714618568170,EDS 250,A00,507344,Hemans; Patricia Ann Benitez,22,0,40,18
1714618569194,EDS 281,A00,507345,Daly; Alan J.,18,0,18,0
1714618570222,EDS 284,A00,507350,Daly; Alan J.,16,0,16,0
1714618571247,EDS 286,A00,507359,Fine; Sarah,18,0,18,0
1714618572272,EDS 289C,A01,507361,Daly; Alan J.,18,0,18,0
1714618573297,EDS 290,A00,507366,Hofstetter; Carolyn,15,0,15,0
1714618574326,LIGM 5A,A00,507421,Fischer-Grunski; Eva K,18,0,20,2
1714618575352,LIGM 5B,A00,507423,Fischer-Grunski; Eva K,19,0,20,1
1714618576378,LIGM 5C,A00,507425,Fischer-Grunski; Eva K,19,0,20,1
1714618577404,LIIT 5AS,A00,507427,Carnelos; Chiara,20,0,20,0
1714618578430,LIIT 5BS,A00,507430,Carnelos; Chiara,20,0,20,0
1714618579455,LIIT 5CS,A00,507432,Carnelos; Chiara,20,0,20,0
1714618580482,LISP 5A,A00,507541,Munoz Sanchez; Alicia,11,0,20,9
1714618581508,LISP 5B,A00,507671,Munoz Sanchez; Alicia,8,0,20,12
1714618582536,LISP 5C,A00,507696,Munoz Sanchez; Alicia,9,0,20,11
1714618583563,MAE 197,001,528363,Boechler; Nicholas Sebastia,9998,0,9999,1
1714618584590,MATH 197,001,523477,Kedlaya; Kiran S.,9995,0,9999,4
1714618584590,MATH 197,002,563811,Zhang; Danna,9995,0,9999,4
1714618584590,MATH 197,003,628552,Dumitriu; Ioana,9998,0,9999,1
1714618585615,MCWP 40R,A00,518780,Staff,2,0,20,18
1714618585615,MCWP 40R,B00,518781,Staff,8,0,20,12
1714618585615,MCWP 40R,C00,518783,Staff,6,0,20,14
1714618586641,MCWP 50R,A00,518791,Staff,0,0,20,20
1714618586641,MCWP 50R,B00,518792,Staff,0,2,20,20
1714618586641,MCWP 50R,C00,518793,Staff,0,2,20,20
1714618586641,MCWP 50R,D00,518794,Staff,0,0,20,20
1714618586641,MCWP 50R,E00,518795,Staff,0,2,20,20
1714618586641,MCWP 50R,F00,518796,Staff,0,0,20,20
1714618586641,MCWP 50R,G00,518797,Staff,0,1,20,20
1714618587671,MMW 12R,A01,514034,Herbst; Matthew,0,0,16,16
1714618587671,MMW 12R,A02,514035,Herbst; Matthew,1,0,16,15
1714618588698,MMW 13R,A01,514037,Staff,0,4,16,16
1714618588698,MMW 13R,A02,514039,Staff,0,2,16,16
1714618588698,MMW 13R,A03,628519,Staff,0,2,16,16
1714618590750,SIO 295LS,A00,523233,Staff,10,0,30,20
1714618591775,SIO 295S,A00,523232,Staff,10,0,30,20
1714618592802,SIOC 290S,A01,637330,Merrifield; Mark A,23,0,30,7
1714618593829,SIOC 291S,A01,637333,Gabriel; Corey John,23,0,30,7
1714618594855,SOCI 117,A01,494376,Staff,0,4,5,5
1714618595880,WES 237B,A00,494380,Staff,9,0,20,11
1714618597960,AESE 279B,A00,494370,Wade; Jon P,0,0,33,33
1714618598986,AIP 197,001,627712,Vespa; Emanuel Ignacio,9998,0,9999,1
1714618600014,ANAR 135S,A00,494369,Braswell; Geoffrey E.,0,0,0,0
1714618601039,BENG 196,001,628496,Engler; Adam J.,9998,0,9999,1
1714618602069,CAT 124RS,A01,519847,Geibel; William,0,0,20,20
1714618603094,CAT 125RS,A01,515971,Geibel; William,0,0,20,20
1714618604118,CLRE 250,A00,511389,Morris; Sheldon,9993,0,9999,6
1714618605149,CLRE 251,A00,507176,Mehta; Ravindra L.,9993,0,9999,6
1714618605149,CLRE 251,B00,511410,Mehta; Ravindra L.,9998,0,9999,1
1714618606174,CLRE 252,A00,507189,Cuomo; Raphael Eduardo,9995,0,9999,4
1714618607199,CLRE 253,A00,507199,Vaida; Florin,9994,0,9999,5
1714618607199,CLRE 253,B00,507202,Vaida; Florin,9999,0,9999,0
1714618608226,CLRE 259,A00,507211,Patel; Hemal,9996,0,9999,3
1714618609251,CLRE 260,A00,507221,Cuomo; Raphael Eduardo,9999,0,9999,0
1714618610279,CLRE 297,001,507242,Cuomo; Raphael Eduardo,9999,0,9999,0
1714618611304,COGS 197,001,638244,Voytek; Bradley Thomas,9998,0,9999,1
1714618612329,CSE 191,A00,516875,Minnes Kemp; Mor Mia,9992,0,9999,7
1714618613356,CSE 197,001,637388,Minnes Kemp; Mor Mia,9998,0,9999,1
1714618614382,CSS 201S,A01,494383,Staff,35,0,35,0
1714618615410,CSS 202S,A01,494387,Staff,35,0,35,0
1714618616438,DSC 197,001,628532,Eldridge; Justin Matthew,9996,0,9999,3
1714618617465,EAP 100,A00,516065,Staff,9797,0,9999,202
1714618618492,ECE 45,A01,507414,Staff,33,0,60,27
1714618620604,ECE 111,A01,507420,Staff,15,0,50,35
1714618621629,ECE 197,001,548057,Sievenpiper; Daniel F.,9993,0,9999,6
1714618622655,EDS 115,A00,507243,Choi; Bailey Miyeon,10,0,28,18
1714618623767,EDS 117,A01,494379,Staff,1,5,30,29
1714618624793,EDS 125,A00,507246,Hopkins; Megan Beth,9,0,30,21
1714618625823,EDS 128A,A01,507264,Fargason; Sharon Gayle,8,0,26,18
1714618626847,EDS 128B,A01,507293,Pappas; Elizabeth,12,0,30,18
1714618627872,EDS 139,A00,507294,Fargason; Sharon Gayle,13,0,30,17
1714618627872,EDS 139,B00,507313,Pappas; Elizabeth,13,0,30,17
1714618628902,EDS 201,A00,507315,Staff,13,0,30,17
1714618629930,EDS 203,A01,507317,Halter; Christopher P.,12,0,30,18
1714618630955,EDS 204R,A01,507319,Halter; Christopher P.,0,3,30,30
1714618630955,EDS 204R,B01,507331,Heinzman; Erica M.,16,0,30,14
1714618631981,EDS 206R,A00,507332,Staff,0,4,30,30
1714618631981,EDS 206R,B00,507343,Staff,17,0,30,13
1714618633007,EDS 250,A00,507344,Hemans; Patricia Ann Benitez,22,0,40,18
1714618634031,EDS 281,A00,507345,Daly; Alan J.,18,0,18,0
1714618635059,EDS 284,A00,507350,Daly; Alan J.,16,0,16,0
1714618636085,EDS 286,A00,507359,Fine; Sarah,18,0,18,0
1714618637111,EDS 289C,A01,507361,Daly; Alan J.,18,0,18,0
1714618638135,EDS 290,A00,507366,Hofstetter; Carolyn,15,0,15,0
1714618639164,LIGM 5A,A00,507421,Fischer-Grunski; Eva K,18,0,20,2
1714618640191,LIGM 5B,A00,507423,Fischer-Grunski; Eva K,19,0,20,1
1714618641218,LIGM 5C,A00,507425,Fischer-Grunski; Eva K,19,0,20,1
1714618642243,LIIT 5AS,A00,507427,Carnelos; Chiara,20,0,20,0
1714618643270,LIIT 5BS,A00,507430,Carnelos; Chiara,20,0,20,0
1714618644295,LIIT 5CS,A00,507432,Carnelos; Chiara,20,0,20,0
1714618645322,LISP 5A,A00,507541,Munoz Sanchez; Alicia,11,0,20,9
1714618646352,LISP 5B,A00,507671,Munoz Sanchez; Alicia,8,0,20,12
1714618647377,LISP 5C,A00,507696,Munoz Sanchez; Alicia,9,0,20,11
1714618648403,MAE 197,001,528363,Boechler; Nicholas Sebastia,9998,0,9999,1
1714618649433,MATH 197,001,523477,Kedlaya; Kiran S.,9995,0,9999,4
1714618649433,MATH 197,002,563811,Zhang; Danna,9995,0,9999,4
1714618649433,MATH 197,003,628552,Dumitriu; Ioana,9998,0,9999,1
1714618650458,MCWP 40R,A00,518780,Staff,2,0,20,18
1714618650458,MCWP 40R,B00,518781,Staff,8,0,20,12
1714618650458,MCWP 40R,C00,518783,Staff,6,0,20,14
1714618651485,MCWP 50R,A00,518791,Staff,0,0,20,20
1714618651485,MCWP 50R,B00,518792,Staff,0,2,20,20
1714618651485,MCWP 50R,C00,518793,Staff,0,2,20,20
1714618651485,MCWP 50R,D00,518794,Staff,0,0,20,20
1714618651485,MCWP 50R,E00,518795,Staff,0,2,20,20
1714618651485,MCWP 50R,F00,518796,Staff,0,0,20,20
1714618651485,MCWP 50R,G00,518797,Staff,0,1,20,20
1714618652512,MMW 12R,A01,514034,Herbst; Matthew,0,0,16,16
1714618652512,MMW 12R,A02,514035,Herbst; Matthew,1,0,16,15
1714618653537,MMW 13R,A01,514037,Staff,0,4,16,16
1714618653537,MMW 13R,A02,514039,Staff,0,2,16,16
1714618653537,MMW 13R,A03,628519,Staff,0,2,16,16
1714618655590,SIO 295LS,A00,523233,Staff,10,0,30,20
1714618656617,SIO 295S,A00,523232,Staff,10,0,30,20
1714618657642,SIOC 290S,A01,637330,Merrifield; Mark A,23,0,30,7
1714618658668,SIOC 291S,A01,637333,Gabriel; Corey John,23,0,30,7
1714618659697,SOCI 117,A01,494376,Staff,0,4,5,5
1714618660723,WES 237B,A00,494380,Staff,9,0,20,11
1714618662778,AESE 279B,A00,494370,Wade; Jon P,0,0,33,33
1714618663803,AIP 197,001,627712,Vespa; Emanuel Ignacio,9998,0,9999,1
1714618664832,ANAR 135S,A00,494369,Braswell; Geoffrey E.,0,0,0,0
1714618665858,BENG 196,001,628496,Engler; Adam J.,9998,0,9999,1
1714618666886,CAT 124RS,A01,519847,Geibel; William,0,0,20,20
1714618667911,CAT 125RS,A01,515971,Geibel; William,0,0,20,20
1714618668936,CLRE 250,A00,511389,Morris; Sheldon,9993,0,9999,6
1714618669966,CLRE 251,A00,507176,Mehta; Ravindra L.,9993,0,9999,6
1714618669966,CLRE 251,B00,511410,Mehta; Ravindra L.,9998,0,9999,1
1714618670990,CLRE 252,A00,507189,Cuomo; Raphael Eduardo,9995,0,9999,4
1714618672016,CLRE 253,A00,507199,Vaida; Florin,9994,0,9999,5
1714618672016,CLRE 253,B00,507202,Vaida; Florin,9999,0,9999,0
1714618673041,CLRE 259,A00,507211,Patel; Hemal,9996,0,9999,3
1714618674066,CLRE 260,A00,507221,Cuomo; Raphael Eduardo,9999,0,9999,0
1714618675092,CLRE 297,001,507242,Cuomo; Raphael Eduardo,9999,0,9999,0
1714618676119,COGS 197,001,638244,Voytek; Bradley Thomas,9998,0,9999,1
1714618677144,CSE 191,A00,516875,Minnes Kemp; Mor Mia,9992,0,9999,7
1714618678168,CSE 197,001,637388,Minnes Kemp; Mor Mia,9998,0,9999,1
1714618679194,CSS 201S,A01,494383,Staff,35,0,35,0
1714618680220,CSS 202S,A01,494387,Staff,35,0,35,0
1714618681245,DSC 197,001,628532,Eldridge; Justin Matthew,9996,0,9999,3
1714618682273,EAP 100,A00,516065,Staff,9797,0,9999,202
1714618683296,ECE 45,A01,507414,Staff,33,0,60,27
1714618685348,ECE 111,A01,507420,Staff,15,0,50,35
1714618686375,ECE 197,001,548057,Sievenpiper; Daniel F.,9993,0,9999,6
1714618687398,EDS 115,A00,507243,Choi; Bailey Miyeon,10,0,28,18
1714618688424,EDS 117,A01,494379,Staff,1,5,30,29
1714618689452,EDS 125,A00,507246,Hopkins; Megan Beth,9,0,30,21
1714618690482,EDS 128A,A01,507264,Fargason; Sharon Gayle,8,0,26,18
1714618691508,EDS 128B,A01,507293,Pappas; Elizabeth,12,0,30,18
1714618692532,EDS 139,A00,507294,Fargason; Sharon Gayle,13,0,30,17
1714618692532,EDS 139,B00,507313,Pappas; Elizabeth,13,0,30,17
1714618693559,EDS 201,A00,507315,Staff,13,0,30,17
1714618694585,EDS 203,A01,507317,Halter; Christopher P.,12,0,30,18
1714618695610,EDS 204R,A01,507319,Halter; Christopher P.,0,3,30,30
1714618695610,EDS 204R,B01,507331,Heinzman; Erica M.,16,0,30,14
1714618696635,EDS 206R,A00,507332,Staff,0,4,30,30
1714618696635,EDS 206R,B00,507343,Staff,17,0,30,13
1714618697664,EDS 250,A00,507344,Hemans; Patricia Ann Benitez,22,0,40,18
1714618698690,EDS 281,A00,507345,Daly; Alan J.,18,0,18,0
1714618699718,EDS 284,A00,507350,Daly; Alan J.,16,0,16,0
1714618700746,EDS 286,A00,507359,Fine; Sarah,18,0,18,0
1714618701771,EDS 289C,A01,507361,Daly; Alan J.,18,0,18,0
1714618702796,EDS 290,A00,507366,Hofstetter; Carolyn,15,0,15,0
1714618703825,LIGM 5A,A00,507421,Fischer-Grunski; Eva K,18,0,20,2
1714618704853,LIGM 5B,A00,507423,Fischer-Grunski; Eva K,19,0,20,1
1714618705881,LIGM 5C,A00,507425,Fischer-Grunski; Eva K,19,0,20,1
1714618706905,LIIT 5AS,A00,507427,Carnelos; Chiara,20,0,20,0
1714618707935,LIIT 5BS,A00,507430,Carnelos; Chiara,20,0,20,0
1714618708958,LIIT 5CS,A00,507432,Carnelos; Chiara,20,0,20,0
1714618709983,LISP 5A,A00,507541,Munoz Sanchez; Alicia,11,0,20,9
1714618711011,LISP 5B,A00,507671,Munoz Sanchez; Alicia,8,0,20,12
1714618712039,LISP 5C,A00,507696,Munoz Sanchez; Alicia,9,0,20,11
1714618713067,MAE 197,001,528363,Boechler; Nicholas Sebastia,9998,0,9999,1
1714618714094,MATH 197,001,523477,Kedlaya; Kiran S.,9995,0,9999,4
1714618714094,MATH 197,002,563811,Zhang; Danna,9995,0,9999,4
1714618714094,MATH 197,003,628552,Dumitriu; Ioana,9998,0,9999,1
1714618715120,MCWP 40R,A00,518780,Staff,2,0,20,18
1714618715120,MCWP 40R,B00,518781,Staff,8,0,20,12
1714618715120,MCWP 40R,C00,518783,Staff,6,0,20,14
1714618716146,MCWP 50R,A00,518791,Staff,0,0,20,20
1714618716146,MCWP 50R,B00,518792,Staff,0,2,20,20
1714618716146,MCWP 50R,C00,518793,Staff,0,2,20,20
1714618716146,MCWP 50R,D00,518794,Staff,0,0,20,20
1714618716146,MCWP 50R,E00,518795,Staff,0,2,20,20
1714618716146,MCWP 50R,F00,518796,Staff,0,0,20,20
1714618716146,MCWP 50R,G00,518797,Staff,0,1,20,20
1714618717174,MMW 12R,A01,514034,Herbst; Matthew,0,0,16,16
1714618717174,MMW 12R,A02,514035,Herbst; Matthew,1,0,16,15
1714618718199,MMW 13R,A01,514037,Staff,0,4,16,16
1714618718199,MMW 13R,A02,514039,Staff,0,2,16,16
1714618718199,MMW 13R,A03,628519,Staff,0,2,16,16
1714618720250,SIO 295LS,A00,523233,Staff,10,0,30,20
1714618721278,SIO 295S,A00,523232,Staff,10,0,30,20
1714618722308,SIOC 290S,A01,637330,Merrifield; Mark A,23,0,30,7
1714618723401,SIOC 291S,A01,637333,Gabriel; Corey John,23,0,30,7
1714618724427,SOCI 117,A01,494376,Staff,0,4,5,5
1714618725456,WES 237B,A00,494380,Staff,9,0,20,11
1714618727530,AESE 279B,A00,494370,Wade; Jon P,0,0,33,33
1714618728557,AIP 197,001,627712,Vespa; Emanuel Ignacio,9998,0,9999,1
1714618729582,ANAR 135S,A00,494369,Braswell; Geoffrey E.,0,0,0,0
1714618730609,BENG 196,001,628496,Engler; Adam J.,9998,0,9999,1
1714618731634,CAT 124RS,A01,519847,Geibel; William,0,0,20,20
1714618732660,CAT 125RS,A01,515971,Geibel; William,0,0,20,20
1714618733686,CLRE 250,A00,511389,Morris; Sheldon,9993,0,9999,6
1714618734712,CLRE 251,A00,507176,Mehta; Ravindra L.,9993,0,9999,6
1714618734712,CLRE 251,B00,511410,Mehta; Ravindra L.,9998,0,9999,1
1714618735740,CLRE 252,A00,507189,Cuomo; Raphael Eduardo,9995,0,9999,4
1714618736766,CLRE 253,A00,507199,Vaida; Florin,9994,0,9999,5
1714618736766,CLRE 253,B00,507202,Vaida; Florin,9999,0,9999,0
1714618737790,CLRE 259,A00,507211,Patel; Hemal,9996,0,9999,3
1714618738815,CLRE 260,A00,507221,Cuomo; Raphael Eduardo,9999,0,9999,0
1714618739841,CLRE 297,001,507242,Cuomo; Raphael Eduardo,9999,0,9999,0
1714618740865,COGS 197,001,638244,Voytek; Bradley Thomas,9998,0,9999,1
1714618741893,CSE 191,A00,516875,Minnes Kemp; Mor Mia,9992,0,9999,7
1714618742918,CSE 197,001,637388,Minnes Kemp; Mor Mia,9998,0,9999,1
1714618743944,CSS 201S,A01,494383,Staff,35,0,35,0
1714618744970,CSS 202S,A01,494387,Staff,35,0,35,0
1714618745996,DSC 197,001,628532,Eldridge; Justin Matthew,9996,0,9999,3
1714618747024,EAP 100,A00,516065,Staff,9797,0,9999,202
1714618748051,ECE 45,A01,507414,Staff,33,0,60,27
1714618750106,ECE 111,A01,507420,Staff,15,0,50,35
1714618751131,ECE 197,001,548057,Sievenpiper; Daniel F.,9993,0,9999,6
1714618752157,EDS 115,A00,507243,Choi; Bailey Miyeon,10,0,28,18
1714618753186,EDS 117,A01,494379,Staff,1,5,30,29
1714618754211,EDS 125,A00,507246,Hopkins; Megan Beth,9,0,30,21
1714618755238,EDS 128A,A01,507264,Fargason; Sharon Gayle,8,0,26,18
1714618756263,EDS 128B,A01,507293,Pappas; Elizabeth,12,0,30,18
1714618757290,EDS 139,A00,507294,Fargason; Sharon Gayle,13,0,30,17
1714618757290,EDS 139,B00,507313,Pappas; Elizabeth,13,0,30,17
1714618758335,EDS 201,A00,507315,Staff,13,0,30,17
1714618759363,EDS 203,A01,507317,Halter; Christopher P.,12,0,30,18
1714618760390,EDS 204R,A01,507319,Halter; Christopher P.,0,3,30,30
1714618760390,EDS 204R,B01,507331,Heinzman; Erica M.,16,0,30,14
1714618761414,EDS 206R,A00,507332,Staff,0,4,30,30
1714618761414,EDS 206R,B00,507343,Staff,17,0,30,13
1714618762437,EDS 250,A00,507344,Hemans; Patricia Ann Benitez,22,0,40,18
1714618763462,EDS 281,A00,507345,Daly; Alan J.,18,0,18,0
1714618764486,EDS 284,A00,507350,Daly; Alan J.,16,0,16,0
1714618765513,EDS 286,A00,507359,Fine; Sarah,18,0,18,0
1714618766537,EDS 289C,A01,507361,Daly; Alan J.,18,0,18,0
1714618767561,EDS 290,A00,507366,Hofstetter; Carolyn,15,0,15,0
1714618768585,LIGM 5A,A00,507421,Fischer-Grunski; Eva K,18,0,20,2
1714618769610,LIGM 5B,A00,507423,Fischer-Grunski; Eva K,19,0,20,1
1714618770636,LIGM 5C,A00,507425,Fischer-Grunski; Eva K,19,0,20,1
1714618771663,LIIT 5AS,A00,507427,Carnelos; Chiara,20,0,20,0
1714618772689,LIIT 5BS,A00,507430,Carnelos; Chiara,20,0,20,0
1714618773714,LIIT 5CS,A00,507432,Carnelos; Chiara,20,0,20,0
1714618774743,LISP 5A,A00,507541,Munoz Sanchez; Alicia,11,0,20,9
1714618775771,LISP 5B,A00,507671,Munoz Sanchez; Alicia,8,0,20,12
1714618776797,LISP 5C,A00,507696,Munoz Sanchez; Alicia,9,0,20,11
1714618777826,MAE 197,001,528363,Boechler; Nicholas Sebastia,9998,0,9999,1
1714618778854,MATH 197,001,523477,Kedlaya; Kiran S.,9995,0,9999,4
1714618778854,MATH 197,002,563811,Zhang; Danna,9995,0,9999,4
1714618778854,MATH 197,003,628552,Dumitriu; Ioana,9998,0,9999,1
1714618779879,MCWP 40R,A00,518780,Staff,2,0,20,18
1714618779879,MCWP 40R,B00,518781,Staff,8,0,20,12
1714618779879,MCWP 40R,C00,518783,Staff,6,0,20,14
1714618780906,MCWP 50R,A00,518791,Staff,0,0,20,20
1714618780906,MCWP 50R,B00,518792,Staff,0,2,20,20
1714618780906,MCWP 50R,C00,518793,Staff,0,2,20,20
1714618780906,MCWP 50R,D00,518794,Staff,0,0,20,20
1714618780906,MCWP 50R,E00,518795,Staff,0,2,20,20
1714618780906,MCWP 50R,F00,518796,Staff,0,0,20,20
1714618780906,MCWP 50R,G00,518797,Staff,0,1,20,20
1714618781933,MMW 12R,A01,514034,Herbst; Matthew,0,0,16,16
1714618781933,MMW 12R,A02,514035,Herbst; Matthew,1,0,16,15
1714618782960,MMW 13R,A01,514037,Staff,0,4,16,16
1714618782960,MMW 13R,A02,514039,Staff,0,2,16,16
1714618782960,MMW 13R,A03,628519,Staff,0,2,16,16
1714618785013,SIO 295LS,A00,523233,Staff,10,0,30,20
1714618786038,SIO 295S,A00,523232,Staff,10,0,30,20
1714618787067,SIOC 290S,A01,637330,Merrifield; Mark A,23,0,30,7
1714618788092,SIOC 291S,A01,637333,Gabriel; Corey John,23,0,30,7
1714618789120,SOCI 117,A01,494376,Staff,0,4,5,5
1714618790144,WES 237B,A00,494380,Staff,9,0,20,11
1714618792211,AESE 279B,A00,494370,Wade; Jon P,0,0,33,33
1714618793288,AIP 197,001,627712,Vespa; Emanuel Ignacio,9998,0,9999,1
1714618794315,ANAR 135S,A00,494369,Braswell; Geoffrey E.,0,0,0,0
1714618795339,BENG 196,001,628496,Engler; Adam J.,9998,0,9999,1
1714618796369,CAT 124RS,A01,519847,Geibel; William,0,0,20,20
1714618797394,CAT 125RS,A01,515971,Geibel; William,0,0,20,20
1714618798422,CLRE 250,A00,511389,Morris; Sheldon,9993,0,9999,6
1714618799447,CLRE 251,A00,507176,Mehta; Ravindra L.,9993,0,9999,6
1714618799447,CLRE 251,B00,511410,Mehta; Ravindra L.,9998,0,9999,1
1714618800476,CLRE 252,A00,507189,Cuomo; Raphael Eduardo,9995,0,9999,4
1714618801506,CLRE 253,A00,507199,Vaida; Florin,9994,0,9999,5
1714618801506,CLRE 253,B00,507202,Vaida; Florin,9999,0,9999,0
1714618802535,CLRE 259,A00,507211,Patel; Hemal,9996,0,9999,3
1714618803559,CLRE 260,A00,507221,Cuomo; Raphael Eduardo,9999,0,9999,0
1714618804587,CLRE 297,001,507242,Cuomo; Raphael Eduardo,9999,0,9999,0
1714618805610,COGS 197,001,638244,Voytek; Bradley Thomas,9998,0,9999,1
1714618806636,CSE 191,A00,516875,Minnes Kemp; Mor Mia,9992,0,9999,7
1714618807665,CSE 197,001,637388,Minnes Kemp; Mor Mia,9998,0,9999,1
1714618808695,CSS 201S,A01,494383,Staff,35,0,35,0
1714618809721,CSS 202S,A01,494387,Staff,35,0,35,0
1714618810745,DSC 197,001,628532,Eldridge; Justin Matthew,9996,0,9999,3
1714618811773,EAP 100,A00,516065,Staff,9797,0,9999,202
1714618812800,ECE 45,A01,507414,Staff,33,0,60,27
1714618814855,ECE 111,A01,507420,Staff,15,0,50,35
1714618815880,ECE 197,001,548057,Sievenpiper; Daniel F.,9993,0,9999,6
1714618816909,EDS 115,A00,507243,Choi; Bailey Miyeon,10,0,28,18
1714618817938,EDS 117,A01,494379,Staff,1,5,30,29
1714618818971,EDS 125,A00,507246,Hopkins; Megan Beth,9,0,30,21
1714618819998,EDS 128A,A01,507264,Fargason; Sharon Gayle,8,0,26,18
1714618821024,EDS 128B,A01,507293,Pappas; Elizabeth,12,0,30,18
1714618822049,EDS 139,A00,507294,Fargason; Sharon Gayle,13,0,30,17
1714618822049,EDS 139,B00,507313,Pappas; Elizabeth,13,0,30,17
1714618823074,EDS 201,A00,507315,Staff,13,0,30,17
1714618824100,EDS 203,A01,507317,Halter; Christopher P.,12,0,30,18
1714618825130,EDS 204R,A01,507319,Halter; Christopher P.,0,3,30,30
1714618825130,EDS 204R,B01,507331,Heinzman; Erica M.,16,0,30,14
1714618826157,EDS 206R,A00,507332,Staff,0,4,30,30
1714618826157,EDS 206R,B00,507343,Staff,17,0,30,13
1714618827182,EDS 250,A00,507344,Hemans; Patricia Ann Benitez,22,0,40,18
1714618828210,EDS 281,A00,507345,Daly; Alan J.,18,0,18,0
1714618829235,EDS 284,A00,507350,Daly; Alan J.,16,0,16,0
1714618830263,EDS 286,A00,507359,Fine; Sarah,18,0,18,0
1714618831290,EDS 289C,A01,507361,Daly; Alan J.,18,0,18,0
1714618832318,EDS 290,A00,507366,Hofstetter; Carolyn,15,0,15,0
1714618833351,LIGM 5A,A00,507421,Fischer-Grunski; Eva K,18,0,20,2
1714618834378,LIGM 5B,A00,507423,Fischer-Grunski; Eva K,19,0,20,1
1714618835402,LIGM 5C,A00,507425,Fischer-Grunski; Eva K,19,0,20,1
1714618836430,LIIT 5AS,A00,507427,Carnelos; Chiara,20,0,20,0
1714618837455,LIIT 5BS,A00,507430,Carnelos; Chiara,20,0,20,0
1714618838480,LIIT 5CS,A00,507432,Carnelos; Chiara,20,0,20,0
1714618839507,LISP 5A,A00,507541,Munoz Sanchez; Alicia,11,0,20,9
1714618840531,LISP 5B,A00,507671,Munoz Sanchez; Alicia,8,0,20,12
1714618841560,LISP 5C,A00,507696,Munoz Sanchez; Alicia,9,0,20,11
1714618842584,MAE 197,001,528363,Boechler; Nicholas Sebastia,9998,0,9999,1
1714618843642,MATH 197,001,523477,Kedlaya; Kiran S.,9995,0,9999,4
1714618843642,MATH 197,002,563811,Zhang; Danna,9995,0,9999,4
1714618843642,MATH 197,003,628552,Dumitriu; Ioana,9998,0,9999,1
1714618844669,MCWP 40R,A00,518780,Staff,2,0,20,18
1714618844669,MCWP 40R,B00,518781,Staff,8,0,20,12
1714618844669,MCWP 40R,C00,518783,Staff,6,0,20,14
1714618845695,MCWP 50R,A00,518791,Staff,0,0,20,20
1714618845695,MCWP 50R,B00,518792,Staff,0,2,20,20
1714618845695,MCWP 50R,C00,518793,Staff,0,2,20,20
1714618845695,MCWP 50R,D00,518794,Staff,0,0,20,20
1714618845695,MCWP 50R,E00,518795,Staff,0,2,20,20
1714618845695,MCWP 50R,F00,518796,Staff,0,0,20,20
1714618845695,MCWP 50R,G00,518797,Staff,0,1,20,20
1714618846726,MMW 12R,A01,514034,Herbst; Matthew,0,0,16,16
1714618846726,MMW 12R,A02,514035,Herbst; Matthew,1,0,16,15
1714618847754,MMW 13R,A01,514037,Staff,0,4,16,16
1714618847754,MMW 13R,A02,514039,Staff,0,2,16,16
1714618847754,MMW 13R,A03,628519,Staff,0,2,16,16
1714618849805,SIO 295LS,A00,523233,Staff,10,0,30,20
1714618850832,SIO 295S,A00,523232,Staff,10,0,30,20
1714618851861,SIOC 290S,A01,637330,Merrifield; Mark A,23,0,30,7
1714618852888,SIOC 291S,A01,637333,Gabriel; Corey John,23,0,30,7
1714618853914,SOCI 117,A01,494376,Staff,0,4,5,5
1714618854938,WES 237B,A00,494380,Staff,9,0,20,11
1714618857003,AESE 279B,A00,494370,Wade; Jon P,0,0,33,33
1714618858030,AIP 197,001,627712,Vespa; Emanuel Ignacio,9998,0,9999,1
1714618859056,ANAR 135S,A00,494369,Braswell; Geoffrey E.,0,0,0,0
1714618860088,BENG 196,001,628496,Engler; Adam J.,9998,0,9999,1
1714618861113,CAT 124RS,A01,519847,Geibel; William,0,0,20,20
1714618862195,CAT 125RS,A01,515971,Geibel; William,0,0,20,20
1714618863220,CLRE 250,A00,511389,Morris; Sheldon,9993,0,9999,6
1714618864256,CLRE 251,A00,507176,Mehta; Ravindra L.,9993,0,9999,6
1714618864256,CLRE 251,B00,511410,Mehta; Ravindra L.,9998,0,9999,1
1714618865282,CLRE 252,A00,507189,Cuomo; Raphael Eduardo,9995,0,9999,4
1714618866310,CLRE 253,A00,507199,Vaida; Florin,9994,0,9999,5
1714618866310,CLRE 253,B00,507202,Vaida; Florin,9999,0,9999,0
1714618867334,CLRE 259,A00,507211,Patel; Hemal,9996,0,9999,3
1714618868359,CLRE 260,A00,507221,Cuomo; Raphael Eduardo,9999,0,9999,0
1714618869388,CLRE 297,001,507242,Cuomo; Raphael Eduardo,9999,0,9999,0
1714618870413,COGS 197,001,638244,Voytek; Bradley Thomas,9998,0,9999,1
1714618871436,CSE 191,A00,516875,Minnes Kemp; Mor Mia,9992,0,9999,7
1714618872461,CSE 197,001,637388,Minnes Kemp; Mor Mia,9998,0,9999,1
1714618873487,CSS 201S,A01,494383,Staff,35,0,35,0
1714618874515,CSS 202S,A01,494387,Staff,35,0,35,0
1714618875538,DSC 197,001,628532,Eldridge; Justin Matthew,9996,0,9999,3
1714618876565,EAP 100,A00,516065,Staff,9797,0,9999,202
1714618877590,ECE 45,A01,507414,Staff,33,0,60,27
1714618879643,ECE 111,A01,507420,Staff,15,0,50,35
1714618880670,ECE 197,001,548057,Sievenpiper; Daniel F.,9993,0,9999,6
1714618881874,EDS 115,A00,507243,Choi; Bailey Miyeon,10,0,28,18
1714618882923,EDS 117,A01,494379,Staff,1,5,30,29
1714618883949,EDS 125,A00,507246,Hopkins; Megan Beth,9,0,30,21
1714618884978,EDS 128A,A01,507264,Fargason; Sharon Gayle,8,0,26,18
1714618886002,EDS 128B,A01,507293,Pappas; Elizabeth,12,0,30,18
1714618887028,EDS 139,A00,507294,Fargason; Sharon Gayle,13,0,30,17
1714618887028,EDS 139,B00,507313,Pappas; Elizabeth,13,0,30,17
1714618888054,EDS 201,A00,507315,Staff,13,0,30,17
1714618889085,EDS 203,A01,507317,Halter; Christopher P.,12,0,30,18
1714618890111,EDS 204R,A01,507319,Halter; Christopher P.,0,3,30,30
1714618890111,EDS 204R,B01,507331,Heinzman; Erica M.,16,0,30,14
1714618891136,EDS 206R,A00,507332,Staff,0,4,30,30
1714618891136,EDS 206R,B00,507343,Staff,17,0,30,13
1714618892166,EDS 250,A00,507344,Hemans; Patricia Ann Benitez,22,0,40,18
1714618893193,EDS 281,A00,507345,Daly; Alan J.,18,0,18,0
1714618894219,EDS 284,A00,507350,Daly; Alan J.,16,0,16,0
1714618895248,EDS 286,A00,507359,Fine; Sarah,18,0,18,0
1714618896276,EDS 289C,A01,507361,Daly; Alan J.,18,0,18,0
1714618897302,EDS 290,A00,507366,Hofstetter; Carolyn,15,0,15,0
1714618898327,LIGM 5A,A00,507421,Fischer-Grunski; Eva K,18,0,20,2
1714618899356,LIGM 5B,A00,507423,Fischer-Grunski; Eva K,19,0,20,1
1714618900385,LIGM 5C,A00,507425,Fischer-Grunski; Eva K,19,0,20,1
1714618901416,LIIT 5AS,A00,507427,Carnelos; Chiara,20,0,20,0
1714618902445,LIIT 5BS,A00,507430,Carnelos; Chiara,20,0,20,0
1714618903469,LIIT 5CS,A00,507432,Carnelos; Chiara,20,0,20,0
1714618904495,LISP 5A,A00,507541,Munoz Sanchez; Alicia,11,0,20,9
1714618905518,LISP 5B,A00,507671,Munoz Sanchez; Alicia,8,0,20,12
1714618906542,LISP 5C,A00,507696,Munoz Sanchez; Alicia,9,0,20,11
1714618907566,MAE 197,001,528363,Boechler; Nicholas Sebastia,9998,0,9999,1
1714618908592,MATH 197,001,523477,Kedlaya; Kiran S.,9995,0,9999,4
1714618908592,MATH 197,002,563811,Zhang; Danna,9995,0,9999,4
1714618908592,MATH 197,003,628552,Dumitriu; Ioana,9998,0,9999,1
1714618909622,MCWP 40R,A00,518780,Staff,2,0,20,18
1714618909622,MCWP 40R,B00,518781,Staff,8,0,20,12
1714618909622,MCWP 40R,C00,518783,Staff,6,0,20,14
1714618910649,MCWP 50R,A00,518791,Staff,0,0,20,20
1714618910649,MCWP 50R,B00,518792,Staff,0,2,20,20
1714618910649,MCWP 50R,C00,518793,Staff,0,2,20,20
1714618910649,MCWP 50R,D00,518794,Staff,0,0,20,20
1714618910649,MCWP 50R,E00,518795,Staff,0,2,20,20
1714618910649,MCWP 50R,F00,518796,Staff,0,0,20,20
1714618910649,MCWP 50R,G00,518797,Staff,0,1,20,20
1714618911677,MMW 12R,A01,514034,Herbst; Matthew,0,0,16,16
1714618911677,MMW 12R,A02,514035,Herbst; Matthew,1,0,16,15
1714618912707,MMW 13R,A01,514037,Staff,0,4,16,16
1714618912707,MMW 13R,A02,514039,Staff,0,2,16,16
1714618912707,MMW 13R,A03,628519,Staff,0,2,16,16
1714618914758,SIO 295LS,A00,523233,Staff,10,0,30,20
1714618915786,SIO 295S,A00,523232,Staff,10,0,30,20
1714618916814,SIOC 290S,A01,637330,Merrifield; Mark A,23,0,30,7
1714618917844,SIOC 291S,A01,637333,Gabriel; Corey John,23,0,30,7
1714618918869,SOCI 117,A01,494376,Staff,0,4,5,5
1714618919895,WES 237B,A00,494380,Staff,9,0,20,11
1714618921963,AESE 279B,A00,494370,Wade; Jon P,0,0,33,33
1714618922989,AIP 197,001,627712,Vespa; Emanuel Ignacio,9998,0,9999,1
1714618924014,ANAR 135S,A00,494369,Braswell; Geoffrey E.,0,0,0,0
1714618925043,BENG 196,001,628496,Engler; Adam J.,9998,0,9999,1
1714618926069,CAT 124RS,A01,519847,Geibel; William,0,0,20,20
1714618927096,CAT 125RS,A01,515971,Geibel; William,0,0,20,20
1714618928121,CLRE 250,A00,511389,Morris; Sheldon,9993,0,9999,6
1714618929155,CLRE 251,A00,507176,Mehta; Ravindra L.,9993,0,9999,6
1714618929155,CLRE 251,B00,511410,Mehta; Ravindra L.,9998,0,9999,1
1714618930179,CLRE 252,A00,507189,Cuomo; Raphael Eduardo,9995,0,9999,4
1714618931208,CLRE 253,A00,507199,Vaida; Florin,9994,0,9999,5
1714618931208,CLRE 253,B00,507202,Vaida; Florin,9999,0,9999,0
1714618932232,CLRE 259,A00,507211,Patel; Hemal,9996,0,9999,3
1714618933261,CLRE 260,A00,507221,Cuomo; Raphael Eduardo,9999,0,9999,0
1714618934290,CLRE 297,001,507242,Cuomo; Raphael Eduardo,9999,0,9999,0
1714618935314,COGS 197,001,638244,Voytek; Bradley Thomas,9998,0,9999,1
1714618936341,CSE 191,A00,516875,Minnes Kemp; Mor Mia,9992,0,9999,7
1714618937369,CSE 197,001,637388,Minnes Kemp; Mor Mia,9998,0,9999,1
1714618938395,CSS 201S,A01,494383,Staff,35,0,35,0
1714618939420,CSS 202S,A01,494387,Staff,35,0,35,0
1714618940448,DSC 197,001,628532,Eldridge; Justin Matthew,9996,0,9999,3
1714618941472,EAP 100,A00,516065,Staff,9797,0,9999,202
1714618942501,ECE 45,A01,507414,Staff,33,0,60,27
1714618944559,ECE 111,A01,507420,Staff,15,0,50,35
1714618945584,ECE 197,001,548057,Sievenpiper; Daniel F.,9993,0,9999,6
1714618946608,EDS 115,A00,507243,Choi; Bailey Miyeon,10,0,28,18
1714618947634,EDS 117,A01,494379,Staff,1,5,30,29
1714618948663,EDS 125,A00,507246,Hopkins; Megan Beth,9,0,30,21
1714618949690,EDS 128A,A01,507264,Fargason; Sharon Gayle,8,0,26,18
1714618950717,EDS 128B,A01,507293,Pappas; Elizabeth,12,0,30,18
1714618951745,EDS 139,A00,507294,Fargason; Sharon Gayle,13,0,30,17
1714618951745,EDS 139,B00,507313,Pappas; Elizabeth,13,0,30,17
1714618952774,EDS 201,A00,507315,Staff,13,0,30,17
1714618953799,EDS 203,A01,507317,Halter; Christopher P.,12,0,30,18
1714618954828,EDS 204R,A01,507319,Halter; Christopher P.,0,3,30,30
1714618954828,EDS 204R,B01,507331,Heinzman; Erica M.,16,0,30,14
1714618955852,EDS 206R,A00,507332,Staff,0,4,30,30
1714618955852,EDS 206R,B00,507343,Staff,17,0,30,13
1714618956877,EDS 250,A00,507344,Hemans; Patricia Ann Benitez,22,0,40,18
1714618957906,EDS 281,A00,507345,Daly; Alan J.,18,0,18,0
1714618958930,EDS 284,A00,507350,Daly; Alan J.,16,0,16,0
1714618959958,EDS 286,A00,507359,Fine; Sarah,18,0,18,0
1714618960986,EDS 289C,A01,507361,Daly; Alan J.,18,0,18,0
1714618962013,EDS 290,A00,507366,Hofstetter; Carolyn,15,0,15,0
1714618963040,LIGM 5A,A00,507421,Fischer-Grunski; Eva K,18,0,20,2
1714618964067,LIGM 5B,A00,507423,Fischer-Grunski; Eva K,19,0,20,1
1714618965093,LIGM 5C,A00,507425,Fischer-Grunski; Eva K,19,0,20,1
1714618966118,LIIT 5AS,A00,507427,Carnelos; Chiara,20,0,20,0
1714618967145,LIIT 5BS,A00,507430,Carnelos; Chiara,20,0,20,0
1714618968175,LIIT 5CS,A00,507432,Carnelos; Chiara,20,0,20,0
1714618969199,LISP 5A,A00,507541,Munoz Sanchez; Alicia,11,0,20,9
1714618970226,LISP 5B,A00,507671,Munoz Sanchez; Alicia,8,0,20,12
1714618971252,LISP 5C,A00,507696,Munoz Sanchez; Alicia,9,0,20,11
1714618972275,MAE 197,001,528363,Boechler; Nicholas Sebastia,9998,0,9999,1
1714618973300,MATH 197,001,523477,Kedlaya; Kiran S.,9995,0,9999,4
1714618973300,MATH 197,002,563811,Zhang; Danna,9995,0,9999,4
1714618973300,MATH 197,003,628552,Dumitriu; Ioana,9998,0,9999,1
1714618974326,MCWP 40R,A00,518780,Staff,2,0,20,18
1714618974326,MCWP 40R,B00,518781,Staff,8,0,20,12
1714618974326,MCWP 40R,C00,518783,Staff,6,0,20,14
1714618975352,MCWP 50R,A00,518791,Staff,0,0,20,20
1714618975352,MCWP 50R,B00,518792,Staff,0,2,20,20
1714618975352,MCWP 50R,C00,518793,Staff,0,2,20,20
1714618975352,MCWP 50R,D00,518794,Staff,0,0,20,20
1714618975352,MCWP 50R,E00,518795,Staff,0,2,20,20
1714618975352,MCWP 50R,F00,518796,Staff,0,0,20,20
1714618975352,MCWP 50R,G00,518797,Staff,0,1,20,20
1714618976377,MMW 12R,A01,514034,Herbst; Matthew,0,0,16,16
1714618976377,MMW 12R,A02,514035,Herbst; Matthew,1,0,16,15
1714618977404,MMW 13R,A01,514037,Staff,0,4,16,16
1714618977404,MMW 13R,A02,514039,Staff,0,2,16,16
1714618977404,MMW 13R,A03,628519,Staff,0,2,16,16
1714618979461,SIO 295LS,A00,523233,Staff,10,0,30,20
1714618980486,SIO 295S,A00,523232,Staff,10,0,30,20
1714618981516,SIOC 290S,A01,637330,Merrifield; Mark A,23,0,30,7
1714618982542,SIOC 291S,A01,637333,Gabriel; Corey John,23,0,30,7
1714618983567,SOCI 117,A01,494376,Staff,0,4,5,5
1714618984593,WES 237B,A00,494380,Staff,9,0,20,11
1714618986652,AESE 279B,A00,494370,Wade; Jon P,0,0,33,33
1714618987675,AIP 197,001,627712,Vespa; Emanuel Ignacio,9998,0,9999,1
1714618988699,ANAR 135S,A00,494369,Braswell; Geoffrey E.,0,0,0,0
1714618989726,BENG 196,001,628496,Engler; Adam J.,9998,0,9999,1
1714618990753,CAT 124RS,A01,519847,Geibel; William,0,0,20,20
1714618991779,CAT 125RS,A01,515971,Geibel; William,0,0,20,20
1714618992804,CLRE 250,A00,511389,Morris; Sheldon,9993,0,9999,6
1714618993832,CLRE 251,A00,507176,Mehta; Ravindra L.,9993,0,9999,6
1714618993832,CLRE 251,B00,511410,Mehta; Ravindra L.,9998,0,9999,1
1714618994859,CLRE 252,A00,507189,Cuomo; Raphael Eduardo,9995,0,9999,4
1714618995884,CLRE 253,A00,507199,Vaida; Florin,9994,0,9999,5
1714618995884,CLRE 253,B00,507202,Vaida; Florin,9999,0,9999,0
1714618996916,CLRE 259,A00,507211,Patel; Hemal,9996,0,9999,3
1714618997941,CLRE 260,A00,507221,Cuomo; Raphael Eduardo,9999,0,9999,0
1714618998968,CLRE 297,001,507242,Cuomo; Raphael Eduardo,9999,0,9999,0
1714618999995,COGS 197,001,638244,Voytek; Bradley Thomas,9998,0,9999,1
1714619001020,CSE 191,A00,516875,Minnes Kemp; Mor Mia,9992,0,9999,7
1714619002049,CSE 197,001,637388,Minnes Kemp; Mor Mia,9998,0,9999,1
1714619003076,CSS 201S,A01,494383,Staff,35,0,35,0
1714619004102,CSS 202S,A01,494387,Staff,35,0,35,0
1714619005127,DSC 197,001,628532,Eldridge; Justin Matthew,9996,0,9999,3
1714619006152,EAP 100,A00,516065,Staff,9797,0,9999,202
1714619007180,ECE 45,A01,507414,Staff,33,0,60,27
1714619009232,ECE 111,A01,507420,Staff,15,0,50,35
1714619010258,ECE 197,001,548057,Sievenpiper; Daniel F.,9993,0,9999,6
1714619011283,EDS 115,A00,507243,Choi; Bailey Miyeon,10,0,28,18
1714619012309,EDS 117,A01,494379,Staff,1,5,30,29
1714619013335,EDS 125,A00,507246,Hopkins; Megan Beth,9,0,30,21
1714619014360,EDS 128A,A01,507264,Fargason; Sharon Gayle,8,0,26,18
1714619015384,EDS 128B,A01,507293,Pappas; Elizabeth,12,0,30,18
1714619016410,EDS 139,A00,507294,Fargason; Sharon Gayle,13,0,30,17
1714619016410,EDS 139,B00,507313,Pappas; Elizabeth,13,0,30,17
1714619017434,EDS 201,A00,507315,Staff,13,0,30,17
1714619018459,EDS 203,A01,507317,Halter; Christopher P.,12,0,30,18
1714619019487,EDS 204R,A01,507319,Halter; Christopher P.,0,3,30,30
1714619019487,EDS 204R,B01,507331,Heinzman; Erica M.,16,0,30,14
1714619020514,EDS 206R,A00,507332,Staff,0,4,30,30
1714619020514,EDS 206R,B00,507343,Staff,17,0,30,13
1714619021540,EDS 250,A00,507344,Hemans; Patricia Ann Benitez,22,0,40,18
1714619022569,EDS 281,A00,507345,Daly; Alan J.,18,0,18,0
1714619023593,EDS 284,A00,507350,Daly; Alan J.,16,0,16,0
1714619024622,EDS 286,A00,507359,Fine; Sarah,18,0,18,0
1714619025649,EDS 289C,A01,507361,Daly; Alan J.,18,0,18,0
1714619026674,EDS 290,A00,507366,Hofstetter; Carolyn,15,0,15,0
1714619027702,LIGM 5A,A00,507421,Fischer-Grunski; Eva K,18,0,20,2
1714619028727,LIGM 5B,A00,507423,Fischer-Grunski; Eva K,19,0,20,1
1714619029755,LIGM 5C,A00,507425,Fischer-Grunski; Eva K,19,0,20,1
1714619030784,LIIT 5AS,A00,507427,Carnelos; Chiara,20,0,20,0
1714619031812,LIIT 5BS,A00,507430,Carnelos; Chiara,20,0,20,0
1714619032836,LIIT 5CS,A00,507432,Carnelos; Chiara,20,0,20,0
1714619033863,LISP 5A,A00,507541,Munoz Sanchez; Alicia,11,0,20,9
1714619034888,LISP 5B,A00,507671,Munoz Sanchez; Alicia,8,0,20,12
1714619035914,LISP 5C,A00,507696,Munoz Sanchez; Alicia,9,0,20,11
1714619036944,MAE 197,001,528363,Boechler; Nicholas Sebastia,9998,0,9999,1
1714619037978,MATH 197,001,523477,Kedlaya; Kiran S.,9995,0,9999,4
1714619037978,MATH 197,002,563811,Zhang; Danna,9995,0,9999,4
1714619037978,MATH 197,003,628552,Dumitriu; Ioana,9998,0,9999,1
1714619039006,MCWP 40R,A00,518780,Staff,2,0,20,18
1714619039006,MCWP 40R,B00,518781,Staff,8,0,20,12
1714619039006,MCWP 40R,C00,518783,Staff,6,0,20,14
1714619040033,MCWP 50R,A00,518791,Staff,0,0,20,20
1714619040033,MCWP 50R,B00,518792,Staff,0,2,20,20
1714619040033,MCWP 50R,C00,518793,Staff,0,2,20,20
1714619040033,MCWP 50R,D00,518794,Staff,0,0,20,20
1714619040033,MCWP 50R,E00,518795,Staff,0,2,20,20
1714619040033,MCWP 50R,F00,518796,Staff,0,0,20,20
1714619040033,MCWP 50R,G00,518797,Staff,0,1,20,20
1714619041060,MMW 12R,A01,514034,Herbst; Matthew,0,0,16,16
1714619041060,MMW 12R,A02,514035,Herbst; Matthew,1,0,16,15
1714619042085,MMW 13R,A01,514037,Staff,0,4,16,16
1714619042085,MMW 13R,A02,514039,Staff,0,2,16,16
1714619042085,MMW 13R,A03,628519,Staff,0,2,16,16
1714619044139,SIO 295LS,A00,523233,Staff,10,0,30,20
1714619045167,SIO 295S,A00,523232,Staff,10,0,30,20
1714619046195,SIOC 290S,A01,637330,Merrifield; Mark A,23,0,30,7
1714619047227,SIOC 291S,A01,637333,Gabriel; Corey John,23,0,30,7
1714619048257,SOCI 117,A01,494376,Staff,0,4,5,5
1714619049282,WES 237B,A00,494380,Staff,9,0,20,11
1714619051417,AESE 279B,A00,494370,Wade; Jon P,0,0,33,33
1714619052440,AIP 197,001,627712,Vespa; Emanuel Ignacio,9998,0,9999,1
1714619053469,ANAR 135S,A00,494369,Braswell; Geoffrey E.,0,0,0,0
1714619054499,BENG 196,001,628496,Engler; Adam J.,9998,0,9999,1
1714619055524,CAT 124RS,A01,519847,Geibel; William,0,0,20,20
1714619056550,CAT 125RS,A01,515971,Geibel; William,0,0,20,20
1714619057575,CLRE 250,A00,511389,Morris; Sheldon,9993,0,9999,6
1714619058604,CLRE 251,A00,507176,Mehta; Ravindra L.,9993,0,9999,6
1714619058604,CLRE 251,B00,511410,Mehta; Ravindra L.,9998,0,9999,1
1714619059631,CLRE 252,A00,507189,Cuomo; Raphael Eduardo,9995,0,9999,4
1714619060660,CLRE 253,A00,507199,Vaida; Florin,9994,0,9999,5
1714619060660,CLRE 253,B00,507202,Vaida; Florin,9999,0,9999,0
1714619061685,CLRE 259,A00,507211,Patel; Hemal,9996,0,9999,3
1714619062710,CLRE 260,A00,507221,Cuomo; Raphael Eduardo,9999,0,9999,0
1714619063737,CLRE 297,001,507242,Cuomo; Raphael Eduardo,9999,0,9999,0
1714619064766,COGS 197,001,638244,Voytek; Bradley Thomas,9998,0,9999,1
1714619065795,CSE 191,A00,516875,Minnes Kemp; Mor Mia,9992,0,9999,7
1714619066822,CSE 197,001,637388,Minnes Kemp; Mor Mia,9998,0,9999,1
1714619067852,CSS 201S,A01,494383,Staff,35,0,35,0
1714619068882,CSS 202S,A01,494387,Staff,35,0,35,0
1714619069907,DSC 197,001,628532,Eldridge; Justin Matthew,9996,0,9999,3
1714619070933,EAP 100,A00,516065,Staff,9797,0,9999,202
1714619071961,ECE 45,A01,507414,Staff,33,0,60,27
1714619074012,ECE 111,A01,507420,Staff,15,0,50,35
1714619075037,ECE 197,001,548057,Sievenpiper; Daniel F.,9993,0,9999,6
1714619076064,EDS 115,A00,507243,Choi; Bailey Miyeon,10,0,28,18
1714619077090,EDS 117,A01,494379,Staff,1,5,30,29
1714619078119,EDS 125,A00,507246,Hopkins; Megan Beth,9,0,30,21
1714619079149,EDS 128A,A01,507264,Fargason; Sharon Gayle,8,0,26,18
1714619080174,EDS 128B,A01,507293,Pappas; Elizabeth,12,0,30,18
1714619081199,EDS 139,A00,507294,Fargason; Sharon Gayle,13,0,30,17
1714619081199,EDS 139,B00,507313,Pappas; Elizabeth,13,0,30,17
1714619082224,EDS 201,A00,507315,Staff,13,0,30,17
1714619083253,EDS 203,A01,507317,Halter; Christopher P.,12,0,30,18
1714619084277,EDS 204R,A01,507319,Halter; Christopher P.,0,3,30,30
1714619084277,EDS 204R,B01,507331,Heinzman; Erica M.,16,0,30,14
1714619085300,EDS 206R,A00,507332,Staff,0,4,30,30
1714619085300,EDS 206R,B00,507343,Staff,17,0,30,13
1714619086329,EDS 250,A00,507344,Hemans; Patricia Ann Benitez,22,0,40,18
1714619087354,EDS 281,A00,507345,Daly; Alan J.,18,0,18,0
1714619088380,EDS 284,A00,507350,Daly; Alan J.,16,0,16,0
1714619089404,EDS 286,A00,507359,Fine; Sarah,18,0,18,0
1714619090428,EDS 289C,A01,507361,Daly; Alan J.,18,0,18,0
1714619091455,EDS 290,A00,507366,Hofstetter; Carolyn,15,0,15,0
1714619092485,LIGM 5A,A00,507421,Fischer-Grunski; Eva K,18,0,20,2
1714619093513,LIGM 5B,A00,507423,Fischer-Grunski; Eva K,19,0,20,1
1714619094539,LIGM 5C,A00,507425,Fischer-Grunski; Eva K,19,0,20,1
1714619095563,LIIT 5AS,A00,507427,Carnelos; Chiara,20,0,20,0
1714619096588,LIIT 5BS,A00,507430,Carnelos; Chiara,20,0,20,0
1714619097614,LIIT 5CS,A00,507432,Carnelos; Chiara,20,0,20,0
1714619098643,LISP 5A,A00,507541,Munoz Sanchez; Alicia,11,0,20,9
1714619099672,LISP 5B,A00,507671,Munoz Sanchez; Alicia,8,0,20,12
1714619100700,LISP 5C,A00,507696,Munoz Sanchez; Alicia,9,0,20,11
1714619101727,MAE 197,001,528363,Boechler; Nicholas Sebastia,9998,0,9999,1
1714619102761,MATH 197,001,523477,Kedlaya; Kiran S.,9995,0,9999,4
1714619102761,MATH 197,002,563811,Zhang; Danna,9995,0,9999,4
1714619102761,MATH 197,003,628552,Dumitriu; Ioana,9998,0,9999,1
1714619103810,MCWP 40R,A00,518780,Staff,2,0,20,18
1714619103810,MCWP 40R,B00,518781,Staff,8,0,20,12
1714619103810,MCWP 40R,C00,518783,Staff,6,0,20,14
1714619104837,MCWP 50R,A00,518791,Staff,0,0,20,20
1714619104837,MCWP 50R,B00,518792,Staff,0,2,20,20
1714619104837,MCWP 50R,C00,518793,Staff,0,2,20,20
1714619104837,MCWP 50R,D00,518794,Staff,0,0,20,20
1714619104837,MCWP 50R,E00,518795,Staff,0,2,20,20
1714619104837,MCWP 50R,F00,518796,Staff,0,0,20,20
1714619104837,MCWP 50R,G00,518797,Staff,0,1,20,20
1714619105862,MMW 12R,A01,514034,Herbst; Matthew,0,0,16,16
1714619105862,MMW 12R,A02,514035,Herbst; Matthew,1,0,16,15
1714619106887,MMW 13R,A01,514037,Staff,0,4,16,16
1714619106887,MMW 13R,A02,514039,Staff,0,2,16,16
1714619106887,MMW 13R,A03,628519,Staff,0,2,16,16
1714619108938,SIO 295LS,A00,523233,Staff,10,0,30,20
1714619109962,SIO 295S,A00,523232,Staff,10,0,30,20
1714619110988,SIOC 290S,A01,637330,Merrifield; Mark A,23,0,30,7
1714619112013,SIOC 291S,A01,637333,Gabriel; Corey John,23,0,30,7
1714619113042,SOCI 117,A01,494376,Staff,0,4,5,5
1714619114069,WES 237B,A00,494380,Staff,9,0,20,11
1714619116140,AESE 279B,A00,494370,Wade; Jon P,0,0,33,33
1714619117169,AIP 197,001,627712,Vespa; Emanuel Ignacio,9998,0,9999,1
1714619118195,ANAR 135S,A00,494369,Braswell; Geoffrey E.,0,0,0,0
1714619119223,BENG 196,001,628496,Engler; Adam J.,9998,0,9999,1
1714619120253,CAT 124RS,A01,519847,Geibel; William,0,0,20,20
1714619121281,CAT 125RS,A01,515971,Geibel; William,0,0,20,20
1714619122310,CLRE 250,A00,511389,Morris; Sheldon,9993,0,9999,6
1714619123341,CLRE 251,A00,507176,Mehta; Ravindra L.,9993,0,9999,6
1714619123341,CLRE 251,B00,511410,Mehta; Ravindra L.,9998,0,9999,1
1714619124370,CLRE 252,A00,507189,Cuomo; Raphael Eduardo,9995,0,9999,4
1714619125395,CLRE 253,A00,507199,Vaida; Florin,9994,0,9999,5
1714619125395,CLRE 253,B00,507202,Vaida; Florin,9999,0,9999,0
1714619126424,CLRE 259,A00,507211,Patel; Hemal,9996,0,9999,3
1714619127448,CLRE 260,A00,507221,Cuomo; Raphael Eduardo,9999,0,9999,0
1714619128473,CLRE 297,001,507242,Cuomo; Raphael Eduardo,9999,0,9999,0
1714619129498,COGS 197,001,638244,Voytek; Bradley Thomas,9998,0,9999,1
1714619130525,CSE 191,A00,516875,Minnes Kemp; Mor Mia,9992,0,9999,7
1714619131552,CSE 197,001,637388,Minnes Kemp; Mor Mia,9998,0,9999,1
1714619132578,CSS 201S,A01,494383,Staff,35,0,35,0
1714619133605,CSS 202S,A01,494387,Staff,35,0,35,0
1714619134633,DSC 197,001,628532,Eldridge; Justin Matthew,9996,0,9999,3
1714619135661,EAP 100,A00,516065,Staff,9797,0,9999,202
1714619136688,ECE 45,A01,507414,Staff,33,0,60,27
1714619138739,ECE 111,A01,507420,Staff,15,0,50,35
1714619139765,ECE 197,001,548057,Sievenpiper; Daniel F.,9993,0,9999,6
1714619140793,EDS 115,A00,507243,Choi; Bailey Miyeon,10,0,28,18
1714619141820,EDS 117,A01,494379,Staff,1,5,30,29
1714619142852,EDS 125,A00,507246,Hopkins; Megan Beth,9,0,30,21
1714619143878,EDS 128A,A01,507264,Fargason; Sharon Gayle,8,0,26,18
1714619144909,EDS 128B,A01,507293,Pappas; Elizabeth,12,0,30,18
1714619145933,EDS 139,A00,507294,Fargason; Sharon Gayle,13,0,30,17
1714619145933,EDS 139,B00,507313,Pappas; Elizabeth,13,0,30,17
1714619146958,EDS 201,A00,507315,Staff,13,0,30,17
1714619148021,EDS 203,A01,507317,Halter; Christopher P.,12,0,30,18
1714619149047,EDS 204R,A01,507319,Halter; Christopher P.,0,3,30,30
1714619149047,EDS 204R,B01,507331,Heinzman; Erica M.,16,0,30,14
1714619150074,EDS 206R,A00,507332,Staff,0,4,30,30
1714619150074,EDS 206R,B00,507343,Staff,17,0,30,13
1714619151104,EDS 250,A00,507344,Hemans; Patricia Ann Benitez,22,0,40,18
1714619152129,EDS 281,A00,507345,Daly; Alan J.,18,0,18,0
1714619153154,EDS 284,A00,507350,Daly; Alan J.,16,0,16,0
1714619154179,EDS 286,A00,507359,Fine; Sarah,18,0,18,0
1714619155206,EDS 289C,A01,507361,Daly; Alan J.,18,0,18,0
1714619156231,EDS 290,A00,507366,Hofstetter; Carolyn,15,0,15,0
1714619157733,LIGM 5A,A00,507421,Fischer-Grunski; Eva K,18,0,20,2
1714619158757,LIGM 5B,A00,507423,Fischer-Grunski; Eva K,19,0,20,1
1714619159784,LIGM 5C,A00,507425,Fischer-Grunski; Eva K,19,0,20,1
1714619160810,LIIT 5AS,A00,507427,Carnelos; Chiara,20,0,20,0
1714619161835,LIIT 5BS,A00,507430,Carnelos; Chiara,20,0,20,0
1714619162866,LIIT 5CS,A00,507432,Carnelos; Chiara,20,0,20,0
1714619163892,LISP 5A,A00,507541,Munoz Sanchez; Alicia,11,0,20,9
1714619164918,LISP 5B,A00,507671,Munoz Sanchez; Alicia,8,0,20,12
1714619165947,LISP 5C,A00,507696,Munoz Sanchez; Alicia,9,0,20,11
1714619166972,MAE 197,001,528363,Boechler; Nicholas Sebastia,9998,0,9999,1
1714619168004,MATH 197,001,523477,Kedlaya; Kiran S.,9995,0,9999,4
1714619168004,MATH 197,002,563811,Zhang; Danna,9995,0,9999,4
1714619168004,MATH 197,003,628552,Dumitriu; Ioana,9998,0,9999,1
1714619169030,MCWP 40R,A00,518780,Staff,2,0,20,18
1714619169030,MCWP 40R,B00,518781,Staff,8,0,20,12
1714619169030,MCWP 40R,C00,518783,Staff,6,0,20,14
1714619170057,MCWP 50R,A00,518791,Staff,0,0,20,20
1714619170057,MCWP 50R,B00,518792,Staff,0,2,20,20
1714619170057,MCWP 50R,C00,518793,Staff,0,2,20,20
1714619170057,MCWP 50R,D00,518794,Staff,0,0,20,20
1714619170057,MCWP 50R,E00,518795,Staff,0,2,20,20
1714619170057,MCWP 50R,F00,518796,Staff,0,0,20,20
1714619170057,MCWP 50R,G00,518797,Staff,0,1,20,20
1714619171082,MMW 12R,A01,514034,Herbst; Matthew,0,0,16,16
1714619171082,MMW 12R,A02,514035,Herbst; Matthew,1,0,16,15
1714619172110,MMW 13R,A01,514037,Staff,0,4,16,16
1714619172110,MMW 13R,A02,514039,Staff,0,2,16,16
1714619172110,MMW 13R,A03,628519,Staff,0,2,16,16
1714619174161,SIO 295LS,A00,523233,Staff,10,0,30,20
1714619175185,SIO 295S,A00,523232,Staff,10,0,30,20
1714619176211,SIOC 290S,A01,637330,Merrifield; Mark A,23,0,30,7
1714619177237,SIOC 291S,A01,637333,Gabriel; Corey John,23,0,30,7
1714619178268,SOCI 117,A01,494376,Staff,0,4,5,5
1714619179298,WES 237B,A00,494380,Staff,9,0,20,11
1714619181362,AESE 279B,A00,494370,Wade; Jon P,0,0,33,33
1714619182391,AIP 197,001,627712,Vespa; Emanuel Ignacio,9998,0,9999,1
1714619183416,ANAR 135S,A00,494369,Braswell; Geoffrey E.,0,0,0,0
1714619184441,BENG 196,001,628496,Engler; Adam J.,9998,0,9999,1
1714619185470,CAT 124RS,A01,519847,Geibel; William,0,0,20,20
1714619186494,CAT 125RS,A01,515971,Geibel; William,0,0,20,20
1714619187528,CLRE 250,A00,511389,Morris; Sheldon,9993,0,9999,6
1714619188562,CLRE 251,A00,507176,Mehta; Ravindra L.,9993,0,9999,6
1714619188562,CLRE 251,B00,511410,Mehta; Ravindra L.,9998,0,9999,1
1714619189589,CLRE 252,A00,507189,Cuomo; Raphael Eduardo,9995,0,9999,4
1714619190618,CLRE 253,A00,507199,Vaida; Florin,9994,0,9999,5
1714619190618,CLRE 253,B00,507202,Vaida; Florin,9999,0,9999,0
1714619191642,CLRE 259,A00,507211,Patel; Hemal,9996,0,9999,3
1714619192669,CLRE 260,A00,507221,Cuomo; Raphael Eduardo,9999,0,9999,0
1714619193696,CLRE 297,001,507242,Cuomo; Raphael Eduardo,9999,0,9999,0
1714619194721,COGS 197,001,638244,Voytek; Bradley Thomas,9998,0,9999,1
1714619195748,CSE 191,A00,516875,Minnes Kemp; Mor Mia,9992,0,9999,7
1714619196774,CSE 197,001,637388,Minnes Kemp; Mor Mia,9998,0,9999,1
1714619197800,CSS 201S,A01,494383,Staff,35,0,35,0
1714619198824,CSS 202S,A01,494387,Staff,35,0,35,0
1714619199852,DSC 197,001,628532,Eldridge; Justin Matthew,9996,0,9999,3
1714619200878,EAP 100,A00,516065,Staff,9797,0,9999,202
1714619201905,ECE 45,A01,507414,Staff,33,0,60,27
1714619203958,ECE 111,A01,507420,Staff,15,0,50,35
1714619204983,ECE 197,001,548057,Sievenpiper; Daniel F.,9993,0,9999,6
1714619206009,EDS 115,A00,507243,Choi; Bailey Miyeon,10,0,28,18
1714619207039,EDS 117,A01,494379,Staff,1,5,30,29
1714619208066,EDS 125,A00,507246,Hopkins; Megan Beth,9,0,30,21
1714619209092,EDS 128A,A01,507264,Fargason; Sharon Gayle,8,0,26,18
1714619210175,EDS 128B,A01,507293,Pappas; Elizabeth,12,0,30,18
1714619211199,EDS 139,A00,507294,Fargason; Sharon Gayle,13,0,30,17
1714619211199,EDS 139,B00,507313,Pappas; Elizabeth,13,0,30,17
1714619212228,EDS 201,A00,507315,Staff,13,0,30,17
1714619213255,EDS 203,A01,507317,Halter; Christopher P.,12,0,30,18
1714619214281,EDS 204R,A01,507319,Halter; Christopher P.,0,3,30,30
1714619214281,EDS 204R,B01,507331,Heinzman; Erica M.,16,0,30,14
1714619215308,EDS 206R,A00,507332,Staff,0,4,30,30
1714619215308,EDS 206R,B00,507343,Staff,17,0,30,13
1714619216337,EDS 250,A00,507344,Hemans; Patricia Ann Benitez,22,0,40,18
1714619217366,EDS 281,A00,507345,Daly; Alan J.,18,0,18,0
1714619218390,EDS 284,A00,507350,Daly; Alan J.,16,0,16,0
1714619219415,EDS 286,A00,507359,Fine; Sarah,18,0,18,0
1714619220442,EDS 289C,A01,507361,Daly; Alan J.,18,0,18,0
1714619221467,EDS 290,A00,507366,Hofstetter; Carolyn,15,0,15,0
1714619222497,LIGM 5A,A00,507421,Fischer-Grunski; Eva K,18,0,20,2
1714619223523,LIGM 5B,A00,507423,Fischer-Grunski; Eva K,19,0,20,1
1714619224548,LIGM 5C,A00,507425,Fischer-Grunski; Eva K,19,0,20,1
1714619225576,LIIT 5AS,A00,507427,Carnelos; Chiara,20,0,20,0
1714619226601,LIIT 5BS,A00,507430,Carnelos; Chiara,20,0,20,0
1714619227628,LIIT 5CS,A00,507432,Carnelos; Chiara,20,0,20,0
1714619228657,LISP 5A,A00,507541,Munoz Sanchez; Alicia,11,0,20,9
1714619229683,LISP 5B,A00,507671,Munoz Sanchez; Alicia,8,0,20,12
1714619230713,LISP 5C,A00,507696,Munoz Sanchez; Alicia,9,0,20,11
1714619231739,MAE 197,001,528363,Boechler; Nicholas Sebastia,9998,0,9999,1
1714619232769,MATH 197,001,523477,Kedlaya; Kiran S.,9995,0,9999,4
1714619232769,MATH 197,002,563811,Zhang; Danna,9995,0,9999,4
1714619232769,MATH 197,003,628552,Dumitriu; Ioana,9998,0,9999,1
1714619233795,MCWP 40R,A00,518780,Staff,2,0,20,18
1714619233795,MCWP 40R,B00,518781,Staff,8,0,20,12
1714619233795,MCWP 40R,C00,518783,Staff,6,0,20,14
1714619234825,MCWP 50R,A00,518791,Staff,0,0,20,20
1714619234825,MCWP 50R,B00,518792,Staff,0,2,20,20
1714619234825,MCWP 50R,C00,518793,Staff,0,2,20,20
1714619234825,MCWP 50R,D00,518794,Staff,0,0,20,20
1714619234825,MCWP 50R,E00,518795,Staff,0,2,20,20
1714619234825,MCWP 50R,F00,518796,Staff,0,0,20,20
1714619234825,MCWP 50R,G00,518797,Staff,0,1,20,20
1714619235853,MMW 12R,A01,514034,Herbst; Matthew,0,0,16,16
1714619235853,MMW 12R,A02,514035,Herbst; Matthew,1,0,16,15
1714619236879,MMW 13R,A01,514037,Staff,0,4,16,16
1714619236879,MMW 13R,A02,514039,Staff,0,2,16,16
1714619236879,MMW 13R,A03,628519,Staff,0,2,16,16
1714619238928,SIO 295LS,A00,523233,Staff,10,0,30,20
1714619239955,SIO 295S,A00,523232,Staff,10,0,30,20
1714619240980,SIOC 290S,A01,637330,Merrifield; Mark A,23,0,30,7
1714619242011,SIOC 291S,A01,637333,Gabriel; Corey John,23,0,30,7
1714619243036,SOCI 117,A01,494376,Staff,0,4,5,5
1714619244064,WES 237B,A00,494380,Staff,9,0,20,11
1714619246149,AESE 279B,A00,494370,Wade; Jon P,0,0,33,33
1714619247176,AIP 197,001,627712,Vespa; Emanuel Ignacio,9998,0,9999,1
1714619248202,ANAR 135S,A00,494369,Braswell; Geoffrey E.,0,0,0,0
1714619249228,BENG 196,001,628496,Engler; Adam J.,9998,0,9999,1
1714619250256,CAT 124RS,A01,519847,Geibel; William,0,0,20,20
1714619251283,CAT 125RS,A01,515971,Geibel; William,0,0,20,20
1714619252311,CLRE 250,A00,511389,Morris; Sheldon,9993,0,9999,6
1714619253345,CLRE 251,A00,507176,Mehta; Ravindra L.,9993,0,9999,6
1714619253345,CLRE 251,B00,511410,Mehta; Ravindra L.,9998,0,9999,1
1714619254374,CLRE 252,A00,507189,Cuomo; Raphael Eduardo,9995,0,9999,4
1714619255399,CLRE 253,A00,507199,Vaida; Florin,9994,0,9999,5
1714619255399,CLRE 253,B00,507202,Vaida; Florin,9999,0,9999,0
1714619256426,CLRE 259,A00,507211,Patel; Hemal,9996,0,9999,3
1714619257452,CLRE 260,A00,507221,Cuomo; Raphael Eduardo,9999,0,9999,0
1714619258534,CLRE 297,001,507242,Cuomo; Raphael Eduardo,9999,0,9999,0
1714619259559,COGS 197,001,638244,Voytek; Bradley Thomas,9998,0,9999,1
1714619260588,CSE 191,A00,516875,Minnes Kemp; Mor Mia,9992,0,9999,7
1714619261616,CSE 197,001,637388,Minnes Kemp; Mor Mia,9998,0,9999,1
1714619262640,CSS 201S,A01,494383,Staff,35,0,35,0
1714619263664,CSS 202S,A01,494387,Staff,35,0,35,0
1714619264692,DSC 197,001,628532,Eldridge; Justin Matthew,9996,0,9999,3
1714619265717,EAP 100,A00,516065,Staff,9797,0,9999,202
1714619266743,ECE 45,A01,507414,Staff,33,0,60,27
1714619268801,ECE 111,A01,507420,Staff,15,0,50,35
1714619269828,ECE 197,001,548057,Sievenpiper; Daniel F.,9993,0,9999,6
1714619270854,EDS 115,A00,507243,Choi; Bailey Miyeon,10,0,28,18
1714619271882,EDS 117,A01,494379,Staff,1,5,30,29
1714619272911,EDS 125,A00,507246,Hopkins; Megan Beth,9,0,30,21
1714619273942,EDS 128A,A01,507264,Fargason; Sharon Gayle,8,0,26,18
1714619274967,EDS 128B,A01,507293,Pappas; Elizabeth,12,0,30,18
1714619275992,EDS 139,A00,507294,Fargason; Sharon Gayle,13,0,30,17
1714619275992,EDS 139,B00,507313,Pappas; Elizabeth,13,0,30,17
1714619277017,EDS 201,A00,507315,Staff,13,0,30,17
1714619278044,EDS 203,A01,507317,Halter; Christopher P.,12,0,30,18
1714619279075,EDS 204R,A01,507319,Halter; Christopher P.,0,3,30,30
1714619279075,EDS 204R,B01,507331,Heinzman; Erica M.,16,0,30,14
1714619280098,EDS 206R,A00,507332,Staff,0,4,30,30
1714619280098,EDS 206R,B00,507343,Staff,17,0,30,13
1714619281125,EDS 250,A00,507344,Hemans; Patricia Ann Benitez,22,0,40,18
1714619282150,EDS 281,A00,507345,Daly; Alan J.,18,0,18,0
1714619283176,EDS 284,A00,507350,Daly; Alan J.,16,0,16,0
1714619284202,EDS 286,A00,507359,Fine; Sarah,18,0,18,0
1714619285226,EDS 289C,A01,507361,Daly; Alan J.,18,0,18,0
1714619286253,EDS 290,A00,507366,Hofstetter; Carolyn,15,0,15,0
1714619287278,LIGM 5A,A00,507421,Fischer-Grunski; Eva K,18,0,20,2
1714619288304,LIGM 5B,A00,507423,Fischer-Grunski; Eva K,19,0,20,1
1714619289330,LIGM 5C,A00,507425,Fischer-Grunski; Eva K,19,0,20,1
1714619290356,LIIT 5AS,A00,507427,Carnelos; Chiara,20,0,20,0
1714619291381,LIIT 5BS,A00,507430,Carnelos; Chiara,20,0,20,0
1714619292409,LIIT 5CS,A00,507432,Carnelos; Chiara,20,0,20,0
1714619293434,LISP 5A,A00,507541,Munoz Sanchez; Alicia,11,0,20,9
1714619294460,LISP 5B,A00,507671,Munoz Sanchez; Alicia,8,0,20,12
1714619295489,LISP 5C,A00,507696,Munoz Sanchez; Alicia,9,0,20,11
1714619296514,MAE 197,001,528363,Boechler; Nicholas Sebastia,9998,0,9999,1
1714619297545,MATH 197,001,523477,Kedlaya; Kiran S.,9995,0,9999,4
1714619297545,MATH 197,002,563811,Zhang; Danna,9995,0,9999,4
1714619297545,MATH 197,003,628552,Dumitriu; Ioana,9998,0,9999,1
1714619298570,MCWP 40R,A00,518780,Staff,2,0,20,18
1714619298570,MCWP 40R,B00,518781,Staff,8,0,20,12
1714619298570,MCWP 40R,C00,518783,Staff,6,0,20,14
1714619299595,MCWP 50R,A00,518791,Staff,0,0,20,20
1714619299595,MCWP 50R,B00,518792,Staff,0,2,20,20
1714619299595,MCWP 50R,C00,518793,Staff,0,2,20,20
1714619299595,MCWP 50R,D00,518794,Staff,0,0,20,20
1714619299595,MCWP 50R,E00,518795,Staff,0,2,20,20
1714619299595,MCWP 50R,F00,518796,Staff,0,0,20,20
1714619299595,MCWP 50R,G00,518797,Staff,0,1,20,20
1714619300624,MMW 12R,A01,514034,Herbst; Matthew,0,0,16,16
1714619300624,MMW 12R,A02,514035,Herbst; Matthew,1,0,16,15
1714619301651,MMW 13R,A01,514037,Staff,0,4,16,16
1714619301651,MMW 13R,A02,514039,Staff,0,2,16,16
1714619301651,MMW 13R,A03,628519,Staff,0,2,16,16
1714619303706,SIO 295LS,A00,523233,Staff,10,0,30,20
1714619304732,SIO 295S,A00,523232,Staff,10,0,30,20
1714619305763,SIOC 290S,A01,637330,Merrifield; Mark A,23,0,30,7
1714619306792,SIOC 291S,A01,637333,Gabriel; Corey John,23,0,30,7
1714619307817,SOCI 117,A01,494376,Staff,0,4,5,5
1714619308845,WES 237B,A00,494380,Staff,9,0,20,11
1714619310919,AESE 279B,A00,494370,Wade; Jon P,0,0,33,33
1714619311942,AIP 197,001,627712,Vespa; Emanuel Ignacio,9998,0,9999,1
1714619312976,ANAR 135S,A00,494369,Braswell; Geoffrey E.,0,0,0,0
1714619314001,BENG 196,001,628496,Engler; Adam J.,9998,0,9999,1
1714619315027,CAT 124RS,A01,519847,Geibel; William,0,0,20,20
1714619316053,CAT 125RS,A01,515971,Geibel; William,0,0,20,20
1714619317081,CLRE 250,A00,511389,Morris; Sheldon,9993,0,9999,6
1714619318106,CLRE 251,A00,507176,Mehta; Ravindra L.,9993,0,9999,6
1714619318106,CLRE 251,B00,511410,Mehta; Ravindra L.,9998,0,9999,1
1714619319129,CLRE 252,A00,507189,Cuomo; Raphael Eduardo,9995,0,9999,4
1714619320158,CLRE 253,A00,507199,Vaida; Florin,9994,0,9999,5
1714619320158,CLRE 253,B00,507202,Vaida; Florin,9999,0,9999,0
1714619321185,CLRE 259,A00,507211,Patel; Hemal,9996,0,9999,3
1714619322210,CLRE 260,A00,507221,Cuomo; Raphael Eduardo,9999,0,9999,0
1714619323283,CLRE 297,001,507242,Cuomo; Raphael Eduardo,9999,0,9999,0
1714619324310,COGS 197,001,638244,Voytek; Bradley Thomas,9998,0,9999,1
1714619325336,CSE 191,A00,516875,Minnes Kemp; Mor Mia,9992,0,9999,7
1714619326360,CSE 197,001,637388,Minnes Kemp; Mor Mia,9998,0,9999,1
1714619327391,CSS 201S,A01,494383,Staff,35,0,35,0
1714619328419,CSS 202S,A01,494387,Staff,35,0,35,0
1714619329443,DSC 197,001,628532,Eldridge; Justin Matthew,9996,0,9999,3
1714619330468,EAP 100,A00,516065,Staff,9797,0,9999,202
1714619331493,ECE 45,A01,507414,Staff,33,0,60,27
1714619333545,ECE 111,A01,507420,Staff,15,0,50,35
1714619334573,ECE 197,001,548057,Sievenpiper; Daniel F.,9993,0,9999,6
1714619335599,EDS 115,A00,507243,Choi; Bailey Miyeon,10,0,28,18
1714619336627,EDS 117,A01,494379,Staff,1,5,30,29
1714619337654,EDS 125,A00,507246,Hopkins; Megan Beth,9,0,30,21
1714619338682,EDS 128A,A01,507264,Fargason; Sharon Gayle,8,0,26,18
1714619339707,EDS 128B,A01,507293,Pappas; Elizabeth,12,0,30,18
1714619340730,EDS 139,A00,507294,Fargason; Sharon Gayle,13,0,30,17
1714619340730,EDS 139,B00,507313,Pappas; Elizabeth,13,0,30,17
1714619341758,EDS 201,A00,507315,Staff,13,0,30,17
1714619342788,EDS 203,A01,507317,Halter; Christopher P.,12,0,30,18
1714619343817,EDS 204R,A01,507319,Halter; Christopher P.,0,3,30,30
1714619343817,EDS 204R,B01,507331,Heinzman; Erica M.,16,0,30,14
1714619344845,EDS 206R,A00,507332,Staff,0,4,30,30
1714619344845,EDS 206R,B00,507343,Staff,17,0,30,13
1714619345874,EDS 250,A00,507344,Hemans; Patricia Ann Benitez,22,0,40,18
1714619346901,EDS 281,A00,507345,Daly; Alan J.,18,0,18,0
1714619347981,EDS 284,A00,507350,Daly; Alan J.,16,0,16,0
1714619349005,EDS 286,A00,507359,Fine; Sarah,18,0,18,0
1714619350030,EDS 289C,A01,507361,Daly; Alan J.,18,0,18,0
1714619351059,EDS 290,A00,507366,Hofstetter; Carolyn,15,0,15,0
1714619352084,LIGM 5A,A00,507421,Fischer-Grunski; Eva K,18,0,20,2
1714619353110,LIGM 5B,A00,507423,Fischer-Grunski; Eva K,19,0,20,1
1714619354135,LIGM 5C,A00,507425,Fischer-Grunski; Eva K,19,0,20,1
1714619355164,LIIT 5AS,A00,507427,Carnelos; Chiara,20,0,20,0
1714619356189,LIIT 5BS,A00,507430,Carnelos; Chiara,20,0,20,0
1714619357215,LIIT 5CS,A00,507432,Carnelos; Chiara,20,0,20,0
1714619358240,LISP 5A,A00,507541,Munoz Sanchez; Alicia,11,0,20,9
1714619359275,LISP 5B,A00,507671,Munoz Sanchez; Alicia,8,0,20,12
1714619360303,LISP 5C,A00,507696,Munoz Sanchez; Alicia,9,0,20,11
1714619361331,MAE 197,001,528363,Boechler; Nicholas Sebastia,9998,0,9999,1
1714619362359,MATH 197,001,523477,Kedlaya; Kiran S.,9995,0,9999,4
1714619362359,MATH 197,002,563811,Zhang; Danna,9995,0,9999,4
1714619362359,MATH 197,003,628552,Dumitriu; Ioana,9998,0,9999,1
1714619363386,MCWP 40R,A00,518780,Staff,2,0,20,18
1714619363386,MCWP 40R,B00,518781,Staff,8,0,20,12
1714619363386,MCWP 40R,C00,518783,Staff,6,0,20,14
1714619364414,MCWP 50R,A00,518791,Staff,0,0,20,20
1714619364414,MCWP 50R,B00,518792,Staff,0,2,20,20
1714619364414,MCWP 50R,C00,518793,Staff,0,2,20,20
1714619364414,MCWP 50R,D00,518794,Staff,0,0,20,20
1714619364414,MCWP 50R,E00,518795,Staff,0,2,20,20
1714619364414,MCWP 50R,F00,518796,Staff,0,0,20,20
1714619364414,MCWP 50R,G00,518797,Staff,0,1,20,20
1714619365438,MMW 12R,A01,514034,Herbst; Matthew,0,0,16,16
1714619365438,MMW 12R,A02,514035,Herbst; Matthew,1,0,16,15
1714619366464,MMW 13R,A01,514037,Staff,0,4,16,16
1714619366464,MMW 13R,A02,514039,Staff,0,2,16,16
1714619366464,MMW 13R,A03,628519,Staff,0,2,16,16
1714619368520,SIO 295LS,A00,523233,Staff,10,0,30,20
1714619369548,SIO 295S,A00,523232,Staff,10,0,30,20
1714619370571,SIOC 290S,A01,637330,Merrifield; Mark A,23,0,30,7
1714619371597,SIOC 291S,A01,637333,Gabriel; Corey John,23,0,30,7
1714619372627,SOCI 117,A01,494376,Staff,0,4,5,5
1714619373651,WES 237B,A00,494380,Staff,9,0,20,11
1714619375728,AESE 279B,A00,494370,Wade; Jon P,0,0,33,33
1714619376754,AIP 197,001,627712,Vespa; Emanuel Ignacio,9998,0,9999,1
1714619377778,ANAR 135S,A00,494369,Braswell; Geoffrey E.,0,0,0,0
1714619378803,BENG 196,001,628496,Engler; Adam J.,9998,0,9999,1
1714619379828,CAT 124RS,A01,519847,Geibel; William,0,0,20,20
1714619380852,CAT 125RS,A01,515971,Geibel; William,0,0,20,20
1714619381878,CLRE 250,A00,511389,Morris; Sheldon,9993,0,9999,6
1714619382904,CLRE 251,A00,507176,Mehta; Ravindra L.,9993,0,9999,6
1714619382904,CLRE 251,B00,511410,Mehta; Ravindra L.,9998,0,9999,1
1714619383931,CLRE 252,A00,507189,Cuomo; Raphael Eduardo,9995,0,9999,4
1714619384955,CLRE 253,A00,507199,Vaida; Florin,9994,0,9999,5
1714619384955,CLRE 253,B00,507202,Vaida; Florin,9999,0,9999,0
1714619385981,CLRE 259,A00,507211,Patel; Hemal,9996,0,9999,3
1714619387009,CLRE 260,A00,507221,Cuomo; Raphael Eduardo,9999,0,9999,0
1714619388035,CLRE 297,001,507242,Cuomo; Raphael Eduardo,9999,0,9999,0
1714619389060,COGS 197,001,638244,Voytek; Bradley Thomas,9998,0,9999,1
1714619390087,CSE 191,A00,516875,Minnes Kemp; Mor Mia,9992,0,9999,7
1714619391112,CSE 197,001,637388,Minnes Kemp; Mor Mia,9998,0,9999,1
1714619392139,CSS 201S,A01,494383,Staff,35,0,35,0
1714619393165,CSS 202S,A01,494387,Staff,35,0,35,0
1714619394189,DSC 197,001,628532,Eldridge; Justin Matthew,9996,0,9999,3
1714619395215,EAP 100,A00,516065,Staff,9797,0,9999,202
1714619396238,ECE 45,A01,507414,Staff,33,0,60,27
1714619398294,ECE 111,A01,507420,Staff,15,0,50,35
1714619399320,ECE 197,001,548057,Sievenpiper; Daniel F.,9993,0,9999,6
1714619400346,EDS 115,A00,507243,Choi; Bailey Miyeon,10,0,28,18
1714619401373,EDS 117,A01,494379,Staff,1,5,30,29
1714619402403,EDS 125,A00,507246,Hopkins; Megan Beth,9,0,30,21
1714619403428,EDS 128A,A01,507264,Fargason; Sharon Gayle,8,0,26,18
1714619404451,EDS 128B,A01,507293,Pappas; Elizabeth,12,0,30,18
1714619405477,EDS 139,A00,507294,Fargason; Sharon Gayle,13,0,30,17
1714619405477,EDS 139,B00,507313,Pappas; Elizabeth,13,0,30,17
1714619406506,EDS 201,A00,507315,Staff,13,0,30,17
1714619407529,EDS 203,A01,507317,Halter; Christopher P.,12,0,30,18
1714619408554,EDS 204R,A01,507319,Halter; Christopher P.,0,3,30,30
1714619408554,EDS 204R,B01,507331,Heinzman; Erica M.,16,0,30,14
1714619409582,EDS 206R,A00,507332,Staff,0,4,30,30
1714619409582,EDS 206R,B00,507343,Staff,17,0,30,13
1714619410604,EDS 250,A00,507344,Hemans; Patricia Ann Benitez,22,0,40,18
1714619411631,EDS 281,A00,507345,Daly; Alan J.,18,0,18,0
1714619412657,EDS 284,A00,507350,Daly; Alan J.,16,0,16,0
1714619413680,EDS 286,A00,507359,Fine; Sarah,18,0,18,0
1714619414707,EDS 289C,A01,507361,Daly; Alan J.,18,0,18,0
1714619415734,EDS 290,A00,507366,Hofstetter; Carolyn,15,0,15,0
1714619416759,LIGM 5A,A00,507421,Fischer-Grunski; Eva K,18,0,20,2
1714619417785,LIGM 5B,A00,507423,Fischer-Grunski; Eva K,19,0,20,1
1714619418813,LIGM 5C,A00,507425,Fischer-Grunski; Eva K,19,0,20,1
1714619419841,LIIT 5AS,A00,507427,Carnelos; Chiara,20,0,20,0
1714619420866,LIIT 5BS,A00,507430,Carnelos; Chiara,20,0,20,0
1714619421892,LIIT 5CS,A00,507432,Carnelos; Chiara,20,0,20,0
1714619422924,LISP 5A,A00,507541,Munoz Sanchez; Alicia,11,0,20,9
1714619423948,LISP 5B,A00,507671,Munoz Sanchez; Alicia,8,0,20,12
1714619424976,LISP 5C,A00,507696,Munoz Sanchez; Alicia,9,0,20,11
1714619426001,MAE 197,001,528363,Boechler; Nicholas Sebastia,9998,0,9999,1
1714619427026,MATH 197,001,523477,Kedlaya; Kiran S.,9995,0,9999,4
1714619427026,MATH 197,002,563811,Zhang; Danna,9995,0,9999,4
1714619427026,MATH 197,003,628552,Dumitriu; Ioana,9998,0,9999,1
1714619428054,MCWP 40R,A00,518780,Staff,2,0,20,18
1714619428054,MCWP 40R,B00,518781,Staff,8,0,20,12
1714619428054,MCWP 40R,C00,518783,Staff,6,0,20,14
1714619429080,MCWP 50R,A00,518791,Staff,0,0,20,20
1714619429080,MCWP 50R,B00,518792,Staff,0,2,20,20
1714619429080,MCWP 50R,C00,518793,Staff,0,2,20,20
1714619429080,MCWP 50R,D00,518794,Staff,0,0,20,20
1714619429080,MCWP 50R,E00,518795,Staff,0,2,20,20
1714619429080,MCWP 50R,F00,518796,Staff,0,0,20,20
1714619429080,MCWP 50R,G00,518797,Staff,0,1,20,20
1714619430108,MMW 12R,A01,514034,Herbst; Matthew,0,0,16,16
1714619430108,MMW 12R,A02,514035,Herbst; Matthew,1,0,16,15
1714619431133,MMW 13R,A01,514037,Staff,0,4,16,16
1714619431133,MMW 13R,A02,514039,Staff,0,2,16,16
1714619431133,MMW 13R,A03,628519,Staff,0,2,16,16
1714619433189,SIO 295LS,A00,523233,Staff,10,0,30,20
1714619434213,SIO 295S,A00,523232,Staff,10,0,30,20
1714619435240,SIOC 290S,A01,637330,Merrifield; Mark A,23,0,30,7
1714619436269,SIOC 291S,A01,637333,Gabriel; Corey John,23,0,30,7
1714619437297,SOCI 117,A01,494376,Staff,0,4,5,5
1714619438322,WES 237B,A00,494380,Staff,9,0,20,11
1714619440396,AESE 279B,A00,494370,Wade; Jon P,0,0,33,33
1714619441422,AIP 197,001,627712,Vespa; Emanuel Ignacio,9998,0,9999,1
1714619442446,ANAR 135S,A00,494369,Braswell; Geoffrey E.,0,0,0,0
1714619443476,BENG 196,001,628496,Engler; Adam J.,9998,0,9999,1
1714619444505,CAT 124RS,A01,519847,Geibel; William,0,0,20,20
1714619445530,CAT 125RS,A01,515971,Geibel; William,0,0,20,20
1714619446556,CLRE 250,A00,511389,Morris; Sheldon,9993,0,9999,6
1714619447583,CLRE 251,A00,507176,Mehta; Ravindra L.,9993,0,9999,6
1714619447583,CLRE 251,B00,511410,Mehta; Ravindra L.,9998,0,9999,1
1714619448608,CLRE 252,A00,507189,Cuomo; Raphael Eduardo,9995,0,9999,4
1714619449631,CLRE 253,A00,507199,Vaida; Florin,9994,0,9999,5
1714619449631,CLRE 253,B00,507202,Vaida; Florin,9999,0,9999,0
1714619450657,CLRE 259,A00,507211,Patel; Hemal,9996,0,9999,3
1714619451684,CLRE 260,A00,507221,Cuomo; Raphael Eduardo,9999,0,9999,0
1714619452709,CLRE 297,001,507242,Cuomo; Raphael Eduardo,9999,0,9999,0
1714619453734,COGS 197,001,638244,Voytek; Bradley Thomas,9998,0,9999,1
1714619454761,CSE 191,A00,516875,Minnes Kemp; Mor Mia,9992,0,9999,7
1714619455787,CSE 197,001,637388,Minnes Kemp; Mor Mia,9998,0,9999,1
1714619456813,CSS 201S,A01,494383,Staff,35,0,35,0
1714619457838,CSS 202S,A01,494387,Staff,35,0,35,0
1714619458863,DSC 197,001,628532,Eldridge; Justin Matthew,9996,0,9999,3
1714619459888,EAP 100,A00,516065,Staff,9797,0,9999,202
1714619460914,ECE 45,A01,507414,Staff,33,0,60,27
1714619462968,ECE 111,A01,507420,Staff,15,0,50,35
1714619464004,ECE 197,001,548057,Sievenpiper; Daniel F.,9993,0,9999,6
1714619465085,EDS 115,A00,507243,Choi; Bailey Miyeon,10,0,28,18
1714619466113,EDS 117,A01,494379,Staff,1,5,30,29
1714619467141,EDS 125,A00,507246,Hopkins; Megan Beth,9,0,30,21
1714619468167,EDS 128A,A01,507264,Fargason; Sharon Gayle,8,0,26,18
1714619469191,EDS 128B,A01,507293,Pappas; Elizabeth,12,0,30,18
1714619470216,EDS 139,A00,507294,Fargason; Sharon Gayle,13,0,30,17
1714619470216,EDS 139,B00,507313,Pappas; Elizabeth,13,0,30,17
1714619471242,EDS 201,A00,507315,Staff,13,0,30,17
1714619472269,EDS 203,A01,507317,Halter; Christopher P.,12,0,30,18
1714619473300,EDS 204R,A01,507319,Halter; Christopher P.,0,3,30,30
1714619473300,EDS 204R,B01,507331,Heinzman; Erica M.,16,0,30,14
1714619474326,EDS 206R,A00,507332,Staff,0,4,30,30
1714619474326,EDS 206R,B00,507343,Staff,17,0,30,13
1714619475356,EDS 250,A00,507344,Hemans; Patricia Ann Benitez,22,0,40,18
1714619476381,EDS 281,A00,507345,Daly; Alan J.,18,0,18,0
1714619477409,EDS 284,A00,507350,Daly; Alan J.,16,0,16,0
1714619478434,EDS 286,A00,507359,Fine; Sarah,18,0,18,0
1714619479465,EDS 289C,A01,507361,Daly; Alan J.,18,0,18,0
1714619480491,EDS 290,A00,507366,Hofstetter; Carolyn,15,0,15,0
1714619481516,LIGM 5A,A00,507421,Fischer-Grunski; Eva K,18,0,20,2
1714619482544,LIGM 5B,A00,507423,Fischer-Grunski; Eva K,19,0,20,1
1714619483570,LIGM 5C,A00,507425,Fischer-Grunski; Eva K,19,0,20,1
1714619484598,LIIT 5AS,A00,507427,Carnelos; Chiara,20,0,20,0
1714619485624,LIIT 5BS,A00,507430,Carnelos; Chiara,20,0,20,0
1714619486649,LIIT 5CS,A00,507432,Carnelos; Chiara,20,0,20,0
1714619487673,LISP 5A,A00,507541,Munoz Sanchez; Alicia,11,0,20,9
1714619488701,LISP 5B,A00,507671,Munoz Sanchez; Alicia,8,0,20,12
1714619489726,LISP 5C,A00,507696,Munoz Sanchez; Alicia,9,0,20,11
1714619490754,MAE 197,001,528363,Boechler; Nicholas Sebastia,9998,0,9999,1
1714619491781,MATH 197,001,523477,Kedlaya; Kiran S.,9995,0,9999,4
1714619491781,MATH 197,002,563811,Zhang; Danna,9995,0,9999,4
1714619491781,MATH 197,003,628552,Dumitriu; Ioana,9998,0,9999,1
1714619492807,MCWP 40R,A00,518780,Staff,2,0,20,18
1714619492807,MCWP 40R,B00,518781,Staff,8,0,20,12
1714619492807,MCWP 40R,C00,518783,Staff,6,0,20,14
1714619493833,MCWP 50R,A00,518791,Staff,0,0,20,20
1714619493833,MCWP 50R,B00,518792,Staff,0,2,20,20
1714619493833,MCWP 50R,C00,518793,Staff,0,2,20,20
1714619493833,MCWP 50R,D00,518794,Staff,0,0,20,20
1714619493833,MCWP 50R,E00,518795,Staff,0,2,20,20
1714619493833,MCWP 50R,F00,518796,Staff,0,0,20,20
1714619493833,MCWP 50R,G00,518797,Staff,0,1,20,20
1714619494861,MMW 12R,A01,514034,Herbst; Matthew,0,0,16,16
1714619494861,MMW 12R,A02,514035,Herbst; Matthew,1,0,16,15
1714619495889,MMW 13R,A01,514037,Staff,0,4,16,16
1714619495889,MMW 13R,A02,514039,Staff,0,2,16,16
1714619495889,MMW 13R,A03,628519,Staff,0,2,16,16
1714619497943,SIO 295LS,A00,523233,Staff,10,0,30,20
1714619498970,SIO 295S,A00,523232,Staff,10,0,30,20
1714619500000,SIOC 290S,A01,637330,Merrifield; Mark A,23,0,30,7
1714619501024,SIOC 291S,A01,637333,Gabriel; Corey John,23,0,30,7
1714619502050,SOCI 117,A01,494376,Staff,0,4,5,5
1714619503076,WES 237B,A00,494380,Staff,9,0,20,11
1714619505150,AESE 279B,A00,494370,Wade; Jon P,0,0,33,33
1714619506177,AIP 197,001,627712,Vespa; Emanuel Ignacio,9998,0,9999,1
1714619507201,ANAR 135S,A00,494369,Braswell; Geoffrey E.,0,0,0,0
1714619508227,BENG 196,001,628496,Engler; Adam J.,9998,0,9999,1
1714619509255,CAT 124RS,A01,519847,Geibel; William,0,0,20,20
1714619510279,CAT 125RS,A01,515971,Geibel; William,0,0,20,20
1714619511304,CLRE 250,A00,511389,Morris; Sheldon,9993,0,9999,6
1714619512331,CLRE 251,A00,507176,Mehta; Ravindra L.,9993,0,9999,6
1714619512331,CLRE 251,B00,511410,Mehta; Ravindra L.,9998,0,9999,1
1714619513357,CLRE 252,A00,507189,Cuomo; Raphael Eduardo,9995,0,9999,4
1714619514382,CLRE 253,A00,507199,Vaida; Florin,9994,0,9999,5
1714619514382,CLRE 253,B00,507202,Vaida; Florin,9999,0,9999,0
1714619515412,CLRE 259,A00,507211,Patel; Hemal,9996,0,9999,3
1714619516437,CLRE 260,A00,507221,Cuomo; Raphael Eduardo,9999,0,9999,0
1714619517461,CLRE 297,001,507242,Cuomo; Raphael Eduardo,9999,0,9999,0
1714619518488,COGS 197,001,638244,Voytek; Bradley Thomas,9998,0,9999,1
1714619519515,CSE 191,A00,516875,Minnes Kemp; Mor Mia,9992,0,9999,7
1714619520543,CSE 197,001,637388,Minnes Kemp; Mor Mia,9998,0,9999,1
1714619521567,CSS 201S,A01,494383,Staff,35,0,35,0
1714619522593,CSS 202S,A01,494387,Staff,35,0,35,0
1714619523620,DSC 197,001,628532,Eldridge; Justin Matthew,9996,0,9999,3
1714619524645,EAP 100,A00,516065,Staff,9797,0,9999,202
1714619525673,ECE 45,A01,507414,Staff,33,0,60,27
1714619527735,ECE 111,A01,507420,Staff,15,0,50,35
1714619528763,ECE 197,001,548057,Sievenpiper; Daniel F.,9993,0,9999,6
1714619529791,EDS 115,A00,507243,Choi; Bailey Miyeon,10,0,28,18
1714619530817,EDS 117,A01,494379,Staff,1,5,30,29
1714619531846,EDS 125,A00,507246,Hopkins; Megan Beth,9,0,30,21
1714619532872,EDS 128A,A01,507264,Fargason; Sharon Gayle,8,0,26,18
1714619533897,EDS 128B,A01,507293,Pappas; Elizabeth,12,0,30,18
1714619534925,EDS 139,A00,507294,Fargason; Sharon Gayle,13,0,30,17
1714619534925,EDS 139,B00,507313,Pappas; Elizabeth,13,0,30,17
1714619535950,EDS 201,A00,507315,Staff,13,0,30,17
1714619536976,EDS 203,A01,507317,Halter; Christopher P.,12,0,30,18
1714619538001,EDS 204R,A01,507319,Halter; Christopher P.,0,3,30,30
1714619538001,EDS 204R,B01,507331,Heinzman; Erica M.,16,0,30,14
1714619539025,EDS 206R,A00,507332,Staff,0,4,30,30
1714619539025,EDS 206R,B00,507343,Staff,17,0,30,13
1714619540052,EDS 250,A00,507344,Hemans; Patricia Ann Benitez,22,0,40,18
1714619541079,EDS 281,A00,507345,Daly; Alan J.,18,0,18,0
1714619542105,EDS 284,A00,507350,Daly; Alan J.,16,0,16,0
1714619543130,EDS 286,A00,507359,Fine; Sarah,18,0,18,0
1714619544156,EDS 289C,A01,507361,Daly; Alan J.,18,0,18,0
1714619545180,EDS 290,A00,507366,Hofstetter; Carolyn,15,0,15,0
1714619546206,LIGM 5A,A00,507421,Fischer-Grunski; Eva K,18,0,20,2
1714619547231,LIGM 5B,A00,507423,Fischer-Grunski; Eva K,19,0,20,1
1714619548256,LIGM 5C,A00,507425,Fischer-Grunski; Eva K,19,0,20,1
1714619549284,LIIT 5AS,A00,507427,Carnelos; Chiara,20,0,20,0
1714619550307,LIIT 5BS,A00,507430,Carnelos; Chiara,20,0,20,0
1714619551331,LIIT 5CS,A00,507432,Carnelos; Chiara,20,0,20,0
1714619552361,LISP 5A,A00,507541,Munoz Sanchez; Alicia,11,0,20,9
1714619553387,LISP 5B,A00,507671,Munoz Sanchez; Alicia,8,0,20,12
1714619554413,LISP 5C,A00,507696,Munoz Sanchez; Alicia,9,0,20,11
1714619555440,MAE 197,001,528363,Boechler; Nicholas Sebastia,9998,0,9999,1
1714619556469,MATH 197,001,523477,Kedlaya; Kiran S.,9995,0,9999,4
1714619556469,MATH 197,002,563811,Zhang; Danna,9995,0,9999,4
1714619556469,MATH 197,003,628552,Dumitriu; Ioana,9998,0,9999,1
1714619557493,MCWP 40R,A00,518780,Staff,2,0,20,18
1714619557493,MCWP 40R,B00,518781,Staff,8,0,20,12
1714619557493,MCWP 40R,C00,518783,Staff,6,0,20,14
1714619558519,MCWP 50R,A00,518791,Staff,0,0,20,20
1714619558519,MCWP 50R,B00,518792,Staff,0,2,20,20
1714619558519,MCWP 50R,C00,518793,Staff,0,2,20,20
1714619558519,MCWP 50R,D00,518794,Staff,0,0,20,20
1714619558519,MCWP 50R,E00,518795,Staff,0,2,20,20
1714619558519,MCWP 50R,F00,518796,Staff,0,0,20,20
1714619558519,MCWP 50R,G00,518797,Staff,0,1,20,20
1714619559544,MMW 12R,A01,514034,Herbst; Matthew,0,0,16,16
1714619559544,MMW 12R,A02,514035,Herbst; Matthew,1,0,16,15
1714619560570,MMW 13R,A01,514037,Staff,0,4,16,16
1714619560570,MMW 13R,A02,514039,Staff,0,2,16,16
1714619560570,MMW 13R,A03,628519,Staff,0,2,16,16
1714619562622,SIO 295LS,A00,523233,Staff,10,0,30,20
1714619563646,SIO 295S,A00,523232,Staff,10,0,30,20
1714619564676,SIOC 290S,A01,637330,Merrifield; Mark A,23,0,30,7
1714619565701,SIOC 291S,A01,637333,Gabriel; Corey John,23,0,30,7
1714619566726,SOCI 117,A01,494376,Staff,0,4,5,5
1714619567751,WES 237B,A00,494380,Staff,9,0,20,11
1714619569860,AESE 279B,A00,494370,Wade; Jon P,0,0,33,33
1714619570887,AIP 197,001,627712,Vespa; Emanuel Ignacio,9998,0,9999,1
1714619571915,ANAR 135S,A00,494369,Braswell; Geoffrey E.,0,0,0,0
1714619572941,BENG 196,001,628496,Engler; Adam J.,9998,0,9999,1
1714619573964,CAT 124RS,A01,519847,Geibel; William,0,0,20,20
1714619574989,CAT 125RS,A01,515971,Geibel; William,0,0,20,20
1714619576016,CLRE 250,A00,511389,Morris; Sheldon,9993,0,9999,6
1714619577042,CLRE 251,A00,507176,Mehta; Ravindra L.,9993,0,9999,6
1714619577042,CLRE 251,B00,511410,Mehta; Ravindra L.,9998,0,9999,1
1714619578068,CLRE 252,A00,507189,Cuomo; Raphael Eduardo,9995,0,9999,4
1714619579094,CLRE 253,A00,507199,Vaida; Florin,9994,0,9999,5
1714619579094,CLRE 253,B00,507202,Vaida; Florin,9999,0,9999,0
1714619580125,CLRE 259,A00,507211,Patel; Hemal,9996,0,9999,3
1714619581150,CLRE 260,A00,507221,Cuomo; Raphael Eduardo,9999,0,9999,0
1714619582177,CLRE 297,001,507242,Cuomo; Raphael Eduardo,9999,0,9999,0
1714619583204,COGS 197,001,638244,Voytek; Bradley Thomas,9998,0,9999,1
1714619584229,CSE 191,A00,516875,Minnes Kemp; Mor Mia,9992,0,9999,7
1714619585254,CSE 197,001,637388,Minnes Kemp; Mor Mia,9998,0,9999,1
1714619586282,CSS 201S,A01,494383,Staff,35,0,35,0
1714619587306,CSS 202S,A01,494387,Staff,35,0,35,0
1714619588334,DSC 197,001,628532,Eldridge; Justin Matthew,9996,0,9999,3
1714619589361,EAP 100,A00,516065,Staff,9797,0,9999,202
1714619590388,ECE 45,A01,507414,Staff,33,0,60,27
1714619592439,ECE 111,A01,507420,Staff,15,0,50,35
1714619593464,ECE 197,001,548057,Sievenpiper; Daniel F.,9993,0,9999,6
1714619594490,EDS 115,A00,507243,Choi; Bailey Miyeon,10,0,28,18
1714619595517,EDS 117,A01,494379,Staff,1,5,30,29
1714619596544,EDS 125,A00,507246,Hopkins; Megan Beth,9,0,30,21
1714619597569,EDS 128A,A01,507264,Fargason; Sharon Gayle,8,0,26,18
1714619598593,EDS 128B,A01,507293,Pappas; Elizabeth,12,0,30,18
1714619599616,EDS 139,A00,507294,Fargason; Sharon Gayle,13,0,30,17
1714619599616,EDS 139,B00,507313,Pappas; Elizabeth,13,0,30,17
1714619600644,EDS 201,A00,507315,Staff,13,0,30,17
1714619601672,EDS 203,A01,507317,Halter; Christopher P.,12,0,30,18
1714619602697,EDS 204R,A01,507319,Halter; Christopher P.,0,3,30,30
1714619602697,EDS 204R,B01,507331,Heinzman; Erica M.,16,0,30,14
1714619603728,EDS 206R,A00,507332,Staff,0,4,30,30
1714619603728,EDS 206R,B00,507343,Staff,17,0,30,13
1714619604755,EDS 250,A00,507344,Hemans; Patricia Ann Benitez,22,0,40,18
1714619605780,EDS 281,A00,507345,Daly; Alan J.,18,0,18,0
1714619606806,EDS 284,A00,507350,Daly; Alan J.,16,0,16,0
1714619607835,EDS 286,A00,507359,Fine; Sarah,18,0,18,0
1714619608864,EDS 289C,A01,507361,Daly; Alan J.,18,0,18,0
1714619609892,EDS 290,A00,507366,Hofstetter; Carolyn,15,0,15,0
1714619610920,LIGM 5A,A00,507421,Fischer-Grunski; Eva K,18,0,20,2
1714619611947,LIGM 5B,A00,507423,Fischer-Grunski; Eva K,19,0,20,1
1714619612972,LIGM 5C,A00,507425,Fischer-Grunski; Eva K,19,0,20,1
1714619614000,LIIT 5AS,A00,507427,Carnelos; Chiara,20,0,20,0
1714619615025,LIIT 5BS,A00,507430,Carnelos; Chiara,20,0,20,0
1714619616055,LIIT 5CS,A00,507432,Carnelos; Chiara,20,0,20,0
1714619617080,LISP 5A,A00,507541,Munoz Sanchez; Alicia,11,0,20,9
1714619618105,LISP 5B,A00,507671,Munoz Sanchez; Alicia,8,0,20,12
1714619619134,LISP 5C,A00,507696,Munoz Sanchez; Alicia,9,0,20,11
1714619620159,MAE 197,001,528363,Boechler; Nicholas Sebastia,9998,0,9999,1
1714619621187,MATH 197,001,523477,Kedlaya; Kiran S.,9995,0,9999,4
1714619621187,MATH 197,002,563811,Zhang; Danna,9995,0,9999,4
1714619621187,MATH 197,003,628552,Dumitriu; Ioana,9998,0,9999,1
1714619622211,MCWP 40R,A00,518780,Staff,2,0,20,18
1714619622211,MCWP 40R,B00,518781,Staff,8,0,20,12
1714619622211,MCWP 40R,C00,518783,Staff,6,0,20,14
1714619623241,MCWP 50R,A00,518791,Staff,0,0,20,20
1714619623241,MCWP 50R,B00,518792,Staff,0,2,20,20
1714619623241,MCWP 50R,C00,518793,Staff,0,2,20,20
1714619623241,MCWP 50R,D00,518794,Staff,0,0,20,20
1714619623241,MCWP 50R,E00,518795,Staff,0,2,20,20
1714619623241,MCWP 50R,F00,518796,Staff,0,0,20,20
1714619623241,MCWP 50R,G00,518797,Staff,0,1,20,20
1714619624268,MMW 12R,A01,514034,Herbst; Matthew,0,0,16,16
1714619624268,MMW 12R,A02,514035,Herbst; Matthew,1,0,16,15
1714619625296,MMW 13R,A01,514037,Staff,0,4,16,16
1714619625296,MMW 13R,A02,514039,Staff,0,2,16,16
1714619625296,MMW 13R,A03,628519,Staff,0,2,16,16
1714619627349,SIO 295LS,A00,523233,Staff,10,0,30,20
1714619628374,SIO 295S,A00,523232,Staff,10,0,30,20
1714619629404,SIOC 290S,A01,637330,Merrifield; Mark A,23,0,30,7
1714619630433,SIOC 291S,A01,637333,Gabriel; Corey John,23,0,30,7
1714619631463,SOCI 117,A01,494376,Staff,0,4,5,5
1714619632488,WES 237B,A00,494380,Staff,9,0,20,11
1714619634556,AESE 279B,A00,494370,Wade; Jon P,0,0,33,33
1714619635581,AIP 197,001,627712,Vespa; Emanuel Ignacio,9998,0,9999,1
1714619636607,ANAR 135S,A00,494369,Braswell; Geoffrey E.,0,0,0,0
1714619637633,BENG 196,001,628496,Engler; Adam J.,9998,0,9999,1
1714619638657,CAT 124RS,A01,519847,Geibel; William,0,0,20,20
1714619639680,CAT 125RS,A01,515971,Geibel; William,0,0,20,20
1714619640705,CLRE 250,A00,511389,Morris; Sheldon,9993,0,9999,6
1714619641732,CLRE 251,A00,507176,Mehta; Ravindra L.,9993,0,9999,6
1714619641732,CLRE 251,B00,511410,Mehta; Ravindra L.,9998,0,9999,1
1714619642759,CLRE 252,A00,507189,Cuomo; Raphael Eduardo,9995,0,9999,4
1714619643784,CLRE 253,A00,507199,Vaida; Florin,9994,0,9999,5
1714619643784,CLRE 253,B00,507202,Vaida; Florin,9999,0,9999,0
1714619644809,CLRE 259,A00,507211,Patel; Hemal,9996,0,9999,3
1714619645837,CLRE 260,A00,507221,Cuomo; Raphael Eduardo,9999,0,9999,0
1714619646863,CLRE 297,001,507242,Cuomo; Raphael Eduardo,9999,0,9999,0
1714619647892,COGS 197,001,638244,Voytek; Bradley Thomas,9998,0,9999,1
1714619648918,CSE 191,A00,516875,Minnes Kemp; Mor Mia,9992,0,9999,7
1714619649943,CSE 197,001,637388,Minnes Kemp; Mor Mia,9998,0,9999,1
1714619650970,CSS 201S,A01,494383,Staff,35,0,35,0
1714619651994,CSS 202S,A01,494387,Staff,35,0,35,0
1714619653020,DSC 197,001,628532,Eldridge; Justin Matthew,9996,0,9999,3
1714619654046,EAP 100,A00,516065,Staff,9797,0,9999,202
1714619655072,ECE 45,A01,507414,Staff,33,0,60,27
1714619657121,ECE 111,A01,507420,Staff,15,0,50,35
1714619658149,ECE 197,001,548057,Sievenpiper; Daniel F.,9993,0,9999,6
1714619659177,EDS 115,A00,507243,Choi; Bailey Miyeon,10,0,28,18
1714619660206,EDS 117,A01,494379,Staff,1,5,30,29
1714619661235,EDS 125,A00,507246,Hopkins; Megan Beth,9,0,30,21
1714619662260,EDS 128A,A01,507264,Fargason; Sharon Gayle,8,0,26,18
1714619663287,EDS 128B,A01,507293,Pappas; Elizabeth,12,0,30,18
1714619664310,EDS 139,A00,507294,Fargason; Sharon Gayle,13,0,30,17
1714619664310,EDS 139,B00,507313,Pappas; Elizabeth,13,0,30,17
1714619665336,EDS 201,A00,507315,Staff,13,0,30,17
1714619666360,EDS 203,A01,507317,Halter; Christopher P.,12,0,30,18
1714619667389,EDS 204R,A01,507319,Halter; Christopher P.,0,3,30,30
1714619667389,EDS 204R,B01,507331,Heinzman; Erica M.,16,0,30,14
1714619668413,EDS 206R,A00,507332,Staff,0,4,30,30
1714619668413,EDS 206R,B00,507343,Staff,17,0,30,13
1714619669440,EDS 250,A00,507344,Hemans; Patricia Ann Benitez,22,0,40,18
1714619670465,EDS 281,A00,507345,Daly; Alan J.,18,0,18,0
1714619671490,EDS 284,A00,507350,Daly; Alan J.,16,0,16,0
1714619672574,EDS 286,A00,507359,Fine; Sarah,18,0,18,0
1714619673598,EDS 289C,A01,507361,Daly; Alan J.,18,0,18,0
1714619674624,EDS 290,A00,507366,Hofstetter; Carolyn,15,0,15,0
1714619675650,LIGM 5A,A00,507421,Fischer-Grunski; Eva K,18,0,20,2
1714619676679,LIGM 5B,A00,507423,Fischer-Grunski; Eva K,19,0,20,1
1714619677704,LIGM 5C,A00,507425,Fischer-Grunski; Eva K,19,0,20,1
1714619678733,LIIT 5AS,A00,507427,Carnelos; Chiara,20,0,20,0
1714619679763,LIIT 5BS,A00,507430,Carnelos; Chiara,20,0,20,0
1714619680786,LIIT 5CS,A00,507432,Carnelos; Chiara,20,0,20,0
1714619681811,LISP 5A,A00,507541,Munoz Sanchez; Alicia,11,0,20,9
1714619682836,LISP 5B,A00,507671,Munoz Sanchez; Alicia,8,0,20,12
1714619683862,LISP 5C,A00,507696,Munoz Sanchez; Alicia,9,0,20,11
1714619684890,MAE 197,001,528363,Boechler; Nicholas Sebastia,9998,0,9999,1
1714619685921,MATH 197,001,523477,Kedlaya; Kiran S.,9995,0,9999,4
1714619685921,MATH 197,002,563811,Zhang; Danna,9995,0,9999,4
1714619685921,MATH 197,003,628552,Dumitriu; Ioana,9998,0,9999,1
1714619686946,MCWP 40R,A00,518780,Staff,2,0,20,18
1714619686946,MCWP 40R,B00,518781,Staff,8,0,20,12
1714619686946,MCWP 40R,C00,518783,Staff,6,0,20,14
1714619687975,MCWP 50R,A00,518791,Staff,0,0,20,20
1714619687975,MCWP 50R,B00,518792,Staff,0,2,20,20
1714619687975,MCWP 50R,C00,518793,Staff,0,2,20,20
1714619687975,MCWP 50R,D00,518794,Staff,0,0,20,20
1714619687975,MCWP 50R,E00,518795,Staff,0,2,20,20
1714619687975,MCWP 50R,F00,518796,Staff,0,0,20,20
1714619687975,MCWP 50R,G00,518797,Staff,0,1,20,20
1714619689003,MMW 12R,A01,514034,Herbst; Matthew,0,0,16,16
1714619689003,MMW 12R,A02,514035,Herbst; Matthew,1,0,16,15
1714619690027,MMW 13R,A01,514037,Staff,0,4,16,16
1714619690027,MMW 13R,A02,514039,Staff,0,2,16,16
1714619690027,MMW 13R,A03,628519,Staff,0,2,16,16
1714619692076,SIO 295LS,A00,523233,Staff,10,0,30,20
1714619693102,SIO 295S,A00,523232,Staff,10,0,30,20
1714619694130,SIOC 290S,A01,637330,Merrifield; Mark A,23,0,30,7
1714619695156,SIOC 291S,A01,637333,Gabriel; Corey John,23,0,30,7
1714619696184,SOCI 117,A01,494376,Staff,0,4,5,5
1714619697209,WES 237B,A00,494380,Staff,9,0,20,11
1714619699279,AESE 279B,A00,494370,Wade; Jon P,0,0,33,33
1714619700310,AIP 197,001,627712,Vespa; Emanuel Ignacio,9998,0,9999,1
1714619701337,ANAR 135S,A00,494369,Braswell; Geoffrey E.,0,0,0,0
1714619702363,BENG 196,001,628496,Engler; Adam J.,9998,0,9999,1
1714619703391,CAT 124RS,A01,519847,Geibel; William,0,0,20,20
1714619704419,CAT 125RS,A01,515971,Geibel; William,0,0,20,20
1714619705444,CLRE 250,A00,511389,Morris; Sheldon,9993,0,9999,6
1714619706474,CLRE 251,A00,507176,Mehta; Ravindra L.,9993,0,9999,6
1714619706474,CLRE 251,B00,511410,Mehta; Ravindra L.,9998,0,9999,1
1714619707499,CLRE 252,A00,507189,Cuomo; Raphael Eduardo,9995,0,9999,4
1714619708529,CLRE 253,A00,507199,Vaida; Florin,9994,0,9999,5
1714619708529,CLRE 253,B00,507202,Vaida; Florin,9999,0,9999,0
1714619709555,CLRE 259,A00,507211,Patel; Hemal,9996,0,9999,3
1714619710580,CLRE 260,A00,507221,Cuomo; Raphael Eduardo,9999,0,9999,0
1714619711604,CLRE 297,001,507242,Cuomo; Raphael Eduardo,9999,0,9999,0
1714619712630,COGS 197,001,638244,Voytek; Bradley Thomas,9998,0,9999,1
1714619713658,CSE 191,A00,516875,Minnes Kemp; Mor Mia,9992,0,9999,7
1714619714684,CSE 197,001,637388,Minnes Kemp; Mor Mia,9998,0,9999,1
1714619715709,CSS 201S,A01,494383,Staff,35,0,35,0
1714619716738,CSS 202S,A01,494387,Staff,35,0,35,0
1714619717764,DSC 197,001,628532,Eldridge; Justin Matthew,9996,0,9999,3
1714619718787,EAP 100,A00,516065,Staff,9797,0,9999,202
1714619719815,ECE 45,A01,507414,Staff,33,0,60,27
1714619721868,ECE 111,A01,507420,Staff,15,0,50,35
1714619722892,ECE 197,001,548057,Sievenpiper; Daniel F.,9993,0,9999,6
1714619723918,EDS 115,A00,507243,Choi; Bailey Miyeon,10,0,28,18
1714619724947,EDS 117,A01,494379,Staff,1,5,30,29
1714619725973,EDS 125,A00,507246,Hopkins; Megan Beth,9,0,30,21
1714619726998,EDS 128A,A01,507264,Fargason; Sharon Gayle,8,0,26,18
1714619728026,EDS 128B,A01,507293,Pappas; Elizabeth,12,0,30,18
1714619729052,EDS 139,A00,507294,Fargason; Sharon Gayle,13,0,30,17
1714619729052,EDS 139,B00,507313,Pappas; Elizabeth,13,0,30,17
1714619730079,EDS 201,A00,507315,Staff,13,0,30,17
1714619731155,EDS 203,A01,507317,Halter; Christopher P.,12,0,30,18
1714619732182,EDS 204R,A01,507319,Halter; Christopher P.,0,3,30,30
1714619732182,EDS 204R,B01,507331,Heinzman; Erica M.,16,0,30,14
1714619733211,EDS 206R,A00,507332,Staff,0,4,30,30
1714619733211,EDS 206R,B00,507343,Staff,17,0,30,13
1714619734236,EDS 250,A00,507344,Hemans; Patricia Ann Benitez,22,0,40,18
1714619735261,EDS 281,A00,507345,Daly; Alan J.,18,0,18,0
1714619736286,EDS 284,A00,507350,Daly; Alan J.,16,0,16,0
1714619737315,EDS 286,A00,507359,Fine; Sarah,18,0,18,0
1714619738339,EDS 289C,A01,507361,Daly; Alan J.,18,0,18,0
1714619739370,EDS 290,A00,507366,Hofstetter; Carolyn,15,0,15,0
1714619740395,LIGM 5A,A00,507421,Fischer-Grunski; Eva K,18,0,20,2
1714619741420,LIGM 5B,A00,507423,Fischer-Grunski; Eva K,19,0,20,1
1714619742446,LIGM 5C,A00,507425,Fischer-Grunski; Eva K,19,0,20,1
1714619743471,LIIT 5AS,A00,507427,Carnelos; Chiara,20,0,20,0
1714619744496,LIIT 5BS,A00,507430,Carnelos; Chiara,20,0,20,0
1714619745525,LIIT 5CS,A00,507432,Carnelos; Chiara,20,0,20,0
1714619746552,LISP 5A,A00,507541,Munoz Sanchez; Alicia,11,0,20,9
1714619747581,LISP 5B,A00,507671,Munoz Sanchez; Alicia,8,0,20,12
1714619748606,LISP 5C,A00,507696,Munoz Sanchez; Alicia,9,0,20,11
1714619749632,MAE 197,001,528363,Boechler; Nicholas Sebastia,9998,0,9999,1
1714619750659,MATH 197,001,523477,Kedlaya; Kiran S.,9995,0,9999,4
1714619750659,MATH 197,002,563811,Zhang; Danna,9995,0,9999,4
1714619750659,MATH 197,003,628552,Dumitriu; Ioana,9998,0,9999,1
1714619751686,MCWP 40R,A00,518780,Staff,2,0,20,18
1714619751686,MCWP 40R,B00,518781,Staff,8,0,20,12
1714619751686,MCWP 40R,C00,518783,Staff,6,0,20,14
1714619752714,MCWP 50R,A00,518791,Staff,0,0,20,20
1714619752714,MCWP 50R,B00,518792,Staff,0,2,20,20
1714619752714,MCWP 50R,C00,518793,Staff,0,2,20,20
1714619752714,MCWP 50R,D00,518794,Staff,0,0,20,20
1714619752714,MCWP 50R,E00,518795,Staff,0,2,20,20
1714619752714,MCWP 50R,F00,518796,Staff,0,0,20,20
1714619752714,MCWP 50R,G00,518797,Staff,0,1,20,20
1714619753740,MMW 12R,A01,514034,Herbst; Matthew,0,0,16,16
1714619753740,MMW 12R,A02,514035,Herbst; Matthew,1,0,16,15
1714619754766,MMW 13R,A01,514037,Staff,0,4,16,16
1714619754766,MMW 13R,A02,514039,Staff,0,2,16,16
1714619754766,MMW 13R,A03,628519,Staff,0,2,16,16
1714619756819,SIO 295LS,A00,523233,Staff,10,0,30,20
1714619757844,SIO 295S,A00,523232,Staff,10,0,30,20
1714619758871,SIOC 290S,A01,637330,Merrifield; Mark A,23,0,30,7
1714619759896,SIOC 291S,A01,637333,Gabriel; Corey John,23,0,30,7
1714619760923,SOCI 117,A01,494376,Staff,0,4,5,5
1714619761949,WES 237B,A00,494380,Staff,9,0,20,11
1714619764023,AESE 279B,A00,494370,Wade; Jon P,0,0,33,33
1714619765048,AIP 197,001,627712,Vespa; Emanuel Ignacio,9998,0,9999,1
1714619766078,ANAR 135S,A00,494369,Braswell; Geoffrey E.,0,0,0,0
1714619767103,BENG 196,001,628496,Engler; Adam J.,9998,0,9999,1
1714619768128,CAT 124RS,A01,519847,Geibel; William,0,0,20,20
1714619769153,CAT 125RS,A01,515971,Geibel; William,0,0,20,20
1714619770179,CLRE 250,A00,511389,Morris; Sheldon,9993,0,9999,6
1714619771208,CLRE 251,A00,507176,Mehta; Ravindra L.,9993,0,9999,6
1714619771208,CLRE 251,B00,511410,Mehta; Ravindra L.,9998,0,9999,1
1714619772238,CLRE 252,A00,507189,Cuomo; Raphael Eduardo,9995,0,9999,4
1714619773269,CLRE 253,A00,507199,Vaida; Florin,9994,0,9999,5
1714619773269,CLRE 253,B00,507202,Vaida; Florin,9999,0,9999,0
1714619774294,CLRE 259,A00,507211,Patel; Hemal,9996,0,9999,3
1714619775321,CLRE 260,A00,507221,Cuomo; Raphael Eduardo,9999,0,9999,0
1714619776401,CLRE 297,001,507242,Cuomo; Raphael Eduardo,9999,0,9999,0
1714619777429,COGS 197,001,638244,Voytek; Bradley Thomas,9998,0,9999,1
1714619778453,CSE 191,A00,516875,Minnes Kemp; Mor Mia,9992,0,9999,7
1714619779477,CSE 197,001,637388,Minnes Kemp; Mor Mia,9998,0,9999,1
1714619780508,CSS 201S,A01,494383,Staff,35,0,35,0
1714619781533,CSS 202S,A01,494387,Staff,35,0,35,0
1714619782558,DSC 197,001,628532,Eldridge; Justin Matthew,9996,0,9999,3
1714619783581,EAP 100,A00,516065,Staff,9797,0,9999,202
1714619784609,ECE 45,A01,507414,Staff,33,0,60,27
1714619786666,ECE 111,A01,507420,Staff,15,0,50,35
1714619787692,ECE 197,001,548057,Sievenpiper; Daniel F.,9993,0,9999,6
1714619788722,EDS 115,A00,507243,Choi; Bailey Miyeon,10,0,28,18
1714619789747,EDS 117,A01,494379,Staff,1,5,30,29
1714619790775,EDS 125,A00,507246,Hopkins; Megan Beth,9,0,30,21
1714619791800,EDS 128A,A01,507264,Fargason; Sharon Gayle,8,0,26,18
1714619792828,EDS 128B,A01,507293,Pappas; Elizabeth,12,0,30,18
1714619793865,EDS 139,A00,507294,Fargason; Sharon Gayle,13,0,30,17
1714619793865,EDS 139,B00,507313,Pappas; Elizabeth,13,0,30,17
1714619794890,EDS 201,A00,507315,Staff,13,0,30,17
1714619795920,EDS 203,A01,507317,Halter; Christopher P.,12,0,30,18
1714619796947,EDS 204R,A01,507319,Halter; Christopher P.,0,3,30,30
1714619796947,EDS 204R,B01,507331,Heinzman; Erica M.,16,0,30,14
1714619797971,EDS 206R,A00,507332,Staff,0,4,30,30
1714619797971,EDS 206R,B00,507343,Staff,17,0,30,13
1714619798998,EDS 250,A00,507344,Hemans; Patricia Ann Benitez,22,0,40,18
1714619800027,EDS 281,A00,507345,Daly; Alan J.,18,0,18,0
1714619801052,EDS 284,A00,507350,Daly; Alan J.,16,0,16,0
1714619802082,EDS 286,A00,507359,Fine; Sarah,18,0,18,0
1714619803107,EDS 289C,A01,507361,Daly; Alan J.,18,0,18,0
1714619804134,EDS 290,A00,507366,Hofstetter; Carolyn,15,0,15,0
1714619805160,LIGM 5A,A00,507421,Fischer-Grunski; Eva K,18,0,20,2
1714619806184,LIGM 5B,A00,507423,Fischer-Grunski; Eva K,19,0,20,1
1714619807213,LIGM 5C,A00,507425,Fischer-Grunski; Eva K,19,0,20,1
1714619808244,LIIT 5AS,A00,507427,Carnelos; Chiara,20,0,20,0
1714619809268,LIIT 5BS,A00,507430,Carnelos; Chiara,20,0,20,0
1714619810293,LIIT 5CS,A00,507432,Carnelos; Chiara,20,0,20,0
1714619811319,LISP 5A,A00,507541,Munoz Sanchez; Alicia,11,0,20,9
1714619812346,LISP 5B,A00,507671,Munoz Sanchez; Alicia,8,0,20,12
1714619813376,LISP 5C,A00,507696,Munoz Sanchez; Alicia,9,0,20,11
1714619814403,MAE 197,001,528363,Boechler; Nicholas Sebastia,9998,0,9999,1
1714619815434,MATH 197,001,523477,Kedlaya; Kiran S.,9995,0,9999,4
1714619815434,MATH 197,002,563811,Zhang; Danna,9995,0,9999,4
1714619815434,MATH 197,003,628552,Dumitriu; Ioana,9998,0,9999,1
1714619816460,MCWP 40R,A00,518780,Staff,2,0,20,18
1714619816460,MCWP 40R,B00,518781,Staff,8,0,20,12
1714619816460,MCWP 40R,C00,518783,Staff,6,0,20,14
1714619817490,MCWP 50R,A00,518791,Staff,0,0,20,20
1714619817490,MCWP 50R,B00,518792,Staff,0,2,20,20
1714619817490,MCWP 50R,C00,518793,Staff,0,2,20,20
1714619817490,MCWP 50R,D00,518794,Staff,0,0,20,20
1714619817490,MCWP 50R,E00,518795,Staff,0,2,20,20
1714619817490,MCWP 50R,F00,518796,Staff,0,0,20,20
1714619817490,MCWP 50R,G00,518797,Staff,0,1,20,20
1714619818518,MMW 12R,A01,514034,Herbst; Matthew,0,0,16,16
1714619818518,MMW 12R,A02,514035,Herbst; Matthew,1,0,16,15
1714619819542,MMW 13R,A01,514037,Staff,0,4,16,16
1714619819542,MMW 13R,A02,514039,Staff,0,2,16,16
1714619819542,MMW 13R,A03,628519,Staff,0,2,16,16
1714619821594,SIO 295LS,A00,523233,Staff,10,0,30,20
1714619822619,SIO 295S,A00,523232,Staff,10,0,30,20
1714619823648,SIOC 290S,A01,637330,Merrifield; Mark A,23,0,30,7
1714619824672,SIOC 291S,A01,637333,Gabriel; Corey John,23,0,30,7
1714619825700,SOCI 117,A01,494376,Staff,0,4,5,5
1714619826724,WES 237B,A00,494380,Staff,9,0,20,11
1714619828797,AESE 279B,A00,494370,Wade; Jon P,0,0,33,33
1714619829822,AIP 197,001,627712,Vespa; Emanuel Ignacio,9998,0,9999,1
1714619830847,ANAR 135S,A00,494369,Braswell; Geoffrey E.,0,0,0,0
1714619831872,BENG 196,001,628496,Engler; Adam J.,9998,0,9999,1
1714619832898,CAT 124RS,A01,519847,Geibel; William,0,0,20,20
1714619833921,CAT 125RS,A01,515971,Geibel; William,0,0,20,20
1714619834947,CLRE 250,A00,511389,Morris; Sheldon,9993,0,9999,6
1714619835977,CLRE 251,A00,507176,Mehta; Ravindra L.,9993,0,9999,6
1714619835977,CLRE 251,B00,511410,Mehta; Ravindra L.,9998,0,9999,1
1714619837003,CLRE 252,A00,507189,Cuomo; Raphael Eduardo,9995,0,9999,4
1714619838028,CLRE 253,A00,507199,Vaida; Florin,9994,0,9999,5
1714619838028,CLRE 253,B00,507202,Vaida; Florin,9999,0,9999,0
1714619839054,CLRE 259,A00,507211,Patel; Hemal,9996,0,9999,3
1714619840078,CLRE 260,A00,507221,Cuomo; Raphael Eduardo,9999,0,9999,0
1714619841104,CLRE 297,001,507242,Cuomo; Raphael Eduardo,9999,0,9999,0
1714619842134,COGS 197,001,638244,Voytek; Bradley Thomas,9998,0,9999,1
1714619843163,CSE 191,A00,516875,Minnes Kemp; Mor Mia,9992,0,9999,7
1714619844189,CSE 197,001,637388,Minnes Kemp; Mor Mia,9998,0,9999,1
1714619845218,CSS 201S,A01,494383,Staff,35,0,35,0
1714619846242,CSS 202S,A01,494387,Staff,35,0,35,0
1714619847268,DSC 197,001,628532,Eldridge; Justin Matthew,9996,0,9999,3
1714619848292,EAP 100,A00,516065,Staff,9797,0,9999,202
1714619849319,ECE 45,A01,507414,Staff,33,0,60,27
1714619851368,ECE 111,A01,507420,Staff,15,0,50,35
1714619852394,ECE 197,001,548057,Sievenpiper; Daniel F.,9993,0,9999,6
1714619853420,EDS 115,A00,507243,Choi; Bailey Miyeon,10,0,28,18
1714619854445,EDS 117,A01,494379,Staff,1,5,30,29
1714619855473,EDS 125,A00,507246,Hopkins; Megan Beth,9,0,30,21
1714619856498,EDS 128A,A01,507264,Fargason; Sharon Gayle,8,0,26,18
1714619857525,EDS 128B,A01,507293,Pappas; Elizabeth,12,0,30,18
1714619858549,EDS 139,A00,507294,Fargason; Sharon Gayle,13,0,30,17
1714619858549,EDS 139,B00,507313,Pappas; Elizabeth,13,0,30,17
1714619859574,EDS 201,A00,507315,Staff,13,0,30,17
1714619860601,EDS 203,A01,507317,Halter; Christopher P.,12,0,30,18
1714619861626,EDS 204R,A01,507319,Halter; Christopher P.,0,3,30,30
1714619861626,EDS 204R,B01,507331,Heinzman; Erica M.,16,0,30,14
1714619862652,EDS 206R,A00,507332,Staff,0,4,30,30
1714619862652,EDS 206R,B00,507343,Staff,17,0,30,13
1714619863676,EDS 250,A00,507344,Hemans; Patricia Ann Benitez,22,0,40,18
1714619864702,EDS 281,A00,507345,Daly; Alan J.,18,0,18,0
1714619865729,EDS 284,A00,507350,Daly; Alan J.,16,0,16,0
1714619866754,EDS 286,A00,507359,Fine; Sarah,18,0,18,0
1714619867778,EDS 289C,A01,507361,Daly; Alan J.,18,0,18,0
1714619868803,EDS 290,A00,507366,Hofstetter; Carolyn,15,0,15,0
1714619869829,LIGM 5A,A00,507421,Fischer-Grunski; Eva K,18,0,20,2
1714619870855,LIGM 5B,A00,507423,Fischer-Grunski; Eva K,19,0,20,1
1714619871884,LIGM 5C,A00,507425,Fischer-Grunski; Eva K,19,0,20,1
1714619872911,LIIT 5AS,A00,507427,Carnelos; Chiara,20,0,20,0
1714619873940,LIIT 5BS,A00,507430,Carnelos; Chiara,20,0,20,0
1714619874970,LIIT 5CS,A00,507432,Carnelos; Chiara,20,0,20,0
1714619875995,LISP 5A,A00,507541,Munoz Sanchez; Alicia,11,0,20,9
1714619877022,LISP 5B,A00,507671,Munoz Sanchez; Alicia,8,0,20,12
1714619878047,LISP 5C,A00,507696,Munoz Sanchez; Alicia,9,0,20,11
1714619879072,MAE 197,001,528363,Boechler; Nicholas Sebastia,9998,0,9999,1
1714619880102,MATH 197,001,523477,Kedlaya; Kiran S.,9995,0,9999,4
1714619880102,MATH 197,002,563811,Zhang; Danna,9995,0,9999,4
1714619880102,MATH 197,003,628552,Dumitriu; Ioana,9998,0,9999,1
1714619881129,MCWP 40R,A00,518780,Staff,2,0,20,18
1714619881129,MCWP 40R,B00,518781,Staff,8,0,20,12
1714619881129,MCWP 40R,C00,518783,Staff,6,0,20,14
1714619882156,MCWP 50R,A00,518791,Staff,0,0,20,20
1714619882156,MCWP 50R,B00,518792,Staff,0,2,20,20
1714619882156,MCWP 50R,C00,518793,Staff,0,2,20,20
1714619882156,MCWP 50R,D00,518794,Staff,0,0,20,20
1714619882156,MCWP 50R,E00,518795,Staff,0,2,20,20
1714619882156,MCWP 50R,F00,518796,Staff,0,0,20,20
1714619882156,MCWP 50R,G00,518797,Staff,0,1,20,20
1714619883183,MMW 12R,A01,514034,Herbst; Matthew,0,0,16,16
1714619883183,MMW 12R,A02,514035,Herbst; Matthew,1,0,16,15
1714619884212,MMW 13R,A01,514037,Staff,0,4,16,16
1714619884212,MMW 13R,A02,514039,Staff,0,2,16,16
1714619884212,MMW 13R,A03,628519,Staff,0,2,16,16
1714619886261,SIO 295LS,A00,523233,Staff,10,0,30,20
1714619887290,SIO 295S,A00,523232,Staff,10,0,30,20
1714619888316,SIOC 290S,A01,637330,Merrifield; Mark A,23,0,30,7
1714619889343,SIOC 291S,A01,637333,Gabriel; Corey John,23,0,30,7
1714619890370,SOCI 117,A01,494376,Staff,0,4,5,5
1714619891397,WES 237B,A00,494380,Staff,9,0,20,11
1714619893469,AESE 279B,A00,494370,Wade; Jon P,0,0,33,33
1714619894498,AIP 197,001,627712,Vespa; Emanuel Ignacio,9998,0,9999,1
1714619895525,ANAR 135S,A00,494369,Braswell; Geoffrey E.,0,0,0,0
1714619896549,BENG 196,001,628496,Engler; Adam J.,9998,0,9999,1
1714619897580,CAT 124RS,A01,519847,Geibel; William,0,0,20,20
1714619898609,CAT 125RS,A01,515971,Geibel; William,0,0,20,20
1714619899633,CLRE 250,A00,511389,Morris; Sheldon,9993,0,9999,6
1714619900659,CLRE 251,A00,507176,Mehta; Ravindra L.,9993,0,9999,6
1714619900659,CLRE 251,B00,511410,Mehta; Ravindra L.,9998,0,9999,1
1714619901684,CLRE 252,A00,507189,Cuomo; Raphael Eduardo,9995,0,9999,4
1714619902711,CLRE 253,A00,507199,Vaida; Florin,9994,0,9999,5
1714619902711,CLRE 253,B00,507202,Vaida; Florin,9999,0,9999,0
1714619903736,CLRE 259,A00,507211,Patel; Hemal,9996,0,9999,3
1714619904761,CLRE 260,A00,507221,Cuomo; Raphael Eduardo,9999,0,9999,0
1714619905789,CLRE 297,001,507242,Cuomo; Raphael Eduardo,9999,0,9999,0
1714619906814,COGS 197,001,638244,Voytek; Bradley Thomas,9998,0,9999,1
1714619907842,CSE 191,A00,516875,Minnes Kemp; Mor Mia,9992,0,9999,7
1714619908867,CSE 197,001,637388,Minnes Kemp; Mor Mia,9998,0,9999,1
1714619909892,CSS 201S,A01,494383,Staff,35,0,35,0
1714619910916,CSS 202S,A01,494387,Staff,35,0,35,0
1714619911940,DSC 197,001,628532,Eldridge; Justin Matthew,9996,0,9999,3
1714619912965,EAP 100,A00,516065,Staff,9797,0,9999,202
1714619913989,ECE 45,A01,507414,Staff,33,0,60,27
1714619916040,ECE 111,A01,507420,Staff,15,0,50,35
1714619917069,ECE 197,001,548057,Sievenpiper; Daniel F.,9993,0,9999,6
1714619918098,EDS 115,A00,507243,Choi; Bailey Miyeon,10,0,28,18
1714619919123,EDS 117,A01,494379,Staff,1,5,30,29
1714619920151,EDS 125,A00,507246,Hopkins; Megan Beth,9,0,30,21
1714619921179,EDS 128A,A01,507264,Fargason; Sharon Gayle,8,0,26,18
1714619922205,EDS 128B,A01,507293,Pappas; Elizabeth,12,0,30,18
1714619923230,EDS 139,A00,507294,Fargason; Sharon Gayle,13,0,30,17
1714619923230,EDS 139,B00,507313,Pappas; Elizabeth,13,0,30,17
1714619924307,EDS 201,A00,507315,Staff,13,0,30,17
1714619925333,EDS 203,A01,507317,Halter; Christopher P.,12,0,30,18
1714619926359,EDS 204R,A01,507319,Halter; Christopher P.,0,3,30,30
1714619926359,EDS 204R,B01,507331,Heinzman; Erica M.,16,0,30,14
1714619927385,EDS 206R,A00,507332,Staff,0,4,30,30
1714619927385,EDS 206R,B00,507343,Staff,17,0,30,13
1714619928412,EDS 250,A00,507344,Hemans; Patricia Ann Benitez,22,0,40,18
1714619929437,EDS 281,A00,507345,Daly; Alan J.,18,0,18,0
1714619930465,EDS 284,A00,507350,Daly; Alan J.,16,0,16,0
1714619931491,EDS 286,A00,507359,Fine; Sarah,18,0,18,0
1714619932518,EDS 289C,A01,507361,Daly; Alan J.,18,0,18,0
1714619933544,EDS 290,A00,507366,Hofstetter; Carolyn,15,0,15,0
1714619934571,LIGM 5A,A00,507421,Fischer-Grunski; Eva K,18,0,20,2
1714619935597,LIGM 5B,A00,507423,Fischer-Grunski; Eva K,19,0,20,1
1714619936623,LIGM 5C,A00,507425,Fischer-Grunski; Eva K,19,0,20,1
1714619937648,LIIT 5AS,A00,507427,Carnelos; Chiara,20,0,20,0
1714619938671,LIIT 5BS,A00,507430,Carnelos; Chiara,20,0,20,0
1714619939696,LIIT 5CS,A00,507432,Carnelos; Chiara,20,0,20,0
1714619940723,LISP 5A,A00,507541,Munoz Sanchez; Alicia,11,0,20,9
1714619941748,LISP 5B,A00,507671,Munoz Sanchez; Alicia,8,0,20,12
1714619942774,LISP 5C,A00,507696,Munoz Sanchez; Alicia,9,0,20,11
1714619943800,MAE 197,001,528363,Boechler; Nicholas Sebastia,9998,0,9999,1
1714619944825,MATH 197,001,523477,Kedlaya; Kiran S.,9995,0,9999,4
1714619944825,MATH 197,002,563811,Zhang; Danna,9995,0,9999,4
1714619944825,MATH 197,003,628552,Dumitriu; Ioana,9998,0,9999,1
1714619945849,MCWP 40R,A00,518780,Staff,2,0,20,18
1714619945849,MCWP 40R,B00,518781,Staff,8,0,20,12
1714619945849,MCWP 40R,C00,518783,Staff,6,0,20,14
1714619946878,MCWP 50R,A00,518791,Staff,0,0,20,20
1714619946878,MCWP 50R,B00,518792,Staff,0,2,20,20
1714619946878,MCWP 50R,C00,518793,Staff,0,2,20,20
1714619946878,MCWP 50R,D00,518794,Staff,0,0,20,20
1714619946878,MCWP 50R,E00,518795,Staff,0,2,20,20
1714619946878,MCWP 50R,F00,518796,Staff,0,0,20,20
1714619946878,MCWP 50R,G00,518797,Staff,0,1,20,20
1714619947903,MMW 12R,A01,514034,Herbst; Matthew,0,0,16,16
1714619947903,MMW 12R,A02,514035,Herbst; Matthew,1,0,16,15
1714619948930,MMW 13R,A01,514037,Staff,0,4,16,16
1714619948930,MMW 13R,A02,514039,Staff,0,2,16,16
1714619948930,MMW 13R,A03,628519,Staff,0,2,16,16
1714619951036,SIO 295LS,A00,523233,Staff,10,0,30,20
1714619952064,SIO 295S,A00,523232,Staff,10,0,30,20
1714619953091,SIOC 290S,A01,637330,Merrifield; Mark A,23,0,30,7
1714619954121,SIOC 291S,A01,637333,Gabriel; Corey John,23,0,30,7
1714619955145,SOCI 117,A01,494376,Staff,0,4,5,5
1714619956175,WES 237B,A00,494380,Staff,9,0,20,11
1714619958248,AESE 279B,A00,494370,Wade; Jon P,0,0,33,33
1714619959274,AIP 197,001,627712,Vespa; Emanuel Ignacio,9998,0,9999,1
1714619960301,ANAR 135S,A00,494369,Braswell; Geoffrey E.,0,0,0,0
1714619961325,BENG 196,001,628496,Engler; Adam J.,9998,0,9999,1
1714619962349,CAT 124RS,A01,519847,Geibel; William,0,0,20,20
1714619963375,CAT 125RS,A01,515971,Geibel; William,0,0,20,20
1714619964401,CLRE 250,A00,511389,Morris; Sheldon,9993,0,9999,6
1714619965432,CLRE 251,A00,507176,Mehta; Ravindra L.,9993,0,9999,6
1714619965432,CLRE 251,B00,511410,Mehta; Ravindra L.,9998,0,9999,1
1714619966457,CLRE 252,A00,507189,Cuomo; Raphael Eduardo,9995,0,9999,4
1714619967486,CLRE 253,A00,507199,Vaida; Florin,9994,0,9999,5
1714619967486,CLRE 253,B00,507202,Vaida; Florin,9999,0,9999,0
1714619968512,CLRE 259,A00,507211,Patel; Hemal,9996,0,9999,3
1714619969540,CLRE 260,A00,507221,Cuomo; Raphael Eduardo,9999,0,9999,0
1714619970565,CLRE 297,001,507242,Cuomo; Raphael Eduardo,9999,0,9999,0
1714619971592,COGS 197,001,638244,Voytek; Bradley Thomas,9998,0,9999,1
1714619972621,CSE 191,A00,516875,Minnes Kemp; Mor Mia,9992,0,9999,7
1714619973646,CSE 197,001,637388,Minnes Kemp; Mor Mia,9998,0,9999,1
1714619974675,CSS 201S,A01,494383,Staff,35,0,35,0
1714619975704,CSS 202S,A01,494387,Staff,35,0,35,0
1714619976729,DSC 197,001,628532,Eldridge; Justin Matthew,9996,0,9999,3
1714619977756,EAP 100,A00,516065,Staff,9797,0,9999,202
1714619978785,ECE 45,A01,507414,Staff,33,0,60,27
1714619980834,ECE 111,A01,507420,Staff,15,0,50,35
1714619981858,ECE 197,001,548057,Sievenpiper; Daniel F.,9993,0,9999,6
1714619982887,EDS 115,A00,507243,Choi; Bailey Miyeon,10,0,28,18
1714619983915,EDS 117,A01,494379,Staff,1,5,30,29
1714619984940,EDS 125,A00,507246,Hopkins; Megan Beth,9,0,30,21
1714619985966,EDS 128A,A01,507264,Fargason; Sharon Gayle,8,0,26,18
1714619986993,EDS 128B,A01,507293,Pappas; Elizabeth,12,0,30,18
1714619988018,EDS 139,A00,507294,Fargason; Sharon Gayle,13,0,30,17
1714619988018,EDS 139,B00,507313,Pappas; Elizabeth,13,0,30,17
1714619989042,EDS 201,A00,507315,Staff,13,0,30,17
1714619990070,EDS 203,A01,507317,Halter; Christopher P.,12,0,30,18
1714619991099,EDS 204R,A01,507319,Halter; Christopher P.,0,3,30,30
1714619991099,EDS 204R,B01,507331,Heinzman; Erica M.,16,0,30,14
1714619992124,EDS 206R,A00,507332,Staff,0,4,30,30
1714619992124,EDS 206R,B00,507343,Staff,17,0,30,13
1714619993153,EDS 250,A00,507344,Hemans; Patricia Ann Benitez,22,0,40,18
1714619994178,EDS 281,A00,507345,Daly; Alan J.,18,0,18,0
1714619995202,EDS 284,A00,507350,Daly; Alan J.,16,0,16,0
1714619996242,EDS 286,A00,507359,Fine; Sarah,18,0,18,0
1714619997269,EDS 289C,A01,507361,Daly; Alan J.,18,0,18,0
1714619998297,EDS 290,A00,507366,Hofstetter; Carolyn,15,0,15,0
1714619999322,LIGM 5A,A00,507421,Fischer-Grunski; Eva K,18,0,20,2
1714620000352,LIGM 5B,A00,507423,Fischer-Grunski; Eva K,19,0,20,1
1714620001377,LIGM 5C,A00,507425,Fischer-Grunski; Eva K,19,0,20,1
1714620002405,LIIT 5AS,A00,507427,Carnelos; Chiara,20,0,20,0
1714620003433,LIIT 5BS,A00,507430,Carnelos; Chiara,20,0,20,0
1714620004459,LIIT 5CS,A00,507432,Carnelos; Chiara,20,0,20,0
1714620005489,LISP 5A,A00,507541,Munoz Sanchez; Alicia,11,0,20,9
1714620006518,LISP 5B,A00,507671,Munoz Sanchez; Alicia,8,0,20,12
1714620007541,LISP 5C,A00,507696,Munoz Sanchez; Alicia,9,0,20,11
1714620008612,MAE 197,001,528363,Boechler; Nicholas Sebastia,9998,0,9999,1
1714620009647,MATH 197,001,523477,Kedlaya; Kiran S.,9995,0,9999,4
1714620009647,MATH 197,002,563811,Zhang; Danna,9995,0,9999,4
1714620009647,MATH 197,003,628552,Dumitriu; Ioana,9998,0,9999,1
1714620010672,MCWP 40R,A00,518780,Staff,2,0,20,18
1714620010672,MCWP 40R,B00,518781,Staff,8,0,20,12
1714620010672,MCWP 40R,C00,518783,Staff,6,0,20,14
1714620011698,MCWP 50R,A00,518791,Staff,0,0,20,20
1714620011698,MCWP 50R,B00,518792,Staff,0,2,20,20
1714620011698,MCWP 50R,C00,518793,Staff,0,2,20,20
1714620011698,MCWP 50R,D00,518794,Staff,0,0,20,20
1714620011698,MCWP 50R,E00,518795,Staff,0,2,20,20
1714620011698,MCWP 50R,F00,518796,Staff,0,0,20,20
1714620011698,MCWP 50R,G00,518797,Staff,0,1,20,20
1714620012728,MMW 12R,A01,514034,Herbst; Matthew,0,0,16,16
1714620012728,MMW 12R,A02,514035,Herbst; Matthew,1,0,16,15
1714620013751,MMW 13R,A01,514037,Staff,0,4,16,16
1714620013751,MMW 13R,A02,514039,Staff,0,2,16,16
1714620013751,MMW 13R,A03,628519,Staff,0,2,16,16
1714620015804,SIO 295LS,A00,523233,Staff,10,0,30,20
1714620016829,SIO 295S,A00,523232,Staff,10,0,30,20
1714620017855,SIOC 290S,A01,637330,Merrifield; Mark A,23,0,30,7
1714620018881,SIOC 291S,A01,637333,Gabriel; Corey John,23,0,30,7
1714620019907,SOCI 117,A01,494376,Staff,0,4,5,5
1714620020934,WES 237B,A00,494380,Staff,9,0,20,11
1714620023018,AESE 279B,A00,494370,Wade; Jon P,0,0,33,33
1714620024045,AIP 197,001,627712,Vespa; Emanuel Ignacio,9998,0,9999,1
1714620025069,ANAR 135S,A00,494369,Braswell; Geoffrey E.,0,0,0,0
1714620026095,BENG 196,001,628496,Engler; Adam J.,9998,0,9999,1
1714620027119,CAT 124RS,A01,519847,Geibel; William,0,0,20,20
1714620028144,CAT 125RS,A01,515971,Geibel; William,0,0,20,20
1714620029171,CLRE 250,A00,511389,Morris; Sheldon,9993,0,9999,6
1714620030198,CLRE 251,A00,507176,Mehta; Ravindra L.,9993,0,9999,6
1714620030198,CLRE 251,B00,511410,Mehta; Ravindra L.,9998,0,9999,1
1714620031223,CLRE 252,A00,507189,Cuomo; Raphael Eduardo,9995,0,9999,4
1714620032296,CLRE 253,A00,507199,Vaida; Florin,9994,0,9999,5
1714620032296,CLRE 253,B00,507202,Vaida; Florin,9999,0,9999,0
1714620033324,CLRE 259,A00,507211,Patel; Hemal,9996,0,9999,3
1714620034352,CLRE 260,A00,507221,Cuomo; Raphael Eduardo,9999,0,9999,0
1714620035376,CLRE 297,001,507242,Cuomo; Raphael Eduardo,9999,0,9999,0
1714620036401,COGS 197,001,638244,Voytek; Bradley Thomas,9998,0,9999,1
1714620037428,CSE 191,A00,516875,Minnes Kemp; Mor Mia,9992,0,9999,7
1714620038456,CSE 197,001,637388,Minnes Kemp; Mor Mia,9998,0,9999,1
1714620039482,CSS 201S,A01,494383,Staff,35,0,35,0
1714620040506,CSS 202S,A01,494387,Staff,35,0,35,0
1714620041535,DSC 197,001,628532,Eldridge; Justin Matthew,9996,0,9999,3
1714620042558,EAP 100,A00,516065,Staff,9797,0,9999,202
1714620043652,ECE 45,A01,507414,Staff,33,0,60,27
1714620045705,ECE 111,A01,507420,Staff,15,0,50,35
1714620046731,ECE 197,001,548057,Sievenpiper; Daniel F.,9993,0,9999,6
1714620047757,EDS 115,A00,507243,Choi; Bailey Miyeon,10,0,28,18
1714620048783,EDS 117,A01,494379,Staff,1,5,30,29
1714620049810,EDS 125,A00,507246,Hopkins; Megan Beth,9,0,30,21
1714620050837,EDS 128A,A01,507264,Fargason; Sharon Gayle,8,0,26,18
1714620051862,EDS 128B,A01,507293,Pappas; Elizabeth,12,0,30,18
1714620052889,EDS 139,A00,507294,Fargason; Sharon Gayle,13,0,30,17
1714620052889,EDS 139,B00,507313,Pappas; Elizabeth,13,0,30,17
1714620053916,EDS 201,A00,507315,Staff,13,0,30,17
1714620054945,EDS 203,A01,507317,Halter; Christopher P.,12,0,30,18
1714620055971,EDS 204R,A01,507319,Halter; Christopher P.,0,3,30,30
1714620055971,EDS 204R,B01,507331,Heinzman; Erica M.,16,0,30,14
1714620056997,EDS 206R,A00,507332,Staff,0,4,30,30
1714620056997,EDS 206R,B00,507343,Staff,17,0,30,13
1714620058023,EDS 250,A00,507344,Hemans; Patricia Ann Benitez,22,0,40,18
1714620059051,EDS 281,A00,507345,Daly; Alan J.,18,0,18,0
1714620060079,EDS 284,A00,507350,Daly; Alan J.,16,0,16,0
1714620061108,EDS 286,A00,507359,Fine; Sarah,18,0,18,0
1714620062132,EDS 289C,A01,507361,Daly; Alan J.,18,0,18,0
1714620063158,EDS 290,A00,507366,Hofstetter; Carolyn,15,0,15,0
1714620064186,LIGM 5A,A00,507421,Fischer-Grunski; Eva K,18,0,20,2
1714620065214,LIGM 5B,A00,507423,Fischer-Grunski; Eva K,19,0,20,1
1714620066240,LIGM 5C,A00,507425,Fischer-Grunski; Eva K,19,0,20,1
1714620067271,LIIT 5AS,A00,507427,Carnelos; Chiara,20,0,20,0
1714620068294,LIIT 5BS,A00,507430,Carnelos; Chiara,20,0,20,0
1714620069323,LIIT 5CS,A00,507432,Carnelos; Chiara,20,0,20,0
1714620070347,LISP 5A,A00,507541,Munoz Sanchez; Alicia,11,0,20,9
1714620071372,LISP 5B,A00,507671,Munoz Sanchez; Alicia,8,0,20,12
1714620072398,LISP 5C,A00,507696,Munoz Sanchez; Alicia,9,0,20,11
1714620073423,MAE 197,001,528363,Boechler; Nicholas Sebastia,9998,0,9999,1
1714620074450,MATH 197,001,523477,Kedlaya; Kiran S.,9995,0,9999,4
1714620074450,MATH 197,002,563811,Zhang; Danna,9995,0,9999,4
1714620074450,MATH 197,003,628552,Dumitriu; Ioana,9998,0,9999,1
1714620075477,MCWP 40R,A00,518780,Staff,2,0,20,18
1714620075477,MCWP 40R,B00,518781,Staff,8,0,20,12
1714620075477,MCWP 40R,C00,518783,Staff,6,0,20,14
1714620076501,MCWP 50R,A00,518791,Staff,0,0,20,20
1714620076501,MCWP 50R,B00,518792,Staff,0,2,20,20
1714620076501,MCWP 50R,C00,518793,Staff,0,2,20,20
1714620076501,MCWP 50R,D00,518794,Staff,0,0,20,20
1714620076501,MCWP 50R,E00,518795,Staff,0,2,20,20
1714620076501,MCWP 50R,F00,518796,Staff,0,0,20,20
1714620076501,MCWP 50R,G00,518797,Staff,0,1,20,20
1714620077529,MMW 12R,A01,514034,Herbst; Matthew,0,0,16,16
1714620077529,MMW 12R,A02,514035,Herbst; Matthew,1,0,16,15
1714620078553,MMW 13R,A01,514037,Staff,0,4,16,16
1714620078553,MMW 13R,A02,514039,Staff,0,2,16,16
1714620078553,MMW 13R,A03,628519,Staff,0,2,16,16
1714620080609,SIO 295LS,A00,523233,Staff,10,0,30,20
1714620081635,SIO 295S,A00,523232,Staff,10,0,30,20
1714620082661,SIOC 290S,A01,637330,Merrifield; Mark A,23,0,30,7
1714620083686,SIOC 291S,A01,637333,Gabriel; Corey John,23,0,30,7
1714620084714,SOCI 117,A01,494376,Staff,0,4,5,5
1714620085740,WES 237B,A00,494380,Staff,9,0,20,11
1714620087820,AESE 279B,A00,494370,Wade; Jon P,0,0,33,33
1714620088847,AIP 197,001,627712,Vespa; Emanuel Ignacio,9998,0,9999,1
1714620089873,ANAR 135S,A00,494369,Braswell; Geoffrey E.,0,0,0,0
1714620090898,BENG 196,001,628496,Engler; Adam J.,9998,0,9999,1
1714620091924,CAT 124RS,A01,519847,Geibel; William,0,0,20,20
1714620092950,CAT 125RS,A01,515971,Geibel; William,0,0,20,20
1714620093976,CLRE 250,A00,511389,Morris; Sheldon,9993,0,9999,6
1714620095007,CLRE 251,A00,507176,Mehta; Ravindra L.,9993,0,9999,6
1714620095007,CLRE 251,B00,511410,Mehta; Ravindra L.,9998,0,9999,1
1714620096033,CLRE 252,A00,507189,Cuomo; Raphael Eduardo,9995,0,9999,4
1714620097062,CLRE 253,A00,507199,Vaida; Florin,9994,0,9999,5
1714620097062,CLRE 253,B00,507202,Vaida; Florin,9999,0,9999,0
1714620098088,CLRE 259,A00,507211,Patel; Hemal,9996,0,9999,3
1714620099112,CLRE 260,A00,507221,Cuomo; Raphael Eduardo,9999,0,9999,0
1714620100134,CLRE 297,001,507242,Cuomo; Raphael Eduardo,9999,0,9999,0
1714620101163,COGS 197,001,638244,Voytek; Bradley Thomas,9998,0,9999,1
1714620102188,CSE 191,A00,516875,Minnes Kemp; Mor Mia,9992,0,9999,7
1714620103216,CSE 197,001,637388,Minnes Kemp; Mor Mia,9998,0,9999,1
1714620104241,CSS 201S,A01,494383,Staff,35,0,35,0
1714620105270,CSS 202S,A01,494387,Staff,35,0,35,0
1714620106294,DSC 197,001,628532,Eldridge; Justin Matthew,9996,0,9999,3
1714620107320,EAP 100,A00,516065,Staff,9797,0,9999,202
1714620108344,ECE 45,A01,507414,Staff,33,0,60,27
1714620110397,ECE 111,A01,507420,Staff,15,0,50,35
1714620111427,ECE 197,001,548057,Sievenpiper; Daniel F.,9993,0,9999,6
1714620112452,EDS 115,A00,507243,Choi; Bailey Miyeon,10,0,28,18
1714620113477,EDS 117,A01,494379,Staff,1,5,30,29
1714620114500,EDS 125,A00,507246,Hopkins; Megan Beth,9,0,30,21
1714620115527,EDS 128A,A01,507264,Fargason; Sharon Gayle,8,0,26,18
1714620116556,EDS 128B,A01,507293,Pappas; Elizabeth,12,0,30,18
1714620117583,EDS 139,A00,507294,Fargason; Sharon Gayle,13,0,30,17
1714620117583,EDS 139,B00,507313,Pappas; Elizabeth,13,0,30,17
1714620118611,EDS 201,A00,507315,Staff,13,0,30,17
1714620119638,EDS 203,A01,507317,Halter; Christopher P.,12,0,30,18
1714620120667,EDS 204R,A01,507319,Halter; Christopher P.,0,3,30,30
1714620120667,EDS 204R,B01,507331,Heinzman; Erica M.,16,0,30,14
1714620121692,EDS 206R,A00,507332,Staff,0,4,30,30
1714620121692,EDS 206R,B00,507343,Staff,17,0,30,13
1714620122717,EDS 250,A00,507344,Hemans; Patricia Ann Benitez,22,0,40,18
1714620123745,EDS 281,A00,507345,Daly; Alan J.,18,0,18,0
1714620124772,EDS 284,A00,507350,Daly; Alan J.,16,0,16,0
1714620125802,EDS 286,A00,507359,Fine; Sarah,18,0,18,0
1714620126826,EDS 289C,A01,507361,Daly; Alan J.,18,0,18,0
1714620127852,EDS 290,A00,507366,Hofstetter; Carolyn,15,0,15,0
1714620128876,LIGM 5A,A00,507421,Fischer-Grunski; Eva K,18,0,20,2
1714620129905,LIGM 5B,A00,507423,Fischer-Grunski; Eva K,19,0,20,1
1714620130930,LIGM 5C,A00,507425,Fischer-Grunski; Eva K,19,0,20,1
1714620131955,LIIT 5AS,A00,507427,Carnelos; Chiara,20,0,20,0
1714620132983,LIIT 5BS,A00,507430,Carnelos; Chiara,20,0,20,0
1714620134009,LIIT 5CS,A00,507432,Carnelos; Chiara,20,0,20,0
1714620135034,LISP 5A,A00,507541,Munoz Sanchez; Alicia,11,0,20,9
1714620136060,LISP 5B,A00,507671,Munoz Sanchez; Alicia,8,0,20,12
1714620137086,LISP 5C,A00,507696,Munoz Sanchez; Alicia,9,0,20,11
1714620138109,MAE 197,001,528363,Boechler; Nicholas Sebastia,9998,0,9999,1
1714620139139,MATH 197,001,523477,Kedlaya; Kiran S.,9995,0,9999,4
1714620139139,MATH 197,002,563811,Zhang; Danna,9995,0,9999,4
1714620139139,MATH 197,003,628552,Dumitriu; Ioana,9998,0,9999,1
1714620140165,MCWP 40R,A00,518780,Staff,2,0,20,18
1714620140165,MCWP 40R,B00,518781,Staff,8,0,20,12
1714620140165,MCWP 40R,C00,518783,Staff,6,0,20,14
1714620141195,MCWP 50R,A00,518791,Staff,0,0,20,20
1714620141195,MCWP 50R,B00,518792,Staff,0,2,20,20
1714620141195,MCWP 50R,C00,518793,Staff,0,2,20,20
1714620141195,MCWP 50R,D00,518794,Staff,0,0,20,20
1714620141195,MCWP 50R,E00,518795,Staff,0,2,20,20
1714620141195,MCWP 50R,F00,518796,Staff,0,0,20,20
1714620141195,MCWP 50R,G00,518797,Staff,0,1,20,20
1714620142220,MMW 12R,A01,514034,Herbst; Matthew,0,0,16,16
1714620142220,MMW 12R,A02,514035,Herbst; Matthew,1,0,16,15
1714620143245,MMW 13R,A01,514037,Staff,0,4,16,16
1714620143245,MMW 13R,A02,514039,Staff,0,2,16,16
1714620143245,MMW 13R,A03,628519,Staff,0,2,16,16
1714620145303,SIO 295LS,A00,523233,Staff,10,0,30,20
1714620146328,SIO 295S,A00,523232,Staff,10,0,30,20
1714620147357,SIOC 290S,A01,637330,Merrifield; Mark A,23,0,30,7
1714620148380,SIOC 291S,A01,637333,Gabriel; Corey John,23,0,30,7
1714620149410,SOCI 117,A01,494376,Staff,0,4,5,5
1714620150438,WES 237B,A00,494380,Staff,9,0,20,11
1714620152509,AESE 279B,A00,494370,Wade; Jon P,0,0,33,33
1714620153537,AIP 197,001,627712,Vespa; Emanuel Ignacio,9998,0,9999,1
1714620154562,ANAR 135S,A00,494369,Braswell; Geoffrey E.,0,0,0,0
1714620155588,BENG 196,001,628496,Engler; Adam J.,9998,0,9999,1
1714620156617,CAT 124RS,A01,519847,Geibel; William,0,0,20,20
1714620157645,CAT 125RS,A01,515971,Geibel; William,0,0,20,20
1714620158670,CLRE 250,A00,511389,Morris; Sheldon,9993,0,9999,6
1714620159697,CLRE 251,A00,507176,Mehta; Ravindra L.,9993,0,9999,6
1714620159697,CLRE 251,B00,511410,Mehta; Ravindra L.,9998,0,9999,1
1714620160722,CLRE 252,A00,507189,Cuomo; Raphael Eduardo,9995,0,9999,4
1714620161749,CLRE 253,A00,507199,Vaida; Florin,9994,0,9999,5
1714620161749,CLRE 253,B00,507202,Vaida; Florin,9999,0,9999,0
1714620162775,CLRE 259,A00,507211,Patel; Hemal,9996,0,9999,3
1714620163802,CLRE 260,A00,507221,Cuomo; Raphael Eduardo,9999,0,9999,0
1714620164829,CLRE 297,001,507242,Cuomo; Raphael Eduardo,9999,0,9999,0
1714620165854,COGS 197,001,638244,Voytek; Bradley Thomas,9998,0,9999,1
1714620166879,CSE 191,A00,516875,Minnes Kemp; Mor Mia,9992,0,9999,7
1714620167904,CSE 197,001,637388,Minnes Kemp; Mor Mia,9998,0,9999,1
1714620168931,CSS 201S,A01,494383,Staff,35,0,35,0
1714620169959,CSS 202S,A01,494387,Staff,35,0,35,0
1714620170985,DSC 197,001,628532,Eldridge; Justin Matthew,9996,0,9999,3
1714620172012,EAP 100,A00,516065,Staff,9797,0,9999,202
1714620173041,ECE 45,A01,507414,Staff,33,0,60,27
1714620175090,ECE 111,A01,507420,Staff,15,0,50,35
1714620176119,ECE 197,001,548057,Sievenpiper; Daniel F.,9993,0,9999,6
1714620177144,EDS 115,A00,507243,Choi; Bailey Miyeon,10,0,28,18
1714620178169,EDS 117,A01,494379,Staff,1,5,30,29
1714620179197,EDS 125,A00,507246,Hopkins; Megan Beth,9,0,30,21
1714620180227,EDS 128A,A01,507264,Fargason; Sharon Gayle,8,0,26,18
1714620181253,EDS 128B,A01,507293,Pappas; Elizabeth,12,0,30,18
1714620182282,EDS 139,A00,507294,Fargason; Sharon Gayle,13,0,30,17
1714620182282,EDS 139,B00,507313,Pappas; Elizabeth,13,0,30,17
1714620183309,EDS 201,A00,507315,Staff,13,0,30,17
1714620184339,EDS 203,A01,507317,Halter; Christopher P.,12,0,30,18
1714620185370,EDS 204R,A01,507319,Halter; Christopher P.,0,3,30,30
1714620185370,EDS 204R,B01,507331,Heinzman; Erica M.,16,0,30,14
1714620186394,EDS 206R,A00,507332,Staff,0,4,30,30
1714620186394,EDS 206R,B00,507343,Staff,17,0,30,13
1714620187421,EDS 250,A00,507344,Hemans; Patricia Ann Benitez,22,0,40,18
1714620188447,EDS 281,A00,507345,Daly; Alan J.,18,0,18,0
1714620189474,EDS 284,A00,507350,Daly; Alan J.,16,0,16,0
1714620190503,EDS 286,A00,507359,Fine; Sarah,18,0,18,0
1714620191527,EDS 289C,A01,507361,Daly; Alan J.,18,0,18,0
1714620192553,EDS 290,A00,507366,Hofstetter; Carolyn,15,0,15,0
1714620193584,LIGM 5A,A00,507421,Fischer-Grunski; Eva K,18,0,20,2
1714620194609,LIGM 5B,A00,507423,Fischer-Grunski; Eva K,19,0,20,1
1714620195635,LIGM 5C,A00,507425,Fischer-Grunski; Eva K,19,0,20,1
1714620196660,LIIT 5AS,A00,507427,Carnelos; Chiara,20,0,20,0
1714620197689,LIIT 5BS,A00,507430,Carnelos; Chiara,20,0,20,0
1714620198716,LIIT 5CS,A00,507432,Carnelos; Chiara,20,0,20,0
1714620199742,LISP 5A,A00,507541,Munoz Sanchez; Alicia,11,0,20,9
1714620200771,LISP 5B,A00,507671,Munoz Sanchez; Alicia,8,0,20,12
1714620201800,LISP 5C,A00,507696,Munoz Sanchez; Alicia,9,0,20,11
1714620202824,MAE 197,001,528363,Boechler; Nicholas Sebastia,9998,0,9999,1
1714620203852,MATH 197,001,523477,Kedlaya; Kiran S.,9995,0,9999,4
1714620203852,MATH 197,002,563811,Zhang; Danna,9995,0,9999,4
1714620203852,MATH 197,003,628552,Dumitriu; Ioana,9998,0,9999,1
1714620204877,MCWP 40R,A00,518780,Staff,2,0,20,18
1714620204877,MCWP 40R,B00,518781,Staff,8,0,20,12
1714620204877,MCWP 40R,C00,518783,Staff,6,0,20,14
1714620205903,MCWP 50R,A00,518791,Staff,0,0,20,20
1714620205903,MCWP 50R,B00,518792,Staff,0,2,20,20
1714620205903,MCWP 50R,C00,518793,Staff,0,2,20,20
1714620205903,MCWP 50R,D00,518794,Staff,0,0,20,20
1714620205903,MCWP 50R,E00,518795,Staff,0,2,20,20
1714620205903,MCWP 50R,F00,518796,Staff,0,0,20,20
1714620205903,MCWP 50R,G00,518797,Staff,0,1,20,20
1714620206929,MMW 12R,A01,514034,Herbst; Matthew,0,0,16,16
1714620206929,MMW 12R,A02,514035,Herbst; Matthew,1,0,16,15
1714620207956,MMW 13R,A01,514037,Staff,0,4,16,16
1714620207956,MMW 13R,A02,514039,Staff,0,2,16,16
1714620207956,MMW 13R,A03,628519,Staff,0,2,16,16
1714620210010,SIO 295LS,A00,523233,Staff,10,0,30,20
1714620211038,SIO 295S,A00,523232,Staff,10,0,30,20
1714620212066,SIOC 290S,A01,637330,Merrifield; Mark A,23,0,30,7
1714620213090,SIOC 291S,A01,637333,Gabriel; Corey John,23,0,30,7
1714620214119,SOCI 117,A01,494376,Staff,0,4,5,5
1714620215143,WES 237B,A00,494380,Staff,9,0,20,11
1714620217209,AESE 279B,A00,494370,Wade; Jon P,0,0,33,33
1714620218234,AIP 197,001,627712,Vespa; Emanuel Ignacio,9998,0,9999,1
1714620219261,ANAR 135S,A00,494369,Braswell; Geoffrey E.,0,0,0,0
1714620220285,BENG 196,001,628496,Engler; Adam J.,9998,0,9999,1
1714620221311,CAT 124RS,A01,519847,Geibel; William,0,0,20,20
1714620222390,CAT 125RS,A01,515971,Geibel; William,0,0,20,20
1714620223415,CLRE 250,A00,511389,Morris; Sheldon,9993,0,9999,6
1714620224442,CLRE 251,A00,507176,Mehta; Ravindra L.,9993,0,9999,6
1714620224442,CLRE 251,B00,511410,Mehta; Ravindra L.,9998,0,9999,1
1714620226011,CLRE 252,A00,507189,Cuomo; Raphael Eduardo,9995,0,9999,4
1714620227040,CLRE 253,A00,507199,Vaida; Florin,9994,0,9999,5
1714620227040,CLRE 253,B00,507202,Vaida; Florin,9999,0,9999,0
1714620228064,CLRE 259,A00,507211,Patel; Hemal,9996,0,9999,3
1714620229090,CLRE 260,A00,507221,Cuomo; Raphael Eduardo,9999,0,9999,0
1714620230114,CLRE 297,001,507242,Cuomo; Raphael Eduardo,9999,0,9999,0
1714620231138,COGS 197,001,638244,Voytek; Bradley Thomas,9998,0,9999,1
1714620232161,CSE 191,A00,516875,Minnes Kemp; Mor Mia,9992,0,9999,7
1714620233185,CSE 197,001,637388,Minnes Kemp; Mor Mia,9998,0,9999,1
1714620234213,CSS 201S,A01,494383,Staff,35,0,35,0
1714620235239,CSS 202S,A01,494387,Staff,35,0,35,0
1714620236263,DSC 197,001,628532,Eldridge; Justin Matthew,9996,0,9999,3
1714620237288,EAP 100,A00,516065,Staff,9797,0,9999,202
1714620238318,ECE 45,A01,507414,Staff,33,0,60,27
1714620240425,ECE 111,A01,507420,Staff,15,0,50,35
1714620241452,ECE 197,001,548057,Sievenpiper; Daniel F.,9993,0,9999,6
1714620242480,EDS 115,A00,507243,Choi; Bailey Miyeon,10,0,28,18
1714620243506,EDS 117,A01,494379,Staff,1,5,30,29
1714620244529,EDS 125,A00,507246,Hopkins; Megan Beth,9,0,30,21
1714620245554,EDS 128A,A01,507264,Fargason; Sharon Gayle,8,0,26,18
1714620246584,EDS 128B,A01,507293,Pappas; Elizabeth,12,0,30,18
1714620247608,EDS 139,A00,507294,Fargason; Sharon Gayle,13,0,30,17
1714620247608,EDS 139,B00,507313,Pappas; Elizabeth,13,0,30,17
1714620248633,EDS 201,A00,507315,Staff,13,0,30,17
1714620249657,EDS 203,A01,507317,Halter; Christopher P.,12,0,30,18
1714620250684,EDS 204R,A01,507319,Halter; Christopher P.,0,3,30,30
1714620250684,EDS 204R,B01,507331,Heinzman; Erica M.,16,0,30,14
1714620251711,EDS 206R,A00,507332,Staff,0,4,30,30
1714620251711,EDS 206R,B00,507343,Staff,17,0,30,13
1714620252736,EDS 250,A00,507344,Hemans; Patricia Ann Benitez,22,0,40,18
1714620253760,EDS 281,A00,507345,Daly; Alan J.,18,0,18,0
1714620254785,EDS 284,A00,507350,Daly; Alan J.,16,0,16,0
1714620255810,EDS 286,A00,507359,Fine; Sarah,18,0,18,0
1714620256835,EDS 289C,A01,507361,Daly; Alan J.,18,0,18,0
1714620257861,EDS 290,A00,507366,Hofstetter; Carolyn,15,0,15,0
1714620258891,LIGM 5A,A00,507421,Fischer-Grunski; Eva K,18,0,20,2
1714620259917,LIGM 5B,A00,507423,Fischer-Grunski; Eva K,19,0,20,1
1714620260943,LIGM 5C,A00,507425,Fischer-Grunski; Eva K,19,0,20,1
1714620261972,LIIT 5AS,A00,507427,Carnelos; Chiara,20,0,20,0
1714620262999,LIIT 5BS,A00,507430,Carnelos; Chiara,20,0,20,0
1714620264025,LIIT 5CS,A00,507432,Carnelos; Chiara,20,0,20,0
1714620265051,LISP 5A,A00,507541,Munoz Sanchez; Alicia,11,0,20,9
1714620266080,LISP 5B,A00,507671,Munoz Sanchez; Alicia,8,0,20,12
1714620267107,LISP 5C,A00,507696,Munoz Sanchez; Alicia,9,0,20,11
1714620268133,MAE 197,001,528363,Boechler; Nicholas Sebastia,9998,0,9999,1
1714620269158,MATH 197,001,523477,Kedlaya; Kiran S.,9995,0,9999,4
1714620269158,MATH 197,002,563811,Zhang; Danna,9995,0,9999,4
1714620269158,MATH 197,003,628552,Dumitriu; Ioana,9998,0,9999,1
1714620270184,MCWP 40R,A00,518780,Staff,2,0,20,18
1714620270184,MCWP 40R,B00,518781,Staff,8,0,20,12
1714620270184,MCWP 40R,C00,518783,Staff,6,0,20,14
1714620271210,MCWP 50R,A00,518791,Staff,0,0,20,20
1714620271210,MCWP 50R,B00,518792,Staff,0,2,20,20
1714620271210,MCWP 50R,C00,518793,Staff,0,2,20,20
1714620271210,MCWP 50R,D00,518794,Staff,0,0,20,20
1714620271210,MCWP 50R,E00,518795,Staff,0,2,20,20
1714620271210,MCWP 50R,F00,518796,Staff,0,0,20,20
1714620271210,MCWP 50R,G00,518797,Staff,0,1,20,20
1714620272234,MMW 12R,A01,514034,Herbst; Matthew,0,0,16,16
1714620272234,MMW 12R,A02,514035,Herbst; Matthew,1,0,16,15
1714620273259,MMW 13R,A01,514037,Staff,0,4,16,16
1714620273259,MMW 13R,A02,514039,Staff,0,2,16,16
1714620273259,MMW 13R,A03,628519,Staff,0,2,16,16
1714620275310,SIO 295LS,A00,523233,Staff,10,0,30,20
1714620276336,SIO 295S,A00,523232,Staff,10,0,30,20
1714620277363,SIOC 290S,A01,637330,Merrifield; Mark A,23,0,30,7
1714620278392,SIOC 291S,A01,637333,Gabriel; Corey John,23,0,30,7
1714620279416,SOCI 117,A01,494376,Staff,0,4,5,5
1714620280440,WES 237B,A00,494380,Staff,9,0,20,11
1714620282495,AESE 279B,A00,494370,Wade; Jon P,0,0,33,33
1714620283521,AIP 197,001,627712,Vespa; Emanuel Ignacio,9998,0,9999,1
1714620284563,ANAR 135S,A00,494369,Braswell; Geoffrey E.,0,0,0,0
1714620285589,BENG 196,001,628496,Engler; Adam J.,9998,0,9999,1
1714620286617,CAT 124RS,A01,519847,Geibel; William,0,0,20,20
1714620287643,CAT 125RS,A01,515971,Geibel; William,0,0,20,20
1714620288673,CLRE 250,A00,511389,Morris; Sheldon,9993,0,9999,6
1714620289698,CLRE 251,A00,507176,Mehta; Ravindra L.,9993,0,9999,6
1714620289698,CLRE 251,B00,511410,Mehta; Ravindra L.,9998,0,9999,1
1714620290725,CLRE 252,A00,507189,Cuomo; Raphael Eduardo,9995,0,9999,4
1714620291757,CLRE 253,A00,507199,Vaida; Florin,9994,0,9999,5
1714620291757,CLRE 253,B00,507202,Vaida; Florin,9999,0,9999,0
1714620292780,CLRE 259,A00,507211,Patel; Hemal,9996,0,9999,3
1714620293806,CLRE 260,A00,507221,Cuomo; Raphael Eduardo,9999,0,9999,0
1714620294832,CLRE 297,001,507242,Cuomo; Raphael Eduardo,9999,0,9999,0
1714620295858,COGS 197,001,638244,Voytek; Bradley Thomas,9998,0,9999,1
1714620296885,CSE 191,A00,516875,Minnes Kemp; Mor Mia,9992,0,9999,7
1714620297910,CSE 197,001,637388,Minnes Kemp; Mor Mia,9998,0,9999,1
1714620298939,CSS 201S,A01,494383,Staff,35,0,35,0
1714620299967,CSS 202S,A01,494387,Staff,35,0,35,0
1714620300992,DSC 197,001,628532,Eldridge; Justin Matthew,9996,0,9999,3
1714620302017,EAP 100,A00,516065,Staff,9797,0,9999,202
1714620303043,ECE 45,A01,507414,Staff,33,0,60,27
1714620305094,ECE 111,A01,507420,Staff,15,0,50,35
1714620306120,ECE 197,001,548057,Sievenpiper; Daniel F.,9993,0,9999,6
1714620307148,EDS 115,A00,507243,Choi; Bailey Miyeon,10,0,28,18
1714620308175,EDS 117,A01,494379,Staff,1,5,30,29
1714620309199,EDS 125,A00,507246,Hopkins; Megan Beth,9,0,30,21
1714620310222,EDS 128A,A01,507264,Fargason; Sharon Gayle,8,0,26,18
1714620311247,EDS 128B,A01,507293,Pappas; Elizabeth,12,0,30,18
1714620312270,EDS 139,A00,507294,Fargason; Sharon Gayle,13,0,30,17
1714620312270,EDS 139,B00,507313,Pappas; Elizabeth,13,0,30,17
1714620313296,EDS 201,A00,507315,Staff,13,0,30,17
1714620314322,EDS 203,A01,507317,Halter; Christopher P.,12,0,30,18
1714620315350,EDS 204R,A01,507319,Halter; Christopher P.,0,3,30,30
1714620315350,EDS 204R,B01,507331,Heinzman; Erica M.,16,0,30,14
1714620316379,EDS 206R,A00,507332,Staff,0,4,30,30
1714620316379,EDS 206R,B00,507343,Staff,17,0,30,13
1714620317404,EDS 250,A00,507344,Hemans; Patricia Ann Benitez,22,0,40,18
1714620318453,EDS 281,A00,507345,Daly; Alan J.,18,0,18,0
1714620319478,EDS 284,A00,507350,Daly; Alan J.,16,0,16,0
1714620320506,EDS 286,A00,507359,Fine; Sarah,18,0,18,0
1714620321530,EDS 289C,A01,507361,Daly; Alan J.,18,0,18,0
1714620322554,EDS 290,A00,507366,Hofstetter; Carolyn,15,0,15,0
1714620323579,LIGM 5A,A00,507421,Fischer-Grunski; Eva K,18,0,20,2
1714620324605,LIGM 5B,A00,507423,Fischer-Grunski; Eva K,19,0,20,1
1714620325634,LIGM 5C,A00,507425,Fischer-Grunski; Eva K,19,0,20,1
1714620326716,LIIT 5AS,A00,507427,Carnelos; Chiara,20,0,20,0
1714620327745,LIIT 5BS,A00,507430,Carnelos; Chiara,20,0,20,0
1714620328775,LIIT 5CS,A00,507432,Carnelos; Chiara,20,0,20,0
1714620329805,LISP 5A,A00,507541,Munoz Sanchez; Alicia,11,0,20,9
1714620330831,LISP 5B,A00,507671,Munoz Sanchez; Alicia,8,0,20,12
1714620331855,LISP 5C,A00,507696,Munoz Sanchez; Alicia,9,0,20,11
1714620332884,MAE 197,001,528363,Boechler; Nicholas Sebastia,9998,0,9999,1
1714620333909,MATH 197,001,523477,Kedlaya; Kiran S.,9995,0,9999,4
1714620333909,MATH 197,002,563811,Zhang; Danna,9995,0,9999,4
1714620333909,MATH 197,003,628552,Dumitriu; Ioana,9998,0,9999,1
1714620334936,MCWP 40R,A00,518780,Staff,2,0,20,18
1714620334936,MCWP 40R,B00,518781,Staff,8,0,20,12
1714620334936,MCWP 40R,C00,518783,Staff,6,0,20,14
1714620335962,MCWP 50R,A00,518791,Staff,0,0,20,20
1714620335962,MCWP 50R,B00,518792,Staff,0,2,20,20
1714620335962,MCWP 50R,C00,518793,Staff,0,2,20,20
1714620335962,MCWP 50R,D00,518794,Staff,0,0,20,20
1714620335962,MCWP 50R,E00,518795,Staff,0,2,20,20
1714620335962,MCWP 50R,F00,518796,Staff,0,0,20,20
1714620335962,MCWP 50R,G00,518797,Staff,0,1,20,20
1714620336991,MMW 12R,A01,514034,Herbst; Matthew,0,0,16,16
1714620336991,MMW 12R,A02,514035,Herbst; Matthew,1,0,16,15
1714620338019,MMW 13R,A01,514037,Staff,0,4,16,16
1714620338019,MMW 13R,A02,514039,Staff,0,2,16,16
1714620338019,MMW 13R,A03,628519,Staff,0,2,16,16
1714620340075,SIO 295LS,A00,523233,Staff,10,0,30,20
1714620341100,SIO 295S,A00,523232,Staff,10,0,30,20
1714620342125,SIOC 290S,A01,637330,Merrifield; Mark A,23,0,30,7
1714620343151,SIOC 291S,A01,637333,Gabriel; Corey John,23,0,30,7
1714620344178,SOCI 117,A01,494376,Staff,0,4,5,5
1714620345203,WES 237B,A00,494380,Staff,9,0,20,11
1714620347262,AESE 279B,A00,494370,Wade; Jon P,0,0,33,33
1714620348290,AIP 197,001,627712,Vespa; Emanuel Ignacio,9998,0,9999,1
1714620349317,ANAR 135S,A00,494369,Braswell; Geoffrey E.,0,0,0,0
1714620350342,BENG 196,001,628496,Engler; Adam J.,9998,0,9999,1
1714620351368,CAT 124RS,A01,519847,Geibel; William,0,0,20,20
1714620352396,CAT 125RS,A01,515971,Geibel; William,0,0,20,20
1714620353425,CLRE 250,A00,511389,Morris; Sheldon,9993,0,9999,6
1714620354453,CLRE 251,A00,507176,Mehta; Ravindra L.,9993,0,9999,6
1714620354453,CLRE 251,B00,511410,Mehta; Ravindra L.,9998,0,9999,1
1714620355478,CLRE 252,A00,507189,Cuomo; Raphael Eduardo,9995,0,9999,4
1714620356503,CLRE 253,A00,507199,Vaida; Florin,9994,0,9999,5
1714620356503,CLRE 253,B00,507202,Vaida; Florin,9999,0,9999,0
1714620357530,CLRE 259,A00,507211,Patel; Hemal,9996,0,9999,3
1714620358559,CLRE 260,A00,507221,Cuomo; Raphael Eduardo,9999,0,9999,0
1714620359583,CLRE 297,001,507242,Cuomo; Raphael Eduardo,9999,0,9999,0
1714620360611,COGS 197,001,638244,Voytek; Bradley Thomas,9998,0,9999,1
1714620361636,CSE 191,A00,516875,Minnes Kemp; Mor Mia,9992,0,9999,7
1714620362662,CSE 197,001,637388,Minnes Kemp; Mor Mia,9998,0,9999,1
1714620363691,CSS 201S,A01,494383,Staff,35,0,35,0
1714620364721,CSS 202S,A01,494387,Staff,35,0,35,0
1714620365747,DSC 197,001,628532,Eldridge; Justin Matthew,9996,0,9999,3
1714620366774,EAP 100,A00,516065,Staff,9797,0,9999,202
1714620367802,ECE 45,A01,507414,Staff,33,0,60,27
1714620369852,ECE 111,A01,507420,Staff,15,0,50,35
1714620370880,ECE 197,001,548057,Sievenpiper; Daniel F.,9993,0,9999,6
1714620371906,EDS 115,A00,507243,Choi; Bailey Miyeon,10,0,28,18
1714620372932,EDS 117,A01,494379,Staff,1,5,30,29
1714620373958,EDS 125,A00,507246,Hopkins; Megan Beth,9,0,30,21
1714620374986,EDS 128A,A01,507264,Fargason; Sharon Gayle,8,0,26,18
1714620376016,EDS 128B,A01,507293,Pappas; Elizabeth,12,0,30,18
1714620377044,EDS 139,A00,507294,Fargason; Sharon Gayle,13,0,30,17
1714620377044,EDS 139,B00,507313,Pappas; Elizabeth,13,0,30,17
1714620378069,EDS 201,A00,507315,Staff,13,0,30,17
1714620379098,EDS 203,A01,507317,Halter; Christopher P.,12,0,30,18
1714620380126,EDS 204R,A01,507319,Halter; Christopher P.,0,3,30,30
1714620380126,EDS 204R,B01,507331,Heinzman; Erica M.,16,0,30,14
1714620381156,EDS 206R,A00,507332,Staff,0,4,30,30
1714620381156,EDS 206R,B00,507343,Staff,17,0,30,13
1714620382180,EDS 250,A00,507344,Hemans; Patricia Ann Benitez,22,0,40,18
1714620383205,EDS 281,A00,507345,Daly; Alan J.,18,0,18,0
1714620384230,EDS 284,A00,507350,Daly; Alan J.,16,0,16,0
1714620385258,EDS 286,A00,507359,Fine; Sarah,18,0,18,0
1714620386287,EDS 289C,A01,507361,Daly; Alan J.,18,0,18,0
1714620387315,EDS 290,A00,507366,Hofstetter; Carolyn,15,0,15,0
1714620388342,LIGM 5A,A00,507421,Fischer-Grunski; Eva K,18,0,20,2
1714620389367,LIGM 5B,A00,507423,Fischer-Grunski; Eva K,19,0,20,1
1714620390392,LIGM 5C,A00,507425,Fischer-Grunski; Eva K,19,0,20,1
1714620391421,LIIT 5AS,A00,507427,Carnelos; Chiara,20,0,20,0
1714620392447,LIIT 5BS,A00,507430,Carnelos; Chiara,20,0,20,0
1714620393475,LIIT 5CS,A00,507432,Carnelos; Chiara,20,0,20,0
1714620394501,LISP 5A,A00,507541,Munoz Sanchez; Alicia,11,0,20,9
1714620395527,LISP 5B,A00,507671,Munoz Sanchez; Alicia,8,0,20,12
1714620396551,LISP 5C,A00,507696,Munoz Sanchez; Alicia,9,0,20,11
1714620397575,MAE 197,001,528363,Boechler; Nicholas Sebastia,9998,0,9999,1
1714620398603,MATH 197,001,523477,Kedlaya; Kiran S.,9995,0,9999,4
1714620398603,MATH 197,002,563811,Zhang; Danna,9995,0,9999,4
1714620398603,MATH 197,003,628552,Dumitriu; Ioana,9998,0,9999,1
1714620399633,MCWP 40R,A00,518780,Staff,2,0,20,18
1714620399633,MCWP 40R,B00,518781,Staff,8,0,20,12
1714620399633,MCWP 40R,C00,518783,Staff,6,0,20,14
1714620400663,MCWP 50R,A00,518791,Staff,0,0,20,20
1714620400663,MCWP 50R,B00,518792,Staff,0,2,20,20
1714620400663,MCWP 50R,C00,518793,Staff,0,2,20,20
1714620400663,MCWP 50R,D00,518794,Staff,0,0,20,20
1714620400663,MCWP 50R,E00,518795,Staff,0,2,20,20
1714620400663,MCWP 50R,F00,518796,Staff,0,0,20,20
1714620400663,MCWP 50R,G00,518797,Staff,0,1,20,20
1714620401688,MMW 12R,A01,514034,Herbst; Matthew,0,0,16,16
1714620401688,MMW 12R,A02,514035,Herbst; Matthew,1,0,16,15
1714620402713,MMW 13R,A01,514037,Staff,0,4,16,16
1714620402713,MMW 13R,A02,514039,Staff,0,2,16,16
1714620402713,MMW 13R,A03,628519,Staff,0,2,16,16
1714620404766,SIO 295LS,A00,523233,Staff,10,0,30,20
1714620405792,SIO 295S,A00,523232,Staff,10,0,30,20
1714620406819,SIOC 290S,A01,637330,Merrifield; Mark A,23,0,30,7
1714620407847,SIOC 291S,A01,637333,Gabriel; Corey John,23,0,30,7
1714620408874,SOCI 117,A01,494376,Staff,0,4,5,5
1714620409904,WES 237B,A00,494380,Staff,9,0,20,11
1714620411974,AESE 279B,A00,494370,Wade; Jon P,0,0,33,33
1714620413001,AIP 197,001,627712,Vespa; Emanuel Ignacio,9998,0,9999,1
1714620414028,ANAR 135S,A00,494369,Braswell; Geoffrey E.,0,0,0,0
1714620415054,BENG 196,001,628496,Engler; Adam J.,9998,0,9999,1
1714620416084,CAT 124RS,A01,519847,Geibel; William,0,0,20,20
1714620417111,CAT 125RS,A01,515971,Geibel; William,0,0,20,20
1714620418141,CLRE 250,A00,511389,Morris; Sheldon,9993,0,9999,6
1714620419172,CLRE 251,A00,507176,Mehta; Ravindra L.,9993,0,9999,6
1714620419172,CLRE 251,B00,511410,Mehta; Ravindra L.,9998,0,9999,1
1714620420203,CLRE 252,A00,507189,Cuomo; Raphael Eduardo,9995,0,9999,4
1714620421232,CLRE 253,A00,507199,Vaida; Florin,9994,0,9999,5
1714620421232,CLRE 253,B00,507202,Vaida; Florin,9999,0,9999,0
1714620422260,CLRE 259,A00,507211,Patel; Hemal,9996,0,9999,3
1714620423284,CLRE 260,A00,507221,Cuomo; Raphael Eduardo,9999,0,9999,0
1714620424309,CLRE 297,001,507242,Cuomo; Raphael Eduardo,9999,0,9999,0
1714620425336,COGS 197,001,638244,Voytek; Bradley Thomas,9998,0,9999,1
1714620426364,CSE 191,A00,516875,Minnes Kemp; Mor Mia,9992,0,9999,7
1714620427387,CSE 197,001,637388,Minnes Kemp; Mor Mia,9998,0,9999,1
1714620428413,CSS 201S,A01,494383,Staff,35,0,35,0
1714620429436,CSS 202S,A01,494387,Staff,35,0,35,0
1714620430461,DSC 197,001,628532,Eldridge; Justin Matthew,9996,0,9999,3
1714620431484,EAP 100,A00,516065,Staff,9797,0,9999,202
1714620432510,ECE 45,A01,507414,Staff,33,0,60,27
1714620434566,ECE 111,A01,507420,Staff,15,0,50,35
1714620435591,ECE 197,001,548057,Sievenpiper; Daniel F.,9993,0,9999,6
1714620436619,EDS 115,A00,507243,Choi; Bailey Miyeon,10,0,28,18
1714620437645,EDS 117,A01,494379,Staff,1,5,30,29
1714620438670,EDS 125,A00,507246,Hopkins; Megan Beth,9,0,30,21
1714620439696,EDS 128A,A01,507264,Fargason; Sharon Gayle,8,0,26,18
1714620440721,EDS 128B,A01,507293,Pappas; Elizabeth,12,0,30,18
1714620441745,EDS 139,A00,507294,Fargason; Sharon Gayle,13,0,30,17
1714620441745,EDS 139,B00,507313,Pappas; Elizabeth,13,0,30,17
1714620442822,EDS 201,A00,507315,Staff,13,0,30,17
1714620443865,EDS 203,A01,507317,Halter; Christopher P.,12,0,30,18
1714620444890,EDS 204R,A01,507319,Halter; Christopher P.,0,3,30,30
1714620444890,EDS 204R,B01,507331,Heinzman; Erica M.,16,0,30,14
1714620445914,EDS 206R,A00,507332,Staff,0,4,30,30
1714620445914,EDS 206R,B00,507343,Staff,17,0,30,13
1714620446940,EDS 250,A00,507344,Hemans; Patricia Ann Benitez,22,0,40,18
1714620447964,EDS 281,A00,507345,Daly; Alan J.,18,0,18,0
1714620448992,EDS 284,A00,507350,Daly; Alan J.,16,0,16,0
1714620450020,EDS 286,A00,507359,Fine; Sarah,18,0,18,0
1714620451044,EDS 289C,A01,507361,Daly; Alan J.,18,0,18,0
1714620452071,EDS 290,A00,507366,Hofstetter; Carolyn,15,0,15,0
1714620453103,LIGM 5A,A00,507421,Fischer-Grunski; Eva K,18,0,20,2
1714620454129,LIGM 5B,A00,507423,Fischer-Grunski; Eva K,19,0,20,1
1714620455153,LIGM 5C,A00,507425,Fischer-Grunski; Eva K,19,0,20,1
1714620456180,LIIT 5AS,A00,507427,Carnelos; Chiara,20,0,20,0
1714620457205,LIIT 5BS,A00,507430,Carnelos; Chiara,20,0,20,0
1714620458231,LIIT 5CS,A00,507432,Carnelos; Chiara,20,0,20,0
1714620459258,LISP 5A,A00,507541,Munoz Sanchez; Alicia,11,0,20,9
1714620460284,LISP 5B,A00,507671,Munoz Sanchez; Alicia,8,0,20,12
1714620461309,LISP 5C,A00,507696,Munoz Sanchez; Alicia,9,0,20,11
1714620462333,MAE 197,001,528363,Boechler; Nicholas Sebastia,9998,0,9999,1
1714620463364,MATH 197,001,523477,Kedlaya; Kiran S.,9995,0,9999,4
1714620463364,MATH 197,002,563811,Zhang; Danna,9995,0,9999,4
1714620463364,MATH 197,003,628552,Dumitriu; Ioana,9998,0,9999,1
1714620464392,MCWP 40R,A00,518780,Staff,2,0,20,18
1714620464392,MCWP 40R,B00,518781,Staff,8,0,20,12
1714620464392,MCWP 40R,C00,518783,Staff,6,0,20,14
1714620465418,MCWP 50R,A00,518791,Staff,0,0,20,20
1714620465418,MCWP 50R,B00,518792,Staff,0,2,20,20
1714620465418,MCWP 50R,C00,518793,Staff,0,2,20,20
1714620465418,MCWP 50R,D00,518794,Staff,0,0,20,20
1714620465418,MCWP 50R,E00,518795,Staff,0,2,20,20
1714620465418,MCWP 50R,F00,518796,Staff,0,0,20,20
1714620465418,MCWP 50R,G00,518797,Staff,0,1,20,20
1714620466447,MMW 12R,A01,514034,Herbst; Matthew,0,0,16,16
1714620466447,MMW 12R,A02,514035,Herbst; Matthew,1,0,16,15
1714620467475,MMW 13R,A01,514037,Staff,0,4,16,16
1714620467475,MMW 13R,A02,514039,Staff,0,2,16,16
1714620467475,MMW 13R,A03,628519,Staff,0,2,16,16
1714620469531,SIO 295LS,A00,523233,Staff,10,0,30,20
1714620470556,SIO 295S,A00,523232,Staff,10,0,30,20
1714620471585,SIOC 290S,A01,637330,Merrifield; Mark A,23,0,30,7
1714620472611,SIOC 291S,A01,637333,Gabriel; Corey John,23,0,30,7
1714620473636,SOCI 117,A01,494376,Staff,0,4,5,5
1714620474663,WES 237B,A00,494380,Staff,9,0,20,11
1714620476732,AESE 279B,A00,494370,Wade; Jon P,0,0,33,33
1714620477760,AIP 197,001,627712,Vespa; Emanuel Ignacio,9998,0,9999,1
1714620478786,ANAR 135S,A00,494369,Braswell; Geoffrey E.,0,0,0,0
1714620479813,BENG 196,001,628496,Engler; Adam J.,9998,0,9999,1
1714620480838,CAT 124RS,A01,519847,Geibel; William,0,0,20,20
1714620481864,CAT 125RS,A01,515971,Geibel; William,0,0,20,20
1714620482893,CLRE 250,A00,511389,Morris; Sheldon,9993,0,9999,6
1714620483923,CLRE 251,A00,507176,Mehta; Ravindra L.,9993,0,9999,6
1714620483923,CLRE 251,B00,511410,Mehta; Ravindra L.,9998,0,9999,1
1714620484949,CLRE 252,A00,507189,Cuomo; Raphael Eduardo,9995,0,9999,4
1714620485976,CLRE 253,A00,507199,Vaida; Florin,9994,0,9999,5
1714620485976,CLRE 253,B00,507202,Vaida; Florin,9999,0,9999,0
1714620487002,CLRE 259,A00,507211,Patel; Hemal,9996,0,9999,3
1714620488028,CLRE 260,A00,507221,Cuomo; Raphael Eduardo,9999,0,9999,0
1714620489053,CLRE 297,001,507242,Cuomo; Raphael Eduardo,9999,0,9999,0
1714620490078,COGS 197,001,638244,Voytek; Bradley Thomas,9998,0,9999,1
1714620491106,CSE 191,A00,516875,Minnes Kemp; Mor Mia,9992,0,9999,7
1714620492133,CSE 197,001,637388,Minnes Kemp; Mor Mia,9998,0,9999,1
1714620493159,CSS 201S,A01,494383,Staff,35,0,35,0
1714620494184,CSS 202S,A01,494387,Staff,35,0,35,0
1714620495209,DSC 197,001,628532,Eldridge; Justin Matthew,9996,0,9999,3
1714620496233,EAP 100,A00,516065,Staff,9797,0,9999,202
1714620497263,ECE 45,A01,507414,Staff,33,0,60,27
1714620499315,ECE 111,A01,507420,Staff,15,0,50,35
1714620500342,ECE 197,001,548057,Sievenpiper; Daniel F.,9993,0,9999,6
1714620501368,EDS 115,A00,507243,Choi; Bailey Miyeon,10,0,28,18
1714620502393,EDS 117,A01,494379,Staff,1,5,30,29
1714620503423,EDS 125,A00,507246,Hopkins; Megan Beth,9,0,30,21
1714620504447,EDS 128A,A01,507264,Fargason; Sharon Gayle,8,0,26,18
1714620505474,EDS 128B,A01,507293,Pappas; Elizabeth,12,0,30,18
1714620506503,EDS 139,A00,507294,Fargason; Sharon Gayle,13,0,30,17
1714620506503,EDS 139,B00,507313,Pappas; Elizabeth,13,0,30,17
1714620507531,EDS 201,A00,507315,Staff,13,0,30,17
1714620508560,EDS 203,A01,507317,Halter; Christopher P.,12,0,30,18
1714620509590,EDS 204R,A01,507319,Halter; Christopher P.,0,3,30,30
1714620509590,EDS 204R,B01,507331,Heinzman; Erica M.,16,0,30,14
1714620510616,EDS 206R,A00,507332,Staff,0,4,30,30
1714620510616,EDS 206R,B00,507343,Staff,17,0,30,13
1714620511646,EDS 250,A00,507344,Hemans; Patricia Ann Benitez,22,0,40,18
1714620512672,EDS 281,A00,507345,Daly; Alan J.,18,0,18,0
1714620513697,EDS 284,A00,507350,Daly; Alan J.,16,0,16,0
1714620514722,EDS 286,A00,507359,Fine; Sarah,18,0,18,0
1714620515750,EDS 289C,A01,507361,Daly; Alan J.,18,0,18,0
1714620516777,EDS 290,A00,507366,Hofstetter; Carolyn,15,0,15,0
1714620517808,LIGM 5A,A00,507421,Fischer-Grunski; Eva K,18,0,20,2
1714620518834,LIGM 5B,A00,507423,Fischer-Grunski; Eva K,19,0,20,1
1714620519862,LIGM 5C,A00,507425,Fischer-Grunski; Eva K,19,0,20,1
1714620520891,LIIT 5AS,A00,507427,Carnelos; Chiara,20,0,20,0
1714620521917,LIIT 5BS,A00,507430,Carnelos; Chiara,20,0,20,0
1714620522942,LIIT 5CS,A00,507432,Carnelos; Chiara,20,0,20,0
1714620523968,LISP 5A,A00,507541,Munoz Sanchez; Alicia,11,0,20,9
1714620524997,LISP 5B,A00,507671,Munoz Sanchez; Alicia,8,0,20,12
1714620526023,LISP 5C,A00,507696,Munoz Sanchez; Alicia,9,0,20,11
1714620527047,MAE 197,001,528363,Boechler; Nicholas Sebastia,9998,0,9999,1
1714620528077,MATH 197,001,523477,Kedlaya; Kiran S.,9995,0,9999,4
1714620528077,MATH 197,002,563811,Zhang; Danna,9995,0,9999,4
1714620528077,MATH 197,003,628552,Dumitriu; Ioana,9998,0,9999,1
1714620529103,MCWP 40R,A00,518780,Staff,2,0,20,18
1714620529103,MCWP 40R,B00,518781,Staff,8,0,20,12
1714620529103,MCWP 40R,C00,518783,Staff,6,0,20,14
1714620530133,MCWP 50R,A00,518791,Staff,0,0,20,20
1714620530133,MCWP 50R,B00,518792,Staff,0,2,20,20
1714620530133,MCWP 50R,C00,518793,Staff,0,2,20,20
1714620530133,MCWP 50R,D00,518794,Staff,0,0,20,20
1714620530133,MCWP 50R,E00,518795,Staff,0,2,20,20
1714620530133,MCWP 50R,F00,518796,Staff,0,0,20,20
1714620530133,MCWP 50R,G00,518797,Staff,0,1,20,20
1714620531161,MMW 12R,A01,514034,Herbst; Matthew,0,0,16,16
1714620531161,MMW 12R,A02,514035,Herbst; Matthew,1,0,16,15
1714620532187,MMW 13R,A01,514037,Staff,0,4,16,16
1714620532187,MMW 13R,A02,514039,Staff,0,2,16,16
1714620532187,MMW 13R,A03,628519,Staff,0,2,16,16
1714620534240,SIO 295LS,A00,523233,Staff,10,0,30,20
1714620535266,SIO 295S,A00,523232,Staff,10,0,30,20
1714620536350,SIOC 290S,A01,637330,Merrifield; Mark A,23,0,30,7
1714620537375,SIOC 291S,A01,637333,Gabriel; Corey John,23,0,30,7
1714620538400,SOCI 117,A01,494376,Staff,0,4,5,5
1714620539425,WES 237B,A00,494380,Staff,9,0,20,11
1714620541493,AESE 279B,A00,494370,Wade; Jon P,0,0,33,33
1714620542523,AIP 197,001,627712,Vespa; Emanuel Ignacio,9998,0,9999,1
1714620543551,ANAR 135S,A00,494369,Braswell; Geoffrey E.,0,0,0,0
1714620544577,BENG 196,001,628496,Engler; Adam J.,9998,0,9999,1
1714620545606,CAT 124RS,A01,519847,Geibel; William,0,0,20,20
1714620546635,CAT 125RS,A01,515971,Geibel; William,0,0,20,20
1714620547663,CLRE 250,A00,511389,Morris; Sheldon,9993,0,9999,6
1714620548691,CLRE 251,A00,507176,Mehta; Ravindra L.,9993,0,9999,6
1714620548691,CLRE 251,B00,511410,Mehta; Ravindra L.,9998,0,9999,1
1714620549721,CLRE 252,A00,507189,Cuomo; Raphael Eduardo,9995,0,9999,4
1714620550746,CLRE 253,A00,507199,Vaida; Florin,9994,0,9999,5
1714620550746,CLRE 253,B00,507202,Vaida; Florin,9999,0,9999,0
1714620551772,CLRE 259,A00,507211,Patel; Hemal,9996,0,9999,3
1714620552797,CLRE 260,A00,507221,Cuomo; Raphael Eduardo,9999,0,9999,0
1714620553826,CLRE 297,001,507242,Cuomo; Raphael Eduardo,9999,0,9999,0
1714620554855,COGS 197,001,638244,Voytek; Bradley Thomas,9998,0,9999,1
1714620555883,CSE 191,A00,516875,Minnes Kemp; Mor Mia,9992,0,9999,7
1714620556907,CSE 197,001,637388,Minnes Kemp; Mor Mia,9998,0,9999,1
1714620557932,CSS 201S,A01,494383,Staff,35,0,35,0
1714620558957,CSS 202S,A01,494387,Staff,35,0,35,0
1714620559986,DSC 197,001,628532,Eldridge; Justin Matthew,9996,0,9999,3
1714620561013,EAP 100,A00,516065,Staff,9797,0,9999,202
1714620562042,ECE 45,A01,507414,Staff,33,0,60,27
1714620564095,ECE 111,A01,507420,Staff,15,0,50,35
1714620565123,ECE 197,001,548057,Sievenpiper; Daniel F.,9993,0,9999,6
1714620566151,EDS 115,A00,507243,Choi; Bailey Miyeon,10,0,28,18
1714620567177,EDS 117,A01,494379,Staff,1,5,30,29
1714620568203,EDS 125,A00,507246,Hopkins; Megan Beth,9,0,30,21
1714620569233,EDS 128A,A01,507264,Fargason; Sharon Gayle,8,0,26,18
1714620570261,EDS 128B,A01,507293,Pappas; Elizabeth,12,0,30,18
1714620571286,EDS 139,A00,507294,Fargason; Sharon Gayle,13,0,30,17
1714620571286,EDS 139,B00,507313,Pappas; Elizabeth,13,0,30,17
1714620572314,EDS 201,A00,507315,Staff,13,0,30,17
1714620573339,EDS 203,A01,507317,Halter; Christopher P.,12,0,30,18
1714620574365,EDS 204R,A01,507319,Halter; Christopher P.,0,3,30,30
1714620574365,EDS 204R,B01,507331,Heinzman; Erica M.,16,0,30,14
1714620575395,EDS 206R,A00,507332,Staff,0,4,30,30
1714620575395,EDS 206R,B00,507343,Staff,17,0,30,13
1714620576423,EDS 250,A00,507344,Hemans; Patricia Ann Benitez,22,0,40,18
1714620577451,EDS 281,A00,507345,Daly; Alan J.,18,0,18,0
1714620578479,EDS 284,A00,507350,Daly; Alan J.,16,0,16,0
1714620579506,EDS 286,A00,507359,Fine; Sarah,18,0,18,0
1714620580529,EDS 289C,A01,507361,Daly; Alan J.,18,0,18,0
1714620581555,EDS 290,A00,507366,Hofstetter; Carolyn,15,0,15,0
1714620582582,LIGM 5A,A00,507421,Fischer-Grunski; Eva K,18,0,20,2
1714620583606,LIGM 5B,A00,507423,Fischer-Grunski; Eva K,19,0,20,1
1714620584636,LIGM 5C,A00,507425,Fischer-Grunski; Eva K,19,0,20,1
1714620585662,LIIT 5AS,A00,507427,Carnelos; Chiara,20,0,20,0
1714620586689,LIIT 5BS,A00,507430,Carnelos; Chiara,20,0,20,0
1714620587720,LIIT 5CS,A00,507432,Carnelos; Chiara,20,0,20,0
1714620588745,LISP 5A,A00,507541,Munoz Sanchez; Alicia,11,0,20,9
1714620589770,LISP 5B,A00,507671,Munoz Sanchez; Alicia,8,0,20,12
1714620590799,LISP 5C,A00,507696,Munoz Sanchez; Alicia,9,0,20,11
1714620591827,MAE 197,001,528363,Boechler; Nicholas Sebastia,9998,0,9999,1
1714620592855,MATH 197,001,523477,Kedlaya; Kiran S.,9995,0,9999,4
1714620592855,MATH 197,002,563811,Zhang; Danna,9995,0,9999,4
1714620592855,MATH 197,003,628552,Dumitriu; Ioana,9998,0,9999,1
1714620593882,MCWP 40R,A00,518780,Staff,2,0,20,18
1714620593882,MCWP 40R,B00,518781,Staff,8,0,20,12
1714620593882,MCWP 40R,C00,518783,Staff,6,0,20,14
1714620594908,MCWP 50R,A00,518791,Staff,0,0,20,20
1714620594908,MCWP 50R,B00,518792,Staff,0,2,20,20
1714620594908,MCWP 50R,C00,518793,Staff,0,2,20,20
1714620594908,MCWP 50R,D00,518794,Staff,0,0,20,20
1714620594908,MCWP 50R,E00,518795,Staff,0,2,20,20
1714620594908,MCWP 50R,F00,518796,Staff,0,0,20,20
1714620594908,MCWP 50R,G00,518797,Staff,0,1,20,20
1714620595936,MMW 12R,A01,514034,Herbst; Matthew,0,0,16,16
1714620595936,MMW 12R,A02,514035,Herbst; Matthew,1,0,16,15
1714620596962,MMW 13R,A01,514037,Staff,0,4,16,16
1714620596962,MMW 13R,A02,514039,Staff,0,2,16,16
1714620596962,MMW 13R,A03,628519,Staff,0,2,16,16
1714620599011,SIO 295LS,A00,523233,Staff,10,0,30,20
1714620600036,SIO 295S,A00,523232,Staff,10,0,30,20
1714620601062,SIOC 290S,A01,637330,Merrifield; Mark A,23,0,30,7
1714620602090,SIOC 291S,A01,637333,Gabriel; Corey John,23,0,30,7
1714620603120,SOCI 117,A01,494376,Staff,0,4,5,5
1714620604147,WES 237B,A00,494380,Staff,9,0,20,11
1714620606217,AESE 279B,A00,494370,Wade; Jon P,0,0,33,33
1714620607245,AIP 197,001,627712,Vespa; Emanuel Ignacio,9998,0,9999,1
1714620608273,ANAR 135S,A00,494369,Braswell; Geoffrey E.,0,0,0,0
1714620609302,BENG 196,001,628496,Engler; Adam J.,9998,0,9999,1
1714620610331,CAT 124RS,A01,519847,Geibel; William,0,0,20,20
1714620611358,CAT 125RS,A01,515971,Geibel; William,0,0,20,20
1714620612387,CLRE 250,A00,511389,Morris; Sheldon,9993,0,9999,6
1714620613411,CLRE 251,A00,507176,Mehta; Ravindra L.,9993,0,9999,6
1714620613411,CLRE 251,B00,511410,Mehta; Ravindra L.,9998,0,9999,1
1714620614434,CLRE 252,A00,507189,Cuomo; Raphael Eduardo,9995,0,9999,4
1714620615465,CLRE 253,A00,507199,Vaida; Florin,9994,0,9999,5
1714620615465,CLRE 253,B00,507202,Vaida; Florin,9999,0,9999,0
1714620616492,CLRE 259,A00,507211,Patel; Hemal,9996,0,9999,3
1714620617517,CLRE 260,A00,507221,Cuomo; Raphael Eduardo,9999,0,9999,0
1714620618540,CLRE 297,001,507242,Cuomo; Raphael Eduardo,9999,0,9999,0
1714620619565,COGS 197,001,638244,Voytek; Bradley Thomas,9998,0,9999,1
1714620620595,CSE 191,A00,516875,Minnes Kemp; Mor Mia,9992,0,9999,7
1714620621620,CSE 197,001,637388,Minnes Kemp; Mor Mia,9998,0,9999,1
1714620622651,CSS 201S,A01,494383,Staff,35,0,35,0
1714620623680,CSS 202S,A01,494387,Staff,35,0,35,0
1714620624708,DSC 197,001,628532,Eldridge; Justin Matthew,9996,0,9999,3
1714620625732,EAP 100,A00,516065,Staff,9797,0,9999,202
1714620626764,ECE 45,A01,507414,Staff,33,0,60,27
1714620628816,ECE 111,A01,507420,Staff,15,0,50,35
1714620629843,ECE 197,001,548057,Sievenpiper; Daniel F.,9993,0,9999,6
1714620630870,EDS 115,A00,507243,Choi; Bailey Miyeon,10,0,28,18
1714620631899,EDS 117,A01,494379,Staff,1,5,30,29
1714620632925,EDS 125,A00,507246,Hopkins; Megan Beth,9,0,30,21
1714620633955,EDS 128A,A01,507264,Fargason; Sharon Gayle,8,0,26,18
1714620634981,EDS 128B,A01,507293,Pappas; Elizabeth,12,0,30,18
1714620636006,EDS 139,A00,507294,Fargason; Sharon Gayle,13,0,30,17
1714620636006,EDS 139,B00,507313,Pappas; Elizabeth,13,0,30,17
1714620637031,EDS 201,A00,507315,Staff,13,0,30,17
1714620638060,EDS 203,A01,507317,Halter; Christopher P.,12,0,30,18
1714620639085,EDS 204R,A01,507319,Halter; Christopher P.,0,3,30,30
1714620639085,EDS 204R,B01,507331,Heinzman; Erica M.,16,0,30,14
1714620640111,EDS 206R,A00,507332,Staff,0,4,30,30
1714620640111,EDS 206R,B00,507343,Staff,17,0,30,13
1714620641136,EDS 250,A00,507344,Hemans; Patricia Ann Benitez,22,0,40,18
1714620642165,EDS 281,A00,507345,Daly; Alan J.,18,0,18,0
1714620643189,EDS 284,A00,507350,Daly; Alan J.,16,0,16,0
1714620644215,EDS 286,A00,507359,Fine; Sarah,18,0,18,0
1714620645241,EDS 289C,A01,507361,Daly; Alan J.,18,0,18,0
1714620646265,EDS 290,A00,507366,Hofstetter; Carolyn,15,0,15,0
1714620647290,LIGM 5A,A00,507421,Fischer-Grunski; Eva K,18,0,20,2
1714620648315,LIGM 5B,A00,507423,Fischer-Grunski; Eva K,19,0,20,1
1714620649339,LIGM 5C,A00,507425,Fischer-Grunski; Eva K,19,0,20,1
1714620650365,LIIT 5AS,A00,507427,Carnelos; Chiara,20,0,20,0
1714620651390,LIIT 5BS,A00,507430,Carnelos; Chiara,20,0,20,0
1714620652471,LIIT 5CS,A00,507432,Carnelos; Chiara,20,0,20,0
1714620653498,LISP 5A,A00,507541,Munoz Sanchez; Alicia,11,0,20,9
1714620654523,LISP 5B,A00,507671,Munoz Sanchez; Alicia,8,0,20,12
1714620655550,LISP 5C,A00,507696,Munoz Sanchez; Alicia,9,0,20,11
1714620656579,MAE 197,001,528363,Boechler; Nicholas Sebastia,9998,0,9999,1
1714620657606,MATH 197,001,523477,Kedlaya; Kiran S.,9995,0,9999,4
1714620657606,MATH 197,002,563811,Zhang; Danna,9995,0,9999,4
1714620657606,MATH 197,003,628552,Dumitriu; Ioana,9998,0,9999,1
1714620658632,MCWP 40R,A00,518780,Staff,2,0,20,18
1714620658632,MCWP 40R,B00,518781,Staff,8,0,20,12
1714620658632,MCWP 40R,C00,518783,Staff,6,0,20,14
1714620659658,MCWP 50R,A00,518791,Staff,0,0,20,20
1714620659658,MCWP 50R,B00,518792,Staff,0,2,20,20
1714620659658,MCWP 50R,C00,518793,Staff,0,2,20,20
1714620659658,MCWP 50R,D00,518794,Staff,0,0,20,20
1714620659658,MCWP 50R,E00,518795,Staff,0,2,20,20
1714620659658,MCWP 50R,F00,518796,Staff,0,0,20,20
1714620659658,MCWP 50R,G00,518797,Staff,0,1,20,20
1714620660687,MMW 12R,A01,514034,Herbst; Matthew,0,0,16,16
1714620660687,MMW 12R,A02,514035,Herbst; Matthew,1,0,16,15
1714620661713,MMW 13R,A01,514037,Staff,0,4,16,16
1714620661713,MMW 13R,A02,514039,Staff,0,2,16,16
1714620661713,MMW 13R,A03,628519,Staff,0,2,16,16
1714620663770,SIO 295LS,A00,523233,Staff,10,0,30,20
1714620664798,SIO 295S,A00,523232,Staff,10,0,30,20
1714620665830,SIOC 290S,A01,637330,Merrifield; Mark A,23,0,30,7
1714620666856,SIOC 291S,A01,637333,Gabriel; Corey John,23,0,30,7
1714620667880,SOCI 117,A01,494376,Staff,0,4,5,5
1714620668908,WES 237B,A00,494380,Staff,9,0,20,11
1714620670984,AESE 279B,A00,494370,Wade; Jon P,0,0,33,33
1714620672014,AIP 197,001,627712,Vespa; Emanuel Ignacio,9998,0,9999,1
1714620673040,ANAR 135S,A00,494369,Braswell; Geoffrey E.,0,0,0,0
1714620674065,BENG 196,001,628496,Engler; Adam J.,9998,0,9999,1
1714620675092,CAT 124RS,A01,519847,Geibel; William,0,0,20,20
1714620676119,CAT 125RS,A01,515971,Geibel; William,0,0,20,20
1714620677143,CLRE 250,A00,511389,Morris; Sheldon,9993,0,9999,6
1714620678171,CLRE 251,A00,507176,Mehta; Ravindra L.,9993,0,9999,6
1714620678171,CLRE 251,B00,511410,Mehta; Ravindra L.,9998,0,9999,1
1714620679197,CLRE 252,A00,507189,Cuomo; Raphael Eduardo,9995,0,9999,4
1714620680226,CLRE 253,A00,507199,Vaida; Florin,9994,0,9999,5
1714620680226,CLRE 253,B00,507202,Vaida; Florin,9999,0,9999,0
1714620681285,CLRE 259,A00,507211,Patel; Hemal,9996,0,9999,3
1714620682310,CLRE 260,A00,507221,Cuomo; Raphael Eduardo,9999,0,9999,0
1714620683336,CLRE 297,001,507242,Cuomo; Raphael Eduardo,9999,0,9999,0
1714620684362,COGS 197,001,638244,Voytek; Bradley Thomas,9998,0,9999,1
1714620685390,CSE 191,A00,516875,Minnes Kemp; Mor Mia,9992,0,9999,7
1714620686417,CSE 197,001,637388,Minnes Kemp; Mor Mia,9998,0,9999,1
1714620687443,CSS 201S,A01,494383,Staff,35,0,35,0
1714620688470,CSS 202S,A01,494387,Staff,35,0,35,0
1714620689494,DSC 197,001,628532,Eldridge; Justin Matthew,9996,0,9999,3
1714620690518,EAP 100,A00,516065,Staff,9797,0,9999,202
1714620691543,ECE 45,A01,507414,Staff,33,0,60,27
1714620693597,ECE 111,A01,507420,Staff,15,0,50,35
1714620694622,ECE 197,001,548057,Sievenpiper; Daniel F.,9993,0,9999,6
1714620695650,EDS 115,A00,507243,Choi; Bailey Miyeon,10,0,28,18
1714620696679,EDS 117,A01,494379,Staff,1,5,30,29
1714620697704,EDS 125,A00,507246,Hopkins; Megan Beth,9,0,30,21
1714620698731,EDS 128A,A01,507264,Fargason; Sharon Gayle,8,0,26,18
1714620699756,EDS 128B,A01,507293,Pappas; Elizabeth,12,0,30,18
1714620700782,EDS 139,A00,507294,Fargason; Sharon Gayle,13,0,30,17
1714620700782,EDS 139,B00,507313,Pappas; Elizabeth,13,0,30,17
1714620701808,EDS 201,A00,507315,Staff,13,0,30,17
1714620702832,EDS 203,A01,507317,Halter; Christopher P.,12,0,30,18
1714620703876,EDS 204R,A01,507319,Halter; Christopher P.,0,3,30,30
1714620703876,EDS 204R,B01,507331,Heinzman; Erica M.,16,0,30,14
1714620704900,EDS 206R,A00,507332,Staff,0,4,30,30
1714620704900,EDS 206R,B00,507343,Staff,17,0,30,13
1714620705927,EDS 250,A00,507344,Hemans; Patricia Ann Benitez,22,0,40,18
1714620706954,EDS 281,A00,507345,Daly; Alan J.,18,0,18,0
1714620707979,EDS 284,A00,507350,Daly; Alan J.,16,0,16,0
1714620709009,EDS 286,A00,507359,Fine; Sarah,18,0,18,0
1714620710038,EDS 289C,A01,507361,Daly; Alan J.,18,0,18,0
1714620711065,EDS 290,A00,507366,Hofstetter; Carolyn,15,0,15,0
1714620712092,LIGM 5A,A00,507421,Fischer-Grunski; Eva K,18,0,20,2
1714620713119,LIGM 5B,A00,507423,Fischer-Grunski; Eva K,19,0,20,1
1714620714145,LIGM 5C,A00,507425,Fischer-Grunski; Eva K,19,0,20,1
1714620715169,LIIT 5AS,A00,507427,Carnelos; Chiara,20,0,20,0
1714620716196,LIIT 5BS,A00,507430,Carnelos; Chiara,20,0,20,0
1714620717220,LIIT 5CS,A00,507432,Carnelos; Chiara,20,0,20,0
1714620718246,LISP 5A,A00,507541,Munoz Sanchez; Alicia,11,0,20,9
1714620719273,LISP 5B,A00,507671,Munoz Sanchez; Alicia,8,0,20,12
1714620720301,LISP 5C,A00,507696,Munoz Sanchez; Alicia,9,0,20,11
1714620721326,MAE 197,001,528363,Boechler; Nicholas Sebastia,9998,0,9999,1
1714620722353,MATH 197,001,523477,Kedlaya; Kiran S.,9995,0,9999,4
1714620722353,MATH 197,002,563811,Zhang; Danna,9995,0,9999,4
1714620722353,MATH 197,003,628552,Dumitriu; Ioana,9998,0,9999,1
1714620723379,MCWP 40R,A00,518780,Staff,2,0,20,18
1714620723379,MCWP 40R,B00,518781,Staff,8,0,20,12
1714620723379,MCWP 40R,C00,518783,Staff,6,0,20,14
1714620724403,MCWP 50R,A00,518791,Staff,0,0,20,20
1714620724403,MCWP 50R,B00,518792,Staff,0,2,20,20
1714620724403,MCWP 50R,C00,518793,Staff,0,2,20,20
1714620724403,MCWP 50R,D00,518794,Staff,0,0,20,20
1714620724403,MCWP 50R,E00,518795,Staff,0,2,20,20
1714620724403,MCWP 50R,F00,518796,Staff,0,0,20,20
1714620724403,MCWP 50R,G00,518797,Staff,0,1,20,20
1714620725431,MMW 12R,A01,514034,Herbst; Matthew,0,0,16,16
1714620725431,MMW 12R,A02,514035,Herbst; Matthew,1,0,16,15
1714620726458,MMW 13R,A01,514037,Staff,0,4,16,16
1714620726458,MMW 13R,A02,514039,Staff,0,2,16,16
1714620726458,MMW 13R,A03,628519,Staff,0,2,16,16
1714620728510,SIO 295LS,A00,523233,Staff,10,0,30,20
1714620729539,SIO 295S,A00,523232,Staff,10,0,30,20
1714620730566,SIOC 290S,A01,637330,Merrifield; Mark A,23,0,30,7
1714620731597,SIOC 291S,A01,637333,Gabriel; Corey John,23,0,30,7
1714620732624,SOCI 117,A01,494376,Staff,0,4,5,5
1714620733648,WES 237B,A00,494380,Staff,9,0,20,11
1714620735721,AESE 279B,A00,494370,Wade; Jon P,0,0,33,33
1714620736746,AIP 197,001,627712,Vespa; Emanuel Ignacio,9998,0,9999,1
1714620737775,ANAR 135S,A00,494369,Braswell; Geoffrey E.,0,0,0,0
1714620738805,BENG 196,001,628496,Engler; Adam J.,9998,0,9999,1
1714620739832,CAT 124RS,A01,519847,Geibel; William,0,0,20,20
1714620740856,CAT 125RS,A01,515971,Geibel; William,0,0,20,20
1714620741884,CLRE 250,A00,511389,Morris; Sheldon,9993,0,9999,6
1714620742912,CLRE 251,A00,507176,Mehta; Ravindra L.,9993,0,9999,6
1714620742912,CLRE 251,B00,511410,Mehta; Ravindra L.,9998,0,9999,1
1714620743937,CLRE 252,A00,507189,Cuomo; Raphael Eduardo,9995,0,9999,4
1714620744961,CLRE 253,A00,507199,Vaida; Florin,9994,0,9999,5
1714620744961,CLRE 253,B00,507202,Vaida; Florin,9999,0,9999,0
1714620745989,CLRE 259,A00,507211,Patel; Hemal,9996,0,9999,3
1714620747016,CLRE 260,A00,507221,Cuomo; Raphael Eduardo,9999,0,9999,0
1714620748040,CLRE 297,001,507242,Cuomo; Raphael Eduardo,9999,0,9999,0
1714620749065,COGS 197,001,638244,Voytek; Bradley Thomas,9998,0,9999,1
1714620750090,CSE 191,A00,516875,Minnes Kemp; Mor Mia,9992,0,9999,7
1714620751119,CSE 197,001,637388,Minnes Kemp; Mor Mia,9998,0,9999,1
1714620752147,CSS 201S,A01,494383,Staff,35,0,35,0
1714620753174,CSS 202S,A01,494387,Staff,35,0,35,0
1714620754200,DSC 197,001,628532,Eldridge; Justin Matthew,9996,0,9999,3
1714620755224,EAP 100,A00,516065,Staff,9797,0,9999,202
1714620756302,ECE 45,A01,507414,Staff,33,0,60,27
1714620758359,ECE 111,A01,507420,Staff,15,0,50,35
1714620759387,ECE 197,001,548057,Sievenpiper; Daniel F.,9993,0,9999,6
1714620760413,EDS 115,A00,507243,Choi; Bailey Miyeon,10,0,28,18
1714620761439,EDS 117,A01,494379,Staff,1,5,30,29
1714620762469,EDS 125,A00,507246,Hopkins; Megan Beth,9,0,30,21
1714620763495,EDS 128A,A01,507264,Fargason; Sharon Gayle,8,0,26,18
1714620764524,EDS 128B,A01,507293,Pappas; Elizabeth,12,0,30,18
1714620765549,EDS 139,A00,507294,Fargason; Sharon Gayle,13,0,30,17
1714620765549,EDS 139,B00,507313,Pappas; Elizabeth,13,0,30,17
1714620766572,EDS 201,A00,507315,Staff,13,0,30,17
1714620767597,EDS 203,A01,507317,Halter; Christopher P.,12,0,30,18
1714620768623,EDS 204R,A01,507319,Halter; Christopher P.,0,3,30,30
1714620768623,EDS 204R,B01,507331,Heinzman; Erica M.,16,0,30,14
1714620769650,EDS 206R,A00,507332,Staff,0,4,30,30
1714620769650,EDS 206R,B00,507343,Staff,17,0,30,13
1714620770681,EDS 250,A00,507344,Hemans; Patricia Ann Benitez,22,0,40,18
1714620771709,EDS 281,A00,507345,Daly; Alan J.,18,0,18,0
1714620772733,EDS 284,A00,507350,Daly; Alan J.,16,0,16,0
1714620773758,EDS 286,A00,507359,Fine; Sarah,18,0,18,0
1714620774785,EDS 289C,A01,507361,Daly; Alan J.,18,0,18,0
1714620775814,EDS 290,A00,507366,Hofstetter; Carolyn,15,0,15,0
1714620776842,LIGM 5A,A00,507421,Fischer-Grunski; Eva K,18,0,20,2
1714620777867,LIGM 5B,A00,507423,Fischer-Grunski; Eva K,19,0,20,1
1714620778894,LIGM 5C,A00,507425,Fischer-Grunski; Eva K,19,0,20,1
1714620779922,LIIT 5AS,A00,507427,Carnelos; Chiara,20,0,20,0
1714620780948,LIIT 5BS,A00,507430,Carnelos; Chiara,20,0,20,0
1714620781973,LIIT 5CS,A00,507432,Carnelos; Chiara,20,0,20,0
1714620783003,LISP 5A,A00,507541,Munoz Sanchez; Alicia,11,0,20,9
1714620784027,LISP 5B,A00,507671,Munoz Sanchez; Alicia,8,0,20,12
1714620785055,LISP 5C,A00,507696,Munoz Sanchez; Alicia,9,0,20,11
1714620786084,MAE 197,001,528363,Boechler; Nicholas Sebastia,9998,0,9999,1
1714620787113,MATH 197,001,523477,Kedlaya; Kiran S.,9995,0,9999,4
1714620787113,MATH 197,002,563811,Zhang; Danna,9995,0,9999,4
1714620787113,MATH 197,003,628552,Dumitriu; Ioana,9998,0,9999,1
1714620788141,MCWP 40R,A00,518780,Staff,2,0,20,18
1714620788141,MCWP 40R,B00,518781,Staff,8,0,20,12
1714620788141,MCWP 40R,C00,518783,Staff,6,0,20,14
1714620789171,MCWP 50R,A00,518791,Staff,0,0,20,20
1714620789171,MCWP 50R,B00,518792,Staff,0,2,20,20
1714620789171,MCWP 50R,C00,518793,Staff,0,2,20,20
1714620789171,MCWP 50R,D00,518794,Staff,0,0,20,20
1714620789171,MCWP 50R,E00,518795,Staff,0,2,20,20
1714620789171,MCWP 50R,F00,518796,Staff,0,0,20,20
1714620789171,MCWP 50R,G00,518797,Staff,0,1,20,20
1714620790201,MMW 12R,A01,514034,Herbst; Matthew,0,0,16,16
1714620790201,MMW 12R,A02,514035,Herbst; Matthew,1,0,16,15
1714620791230,MMW 13R,A01,514037,Staff,0,4,16,16
1714620791230,MMW 13R,A02,514039,Staff,0,2,16,16
1714620791230,MMW 13R,A03,628519,Staff,0,2,16,16
1714620793285,SIO 295LS,A00,523233,Staff,10,0,30,20
1714620794309,SIO 295S,A00,523232,Staff,10,0,30,20
1714620795335,SIOC 290S,A01,637330,Merrifield; Mark A,23,0,30,7
1714620796361,SIOC 291S,A01,637333,Gabriel; Corey John,23,0,30,7
1714620797386,SOCI 117,A01,494376,Staff,0,4,5,5
1714620798412,WES 237B,A00,494380,Staff,9,0,20,11
1714620800484,AESE 279B,A00,494370,Wade; Jon P,0,0,33,33
1714620801513,AIP 197,001,627712,Vespa; Emanuel Ignacio,9998,0,9999,1
1714620802538,ANAR 135S,A00,494369,Braswell; Geoffrey E.,0,0,0,0
1714620803562,BENG 196,001,628496,Engler; Adam J.,9998,0,9999,1
1714620804592,CAT 124RS,A01,519847,Geibel; William,0,0,20,20
1714620805619,CAT 125RS,A01,515971,Geibel; William,0,0,20,20
1714620806648,CLRE 250,A00,511389,Morris; Sheldon,9993,0,9999,6
1714620807677,CLRE 251,A00,507176,Mehta; Ravindra L.,9993,0,9999,6
1714620807677,CLRE 251,B00,511410,Mehta; Ravindra L.,9998,0,9999,1
1714620808701,CLRE 252,A00,507189,Cuomo; Raphael Eduardo,9995,0,9999,4
1714620809727,CLRE 253,A00,507199,Vaida; Florin,9994,0,9999,5
1714620809727,CLRE 253,B00,507202,Vaida; Florin,9999,0,9999,0
1714620810752,CLRE 259,A00,507211,Patel; Hemal,9996,0,9999,3
1714620811781,CLRE 260,A00,507221,Cuomo; Raphael Eduardo,9999,0,9999,0
1714620812809,CLRE 297,001,507242,Cuomo; Raphael Eduardo,9999,0,9999,0
1714620813839,COGS 197,001,638244,Voytek; Bradley Thomas,9998,0,9999,1
1714620814864,CSE 191,A00,516875,Minnes Kemp; Mor Mia,9992,0,9999,7
1714620815891,CSE 197,001,637388,Minnes Kemp; Mor Mia,9998,0,9999,1
1714620816918,CSS 201S,A01,494383,Staff,35,0,35,0
1714620817943,CSS 202S,A01,494387,Staff,35,0,35,0
1714620818973,DSC 197,001,628532,Eldridge; Justin Matthew,9996,0,9999,3
1714620820001,EAP 100,A00,516065,Staff,9797,0,9999,202
1714620821029,ECE 45,A01,507414,Staff,33,0,60,27
1714620823081,ECE 111,A01,507420,Staff,15,0,50,35
1714620824106,ECE 197,001,548057,Sievenpiper; Daniel F.,9993,0,9999,6
1714620825132,EDS 115,A00,507243,Choi; Bailey Miyeon,10,0,28,18
1714620826158,EDS 117,A01,494379,Staff,1,5,30,29
1714620827190,EDS 125,A00,507246,Hopkins; Megan Beth,9,0,30,21
1714620828214,EDS 128A,A01,507264,Fargason; Sharon Gayle,8,0,26,18
1714620829241,EDS 128B,A01,507293,Pappas; Elizabeth,12,0,30,18
1714620830267,EDS 139,A00,507294,Fargason; Sharon Gayle,13,0,30,17
1714620830267,EDS 139,B00,507313,Pappas; Elizabeth,13,0,30,17
1714620831296,EDS 201,A00,507315,Staff,13,0,30,17
1714620832322,EDS 203,A01,507317,Halter; Christopher P.,12,0,30,18
1714620833347,EDS 204R,A01,507319,Halter; Christopher P.,0,3,30,30
1714620833347,EDS 204R,B01,507331,Heinzman; Erica M.,16,0,30,14
1714620834371,EDS 206R,A00,507332,Staff,0,4,30,30
1714620834371,EDS 206R,B00,507343,Staff,17,0,30,13
1714620835396,EDS 250,A00,507344,Hemans; Patricia Ann Benitez,22,0,40,18
1714620836422,EDS 281,A00,507345,Daly; Alan J.,18,0,18,0
1714620837448,EDS 284,A00,507350,Daly; Alan J.,16,0,16,0
1714620838478,EDS 286,A00,507359,Fine; Sarah,18,0,18,0
1714620839503,EDS 289C,A01,507361,Daly; Alan J.,18,0,18,0
1714620840528,EDS 290,A00,507366,Hofstetter; Carolyn,15,0,15,0
1714620841555,LIGM 5A,A00,507421,Fischer-Grunski; Eva K,18,0,20,2
1714620842580,LIGM 5B,A00,507423,Fischer-Grunski; Eva K,19,0,20,1
1714620843607,LIGM 5C,A00,507425,Fischer-Grunski; Eva K,19,0,20,1
1714620844637,LIIT 5AS,A00,507427,Carnelos; Chiara,20,0,20,0
1714620845664,LIIT 5BS,A00,507430,Carnelos; Chiara,20,0,20,0
1714620846694,LIIT 5CS,A00,507432,Carnelos; Chiara,20,0,20,0
1714620847720,LISP 5A,A00,507541,Munoz Sanchez; Alicia,11,0,20,9
1714620848746,LISP 5B,A00,507671,Munoz Sanchez; Alicia,8,0,20,12
1714620849774,LISP 5C,A00,507696,Munoz Sanchez; Alicia,9,0,20,11
1714620850798,MAE 197,001,528363,Boechler; Nicholas Sebastia,9998,0,9999,1
1714620851826,MATH 197,001,523477,Kedlaya; Kiran S.,9995,0,9999,4
1714620851826,MATH 197,002,563811,Zhang; Danna,9995,0,9999,4
1714620851826,MATH 197,003,628552,Dumitriu; Ioana,9998,0,9999,1
1714620852851,MCWP 40R,A00,518780,Staff,2,0,20,18
1714620852851,MCWP 40R,B00,518781,Staff,8,0,20,12
1714620852851,MCWP 40R,C00,518783,Staff,6,0,20,14
1714620853879,MCWP 50R,A00,518791,Staff,0,0,20,20
1714620853879,MCWP 50R,B00,518792,Staff,0,2,20,20
1714620853879,MCWP 50R,C00,518793,Staff,0,2,20,20
1714620853879,MCWP 50R,D00,518794,Staff,0,0,20,20
1714620853879,MCWP 50R,E00,518795,Staff,0,2,20,20
1714620853879,MCWP 50R,F00,518796,Staff,0,0,20,20
1714620853879,MCWP 50R,G00,518797,Staff,0,1,20,20
1714620854910,MMW 12R,A01,514034,Herbst; Matthew,0,0,16,16
1714620854910,MMW 12R,A02,514035,Herbst; Matthew,1,0,16,15
1714620855935,MMW 13R,A01,514037,Staff,0,4,16,16
1714620855935,MMW 13R,A02,514039,Staff,0,2,16,16
1714620855935,MMW 13R,A03,628519,Staff,0,2,16,16
1714620857987,SIO 295LS,A00,523233,Staff,10,0,30,20
1714620859015,SIO 295S,A00,523232,Staff,10,0,30,20
1714620860115,SIOC 290S,A01,637330,Merrifield; Mark A,23,0,30,7
1714620861142,SIOC 291S,A01,637333,Gabriel; Corey John,23,0,30,7
1714620862166,SOCI 117,A01,494376,Staff,0,4,5,5
1714620863191,WES 237B,A00,494380,Staff,9,0,20,11
1714620865259,AESE 279B,A00,494370,Wade; Jon P,0,0,33,33
1714620866287,AIP 197,001,627712,Vespa; Emanuel Ignacio,9998,0,9999,1
1714620867319,ANAR 135S,A00,494369,Braswell; Geoffrey E.,0,0,0,0
1714620868345,BENG 196,001,628496,Engler; Adam J.,9998,0,9999,1
1714620869369,CAT 124RS,A01,519847,Geibel; William,0,0,20,20
1714620870391,CAT 125RS,A01,515971,Geibel; William,0,0,20,20
1714620871418,CLRE 250,A00,511389,Morris; Sheldon,9993,0,9999,6
1714620872446,CLRE 251,A00,507176,Mehta; Ravindra L.,9993,0,9999,6
1714620872446,CLRE 251,B00,511410,Mehta; Ravindra L.,9998,0,9999,1
1714620873471,CLRE 252,A00,507189,Cuomo; Raphael Eduardo,9995,0,9999,4
1714620874496,CLRE 253,A00,507199,Vaida; Florin,9994,0,9999,5
1714620874496,CLRE 253,B00,507202,Vaida; Florin,9999,0,9999,0
1714620875521,CLRE 259,A00,507211,Patel; Hemal,9996,0,9999,3
1714620876547,CLRE 260,A00,507221,Cuomo; Raphael Eduardo,9999,0,9999,0
1714620877570,CLRE 297,001,507242,Cuomo; Raphael Eduardo,9999,0,9999,0
1714620878599,COGS 197,001,638244,Voytek; Bradley Thomas,9998,0,9999,1
1714620879624,CSE 191,A00,516875,Minnes Kemp; Mor Mia,9992,0,9999,7
1714620880652,CSE 197,001,637388,Minnes Kemp; Mor Mia,9998,0,9999,1
1714620881679,CSS 201S,A01,494383,Staff,35,0,35,0
1714620882705,CSS 202S,A01,494387,Staff,35,0,35,0
1714620883730,DSC 197,001,628532,Eldridge; Justin Matthew,9996,0,9999,3
1714620884757,EAP 100,A00,516065,Staff,9797,0,9999,202
1714620885784,ECE 45,A01,507414,Staff,33,0,60,27
1714620887835,ECE 111,A01,507420,Staff,15,0,50,35
1714620888864,ECE 197,001,548057,Sievenpiper; Daniel F.,9993,0,9999,6
1714620889890,EDS 115,A00,507243,Choi; Bailey Miyeon,10,0,28,18
1714620890917,EDS 117,A01,494379,Staff,1,5,30,29
1714620891942,EDS 125,A00,507246,Hopkins; Megan Beth,9,0,30,21
1714620892972,EDS 128A,A01,507264,Fargason; Sharon Gayle,8,0,26,18
1714620893996,EDS 128B,A01,507293,Pappas; Elizabeth,12,0,30,18
1714620895024,EDS 139,A00,507294,Fargason; Sharon Gayle,13,0,30,17
1714620895024,EDS 139,B00,507313,Pappas; Elizabeth,13,0,30,17
1714620896049,EDS 201,A00,507315,Staff,13,0,30,17
1714620897077,EDS 203,A01,507317,Halter; Christopher P.,12,0,30,18
1714620898121,EDS 204R,A01,507319,Halter; Christopher P.,0,3,30,30
1714620898121,EDS 204R,B01,507331,Heinzman; Erica M.,16,0,30,14
1714620899144,EDS 206R,A00,507332,Staff,0,4,30,30
1714620899144,EDS 206R,B00,507343,Staff,17,0,30,13
1714620900171,EDS 250,A00,507344,Hemans; Patricia Ann Benitez,22,0,40,18
1714620901198,EDS 281,A00,507345,Daly; Alan J.,18,0,18,0
1714620902226,EDS 284,A00,507350,Daly; Alan J.,16,0,16,0
1714620903256,EDS 286,A00,507359,Fine; Sarah,18,0,18,0
1714620904280,EDS 289C,A01,507361,Daly; Alan J.,18,0,18,0
1714620905306,EDS 290,A00,507366,Hofstetter; Carolyn,15,0,15,0
1714620906332,LIGM 5A,A00,507421,Fischer-Grunski; Eva K,18,0,20,2
1714620907360,LIGM 5B,A00,507423,Fischer-Grunski; Eva K,19,0,20,1
1714620908385,LIGM 5C,A00,507425,Fischer-Grunski; Eva K,19,0,20,1
1714620909412,LIIT 5AS,A00,507427,Carnelos; Chiara,20,0,20,0
1714620910436,LIIT 5BS,A00,507430,Carnelos; Chiara,20,0,20,0
1714620911459,LIIT 5CS,A00,507432,Carnelos; Chiara,20,0,20,0
1714620912484,LISP 5A,A00,507541,Munoz Sanchez; Alicia,11,0,20,9
1714620913509,LISP 5B,A00,507671,Munoz Sanchez; Alicia,8,0,20,12
1714620914537,LISP 5C,A00,507696,Munoz Sanchez; Alicia,9,0,20,11
1714620915563,MAE 197,001,528363,Boechler; Nicholas Sebastia,9998,0,9999,1
1714620916588,MATH 197,001,523477,Kedlaya; Kiran S.,9995,0,9999,4
1714620916588,MATH 197,002,563811,Zhang; Danna,9995,0,9999,4
1714620916588,MATH 197,003,628552,Dumitriu; Ioana,9998,0,9999,1
1714620917613,MCWP 40R,A00,518780,Staff,2,0,20,18
1714620917613,MCWP 40R,B00,518781,Staff,8,0,20,12
1714620917613,MCWP 40R,C00,518783,Staff,6,0,20,14
1714620918640,MCWP 50R,A00,518791,Staff,0,0,20,20
1714620918640,MCWP 50R,B00,518792,Staff,0,2,20,20
1714620918640,MCWP 50R,C00,518793,Staff,0,2,20,20
1714620918640,MCWP 50R,D00,518794,Staff,0,0,20,20
1714620918640,MCWP 50R,E00,518795,Staff,0,2,20,20
1714620918640,MCWP 50R,F00,518796,Staff,0,0,20,20
1714620918640,MCWP 50R,G00,518797,Staff,0,1,20,20
1714620919665,MMW 12R,A01,514034,Herbst; Matthew,0,0,16,16
1714620919665,MMW 12R,A02,514035,Herbst; Matthew,1,0,16,15
1714620920692,MMW 13R,A01,514037,Staff,0,4,16,16
1714620920692,MMW 13R,A02,514039,Staff,0,2,16,16
1714620920692,MMW 13R,A03,628519,Staff,0,2,16,16
1714620922743,SIO 295LS,A00,523233,Staff,10,0,30,20
1714620923771,SIO 295S,A00,523232,Staff,10,0,30,20
1714620924801,SIOC 290S,A01,637330,Merrifield; Mark A,23,0,30,7
1714620925830,SIOC 291S,A01,637333,Gabriel; Corey John,23,0,30,7
1714620926856,SOCI 117,A01,494376,Staff,0,4,5,5
1714620927883,WES 237B,A00,494380,Staff,9,0,20,11
1714620929953,AESE 279B,A00,494370,Wade; Jon P,0,0,33,33
1714620930983,AIP 197,001,627712,Vespa; Emanuel Ignacio,9998,0,9999,1
1714620932010,ANAR 135S,A00,494369,Braswell; Geoffrey E.,0,0,0,0
1714620933036,BENG 196,001,628496,Engler; Adam J.,9998,0,9999,1
1714620934062,CAT 124RS,A01,519847,Geibel; William,0,0,20,20
1714620935087,CAT 125RS,A01,515971,Geibel; William,0,0,20,20
1714620936117,CLRE 250,A00,511389,Morris; Sheldon,9993,0,9999,6
1714620937148,CLRE 251,A00,507176,Mehta; Ravindra L.,9993,0,9999,6
1714620937148,CLRE 251,B00,511410,Mehta; Ravindra L.,9998,0,9999,1
1714620938174,CLRE 252,A00,507189,Cuomo; Raphael Eduardo,9995,0,9999,4
1714620939199,CLRE 253,A00,507199,Vaida; Florin,9994,0,9999,5
1714620939199,CLRE 253,B00,507202,Vaida; Florin,9999,0,9999,0
1714620940224,CLRE 259,A00,507211,Patel; Hemal,9996,0,9999,3
1714620941249,CLRE 260,A00,507221,Cuomo; Raphael Eduardo,9999,0,9999,0
1714620942277,CLRE 297,001,507242,Cuomo; Raphael Eduardo,9999,0,9999,0
1714620943303,COGS 197,001,638244,Voytek; Bradley Thomas,9998,0,9999,1
1714620944328,CSE 191,A00,516875,Minnes Kemp; Mor Mia,9992,0,9999,7
1714620945354,CSE 197,001,637388,Minnes Kemp; Mor Mia,9998,0,9999,1
1714620946380,CSS 201S,A01,494383,Staff,35,0,35,0
1714620947408,CSS 202S,A01,494387,Staff,35,0,35,0
1714620948433,DSC 197,001,628532,Eldridge; Justin Matthew,9996,0,9999,3
1714620949458,EAP 100,A00,516065,Staff,9797,0,9999,202
1714620950487,ECE 45,A01,507414,Staff,33,0,60,27
1714620952539,ECE 111,A01,507420,Staff,15,0,50,35
1714620953567,ECE 197,001,548057,Sievenpiper; Daniel F.,9993,0,9999,6
1714620954598,EDS 115,A00,507243,Choi; Bailey Miyeon,10,0,28,18
1714620955627,EDS 117,A01,494379,Staff,1,5,30,29
1714620956653,EDS 125,A00,507246,Hopkins; Megan Beth,9,0,30,21
1714620957683,EDS 128A,A01,507264,Fargason; Sharon Gayle,8,0,26,18
1714620958713,EDS 128B,A01,507293,Pappas; Elizabeth,12,0,30,18
1714620959741,EDS 139,A00,507294,Fargason; Sharon Gayle,13,0,30,17
1714620959741,EDS 139,B00,507313,Pappas; Elizabeth,13,0,30,17
1714620960765,EDS 201,A00,507315,Staff,13,0,30,17
1714620961796,EDS 203,A01,507317,Halter; Christopher P.,12,0,30,18
1714620962820,EDS 204R,A01,507319,Halter; Christopher P.,0,3,30,30
1714620962820,EDS 204R,B01,507331,Heinzman; Erica M.,16,0,30,14
1714620963845,EDS 206R,A00,507332,Staff,0,4,30,30
1714620963845,EDS 206R,B00,507343,Staff,17,0,30,13
1714620964872,EDS 250,A00,507344,Hemans; Patricia Ann Benitez,22,0,40,18
1714620965897,EDS 281,A00,507345,Daly; Alan J.,18,0,18,0
1714620966927,EDS 284,A00,507350,Daly; Alan J.,16,0,16,0
1714620967955,EDS 286,A00,507359,Fine; Sarah,18,0,18,0
1714620968981,EDS 289C,A01,507361,Daly; Alan J.,18,0,18,0
1714620970015,EDS 290,A00,507366,Hofstetter; Carolyn,15,0,15,0
1714620971041,LIGM 5A,A00,507421,Fischer-Grunski; Eva K,18,0,20,2
1714620972065,LIGM 5B,A00,507423,Fischer-Grunski; Eva K,19,0,20,1
1714620973091,LIGM 5C,A00,507425,Fischer-Grunski; Eva K,19,0,20,1
1714620974117,LIIT 5AS,A00,507427,Carnelos; Chiara,20,0,20,0
1714620975142,LIIT 5BS,A00,507430,Carnelos; Chiara,20,0,20,0
1714620976167,LIIT 5CS,A00,507432,Carnelos; Chiara,20,0,20,0
1714620977195,LISP 5A,A00,507541,Munoz Sanchez; Alicia,11,0,20,9
1714620978221,LISP 5B,A00,507671,Munoz Sanchez; Alicia,8,0,20,12
1714620979247,LISP 5C,A00,507696,Munoz Sanchez; Alicia,9,0,20,11
1714620980271,MAE 197,001,528363,Boechler; Nicholas Sebastia,9998,0,9999,1
1714620981298,MATH 197,001,523477,Kedlaya; Kiran S.,9995,0,9999,4
1714620981298,MATH 197,002,563811,Zhang; Danna,9995,0,9999,4
1714620981298,MATH 197,003,628552,Dumitriu; Ioana,9998,0,9999,1
1714620982327,MCWP 40R,A00,518780,Staff,2,0,20,18
1714620982327,MCWP 40R,B00,518781,Staff,8,0,20,12
1714620982327,MCWP 40R,C00,518783,Staff,6,0,20,14
1714620983355,MCWP 50R,A00,518791,Staff,0,0,20,20
1714620983355,MCWP 50R,B00,518792,Staff,0,2,20,20
1714620983355,MCWP 50R,C00,518793,Staff,0,2,20,20
1714620983355,MCWP 50R,D00,518794,Staff,0,0,20,20
1714620983355,MCWP 50R,E00,518795,Staff,0,2,20,20
1714620983355,MCWP 50R,F00,518796,Staff,0,0,20,20
1714620983355,MCWP 50R,G00,518797,Staff,0,1,20,20
1714620984383,MMW 12R,A01,514034,Herbst; Matthew,0,0,16,16
1714620984383,MMW 12R,A02,514035,Herbst; Matthew,1,0,16,15
1714620985409,MMW 13R,A01,514037,Staff,0,4,16,16
1714620985409,MMW 13R,A02,514039,Staff,0,2,16,16
1714620985409,MMW 13R,A03,628519,Staff,0,2,16,16
1714620987466,SIO 295LS,A00,523233,Staff,10,0,30,20
1714620988492,SIO 295S,A00,523232,Staff,10,0,30,20
1714620989520,SIOC 290S,A01,637330,Merrifield; Mark A,23,0,30,7
1714620990546,SIOC 291S,A01,637333,Gabriel; Corey John,23,0,30,7
1714620991572,SOCI 117,A01,494376,Staff,0,4,5,5
1714620992598,WES 237B,A00,494380,Staff,9,0,20,11
1714620994662,AESE 279B,A00,494370,Wade; Jon P,0,0,33,33
1714620995687,AIP 197,001,627712,Vespa; Emanuel Ignacio,9998,0,9999,1
1714620996713,ANAR 135S,A00,494369,Braswell; Geoffrey E.,0,0,0,0
1714620997738,BENG 196,001,628496,Engler; Adam J.,9998,0,9999,1
1714620998763,CAT 124RS,A01,519847,Geibel; William,0,0,20,20
1714620999787,CAT 125RS,A01,515971,Geibel; William,0,0,20,20
1714621000816,CLRE 250,A00,511389,Morris; Sheldon,9993,0,9999,6
1714621001846,CLRE 251,A00,507176,Mehta; Ravindra L.,9993,0,9999,6
1714621001846,CLRE 251,B00,511410,Mehta; Ravindra L.,9998,0,9999,1
1714621002873,CLRE 252,A00,507189,Cuomo; Raphael Eduardo,9995,0,9999,4
1714621003906,CLRE 253,A00,507199,Vaida; Florin,9994,0,9999,5
1714621003906,CLRE 253,B00,507202,Vaida; Florin,9999,0,9999,0
1714621004938,CLRE 259,A00,507211,Patel; Hemal,9996,0,9999,3
1714621005962,CLRE 260,A00,507221,Cuomo; Raphael Eduardo,9999,0,9999,0
1714621006987,CLRE 297,001,507242,Cuomo; Raphael Eduardo,9999,0,9999,0
1714621008013,COGS 197,001,638244,Voytek; Bradley Thomas,9998,0,9999,1
1714621009045,CSE 191,A00,516875,Minnes Kemp; Mor Mia,9992,0,9999,7
1714621010070,CSE 197,001,637388,Minnes Kemp; Mor Mia,9998,0,9999,1
1714621011097,CSS 201S,A01,494383,Staff,35,0,35,0
1714621012122,CSS 202S,A01,494387,Staff,35,0,35,0
1714621013145,DSC 197,001,628532,Eldridge; Justin Matthew,9996,0,9999,3
1714621014170,EAP 100,A00,516065,Staff,9797,0,9999,202
1714621015194,ECE 45,A01,507414,Staff,33,0,60,27
1714621017247,ECE 111,A01,507420,Staff,15,0,50,35
1714621018276,ECE 197,001,548057,Sievenpiper; Daniel F.,9993,0,9999,6
1714621019302,EDS 115,A00,507243,Choi; Bailey Miyeon,10,0,28,18
1714621020331,EDS 117,A01,494379,Staff,1,5,30,29
1714621021355,EDS 125,A00,507246,Hopkins; Megan Beth,9,0,30,21
1714621022380,EDS 128A,A01,507264,Fargason; Sharon Gayle,8,0,26,18
1714621023405,EDS 128B,A01,507293,Pappas; Elizabeth,12,0,30,18
1714621024430,EDS 139,A00,507294,Fargason; Sharon Gayle,13,0,30,17
1714621024430,EDS 139,B00,507313,Pappas; Elizabeth,13,0,30,17
1714621025454,EDS 201,A00,507315,Staff,13,0,30,17
1714621026480,EDS 203,A01,507317,Halter; Christopher P.,12,0,30,18
1714621027505,EDS 204R,A01,507319,Halter; Christopher P.,0,3,30,30
1714621027505,EDS 204R,B01,507331,Heinzman; Erica M.,16,0,30,14
1714621028529,EDS 206R,A00,507332,Staff,0,4,30,30
1714621028529,EDS 206R,B00,507343,Staff,17,0,30,13
1714621029555,EDS 250,A00,507344,Hemans; Patricia Ann Benitez,22,0,40,18
1714621030579,EDS 281,A00,507345,Daly; Alan J.,18,0,18,0
1714621031603,EDS 284,A00,507350,Daly; Alan J.,16,0,16,0
1714621032634,EDS 286,A00,507359,Fine; Sarah,18,0,18,0
1714621033659,EDS 289C,A01,507361,Daly; Alan J.,18,0,18,0
1714621034686,EDS 290,A00,507366,Hofstetter; Carolyn,15,0,15,0
1714621035711,LIGM 5A,A00,507421,Fischer-Grunski; Eva K,18,0,20,2
1714621036736,LIGM 5B,A00,507423,Fischer-Grunski; Eva K,19,0,20,1
1714621037765,LIGM 5C,A00,507425,Fischer-Grunski; Eva K,19,0,20,1
1714621038796,LIIT 5AS,A00,507427,Carnelos; Chiara,20,0,20,0
1714621039820,LIIT 5BS,A00,507430,Carnelos; Chiara,20,0,20,0
1714621040845,LIIT 5CS,A00,507432,Carnelos; Chiara,20,0,20,0
1714621041872,LISP 5A,A00,507541,Munoz Sanchez; Alicia,11,0,20,9
1714621042901,LISP 5B,A00,507671,Munoz Sanchez; Alicia,8,0,20,12
1714621043927,LISP 5C,A00,507696,Munoz Sanchez; Alicia,9,0,20,11
1714621044958,MAE 197,001,528363,Boechler; Nicholas Sebastia,9998,0,9999,1
1714621045984,MATH 197,001,523477,Kedlaya; Kiran S.,9995,0,9999,4
1714621045984,MATH 197,002,563811,Zhang; Danna,9995,0,9999,4
1714621045984,MATH 197,003,628552,Dumitriu; Ioana,9998,0,9999,1
1714621047011,MCWP 40R,A00,518780,Staff,2,0,20,18
1714621047011,MCWP 40R,B00,518781,Staff,8,0,20,12
1714621047011,MCWP 40R,C00,518783,Staff,6,0,20,14
1714621048053,MCWP 50R,A00,518791,Staff,0,0,20,20
1714621048053,MCWP 50R,B00,518792,Staff,0,2,20,20
1714621048053,MCWP 50R,C00,518793,Staff,0,2,20,20
1714621048053,MCWP 50R,D00,518794,Staff,0,0,20,20
1714621048053,MCWP 50R,E00,518795,Staff,0,2,20,20
1714621048053,MCWP 50R,F00,518796,Staff,0,0,20,20
1714621048053,MCWP 50R,G00,518797,Staff,0,1,20,20
1714621049078,MMW 12R,A01,514034,Herbst; Matthew,0,0,16,16
1714621049078,MMW 12R,A02,514035,Herbst; Matthew,1,0,16,15
1714621050105,MMW 13R,A01,514037,Staff,0,4,16,16
1714621050105,MMW 13R,A02,514039,Staff,0,2,16,16
1714621050105,MMW 13R,A03,628519,Staff,0,2,16,16
1714621052158,SIO 295LS,A00,523233,Staff,10,0,30,20
1714621053186,SIO 295S,A00,523232,Staff,10,0,30,20
1714621054212,SIOC 290S,A01,637330,Merrifield; Mark A,23,0,30,7
1714621055238,SIOC 291S,A01,637333,Gabriel; Corey John,23,0,30,7
1714621056263,SOCI 117,A01,494376,Staff,0,4,5,5
1714621057290,WES 237B,A00,494380,Staff,9,0,20,11
1714621059359,AESE 279B,A00,494370,Wade; Jon P,0,0,33,33
1714621060383,AIP 197,001,627712,Vespa; Emanuel Ignacio,9998,0,9999,1
1714621061412,ANAR 135S,A00,494369,Braswell; Geoffrey E.,0,0,0,0
1714621062436,BENG 196,001,628496,Engler; Adam J.,9998,0,9999,1
1714621063462,CAT 124RS,A01,519847,Geibel; William,0,0,20,20
1714621064486,CAT 125RS,A01,515971,Geibel; William,0,0,20,20
1714621065514,CLRE 250,A00,511389,Morris; Sheldon,9993,0,9999,6
1714621066540,CLRE 251,A00,507176,Mehta; Ravindra L.,9993,0,9999,6
1714621066540,CLRE 251,B00,511410,Mehta; Ravindra L.,9998,0,9999,1
1714621067620,CLRE 252,A00,507189,Cuomo; Raphael Eduardo,9995,0,9999,4
1714621068646,CLRE 253,A00,507199,Vaida; Florin,9994,0,9999,5
1714621068646,CLRE 253,B00,507202,Vaida; Florin,9999,0,9999,0
1714621069673,CLRE 259,A00,507211,Patel; Hemal,9996,0,9999,3
1714621070700,CLRE 260,A00,507221,Cuomo; Raphael Eduardo,9999,0,9999,0
1714621071724,CLRE 297,001,507242,Cuomo; Raphael Eduardo,9999,0,9999,0
1714621072749,COGS 197,001,638244,Voytek; Bradley Thomas,9998,0,9999,1
1714621073774,CSE 191,A00,516875,Minnes Kemp; Mor Mia,9992,0,9999,7
1714621074801,CSE 197,001,637388,Minnes Kemp; Mor Mia,9998,0,9999,1
1714621075826,CSS 201S,A01,494383,Staff,35,0,35,0
1714621076851,CSS 202S,A01,494387,Staff,35,0,35,0
1714621077879,DSC 197,001,628532,Eldridge; Justin Matthew,9996,0,9999,3
1714621078905,EAP 100,A00,516065,Staff,9797,0,9999,202
1714621079931,ECE 45,A01,507414,Staff,33,0,60,27
1714621081983,ECE 111,A01,507420,Staff,15,0,50,35
1714621083009,ECE 197,001,548057,Sievenpiper; Daniel F.,9993,0,9999,6
1714621084036,EDS 115,A00,507243,Choi; Bailey Miyeon,10,0,28,18
1714621085062,EDS 117,A01,494379,Staff,1,5,30,29
1714621086089,EDS 125,A00,507246,Hopkins; Megan Beth,9,0,30,21
1714621087117,EDS 128A,A01,507264,Fargason; Sharon Gayle,8,0,26,18
1714621088144,EDS 128B,A01,507293,Pappas; Elizabeth,12,0,30,18
1714621089168,EDS 139,A00,507294,Fargason; Sharon Gayle,13,0,30,17
1714621089168,EDS 139,B00,507313,Pappas; Elizabeth,13,0,30,17
1714621090195,EDS 201,A00,507315,Staff,13,0,30,17
1714621091224,EDS 203,A01,507317,Halter; Christopher P.,12,0,30,18
1714621092248,EDS 204R,A01,507319,Halter; Christopher P.,0,3,30,30
1714621092248,EDS 204R,B01,507331,Heinzman; Erica M.,16,0,30,14
1714621093273,EDS 206R,A00,507332,Staff,0,4,30,30
1714621093273,EDS 206R,B00,507343,Staff,17,0,30,13
1714621094301,EDS 250,A00,507344,Hemans; Patricia Ann Benitez,22,0,40,18
1714621095327,EDS 281,A00,507345,Daly; Alan J.,18,0,18,0
1714621096350,EDS 284,A00,507350,Daly; Alan J.,16,0,16,0
1714621097374,EDS 286,A00,507359,Fine; Sarah,18,0,18,0
1714621098401,EDS 289C,A01,507361,Daly; Alan J.,18,0,18,0
1714621099427,EDS 290,A00,507366,Hofstetter; Carolyn,15,0,15,0
1714621100457,LIGM 5A,A00,507421,Fischer-Grunski; Eva K,18,0,20,2
1714621101487,LIGM 5B,A00,507423,Fischer-Grunski; Eva K,19,0,20,1
1714621102514,LIGM 5C,A00,507425,Fischer-Grunski; Eva K,19,0,20,1
1714621103540,LIIT 5AS,A00,507427,Carnelos; Chiara,20,0,20,0
1714621104565,LIIT 5BS,A00,507430,Carnelos; Chiara,20,0,20,0
1714621105594,LIIT 5CS,A00,507432,Carnelos; Chiara,20,0,20,0
1714621106622,LISP 5A,A00,507541,Munoz Sanchez; Alicia,11,0,20,9
1714621107650,LISP 5B,A00,507671,Munoz Sanchez; Alicia,8,0,20,12
1714621108678,LISP 5C,A00,507696,Munoz Sanchez; Alicia,9,0,20,11
1714621109703,MAE 197,001,528363,Boechler; Nicholas Sebastia,9998,0,9999,1
1714621110731,MATH 197,001,523477,Kedlaya; Kiran S.,9995,0,9999,4
1714621110731,MATH 197,002,563811,Zhang; Danna,9995,0,9999,4
1714621110731,MATH 197,003,628552,Dumitriu; Ioana,9998,0,9999,1
1714621111762,MCWP 40R,A00,518780,Staff,2,0,20,18
1714621111762,MCWP 40R,B00,518781,Staff,8,0,20,12
1714621111762,MCWP 40R,C00,518783,Staff,6,0,20,14
1714621112791,MCWP 50R,A00,518791,Staff,0,0,20,20
1714621112791,MCWP 50R,B00,518792,Staff,0,2,20,20
1714621112791,MCWP 50R,C00,518793,Staff,0,2,20,20
1714621112791,MCWP 50R,D00,518794,Staff,0,0,20,20
1714621112791,MCWP 50R,E00,518795,Staff,0,2,20,20
1714621112791,MCWP 50R,F00,518796,Staff,0,0,20,20
1714621112791,MCWP 50R,G00,518797,Staff,0,1,20,20
1714621113816,MMW 12R,A01,514034,Herbst; Matthew,0,0,16,16
1714621113816,MMW 12R,A02,514035,Herbst; Matthew,1,0,16,15
1714621114844,MMW 13R,A01,514037,Staff,0,4,16,16
1714621114844,MMW 13R,A02,514039,Staff,0,2,16,16
1714621114844,MMW 13R,A03,628519,Staff,0,2,16,16
1714621116898,SIO 295LS,A00,523233,Staff,10,0,30,20
1714621117927,SIO 295S,A00,523232,Staff,10,0,30,20
1714621118955,SIOC 290S,A01,637330,Merrifield; Mark A,23,0,30,7
1714621119981,SIOC 291S,A01,637333,Gabriel; Corey John,23,0,30,7
1714621121011,SOCI 117,A01,494376,Staff,0,4,5,5
1714621122037,WES 237B,A00,494380,Staff,9,0,20,11
1714621124106,AESE 279B,A00,494370,Wade; Jon P,0,0,33,33
1714621125134,AIP 197,001,627712,Vespa; Emanuel Ignacio,9998,0,9999,1
1714621126163,ANAR 135S,A00,494369,Braswell; Geoffrey E.,0,0,0,0
1714621127190,BENG 196,001,628496,Engler; Adam J.,9998,0,9999,1
1714621128218,CAT 124RS,A01,519847,Geibel; William,0,0,20,20
1714621129243,CAT 125RS,A01,515971,Geibel; William,0,0,20,20
1714621130270,CLRE 250,A00,511389,Morris; Sheldon,9993,0,9999,6
1714621131296,CLRE 251,A00,507176,Mehta; Ravindra L.,9993,0,9999,6
1714621131296,CLRE 251,B00,511410,Mehta; Ravindra L.,9998,0,9999,1
1714621132321,CLRE 252,A00,507189,Cuomo; Raphael Eduardo,9995,0,9999,4
1714621133346,CLRE 253,A00,507199,Vaida; Florin,9994,0,9999,5
1714621133346,CLRE 253,B00,507202,Vaida; Florin,9999,0,9999,0
1714621134371,CLRE 259,A00,507211,Patel; Hemal,9996,0,9999,3
1714621135398,CLRE 260,A00,507221,Cuomo; Raphael Eduardo,9999,0,9999,0
1714621136422,CLRE 297,001,507242,Cuomo; Raphael Eduardo,9999,0,9999,0
1714621137449,COGS 197,001,638244,Voytek; Bradley Thomas,9998,0,9999,1
1714621138476,CSE 191,A00,516875,Minnes Kemp; Mor Mia,9992,0,9999,7
1714621139504,CSE 197,001,637388,Minnes Kemp; Mor Mia,9998,0,9999,1
1714621140534,CSS 201S,A01,494383,Staff,35,0,35,0
1714621141572,CSS 202S,A01,494387,Staff,35,0,35,0
1714621142598,DSC 197,001,628532,Eldridge; Justin Matthew,9996,0,9999,3
1714621143623,EAP 100,A00,516065,Staff,9797,0,9999,202
1714621144650,ECE 45,A01,507414,Staff,33,0,60,27
1714621146701,ECE 111,A01,507420,Staff,15,0,50,35
1714621147729,ECE 197,001,548057,Sievenpiper; Daniel F.,9993,0,9999,6
1714621148757,EDS 115,A00,507243,Choi; Bailey Miyeon,10,0,28,18
1714621149782,EDS 117,A01,494379,Staff,1,5,30,29
1714621150807,EDS 125,A00,507246,Hopkins; Megan Beth,9,0,30,21
1714621151837,EDS 128A,A01,507264,Fargason; Sharon Gayle,8,0,26,18
1714621152865,EDS 128B,A01,507293,Pappas; Elizabeth,12,0,30,18
1714621153890,EDS 139,A00,507294,Fargason; Sharon Gayle,13,0,30,17
1714621153890,EDS 139,B00,507313,Pappas; Elizabeth,13,0,30,17
1714621154915,EDS 201,A00,507315,Staff,13,0,30,17
1714621155944,EDS 203,A01,507317,Halter; Christopher P.,12,0,30,18
1714621156973,EDS 204R,A01,507319,Halter; Christopher P.,0,3,30,30
1714621156973,EDS 204R,B01,507331,Heinzman; Erica M.,16,0,30,14
1714621157996,EDS 206R,A00,507332,Staff,0,4,30,30
1714621157996,EDS 206R,B00,507343,Staff,17,0,30,13
1714621159024,EDS 250,A00,507344,Hemans; Patricia Ann Benitez,22,0,40,18
1714621160053,EDS 281,A00,507345,Daly; Alan J.,18,0,18,0
1714621161081,EDS 284,A00,507350,Daly; Alan J.,16,0,16,0
1714621162112,EDS 286,A00,507359,Fine; Sarah,18,0,18,0
1714621163136,EDS 289C,A01,507361,Daly; Alan J.,18,0,18,0
1714621164166,EDS 290,A00,507366,Hofstetter; Carolyn,15,0,15,0
1714621165197,LIGM 5A,A00,507421,Fischer-Grunski; Eva K,18,0,20,2
1714621166224,LIGM 5B,A00,507423,Fischer-Grunski; Eva K,19,0,20,1
1714621167251,LIGM 5C,A00,507425,Fischer-Grunski; Eva K,19,0,20,1
1714621168279,LIIT 5AS,A00,507427,Carnelos; Chiara,20,0,20,0
1714621169304,LIIT 5BS,A00,507430,Carnelos; Chiara,20,0,20,0
1714621170331,LIIT 5CS,A00,507432,Carnelos; Chiara,20,0,20,0
1714621171357,LISP 5A,A00,507541,Munoz Sanchez; Alicia,11,0,20,9
1714621172382,LISP 5B,A00,507671,Munoz Sanchez; Alicia,8,0,20,12
1714621173408,LISP 5C,A00,507696,Munoz Sanchez; Alicia,9,0,20,11
1714621174432,MAE 197,001,528363,Boechler; Nicholas Sebastia,9998,0,9999,1
1714621175459,MATH 197,001,523477,Kedlaya; Kiran S.,9995,0,9999,4
1714621175459,MATH 197,002,563811,Zhang; Danna,9995,0,9999,4
1714621175459,MATH 197,003,628552,Dumitriu; Ioana,9998,0,9999,1
1714621176485,MCWP 40R,A00,518780,Staff,2,0,20,18
1714621176485,MCWP 40R,B00,518781,Staff,8,0,20,12
1714621176485,MCWP 40R,C00,518783,Staff,6,0,20,14
1714621177510,MCWP 50R,A00,518791,Staff,0,0,20,20
1714621177510,MCWP 50R,B00,518792,Staff,0,2,20,20
1714621177510,MCWP 50R,C00,518793,Staff,0,2,20,20
1714621177510,MCWP 50R,D00,518794,Staff,0,0,20,20
1714621177510,MCWP 50R,E00,518795,Staff,0,2,20,20
1714621177510,MCWP 50R,F00,518796,Staff,0,0,20,20
1714621177510,MCWP 50R,G00,518797,Staff,0,1,20,20
1714621178535,MMW 12R,A01,514034,Herbst; Matthew,0,0,16,16
1714621178535,MMW 12R,A02,514035,Herbst; Matthew,1,0,16,15
1714621179561,MMW 13R,A01,514037,Staff,0,4,16,16
1714621179561,MMW 13R,A02,514039,Staff,0,2,16,16
1714621179561,MMW 13R,A03,628519,Staff,0,2,16,16
1714621181644,SIO 295LS,A00,523233,Staff,10,0,30,20
1714621182669,SIO 295S,A00,523232,Staff,10,0,30,20
1714621183699,SIOC 290S,A01,637330,Merrifield; Mark A,23,0,30,7
1714621184729,SIOC 291S,A01,637333,Gabriel; Corey John,23,0,30,7
1714621185760,SOCI 117,A01,494376,Staff,0,4,5,5
1714621186787,WES 237B,A00,494380,Staff,9,0,20,11
1714621188869,AESE 279B,A00,494370,Wade; Jon P,0,0,33,33
1714621189894,AIP 197,001,627712,Vespa; Emanuel Ignacio,9998,0,9999,1
1714621190923,ANAR 135S,A00,494369,Braswell; Geoffrey E.,0,0,0,0
1714621191949,BENG 196,001,628496,Engler; Adam J.,9998,0,9999,1
1714621192978,CAT 124RS,A01,519847,Geibel; William,0,0,20,20
1714621194005,CAT 125RS,A01,515971,Geibel; William,0,0,20,20
1714621195036,CLRE 250,A00,511389,Morris; Sheldon,9993,0,9999,6
1714621196064,CLRE 251,A00,507176,Mehta; Ravindra L.,9993,0,9999,6
1714621196064,CLRE 251,B00,511410,Mehta; Ravindra L.,9998,0,9999,1
1714621197089,CLRE 252,A00,507189,Cuomo; Raphael Eduardo,9995,0,9999,4
1714621198114,CLRE 253,A00,507199,Vaida; Florin,9994,0,9999,5
1714621198114,CLRE 253,B00,507202,Vaida; Florin,9999,0,9999,0
1714621199142,CLRE 259,A00,507211,Patel; Hemal,9996,0,9999,3
1714621200167,CLRE 260,A00,507221,Cuomo; Raphael Eduardo,9999,0,9999,0
1714621201195,CLRE 297,001,507242,Cuomo; Raphael Eduardo,9999,0,9999,0
1714621202225,COGS 197,001,638244,Voytek; Bradley Thomas,9998,0,9999,1
1714621203248,CSE 191,A00,516875,Minnes Kemp; Mor Mia,9992,0,9999,7
1714621204273,CSE 197,001,637388,Minnes Kemp; Mor Mia,9998,0,9999,1
1714621205302,CSS 201S,A01,494383,Staff,35,0,35,0
1714621206331,CSS 202S,A01,494387,Staff,35,0,35,0
1714621207358,DSC 197,001,628532,Eldridge; Justin Matthew,9996,0,9999,3
1714621208385,EAP 100,A00,516065,Staff,9797,0,9999,202
1714621209414,ECE 45,A01,507414,Staff,33,0,60,27
1714621211465,ECE 111,A01,507420,Staff,15,0,50,35
1714621212490,ECE 197,001,548057,Sievenpiper; Daniel F.,9993,0,9999,6
1714621213518,EDS 115,A00,507243,Choi; Bailey Miyeon,10,0,28,18
1714621214544,EDS 117,A01,494379,Staff,1,5,30,29
1714621215569,EDS 125,A00,507246,Hopkins; Megan Beth,9,0,30,21
1714621216597,EDS 128A,A01,507264,Fargason; Sharon Gayle,8,0,26,18
1714621217623,EDS 128B,A01,507293,Pappas; Elizabeth,12,0,30,18
1714621218647,EDS 139,A00,507294,Fargason; Sharon Gayle,13,0,30,17
1714621218647,EDS 139,B00,507313,Pappas; Elizabeth,13,0,30,17
1714621219671,EDS 201,A00,507315,Staff,13,0,30,17
1714621220698,EDS 203,A01,507317,Halter; Christopher P.,12,0,30,18
1714621221727,EDS 204R,A01,507319,Halter; Christopher P.,0,3,30,30
1714621221727,EDS 204R,B01,507331,Heinzman; Erica M.,16,0,30,14
1714621222756,EDS 206R,A00,507332,Staff,0,4,30,30
1714621222756,EDS 206R,B00,507343,Staff,17,0,30,13
1714621223781,EDS 250,A00,507344,Hemans; Patricia Ann Benitez,22,0,40,18
1714621224807,EDS 281,A00,507345,Daly; Alan J.,18,0,18,0
1714621225832,EDS 284,A00,507350,Daly; Alan J.,16,0,16,0
1714621226861,EDS 286,A00,507359,Fine; Sarah,18,0,18,0
1714621227886,EDS 289C,A01,507361,Daly; Alan J.,18,0,18,0
1714621228914,EDS 290,A00,507366,Hofstetter; Carolyn,15,0,15,0
1714621229941,LIGM 5A,A00,507421,Fischer-Grunski; Eva K,18,0,20,2
1714621230969,LIGM 5B,A00,507423,Fischer-Grunski; Eva K,19,0,20,1
1714621231994,LIGM 5C,A00,507425,Fischer-Grunski; Eva K,19,0,20,1
1714621233020,LIIT 5AS,A00,507427,Carnelos; Chiara,20,0,20,0
1714621234044,LIIT 5BS,A00,507430,Carnelos; Chiara,20,0,20,0
1714621235071,LIIT 5CS,A00,507432,Carnelos; Chiara,20,0,20,0
1714621236098,LISP 5A,A00,507541,Munoz Sanchez; Alicia,11,0,20,9
1714621237123,LISP 5B,A00,507671,Munoz Sanchez; Alicia,8,0,20,12
1714621238152,LISP 5C,A00,507696,Munoz Sanchez; Alicia,9,0,20,11
1714621239177,MAE 197,001,528363,Boechler; Nicholas Sebastia,9998,0,9999,1
1714621240203,MATH 197,001,523477,Kedlaya; Kiran S.,9995,0,9999,4
1714621240203,MATH 197,002,563811,Zhang; Danna,9995,0,9999,4
1714621240203,MATH 197,003,628552,Dumitriu; Ioana,9998,0,9999,1
1714621241233,MCWP 40R,A00,518780,Staff,2,0,20,18
1714621241233,MCWP 40R,B00,518781,Staff,8,0,20,12
1714621241233,MCWP 40R,C00,518783,Staff,6,0,20,14
1714621242257,MCWP 50R,A00,518791,Staff,0,0,20,20
1714621242257,MCWP 50R,B00,518792,Staff,0,2,20,20
1714621242257,MCWP 50R,C00,518793,Staff,0,2,20,20
1714621242257,MCWP 50R,D00,518794,Staff,0,0,20,20
1714621242257,MCWP 50R,E00,518795,Staff,0,2,20,20
1714621242257,MCWP 50R,F00,518796,Staff,0,0,20,20
1714621242257,MCWP 50R,G00,518797,Staff,0,1,20,20
1714621243281,MMW 12R,A01,514034,Herbst; Matthew,0,0,16,16
1714621243281,MMW 12R,A02,514035,Herbst; Matthew,1,0,16,15
1714621244307,MMW 13R,A01,514037,Staff,0,4,16,16
1714621244307,MMW 13R,A02,514039,Staff,0,2,16,16
1714621244307,MMW 13R,A03,628519,Staff,0,2,16,16
1714621246359,SIO 295LS,A00,523233,Staff,10,0,30,20
1714621247386,SIO 295S,A00,523232,Staff,10,0,30,20
1714621248413,SIOC 290S,A01,637330,Merrifield; Mark A,23,0,30,7
1714621249437,SIOC 291S,A01,637333,Gabriel; Corey John,23,0,30,7
1714621250464,SOCI 117,A01,494376,Staff,0,4,5,5
1714621251489,WES 237B,A00,494380,Staff,9,0,20,11
1714621253560,AESE 279B,A00,494370,Wade; Jon P,0,0,33,33
1714621254590,AIP 197,001,627712,Vespa; Emanuel Ignacio,9998,0,9999,1
1714621255618,ANAR 135S,A00,494369,Braswell; Geoffrey E.,0,0,0,0
1714621256644,BENG 196,001,628496,Engler; Adam J.,9998,0,9999,1
1714621257672,CAT 124RS,A01,519847,Geibel; William,0,0,20,20
1714621258700,CAT 125RS,A01,515971,Geibel; William,0,0,20,20
1714621259725,CLRE 250,A00,511389,Morris; Sheldon,9993,0,9999,6
1714621260756,CLRE 251,A00,507176,Mehta; Ravindra L.,9993,0,9999,6
1714621260756,CLRE 251,B00,511410,Mehta; Ravindra L.,9998,0,9999,1
1714621261787,CLRE 252,A00,507189,Cuomo; Raphael Eduardo,9995,0,9999,4
1714621262811,CLRE 253,A00,507199,Vaida; Florin,9994,0,9999,5
1714621262811,CLRE 253,B00,507202,Vaida; Florin,9999,0,9999,0
1714621263842,CLRE 259,A00,507211,Patel; Hemal,9996,0,9999,3
1714621264870,CLRE 260,A00,507221,Cuomo; Raphael Eduardo,9999,0,9999,0
1714621265896,CLRE 297,001,507242,Cuomo; Raphael Eduardo,9999,0,9999,0
1714621266925,COGS 197,001,638244,Voytek; Bradley Thomas,9998,0,9999,1
1714621267949,CSE 191,A00,516875,Minnes Kemp; Mor Mia,9992,0,9999,7
1714621268978,CSE 197,001,637388,Minnes Kemp; Mor Mia,9998,0,9999,1
1714621270010,CSS 201S,A01,494383,Staff,35,0,35,0
1714621271037,CSS 202S,A01,494387,Staff,35,0,35,0
1714621272065,DSC 197,001,628532,Eldridge; Justin Matthew,9996,0,9999,3
1714621273092,EAP 100,A00,516065,Staff,9797,0,9999,202
1714621274118,ECE 45,A01,507414,Staff,33,0,60,27
1714621276168,ECE 111,A01,507420,Staff,15,0,50,35
1714621277197,ECE 197,001,548057,Sievenpiper; Daniel F.,9993,0,9999,6
1714621278227,EDS 115,A00,507243,Choi; Bailey Miyeon,10,0,28,18
1714621279256,EDS 117,A01,494379,Staff,1,5,30,29
1714621280283,EDS 125,A00,507246,Hopkins; Megan Beth,9,0,30,21
1714621281309,EDS 128A,A01,507264,Fargason; Sharon Gayle,8,0,26,18
1714621282335,EDS 128B,A01,507293,Pappas; Elizabeth,12,0,30,18
1714621283360,EDS 139,A00,507294,Fargason; Sharon Gayle,13,0,30,17
1714621283360,EDS 139,B00,507313,Pappas; Elizabeth,13,0,30,17
1714621284383,EDS 201,A00,507315,Staff,13,0,30,17
1714621285412,EDS 203,A01,507317,Halter; Christopher P.,12,0,30,18
1714621286441,EDS 204R,A01,507319,Halter; Christopher P.,0,3,30,30
1714621286441,EDS 204R,B01,507331,Heinzman; Erica M.,16,0,30,14
1714621287469,EDS 206R,A00,507332,Staff,0,4,30,30
1714621287469,EDS 206R,B00,507343,Staff,17,0,30,13
1714621288497,EDS 250,A00,507344,Hemans; Patricia Ann Benitez,22,0,40,18
1714621289523,EDS 281,A00,507345,Daly; Alan J.,18,0,18,0
1714621290549,EDS 284,A00,507350,Daly; Alan J.,16,0,16,0
1714621291575,EDS 286,A00,507359,Fine; Sarah,18,0,18,0
1714621292603,EDS 289C,A01,507361,Daly; Alan J.,18,0,18,0
1714621293629,EDS 290,A00,507366,Hofstetter; Carolyn,15,0,15,0
1714621294659,LIGM 5A,A00,507421,Fischer-Grunski; Eva K,18,0,20,2
1714621295685,LIGM 5B,A00,507423,Fischer-Grunski; Eva K,19,0,20,1
1714621296710,LIGM 5C,A00,507425,Fischer-Grunski; Eva K,19,0,20,1
1714621297739,LIIT 5AS,A00,507427,Carnelos; Chiara,20,0,20,0
1714621298764,LIIT 5BS,A00,507430,Carnelos; Chiara,20,0,20,0
1714621299789,LIIT 5CS,A00,507432,Carnelos; Chiara,20,0,20,0
1714621300816,LISP 5A,A00,507541,Munoz Sanchez; Alicia,11,0,20,9
1714621301846,LISP 5B,A00,507671,Munoz Sanchez; Alicia,8,0,20,12
1714621302875,LISP 5C,A00,507696,Munoz Sanchez; Alicia,9,0,20,11
1714621303900,MAE 197,001,528363,Boechler; Nicholas Sebastia,9998,0,9999,1
1714621304931,MATH 197,001,523477,Kedlaya; Kiran S.,9995,0,9999,4
1714621304931,MATH 197,002,563811,Zhang; Danna,9995,0,9999,4
1714621304931,MATH 197,003,628552,Dumitriu; Ioana,9998,0,9999,1
1714621305961,MCWP 40R,A00,518780,Staff,2,0,20,18
1714621305961,MCWP 40R,B00,518781,Staff,8,0,20,12
1714621305961,MCWP 40R,C00,518783,Staff,6,0,20,14
1714621306987,MCWP 50R,A00,518791,Staff,0,0,20,20
1714621306987,MCWP 50R,B00,518792,Staff,0,2,20,20
1714621306987,MCWP 50R,C00,518793,Staff,0,2,20,20
1714621306987,MCWP 50R,D00,518794,Staff,0,0,20,20
1714621306987,MCWP 50R,E00,518795,Staff,0,2,20,20
1714621306987,MCWP 50R,F00,518796,Staff,0,0,20,20
1714621306987,MCWP 50R,G00,518797,Staff,0,1,20,20
1714621308013,MMW 12R,A01,514034,Herbst; Matthew,0,0,16,16
1714621308013,MMW 12R,A02,514035,Herbst; Matthew,1,0,16,15
1714621309039,MMW 13R,A01,514037,Staff,0,4,16,16
1714621309039,MMW 13R,A02,514039,Staff,0,2,16,16
1714621309039,MMW 13R,A03,628519,Staff,0,2,16,16
1714621311094,SIO 295LS,A00,523233,Staff,10,0,30,20
1714621312121,SIO 295S,A00,523232,Staff,10,0,30,20
1714621313147,SIOC 290S,A01,637330,Merrifield; Mark A,23,0,30,7
1714621314177,SIOC 291S,A01,637333,Gabriel; Corey John,23,0,30,7
1714621315201,SOCI 117,A01,494376,Staff,0,4,5,5
1714621316227,WES 237B,A00,494380,Staff,9,0,20,11
1714621318297,AESE 279B,A00,494370,Wade; Jon P,0,0,33,33
1714621319323,AIP 197,001,627712,Vespa; Emanuel Ignacio,9998,0,9999,1
1714621320352,ANAR 135S,A00,494369,Braswell; Geoffrey E.,0,0,0,0
1714621321383,BENG 196,001,628496,Engler; Adam J.,9998,0,9999,1
1714621322407,CAT 124RS,A01,519847,Geibel; William,0,0,20,20
1714621323431,CAT 125RS,A01,515971,Geibel; William,0,0,20,20
1714621324458,CLRE 250,A00,511389,Morris; Sheldon,9993,0,9999,6
1714621325489,CLRE 251,A00,507176,Mehta; Ravindra L.,9993,0,9999,6
1714621325489,CLRE 251,B00,511410,Mehta; Ravindra L.,9998,0,9999,1
1714621326518,CLRE 252,A00,507189,Cuomo; Raphael Eduardo,9995,0,9999,4
1714621327542,CLRE 253,A00,507199,Vaida; Florin,9994,0,9999,5
1714621327542,CLRE 253,B00,507202,Vaida; Florin,9999,0,9999,0
1714621328571,CLRE 259,A00,507211,Patel; Hemal,9996,0,9999,3
1714621329598,CLRE 260,A00,507221,Cuomo; Raphael Eduardo,9999,0,9999,0
1714621330625,CLRE 297,001,507242,Cuomo; Raphael Eduardo,9999,0,9999,0
1714621331652,COGS 197,001,638244,Voytek; Bradley Thomas,9998,0,9999,1
1714621332678,CSE 191,A00,516875,Minnes Kemp; Mor Mia,9992,0,9999,7
1714621333702,CSE 197,001,637388,Minnes Kemp; Mor Mia,9998,0,9999,1
1714621334731,CSS 201S,A01,494383,Staff,35,0,35,0
1714621335756,CSS 202S,A01,494387,Staff,35,0,35,0
1714621336782,DSC 197,001,628532,Eldridge; Justin Matthew,9996,0,9999,3
1714621337807,EAP 100,A00,516065,Staff,9797,0,9999,202
1714621338833,ECE 45,A01,507414,Staff,33,0,60,27
1714621340885,ECE 111,A01,507420,Staff,15,0,50,35
1714621341914,ECE 197,001,548057,Sievenpiper; Daniel F.,9993,0,9999,6
1714621342943,EDS 115,A00,507243,Choi; Bailey Miyeon,10,0,28,18
1714621343973,EDS 117,A01,494379,Staff,1,5,30,29
1714621345001,EDS 125,A00,507246,Hopkins; Megan Beth,9,0,30,21
1714621346032,EDS 128A,A01,507264,Fargason; Sharon Gayle,8,0,26,18
1714621347060,EDS 128B,A01,507293,Pappas; Elizabeth,12,0,30,18
1714621348085,EDS 139,A00,507294,Fargason; Sharon Gayle,13,0,30,17
1714621348085,EDS 139,B00,507313,Pappas; Elizabeth,13,0,30,17
1714621349109,EDS 201,A00,507315,Staff,13,0,30,17
1714621350137,EDS 203,A01,507317,Halter; Christopher P.,12,0,30,18
1714621351165,EDS 204R,A01,507319,Halter; Christopher P.,0,3,30,30
1714621351165,EDS 204R,B01,507331,Heinzman; Erica M.,16,0,30,14
1714621352193,EDS 206R,A00,507332,Staff,0,4,30,30
1714621352193,EDS 206R,B00,507343,Staff,17,0,30,13
1714621353217,EDS 250,A00,507344,Hemans; Patricia Ann Benitez,22,0,40,18
1714621354245,EDS 281,A00,507345,Daly; Alan J.,18,0,18,0
1714621355272,EDS 284,A00,507350,Daly; Alan J.,16,0,16,0
1714621356301,EDS 286,A00,507359,Fine; Sarah,18,0,18,0
1714621357327,EDS 289C,A01,507361,Daly; Alan J.,18,0,18,0
1714621358353,EDS 290,A00,507366,Hofstetter; Carolyn,15,0,15,0
1714621359382,LIGM 5A,A00,507421,Fischer-Grunski; Eva K,18,0,20,2
1714621360407,LIGM 5B,A00,507423,Fischer-Grunski; Eva K,19,0,20,1
1714621361431,LIGM 5C,A00,507425,Fischer-Grunski; Eva K,19,0,20,1
1714621362457,LIIT 5AS,A00,507427,Carnelos; Chiara,20,0,20,0
1714621363484,LIIT 5BS,A00,507430,Carnelos; Chiara,20,0,20,0
1714621364508,LIIT 5CS,A00,507432,Carnelos; Chiara,20,0,20,0
1714621365641,LISP 5A,A00,507541,Munoz Sanchez; Alicia,11,0,20,9
1714621366665,LISP 5B,A00,507671,Munoz Sanchez; Alicia,8,0,20,12
1714621367693,LISP 5C,A00,507696,Munoz Sanchez; Alicia,9,0,20,11
1714621368718,MAE 197,001,528363,Boechler; Nicholas Sebastia,9998,0,9999,1
1714621369749,MATH 197,001,523477,Kedlaya; Kiran S.,9995,0,9999,4
1714621369749,MATH 197,002,563811,Zhang; Danna,9995,0,9999,4
1714621369749,MATH 197,003,628552,Dumitriu; Ioana,9998,0,9999,1
1714621370773,MCWP 40R,A00,518780,Staff,2,0,20,18
1714621370773,MCWP 40R,B00,518781,Staff,8,0,20,12
1714621370773,MCWP 40R,C00,518783,Staff,6,0,20,14
1714621371801,MCWP 50R,A00,518791,Staff,0,0,20,20
1714621371801,MCWP 50R,B00,518792,Staff,0,2,20,20
1714621371801,MCWP 50R,C00,518793,Staff,0,2,20,20
1714621371801,MCWP 50R,D00,518794,Staff,0,0,20,20
1714621371801,MCWP 50R,E00,518795,Staff,0,2,20,20
1714621371801,MCWP 50R,F00,518796,Staff,0,0,20,20
1714621371801,MCWP 50R,G00,518797,Staff,0,1,20,20
1714621372831,MMW 12R,A01,514034,Herbst; Matthew,0,0,16,16
1714621372831,MMW 12R,A02,514035,Herbst; Matthew,1,0,16,15
1714621373864,MMW 13R,A01,514037,Staff,0,4,16,16
1714621373864,MMW 13R,A02,514039,Staff,0,2,16,16
1714621373864,MMW 13R,A03,628519,Staff,0,2,16,16
1714621375915,SIO 295LS,A00,523233,Staff,10,0,30,20
1714621376940,SIO 295S,A00,523232,Staff,10,0,30,20
1714621377968,SIOC 290S,A01,637330,Merrifield; Mark A,23,0,30,7
1714621378996,SIOC 291S,A01,637333,Gabriel; Corey John,23,0,30,7
1714621380022,SOCI 117,A01,494376,Staff,0,4,5,5
1714621381052,WES 237B,A00,494380,Staff,9,0,20,11
1714621383116,AESE 279B,A00,494370,Wade; Jon P,0,0,33,33
1714621384142,AIP 197,001,627712,Vespa; Emanuel Ignacio,9998,0,9999,1
1714621385167,ANAR 135S,A00,494369,Braswell; Geoffrey E.,0,0,0,0
1714621386194,BENG 196,001,628496,Engler; Adam J.,9998,0,9999,1
1714621387221,CAT 124RS,A01,519847,Geibel; William,0,0,20,20
1714621388249,CAT 125RS,A01,515971,Geibel; William,0,0,20,20
1714621389277,CLRE 250,A00,511389,Morris; Sheldon,9993,0,9999,6
1714621390303,CLRE 251,A00,507176,Mehta; Ravindra L.,9993,0,9999,6
1714621390303,CLRE 251,B00,511410,Mehta; Ravindra L.,9998,0,9999,1
1714621391331,CLRE 252,A00,507189,Cuomo; Raphael Eduardo,9995,0,9999,4
1714621392357,CLRE 253,A00,507199,Vaida; Florin,9994,0,9999,5
1714621392357,CLRE 253,B00,507202,Vaida; Florin,9999,0,9999,0
1714621393385,CLRE 259,A00,507211,Patel; Hemal,9996,0,9999,3
1714621394411,CLRE 260,A00,507221,Cuomo; Raphael Eduardo,9999,0,9999,0
1714621395437,CLRE 297,001,507242,Cuomo; Raphael Eduardo,9999,0,9999,0
1714621396462,COGS 197,001,638244,Voytek; Bradley Thomas,9998,0,9999,1
1714621397487,CSE 191,A00,516875,Minnes Kemp; Mor Mia,9992,0,9999,7
1714621398510,CSE 197,001,637388,Minnes Kemp; Mor Mia,9998,0,9999,1
1714621399535,CSS 201S,A01,494383,Staff,35,0,35,0
1714621400561,CSS 202S,A01,494387,Staff,35,0,35,0
1714621401586,DSC 197,001,628532,Eldridge; Justin Matthew,9996,0,9999,3
1714621402612,EAP 100,A00,516065,Staff,9797,0,9999,202
1714621403640,ECE 45,A01,507414,Staff,33,0,60,27
1714621405692,ECE 111,A01,507420,Staff,15,0,50,35
1714621406722,ECE 197,001,548057,Sievenpiper; Daniel F.,9993,0,9999,6
1714621407748,EDS 115,A00,507243,Choi; Bailey Miyeon,10,0,28,18
1714621408776,EDS 117,A01,494379,Staff,1,5,30,29
1714621409802,EDS 125,A00,507246,Hopkins; Megan Beth,9,0,30,21
1714621410831,EDS 128A,A01,507264,Fargason; Sharon Gayle,8,0,26,18
1714621411859,EDS 128B,A01,507293,Pappas; Elizabeth,12,0,30,18
1714621412886,EDS 139,A00,507294,Fargason; Sharon Gayle,13,0,30,17
1714621412886,EDS 139,B00,507313,Pappas; Elizabeth,13,0,30,17
1714621413911,EDS 201,A00,507315,Staff,13,0,30,17
1714621414936,EDS 203,A01,507317,Halter; Christopher P.,12,0,30,18
1714621415966,EDS 204R,A01,507319,Halter; Christopher P.,0,3,30,30
1714621415966,EDS 204R,B01,507331,Heinzman; Erica M.,16,0,30,14
1714621416991,EDS 206R,A00,507332,Staff,0,4,30,30
1714621416991,EDS 206R,B00,507343,Staff,17,0,30,13
1714621418019,EDS 250,A00,507344,Hemans; Patricia Ann Benitez,22,0,40,18
1714621419047,EDS 281,A00,507345,Daly; Alan J.,18,0,18,0
1714621420075,EDS 284,A00,507350,Daly; Alan J.,16,0,16,0
1714621421101,EDS 286,A00,507359,Fine; Sarah,18,0,18,0
1714621422127,EDS 289C,A01,507361,Daly; Alan J.,18,0,18,0
1714621423155,EDS 290,A00,507366,Hofstetter; Carolyn,15,0,15,0
1714621424181,LIGM 5A,A00,507421,Fischer-Grunski; Eva K,18,0,20,2
1714621425210,LIGM 5B,A00,507423,Fischer-Grunski; Eva K,19,0,20,1
1714621426235,LIGM 5C,A00,507425,Fischer-Grunski; Eva K,19,0,20,1
1714621427263,LIIT 5AS,A00,507427,Carnelos; Chiara,20,0,20,0
1714621428289,LIIT 5BS,A00,507430,Carnelos; Chiara,20,0,20,0
1714621429314,LIIT 5CS,A00,507432,Carnelos; Chiara,20,0,20,0
1714621430340,LISP 5A,A00,507541,Munoz Sanchez; Alicia,11,0,20,9
1714621431368,LISP 5B,A00,507671,Munoz Sanchez; Alicia,8,0,20,12
1714621432393,LISP 5C,A00,507696,Munoz Sanchez; Alicia,9,0,20,11
1714621433418,MAE 197,001,528363,Boechler; Nicholas Sebastia,9998,0,9999,1
1714621434446,MATH 197,001,523477,Kedlaya; Kiran S.,9995,0,9999,4
1714621434446,MATH 197,002,563811,Zhang; Danna,9995,0,9999,4
1714621434446,MATH 197,003,628552,Dumitriu; Ioana,9998,0,9999,1
1714621435472,MCWP 40R,A00,518780,Staff,2,0,20,18
1714621435472,MCWP 40R,B00,518781,Staff,8,0,20,12
1714621435472,MCWP 40R,C00,518783,Staff,6,0,20,14
1714621436557,MCWP 50R,A00,518791,Staff,0,0,20,20
1714621436557,MCWP 50R,B00,518792,Staff,0,2,20,20
1714621436557,MCWP 50R,C00,518793,Staff,0,2,20,20
1714621436557,MCWP 50R,D00,518794,Staff,0,0,20,20
1714621436557,MCWP 50R,E00,518795,Staff,0,2,20,20
1714621436557,MCWP 50R,F00,518796,Staff,0,0,20,20
1714621436557,MCWP 50R,G00,518797,Staff,0,1,20,20
1714621437583,MMW 12R,A01,514034,Herbst; Matthew,0,0,16,16
1714621437583,MMW 12R,A02,514035,Herbst; Matthew,1,0,16,15
1714621438608,MMW 13R,A01,514037,Staff,0,4,16,16
1714621438608,MMW 13R,A02,514039,Staff,0,2,16,16
1714621438608,MMW 13R,A03,628519,Staff,0,2,16,16
1714621440662,SIO 295LS,A00,523233,Staff,10,0,30,20
1714621441686,SIO 295S,A00,523232,Staff,10,0,30,20
1714621442711,SIOC 290S,A01,637330,Merrifield; Mark A,23,0,30,7
1714621443742,SIOC 291S,A01,637333,Gabriel; Corey John,23,0,30,7
1714621444771,SOCI 117,A01,494376,Staff,0,4,5,5
1714621445796,WES 237B,A00,494380,Staff,9,0,20,11
1714621447881,AESE 279B,A00,494370,Wade; Jon P,0,0,33,33
1714621448908,AIP 197,001,627712,Vespa; Emanuel Ignacio,9998,0,9999,1
1714621449936,ANAR 135S,A00,494369,Braswell; Geoffrey E.,0,0,0,0
1714621450964,BENG 196,001,628496,Engler; Adam J.,9998,0,9999,1
1714621451991,CAT 124RS,A01,519847,Geibel; William,0,0,20,20
1714621453018,CAT 125RS,A01,515971,Geibel; William,0,0,20,20
1714621454047,CLRE 250,A00,511389,Morris; Sheldon,9993,0,9999,6
1714621455074,CLRE 251,A00,507176,Mehta; Ravindra L.,9993,0,9999,6
1714621455074,CLRE 251,B00,511410,Mehta; Ravindra L.,9998,0,9999,1
1714621456103,CLRE 252,A00,507189,Cuomo; Raphael Eduardo,9995,0,9999,4
1714621457129,CLRE 253,A00,507199,Vaida; Florin,9994,0,9999,5
1714621457129,CLRE 253,B00,507202,Vaida; Florin,9999,0,9999,0
1714621458152,CLRE 259,A00,507211,Patel; Hemal,9996,0,9999,3
1714621459179,CLRE 260,A00,507221,Cuomo; Raphael Eduardo,9999,0,9999,0
1714621460207,CLRE 297,001,507242,Cuomo; Raphael Eduardo,9999,0,9999,0
1714621461233,COGS 197,001,638244,Voytek; Bradley Thomas,9998,0,9999,1
1714621462258,CSE 191,A00,516875,Minnes Kemp; Mor Mia,9992,0,9999,7
1714621463287,CSE 197,001,637388,Minnes Kemp; Mor Mia,9998,0,9999,1
1714621464311,CSS 201S,A01,494383,Staff,35,0,35,0
1714621465335,CSS 202S,A01,494387,Staff,35,0,35,0
1714621466361,DSC 197,001,628532,Eldridge; Justin Matthew,9996,0,9999,3
1714621467387,EAP 100,A00,516065,Staff,9797,0,9999,202
1714621468412,ECE 45,A01,507414,Staff,33,0,60,27
1714621470464,ECE 111,A01,507420,Staff,15,0,50,35
1714621471490,ECE 197,001,548057,Sievenpiper; Daniel F.,9993,0,9999,6
1714621472515,EDS 115,A00,507243,Choi; Bailey Miyeon,10,0,28,18
1714621473541,EDS 117,A01,494379,Staff,1,5,30,29
1714621474565,EDS 125,A00,507246,Hopkins; Megan Beth,9,0,30,21
1714621475593,EDS 128A,A01,507264,Fargason; Sharon Gayle,8,0,26,18
1714621476621,EDS 128B,A01,507293,Pappas; Elizabeth,12,0,30,18
1714621477645,EDS 139,A00,507294,Fargason; Sharon Gayle,13,0,30,17
1714621477645,EDS 139,B00,507313,Pappas; Elizabeth,13,0,30,17
1714621478672,EDS 201,A00,507315,Staff,13,0,30,17
1714621479699,EDS 203,A01,507317,Halter; Christopher P.,12,0,30,18
1714621480723,EDS 204R,A01,507319,Halter; Christopher P.,0,3,30,30
1714621480723,EDS 204R,B01,507331,Heinzman; Erica M.,16,0,30,14
1714621481752,EDS 206R,A00,507332,Staff,0,4,30,30
1714621481752,EDS 206R,B00,507343,Staff,17,0,30,13
1714621482781,EDS 250,A00,507344,Hemans; Patricia Ann Benitez,22,0,40,18
1714621483810,EDS 281,A00,507345,Daly; Alan J.,18,0,18,0
1714621484838,EDS 284,A00,507350,Daly; Alan J.,16,0,16,0
1714621485867,EDS 286,A00,507359,Fine; Sarah,18,0,18,0
1714621486893,EDS 289C,A01,507361,Daly; Alan J.,18,0,18,0
1714621487922,EDS 290,A00,507366,Hofstetter; Carolyn,15,0,15,0
1714621488951,LIGM 5A,A00,507421,Fischer-Grunski; Eva K,18,0,20,2
1714621489976,LIGM 5B,A00,507423,Fischer-Grunski; Eva K,19,0,20,1
1714621491005,LIGM 5C,A00,507425,Fischer-Grunski; Eva K,19,0,20,1
1714621492031,LIIT 5AS,A00,507427,Carnelos; Chiara,20,0,20,0
1714621493059,LIIT 5BS,A00,507430,Carnelos; Chiara,20,0,20,0
1714621494084,LIIT 5CS,A00,507432,Carnelos; Chiara,20,0,20,0
1714621495111,LISP 5A,A00,507541,Munoz Sanchez; Alicia,11,0,20,9
1714621496136,LISP 5B,A00,507671,Munoz Sanchez; Alicia,8,0,20,12
1714621497161,LISP 5C,A00,507696,Munoz Sanchez; Alicia,9,0,20,11
1714621498186,MAE 197,001,528363,Boechler; Nicholas Sebastia,9998,0,9999,1
1714621499213,MATH 197,001,523477,Kedlaya; Kiran S.,9995,0,9999,4
1714621499213,MATH 197,002,563811,Zhang; Danna,9995,0,9999,4
1714621499213,MATH 197,003,628552,Dumitriu; Ioana,9998,0,9999,1
1714621500247,MCWP 40R,A00,518780,Staff,2,0,20,18
1714621500247,MCWP 40R,B00,518781,Staff,8,0,20,12
1714621500247,MCWP 40R,C00,518783,Staff,6,0,20,14
1714621501277,MCWP 50R,A00,518791,Staff,0,0,20,20
1714621501277,MCWP 50R,B00,518792,Staff,0,2,20,20
1714621501277,MCWP 50R,C00,518793,Staff,0,2,20,20
1714621501277,MCWP 50R,D00,518794,Staff,0,0,20,20
1714621501277,MCWP 50R,E00,518795,Staff,0,2,20,20
1714621501277,MCWP 50R,F00,518796,Staff,0,0,20,20
1714621501277,MCWP 50R,G00,518797,Staff,0,1,20,20
1714621502305,MMW 12R,A01,514034,Herbst; Matthew,0,0,16,16
1714621502305,MMW 12R,A02,514035,Herbst; Matthew,1,0,16,15
1714621503330,MMW 13R,A01,514037,Staff,0,4,16,16
1714621503330,MMW 13R,A02,514039,Staff,0,2,16,16
1714621503330,MMW 13R,A03,628519,Staff,0,2,16,16
1714621505385,SIO 295LS,A00,523233,Staff,10,0,30,20
1714621506408,SIO 295S,A00,523232,Staff,10,0,30,20
1714621507439,SIOC 290S,A01,637330,Merrifield; Mark A,23,0,30,7
1714621508469,SIOC 291S,A01,637333,Gabriel; Corey John,23,0,30,7
1714621509498,SOCI 117,A01,494376,Staff,0,4,5,5
1714621510525,WES 237B,A00,494380,Staff,9,0,20,11
1714621512606,AESE 279B,A00,494370,Wade; Jon P,0,0,33,33
1714621513631,AIP 197,001,627712,Vespa; Emanuel Ignacio,9998,0,9999,1
1714621514660,ANAR 135S,A00,494369,Braswell; Geoffrey E.,0,0,0,0
1714621515687,BENG 196,001,628496,Engler; Adam J.,9998,0,9999,1
1714621516713,CAT 124RS,A01,519847,Geibel; William,0,0,20,20
1714621517740,CAT 125RS,A01,515971,Geibel; William,0,0,20,20
1714621518766,CLRE 250,A00,511389,Morris; Sheldon,9993,0,9999,6
1714621519801,CLRE 251,A00,507176,Mehta; Ravindra L.,9993,0,9999,6
1714621519801,CLRE 251,B00,511410,Mehta; Ravindra L.,9998,0,9999,1
1714621520829,CLRE 252,A00,507189,Cuomo; Raphael Eduardo,9995,0,9999,4
1714621521858,CLRE 253,A00,507199,Vaida; Florin,9994,0,9999,5
1714621521858,CLRE 253,B00,507202,Vaida; Florin,9999,0,9999,0
1714621522886,CLRE 259,A00,507211,Patel; Hemal,9996,0,9999,3
1714621523911,CLRE 260,A00,507221,Cuomo; Raphael Eduardo,9999,0,9999,0
1714621524934,CLRE 297,001,507242,Cuomo; Raphael Eduardo,9999,0,9999,0
1714621525959,COGS 197,001,638244,Voytek; Bradley Thomas,9998,0,9999,1
1714621526985,CSE 191,A00,516875,Minnes Kemp; Mor Mia,9992,0,9999,7
1714621528012,CSE 197,001,637388,Minnes Kemp; Mor Mia,9998,0,9999,1
1714621529041,CSS 201S,A01,494383,Staff,35,0,35,0
1714621530066,CSS 202S,A01,494387,Staff,35,0,35,0
1714621531091,DSC 197,001,628532,Eldridge; Justin Matthew,9996,0,9999,3
1714621532114,EAP 100,A00,516065,Staff,9797,0,9999,202
1714621533142,ECE 45,A01,507414,Staff,33,0,60,27
1714621535192,ECE 111,A01,507420,Staff,15,0,50,35
1714621536221,ECE 197,001,548057,Sievenpiper; Daniel F.,9993,0,9999,6
1714621537247,EDS 115,A00,507243,Choi; Bailey Miyeon,10,0,28,18
1714621538272,EDS 117,A01,494379,Staff,1,5,30,29
1714621539300,EDS 125,A00,507246,Hopkins; Megan Beth,9,0,30,21
1714621540380,EDS 128A,A01,507264,Fargason; Sharon Gayle,8,0,26,18
1714621541405,EDS 128B,A01,507293,Pappas; Elizabeth,12,0,30,18
1714621542431,EDS 139,A00,507294,Fargason; Sharon Gayle,13,0,30,17
1714621542431,EDS 139,B00,507313,Pappas; Elizabeth,13,0,30,17
1714621543458,EDS 201,A00,507315,Staff,13,0,30,17
1714621544484,EDS 203,A01,507317,Halter; Christopher P.,12,0,30,18
1714621545519,EDS 204R,A01,507319,Halter; Christopher P.,0,3,30,30
1714621545519,EDS 204R,B01,507331,Heinzman; Erica M.,16,0,30,14
1714621546545,EDS 206R,A00,507332,Staff,0,4,30,30
1714621546545,EDS 206R,B00,507343,Staff,17,0,30,13
1714621547572,EDS 250,A00,507344,Hemans; Patricia Ann Benitez,22,0,40,18
1714621548598,EDS 281,A00,507345,Daly; Alan J.,18,0,18,0
1714621549623,EDS 284,A00,507350,Daly; Alan J.,16,0,16,0
1714621550648,EDS 286,A00,507359,Fine; Sarah,18,0,18,0
1714621551673,EDS 289C,A01,507361,Daly; Alan J.,18,0,18,0
1714621552703,EDS 290,A00,507366,Hofstetter; Carolyn,15,0,15,0
1714621553933,LIGM 5A,A00,507421,Fischer-Grunski; Eva K,18,0,20,2
1714621554962,LIGM 5B,A00,507423,Fischer-Grunski; Eva K,19,0,20,1
1714621555993,LIGM 5C,A00,507425,Fischer-Grunski; Eva K,19,0,20,1
1714621557021,LIIT 5AS,A00,507427,Carnelos; Chiara,20,0,20,0
1714621558050,LIIT 5BS,A00,507430,Carnelos; Chiara,20,0,20,0
1714621559077,LIIT 5CS,A00,507432,Carnelos; Chiara,20,0,20,0
1714621560109,LISP 5A,A00,507541,Munoz Sanchez; Alicia,11,0,20,9
1714621561140,LISP 5B,A00,507671,Munoz Sanchez; Alicia,8,0,20,12
1714621562164,LISP 5C,A00,507696,Munoz Sanchez; Alicia,9,0,20,11
1714621563190,MAE 197,001,528363,Boechler; Nicholas Sebastia,9998,0,9999,1
1714621564220,MATH 197,001,523477,Kedlaya; Kiran S.,9995,0,9999,4
1714621564220,MATH 197,002,563811,Zhang; Danna,9995,0,9999,4
1714621564220,MATH 197,003,628552,Dumitriu; Ioana,9998,0,9999,1
1714621565248,MCWP 40R,A00,518780,Staff,2,0,20,18
1714621565248,MCWP 40R,B00,518781,Staff,8,0,20,12
1714621565248,MCWP 40R,C00,518783,Staff,6,0,20,14
1714621566278,MCWP 50R,A00,518791,Staff,0,0,20,20
1714621566278,MCWP 50R,B00,518792,Staff,0,2,20,20
1714621566278,MCWP 50R,C00,518793,Staff,0,2,20,20
1714621566278,MCWP 50R,D00,518794,Staff,0,0,20,20
1714621566278,MCWP 50R,E00,518795,Staff,0,2,20,20
1714621566278,MCWP 50R,F00,518796,Staff,0,0,20,20
1714621566278,MCWP 50R,G00,518797,Staff,0,1,20,20
1714621567307,MMW 12R,A01,514034,Herbst; Matthew,0,0,16,16
1714621567307,MMW 12R,A02,514035,Herbst; Matthew,1,0,16,15
1714621568332,MMW 13R,A01,514037,Staff,0,4,16,16
1714621568332,MMW 13R,A02,514039,Staff,0,2,16,16
1714621568332,MMW 13R,A03,628519,Staff,0,2,16,16
1714621570388,SIO 295LS,A00,523233,Staff,10,0,30,20
1714621571411,SIO 295S,A00,523232,Staff,10,0,30,20
1714621572438,SIOC 290S,A01,637330,Merrifield; Mark A,23,0,30,7
1714621573463,SIOC 291S,A01,637333,Gabriel; Corey John,23,0,30,7
1714621574489,SOCI 117,A01,494376,Staff,0,4,5,5
1714621575517,WES 237B,A00,494380,Staff,9,0,20,11
1714621577591,AESE 279B,A00,494370,Wade; Jon P,0,0,33,33
1714621578615,AIP 197,001,627712,Vespa; Emanuel Ignacio,9998,0,9999,1
1714621579642,ANAR 135S,A00,494369,Braswell; Geoffrey E.,0,0,0,0
1714621580671,BENG 196,001,628496,Engler; Adam J.,9998,0,9999,1
1714621581696,CAT 124RS,A01,519847,Geibel; William,0,0,20,20
1714621582725,CAT 125RS,A01,515971,Geibel; William,0,0,20,20
1714621583751,CLRE 250,A00,511389,Morris; Sheldon,9993,0,9999,6
1714621584777,CLRE 251,A00,507176,Mehta; Ravindra L.,9993,0,9999,6
1714621584777,CLRE 251,B00,511410,Mehta; Ravindra L.,9998,0,9999,1
1714621585805,CLRE 252,A00,507189,Cuomo; Raphael Eduardo,9995,0,9999,4
1714621586830,CLRE 253,A00,507199,Vaida; Florin,9994,0,9999,5
1714621586830,CLRE 253,B00,507202,Vaida; Florin,9999,0,9999,0
1714621587860,CLRE 259,A00,507211,Patel; Hemal,9996,0,9999,3
1714621588885,CLRE 260,A00,507221,Cuomo; Raphael Eduardo,9999,0,9999,0
1714621589913,CLRE 297,001,507242,Cuomo; Raphael Eduardo,9999,0,9999,0
1714621590939,COGS 197,001,638244,Voytek; Bradley Thomas,9998,0,9999,1
1714621591967,CSE 191,A00,516875,Minnes Kemp; Mor Mia,9992,0,9999,7
1714621592992,CSE 197,001,637388,Minnes Kemp; Mor Mia,9998,0,9999,1
1714621594024,CSS 201S,A01,494383,Staff,35,0,35,0
1714621595052,CSS 202S,A01,494387,Staff,35,0,35,0
1714621596076,DSC 197,001,628532,Eldridge; Justin Matthew,9996,0,9999,3
1714621597103,EAP 100,A00,516065,Staff,9797,0,9999,202
1714621598130,ECE 45,A01,507414,Staff,33,0,60,27
1714621600182,ECE 111,A01,507420,Staff,15,0,50,35
1714621601215,ECE 197,001,548057,Sievenpiper; Daniel F.,9993,0,9999,6
1714621602246,EDS 115,A00,507243,Choi; Bailey Miyeon,10,0,28,18
1714621603272,EDS 117,A01,494379,Staff,1,5,30,29
1714621604302,EDS 125,A00,507246,Hopkins; Megan Beth,9,0,30,21
1714621605328,EDS 128A,A01,507264,Fargason; Sharon Gayle,8,0,26,18
1714621606354,EDS 128B,A01,507293,Pappas; Elizabeth,12,0,30,18
1714621607382,EDS 139,A00,507294,Fargason; Sharon Gayle,13,0,30,17
1714621607382,EDS 139,B00,507313,Pappas; Elizabeth,13,0,30,17
1714621608407,EDS 201,A00,507315,Staff,13,0,30,17
1714621609434,EDS 203,A01,507317,Halter; Christopher P.,12,0,30,18
1714621610459,EDS 204R,A01,507319,Halter; Christopher P.,0,3,30,30
1714621610459,EDS 204R,B01,507331,Heinzman; Erica M.,16,0,30,14
1714621611485,EDS 206R,A00,507332,Staff,0,4,30,30
1714621611485,EDS 206R,B00,507343,Staff,17,0,30,13
1714621612514,EDS 250,A00,507344,Hemans; Patricia Ann Benitez,22,0,40,18
1714621613541,EDS 281,A00,507345,Daly; Alan J.,18,0,18,0
1714621614567,EDS 284,A00,507350,Daly; Alan J.,16,0,16,0
1714621615596,EDS 286,A00,507359,Fine; Sarah,18,0,18,0
1714621616620,EDS 289C,A01,507361,Daly; Alan J.,18,0,18,0
1714621617649,EDS 290,A00,507366,Hofstetter; Carolyn,15,0,15,0
1714621618674,LIGM 5A,A00,507421,Fischer-Grunski; Eva K,18,0,20,2
1714621619699,LIGM 5B,A00,507423,Fischer-Grunski; Eva K,19,0,20,1
1714621620725,LIGM 5C,A00,507425,Fischer-Grunski; Eva K,19,0,20,1
1714621621751,LIIT 5AS,A00,507427,Carnelos; Chiara,20,0,20,0
1714621622777,LIIT 5BS,A00,507430,Carnelos; Chiara,20,0,20,0
1714621623806,LIIT 5CS,A00,507432,Carnelos; Chiara,20,0,20,0
1714621624834,LISP 5A,A00,507541,Munoz Sanchez; Alicia,11,0,20,9
1714621625859,LISP 5B,A00,507671,Munoz Sanchez; Alicia,8,0,20,12
1714621626889,LISP 5C,A00,507696,Munoz Sanchez; Alicia,9,0,20,11
1714621627969,MAE 197,001,528363,Boechler; Nicholas Sebastia,9998,0,9999,1
1714621628999,MATH 197,001,523477,Kedlaya; Kiran S.,9995,0,9999,4
1714621628999,MATH 197,002,563811,Zhang; Danna,9995,0,9999,4
1714621628999,MATH 197,003,628552,Dumitriu; Ioana,9998,0,9999,1
1714621630029,MCWP 40R,A00,518780,Staff,2,0,20,18
1714621630029,MCWP 40R,B00,518781,Staff,8,0,20,12
1714621630029,MCWP 40R,C00,518783,Staff,6,0,20,14
1714621631058,MCWP 50R,A00,518791,Staff,0,0,20,20
1714621631058,MCWP 50R,B00,518792,Staff,0,2,20,20
1714621631058,MCWP 50R,C00,518793,Staff,0,2,20,20
1714621631058,MCWP 50R,D00,518794,Staff,0,0,20,20
1714621631058,MCWP 50R,E00,518795,Staff,0,2,20,20
1714621631058,MCWP 50R,F00,518796,Staff,0,0,20,20
1714621631058,MCWP 50R,G00,518797,Staff,0,1,20,20
1714621632084,MMW 12R,A01,514034,Herbst; Matthew,0,0,16,16
1714621632084,MMW 12R,A02,514035,Herbst; Matthew,1,0,16,15
1714621633107,MMW 13R,A01,514037,Staff,0,4,16,16
1714621633107,MMW 13R,A02,514039,Staff,0,2,16,16
1714621633107,MMW 13R,A03,628519,Staff,0,2,16,16
1714621635161,SIO 295LS,A00,523233,Staff,10,0,30,20
1714621636185,SIO 295S,A00,523232,Staff,10,0,30,20
1714621637212,SIOC 290S,A01,637330,Merrifield; Mark A,23,0,30,7
1714621638240,SIOC 291S,A01,637333,Gabriel; Corey John,23,0,30,7
1714621639264,SOCI 117,A01,494376,Staff,0,4,5,5
1714621640289,WES 237B,A00,494380,Staff,9,0,20,11
1714621642364,AESE 279B,A00,494370,Wade; Jon P,0,0,33,33
1714621643389,AIP 197,001,627712,Vespa; Emanuel Ignacio,9998,0,9999,1
1714621644416,ANAR 135S,A00,494369,Braswell; Geoffrey E.,0,0,0,0
1714621645441,BENG 196,001,628496,Engler; Adam J.,9998,0,9999,1
1714621646467,CAT 124RS,A01,519847,Geibel; William,0,0,20,20
1714621647494,CAT 125RS,A01,515971,Geibel; William,0,0,20,20
1714621648519,CLRE 250,A00,511389,Morris; Sheldon,9993,0,9999,6
1714621649544,CLRE 251,A00,507176,Mehta; Ravindra L.,9993,0,9999,6
1714621649544,CLRE 251,B00,511410,Mehta; Ravindra L.,9998,0,9999,1
1714621650569,CLRE 252,A00,507189,Cuomo; Raphael Eduardo,9995,0,9999,4
1714621651596,CLRE 253,A00,507199,Vaida; Florin,9994,0,9999,5
1714621651596,CLRE 253,B00,507202,Vaida; Florin,9999,0,9999,0
1714621652623,CLRE 259,A00,507211,Patel; Hemal,9996,0,9999,3
1714621653652,CLRE 260,A00,507221,Cuomo; Raphael Eduardo,9999,0,9999,0
1714621654678,CLRE 297,001,507242,Cuomo; Raphael Eduardo,9999,0,9999,0
1714621655704,COGS 197,001,638244,Voytek; Bradley Thomas,9998,0,9999,1
1714621656730,CSE 191,A00,516875,Minnes Kemp; Mor Mia,9992,0,9999,7
1714621657758,CSE 197,001,637388,Minnes Kemp; Mor Mia,9998,0,9999,1
1714621658785,CSS 201S,A01,494383,Staff,35,0,35,0
1714621659814,CSS 202S,A01,494387,Staff,35,0,35,0
1714621660839,DSC 197,001,628532,Eldridge; Justin Matthew,9996,0,9999,3
1714621661862,EAP 100,A00,516065,Staff,9797,0,9999,202
1714621662888,ECE 45,A01,507414,Staff,33,0,60,27
1714621664942,ECE 111,A01,507420,Staff,15,0,50,35
1714621665968,ECE 197,001,548057,Sievenpiper; Daniel F.,9993,0,9999,6
1714621666994,EDS 115,A00,507243,Choi; Bailey Miyeon,10,0,28,18
1714621668022,EDS 117,A01,494379,Staff,1,5,30,29
1714621669051,EDS 125,A00,507246,Hopkins; Megan Beth,9,0,30,21
1714621670082,EDS 128A,A01,507264,Fargason; Sharon Gayle,8,0,26,18
1714621671113,EDS 128B,A01,507293,Pappas; Elizabeth,12,0,30,18
1714621672141,EDS 139,A00,507294,Fargason; Sharon Gayle,13,0,30,17
1714621672141,EDS 139,B00,507313,Pappas; Elizabeth,13,0,30,17
1714621673167,EDS 201,A00,507315,Staff,13,0,30,17
1714621674194,EDS 203,A01,507317,Halter; Christopher P.,12,0,30,18
1714621675233,EDS 204R,A01,507319,Halter; Christopher P.,0,3,30,30
1714621675233,EDS 204R,B01,507331,Heinzman; Erica M.,16,0,30,14
1714621676261,EDS 206R,A00,507332,Staff,0,4,30,30
1714621676261,EDS 206R,B00,507343,Staff,17,0,30,13
1714621677287,EDS 250,A00,507344,Hemans; Patricia Ann Benitez,22,0,40,18
1714621678313,EDS 281,A00,507345,Daly; Alan J.,18,0,18,0
1714621679339,EDS 284,A00,507350,Daly; Alan J.,16,0,16,0
1714621680368,EDS 286,A00,507359,Fine; Sarah,18,0,18,0
1714621681395,EDS 289C,A01,507361,Daly; Alan J.,18,0,18,0
1714621682421,EDS 290,A00,507366,Hofstetter; Carolyn,15,0,15,0
1714621683447,LIGM 5A,A00,507421,Fischer-Grunski; Eva K,18,0,20,2
1714621684472,LIGM 5B,A00,507423,Fischer-Grunski; Eva K,19,0,20,1
1714621685500,LIGM 5C,A00,507425,Fischer-Grunski; Eva K,19,0,20,1
1714621686527,LIIT 5AS,A00,507427,Carnelos; Chiara,20,0,20,0
1714621687553,LIIT 5BS,A00,507430,Carnelos; Chiara,20,0,20,0
1714621688582,LIIT 5CS,A00,507432,Carnelos; Chiara,20,0,20,0
1714621689612,LISP 5A,A00,507541,Munoz Sanchez; Alicia,11,0,20,9
1714621690636,LISP 5B,A00,507671,Munoz Sanchez; Alicia,8,0,20,12
1714621691667,LISP 5C,A00,507696,Munoz Sanchez; Alicia,9,0,20,11
1714621692692,MAE 197,001,528363,Boechler; Nicholas Sebastia,9998,0,9999,1
1714621693719,MATH 197,001,523477,Kedlaya; Kiran S.,9995,0,9999,4
1714621693719,MATH 197,002,563811,Zhang; Danna,9995,0,9999,4
1714621693719,MATH 197,003,628552,Dumitriu; Ioana,9998,0,9999,1
1714621694749,MCWP 40R,A00,518780,Staff,2,0,20,18
1714621694749,MCWP 40R,B00,518781,Staff,8,0,20,12
1714621694749,MCWP 40R,C00,518783,Staff,6,0,20,14
1714621695780,MCWP 50R,A00,518791,Staff,0,0,20,20
1714621695780,MCWP 50R,B00,518792,Staff,0,2,20,20
1714621695780,MCWP 50R,C00,518793,Staff,0,2,20,20
1714621695780,MCWP 50R,D00,518794,Staff,0,0,20,20
1714621695780,MCWP 50R,E00,518795,Staff,0,2,20,20
1714621695780,MCWP 50R,F00,518796,Staff,0,0,20,20
1714621695780,MCWP 50R,G00,518797,Staff,0,1,20,20
1714621696806,MMW 12R,A01,514034,Herbst; Matthew,0,0,16,16
1714621696806,MMW 12R,A02,514035,Herbst; Matthew,1,0,16,15
1714621697831,MMW 13R,A01,514037,Staff,0,4,16,16
1714621697831,MMW 13R,A02,514039,Staff,0,2,16,16
1714621697831,MMW 13R,A03,628519,Staff,0,2,16,16
1714621699889,SIO 295LS,A00,523233,Staff,10,0,30,20
1714621700913,SIO 295S,A00,523232,Staff,10,0,30,20
1714621701939,SIOC 290S,A01,637330,Merrifield; Mark A,23,0,30,7
1714621702965,SIOC 291S,A01,637333,Gabriel; Corey John,23,0,30,7
1714621703989,SOCI 117,A01,494376,Staff,0,4,5,5
1714621705015,WES 237B,A00,494380,Staff,9,0,20,11
1714621707088,AESE 279B,A00,494370,Wade; Jon P,0,0,33,33
1714621708115,AIP 197,001,627712,Vespa; Emanuel Ignacio,9998,0,9999,1
1714621709139,ANAR 135S,A00,494369,Braswell; Geoffrey E.,0,0,0,0
1714621710165,BENG 196,001,628496,Engler; Adam J.,9998,0,9999,1
1714621711193,CAT 124RS,A01,519847,Geibel; William,0,0,20,20
1714621712220,CAT 125RS,A01,515971,Geibel; William,0,0,20,20
1714621713245,CLRE 250,A00,511389,Morris; Sheldon,9993,0,9999,6
1714621714274,CLRE 251,A00,507176,Mehta; Ravindra L.,9993,0,9999,6
1714621714274,CLRE 251,B00,511410,Mehta; Ravindra L.,9998,0,9999,1
1714621715298,CLRE 252,A00,507189,Cuomo; Raphael Eduardo,9995,0,9999,4
1714621716327,CLRE 253,A00,507199,Vaida; Florin,9994,0,9999,5
1714621716327,CLRE 253,B00,507202,Vaida; Florin,9999,0,9999,0
1714621717352,CLRE 259,A00,507211,Patel; Hemal,9996,0,9999,3
1714621718378,CLRE 260,A00,507221,Cuomo; Raphael Eduardo,9999,0,9999,0
1714621719403,CLRE 297,001,507242,Cuomo; Raphael Eduardo,9999,0,9999,0
1714621720430,COGS 197,001,638244,Voytek; Bradley Thomas,9998,0,9999,1
1714621721460,CSE 191,A00,516875,Minnes Kemp; Mor Mia,9992,0,9999,7
1714621722486,CSE 197,001,637388,Minnes Kemp; Mor Mia,9998,0,9999,1
1714621723518,CSS 201S,A01,494383,Staff,35,0,35,0
1714621724544,CSS 202S,A01,494387,Staff,35,0,35,0
1714621725569,DSC 197,001,628532,Eldridge; Justin Matthew,9996,0,9999,3
1714621726595,EAP 100,A00,516065,Staff,9797,0,9999,202
1714621727622,ECE 45,A01,507414,Staff,33,0,60,27
1714621729675,ECE 111,A01,507420,Staff,15,0,50,35
1714621730703,ECE 197,001,548057,Sievenpiper; Daniel F.,9993,0,9999,6
1714621731729,EDS 115,A00,507243,Choi; Bailey Miyeon,10,0,28,18
1714621732757,EDS 117,A01,494379,Staff,1,5,30,29
1714621733782,EDS 125,A00,507246,Hopkins; Megan Beth,9,0,30,21
1714621734809,EDS 128A,A01,507264,Fargason; Sharon Gayle,8,0,26,18
1714621735838,EDS 128B,A01,507293,Pappas; Elizabeth,12,0,30,18
1714621736865,EDS 139,A00,507294,Fargason; Sharon Gayle,13,0,30,17
1714621736865,EDS 139,B00,507313,Pappas; Elizabeth,13,0,30,17
1714621737890,EDS 201,A00,507315,Staff,13,0,30,17
1714621738914,EDS 203,A01,507317,Halter; Christopher P.,12,0,30,18
1714621739940,EDS 204R,A01,507319,Halter; Christopher P.,0,3,30,30
1714621739940,EDS 204R,B01,507331,Heinzman; Erica M.,16,0,30,14
1714621740965,EDS 206R,A00,507332,Staff,0,4,30,30
1714621740965,EDS 206R,B00,507343,Staff,17,0,30,13
1714621741992,EDS 250,A00,507344,Hemans; Patricia Ann Benitez,22,0,40,18
1714621743019,EDS 281,A00,507345,Daly; Alan J.,18,0,18,0
1714621744047,EDS 284,A00,507350,Daly; Alan J.,16,0,16,0
1714621745073,EDS 286,A00,507359,Fine; Sarah,18,0,18,0
1714621746097,EDS 289C,A01,507361,Daly; Alan J.,18,0,18,0
1714621747120,EDS 290,A00,507366,Hofstetter; Carolyn,15,0,15,0
1714621748205,LIGM 5A,A00,507421,Fischer-Grunski; Eva K,18,0,20,2
1714621749229,LIGM 5B,A00,507423,Fischer-Grunski; Eva K,19,0,20,1
1714621750257,LIGM 5C,A00,507425,Fischer-Grunski; Eva K,19,0,20,1
1714621751282,LIIT 5AS,A00,507427,Carnelos; Chiara,20,0,20,0
1714621752311,LIIT 5BS,A00,507430,Carnelos; Chiara,20,0,20,0
1714621753339,LIIT 5CS,A00,507432,Carnelos; Chiara,20,0,20,0
1714621754367,LISP 5A,A00,507541,Munoz Sanchez; Alicia,11,0,20,9
1714621755392,LISP 5B,A00,507671,Munoz Sanchez; Alicia,8,0,20,12
1714621756423,LISP 5C,A00,507696,Munoz Sanchez; Alicia,9,0,20,11
1714621757448,MAE 197,001,528363,Boechler; Nicholas Sebastia,9998,0,9999,1
1714621758475,MATH 197,001,523477,Kedlaya; Kiran S.,9995,0,9999,4
1714621758475,MATH 197,002,563811,Zhang; Danna,9995,0,9999,4
1714621758475,MATH 197,003,628552,Dumitriu; Ioana,9998,0,9999,1
1714621759500,MCWP 40R,A00,518780,Staff,2,0,20,18
1714621759500,MCWP 40R,B00,518781,Staff,8,0,20,12
1714621759500,MCWP 40R,C00,518783,Staff,6,0,20,14
1714621760527,MCWP 50R,A00,518791,Staff,0,0,20,20
1714621760527,MCWP 50R,B00,518792,Staff,0,2,20,20
1714621760527,MCWP 50R,C00,518793,Staff,0,2,20,20
1714621760527,MCWP 50R,D00,518794,Staff,0,0,20,20
1714621760527,MCWP 50R,E00,518795,Staff,0,2,20,20
1714621760527,MCWP 50R,F00,518796,Staff,0,0,20,20
1714621760527,MCWP 50R,G00,518797,Staff,0,1,20,20
1714621761553,MMW 12R,A01,514034,Herbst; Matthew,0,0,16,16
1714621761553,MMW 12R,A02,514035,Herbst; Matthew,1,0,16,15
1714621762578,MMW 13R,A01,514037,Staff,0,4,16,16
1714621762578,MMW 13R,A02,514039,Staff,0,2,16,16
1714621762578,MMW 13R,A03,628519,Staff,0,2,16,16
1714621764627,SIO 295LS,A00,523233,Staff,10,0,30,20
1714621765650,SIO 295S,A00,523232,Staff,10,0,30,20
1714621766677,SIOC 290S,A01,637330,Merrifield; Mark A,23,0,30,7
1714621767707,SIOC 291S,A01,637333,Gabriel; Corey John,23,0,30,7
1714621768732,SOCI 117,A01,494376,Staff,0,4,5,5
1714621769756,WES 237B,A00,494380,Staff,9,0,20,11
1714621771842,AESE 279B,A00,494370,Wade; Jon P,0,0,33,33
1714621772871,AIP 197,001,627712,Vespa; Emanuel Ignacio,9998,0,9999,1
1714621773904,ANAR 135S,A00,494369,Braswell; Geoffrey E.,0,0,0,0
1714621774932,BENG 196,001,628496,Engler; Adam J.,9998,0,9999,1
1714621775956,CAT 124RS,A01,519847,Geibel; William,0,0,20,20
1714621776984,CAT 125RS,A01,515971,Geibel; William,0,0,20,20
1714621778010,CLRE 250,A00,511389,Morris; Sheldon,9993,0,9999,6
1714621779038,CLRE 251,A00,507176,Mehta; Ravindra L.,9993,0,9999,6
1714621779038,CLRE 251,B00,511410,Mehta; Ravindra L.,9998,0,9999,1
1714621780066,CLRE 252,A00,507189,Cuomo; Raphael Eduardo,9995,0,9999,4
1714621781090,CLRE 253,A00,507199,Vaida; Florin,9994,0,9999,5
1714621781090,CLRE 253,B00,507202,Vaida; Florin,9999,0,9999,0
1714621782115,CLRE 259,A00,507211,Patel; Hemal,9996,0,9999,3
1714621783138,CLRE 260,A00,507221,Cuomo; Raphael Eduardo,9999,0,9999,0
1714621784161,CLRE 297,001,507242,Cuomo; Raphael Eduardo,9999,0,9999,0
1714621785189,COGS 197,001,638244,Voytek; Bradley Thomas,9998,0,9999,1
1714621786215,CSE 191,A00,516875,Minnes Kemp; Mor Mia,9992,0,9999,7
1714621787243,CSE 197,001,637388,Minnes Kemp; Mor Mia,9998,0,9999,1
1714621788269,CSS 201S,A01,494383,Staff,35,0,35,0
1714621789294,CSS 202S,A01,494387,Staff,35,0,35,0
1714621790321,DSC 197,001,628532,Eldridge; Justin Matthew,9996,0,9999,3
1714621791345,EAP 100,A00,516065,Staff,9797,0,9999,202
1714621792369,ECE 45,A01,507414,Staff,33,0,60,27
1714621794418,ECE 111,A01,507420,Staff,15,0,50,35
1714621795444,ECE 197,001,548057,Sievenpiper; Daniel F.,9993,0,9999,6
1714621796469,EDS 115,A00,507243,Choi; Bailey Miyeon,10,0,28,18
1714621797498,EDS 117,A01,494379,Staff,1,5,30,29
1714621798524,EDS 125,A00,507246,Hopkins; Megan Beth,9,0,30,21
1714621799550,EDS 128A,A01,507264,Fargason; Sharon Gayle,8,0,26,18
1714621800580,EDS 128B,A01,507293,Pappas; Elizabeth,12,0,30,18
1714621801607,EDS 139,A00,507294,Fargason; Sharon Gayle,13,0,30,17
1714621801607,EDS 139,B00,507313,Pappas; Elizabeth,13,0,30,17
1714621802635,EDS 201,A00,507315,Staff,13,0,30,17
1714621803667,EDS 203,A01,507317,Halter; Christopher P.,12,0,30,18
1714621804692,EDS 204R,A01,507319,Halter; Christopher P.,0,3,30,30
1714621804692,EDS 204R,B01,507331,Heinzman; Erica M.,16,0,30,14
1714621805718,EDS 206R,A00,507332,Staff,0,4,30,30
1714621805718,EDS 206R,B00,507343,Staff,17,0,30,13
1714621806745,EDS 250,A00,507344,Hemans; Patricia Ann Benitez,22,0,40,18
1714621807769,EDS 281,A00,507345,Daly; Alan J.,18,0,18,0
1714621808793,EDS 284,A00,507350,Daly; Alan J.,16,0,16,0
1714621809820,EDS 286,A00,507359,Fine; Sarah,18,0,18,0
1714621810848,EDS 289C,A01,507361,Daly; Alan J.,18,0,18,0
1714621811872,EDS 290,A00,507366,Hofstetter; Carolyn,15,0,15,0
1714621812899,LIGM 5A,A00,507421,Fischer-Grunski; Eva K,18,0,20,2
1714621813927,LIGM 5B,A00,507423,Fischer-Grunski; Eva K,19,0,20,1
1714621814951,LIGM 5C,A00,507425,Fischer-Grunski; Eva K,19,0,20,1
1714621815980,LIIT 5AS,A00,507427,Carnelos; Chiara,20,0,20,0
1714621817004,LIIT 5BS,A00,507430,Carnelos; Chiara,20,0,20,0
1714621818030,LIIT 5CS,A00,507432,Carnelos; Chiara,20,0,20,0
1714621819059,LISP 5A,A00,507541,Munoz Sanchez; Alicia,11,0,20,9
1714621820089,LISP 5B,A00,507671,Munoz Sanchez; Alicia,8,0,20,12
1714621821114,LISP 5C,A00,507696,Munoz Sanchez; Alicia,9,0,20,11
1714621822141,MAE 197,001,528363,Boechler; Nicholas Sebastia,9998,0,9999,1
1714621823167,MATH 197,001,523477,Kedlaya; Kiran S.,9995,0,9999,4
1714621823167,MATH 197,002,563811,Zhang; Danna,9995,0,9999,4
1714621823167,MATH 197,003,628552,Dumitriu; Ioana,9998,0,9999,1
1714621824196,MCWP 40R,A00,518780,Staff,2,0,20,18
1714621824196,MCWP 40R,B00,518781,Staff,8,0,20,12
1714621824196,MCWP 40R,C00,518783,Staff,6,0,20,14
1714621825223,MCWP 50R,A00,518791,Staff,0,0,20,20
1714621825223,MCWP 50R,B00,518792,Staff,0,2,20,20
1714621825223,MCWP 50R,C00,518793,Staff,0,2,20,20
1714621825223,MCWP 50R,D00,518794,Staff,0,0,20,20
1714621825223,MCWP 50R,E00,518795,Staff,0,2,20,20
1714621825223,MCWP 50R,F00,518796,Staff,0,0,20,20
1714621825223,MCWP 50R,G00,518797,Staff,0,1,20,20
1714621826255,MMW 12R,A01,514034,Herbst; Matthew,0,0,16,16
1714621826255,MMW 12R,A02,514035,Herbst; Matthew,1,0,16,15
1714621827284,MMW 13R,A01,514037,Staff,0,4,16,16
1714621827284,MMW 13R,A02,514039,Staff,0,2,16,16
1714621827284,MMW 13R,A03,628519,Staff,0,2,16,16
1714621829336,SIO 295LS,A00,523233,Staff,10,0,30,20
1714621830364,SIO 295S,A00,523232,Staff,10,0,30,20
1714621831389,SIOC 290S,A01,637330,Merrifield; Mark A,23,0,30,7
1714621832421,SIOC 291S,A01,637333,Gabriel; Corey John,23,0,30,7
1714621833445,SOCI 117,A01,494376,Staff,0,4,5,5
1714621834471,WES 237B,A00,494380,Staff,9,0,20,11
1714621836550,AESE 279B,A00,494370,Wade; Jon P,0,0,33,33
1714621837575,AIP 197,001,627712,Vespa; Emanuel Ignacio,9998,0,9999,1
1714621838600,ANAR 135S,A00,494369,Braswell; Geoffrey E.,0,0,0,0
1714621839627,BENG 196,001,628496,Engler; Adam J.,9998,0,9999,1
1714621840657,CAT 124RS,A01,519847,Geibel; William,0,0,20,20
1714621841682,CAT 125RS,A01,515971,Geibel; William,0,0,20,20
1714621842711,CLRE 250,A00,511389,Morris; Sheldon,9993,0,9999,6
1714621843741,CLRE 251,A00,507176,Mehta; Ravindra L.,9993,0,9999,6
1714621843741,CLRE 251,B00,511410,Mehta; Ravindra L.,9998,0,9999,1
1714621844770,CLRE 252,A00,507189,Cuomo; Raphael Eduardo,9995,0,9999,4
1714621845798,CLRE 253,A00,507199,Vaida; Florin,9994,0,9999,5
1714621845798,CLRE 253,B00,507202,Vaida; Florin,9999,0,9999,0
1714621846823,CLRE 259,A00,507211,Patel; Hemal,9996,0,9999,3
1714621847847,CLRE 260,A00,507221,Cuomo; Raphael Eduardo,9999,0,9999,0
1714621848871,CLRE 297,001,507242,Cuomo; Raphael Eduardo,9999,0,9999,0
1714621849897,COGS 197,001,638244,Voytek; Bradley Thomas,9998,0,9999,1
1714621850929,CSE 191,A00,516875,Minnes Kemp; Mor Mia,9992,0,9999,7
1714621852031,CSE 197,001,637388,Minnes Kemp; Mor Mia,9998,0,9999,1
1714621853056,CSS 201S,A01,494383,Staff,35,0,35,0
1714621854085,CSS 202S,A01,494387,Staff,35,0,35,0
1714621855111,DSC 197,001,628532,Eldridge; Justin Matthew,9996,0,9999,3
1714621856136,EAP 100,A00,516065,Staff,9797,0,9999,202
1714621857162,ECE 45,A01,507414,Staff,33,0,60,27
1714621859215,ECE 111,A01,507420,Staff,15,0,50,35
1714621860241,ECE 197,001,548057,Sievenpiper; Daniel F.,9993,0,9999,6
1714621861265,EDS 115,A00,507243,Choi; Bailey Miyeon,10,0,28,18
1714621862295,EDS 117,A01,494379,Staff,1,5,30,29
1714621863319,EDS 125,A00,507246,Hopkins; Megan Beth,9,0,30,21
1714621864348,EDS 128A,A01,507264,Fargason; Sharon Gayle,8,0,26,18
1714621865375,EDS 128B,A01,507293,Pappas; Elizabeth,12,0,30,18
1714621866399,EDS 139,A00,507294,Fargason; Sharon Gayle,13,0,30,17
1714621866399,EDS 139,B00,507313,Pappas; Elizabeth,13,0,30,17
1714621867424,EDS 201,A00,507315,Staff,13,0,30,17
1714621868451,EDS 203,A01,507317,Halter; Christopher P.,12,0,30,18
1714621869480,EDS 204R,A01,507319,Halter; Christopher P.,0,3,30,30
1714621869480,EDS 204R,B01,507331,Heinzman; Erica M.,16,0,30,14
1714621870505,EDS 206R,A00,507332,Staff,0,4,30,30
1714621870505,EDS 206R,B00,507343,Staff,17,0,30,13
1714621871534,EDS 250,A00,507344,Hemans; Patricia Ann Benitez,22,0,40,18
1714621872564,EDS 281,A00,507345,Daly; Alan J.,18,0,18,0
1714621873586,EDS 284,A00,507350,Daly; Alan J.,16,0,16,0
1714621874614,EDS 286,A00,507359,Fine; Sarah,18,0,18,0
1714621875639,EDS 289C,A01,507361,Daly; Alan J.,18,0,18,0
1714621876668,EDS 290,A00,507366,Hofstetter; Carolyn,15,0,15,0
1714621877700,LIGM 5A,A00,507421,Fischer-Grunski; Eva K,18,0,20,2
1714621878727,LIGM 5B,A00,507423,Fischer-Grunski; Eva K,19,0,20,1
1714621879751,LIGM 5C,A00,507425,Fischer-Grunski; Eva K,19,0,20,1
1714621880777,LIIT 5AS,A00,507427,Carnelos; Chiara,20,0,20,0
1714621881801,LIIT 5BS,A00,507430,Carnelos; Chiara,20,0,20,0
1714621882826,LIIT 5CS,A00,507432,Carnelos; Chiara,20,0,20,0
1714621883857,LISP 5A,A00,507541,Munoz Sanchez; Alicia,11,0,20,9
1714621884882,LISP 5B,A00,507671,Munoz Sanchez; Alicia,8,0,20,12
1714621885910,LISP 5C,A00,507696,Munoz Sanchez; Alicia,9,0,20,11
1714621886936,MAE 197,001,528363,Boechler; Nicholas Sebastia,9998,0,9999,1
1714621887963,MATH 197,001,523477,Kedlaya; Kiran S.,9995,0,9999,4
1714621887963,MATH 197,002,563811,Zhang; Danna,9995,0,9999,4
1714621887963,MATH 197,003,628552,Dumitriu; Ioana,9998,0,9999,1
1714621888988,MCWP 40R,A00,518780,Staff,2,0,20,18
1714621888988,MCWP 40R,B00,518781,Staff,8,0,20,12
1714621888988,MCWP 40R,C00,518783,Staff,6,0,20,14
1714621890017,MCWP 50R,A00,518791,Staff,0,0,20,20
1714621890017,MCWP 50R,B00,518792,Staff,0,2,20,20
1714621890017,MCWP 50R,C00,518793,Staff,0,2,20,20
1714621890017,MCWP 50R,D00,518794,Staff,0,0,20,20
1714621890017,MCWP 50R,E00,518795,Staff,0,2,20,20
1714621890017,MCWP 50R,F00,518796,Staff,0,0,20,20
1714621890017,MCWP 50R,G00,518797,Staff,0,1,20,20
1714621891045,MMW 12R,A01,514034,Herbst; Matthew,0,0,16,16
1714621891045,MMW 12R,A02,514035,Herbst; Matthew,1,0,16,15
1714621892070,MMW 13R,A01,514037,Staff,0,4,16,16
1714621892070,MMW 13R,A02,514039,Staff,0,2,16,16
1714621892070,MMW 13R,A03,628519,Staff,0,2,16,16
1714621894122,SIO 295LS,A00,523233,Staff,10,0,30,20
1714621895146,SIO 295S,A00,523232,Staff,10,0,30,20
1714621896172,SIOC 290S,A01,637330,Merrifield; Mark A,23,0,30,7
1714621897201,SIOC 291S,A01,637333,Gabriel; Corey John,23,0,30,7
1714621898229,SOCI 117,A01,494376,Staff,0,4,5,5
1714621899255,WES 237B,A00,494380,Staff,9,0,20,11
1714621901333,AESE 279B,A00,494370,Wade; Jon P,0,0,33,33
1714621902358,AIP 197,001,627712,Vespa; Emanuel Ignacio,9998,0,9999,1
1714621903382,ANAR 135S,A00,494369,Braswell; Geoffrey E.,0,0,0,0
1714621904411,BENG 196,001,628496,Engler; Adam J.,9998,0,9999,1
1714621905437,CAT 124RS,A01,519847,Geibel; William,0,0,20,20
1714621906463,CAT 125RS,A01,515971,Geibel; William,0,0,20,20
1714621907491,CLRE 250,A00,511389,Morris; Sheldon,9993,0,9999,6
1714621908517,CLRE 251,A00,507176,Mehta; Ravindra L.,9993,0,9999,6
1714621908517,CLRE 251,B00,511410,Mehta; Ravindra L.,9998,0,9999,1
1714621909547,CLRE 252,A00,507189,Cuomo; Raphael Eduardo,9995,0,9999,4
1714621910576,CLRE 253,A00,507199,Vaida; Florin,9994,0,9999,5
1714621910576,CLRE 253,B00,507202,Vaida; Florin,9999,0,9999,0
1714621911601,CLRE 259,A00,507211,Patel; Hemal,9996,0,9999,3
1714621912628,CLRE 260,A00,507221,Cuomo; Raphael Eduardo,9999,0,9999,0
1714621913652,CLRE 297,001,507242,Cuomo; Raphael Eduardo,9999,0,9999,0
1714621914681,COGS 197,001,638244,Voytek; Bradley Thomas,9998,0,9999,1
1714621915705,CSE 191,A00,516875,Minnes Kemp; Mor Mia,9992,0,9999,7
1714621916731,CSE 197,001,637388,Minnes Kemp; Mor Mia,9998,0,9999,1
1714621917760,CSS 201S,A01,494383,Staff,35,0,35,0
1714621918786,CSS 202S,A01,494387,Staff,35,0,35,0
1714621919815,DSC 197,001,628532,Eldridge; Justin Matthew,9996,0,9999,3
1714621920841,EAP 100,A00,516065,Staff,9797,0,9999,202
1714621921868,ECE 45,A01,507414,Staff,33,0,60,27
1714621923923,ECE 111,A01,507420,Staff,15,0,50,35
1714621924948,ECE 197,001,548057,Sievenpiper; Daniel F.,9993,0,9999,6
1714621925980,EDS 115,A00,507243,Choi; Bailey Miyeon,10,0,28,18
1714621927009,EDS 117,A01,494379,Staff,1,5,30,29
1714621928034,EDS 125,A00,507246,Hopkins; Megan Beth,9,0,30,21
1714621929062,EDS 128A,A01,507264,Fargason; Sharon Gayle,8,0,26,18
1714621930089,EDS 128B,A01,507293,Pappas; Elizabeth,12,0,30,18
1714621931115,EDS 139,A00,507294,Fargason; Sharon Gayle,13,0,30,17
1714621931115,EDS 139,B00,507313,Pappas; Elizabeth,13,0,30,17
1714621932142,EDS 201,A00,507315,Staff,13,0,30,17
1714621933169,EDS 203,A01,507317,Halter; Christopher P.,12,0,30,18
1714621934195,EDS 204R,A01,507319,Halter; Christopher P.,0,3,30,30
1714621934195,EDS 204R,B01,507331,Heinzman; Erica M.,16,0,30,14
1714621935225,EDS 206R,A00,507332,Staff,0,4,30,30
1714621935225,EDS 206R,B00,507343,Staff,17,0,30,13
1714621936255,EDS 250,A00,507344,Hemans; Patricia Ann Benitez,22,0,40,18
1714621937282,EDS 281,A00,507345,Daly; Alan J.,18,0,18,0
1714621938307,EDS 284,A00,507350,Daly; Alan J.,16,0,16,0
1714621939334,EDS 286,A00,507359,Fine; Sarah,18,0,18,0
1714621940359,EDS 289C,A01,507361,Daly; Alan J.,18,0,18,0
1714621941388,EDS 290,A00,507366,Hofstetter; Carolyn,15,0,15,0
1714621942414,LIGM 5A,A00,507421,Fischer-Grunski; Eva K,18,0,20,2
1714621943441,LIGM 5B,A00,507423,Fischer-Grunski; Eva K,19,0,20,1
1714621944470,LIGM 5C,A00,507425,Fischer-Grunski; Eva K,19,0,20,1
1714621945500,LIIT 5AS,A00,507427,Carnelos; Chiara,20,0,20,0
1714621946526,LIIT 5BS,A00,507430,Carnelos; Chiara,20,0,20,0
1714621947550,LIIT 5CS,A00,507432,Carnelos; Chiara,20,0,20,0
1714621948576,LISP 5A,A00,507541,Munoz Sanchez; Alicia,11,0,20,9
1714621949605,LISP 5B,A00,507671,Munoz Sanchez; Alicia,8,0,20,12
1714621950629,LISP 5C,A00,507696,Munoz Sanchez; Alicia,9,0,20,11
1714621951658,MAE 197,001,528363,Boechler; Nicholas Sebastia,9998,0,9999,1
1714621952688,MATH 197,001,523477,Kedlaya; Kiran S.,9995,0,9999,4
1714621952688,MATH 197,002,563811,Zhang; Danna,9995,0,9999,4
1714621952688,MATH 197,003,628552,Dumitriu; Ioana,9998,0,9999,1
1714621953714,MCWP 40R,A00,518780,Staff,2,0,20,18
1714621953714,MCWP 40R,B00,518781,Staff,8,0,20,12
1714621953714,MCWP 40R,C00,518783,Staff,6,0,20,14
1714621954743,MCWP 50R,A00,518791,Staff,0,0,20,20
1714621954743,MCWP 50R,B00,518792,Staff,0,2,20,20
1714621954743,MCWP 50R,C00,518793,Staff,0,2,20,20
1714621954743,MCWP 50R,D00,518794,Staff,0,0,20,20
1714621954743,MCWP 50R,E00,518795,Staff,0,2,20,20
1714621954743,MCWP 50R,F00,518796,Staff,0,0,20,20
1714621954743,MCWP 50R,G00,518797,Staff,0,1,20,20
1714621955822,MMW 12R,A01,514034,Herbst; Matthew,0,0,16,16
1714621955822,MMW 12R,A02,514035,Herbst; Matthew,1,0,16,15
1714621956848,MMW 13R,A01,514037,Staff,0,4,16,16
1714621956848,MMW 13R,A02,514039,Staff,0,2,16,16
1714621956848,MMW 13R,A03,628519,Staff,0,2,16,16
1714621958899,SIO 295LS,A00,523233,Staff,10,0,30,20
1714621959925,SIO 295S,A00,523232,Staff,10,0,30,20
1714621960950,SIOC 290S,A01,637330,Merrifield; Mark A,23,0,30,7
1714621961979,SIOC 291S,A01,637333,Gabriel; Corey John,23,0,30,7
1714621963003,SOCI 117,A01,494376,Staff,0,4,5,5
1714621964030,WES 237B,A00,494380,Staff,9,0,20,11
1714621966100,AESE 279B,A00,494370,Wade; Jon P,0,0,33,33
1714621967126,AIP 197,001,627712,Vespa; Emanuel Ignacio,9998,0,9999,1
1714621968151,ANAR 135S,A00,494369,Braswell; Geoffrey E.,0,0,0,0
1714621969178,BENG 196,001,628496,Engler; Adam J.,9998,0,9999,1
1714621970207,CAT 124RS,A01,519847,Geibel; William,0,0,20,20
1714621971233,CAT 125RS,A01,515971,Geibel; William,0,0,20,20
1714621972261,CLRE 250,A00,511389,Morris; Sheldon,9993,0,9999,6
1714621973287,CLRE 251,A00,507176,Mehta; Ravindra L.,9993,0,9999,6
1714621973287,CLRE 251,B00,511410,Mehta; Ravindra L.,9998,0,9999,1
1714621974311,CLRE 252,A00,507189,Cuomo; Raphael Eduardo,9995,0,9999,4
1714621975339,CLRE 253,A00,507199,Vaida; Florin,9994,0,9999,5
1714621975339,CLRE 253,B00,507202,Vaida; Florin,9999,0,9999,0
1714621976367,CLRE 259,A00,507211,Patel; Hemal,9996,0,9999,3
1714621977392,CLRE 260,A00,507221,Cuomo; Raphael Eduardo,9999,0,9999,0
1714621978416,CLRE 297,001,507242,Cuomo; Raphael Eduardo,9999,0,9999,0
1714621979441,COGS 197,001,638244,Voytek; Bradley Thomas,9998,0,9999,1
1714621980466,CSE 191,A00,516875,Minnes Kemp; Mor Mia,9992,0,9999,7
1714621981490,CSE 197,001,637388,Minnes Kemp; Mor Mia,9998,0,9999,1
1714621982515,CSS 201S,A01,494383,Staff,35,0,35,0
1714621983539,CSS 202S,A01,494387,Staff,35,0,35,0
1714621984567,DSC 197,001,628532,Eldridge; Justin Matthew,9996,0,9999,3
1714621985591,EAP 100,A00,516065,Staff,9797,0,9999,202
1714621986620,ECE 45,A01,507414,Staff,33,0,60,27
1714621988671,ECE 111,A01,507420,Staff,15,0,50,35
1714621989700,ECE 197,001,548057,Sievenpiper; Daniel F.,9993,0,9999,6
1714621990732,EDS 115,A00,507243,Choi; Bailey Miyeon,10,0,28,18
1714621991758,EDS 117,A01,494379,Staff,1,5,30,29
1714621992784,EDS 125,A00,507246,Hopkins; Megan Beth,9,0,30,21
1714621993813,EDS 128A,A01,507264,Fargason; Sharon Gayle,8,0,26,18
1714621994842,EDS 128B,A01,507293,Pappas; Elizabeth,12,0,30,18
1714621995870,EDS 139,A00,507294,Fargason; Sharon Gayle,13,0,30,17
1714621995870,EDS 139,B00,507313,Pappas; Elizabeth,13,0,30,17
1714621996897,EDS 201,A00,507315,Staff,13,0,30,17
1714621997922,EDS 203,A01,507317,Halter; Christopher P.,12,0,30,18
1714621998948,EDS 204R,A01,507319,Halter; Christopher P.,0,3,30,30
1714621998948,EDS 204R,B01,507331,Heinzman; Erica M.,16,0,30,14
1714621999973,EDS 206R,A00,507332,Staff,0,4,30,30
1714621999973,EDS 206R,B00,507343,Staff,17,0,30,13
1714622001002,EDS 250,A00,507344,Hemans; Patricia Ann Benitez,22,0,40,18
1714622002029,EDS 281,A00,507345,Daly; Alan J.,18,0,18,0
1714622003053,EDS 284,A00,507350,Daly; Alan J.,16,0,16,0
1714622004077,EDS 286,A00,507359,Fine; Sarah,18,0,18,0
1714622005102,EDS 289C,A01,507361,Daly; Alan J.,18,0,18,0
1714622006128,EDS 290,A00,507366,Hofstetter; Carolyn,15,0,15,0
1714622007157,LIGM 5A,A00,507421,Fischer-Grunski; Eva K,18,0,20,2
1714622008180,LIGM 5B,A00,507423,Fischer-Grunski; Eva K,19,0,20,1
1714622009210,LIGM 5C,A00,507425,Fischer-Grunski; Eva K,19,0,20,1
1714622010236,LIIT 5AS,A00,507427,Carnelos; Chiara,20,0,20,0
1714622011265,LIIT 5BS,A00,507430,Carnelos; Chiara,20,0,20,0
1714622012294,LIIT 5CS,A00,507432,Carnelos; Chiara,20,0,20,0
1714622013320,LISP 5A,A00,507541,Munoz Sanchez; Alicia,11,0,20,9
1714622014348,LISP 5B,A00,507671,Munoz Sanchez; Alicia,8,0,20,12
1714622015373,LISP 5C,A00,507696,Munoz Sanchez; Alicia,9,0,20,11
1714622016399,MAE 197,001,528363,Boechler; Nicholas Sebastia,9998,0,9999,1
1714622017423,MATH 197,001,523477,Kedlaya; Kiran S.,9995,0,9999,4
1714622017423,MATH 197,002,563811,Zhang; Danna,9995,0,9999,4
1714622017423,MATH 197,003,628552,Dumitriu; Ioana,9998,0,9999,1
1714622018452,MCWP 40R,A00,518780,Staff,2,0,20,18
1714622018452,MCWP 40R,B00,518781,Staff,8,0,20,12
1714622018452,MCWP 40R,C00,518783,Staff,6,0,20,14
1714622019478,MCWP 50R,A00,518791,Staff,0,0,20,20
1714622019478,MCWP 50R,B00,518792,Staff,0,2,20,20
1714622019478,MCWP 50R,C00,518793,Staff,0,2,20,20
1714622019478,MCWP 50R,D00,518794,Staff,0,0,20,20
1714622019478,MCWP 50R,E00,518795,Staff,0,2,20,20
1714622019478,MCWP 50R,F00,518796,Staff,0,0,20,20
1714622019478,MCWP 50R,G00,518797,Staff,0,1,20,20
1714622020503,MMW 12R,A01,514034,Herbst; Matthew,0,0,16,16
1714622020503,MMW 12R,A02,514035,Herbst; Matthew,1,0,16,15
1714622021532,MMW 13R,A01,514037,Staff,0,4,16,16
1714622021532,MMW 13R,A02,514039,Staff,0,2,16,16
1714622021532,MMW 13R,A03,628519,Staff,0,2,16,16
1714622023581,SIO 295LS,A00,523233,Staff,10,0,30,20
1714622024610,SIO 295S,A00,523232,Staff,10,0,30,20
1714622025635,SIOC 290S,A01,637330,Merrifield; Mark A,23,0,30,7
1714622026660,SIOC 291S,A01,637333,Gabriel; Corey John,23,0,30,7
1714622027686,SOCI 117,A01,494376,Staff,0,4,5,5
1714622028711,WES 237B,A00,494380,Staff,9,0,20,11
1714622030775,AESE 279B,A00,494370,Wade; Jon P,0,0,33,33
1714622031800,AIP 197,001,627712,Vespa; Emanuel Ignacio,9998,0,9999,1
1714622032825,ANAR 135S,A00,494369,Braswell; Geoffrey E.,0,0,0,0
1714622033850,BENG 196,001,628496,Engler; Adam J.,9998,0,9999,1
1714622034879,CAT 124RS,A01,519847,Geibel; William,0,0,20,20
1714622035904,CAT 125RS,A01,515971,Geibel; William,0,0,20,20
1714622036928,CLRE 250,A00,511389,Morris; Sheldon,9993,0,9999,6
1714622037956,CLRE 251,A00,507176,Mehta; Ravindra L.,9993,0,9999,6
1714622037956,CLRE 251,B00,511410,Mehta; Ravindra L.,9998,0,9999,1
1714622038984,CLRE 252,A00,507189,Cuomo; Raphael Eduardo,9995,0,9999,4
1714622040016,CLRE 253,A00,507199,Vaida; Florin,9994,0,9999,5
1714622040016,CLRE 253,B00,507202,Vaida; Florin,9999,0,9999,0
1714622041047,CLRE 259,A00,507211,Patel; Hemal,9996,0,9999,3
1714622042073,CLRE 260,A00,507221,Cuomo; Raphael Eduardo,9999,0,9999,0
1714622043097,CLRE 297,001,507242,Cuomo; Raphael Eduardo,9999,0,9999,0
1714622044125,COGS 197,001,638244,Voytek; Bradley Thomas,9998,0,9999,1
1714622045150,CSE 191,A00,516875,Minnes Kemp; Mor Mia,9992,0,9999,7
1714622046181,CSE 197,001,637388,Minnes Kemp; Mor Mia,9998,0,9999,1
1714622047309,CSS 201S,A01,494383,Staff,35,0,35,0
1714622048333,CSS 202S,A01,494387,Staff,35,0,35,0
1714622049363,DSC 197,001,628532,Eldridge; Justin Matthew,9996,0,9999,3
1714622050387,EAP 100,A00,516065,Staff,9797,0,9999,202
1714622051412,ECE 45,A01,507414,Staff,33,0,60,27
1714622053465,ECE 111,A01,507420,Staff,15,0,50,35
1714622054495,ECE 197,001,548057,Sievenpiper; Daniel F.,9993,0,9999,6
1714622055524,EDS 115,A00,507243,Choi; Bailey Miyeon,10,0,28,18
1714622056548,EDS 117,A01,494379,Staff,1,5,30,29
1714622057576,EDS 125,A00,507246,Hopkins; Megan Beth,9,0,30,21
1714622058602,EDS 128A,A01,507264,Fargason; Sharon Gayle,8,0,26,18
1714622059684,EDS 128B,A01,507293,Pappas; Elizabeth,12,0,30,18
1714622060709,EDS 139,A00,507294,Fargason; Sharon Gayle,13,0,30,17
1714622060709,EDS 139,B00,507313,Pappas; Elizabeth,13,0,30,17
1714622061733,EDS 201,A00,507315,Staff,13,0,30,17
1714622062760,EDS 203,A01,507317,Halter; Christopher P.,12,0,30,18
1714622063785,EDS 204R,A01,507319,Halter; Christopher P.,0,3,30,30
1714622063785,EDS 204R,B01,507331,Heinzman; Erica M.,16,0,30,14
1714622064809,EDS 206R,A00,507332,Staff,0,4,30,30
1714622064809,EDS 206R,B00,507343,Staff,17,0,30,13
1714622065834,EDS 250,A00,507344,Hemans; Patricia Ann Benitez,22,0,40,18
1714622066859,EDS 281,A00,507345,Daly; Alan J.,18,0,18,0
1714622067886,EDS 284,A00,507350,Daly; Alan J.,16,0,16,0
1714622068916,EDS 286,A00,507359,Fine; Sarah,18,0,18,0
1714622069944,EDS 289C,A01,507361,Daly; Alan J.,18,0,18,0
1714622070970,EDS 290,A00,507366,Hofstetter; Carolyn,15,0,15,0
1714622072000,LIGM 5A,A00,507421,Fischer-Grunski; Eva K,18,0,20,2
1714622073024,LIGM 5B,A00,507423,Fischer-Grunski; Eva K,19,0,20,1
1714622074053,LIGM 5C,A00,507425,Fischer-Grunski; Eva K,19,0,20,1
1714622075078,LIIT 5AS,A00,507427,Carnelos; Chiara,20,0,20,0
1714622076106,LIIT 5BS,A00,507430,Carnelos; Chiara,20,0,20,0
1714622077130,LIIT 5CS,A00,507432,Carnelos; Chiara,20,0,20,0
1714622078155,LISP 5A,A00,507541,Munoz Sanchez; Alicia,11,0,20,9
1714622079181,LISP 5B,A00,507671,Munoz Sanchez; Alicia,8,0,20,12
1714622080206,LISP 5C,A00,507696,Munoz Sanchez; Alicia,9,0,20,11
1714622081236,MAE 197,001,528363,Boechler; Nicholas Sebastia,9998,0,9999,1
1714622082264,MATH 197,001,523477,Kedlaya; Kiran S.,9995,0,9999,4
1714622082264,MATH 197,002,563811,Zhang; Danna,9995,0,9999,4
1714622082264,MATH 197,003,628552,Dumitriu; Ioana,9998,0,9999,1
1714622083290,MCWP 40R,A00,518780,Staff,2,0,20,18
1714622083290,MCWP 40R,B00,518781,Staff,8,0,20,12
1714622083290,MCWP 40R,C00,518783,Staff,6,0,20,14
1714622084315,MCWP 50R,A00,518791,Staff,0,0,20,20
1714622084315,MCWP 50R,B00,518792,Staff,0,2,20,20
1714622084315,MCWP 50R,C00,518793,Staff,0,2,20,20
1714622084315,MCWP 50R,D00,518794,Staff,0,0,20,20
1714622084315,MCWP 50R,E00,518795,Staff,0,2,20,20
1714622084315,MCWP 50R,F00,518796,Staff,0,0,20,20
1714622084315,MCWP 50R,G00,518797,Staff,0,1,20,20
1714622085342,MMW 12R,A01,514034,Herbst; Matthew,0,0,16,16
1714622085342,MMW 12R,A02,514035,Herbst; Matthew,1,0,16,15
1714622086367,MMW 13R,A01,514037,Staff,0,4,16,16
1714622086367,MMW 13R,A02,514039,Staff,0,2,16,16
1714622086367,MMW 13R,A03,628519,Staff,0,2,16,16
1714622088418,SIO 295LS,A00,523233,Staff,10,0,30,20
1714622089442,SIO 295S,A00,523232,Staff,10,0,30,20
1714622090467,SIOC 290S,A01,637330,Merrifield; Mark A,23,0,30,7
1714622091490,SIOC 291S,A01,637333,Gabriel; Corey John,23,0,30,7
1714622092515,SOCI 117,A01,494376,Staff,0,4,5,5
1714622093544,WES 237B,A00,494380,Staff,9,0,20,11
1714622095613,AESE 279B,A00,494370,Wade; Jon P,0,0,33,33
1714622096636,AIP 197,001,627712,Vespa; Emanuel Ignacio,9998,0,9999,1
1714622097663,ANAR 135S,A00,494369,Braswell; Geoffrey E.,0,0,0,0
1714622098689,BENG 196,001,628496,Engler; Adam J.,9998,0,9999,1
1714622099717,CAT 124RS,A01,519847,Geibel; William,0,0,20,20
1714622100748,CAT 125RS,A01,515971,Geibel; William,0,0,20,20
1714622101776,CLRE 250,A00,511389,Morris; Sheldon,9993,0,9999,6
1714622102807,CLRE 251,A00,507176,Mehta; Ravindra L.,9993,0,9999,6
1714622102807,CLRE 251,B00,511410,Mehta; Ravindra L.,9998,0,9999,1
1714622103832,CLRE 252,A00,507189,Cuomo; Raphael Eduardo,9995,0,9999,4
1714622104856,CLRE 253,A00,507199,Vaida; Florin,9994,0,9999,5
1714622104856,CLRE 253,B00,507202,Vaida; Florin,9999,0,9999,0
1714622105881,CLRE 259,A00,507211,Patel; Hemal,9996,0,9999,3
1714622106908,CLRE 260,A00,507221,Cuomo; Raphael Eduardo,9999,0,9999,0
1714622107934,CLRE 297,001,507242,Cuomo; Raphael Eduardo,9999,0,9999,0
1714622108960,COGS 197,001,638244,Voytek; Bradley Thomas,9998,0,9999,1
1714622109983,CSE 191,A00,516875,Minnes Kemp; Mor Mia,9992,0,9999,7
1714622111012,CSE 197,001,637388,Minnes Kemp; Mor Mia,9998,0,9999,1
1714622112040,CSS 201S,A01,494383,Staff,35,0,35,0
1714622113064,CSS 202S,A01,494387,Staff,35,0,35,0
1714622114090,DSC 197,001,628532,Eldridge; Justin Matthew,9996,0,9999,3
1714622115115,EAP 100,A00,516065,Staff,9797,0,9999,202
1714622116140,ECE 45,A01,507414,Staff,33,0,60,27
1714622118190,ECE 111,A01,507420,Staff,15,0,50,35
1714622119213,ECE 197,001,548057,Sievenpiper; Daniel F.,9993,0,9999,6
1714622120242,EDS 115,A00,507243,Choi; Bailey Miyeon,10,0,28,18
1714622121267,EDS 117,A01,494379,Staff,1,5,30,29
1714622122292,EDS 125,A00,507246,Hopkins; Megan Beth,9,0,30,21
1714622123319,EDS 128A,A01,507264,Fargason; Sharon Gayle,8,0,26,18
1714622124343,EDS 128B,A01,507293,Pappas; Elizabeth,12,0,30,18
1714622125368,EDS 139,A00,507294,Fargason; Sharon Gayle,13,0,30,17
1714622125368,EDS 139,B00,507313,Pappas; Elizabeth,13,0,30,17
1714622126393,EDS 201,A00,507315,Staff,13,0,30,17
1714622127418,EDS 203,A01,507317,Halter; Christopher P.,12,0,30,18
1714622128446,EDS 204R,A01,507319,Halter; Christopher P.,0,3,30,30
1714622128446,EDS 204R,B01,507331,Heinzman; Erica M.,16,0,30,14
1714622129475,EDS 206R,A00,507332,Staff,0,4,30,30
1714622129475,EDS 206R,B00,507343,Staff,17,0,30,13
1714622130503,EDS 250,A00,507344,Hemans; Patricia Ann Benitez,22,0,40,18
1714622131528,EDS 281,A00,507345,Daly; Alan J.,18,0,18,0
1714622132553,EDS 284,A00,507350,Daly; Alan J.,16,0,16,0
1714622133580,EDS 286,A00,507359,Fine; Sarah,18,0,18,0
1714622134606,EDS 289C,A01,507361,Daly; Alan J.,18,0,18,0
1714622135633,EDS 290,A00,507366,Hofstetter; Carolyn,15,0,15,0
1714622136660,LIGM 5A,A00,507421,Fischer-Grunski; Eva K,18,0,20,2
1714622137683,LIGM 5B,A00,507423,Fischer-Grunski; Eva K,19,0,20,1
1714622138708,LIGM 5C,A00,507425,Fischer-Grunski; Eva K,19,0,20,1
1714622139738,LIIT 5AS,A00,507427,Carnelos; Chiara,20,0,20,0
1714622140766,LIIT 5BS,A00,507430,Carnelos; Chiara,20,0,20,0
1714622141790,LIIT 5CS,A00,507432,Carnelos; Chiara,20,0,20,0
1714622142819,LISP 5A,A00,507541,Munoz Sanchez; Alicia,11,0,20,9
1714622143848,LISP 5B,A00,507671,Munoz Sanchez; Alicia,8,0,20,12
1714622144877,LISP 5C,A00,507696,Munoz Sanchez; Alicia,9,0,20,11
1714622145902,MAE 197,001,528363,Boechler; Nicholas Sebastia,9998,0,9999,1
1714622146929,MATH 197,001,523477,Kedlaya; Kiran S.,9995,0,9999,4
1714622146929,MATH 197,002,563811,Zhang; Danna,9995,0,9999,4
1714622146929,MATH 197,003,628552,Dumitriu; Ioana,9998,0,9999,1
1714622147958,MCWP 40R,A00,518780,Staff,2,0,20,18
1714622147958,MCWP 40R,B00,518781,Staff,8,0,20,12
1714622147958,MCWP 40R,C00,518783,Staff,6,0,20,14
1714622148988,MCWP 50R,A00,518791,Staff,0,0,20,20
1714622148988,MCWP 50R,B00,518792,Staff,0,2,20,20
1714622148988,MCWP 50R,C00,518793,Staff,0,2,20,20
1714622148988,MCWP 50R,D00,518794,Staff,0,0,20,20
1714622148988,MCWP 50R,E00,518795,Staff,0,2,20,20
1714622148988,MCWP 50R,F00,518796,Staff,0,0,20,20
1714622148988,MCWP 50R,G00,518797,Staff,0,1,20,20
1714622150018,MMW 12R,A01,514034,Herbst; Matthew,0,0,16,16
1714622150018,MMW 12R,A02,514035,Herbst; Matthew,1,0,16,15
1714622151043,MMW 13R,A01,514037,Staff,0,4,16,16
1714622151043,MMW 13R,A02,514039,Staff,0,2,16,16
1714622151043,MMW 13R,A03,628519,Staff,0,2,16,16
1714622153092,SIO 295LS,A00,523233,Staff,10,0,30,20
1714622154120,SIO 295S,A00,523232,Staff,10,0,30,20
1714622155147,SIOC 290S,A01,637330,Merrifield; Mark A,23,0,30,7
1714622156172,SIOC 291S,A01,637333,Gabriel; Corey John,23,0,30,7
1714622157200,SOCI 117,A01,494376,Staff,0,4,5,5
1714622158228,WES 237B,A00,494380,Staff,9,0,20,11
1714622160303,AESE 279B,A00,494370,Wade; Jon P,0,0,33,33
1714622161332,AIP 197,001,627712,Vespa; Emanuel Ignacio,9998,0,9999,1
1714622162362,ANAR 135S,A00,494369,Braswell; Geoffrey E.,0,0,0,0
1714622163461,BENG 196,001,628496,Engler; Adam J.,9998,0,9999,1
1714622164485,CAT 124RS,A01,519847,Geibel; William,0,0,20,20
1714622165511,CAT 125RS,A01,515971,Geibel; William,0,0,20,20
1714622166540,CLRE 250,A00,511389,Morris; Sheldon,9993,0,9999,6
1714622167565,CLRE 251,A00,507176,Mehta; Ravindra L.,9993,0,9999,6
1714622167565,CLRE 251,B00,511410,Mehta; Ravindra L.,9998,0,9999,1
1714622168590,CLRE 252,A00,507189,Cuomo; Raphael Eduardo,9995,0,9999,4
1714622169615,CLRE 253,A00,507199,Vaida; Florin,9994,0,9999,5
1714622169615,CLRE 253,B00,507202,Vaida; Florin,9999,0,9999,0
1714622170639,CLRE 259,A00,507211,Patel; Hemal,9996,0,9999,3
1714622171663,CLRE 260,A00,507221,Cuomo; Raphael Eduardo,9999,0,9999,0
1714622172690,CLRE 297,001,507242,Cuomo; Raphael Eduardo,9999,0,9999,0
1714622173716,COGS 197,001,638244,Voytek; Bradley Thomas,9998,0,9999,1
1714622174741,CSE 191,A00,516875,Minnes Kemp; Mor Mia,9992,0,9999,7
1714622175765,CSE 197,001,637388,Minnes Kemp; Mor Mia,9998,0,9999,1
1714622176790,CSS 201S,A01,494383,Staff,35,0,35,0
1714622177818,CSS 202S,A01,494387,Staff,35,0,35,0
1714622178845,DSC 197,001,628532,Eldridge; Justin Matthew,9996,0,9999,3
1714622179870,EAP 100,A00,516065,Staff,9797,0,9999,202
1714622180896,ECE 45,A01,507414,Staff,33,0,60,27
1714622182947,ECE 111,A01,507420,Staff,15,0,50,35
1714622183972,ECE 197,001,548057,Sievenpiper; Daniel F.,9993,0,9999,6
1714622184996,EDS 115,A00,507243,Choi; Bailey Miyeon,10,0,28,18
1714622186027,EDS 117,A01,494379,Staff,1,5,30,29
1714622187056,EDS 125,A00,507246,Hopkins; Megan Beth,9,0,30,21
1714622188083,EDS 128A,A01,507264,Fargason; Sharon Gayle,8,0,26,18
1714622189111,EDS 128B,A01,507293,Pappas; Elizabeth,12,0,30,18
1714622190139,EDS 139,A00,507294,Fargason; Sharon Gayle,13,0,30,17
1714622190139,EDS 139,B00,507313,Pappas; Elizabeth,13,0,30,17
1714622191164,EDS 201,A00,507315,Staff,13,0,30,17
1714622192191,EDS 203,A01,507317,Halter; Christopher P.,12,0,30,18
1714622193216,EDS 204R,A01,507319,Halter; Christopher P.,0,3,30,30
1714622193216,EDS 204R,B01,507331,Heinzman; Erica M.,16,0,30,14
1714622194241,EDS 206R,A00,507332,Staff,0,4,30,30
1714622194241,EDS 206R,B00,507343,Staff,17,0,30,13
1714622195267,EDS 250,A00,507344,Hemans; Patricia Ann Benitez,22,0,40,18
1714622196291,EDS 281,A00,507345,Daly; Alan J.,18,0,18,0
1714622197318,EDS 284,A00,507350,Daly; Alan J.,16,0,16,0
1714622198347,EDS 286,A00,507359,Fine; Sarah,18,0,18,0
1714622199373,EDS 289C,A01,507361,Daly; Alan J.,18,0,18,0
1714622200399,EDS 290,A00,507366,Hofstetter; Carolyn,15,0,15,0
1714622201598,LIGM 5A,A00,507421,Fischer-Grunski; Eva K,18,0,20,2
1714622202621,LIGM 5B,A00,507423,Fischer-Grunski; Eva K,19,0,20,1
1714622203645,LIGM 5C,A00,507425,Fischer-Grunski; Eva K,19,0,20,1
1714622204673,LIIT 5AS,A00,507427,Carnelos; Chiara,20,0,20,0
1714622205697,LIIT 5BS,A00,507430,Carnelos; Chiara,20,0,20,0
1714622206722,LIIT 5CS,A00,507432,Carnelos; Chiara,20,0,20,0
1714622207750,LISP 5A,A00,507541,Munoz Sanchez; Alicia,11,0,20,9
1714622208778,LISP 5B,A00,507671,Munoz Sanchez; Alicia,8,0,20,12
1714622209804,LISP 5C,A00,507696,Munoz Sanchez; Alicia,9,0,20,11
1714622210828,MAE 197,001,528363,Boechler; Nicholas Sebastia,9998,0,9999,1
1714622211858,MATH 197,001,523477,Kedlaya; Kiran S.,9995,0,9999,4
1714622211858,MATH 197,002,563811,Zhang; Danna,9995,0,9999,4
1714622211858,MATH 197,003,628552,Dumitriu; Ioana,9998,0,9999,1
1714622212886,MCWP 40R,A00,518780,Staff,2,0,20,18
1714622212886,MCWP 40R,B00,518781,Staff,8,0,20,12
1714622212886,MCWP 40R,C00,518783,Staff,6,0,20,14
1714622213912,MCWP 50R,A00,518791,Staff,0,0,20,20
1714622213912,MCWP 50R,B00,518792,Staff,0,2,20,20
1714622213912,MCWP 50R,C00,518793,Staff,0,2,20,20
1714622213912,MCWP 50R,D00,518794,Staff,0,0,20,20
1714622213912,MCWP 50R,E00,518795,Staff,0,2,20,20
1714622213912,MCWP 50R,F00,518796,Staff,0,0,20,20
1714622213912,MCWP 50R,G00,518797,Staff,0,1,20,20
1714622214940,MMW 12R,A01,514034,Herbst; Matthew,0,0,16,16
1714622214940,MMW 12R,A02,514035,Herbst; Matthew,1,0,16,15
1714622215970,MMW 13R,A01,514037,Staff,0,4,16,16
1714622215970,MMW 13R,A02,514039,Staff,0,2,16,16
1714622215970,MMW 13R,A03,628519,Staff,0,2,16,16
1714622218023,SIO 295LS,A00,523233,Staff,10,0,30,20
1714622219051,SIO 295S,A00,523232,Staff,10,0,30,20
1714622220077,SIOC 290S,A01,637330,Merrifield; Mark A,23,0,30,7
1714622221108,SIOC 291S,A01,637333,Gabriel; Corey John,23,0,30,7
1714622222134,SOCI 117,A01,494376,Staff,0,4,5,5
1714622223164,WES 237B,A00,494380,Staff,9,0,20,11
1714622225233,AESE 279B,A00,494370,Wade; Jon P,0,0,33,33
1714622226259,AIP 197,001,627712,Vespa; Emanuel Ignacio,9998,0,9999,1
1714622227286,ANAR 135S,A00,494369,Braswell; Geoffrey E.,0,0,0,0
1714622228313,BENG 196,001,628496,Engler; Adam J.,9998,0,9999,1
1714622229338,CAT 124RS,A01,519847,Geibel; William,0,0,20,20
1714622230365,CAT 125RS,A01,515971,Geibel; William,0,0,20,20
1714622231389,CLRE 250,A00,511389,Morris; Sheldon,9993,0,9999,6
1714622236012,CLRE 251,A00,507176,Mehta; Ravindra L.,9993,0,9999,6
1714622236012,CLRE 251,B00,511410,Mehta; Ravindra L.,9998,0,9999,1
1714622237036,CLRE 252,A00,507189,Cuomo; Raphael Eduardo,9995,0,9999,4
1714622238062,CLRE 253,A00,507199,Vaida; Florin,9994,0,9999,5
1714622238062,CLRE 253,B00,507202,Vaida; Florin,9999,0,9999,0
1714622239091,CLRE 259,A00,507211,Patel; Hemal,9996,0,9999,3
1714622240118,CLRE 260,A00,507221,Cuomo; Raphael Eduardo,9999,0,9999,0
1714622241148,CLRE 297,001,507242,Cuomo; Raphael Eduardo,9999,0,9999,0
1714622242172,COGS 197,001,638244,Voytek; Bradley Thomas,9998,0,9999,1
1714622243197,CSE 191,A00,516875,Minnes Kemp; Mor Mia,9992,0,9999,7
1714622244224,CSE 197,001,637388,Minnes Kemp; Mor Mia,9998,0,9999,1
1714622245249,CSS 201S,A01,494383,Staff,35,0,35,0
1714622246276,CSS 202S,A01,494387,Staff,35,0,35,0
1714622247301,DSC 197,001,628532,Eldridge; Justin Matthew,9996,0,9999,3
1714622248327,EAP 100,A00,516065,Staff,9797,0,9999,202
1714622249355,ECE 45,A01,507414,Staff,33,0,60,27
1714622251404,ECE 111,A01,507420,Staff,15,0,50,35
1714622252434,ECE 197,001,548057,Sievenpiper; Daniel F.,9993,0,9999,6
1714622253460,EDS 115,A00,507243,Choi; Bailey Miyeon,10,0,28,18
1714622254489,EDS 117,A01,494379,Staff,1,5,30,29
1714622255517,EDS 125,A00,507246,Hopkins; Megan Beth,9,0,30,21
1714622256543,EDS 128A,A01,507264,Fargason; Sharon Gayle,8,0,26,18
1714622257572,EDS 128B,A01,507293,Pappas; Elizabeth,12,0,30,18
1714622258600,EDS 139,A00,507294,Fargason; Sharon Gayle,13,0,30,17
1714622258600,EDS 139,B00,507313,Pappas; Elizabeth,13,0,30,17
1714622259626,EDS 201,A00,507315,Staff,13,0,30,17
1714622260653,EDS 203,A01,507317,Halter; Christopher P.,12,0,30,18
1714622261678,EDS 204R,A01,507319,Halter; Christopher P.,0,3,30,30
1714622261678,EDS 204R,B01,507331,Heinzman; Erica M.,16,0,30,14
1714622262702,EDS 206R,A00,507332,Staff,0,4,30,30
1714622262702,EDS 206R,B00,507343,Staff,17,0,30,13
1714622263730,EDS 250,A00,507344,Hemans; Patricia Ann Benitez,22,0,40,18
1714622264756,EDS 281,A00,507345,Daly; Alan J.,18,0,18,0
1714622265784,EDS 284,A00,507350,Daly; Alan J.,16,0,16,0
1714622266812,EDS 286,A00,507359,Fine; Sarah,18,0,18,0
1714622267839,EDS 289C,A01,507361,Daly; Alan J.,18,0,18,0
1714622268864,EDS 290,A00,507366,Hofstetter; Carolyn,15,0,15,0
1714622269892,LIGM 5A,A00,507421,Fischer-Grunski; Eva K,18,0,20,2
1714622270917,LIGM 5B,A00,507423,Fischer-Grunski; Eva K,19,0,20,1
1714622271946,LIGM 5C,A00,507425,Fischer-Grunski; Eva K,19,0,20,1
1714622272972,LIIT 5AS,A00,507427,Carnelos; Chiara,20,0,20,0
1714622274002,LIIT 5BS,A00,507430,Carnelos; Chiara,20,0,20,0
1714622275028,LIIT 5CS,A00,507432,Carnelos; Chiara,20,0,20,0
1714622276114,LISP 5A,A00,507541,Munoz Sanchez; Alicia,11,0,20,9
1714622277140,LISP 5B,A00,507671,Munoz Sanchez; Alicia,8,0,20,12
1714622278167,LISP 5C,A00,507696,Munoz Sanchez; Alicia,9,0,20,11
1714622279192,MAE 197,001,528363,Boechler; Nicholas Sebastia,9998,0,9999,1
1714622280216,MATH 197,001,523477,Kedlaya; Kiran S.,9995,0,9999,4
1714622280216,MATH 197,002,563811,Zhang; Danna,9995,0,9999,4
1714622280216,MATH 197,003,628552,Dumitriu; Ioana,9998,0,9999,1
1714622281245,MCWP 40R,A00,518780,Staff,2,0,20,18
1714622281245,MCWP 40R,B00,518781,Staff,8,0,20,12
1714622281245,MCWP 40R,C00,518783,Staff,6,0,20,14
1714622282271,MCWP 50R,A00,518791,Staff,0,0,20,20
1714622282271,MCWP 50R,B00,518792,Staff,0,2,20,20
1714622282271,MCWP 50R,C00,518793,Staff,0,2,20,20
1714622282271,MCWP 50R,D00,518794,Staff,0,0,20,20
1714622282271,MCWP 50R,E00,518795,Staff,0,2,20,20
1714622282271,MCWP 50R,F00,518796,Staff,0,0,20,20
1714622282271,MCWP 50R,G00,518797,Staff,0,1,20,20
1714622283297,MMW 12R,A01,514034,Herbst; Matthew,0,0,16,16
1714622283297,MMW 12R,A02,514035,Herbst; Matthew,1,0,16,15
1714622284324,MMW 13R,A01,514037,Staff,0,4,16,16
1714622284324,MMW 13R,A02,514039,Staff,0,2,16,16
1714622284324,MMW 13R,A03,628519,Staff,0,2,16,16
1714622286382,SIO 295LS,A00,523233,Staff,10,0,30,20
1714622287404,SIO 295S,A00,523232,Staff,10,0,30,20
1714622288436,SIOC 290S,A01,637330,Merrifield; Mark A,23,0,30,7
1714622289461,SIOC 291S,A01,637333,Gabriel; Corey John,23,0,30,7
1714622290489,SOCI 117,A01,494376,Staff,0,4,5,5
1714622291513,WES 237B,A00,494380,Staff,9,0,20,11
1714622293580,AESE 279B,A00,494370,Wade; Jon P,0,0,33,33
1714622294603,AIP 197,001,627712,Vespa; Emanuel Ignacio,9998,0,9999,1
1714622295629,ANAR 135S,A00,494369,Braswell; Geoffrey E.,0,0,0,0
1714622296653,BENG 196,001,628496,Engler; Adam J.,9998,0,9999,1
1714622297679,CAT 124RS,A01,519847,Geibel; William,0,0,20,20
1714622298702,CAT 125RS,A01,515971,Geibel; William,0,0,20,20
1714622299730,CLRE 250,A00,511389,Morris; Sheldon,9993,0,9999,6
1714622300756,CLRE 251,A00,507176,Mehta; Ravindra L.,9993,0,9999,6
1714622300756,CLRE 251,B00,511410,Mehta; Ravindra L.,9998,0,9999,1
1714622301785,CLRE 252,A00,507189,Cuomo; Raphael Eduardo,9995,0,9999,4
1714622302809,CLRE 253,A00,507199,Vaida; Florin,9994,0,9999,5
1714622302809,CLRE 253,B00,507202,Vaida; Florin,9999,0,9999,0
1714622303835,CLRE 259,A00,507211,Patel; Hemal,9996,0,9999,3
1714622304859,CLRE 260,A00,507221,Cuomo; Raphael Eduardo,9999,0,9999,0
1714622305882,CLRE 297,001,507242,Cuomo; Raphael Eduardo,9999,0,9999,0
1714622306907,COGS 197,001,638244,Voytek; Bradley Thomas,9998,0,9999,1
1714622307933,CSE 191,A00,516875,Minnes Kemp; Mor Mia,9992,0,9999,7
1714622308959,CSE 197,001,637388,Minnes Kemp; Mor Mia,9998,0,9999,1
1714622309987,CSS 201S,A01,494383,Staff,35,0,35,0
1714622311014,CSS 202S,A01,494387,Staff,35,0,35,0
1714622312039,DSC 197,001,628532,Eldridge; Justin Matthew,9996,0,9999,3
1714622313066,EAP 100,A00,516065,Staff,9797,0,9999,202
1714622314095,ECE 45,A01,507414,Staff,33,0,60,27
1714622316144,ECE 111,A01,507420,Staff,15,0,50,35
1714622317172,ECE 197,001,548057,Sievenpiper; Daniel F.,9993,0,9999,6
1714622318200,EDS 115,A00,507243,Choi; Bailey Miyeon,10,0,28,18
1714622319225,EDS 117,A01,494379,Staff,1,5,30,29
1714622320254,EDS 125,A00,507246,Hopkins; Megan Beth,9,0,30,21
1714622321284,EDS 128A,A01,507264,Fargason; Sharon Gayle,8,0,26,18
1714622322310,EDS 128B,A01,507293,Pappas; Elizabeth,12,0,30,18
1714622323334,EDS 139,A00,507294,Fargason; Sharon Gayle,13,0,30,17
1714622323334,EDS 139,B00,507313,Pappas; Elizabeth,13,0,30,17
1714622324364,EDS 201,A00,507315,Staff,13,0,30,17
1714622325389,EDS 203,A01,507317,Halter; Christopher P.,12,0,30,18
1714622326415,EDS 204R,A01,507319,Halter; Christopher P.,0,3,30,30
1714622326415,EDS 204R,B01,507331,Heinzman; Erica M.,16,0,30,14
1714622327442,EDS 206R,A00,507332,Staff,0,4,30,30
1714622327442,EDS 206R,B00,507343,Staff,17,0,30,13
1714622328470,EDS 250,A00,507344,Hemans; Patricia Ann Benitez,22,0,40,18
1714622329500,EDS 281,A00,507345,Daly; Alan J.,18,0,18,0
1714622330527,EDS 284,A00,507350,Daly; Alan J.,16,0,16,0
1714622331554,EDS 286,A00,507359,Fine; Sarah,18,0,18,0
1714622332584,EDS 289C,A01,507361,Daly; Alan J.,18,0,18,0
1714622333613,EDS 290,A00,507366,Hofstetter; Carolyn,15,0,15,0
1714622334639,LIGM 5A,A00,507421,Fischer-Grunski; Eva K,18,0,20,2
1714622335669,LIGM 5B,A00,507423,Fischer-Grunski; Eva K,19,0,20,1
1714622336721,LIGM 5C,A00,507425,Fischer-Grunski; Eva K,19,0,20,1
1714622337751,LIIT 5AS,A00,507427,Carnelos; Chiara,20,0,20,0
1714622338778,LIIT 5BS,A00,507430,Carnelos; Chiara,20,0,20,0
1714622339806,LIIT 5CS,A00,507432,Carnelos; Chiara,20,0,20,0
1714622340834,LISP 5A,A00,507541,Munoz Sanchez; Alicia,11,0,20,9
1714622341859,LISP 5B,A00,507671,Munoz Sanchez; Alicia,8,0,20,12
1714622342884,LISP 5C,A00,507696,Munoz Sanchez; Alicia,9,0,20,11
1714622343913,MAE 197,001,528363,Boechler; Nicholas Sebastia,9998,0,9999,1
1714622344940,MATH 197,001,523477,Kedlaya; Kiran S.,9995,0,9999,4
1714622344940,MATH 197,002,563811,Zhang; Danna,9995,0,9999,4
1714622344940,MATH 197,003,628552,Dumitriu; Ioana,9998,0,9999,1
1714622345968,MCWP 40R,A00,518780,Staff,2,0,20,18
1714622345968,MCWP 40R,B00,518781,Staff,8,0,20,12
1714622345968,MCWP 40R,C00,518783,Staff,6,0,20,14
1714622346996,MCWP 50R,A00,518791,Staff,0,0,20,20
1714622346996,MCWP 50R,B00,518792,Staff,0,2,20,20
1714622346996,MCWP 50R,C00,518793,Staff,0,2,20,20
1714622346996,MCWP 50R,D00,518794,Staff,0,0,20,20
1714622346996,MCWP 50R,E00,518795,Staff,0,2,20,20
1714622346996,MCWP 50R,F00,518796,Staff,0,0,20,20
1714622346996,MCWP 50R,G00,518797,Staff,0,1,20,20
1714622348021,MMW 12R,A01,514034,Herbst; Matthew,0,0,16,16
1714622348021,MMW 12R,A02,514035,Herbst; Matthew,1,0,16,15
1714622349048,MMW 13R,A01,514037,Staff,0,4,16,16
1714622349048,MMW 13R,A02,514039,Staff,0,2,16,16
1714622349048,MMW 13R,A03,628519,Staff,0,2,16,16
1714622351105,SIO 295LS,A00,523233,Staff,10,0,30,20
1714622352129,SIO 295S,A00,523232,Staff,10,0,30,20
1714622353154,SIOC 290S,A01,637330,Merrifield; Mark A,23,0,30,7
1714622354180,SIOC 291S,A01,637333,Gabriel; Corey John,23,0,30,7
1714622355206,SOCI 117,A01,494376,Staff,0,4,5,5
1714622356234,WES 237B,A00,494380,Staff,9,0,20,11
1714622358313,AESE 279B,A00,494370,Wade; Jon P,0,0,33,33
1714622359339,AIP 197,001,627712,Vespa; Emanuel Ignacio,9998,0,9999,1
1714622360364,ANAR 135S,A00,494369,Braswell; Geoffrey E.,0,0,0,0
1714622361388,BENG 196,001,628496,Engler; Adam J.,9998,0,9999,1
1714622362416,CAT 124RS,A01,519847,Geibel; William,0,0,20,20
1714622363441,CAT 125RS,A01,515971,Geibel; William,0,0,20,20
1714622364467,CLRE 250,A00,511389,Morris; Sheldon,9993,0,9999,6
1714622365496,CLRE 251,A00,507176,Mehta; Ravindra L.,9993,0,9999,6
1714622365496,CLRE 251,B00,511410,Mehta; Ravindra L.,9998,0,9999,1
1714622366522,CLRE 252,A00,507189,Cuomo; Raphael Eduardo,9995,0,9999,4
1714622367548,CLRE 253,A00,507199,Vaida; Florin,9994,0,9999,5
1714622367548,CLRE 253,B00,507202,Vaida; Florin,9999,0,9999,0
1714622368576,CLRE 259,A00,507211,Patel; Hemal,9996,0,9999,3
1714622369602,CLRE 260,A00,507221,Cuomo; Raphael Eduardo,9999,0,9999,0
1714622370628,CLRE 297,001,507242,Cuomo; Raphael Eduardo,9999,0,9999,0
1714622371658,COGS 197,001,638244,Voytek; Bradley Thomas,9998,0,9999,1
1714622372684,CSE 191,A00,516875,Minnes Kemp; Mor Mia,9992,0,9999,7
1714622373712,CSE 197,001,637388,Minnes Kemp; Mor Mia,9998,0,9999,1
1714622374741,CSS 201S,A01,494383,Staff,35,0,35,0
1714622375766,CSS 202S,A01,494387,Staff,35,0,35,0
1714622376794,DSC 197,001,628532,Eldridge; Justin Matthew,9996,0,9999,3
1714622377818,EAP 100,A00,516065,Staff,9797,0,9999,202
1714622378848,ECE 45,A01,507414,Staff,33,0,60,27
1714622380898,ECE 111,A01,507420,Staff,15,0,50,35
1714622381923,ECE 197,001,548057,Sievenpiper; Daniel F.,9993,0,9999,6
1714622382952,EDS 115,A00,507243,Choi; Bailey Miyeon,10,0,28,18
1714622383977,EDS 117,A01,494379,Staff,1,5,30,29
1714622385002,EDS 125,A00,507246,Hopkins; Megan Beth,9,0,30,21
1714622386027,EDS 128A,A01,507264,Fargason; Sharon Gayle,8,0,26,18
1714622387053,EDS 128B,A01,507293,Pappas; Elizabeth,12,0,30,18
1714622388077,EDS 139,A00,507294,Fargason; Sharon Gayle,13,0,30,17
1714622388077,EDS 139,B00,507313,Pappas; Elizabeth,13,0,30,17
1714622389102,EDS 201,A00,507315,Staff,13,0,30,17
1714622390127,EDS 203,A01,507317,Halter; Christopher P.,12,0,30,18
1714622391152,EDS 204R,A01,507319,Halter; Christopher P.,0,3,30,30
1714622391152,EDS 204R,B01,507331,Heinzman; Erica M.,16,0,30,14
1714622392176,EDS 206R,A00,507332,Staff,0,4,30,30
1714622392176,EDS 206R,B00,507343,Staff,17,0,30,13
1714622393202,EDS 250,A00,507344,Hemans; Patricia Ann Benitez,22,0,40,18
1714622394227,EDS 281,A00,507345,Daly; Alan J.,18,0,18,0
1714622395251,EDS 284,A00,507350,Daly; Alan J.,16,0,16,0
1714622396280,EDS 286,A00,507359,Fine; Sarah,18,0,18,0
1714622397304,EDS 289C,A01,507361,Daly; Alan J.,18,0,18,0
1714622398331,EDS 290,A00,507366,Hofstetter; Carolyn,15,0,15,0
1714622399359,LIGM 5A,A00,507421,Fischer-Grunski; Eva K,18,0,20,2
1714622400385,LIGM 5B,A00,507423,Fischer-Grunski; Eva K,19,0,20,1
1714622401410,LIGM 5C,A00,507425,Fischer-Grunski; Eva K,19,0,20,1
1714622402438,LIIT 5AS,A00,507427,Carnelos; Chiara,20,0,20,0
1714622403466,LIIT 5BS,A00,507430,Carnelos; Chiara,20,0,20,0
1714622404493,LIIT 5CS,A00,507432,Carnelos; Chiara,20,0,20,0
1714622405517,LISP 5A,A00,507541,Munoz Sanchez; Alicia,11,0,20,9
1714622406543,LISP 5B,A00,507671,Munoz Sanchez; Alicia,8,0,20,12
1714622407568,LISP 5C,A00,507696,Munoz Sanchez; Alicia,9,0,20,11
1714622408592,MAE 197,001,528363,Boechler; Nicholas Sebastia,9998,0,9999,1
1714622409620,MATH 197,001,523477,Kedlaya; Kiran S.,9995,0,9999,4
1714622409620,MATH 197,002,563811,Zhang; Danna,9995,0,9999,4
1714622409620,MATH 197,003,628552,Dumitriu; Ioana,9998,0,9999,1
1714622410644,MCWP 40R,A00,518780,Staff,2,0,20,18
1714622410644,MCWP 40R,B00,518781,Staff,8,0,20,12
1714622410644,MCWP 40R,C00,518783,Staff,6,0,20,14
1714622411669,MCWP 50R,A00,518791,Staff,0,0,20,20
1714622411669,MCWP 50R,B00,518792,Staff,0,2,20,20
1714622411669,MCWP 50R,C00,518793,Staff,0,2,20,20
1714622411669,MCWP 50R,D00,518794,Staff,0,0,20,20
1714622411669,MCWP 50R,E00,518795,Staff,0,2,20,20
1714622411669,MCWP 50R,F00,518796,Staff,0,0,20,20
1714622411669,MCWP 50R,G00,518797,Staff,0,1,20,20
1714622412695,MMW 12R,A01,514034,Herbst; Matthew,0,0,16,16
1714622412695,MMW 12R,A02,514035,Herbst; Matthew,1,0,16,15
1714622413723,MMW 13R,A01,514037,Staff,0,4,16,16
1714622413723,MMW 13R,A02,514039,Staff,0,2,16,16
1714622413723,MMW 13R,A03,628519,Staff,0,2,16,16
1714622415774,SIO 295LS,A00,523233,Staff,10,0,30,20
1714622416806,SIO 295S,A00,523232,Staff,10,0,30,20
1714622417836,SIOC 290S,A01,637330,Merrifield; Mark A,23,0,30,7
1714622418862,SIOC 291S,A01,637333,Gabriel; Corey John,23,0,30,7
1714622419889,SOCI 117,A01,494376,Staff,0,4,5,5
1714622420915,WES 237B,A00,494380,Staff,9,0,20,11
1714622422993,AESE 279B,A00,494370,Wade; Jon P,0,0,33,33
1714622424020,AIP 197,001,627712,Vespa; Emanuel Ignacio,9998,0,9999,1
1714622425047,ANAR 135S,A00,494369,Braswell; Geoffrey E.,0,0,0,0
1714622426075,BENG 196,001,628496,Engler; Adam J.,9998,0,9999,1
1714622427102,CAT 124RS,A01,519847,Geibel; William,0,0,20,20
1714622428126,CAT 125RS,A01,515971,Geibel; William,0,0,20,20
1714622429154,CLRE 250,A00,511389,Morris; Sheldon,9993,0,9999,6
1714622430181,CLRE 251,A00,507176,Mehta; Ravindra L.,9993,0,9999,6
1714622430181,CLRE 251,B00,511410,Mehta; Ravindra L.,9998,0,9999,1
1714622431211,CLRE 252,A00,507189,Cuomo; Raphael Eduardo,9995,0,9999,4
1714622432237,CLRE 253,A00,507199,Vaida; Florin,9994,0,9999,5
1714622432237,CLRE 253,B00,507202,Vaida; Florin,9999,0,9999,0
1714622433262,CLRE 259,A00,507211,Patel; Hemal,9996,0,9999,3
1714622434289,CLRE 260,A00,507221,Cuomo; Raphael Eduardo,9999,0,9999,0
1714622435317,CLRE 297,001,507242,Cuomo; Raphael Eduardo,9999,0,9999,0
1714622436343,COGS 197,001,638244,Voytek; Bradley Thomas,9998,0,9999,1
1714622437371,CSE 191,A00,516875,Minnes Kemp; Mor Mia,9992,0,9999,7
1714622438397,CSE 197,001,637388,Minnes Kemp; Mor Mia,9998,0,9999,1
1714622439424,CSS 201S,A01,494383,Staff,35,0,35,0
1714622440450,CSS 202S,A01,494387,Staff,35,0,35,0
1714622441480,DSC 197,001,628532,Eldridge; Justin Matthew,9996,0,9999,3
1714622442506,EAP 100,A00,516065,Staff,9797,0,9999,202
1714622443530,ECE 45,A01,507414,Staff,33,0,60,27
1714622445596,ECE 111,A01,507420,Staff,15,0,50,35
1714622446625,ECE 197,001,548057,Sievenpiper; Daniel F.,9993,0,9999,6
1714622447650,EDS 115,A00,507243,Choi; Bailey Miyeon,10,0,28,18
1714622448679,EDS 117,A01,494379,Staff,1,5,30,29
1714622449705,EDS 125,A00,507246,Hopkins; Megan Beth,9,0,30,21
1714622450731,EDS 128A,A01,507264,Fargason; Sharon Gayle,8,0,26,18
1714622451757,EDS 128B,A01,507293,Pappas; Elizabeth,12,0,30,18
1714622452784,EDS 139,A00,507294,Fargason; Sharon Gayle,13,0,30,17
1714622452784,EDS 139,B00,507313,Pappas; Elizabeth,13,0,30,17
1714622453809,EDS 201,A00,507315,Staff,13,0,30,17
1714622454842,EDS 203,A01,507317,Halter; Christopher P.,12,0,30,18
1714622455871,EDS 204R,A01,507319,Halter; Christopher P.,0,3,30,30
1714622455871,EDS 204R,B01,507331,Heinzman; Erica M.,16,0,30,14
1714622456895,EDS 206R,A00,507332,Staff,0,4,30,30
1714622456895,EDS 206R,B00,507343,Staff,17,0,30,13
1714622457923,EDS 250,A00,507344,Hemans; Patricia Ann Benitez,22,0,40,18
1714622458947,EDS 281,A00,507345,Daly; Alan J.,18,0,18,0
1714622459973,EDS 284,A00,507350,Daly; Alan J.,16,0,16,0
1714622461001,EDS 286,A00,507359,Fine; Sarah,18,0,18,0
1714622462029,EDS 289C,A01,507361,Daly; Alan J.,18,0,18,0
1714622463059,EDS 290,A00,507366,Hofstetter; Carolyn,15,0,15,0
1714622464086,LIGM 5A,A00,507421,Fischer-Grunski; Eva K,18,0,20,2
1714622465116,LIGM 5B,A00,507423,Fischer-Grunski; Eva K,19,0,20,1
1714622466142,LIGM 5C,A00,507425,Fischer-Grunski; Eva K,19,0,20,1
1714622467169,LIIT 5AS,A00,507427,Carnelos; Chiara,20,0,20,0
1714622468195,LIIT 5BS,A00,507430,Carnelos; Chiara,20,0,20,0
1714622469222,LIIT 5CS,A00,507432,Carnelos; Chiara,20,0,20,0
1714622470248,LISP 5A,A00,507541,Munoz Sanchez; Alicia,11,0,20,9
1714622471274,LISP 5B,A00,507671,Munoz Sanchez; Alicia,8,0,20,12
1714622472300,LISP 5C,A00,507696,Munoz Sanchez; Alicia,9,0,20,11
1714622473325,MAE 197,001,528363,Boechler; Nicholas Sebastia,9998,0,9999,1
1714622474353,MATH 197,001,523477,Kedlaya; Kiran S.,9995,0,9999,4
1714622474353,MATH 197,002,563811,Zhang; Danna,9995,0,9999,4
1714622474353,MATH 197,003,628552,Dumitriu; Ioana,9998,0,9999,1
1714622475382,MCWP 40R,A00,518780,Staff,2,0,20,18
1714622475382,MCWP 40R,B00,518781,Staff,8,0,20,12
1714622475382,MCWP 40R,C00,518783,Staff,6,0,20,14
1714622476409,MCWP 50R,A00,518791,Staff,0,0,20,20
1714622476409,MCWP 50R,B00,518792,Staff,0,2,20,20
1714622476409,MCWP 50R,C00,518793,Staff,0,2,20,20
1714622476409,MCWP 50R,D00,518794,Staff,0,0,20,20
1714622476409,MCWP 50R,E00,518795,Staff,0,2,20,20
1714622476409,MCWP 50R,F00,518796,Staff,0,0,20,20
1714622476409,MCWP 50R,G00,518797,Staff,0,1,20,20
1714622477433,MMW 12R,A01,514034,Herbst; Matthew,0,0,16,16
1714622477433,MMW 12R,A02,514035,Herbst; Matthew,1,0,16,15
1714622478459,MMW 13R,A01,514037,Staff,0,4,16,16
1714622478459,MMW 13R,A02,514039,Staff,0,2,16,16
1714622478459,MMW 13R,A03,628519,Staff,0,2,16,16
1714622480515,SIO 295LS,A00,523233,Staff,10,0,30,20
1714622481542,SIO 295S,A00,523232,Staff,10,0,30,20
1714622482567,SIOC 290S,A01,637330,Merrifield; Mark A,23,0,30,7
1714622483594,SIOC 291S,A01,637333,Gabriel; Corey John,23,0,30,7
1714622484620,SOCI 117,A01,494376,Staff,0,4,5,5
1714622485648,WES 237B,A00,494380,Staff,9,0,20,11
1714622487710,AESE 279B,A00,494370,Wade; Jon P,0,0,33,33
1714622488735,AIP 197,001,627712,Vespa; Emanuel Ignacio,9998,0,9999,1
1714622489762,ANAR 135S,A00,494369,Braswell; Geoffrey E.,0,0,0,0
1714622490788,BENG 196,001,628496,Engler; Adam J.,9998,0,9999,1
1714622491816,CAT 124RS,A01,519847,Geibel; William,0,0,20,20
1714622492841,CAT 125RS,A01,515971,Geibel; William,0,0,20,20
1714622493872,CLRE 250,A00,511389,Morris; Sheldon,9993,0,9999,6
1714622494899,CLRE 251,A00,507176,Mehta; Ravindra L.,9993,0,9999,6
1714622494899,CLRE 251,B00,511410,Mehta; Ravindra L.,9998,0,9999,1
1714622495924,CLRE 252,A00,507189,Cuomo; Raphael Eduardo,9995,0,9999,4
1714622496949,CLRE 253,A00,507199,Vaida; Florin,9994,0,9999,5
1714622496949,CLRE 253,B00,507202,Vaida; Florin,9999,0,9999,0
1714622497974,CLRE 259,A00,507211,Patel; Hemal,9996,0,9999,3
1714622498998,CLRE 260,A00,507221,Cuomo; Raphael Eduardo,9999,0,9999,0
1714622500025,CLRE 297,001,507242,Cuomo; Raphael Eduardo,9999,0,9999,0
1714622501050,COGS 197,001,638244,Voytek; Bradley Thomas,9998,0,9999,1
1714622502074,CSE 191,A00,516875,Minnes Kemp; Mor Mia,9992,0,9999,7
1714622503102,CSE 197,001,637388,Minnes Kemp; Mor Mia,9998,0,9999,1
1714622504130,CSS 201S,A01,494383,Staff,35,0,35,0
1714622505155,CSS 202S,A01,494387,Staff,35,0,35,0
1714622506184,DSC 197,001,628532,Eldridge; Justin Matthew,9996,0,9999,3
1714622507210,EAP 100,A00,516065,Staff,9797,0,9999,202
1714622508234,ECE 45,A01,507414,Staff,33,0,60,27
1714622510291,ECE 111,A01,507420,Staff,15,0,50,35
1714622511318,ECE 197,001,548057,Sievenpiper; Daniel F.,9993,0,9999,6
1714622512405,EDS 115,A00,507243,Choi; Bailey Miyeon,10,0,28,18
1714622513432,EDS 117,A01,494379,Staff,1,5,30,29
1714622514457,EDS 125,A00,507246,Hopkins; Megan Beth,9,0,30,21
1714622515485,EDS 128A,A01,507264,Fargason; Sharon Gayle,8,0,26,18
1714622516510,EDS 128B,A01,507293,Pappas; Elizabeth,12,0,30,18
1714622517535,EDS 139,A00,507294,Fargason; Sharon Gayle,13,0,30,17
1714622517535,EDS 139,B00,507313,Pappas; Elizabeth,13,0,30,17
1714622518562,EDS 201,A00,507315,Staff,13,0,30,17
1714622519588,EDS 203,A01,507317,Halter; Christopher P.,12,0,30,18
1714622520614,EDS 204R,A01,507319,Halter; Christopher P.,0,3,30,30
1714622520614,EDS 204R,B01,507331,Heinzman; Erica M.,16,0,30,14
1714622521639,EDS 206R,A00,507332,Staff,0,4,30,30
1714622521639,EDS 206R,B00,507343,Staff,17,0,30,13
1714622522667,EDS 250,A00,507344,Hemans; Patricia Ann Benitez,22,0,40,18
1714622523696,EDS 281,A00,507345,Daly; Alan J.,18,0,18,0
1714622524721,EDS 284,A00,507350,Daly; Alan J.,16,0,16,0
1714622525747,EDS 286,A00,507359,Fine; Sarah,18,0,18,0
1714622526773,EDS 289C,A01,507361,Daly; Alan J.,18,0,18,0
1714622527797,EDS 290,A00,507366,Hofstetter; Carolyn,15,0,15,0
1714622528823,LIGM 5A,A00,507421,Fischer-Grunski; Eva K,18,0,20,2
1714622529848,LIGM 5B,A00,507423,Fischer-Grunski; Eva K,19,0,20,1
1714622530875,LIGM 5C,A00,507425,Fischer-Grunski; Eva K,19,0,20,1
1714622531901,LIIT 5AS,A00,507427,Carnelos; Chiara,20,0,20,0
1714622532932,LIIT 5BS,A00,507430,Carnelos; Chiara,20,0,20,0
1714622533960,LIIT 5CS,A00,507432,Carnelos; Chiara,20,0,20,0
1714622534987,LISP 5A,A00,507541,Munoz Sanchez; Alicia,11,0,20,9
1714622536013,LISP 5B,A00,507671,Munoz Sanchez; Alicia,8,0,20,12
1714622537041,LISP 5C,A00,507696,Munoz Sanchez; Alicia,9,0,20,11
1714622538068,MAE 197,001,528363,Boechler; Nicholas Sebastia,9998,0,9999,1
1714622539098,MATH 197,001,523477,Kedlaya; Kiran S.,9995,0,9999,4
1714622539098,MATH 197,002,563811,Zhang; Danna,9995,0,9999,4
1714622539098,MATH 197,003,628552,Dumitriu; Ioana,9998,0,9999,1
1714622540127,MCWP 40R,A00,518780,Staff,2,0,20,18
1714622540127,MCWP 40R,B00,518781,Staff,8,0,20,12
1714622540127,MCWP 40R,C00,518783,Staff,6,0,20,14
1714622541154,MCWP 50R,A00,518791,Staff,0,0,20,20
1714622541154,MCWP 50R,B00,518792,Staff,0,2,20,20
1714622541154,MCWP 50R,C00,518793,Staff,0,2,20,20
1714622541154,MCWP 50R,D00,518794,Staff,0,0,20,20
1714622541154,MCWP 50R,E00,518795,Staff,0,2,20,20
1714622541154,MCWP 50R,F00,518796,Staff,0,0,20,20
1714622541154,MCWP 50R,G00,518797,Staff,0,1,20,20
1714622542183,MMW 12R,A01,514034,Herbst; Matthew,0,0,16,16
1714622542183,MMW 12R,A02,514035,Herbst; Matthew,1,0,16,15
1714622543207,MMW 13R,A01,514037,Staff,0,4,16,16
1714622543207,MMW 13R,A02,514039,Staff,0,2,16,16
1714622543207,MMW 13R,A03,628519,Staff,0,2,16,16
1714622545260,SIO 295LS,A00,523233,Staff,10,0,30,20
1714622546285,SIO 295S,A00,523232,Staff,10,0,30,20
1714622547312,SIOC 290S,A01,637330,Merrifield; Mark A,23,0,30,7
1714622548337,SIOC 291S,A01,637333,Gabriel; Corey John,23,0,30,7
1714622549365,SOCI 117,A01,494376,Staff,0,4,5,5
1714622550390,WES 237B,A00,494380,Staff,9,0,20,11
1714622552476,AESE 279B,A00,494370,Wade; Jon P,0,0,33,33
1714622553503,AIP 197,001,627712,Vespa; Emanuel Ignacio,9998,0,9999,1
1714622554531,ANAR 135S,A00,494369,Braswell; Geoffrey E.,0,0,0,0
1714622555560,BENG 196,001,628496,Engler; Adam J.,9998,0,9999,1
1714622556585,CAT 124RS,A01,519847,Geibel; William,0,0,20,20
1714622557612,CAT 125RS,A01,515971,Geibel; William,0,0,20,20
1714622558642,CLRE 250,A00,511389,Morris; Sheldon,9993,0,9999,6
1714622559670,CLRE 251,A00,507176,Mehta; Ravindra L.,9993,0,9999,6
1714622559670,CLRE 251,B00,511410,Mehta; Ravindra L.,9998,0,9999,1
1714622560693,CLRE 252,A00,507189,Cuomo; Raphael Eduardo,9995,0,9999,4
1714622561721,CLRE 253,A00,507199,Vaida; Florin,9994,0,9999,5
1714622561721,CLRE 253,B00,507202,Vaida; Florin,9999,0,9999,0
1714622562748,CLRE 259,A00,507211,Patel; Hemal,9996,0,9999,3
1714622563775,CLRE 260,A00,507221,Cuomo; Raphael Eduardo,9999,0,9999,0
1714622564800,CLRE 297,001,507242,Cuomo; Raphael Eduardo,9999,0,9999,0
1714622565825,COGS 197,001,638244,Voytek; Bradley Thomas,9998,0,9999,1
1714622566854,CSE 191,A00,516875,Minnes Kemp; Mor Mia,9992,0,9999,7
1714622567879,CSE 197,001,637388,Minnes Kemp; Mor Mia,9998,0,9999,1
1714622568910,CSS 201S,A01,494383,Staff,35,0,35,0
1714622569936,CSS 202S,A01,494387,Staff,35,0,35,0
1714622570965,DSC 197,001,628532,Eldridge; Justin Matthew,9996,0,9999,3
1714622571992,EAP 100,A00,516065,Staff,9797,0,9999,202
1714622573020,ECE 45,A01,507414,Staff,33,0,60,27
1714622575150,ECE 111,A01,507420,Staff,15,0,50,35
1714622576179,ECE 197,001,548057,Sievenpiper; Daniel F.,9993,0,9999,6
1714622577205,EDS 115,A00,507243,Choi; Bailey Miyeon,10,0,28,18
1714622578234,EDS 117,A01,494379,Staff,1,5,30,29
1714622579263,EDS 125,A00,507246,Hopkins; Megan Beth,9,0,30,21
1714622580288,EDS 128A,A01,507264,Fargason; Sharon Gayle,8,0,26,18
1714622581317,EDS 128B,A01,507293,Pappas; Elizabeth,12,0,30,18
1714622582340,EDS 139,A00,507294,Fargason; Sharon Gayle,13,0,30,17
1714622582340,EDS 139,B00,507313,Pappas; Elizabeth,13,0,30,17
1714622583364,EDS 201,A00,507315,Staff,13,0,30,17
1714622584393,EDS 203,A01,507317,Halter; Christopher P.,12,0,30,18
1714622585418,EDS 204R,A01,507319,Halter; Christopher P.,0,3,30,30
1714622585418,EDS 204R,B01,507331,Heinzman; Erica M.,16,0,30,14
1714622586442,EDS 206R,A00,507332,Staff,0,4,30,30
1714622586442,EDS 206R,B00,507343,Staff,17,0,30,13
1714622587468,EDS 250,A00,507344,Hemans; Patricia Ann Benitez,22,0,40,18
1714622588496,EDS 281,A00,507345,Daly; Alan J.,18,0,18,0
1714622589521,EDS 284,A00,507350,Daly; Alan J.,16,0,16,0
1714622590549,EDS 286,A00,507359,Fine; Sarah,18,0,18,0
1714622591575,EDS 289C,A01,507361,Daly; Alan J.,18,0,18,0
1714622592601,EDS 290,A00,507366,Hofstetter; Carolyn,15,0,15,0
1714622593625,LIGM 5A,A00,507421,Fischer-Grunski; Eva K,18,0,20,2
1714622594651,LIGM 5B,A00,507423,Fischer-Grunski; Eva K,19,0,20,1
1714622595676,LIGM 5C,A00,507425,Fischer-Grunski; Eva K,19,0,20,1
1714622596702,LIIT 5AS,A00,507427,Carnelos; Chiara,20,0,20,0
1714622597730,LIIT 5BS,A00,507430,Carnelos; Chiara,20,0,20,0
1714622598754,LIIT 5CS,A00,507432,Carnelos; Chiara,20,0,20,0
1714622599781,LISP 5A,A00,507541,Munoz Sanchez; Alicia,11,0,20,9
1714622600812,LISP 5B,A00,507671,Munoz Sanchez; Alicia,8,0,20,12
1714622601839,LISP 5C,A00,507696,Munoz Sanchez; Alicia,9,0,20,11
1714622602865,MAE 197,001,528363,Boechler; Nicholas Sebastia,9998,0,9999,1
1714622603897,MATH 197,001,523477,Kedlaya; Kiran S.,9995,0,9999,4
1714622603897,MATH 197,002,563811,Zhang; Danna,9995,0,9999,4
1714622603897,MATH 197,003,628552,Dumitriu; Ioana,9998,0,9999,1
1714622604923,MCWP 40R,A00,518780,Staff,2,0,20,18
1714622604923,MCWP 40R,B00,518781,Staff,8,0,20,12
1714622604923,MCWP 40R,C00,518783,Staff,6,0,20,14
1714622605951,MCWP 50R,A00,518791,Staff,0,0,20,20
1714622605951,MCWP 50R,B00,518792,Staff,0,2,20,20
1714622605951,MCWP 50R,C00,518793,Staff,0,2,20,20
1714622605951,MCWP 50R,D00,518794,Staff,0,0,20,20
1714622605951,MCWP 50R,E00,518795,Staff,0,2,20,20
1714622605951,MCWP 50R,F00,518796,Staff,0,0,20,20
1714622605951,MCWP 50R,G00,518797,Staff,0,1,20,20
1714622606977,MMW 12R,A01,514034,Herbst; Matthew,0,0,16,16
1714622606977,MMW 12R,A02,514035,Herbst; Matthew,1,0,16,15
1714622608005,MMW 13R,A01,514037,Staff,0,4,16,16
1714622608005,MMW 13R,A02,514039,Staff,0,2,16,16
1714622608005,MMW 13R,A03,628519,Staff,0,2,16,16
1714622610060,SIO 295LS,A00,523233,Staff,10,0,30,20
1714622611090,SIO 295S,A00,523232,Staff,10,0,30,20
1714622612117,SIOC 290S,A01,637330,Merrifield; Mark A,23,0,30,7
1714622613143,SIOC 291S,A01,637333,Gabriel; Corey John,23,0,30,7
1714622614169,SOCI 117,A01,494376,Staff,0,4,5,5
1714622615197,WES 237B,A00,494380,Staff,9,0,20,11
1714622617267,AESE 279B,A00,494370,Wade; Jon P,0,0,33,33
1714622618295,AIP 197,001,627712,Vespa; Emanuel Ignacio,9998,0,9999,1
1714622619323,ANAR 135S,A00,494369,Braswell; Geoffrey E.,0,0,0,0
1714622620349,BENG 196,001,628496,Engler; Adam J.,9998,0,9999,1
1714622621376,CAT 124RS,A01,519847,Geibel; William,0,0,20,20
1714622622404,CAT 125RS,A01,515971,Geibel; William,0,0,20,20
1714622623433,CLRE 250,A00,511389,Morris; Sheldon,9993,0,9999,6
1714622624463,CLRE 251,A00,507176,Mehta; Ravindra L.,9993,0,9999,6
1714622624463,CLRE 251,B00,511410,Mehta; Ravindra L.,9998,0,9999,1
1714622625490,CLRE 252,A00,507189,Cuomo; Raphael Eduardo,9995,0,9999,4
1714622626515,CLRE 253,A00,507199,Vaida; Florin,9994,0,9999,5
1714622626515,CLRE 253,B00,507202,Vaida; Florin,9999,0,9999,0
1714622627544,CLRE 259,A00,507211,Patel; Hemal,9996,0,9999,3
1714622628568,CLRE 260,A00,507221,Cuomo; Raphael Eduardo,9999,0,9999,0
1714622629593,CLRE 297,001,507242,Cuomo; Raphael Eduardo,9999,0,9999,0
1714622630623,COGS 197,001,638244,Voytek; Bradley Thomas,9998,0,9999,1
1714622631649,CSE 191,A00,516875,Minnes Kemp; Mor Mia,9992,0,9999,7
1714622632674,CSE 197,001,637388,Minnes Kemp; Mor Mia,9998,0,9999,1
1714622633700,CSS 201S,A01,494383,Staff,35,0,35,0
1714622634724,CSS 202S,A01,494387,Staff,35,0,35,0
1714622635754,DSC 197,001,628532,Eldridge; Justin Matthew,9996,0,9999,3
1714622636781,EAP 100,A00,516065,Staff,9797,0,9999,202
1714622637810,ECE 45,A01,507414,Staff,33,0,60,27
1714622639866,ECE 111,A01,507420,Staff,15,0,50,35
1714622640891,ECE 197,001,548057,Sievenpiper; Daniel F.,9993,0,9999,6
1714622641921,EDS 115,A00,507243,Choi; Bailey Miyeon,10,0,28,18
1714622642947,EDS 117,A01,494379,Staff,1,5,30,29
1714622643976,EDS 125,A00,507246,Hopkins; Megan Beth,9,0,30,21
1714622645004,EDS 128A,A01,507264,Fargason; Sharon Gayle,8,0,26,18
1714622646031,EDS 128B,A01,507293,Pappas; Elizabeth,12,0,30,18
1714622647057,EDS 139,A00,507294,Fargason; Sharon Gayle,13,0,30,17
1714622647057,EDS 139,B00,507313,Pappas; Elizabeth,13,0,30,17
1714622648085,EDS 201,A00,507315,Staff,13,0,30,17
1714622649113,EDS 203,A01,507317,Halter; Christopher P.,12,0,30,18
1714622650139,EDS 204R,A01,507319,Halter; Christopher P.,0,3,30,30
1714622650139,EDS 204R,B01,507331,Heinzman; Erica M.,16,0,30,14
1714622651164,EDS 206R,A00,507332,Staff,0,4,30,30
1714622651164,EDS 206R,B00,507343,Staff,17,0,30,13
1714622652191,EDS 250,A00,507344,Hemans; Patricia Ann Benitez,22,0,40,18
1714622653219,EDS 281,A00,507345,Daly; Alan J.,18,0,18,0
1714622654244,EDS 284,A00,507350,Daly; Alan J.,16,0,16,0
1714622655276,EDS 286,A00,507359,Fine; Sarah,18,0,18,0
1714622656304,EDS 289C,A01,507361,Daly; Alan J.,18,0,18,0
1714622657331,EDS 290,A00,507366,Hofstetter; Carolyn,15,0,15,0
1714622658357,LIGM 5A,A00,507421,Fischer-Grunski; Eva K,18,0,20,2
1714622659385,LIGM 5B,A00,507423,Fischer-Grunski; Eva K,19,0,20,1
1714622660414,LIGM 5C,A00,507425,Fischer-Grunski; Eva K,19,0,20,1
1714622661441,LIIT 5AS,A00,507427,Carnelos; Chiara,20,0,20,0
1714622662470,LIIT 5BS,A00,507430,Carnelos; Chiara,20,0,20,0
1714622663494,LIIT 5CS,A00,507432,Carnelos; Chiara,20,0,20,0
1714622664525,LISP 5A,A00,507541,Munoz Sanchez; Alicia,11,0,20,9
1714622665550,LISP 5B,A00,507671,Munoz Sanchez; Alicia,8,0,20,12
1714622666576,LISP 5C,A00,507696,Munoz Sanchez; Alicia,9,0,20,11
1714622667605,MAE 197,001,528363,Boechler; Nicholas Sebastia,9998,0,9999,1
1714622668639,MATH 197,001,523477,Kedlaya; Kiran S.,9995,0,9999,4
1714622668639,MATH 197,002,563811,Zhang; Danna,9995,0,9999,4
1714622668639,MATH 197,003,628552,Dumitriu; Ioana,9998,0,9999,1
1714622669665,MCWP 40R,A00,518780,Staff,2,0,20,18
1714622669665,MCWP 40R,B00,518781,Staff,8,0,20,12
1714622669665,MCWP 40R,C00,518783,Staff,6,0,20,14
1714622670694,MCWP 50R,A00,518791,Staff,0,0,20,20
1714622670694,MCWP 50R,B00,518792,Staff,0,2,20,20
1714622670694,MCWP 50R,C00,518793,Staff,0,2,20,20
1714622670694,MCWP 50R,D00,518794,Staff,0,0,20,20
1714622670694,MCWP 50R,E00,518795,Staff,0,2,20,20
1714622670694,MCWP 50R,F00,518796,Staff,0,0,20,20
1714622670694,MCWP 50R,G00,518797,Staff,0,1,20,20
1714622671720,MMW 12R,A01,514034,Herbst; Matthew,0,0,16,16
1714622671720,MMW 12R,A02,514035,Herbst; Matthew,1,0,16,15
1714622672745,MMW 13R,A01,514037,Staff,0,4,16,16
1714622672745,MMW 13R,A02,514039,Staff,0,2,16,16
1714622672745,MMW 13R,A03,628519,Staff,0,2,16,16
1714622674802,SIO 295LS,A00,523233,Staff,10,0,30,20
1714622675829,SIO 295S,A00,523232,Staff,10,0,30,20
1714622676859,SIOC 290S,A01,637330,Merrifield; Mark A,23,0,30,7
1714622677890,SIOC 291S,A01,637333,Gabriel; Corey John,23,0,30,7
1714622678916,SOCI 117,A01,494376,Staff,0,4,5,5
1714622679943,WES 237B,A00,494380,Staff,9,0,20,11
1714622682016,AESE 279B,A00,494370,Wade; Jon P,0,0,33,33
1714622683045,AIP 197,001,627712,Vespa; Emanuel Ignacio,9998,0,9999,1
1714622684070,ANAR 135S,A00,494369,Braswell; Geoffrey E.,0,0,0,0
1714622685098,BENG 196,001,628496,Engler; Adam J.,9998,0,9999,1
1714622686128,CAT 124RS,A01,519847,Geibel; William,0,0,20,20
1714622687153,CAT 125RS,A01,515971,Geibel; William,0,0,20,20
1714622688179,CLRE 250,A00,511389,Morris; Sheldon,9993,0,9999,6
1714622689209,CLRE 251,A00,507176,Mehta; Ravindra L.,9993,0,9999,6
1714622689209,CLRE 251,B00,511410,Mehta; Ravindra L.,9998,0,9999,1
1714622690236,CLRE 252,A00,507189,Cuomo; Raphael Eduardo,9995,0,9999,4
1714622691260,CLRE 253,A00,507199,Vaida; Florin,9994,0,9999,5
1714622691260,CLRE 253,B00,507202,Vaida; Florin,9999,0,9999,0
1714622692286,CLRE 259,A00,507211,Patel; Hemal,9996,0,9999,3
1714622693310,CLRE 260,A00,507221,Cuomo; Raphael Eduardo,9999,0,9999,0
1714622694338,CLRE 297,001,507242,Cuomo; Raphael Eduardo,9999,0,9999,0
1714622695363,COGS 197,001,638244,Voytek; Bradley Thomas,9998,0,9999,1
1714622696389,CSE 191,A00,516875,Minnes Kemp; Mor Mia,9992,0,9999,7
1714622697415,CSE 197,001,637388,Minnes Kemp; Mor Mia,9998,0,9999,1
1714622698441,CSS 201S,A01,494383,Staff,35,0,35,0
1714622699469,CSS 202S,A01,494387,Staff,35,0,35,0
1714622700498,DSC 197,001,628532,Eldridge; Justin Matthew,9996,0,9999,3
1714622701523,EAP 100,A00,516065,Staff,9797,0,9999,202
1714622702548,ECE 45,A01,507414,Staff,33,0,60,27
1714622704604,ECE 111,A01,507420,Staff,15,0,50,35
1714622705633,ECE 197,001,548057,Sievenpiper; Daniel F.,9993,0,9999,6
1714622706660,EDS 115,A00,507243,Choi; Bailey Miyeon,10,0,28,18
1714622707692,EDS 117,A01,494379,Staff,1,5,30,29
1714622708718,EDS 125,A00,507246,Hopkins; Megan Beth,9,0,30,21
1714622709749,EDS 128A,A01,507264,Fargason; Sharon Gayle,8,0,26,18
1714622710775,EDS 128B,A01,507293,Pappas; Elizabeth,12,0,30,18
1714622711800,EDS 139,A00,507294,Fargason; Sharon Gayle,13,0,30,17
1714622711800,EDS 139,B00,507313,Pappas; Elizabeth,13,0,30,17
1714622712827,EDS 201,A00,507315,Staff,13,0,30,17
1714622713868,EDS 203,A01,507317,Halter; Christopher P.,12,0,30,18
1714622714894,EDS 204R,A01,507319,Halter; Christopher P.,0,3,30,30
1714622714894,EDS 204R,B01,507331,Heinzman; Erica M.,16,0,30,14
1714622715921,EDS 206R,A00,507332,Staff,0,4,30,30
1714622715921,EDS 206R,B00,507343,Staff,17,0,30,13
1714622716948,EDS 250,A00,507344,Hemans; Patricia Ann Benitez,22,0,40,18
1714622717974,EDS 281,A00,507345,Daly; Alan J.,18,0,18,0
1714622718999,EDS 284,A00,507350,Daly; Alan J.,16,0,16,0
1714622720026,EDS 286,A00,507359,Fine; Sarah,18,0,18,0
1714622721054,EDS 289C,A01,507361,Daly; Alan J.,18,0,18,0
1714622722081,EDS 290,A00,507366,Hofstetter; Carolyn,15,0,15,0
1714622723108,LIGM 5A,A00,507421,Fischer-Grunski; Eva K,18,0,20,2
1714622724137,LIGM 5B,A00,507423,Fischer-Grunski; Eva K,19,0,20,1
1714622725162,LIGM 5C,A00,507425,Fischer-Grunski; Eva K,19,0,20,1
1714622726188,LIIT 5AS,A00,507427,Carnelos; Chiara,20,0,20,0
1714622727215,LIIT 5BS,A00,507430,Carnelos; Chiara,20,0,20,0
1714622728241,LIIT 5CS,A00,507432,Carnelos; Chiara,20,0,20,0
1714622729270,LISP 5A,A00,507541,Munoz Sanchez; Alicia,11,0,20,9
1714622730295,LISP 5B,A00,507671,Munoz Sanchez; Alicia,8,0,20,12
1714622731325,LISP 5C,A00,507696,Munoz Sanchez; Alicia,9,0,20,11
1714622732349,MAE 197,001,528363,Boechler; Nicholas Sebastia,9998,0,9999,1
1714622733379,MATH 197,001,523477,Kedlaya; Kiran S.,9995,0,9999,4
1714622733379,MATH 197,002,563811,Zhang; Danna,9995,0,9999,4
1714622733379,MATH 197,003,628552,Dumitriu; Ioana,9998,0,9999,1
1714622734410,MCWP 40R,A00,518780,Staff,2,0,20,18
1714622734410,MCWP 40R,B00,518781,Staff,8,0,20,12
1714622734410,MCWP 40R,C00,518783,Staff,6,0,20,14
1714622735436,MCWP 50R,A00,518791,Staff,0,0,20,20
1714622735436,MCWP 50R,B00,518792,Staff,0,2,20,20
1714622735436,MCWP 50R,C00,518793,Staff,0,2,20,20
1714622735436,MCWP 50R,D00,518794,Staff,0,0,20,20
1714622735436,MCWP 50R,E00,518795,Staff,0,2,20,20
1714622735436,MCWP 50R,F00,518796,Staff,0,0,20,20
1714622735436,MCWP 50R,G00,518797,Staff,0,1,20,20
1714622736465,MMW 12R,A01,514034,Herbst; Matthew,0,0,16,16
1714622736465,MMW 12R,A02,514035,Herbst; Matthew,1,0,16,15
1714622737490,MMW 13R,A01,514037,Staff,0,4,16,16
1714622737490,MMW 13R,A02,514039,Staff,0,2,16,16
1714622737490,MMW 13R,A03,628519,Staff,0,2,16,16
1714622739543,SIO 295LS,A00,523233,Staff,10,0,30,20
1714622740567,SIO 295S,A00,523232,Staff,10,0,30,20
1714622741597,SIOC 290S,A01,637330,Merrifield; Mark A,23,0,30,7
1714622742625,SIOC 291S,A01,637333,Gabriel; Corey John,23,0,30,7
1714622743651,SOCI 117,A01,494376,Staff,0,4,5,5
1714622744678,WES 237B,A00,494380,Staff,9,0,20,11
1714622746747,AESE 279B,A00,494370,Wade; Jon P,0,0,33,33
1714622747777,AIP 197,001,627712,Vespa; Emanuel Ignacio,9998,0,9999,1
1714622748803,ANAR 135S,A00,494369,Braswell; Geoffrey E.,0,0,0,0
1714622749829,BENG 196,001,628496,Engler; Adam J.,9998,0,9999,1
1714622750857,CAT 124RS,A01,519847,Geibel; William,0,0,20,20
1714622751882,CAT 125RS,A01,515971,Geibel; William,0,0,20,20
1714622752909,CLRE 250,A00,511389,Morris; Sheldon,9993,0,9999,6
1714622753935,CLRE 251,A00,507176,Mehta; Ravindra L.,9993,0,9999,6
1714622753935,CLRE 251,B00,511410,Mehta; Ravindra L.,9998,0,9999,1
1714622754962,CLRE 252,A00,507189,Cuomo; Raphael Eduardo,9995,0,9999,4
1714622755988,CLRE 253,A00,507199,Vaida; Florin,9994,0,9999,5
1714622755988,CLRE 253,B00,507202,Vaida; Florin,9999,0,9999,0
1714622757015,CLRE 259,A00,507211,Patel; Hemal,9996,0,9999,3
1714622758040,CLRE 260,A00,507221,Cuomo; Raphael Eduardo,9999,0,9999,0
1714622759067,CLRE 297,001,507242,Cuomo; Raphael Eduardo,9999,0,9999,0
1714622760092,COGS 197,001,638244,Voytek; Bradley Thomas,9998,0,9999,1
1714622761119,CSE 191,A00,516875,Minnes Kemp; Mor Mia,9992,0,9999,7
1714622762145,CSE 197,001,637388,Minnes Kemp; Mor Mia,9998,0,9999,1
1714622763170,CSS 201S,A01,494383,Staff,35,0,35,0
1714622764196,CSS 202S,A01,494387,Staff,35,0,35,0
1714622765222,DSC 197,001,628532,Eldridge; Justin Matthew,9996,0,9999,3
1714622766251,EAP 100,A00,516065,Staff,9797,0,9999,202
1714622767276,ECE 45,A01,507414,Staff,33,0,60,27
1714622769326,ECE 111,A01,507420,Staff,15,0,50,35
1714622770354,ECE 197,001,548057,Sievenpiper; Daniel F.,9993,0,9999,6
1714622771381,EDS 115,A00,507243,Choi; Bailey Miyeon,10,0,28,18
1714622772405,EDS 117,A01,494379,Staff,1,5,30,29
1714622773431,EDS 125,A00,507246,Hopkins; Megan Beth,9,0,30,21
1714622774455,EDS 128A,A01,507264,Fargason; Sharon Gayle,8,0,26,18
1714622775482,EDS 128B,A01,507293,Pappas; Elizabeth,12,0,30,18
1714622776507,EDS 139,A00,507294,Fargason; Sharon Gayle,13,0,30,17
1714622776507,EDS 139,B00,507313,Pappas; Elizabeth,13,0,30,17
1714622777532,EDS 201,A00,507315,Staff,13,0,30,17
1714622778561,EDS 203,A01,507317,Halter; Christopher P.,12,0,30,18
1714622779586,EDS 204R,A01,507319,Halter; Christopher P.,0,3,30,30
1714622779586,EDS 204R,B01,507331,Heinzman; Erica M.,16,0,30,14
1714622780612,EDS 206R,A00,507332,Staff,0,4,30,30
1714622780612,EDS 206R,B00,507343,Staff,17,0,30,13
1714622781638,EDS 250,A00,507344,Hemans; Patricia Ann Benitez,22,0,40,18
1714622782667,EDS 281,A00,507345,Daly; Alan J.,18,0,18,0
1714622783695,EDS 284,A00,507350,Daly; Alan J.,16,0,16,0
1714622784721,EDS 286,A00,507359,Fine; Sarah,18,0,18,0
1714622785749,EDS 289C,A01,507361,Daly; Alan J.,18,0,18,0
1714622786777,EDS 290,A00,507366,Hofstetter; Carolyn,15,0,15,0
1714622787804,LIGM 5A,A00,507421,Fischer-Grunski; Eva K,18,0,20,2
1714622788835,LIGM 5B,A00,507423,Fischer-Grunski; Eva K,19,0,20,1
1714622789862,LIGM 5C,A00,507425,Fischer-Grunski; Eva K,19,0,20,1
1714622790886,LIIT 5AS,A00,507427,Carnelos; Chiara,20,0,20,0
1714622792948,LIIT 5BS,A00,507430,Carnelos; Chiara,20,0,20,0
1714622793977,LIIT 5CS,A00,507432,Carnelos; Chiara,20,0,20,0
1714622795007,LISP 5A,A00,507541,Munoz Sanchez; Alicia,11,0,20,9
1714622796032,LISP 5B,A00,507671,Munoz Sanchez; Alicia,8,0,20,12
1714622797058,LISP 5C,A00,507696,Munoz Sanchez; Alicia,9,0,20,11
1714622798084,MAE 197,001,528363,Boechler; Nicholas Sebastia,9998,0,9999,1
1714622799112,MATH 197,001,523477,Kedlaya; Kiran S.,9995,0,9999,4
1714622799112,MATH 197,002,563811,Zhang; Danna,9995,0,9999,4
1714622799112,MATH 197,003,628552,Dumitriu; Ioana,9998,0,9999,1
1714622800138,MCWP 40R,A00,518780,Staff,2,0,20,18
1714622800138,MCWP 40R,B00,518781,Staff,8,0,20,12
1714622800138,MCWP 40R,C00,518783,Staff,6,0,20,14
1714622801167,MCWP 50R,A00,518791,Staff,0,0,20,20
1714622801167,MCWP 50R,B00,518792,Staff,0,2,20,20
1714622801167,MCWP 50R,C00,518793,Staff,0,2,20,20
1714622801167,MCWP 50R,D00,518794,Staff,0,0,20,20
1714622801167,MCWP 50R,E00,518795,Staff,0,2,20,20
1714622801167,MCWP 50R,F00,518796,Staff,0,0,20,20
1714622801167,MCWP 50R,G00,518797,Staff,0,1,20,20
1714622802194,MMW 12R,A01,514034,Herbst; Matthew,0,0,16,16
1714622802194,MMW 12R,A02,514035,Herbst; Matthew,1,0,16,15
1714622803220,MMW 13R,A01,514037,Staff,0,4,16,16
1714622803220,MMW 13R,A02,514039,Staff,0,2,16,16
1714622803220,MMW 13R,A03,628519,Staff,0,2,16,16
1714622805273,SIO 295LS,A00,523233,Staff,10,0,30,20
1714622806302,SIO 295S,A00,523232,Staff,10,0,30,20
1714622807327,SIOC 290S,A01,637330,Merrifield; Mark A,23,0,30,7
1714622808353,SIOC 291S,A01,637333,Gabriel; Corey John,23,0,30,7
1714622809382,SOCI 117,A01,494376,Staff,0,4,5,5
1714622810409,WES 237B,A00,494380,Staff,9,0,20,11
1714622812481,AESE 279B,A00,494370,Wade; Jon P,0,0,33,33
1714622813509,AIP 197,001,627712,Vespa; Emanuel Ignacio,9998,0,9999,1
1714622814536,ANAR 135S,A00,494369,Braswell; Geoffrey E.,0,0,0,0
1714622815563,BENG 196,001,628496,Engler; Adam J.,9998,0,9999,1
1714622816591,CAT 124RS,A01,519847,Geibel; William,0,0,20,20
1714622817615,CAT 125RS,A01,515971,Geibel; William,0,0,20,20
1714622818644,CLRE 250,A00,511389,Morris; Sheldon,9993,0,9999,6
1714622819672,CLRE 251,A00,507176,Mehta; Ravindra L.,9993,0,9999,6
1714622819672,CLRE 251,B00,511410,Mehta; Ravindra L.,9998,0,9999,1
1714622820702,CLRE 252,A00,507189,Cuomo; Raphael Eduardo,9995,0,9999,4
1714622821728,CLRE 253,A00,507199,Vaida; Florin,9994,0,9999,5
1714622821728,CLRE 253,B00,507202,Vaida; Florin,9999,0,9999,0
1714622822755,CLRE 259,A00,507211,Patel; Hemal,9996,0,9999,3
1714622823780,CLRE 260,A00,507221,Cuomo; Raphael Eduardo,9999,0,9999,0
1714622824805,CLRE 297,001,507242,Cuomo; Raphael Eduardo,9999,0,9999,0
1714622825831,COGS 197,001,638244,Voytek; Bradley Thomas,9998,0,9999,1
1714622826859,CSE 191,A00,516875,Minnes Kemp; Mor Mia,9992,0,9999,7
1714622827885,CSE 197,001,637388,Minnes Kemp; Mor Mia,9998,0,9999,1
1714622828913,CSS 201S,A01,494383,Staff,35,0,35,0
1714622829943,CSS 202S,A01,494387,Staff,35,0,35,0
1714622830978,DSC 197,001,628532,Eldridge; Justin Matthew,9996,0,9999,3
1714622832010,EAP 100,A00,516065,Staff,9797,0,9999,202
1714622833038,ECE 45,A01,507414,Staff,33,0,60,27
1714622835092,ECE 111,A01,507420,Staff,15,0,50,35
1714622836118,ECE 197,001,548057,Sievenpiper; Daniel F.,9993,0,9999,6
1714622837143,EDS 115,A00,507243,Choi; Bailey Miyeon,10,0,28,18
1714622838168,EDS 117,A01,494379,Staff,1,5,30,29
1714622839194,EDS 125,A00,507246,Hopkins; Megan Beth,9,0,30,21
1714622840223,EDS 128A,A01,507264,Fargason; Sharon Gayle,8,0,26,18
1714622841251,EDS 128B,A01,507293,Pappas; Elizabeth,12,0,30,18
1714622842275,EDS 139,A00,507294,Fargason; Sharon Gayle,13,0,30,17
1714622842275,EDS 139,B00,507313,Pappas; Elizabeth,13,0,30,17
1714622843300,EDS 201,A00,507315,Staff,13,0,30,17
1714622844330,EDS 203,A01,507317,Halter; Christopher P.,12,0,30,18
1714622845355,EDS 204R,A01,507319,Halter; Christopher P.,0,3,30,30
1714622845355,EDS 204R,B01,507331,Heinzman; Erica M.,16,0,30,14
1714622846380,EDS 206R,A00,507332,Staff,0,4,30,30
1714622846380,EDS 206R,B00,507343,Staff,17,0,30,13
1714622847407,EDS 250,A00,507344,Hemans; Patricia Ann Benitez,22,0,40,18
1714622848433,EDS 281,A00,507345,Daly; Alan J.,18,0,18,0
1714622849460,EDS 284,A00,507350,Daly; Alan J.,16,0,16,0
1714622850486,EDS 286,A00,507359,Fine; Sarah,18,0,18,0
1714622851513,EDS 289C,A01,507361,Daly; Alan J.,18,0,18,0
1714622852538,EDS 290,A00,507366,Hofstetter; Carolyn,15,0,15,0
1714622853565,LIGM 5A,A00,507421,Fischer-Grunski; Eva K,18,0,20,2
1714622854592,LIGM 5B,A00,507423,Fischer-Grunski; Eva K,19,0,20,1
1714622855618,LIGM 5C,A00,507425,Fischer-Grunski; Eva K,19,0,20,1
1714622856644,LIIT 5AS,A00,507427,Carnelos; Chiara,20,0,20,0
1714622857670,LIIT 5BS,A00,507430,Carnelos; Chiara,20,0,20,0
1714622858696,LIIT 5CS,A00,507432,Carnelos; Chiara,20,0,20,0
1714622859725,LISP 5A,A00,507541,Munoz Sanchez; Alicia,11,0,20,9
1714622860752,LISP 5B,A00,507671,Munoz Sanchez; Alicia,8,0,20,12
1714622861778,LISP 5C,A00,507696,Munoz Sanchez; Alicia,9,0,20,11
1714622862803,MAE 197,001,528363,Boechler; Nicholas Sebastia,9998,0,9999,1
1714622863834,MATH 197,001,523477,Kedlaya; Kiran S.,9995,0,9999,4
1714622863834,MATH 197,002,563811,Zhang; Danna,9995,0,9999,4
1714622863834,MATH 197,003,628552,Dumitriu; Ioana,9998,0,9999,1
1714622864859,MCWP 40R,A00,518780,Staff,2,0,20,18
1714622864859,MCWP 40R,B00,518781,Staff,8,0,20,12
1714622864859,MCWP 40R,C00,518783,Staff,6,0,20,14
1714622865891,MCWP 50R,A00,518791,Staff,0,0,20,20
1714622865891,MCWP 50R,B00,518792,Staff,0,2,20,20
1714622865891,MCWP 50R,C00,518793,Staff,0,2,20,20
1714622865891,MCWP 50R,D00,518794,Staff,0,0,20,20
1714622865891,MCWP 50R,E00,518795,Staff,0,2,20,20
1714622865891,MCWP 50R,F00,518796,Staff,0,0,20,20
1714622865891,MCWP 50R,G00,518797,Staff,0,1,20,20
1714622866917,MMW 12R,A01,514034,Herbst; Matthew,0,0,16,16
1714622866917,MMW 12R,A02,514035,Herbst; Matthew,1,0,16,15
1714622867943,MMW 13R,A01,514037,Staff,0,4,16,16
1714622867943,MMW 13R,A02,514039,Staff,0,2,16,16
1714622867943,MMW 13R,A03,628519,Staff,0,2,16,16
1714622869995,SIO 295LS,A00,523233,Staff,10,0,30,20
1714622871023,SIO 295S,A00,523232,Staff,10,0,30,20
1714622872054,SIOC 290S,A01,637330,Merrifield; Mark A,23,0,30,7
1714622873083,SIOC 291S,A01,637333,Gabriel; Corey John,23,0,30,7
1714622874108,SOCI 117,A01,494376,Staff,0,4,5,5
1714622875134,WES 237B,A00,494380,Staff,9,0,20,11
1714622877202,AESE 279B,A00,494370,Wade; Jon P,0,0,33,33
1714622878229,AIP 197,001,627712,Vespa; Emanuel Ignacio,9998,0,9999,1
1714622879259,ANAR 135S,A00,494369,Braswell; Geoffrey E.,0,0,0,0
1714622880287,BENG 196,001,628496,Engler; Adam J.,9998,0,9999,1
1714622881315,CAT 124RS,A01,519847,Geibel; William,0,0,20,20
1714622882343,CAT 125RS,A01,515971,Geibel; William,0,0,20,20
1714622883374,CLRE 250,A00,511389,Morris; Sheldon,9993,0,9999,6
1714622884400,CLRE 251,A00,507176,Mehta; Ravindra L.,9993,0,9999,6
1714622884400,CLRE 251,B00,511410,Mehta; Ravindra L.,9998,0,9999,1
1714622885429,CLRE 252,A00,507189,Cuomo; Raphael Eduardo,9995,0,9999,4
1714622886457,CLRE 253,A00,507199,Vaida; Florin,9994,0,9999,5
1714622886457,CLRE 253,B00,507202,Vaida; Florin,9999,0,9999,0
1714622887481,CLRE 259,A00,507211,Patel; Hemal,9996,0,9999,3
1714622888507,CLRE 260,A00,507221,Cuomo; Raphael Eduardo,9999,0,9999,0
1714622889533,CLRE 297,001,507242,Cuomo; Raphael Eduardo,9999,0,9999,0
1714622890559,COGS 197,001,638244,Voytek; Bradley Thomas,9998,0,9999,1
1714622891587,CSE 191,A00,516875,Minnes Kemp; Mor Mia,9992,0,9999,7
1714622892611,CSE 197,001,637388,Minnes Kemp; Mor Mia,9998,0,9999,1
1714622893640,CSS 201S,A01,494383,Staff,35,0,35,0
1714622894669,CSS 202S,A01,494387,Staff,35,0,35,0
1714622895694,DSC 197,001,628532,Eldridge; Justin Matthew,9996,0,9999,3
1714622896722,EAP 100,A00,516065,Staff,9797,0,9999,202
1714622897750,ECE 45,A01,507414,Staff,33,0,60,27
1714622899801,ECE 111,A01,507420,Staff,15,0,50,35
1714622900827,ECE 197,001,548057,Sievenpiper; Daniel F.,9993,0,9999,6
1714622901857,EDS 115,A00,507243,Choi; Bailey Miyeon,10,0,28,18
1714622902883,EDS 117,A01,494379,Staff,1,5,30,29
1714622903910,EDS 125,A00,507246,Hopkins; Megan Beth,9,0,30,21
1714622904937,EDS 128A,A01,507264,Fargason; Sharon Gayle,8,0,26,18
1714622905966,EDS 128B,A01,507293,Pappas; Elizabeth,12,0,30,18
1714622906996,EDS 139,A00,507294,Fargason; Sharon Gayle,13,0,30,17
1714622906996,EDS 139,B00,507313,Pappas; Elizabeth,13,0,30,17
1714622908021,EDS 201,A00,507315,Staff,13,0,30,17
1714622909046,EDS 203,A01,507317,Halter; Christopher P.,12,0,30,18
1714622910071,EDS 204R,A01,507319,Halter; Christopher P.,0,3,30,30
1714622910071,EDS 204R,B01,507331,Heinzman; Erica M.,16,0,30,14
1714622911098,EDS 206R,A00,507332,Staff,0,4,30,30
1714622911098,EDS 206R,B00,507343,Staff,17,0,30,13
1714622912125,EDS 250,A00,507344,Hemans; Patricia Ann Benitez,22,0,40,18
1714622913151,EDS 281,A00,507345,Daly; Alan J.,18,0,18,0
1714622914178,EDS 284,A00,507350,Daly; Alan J.,16,0,16,0
1714622915206,EDS 286,A00,507359,Fine; Sarah,18,0,18,0
1714622916231,EDS 289C,A01,507361,Daly; Alan J.,18,0,18,0
1714622917259,EDS 290,A00,507366,Hofstetter; Carolyn,15,0,15,0
1714622918290,LIGM 5A,A00,507421,Fischer-Grunski; Eva K,18,0,20,2
1714622919316,LIGM 5B,A00,507423,Fischer-Grunski; Eva K,19,0,20,1
1714622920341,LIGM 5C,A00,507425,Fischer-Grunski; Eva K,19,0,20,1
1714622921371,LIIT 5AS,A00,507427,Carnelos; Chiara,20,0,20,0
1714622922396,LIIT 5BS,A00,507430,Carnelos; Chiara,20,0,20,0
1714622923421,LIIT 5CS,A00,507432,Carnelos; Chiara,20,0,20,0
1714622924451,LISP 5A,A00,507541,Munoz Sanchez; Alicia,11,0,20,9
1714622925475,LISP 5B,A00,507671,Munoz Sanchez; Alicia,8,0,20,12
1714622926502,LISP 5C,A00,507696,Munoz Sanchez; Alicia,9,0,20,11
1714622927532,MAE 197,001,528363,Boechler; Nicholas Sebastia,9998,0,9999,1
1714622928558,MATH 197,001,523477,Kedlaya; Kiran S.,9995,0,9999,4
1714622928558,MATH 197,002,563811,Zhang; Danna,9995,0,9999,4
1714622928558,MATH 197,003,628552,Dumitriu; Ioana,9998,0,9999,1
1714622929586,MCWP 40R,A00,518780,Staff,2,0,20,18
1714622929586,MCWP 40R,B00,518781,Staff,8,0,20,12
1714622929586,MCWP 40R,C00,518783,Staff,6,0,20,14
1714622930614,MCWP 50R,A00,518791,Staff,0,0,20,20
1714622930614,MCWP 50R,B00,518792,Staff,0,2,20,20
1714622930614,MCWP 50R,C00,518793,Staff,0,2,20,20
1714622930614,MCWP 50R,D00,518794,Staff,0,0,20,20
1714622930614,MCWP 50R,E00,518795,Staff,0,2,20,20
1714622930614,MCWP 50R,F00,518796,Staff,0,0,20,20
1714622930614,MCWP 50R,G00,518797,Staff,0,1,20,20
1714622931644,MMW 12R,A01,514034,Herbst; Matthew,0,0,16,16
1714622931644,MMW 12R,A02,514035,Herbst; Matthew,1,0,16,15
1714622932669,MMW 13R,A01,514037,Staff,0,4,16,16
1714622932669,MMW 13R,A02,514039,Staff,0,2,16,16
1714622932669,MMW 13R,A03,628519,Staff,0,2,16,16
1714622934724,SIO 295LS,A00,523233,Staff,10,0,30,20
1714622935752,SIO 295S,A00,523232,Staff,10,0,30,20
1714622936783,SIOC 290S,A01,637330,Merrifield; Mark A,23,0,30,7
1714622937811,SIOC 291S,A01,637333,Gabriel; Corey John,23,0,30,7
1714622938837,SOCI 117,A01,494376,Staff,0,4,5,5
1714622939864,WES 237B,A00,494380,Staff,9,0,20,11
1714622941960,AESE 279B,A00,494370,Wade; Jon P,0,0,33,33
1714622943046,AIP 197,001,627712,Vespa; Emanuel Ignacio,9998,0,9999,1
1714622944072,ANAR 135S,A00,494369,Braswell; Geoffrey E.,0,0,0,0
1714622945101,BENG 196,001,628496,Engler; Adam J.,9998,0,9999,1
1714622946131,CAT 124RS,A01,519847,Geibel; William,0,0,20,20
1714622947160,CAT 125RS,A01,515971,Geibel; William,0,0,20,20
1714622948189,CLRE 250,A00,511389,Morris; Sheldon,9993,0,9999,6
1714622949218,CLRE 251,A00,507176,Mehta; Ravindra L.,9993,0,9999,6
1714622949218,CLRE 251,B00,511410,Mehta; Ravindra L.,9998,0,9999,1
1714622950248,CLRE 252,A00,507189,Cuomo; Raphael Eduardo,9995,0,9999,4
1714622951276,CLRE 253,A00,507199,Vaida; Florin,9994,0,9999,5
1714622951276,CLRE 253,B00,507202,Vaida; Florin,9999,0,9999,0
1714622952300,CLRE 259,A00,507211,Patel; Hemal,9996,0,9999,3
1714622953327,CLRE 260,A00,507221,Cuomo; Raphael Eduardo,9999,0,9999,0
1714622954355,CLRE 297,001,507242,Cuomo; Raphael Eduardo,9999,0,9999,0
1714622955384,COGS 197,001,638244,Voytek; Bradley Thomas,9998,0,9999,1
1714622956413,CSE 191,A00,516875,Minnes Kemp; Mor Mia,9992,0,9999,7
1714622957442,CSE 197,001,637388,Minnes Kemp; Mor Mia,9998,0,9999,1
1714622958469,CSS 201S,A01,494383,Staff,35,0,35,0
1714622959495,CSS 202S,A01,494387,Staff,35,0,35,0
1714622960521,DSC 197,001,628532,Eldridge; Justin Matthew,9996,0,9999,3
1714622961547,EAP 100,A00,516065,Staff,9797,0,9999,202
1714622962572,ECE 45,A01,507414,Staff,33,0,60,27
1714622964628,ECE 111,A01,507420,Staff,15,0,50,35
1714622965652,ECE 197,001,548057,Sievenpiper; Daniel F.,9993,0,9999,6
1714622966677,EDS 115,A00,507243,Choi; Bailey Miyeon,10,0,28,18
1714622967701,EDS 117,A01,494379,Staff,1,5,30,29
1714622968729,EDS 125,A00,507246,Hopkins; Megan Beth,9,0,30,21
1714622969755,EDS 128A,A01,507264,Fargason; Sharon Gayle,8,0,26,18
1714622970782,EDS 128B,A01,507293,Pappas; Elizabeth,12,0,30,18
1714622971807,EDS 139,A00,507294,Fargason; Sharon Gayle,13,0,30,17
1714622971807,EDS 139,B00,507313,Pappas; Elizabeth,13,0,30,17
1714622972834,EDS 201,A00,507315,Staff,13,0,30,17
1714622973872,EDS 203,A01,507317,Halter; Christopher P.,12,0,30,18
1714622974898,EDS 204R,A01,507319,Halter; Christopher P.,0,3,30,30
1714622974898,EDS 204R,B01,507331,Heinzman; Erica M.,16,0,30,14
1714622975923,EDS 206R,A00,507332,Staff,0,4,30,30
1714622975923,EDS 206R,B00,507343,Staff,17,0,30,13
1714622976950,EDS 250,A00,507344,Hemans; Patricia Ann Benitez,22,0,40,18
1714622977974,EDS 281,A00,507345,Daly; Alan J.,18,0,18,0
1714622979000,EDS 284,A00,507350,Daly; Alan J.,16,0,16,0
1714622980028,EDS 286,A00,507359,Fine; Sarah,18,0,18,0
1714622981056,EDS 289C,A01,507361,Daly; Alan J.,18,0,18,0
1714622982084,EDS 290,A00,507366,Hofstetter; Carolyn,15,0,15,0
1714622983115,LIGM 5A,A00,507421,Fischer-Grunski; Eva K,18,0,20,2
1714622984144,LIGM 5B,A00,507423,Fischer-Grunski; Eva K,19,0,20,1
1714622985175,LIGM 5C,A00,507425,Fischer-Grunski; Eva K,19,0,20,1
1714622986199,LIIT 5AS,A00,507427,Carnelos; Chiara,20,0,20,0
1714622987228,LIIT 5BS,A00,507430,Carnelos; Chiara,20,0,20,0
1714622988257,LIIT 5CS,A00,507432,Carnelos; Chiara,20,0,20,0
1714622989288,LISP 5A,A00,507541,Munoz Sanchez; Alicia,11,0,20,9
1714622990314,LISP 5B,A00,507671,Munoz Sanchez; Alicia,8,0,20,12
1714622991338,LISP 5C,A00,507696,Munoz Sanchez; Alicia,9,0,20,11
1714622992364,MAE 197,001,528363,Boechler; Nicholas Sebastia,9998,0,9999,1
1714622993390,MATH 197,001,523477,Kedlaya; Kiran S.,9995,0,9999,4
1714622993390,MATH 197,002,563811,Zhang; Danna,9995,0,9999,4
1714622993390,MATH 197,003,628552,Dumitriu; Ioana,9998,0,9999,1
1714622994415,MCWP 40R,A00,518780,Staff,2,0,20,18
1714622994415,MCWP 40R,B00,518781,Staff,8,0,20,12
1714622994415,MCWP 40R,C00,518783,Staff,6,0,20,14
1714622995442,MCWP 50R,A00,518791,Staff,0,0,20,20
1714622995442,MCWP 50R,B00,518792,Staff,0,2,20,20
1714622995442,MCWP 50R,C00,518793,Staff,0,2,20,20
1714622995442,MCWP 50R,D00,518794,Staff,0,0,20,20
1714622995442,MCWP 50R,E00,518795,Staff,0,2,20,20
1714622995442,MCWP 50R,F00,518796,Staff,0,0,20,20
1714622995442,MCWP 50R,G00,518797,Staff,0,1,20,20
1714622996468,MMW 12R,A01,514034,Herbst; Matthew,0,0,16,16
1714622996468,MMW 12R,A02,514035,Herbst; Matthew,1,0,16,15
1714622997497,MMW 13R,A01,514037,Staff,0,4,16,16
1714622997497,MMW 13R,A02,514039,Staff,0,2,16,16
1714622997497,MMW 13R,A03,628519,Staff,0,2,16,16
1714622999553,SIO 295LS,A00,523233,Staff,10,0,30,20
1714623000578,SIO 295S,A00,523232,Staff,10,0,30,20
1714623001604,SIOC 290S,A01,637330,Merrifield; Mark A,23,0,30,7
1714623002630,SIOC 291S,A01,637333,Gabriel; Corey John,23,0,30,7
1714623003654,SOCI 117,A01,494376,Staff,0,4,5,5
1714623004680,WES 237B,A00,494380,Staff,9,0,20,11
1714623006762,AESE 279B,A00,494370,Wade; Jon P,0,0,33,33
1714623007787,AIP 197,001,627712,Vespa; Emanuel Ignacio,9998,0,9999,1
1714623008815,ANAR 135S,A00,494369,Braswell; Geoffrey E.,0,0,0,0
1714623009844,BENG 196,001,628496,Engler; Adam J.,9998,0,9999,1
1714623011419,CAT 124RS,A01,519847,Geibel; William,0,0,20,20
1714623012447,CAT 125RS,A01,515971,Geibel; William,0,0,20,20
1714623013474,CLRE 250,A00,511389,Morris; Sheldon,9993,0,9999,6
1714623014501,CLRE 251,A00,507176,Mehta; Ravindra L.,9993,0,9999,6
1714623014501,CLRE 251,B00,511410,Mehta; Ravindra L.,9998,0,9999,1
1714623015526,CLRE 252,A00,507189,Cuomo; Raphael Eduardo,9995,0,9999,4
1714623016552,CLRE 253,A00,507199,Vaida; Florin,9994,0,9999,5
1714623016552,CLRE 253,B00,507202,Vaida; Florin,9999,0,9999,0
1714623017581,CLRE 259,A00,507211,Patel; Hemal,9996,0,9999,3
1714623018604,CLRE 260,A00,507221,Cuomo; Raphael Eduardo,9999,0,9999,0
1714623019632,CLRE 297,001,507242,Cuomo; Raphael Eduardo,9999,0,9999,0
1714623020660,COGS 197,001,638244,Voytek; Bradley Thomas,9998,0,9999,1
1714623021688,CSE 191,A00,516875,Minnes Kemp; Mor Mia,9992,0,9999,7
1714623022713,CSE 197,001,637388,Minnes Kemp; Mor Mia,9998,0,9999,1
1714623023739,CSS 201S,A01,494383,Staff,35,0,35,0
1714623024770,CSS 202S,A01,494387,Staff,35,0,35,0
1714623025795,DSC 197,001,628532,Eldridge; Justin Matthew,9996,0,9999,3
1714623026822,EAP 100,A00,516065,Staff,9797,0,9999,202
1714623027849,ECE 45,A01,507414,Staff,33,0,60,27
1714623029900,ECE 111,A01,507420,Staff,15,0,50,35
1714623030928,ECE 197,001,548057,Sievenpiper; Daniel F.,9993,0,9999,6
1714623031953,EDS 115,A00,507243,Choi; Bailey Miyeon,10,0,28,18
1714623032978,EDS 117,A01,494379,Staff,1,5,30,29
1714623034007,EDS 125,A00,507246,Hopkins; Megan Beth,9,0,30,21
1714623035034,EDS 128A,A01,507264,Fargason; Sharon Gayle,8,0,26,18
1714623036062,EDS 128B,A01,507293,Pappas; Elizabeth,12,0,30,18
1714623037089,EDS 139,A00,507294,Fargason; Sharon Gayle,13,0,30,17
1714623037089,EDS 139,B00,507313,Pappas; Elizabeth,13,0,30,17
1714623038116,EDS 201,A00,507315,Staff,13,0,30,17
1714623039142,EDS 203,A01,507317,Halter; Christopher P.,12,0,30,18
1714623040168,EDS 204R,A01,507319,Halter; Christopher P.,0,3,30,30
1714623040168,EDS 204R,B01,507331,Heinzman; Erica M.,16,0,30,14
1714623041193,EDS 206R,A00,507332,Staff,0,4,30,30
1714623041193,EDS 206R,B00,507343,Staff,17,0,30,13
1714623042218,EDS 250,A00,507344,Hemans; Patricia Ann Benitez,22,0,40,18
1714623043243,EDS 281,A00,507345,Daly; Alan J.,18,0,18,0
1714623044268,EDS 284,A00,507350,Daly; Alan J.,16,0,16,0
1714623045294,EDS 286,A00,507359,Fine; Sarah,18,0,18,0
1714623046320,EDS 289C,A01,507361,Daly; Alan J.,18,0,18,0
1714623047345,EDS 290,A00,507366,Hofstetter; Carolyn,15,0,15,0
1714623048372,LIGM 5A,A00,507421,Fischer-Grunski; Eva K,18,0,20,2
1714623049402,LIGM 5B,A00,507423,Fischer-Grunski; Eva K,19,0,20,1
1714623050431,LIGM 5C,A00,507425,Fischer-Grunski; Eva K,19,0,20,1
1714623051456,LIIT 5AS,A00,507427,Carnelos; Chiara,20,0,20,0
1714623052481,LIIT 5BS,A00,507430,Carnelos; Chiara,20,0,20,0
1714623053510,LIIT 5CS,A00,507432,Carnelos; Chiara,20,0,20,0
1714623054537,LISP 5A,A00,507541,Munoz Sanchez; Alicia,11,0,20,9
1714623055562,LISP 5B,A00,507671,Munoz Sanchez; Alicia,8,0,20,12
1714623056590,LISP 5C,A00,507696,Munoz Sanchez; Alicia,9,0,20,11
1714623057619,MAE 197,001,528363,Boechler; Nicholas Sebastia,9998,0,9999,1
1714623058651,MATH 197,001,523477,Kedlaya; Kiran S.,9995,0,9999,4
1714623058651,MATH 197,002,563811,Zhang; Danna,9995,0,9999,4
1714623058651,MATH 197,003,628552,Dumitriu; Ioana,9998,0,9999,1
1714623059676,MCWP 40R,A00,518780,Staff,2,0,20,18
1714623059676,MCWP 40R,B00,518781,Staff,8,0,20,12
1714623059676,MCWP 40R,C00,518783,Staff,6,0,20,14
1714623060701,MCWP 50R,A00,518791,Staff,0,0,20,20
1714623060701,MCWP 50R,B00,518792,Staff,0,2,20,20
1714623060701,MCWP 50R,C00,518793,Staff,0,2,20,20
1714623060701,MCWP 50R,D00,518794,Staff,0,0,20,20
1714623060701,MCWP 50R,E00,518795,Staff,0,2,20,20
1714623060701,MCWP 50R,F00,518796,Staff,0,0,20,20
1714623060701,MCWP 50R,G00,518797,Staff,0,1,20,20
1714623061731,MMW 12R,A01,514034,Herbst; Matthew,0,0,16,16
1714623061731,MMW 12R,A02,514035,Herbst; Matthew,1,0,16,15
1714623062758,MMW 13R,A01,514037,Staff,0,4,16,16
1714623062758,MMW 13R,A02,514039,Staff,0,2,16,16
1714623062758,MMW 13R,A03,628519,Staff,0,2,16,16
1714623064811,SIO 295LS,A00,523233,Staff,10,0,30,20
1714623065839,SIO 295S,A00,523232,Staff,10,0,30,20
1714623066865,SIOC 290S,A01,637330,Merrifield; Mark A,23,0,30,7
1714623067892,SIOC 291S,A01,637333,Gabriel; Corey John,23,0,30,7
1714623069965,SOCI 117,A01,494376,Staff,0,4,5,5
1714623070994,WES 237B,A00,494380,Staff,9,0,20,11
1714623073062,AESE 279B,A00,494370,Wade; Jon P,0,0,33,33
1714623074090,AIP 197,001,627712,Vespa; Emanuel Ignacio,9998,0,9999,1
1714623075370,ANAR 135S,A00,494369,Braswell; Geoffrey E.,0,0,0,0
1714623076398,BENG 196,001,628496,Engler; Adam J.,9998,0,9999,1
1714623077425,CAT 124RS,A01,519847,Geibel; William,0,0,20,20
1714623078454,CAT 125RS,A01,515971,Geibel; William,0,0,20,20
1714623079479,CLRE 250,A00,511389,Morris; Sheldon,9993,0,9999,6
1714623080504,CLRE 251,A00,507176,Mehta; Ravindra L.,9993,0,9999,6
1714623080504,CLRE 251,B00,511410,Mehta; Ravindra L.,9998,0,9999,1
1714623081530,CLRE 252,A00,507189,Cuomo; Raphael Eduardo,9995,0,9999,4
1714623082560,CLRE 253,A00,507199,Vaida; Florin,9994,0,9999,5
1714623082560,CLRE 253,B00,507202,Vaida; Florin,9999,0,9999,0
1714623083587,CLRE 259,A00,507211,Patel; Hemal,9996,0,9999,3
1714623084612,CLRE 260,A00,507221,Cuomo; Raphael Eduardo,9999,0,9999,0
1714623085639,CLRE 297,001,507242,Cuomo; Raphael Eduardo,9999,0,9999,0
1714623086664,COGS 197,001,638244,Voytek; Bradley Thomas,9998,0,9999,1
1714623087691,CSE 191,A00,516875,Minnes Kemp; Mor Mia,9992,0,9999,7
1714623088715,CSE 197,001,637388,Minnes Kemp; Mor Mia,9998,0,9999,1
1714623089742,CSS 201S,A01,494383,Staff,35,0,35,0
1714623090767,CSS 202S,A01,494387,Staff,35,0,35,0
1714623091792,DSC 197,001,628532,Eldridge; Justin Matthew,9996,0,9999,3
1714623092818,EAP 100,A00,516065,Staff,9797,0,9999,202
1714623093847,ECE 45,A01,507414,Staff,33,0,60,27
1714623095897,ECE 111,A01,507420,Staff,15,0,50,35
1714623096924,ECE 197,001,548057,Sievenpiper; Daniel F.,9993,0,9999,6
1714623097953,EDS 115,A00,507243,Choi; Bailey Miyeon,10,0,28,18
1714623099189,EDS 117,A01,494379,Staff,1,5,30,29
1714623100217,EDS 125,A00,507246,Hopkins; Megan Beth,9,0,30,21
1714623101247,EDS 128A,A01,507264,Fargason; Sharon Gayle,8,0,26,18
1714623102273,EDS 128B,A01,507293,Pappas; Elizabeth,12,0,30,18
1714623103299,EDS 139,A00,507294,Fargason; Sharon Gayle,13,0,30,17
1714623103299,EDS 139,B00,507313,Pappas; Elizabeth,13,0,30,17
1714623104325,EDS 201,A00,507315,Staff,13,0,30,17
1714623105355,EDS 203,A01,507317,Halter; Christopher P.,12,0,30,18
1714623106381,EDS 204R,A01,507319,Halter; Christopher P.,0,3,30,30
1714623106381,EDS 204R,B01,507331,Heinzman; Erica M.,16,0,30,14
1714623107407,EDS 206R,A00,507332,Staff,0,4,30,30
1714623107407,EDS 206R,B00,507343,Staff,17,0,30,13
1714623108436,EDS 250,A00,507344,Hemans; Patricia Ann Benitez,22,0,40,18
1714623109461,EDS 281,A00,507345,Daly; Alan J.,18,0,18,0
1714623110487,EDS 284,A00,507350,Daly; Alan J.,16,0,16,0
1714623111513,EDS 286,A00,507359,Fine; Sarah,18,0,18,0
1714623112538,EDS 289C,A01,507361,Daly; Alan J.,18,0,18,0
1714623113567,EDS 290,A00,507366,Hofstetter; Carolyn,15,0,15,0
1714623114593,LIGM 5A,A00,507421,Fischer-Grunski; Eva K,18,0,20,2
1714623115623,LIGM 5B,A00,507423,Fischer-Grunski; Eva K,19,0,20,1
1714623116648,LIGM 5C,A00,507425,Fischer-Grunski; Eva K,19,0,20,1
1714623117677,LIIT 5AS,A00,507427,Carnelos; Chiara,20,0,20,0
1714623118705,LIIT 5BS,A00,507430,Carnelos; Chiara,20,0,20,0
1714623119731,LIIT 5CS,A00,507432,Carnelos; Chiara,20,0,20,0
1714623120758,LISP 5A,A00,507541,Munoz Sanchez; Alicia,11,0,20,9
1714623121788,LISP 5B,A00,507671,Munoz Sanchez; Alicia,8,0,20,12
1714623122817,LISP 5C,A00,507696,Munoz Sanchez; Alicia,9,0,20,11
1714623123844,MAE 197,001,528363,Boechler; Nicholas Sebastia,9998,0,9999,1
1714623124872,MATH 197,001,523477,Kedlaya; Kiran S.,9995,0,9999,4
1714623124872,MATH 197,002,563811,Zhang; Danna,9995,0,9999,4
1714623124872,MATH 197,003,628552,Dumitriu; Ioana,9998,0,9999,1
1714623125898,MCWP 40R,A00,518780,Staff,2,0,20,18
1714623125898,MCWP 40R,B00,518781,Staff,8,0,20,12
1714623125898,MCWP 40R,C00,518783,Staff,6,0,20,14
1714623126925,MCWP 50R,A00,518791,Staff,0,0,20,20
1714623126925,MCWP 50R,B00,518792,Staff,0,2,20,20
1714623126925,MCWP 50R,C00,518793,Staff,0,2,20,20
1714623126925,MCWP 50R,D00,518794,Staff,0,0,20,20
1714623126925,MCWP 50R,E00,518795,Staff,0,2,20,20
1714623126925,MCWP 50R,F00,518796,Staff,0,0,20,20
1714623126925,MCWP 50R,G00,518797,Staff,0,1,20,20
1714623127955,MMW 12R,A01,514034,Herbst; Matthew,0,0,16,16
1714623127955,MMW 12R,A02,514035,Herbst; Matthew,1,0,16,15
1714623128981,MMW 13R,A01,514037,Staff,0,4,16,16
1714623128981,MMW 13R,A02,514039,Staff,0,2,16,16
1714623128981,MMW 13R,A03,628519,Staff,0,2,16,16
1714623131034,SIO 295LS,A00,523233,Staff,10,0,30,20
1714623132059,SIO 295S,A00,523232,Staff,10,0,30,20
1714623133085,SIOC 290S,A01,637330,Merrifield; Mark A,23,0,30,7
1714623134133,SIOC 291S,A01,637333,Gabriel; Corey John,23,0,30,7
1714623135160,SOCI 117,A01,494376,Staff,0,4,5,5
1714623136184,WES 237B,A00,494380,Staff,9,0,20,11
1714623138260,AESE 279B,A00,494370,Wade; Jon P,0,0,33,33
1714623139285,AIP 197,001,627712,Vespa; Emanuel Ignacio,9998,0,9999,1
1714623140315,ANAR 135S,A00,494369,Braswell; Geoffrey E.,0,0,0,0
1714623141341,BENG 196,001,628496,Engler; Adam J.,9998,0,9999,1
1714623142367,CAT 124RS,A01,519847,Geibel; William,0,0,20,20
1714623143392,CAT 125RS,A01,515971,Geibel; William,0,0,20,20
1714623144421,CLRE 250,A00,511389,Morris; Sheldon,9993,0,9999,6
1714623145448,CLRE 251,A00,507176,Mehta; Ravindra L.,9993,0,9999,6
1714623145448,CLRE 251,B00,511410,Mehta; Ravindra L.,9998,0,9999,1
1714623146479,CLRE 252,A00,507189,Cuomo; Raphael Eduardo,9995,0,9999,4
1714623147505,CLRE 253,A00,507199,Vaida; Florin,9994,0,9999,5
1714623147505,CLRE 253,B00,507202,Vaida; Florin,9999,0,9999,0
1714623148532,CLRE 259,A00,507211,Patel; Hemal,9996,0,9999,3
1714623149557,CLRE 260,A00,507221,Cuomo; Raphael Eduardo,9999,0,9999,0
1714623150585,CLRE 297,001,507242,Cuomo; Raphael Eduardo,9999,0,9999,0
1714623151610,COGS 197,001,638244,Voytek; Bradley Thomas,9998,0,9999,1
1714623152636,CSE 191,A00,516875,Minnes Kemp; Mor Mia,9992,0,9999,7
1714623153660,CSE 197,001,637388,Minnes Kemp; Mor Mia,9998,0,9999,1
1714623154685,CSS 201S,A01,494383,Staff,35,0,35,0
1714623155714,CSS 202S,A01,494387,Staff,35,0,35,0
1714623156739,DSC 197,001,628532,Eldridge; Justin Matthew,9996,0,9999,3
1714623157764,EAP 100,A00,516065,Staff,9797,0,9999,202
1714623159144,ECE 45,A01,507414,Staff,33,0,60,27
1714623161198,ECE 111,A01,507420,Staff,15,0,50,35
1714623162226,ECE 197,001,548057,Sievenpiper; Daniel F.,9993,0,9999,6
1714623163253,EDS 115,A00,507243,Choi; Bailey Miyeon,10,0,28,18
1714623164282,EDS 117,A01,494379,Staff,1,5,30,29
1714623165311,EDS 125,A00,507246,Hopkins; Megan Beth,9,0,30,21
1714623166340,EDS 128A,A01,507264,Fargason; Sharon Gayle,8,0,26,18
1714623167364,EDS 128B,A01,507293,Pappas; Elizabeth,12,0,30,18
1714623168389,EDS 139,A00,507294,Fargason; Sharon Gayle,13,0,30,17
1714623168389,EDS 139,B00,507313,Pappas; Elizabeth,13,0,30,17
1714623169414,EDS 201,A00,507315,Staff,13,0,30,17
1714623170439,EDS 203,A01,507317,Halter; Christopher P.,12,0,30,18
1714623171467,EDS 204R,A01,507319,Halter; Christopher P.,0,3,30,30
1714623171467,EDS 204R,B01,507331,Heinzman; Erica M.,16,0,30,14
1714623172493,EDS 206R,A00,507332,Staff,0,4,30,30
1714623172493,EDS 206R,B00,507343,Staff,17,0,30,13
1714623173518,EDS 250,A00,507344,Hemans; Patricia Ann Benitez,22,0,40,18
1714623174544,EDS 281,A00,507345,Daly; Alan J.,18,0,18,0
1714623175573,EDS 284,A00,507350,Daly; Alan J.,16,0,16,0
1714623176602,EDS 286,A00,507359,Fine; Sarah,18,0,18,0
1714623177628,EDS 289C,A01,507361,Daly; Alan J.,18,0,18,0
1714623178652,EDS 290,A00,507366,Hofstetter; Carolyn,15,0,15,0
1714623179678,LIGM 5A,A00,507421,Fischer-Grunski; Eva K,18,0,20,2
1714623180702,LIGM 5B,A00,507423,Fischer-Grunski; Eva K,19,0,20,1
1714623181733,LIGM 5C,A00,507425,Fischer-Grunski; Eva K,19,0,20,1
1714623182757,LIIT 5AS,A00,507427,Carnelos; Chiara,20,0,20,0
1714623183783,LIIT 5BS,A00,507430,Carnelos; Chiara,20,0,20,0
1714623184809,LIIT 5CS,A00,507432,Carnelos; Chiara,20,0,20,0
1714623185835,LISP 5A,A00,507541,Munoz Sanchez; Alicia,11,0,20,9
1714623186859,LISP 5B,A00,507671,Munoz Sanchez; Alicia,8,0,20,12
1714623187886,LISP 5C,A00,507696,Munoz Sanchez; Alicia,9,0,20,11
1714623188911,MAE 197,001,528363,Boechler; Nicholas Sebastia,9998,0,9999,1
1714623189941,MATH 197,001,523477,Kedlaya; Kiran S.,9995,0,9999,4
1714623189941,MATH 197,002,563811,Zhang; Danna,9995,0,9999,4
1714623189941,MATH 197,003,628552,Dumitriu; Ioana,9998,0,9999,1
1714623190966,MCWP 40R,A00,518780,Staff,2,0,20,18
1714623190966,MCWP 40R,B00,518781,Staff,8,0,20,12
1714623190966,MCWP 40R,C00,518783,Staff,6,0,20,14
1714623191995,MCWP 50R,A00,518791,Staff,0,0,20,20
1714623191995,MCWP 50R,B00,518792,Staff,0,2,20,20
1714623191995,MCWP 50R,C00,518793,Staff,0,2,20,20
1714623191995,MCWP 50R,D00,518794,Staff,0,0,20,20
1714623191995,MCWP 50R,E00,518795,Staff,0,2,20,20
1714623191995,MCWP 50R,F00,518796,Staff,0,0,20,20
1714623191995,MCWP 50R,G00,518797,Staff,0,1,20,20
1714623193020,MMW 12R,A01,514034,Herbst; Matthew,0,0,16,16
1714623193020,MMW 12R,A02,514035,Herbst; Matthew,1,0,16,15
1714623194044,MMW 13R,A01,514037,Staff,0,4,16,16
1714623194044,MMW 13R,A02,514039,Staff,0,2,16,16
1714623194044,MMW 13R,A03,628519,Staff,0,2,16,16
1714623196100,SIO 295LS,A00,523233,Staff,10,0,30,20
1714623197129,SIO 295S,A00,523232,Staff,10,0,30,20
1714623198157,SIOC 290S,A01,637330,Merrifield; Mark A,23,0,30,7
1714623199187,SIOC 291S,A01,637333,Gabriel; Corey John,23,0,30,7
1714623200215,SOCI 117,A01,494376,Staff,0,4,5,5
1714623201242,WES 237B,A00,494380,Staff,9,0,20,11
1714623203313,AESE 279B,A00,494370,Wade; Jon P,0,0,33,33
1714623204339,AIP 197,001,627712,Vespa; Emanuel Ignacio,9998,0,9999,1
1714623205366,ANAR 135S,A00,494369,Braswell; Geoffrey E.,0,0,0,0
1714623206394,BENG 196,001,628496,Engler; Adam J.,9998,0,9999,1
1714623207422,CAT 124RS,A01,519847,Geibel; William,0,0,20,20
1714623208446,CAT 125RS,A01,515971,Geibel; William,0,0,20,20
1714623209475,CLRE 250,A00,511389,Morris; Sheldon,9993,0,9999,6
1714623210501,CLRE 251,A00,507176,Mehta; Ravindra L.,9993,0,9999,6
1714623210501,CLRE 251,B00,511410,Mehta; Ravindra L.,9998,0,9999,1
1714623211526,CLRE 252,A00,507189,Cuomo; Raphael Eduardo,9995,0,9999,4
1714623212556,CLRE 253,A00,507199,Vaida; Florin,9994,0,9999,5
1714623212556,CLRE 253,B00,507202,Vaida; Florin,9999,0,9999,0
1714623213586,CLRE 259,A00,507211,Patel; Hemal,9996,0,9999,3
1714623214610,CLRE 260,A00,507221,Cuomo; Raphael Eduardo,9999,0,9999,0
1714623215633,CLRE 297,001,507242,Cuomo; Raphael Eduardo,9999,0,9999,0
1714623216664,COGS 197,001,638244,Voytek; Bradley Thomas,9998,0,9999,1
1714623217690,CSE 191,A00,516875,Minnes Kemp; Mor Mia,9992,0,9999,7
1714623218716,CSE 197,001,637388,Minnes Kemp; Mor Mia,9998,0,9999,1
1714623219742,CSS 201S,A01,494383,Staff,35,0,35,0
1714623220767,CSS 202S,A01,494387,Staff,35,0,35,0
1714623221807,DSC 197,001,628532,Eldridge; Justin Matthew,9996,0,9999,3
1714623222834,EAP 100,A00,516065,Staff,9797,0,9999,202
1714623223859,ECE 45,A01,507414,Staff,33,0,60,27
1714623225912,ECE 111,A01,507420,Staff,15,0,50,35
1714623226941,ECE 197,001,548057,Sievenpiper; Daniel F.,9993,0,9999,6
1714623227967,EDS 115,A00,507243,Choi; Bailey Miyeon,10,0,28,18
1714623228993,EDS 117,A01,494379,Staff,1,5,30,29
1714623230022,EDS 125,A00,507246,Hopkins; Megan Beth,9,0,30,21
1714623231049,EDS 128A,A01,507264,Fargason; Sharon Gayle,8,0,26,18
1714623232077,EDS 128B,A01,507293,Pappas; Elizabeth,12,0,30,18
1714623233105,EDS 139,A00,507294,Fargason; Sharon Gayle,13,0,30,17
1714623233105,EDS 139,B00,507313,Pappas; Elizabeth,13,0,30,17
1714623234133,EDS 201,A00,507315,Staff,13,0,30,17
1714623235158,EDS 203,A01,507317,Halter; Christopher P.,12,0,30,18
1714623236184,EDS 204R,A01,507319,Halter; Christopher P.,0,3,30,30
1714623236184,EDS 204R,B01,507331,Heinzman; Erica M.,16,0,30,14
1714623237211,EDS 206R,A00,507332,Staff,0,4,30,30
1714623237211,EDS 206R,B00,507343,Staff,17,0,30,13
1714623238237,EDS 250,A00,507344,Hemans; Patricia Ann Benitez,22,0,40,18
1714623239263,EDS 281,A00,507345,Daly; Alan J.,18,0,18,0
1714623240292,EDS 284,A00,507350,Daly; Alan J.,16,0,16,0
1714623241318,EDS 286,A00,507359,Fine; Sarah,18,0,18,0
1714623242342,EDS 289C,A01,507361,Daly; Alan J.,18,0,18,0
1714623243369,EDS 290,A00,507366,Hofstetter; Carolyn,15,0,15,0
1714623244397,LIGM 5A,A00,507421,Fischer-Grunski; Eva K,18,0,20,2
1714623245422,LIGM 5B,A00,507423,Fischer-Grunski; Eva K,19,0,20,1
1714623246448,LIGM 5C,A00,507425,Fischer-Grunski; Eva K,19,0,20,1
1714623247475,LIIT 5AS,A00,507427,Carnelos; Chiara,20,0,20,0
1714623248506,LIIT 5BS,A00,507430,Carnelos; Chiara,20,0,20,0
1714623249536,LIIT 5CS,A00,507432,Carnelos; Chiara,20,0,20,0
1714623250565,LISP 5A,A00,507541,Munoz Sanchez; Alicia,11,0,20,9
1714623251593,LISP 5B,A00,507671,Munoz Sanchez; Alicia,8,0,20,12
1714623252618,LISP 5C,A00,507696,Munoz Sanchez; Alicia,9,0,20,11
1714623253641,MAE 197,001,528363,Boechler; Nicholas Sebastia,9998,0,9999,1
1714623254667,MATH 197,001,523477,Kedlaya; Kiran S.,9995,0,9999,4
1714623254667,MATH 197,002,563811,Zhang; Danna,9995,0,9999,4
1714623254667,MATH 197,003,628552,Dumitriu; Ioana,9998,0,9999,1
1714623255691,MCWP 40R,A00,518780,Staff,2,0,20,18
1714623255691,MCWP 40R,B00,518781,Staff,8,0,20,12
1714623255691,MCWP 40R,C00,518783,Staff,6,0,20,14
1714623256717,MCWP 50R,A00,518791,Staff,0,0,20,20
1714623256717,MCWP 50R,B00,518792,Staff,0,2,20,20
1714623256717,MCWP 50R,C00,518793,Staff,0,2,20,20
1714623256717,MCWP 50R,D00,518794,Staff,0,0,20,20
1714623256717,MCWP 50R,E00,518795,Staff,0,2,20,20
1714623256717,MCWP 50R,F00,518796,Staff,0,0,20,20
1714623256717,MCWP 50R,G00,518797,Staff,0,1,20,20
1714623257745,MMW 12R,A01,514034,Herbst; Matthew,0,0,16,16
1714623257745,MMW 12R,A02,514035,Herbst; Matthew,1,0,16,15
1714623258770,MMW 13R,A01,514037,Staff,0,4,16,16
1714623258770,MMW 13R,A02,514039,Staff,0,2,16,16
1714623258770,MMW 13R,A03,628519,Staff,0,2,16,16
1714623260823,SIO 295LS,A00,523233,Staff,10,0,30,20
1714623261849,SIO 295S,A00,523232,Staff,10,0,30,20
1714623262875,SIOC 290S,A01,637330,Merrifield; Mark A,23,0,30,7
1714623263902,SIOC 291S,A01,637333,Gabriel; Corey John,23,0,30,7
1714623264927,SOCI 117,A01,494376,Staff,0,4,5,5
1714623265954,WES 237B,A00,494380,Staff,9,0,20,11
1714623268020,AESE 279B,A00,494370,Wade; Jon P,0,0,33,33
1714623269048,AIP 197,001,627712,Vespa; Emanuel Ignacio,9998,0,9999,1
1714623270072,ANAR 135S,A00,494369,Braswell; Geoffrey E.,0,0,0,0
1714623271097,BENG 196,001,628496,Engler; Adam J.,9998,0,9999,1
1714623272122,CAT 124RS,A01,519847,Geibel; William,0,0,20,20
1714623273147,CAT 125RS,A01,515971,Geibel; William,0,0,20,20
1714623274174,CLRE 250,A00,511389,Morris; Sheldon,9993,0,9999,6
1714623275201,CLRE 251,A00,507176,Mehta; Ravindra L.,9993,0,9999,6
1714623275201,CLRE 251,B00,511410,Mehta; Ravindra L.,9998,0,9999,1
1714623276225,CLRE 252,A00,507189,Cuomo; Raphael Eduardo,9995,0,9999,4
1714623277251,CLRE 253,A00,507199,Vaida; Florin,9994,0,9999,5
1714623277251,CLRE 253,B00,507202,Vaida; Florin,9999,0,9999,0
1714623278276,CLRE 259,A00,507211,Patel; Hemal,9996,0,9999,3
1714623279305,CLRE 260,A00,507221,Cuomo; Raphael Eduardo,9999,0,9999,0
1714623280329,CLRE 297,001,507242,Cuomo; Raphael Eduardo,9999,0,9999,0
1714623281357,COGS 197,001,638244,Voytek; Bradley Thomas,9998,0,9999,1
1714623282386,CSE 191,A00,516875,Minnes Kemp; Mor Mia,9992,0,9999,7
1714623283409,CSE 197,001,637388,Minnes Kemp; Mor Mia,9998,0,9999,1
1714623284435,CSS 201S,A01,494383,Staff,35,0,35,0
1714623285462,CSS 202S,A01,494387,Staff,35,0,35,0
1714623286487,DSC 197,001,628532,Eldridge; Justin Matthew,9996,0,9999,3
1714623287512,EAP 100,A00,516065,Staff,9797,0,9999,202
1714623288541,ECE 45,A01,507414,Staff,33,0,60,27
1714623290591,ECE 111,A01,507420,Staff,15,0,50,35
1714623291615,ECE 197,001,548057,Sievenpiper; Daniel F.,9993,0,9999,6
1714623292640,EDS 115,A00,507243,Choi; Bailey Miyeon,10,0,28,18
1714623293669,EDS 117,A01,494379,Staff,1,5,30,29
1714623294695,EDS 125,A00,507246,Hopkins; Megan Beth,9,0,30,21
1714623295721,EDS 128A,A01,507264,Fargason; Sharon Gayle,8,0,26,18
1714623296746,EDS 128B,A01,507293,Pappas; Elizabeth,12,0,30,18
1714623297772,EDS 139,A00,507294,Fargason; Sharon Gayle,13,0,30,17
1714623297772,EDS 139,B00,507313,Pappas; Elizabeth,13,0,30,17
1714623298798,EDS 201,A00,507315,Staff,13,0,30,17
1714623299824,EDS 203,A01,507317,Halter; Christopher P.,12,0,30,18
1714623300849,EDS 204R,A01,507319,Halter; Christopher P.,0,3,30,30
1714623300849,EDS 204R,B01,507331,Heinzman; Erica M.,16,0,30,14
1714623301878,EDS 206R,A00,507332,Staff,0,4,30,30
1714623301878,EDS 206R,B00,507343,Staff,17,0,30,13
1714623302904,EDS 250,A00,507344,Hemans; Patricia Ann Benitez,22,0,40,18
1714623303928,EDS 281,A00,507345,Daly; Alan J.,18,0,18,0
1714623304952,EDS 284,A00,507350,Daly; Alan J.,16,0,16,0
1714623305979,EDS 286,A00,507359,Fine; Sarah,18,0,18,0
1714623307006,EDS 289C,A01,507361,Daly; Alan J.,18,0,18,0
1714623308030,EDS 290,A00,507366,Hofstetter; Carolyn,15,0,15,0
1714623309054,LIGM 5A,A00,507421,Fischer-Grunski; Eva K,18,0,20,2
1714623310079,LIGM 5B,A00,507423,Fischer-Grunski; Eva K,19,0,20,1
1714623311108,LIGM 5C,A00,507425,Fischer-Grunski; Eva K,19,0,20,1
1714623312133,LIIT 5AS,A00,507427,Carnelos; Chiara,20,0,20,0
1714623313162,LIIT 5BS,A00,507430,Carnelos; Chiara,20,0,20,0
1714623314185,LIIT 5CS,A00,507432,Carnelos; Chiara,20,0,20,0
1714623315212,LISP 5A,A00,507541,Munoz Sanchez; Alicia,11,0,20,9
1714623316238,LISP 5B,A00,507671,Munoz Sanchez; Alicia,8,0,20,12
1714623317266,LISP 5C,A00,507696,Munoz Sanchez; Alicia,9,0,20,11
1714623318291,MAE 197,001,528363,Boechler; Nicholas Sebastia,9998,0,9999,1
1714623319315,MATH 197,001,523477,Kedlaya; Kiran S.,9995,0,9999,4
1714623319315,MATH 197,002,563811,Zhang; Danna,9995,0,9999,4
1714623319315,MATH 197,003,628552,Dumitriu; Ioana,9998,0,9999,1
1714623320342,MCWP 40R,A00,518780,Staff,2,0,20,18
1714623320342,MCWP 40R,B00,518781,Staff,8,0,20,12
1714623320342,MCWP 40R,C00,518783,Staff,6,0,20,14
1714623321373,MCWP 50R,A00,518791,Staff,0,0,20,20
1714623321373,MCWP 50R,B00,518792,Staff,0,2,20,20
1714623321373,MCWP 50R,C00,518793,Staff,0,2,20,20
1714623321373,MCWP 50R,D00,518794,Staff,0,0,20,20
1714623321373,MCWP 50R,E00,518795,Staff,0,2,20,20
1714623321373,MCWP 50R,F00,518796,Staff,0,0,20,20
1714623321373,MCWP 50R,G00,518797,Staff,0,1,20,20
1714623322398,MMW 12R,A01,514034,Herbst; Matthew,0,0,16,16
1714623322398,MMW 12R,A02,514035,Herbst; Matthew,1,0,16,15
1714623323426,MMW 13R,A01,514037,Staff,0,4,16,16
1714623323426,MMW 13R,A02,514039,Staff,0,2,16,16
1714623323426,MMW 13R,A03,628519,Staff,0,2,16,16
1714623325481,SIO 295LS,A00,523233,Staff,10,0,30,20
1714623326507,SIO 295S,A00,523232,Staff,10,0,30,20
1714623327533,SIOC 290S,A01,637330,Merrifield; Mark A,23,0,30,7
1714623328558,SIOC 291S,A01,637333,Gabriel; Corey John,23,0,30,7
1714623329639,SOCI 117,A01,494376,Staff,0,4,5,5
1714623330665,WES 237B,A00,494380,Staff,9,0,20,11
1714623332749,AESE 279B,A00,494370,Wade; Jon P,0,0,33,33
1714623333979,AIP 197,001,627712,Vespa; Emanuel Ignacio,9998,0,9999,1
1714623335007,ANAR 135S,A00,494369,Braswell; Geoffrey E.,0,0,0,0
1714623336032,BENG 196,001,628496,Engler; Adam J.,9998,0,9999,1
1714623337058,CAT 124RS,A01,519847,Geibel; William,0,0,20,20
1714623338671,CAT 125RS,A01,515971,Geibel; William,0,0,20,20
1714623339700,CLRE 250,A00,511389,Morris; Sheldon,9993,0,9999,6
1714623340731,CLRE 251,A00,507176,Mehta; Ravindra L.,9993,0,9999,6
1714623340731,CLRE 251,B00,511410,Mehta; Ravindra L.,9998,0,9999,1
1714623341759,CLRE 252,A00,507189,Cuomo; Raphael Eduardo,9995,0,9999,4
1714623342784,CLRE 253,A00,507199,Vaida; Florin,9994,0,9999,5
1714623342784,CLRE 253,B00,507202,Vaida; Florin,9999,0,9999,0
1714623343811,CLRE 259,A00,507211,Patel; Hemal,9996,0,9999,3
1714623344840,CLRE 260,A00,507221,Cuomo; Raphael Eduardo,9999,0,9999,0
1714623345864,CLRE 297,001,507242,Cuomo; Raphael Eduardo,9999,0,9999,0
1714623346893,COGS 197,001,638244,Voytek; Bradley Thomas,9998,0,9999,1
1714623347919,CSE 191,A00,516875,Minnes Kemp; Mor Mia,9992,0,9999,7
1714623348945,CSE 197,001,637388,Minnes Kemp; Mor Mia,9998,0,9999,1
1714623349969,CSS 201S,A01,494383,Staff,35,0,35,0
1714623350998,CSS 202S,A01,494387,Staff,35,0,35,0
1714623352024,DSC 197,001,628532,Eldridge; Justin Matthew,9996,0,9999,3
1714623353050,EAP 100,A00,516065,Staff,9797,0,9999,202
1714623354081,ECE 45,A01,507414,Staff,33,0,60,27
1714623356131,ECE 111,A01,507420,Staff,15,0,50,35
1714623357156,ECE 197,001,548057,Sievenpiper; Daniel F.,9993,0,9999,6
1714623358185,EDS 115,A00,507243,Choi; Bailey Miyeon,10,0,28,18
1714623359212,EDS 117,A01,494379,Staff,1,5,30,29
1714623360242,EDS 125,A00,507246,Hopkins; Megan Beth,9,0,30,21
1714623361270,EDS 128A,A01,507264,Fargason; Sharon Gayle,8,0,26,18
1714623362294,EDS 128B,A01,507293,Pappas; Elizabeth,12,0,30,18
1714623363319,EDS 139,A00,507294,Fargason; Sharon Gayle,13,0,30,17
1714623363319,EDS 139,B00,507313,Pappas; Elizabeth,13,0,30,17
1714623364344,EDS 201,A00,507315,Staff,13,0,30,17
1714623365369,EDS 203,A01,507317,Halter; Christopher P.,12,0,30,18
1714623366396,EDS 204R,A01,507319,Halter; Christopher P.,0,3,30,30
1714623366396,EDS 204R,B01,507331,Heinzman; Erica M.,16,0,30,14
1714623367418,EDS 206R,A00,507332,Staff,0,4,30,30
1714623367418,EDS 206R,B00,507343,Staff,17,0,30,13
1714623368444,EDS 250,A00,507344,Hemans; Patricia Ann Benitez,22,0,40,18
1714623369474,EDS 281,A00,507345,Daly; Alan J.,18,0,18,0
1714623370503,EDS 284,A00,507350,Daly; Alan J.,16,0,16,0
1714623371533,EDS 286,A00,507359,Fine; Sarah,18,0,18,0
1714623372558,EDS 289C,A01,507361,Daly; Alan J.,18,0,18,0
1714623373586,EDS 290,A00,507366,Hofstetter; Carolyn,15,0,15,0
1714623374612,LIGM 5A,A00,507421,Fischer-Grunski; Eva K,18,0,20,2
1714623375638,LIGM 5B,A00,507423,Fischer-Grunski; Eva K,19,0,20,1
1714623376662,LIGM 5C,A00,507425,Fischer-Grunski; Eva K,19,0,20,1
1714623377688,LIIT 5AS,A00,507427,Carnelos; Chiara,20,0,20,0
1714623378919,LIIT 5BS,A00,507430,Carnelos; Chiara,20,0,20,0
1714623379998,LIIT 5CS,A00,507432,Carnelos; Chiara,20,0,20,0
1714623381029,LISP 5A,A00,507541,Munoz Sanchez; Alicia,11,0,20,9
1714623382056,LISP 5B,A00,507671,Munoz Sanchez; Alicia,8,0,20,12
1714623383082,LISP 5C,A00,507696,Munoz Sanchez; Alicia,9,0,20,11
1714623384107,MAE 197,001,528363,Boechler; Nicholas Sebastia,9998,0,9999,1
1714623385139,MATH 197,001,523477,Kedlaya; Kiran S.,9995,0,9999,4
1714623385139,MATH 197,002,563811,Zhang; Danna,9995,0,9999,4
1714623385139,MATH 197,003,628552,Dumitriu; Ioana,9998,0,9999,1
1714623386164,MCWP 40R,A00,518780,Staff,2,0,20,18
1714623386164,MCWP 40R,B00,518781,Staff,8,0,20,12
1714623386164,MCWP 40R,C00,518783,Staff,6,0,20,14
1714623387189,MCWP 50R,A00,518791,Staff,0,0,20,20
1714623387189,MCWP 50R,B00,518792,Staff,0,2,20,20
1714623387189,MCWP 50R,C00,518793,Staff,0,2,20,20
1714623387189,MCWP 50R,D00,518794,Staff,0,0,20,20
1714623387189,MCWP 50R,E00,518795,Staff,0,2,20,20
1714623387189,MCWP 50R,F00,518796,Staff,0,0,20,20
1714623387189,MCWP 50R,G00,518797,Staff,0,1,20,20
1714623388213,MMW 12R,A01,514034,Herbst; Matthew,0,0,16,16
1714623388213,MMW 12R,A02,514035,Herbst; Matthew,1,0,16,15
1714623389237,MMW 13R,A01,514037,Staff,0,4,16,16
1714623389237,MMW 13R,A02,514039,Staff,0,2,16,16
1714623389237,MMW 13R,A03,628519,Staff,0,2,16,16
1714623391291,SIO 295LS,A00,523233,Staff,10,0,30,20
1714623392316,SIO 295S,A00,523232,Staff,10,0,30,20
1714623393346,SIOC 290S,A01,637330,Merrifield; Mark A,23,0,30,7
1714623394371,SIOC 291S,A01,637333,Gabriel; Corey John,23,0,30,7
1714623395400,SOCI 117,A01,494376,Staff,0,4,5,5
1714623396425,WES 237B,A00,494380,Staff,9,0,20,11
1714623398498,AESE 279B,A00,494370,Wade; Jon P,0,0,33,33
1714623399527,AIP 197,001,627712,Vespa; Emanuel Ignacio,9998,0,9999,1
1714623400555,ANAR 135S,A00,494369,Braswell; Geoffrey E.,0,0,0,0
1714623401604,BENG 196,001,628496,Engler; Adam J.,9998,0,9999,1
1714623402629,CAT 124RS,A01,519847,Geibel; William,0,0,20,20
1714623403655,CAT 125RS,A01,515971,Geibel; William,0,0,20,20
1714623404680,CLRE 250,A00,511389,Morris; Sheldon,9993,0,9999,6
1714623405710,CLRE 251,A00,507176,Mehta; Ravindra L.,9993,0,9999,6
1714623405710,CLRE 251,B00,511410,Mehta; Ravindra L.,9998,0,9999,1
1714623406740,CLRE 252,A00,507189,Cuomo; Raphael Eduardo,9995,0,9999,4
1714623407765,CLRE 253,A00,507199,Vaida; Florin,9994,0,9999,5
1714623407765,CLRE 253,B00,507202,Vaida; Florin,9999,0,9999,0
1714623408793,CLRE 259,A00,507211,Patel; Hemal,9996,0,9999,3
1714623409817,CLRE 260,A00,507221,Cuomo; Raphael Eduardo,9999,0,9999,0
1714623410841,CLRE 297,001,507242,Cuomo; Raphael Eduardo,9999,0,9999,0
1714623411866,COGS 197,001,638244,Voytek; Bradley Thomas,9998,0,9999,1
1714623412891,CSE 191,A00,516875,Minnes Kemp; Mor Mia,9992,0,9999,7
1714623413916,CSE 197,001,637388,Minnes Kemp; Mor Mia,9998,0,9999,1
1714623414944,CSS 201S,A01,494383,Staff,35,0,35,0
1714623415970,CSS 202S,A01,494387,Staff,35,0,35,0
1714623416993,DSC 197,001,628532,Eldridge; Justin Matthew,9996,0,9999,3
1714623418016,EAP 100,A00,516065,Staff,9797,0,9999,202
1714623419041,ECE 45,A01,507414,Staff,33,0,60,27
1714623421091,ECE 111,A01,507420,Staff,15,0,50,35
1714623422116,ECE 197,001,548057,Sievenpiper; Daniel F.,9993,0,9999,6
1714623423145,EDS 115,A00,507243,Choi; Bailey Miyeon,10,0,28,18
1714623424172,EDS 117,A01,494379,Staff,1,5,30,29
1714623425197,EDS 125,A00,507246,Hopkins; Megan Beth,9,0,30,21
1714623426228,EDS 128A,A01,507264,Fargason; Sharon Gayle,8,0,26,18
1714623427261,EDS 128B,A01,507293,Pappas; Elizabeth,12,0,30,18
1714623428286,EDS 139,A00,507294,Fargason; Sharon Gayle,13,0,30,17
1714623428286,EDS 139,B00,507313,Pappas; Elizabeth,13,0,30,17
1714623429314,EDS 201,A00,507315,Staff,13,0,30,17
1714623430343,EDS 203,A01,507317,Halter; Christopher P.,12,0,30,18
1714623431371,EDS 204R,A01,507319,Halter; Christopher P.,0,3,30,30
1714623431371,EDS 204R,B01,507331,Heinzman; Erica M.,16,0,30,14
1714623432400,EDS 206R,A00,507332,Staff,0,4,30,30
1714623432400,EDS 206R,B00,507343,Staff,17,0,30,13
1714623433427,EDS 250,A00,507344,Hemans; Patricia Ann Benitez,22,0,40,18
1714623434456,EDS 281,A00,507345,Daly; Alan J.,18,0,18,0
1714623435482,EDS 284,A00,507350,Daly; Alan J.,16,0,16,0
1714623436510,EDS 286,A00,507359,Fine; Sarah,18,0,18,0
1714623437539,EDS 289C,A01,507361,Daly; Alan J.,18,0,18,0
1714623438766,EDS 290,A00,507366,Hofstetter; Carolyn,15,0,15,0
1714623439794,LIGM 5A,A00,507421,Fischer-Grunski; Eva K,18,0,20,2
1714623440822,LIGM 5B,A00,507423,Fischer-Grunski; Eva K,19,0,20,1
1714623441850,LIGM 5C,A00,507425,Fischer-Grunski; Eva K,19,0,20,1
1714623442877,LIIT 5AS,A00,507427,Carnelos; Chiara,20,0,20,0
1714623443908,LIIT 5BS,A00,507430,Carnelos; Chiara,20,0,20,0
1714623444933,LIIT 5CS,A00,507432,Carnelos; Chiara,20,0,20,0
1714623445958,LISP 5A,A00,507541,Munoz Sanchez; Alicia,11,0,20,9
1714623446987,LISP 5B,A00,507671,Munoz Sanchez; Alicia,8,0,20,12
1714623448011,LISP 5C,A00,507696,Munoz Sanchez; Alicia,9,0,20,11
1714623449246,MAE 197,001,528363,Boechler; Nicholas Sebastia,9998,0,9999,1
1714623450272,MATH 197,001,523477,Kedlaya; Kiran S.,9995,0,9999,4
1714623450272,MATH 197,002,563811,Zhang; Danna,9995,0,9999,4
1714623450272,MATH 197,003,628552,Dumitriu; Ioana,9998,0,9999,1
1714623451299,MCWP 40R,A00,518780,Staff,2,0,20,18
1714623451299,MCWP 40R,B00,518781,Staff,8,0,20,12
1714623451299,MCWP 40R,C00,518783,Staff,6,0,20,14
1714623452329,MCWP 50R,A00,518791,Staff,0,0,20,20
1714623452329,MCWP 50R,B00,518792,Staff,0,2,20,20
1714623452329,MCWP 50R,C00,518793,Staff,0,2,20,20
1714623452329,MCWP 50R,D00,518794,Staff,0,0,20,20
1714623452329,MCWP 50R,E00,518795,Staff,0,2,20,20
1714623452329,MCWP 50R,F00,518796,Staff,0,0,20,20
1714623452329,MCWP 50R,G00,518797,Staff,0,1,20,20
1714623453353,MMW 12R,A01,514034,Herbst; Matthew,0,0,16,16
1714623453353,MMW 12R,A02,514035,Herbst; Matthew,1,0,16,15
1714623454379,MMW 13R,A01,514037,Staff,0,4,16,16
1714623454379,MMW 13R,A02,514039,Staff,0,2,16,16
1714623454379,MMW 13R,A03,628519,Staff,0,2,16,16
1714623456437,SIO 295LS,A00,523233,Staff,10,0,30,20
1714623457464,SIO 295S,A00,523232,Staff,10,0,30,20
1714623458490,SIOC 290S,A01,637330,Merrifield; Mark A,23,0,30,7
1714623459518,SIOC 291S,A01,637333,Gabriel; Corey John,23,0,30,7
1714623460543,SOCI 117,A01,494376,Staff,0,4,5,5
1714623461569,WES 237B,A00,494380,Staff,9,0,20,11
1714623463652,AESE 279B,A00,494370,Wade; Jon P,0,0,33,33
1714623464680,AIP 197,001,627712,Vespa; Emanuel Ignacio,9998,0,9999,1
1714623465708,ANAR 135S,A00,494369,Braswell; Geoffrey E.,0,0,0,0
1714623466734,BENG 196,001,628496,Engler; Adam J.,9998,0,9999,1
1714623467760,CAT 124RS,A01,519847,Geibel; William,0,0,20,20
1714623468785,CAT 125RS,A01,515971,Geibel; William,0,0,20,20
1714623469811,CLRE 250,A00,511389,Morris; Sheldon,9993,0,9999,6
1714623470840,CLRE 251,A00,507176,Mehta; Ravindra L.,9993,0,9999,6
1714623470840,CLRE 251,B00,511410,Mehta; Ravindra L.,9998,0,9999,1
1714623471867,CLRE 252,A00,507189,Cuomo; Raphael Eduardo,9995,0,9999,4
1714623472896,CLRE 253,A00,507199,Vaida; Florin,9994,0,9999,5
1714623472896,CLRE 253,B00,507202,Vaida; Florin,9999,0,9999,0
1714623473922,CLRE 259,A00,507211,Patel; Hemal,9996,0,9999,3
1714623474947,CLRE 260,A00,507221,Cuomo; Raphael Eduardo,9999,0,9999,0
1714623475974,CLRE 297,001,507242,Cuomo; Raphael Eduardo,9999,0,9999,0
1714623476999,COGS 197,001,638244,Voytek; Bradley Thomas,9998,0,9999,1
1714623478023,CSE 191,A00,516875,Minnes Kemp; Mor Mia,9992,0,9999,7
1714623479049,CSE 197,001,637388,Minnes Kemp; Mor Mia,9998,0,9999,1
1714623480076,CSS 201S,A01,494383,Staff,35,0,35,0
1714623481107,CSS 202S,A01,494387,Staff,35,0,35,0
1714623482134,DSC 197,001,628532,Eldridge; Justin Matthew,9996,0,9999,3
1714623483162,EAP 100,A00,516065,Staff,9797,0,9999,202
1714623484190,ECE 45,A01,507414,Staff,33,0,60,27
1714623486247,ECE 111,A01,507420,Staff,15,0,50,35
1714623487272,ECE 197,001,548057,Sievenpiper; Daniel F.,9993,0,9999,6
1714623488301,EDS 115,A00,507243,Choi; Bailey Miyeon,10,0,28,18
1714623489329,EDS 117,A01,494379,Staff,1,5,30,29
1714623490354,EDS 125,A00,507246,Hopkins; Megan Beth,9,0,30,21
1714623491385,EDS 128A,A01,507264,Fargason; Sharon Gayle,8,0,26,18
1714623492411,EDS 128B,A01,507293,Pappas; Elizabeth,12,0,30,18
1714623493435,EDS 139,A00,507294,Fargason; Sharon Gayle,13,0,30,17
1714623493435,EDS 139,B00,507313,Pappas; Elizabeth,13,0,30,17
1714623494463,EDS 201,A00,507315,Staff,13,0,30,17
1714623495492,EDS 203,A01,507317,Halter; Christopher P.,12,0,30,18
1714623496518,EDS 204R,A01,507319,Halter; Christopher P.,0,3,30,30
1714623496518,EDS 204R,B01,507331,Heinzman; Erica M.,16,0,30,14
1714623497544,EDS 206R,A00,507332,Staff,0,4,30,30
1714623497544,EDS 206R,B00,507343,Staff,17,0,30,13
1714623498569,EDS 250,A00,507344,Hemans; Patricia Ann Benitez,22,0,40,18
1714623499598,EDS 281,A00,507345,Daly; Alan J.,18,0,18,0
1714623500622,EDS 284,A00,507350,Daly; Alan J.,16,0,16,0
1714623501647,EDS 286,A00,507359,Fine; Sarah,18,0,18,0
1714623502741,EDS 289C,A01,507361,Daly; Alan J.,18,0,18,0
1714623503768,EDS 290,A00,507366,Hofstetter; Carolyn,15,0,15,0
1714623504794,LIGM 5A,A00,507421,Fischer-Grunski; Eva K,18,0,20,2
1714623505821,LIGM 5B,A00,507423,Fischer-Grunski; Eva K,19,0,20,1
1714623506846,LIGM 5C,A00,507425,Fischer-Grunski; Eva K,19,0,20,1
1714623507872,LIIT 5AS,A00,507427,Carnelos; Chiara,20,0,20,0
1714623508899,LIIT 5BS,A00,507430,Carnelos; Chiara,20,0,20,0
1714623509924,LIIT 5CS,A00,507432,Carnelos; Chiara,20,0,20,0
1714623511027,LISP 5A,A00,507541,Munoz Sanchez; Alicia,11,0,20,9
1714623512054,LISP 5B,A00,507671,Munoz Sanchez; Alicia,8,0,20,12
1714623513079,LISP 5C,A00,507696,Munoz Sanchez; Alicia,9,0,20,11
1714623514106,MAE 197,001,528363,Boechler; Nicholas Sebastia,9998,0,9999,1
1714623515136,MATH 197,001,523477,Kedlaya; Kiran S.,9995,0,9999,4
1714623515136,MATH 197,002,563811,Zhang; Danna,9995,0,9999,4
1714623515136,MATH 197,003,628552,Dumitriu; Ioana,9998,0,9999,1
1714623516164,MCWP 40R,A00,518780,Staff,2,0,20,18
1714623516164,MCWP 40R,B00,518781,Staff,8,0,20,12
1714623516164,MCWP 40R,C00,518783,Staff,6,0,20,14
1714623517195,MCWP 50R,A00,518791,Staff,0,0,20,20
1714623517195,MCWP 50R,B00,518792,Staff,0,2,20,20
1714623517195,MCWP 50R,C00,518793,Staff,0,2,20,20
1714623517195,MCWP 50R,D00,518794,Staff,0,0,20,20
1714623517195,MCWP 50R,E00,518795,Staff,0,2,20,20
1714623517195,MCWP 50R,F00,518796,Staff,0,0,20,20
1714623517195,MCWP 50R,G00,518797,Staff,0,1,20,20
1714623518224,MMW 12R,A01,514034,Herbst; Matthew,0,0,16,16
1714623518224,MMW 12R,A02,514035,Herbst; Matthew,1,0,16,15
1714623519248,MMW 13R,A01,514037,Staff,0,4,16,16
1714623519248,MMW 13R,A02,514039,Staff,0,2,16,16
1714623519248,MMW 13R,A03,628519,Staff,0,2,16,16
1714623521301,SIO 295LS,A00,523233,Staff,10,0,30,20
1714623522329,SIO 295S,A00,523232,Staff,10,0,30,20
1714623523355,SIOC 290S,A01,637330,Merrifield; Mark A,23,0,30,7
1714623524381,SIOC 291S,A01,637333,Gabriel; Corey John,23,0,30,7
1714623525407,SOCI 117,A01,494376,Staff,0,4,5,5
1714623526432,WES 237B,A00,494380,Staff,9,0,20,11
1714623528490,AESE 279B,A00,494370,Wade; Jon P,0,0,33,33
1714623529518,AIP 197,001,627712,Vespa; Emanuel Ignacio,9998,0,9999,1
1714623530544,ANAR 135S,A00,494369,Braswell; Geoffrey E.,0,0,0,0
1714623531569,BENG 196,001,628496,Engler; Adam J.,9998,0,9999,1
1714623532593,CAT 124RS,A01,519847,Geibel; William,0,0,20,20
1714623533623,CAT 125RS,A01,515971,Geibel; William,0,0,20,20
1714623534649,CLRE 250,A00,511389,Morris; Sheldon,9993,0,9999,6
1714623535676,CLRE 251,A00,507176,Mehta; Ravindra L.,9993,0,9999,6
1714623535676,CLRE 251,B00,511410,Mehta; Ravindra L.,9998,0,9999,1
1714623536701,CLRE 252,A00,507189,Cuomo; Raphael Eduardo,9995,0,9999,4
1714623537725,CLRE 253,A00,507199,Vaida; Florin,9994,0,9999,5
1714623537725,CLRE 253,B00,507202,Vaida; Florin,9999,0,9999,0
1714623538750,CLRE 259,A00,507211,Patel; Hemal,9996,0,9999,3
1714623539775,CLRE 260,A00,507221,Cuomo; Raphael Eduardo,9999,0,9999,0
1714623540804,CLRE 297,001,507242,Cuomo; Raphael Eduardo,9999,0,9999,0
1714623541828,COGS 197,001,638244,Voytek; Bradley Thomas,9998,0,9999,1
1714623542853,CSE 191,A00,516875,Minnes Kemp; Mor Mia,9992,0,9999,7
1714623543877,CSE 197,001,637388,Minnes Kemp; Mor Mia,9998,0,9999,1
1714623544908,CSS 201S,A01,494383,Staff,35,0,35,0
1714623545934,CSS 202S,A01,494387,Staff,35,0,35,0
1714623546963,DSC 197,001,628532,Eldridge; Justin Matthew,9996,0,9999,3
1714623547990,EAP 100,A00,516065,Staff,9797,0,9999,202
1714623549017,ECE 45,A01,507414,Staff,33,0,60,27
1714623551067,ECE 111,A01,507420,Staff,15,0,50,35
1714623552094,ECE 197,001,548057,Sievenpiper; Daniel F.,9993,0,9999,6
1714623553122,EDS 115,A00,507243,Choi; Bailey Miyeon,10,0,28,18
1714623554148,EDS 117,A01,494379,Staff,1,5,30,29
1714623555353,EDS 125,A00,507246,Hopkins; Megan Beth,9,0,30,21
1714623556379,EDS 128A,A01,507264,Fargason; Sharon Gayle,8,0,26,18
1714623557407,EDS 128B,A01,507293,Pappas; Elizabeth,12,0,30,18
1714623558431,EDS 139,A00,507294,Fargason; Sharon Gayle,13,0,30,17
1714623558431,EDS 139,B00,507313,Pappas; Elizabeth,13,0,30,17
1714623559457,EDS 201,A00,507315,Staff,13,0,30,17
1714623560485,EDS 203,A01,507317,Halter; Christopher P.,12,0,30,18
1714623561515,EDS 204R,A01,507319,Halter; Christopher P.,0,3,30,30
1714623561515,EDS 204R,B01,507331,Heinzman; Erica M.,16,0,30,14
1714623562540,EDS 206R,A00,507332,Staff,0,4,30,30
1714623562540,EDS 206R,B00,507343,Staff,17,0,30,13
1714623563567,EDS 250,A00,507344,Hemans; Patricia Ann Benitez,22,0,40,18
1714623564591,EDS 281,A00,507345,Daly; Alan J.,18,0,18,0
1714623565617,EDS 284,A00,507350,Daly; Alan J.,16,0,16,0
1714623566644,EDS 286,A00,507359,Fine; Sarah,18,0,18,0
1714623567668,EDS 289C,A01,507361,Daly; Alan J.,18,0,18,0
1714623568695,EDS 290,A00,507366,Hofstetter; Carolyn,15,0,15,0
1714623569719,LIGM 5A,A00,507421,Fischer-Grunski; Eva K,18,0,20,2
1714623570743,LIGM 5B,A00,507423,Fischer-Grunski; Eva K,19,0,20,1
1714623571823,LIGM 5C,A00,507425,Fischer-Grunski; Eva K,19,0,20,1
1714623572850,LIIT 5AS,A00,507427,Carnelos; Chiara,20,0,20,0
1714623573878,LIIT 5BS,A00,507430,Carnelos; Chiara,20,0,20,0
1714623574905,LIIT 5CS,A00,507432,Carnelos; Chiara,20,0,20,0
1714623575930,LISP 5A,A00,507541,Munoz Sanchez; Alicia,11,0,20,9
1714623576959,LISP 5B,A00,507671,Munoz Sanchez; Alicia,8,0,20,12
1714623577984,LISP 5C,A00,507696,Munoz Sanchez; Alicia,9,0,20,11
1714623579009,MAE 197,001,528363,Boechler; Nicholas Sebastia,9998,0,9999,1
1714623580035,MATH 197,001,523477,Kedlaya; Kiran S.,9995,0,9999,4
1714623580035,MATH 197,002,563811,Zhang; Danna,9995,0,9999,4
1714623580035,MATH 197,003,628552,Dumitriu; Ioana,9998,0,9999,1
1714623581115,MCWP 40R,A00,518780,Staff,2,0,20,18
1714623581115,MCWP 40R,B00,518781,Staff,8,0,20,12
1714623581115,MCWP 40R,C00,518783,Staff,6,0,20,14
1714623582144,MCWP 50R,A00,518791,Staff,0,0,20,20
1714623582144,MCWP 50R,B00,518792,Staff,0,2,20,20
1714623582144,MCWP 50R,C00,518793,Staff,0,2,20,20
1714623582144,MCWP 50R,D00,518794,Staff,0,0,20,20
1714623582144,MCWP 50R,E00,518795,Staff,0,2,20,20
1714623582144,MCWP 50R,F00,518796,Staff,0,0,20,20
1714623582144,MCWP 50R,G00,518797,Staff,0,1,20,20
1714623583169,MMW 12R,A01,514034,Herbst; Matthew,0,0,16,16
1714623583169,MMW 12R,A02,514035,Herbst; Matthew,1,0,16,15
1714623584195,MMW 13R,A01,514037,Staff,0,4,16,16
1714623584195,MMW 13R,A02,514039,Staff,0,2,16,16
1714623584195,MMW 13R,A03,628519,Staff,0,2,16,16
1714623586249,SIO 295LS,A00,523233,Staff,10,0,30,20
1714623587273,SIO 295S,A00,523232,Staff,10,0,30,20
1714623588299,SIOC 290S,A01,637330,Merrifield; Mark A,23,0,30,7
1714623590345,SIOC 291S,A01,637333,Gabriel; Corey John,23,0,30,7
1714623591370,SOCI 117,A01,494376,Staff,0,4,5,5
1714623592395,WES 237B,A00,494380,Staff,9,0,20,11
1714623594466,AESE 279B,A00,494370,Wade; Jon P,0,0,33,33
1714623595492,AIP 197,001,627712,Vespa; Emanuel Ignacio,9998,0,9999,1
1714623596520,ANAR 135S,A00,494369,Braswell; Geoffrey E.,0,0,0,0
1714623597548,BENG 196,001,628496,Engler; Adam J.,9998,0,9999,1
1714623598578,CAT 124RS,A01,519847,Geibel; William,0,0,20,20
1714623599606,CAT 125RS,A01,515971,Geibel; William,0,0,20,20
1714623600633,CLRE 250,A00,511389,Morris; Sheldon,9993,0,9999,6
1714623601661,CLRE 251,A00,507176,Mehta; Ravindra L.,9993,0,9999,6
1714623601661,CLRE 251,B00,511410,Mehta; Ravindra L.,9998,0,9999,1
1714623602691,CLRE 252,A00,507189,Cuomo; Raphael Eduardo,9995,0,9999,4
1714623603717,CLRE 253,A00,507199,Vaida; Florin,9994,0,9999,5
1714623603717,CLRE 253,B00,507202,Vaida; Florin,9999,0,9999,0
1714623604745,CLRE 259,A00,507211,Patel; Hemal,9996,0,9999,3
1714623605772,CLRE 260,A00,507221,Cuomo; Raphael Eduardo,9999,0,9999,0
1714623606800,CLRE 297,001,507242,Cuomo; Raphael Eduardo,9999,0,9999,0
1714623607827,COGS 197,001,638244,Voytek; Bradley Thomas,9998,0,9999,1
1714623608853,CSE 191,A00,516875,Minnes Kemp; Mor Mia,9992,0,9999,7
1714623609879,CSE 197,001,637388,Minnes Kemp; Mor Mia,9998,0,9999,1
1714623610908,CSS 201S,A01,494383,Staff,35,0,35,0
1714623611937,CSS 202S,A01,494387,Staff,35,0,35,0
1714623612966,DSC 197,001,628532,Eldridge; Justin Matthew,9996,0,9999,3
1714623613992,EAP 100,A00,516065,Staff,9797,0,9999,202
1714623615019,ECE 45,A01,507414,Staff,33,0,60,27
1714623617077,ECE 111,A01,507420,Staff,15,0,50,35
1714623618102,ECE 197,001,548057,Sievenpiper; Daniel F.,9993,0,9999,6
1714623619131,EDS 115,A00,507243,Choi; Bailey Miyeon,10,0,28,18
1714623620157,EDS 117,A01,494379,Staff,1,5,30,29
1714623621182,EDS 125,A00,507246,Hopkins; Megan Beth,9,0,30,21
1714623622211,EDS 128A,A01,507264,Fargason; Sharon Gayle,8,0,26,18
1714623623240,EDS 128B,A01,507293,Pappas; Elizabeth,12,0,30,18
1714623624265,EDS 139,A00,507294,Fargason; Sharon Gayle,13,0,30,17
1714623624265,EDS 139,B00,507313,Pappas; Elizabeth,13,0,30,17
1714623625812,EDS 201,A00,507315,Staff,13,0,30,17
1714623626840,EDS 203,A01,507317,Halter; Christopher P.,12,0,30,18
1714623627868,EDS 204R,A01,507319,Halter; Christopher P.,0,3,30,30
1714623627868,EDS 204R,B01,507331,Heinzman; Erica M.,16,0,30,14
1714623628893,EDS 206R,A00,507332,Staff,0,4,30,30
1714623628893,EDS 206R,B00,507343,Staff,17,0,30,13
1714623629918,EDS 250,A00,507344,Hemans; Patricia Ann Benitez,22,0,40,18
1714623630947,EDS 281,A00,507345,Daly; Alan J.,18,0,18,0
1714623631973,EDS 284,A00,507350,Daly; Alan J.,16,0,16,0
1714623632998,EDS 286,A00,507359,Fine; Sarah,18,0,18,0
1714623634023,EDS 289C,A01,507361,Daly; Alan J.,18,0,18,0
1714623635047,EDS 290,A00,507366,Hofstetter; Carolyn,15,0,15,0
1714623636073,LIGM 5A,A00,507421,Fischer-Grunski; Eva K,18,0,20,2
1714623637098,LIGM 5B,A00,507423,Fischer-Grunski; Eva K,19,0,20,1
1714623638128,LIGM 5C,A00,507425,Fischer-Grunski; Eva K,19,0,20,1
1714623639154,LIIT 5AS,A00,507427,Carnelos; Chiara,20,0,20,0
1714623640181,LIIT 5BS,A00,507430,Carnelos; Chiara,20,0,20,0
1714623641209,LIIT 5CS,A00,507432,Carnelos; Chiara,20,0,20,0
1714623642240,LISP 5A,A00,507541,Munoz Sanchez; Alicia,11,0,20,9
1714623643265,LISP 5B,A00,507671,Munoz Sanchez; Alicia,8,0,20,12
1714623644294,LISP 5C,A00,507696,Munoz Sanchez; Alicia,9,0,20,11
1714623645320,MAE 197,001,528363,Boechler; Nicholas Sebastia,9998,0,9999,1
1714623646347,MATH 197,001,523477,Kedlaya; Kiran S.,9995,0,9999,4
1714623646347,MATH 197,002,563811,Zhang; Danna,9995,0,9999,4
1714623646347,MATH 197,003,628552,Dumitriu; Ioana,9998,0,9999,1
1714623647371,MCWP 40R,A00,518780,Staff,2,0,20,18
1714623647371,MCWP 40R,B00,518781,Staff,8,0,20,12
1714623647371,MCWP 40R,C00,518783,Staff,6,0,20,14
1714623648398,MCWP 50R,A00,518791,Staff,0,0,20,20
1714623648398,MCWP 50R,B00,518792,Staff,0,2,20,20
1714623648398,MCWP 50R,C00,518793,Staff,0,2,20,20
1714623648398,MCWP 50R,D00,518794,Staff,0,0,20,20
1714623648398,MCWP 50R,E00,518795,Staff,0,2,20,20
1714623648398,MCWP 50R,F00,518796,Staff,0,0,20,20
1714623648398,MCWP 50R,G00,518797,Staff,0,1,20,20
1714623649428,MMW 12R,A01,514034,Herbst; Matthew,0,0,16,16
1714623649428,MMW 12R,A02,514035,Herbst; Matthew,1,0,16,15
1714623650453,MMW 13R,A01,514037,Staff,0,4,16,16
1714623650453,MMW 13R,A02,514039,Staff,0,2,16,16
1714623650453,MMW 13R,A03,628519,Staff,0,2,16,16
1714623652506,SIO 295LS,A00,523233,Staff,10,0,30,20
1714623653533,SIO 295S,A00,523232,Staff,10,0,30,20
1714623654562,SIOC 290S,A01,637330,Merrifield; Mark A,23,0,30,7
1714623655591,SIOC 291S,A01,637333,Gabriel; Corey John,23,0,30,7
1714623656617,SOCI 117,A01,494376,Staff,0,4,5,5
1714623657644,WES 237B,A00,494380,Staff,9,0,20,11
1714623659710,AESE 279B,A00,494370,Wade; Jon P,0,0,33,33
1714623660737,AIP 197,001,627712,Vespa; Emanuel Ignacio,9998,0,9999,1
1714623661762,ANAR 135S,A00,494369,Braswell; Geoffrey E.,0,0,0,0
1714623662786,BENG 196,001,628496,Engler; Adam J.,9998,0,9999,1
1714623663813,CAT 124RS,A01,519847,Geibel; William,0,0,20,20
1714623664842,CAT 125RS,A01,515971,Geibel; William,0,0,20,20
1714623665869,CLRE 250,A00,511389,Morris; Sheldon,9993,0,9999,6
1714623666894,CLRE 251,A00,507176,Mehta; Ravindra L.,9993,0,9999,6
1714623666894,CLRE 251,B00,511410,Mehta; Ravindra L.,9998,0,9999,1
1714623667920,CLRE 252,A00,507189,Cuomo; Raphael Eduardo,9995,0,9999,4
1714623668946,CLRE 253,A00,507199,Vaida; Florin,9994,0,9999,5
1714623668946,CLRE 253,B00,507202,Vaida; Florin,9999,0,9999,0
1714623669972,CLRE 259,A00,507211,Patel; Hemal,9996,0,9999,3
1714623670997,CLRE 260,A00,507221,Cuomo; Raphael Eduardo,9999,0,9999,0
1714623672022,CLRE 297,001,507242,Cuomo; Raphael Eduardo,9999,0,9999,0
1714623673048,COGS 197,001,638244,Voytek; Bradley Thomas,9998,0,9999,1
1714623674073,CSE 191,A00,516875,Minnes Kemp; Mor Mia,9992,0,9999,7
1714623675102,CSE 197,001,637388,Minnes Kemp; Mor Mia,9998,0,9999,1
1714623676132,CSS 201S,A01,494383,Staff,35,0,35,0
1714623677157,CSS 202S,A01,494387,Staff,35,0,35,0
1714623678182,DSC 197,001,628532,Eldridge; Justin Matthew,9996,0,9999,3
1714623679207,EAP 100,A00,516065,Staff,9797,0,9999,202
1714623680233,ECE 45,A01,507414,Staff,33,0,60,27
1714623682283,ECE 111,A01,507420,Staff,15,0,50,35
1714623683309,ECE 197,001,548057,Sievenpiper; Daniel F.,9993,0,9999,6
1714623684334,EDS 115,A00,507243,Choi; Bailey Miyeon,10,0,28,18
1714623685362,EDS 117,A01,494379,Staff,1,5,30,29
1714623686391,EDS 125,A00,507246,Hopkins; Megan Beth,9,0,30,21
1714623687421,EDS 128A,A01,507264,Fargason; Sharon Gayle,8,0,26,18
1714623688451,EDS 128B,A01,507293,Pappas; Elizabeth,12,0,30,18
1714623689481,EDS 139,A00,507294,Fargason; Sharon Gayle,13,0,30,17
1714623689481,EDS 139,B00,507313,Pappas; Elizabeth,13,0,30,17
1714623690506,EDS 201,A00,507315,Staff,13,0,30,17
1714623691532,EDS 203,A01,507317,Halter; Christopher P.,12,0,30,18
1714623692557,EDS 204R,A01,507319,Halter; Christopher P.,0,3,30,30
1714623692557,EDS 204R,B01,507331,Heinzman; Erica M.,16,0,30,14
1714623693582,EDS 206R,A00,507332,Staff,0,4,30,30
1714623693582,EDS 206R,B00,507343,Staff,17,0,30,13
1714623694608,EDS 250,A00,507344,Hemans; Patricia Ann Benitez,22,0,40,18
1714623695636,EDS 281,A00,507345,Daly; Alan J.,18,0,18,0
1714623696661,EDS 284,A00,507350,Daly; Alan J.,16,0,16,0
1714623697688,EDS 286,A00,507359,Fine; Sarah,18,0,18,0
1714623698716,EDS 289C,A01,507361,Daly; Alan J.,18,0,18,0
1714623699742,EDS 290,A00,507366,Hofstetter; Carolyn,15,0,15,0
1714623700773,LIGM 5A,A00,507421,Fischer-Grunski; Eva K,18,0,20,2
1714623701798,LIGM 5B,A00,507423,Fischer-Grunski; Eva K,19,0,20,1
1714623702828,LIGM 5C,A00,507425,Fischer-Grunski; Eva K,19,0,20,1
1714623703854,LIIT 5AS,A00,507427,Carnelos; Chiara,20,0,20,0
1714623704879,LIIT 5BS,A00,507430,Carnelos; Chiara,20,0,20,0
1714623705909,LIIT 5CS,A00,507432,Carnelos; Chiara,20,0,20,0
1714623706941,LISP 5A,A00,507541,Munoz Sanchez; Alicia,11,0,20,9
1714623707971,LISP 5B,A00,507671,Munoz Sanchez; Alicia,8,0,20,12
1714623708998,LISP 5C,A00,507696,Munoz Sanchez; Alicia,9,0,20,11
1714623710027,MAE 197,001,528363,Boechler; Nicholas Sebastia,9998,0,9999,1
1714623711058,MATH 197,001,523477,Kedlaya; Kiran S.,9995,0,9999,4
1714623711058,MATH 197,002,563811,Zhang; Danna,9995,0,9999,4
1714623711058,MATH 197,003,628552,Dumitriu; Ioana,9998,0,9999,1
1714623712084,MCWP 40R,A00,518780,Staff,2,0,20,18
1714623712084,MCWP 40R,B00,518781,Staff,8,0,20,12
1714623712084,MCWP 40R,C00,518783,Staff,6,0,20,14
1714623713112,MCWP 50R,A00,518791,Staff,0,0,20,20
1714623713112,MCWP 50R,B00,518792,Staff,0,2,20,20
1714623713112,MCWP 50R,C00,518793,Staff,0,2,20,20
1714623713112,MCWP 50R,D00,518794,Staff,0,0,20,20
1714623713112,MCWP 50R,E00,518795,Staff,0,2,20,20
1714623713112,MCWP 50R,F00,518796,Staff,0,0,20,20
1714623713112,MCWP 50R,G00,518797,Staff,0,1,20,20
1714623714138,MMW 12R,A01,514034,Herbst; Matthew,0,0,16,16
1714623714138,MMW 12R,A02,514035,Herbst; Matthew,1,0,16,15
1714623715168,MMW 13R,A01,514037,Staff,0,4,16,16
1714623715168,MMW 13R,A02,514039,Staff,0,2,16,16
1714623715168,MMW 13R,A03,628519,Staff,0,2,16,16
1714623717220,SIO 295LS,A00,523233,Staff,10,0,30,20
1714623718245,SIO 295S,A00,523232,Staff,10,0,30,20
1714623719275,SIOC 290S,A01,637330,Merrifield; Mark A,23,0,30,7
1714623720303,SIOC 291S,A01,637333,Gabriel; Corey John,23,0,30,7
1714623721339,SOCI 117,A01,494376,Staff,0,4,5,5
1714623722366,WES 237B,A00,494380,Staff,9,0,20,11
1714623724505,AESE 279B,A00,494370,Wade; Jon P,0,0,33,33
1714623725534,AIP 197,001,627712,Vespa; Emanuel Ignacio,9998,0,9999,1
1714623726562,ANAR 135S,A00,494369,Braswell; Geoffrey E.,0,0,0,0
1714623727586,BENG 196,001,628496,Engler; Adam J.,9998,0,9999,1
1714623728613,CAT 124RS,A01,519847,Geibel; William,0,0,20,20
1714623729641,CAT 125RS,A01,515971,Geibel; William,0,0,20,20
1714623730665,CLRE 250,A00,511389,Morris; Sheldon,9993,0,9999,6
1714623731693,CLRE 251,A00,507176,Mehta; Ravindra L.,9993,0,9999,6
1714623731693,CLRE 251,B00,511410,Mehta; Ravindra L.,9998,0,9999,1
1714623732721,CLRE 252,A00,507189,Cuomo; Raphael Eduardo,9995,0,9999,4
1714623733750,CLRE 253,A00,507199,Vaida; Florin,9994,0,9999,5
1714623733750,CLRE 253,B00,507202,Vaida; Florin,9999,0,9999,0
1714623734778,CLRE 259,A00,507211,Patel; Hemal,9996,0,9999,3
1714623735804,CLRE 260,A00,507221,Cuomo; Raphael Eduardo,9999,0,9999,0
1714623736832,CLRE 297,001,507242,Cuomo; Raphael Eduardo,9999,0,9999,0
1714623737861,COGS 197,001,638244,Voytek; Bradley Thomas,9998,0,9999,1
1714623738892,CSE 191,A00,516875,Minnes Kemp; Mor Mia,9992,0,9999,7
1714623739916,CSE 197,001,637388,Minnes Kemp; Mor Mia,9998,0,9999,1
1714623740943,CSS 201S,A01,494383,Staff,35,0,35,0
1714623741968,CSS 202S,A01,494387,Staff,35,0,35,0
1714623742996,DSC 197,001,628532,Eldridge; Justin Matthew,9996,0,9999,3
1714623744023,EAP 100,A00,516065,Staff,9797,0,9999,202
1714623745048,ECE 45,A01,507414,Staff,33,0,60,27
1714623747102,ECE 111,A01,507420,Staff,15,0,50,35
1714623748130,ECE 197,001,548057,Sievenpiper; Daniel F.,9993,0,9999,6
1714623749159,EDS 115,A00,507243,Choi; Bailey Miyeon,10,0,28,18
1714623750187,EDS 117,A01,494379,Staff,1,5,30,29
1714623751213,EDS 125,A00,507246,Hopkins; Megan Beth,9,0,30,21
1714623752238,EDS 128A,A01,507264,Fargason; Sharon Gayle,8,0,26,18
1714623753269,EDS 128B,A01,507293,Pappas; Elizabeth,12,0,30,18
1714623754293,EDS 139,A00,507294,Fargason; Sharon Gayle,13,0,30,17
1714623754293,EDS 139,B00,507313,Pappas; Elizabeth,13,0,30,17
1714623755320,EDS 201,A00,507315,Staff,13,0,30,17
1714623756347,EDS 203,A01,507317,Halter; Christopher P.,12,0,30,18
1714623757377,EDS 204R,A01,507319,Halter; Christopher P.,0,3,30,30
1714623757377,EDS 204R,B01,507331,Heinzman; Erica M.,16,0,30,14
1714623758403,EDS 206R,A00,507332,Staff,0,4,30,30
1714623758403,EDS 206R,B00,507343,Staff,17,0,30,13
1714623759431,EDS 250,A00,507344,Hemans; Patricia Ann Benitez,22,0,40,18
1714623760456,EDS 281,A00,507345,Daly; Alan J.,18,0,18,0
1714623761483,EDS 284,A00,507350,Daly; Alan J.,16,0,16,0
1714623762512,EDS 286,A00,507359,Fine; Sarah,18,0,18,0
1714623763541,EDS 289C,A01,507361,Daly; Alan J.,18,0,18,0
1714623764566,EDS 290,A00,507366,Hofstetter; Carolyn,15,0,15,0
1714623765597,LIGM 5A,A00,507421,Fischer-Grunski; Eva K,18,0,20,2
1714623766626,LIGM 5B,A00,507423,Fischer-Grunski; Eva K,19,0,20,1
1714623767651,LIGM 5C,A00,507425,Fischer-Grunski; Eva K,19,0,20,1
1714623768679,LIIT 5AS,A00,507427,Carnelos; Chiara,20,0,20,0
1714623769703,LIIT 5BS,A00,507430,Carnelos; Chiara,20,0,20,0
1714623770733,LIIT 5CS,A00,507432,Carnelos; Chiara,20,0,20,0
1714623771763,LISP 5A,A00,507541,Munoz Sanchez; Alicia,11,0,20,9
1714623772790,LISP 5B,A00,507671,Munoz Sanchez; Alicia,8,0,20,12
1714623773814,LISP 5C,A00,507696,Munoz Sanchez; Alicia,9,0,20,11
1714623774840,MAE 197,001,528363,Boechler; Nicholas Sebastia,9998,0,9999,1
1714623775867,MATH 197,001,523477,Kedlaya; Kiran S.,9995,0,9999,4
1714623775867,MATH 197,002,563811,Zhang; Danna,9995,0,9999,4
1714623775867,MATH 197,003,628552,Dumitriu; Ioana,9998,0,9999,1
1714623776896,MCWP 40R,A00,518780,Staff,2,0,20,18
1714623776896,MCWP 40R,B00,518781,Staff,8,0,20,12
1714623776896,MCWP 40R,C00,518783,Staff,6,0,20,14
1714623777921,MCWP 50R,A00,518791,Staff,0,0,20,20
1714623777921,MCWP 50R,B00,518792,Staff,0,2,20,20
1714623777921,MCWP 50R,C00,518793,Staff,0,2,20,20
1714623777921,MCWP 50R,D00,518794,Staff,0,0,20,20
1714623777921,MCWP 50R,E00,518795,Staff,0,2,20,20
1714623777921,MCWP 50R,F00,518796,Staff,0,0,20,20
1714623777921,MCWP 50R,G00,518797,Staff,0,1,20,20
1714623778947,MMW 12R,A01,514034,Herbst; Matthew,0,0,16,16
1714623778947,MMW 12R,A02,514035,Herbst; Matthew,1,0,16,15
1714623779973,MMW 13R,A01,514037,Staff,0,4,16,16
1714623779973,MMW 13R,A02,514039,Staff,0,2,16,16
1714623779973,MMW 13R,A03,628519,Staff,0,2,16,16
1714623782027,SIO 295LS,A00,523233,Staff,10,0,30,20
1714623783054,SIO 295S,A00,523232,Staff,10,0,30,20
1714623784084,SIOC 290S,A01,637330,Merrifield; Mark A,23,0,30,7
1714623785113,SIOC 291S,A01,637333,Gabriel; Corey John,23,0,30,7
1714623786330,SOCI 117,A01,494376,Staff,0,4,5,5
1714623787354,WES 237B,A00,494380,Staff,9,0,20,11
1714623789423,AESE 279B,A00,494370,Wade; Jon P,0,0,33,33
1714623790448,AIP 197,001,627712,Vespa; Emanuel Ignacio,9998,0,9999,1
1714623791475,ANAR 135S,A00,494369,Braswell; Geoffrey E.,0,0,0,0
1714623792501,BENG 196,001,628496,Engler; Adam J.,9998,0,9999,1
1714623793525,CAT 124RS,A01,519847,Geibel; William,0,0,20,20
1714623794550,CAT 125RS,A01,515971,Geibel; William,0,0,20,20
1714623795574,CLRE 250,A00,511389,Morris; Sheldon,9993,0,9999,6
1714623796604,CLRE 251,A00,507176,Mehta; Ravindra L.,9993,0,9999,6
1714623796604,CLRE 251,B00,511410,Mehta; Ravindra L.,9998,0,9999,1
1714623797627,CLRE 252,A00,507189,Cuomo; Raphael Eduardo,9995,0,9999,4
1714623798654,CLRE 253,A00,507199,Vaida; Florin,9994,0,9999,5
1714623798654,CLRE 253,B00,507202,Vaida; Florin,9999,0,9999,0
1714623799682,CLRE 259,A00,507211,Patel; Hemal,9996,0,9999,3
1714623800707,CLRE 260,A00,507221,Cuomo; Raphael Eduardo,9999,0,9999,0
1714623801735,CLRE 297,001,507242,Cuomo; Raphael Eduardo,9999,0,9999,0
1714623802763,COGS 197,001,638244,Voytek; Bradley Thomas,9998,0,9999,1
1714623803792,CSE 191,A00,516875,Minnes Kemp; Mor Mia,9992,0,9999,7
1714623804818,CSE 197,001,637388,Minnes Kemp; Mor Mia,9998,0,9999,1
1714623805847,CSS 201S,A01,494383,Staff,35,0,35,0
1714623806873,CSS 202S,A01,494387,Staff,35,0,35,0
1714623807907,DSC 197,001,628532,Eldridge; Justin Matthew,9996,0,9999,3
1714623808936,EAP 100,A00,516065,Staff,9797,0,9999,202
1714623809961,ECE 45,A01,507414,Staff,33,0,60,27
1714623812013,ECE 111,A01,507420,Staff,15,0,50,35
1714623813040,ECE 197,001,548057,Sievenpiper; Daniel F.,9993,0,9999,6
1714623814065,EDS 115,A00,507243,Choi; Bailey Miyeon,10,0,28,18
1714623815090,EDS 117,A01,494379,Staff,1,5,30,29
1714623816118,EDS 125,A00,507246,Hopkins; Megan Beth,9,0,30,21
1714623817147,EDS 128A,A01,507264,Fargason; Sharon Gayle,8,0,26,18
1714623818173,EDS 128B,A01,507293,Pappas; Elizabeth,12,0,30,18
1714623819202,EDS 139,A00,507294,Fargason; Sharon Gayle,13,0,30,17
1714623819202,EDS 139,B00,507313,Pappas; Elizabeth,13,0,30,17
1714623820230,EDS 201,A00,507315,Staff,13,0,30,17
1714623821256,EDS 203,A01,507317,Halter; Christopher P.,12,0,30,18
1714623822281,EDS 204R,A01,507319,Halter; Christopher P.,0,3,30,30
1714623822281,EDS 204R,B01,507331,Heinzman; Erica M.,16,0,30,14
1714623823307,EDS 206R,A00,507332,Staff,0,4,30,30
1714623823307,EDS 206R,B00,507343,Staff,17,0,30,13
1714623824336,EDS 250,A00,507344,Hemans; Patricia Ann Benitez,22,0,40,18
1714623825363,EDS 281,A00,507345,Daly; Alan J.,18,0,18,0
1714623826387,EDS 284,A00,507350,Daly; Alan J.,16,0,16,0
1714623827416,EDS 286,A00,507359,Fine; Sarah,18,0,18,0
1714623828443,EDS 289C,A01,507361,Daly; Alan J.,18,0,18,0
1714623829469,EDS 290,A00,507366,Hofstetter; Carolyn,15,0,15,0
1714623830498,LIGM 5A,A00,507421,Fischer-Grunski; Eva K,18,0,20,2
1714623831523,LIGM 5B,A00,507423,Fischer-Grunski; Eva K,19,0,20,1
1714623832551,LIGM 5C,A00,507425,Fischer-Grunski; Eva K,19,0,20,1
1714623833578,LIIT 5AS,A00,507427,Carnelos; Chiara,20,0,20,0
1714623834606,LIIT 5BS,A00,507430,Carnelos; Chiara,20,0,20,0
1714623835633,LIIT 5CS,A00,507432,Carnelos; Chiara,20,0,20,0
1714623836661,LISP 5A,A00,507541,Munoz Sanchez; Alicia,11,0,20,9
1714623837689,LISP 5B,A00,507671,Munoz Sanchez; Alicia,8,0,20,12
1714623838716,LISP 5C,A00,507696,Munoz Sanchez; Alicia,9,0,20,11
1714623839743,MAE 197,001,528363,Boechler; Nicholas Sebastia,9998,0,9999,1
1714623840768,MATH 197,001,523477,Kedlaya; Kiran S.,9995,0,9999,4
1714623840768,MATH 197,002,563811,Zhang; Danna,9995,0,9999,4
1714623840768,MATH 197,003,628552,Dumitriu; Ioana,9998,0,9999,1
1714623841795,MCWP 40R,A00,518780,Staff,2,0,20,18
1714623841795,MCWP 40R,B00,518781,Staff,8,0,20,12
1714623841795,MCWP 40R,C00,518783,Staff,6,0,20,14
1714623842824,MCWP 50R,A00,518791,Staff,0,0,20,20
1714623842824,MCWP 50R,B00,518792,Staff,0,2,20,20
1714623842824,MCWP 50R,C00,518793,Staff,0,2,20,20
1714623842824,MCWP 50R,D00,518794,Staff,0,0,20,20
1714623842824,MCWP 50R,E00,518795,Staff,0,2,20,20
1714623842824,MCWP 50R,F00,518796,Staff,0,0,20,20
1714623842824,MCWP 50R,G00,518797,Staff,0,1,20,20
1714623843865,MMW 12R,A01,514034,Herbst; Matthew,0,0,16,16
1714623843865,MMW 12R,A02,514035,Herbst; Matthew,1,0,16,15
1714623844892,MMW 13R,A01,514037,Staff,0,4,16,16
1714623844892,MMW 13R,A02,514039,Staff,0,2,16,16
1714623844892,MMW 13R,A03,628519,Staff,0,2,16,16
1714623846943,SIO 295LS,A00,523233,Staff,10,0,30,20
1714623847970,SIO 295S,A00,523232,Staff,10,0,30,20
1714623848997,SIOC 290S,A01,637330,Merrifield; Mark A,23,0,30,7
1714623850021,SIOC 291S,A01,637333,Gabriel; Corey John,23,0,30,7
1714623851047,SOCI 117,A01,494376,Staff,0,4,5,5
1714623852073,WES 237B,A00,494380,Staff,9,0,20,11
1714623854128,AESE 279B,A00,494370,Wade; Jon P,0,0,33,33
1714623855155,AIP 197,001,627712,Vespa; Emanuel Ignacio,9998,0,9999,1
1714623856183,ANAR 135S,A00,494369,Braswell; Geoffrey E.,0,0,0,0
1714623857210,BENG 196,001,628496,Engler; Adam J.,9998,0,9999,1
1714623858234,CAT 124RS,A01,519847,Geibel; William,0,0,20,20
1714623859263,CAT 125RS,A01,515971,Geibel; William,0,0,20,20
1714623860290,CLRE 250,A00,511389,Morris; Sheldon,9993,0,9999,6
1714623861318,CLRE 251,A00,507176,Mehta; Ravindra L.,9993,0,9999,6
1714623861318,CLRE 251,B00,511410,Mehta; Ravindra L.,9998,0,9999,1
1714623862347,CLRE 252,A00,507189,Cuomo; Raphael Eduardo,9995,0,9999,4
1714623863376,CLRE 253,A00,507199,Vaida; Florin,9994,0,9999,5
1714623863376,CLRE 253,B00,507202,Vaida; Florin,9999,0,9999,0
1714623864400,CLRE 259,A00,507211,Patel; Hemal,9996,0,9999,3
1714623865424,CLRE 260,A00,507221,Cuomo; Raphael Eduardo,9999,0,9999,0
1714623866449,CLRE 297,001,507242,Cuomo; Raphael Eduardo,9999,0,9999,0
1714623867475,COGS 197,001,638244,Voytek; Bradley Thomas,9998,0,9999,1
1714623868502,CSE 191,A00,516875,Minnes Kemp; Mor Mia,9992,0,9999,7
1714623869530,CSE 197,001,637388,Minnes Kemp; Mor Mia,9998,0,9999,1
1714623870557,CSS 201S,A01,494383,Staff,35,0,35,0
1714623871584,CSS 202S,A01,494387,Staff,35,0,35,0
1714623872609,DSC 197,001,628532,Eldridge; Justin Matthew,9996,0,9999,3
1714623873637,EAP 100,A00,516065,Staff,9797,0,9999,202
1714623874663,ECE 45,A01,507414,Staff,33,0,60,27
1714623876713,ECE 111,A01,507420,Staff,15,0,50,35
1714623877737,ECE 197,001,548057,Sievenpiper; Daniel F.,9993,0,9999,6
1714623878764,EDS 115,A00,507243,Choi; Bailey Miyeon,10,0,28,18
1714623879794,EDS 117,A01,494379,Staff,1,5,30,29
1714623880819,EDS 125,A00,507246,Hopkins; Megan Beth,9,0,30,21
1714623881848,EDS 128A,A01,507264,Fargason; Sharon Gayle,8,0,26,18
1714623882876,EDS 128B,A01,507293,Pappas; Elizabeth,12,0,30,18
1714623883899,EDS 139,A00,507294,Fargason; Sharon Gayle,13,0,30,17
1714623883899,EDS 139,B00,507313,Pappas; Elizabeth,13,0,30,17
1714623884925,EDS 201,A00,507315,Staff,13,0,30,17
1714623885950,EDS 203,A01,507317,Halter; Christopher P.,12,0,30,18
1714623886979,EDS 204R,A01,507319,Halter; Christopher P.,0,3,30,30
1714623886979,EDS 204R,B01,507331,Heinzman; Erica M.,16,0,30,14
1714623888004,EDS 206R,A00,507332,Staff,0,4,30,30
1714623888004,EDS 206R,B00,507343,Staff,17,0,30,13
1714623889030,EDS 250,A00,507344,Hemans; Patricia Ann Benitez,22,0,40,18
1714623890053,EDS 281,A00,507345,Daly; Alan J.,18,0,18,0
1714623891082,EDS 284,A00,507350,Daly; Alan J.,16,0,16,0
1714623892107,EDS 286,A00,507359,Fine; Sarah,18,0,18,0
1714623893136,EDS 289C,A01,507361,Daly; Alan J.,18,0,18,0
1714623894165,EDS 290,A00,507366,Hofstetter; Carolyn,15,0,15,0
1714623895194,LIGM 5A,A00,507421,Fischer-Grunski; Eva K,18,0,20,2
1714623896220,LIGM 5B,A00,507423,Fischer-Grunski; Eva K,19,0,20,1
1714623897246,LIGM 5C,A00,507425,Fischer-Grunski; Eva K,19,0,20,1
1714623898270,LIIT 5AS,A00,507427,Carnelos; Chiara,20,0,20,0
1714623899300,LIIT 5BS,A00,507430,Carnelos; Chiara,20,0,20,0
1714623900326,LIIT 5CS,A00,507432,Carnelos; Chiara,20,0,20,0
1714623901352,LISP 5A,A00,507541,Munoz Sanchez; Alicia,11,0,20,9
1714623902380,LISP 5B,A00,507671,Munoz Sanchez; Alicia,8,0,20,12
1714623903410,LISP 5C,A00,507696,Munoz Sanchez; Alicia,9,0,20,11
1714623904441,MAE 197,001,528363,Boechler; Nicholas Sebastia,9998,0,9999,1
1714623905468,MATH 197,001,523477,Kedlaya; Kiran S.,9995,0,9999,4
1714623905468,MATH 197,002,563811,Zhang; Danna,9995,0,9999,4
1714623905468,MATH 197,003,628552,Dumitriu; Ioana,9998,0,9999,1
1714623906497,MCWP 40R,A00,518780,Staff,2,0,20,18
1714623906497,MCWP 40R,B00,518781,Staff,8,0,20,12
1714623906497,MCWP 40R,C00,518783,Staff,6,0,20,14
1714623907549,MCWP 50R,A00,518791,Staff,0,0,20,20
1714623907549,MCWP 50R,B00,518792,Staff,0,2,20,20
1714623907549,MCWP 50R,C00,518793,Staff,0,2,20,20
1714623907549,MCWP 50R,D00,518794,Staff,0,0,20,20
1714623907549,MCWP 50R,E00,518795,Staff,0,2,20,20
1714623907549,MCWP 50R,F00,518796,Staff,0,0,20,20
1714623907549,MCWP 50R,G00,518797,Staff,0,1,20,20
1714623908574,MMW 12R,A01,514034,Herbst; Matthew,0,0,16,16
1714623908574,MMW 12R,A02,514035,Herbst; Matthew,1,0,16,15
1714623909602,MMW 13R,A01,514037,Staff,0,4,16,16
1714623909602,MMW 13R,A02,514039,Staff,0,2,16,16
1714623909602,MMW 13R,A03,628519,Staff,0,2,16,16
1714623911659,SIO 295LS,A00,523233,Staff,10,0,30,20
1714623912684,SIO 295S,A00,523232,Staff,10,0,30,20
1714623913709,SIOC 290S,A01,637330,Merrifield; Mark A,23,0,30,7
1714623914735,SIOC 291S,A01,637333,Gabriel; Corey John,23,0,30,7
1714623915761,SOCI 117,A01,494376,Staff,0,4,5,5
1714623916786,WES 237B,A00,494380,Staff,9,0,20,11
1714623918862,AESE 279B,A00,494370,Wade; Jon P,0,0,33,33
1714623919888,AIP 197,001,627712,Vespa; Emanuel Ignacio,9998,0,9999,1
1714623920912,ANAR 135S,A00,494369,Braswell; Geoffrey E.,0,0,0,0
1714623921937,BENG 196,001,628496,Engler; Adam J.,9998,0,9999,1
1714623922968,CAT 124RS,A01,519847,Geibel; William,0,0,20,20
1714623923994,CAT 125RS,A01,515971,Geibel; William,0,0,20,20
1714623925021,CLRE 250,A00,511389,Morris; Sheldon,9993,0,9999,6
1714623926055,CLRE 251,A00,507176,Mehta; Ravindra L.,9993,0,9999,6
1714623926055,CLRE 251,B00,511410,Mehta; Ravindra L.,9998,0,9999,1
1714623927082,CLRE 252,A00,507189,Cuomo; Raphael Eduardo,9995,0,9999,4
1714623928111,CLRE 253,A00,507199,Vaida; Florin,9994,0,9999,5
1714623928111,CLRE 253,B00,507202,Vaida; Florin,9999,0,9999,0
1714623929137,CLRE 259,A00,507211,Patel; Hemal,9996,0,9999,3
1714623930164,CLRE 260,A00,507221,Cuomo; Raphael Eduardo,9999,0,9999,0
1714623931190,CLRE 297,001,507242,Cuomo; Raphael Eduardo,9999,0,9999,0
1714623932215,COGS 197,001,638244,Voytek; Bradley Thomas,9998,0,9999,1
1714623933243,CSE 191,A00,516875,Minnes Kemp; Mor Mia,9992,0,9999,7
1714623934269,CSE 197,001,637388,Minnes Kemp; Mor Mia,9998,0,9999,1
1714623935299,CSS 201S,A01,494383,Staff,35,0,35,0
1714623936327,CSS 202S,A01,494387,Staff,35,0,35,0
1714623937352,DSC 197,001,628532,Eldridge; Justin Matthew,9996,0,9999,3
1714623938377,EAP 100,A00,516065,Staff,9797,0,9999,202
1714623939405,ECE 45,A01,507414,Staff,33,0,60,27
1714623941458,ECE 111,A01,507420,Staff,15,0,50,35
1714623942486,ECE 197,001,548057,Sievenpiper; Daniel F.,9993,0,9999,6
1714623943513,EDS 115,A00,507243,Choi; Bailey Miyeon,10,0,28,18
1714623944540,EDS 117,A01,494379,Staff,1,5,30,29
1714623945568,EDS 125,A00,507246,Hopkins; Megan Beth,9,0,30,21
1714623946597,EDS 128A,A01,507264,Fargason; Sharon Gayle,8,0,26,18
1714623947621,EDS 128B,A01,507293,Pappas; Elizabeth,12,0,30,18
1714623948648,EDS 139,A00,507294,Fargason; Sharon Gayle,13,0,30,17
1714623948648,EDS 139,B00,507313,Pappas; Elizabeth,13,0,30,17
1714623949675,EDS 201,A00,507315,Staff,13,0,30,17
1714623950701,EDS 203,A01,507317,Halter; Christopher P.,12,0,30,18
1714623951727,EDS 204R,A01,507319,Halter; Christopher P.,0,3,30,30
1714623951727,EDS 204R,B01,507331,Heinzman; Erica M.,16,0,30,14
1714623952757,EDS 206R,A00,507332,Staff,0,4,30,30
1714623952757,EDS 206R,B00,507343,Staff,17,0,30,13
1714623953783,EDS 250,A00,507344,Hemans; Patricia Ann Benitez,22,0,40,18
1714623954808,EDS 281,A00,507345,Daly; Alan J.,18,0,18,0
1714623955833,EDS 284,A00,507350,Daly; Alan J.,16,0,16,0
1714623956861,EDS 286,A00,507359,Fine; Sarah,18,0,18,0
1714623957890,EDS 289C,A01,507361,Daly; Alan J.,18,0,18,0
1714623958917,EDS 290,A00,507366,Hofstetter; Carolyn,15,0,15,0
1714623959945,LIGM 5A,A00,507421,Fischer-Grunski; Eva K,18,0,20,2
1714623960973,LIGM 5B,A00,507423,Fischer-Grunski; Eva K,19,0,20,1
1714623961998,LIGM 5C,A00,507425,Fischer-Grunski; Eva K,19,0,20,1
1714623963029,LIIT 5AS,A00,507427,Carnelos; Chiara,20,0,20,0
1714623964057,LIIT 5BS,A00,507430,Carnelos; Chiara,20,0,20,0
1714623965083,LIIT 5CS,A00,507432,Carnelos; Chiara,20,0,20,0
1714623966109,LISP 5A,A00,507541,Munoz Sanchez; Alicia,11,0,20,9
1714623967137,LISP 5B,A00,507671,Munoz Sanchez; Alicia,8,0,20,12
1714623968165,LISP 5C,A00,507696,Munoz Sanchez; Alicia,9,0,20,11
1714623969193,MAE 197,001,528363,Boechler; Nicholas Sebastia,9998,0,9999,1
1714623970219,MATH 197,001,523477,Kedlaya; Kiran S.,9995,0,9999,4
1714623970219,MATH 197,002,563811,Zhang; Danna,9995,0,9999,4
1714623970219,MATH 197,003,628552,Dumitriu; Ioana,9998,0,9999,1
1714623971246,MCWP 40R,A00,518780,Staff,2,0,20,18
1714623971246,MCWP 40R,B00,518781,Staff,8,0,20,12
1714623971246,MCWP 40R,C00,518783,Staff,6,0,20,14
1714623972272,MCWP 50R,A00,518791,Staff,0,0,20,20
1714623972272,MCWP 50R,B00,518792,Staff,0,2,20,20
1714623972272,MCWP 50R,C00,518793,Staff,0,2,20,20
1714623972272,MCWP 50R,D00,518794,Staff,0,0,20,20
1714623972272,MCWP 50R,E00,518795,Staff,0,2,20,20
1714623972272,MCWP 50R,F00,518796,Staff,0,0,20,20
1714623972272,MCWP 50R,G00,518797,Staff,0,1,20,20
1714623973298,MMW 12R,A01,514034,Herbst; Matthew,0,0,16,16
1714623973298,MMW 12R,A02,514035,Herbst; Matthew,1,0,16,15
1714623974325,MMW 13R,A01,514037,Staff,0,4,16,16
1714623974325,MMW 13R,A02,514039,Staff,0,2,16,16
1714623974325,MMW 13R,A03,628519,Staff,0,2,16,16
1714623976379,SIO 295LS,A00,523233,Staff,10,0,30,20
1714623977406,SIO 295S,A00,523232,Staff,10,0,30,20
1714623978432,SIOC 290S,A01,637330,Merrifield; Mark A,23,0,30,7
1714623979459,SIOC 291S,A01,637333,Gabriel; Corey John,23,0,30,7
1714623980487,SOCI 117,A01,494376,Staff,0,4,5,5
1714623981512,WES 237B,A00,494380,Staff,9,0,20,11
1714623983596,AESE 279B,A00,494370,Wade; Jon P,0,0,33,33
1714623984623,AIP 197,001,627712,Vespa; Emanuel Ignacio,9998,0,9999,1
1714623985650,ANAR 135S,A00,494369,Braswell; Geoffrey E.,0,0,0,0
1714623986674,BENG 196,001,628496,Engler; Adam J.,9998,0,9999,1
1714623987699,CAT 124RS,A01,519847,Geibel; William,0,0,20,20
1714623988722,CAT 125RS,A01,515971,Geibel; William,0,0,20,20
1714623989749,CLRE 250,A00,511389,Morris; Sheldon,9993,0,9999,6
1714623990780,CLRE 251,A00,507176,Mehta; Ravindra L.,9993,0,9999,6
1714623990780,CLRE 251,B00,511410,Mehta; Ravindra L.,9998,0,9999,1
1714623991806,CLRE 252,A00,507189,Cuomo; Raphael Eduardo,9995,0,9999,4
1714623992831,CLRE 253,A00,507199,Vaida; Florin,9994,0,9999,5
1714623992831,CLRE 253,B00,507202,Vaida; Florin,9999,0,9999,0
1714623993866,CLRE 259,A00,507211,Patel; Hemal,9996,0,9999,3
1714623994894,CLRE 260,A00,507221,Cuomo; Raphael Eduardo,9999,0,9999,0
1714623995921,CLRE 297,001,507242,Cuomo; Raphael Eduardo,9999,0,9999,0
1714623996948,COGS 197,001,638244,Voytek; Bradley Thomas,9998,0,9999,1
1714623997975,CSE 191,A00,516875,Minnes Kemp; Mor Mia,9992,0,9999,7
1714623999001,CSE 197,001,637388,Minnes Kemp; Mor Mia,9998,0,9999,1
1714624000028,CSS 201S,A01,494383,Staff,35,0,35,0
1714624001057,CSS 202S,A01,494387,Staff,35,0,35,0
1714624002085,DSC 197,001,628532,Eldridge; Justin Matthew,9996,0,9999,3
1714624003113,EAP 100,A00,516065,Staff,9797,0,9999,202
1714624004136,ECE 45,A01,507414,Staff,33,0,60,27
1714624006206,ECE 111,A01,507420,Staff,15,0,50,35
1714624007232,ECE 197,001,548057,Sievenpiper; Daniel F.,9993,0,9999,6
1714624008259,EDS 115,A00,507243,Choi; Bailey Miyeon,10,0,28,18
1714624009288,EDS 117,A01,494379,Staff,1,5,30,29
1714624010318,EDS 125,A00,507246,Hopkins; Megan Beth,9,0,30,21
1714624011343,EDS 128A,A01,507264,Fargason; Sharon Gayle,8,0,26,18
1714624012369,EDS 128B,A01,507293,Pappas; Elizabeth,12,0,30,18
1714624013394,EDS 139,A00,507294,Fargason; Sharon Gayle,13,0,30,17
1714624013394,EDS 139,B00,507313,Pappas; Elizabeth,13,0,30,17
1714624014421,EDS 201,A00,507315,Staff,13,0,30,17
1714624015450,EDS 203,A01,507317,Halter; Christopher P.,12,0,30,18
1714624016476,EDS 204R,A01,507319,Halter; Christopher P.,0,3,30,30
1714624016476,EDS 204R,B01,507331,Heinzman; Erica M.,16,0,30,14
1714624017505,EDS 206R,A00,507332,Staff,0,4,30,30
1714624017505,EDS 206R,B00,507343,Staff,17,0,30,13
1714624018529,EDS 250,A00,507344,Hemans; Patricia Ann Benitez,22,0,40,18
1714624019556,EDS 281,A00,507345,Daly; Alan J.,18,0,18,0
1714624020581,EDS 284,A00,507350,Daly; Alan J.,16,0,16,0
1714624021605,EDS 286,A00,507359,Fine; Sarah,18,0,18,0
1714624022631,EDS 289C,A01,507361,Daly; Alan J.,18,0,18,0
1714624023656,EDS 290,A00,507366,Hofstetter; Carolyn,15,0,15,0
1714624024682,LIGM 5A,A00,507421,Fischer-Grunski; Eva K,18,0,20,2
1714624025712,LIGM 5B,A00,507423,Fischer-Grunski; Eva K,19,0,20,1
1714624026738,LIGM 5C,A00,507425,Fischer-Grunski; Eva K,19,0,20,1
1714624027769,LIIT 5AS,A00,507427,Carnelos; Chiara,20,0,20,0
1714624028795,LIIT 5BS,A00,507430,Carnelos; Chiara,20,0,20,0
1714624029822,LIIT 5CS,A00,507432,Carnelos; Chiara,20,0,20,0
1714624030852,LISP 5A,A00,507541,Munoz Sanchez; Alicia,11,0,20,9
1714624031879,LISP 5B,A00,507671,Munoz Sanchez; Alicia,8,0,20,12
1714624032905,LISP 5C,A00,507696,Munoz Sanchez; Alicia,9,0,20,11
1714624033937,MAE 197,001,528363,Boechler; Nicholas Sebastia,9998,0,9999,1
1714624035019,MATH 197,001,523477,Kedlaya; Kiran S.,9995,0,9999,4
1714624035019,MATH 197,002,563811,Zhang; Danna,9995,0,9999,4
1714624035019,MATH 197,003,628552,Dumitriu; Ioana,9998,0,9999,1
1714624036048,MCWP 40R,A00,518780,Staff,2,0,20,18
1714624036048,MCWP 40R,B00,518781,Staff,8,0,20,12
1714624036048,MCWP 40R,C00,518783,Staff,6,0,20,14
1714624037075,MCWP 50R,A00,518791,Staff,0,0,20,20
1714624037075,MCWP 50R,B00,518792,Staff,0,2,20,20
1714624037075,MCWP 50R,C00,518793,Staff,0,2,20,20
1714624037075,MCWP 50R,D00,518794,Staff,0,0,20,20
1714624037075,MCWP 50R,E00,518795,Staff,0,2,20,20
1714624037075,MCWP 50R,F00,518796,Staff,0,0,20,20
1714624037075,MCWP 50R,G00,518797,Staff,0,1,20,20
1714624038101,MMW 12R,A01,514034,Herbst; Matthew,0,0,16,16
1714624038101,MMW 12R,A02,514035,Herbst; Matthew,1,0,16,15
1714624039126,MMW 13R,A01,514037,Staff,0,4,16,16
1714624039126,MMW 13R,A02,514039,Staff,0,2,16,16
1714624039126,MMW 13R,A03,628519,Staff,0,2,16,16
1714624041177,SIO 295LS,A00,523233,Staff,10,0,30,20
1714624042202,SIO 295S,A00,523232,Staff,10,0,30,20
1714624043229,SIOC 290S,A01,637330,Merrifield; Mark A,23,0,30,7
1714624044262,SIOC 291S,A01,637333,Gabriel; Corey John,23,0,30,7
1714624045292,SOCI 117,A01,494376,Staff,0,4,5,5
1714624046318,WES 237B,A00,494380,Staff,9,0,20,11
1714624048395,AESE 279B,A00,494370,Wade; Jon P,0,0,33,33
1714624049423,AIP 197,001,627712,Vespa; Emanuel Ignacio,9998,0,9999,1
1714624050452,ANAR 135S,A00,494369,Braswell; Geoffrey E.,0,0,0,0
1714624051477,BENG 196,001,628496,Engler; Adam J.,9998,0,9999,1
1714624052502,CAT 124RS,A01,519847,Geibel; William,0,0,20,20
1714624053527,CAT 125RS,A01,515971,Geibel; William,0,0,20,20
1714624054553,CLRE 250,A00,511389,Morris; Sheldon,9993,0,9999,6
1714624055584,CLRE 251,A00,507176,Mehta; Ravindra L.,9993,0,9999,6
1714624055584,CLRE 251,B00,511410,Mehta; Ravindra L.,9998,0,9999,1
1714624056610,CLRE 252,A00,507189,Cuomo; Raphael Eduardo,9995,0,9999,4
1714624057637,CLRE 253,A00,507199,Vaida; Florin,9994,0,9999,5
1714624057637,CLRE 253,B00,507202,Vaida; Florin,9999,0,9999,0
1714624058664,CLRE 259,A00,507211,Patel; Hemal,9996,0,9999,3
1714624059690,CLRE 260,A00,507221,Cuomo; Raphael Eduardo,9999,0,9999,0
1714624060714,CLRE 297,001,507242,Cuomo; Raphael Eduardo,9999,0,9999,0
1714624061741,COGS 197,001,638244,Voytek; Bradley Thomas,9998,0,9999,1
1714624062767,CSE 191,A00,516875,Minnes Kemp; Mor Mia,9992,0,9999,7
1714624063795,CSE 197,001,637388,Minnes Kemp; Mor Mia,9998,0,9999,1
1714624064824,CSS 201S,A01,494383,Staff,35,0,35,0
1714624065853,CSS 202S,A01,494387,Staff,35,0,35,0
1714624066880,DSC 197,001,628532,Eldridge; Justin Matthew,9996,0,9999,3
1714624067905,EAP 100,A00,516065,Staff,9797,0,9999,202
1714624068930,ECE 45,A01,507414,Staff,33,0,60,27
1714624070983,ECE 111,A01,507420,Staff,15,0,50,35
1714624072014,ECE 197,001,548057,Sievenpiper; Daniel F.,9993,0,9999,6
1714624073039,EDS 115,A00,507243,Choi; Bailey Miyeon,10,0,28,18
1714624074069,EDS 117,A01,494379,Staff,1,5,30,29
1714624075097,EDS 125,A00,507246,Hopkins; Megan Beth,9,0,30,21
1714624076129,EDS 128A,A01,507264,Fargason; Sharon Gayle,8,0,26,18
1714624077160,EDS 128B,A01,507293,Pappas; Elizabeth,12,0,30,18
1714624078184,EDS 139,A00,507294,Fargason; Sharon Gayle,13,0,30,17
1714624078184,EDS 139,B00,507313,Pappas; Elizabeth,13,0,30,17
1714624079212,EDS 201,A00,507315,Staff,13,0,30,17
1714624080241,EDS 203,A01,507317,Halter; Christopher P.,12,0,30,18
1714624081269,EDS 204R,A01,507319,Halter; Christopher P.,0,3,30,30
1714624081269,EDS 204R,B01,507331,Heinzman; Erica M.,16,0,30,14
1714624082294,EDS 206R,A00,507332,Staff,0,4,30,30
1714624082294,EDS 206R,B00,507343,Staff,17,0,30,13
1714624083320,EDS 250,A00,507344,Hemans; Patricia Ann Benitez,22,0,40,18
1714624084343,EDS 281,A00,507345,Daly; Alan J.,18,0,18,0
1714624085371,EDS 284,A00,507350,Daly; Alan J.,16,0,16,0
1714624086401,EDS 286,A00,507359,Fine; Sarah,18,0,18,0
1714624087428,EDS 289C,A01,507361,Daly; Alan J.,18,0,18,0
1714624088457,EDS 290,A00,507366,Hofstetter; Carolyn,15,0,15,0
1714624089501,LIGM 5A,A00,507421,Fischer-Grunski; Eva K,18,0,20,2
1714624090529,LIGM 5B,A00,507423,Fischer-Grunski; Eva K,19,0,20,1
1714624091559,LIGM 5C,A00,507425,Fischer-Grunski; Eva K,19,0,20,1
1714624092585,LIIT 5AS,A00,507427,Carnelos; Chiara,20,0,20,0
1714624093619,LIIT 5BS,A00,507430,Carnelos; Chiara,20,0,20,0
1714624094644,LIIT 5CS,A00,507432,Carnelos; Chiara,20,0,20,0
1714624095669,LISP 5A,A00,507541,Munoz Sanchez; Alicia,11,0,20,9
1714624096695,LISP 5B,A00,507671,Munoz Sanchez; Alicia,8,0,20,12
1714624097725,LISP 5C,A00,507696,Munoz Sanchez; Alicia,9,0,20,11
1714624098757,MAE 197,001,528363,Boechler; Nicholas Sebastia,9998,0,9999,1
1714624099785,MATH 197,001,523477,Kedlaya; Kiran S.,9995,0,9999,4
1714624099785,MATH 197,002,563811,Zhang; Danna,9995,0,9999,4
1714624099785,MATH 197,003,628552,Dumitriu; Ioana,9998,0,9999,1
1714624100816,MCWP 40R,A00,518780,Staff,2,0,20,18
1714624100816,MCWP 40R,B00,518781,Staff,8,0,20,12
1714624100816,MCWP 40R,C00,518783,Staff,6,0,20,14
1714624101846,MCWP 50R,A00,518791,Staff,0,0,20,20
1714624101846,MCWP 50R,B00,518792,Staff,0,2,20,20
1714624101846,MCWP 50R,C00,518793,Staff,0,2,20,20
1714624101846,MCWP 50R,D00,518794,Staff,0,0,20,20
1714624101846,MCWP 50R,E00,518795,Staff,0,2,20,20
1714624101846,MCWP 50R,F00,518796,Staff,0,0,20,20
1714624101846,MCWP 50R,G00,518797,Staff,0,1,20,20
1714624102871,MMW 12R,A01,514034,Herbst; Matthew,0,0,16,16
1714624102871,MMW 12R,A02,514035,Herbst; Matthew,1,0,16,15
1714624103899,MMW 13R,A01,514037,Staff,0,4,16,16
1714624103899,MMW 13R,A02,514039,Staff,0,2,16,16
1714624103899,MMW 13R,A03,628519,Staff,0,2,16,16
1714624105954,SIO 295LS,A00,523233,Staff,10,0,30,20
1714624106978,SIO 295S,A00,523232,Staff,10,0,30,20
1714624108003,SIOC 290S,A01,637330,Merrifield; Mark A,23,0,30,7
1714624109034,SIOC 291S,A01,637333,Gabriel; Corey John,23,0,30,7
1714624110057,SOCI 117,A01,494376,Staff,0,4,5,5
1714624111085,WES 237B,A00,494380,Staff,9,0,20,11
1714624113164,AESE 279B,A00,494370,Wade; Jon P,0,0,33,33
1714624114191,AIP 197,001,627712,Vespa; Emanuel Ignacio,9998,0,9999,1
1714624115217,ANAR 135S,A00,494369,Braswell; Geoffrey E.,0,0,0,0
1714624116241,BENG 196,001,628496,Engler; Adam J.,9998,0,9999,1
1714624117268,CAT 124RS,A01,519847,Geibel; William,0,0,20,20
1714624118293,CAT 125RS,A01,515971,Geibel; William,0,0,20,20
1714624119321,CLRE 250,A00,511389,Morris; Sheldon,9993,0,9999,6
1714624120351,CLRE 251,A00,507176,Mehta; Ravindra L.,9993,0,9999,6
1714624120351,CLRE 251,B00,511410,Mehta; Ravindra L.,9998,0,9999,1
1714624121378,CLRE 252,A00,507189,Cuomo; Raphael Eduardo,9995,0,9999,4
1714624122405,CLRE 253,A00,507199,Vaida; Florin,9994,0,9999,5
1714624122405,CLRE 253,B00,507202,Vaida; Florin,9999,0,9999,0
1714624123432,CLRE 259,A00,507211,Patel; Hemal,9996,0,9999,3
1714624124459,CLRE 260,A00,507221,Cuomo; Raphael Eduardo,9999,0,9999,0
1714624125484,CLRE 297,001,507242,Cuomo; Raphael Eduardo,9999,0,9999,0
1714624126512,COGS 197,001,638244,Voytek; Bradley Thomas,9998,0,9999,1
1714624127540,CSE 191,A00,516875,Minnes Kemp; Mor Mia,9992,0,9999,7
1714624128566,CSE 197,001,637388,Minnes Kemp; Mor Mia,9998,0,9999,1
1714624129597,CSS 201S,A01,494383,Staff,35,0,35,0
1714624130624,CSS 202S,A01,494387,Staff,35,0,35,0
1714624131649,DSC 197,001,628532,Eldridge; Justin Matthew,9996,0,9999,3
1714624132674,EAP 100,A00,516065,Staff,9797,0,9999,202
1714624133701,ECE 45,A01,507414,Staff,33,0,60,27
1714624135751,ECE 111,A01,507420,Staff,15,0,50,35
1714624136778,ECE 197,001,548057,Sievenpiper; Daniel F.,9993,0,9999,6
1714624137809,EDS 115,A00,507243,Choi; Bailey Miyeon,10,0,28,18
1714624138840,EDS 117,A01,494379,Staff,1,5,30,29
1714624139866,EDS 125,A00,507246,Hopkins; Megan Beth,9,0,30,21
1714624140895,EDS 128A,A01,507264,Fargason; Sharon Gayle,8,0,26,18
1714624141921,EDS 128B,A01,507293,Pappas; Elizabeth,12,0,30,18
1714624142949,EDS 139,A00,507294,Fargason; Sharon Gayle,13,0,30,17
1714624142949,EDS 139,B00,507313,Pappas; Elizabeth,13,0,30,17
1714624143975,EDS 201,A00,507315,Staff,13,0,30,17
1714624145001,EDS 203,A01,507317,Halter; Christopher P.,12,0,30,18
1714624146029,EDS 204R,A01,507319,Halter; Christopher P.,0,3,30,30
1714624146029,EDS 204R,B01,507331,Heinzman; Erica M.,16,0,30,14
1714624147054,EDS 206R,A00,507332,Staff,0,4,30,30
1714624147054,EDS 206R,B00,507343,Staff,17,0,30,13
1714624148079,EDS 250,A00,507344,Hemans; Patricia Ann Benitez,22,0,40,18
1714624149105,EDS 281,A00,507345,Daly; Alan J.,18,0,18,0
1714624150133,EDS 284,A00,507350,Daly; Alan J.,16,0,16,0
1714624151162,EDS 286,A00,507359,Fine; Sarah,18,0,18,0
1714624152187,EDS 289C,A01,507361,Daly; Alan J.,18,0,18,0
1714624153217,EDS 290,A00,507366,Hofstetter; Carolyn,15,0,15,0
1714624154244,LIGM 5A,A00,507421,Fischer-Grunski; Eva K,18,0,20,2
1714624155275,LIGM 5B,A00,507423,Fischer-Grunski; Eva K,19,0,20,1
1714624156356,LIGM 5C,A00,507425,Fischer-Grunski; Eva K,19,0,20,1
1714624157386,LIIT 5AS,A00,507427,Carnelos; Chiara,20,0,20,0
1714624158413,LIIT 5BS,A00,507430,Carnelos; Chiara,20,0,20,0
1714624159440,LIIT 5CS,A00,507432,Carnelos; Chiara,20,0,20,0
1714624160466,LISP 5A,A00,507541,Munoz Sanchez; Alicia,11,0,20,9
1714624161493,LISP 5B,A00,507671,Munoz Sanchez; Alicia,8,0,20,12
1714624162519,LISP 5C,A00,507696,Munoz Sanchez; Alicia,9,0,20,11
1714624163544,MAE 197,001,528363,Boechler; Nicholas Sebastia,9998,0,9999,1
1714624164571,MATH 197,001,523477,Kedlaya; Kiran S.,9995,0,9999,4
1714624164571,MATH 197,002,563811,Zhang; Danna,9995,0,9999,4
1714624164571,MATH 197,003,628552,Dumitriu; Ioana,9998,0,9999,1
1714624165597,MCWP 40R,A00,518780,Staff,2,0,20,18
1714624165597,MCWP 40R,B00,518781,Staff,8,0,20,12
1714624165597,MCWP 40R,C00,518783,Staff,6,0,20,14
1714624166621,MCWP 50R,A00,518791,Staff,0,0,20,20
1714624166621,MCWP 50R,B00,518792,Staff,0,2,20,20
1714624166621,MCWP 50R,C00,518793,Staff,0,2,20,20
1714624166621,MCWP 50R,D00,518794,Staff,0,0,20,20
1714624166621,MCWP 50R,E00,518795,Staff,0,2,20,20
1714624166621,MCWP 50R,F00,518796,Staff,0,0,20,20
1714624166621,MCWP 50R,G00,518797,Staff,0,1,20,20
1714624167649,MMW 12R,A01,514034,Herbst; Matthew,0,0,16,16
1714624167649,MMW 12R,A02,514035,Herbst; Matthew,1,0,16,15
1714624168675,MMW 13R,A01,514037,Staff,0,4,16,16
1714624168675,MMW 13R,A02,514039,Staff,0,2,16,16
1714624168675,MMW 13R,A03,628519,Staff,0,2,16,16
1714624170730,SIO 295LS,A00,523233,Staff,10,0,30,20
1714624171760,SIO 295S,A00,523232,Staff,10,0,30,20
1714624172785,SIOC 290S,A01,637330,Merrifield; Mark A,23,0,30,7
1714624173812,SIOC 291S,A01,637333,Gabriel; Corey John,23,0,30,7
1714624174840,SOCI 117,A01,494376,Staff,0,4,5,5
1714624175869,WES 237B,A00,494380,Staff,9,0,20,11
1714624177942,AESE 279B,A00,494370,Wade; Jon P,0,0,33,33
1714624178966,AIP 197,001,627712,Vespa; Emanuel Ignacio,9998,0,9999,1
1714624179993,ANAR 135S,A00,494369,Braswell; Geoffrey E.,0,0,0,0
1714624181018,BENG 196,001,628496,Engler; Adam J.,9998,0,9999,1
1714624182045,CAT 124RS,A01,519847,Geibel; William,0,0,20,20
1714624183069,CAT 125RS,A01,515971,Geibel; William,0,0,20,20
1714624184093,CLRE 250,A00,511389,Morris; Sheldon,9993,0,9999,6
1714624185122,CLRE 251,A00,507176,Mehta; Ravindra L.,9993,0,9999,6
1714624185122,CLRE 251,B00,511410,Mehta; Ravindra L.,9998,0,9999,1
1714624186148,CLRE 252,A00,507189,Cuomo; Raphael Eduardo,9995,0,9999,4
1714624187174,CLRE 253,A00,507199,Vaida; Florin,9994,0,9999,5
1714624187174,CLRE 253,B00,507202,Vaida; Florin,9999,0,9999,0
1714624188201,CLRE 259,A00,507211,Patel; Hemal,9996,0,9999,3
1714624189228,CLRE 260,A00,507221,Cuomo; Raphael Eduardo,9999,0,9999,0
1714624190252,CLRE 297,001,507242,Cuomo; Raphael Eduardo,9999,0,9999,0
1714624191868,COGS 197,001,638244,Voytek; Bradley Thomas,9998,0,9999,1
1714624192893,CSE 191,A00,516875,Minnes Kemp; Mor Mia,9992,0,9999,7
1714624193919,CSE 197,001,637388,Minnes Kemp; Mor Mia,9998,0,9999,1
1714624194946,CSS 201S,A01,494383,Staff,35,0,35,0
1714624195974,CSS 202S,A01,494387,Staff,35,0,35,0
1714624197002,DSC 197,001,628532,Eldridge; Justin Matthew,9996,0,9999,3
1714624198029,EAP 100,A00,516065,Staff,9797,0,9999,202
1714624199057,ECE 45,A01,507414,Staff,33,0,60,27
1714624201114,ECE 111,A01,507420,Staff,15,0,50,35
1714624202139,ECE 197,001,548057,Sievenpiper; Daniel F.,9993,0,9999,6
1714624203166,EDS 115,A00,507243,Choi; Bailey Miyeon,10,0,28,18
1714624204194,EDS 117,A01,494379,Staff,1,5,30,29
1714624205220,EDS 125,A00,507246,Hopkins; Megan Beth,9,0,30,21
1714624206249,EDS 128A,A01,507264,Fargason; Sharon Gayle,8,0,26,18
1714624207275,EDS 128B,A01,507293,Pappas; Elizabeth,12,0,30,18
1714624208354,EDS 139,A00,507294,Fargason; Sharon Gayle,13,0,30,17
1714624208354,EDS 139,B00,507313,Pappas; Elizabeth,13,0,30,17
1714624209378,EDS 201,A00,507315,Staff,13,0,30,17
1714624210406,EDS 203,A01,507317,Halter; Christopher P.,12,0,30,18
1714624211431,EDS 204R,A01,507319,Halter; Christopher P.,0,3,30,30
1714624211431,EDS 204R,B01,507331,Heinzman; Erica M.,16,0,30,14
1714624212455,EDS 206R,A00,507332,Staff,0,4,30,30
1714624212455,EDS 206R,B00,507343,Staff,17,0,30,13
1714624213482,EDS 250,A00,507344,Hemans; Patricia Ann Benitez,22,0,40,18
1714624214509,EDS 281,A00,507345,Daly; Alan J.,18,0,18,0
1714624215533,EDS 284,A00,507350,Daly; Alan J.,16,0,16,0
1714624216559,EDS 286,A00,507359,Fine; Sarah,18,0,18,0
1714624217583,EDS 289C,A01,507361,Daly; Alan J.,18,0,18,0
1714624218607,EDS 290,A00,507366,Hofstetter; Carolyn,15,0,15,0
1714624219637,LIGM 5A,A00,507421,Fischer-Grunski; Eva K,18,0,20,2
1714624220663,LIGM 5B,A00,507423,Fischer-Grunski; Eva K,19,0,20,1
1714624221689,LIGM 5C,A00,507425,Fischer-Grunski; Eva K,19,0,20,1
1714624222717,LIIT 5AS,A00,507427,Carnelos; Chiara,20,0,20,0
1714624223741,LIIT 5BS,A00,507430,Carnelos; Chiara,20,0,20,0
1714624224771,LIIT 5CS,A00,507432,Carnelos; Chiara,20,0,20,0
1714624225798,LISP 5A,A00,507541,Munoz Sanchez; Alicia,11,0,20,9
1714624226827,LISP 5B,A00,507671,Munoz Sanchez; Alicia,8,0,20,12
1714624227853,LISP 5C,A00,507696,Munoz Sanchez; Alicia,9,0,20,11
1714624228878,MAE 197,001,528363,Boechler; Nicholas Sebastia,9998,0,9999,1
1714624229906,MATH 197,001,523477,Kedlaya; Kiran S.,9995,0,9999,4
1714624229906,MATH 197,002,563811,Zhang; Danna,9995,0,9999,4
1714624229906,MATH 197,003,628552,Dumitriu; Ioana,9998,0,9999,1
1714624230931,MCWP 40R,A00,518780,Staff,2,0,20,18
1714624230931,MCWP 40R,B00,518781,Staff,8,0,20,12
1714624230931,MCWP 40R,C00,518783,Staff,6,0,20,14
1714624231957,MCWP 50R,A00,518791,Staff,0,0,20,20
1714624231957,MCWP 50R,B00,518792,Staff,0,2,20,20
1714624231957,MCWP 50R,C00,518793,Staff,0,2,20,20
1714624231957,MCWP 50R,D00,518794,Staff,0,0,20,20
1714624231957,MCWP 50R,E00,518795,Staff,0,2,20,20
1714624231957,MCWP 50R,F00,518796,Staff,0,0,20,20
1714624231957,MCWP 50R,G00,518797,Staff,0,1,20,20
1714624232981,MMW 12R,A01,514034,Herbst; Matthew,0,0,16,16
1714624232981,MMW 12R,A02,514035,Herbst; Matthew,1,0,16,15
1714624234006,MMW 13R,A01,514037,Staff,0,4,16,16
1714624234006,MMW 13R,A02,514039,Staff,0,2,16,16
1714624234006,MMW 13R,A03,628519,Staff,0,2,16,16
1714624236059,SIO 295LS,A00,523233,Staff,10,0,30,20
1714624237086,SIO 295S,A00,523232,Staff,10,0,30,20
1714624238114,SIOC 290S,A01,637330,Merrifield; Mark A,23,0,30,7
1714624239142,SIOC 291S,A01,637333,Gabriel; Corey John,23,0,30,7
1714624240167,SOCI 117,A01,494376,Staff,0,4,5,5
1714624241192,WES 237B,A00,494380,Staff,9,0,20,11
1714624243268,AESE 279B,A00,494370,Wade; Jon P,0,0,33,33
1714624244294,AIP 197,001,627712,Vespa; Emanuel Ignacio,9998,0,9999,1
1714624245318,ANAR 135S,A00,494369,Braswell; Geoffrey E.,0,0,0,0
1714624246344,BENG 196,001,628496,Engler; Adam J.,9998,0,9999,1
1714624247370,CAT 124RS,A01,519847,Geibel; William,0,0,20,20
1714624248399,CAT 125RS,A01,515971,Geibel; William,0,0,20,20
1714624249422,CLRE 250,A00,511389,Morris; Sheldon,9993,0,9999,6
1714624250447,CLRE 251,A00,507176,Mehta; Ravindra L.,9993,0,9999,6
1714624250447,CLRE 251,B00,511410,Mehta; Ravindra L.,9998,0,9999,1
1714624251476,CLRE 252,A00,507189,Cuomo; Raphael Eduardo,9995,0,9999,4
1714624252501,CLRE 253,A00,507199,Vaida; Florin,9994,0,9999,5
1714624252501,CLRE 253,B00,507202,Vaida; Florin,9999,0,9999,0
1714624253530,CLRE 259,A00,507211,Patel; Hemal,9996,0,9999,3
1714624254556,CLRE 260,A00,507221,Cuomo; Raphael Eduardo,9999,0,9999,0
1714624255580,CLRE 297,001,507242,Cuomo; Raphael Eduardo,9999,0,9999,0
1714624256607,COGS 197,001,638244,Voytek; Bradley Thomas,9998,0,9999,1
1714624257637,CSE 191,A00,516875,Minnes Kemp; Mor Mia,9992,0,9999,7
1714624258700,CSE 197,001,637388,Minnes Kemp; Mor Mia,9998,0,9999,1
1714624259730,CSS 201S,A01,494383,Staff,35,0,35,0
1714624260761,CSS 202S,A01,494387,Staff,35,0,35,0
1714624261791,DSC 197,001,628532,Eldridge; Justin Matthew,9996,0,9999,3
1714624262821,EAP 100,A00,516065,Staff,9797,0,9999,202
1714624263850,ECE 45,A01,507414,Staff,33,0,60,27
1714624265905,ECE 111,A01,507420,Staff,15,0,50,35
1714624266929,ECE 197,001,548057,Sievenpiper; Daniel F.,9993,0,9999,6
1714624267960,EDS 115,A00,507243,Choi; Bailey Miyeon,10,0,28,18
1714624268988,EDS 117,A01,494379,Staff,1,5,30,29
1714624270014,EDS 125,A00,507246,Hopkins; Megan Beth,9,0,30,21
1714624271044,EDS 128A,A01,507264,Fargason; Sharon Gayle,8,0,26,18
1714624272073,EDS 128B,A01,507293,Pappas; Elizabeth,12,0,30,18
1714624273101,EDS 139,A00,507294,Fargason; Sharon Gayle,13,0,30,17
1714624273101,EDS 139,B00,507313,Pappas; Elizabeth,13,0,30,17
1714624274129,EDS 201,A00,507315,Staff,13,0,30,17
1714624275156,EDS 203,A01,507317,Halter; Christopher P.,12,0,30,18
1714624276182,EDS 204R,A01,507319,Halter; Christopher P.,0,3,30,30
1714624276182,EDS 204R,B01,507331,Heinzman; Erica M.,16,0,30,14
1714624277206,EDS 206R,A00,507332,Staff,0,4,30,30
1714624277206,EDS 206R,B00,507343,Staff,17,0,30,13
1714624278236,EDS 250,A00,507344,Hemans; Patricia Ann Benitez,22,0,40,18
1714624279261,EDS 281,A00,507345,Daly; Alan J.,18,0,18,0
1714624280289,EDS 284,A00,507350,Daly; Alan J.,16,0,16,0
1714624281315,EDS 286,A00,507359,Fine; Sarah,18,0,18,0
1714624282340,EDS 289C,A01,507361,Daly; Alan J.,18,0,18,0
1714624283368,EDS 290,A00,507366,Hofstetter; Carolyn,15,0,15,0
1714624284401,LIGM 5A,A00,507421,Fischer-Grunski; Eva K,18,0,20,2
1714624285430,LIGM 5B,A00,507423,Fischer-Grunski; Eva K,19,0,20,1
1714624286456,LIGM 5C,A00,507425,Fischer-Grunski; Eva K,19,0,20,1
1714624287481,LIIT 5AS,A00,507427,Carnelos; Chiara,20,0,20,0
1714624288507,LIIT 5BS,A00,507430,Carnelos; Chiara,20,0,20,0
1714624289533,LIIT 5CS,A00,507432,Carnelos; Chiara,20,0,20,0
1714624290559,LISP 5A,A00,507541,Munoz Sanchez; Alicia,11,0,20,9
1714624291589,LISP 5B,A00,507671,Munoz Sanchez; Alicia,8,0,20,12
1714624292618,LISP 5C,A00,507696,Munoz Sanchez; Alicia,9,0,20,11
1714624293649,MAE 197,001,528363,Boechler; Nicholas Sebastia,9998,0,9999,1
1714624294676,MATH 197,001,523477,Kedlaya; Kiran S.,9995,0,9999,4
1714624294676,MATH 197,002,563811,Zhang; Danna,9995,0,9999,4
1714624294676,MATH 197,003,628552,Dumitriu; Ioana,9998,0,9999,1
1714624295703,MCWP 40R,A00,518780,Staff,2,0,20,18
1714624295703,MCWP 40R,B00,518781,Staff,8,0,20,12
1714624295703,MCWP 40R,C00,518783,Staff,6,0,20,14
1714624296728,MCWP 50R,A00,518791,Staff,0,0,20,20
1714624296728,MCWP 50R,B00,518792,Staff,0,2,20,20
1714624296728,MCWP 50R,C00,518793,Staff,0,2,20,20
1714624296728,MCWP 50R,D00,518794,Staff,0,0,20,20
1714624296728,MCWP 50R,E00,518795,Staff,0,2,20,20
1714624296728,MCWP 50R,F00,518796,Staff,0,0,20,20
1714624296728,MCWP 50R,G00,518797,Staff,0,1,20,20
1714624297755,MMW 12R,A01,514034,Herbst; Matthew,0,0,16,16
1714624297755,MMW 12R,A02,514035,Herbst; Matthew,1,0,16,15
1714624298783,MMW 13R,A01,514037,Staff,0,4,16,16
1714624298783,MMW 13R,A02,514039,Staff,0,2,16,16
1714624298783,MMW 13R,A03,628519,Staff,0,2,16,16
1714624300840,SIO 295LS,A00,523233,Staff,10,0,30,20
1714624301864,SIO 295S,A00,523232,Staff,10,0,30,20
1714624302890,SIOC 290S,A01,637330,Merrifield; Mark A,23,0,30,7
1714624303915,SIOC 291S,A01,637333,Gabriel; Corey John,23,0,30,7
1714624304942,SOCI 117,A01,494376,Staff,0,4,5,5
1714624305969,WES 237B,A00,494380,Staff,9,0,20,11
1714624308039,AESE 279B,A00,494370,Wade; Jon P,0,0,33,33
1714624309066,AIP 197,001,627712,Vespa; Emanuel Ignacio,9998,0,9999,1
1714624310095,ANAR 135S,A00,494369,Braswell; Geoffrey E.,0,0,0,0
1714624311121,BENG 196,001,628496,Engler; Adam J.,9998,0,9999,1
1714624312205,CAT 124RS,A01,519847,Geibel; William,0,0,20,20
1714624313230,CAT 125RS,A01,515971,Geibel; William,0,0,20,20
1714624314262,CLRE 250,A00,511389,Morris; Sheldon,9993,0,9999,6
1714624315291,CLRE 251,A00,507176,Mehta; Ravindra L.,9993,0,9999,6
1714624315291,CLRE 251,B00,511410,Mehta; Ravindra L.,9998,0,9999,1
1714624316317,CLRE 252,A00,507189,Cuomo; Raphael Eduardo,9995,0,9999,4
1714624317347,CLRE 253,A00,507199,Vaida; Florin,9994,0,9999,5
1714624317347,CLRE 253,B00,507202,Vaida; Florin,9999,0,9999,0
1714624318375,CLRE 259,A00,507211,Patel; Hemal,9996,0,9999,3
1714624319404,CLRE 260,A00,507221,Cuomo; Raphael Eduardo,9999,0,9999,0
1714624320433,CLRE 297,001,507242,Cuomo; Raphael Eduardo,9999,0,9999,0
1714624321460,COGS 197,001,638244,Voytek; Bradley Thomas,9998,0,9999,1
1714624322486,CSE 191,A00,516875,Minnes Kemp; Mor Mia,9992,0,9999,7
1714624323515,CSE 197,001,637388,Minnes Kemp; Mor Mia,9998,0,9999,1
1714624324547,CSS 201S,A01,494383,Staff,35,0,35,0
1714624325574,CSS 202S,A01,494387,Staff,35,0,35,0
1714624326603,DSC 197,001,628532,Eldridge; Justin Matthew,9996,0,9999,3
1714624327626,EAP 100,A00,516065,Staff,9797,0,9999,202
1714624328655,ECE 45,A01,507414,Staff,33,0,60,27
1714624330706,ECE 111,A01,507420,Staff,15,0,50,35
1714624331736,ECE 197,001,548057,Sievenpiper; Daniel F.,9993,0,9999,6
1714624332766,EDS 115,A00,507243,Choi; Bailey Miyeon,10,0,28,18
1714624333794,EDS 117,A01,494379,Staff,1,5,30,29
1714624334821,EDS 125,A00,507246,Hopkins; Megan Beth,9,0,30,21
1714624335845,EDS 128A,A01,507264,Fargason; Sharon Gayle,8,0,26,18
1714624336870,EDS 128B,A01,507293,Pappas; Elizabeth,12,0,30,18
1714624337898,EDS 139,A00,507294,Fargason; Sharon Gayle,13,0,30,17
1714624337898,EDS 139,B00,507313,Pappas; Elizabeth,13,0,30,17
1714624338924,EDS 201,A00,507315,Staff,13,0,30,17
1714624339954,EDS 203,A01,507317,Halter; Christopher P.,12,0,30,18
1714624340979,EDS 204R,A01,507319,Halter; Christopher P.,0,3,30,30
1714624340979,EDS 204R,B01,507331,Heinzman; Erica M.,16,0,30,14
1714624342003,EDS 206R,A00,507332,Staff,0,4,30,30
1714624342003,EDS 206R,B00,507343,Staff,17,0,30,13
1714624343032,EDS 250,A00,507344,Hemans; Patricia Ann Benitez,22,0,40,18
1714624344057,EDS 281,A00,507345,Daly; Alan J.,18,0,18,0
1714624345081,EDS 284,A00,507350,Daly; Alan J.,16,0,16,0
1714624346106,EDS 286,A00,507359,Fine; Sarah,18,0,18,0
1714624347186,EDS 289C,A01,507361,Daly; Alan J.,18,0,18,0
1714624348211,EDS 290,A00,507366,Hofstetter; Carolyn,15,0,15,0
1714624349241,LIGM 5A,A00,507421,Fischer-Grunski; Eva K,18,0,20,2
1714624350269,LIGM 5B,A00,507423,Fischer-Grunski; Eva K,19,0,20,1
1714624351294,LIGM 5C,A00,507425,Fischer-Grunski; Eva K,19,0,20,1
1714624352320,LIIT 5AS,A00,507427,Carnelos; Chiara,20,0,20,0
1714624353345,LIIT 5BS,A00,507430,Carnelos; Chiara,20,0,20,0
1714624354371,LIIT 5CS,A00,507432,Carnelos; Chiara,20,0,20,0
1714624355397,LISP 5A,A00,507541,Munoz Sanchez; Alicia,11,0,20,9
1714624356423,LISP 5B,A00,507671,Munoz Sanchez; Alicia,8,0,20,12
1714624357449,LISP 5C,A00,507696,Munoz Sanchez; Alicia,9,0,20,11
1714624358473,MAE 197,001,528363,Boechler; Nicholas Sebastia,9998,0,9999,1
1714624359501,MATH 197,001,523477,Kedlaya; Kiran S.,9995,0,9999,4
1714624359501,MATH 197,002,563811,Zhang; Danna,9995,0,9999,4
1714624359501,MATH 197,003,628552,Dumitriu; Ioana,9998,0,9999,1
1714624360525,MCWP 40R,A00,518780,Staff,2,0,20,18
1714624360525,MCWP 40R,B00,518781,Staff,8,0,20,12
1714624360525,MCWP 40R,C00,518783,Staff,6,0,20,14
1714624361552,MCWP 50R,A00,518791,Staff,0,0,20,20
1714624361552,MCWP 50R,B00,518792,Staff,0,2,20,20
1714624361552,MCWP 50R,C00,518793,Staff,0,2,20,20
1714624361552,MCWP 50R,D00,518794,Staff,0,0,20,20
1714624361552,MCWP 50R,E00,518795,Staff,0,2,20,20
1714624361552,MCWP 50R,F00,518796,Staff,0,0,20,20
1714624361552,MCWP 50R,G00,518797,Staff,0,1,20,20
1714624362577,MMW 12R,A01,514034,Herbst; Matthew,0,0,16,16
1714624362577,MMW 12R,A02,514035,Herbst; Matthew,1,0,16,15
1714624363603,MMW 13R,A01,514037,Staff,0,4,16,16
1714624363603,MMW 13R,A02,514039,Staff,0,2,16,16
1714624363603,MMW 13R,A03,628519,Staff,0,2,16,16
1714624365659,SIO 295LS,A00,523233,Staff,10,0,30,20
1714624366683,SIO 295S,A00,523232,Staff,10,0,30,20
1714624367710,SIOC 290S,A01,637330,Merrifield; Mark A,23,0,30,7
1714624368740,SIOC 291S,A01,637333,Gabriel; Corey John,23,0,30,7
1714624369766,SOCI 117,A01,494376,Staff,0,4,5,5
1714624370793,WES 237B,A00,494380,Staff,9,0,20,11
1714624372869,AESE 279B,A00,494370,Wade; Jon P,0,0,33,33
1714624373907,AIP 197,001,627712,Vespa; Emanuel Ignacio,9998,0,9999,1
1714624374932,ANAR 135S,A00,494369,Braswell; Geoffrey E.,0,0,0,0
1714624375962,BENG 196,001,628496,Engler; Adam J.,9998,0,9999,1
1714624376989,CAT 124RS,A01,519847,Geibel; William,0,0,20,20
1714624378014,CAT 125RS,A01,515971,Geibel; William,0,0,20,20
1714624379039,CLRE 250,A00,511389,Morris; Sheldon,9993,0,9999,6
1714624380065,CLRE 251,A00,507176,Mehta; Ravindra L.,9993,0,9999,6
1714624380065,CLRE 251,B00,511410,Mehta; Ravindra L.,9998,0,9999,1
1714624381090,CLRE 252,A00,507189,Cuomo; Raphael Eduardo,9995,0,9999,4
1714624382122,CLRE 253,A00,507199,Vaida; Florin,9994,0,9999,5
1714624382122,CLRE 253,B00,507202,Vaida; Florin,9999,0,9999,0
1714624383151,CLRE 259,A00,507211,Patel; Hemal,9996,0,9999,3
1714624384176,CLRE 260,A00,507221,Cuomo; Raphael Eduardo,9999,0,9999,0
1714624385204,CLRE 297,001,507242,Cuomo; Raphael Eduardo,9999,0,9999,0
1714624386229,COGS 197,001,638244,Voytek; Bradley Thomas,9998,0,9999,1
1714624387253,CSE 191,A00,516875,Minnes Kemp; Mor Mia,9992,0,9999,7
1714624388276,CSE 197,001,637388,Minnes Kemp; Mor Mia,9998,0,9999,1
1714624389308,CSS 201S,A01,494383,Staff,35,0,35,0
1714624390338,CSS 202S,A01,494387,Staff,35,0,35,0
1714624391363,DSC 197,001,628532,Eldridge; Justin Matthew,9996,0,9999,3
1714624392390,EAP 100,A00,516065,Staff,9797,0,9999,202
1714624393417,ECE 45,A01,507414,Staff,33,0,60,27
1714624395469,ECE 111,A01,507420,Staff,15,0,50,35
1714624396492,ECE 197,001,548057,Sievenpiper; Daniel F.,9993,0,9999,6
1714624397523,EDS 115,A00,507243,Choi; Bailey Miyeon,10,0,28,18
1714624398549,EDS 117,A01,494379,Staff,1,5,30,29
1714624399575,EDS 125,A00,507246,Hopkins; Megan Beth,9,0,30,21
1714624400603,EDS 128A,A01,507264,Fargason; Sharon Gayle,8,0,26,18
1714624401628,EDS 128B,A01,507293,Pappas; Elizabeth,12,0,30,18
1714624402655,EDS 139,A00,507294,Fargason; Sharon Gayle,13,0,30,17
1714624402655,EDS 139,B00,507313,Pappas; Elizabeth,13,0,30,17
1714624403681,EDS 201,A00,507315,Staff,13,0,30,17
1714624404709,EDS 203,A01,507317,Halter; Christopher P.,12,0,30,18
1714624405734,EDS 204R,A01,507319,Halter; Christopher P.,0,3,30,30
1714624405734,EDS 204R,B01,507331,Heinzman; Erica M.,16,0,30,14
1714624406758,EDS 206R,A00,507332,Staff,0,4,30,30
1714624406758,EDS 206R,B00,507343,Staff,17,0,30,13
1714624407786,EDS 250,A00,507344,Hemans; Patricia Ann Benitez,22,0,40,18
1714624408810,EDS 281,A00,507345,Daly; Alan J.,18,0,18,0
1714624409834,EDS 284,A00,507350,Daly; Alan J.,16,0,16,0
1714624410859,EDS 286,A00,507359,Fine; Sarah,18,0,18,0
1714624411885,EDS 289C,A01,507361,Daly; Alan J.,18,0,18,0
1714624412910,EDS 290,A00,507366,Hofstetter; Carolyn,15,0,15,0
1714624413935,LIGM 5A,A00,507421,Fischer-Grunski; Eva K,18,0,20,2
1714624414964,LIGM 5B,A00,507423,Fischer-Grunski; Eva K,19,0,20,1
1714624416044,LIGM 5C,A00,507425,Fischer-Grunski; Eva K,19,0,20,1
1714624417069,LIIT 5AS,A00,507427,Carnelos; Chiara,20,0,20,0
1714624418094,LIIT 5BS,A00,507430,Carnelos; Chiara,20,0,20,0
1714624419119,LIIT 5CS,A00,507432,Carnelos; Chiara,20,0,20,0
1714624420144,LISP 5A,A00,507541,Munoz Sanchez; Alicia,11,0,20,9
1714624421169,LISP 5B,A00,507671,Munoz Sanchez; Alicia,8,0,20,12
1714624422195,LISP 5C,A00,507696,Munoz Sanchez; Alicia,9,0,20,11
1714624423220,MAE 197,001,528363,Boechler; Nicholas Sebastia,9998,0,9999,1
1714624424249,MATH 197,001,523477,Kedlaya; Kiran S.,9995,0,9999,4
1714624424249,MATH 197,002,563811,Zhang; Danna,9995,0,9999,4
1714624424249,MATH 197,003,628552,Dumitriu; Ioana,9998,0,9999,1
1714624425275,MCWP 40R,A00,518780,Staff,2,0,20,18
1714624425275,MCWP 40R,B00,518781,Staff,8,0,20,12
1714624425275,MCWP 40R,C00,518783,Staff,6,0,20,14
1714624426302,MCWP 50R,A00,518791,Staff,0,0,20,20
1714624426302,MCWP 50R,B00,518792,Staff,0,2,20,20
1714624426302,MCWP 50R,C00,518793,Staff,0,2,20,20
1714624426302,MCWP 50R,D00,518794,Staff,0,0,20,20
1714624426302,MCWP 50R,E00,518795,Staff,0,2,20,20
1714624426302,MCWP 50R,F00,518796,Staff,0,0,20,20
1714624426302,MCWP 50R,G00,518797,Staff,0,1,20,20
1714624427331,MMW 12R,A01,514034,Herbst; Matthew,0,0,16,16
1714624427331,MMW 12R,A02,514035,Herbst; Matthew,1,0,16,15
1714624428356,MMW 13R,A01,514037,Staff,0,4,16,16
1714624428356,MMW 13R,A02,514039,Staff,0,2,16,16
1714624428356,MMW 13R,A03,628519,Staff,0,2,16,16
1714624430408,SIO 295LS,A00,523233,Staff,10,0,30,20
1714624431434,SIO 295S,A00,523232,Staff,10,0,30,20
1714624432465,SIOC 290S,A01,637330,Merrifield; Mark A,23,0,30,7
1714624433490,SIOC 291S,A01,637333,Gabriel; Corey John,23,0,30,7
1714624434514,SOCI 117,A01,494376,Staff,0,4,5,5
1714624435540,WES 237B,A00,494380,Staff,9,0,20,11
1714624437609,AESE 279B,A00,494370,Wade; Jon P,0,0,33,33
1714624438633,AIP 197,001,627712,Vespa; Emanuel Ignacio,9998,0,9999,1
1714624439676,ANAR 135S,A00,494369,Braswell; Geoffrey E.,0,0,0,0
1714624440702,BENG 196,001,628496,Engler; Adam J.,9998,0,9999,1
1714624441726,CAT 124RS,A01,519847,Geibel; William,0,0,20,20
1714624442750,CAT 125RS,A01,515971,Geibel; William,0,0,20,20
1714624443775,CLRE 250,A00,511389,Morris; Sheldon,9993,0,9999,6
1714624444801,CLRE 251,A00,507176,Mehta; Ravindra L.,9993,0,9999,6
1714624444801,CLRE 251,B00,511410,Mehta; Ravindra L.,9998,0,9999,1
1714624445827,CLRE 252,A00,507189,Cuomo; Raphael Eduardo,9995,0,9999,4
1714624446855,CLRE 253,A00,507199,Vaida; Florin,9994,0,9999,5
1714624446855,CLRE 253,B00,507202,Vaida; Florin,9999,0,9999,0
1714624447882,CLRE 259,A00,507211,Patel; Hemal,9996,0,9999,3
1714624448906,CLRE 260,A00,507221,Cuomo; Raphael Eduardo,9999,0,9999,0
1714624449932,CLRE 297,001,507242,Cuomo; Raphael Eduardo,9999,0,9999,0
1714624450958,COGS 197,001,638244,Voytek; Bradley Thomas,9998,0,9999,1
1714624451985,CSE 191,A00,516875,Minnes Kemp; Mor Mia,9992,0,9999,7
1714624453010,CSE 197,001,637388,Minnes Kemp; Mor Mia,9998,0,9999,1
1714624454043,CSS 201S,A01,494383,Staff,35,0,35,0
1714624455073,CSS 202S,A01,494387,Staff,35,0,35,0
1714624456098,DSC 197,001,628532,Eldridge; Justin Matthew,9996,0,9999,3
1714624457122,EAP 100,A00,516065,Staff,9797,0,9999,202
1714624458148,ECE 45,A01,507414,Staff,33,0,60,27
1714624460199,ECE 111,A01,507420,Staff,15,0,50,35
1714624461226,ECE 197,001,548057,Sievenpiper; Daniel F.,9993,0,9999,6
1714624462252,EDS 115,A00,507243,Choi; Bailey Miyeon,10,0,28,18
1714624463277,EDS 117,A01,494379,Staff,1,5,30,29
1714624464306,EDS 125,A00,507246,Hopkins; Megan Beth,9,0,30,21
1714624465334,EDS 128A,A01,507264,Fargason; Sharon Gayle,8,0,26,18
1714624466361,EDS 128B,A01,507293,Pappas; Elizabeth,12,0,30,18
1714624467388,EDS 139,A00,507294,Fargason; Sharon Gayle,13,0,30,17
1714624467388,EDS 139,B00,507313,Pappas; Elizabeth,13,0,30,17
1714624468413,EDS 201,A00,507315,Staff,13,0,30,17
1714624469441,EDS 203,A01,507317,Halter; Christopher P.,12,0,30,18
1714624470469,EDS 204R,A01,507319,Halter; Christopher P.,0,3,30,30
1714624470469,EDS 204R,B01,507331,Heinzman; Erica M.,16,0,30,14
1714624471494,EDS 206R,A00,507332,Staff,0,4,30,30
1714624471494,EDS 206R,B00,507343,Staff,17,0,30,13
1714624472520,EDS 250,A00,507344,Hemans; Patricia Ann Benitez,22,0,40,18
1714624473545,EDS 281,A00,507345,Daly; Alan J.,18,0,18,0
1714624474573,EDS 284,A00,507350,Daly; Alan J.,16,0,16,0
1714624475601,EDS 286,A00,507359,Fine; Sarah,18,0,18,0
1714624476626,EDS 289C,A01,507361,Daly; Alan J.,18,0,18,0
1714624477651,EDS 290,A00,507366,Hofstetter; Carolyn,15,0,15,0
1714624478677,LIGM 5A,A00,507421,Fischer-Grunski; Eva K,18,0,20,2
1714624479707,LIGM 5B,A00,507423,Fischer-Grunski; Eva K,19,0,20,1
1714624480733,LIGM 5C,A00,507425,Fischer-Grunski; Eva K,19,0,20,1
1714624481762,LIIT 5AS,A00,507427,Carnelos; Chiara,20,0,20,0
1714624482788,LIIT 5BS,A00,507430,Carnelos; Chiara,20,0,20,0
1714624483817,LIIT 5CS,A00,507432,Carnelos; Chiara,20,0,20,0
1714624484845,LISP 5A,A00,507541,Munoz Sanchez; Alicia,11,0,20,9
1714624485870,LISP 5B,A00,507671,Munoz Sanchez; Alicia,8,0,20,12
1714624486898,LISP 5C,A00,507696,Munoz Sanchez; Alicia,9,0,20,11
1714624487925,MAE 197,001,528363,Boechler; Nicholas Sebastia,9998,0,9999,1
1714624488955,MATH 197,001,523477,Kedlaya; Kiran S.,9995,0,9999,4
1714624488955,MATH 197,002,563811,Zhang; Danna,9995,0,9999,4
1714624488955,MATH 197,003,628552,Dumitriu; Ioana,9998,0,9999,1
1714624489983,MCWP 40R,A00,518780,Staff,2,0,20,18
1714624489983,MCWP 40R,B00,518781,Staff,8,0,20,12
1714624489983,MCWP 40R,C00,518783,Staff,6,0,20,14
1714624491009,MCWP 50R,A00,518791,Staff,0,0,20,20
1714624491009,MCWP 50R,B00,518792,Staff,0,2,20,20
1714624491009,MCWP 50R,C00,518793,Staff,0,2,20,20
1714624491009,MCWP 50R,D00,518794,Staff,0,0,20,20
1714624491009,MCWP 50R,E00,518795,Staff,0,2,20,20
1714624491009,MCWP 50R,F00,518796,Staff,0,0,20,20
1714624491009,MCWP 50R,G00,518797,Staff,0,1,20,20
1714624492037,MMW 12R,A01,514034,Herbst; Matthew,0,0,16,16
1714624492037,MMW 12R,A02,514035,Herbst; Matthew,1,0,16,15
1714624493061,MMW 13R,A01,514037,Staff,0,4,16,16
1714624493061,MMW 13R,A02,514039,Staff,0,2,16,16
1714624493061,MMW 13R,A03,628519,Staff,0,2,16,16
1714624495114,SIO 295LS,A00,523233,Staff,10,0,30,20
1714624496139,SIO 295S,A00,523232,Staff,10,0,30,20
1714624497168,SIOC 290S,A01,637330,Merrifield; Mark A,23,0,30,7
1714624498191,SIOC 291S,A01,637333,Gabriel; Corey John,23,0,30,7
1714624499217,SOCI 117,A01,494376,Staff,0,4,5,5
1714624500244,WES 237B,A00,494380,Staff,9,0,20,11
1714624502317,AESE 279B,A00,494370,Wade; Jon P,0,0,33,33
1714624503343,AIP 197,001,627712,Vespa; Emanuel Ignacio,9998,0,9999,1
1714624504367,ANAR 135S,A00,494369,Braswell; Geoffrey E.,0,0,0,0
1714624505393,BENG 196,001,628496,Engler; Adam J.,9998,0,9999,1
1714624506420,CAT 124RS,A01,519847,Geibel; William,0,0,20,20
1714624507445,CAT 125RS,A01,515971,Geibel; William,0,0,20,20
1714624508594,CLRE 250,A00,511389,Morris; Sheldon,9993,0,9999,6
1714624509619,CLRE 251,A00,507176,Mehta; Ravindra L.,9993,0,9999,6
1714624509619,CLRE 251,B00,511410,Mehta; Ravindra L.,9998,0,9999,1
1714624510643,CLRE 252,A00,507189,Cuomo; Raphael Eduardo,9995,0,9999,4
1714624511668,CLRE 253,A00,507199,Vaida; Florin,9994,0,9999,5
1714624511668,CLRE 253,B00,507202,Vaida; Florin,9999,0,9999,0
1714624512696,CLRE 259,A00,507211,Patel; Hemal,9996,0,9999,3
1714624513720,CLRE 260,A00,507221,Cuomo; Raphael Eduardo,9999,0,9999,0
1714624514747,CLRE 297,001,507242,Cuomo; Raphael Eduardo,9999,0,9999,0
1714624515773,COGS 197,001,638244,Voytek; Bradley Thomas,9998,0,9999,1
1714624516802,CSE 191,A00,516875,Minnes Kemp; Mor Mia,9992,0,9999,7
1714624517829,CSE 197,001,637388,Minnes Kemp; Mor Mia,9998,0,9999,1
1714624518853,CSS 201S,A01,494383,Staff,35,0,35,0
1714624519881,CSS 202S,A01,494387,Staff,35,0,35,0
1714624520909,DSC 197,001,628532,Eldridge; Justin Matthew,9996,0,9999,3
1714624521936,EAP 100,A00,516065,Staff,9797,0,9999,202
1714624522961,ECE 45,A01,507414,Staff,33,0,60,27
1714624525073,ECE 111,A01,507420,Staff,15,0,50,35
1714624526098,ECE 197,001,548057,Sievenpiper; Daniel F.,9993,0,9999,6
1714624527125,EDS 115,A00,507243,Choi; Bailey Miyeon,10,0,28,18
1714624528150,EDS 117,A01,494379,Staff,1,5,30,29
1714624529178,EDS 125,A00,507246,Hopkins; Megan Beth,9,0,30,21
1714624530205,EDS 128A,A01,507264,Fargason; Sharon Gayle,8,0,26,18
1714624531229,EDS 128B,A01,507293,Pappas; Elizabeth,12,0,30,18
1714624532256,EDS 139,A00,507294,Fargason; Sharon Gayle,13,0,30,17
1714624532256,EDS 139,B00,507313,Pappas; Elizabeth,13,0,30,17
1714624533279,EDS 201,A00,507315,Staff,13,0,30,17
1714624534302,EDS 203,A01,507317,Halter; Christopher P.,12,0,30,18
1714624535331,EDS 204R,A01,507319,Halter; Christopher P.,0,3,30,30
1714624535331,EDS 204R,B01,507331,Heinzman; Erica M.,16,0,30,14
1714624536359,EDS 206R,A00,507332,Staff,0,4,30,30
1714624536359,EDS 206R,B00,507343,Staff,17,0,30,13
1714624537384,EDS 250,A00,507344,Hemans; Patricia Ann Benitez,22,0,40,18
1714624538409,EDS 281,A00,507345,Daly; Alan J.,18,0,18,0
1714624539434,EDS 284,A00,507350,Daly; Alan J.,16,0,16,0
1714624540460,EDS 286,A00,507359,Fine; Sarah,18,0,18,0
1714624541489,EDS 289C,A01,507361,Daly; Alan J.,18,0,18,0
1714624542515,EDS 290,A00,507366,Hofstetter; Carolyn,15,0,15,0
1714624543540,LIGM 5A,A00,507421,Fischer-Grunski; Eva K,18,0,20,2
1714624544567,LIGM 5B,A00,507423,Fischer-Grunski; Eva K,19,0,20,1
1714624545596,LIGM 5C,A00,507425,Fischer-Grunski; Eva K,19,0,20,1
1714624546620,LIIT 5AS,A00,507427,Carnelos; Chiara,20,0,20,0
1714624547649,LIIT 5BS,A00,507430,Carnelos; Chiara,20,0,20,0
1714624548674,LIIT 5CS,A00,507432,Carnelos; Chiara,20,0,20,0
1714624549761,LISP 5A,A00,507541,Munoz Sanchez; Alicia,11,0,20,9
1714624550787,LISP 5B,A00,507671,Munoz Sanchez; Alicia,8,0,20,12
1714624551812,LISP 5C,A00,507696,Munoz Sanchez; Alicia,9,0,20,11
1714624552843,MAE 197,001,528363,Boechler; Nicholas Sebastia,9998,0,9999,1
1714624553875,MATH 197,001,523477,Kedlaya; Kiran S.,9995,0,9999,4
1714624553875,MATH 197,002,563811,Zhang; Danna,9995,0,9999,4
1714624553875,MATH 197,003,628552,Dumitriu; Ioana,9998,0,9999,1
1714624554900,MCWP 40R,A00,518780,Staff,2,0,20,18
1714624554900,MCWP 40R,B00,518781,Staff,8,0,20,12
1714624554900,MCWP 40R,C00,518783,Staff,6,0,20,14
1714624555926,MCWP 50R,A00,518791,Staff,0,0,20,20
1714624555926,MCWP 50R,B00,518792,Staff,0,2,20,20
1714624555926,MCWP 50R,C00,518793,Staff,0,2,20,20
1714624555926,MCWP 50R,D00,518794,Staff,0,0,20,20
1714624555926,MCWP 50R,E00,518795,Staff,0,2,20,20
1714624555926,MCWP 50R,F00,518796,Staff,0,0,20,20
1714624555926,MCWP 50R,G00,518797,Staff,0,1,20,20
1714624556953,MMW 12R,A01,514034,Herbst; Matthew,0,0,16,16
1714624556953,MMW 12R,A02,514035,Herbst; Matthew,1,0,16,15
1714624557979,MMW 13R,A01,514037,Staff,0,4,16,16
1714624557979,MMW 13R,A02,514039,Staff,0,2,16,16
1714624557979,MMW 13R,A03,628519,Staff,0,2,16,16
1714624560032,SIO 295LS,A00,523233,Staff,10,0,30,20
1714624561059,SIO 295S,A00,523232,Staff,10,0,30,20
1714624562085,SIOC 290S,A01,637330,Merrifield; Mark A,23,0,30,7
1714624563114,SIOC 291S,A01,637333,Gabriel; Corey John,23,0,30,7
1714624564141,SOCI 117,A01,494376,Staff,0,4,5,5
1714624565166,WES 237B,A00,494380,Staff,9,0,20,11
1714624567244,AESE 279B,A00,494370,Wade; Jon P,0,0,33,33
1714624568271,AIP 197,001,627712,Vespa; Emanuel Ignacio,9998,0,9999,1
1714624569300,ANAR 135S,A00,494369,Braswell; Geoffrey E.,0,0,0,0
1714624570328,BENG 196,001,628496,Engler; Adam J.,9998,0,9999,1
1714624571355,CAT 124RS,A01,519847,Geibel; William,0,0,20,20
1714624572434,CAT 125RS,A01,515971,Geibel; William,0,0,20,20
1714624573460,CLRE 250,A00,511389,Morris; Sheldon,9993,0,9999,6
1714624574486,CLRE 251,A00,507176,Mehta; Ravindra L.,9993,0,9999,6
1714624574486,CLRE 251,B00,511410,Mehta; Ravindra L.,9998,0,9999,1
1714624575515,CLRE 252,A00,507189,Cuomo; Raphael Eduardo,9995,0,9999,4
1714624576541,CLRE 253,A00,507199,Vaida; Florin,9994,0,9999,5
1714624576541,CLRE 253,B00,507202,Vaida; Florin,9999,0,9999,0
1714624577570,CLRE 259,A00,507211,Patel; Hemal,9996,0,9999,3
1714624578594,CLRE 260,A00,507221,Cuomo; Raphael Eduardo,9999,0,9999,0
1714624579622,CLRE 297,001,507242,Cuomo; Raphael Eduardo,9999,0,9999,0
1714624580647,COGS 197,001,638244,Voytek; Bradley Thomas,9998,0,9999,1
1714624581677,CSE 191,A00,516875,Minnes Kemp; Mor Mia,9992,0,9999,7
1714624582701,CSE 197,001,637388,Minnes Kemp; Mor Mia,9998,0,9999,1
1714624583729,CSS 201S,A01,494383,Staff,35,0,35,0
1714624584755,CSS 202S,A01,494387,Staff,35,0,35,0
1714624585785,DSC 197,001,628532,Eldridge; Justin Matthew,9996,0,9999,3
1714624586817,EAP 100,A00,516065,Staff,9797,0,9999,202
1714624587842,ECE 45,A01,507414,Staff,33,0,60,27
1714624589895,ECE 111,A01,507420,Staff,15,0,50,35
1714624590921,ECE 197,001,548057,Sievenpiper; Daniel F.,9993,0,9999,6
1714624591951,EDS 115,A00,507243,Choi; Bailey Miyeon,10,0,28,18
1714624592979,EDS 117,A01,494379,Staff,1,5,30,29
1714624594004,EDS 125,A00,507246,Hopkins; Megan Beth,9,0,30,21
1714624595029,EDS 128A,A01,507264,Fargason; Sharon Gayle,8,0,26,18
1714624596058,EDS 128B,A01,507293,Pappas; Elizabeth,12,0,30,18
1714624597082,EDS 139,A00,507294,Fargason; Sharon Gayle,13,0,30,17
1714624597082,EDS 139,B00,507313,Pappas; Elizabeth,13,0,30,17
1714624598110,EDS 201,A00,507315,Staff,13,0,30,17
1714624599143,EDS 203,A01,507317,Halter; Christopher P.,12,0,30,18
1714624600173,EDS 204R,A01,507319,Halter; Christopher P.,0,3,30,30
1714624600173,EDS 204R,B01,507331,Heinzman; Erica M.,16,0,30,14
1714624601198,EDS 206R,A00,507332,Staff,0,4,30,30
1714624601198,EDS 206R,B00,507343,Staff,17,0,30,13
1714624602225,EDS 250,A00,507344,Hemans; Patricia Ann Benitez,22,0,40,18
1714624603249,EDS 281,A00,507345,Daly; Alan J.,18,0,18,0
1714624604277,EDS 284,A00,507350,Daly; Alan J.,16,0,16,0
1714624605302,EDS 286,A00,507359,Fine; Sarah,18,0,18,0
1714624606328,EDS 289C,A01,507361,Daly; Alan J.,18,0,18,0
1714624607382,EDS 290,A00,507366,Hofstetter; Carolyn,15,0,15,0
1714624608418,LIGM 5A,A00,507421,Fischer-Grunski; Eva K,18,0,20,2
1714624609447,LIGM 5B,A00,507423,Fischer-Grunski; Eva K,19,0,20,1
1714624610473,LIGM 5C,A00,507425,Fischer-Grunski; Eva K,19,0,20,1
1714624611504,LIIT 5AS,A00,507427,Carnelos; Chiara,20,0,20,0
1714624612531,LIIT 5BS,A00,507430,Carnelos; Chiara,20,0,20,0
1714624613557,LIIT 5CS,A00,507432,Carnelos; Chiara,20,0,20,0
1714624614587,LISP 5A,A00,507541,Munoz Sanchez; Alicia,11,0,20,9
1714624615617,LISP 5B,A00,507671,Munoz Sanchez; Alicia,8,0,20,12
1714624616648,LISP 5C,A00,507696,Munoz Sanchez; Alicia,9,0,20,11
1714624617675,MAE 197,001,528363,Boechler; Nicholas Sebastia,9998,0,9999,1
1714624618701,MATH 197,001,523477,Kedlaya; Kiran S.,9995,0,9999,4
1714624618701,MATH 197,002,563811,Zhang; Danna,9995,0,9999,4
1714624618701,MATH 197,003,628552,Dumitriu; Ioana,9998,0,9999,1
1714624619730,MCWP 40R,A00,518780,Staff,2,0,20,18
1714624619730,MCWP 40R,B00,518781,Staff,8,0,20,12
1714624619730,MCWP 40R,C00,518783,Staff,6,0,20,14
1714624620757,MCWP 50R,A00,518791,Staff,0,0,20,20
1714624620757,MCWP 50R,B00,518792,Staff,0,2,20,20
1714624620757,MCWP 50R,C00,518793,Staff,0,2,20,20
1714624620757,MCWP 50R,D00,518794,Staff,0,0,20,20
1714624620757,MCWP 50R,E00,518795,Staff,0,2,20,20
1714624620757,MCWP 50R,F00,518796,Staff,0,0,20,20
1714624620757,MCWP 50R,G00,518797,Staff,0,1,20,20
1714624621787,MMW 12R,A01,514034,Herbst; Matthew,0,0,16,16
1714624621787,MMW 12R,A02,514035,Herbst; Matthew,1,0,16,15
1714624622817,MMW 13R,A01,514037,Staff,0,4,16,16
1714624622817,MMW 13R,A02,514039,Staff,0,2,16,16
1714624622817,MMW 13R,A03,628519,Staff,0,2,16,16
1714624624871,SIO 295LS,A00,523233,Staff,10,0,30,20
1714624625896,SIO 295S,A00,523232,Staff,10,0,30,20
1714624626927,SIOC 290S,A01,637330,Merrifield; Mark A,23,0,30,7
1714624627953,SIOC 291S,A01,637333,Gabriel; Corey John,23,0,30,7
1714624628978,SOCI 117,A01,494376,Staff,0,4,5,5
1714624630003,WES 237B,A00,494380,Staff,9,0,20,11
1714624632079,AESE 279B,A00,494370,Wade; Jon P,0,0,33,33
1714624633109,AIP 197,001,627712,Vespa; Emanuel Ignacio,9998,0,9999,1
1714624634135,ANAR 135S,A00,494369,Braswell; Geoffrey E.,0,0,0,0
1714624635160,BENG 196,001,628496,Engler; Adam J.,9998,0,9999,1
1714624636185,CAT 124RS,A01,519847,Geibel; William,0,0,20,20
1714624637211,CAT 125RS,A01,515971,Geibel; William,0,0,20,20
1714624638241,CLRE 250,A00,511389,Morris; Sheldon,9993,0,9999,6
1714624639268,CLRE 251,A00,507176,Mehta; Ravindra L.,9993,0,9999,6
1714624639268,CLRE 251,B00,511410,Mehta; Ravindra L.,9998,0,9999,1
1714624640293,CLRE 252,A00,507189,Cuomo; Raphael Eduardo,9995,0,9999,4
1714624641321,CLRE 253,A00,507199,Vaida; Florin,9994,0,9999,5
1714624641321,CLRE 253,B00,507202,Vaida; Florin,9999,0,9999,0
1714624642347,CLRE 259,A00,507211,Patel; Hemal,9996,0,9999,3
1714624643374,CLRE 260,A00,507221,Cuomo; Raphael Eduardo,9999,0,9999,0
1714624644402,CLRE 297,001,507242,Cuomo; Raphael Eduardo,9999,0,9999,0
1714624645431,COGS 197,001,638244,Voytek; Bradley Thomas,9998,0,9999,1
1714624646461,CSE 191,A00,516875,Minnes Kemp; Mor Mia,9992,0,9999,7
1714624647486,CSE 197,001,637388,Minnes Kemp; Mor Mia,9998,0,9999,1
1714624648510,CSS 201S,A01,494383,Staff,35,0,35,0
1714624649536,CSS 202S,A01,494387,Staff,35,0,35,0
1714624650561,DSC 197,001,628532,Eldridge; Justin Matthew,9996,0,9999,3
1714624651586,EAP 100,A00,516065,Staff,9797,0,9999,202
1714624652612,ECE 45,A01,507414,Staff,33,0,60,27
1714624654670,ECE 111,A01,507420,Staff,15,0,50,35
1714624655695,ECE 197,001,548057,Sievenpiper; Daniel F.,9993,0,9999,6
1714624656726,EDS 115,A00,507243,Choi; Bailey Miyeon,10,0,28,18
1714624657751,EDS 117,A01,494379,Staff,1,5,30,29
1714624658779,EDS 125,A00,507246,Hopkins; Megan Beth,9,0,30,21
1714624659811,EDS 128A,A01,507264,Fargason; Sharon Gayle,8,0,26,18
1714624660838,EDS 128B,A01,507293,Pappas; Elizabeth,12,0,30,18
1714624661865,EDS 139,A00,507294,Fargason; Sharon Gayle,13,0,30,17
1714624661865,EDS 139,B00,507313,Pappas; Elizabeth,13,0,30,17
1714624662890,EDS 201,A00,507315,Staff,13,0,30,17
1714624663915,EDS 203,A01,507317,Halter; Christopher P.,12,0,30,18
1714624664941,EDS 204R,A01,507319,Halter; Christopher P.,0,3,30,30
1714624664941,EDS 204R,B01,507331,Heinzman; Erica M.,16,0,30,14
1714624665966,EDS 206R,A00,507332,Staff,0,4,30,30
1714624665966,EDS 206R,B00,507343,Staff,17,0,30,13
1714624666994,EDS 250,A00,507344,Hemans; Patricia Ann Benitez,22,0,40,18
1714624668022,EDS 281,A00,507345,Daly; Alan J.,18,0,18,0
1714624669049,EDS 284,A00,507350,Daly; Alan J.,16,0,16,0
1714624670078,EDS 286,A00,507359,Fine; Sarah,18,0,18,0
1714624671102,EDS 289C,A01,507361,Daly; Alan J.,18,0,18,0
1714624672129,EDS 290,A00,507366,Hofstetter; Carolyn,15,0,15,0
1714624673154,LIGM 5A,A00,507421,Fischer-Grunski; Eva K,18,0,20,2
1714624674181,LIGM 5B,A00,507423,Fischer-Grunski; Eva K,19,0,20,1
1714624675210,LIGM 5C,A00,507425,Fischer-Grunski; Eva K,19,0,20,1
1714624676236,LIIT 5AS,A00,507427,Carnelos; Chiara,20,0,20,0
1714624677262,LIIT 5BS,A00,507430,Carnelos; Chiara,20,0,20,0
1714624678361,LIIT 5CS,A00,507432,Carnelos; Chiara,20,0,20,0
1714624679444,LISP 5A,A00,507541,Munoz Sanchez; Alicia,11,0,20,9
1714624680474,LISP 5B,A00,507671,Munoz Sanchez; Alicia,8,0,20,12
1714624681500,LISP 5C,A00,507696,Munoz Sanchez; Alicia,9,0,20,11
1714624682526,MAE 197,001,528363,Boechler; Nicholas Sebastia,9998,0,9999,1
1714624683553,MATH 197,001,523477,Kedlaya; Kiran S.,9995,0,9999,4
1714624683553,MATH 197,002,563811,Zhang; Danna,9995,0,9999,4
1714624683553,MATH 197,003,628552,Dumitriu; Ioana,9998,0,9999,1
1714624684583,MCWP 40R,A00,518780,Staff,2,0,20,18
1714624684583,MCWP 40R,B00,518781,Staff,8,0,20,12
1714624684583,MCWP 40R,C00,518783,Staff,6,0,20,14
1714624685614,MCWP 50R,A00,518791,Staff,0,0,20,20
1714624685614,MCWP 50R,B00,518792,Staff,0,2,20,20
1714624685614,MCWP 50R,C00,518793,Staff,0,2,20,20
1714624685614,MCWP 50R,D00,518794,Staff,0,0,20,20
1714624685614,MCWP 50R,E00,518795,Staff,0,2,20,20
1714624685614,MCWP 50R,F00,518796,Staff,0,0,20,20
1714624685614,MCWP 50R,G00,518797,Staff,0,1,20,20
1714624686647,MMW 12R,A01,514034,Herbst; Matthew,0,0,16,16
1714624686647,MMW 12R,A02,514035,Herbst; Matthew,1,0,16,15
1714624687671,MMW 13R,A01,514037,Staff,0,4,16,16
1714624687671,MMW 13R,A02,514039,Staff,0,2,16,16
1714624687671,MMW 13R,A03,628519,Staff,0,2,16,16
1714624689724,SIO 295LS,A00,523233,Staff,10,0,30,20
1714624690751,SIO 295S,A00,523232,Staff,10,0,30,20
1714624691778,SIOC 290S,A01,637330,Merrifield; Mark A,23,0,30,7
1714624692806,SIOC 291S,A01,637333,Gabriel; Corey John,23,0,30,7
1714624693834,SOCI 117,A01,494376,Staff,0,4,5,5
1714624694860,WES 237B,A00,494380,Staff,9,0,20,11
1714624696942,AESE 279B,A00,494370,Wade; Jon P,0,0,33,33
1714624697968,AIP 197,001,627712,Vespa; Emanuel Ignacio,9998,0,9999,1
1714624698996,ANAR 135S,A00,494369,Braswell; Geoffrey E.,0,0,0,0
1714624700022,BENG 196,001,628496,Engler; Adam J.,9998,0,9999,1
1714624701049,CAT 124RS,A01,519847,Geibel; William,0,0,20,20
1714624702076,CAT 125RS,A01,515971,Geibel; William,0,0,20,20
1714624703101,CLRE 250,A00,511389,Morris; Sheldon,9993,0,9999,6
1714624704127,CLRE 251,A00,507176,Mehta; Ravindra L.,9993,0,9999,6
1714624704127,CLRE 251,B00,511410,Mehta; Ravindra L.,9998,0,9999,1
1714624705155,CLRE 252,A00,507189,Cuomo; Raphael Eduardo,9995,0,9999,4
1714624706182,CLRE 253,A00,507199,Vaida; Florin,9994,0,9999,5
1714624706182,CLRE 253,B00,507202,Vaida; Florin,9999,0,9999,0
1714624707207,CLRE 259,A00,507211,Patel; Hemal,9996,0,9999,3
1714624708232,CLRE 260,A00,507221,Cuomo; Raphael Eduardo,9999,0,9999,0
1714624709258,CLRE 297,001,507242,Cuomo; Raphael Eduardo,9999,0,9999,0
1714624710284,COGS 197,001,638244,Voytek; Bradley Thomas,9998,0,9999,1
1714624711309,CSE 191,A00,516875,Minnes Kemp; Mor Mia,9992,0,9999,7
1714624712335,CSE 197,001,637388,Minnes Kemp; Mor Mia,9998,0,9999,1
1714624713361,CSS 201S,A01,494383,Staff,35,0,35,0
1714624714386,CSS 202S,A01,494387,Staff,35,0,35,0
1714624715414,DSC 197,001,628532,Eldridge; Justin Matthew,9996,0,9999,3
1714624716441,EAP 100,A00,516065,Staff,9797,0,9999,202
1714624717467,ECE 45,A01,507414,Staff,33,0,60,27
1714624719516,ECE 111,A01,507420,Staff,15,0,50,35
1714624720541,ECE 197,001,548057,Sievenpiper; Daniel F.,9993,0,9999,6
1714624721572,EDS 115,A00,507243,Choi; Bailey Miyeon,10,0,28,18
1714624722597,EDS 117,A01,494379,Staff,1,5,30,29
1714624723623,EDS 125,A00,507246,Hopkins; Megan Beth,9,0,30,21
1714624724650,EDS 128A,A01,507264,Fargason; Sharon Gayle,8,0,26,18
1714624725675,EDS 128B,A01,507293,Pappas; Elizabeth,12,0,30,18
1714624726701,EDS 139,A00,507294,Fargason; Sharon Gayle,13,0,30,17
1714624726701,EDS 139,B00,507313,Pappas; Elizabeth,13,0,30,17
1714624727727,EDS 201,A00,507315,Staff,13,0,30,17
1714624728755,EDS 203,A01,507317,Halter; Christopher P.,12,0,30,18
1714624729780,EDS 204R,A01,507319,Halter; Christopher P.,0,3,30,30
1714624729780,EDS 204R,B01,507331,Heinzman; Erica M.,16,0,30,14
1714624730807,EDS 206R,A00,507332,Staff,0,4,30,30
1714624730807,EDS 206R,B00,507343,Staff,17,0,30,13
1714624731834,EDS 250,A00,507344,Hemans; Patricia Ann Benitez,22,0,40,18
1714624732862,EDS 281,A00,507345,Daly; Alan J.,18,0,18,0
1714624733887,EDS 284,A00,507350,Daly; Alan J.,16,0,16,0
1714624734917,EDS 286,A00,507359,Fine; Sarah,18,0,18,0
1714624735944,EDS 289C,A01,507361,Daly; Alan J.,18,0,18,0
1714624736970,EDS 290,A00,507366,Hofstetter; Carolyn,15,0,15,0
1714624738001,LIGM 5A,A00,507421,Fischer-Grunski; Eva K,18,0,20,2
1714624739025,LIGM 5B,A00,507423,Fischer-Grunski; Eva K,19,0,20,1
1714624740050,LIGM 5C,A00,507425,Fischer-Grunski; Eva K,19,0,20,1
1714624741077,LIIT 5AS,A00,507427,Carnelos; Chiara,20,0,20,0
1714624742106,LIIT 5BS,A00,507430,Carnelos; Chiara,20,0,20,0
1714624743135,LIIT 5CS,A00,507432,Carnelos; Chiara,20,0,20,0
1714624744162,LISP 5A,A00,507541,Munoz Sanchez; Alicia,11,0,20,9
1714624745190,LISP 5B,A00,507671,Munoz Sanchez; Alicia,8,0,20,12
1714624746218,LISP 5C,A00,507696,Munoz Sanchez; Alicia,9,0,20,11
1714624747244,MAE 197,001,528363,Boechler; Nicholas Sebastia,9998,0,9999,1
1714624748269,MATH 197,001,523477,Kedlaya; Kiran S.,9995,0,9999,4
1714624748269,MATH 197,002,563811,Zhang; Danna,9995,0,9999,4
1714624748269,MATH 197,003,628552,Dumitriu; Ioana,9998,0,9999,1
1714624749299,MCWP 40R,A00,518780,Staff,2,0,20,18
1714624749299,MCWP 40R,B00,518781,Staff,8,0,20,12
1714624749299,MCWP 40R,C00,518783,Staff,6,0,20,14
1714624750330,MCWP 50R,A00,518791,Staff,0,0,20,20
1714624750330,MCWP 50R,B00,518792,Staff,0,2,20,20
1714624750330,MCWP 50R,C00,518793,Staff,0,2,20,20
1714624750330,MCWP 50R,D00,518794,Staff,0,0,20,20
1714624750330,MCWP 50R,E00,518795,Staff,0,2,20,20
1714624750330,MCWP 50R,F00,518796,Staff,0,0,20,20
1714624750330,MCWP 50R,G00,518797,Staff,0,1,20,20
1714624751359,MMW 12R,A01,514034,Herbst; Matthew,0,0,16,16
1714624751359,MMW 12R,A02,514035,Herbst; Matthew,1,0,16,15
1714624752385,MMW 13R,A01,514037,Staff,0,4,16,16
1714624752385,MMW 13R,A02,514039,Staff,0,2,16,16
1714624752385,MMW 13R,A03,628519,Staff,0,2,16,16
1714624754435,SIO 295LS,A00,523233,Staff,10,0,30,20
1714624755462,SIO 295S,A00,523232,Staff,10,0,30,20
1714624756489,SIOC 290S,A01,637330,Merrifield; Mark A,23,0,30,7
1714624757514,SIOC 291S,A01,637333,Gabriel; Corey John,23,0,30,7
1714624758543,SOCI 117,A01,494376,Staff,0,4,5,5
1714624759567,WES 237B,A00,494380,Staff,9,0,20,11
1714624761640,AESE 279B,A00,494370,Wade; Jon P,0,0,33,33
1714624762665,AIP 197,001,627712,Vespa; Emanuel Ignacio,9998,0,9999,1
1714624763753,ANAR 135S,A00,494369,Braswell; Geoffrey E.,0,0,0,0
1714624764779,BENG 196,001,628496,Engler; Adam J.,9998,0,9999,1
1714624765806,CAT 124RS,A01,519847,Geibel; William,0,0,20,20
1714624766831,CAT 125RS,A01,515971,Geibel; William,0,0,20,20
1714624767858,CLRE 250,A00,511389,Morris; Sheldon,9993,0,9999,6
1714624768886,CLRE 251,A00,507176,Mehta; Ravindra L.,9993,0,9999,6
1714624768886,CLRE 251,B00,511410,Mehta; Ravindra L.,9998,0,9999,1
1714624769911,CLRE 252,A00,507189,Cuomo; Raphael Eduardo,9995,0,9999,4
1714624770937,CLRE 253,A00,507199,Vaida; Florin,9994,0,9999,5
1714624770937,CLRE 253,B00,507202,Vaida; Florin,9999,0,9999,0
1714624771965,CLRE 259,A00,507211,Patel; Hemal,9996,0,9999,3
1714624772992,CLRE 260,A00,507221,Cuomo; Raphael Eduardo,9999,0,9999,0
1714624774018,CLRE 297,001,507242,Cuomo; Raphael Eduardo,9999,0,9999,0
1714624775045,COGS 197,001,638244,Voytek; Bradley Thomas,9998,0,9999,1
1714624776072,CSE 191,A00,516875,Minnes Kemp; Mor Mia,9992,0,9999,7
1714624777097,CSE 197,001,637388,Minnes Kemp; Mor Mia,9998,0,9999,1
1714624778129,CSS 201S,A01,494383,Staff,35,0,35,0
1714624779157,CSS 202S,A01,494387,Staff,35,0,35,0
1714624780182,DSC 197,001,628532,Eldridge; Justin Matthew,9996,0,9999,3
1714624781207,EAP 100,A00,516065,Staff,9797,0,9999,202
1714624782235,ECE 45,A01,507414,Staff,33,0,60,27
1714624784287,ECE 111,A01,507420,Staff,15,0,50,35
1714624785316,ECE 197,001,548057,Sievenpiper; Daniel F.,9993,0,9999,6
1714624786342,EDS 115,A00,507243,Choi; Bailey Miyeon,10,0,28,18
1714624787370,EDS 117,A01,494379,Staff,1,5,30,29
1714624788398,EDS 125,A00,507246,Hopkins; Megan Beth,9,0,30,21
1714624789427,EDS 128A,A01,507264,Fargason; Sharon Gayle,8,0,26,18
1714624790452,EDS 128B,A01,507293,Pappas; Elizabeth,12,0,30,18
1714624791477,EDS 139,A00,507294,Fargason; Sharon Gayle,13,0,30,17
1714624791477,EDS 139,B00,507313,Pappas; Elizabeth,13,0,30,17
1714624792506,EDS 201,A00,507315,Staff,13,0,30,17
1714624793535,EDS 203,A01,507317,Halter; Christopher P.,12,0,30,18
1714624794561,EDS 204R,A01,507319,Halter; Christopher P.,0,3,30,30
1714624794561,EDS 204R,B01,507331,Heinzman; Erica M.,16,0,30,14
1714624795586,EDS 206R,A00,507332,Staff,0,4,30,30
1714624795586,EDS 206R,B00,507343,Staff,17,0,30,13
1714624796612,EDS 250,A00,507344,Hemans; Patricia Ann Benitez,22,0,40,18
1714624797638,EDS 281,A00,507345,Daly; Alan J.,18,0,18,0
1714624798665,EDS 284,A00,507350,Daly; Alan J.,16,0,16,0
1714624799690,EDS 286,A00,507359,Fine; Sarah,18,0,18,0
1714624800714,EDS 289C,A01,507361,Daly; Alan J.,18,0,18,0
1714624801742,EDS 290,A00,507366,Hofstetter; Carolyn,15,0,15,0
1714624802774,LIGM 5A,A00,507421,Fischer-Grunski; Eva K,18,0,20,2
1714624803801,LIGM 5B,A00,507423,Fischer-Grunski; Eva K,19,0,20,1
1714624804828,LIGM 5C,A00,507425,Fischer-Grunski; Eva K,19,0,20,1
1714624805854,LIIT 5AS,A00,507427,Carnelos; Chiara,20,0,20,0
1714624806880,LIIT 5BS,A00,507430,Carnelos; Chiara,20,0,20,0
1714624807905,LIIT 5CS,A00,507432,Carnelos; Chiara,20,0,20,0
1714624808983,LISP 5A,A00,507541,Munoz Sanchez; Alicia,11,0,20,9
1714624810011,LISP 5B,A00,507671,Munoz Sanchez; Alicia,8,0,20,12
1714624811041,LISP 5C,A00,507696,Munoz Sanchez; Alicia,9,0,20,11
1714624812069,MAE 197,001,528363,Boechler; Nicholas Sebastia,9998,0,9999,1
1714624813095,MATH 197,001,523477,Kedlaya; Kiran S.,9995,0,9999,4
1714624813095,MATH 197,002,563811,Zhang; Danna,9995,0,9999,4
1714624813095,MATH 197,003,628552,Dumitriu; Ioana,9998,0,9999,1
1714624814120,MCWP 40R,A00,518780,Staff,2,0,20,18
1714624814120,MCWP 40R,B00,518781,Staff,8,0,20,12
1714624814120,MCWP 40R,C00,518783,Staff,6,0,20,14
1714624815149,MCWP 50R,A00,518791,Staff,0,0,20,20
1714624815149,MCWP 50R,B00,518792,Staff,0,2,20,20
1714624815149,MCWP 50R,C00,518793,Staff,0,2,20,20
1714624815149,MCWP 50R,D00,518794,Staff,0,0,20,20
1714624815149,MCWP 50R,E00,518795,Staff,0,2,20,20
1714624815149,MCWP 50R,F00,518796,Staff,0,0,20,20
1714624815149,MCWP 50R,G00,518797,Staff,0,1,20,20
1714624816179,MMW 12R,A01,514034,Herbst; Matthew,0,0,16,16
1714624816179,MMW 12R,A02,514035,Herbst; Matthew,1,0,16,15
1714624817203,MMW 13R,A01,514037,Staff,0,4,16,16
1714624817203,MMW 13R,A02,514039,Staff,0,2,16,16
1714624817203,MMW 13R,A03,628519,Staff,0,2,16,16
1714624819258,SIO 295LS,A00,523233,Staff,10,0,30,20
1714624820285,SIO 295S,A00,523232,Staff,10,0,30,20
1714624821316,SIOC 290S,A01,637330,Merrifield; Mark A,23,0,30,7
1714624822344,SIOC 291S,A01,637333,Gabriel; Corey John,23,0,30,7
1714624823373,SOCI 117,A01,494376,Staff,0,4,5,5
1714624824401,WES 237B,A00,494380,Staff,9,0,20,11
1714624826487,AESE 279B,A00,494370,Wade; Jon P,0,0,33,33
1714624827513,AIP 197,001,627712,Vespa; Emanuel Ignacio,9998,0,9999,1
1714624828540,ANAR 135S,A00,494369,Braswell; Geoffrey E.,0,0,0,0
1714624829568,BENG 196,001,628496,Engler; Adam J.,9998,0,9999,1
1714624830598,CAT 124RS,A01,519847,Geibel; William,0,0,20,20
1714624831623,CAT 125RS,A01,515971,Geibel; William,0,0,20,20
1714624832649,CLRE 250,A00,511389,Morris; Sheldon,9993,0,9999,6
1714624833680,CLRE 251,A00,507176,Mehta; Ravindra L.,9993,0,9999,6
1714624833680,CLRE 251,B00,511410,Mehta; Ravindra L.,9998,0,9999,1
1714624834704,CLRE 252,A00,507189,Cuomo; Raphael Eduardo,9995,0,9999,4
1714624835729,CLRE 253,A00,507199,Vaida; Florin,9994,0,9999,5
1714624835729,CLRE 253,B00,507202,Vaida; Florin,9999,0,9999,0
1714624836755,CLRE 259,A00,507211,Patel; Hemal,9996,0,9999,3
1714624837783,CLRE 260,A00,507221,Cuomo; Raphael Eduardo,9999,0,9999,0
1714624838807,CLRE 297,001,507242,Cuomo; Raphael Eduardo,9999,0,9999,0
1714624839837,COGS 197,001,638244,Voytek; Bradley Thomas,9998,0,9999,1
1714624840864,CSE 191,A00,516875,Minnes Kemp; Mor Mia,9992,0,9999,7
1714624841890,CSE 197,001,637388,Minnes Kemp; Mor Mia,9998,0,9999,1
1714624842918,CSS 201S,A01,494383,Staff,35,0,35,0
1714624853189,CSS 202S,A01,494387,Staff,35,0,35,0
1714624854216,DSC 197,001,628532,Eldridge; Justin Matthew,9996,0,9999,3
1714624855241,EAP 100,A00,516065,Staff,9797,0,9999,202
1714624856267,ECE 45,A01,507414,Staff,33,0,60,27
1714624858320,ECE 111,A01,507420,Staff,15,0,50,35
1714624859346,ECE 197,001,548057,Sievenpiper; Daniel F.,9993,0,9999,6
1714624860372,EDS 115,A00,507243,Choi; Bailey Miyeon,10,0,28,18
1714624861402,EDS 117,A01,494379,Staff,1,5,30,29
1714624862426,EDS 125,A00,507246,Hopkins; Megan Beth,9,0,30,21
1714624863452,EDS 128A,A01,507264,Fargason; Sharon Gayle,8,0,26,18
1714624864479,EDS 128B,A01,507293,Pappas; Elizabeth,12,0,30,18
1714624865506,EDS 139,A00,507294,Fargason; Sharon Gayle,13,0,30,17
1714624865506,EDS 139,B00,507313,Pappas; Elizabeth,13,0,30,17
1714624866534,EDS 201,A00,507315,Staff,13,0,30,17
1714624867559,EDS 203,A01,507317,Halter; Christopher P.,12,0,30,18
1714624868591,EDS 204R,A01,507319,Halter; Christopher P.,0,3,30,30
1714624868591,EDS 204R,B01,507331,Heinzman; Erica M.,16,0,30,14
1714624869619,EDS 206R,A00,507332,Staff,0,4,30,30
1714624869619,EDS 206R,B00,507343,Staff,17,0,30,13
1714624870642,EDS 250,A00,507344,Hemans; Patricia Ann Benitez,22,0,40,18
1714624871670,EDS 281,A00,507345,Daly; Alan J.,18,0,18,0
1714624872696,EDS 284,A00,507350,Daly; Alan J.,16,0,16,0
1714624873726,EDS 286,A00,507359,Fine; Sarah,18,0,18,0
1714624874757,EDS 289C,A01,507361,Daly; Alan J.,18,0,18,0
1714624875783,EDS 290,A00,507366,Hofstetter; Carolyn,15,0,15,0
1714624876809,LIGM 5A,A00,507421,Fischer-Grunski; Eva K,18,0,20,2
1714624877836,LIGM 5B,A00,507423,Fischer-Grunski; Eva K,19,0,20,1
1714624878866,LIGM 5C,A00,507425,Fischer-Grunski; Eva K,19,0,20,1
1714624879891,LIIT 5AS,A00,507427,Carnelos; Chiara,20,0,20,0
1714624880920,LIIT 5BS,A00,507430,Carnelos; Chiara,20,0,20,0
1714624881948,LIIT 5CS,A00,507432,Carnelos; Chiara,20,0,20,0
1714624882981,LISP 5A,A00,507541,Munoz Sanchez; Alicia,11,0,20,9
1714624884006,LISP 5B,A00,507671,Munoz Sanchez; Alicia,8,0,20,12
1714624885035,LISP 5C,A00,507696,Munoz Sanchez; Alicia,9,0,20,11
1714624886065,MAE 197,001,528363,Boechler; Nicholas Sebastia,9998,0,9999,1
1714624887093,MATH 197,001,523477,Kedlaya; Kiran S.,9995,0,9999,4
1714624887093,MATH 197,002,563811,Zhang; Danna,9995,0,9999,4
1714624887093,MATH 197,003,628552,Dumitriu; Ioana,9998,0,9999,1
1714624888118,MCWP 40R,A00,518780,Staff,2,0,20,18
1714624888118,MCWP 40R,B00,518781,Staff,8,0,20,12
1714624888118,MCWP 40R,C00,518783,Staff,6,0,20,14
1714624889144,MCWP 50R,A00,518791,Staff,0,0,20,20
1714624889144,MCWP 50R,B00,518792,Staff,0,2,20,20
1714624889144,MCWP 50R,C00,518793,Staff,0,2,20,20
1714624889144,MCWP 50R,D00,518794,Staff,0,0,20,20
1714624889144,MCWP 50R,E00,518795,Staff,0,2,20,20
1714624889144,MCWP 50R,F00,518796,Staff,0,0,20,20
1714624889144,MCWP 50R,G00,518797,Staff,0,1,20,20
1714624890174,MMW 12R,A01,514034,Herbst; Matthew,0,0,16,16
1714624890174,MMW 12R,A02,514035,Herbst; Matthew,1,0,16,15
1714624891200,MMW 13R,A01,514037,Staff,0,4,16,16
1714624891200,MMW 13R,A02,514039,Staff,0,2,16,16
1714624891200,MMW 13R,A03,628519,Staff,0,2,16,16
1714624893256,SIO 295LS,A00,523233,Staff,10,0,30,20
1714624894281,SIO 295S,A00,523232,Staff,10,0,30,20
1714624895315,SIOC 290S,A01,637330,Merrifield; Mark A,23,0,30,7
1714624896340,SIOC 291S,A01,637333,Gabriel; Corey John,23,0,30,7
1714624897365,SOCI 117,A01,494376,Staff,0,4,5,5
1714624898390,WES 237B,A00,494380,Staff,9,0,20,11
1714624900464,AESE 279B,A00,494370,Wade; Jon P,0,0,33,33
1714624901489,AIP 197,001,627712,Vespa; Emanuel Ignacio,9998,0,9999,1
1714624902512,ANAR 135S,A00,494369,Braswell; Geoffrey E.,0,0,0,0
1714624903538,BENG 196,001,628496,Engler; Adam J.,9998,0,9999,1
1714624904563,CAT 124RS,A01,519847,Geibel; William,0,0,20,20
1714624905592,CAT 125RS,A01,515971,Geibel; William,0,0,20,20
1714624906620,CLRE 250,A00,511389,Morris; Sheldon,9993,0,9999,6
1714624907652,CLRE 251,A00,507176,Mehta; Ravindra L.,9993,0,9999,6
1714624907652,CLRE 251,B00,511410,Mehta; Ravindra L.,9998,0,9999,1
1714624908679,CLRE 252,A00,507189,Cuomo; Raphael Eduardo,9995,0,9999,4
1714624909703,CLRE 253,A00,507199,Vaida; Florin,9994,0,9999,5
1714624909703,CLRE 253,B00,507202,Vaida; Florin,9999,0,9999,0
1714624910729,CLRE 259,A00,507211,Patel; Hemal,9996,0,9999,3
1714624911757,CLRE 260,A00,507221,Cuomo; Raphael Eduardo,9999,0,9999,0
1714624912782,CLRE 297,001,507242,Cuomo; Raphael Eduardo,9999,0,9999,0
1714624913810,COGS 197,001,638244,Voytek; Bradley Thomas,9998,0,9999,1
1714624914837,CSE 191,A00,516875,Minnes Kemp; Mor Mia,9992,0,9999,7
1714624915863,CSE 197,001,637388,Minnes Kemp; Mor Mia,9998,0,9999,1
1714624916894,CSS 201S,A01,494383,Staff,35,0,35,0
1714624917918,CSS 202S,A01,494387,Staff,35,0,35,0
1714624918948,DSC 197,001,628532,Eldridge; Justin Matthew,9996,0,9999,3
1714624919977,EAP 100,A00,516065,Staff,9797,0,9999,202
1714624921003,ECE 45,A01,507414,Staff,33,0,60,27
1714624923056,ECE 111,A01,507420,Staff,15,0,50,35
1714624924625,ECE 197,001,548057,Sievenpiper; Daniel F.,9993,0,9999,6
1714624925653,EDS 115,A00,507243,Choi; Bailey Miyeon,10,0,28,18
1714624926678,EDS 117,A01,494379,Staff,1,5,30,29
1714624927703,EDS 125,A00,507246,Hopkins; Megan Beth,9,0,30,21
1714624928733,EDS 128A,A01,507264,Fargason; Sharon Gayle,8,0,26,18
1714624929759,EDS 128B,A01,507293,Pappas; Elizabeth,12,0,30,18
1714624930785,EDS 139,A00,507294,Fargason; Sharon Gayle,13,0,30,17
1714624930785,EDS 139,B00,507313,Pappas; Elizabeth,13,0,30,17
1714624931812,EDS 201,A00,507315,Staff,13,0,30,17
1714624932837,EDS 203,A01,507317,Halter; Christopher P.,12,0,30,18
1714624933867,EDS 204R,A01,507319,Halter; Christopher P.,0,3,30,30
1714624933867,EDS 204R,B01,507331,Heinzman; Erica M.,16,0,30,14
1714624934899,EDS 206R,A00,507332,Staff,0,4,30,30
1714624934899,EDS 206R,B00,507343,Staff,17,0,30,13
1714624935924,EDS 250,A00,507344,Hemans; Patricia Ann Benitez,22,0,40,18
1714624936950,EDS 281,A00,507345,Daly; Alan J.,18,0,18,0
1714624937976,EDS 284,A00,507350,Daly; Alan J.,16,0,16,0
1714624939005,EDS 286,A00,507359,Fine; Sarah,18,0,18,0
1714624940033,EDS 289C,A01,507361,Daly; Alan J.,18,0,18,0
1714624941058,EDS 290,A00,507366,Hofstetter; Carolyn,15,0,15,0
1714624942091,LIGM 5A,A00,507421,Fischer-Grunski; Eva K,18,0,20,2
1714624943119,LIGM 5B,A00,507423,Fischer-Grunski; Eva K,19,0,20,1
1714624944144,LIGM 5C,A00,507425,Fischer-Grunski; Eva K,19,0,20,1
1714624945170,LIIT 5AS,A00,507427,Carnelos; Chiara,20,0,20,0
1714624946196,LIIT 5BS,A00,507430,Carnelos; Chiara,20,0,20,0
1714624947221,LIIT 5CS,A00,507432,Carnelos; Chiara,20,0,20,0
1714624948251,LISP 5A,A00,507541,Munoz Sanchez; Alicia,11,0,20,9
1714624949275,LISP 5B,A00,507671,Munoz Sanchez; Alicia,8,0,20,12
1714624950299,LISP 5C,A00,507696,Munoz Sanchez; Alicia,9,0,20,11
1714624951326,MAE 197,001,528363,Boechler; Nicholas Sebastia,9998,0,9999,1
1714624952359,MATH 197,001,523477,Kedlaya; Kiran S.,9995,0,9999,4
1714624952359,MATH 197,002,563811,Zhang; Danna,9995,0,9999,4
1714624952359,MATH 197,003,628552,Dumitriu; Ioana,9998,0,9999,1
1714624953383,MCWP 40R,A00,518780,Staff,2,0,20,18
1714624953383,MCWP 40R,B00,518781,Staff,8,0,20,12
1714624953383,MCWP 40R,C00,518783,Staff,6,0,20,14
1714624954414,MCWP 50R,A00,518791,Staff,0,0,20,20
1714624954414,MCWP 50R,B00,518792,Staff,0,2,20,20
1714624954414,MCWP 50R,C00,518793,Staff,0,2,20,20
1714624954414,MCWP 50R,D00,518794,Staff,0,0,20,20
1714624954414,MCWP 50R,E00,518795,Staff,0,2,20,20
1714624954414,MCWP 50R,F00,518796,Staff,0,0,20,20
1714624954414,MCWP 50R,G00,518797,Staff,0,1,20,20
1714624955440,MMW 12R,A01,514034,Herbst; Matthew,0,0,16,16
1714624955440,MMW 12R,A02,514035,Herbst; Matthew,1,0,16,15
1714624956467,MMW 13R,A01,514037,Staff,0,4,16,16
1714624956467,MMW 13R,A02,514039,Staff,0,2,16,16
1714624956467,MMW 13R,A03,628519,Staff,0,2,16,16
1714624958522,SIO 295LS,A00,523233,Staff,10,0,30,20
1714624959550,SIO 295S,A00,523232,Staff,10,0,30,20
1714624960577,SIOC 290S,A01,637330,Merrifield; Mark A,23,0,30,7
1714624961603,SIOC 291S,A01,637333,Gabriel; Corey John,23,0,30,7
1714624962629,SOCI 117,A01,494376,Staff,0,4,5,5
1714624963654,WES 237B,A00,494380,Staff,9,0,20,11
1714624965722,AESE 279B,A00,494370,Wade; Jon P,0,0,33,33
1714624966747,AIP 197,001,627712,Vespa; Emanuel Ignacio,9998,0,9999,1
1714624967773,ANAR 135S,A00,494369,Braswell; Geoffrey E.,0,0,0,0
1714624968797,BENG 196,001,628496,Engler; Adam J.,9998,0,9999,1
1714624969823,CAT 124RS,A01,519847,Geibel; William,0,0,20,20
1714624970852,CAT 125RS,A01,515971,Geibel; William,0,0,20,20
1714624971877,CLRE 250,A00,511389,Morris; Sheldon,9993,0,9999,6
1714624972906,CLRE 251,A00,507176,Mehta; Ravindra L.,9993,0,9999,6
1714624972906,CLRE 251,B00,511410,Mehta; Ravindra L.,9998,0,9999,1
1714624973935,CLRE 252,A00,507189,Cuomo; Raphael Eduardo,9995,0,9999,4
1714624974962,CLRE 253,A00,507199,Vaida; Florin,9994,0,9999,5
1714624974962,CLRE 253,B00,507202,Vaida; Florin,9999,0,9999,0
1714624975987,CLRE 259,A00,507211,Patel; Hemal,9996,0,9999,3
1714624977012,CLRE 260,A00,507221,Cuomo; Raphael Eduardo,9999,0,9999,0
1714624978037,CLRE 297,001,507242,Cuomo; Raphael Eduardo,9999,0,9999,0
1714624979063,COGS 197,001,638244,Voytek; Bradley Thomas,9998,0,9999,1
1714624980091,CSE 191,A00,516875,Minnes Kemp; Mor Mia,9992,0,9999,7
1714624981116,CSE 197,001,637388,Minnes Kemp; Mor Mia,9998,0,9999,1
1714624982142,CSS 201S,A01,494383,Staff,35,0,35,0
1714624983167,CSS 202S,A01,494387,Staff,35,0,35,0
1714624984195,DSC 197,001,628532,Eldridge; Justin Matthew,9996,0,9999,3
1714624985221,EAP 100,A00,516065,Staff,9797,0,9999,202
1714624986248,ECE 45,A01,507414,Staff,33,0,60,27
1714624988301,ECE 111,A01,507420,Staff,15,0,50,35
1714624989326,ECE 197,001,548057,Sievenpiper; Daniel F.,9993,0,9999,6
1714624990357,EDS 115,A00,507243,Choi; Bailey Miyeon,10,0,28,18
1714624991386,EDS 117,A01,494379,Staff,1,5,30,29
1714624992412,EDS 125,A00,507246,Hopkins; Megan Beth,9,0,30,21
1714624993442,EDS 128A,A01,507264,Fargason; Sharon Gayle,8,0,26,18
1714624994471,EDS 128B,A01,507293,Pappas; Elizabeth,12,0,30,18
1714624995500,EDS 139,A00,507294,Fargason; Sharon Gayle,13,0,30,17
1714624995500,EDS 139,B00,507313,Pappas; Elizabeth,13,0,30,17
1714624996529,EDS 201,A00,507315,Staff,13,0,30,17
1714624997554,EDS 203,A01,507317,Halter; Christopher P.,12,0,30,18
1714624998581,EDS 204R,A01,507319,Halter; Christopher P.,0,3,30,30
1714624998581,EDS 204R,B01,507331,Heinzman; Erica M.,16,0,30,14
1714624999605,EDS 206R,A00,507332,Staff,0,4,30,30
1714624999605,EDS 206R,B00,507343,Staff,17,0,30,13
1714625000631,EDS 250,A00,507344,Hemans; Patricia Ann Benitez,22,0,40,18
1714625001655,EDS 281,A00,507345,Daly; Alan J.,18,0,18,0
1714625002682,EDS 284,A00,507350,Daly; Alan J.,16,0,16,0
1714625003708,EDS 286,A00,507359,Fine; Sarah,18,0,18,0
1714625004734,EDS 289C,A01,507361,Daly; Alan J.,18,0,18,0
1714625005759,EDS 290,A00,507366,Hofstetter; Carolyn,15,0,15,0
1714625006785,LIGM 5A,A00,507421,Fischer-Grunski; Eva K,18,0,20,2
1714625007811,LIGM 5B,A00,507423,Fischer-Grunski; Eva K,19,0,20,1
1714625008837,LIGM 5C,A00,507425,Fischer-Grunski; Eva K,19,0,20,1
1714625009863,LIIT 5AS,A00,507427,Carnelos; Chiara,20,0,20,0
1714625010889,LIIT 5BS,A00,507430,Carnelos; Chiara,20,0,20,0
1714625011914,LIIT 5CS,A00,507432,Carnelos; Chiara,20,0,20,0
1714625012939,LISP 5A,A00,507541,Munoz Sanchez; Alicia,11,0,20,9
1714625013966,LISP 5B,A00,507671,Munoz Sanchez; Alicia,8,0,20,12
1714625014993,LISP 5C,A00,507696,Munoz Sanchez; Alicia,9,0,20,11
1714625016019,MAE 197,001,528363,Boechler; Nicholas Sebastia,9998,0,9999,1
1714625017063,MATH 197,001,523477,Kedlaya; Kiran S.,9995,0,9999,4
1714625017063,MATH 197,002,563811,Zhang; Danna,9995,0,9999,4
1714625017063,MATH 197,003,628552,Dumitriu; Ioana,9998,0,9999,1
1714625018088,MCWP 40R,A00,518780,Staff,2,0,20,18
1714625018088,MCWP 40R,B00,518781,Staff,8,0,20,12
1714625018088,MCWP 40R,C00,518783,Staff,6,0,20,14
1714625019119,MCWP 50R,A00,518791,Staff,0,0,20,20
1714625019119,MCWP 50R,B00,518792,Staff,0,2,20,20
1714625019119,MCWP 50R,C00,518793,Staff,0,2,20,20
1714625019119,MCWP 50R,D00,518794,Staff,0,0,20,20
1714625019119,MCWP 50R,E00,518795,Staff,0,2,20,20
1714625019119,MCWP 50R,F00,518796,Staff,0,0,20,20
1714625019119,MCWP 50R,G00,518797,Staff,0,1,20,20
1714625020150,MMW 12R,A01,514034,Herbst; Matthew,0,0,16,16
1714625020150,MMW 12R,A02,514035,Herbst; Matthew,1,0,16,15
1714625021178,MMW 13R,A01,514037,Staff,0,4,16,16
1714625021178,MMW 13R,A02,514039,Staff,0,2,16,16
1714625021178,MMW 13R,A03,628519,Staff,0,2,16,16
1714625023231,SIO 295LS,A00,523233,Staff,10,0,30,20
1714625024261,SIO 295S,A00,523232,Staff,10,0,30,20
1714625025298,SIOC 290S,A01,637330,Merrifield; Mark A,23,0,30,7
1714625026325,SIOC 291S,A01,637333,Gabriel; Corey John,23,0,30,7
1714625027405,SOCI 117,A01,494376,Staff,0,4,5,5
1714625028430,WES 237B,A00,494380,Staff,9,0,20,11
1714625030512,AESE 279B,A00,494370,Wade; Jon P,0,0,33,33
1714625031541,AIP 197,001,627712,Vespa; Emanuel Ignacio,9998,0,9999,1
1714625032567,ANAR 135S,A00,494369,Braswell; Geoffrey E.,0,0,0,0
1714625033593,BENG 196,001,628496,Engler; Adam J.,9998,0,9999,1
1714625034620,CAT 124RS,A01,519847,Geibel; William,0,0,20,20
1714625035646,CAT 125RS,A01,515971,Geibel; William,0,0,20,20
1714625036673,CLRE 250,A00,511389,Morris; Sheldon,9993,0,9999,6
1714625037700,CLRE 251,A00,507176,Mehta; Ravindra L.,9993,0,9999,6
1714625037700,CLRE 251,B00,511410,Mehta; Ravindra L.,9998,0,9999,1
1714625038730,CLRE 252,A00,507189,Cuomo; Raphael Eduardo,9995,0,9999,4
1714625039756,CLRE 253,A00,507199,Vaida; Florin,9994,0,9999,5
1714625039756,CLRE 253,B00,507202,Vaida; Florin,9999,0,9999,0
1714625040783,CLRE 259,A00,507211,Patel; Hemal,9996,0,9999,3
1714625041809,CLRE 260,A00,507221,Cuomo; Raphael Eduardo,9999,0,9999,0
1714625042833,CLRE 297,001,507242,Cuomo; Raphael Eduardo,9999,0,9999,0
1714625043875,COGS 197,001,638244,Voytek; Bradley Thomas,9998,0,9999,1
1714625044900,CSE 191,A00,516875,Minnes Kemp; Mor Mia,9992,0,9999,7
1714625045923,CSE 197,001,637388,Minnes Kemp; Mor Mia,9998,0,9999,1
1714625046951,CSS 201S,A01,494383,Staff,35,0,35,0
1714625047976,CSS 202S,A01,494387,Staff,35,0,35,0
1714625049007,DSC 197,001,628532,Eldridge; Justin Matthew,9996,0,9999,3
1714625050031,EAP 100,A00,516065,Staff,9797,0,9999,202
1714625051058,ECE 45,A01,507414,Staff,33,0,60,27
1714625053111,ECE 111,A01,507420,Staff,15,0,50,35
1714625054137,ECE 197,001,548057,Sievenpiper; Daniel F.,9993,0,9999,6
1714625055164,EDS 115,A00,507243,Choi; Bailey Miyeon,10,0,28,18
1714625056194,EDS 117,A01,494379,Staff,1,5,30,29
1714625057223,EDS 125,A00,507246,Hopkins; Megan Beth,9,0,30,21
1714625058247,EDS 128A,A01,507264,Fargason; Sharon Gayle,8,0,26,18
1714625059273,EDS 128B,A01,507293,Pappas; Elizabeth,12,0,30,18
1714625060302,EDS 139,A00,507294,Fargason; Sharon Gayle,13,0,30,17
1714625060302,EDS 139,B00,507313,Pappas; Elizabeth,13,0,30,17
1714625061329,EDS 201,A00,507315,Staff,13,0,30,17
1714625062354,EDS 203,A01,507317,Halter; Christopher P.,12,0,30,18
1714625063382,EDS 204R,A01,507319,Halter; Christopher P.,0,3,30,30
1714625063382,EDS 204R,B01,507331,Heinzman; Erica M.,16,0,30,14
1714625064408,EDS 206R,A00,507332,Staff,0,4,30,30
1714625064408,EDS 206R,B00,507343,Staff,17,0,30,13
1714625065436,EDS 250,A00,507344,Hemans; Patricia Ann Benitez,22,0,40,18
1714625066463,EDS 281,A00,507345,Daly; Alan J.,18,0,18,0
1714625067487,EDS 284,A00,507350,Daly; Alan J.,16,0,16,0
1714625068516,EDS 286,A00,507359,Fine; Sarah,18,0,18,0
1714625069540,EDS 289C,A01,507361,Daly; Alan J.,18,0,18,0
1714625070568,EDS 290,A00,507366,Hofstetter; Carolyn,15,0,15,0
1714625071720,LIGM 5A,A00,507421,Fischer-Grunski; Eva K,18,0,20,2
1714625072748,LIGM 5B,A00,507423,Fischer-Grunski; Eva K,19,0,20,1
1714625073772,LIGM 5C,A00,507425,Fischer-Grunski; Eva K,19,0,20,1
1714625074805,LIIT 5AS,A00,507427,Carnelos; Chiara,20,0,20,0
1714625075834,LIIT 5BS,A00,507430,Carnelos; Chiara,20,0,20,0
1714625076859,LIIT 5CS,A00,507432,Carnelos; Chiara,20,0,20,0
1714625077889,LISP 5A,A00,507541,Munoz Sanchez; Alicia,11,0,20,9
1714625078915,LISP 5B,A00,507671,Munoz Sanchez; Alicia,8,0,20,12
1714625079940,LISP 5C,A00,507696,Munoz Sanchez; Alicia,9,0,20,11
1714625080966,MAE 197,001,528363,Boechler; Nicholas Sebastia,9998,0,9999,1
1714625081997,MATH 197,001,523477,Kedlaya; Kiran S.,9995,0,9999,4
1714625081997,MATH 197,002,563811,Zhang; Danna,9995,0,9999,4
1714625081997,MATH 197,003,628552,Dumitriu; Ioana,9998,0,9999,1
1714625083025,MCWP 40R,A00,518780,Staff,2,0,20,18
1714625083025,MCWP 40R,B00,518781,Staff,8,0,20,12
1714625083025,MCWP 40R,C00,518783,Staff,6,0,20,14
1714625084050,MCWP 50R,A00,518791,Staff,0,0,20,20
1714625084050,MCWP 50R,B00,518792,Staff,0,2,20,20
1714625084050,MCWP 50R,C00,518793,Staff,0,2,20,20
1714625084050,MCWP 50R,D00,518794,Staff,0,0,20,20
1714625084050,MCWP 50R,E00,518795,Staff,0,2,20,20
1714625084050,MCWP 50R,F00,518796,Staff,0,0,20,20
1714625084050,MCWP 50R,G00,518797,Staff,0,1,20,20
1714625085077,MMW 12R,A01,514034,Herbst; Matthew,0,0,16,16
1714625085077,MMW 12R,A02,514035,Herbst; Matthew,1,0,16,15
1714625086102,MMW 13R,A01,514037,Staff,0,4,16,16
1714625086102,MMW 13R,A02,514039,Staff,0,2,16,16
1714625086102,MMW 13R,A03,628519,Staff,0,2,16,16
1714625088154,SIO 295LS,A00,523233,Staff,10,0,30,20
1714625089182,SIO 295S,A00,523232,Staff,10,0,30,20
1714625090210,SIOC 290S,A01,637330,Merrifield; Mark A,23,0,30,7
1714625091238,SIOC 291S,A01,637333,Gabriel; Corey John,23,0,30,7
1714625092269,SOCI 117,A01,494376,Staff,0,4,5,5
1714625093298,WES 237B,A00,494380,Staff,9,0,20,11
1714625095368,AESE 279B,A00,494370,Wade; Jon P,0,0,33,33
1714625096394,AIP 197,001,627712,Vespa; Emanuel Ignacio,9998,0,9999,1
1714625097422,ANAR 135S,A00,494369,Braswell; Geoffrey E.,0,0,0,0
1714625098448,BENG 196,001,628496,Engler; Adam J.,9998,0,9999,1
1714625099476,CAT 124RS,A01,519847,Geibel; William,0,0,20,20
1714625100504,CAT 125RS,A01,515971,Geibel; William,0,0,20,20
1714625101530,CLRE 250,A00,511389,Morris; Sheldon,9993,0,9999,6
1714625102558,CLRE 251,A00,507176,Mehta; Ravindra L.,9993,0,9999,6
1714625102558,CLRE 251,B00,511410,Mehta; Ravindra L.,9998,0,9999,1
1714625103585,CLRE 252,A00,507189,Cuomo; Raphael Eduardo,9995,0,9999,4
1714625104610,CLRE 253,A00,507199,Vaida; Florin,9994,0,9999,5
1714625104610,CLRE 253,B00,507202,Vaida; Florin,9999,0,9999,0
1714625105634,CLRE 259,A00,507211,Patel; Hemal,9996,0,9999,3
1714625106662,CLRE 260,A00,507221,Cuomo; Raphael Eduardo,9999,0,9999,0
1714625107685,CLRE 297,001,507242,Cuomo; Raphael Eduardo,9999,0,9999,0
1714625108713,COGS 197,001,638244,Voytek; Bradley Thomas,9998,0,9999,1
1714625109738,CSE 191,A00,516875,Minnes Kemp; Mor Mia,9992,0,9999,7
1714625110763,CSE 197,001,637388,Minnes Kemp; Mor Mia,9998,0,9999,1
1714625111788,CSS 201S,A01,494383,Staff,35,0,35,0
1714625112813,CSS 202S,A01,494387,Staff,35,0,35,0
1714625113839,DSC 197,001,628532,Eldridge; Justin Matthew,9996,0,9999,3
1714625114865,EAP 100,A00,516065,Staff,9797,0,9999,202
1714625115894,ECE 45,A01,507414,Staff,33,0,60,27
1714625117965,ECE 111,A01,507420,Staff,15,0,50,35
1714625118992,ECE 197,001,548057,Sievenpiper; Daniel F.,9993,0,9999,6
1714625120018,EDS 115,A00,507243,Choi; Bailey Miyeon,10,0,28,18
1714625121046,EDS 117,A01,494379,Staff,1,5,30,29
1714625122072,EDS 125,A00,507246,Hopkins; Megan Beth,9,0,30,21
1714625123098,EDS 128A,A01,507264,Fargason; Sharon Gayle,8,0,26,18
1714625124124,EDS 128B,A01,507293,Pappas; Elizabeth,12,0,30,18
1714625125151,EDS 139,A00,507294,Fargason; Sharon Gayle,13,0,30,17
1714625125151,EDS 139,B00,507313,Pappas; Elizabeth,13,0,30,17
1714625126177,EDS 201,A00,507315,Staff,13,0,30,17
1714625127207,EDS 203,A01,507317,Halter; Christopher P.,12,0,30,18
1714625128232,EDS 204R,A01,507319,Halter; Christopher P.,0,3,30,30
1714625128232,EDS 204R,B01,507331,Heinzman; Erica M.,16,0,30,14
1714625129257,EDS 206R,A00,507332,Staff,0,4,30,30
1714625129257,EDS 206R,B00,507343,Staff,17,0,30,13
1714625130286,EDS 250,A00,507344,Hemans; Patricia Ann Benitez,22,0,40,18
1714625131311,EDS 281,A00,507345,Daly; Alan J.,18,0,18,0
1714625132336,EDS 284,A00,507350,Daly; Alan J.,16,0,16,0
1714625133361,EDS 286,A00,507359,Fine; Sarah,18,0,18,0
1714625134386,EDS 289C,A01,507361,Daly; Alan J.,18,0,18,0
1714625135409,EDS 290,A00,507366,Hofstetter; Carolyn,15,0,15,0
1714625136436,LIGM 5A,A00,507421,Fischer-Grunski; Eva K,18,0,20,2
1714625137461,LIGM 5B,A00,507423,Fischer-Grunski; Eva K,19,0,20,1
1714625138486,LIGM 5C,A00,507425,Fischer-Grunski; Eva K,19,0,20,1
1714625139513,LIIT 5AS,A00,507427,Carnelos; Chiara,20,0,20,0
1714625140541,LIIT 5BS,A00,507430,Carnelos; Chiara,20,0,20,0
1714625141571,LIIT 5CS,A00,507432,Carnelos; Chiara,20,0,20,0
1714625142596,LISP 5A,A00,507541,Munoz Sanchez; Alicia,11,0,20,9
1714625143625,LISP 5B,A00,507671,Munoz Sanchez; Alicia,8,0,20,12
1714625144649,LISP 5C,A00,507696,Munoz Sanchez; Alicia,9,0,20,11
1714625145674,MAE 197,001,528363,Boechler; Nicholas Sebastia,9998,0,9999,1
1714625146700,MATH 197,001,523477,Kedlaya; Kiran S.,9995,0,9999,4
1714625146700,MATH 197,002,563811,Zhang; Danna,9995,0,9999,4
1714625146700,MATH 197,003,628552,Dumitriu; Ioana,9998,0,9999,1
1714625147728,MCWP 40R,A00,518780,Staff,2,0,20,18
1714625147728,MCWP 40R,B00,518781,Staff,8,0,20,12
1714625147728,MCWP 40R,C00,518783,Staff,6,0,20,14
1714625148758,MCWP 50R,A00,518791,Staff,0,0,20,20
1714625148758,MCWP 50R,B00,518792,Staff,0,2,20,20
1714625148758,MCWP 50R,C00,518793,Staff,0,2,20,20
1714625148758,MCWP 50R,D00,518794,Staff,0,0,20,20
1714625148758,MCWP 50R,E00,518795,Staff,0,2,20,20
1714625148758,MCWP 50R,F00,518796,Staff,0,0,20,20
1714625148758,MCWP 50R,G00,518797,Staff,0,1,20,20
1714625149784,MMW 12R,A01,514034,Herbst; Matthew,0,0,16,16
1714625149784,MMW 12R,A02,514035,Herbst; Matthew,1,0,16,15
1714625150812,MMW 13R,A01,514037,Staff,0,4,16,16
1714625150812,MMW 13R,A02,514039,Staff,0,2,16,16
1714625150812,MMW 13R,A03,628519,Staff,0,2,16,16
1714625152867,SIO 295LS,A00,523233,Staff,10,0,30,20
1714625153908,SIO 295S,A00,523232,Staff,10,0,30,20
1714625154941,SIOC 290S,A01,637330,Merrifield; Mark A,23,0,30,7
1714625155967,SIOC 291S,A01,637333,Gabriel; Corey John,23,0,30,7
1714625156993,SOCI 117,A01,494376,Staff,0,4,5,5
1714625158021,WES 237B,A00,494380,Staff,9,0,20,11
1714625160086,AESE 279B,A00,494370,Wade; Jon P,0,0,33,33
1714625161113,AIP 197,001,627712,Vespa; Emanuel Ignacio,9998,0,9999,1
1714625162139,ANAR 135S,A00,494369,Braswell; Geoffrey E.,0,0,0,0
1714625163165,BENG 196,001,628496,Engler; Adam J.,9998,0,9999,1
1714625164196,CAT 124RS,A01,519847,Geibel; William,0,0,20,20
1714625165224,CAT 125RS,A01,515971,Geibel; William,0,0,20,20
1714625166254,CLRE 250,A00,511389,Morris; Sheldon,9993,0,9999,6
1714625167279,CLRE 251,A00,507176,Mehta; Ravindra L.,9993,0,9999,6
1714625167279,CLRE 251,B00,511410,Mehta; Ravindra L.,9998,0,9999,1
1714625168305,CLRE 252,A00,507189,Cuomo; Raphael Eduardo,9995,0,9999,4
1714625169330,CLRE 253,A00,507199,Vaida; Florin,9994,0,9999,5
1714625169330,CLRE 253,B00,507202,Vaida; Florin,9999,0,9999,0
1714625170356,CLRE 259,A00,507211,Patel; Hemal,9996,0,9999,3
1714625171385,CLRE 260,A00,507221,Cuomo; Raphael Eduardo,9999,0,9999,0
1714625172412,CLRE 297,001,507242,Cuomo; Raphael Eduardo,9999,0,9999,0
1714625173438,COGS 197,001,638244,Voytek; Bradley Thomas,9998,0,9999,1
1714625174465,CSE 191,A00,516875,Minnes Kemp; Mor Mia,9992,0,9999,7
1714625175490,CSE 197,001,637388,Minnes Kemp; Mor Mia,9998,0,9999,1
1714625176520,CSS 201S,A01,494383,Staff,35,0,35,0
1714625177547,CSS 202S,A01,494387,Staff,35,0,35,0
1714625178576,DSC 197,001,628532,Eldridge; Justin Matthew,9996,0,9999,3
1714625179604,EAP 100,A00,516065,Staff,9797,0,9999,202
1714625180631,ECE 45,A01,507414,Staff,33,0,60,27
1714625182685,ECE 111,A01,507420,Staff,15,0,50,35
1714625183709,ECE 197,001,548057,Sievenpiper; Daniel F.,9993,0,9999,6
1714625184739,EDS 115,A00,507243,Choi; Bailey Miyeon,10,0,28,18
1714625185769,EDS 117,A01,494379,Staff,1,5,30,29
1714625186794,EDS 125,A00,507246,Hopkins; Megan Beth,9,0,30,21
1714625187819,EDS 128A,A01,507264,Fargason; Sharon Gayle,8,0,26,18
1714625188845,EDS 128B,A01,507293,Pappas; Elizabeth,12,0,30,18
1714625189869,EDS 139,A00,507294,Fargason; Sharon Gayle,13,0,30,17
1714625189869,EDS 139,B00,507313,Pappas; Elizabeth,13,0,30,17
1714625190898,EDS 201,A00,507315,Staff,13,0,30,17
1714625191929,EDS 203,A01,507317,Halter; Christopher P.,12,0,30,18
1714625192957,EDS 204R,A01,507319,Halter; Christopher P.,0,3,30,30
1714625192957,EDS 204R,B01,507331,Heinzman; Erica M.,16,0,30,14
1714625193983,EDS 206R,A00,507332,Staff,0,4,30,30
1714625193983,EDS 206R,B00,507343,Staff,17,0,30,13
1714625195008,EDS 250,A00,507344,Hemans; Patricia Ann Benitez,22,0,40,18
1714625196108,EDS 281,A00,507345,Daly; Alan J.,18,0,18,0
1714625197138,EDS 284,A00,507350,Daly; Alan J.,16,0,16,0
1714625198163,EDS 286,A00,507359,Fine; Sarah,18,0,18,0
1714625199193,EDS 289C,A01,507361,Daly; Alan J.,18,0,18,0
1714625200223,EDS 290,A00,507366,Hofstetter; Carolyn,15,0,15,0
1714625201251,LIGM 5A,A00,507421,Fischer-Grunski; Eva K,18,0,20,2
1714625202281,LIGM 5B,A00,507423,Fischer-Grunski; Eva K,19,0,20,1
1714625203308,LIGM 5C,A00,507425,Fischer-Grunski; Eva K,19,0,20,1
1714625204338,LIIT 5AS,A00,507427,Carnelos; Chiara,20,0,20,0
1714625205364,LIIT 5BS,A00,507430,Carnelos; Chiara,20,0,20,0
1714625206389,LIIT 5CS,A00,507432,Carnelos; Chiara,20,0,20,0
1714625207415,LISP 5A,A00,507541,Munoz Sanchez; Alicia,11,0,20,9
1714625208439,LISP 5B,A00,507671,Munoz Sanchez; Alicia,8,0,20,12
1714625209469,LISP 5C,A00,507696,Munoz Sanchez; Alicia,9,0,20,11
1714625210500,MAE 197,001,528363,Boechler; Nicholas Sebastia,9998,0,9999,1
1714625211526,MATH 197,001,523477,Kedlaya; Kiran S.,9995,0,9999,4
1714625211526,MATH 197,002,563811,Zhang; Danna,9995,0,9999,4
1714625211526,MATH 197,003,628552,Dumitriu; Ioana,9998,0,9999,1
1714625212557,MCWP 40R,A00,518780,Staff,2,0,20,18
1714625212557,MCWP 40R,B00,518781,Staff,8,0,20,12
1714625212557,MCWP 40R,C00,518783,Staff,6,0,20,14
1714625213584,MCWP 50R,A00,518791,Staff,0,0,20,20
1714625213584,MCWP 50R,B00,518792,Staff,0,2,20,20
1714625213584,MCWP 50R,C00,518793,Staff,0,2,20,20
1714625213584,MCWP 50R,D00,518794,Staff,0,0,20,20
1714625213584,MCWP 50R,E00,518795,Staff,0,2,20,20
1714625213584,MCWP 50R,F00,518796,Staff,0,0,20,20
1714625213584,MCWP 50R,G00,518797,Staff,0,1,20,20
1714625214610,MMW 12R,A01,514034,Herbst; Matthew,0,0,16,16
1714625214610,MMW 12R,A02,514035,Herbst; Matthew,1,0,16,15
1714625215636,MMW 13R,A01,514037,Staff,0,4,16,16
1714625215636,MMW 13R,A02,514039,Staff,0,2,16,16
1714625215636,MMW 13R,A03,628519,Staff,0,2,16,16
1714625217687,SIO 295LS,A00,523233,Staff,10,0,30,20
1714625218712,SIO 295S,A00,523232,Staff,10,0,30,20
1714625219739,SIOC 290S,A01,637330,Merrifield; Mark A,23,0,30,7
1714625220766,SIOC 291S,A01,637333,Gabriel; Corey John,23,0,30,7
1714625221791,SOCI 117,A01,494376,Staff,0,4,5,5
1714625222818,WES 237B,A00,494380,Staff,9,0,20,11
1714625224899,AESE 279B,A00,494370,Wade; Jon P,0,0,33,33
1714625225927,AIP 197,001,627712,Vespa; Emanuel Ignacio,9998,0,9999,1
1714625226954,ANAR 135S,A00,494369,Braswell; Geoffrey E.,0,0,0,0
1714625227982,BENG 196,001,628496,Engler; Adam J.,9998,0,9999,1
1714625229011,CAT 124RS,A01,519847,Geibel; William,0,0,20,20
1714625230036,CAT 125RS,A01,515971,Geibel; William,0,0,20,20
1714625231064,CLRE 250,A00,511389,Morris; Sheldon,9993,0,9999,6
1714625232095,CLRE 251,A00,507176,Mehta; Ravindra L.,9993,0,9999,6
1714625232095,CLRE 251,B00,511410,Mehta; Ravindra L.,9998,0,9999,1
1714625233123,CLRE 252,A00,507189,Cuomo; Raphael Eduardo,9995,0,9999,4
1714625234153,CLRE 253,A00,507199,Vaida; Florin,9994,0,9999,5
1714625234153,CLRE 253,B00,507202,Vaida; Florin,9999,0,9999,0
1714625235183,CLRE 259,A00,507211,Patel; Hemal,9996,0,9999,3
1714625236210,CLRE 260,A00,507221,Cuomo; Raphael Eduardo,9999,0,9999,0
1714625237237,CLRE 297,001,507242,Cuomo; Raphael Eduardo,9999,0,9999,0
1714625238263,COGS 197,001,638244,Voytek; Bradley Thomas,9998,0,9999,1
1714625239293,CSE 191,A00,516875,Minnes Kemp; Mor Mia,9992,0,9999,7
1714625240319,CSE 197,001,637388,Minnes Kemp; Mor Mia,9998,0,9999,1
1714625241351,CSS 201S,A01,494383,Staff,35,0,35,0
1714625242374,CSS 202S,A01,494387,Staff,35,0,35,0
1714625243400,DSC 197,001,628532,Eldridge; Justin Matthew,9996,0,9999,3
1714625244426,EAP 100,A00,516065,Staff,9797,0,9999,202
1714625245458,ECE 45,A01,507414,Staff,33,0,60,27
1714625247508,ECE 111,A01,507420,Staff,15,0,50,35
1714625248533,ECE 197,001,548057,Sievenpiper; Daniel F.,9993,0,9999,6
1714625249557,EDS 115,A00,507243,Choi; Bailey Miyeon,10,0,28,18
1714625250584,EDS 117,A01,494379,Staff,1,5,30,29
1714625251613,EDS 125,A00,507246,Hopkins; Megan Beth,9,0,30,21
1714625252641,EDS 128A,A01,507264,Fargason; Sharon Gayle,8,0,26,18
1714625253671,EDS 128B,A01,507293,Pappas; Elizabeth,12,0,30,18
1714625254697,EDS 139,A00,507294,Fargason; Sharon Gayle,13,0,30,17
1714625254697,EDS 139,B00,507313,Pappas; Elizabeth,13,0,30,17
1714625255723,EDS 201,A00,507315,Staff,13,0,30,17
1714625256753,EDS 203,A01,507317,Halter; Christopher P.,12,0,30,18
1714625257780,EDS 204R,A01,507319,Halter; Christopher P.,0,3,30,30
1714625257780,EDS 204R,B01,507331,Heinzman; Erica M.,16,0,30,14
1714625258808,EDS 206R,A00,507332,Staff,0,4,30,30
1714625258808,EDS 206R,B00,507343,Staff,17,0,30,13
1714625259833,EDS 250,A00,507344,Hemans; Patricia Ann Benitez,22,0,40,18
1714625260858,EDS 281,A00,507345,Daly; Alan J.,18,0,18,0
1714625261882,EDS 284,A00,507350,Daly; Alan J.,16,0,16,0
1714625262907,EDS 286,A00,507359,Fine; Sarah,18,0,18,0
1714625263935,EDS 289C,A01,507361,Daly; Alan J.,18,0,18,0
1714625264961,EDS 290,A00,507366,Hofstetter; Carolyn,15,0,15,0
1714625265988,LIGM 5A,A00,507421,Fischer-Grunski; Eva K,18,0,20,2
1714625267013,LIGM 5B,A00,507423,Fischer-Grunski; Eva K,19,0,20,1
1714625268040,LIGM 5C,A00,507425,Fischer-Grunski; Eva K,19,0,20,1
1714625269067,LIIT 5AS,A00,507427,Carnelos; Chiara,20,0,20,0
1714625270096,LIIT 5BS,A00,507430,Carnelos; Chiara,20,0,20,0
1714625271125,LIIT 5CS,A00,507432,Carnelos; Chiara,20,0,20,0
1714625272152,LISP 5A,A00,507541,Munoz Sanchez; Alicia,11,0,20,9
1714625273181,LISP 5B,A00,507671,Munoz Sanchez; Alicia,8,0,20,12
1714625274211,LISP 5C,A00,507696,Munoz Sanchez; Alicia,9,0,20,11
1714625275238,MAE 197,001,528363,Boechler; Nicholas Sebastia,9998,0,9999,1
1714625276273,MATH 197,001,523477,Kedlaya; Kiran S.,9995,0,9999,4
1714625276273,MATH 197,002,563811,Zhang; Danna,9995,0,9999,4
1714625276273,MATH 197,003,628552,Dumitriu; Ioana,9998,0,9999,1
1714625277297,MCWP 40R,A00,518780,Staff,2,0,20,18
1714625277297,MCWP 40R,B00,518781,Staff,8,0,20,12
1714625277297,MCWP 40R,C00,518783,Staff,6,0,20,14
1714625278322,MCWP 50R,A00,518791,Staff,0,0,20,20
1714625278322,MCWP 50R,B00,518792,Staff,0,2,20,20
1714625278322,MCWP 50R,C00,518793,Staff,0,2,20,20
1714625278322,MCWP 50R,D00,518794,Staff,0,0,20,20
1714625278322,MCWP 50R,E00,518795,Staff,0,2,20,20
1714625278322,MCWP 50R,F00,518796,Staff,0,0,20,20
1714625278322,MCWP 50R,G00,518797,Staff,0,1,20,20
1714625279351,MMW 12R,A01,514034,Herbst; Matthew,0,0,16,16
1714625279351,MMW 12R,A02,514035,Herbst; Matthew,1,0,16,15
1714625280377,MMW 13R,A01,514037,Staff,0,4,16,16
1714625280377,MMW 13R,A02,514039,Staff,0,2,16,16
1714625280377,MMW 13R,A03,628519,Staff,0,2,16,16
1714625282432,SIO 295LS,A00,523233,Staff,10,0,30,20
1714625283460,SIO 295S,A00,523232,Staff,10,0,30,20
1714625284490,SIOC 290S,A01,637330,Merrifield; Mark A,23,0,30,7
1714625285519,SIOC 291S,A01,637333,Gabriel; Corey John,23,0,30,7
1714625286546,SOCI 117,A01,494376,Staff,0,4,5,5
1714625287571,WES 237B,A00,494380,Staff,9,0,20,11
1714625289652,AESE 279B,A00,494370,Wade; Jon P,0,0,33,33
1714625290681,AIP 197,001,627712,Vespa; Emanuel Ignacio,9998,0,9999,1
1714625291707,ANAR 135S,A00,494369,Braswell; Geoffrey E.,0,0,0,0
1714625292732,BENG 196,001,628496,Engler; Adam J.,9998,0,9999,1
1714625293762,CAT 124RS,A01,519847,Geibel; William,0,0,20,20
1714625294788,CAT 125RS,A01,515971,Geibel; William,0,0,20,20
1714625295816,CLRE 250,A00,511389,Morris; Sheldon,9993,0,9999,6
1714625296843,CLRE 251,A00,507176,Mehta; Ravindra L.,9993,0,9999,6
1714625296843,CLRE 251,B00,511410,Mehta; Ravindra L.,9998,0,9999,1
1714625297870,CLRE 252,A00,507189,Cuomo; Raphael Eduardo,9995,0,9999,4
1714625298900,CLRE 253,A00,507199,Vaida; Florin,9994,0,9999,5
1714625298900,CLRE 253,B00,507202,Vaida; Florin,9999,0,9999,0
1714625299980,CLRE 259,A00,507211,Patel; Hemal,9996,0,9999,3
1714625301005,CLRE 260,A00,507221,Cuomo; Raphael Eduardo,9999,0,9999,0
1714625302031,CLRE 297,001,507242,Cuomo; Raphael Eduardo,9999,0,9999,0
1714625303061,COGS 197,001,638244,Voytek; Bradley Thomas,9998,0,9999,1
1714625304090,CSE 191,A00,516875,Minnes Kemp; Mor Mia,9992,0,9999,7
1714625305116,CSE 197,001,637388,Minnes Kemp; Mor Mia,9998,0,9999,1
1714625306144,CSS 201S,A01,494383,Staff,35,0,35,0
1714625307172,CSS 202S,A01,494387,Staff,35,0,35,0
1714625308200,DSC 197,001,628532,Eldridge; Justin Matthew,9996,0,9999,3
1714625309280,EAP 100,A00,516065,Staff,9797,0,9999,202
1714625310306,ECE 45,A01,507414,Staff,33,0,60,27
1714625312363,ECE 111,A01,507420,Staff,15,0,50,35
1714625313387,ECE 197,001,548057,Sievenpiper; Daniel F.,9993,0,9999,6
1714625314412,EDS 115,A00,507243,Choi; Bailey Miyeon,10,0,28,18
1714625315440,EDS 117,A01,494379,Staff,1,5,30,29
1714625316467,EDS 125,A00,507246,Hopkins; Megan Beth,9,0,30,21
1714625317495,EDS 128A,A01,507264,Fargason; Sharon Gayle,8,0,26,18
1714625318524,EDS 128B,A01,507293,Pappas; Elizabeth,12,0,30,18
1714625319548,EDS 139,A00,507294,Fargason; Sharon Gayle,13,0,30,17
1714625319548,EDS 139,B00,507313,Pappas; Elizabeth,13,0,30,17
1714625320572,EDS 201,A00,507315,Staff,13,0,30,17
1714625321597,EDS 203,A01,507317,Halter; Christopher P.,12,0,30,18
1714625322622,EDS 204R,A01,507319,Halter; Christopher P.,0,3,30,30
1714625322622,EDS 204R,B01,507331,Heinzman; Erica M.,16,0,30,14
1714625323651,EDS 206R,A00,507332,Staff,0,4,30,30
1714625323651,EDS 206R,B00,507343,Staff,17,0,30,13
1714625324677,EDS 250,A00,507344,Hemans; Patricia Ann Benitez,22,0,40,18
1714625325703,EDS 281,A00,507345,Daly; Alan J.,18,0,18,0
1714625326727,EDS 284,A00,507350,Daly; Alan J.,16,0,16,0
1714625327758,EDS 286,A00,507359,Fine; Sarah,18,0,18,0
1714625328786,EDS 289C,A01,507361,Daly; Alan J.,18,0,18,0
1714625329815,EDS 290,A00,507366,Hofstetter; Carolyn,15,0,15,0
1714625330844,LIGM 5A,A00,507421,Fischer-Grunski; Eva K,18,0,20,2
1714625331871,LIGM 5B,A00,507423,Fischer-Grunski; Eva K,19,0,20,1
1714625332896,LIGM 5C,A00,507425,Fischer-Grunski; Eva K,19,0,20,1
1714625333920,LIIT 5AS,A00,507427,Carnelos; Chiara,20,0,20,0
1714625334949,LIIT 5BS,A00,507430,Carnelos; Chiara,20,0,20,0
1714625335975,LIIT 5CS,A00,507432,Carnelos; Chiara,20,0,20,0
1714625337000,LISP 5A,A00,507541,Munoz Sanchez; Alicia,11,0,20,9
1714625338030,LISP 5B,A00,507671,Munoz Sanchez; Alicia,8,0,20,12
1714625339056,LISP 5C,A00,507696,Munoz Sanchez; Alicia,9,0,20,11
1714625340089,MAE 197,001,528363,Boechler; Nicholas Sebastia,9998,0,9999,1
1714625341123,MATH 197,001,523477,Kedlaya; Kiran S.,9995,0,9999,4
1714625341123,MATH 197,002,563811,Zhang; Danna,9995,0,9999,4
1714625341123,MATH 197,003,628552,Dumitriu; Ioana,9998,0,9999,1
1714625342149,MCWP 40R,A00,518780,Staff,2,0,20,18
1714625342149,MCWP 40R,B00,518781,Staff,8,0,20,12
1714625342149,MCWP 40R,C00,518783,Staff,6,0,20,14
1714625343177,MCWP 50R,A00,518791,Staff,0,0,20,20
1714625343177,MCWP 50R,B00,518792,Staff,0,2,20,20
1714625343177,MCWP 50R,C00,518793,Staff,0,2,20,20
1714625343177,MCWP 50R,D00,518794,Staff,0,0,20,20
1714625343177,MCWP 50R,E00,518795,Staff,0,2,20,20
1714625343177,MCWP 50R,F00,518796,Staff,0,0,20,20
1714625343177,MCWP 50R,G00,518797,Staff,0,1,20,20
1714625344201,MMW 12R,A01,514034,Herbst; Matthew,0,0,16,16
1714625344201,MMW 12R,A02,514035,Herbst; Matthew,1,0,16,15
1714625345230,MMW 13R,A01,514037,Staff,0,4,16,16
1714625345230,MMW 13R,A02,514039,Staff,0,2,16,16
1714625345230,MMW 13R,A03,628519,Staff,0,2,16,16
1714625347317,SIO 295LS,A00,523233,Staff,10,0,30,20
1714625348344,SIO 295S,A00,523232,Staff,10,0,30,20
1714625349375,SIOC 290S,A01,637330,Merrifield; Mark A,23,0,30,7
1714625350401,SIOC 291S,A01,637333,Gabriel; Corey John,23,0,30,7
1714625351427,SOCI 117,A01,494376,Staff,0,4,5,5
1714625352451,WES 237B,A00,494380,Staff,9,0,20,11
1714625354538,AESE 279B,A00,494370,Wade; Jon P,0,0,33,33
1714625355566,AIP 197,001,627712,Vespa; Emanuel Ignacio,9998,0,9999,1
1714625356591,ANAR 135S,A00,494369,Braswell; Geoffrey E.,0,0,0,0
1714625357617,BENG 196,001,628496,Engler; Adam J.,9998,0,9999,1
1714625358642,CAT 124RS,A01,519847,Geibel; William,0,0,20,20
1714625359667,CAT 125RS,A01,515971,Geibel; William,0,0,20,20
1714625360696,CLRE 250,A00,511389,Morris; Sheldon,9993,0,9999,6
1714625361723,CLRE 251,A00,507176,Mehta; Ravindra L.,9993,0,9999,6
1714625361723,CLRE 251,B00,511410,Mehta; Ravindra L.,9998,0,9999,1
1714625362749,CLRE 252,A00,507189,Cuomo; Raphael Eduardo,9995,0,9999,4
1714625363773,CLRE 253,A00,507199,Vaida; Florin,9994,0,9999,5
1714625363773,CLRE 253,B00,507202,Vaida; Florin,9999,0,9999,0
1714625364802,CLRE 259,A00,507211,Patel; Hemal,9996,0,9999,3
1714625365829,CLRE 260,A00,507221,Cuomo; Raphael Eduardo,9999,0,9999,0
1714625366855,CLRE 297,001,507242,Cuomo; Raphael Eduardo,9999,0,9999,0
1714625367881,COGS 197,001,638244,Voytek; Bradley Thomas,9998,0,9999,1
1714625368906,CSE 191,A00,516875,Minnes Kemp; Mor Mia,9992,0,9999,7
1714625369929,CSE 197,001,637388,Minnes Kemp; Mor Mia,9998,0,9999,1
1714625370955,CSS 201S,A01,494383,Staff,35,0,35,0
1714625371983,CSS 202S,A01,494387,Staff,35,0,35,0
1714625373009,DSC 197,001,628532,Eldridge; Justin Matthew,9996,0,9999,3
1714625374035,EAP 100,A00,516065,Staff,9797,0,9999,202
1714625375062,ECE 45,A01,507414,Staff,33,0,60,27
1714625377115,ECE 111,A01,507420,Staff,15,0,50,35
1714625378141,ECE 197,001,548057,Sievenpiper; Daniel F.,9993,0,9999,6
1714625379167,EDS 115,A00,507243,Choi; Bailey Miyeon,10,0,28,18
1714625380195,EDS 117,A01,494379,Staff,1,5,30,29
1714625381225,EDS 125,A00,507246,Hopkins; Megan Beth,9,0,30,21
1714625382251,EDS 128A,A01,507264,Fargason; Sharon Gayle,8,0,26,18
1714625383275,EDS 128B,A01,507293,Pappas; Elizabeth,12,0,30,18
1714625384300,EDS 139,A00,507294,Fargason; Sharon Gayle,13,0,30,17
1714625384300,EDS 139,B00,507313,Pappas; Elizabeth,13,0,30,17
1714625385328,EDS 201,A00,507315,Staff,13,0,30,17
1714625386357,EDS 203,A01,507317,Halter; Christopher P.,12,0,30,18
1714625387383,EDS 204R,A01,507319,Halter; Christopher P.,0,3,30,30
1714625387383,EDS 204R,B01,507331,Heinzman; Erica M.,16,0,30,14
1714625388407,EDS 206R,A00,507332,Staff,0,4,30,30
1714625388407,EDS 206R,B00,507343,Staff,17,0,30,13
1714625389431,EDS 250,A00,507344,Hemans; Patricia Ann Benitez,22,0,40,18
1714625390457,EDS 281,A00,507345,Daly; Alan J.,18,0,18,0
1714625391485,EDS 284,A00,507350,Daly; Alan J.,16,0,16,0
1714625392510,EDS 286,A00,507359,Fine; Sarah,18,0,18,0
1714625393535,EDS 289C,A01,507361,Daly; Alan J.,18,0,18,0
1714625394559,EDS 290,A00,507366,Hofstetter; Carolyn,15,0,15,0
1714625395584,LIGM 5A,A00,507421,Fischer-Grunski; Eva K,18,0,20,2
1714625396609,LIGM 5B,A00,507423,Fischer-Grunski; Eva K,19,0,20,1
1714625397638,LIGM 5C,A00,507425,Fischer-Grunski; Eva K,19,0,20,1
1714625398667,LIIT 5AS,A00,507427,Carnelos; Chiara,20,0,20,0
1714625399693,LIIT 5BS,A00,507430,Carnelos; Chiara,20,0,20,0
1714625400717,LIIT 5CS,A00,507432,Carnelos; Chiara,20,0,20,0
1714625401743,LISP 5A,A00,507541,Munoz Sanchez; Alicia,11,0,20,9
1714625402769,LISP 5B,A00,507671,Munoz Sanchez; Alicia,8,0,20,12
1714625403795,LISP 5C,A00,507696,Munoz Sanchez; Alicia,9,0,20,11
1714625404820,MAE 197,001,528363,Boechler; Nicholas Sebastia,9998,0,9999,1
1714625405847,MATH 197,001,523477,Kedlaya; Kiran S.,9995,0,9999,4
1714625405847,MATH 197,002,563811,Zhang; Danna,9995,0,9999,4
1714625405847,MATH 197,003,628552,Dumitriu; Ioana,9998,0,9999,1
1714625406872,MCWP 40R,A00,518780,Staff,2,0,20,18
1714625406872,MCWP 40R,B00,518781,Staff,8,0,20,12
1714625406872,MCWP 40R,C00,518783,Staff,6,0,20,14
1714625407901,MCWP 50R,A00,518791,Staff,0,0,20,20
1714625407901,MCWP 50R,B00,518792,Staff,0,2,20,20
1714625407901,MCWP 50R,C00,518793,Staff,0,2,20,20
1714625407901,MCWP 50R,D00,518794,Staff,0,0,20,20
1714625407901,MCWP 50R,E00,518795,Staff,0,2,20,20
1714625407901,MCWP 50R,F00,518796,Staff,0,0,20,20
1714625407901,MCWP 50R,G00,518797,Staff,0,1,20,20
1714625408926,MMW 12R,A01,514034,Herbst; Matthew,0,0,16,16
1714625408926,MMW 12R,A02,514035,Herbst; Matthew,1,0,16,15
1714625409954,MMW 13R,A01,514037,Staff,0,4,16,16
1714625409954,MMW 13R,A02,514039,Staff,0,2,16,16
1714625409954,MMW 13R,A03,628519,Staff,0,2,16,16
1714625412007,SIO 295LS,A00,523233,Staff,10,0,30,20
1714625413035,SIO 295S,A00,523232,Staff,10,0,30,20
1714625414065,SIOC 290S,A01,637330,Merrifield; Mark A,23,0,30,7
1714625415094,SIOC 291S,A01,637333,Gabriel; Corey John,23,0,30,7
1714625416122,SOCI 117,A01,494376,Staff,0,4,5,5
1714625417151,WES 237B,A00,494380,Staff,9,0,20,11
1714625419210,AESE 279B,A00,494370,Wade; Jon P,0,0,33,33
1714625420238,AIP 197,001,627712,Vespa; Emanuel Ignacio,9998,0,9999,1
1714625421264,ANAR 135S,A00,494369,Braswell; Geoffrey E.,0,0,0,0
1714625422289,BENG 196,001,628496,Engler; Adam J.,9998,0,9999,1
1714625423316,CAT 124RS,A01,519847,Geibel; William,0,0,20,20
1714625424342,CAT 125RS,A01,515971,Geibel; William,0,0,20,20
1714625425368,CLRE 250,A00,511389,Morris; Sheldon,9993,0,9999,6
1714625426401,CLRE 251,A00,507176,Mehta; Ravindra L.,9993,0,9999,6
1714625426401,CLRE 251,B00,511410,Mehta; Ravindra L.,9998,0,9999,1
1714625427429,CLRE 252,A00,507189,Cuomo; Raphael Eduardo,9995,0,9999,4
1714625428456,CLRE 253,A00,507199,Vaida; Florin,9994,0,9999,5
1714625428456,CLRE 253,B00,507202,Vaida; Florin,9999,0,9999,0
1714625429480,CLRE 259,A00,507211,Patel; Hemal,9996,0,9999,3
1714625430508,CLRE 260,A00,507221,Cuomo; Raphael Eduardo,9999,0,9999,0
1714625431533,CLRE 297,001,507242,Cuomo; Raphael Eduardo,9999,0,9999,0
1714625432559,COGS 197,001,638244,Voytek; Bradley Thomas,9998,0,9999,1
1714625433585,CSE 191,A00,516875,Minnes Kemp; Mor Mia,9992,0,9999,7
1714625434610,CSE 197,001,637388,Minnes Kemp; Mor Mia,9998,0,9999,1
1714625435636,CSS 201S,A01,494383,Staff,35,0,35,0
1714625436663,CSS 202S,A01,494387,Staff,35,0,35,0
1714625437688,DSC 197,001,628532,Eldridge; Justin Matthew,9996,0,9999,3
1714625438712,EAP 100,A00,516065,Staff,9797,0,9999,202
1714625439738,ECE 45,A01,507414,Staff,33,0,60,27
1714625441789,ECE 111,A01,507420,Staff,15,0,50,35
1714625442819,ECE 197,001,548057,Sievenpiper; Daniel F.,9993,0,9999,6
1714625443847,EDS 115,A00,507243,Choi; Bailey Miyeon,10,0,28,18
1714625444874,EDS 117,A01,494379,Staff,1,5,30,29
1714625445902,EDS 125,A00,507246,Hopkins; Megan Beth,9,0,30,21
1714625446930,EDS 128A,A01,507264,Fargason; Sharon Gayle,8,0,26,18
1714625447956,EDS 128B,A01,507293,Pappas; Elizabeth,12,0,30,18
1714625448983,EDS 139,A00,507294,Fargason; Sharon Gayle,13,0,30,17
1714625448983,EDS 139,B00,507313,Pappas; Elizabeth,13,0,30,17
1714625450019,EDS 201,A00,507315,Staff,13,0,30,17
1714625451047,EDS 203,A01,507317,Halter; Christopher P.,12,0,30,18
1714625452078,EDS 204R,A01,507319,Halter; Christopher P.,0,3,30,30
1714625452078,EDS 204R,B01,507331,Heinzman; Erica M.,16,0,30,14
1714625453106,EDS 206R,A00,507332,Staff,0,4,30,30
1714625453106,EDS 206R,B00,507343,Staff,17,0,30,13
1714625454133,EDS 250,A00,507344,Hemans; Patricia Ann Benitez,22,0,40,18
1714625455164,EDS 281,A00,507345,Daly; Alan J.,18,0,18,0
1714625456189,EDS 284,A00,507350,Daly; Alan J.,16,0,16,0
1714625457214,EDS 286,A00,507359,Fine; Sarah,18,0,18,0
1714625458242,EDS 289C,A01,507361,Daly; Alan J.,18,0,18,0
1714625459267,EDS 290,A00,507366,Hofstetter; Carolyn,15,0,15,0
1714625460299,LIGM 5A,A00,507421,Fischer-Grunski; Eva K,18,0,20,2
1714625461328,LIGM 5B,A00,507423,Fischer-Grunski; Eva K,19,0,20,1
1714625462358,LIGM 5C,A00,507425,Fischer-Grunski; Eva K,19,0,20,1
1714625463385,LIIT 5AS,A00,507427,Carnelos; Chiara,20,0,20,0
1714625464410,LIIT 5BS,A00,507430,Carnelos; Chiara,20,0,20,0
1714625465435,LIIT 5CS,A00,507432,Carnelos; Chiara,20,0,20,0
1714625466461,LISP 5A,A00,507541,Munoz Sanchez; Alicia,11,0,20,9
1714625467489,LISP 5B,A00,507671,Munoz Sanchez; Alicia,8,0,20,12
1714625468515,LISP 5C,A00,507696,Munoz Sanchez; Alicia,9,0,20,11
1714625469540,MAE 197,001,528363,Boechler; Nicholas Sebastia,9998,0,9999,1
1714625470566,MATH 197,001,523477,Kedlaya; Kiran S.,9995,0,9999,4
1714625470566,MATH 197,002,563811,Zhang; Danna,9995,0,9999,4
1714625470566,MATH 197,003,628552,Dumitriu; Ioana,9998,0,9999,1
1714625471591,MCWP 40R,A00,518780,Staff,2,0,20,18
1714625471591,MCWP 40R,B00,518781,Staff,8,0,20,12
1714625471591,MCWP 40R,C00,518783,Staff,6,0,20,14
1714625472617,MCWP 50R,A00,518791,Staff,0,0,20,20
1714625472617,MCWP 50R,B00,518792,Staff,0,2,20,20
1714625472617,MCWP 50R,C00,518793,Staff,0,2,20,20
1714625472617,MCWP 50R,D00,518794,Staff,0,0,20,20
1714625472617,MCWP 50R,E00,518795,Staff,0,2,20,20
1714625472617,MCWP 50R,F00,518796,Staff,0,0,20,20
1714625472617,MCWP 50R,G00,518797,Staff,0,1,20,20
1714625473641,MMW 12R,A01,514034,Herbst; Matthew,0,0,16,16
1714625473641,MMW 12R,A02,514035,Herbst; Matthew,1,0,16,15
1714625474666,MMW 13R,A01,514037,Staff,0,4,16,16
1714625474666,MMW 13R,A02,514039,Staff,0,2,16,16
1714625474666,MMW 13R,A03,628519,Staff,0,2,16,16
1714625476716,SIO 295LS,A00,523233,Staff,10,0,30,20
1714625477741,SIO 295S,A00,523232,Staff,10,0,30,20
1714625478767,SIOC 290S,A01,637330,Merrifield; Mark A,23,0,30,7
1714625479797,SIOC 291S,A01,637333,Gabriel; Corey John,23,0,30,7
1714625480823,SOCI 117,A01,494376,Staff,0,4,5,5
1714625481854,WES 237B,A00,494380,Staff,9,0,20,11
1714625483916,AESE 279B,A00,494370,Wade; Jon P,0,0,33,33
1714625484945,AIP 197,001,627712,Vespa; Emanuel Ignacio,9998,0,9999,1
1714625485970,ANAR 135S,A00,494369,Braswell; Geoffrey E.,0,0,0,0
1714625486996,BENG 196,001,628496,Engler; Adam J.,9998,0,9999,1
1714625488025,CAT 124RS,A01,519847,Geibel; William,0,0,20,20
1714625489051,CAT 125RS,A01,515971,Geibel; William,0,0,20,20
1714625490080,CLRE 250,A00,511389,Morris; Sheldon,9993,0,9999,6
1714625491107,CLRE 251,A00,507176,Mehta; Ravindra L.,9993,0,9999,6
1714625491107,CLRE 251,B00,511410,Mehta; Ravindra L.,9998,0,9999,1
1714625492133,CLRE 252,A00,507189,Cuomo; Raphael Eduardo,9995,0,9999,4
1714625493158,CLRE 253,A00,507199,Vaida; Florin,9994,0,9999,5
1714625493158,CLRE 253,B00,507202,Vaida; Florin,9999,0,9999,0
1714625494184,CLRE 259,A00,507211,Patel; Hemal,9996,0,9999,3
1714625495209,CLRE 260,A00,507221,Cuomo; Raphael Eduardo,9999,0,9999,0
1714625496239,CLRE 297,001,507242,Cuomo; Raphael Eduardo,9999,0,9999,0
1714625497265,COGS 197,001,638244,Voytek; Bradley Thomas,9998,0,9999,1
1714625498293,CSE 191,A00,516875,Minnes Kemp; Mor Mia,9992,0,9999,7
1714625499320,CSE 197,001,637388,Minnes Kemp; Mor Mia,9998,0,9999,1
1714625500345,CSS 201S,A01,494383,Staff,35,0,35,0
1714625501373,CSS 202S,A01,494387,Staff,35,0,35,0
1714625502403,DSC 197,001,628532,Eldridge; Justin Matthew,9996,0,9999,3
1714625503427,EAP 100,A00,516065,Staff,9797,0,9999,202
1714625504457,ECE 45,A01,507414,Staff,33,0,60,27
1714625506509,ECE 111,A01,507420,Staff,15,0,50,35
1714625507536,ECE 197,001,548057,Sievenpiper; Daniel F.,9993,0,9999,6
1714625508564,EDS 115,A00,507243,Choi; Bailey Miyeon,10,0,28,18
1714625509592,EDS 117,A01,494379,Staff,1,5,30,29
1714625510620,EDS 125,A00,507246,Hopkins; Megan Beth,9,0,30,21
1714625511647,EDS 128A,A01,507264,Fargason; Sharon Gayle,8,0,26,18
1714625512675,EDS 128B,A01,507293,Pappas; Elizabeth,12,0,30,18
1714625513702,EDS 139,A00,507294,Fargason; Sharon Gayle,13,0,30,17
1714625513702,EDS 139,B00,507313,Pappas; Elizabeth,13,0,30,17
1714625514729,EDS 201,A00,507315,Staff,13,0,30,17
1714625515756,EDS 203,A01,507317,Halter; Christopher P.,12,0,30,18
1714625516785,EDS 204R,A01,507319,Halter; Christopher P.,0,3,30,30
1714625516785,EDS 204R,B01,507331,Heinzman; Erica M.,16,0,30,14
1714625517811,EDS 206R,A00,507332,Staff,0,4,30,30
1714625517811,EDS 206R,B00,507343,Staff,17,0,30,13
1714625518837,EDS 250,A00,507344,Hemans; Patricia Ann Benitez,22,0,40,18
1714625519863,EDS 281,A00,507345,Daly; Alan J.,18,0,18,0
1714625520888,EDS 284,A00,507350,Daly; Alan J.,16,0,16,0
1714625521915,EDS 286,A00,507359,Fine; Sarah,18,0,18,0
1714625522942,EDS 289C,A01,507361,Daly; Alan J.,18,0,18,0
1714625523967,EDS 290,A00,507366,Hofstetter; Carolyn,15,0,15,0
1714625524993,LIGM 5A,A00,507421,Fischer-Grunski; Eva K,18,0,20,2
1714625526018,LIGM 5B,A00,507423,Fischer-Grunski; Eva K,19,0,20,1
1714625527048,LIGM 5C,A00,507425,Fischer-Grunski; Eva K,19,0,20,1
1714625528080,LIIT 5AS,A00,507427,Carnelos; Chiara,20,0,20,0
1714625529106,LIIT 5BS,A00,507430,Carnelos; Chiara,20,0,20,0
1714625530131,LIIT 5CS,A00,507432,Carnelos; Chiara,20,0,20,0
1714625531162,LISP 5A,A00,507541,Munoz Sanchez; Alicia,11,0,20,9
1714625532188,LISP 5B,A00,507671,Munoz Sanchez; Alicia,8,0,20,12
1714625533217,LISP 5C,A00,507696,Munoz Sanchez; Alicia,9,0,20,11
1714625534242,MAE 197,001,528363,Boechler; Nicholas Sebastia,9998,0,9999,1
1714625535270,MATH 197,001,523477,Kedlaya; Kiran S.,9995,0,9999,4
1714625535270,MATH 197,002,563811,Zhang; Danna,9995,0,9999,4
1714625535270,MATH 197,003,628552,Dumitriu; Ioana,9998,0,9999,1
1714625536300,MCWP 40R,A00,518780,Staff,2,0,20,18
1714625536300,MCWP 40R,B00,518781,Staff,8,0,20,12
1714625536300,MCWP 40R,C00,518783,Staff,6,0,20,14
1714625537326,MCWP 50R,A00,518791,Staff,0,0,20,20
1714625537326,MCWP 50R,B00,518792,Staff,0,2,20,20
1714625537326,MCWP 50R,C00,518793,Staff,0,2,20,20
1714625537326,MCWP 50R,D00,518794,Staff,0,0,20,20
1714625537326,MCWP 50R,E00,518795,Staff,0,2,20,20
1714625537326,MCWP 50R,F00,518796,Staff,0,0,20,20
1714625537326,MCWP 50R,G00,518797,Staff,0,1,20,20
1714625538355,MMW 12R,A01,514034,Herbst; Matthew,0,0,16,16
1714625538355,MMW 12R,A02,514035,Herbst; Matthew,1,0,16,15
1714625539384,MMW 13R,A01,514037,Staff,0,4,16,16
1714625539384,MMW 13R,A02,514039,Staff,0,2,16,16
1714625539384,MMW 13R,A03,628519,Staff,0,2,16,16
1714625541438,SIO 295LS,A00,523233,Staff,10,0,30,20
1714625542461,SIO 295S,A00,523232,Staff,10,0,30,20
1714625543488,SIOC 290S,A01,637330,Merrifield; Mark A,23,0,30,7
1714625544518,SIOC 291S,A01,637333,Gabriel; Corey John,23,0,30,7
1714625545544,SOCI 117,A01,494376,Staff,0,4,5,5
1714625546568,WES 237B,A00,494380,Staff,9,0,20,11
1714625548645,AESE 279B,A00,494370,Wade; Jon P,0,0,33,33
1714625549669,AIP 197,001,627712,Vespa; Emanuel Ignacio,9998,0,9999,1
1714625550693,ANAR 135S,A00,494369,Braswell; Geoffrey E.,0,0,0,0
1714625551722,BENG 196,001,628496,Engler; Adam J.,9998,0,9999,1
1714625552748,CAT 124RS,A01,519847,Geibel; William,0,0,20,20
1714625553776,CAT 125RS,A01,515971,Geibel; William,0,0,20,20
1714625554804,CLRE 250,A00,511389,Morris; Sheldon,9993,0,9999,6
1714625555835,CLRE 251,A00,507176,Mehta; Ravindra L.,9993,0,9999,6
1714625555835,CLRE 251,B00,511410,Mehta; Ravindra L.,9998,0,9999,1
1714625556861,CLRE 252,A00,507189,Cuomo; Raphael Eduardo,9995,0,9999,4
1714625557886,CLRE 253,A00,507199,Vaida; Florin,9994,0,9999,5
1714625557886,CLRE 253,B00,507202,Vaida; Florin,9999,0,9999,0
1714625558913,CLRE 259,A00,507211,Patel; Hemal,9996,0,9999,3
1714625559937,CLRE 260,A00,507221,Cuomo; Raphael Eduardo,9999,0,9999,0
1714625560962,CLRE 297,001,507242,Cuomo; Raphael Eduardo,9999,0,9999,0
1714625561990,COGS 197,001,638244,Voytek; Bradley Thomas,9998,0,9999,1
1714625563015,CSE 191,A00,516875,Minnes Kemp; Mor Mia,9992,0,9999,7
1714625564040,CSE 197,001,637388,Minnes Kemp; Mor Mia,9998,0,9999,1
1714625565068,CSS 201S,A01,494383,Staff,35,0,35,0
1714625566098,CSS 202S,A01,494387,Staff,35,0,35,0
1714625567124,DSC 197,001,628532,Eldridge; Justin Matthew,9996,0,9999,3
1714625568149,EAP 100,A00,516065,Staff,9797,0,9999,202
1714625569175,ECE 45,A01,507414,Staff,33,0,60,27
1714625571234,ECE 111,A01,507420,Staff,15,0,50,35
1714625572260,ECE 197,001,548057,Sievenpiper; Daniel F.,9993,0,9999,6
1714625573291,EDS 115,A00,507243,Choi; Bailey Miyeon,10,0,28,18
1714625574318,EDS 117,A01,494379,Staff,1,5,30,29
1714625575347,EDS 125,A00,507246,Hopkins; Megan Beth,9,0,30,21
1714625576374,EDS 128A,A01,507264,Fargason; Sharon Gayle,8,0,26,18
1714625577400,EDS 128B,A01,507293,Pappas; Elizabeth,12,0,30,18
1714625578425,EDS 139,A00,507294,Fargason; Sharon Gayle,13,0,30,17
1714625578425,EDS 139,B00,507313,Pappas; Elizabeth,13,0,30,17
1714625579452,EDS 201,A00,507315,Staff,13,0,30,17
1714625580482,EDS 203,A01,507317,Halter; Christopher P.,12,0,30,18
1714625581511,EDS 204R,A01,507319,Halter; Christopher P.,0,3,30,30
1714625581511,EDS 204R,B01,507331,Heinzman; Erica M.,16,0,30,14
1714625582536,EDS 206R,A00,507332,Staff,0,4,30,30
1714625582536,EDS 206R,B00,507343,Staff,17,0,30,13
1714625583561,EDS 250,A00,507344,Hemans; Patricia Ann Benitez,22,0,40,18
1714625584587,EDS 281,A00,507345,Daly; Alan J.,18,0,18,0
1714625585612,EDS 284,A00,507350,Daly; Alan J.,16,0,16,0
1714625586637,EDS 286,A00,507359,Fine; Sarah,18,0,18,0
1714625587665,EDS 289C,A01,507361,Daly; Alan J.,18,0,18,0
1714625588691,EDS 290,A00,507366,Hofstetter; Carolyn,15,0,15,0
1714625589718,LIGM 5A,A00,507421,Fischer-Grunski; Eva K,18,0,20,2
1714625590743,LIGM 5B,A00,507423,Fischer-Grunski; Eva K,19,0,20,1
1714625591771,LIGM 5C,A00,507425,Fischer-Grunski; Eva K,19,0,20,1
1714625592800,LIIT 5AS,A00,507427,Carnelos; Chiara,20,0,20,0
1714625593825,LIIT 5BS,A00,507430,Carnelos; Chiara,20,0,20,0
1714625594854,LIIT 5CS,A00,507432,Carnelos; Chiara,20,0,20,0
1714625595880,LISP 5A,A00,507541,Munoz Sanchez; Alicia,11,0,20,9
1714625596908,LISP 5B,A00,507671,Munoz Sanchez; Alicia,8,0,20,12
1714625597935,LISP 5C,A00,507696,Munoz Sanchez; Alicia,9,0,20,11
1714625598961,MAE 197,001,528363,Boechler; Nicholas Sebastia,9998,0,9999,1
1714625599987,MATH 197,001,523477,Kedlaya; Kiran S.,9995,0,9999,4
1714625599987,MATH 197,002,563811,Zhang; Danna,9995,0,9999,4
1714625599987,MATH 197,003,628552,Dumitriu; Ioana,9998,0,9999,1
1714625601016,MCWP 40R,A00,518780,Staff,2,0,20,18
1714625601016,MCWP 40R,B00,518781,Staff,8,0,20,12
1714625601016,MCWP 40R,C00,518783,Staff,6,0,20,14
1714625602041,MCWP 50R,A00,518791,Staff,0,0,20,20
1714625602041,MCWP 50R,B00,518792,Staff,0,2,20,20
1714625602041,MCWP 50R,C00,518793,Staff,0,2,20,20
1714625602041,MCWP 50R,D00,518794,Staff,0,0,20,20
1714625602041,MCWP 50R,E00,518795,Staff,0,2,20,20
1714625602041,MCWP 50R,F00,518796,Staff,0,0,20,20
1714625602041,MCWP 50R,G00,518797,Staff,0,1,20,20
1714625603071,MMW 12R,A01,514034,Herbst; Matthew,0,0,16,16
1714625603071,MMW 12R,A02,514035,Herbst; Matthew,1,0,16,15
1714625604097,MMW 13R,A01,514037,Staff,0,4,16,16
1714625604097,MMW 13R,A02,514039,Staff,0,2,16,16
1714625604097,MMW 13R,A03,628519,Staff,0,2,16,16
1714625606145,SIO 295LS,A00,523233,Staff,10,0,30,20
1714625607173,SIO 295S,A00,523232,Staff,10,0,30,20
1714625608199,SIOC 290S,A01,637330,Merrifield; Mark A,23,0,30,7
1714625609279,SIOC 291S,A01,637333,Gabriel; Corey John,23,0,30,7
1714625610307,SOCI 117,A01,494376,Staff,0,4,5,5
1714625611335,WES 237B,A00,494380,Staff,9,0,20,11
1714625613398,AESE 279B,A00,494370,Wade; Jon P,0,0,33,33
1714625614426,AIP 197,001,627712,Vespa; Emanuel Ignacio,9998,0,9999,1
1714625615450,ANAR 135S,A00,494369,Braswell; Geoffrey E.,0,0,0,0
1714625616476,BENG 196,001,628496,Engler; Adam J.,9998,0,9999,1
1714625617500,CAT 124RS,A01,519847,Geibel; William,0,0,20,20
1714625618524,CAT 125RS,A01,515971,Geibel; William,0,0,20,20
1714625619549,CLRE 250,A00,511389,Morris; Sheldon,9993,0,9999,6
1714625620578,CLRE 251,A00,507176,Mehta; Ravindra L.,9993,0,9999,6
1714625620578,CLRE 251,B00,511410,Mehta; Ravindra L.,9998,0,9999,1
1714625621603,CLRE 252,A00,507189,Cuomo; Raphael Eduardo,9995,0,9999,4
1714625622628,CLRE 253,A00,507199,Vaida; Florin,9994,0,9999,5
1714625622628,CLRE 253,B00,507202,Vaida; Florin,9999,0,9999,0
1714625623654,CLRE 259,A00,507211,Patel; Hemal,9996,0,9999,3
1714625624681,CLRE 260,A00,507221,Cuomo; Raphael Eduardo,9999,0,9999,0
1714625625711,CLRE 297,001,507242,Cuomo; Raphael Eduardo,9999,0,9999,0
1714625626741,COGS 197,001,638244,Voytek; Bradley Thomas,9998,0,9999,1
1714625627770,CSE 191,A00,516875,Minnes Kemp; Mor Mia,9992,0,9999,7
1714625628796,CSE 197,001,637388,Minnes Kemp; Mor Mia,9998,0,9999,1
1714625629828,CSS 201S,A01,494383,Staff,35,0,35,0
1714625630853,CSS 202S,A01,494387,Staff,35,0,35,0
1714625631879,DSC 197,001,628532,Eldridge; Justin Matthew,9996,0,9999,3
1714625632907,EAP 100,A00,516065,Staff,9797,0,9999,202
1714625633939,ECE 45,A01,507414,Staff,33,0,60,27
1714625635993,ECE 111,A01,507420,Staff,15,0,50,35
1714625637019,ECE 197,001,548057,Sievenpiper; Daniel F.,9993,0,9999,6
1714625638047,EDS 115,A00,507243,Choi; Bailey Miyeon,10,0,28,18
1714625639074,EDS 117,A01,494379,Staff,1,5,30,29
1714625640103,EDS 125,A00,507246,Hopkins; Megan Beth,9,0,30,21
1714625641130,EDS 128A,A01,507264,Fargason; Sharon Gayle,8,0,26,18
1714625642163,EDS 128B,A01,507293,Pappas; Elizabeth,12,0,30,18
1714625643189,EDS 139,A00,507294,Fargason; Sharon Gayle,13,0,30,17
1714625643189,EDS 139,B00,507313,Pappas; Elizabeth,13,0,30,17
1714625644213,EDS 201,A00,507315,Staff,13,0,30,17
1714625645241,EDS 203,A01,507317,Halter; Christopher P.,12,0,30,18
1714625646268,EDS 204R,A01,507319,Halter; Christopher P.,0,3,30,30
1714625646268,EDS 204R,B01,507331,Heinzman; Erica M.,16,0,30,14
1714625647297,EDS 206R,A00,507332,Staff,0,4,30,30
1714625647297,EDS 206R,B00,507343,Staff,17,0,30,13
1714625648327,EDS 250,A00,507344,Hemans; Patricia Ann Benitez,22,0,40,18
1714625649353,EDS 281,A00,507345,Daly; Alan J.,18,0,18,0
1714625650376,EDS 284,A00,507350,Daly; Alan J.,16,0,16,0
1714625651403,EDS 286,A00,507359,Fine; Sarah,18,0,18,0
1714625652432,EDS 289C,A01,507361,Daly; Alan J.,18,0,18,0
1714625653459,EDS 290,A00,507366,Hofstetter; Carolyn,15,0,15,0
1714625654490,LIGM 5A,A00,507421,Fischer-Grunski; Eva K,18,0,20,2
1714625655514,LIGM 5B,A00,507423,Fischer-Grunski; Eva K,19,0,20,1
1714625656541,LIGM 5C,A00,507425,Fischer-Grunski; Eva K,19,0,20,1
1714625657568,LIIT 5AS,A00,507427,Carnelos; Chiara,20,0,20,0
1714625658596,LIIT 5BS,A00,507430,Carnelos; Chiara,20,0,20,0
1714625659621,LIIT 5CS,A00,507432,Carnelos; Chiara,20,0,20,0
1714625660646,LISP 5A,A00,507541,Munoz Sanchez; Alicia,11,0,20,9
1714625661671,LISP 5B,A00,507671,Munoz Sanchez; Alicia,8,0,20,12
1714625662696,LISP 5C,A00,507696,Munoz Sanchez; Alicia,9,0,20,11
1714625663725,MAE 197,001,528363,Boechler; Nicholas Sebastia,9998,0,9999,1
1714625664753,MATH 197,001,523477,Kedlaya; Kiran S.,9995,0,9999,4
1714625664753,MATH 197,002,563811,Zhang; Danna,9995,0,9999,4
1714625664753,MATH 197,003,628552,Dumitriu; Ioana,9998,0,9999,1
1714625665776,MCWP 40R,A00,518780,Staff,2,0,20,18
1714625665776,MCWP 40R,B00,518781,Staff,8,0,20,12
1714625665776,MCWP 40R,C00,518783,Staff,6,0,20,14
1714625666804,MCWP 50R,A00,518791,Staff,0,0,20,20
1714625666804,MCWP 50R,B00,518792,Staff,0,2,20,20
1714625666804,MCWP 50R,C00,518793,Staff,0,2,20,20
1714625666804,MCWP 50R,D00,518794,Staff,0,0,20,20
1714625666804,MCWP 50R,E00,518795,Staff,0,2,20,20
1714625666804,MCWP 50R,F00,518796,Staff,0,0,20,20
1714625666804,MCWP 50R,G00,518797,Staff,0,1,20,20
1714625667833,MMW 12R,A01,514034,Herbst; Matthew,0,0,16,16
1714625667833,MMW 12R,A02,514035,Herbst; Matthew,1,0,16,15
1714625668859,MMW 13R,A01,514037,Staff,0,4,16,16
1714625668859,MMW 13R,A02,514039,Staff,0,2,16,16
1714625668859,MMW 13R,A03,628519,Staff,0,2,16,16
1714625670914,SIO 295LS,A00,523233,Staff,10,0,30,20
1714625671938,SIO 295S,A00,523232,Staff,10,0,30,20
1714625672964,SIOC 290S,A01,637330,Merrifield; Mark A,23,0,30,7
1714625673995,SIOC 291S,A01,637333,Gabriel; Corey John,23,0,30,7
1714625675021,SOCI 117,A01,494376,Staff,0,4,5,5
1714625676049,WES 237B,A00,494380,Staff,9,0,20,11
1714625678117,AESE 279B,A00,494370,Wade; Jon P,0,0,33,33
1714625679142,AIP 197,001,627712,Vespa; Emanuel Ignacio,9998,0,9999,1
1714625680169,ANAR 135S,A00,494369,Braswell; Geoffrey E.,0,0,0,0
1714625681196,BENG 196,001,628496,Engler; Adam J.,9998,0,9999,1
1714625682221,CAT 124RS,A01,519847,Geibel; William,0,0,20,20
1714625683247,CAT 125RS,A01,515971,Geibel; William,0,0,20,20
1714625684271,CLRE 250,A00,511389,Morris; Sheldon,9993,0,9999,6
1714625685297,CLRE 251,A00,507176,Mehta; Ravindra L.,9993,0,9999,6
1714625685297,CLRE 251,B00,511410,Mehta; Ravindra L.,9998,0,9999,1
1714625686326,CLRE 252,A00,507189,Cuomo; Raphael Eduardo,9995,0,9999,4
1714625687354,CLRE 253,A00,507199,Vaida; Florin,9994,0,9999,5
1714625687354,CLRE 253,B00,507202,Vaida; Florin,9999,0,9999,0
1714625688381,CLRE 259,A00,507211,Patel; Hemal,9996,0,9999,3
1714625689405,CLRE 260,A00,507221,Cuomo; Raphael Eduardo,9999,0,9999,0
1714625690429,CLRE 297,001,507242,Cuomo; Raphael Eduardo,9999,0,9999,0
1714625691454,COGS 197,001,638244,Voytek; Bradley Thomas,9998,0,9999,1
1714625692479,CSE 191,A00,516875,Minnes Kemp; Mor Mia,9992,0,9999,7
1714625693509,CSE 197,001,637388,Minnes Kemp; Mor Mia,9998,0,9999,1
1714625694534,CSS 201S,A01,494383,Staff,35,0,35,0
1714625695561,CSS 202S,A01,494387,Staff,35,0,35,0
1714625696586,DSC 197,001,628532,Eldridge; Justin Matthew,9996,0,9999,3
1714625697612,EAP 100,A00,516065,Staff,9797,0,9999,202
1714625698636,ECE 45,A01,507414,Staff,33,0,60,27
1714625700688,ECE 111,A01,507420,Staff,15,0,50,35
1714625701713,ECE 197,001,548057,Sievenpiper; Daniel F.,9993,0,9999,6
1714625702740,EDS 115,A00,507243,Choi; Bailey Miyeon,10,0,28,18
1714625703769,EDS 117,A01,494379,Staff,1,5,30,29
1714625704796,EDS 125,A00,507246,Hopkins; Megan Beth,9,0,30,21
1714625705822,EDS 128A,A01,507264,Fargason; Sharon Gayle,8,0,26,18
1714625706847,EDS 128B,A01,507293,Pappas; Elizabeth,12,0,30,18
1714625707875,EDS 139,A00,507294,Fargason; Sharon Gayle,13,0,30,17
1714625707875,EDS 139,B00,507313,Pappas; Elizabeth,13,0,30,17
1714625708901,EDS 201,A00,507315,Staff,13,0,30,17
1714625709926,EDS 203,A01,507317,Halter; Christopher P.,12,0,30,18
1714625710953,EDS 204R,A01,507319,Halter; Christopher P.,0,3,30,30
1714625710953,EDS 204R,B01,507331,Heinzman; Erica M.,16,0,30,14
1714625711979,EDS 206R,A00,507332,Staff,0,4,30,30
1714625711979,EDS 206R,B00,507343,Staff,17,0,30,13
1714625713057,EDS 250,A00,507344,Hemans; Patricia Ann Benitez,22,0,40,18
1714625714085,EDS 281,A00,507345,Daly; Alan J.,18,0,18,0
1714625715114,EDS 284,A00,507350,Daly; Alan J.,16,0,16,0
1714625716139,EDS 286,A00,507359,Fine; Sarah,18,0,18,0
1714625717168,EDS 289C,A01,507361,Daly; Alan J.,18,0,18,0
1714625718194,EDS 290,A00,507366,Hofstetter; Carolyn,15,0,15,0
1714625719225,LIGM 5A,A00,507421,Fischer-Grunski; Eva K,18,0,20,2
1714625720250,LIGM 5B,A00,507423,Fischer-Grunski; Eva K,19,0,20,1
1714625721280,LIGM 5C,A00,507425,Fischer-Grunski; Eva K,19,0,20,1
1714625722306,LIIT 5AS,A00,507427,Carnelos; Chiara,20,0,20,0
1714625723331,LIIT 5BS,A00,507430,Carnelos; Chiara,20,0,20,0
1714625724357,LIIT 5CS,A00,507432,Carnelos; Chiara,20,0,20,0
1714625725381,LISP 5A,A00,507541,Munoz Sanchez; Alicia,11,0,20,9
1714625726406,LISP 5B,A00,507671,Munoz Sanchez; Alicia,8,0,20,12
1714625727432,LISP 5C,A00,507696,Munoz Sanchez; Alicia,9,0,20,11
1714625728458,MAE 197,001,528363,Boechler; Nicholas Sebastia,9998,0,9999,1
1714625729488,MATH 197,001,523477,Kedlaya; Kiran S.,9995,0,9999,4
1714625729488,MATH 197,002,563811,Zhang; Danna,9995,0,9999,4
1714625729488,MATH 197,003,628552,Dumitriu; Ioana,9998,0,9999,1
1714625730516,MCWP 40R,A00,518780,Staff,2,0,20,18
1714625730516,MCWP 40R,B00,518781,Staff,8,0,20,12
1714625730516,MCWP 40R,C00,518783,Staff,6,0,20,14
1714625731541,MCWP 50R,A00,518791,Staff,0,0,20,20
1714625731541,MCWP 50R,B00,518792,Staff,0,2,20,20
1714625731541,MCWP 50R,C00,518793,Staff,0,2,20,20
1714625731541,MCWP 50R,D00,518794,Staff,0,0,20,20
1714625731541,MCWP 50R,E00,518795,Staff,0,2,20,20
1714625731541,MCWP 50R,F00,518796,Staff,0,0,20,20
1714625731541,MCWP 50R,G00,518797,Staff,0,1,20,20
1714625732572,MMW 12R,A01,514034,Herbst; Matthew,0,0,16,16
1714625732572,MMW 12R,A02,514035,Herbst; Matthew,1,0,16,15
1714625733597,MMW 13R,A01,514037,Staff,0,4,16,16
1714625733597,MMW 13R,A02,514039,Staff,0,2,16,16
1714625733597,MMW 13R,A03,628519,Staff,0,2,16,16
1714625735648,SIO 295LS,A00,523233,Staff,10,0,30,20
1714625736672,SIO 295S,A00,523232,Staff,10,0,30,20
1714625737698,SIOC 290S,A01,637330,Merrifield; Mark A,23,0,30,7
1714625738724,SIOC 291S,A01,637333,Gabriel; Corey John,23,0,30,7
1714625739753,SOCI 117,A01,494376,Staff,0,4,5,5
1714625740781,WES 237B,A00,494380,Staff,9,0,20,11
1714625742851,AESE 279B,A00,494370,Wade; Jon P,0,0,33,33
1714625743876,AIP 197,001,627712,Vespa; Emanuel Ignacio,9998,0,9999,1
1714625744902,ANAR 135S,A00,494369,Braswell; Geoffrey E.,0,0,0,0
1714625745927,BENG 196,001,628496,Engler; Adam J.,9998,0,9999,1
1714625746955,CAT 124RS,A01,519847,Geibel; William,0,0,20,20
1714625747983,CAT 125RS,A01,515971,Geibel; William,0,0,20,20
1714625749009,CLRE 250,A00,511389,Morris; Sheldon,9993,0,9999,6
1714625750040,CLRE 251,A00,507176,Mehta; Ravindra L.,9993,0,9999,6
1714625750040,CLRE 251,B00,511410,Mehta; Ravindra L.,9998,0,9999,1
1714625751069,CLRE 252,A00,507189,Cuomo; Raphael Eduardo,9995,0,9999,4
1714625752094,CLRE 253,A00,507199,Vaida; Florin,9994,0,9999,5
1714625752094,CLRE 253,B00,507202,Vaida; Florin,9999,0,9999,0
1714625753118,CLRE 259,A00,507211,Patel; Hemal,9996,0,9999,3
1714625754143,CLRE 260,A00,507221,Cuomo; Raphael Eduardo,9999,0,9999,0
1714625755169,CLRE 297,001,507242,Cuomo; Raphael Eduardo,9999,0,9999,0
1714625756194,COGS 197,001,638244,Voytek; Bradley Thomas,9998,0,9999,1
1714625757222,CSE 191,A00,516875,Minnes Kemp; Mor Mia,9992,0,9999,7
1714625758245,CSE 197,001,637388,Minnes Kemp; Mor Mia,9998,0,9999,1
1714625759272,CSS 201S,A01,494383,Staff,35,0,35,0
1714625760299,CSS 202S,A01,494387,Staff,35,0,35,0
1714625761326,DSC 197,001,628532,Eldridge; Justin Matthew,9996,0,9999,3
1714625762353,EAP 100,A00,516065,Staff,9797,0,9999,202
1714625763381,ECE 45,A01,507414,Staff,33,0,60,27
1714625765432,ECE 111,A01,507420,Staff,15,0,50,35
1714625766461,ECE 197,001,548057,Sievenpiper; Daniel F.,9993,0,9999,6
1714625767487,EDS 115,A00,507243,Choi; Bailey Miyeon,10,0,28,18
1714625768512,EDS 117,A01,494379,Staff,1,5,30,29
1714625769541,EDS 125,A00,507246,Hopkins; Megan Beth,9,0,30,21
1714625770567,EDS 128A,A01,507264,Fargason; Sharon Gayle,8,0,26,18
1714625771592,EDS 128B,A01,507293,Pappas; Elizabeth,12,0,30,18
1714625772618,EDS 139,A00,507294,Fargason; Sharon Gayle,13,0,30,17
1714625772618,EDS 139,B00,507313,Pappas; Elizabeth,13,0,30,17
1714625773641,EDS 201,A00,507315,Staff,13,0,30,17
1714625774671,EDS 203,A01,507317,Halter; Christopher P.,12,0,30,18
1714625775698,EDS 204R,A01,507319,Halter; Christopher P.,0,3,30,30
1714625775698,EDS 204R,B01,507331,Heinzman; Erica M.,16,0,30,14
1714625776774,EDS 206R,A00,507332,Staff,0,4,30,30
1714625776774,EDS 206R,B00,507343,Staff,17,0,30,13
1714625777799,EDS 250,A00,507344,Hemans; Patricia Ann Benitez,22,0,40,18
1714625778826,EDS 281,A00,507345,Daly; Alan J.,18,0,18,0
1714625779851,EDS 284,A00,507350,Daly; Alan J.,16,0,16,0
1714625780879,EDS 286,A00,507359,Fine; Sarah,18,0,18,0
1714625781908,EDS 289C,A01,507361,Daly; Alan J.,18,0,18,0
1714625782932,EDS 290,A00,507366,Hofstetter; Carolyn,15,0,15,0
1714625783959,LIGM 5A,A00,507421,Fischer-Grunski; Eva K,18,0,20,2
1714625784984,LIGM 5B,A00,507423,Fischer-Grunski; Eva K,19,0,20,1
1714625786014,LIGM 5C,A00,507425,Fischer-Grunski; Eva K,19,0,20,1
1714625787039,LIIT 5AS,A00,507427,Carnelos; Chiara,20,0,20,0
1714625788066,LIIT 5BS,A00,507430,Carnelos; Chiara,20,0,20,0
1714625789090,LIIT 5CS,A00,507432,Carnelos; Chiara,20,0,20,0
1714625790120,LISP 5A,A00,507541,Munoz Sanchez; Alicia,11,0,20,9
1714625791146,LISP 5B,A00,507671,Munoz Sanchez; Alicia,8,0,20,12
1714625792173,LISP 5C,A00,507696,Munoz Sanchez; Alicia,9,0,20,11
1714625793200,MAE 197,001,528363,Boechler; Nicholas Sebastia,9998,0,9999,1
1714625794231,MATH 197,001,523477,Kedlaya; Kiran S.,9995,0,9999,4
1714625794231,MATH 197,002,563811,Zhang; Danna,9995,0,9999,4
1714625794231,MATH 197,003,628552,Dumitriu; Ioana,9998,0,9999,1
1714625795255,MCWP 40R,A00,518780,Staff,2,0,20,18
1714625795255,MCWP 40R,B00,518781,Staff,8,0,20,12
1714625795255,MCWP 40R,C00,518783,Staff,6,0,20,14
1714625796282,MCWP 50R,A00,518791,Staff,0,0,20,20
1714625796282,MCWP 50R,B00,518792,Staff,0,2,20,20
1714625796282,MCWP 50R,C00,518793,Staff,0,2,20,20
1714625796282,MCWP 50R,D00,518794,Staff,0,0,20,20
1714625796282,MCWP 50R,E00,518795,Staff,0,2,20,20
1714625796282,MCWP 50R,F00,518796,Staff,0,0,20,20
1714625796282,MCWP 50R,G00,518797,Staff,0,1,20,20
1714625797312,MMW 12R,A01,514034,Herbst; Matthew,0,0,16,16
1714625797312,MMW 12R,A02,514035,Herbst; Matthew,1,0,16,15
1714625798340,MMW 13R,A01,514037,Staff,0,4,16,16
1714625798340,MMW 13R,A02,514039,Staff,0,2,16,16
1714625798340,MMW 13R,A03,628519,Staff,0,2,16,16
1714625800392,SIO 295LS,A00,523233,Staff,10,0,30,20
1714625801416,SIO 295S,A00,523232,Staff,10,0,30,20
1714625802446,SIOC 290S,A01,637330,Merrifield; Mark A,23,0,30,7
1714625803476,SIOC 291S,A01,637333,Gabriel; Corey John,23,0,30,7
1714625804501,SOCI 117,A01,494376,Staff,0,4,5,5
1714625805528,WES 237B,A00,494380,Staff,9,0,20,11
1714625807602,AESE 279B,A00,494370,Wade; Jon P,0,0,33,33
1714625808631,AIP 197,001,627712,Vespa; Emanuel Ignacio,9998,0,9999,1
1714625809655,ANAR 135S,A00,494369,Braswell; Geoffrey E.,0,0,0,0
1714625810680,BENG 196,001,628496,Engler; Adam J.,9998,0,9999,1
1714625811708,CAT 124RS,A01,519847,Geibel; William,0,0,20,20
1714625812734,CAT 125RS,A01,515971,Geibel; William,0,0,20,20
1714625813761,CLRE 250,A00,511389,Morris; Sheldon,9993,0,9999,6
1714625814790,CLRE 251,A00,507176,Mehta; Ravindra L.,9993,0,9999,6
1714625814790,CLRE 251,B00,511410,Mehta; Ravindra L.,9998,0,9999,1
1714625815821,CLRE 252,A00,507189,Cuomo; Raphael Eduardo,9995,0,9999,4
1714625816900,CLRE 253,A00,507199,Vaida; Florin,9994,0,9999,5
1714625816900,CLRE 253,B00,507202,Vaida; Florin,9999,0,9999,0
1714625817928,CLRE 259,A00,507211,Patel; Hemal,9996,0,9999,3
1714625818952,CLRE 260,A00,507221,Cuomo; Raphael Eduardo,9999,0,9999,0
1714625819976,CLRE 297,001,507242,Cuomo; Raphael Eduardo,9999,0,9999,0
1714625821002,COGS 197,001,638244,Voytek; Bradley Thomas,9998,0,9999,1
1714625822027,CSE 191,A00,516875,Minnes Kemp; Mor Mia,9992,0,9999,7
1714625823053,CSE 197,001,637388,Minnes Kemp; Mor Mia,9998,0,9999,1
1714625824078,CSS 201S,A01,494383,Staff,35,0,35,0
1714625825104,CSS 202S,A01,494387,Staff,35,0,35,0
1714625826132,DSC 197,001,628532,Eldridge; Justin Matthew,9996,0,9999,3
1714625827158,EAP 100,A00,516065,Staff,9797,0,9999,202
1714625828185,ECE 45,A01,507414,Staff,33,0,60,27
1714625830237,ECE 111,A01,507420,Staff,15,0,50,35
1714625831268,ECE 197,001,548057,Sievenpiper; Daniel F.,9993,0,9999,6
1714625832293,EDS 115,A00,507243,Choi; Bailey Miyeon,10,0,28,18
1714625833324,EDS 117,A01,494379,Staff,1,5,30,29
1714625834350,EDS 125,A00,507246,Hopkins; Megan Beth,9,0,30,21
1714625835375,EDS 128A,A01,507264,Fargason; Sharon Gayle,8,0,26,18
1714625836402,EDS 128B,A01,507293,Pappas; Elizabeth,12,0,30,18
1714625837427,EDS 139,A00,507294,Fargason; Sharon Gayle,13,0,30,17
1714625837427,EDS 139,B00,507313,Pappas; Elizabeth,13,0,30,17
1714625838452,EDS 201,A00,507315,Staff,13,0,30,17
1714625839481,EDS 203,A01,507317,Halter; Christopher P.,12,0,30,18
1714625840507,EDS 204R,A01,507319,Halter; Christopher P.,0,3,30,30
1714625840507,EDS 204R,B01,507331,Heinzman; Erica M.,16,0,30,14
1714625841532,EDS 206R,A00,507332,Staff,0,4,30,30
1714625841532,EDS 206R,B00,507343,Staff,17,0,30,13
1714625842561,EDS 250,A00,507344,Hemans; Patricia Ann Benitez,22,0,40,18
1714625843590,EDS 281,A00,507345,Daly; Alan J.,18,0,18,0
1714625844615,EDS 284,A00,507350,Daly; Alan J.,16,0,16,0
1714625845646,EDS 286,A00,507359,Fine; Sarah,18,0,18,0
1714625846671,EDS 289C,A01,507361,Daly; Alan J.,18,0,18,0
1714625847699,EDS 290,A00,507366,Hofstetter; Carolyn,15,0,15,0
1714625848725,LIGM 5A,A00,507421,Fischer-Grunski; Eva K,18,0,20,2
1714625849750,LIGM 5B,A00,507423,Fischer-Grunski; Eva K,19,0,20,1
1714625850774,LIGM 5C,A00,507425,Fischer-Grunski; Eva K,19,0,20,1
1714625851802,LIIT 5AS,A00,507427,Carnelos; Chiara,20,0,20,0
1714625852827,LIIT 5BS,A00,507430,Carnelos; Chiara,20,0,20,0
1714625853853,LIIT 5CS,A00,507432,Carnelos; Chiara,20,0,20,0
1714625854878,LISP 5A,A00,507541,Munoz Sanchez; Alicia,11,0,20,9
1714625855904,LISP 5B,A00,507671,Munoz Sanchez; Alicia,8,0,20,12
1714625856931,LISP 5C,A00,507696,Munoz Sanchez; Alicia,9,0,20,11
1714625857957,MAE 197,001,528363,Boechler; Nicholas Sebastia,9998,0,9999,1
1714625858984,MATH 197,001,523477,Kedlaya; Kiran S.,9995,0,9999,4
1714625858984,MATH 197,002,563811,Zhang; Danna,9995,0,9999,4
1714625858984,MATH 197,003,628552,Dumitriu; Ioana,9998,0,9999,1
1714625860009,MCWP 40R,A00,518780,Staff,2,0,20,18
1714625860009,MCWP 40R,B00,518781,Staff,8,0,20,12
1714625860009,MCWP 40R,C00,518783,Staff,6,0,20,14
1714625861040,MCWP 50R,A00,518791,Staff,0,0,20,20
1714625861040,MCWP 50R,B00,518792,Staff,0,2,20,20
1714625861040,MCWP 50R,C00,518793,Staff,0,2,20,20
1714625861040,MCWP 50R,D00,518794,Staff,0,0,20,20
1714625861040,MCWP 50R,E00,518795,Staff,0,2,20,20
1714625861040,MCWP 50R,F00,518796,Staff,0,0,20,20
1714625861040,MCWP 50R,G00,518797,Staff,0,1,20,20
1714625862065,MMW 12R,A01,514034,Herbst; Matthew,0,0,16,16
1714625862065,MMW 12R,A02,514035,Herbst; Matthew,1,0,16,15
1714625863089,MMW 13R,A01,514037,Staff,0,4,16,16
1714625863089,MMW 13R,A02,514039,Staff,0,2,16,16
1714625863089,MMW 13R,A03,628519,Staff,0,2,16,16
1714625865140,SIO 295LS,A00,523233,Staff,10,0,30,20
1714625866166,SIO 295S,A00,523232,Staff,10,0,30,20
1714625867197,SIOC 290S,A01,637330,Merrifield; Mark A,23,0,30,7
1714625868222,SIOC 291S,A01,637333,Gabriel; Corey John,23,0,30,7
1714625869251,SOCI 117,A01,494376,Staff,0,4,5,5
1714625870278,WES 237B,A00,494380,Staff,9,0,20,11
1714625872352,AESE 279B,A00,494370,Wade; Jon P,0,0,33,33
1714625873382,AIP 197,001,627712,Vespa; Emanuel Ignacio,9998,0,9999,1
1714625874406,ANAR 135S,A00,494369,Braswell; Geoffrey E.,0,0,0,0
1714625875437,BENG 196,001,628496,Engler; Adam J.,9998,0,9999,1
1714625876464,CAT 124RS,A01,519847,Geibel; William,0,0,20,20
1714625877489,CAT 125RS,A01,515971,Geibel; William,0,0,20,20
1714625878515,CLRE 250,A00,511389,Morris; Sheldon,9993,0,9999,6
1714625879542,CLRE 251,A00,507176,Mehta; Ravindra L.,9993,0,9999,6
1714625879542,CLRE 251,B00,511410,Mehta; Ravindra L.,9998,0,9999,1
1714625880573,CLRE 252,A00,507189,Cuomo; Raphael Eduardo,9995,0,9999,4
1714625881599,CLRE 253,A00,507199,Vaida; Florin,9994,0,9999,5
1714625881599,CLRE 253,B00,507202,Vaida; Florin,9999,0,9999,0
1714625882626,CLRE 259,A00,507211,Patel; Hemal,9996,0,9999,3
1714625883651,CLRE 260,A00,507221,Cuomo; Raphael Eduardo,9999,0,9999,0
1714625884677,CLRE 297,001,507242,Cuomo; Raphael Eduardo,9999,0,9999,0
1714625885703,COGS 197,001,638244,Voytek; Bradley Thomas,9998,0,9999,1
1714625886729,CSE 191,A00,516875,Minnes Kemp; Mor Mia,9992,0,9999,7
1714625887755,CSE 197,001,637388,Minnes Kemp; Mor Mia,9998,0,9999,1
1714625888783,CSS 201S,A01,494383,Staff,35,0,35,0
1714625889813,CSS 202S,A01,494387,Staff,35,0,35,0
1714625890838,DSC 197,001,628532,Eldridge; Justin Matthew,9996,0,9999,3
1714625891863,EAP 100,A00,516065,Staff,9797,0,9999,202
1714625892889,ECE 45,A01,507414,Staff,33,0,60,27
1714625894940,ECE 111,A01,507420,Staff,15,0,50,35
1714625895967,ECE 197,001,548057,Sievenpiper; Daniel F.,9993,0,9999,6
1714625896996,EDS 115,A00,507243,Choi; Bailey Miyeon,10,0,28,18
1714625898022,EDS 117,A01,494379,Staff,1,5,30,29
1714625899048,EDS 125,A00,507246,Hopkins; Megan Beth,9,0,30,21
1714625900073,EDS 128A,A01,507264,Fargason; Sharon Gayle,8,0,26,18
1714625901104,EDS 128B,A01,507293,Pappas; Elizabeth,12,0,30,18
1714625902131,EDS 139,A00,507294,Fargason; Sharon Gayle,13,0,30,17
1714625902131,EDS 139,B00,507313,Pappas; Elizabeth,13,0,30,17
1714625903156,EDS 201,A00,507315,Staff,13,0,30,17
1714625904181,EDS 203,A01,507317,Halter; Christopher P.,12,0,30,18
1714625905213,EDS 204R,A01,507319,Halter; Christopher P.,0,3,30,30
1714625905213,EDS 204R,B01,507331,Heinzman; Erica M.,16,0,30,14
1714625906239,EDS 206R,A00,507332,Staff,0,4,30,30
1714625906239,EDS 206R,B00,507343,Staff,17,0,30,13
1714625907267,EDS 250,A00,507344,Hemans; Patricia Ann Benitez,22,0,40,18
1714625908296,EDS 281,A00,507345,Daly; Alan J.,18,0,18,0
1714625909321,EDS 284,A00,507350,Daly; Alan J.,16,0,16,0
1714625910349,EDS 286,A00,507359,Fine; Sarah,18,0,18,0
1714625911373,EDS 289C,A01,507361,Daly; Alan J.,18,0,18,0
1714625912398,EDS 290,A00,507366,Hofstetter; Carolyn,15,0,15,0
1714625913424,LIGM 5A,A00,507421,Fischer-Grunski; Eva K,18,0,20,2
1714625914449,LIGM 5B,A00,507423,Fischer-Grunski; Eva K,19,0,20,1
1714625915473,LIGM 5C,A00,507425,Fischer-Grunski; Eva K,19,0,20,1
1714625916497,LIIT 5AS,A00,507427,Carnelos; Chiara,20,0,20,0
1714625917520,LIIT 5BS,A00,507430,Carnelos; Chiara,20,0,20,0
1714625918545,LIIT 5CS,A00,507432,Carnelos; Chiara,20,0,20,0
1714625919570,LISP 5A,A00,507541,Munoz Sanchez; Alicia,11,0,20,9
1714625920596,LISP 5B,A00,507671,Munoz Sanchez; Alicia,8,0,20,12
1714625921624,LISP 5C,A00,507696,Munoz Sanchez; Alicia,9,0,20,11
1714625922655,MAE 197,001,528363,Boechler; Nicholas Sebastia,9998,0,9999,1
1714625923681,MATH 197,001,523477,Kedlaya; Kiran S.,9995,0,9999,4
1714625923681,MATH 197,002,563811,Zhang; Danna,9995,0,9999,4
1714625923681,MATH 197,003,628552,Dumitriu; Ioana,9998,0,9999,1
1714625924708,MCWP 40R,A00,518780,Staff,2,0,20,18
1714625924708,MCWP 40R,B00,518781,Staff,8,0,20,12
1714625924708,MCWP 40R,C00,518783,Staff,6,0,20,14
1714625925736,MCWP 50R,A00,518791,Staff,0,0,20,20
1714625925736,MCWP 50R,B00,518792,Staff,0,2,20,20
1714625925736,MCWP 50R,C00,518793,Staff,0,2,20,20
1714625925736,MCWP 50R,D00,518794,Staff,0,0,20,20
1714625925736,MCWP 50R,E00,518795,Staff,0,2,20,20
1714625925736,MCWP 50R,F00,518796,Staff,0,0,20,20
1714625925736,MCWP 50R,G00,518797,Staff,0,1,20,20
1714625926762,MMW 12R,A01,514034,Herbst; Matthew,0,0,16,16
1714625926762,MMW 12R,A02,514035,Herbst; Matthew,1,0,16,15
1714625927788,MMW 13R,A01,514037,Staff,0,4,16,16
1714625927788,MMW 13R,A02,514039,Staff,0,2,16,16
1714625927788,MMW 13R,A03,628519,Staff,0,2,16,16
1714625929842,SIO 295LS,A00,523233,Staff,10,0,30,20
1714625930869,SIO 295S,A00,523232,Staff,10,0,30,20
1714625931895,SIOC 290S,A01,637330,Merrifield; Mark A,23,0,30,7
1714625932922,SIOC 291S,A01,637333,Gabriel; Corey John,23,0,30,7
1714625933947,SOCI 117,A01,494376,Staff,0,4,5,5
1714625934973,WES 237B,A00,494380,Staff,9,0,20,11
1714625937056,AESE 279B,A00,494370,Wade; Jon P,0,0,33,33
1714625938081,AIP 197,001,627712,Vespa; Emanuel Ignacio,9998,0,9999,1
1714625939105,ANAR 135S,A00,494369,Braswell; Geoffrey E.,0,0,0,0
1714625940136,BENG 196,001,628496,Engler; Adam J.,9998,0,9999,1
1714625941163,CAT 124RS,A01,519847,Geibel; William,0,0,20,20
1714625942187,CAT 125RS,A01,515971,Geibel; William,0,0,20,20
1714625943218,CLRE 250,A00,511389,Morris; Sheldon,9993,0,9999,6
1714625944246,CLRE 251,A00,507176,Mehta; Ravindra L.,9993,0,9999,6
1714625944246,CLRE 251,B00,511410,Mehta; Ravindra L.,9998,0,9999,1
1714625945274,CLRE 252,A00,507189,Cuomo; Raphael Eduardo,9995,0,9999,4
1714625946300,CLRE 253,A00,507199,Vaida; Florin,9994,0,9999,5
1714625946300,CLRE 253,B00,507202,Vaida; Florin,9999,0,9999,0
1714625947326,CLRE 259,A00,507211,Patel; Hemal,9996,0,9999,3
1714625948352,CLRE 260,A00,507221,Cuomo; Raphael Eduardo,9999,0,9999,0
1714625949381,CLRE 297,001,507242,Cuomo; Raphael Eduardo,9999,0,9999,0
1714625950408,COGS 197,001,638244,Voytek; Bradley Thomas,9998,0,9999,1
1714625951434,CSE 191,A00,516875,Minnes Kemp; Mor Mia,9992,0,9999,7
1714625952459,CSE 197,001,637388,Minnes Kemp; Mor Mia,9998,0,9999,1
1714625953484,CSS 201S,A01,494383,Staff,35,0,35,0
1714625954513,CSS 202S,A01,494387,Staff,35,0,35,0
1714625955539,DSC 197,001,628532,Eldridge; Justin Matthew,9996,0,9999,3
1714625956565,EAP 100,A00,516065,Staff,9797,0,9999,202
1714625957594,ECE 45,A01,507414,Staff,33,0,60,27
1714625959644,ECE 111,A01,507420,Staff,15,0,50,35
1714625960670,ECE 197,001,548057,Sievenpiper; Daniel F.,9993,0,9999,6
1714625961698,EDS 115,A00,507243,Choi; Bailey Miyeon,10,0,28,18
1714625962729,EDS 117,A01,494379,Staff,1,5,30,29
1714625963756,EDS 125,A00,507246,Hopkins; Megan Beth,9,0,30,21
1714625964783,EDS 128A,A01,507264,Fargason; Sharon Gayle,8,0,26,18
1714625965814,EDS 128B,A01,507293,Pappas; Elizabeth,12,0,30,18
1714625966837,EDS 139,A00,507294,Fargason; Sharon Gayle,13,0,30,17
1714625966837,EDS 139,B00,507313,Pappas; Elizabeth,13,0,30,17
1714625967862,EDS 201,A00,507315,Staff,13,0,30,17
1714625968887,EDS 203,A01,507317,Halter; Christopher P.,12,0,30,18
1714625969913,EDS 204R,A01,507319,Halter; Christopher P.,0,3,30,30
1714625969913,EDS 204R,B01,507331,Heinzman; Erica M.,16,0,30,14
1714625970941,EDS 206R,A00,507332,Staff,0,4,30,30
1714625970941,EDS 206R,B00,507343,Staff,17,0,30,13
1714625971967,EDS 250,A00,507344,Hemans; Patricia Ann Benitez,22,0,40,18
1714625972996,EDS 281,A00,507345,Daly; Alan J.,18,0,18,0
1714625974020,EDS 284,A00,507350,Daly; Alan J.,16,0,16,0
1714625975046,EDS 286,A00,507359,Fine; Sarah,18,0,18,0
1714625976070,EDS 289C,A01,507361,Daly; Alan J.,18,0,18,0
1714625977095,EDS 290,A00,507366,Hofstetter; Carolyn,15,0,15,0
1714625978147,LIGM 5A,A00,507421,Fischer-Grunski; Eva K,18,0,20,2
1714625979175,LIGM 5B,A00,507423,Fischer-Grunski; Eva K,19,0,20,1
1714625980202,LIGM 5C,A00,507425,Fischer-Grunski; Eva K,19,0,20,1
1714625981228,LIIT 5AS,A00,507427,Carnelos; Chiara,20,0,20,0
1714625982256,LIIT 5BS,A00,507430,Carnelos; Chiara,20,0,20,0
1714625983284,LIIT 5CS,A00,507432,Carnelos; Chiara,20,0,20,0
1714625984313,LISP 5A,A00,507541,Munoz Sanchez; Alicia,11,0,20,9
1714625985341,LISP 5B,A00,507671,Munoz Sanchez; Alicia,8,0,20,12
1714625986369,LISP 5C,A00,507696,Munoz Sanchez; Alicia,9,0,20,11
1714625987395,MAE 197,001,528363,Boechler; Nicholas Sebastia,9998,0,9999,1
1714625988421,MATH 197,001,523477,Kedlaya; Kiran S.,9995,0,9999,4
1714625988421,MATH 197,002,563811,Zhang; Danna,9995,0,9999,4
1714625988421,MATH 197,003,628552,Dumitriu; Ioana,9998,0,9999,1
1714625989447,MCWP 40R,A00,518780,Staff,2,0,20,18
1714625989447,MCWP 40R,B00,518781,Staff,8,0,20,12
1714625989447,MCWP 40R,C00,518783,Staff,6,0,20,14
1714625990473,MCWP 50R,A00,518791,Staff,0,0,20,20
1714625990473,MCWP 50R,B00,518792,Staff,0,2,20,20
1714625990473,MCWP 50R,C00,518793,Staff,0,2,20,20
1714625990473,MCWP 50R,D00,518794,Staff,0,0,20,20
1714625990473,MCWP 50R,E00,518795,Staff,0,2,20,20
1714625990473,MCWP 50R,F00,518796,Staff,0,0,20,20
1714625990473,MCWP 50R,G00,518797,Staff,0,1,20,20
1714625991500,MMW 12R,A01,514034,Herbst; Matthew,0,0,16,16
1714625991500,MMW 12R,A02,514035,Herbst; Matthew,1,0,16,15
1714625992525,MMW 13R,A01,514037,Staff,0,4,16,16
1714625992525,MMW 13R,A02,514039,Staff,0,2,16,16
1714625992525,MMW 13R,A03,628519,Staff,0,2,16,16
1714625994577,SIO 295LS,A00,523233,Staff,10,0,30,20
1714625995601,SIO 295S,A00,523232,Staff,10,0,30,20
1714625996627,SIOC 290S,A01,637330,Merrifield; Mark A,23,0,30,7
1714625997658,SIOC 291S,A01,637333,Gabriel; Corey John,23,0,30,7
1714625998686,SOCI 117,A01,494376,Staff,0,4,5,5
1714625999712,WES 237B,A00,494380,Staff,9,0,20,11
1714626001790,AESE 279B,A00,494370,Wade; Jon P,0,0,33,33
1714626002815,AIP 197,001,627712,Vespa; Emanuel Ignacio,9998,0,9999,1
1714626003841,ANAR 135S,A00,494369,Braswell; Geoffrey E.,0,0,0,0
1714626004866,BENG 196,001,628496,Engler; Adam J.,9998,0,9999,1
1714626005892,CAT 124RS,A01,519847,Geibel; William,0,0,20,20
1714626006919,CAT 125RS,A01,515971,Geibel; William,0,0,20,20
1714626007945,CLRE 250,A00,511389,Morris; Sheldon,9993,0,9999,6
1714626008972,CLRE 251,A00,507176,Mehta; Ravindra L.,9993,0,9999,6
1714626008972,CLRE 251,B00,511410,Mehta; Ravindra L.,9998,0,9999,1
1714626009997,CLRE 252,A00,507189,Cuomo; Raphael Eduardo,9995,0,9999,4
1714626011032,CLRE 253,A00,507199,Vaida; Florin,9994,0,9999,5
1714626011032,CLRE 253,B00,507202,Vaida; Florin,9999,0,9999,0
1714626012056,CLRE 259,A00,507211,Patel; Hemal,9996,0,9999,3
1714626013079,CLRE 260,A00,507221,Cuomo; Raphael Eduardo,9999,0,9999,0
1714626014102,CLRE 297,001,507242,Cuomo; Raphael Eduardo,9999,0,9999,0
1714626015129,COGS 197,001,638244,Voytek; Bradley Thomas,9998,0,9999,1
1714626016155,CSE 191,A00,516875,Minnes Kemp; Mor Mia,9992,0,9999,7
1714626017184,CSE 197,001,637388,Minnes Kemp; Mor Mia,9998,0,9999,1
1714626018209,CSS 201S,A01,494383,Staff,35,0,35,0
1714626019237,CSS 202S,A01,494387,Staff,35,0,35,0
1714626020263,DSC 197,001,628532,Eldridge; Justin Matthew,9996,0,9999,3
1714626021287,EAP 100,A00,516065,Staff,9797,0,9999,202
1714626022313,ECE 45,A01,507414,Staff,33,0,60,27
1714626024368,ECE 111,A01,507420,Staff,15,0,50,35
1714626025393,ECE 197,001,548057,Sievenpiper; Daniel F.,9993,0,9999,6
1714626026421,EDS 115,A00,507243,Choi; Bailey Miyeon,10,0,28,18
1714626027451,EDS 117,A01,494379,Staff,1,5,30,29
1714626028482,EDS 125,A00,507246,Hopkins; Megan Beth,9,0,30,21
1714626029513,EDS 128A,A01,507264,Fargason; Sharon Gayle,8,0,26,18
1714626030542,EDS 128B,A01,507293,Pappas; Elizabeth,12,0,30,18
1714626031569,EDS 139,A00,507294,Fargason; Sharon Gayle,13,0,30,17
1714626031569,EDS 139,B00,507313,Pappas; Elizabeth,13,0,30,17
1714626032594,EDS 201,A00,507315,Staff,13,0,30,17
1714626033624,EDS 203,A01,507317,Halter; Christopher P.,12,0,30,18
1714626034648,EDS 204R,A01,507319,Halter; Christopher P.,0,3,30,30
1714626034648,EDS 204R,B01,507331,Heinzman; Erica M.,16,0,30,14
1714626035673,EDS 206R,A00,507332,Staff,0,4,30,30
1714626035673,EDS 206R,B00,507343,Staff,17,0,30,13
1714626036701,EDS 250,A00,507344,Hemans; Patricia Ann Benitez,22,0,40,18
1714626037738,EDS 281,A00,507345,Daly; Alan J.,18,0,18,0
1714626038761,EDS 284,A00,507350,Daly; Alan J.,16,0,16,0
1714626039787,EDS 286,A00,507359,Fine; Sarah,18,0,18,0
1714626040814,EDS 289C,A01,507361,Daly; Alan J.,18,0,18,0
1714626041841,EDS 290,A00,507366,Hofstetter; Carolyn,15,0,15,0
1714626042868,LIGM 5A,A00,507421,Fischer-Grunski; Eva K,18,0,20,2
1714626043892,LIGM 5B,A00,507423,Fischer-Grunski; Eva K,19,0,20,1
1714626044916,LIGM 5C,A00,507425,Fischer-Grunski; Eva K,19,0,20,1
1714626045943,LIIT 5AS,A00,507427,Carnelos; Chiara,20,0,20,0
1714626046970,LIIT 5BS,A00,507430,Carnelos; Chiara,20,0,20,0
1714626047995,LIIT 5CS,A00,507432,Carnelos; Chiara,20,0,20,0
1714626049022,LISP 5A,A00,507541,Munoz Sanchez; Alicia,11,0,20,9
1714626050052,LISP 5B,A00,507671,Munoz Sanchez; Alicia,8,0,20,12
1714626051081,LISP 5C,A00,507696,Munoz Sanchez; Alicia,9,0,20,11
1714626052109,MAE 197,001,528363,Boechler; Nicholas Sebastia,9998,0,9999,1
1714626053139,MATH 197,001,523477,Kedlaya; Kiran S.,9995,0,9999,4
1714626053139,MATH 197,002,563811,Zhang; Danna,9995,0,9999,4
1714626053139,MATH 197,003,628552,Dumitriu; Ioana,9998,0,9999,1
1714626054167,MCWP 40R,A00,518780,Staff,2,0,20,18
1714626054167,MCWP 40R,B00,518781,Staff,8,0,20,12
1714626054167,MCWP 40R,C00,518783,Staff,6,0,20,14
1714626055193,MCWP 50R,A00,518791,Staff,0,0,20,20
1714626055193,MCWP 50R,B00,518792,Staff,0,2,20,20
1714626055193,MCWP 50R,C00,518793,Staff,0,2,20,20
1714626055193,MCWP 50R,D00,518794,Staff,0,0,20,20
1714626055193,MCWP 50R,E00,518795,Staff,0,2,20,20
1714626055193,MCWP 50R,F00,518796,Staff,0,0,20,20
1714626055193,MCWP 50R,G00,518797,Staff,0,1,20,20
1714626056220,MMW 12R,A01,514034,Herbst; Matthew,0,0,16,16
1714626056220,MMW 12R,A02,514035,Herbst; Matthew,1,0,16,15
1714626057246,MMW 13R,A01,514037,Staff,0,4,16,16
1714626057246,MMW 13R,A02,514039,Staff,0,2,16,16
1714626057246,MMW 13R,A03,628519,Staff,0,2,16,16
1714626059297,SIO 295LS,A00,523233,Staff,10,0,30,20
1714626060328,SIO 295S,A00,523232,Staff,10,0,30,20
1714626061353,SIOC 290S,A01,637330,Merrifield; Mark A,23,0,30,7
1714626062379,SIOC 291S,A01,637333,Gabriel; Corey John,23,0,30,7
1714626063411,SOCI 117,A01,494376,Staff,0,4,5,5
1714626064435,WES 237B,A00,494380,Staff,9,0,20,11
1714626066509,AESE 279B,A00,494370,Wade; Jon P,0,0,33,33
1714626067535,AIP 197,001,627712,Vespa; Emanuel Ignacio,9998,0,9999,1
1714626068560,ANAR 135S,A00,494369,Braswell; Geoffrey E.,0,0,0,0
1714626069587,BENG 196,001,628496,Engler; Adam J.,9998,0,9999,1
1714626070612,CAT 124RS,A01,519847,Geibel; William,0,0,20,20
1714626071640,CAT 125RS,A01,515971,Geibel; William,0,0,20,20
1714626072666,CLRE 250,A00,511389,Morris; Sheldon,9993,0,9999,6
1714626073698,CLRE 251,A00,507176,Mehta; Ravindra L.,9993,0,9999,6
1714626073698,CLRE 251,B00,511410,Mehta; Ravindra L.,9998,0,9999,1
1714626074724,CLRE 252,A00,507189,Cuomo; Raphael Eduardo,9995,0,9999,4
1714626075755,CLRE 253,A00,507199,Vaida; Florin,9994,0,9999,5
1714626075755,CLRE 253,B00,507202,Vaida; Florin,9999,0,9999,0
1714626076783,CLRE 259,A00,507211,Patel; Hemal,9996,0,9999,3
1714626077809,CLRE 260,A00,507221,Cuomo; Raphael Eduardo,9999,0,9999,0
1714626078836,CLRE 297,001,507242,Cuomo; Raphael Eduardo,9999,0,9999,0
1714626079860,COGS 197,001,638244,Voytek; Bradley Thomas,9998,0,9999,1
1714626080885,CSE 191,A00,516875,Minnes Kemp; Mor Mia,9992,0,9999,7
1714626081910,CSE 197,001,637388,Minnes Kemp; Mor Mia,9998,0,9999,1
1714626082936,CSS 201S,A01,494383,Staff,35,0,35,0
1714626083966,CSS 202S,A01,494387,Staff,35,0,35,0
1714626084990,DSC 197,001,628532,Eldridge; Justin Matthew,9996,0,9999,3
1714626086017,EAP 100,A00,516065,Staff,9797,0,9999,202
1714626087047,ECE 45,A01,507414,Staff,33,0,60,27
1714626089096,ECE 111,A01,507420,Staff,15,0,50,35
1714626090125,ECE 197,001,548057,Sievenpiper; Daniel F.,9993,0,9999,6
1714626091207,EDS 115,A00,507243,Choi; Bailey Miyeon,10,0,28,18
1714626092233,EDS 117,A01,494379,Staff,1,5,30,29
1714626093262,EDS 125,A00,507246,Hopkins; Megan Beth,9,0,30,21
1714626094292,EDS 128A,A01,507264,Fargason; Sharon Gayle,8,0,26,18
1714626095318,EDS 128B,A01,507293,Pappas; Elizabeth,12,0,30,18
1714626096345,EDS 139,A00,507294,Fargason; Sharon Gayle,13,0,30,17
1714626096345,EDS 139,B00,507313,Pappas; Elizabeth,13,0,30,17
1714626097368,EDS 201,A00,507315,Staff,13,0,30,17
1714626098398,EDS 203,A01,507317,Halter; Christopher P.,12,0,30,18
1714626099423,EDS 204R,A01,507319,Halter; Christopher P.,0,3,30,30
1714626099423,EDS 204R,B01,507331,Heinzman; Erica M.,16,0,30,14
1714626100448,EDS 206R,A00,507332,Staff,0,4,30,30
1714626100448,EDS 206R,B00,507343,Staff,17,0,30,13
1714626101475,EDS 250,A00,507344,Hemans; Patricia Ann Benitez,22,0,40,18
1714626102503,EDS 281,A00,507345,Daly; Alan J.,18,0,18,0
1714626103527,EDS 284,A00,507350,Daly; Alan J.,16,0,16,0
1714626104555,EDS 286,A00,507359,Fine; Sarah,18,0,18,0
1714626105584,EDS 289C,A01,507361,Daly; Alan J.,18,0,18,0
1714626106614,EDS 290,A00,507366,Hofstetter; Carolyn,15,0,15,0
1714626107641,LIGM 5A,A00,507421,Fischer-Grunski; Eva K,18,0,20,2
1714626108665,LIGM 5B,A00,507423,Fischer-Grunski; Eva K,19,0,20,1
1714626109695,LIGM 5C,A00,507425,Fischer-Grunski; Eva K,19,0,20,1
1714626110720,LIIT 5AS,A00,507427,Carnelos; Chiara,20,0,20,0
1714626111749,LIIT 5BS,A00,507430,Carnelos; Chiara,20,0,20,0
1714626112776,LIIT 5CS,A00,507432,Carnelos; Chiara,20,0,20,0
1714626113801,LISP 5A,A00,507541,Munoz Sanchez; Alicia,11,0,20,9
1714626114828,LISP 5B,A00,507671,Munoz Sanchez; Alicia,8,0,20,12
1714626115853,LISP 5C,A00,507696,Munoz Sanchez; Alicia,9,0,20,11
1714626116878,MAE 197,001,528363,Boechler; Nicholas Sebastia,9998,0,9999,1
1714626117908,MATH 197,001,523477,Kedlaya; Kiran S.,9995,0,9999,4
1714626117908,MATH 197,002,563811,Zhang; Danna,9995,0,9999,4
1714626117908,MATH 197,003,628552,Dumitriu; Ioana,9998,0,9999,1
1714626118934,MCWP 40R,A00,518780,Staff,2,0,20,18
1714626118934,MCWP 40R,B00,518781,Staff,8,0,20,12
1714626118934,MCWP 40R,C00,518783,Staff,6,0,20,14
1714626119968,MCWP 50R,A00,518791,Staff,0,0,20,20
1714626119968,MCWP 50R,B00,518792,Staff,0,2,20,20
1714626119968,MCWP 50R,C00,518793,Staff,0,2,20,20
1714626119968,MCWP 50R,D00,518794,Staff,0,0,20,20
1714626119968,MCWP 50R,E00,518795,Staff,0,2,20,20
1714626119968,MCWP 50R,F00,518796,Staff,0,0,20,20
1714626119968,MCWP 50R,G00,518797,Staff,0,1,20,20
1714626121533,MMW 12R,A01,514034,Herbst; Matthew,0,0,16,16
1714626121533,MMW 12R,A02,514035,Herbst; Matthew,1,0,16,15
1714626122558,MMW 13R,A01,514037,Staff,0,4,16,16
1714626122558,MMW 13R,A02,514039,Staff,0,2,16,16
1714626122558,MMW 13R,A03,628519,Staff,0,2,16,16
1714626124609,SIO 295LS,A00,523233,Staff,10,0,30,20
1714626125637,SIO 295S,A00,523232,Staff,10,0,30,20
1714626126663,SIOC 290S,A01,637330,Merrifield; Mark A,23,0,30,7
1714626127689,SIOC 291S,A01,637333,Gabriel; Corey John,23,0,30,7
1714626128716,SOCI 117,A01,494376,Staff,0,4,5,5
1714626129741,WES 237B,A00,494380,Staff,9,0,20,11
1714626131828,AESE 279B,A00,494370,Wade; Jon P,0,0,33,33
1714626132855,AIP 197,001,627712,Vespa; Emanuel Ignacio,9998,0,9999,1
1714626133881,ANAR 135S,A00,494369,Braswell; Geoffrey E.,0,0,0,0
1714626134907,BENG 196,001,628496,Engler; Adam J.,9998,0,9999,1
1714626135934,CAT 124RS,A01,519847,Geibel; William,0,0,20,20
1714626136961,CAT 125RS,A01,515971,Geibel; William,0,0,20,20
1714626137988,CLRE 250,A00,511389,Morris; Sheldon,9993,0,9999,6
1714626139018,CLRE 251,A00,507176,Mehta; Ravindra L.,9993,0,9999,6
1714626139018,CLRE 251,B00,511410,Mehta; Ravindra L.,9998,0,9999,1
1714626140047,CLRE 252,A00,507189,Cuomo; Raphael Eduardo,9995,0,9999,4
1714626141078,CLRE 253,A00,507199,Vaida; Florin,9994,0,9999,5
1714626141078,CLRE 253,B00,507202,Vaida; Florin,9999,0,9999,0
1714626142105,CLRE 259,A00,507211,Patel; Hemal,9996,0,9999,3
1714626143132,CLRE 260,A00,507221,Cuomo; Raphael Eduardo,9999,0,9999,0
1714626144156,CLRE 297,001,507242,Cuomo; Raphael Eduardo,9999,0,9999,0
1714626145182,COGS 197,001,638244,Voytek; Bradley Thomas,9998,0,9999,1
1714626146210,CSE 191,A00,516875,Minnes Kemp; Mor Mia,9992,0,9999,7
1714626147237,CSE 197,001,637388,Minnes Kemp; Mor Mia,9998,0,9999,1
1714626148262,CSS 201S,A01,494383,Staff,35,0,35,0
1714626149288,CSS 202S,A01,494387,Staff,35,0,35,0
1714626150313,DSC 197,001,628532,Eldridge; Justin Matthew,9996,0,9999,3
1714626151339,EAP 100,A00,516065,Staff,9797,0,9999,202
1714626152368,ECE 45,A01,507414,Staff,33,0,60,27
1714626154423,ECE 111,A01,507420,Staff,15,0,50,35
1714626155452,ECE 197,001,548057,Sievenpiper; Daniel F.,9993,0,9999,6
1714626156482,EDS 115,A00,507243,Choi; Bailey Miyeon,10,0,28,18
1714626157507,EDS 117,A01,494379,Staff,1,5,30,29
1714626158533,EDS 125,A00,507246,Hopkins; Megan Beth,9,0,30,21
1714626159558,EDS 128A,A01,507264,Fargason; Sharon Gayle,8,0,26,18
1714626160588,EDS 128B,A01,507293,Pappas; Elizabeth,12,0,30,18
1714626161617,EDS 139,A00,507294,Fargason; Sharon Gayle,13,0,30,17
1714626161617,EDS 139,B00,507313,Pappas; Elizabeth,13,0,30,17
1714626162643,EDS 201,A00,507315,Staff,13,0,30,17
1714626163669,EDS 203,A01,507317,Halter; Christopher P.,12,0,30,18
1714626164697,EDS 204R,A01,507319,Halter; Christopher P.,0,3,30,30
1714626164697,EDS 204R,B01,507331,Heinzman; Erica M.,16,0,30,14
1714626165727,EDS 206R,A00,507332,Staff,0,4,30,30
1714626165727,EDS 206R,B00,507343,Staff,17,0,30,13
1714626166752,EDS 250,A00,507344,Hemans; Patricia Ann Benitez,22,0,40,18
1714626167778,EDS 281,A00,507345,Daly; Alan J.,18,0,18,0
1714626168802,EDS 284,A00,507350,Daly; Alan J.,16,0,16,0
1714626169828,EDS 286,A00,507359,Fine; Sarah,18,0,18,0
1714626170852,EDS 289C,A01,507361,Daly; Alan J.,18,0,18,0
1714626171876,EDS 290,A00,507366,Hofstetter; Carolyn,15,0,15,0
1714626172909,LIGM 5A,A00,507421,Fischer-Grunski; Eva K,18,0,20,2
1714626173934,LIGM 5B,A00,507423,Fischer-Grunski; Eva K,19,0,20,1
1714626174960,LIGM 5C,A00,507425,Fischer-Grunski; Eva K,19,0,20,1
1714626175991,LIIT 5AS,A00,507427,Carnelos; Chiara,20,0,20,0
1714626177017,LIIT 5BS,A00,507430,Carnelos; Chiara,20,0,20,0
1714626178046,LIIT 5CS,A00,507432,Carnelos; Chiara,20,0,20,0
1714626179071,LISP 5A,A00,507541,Munoz Sanchez; Alicia,11,0,20,9
1714626180097,LISP 5B,A00,507671,Munoz Sanchez; Alicia,8,0,20,12
1714626181127,LISP 5C,A00,507696,Munoz Sanchez; Alicia,9,0,20,11
1714626182156,MAE 197,001,528363,Boechler; Nicholas Sebastia,9998,0,9999,1
1714626183184,MATH 197,001,523477,Kedlaya; Kiran S.,9995,0,9999,4
1714626183184,MATH 197,002,563811,Zhang; Danna,9995,0,9999,4
1714626183184,MATH 197,003,628552,Dumitriu; Ioana,9998,0,9999,1
1714626184209,MCWP 40R,A00,518780,Staff,2,0,20,18
1714626184209,MCWP 40R,B00,518781,Staff,8,0,20,12
1714626184209,MCWP 40R,C00,518783,Staff,6,0,20,14
1714626185235,MCWP 50R,A00,518791,Staff,0,0,20,20
1714626185235,MCWP 50R,B00,518792,Staff,0,2,20,20
1714626185235,MCWP 50R,C00,518793,Staff,0,2,20,20
1714626185235,MCWP 50R,D00,518794,Staff,0,0,20,20
1714626185235,MCWP 50R,E00,518795,Staff,0,2,20,20
1714626185235,MCWP 50R,F00,518796,Staff,0,0,20,20
1714626185235,MCWP 50R,G00,518797,Staff,0,1,20,20
1714626186263,MMW 12R,A01,514034,Herbst; Matthew,0,0,16,16
1714626186263,MMW 12R,A02,514035,Herbst; Matthew,1,0,16,15
1714626187287,MMW 13R,A01,514037,Staff,0,4,16,16
1714626187287,MMW 13R,A02,514039,Staff,0,2,16,16
1714626187287,MMW 13R,A03,628519,Staff,0,2,16,16
1714626189346,SIO 295LS,A00,523233,Staff,10,0,30,20
1714626190374,SIO 295S,A00,523232,Staff,10,0,30,20
1714626191596,SIOC 290S,A01,637330,Merrifield; Mark A,23,0,30,7
1714626192624,SIOC 291S,A01,637333,Gabriel; Corey John,23,0,30,7
1714626193654,SOCI 117,A01,494376,Staff,0,4,5,5
1714626194683,WES 237B,A00,494380,Staff,9,0,20,11
1714626196821,AESE 279B,A00,494370,Wade; Jon P,0,0,33,33
1714626197854,AIP 197,001,627712,Vespa; Emanuel Ignacio,9998,0,9999,1
1714626198884,ANAR 135S,A00,494369,Braswell; Geoffrey E.,0,0,0,0
1714626199910,BENG 196,001,628496,Engler; Adam J.,9998,0,9999,1
1714626200935,CAT 124RS,A01,519847,Geibel; William,0,0,20,20
1714626201962,CAT 125RS,A01,515971,Geibel; William,0,0,20,20
1714626202991,CLRE 250,A00,511389,Morris; Sheldon,9993,0,9999,6
1714626204024,CLRE 251,A00,507176,Mehta; Ravindra L.,9993,0,9999,6
1714626204024,CLRE 251,B00,511410,Mehta; Ravindra L.,9998,0,9999,1
1714626205049,CLRE 252,A00,507189,Cuomo; Raphael Eduardo,9995,0,9999,4
1714626206077,CLRE 253,A00,507199,Vaida; Florin,9994,0,9999,5
1714626206077,CLRE 253,B00,507202,Vaida; Florin,9999,0,9999,0
1714626207105,CLRE 259,A00,507211,Patel; Hemal,9996,0,9999,3
1714626208133,CLRE 260,A00,507221,Cuomo; Raphael Eduardo,9999,0,9999,0
1714626209160,CLRE 297,001,507242,Cuomo; Raphael Eduardo,9999,0,9999,0
1714626210187,COGS 197,001,638244,Voytek; Bradley Thomas,9998,0,9999,1
1714626211213,CSE 191,A00,516875,Minnes Kemp; Mor Mia,9992,0,9999,7
1714626212237,CSE 197,001,637388,Minnes Kemp; Mor Mia,9998,0,9999,1
1714626213265,CSS 201S,A01,494383,Staff,35,0,35,0
1714626214294,CSS 202S,A01,494387,Staff,35,0,35,0
1714626215323,DSC 197,001,628532,Eldridge; Justin Matthew,9996,0,9999,3
1714626216350,EAP 100,A00,516065,Staff,9797,0,9999,202
1714626217376,ECE 45,A01,507414,Staff,33,0,60,27
1714626219428,ECE 111,A01,507420,Staff,15,0,50,35
1714626220457,ECE 197,001,548057,Sievenpiper; Daniel F.,9993,0,9999,6
1714626221483,EDS 115,A00,507243,Choi; Bailey Miyeon,10,0,28,18
1714626222509,EDS 117,A01,494379,Staff,1,5,30,29
1714626223534,EDS 125,A00,507246,Hopkins; Megan Beth,9,0,30,21
1714626224767,EDS 128A,A01,507264,Fargason; Sharon Gayle,8,0,26,18
1714626225793,EDS 128B,A01,507293,Pappas; Elizabeth,12,0,30,18
1714626226818,EDS 139,A00,507294,Fargason; Sharon Gayle,13,0,30,17
1714626226818,EDS 139,B00,507313,Pappas; Elizabeth,13,0,30,17
1714626227898,EDS 201,A00,507315,Staff,13,0,30,17
1714626228931,EDS 203,A01,507317,Halter; Christopher P.,12,0,30,18
1714626229960,EDS 204R,A01,507319,Halter; Christopher P.,0,3,30,30
1714626229960,EDS 204R,B01,507331,Heinzman; Erica M.,16,0,30,14
1714626230983,EDS 206R,A00,507332,Staff,0,4,30,30
1714626230983,EDS 206R,B00,507343,Staff,17,0,30,13
1714626232009,EDS 250,A00,507344,Hemans; Patricia Ann Benitez,22,0,40,18
1714626233032,EDS 281,A00,507345,Daly; Alan J.,18,0,18,0
1714626234061,EDS 284,A00,507350,Daly; Alan J.,16,0,16,0
1714626235090,EDS 286,A00,507359,Fine; Sarah,18,0,18,0
1714626236114,EDS 289C,A01,507361,Daly; Alan J.,18,0,18,0
1714626237141,EDS 290,A00,507366,Hofstetter; Carolyn,15,0,15,0
1714626238166,LIGM 5A,A00,507421,Fischer-Grunski; Eva K,18,0,20,2
1714626239191,LIGM 5B,A00,507423,Fischer-Grunski; Eva K,19,0,20,1
1714626240223,LIGM 5C,A00,507425,Fischer-Grunski; Eva K,19,0,20,1
1714626241250,LIIT 5AS,A00,507427,Carnelos; Chiara,20,0,20,0
1714626242281,LIIT 5BS,A00,507430,Carnelos; Chiara,20,0,20,0
1714626243307,LIIT 5CS,A00,507432,Carnelos; Chiara,20,0,20,0
1714626244332,LISP 5A,A00,507541,Munoz Sanchez; Alicia,11,0,20,9
1714626245358,LISP 5B,A00,507671,Munoz Sanchez; Alicia,8,0,20,12
1714626246388,LISP 5C,A00,507696,Munoz Sanchez; Alicia,9,0,20,11
1714626247413,MAE 197,001,528363,Boechler; Nicholas Sebastia,9998,0,9999,1
1714626248496,MATH 197,001,523477,Kedlaya; Kiran S.,9995,0,9999,4
1714626248496,MATH 197,002,563811,Zhang; Danna,9995,0,9999,4
1714626248496,MATH 197,003,628552,Dumitriu; Ioana,9998,0,9999,1
1714626249524,MCWP 40R,A00,518780,Staff,2,0,20,18
1714626249524,MCWP 40R,B00,518781,Staff,8,0,20,12
1714626249524,MCWP 40R,C00,518783,Staff,6,0,20,14
1714626250550,MCWP 50R,A00,518791,Staff,0,0,20,20
1714626250550,MCWP 50R,B00,518792,Staff,0,2,20,20
1714626250550,MCWP 50R,C00,518793,Staff,0,2,20,20
1714626250550,MCWP 50R,D00,518794,Staff,0,0,20,20
1714626250550,MCWP 50R,E00,518795,Staff,0,2,20,20
1714626250550,MCWP 50R,F00,518796,Staff,0,0,20,20
1714626250550,MCWP 50R,G00,518797,Staff,0,1,20,20
1714626251576,MMW 12R,A01,514034,Herbst; Matthew,0,0,16,16
1714626251576,MMW 12R,A02,514035,Herbst; Matthew,1,0,16,15
1714626252607,MMW 13R,A01,514037,Staff,0,4,16,16
1714626252607,MMW 13R,A02,514039,Staff,0,2,16,16
1714626252607,MMW 13R,A03,628519,Staff,0,2,16,16
1714626254660,SIO 295LS,A00,523233,Staff,10,0,30,20
1714626255685,SIO 295S,A00,523232,Staff,10,0,30,20
1714626256711,SIOC 290S,A01,637330,Merrifield; Mark A,23,0,30,7
1714626257738,SIOC 291S,A01,637333,Gabriel; Corey John,23,0,30,7
1714626258764,SOCI 117,A01,494376,Staff,0,4,5,5
1714626259791,WES 237B,A00,494380,Staff,9,0,20,11
1714626261862,AESE 279B,A00,494370,Wade; Jon P,0,0,33,33
1714626262885,AIP 197,001,627712,Vespa; Emanuel Ignacio,9998,0,9999,1
1714626263912,ANAR 135S,A00,494369,Braswell; Geoffrey E.,0,0,0,0
1714626264937,BENG 196,001,628496,Engler; Adam J.,9998,0,9999,1
1714626265963,CAT 124RS,A01,519847,Geibel; William,0,0,20,20
1714626266992,CAT 125RS,A01,515971,Geibel; William,0,0,20,20
1714626268022,CLRE 250,A00,511389,Morris; Sheldon,9993,0,9999,6
1714626269056,CLRE 251,A00,507176,Mehta; Ravindra L.,9993,0,9999,6
1714626269056,CLRE 251,B00,511410,Mehta; Ravindra L.,9998,0,9999,1
1714626270082,CLRE 252,A00,507189,Cuomo; Raphael Eduardo,9995,0,9999,4
1714626271108,CLRE 253,A00,507199,Vaida; Florin,9994,0,9999,5
1714626271108,CLRE 253,B00,507202,Vaida; Florin,9999,0,9999,0
1714626272133,CLRE 259,A00,507211,Patel; Hemal,9996,0,9999,3
1714626273160,CLRE 260,A00,507221,Cuomo; Raphael Eduardo,9999,0,9999,0
1714626274184,CLRE 297,001,507242,Cuomo; Raphael Eduardo,9999,0,9999,0
1714626275211,COGS 197,001,638244,Voytek; Bradley Thomas,9998,0,9999,1
1714626276238,CSE 191,A00,516875,Minnes Kemp; Mor Mia,9992,0,9999,7
1714626277264,CSE 197,001,637388,Minnes Kemp; Mor Mia,9998,0,9999,1
1714626278289,CSS 201S,A01,494383,Staff,35,0,35,0
1714626279321,CSS 202S,A01,494387,Staff,35,0,35,0
1714626280346,DSC 197,001,628532,Eldridge; Justin Matthew,9996,0,9999,3
1714626281372,EAP 100,A00,516065,Staff,9797,0,9999,202
1714626282399,ECE 45,A01,507414,Staff,33,0,60,27
1714626284450,ECE 111,A01,507420,Staff,15,0,50,35
1714626285476,ECE 197,001,548057,Sievenpiper; Daniel F.,9993,0,9999,6
1714626286503,EDS 115,A00,507243,Choi; Bailey Miyeon,10,0,28,18
1714626287532,EDS 117,A01,494379,Staff,1,5,30,29
1714626288557,EDS 125,A00,507246,Hopkins; Megan Beth,9,0,30,21
1714626289582,EDS 128A,A01,507264,Fargason; Sharon Gayle,8,0,26,18
1714626290611,EDS 128B,A01,507293,Pappas; Elizabeth,12,0,30,18
1714626291638,EDS 139,A00,507294,Fargason; Sharon Gayle,13,0,30,17
1714626291638,EDS 139,B00,507313,Pappas; Elizabeth,13,0,30,17
1714626292663,EDS 201,A00,507315,Staff,13,0,30,17
1714626293690,EDS 203,A01,507317,Halter; Christopher P.,12,0,30,18
1714626294715,EDS 204R,A01,507319,Halter; Christopher P.,0,3,30,30
1714626294715,EDS 204R,B01,507331,Heinzman; Erica M.,16,0,30,14
1714626295738,EDS 206R,A00,507332,Staff,0,4,30,30
1714626295738,EDS 206R,B00,507343,Staff,17,0,30,13
1714626296764,EDS 250,A00,507344,Hemans; Patricia Ann Benitez,22,0,40,18
1714626297790,EDS 281,A00,507345,Daly; Alan J.,18,0,18,0
1714626298816,EDS 284,A00,507350,Daly; Alan J.,16,0,16,0
1714626299845,EDS 286,A00,507359,Fine; Sarah,18,0,18,0
1714626300872,EDS 289C,A01,507361,Daly; Alan J.,18,0,18,0
1714626301901,EDS 290,A00,507366,Hofstetter; Carolyn,15,0,15,0
1714626302927,LIGM 5A,A00,507421,Fischer-Grunski; Eva K,18,0,20,2
1714626303955,LIGM 5B,A00,507423,Fischer-Grunski; Eva K,19,0,20,1
1714626304981,LIGM 5C,A00,507425,Fischer-Grunski; Eva K,19,0,20,1
1714626306005,LIIT 5AS,A00,507427,Carnelos; Chiara,20,0,20,0
1714626307028,LIIT 5BS,A00,507430,Carnelos; Chiara,20,0,20,0
1714626308056,LIIT 5CS,A00,507432,Carnelos; Chiara,20,0,20,0
1714626309080,LISP 5A,A00,507541,Munoz Sanchez; Alicia,11,0,20,9
1714626310108,LISP 5B,A00,507671,Munoz Sanchez; Alicia,8,0,20,12
1714626311137,LISP 5C,A00,507696,Munoz Sanchez; Alicia,9,0,20,11
1714626312218,MAE 197,001,528363,Boechler; Nicholas Sebastia,9998,0,9999,1
1714626313245,MATH 197,001,523477,Kedlaya; Kiran S.,9995,0,9999,4
1714626313245,MATH 197,002,563811,Zhang; Danna,9995,0,9999,4
1714626313245,MATH 197,003,628552,Dumitriu; Ioana,9998,0,9999,1
1714626314268,MCWP 40R,A00,518780,Staff,2,0,20,18
1714626314268,MCWP 40R,B00,518781,Staff,8,0,20,12
1714626314268,MCWP 40R,C00,518783,Staff,6,0,20,14
1714626315299,MCWP 50R,A00,518791,Staff,0,0,20,20
1714626315299,MCWP 50R,B00,518792,Staff,0,2,20,20
1714626315299,MCWP 50R,C00,518793,Staff,0,2,20,20
1714626315299,MCWP 50R,D00,518794,Staff,0,0,20,20
1714626315299,MCWP 50R,E00,518795,Staff,0,2,20,20
1714626315299,MCWP 50R,F00,518796,Staff,0,0,20,20
1714626315299,MCWP 50R,G00,518797,Staff,0,1,20,20
1714626316325,MMW 12R,A01,514034,Herbst; Matthew,0,0,16,16
1714626316325,MMW 12R,A02,514035,Herbst; Matthew,1,0,16,15
1714626317353,MMW 13R,A01,514037,Staff,0,4,16,16
1714626317353,MMW 13R,A02,514039,Staff,0,2,16,16
1714626317353,MMW 13R,A03,628519,Staff,0,2,16,16
1714626319405,SIO 295LS,A00,523233,Staff,10,0,30,20
1714626320435,SIO 295S,A00,523232,Staff,10,0,30,20
1714626321466,SIOC 290S,A01,637330,Merrifield; Mark A,23,0,30,7
1714626322495,SIOC 291S,A01,637333,Gabriel; Corey John,23,0,30,7
1714626323521,SOCI 117,A01,494376,Staff,0,4,5,5
1714626324549,WES 237B,A00,494380,Staff,9,0,20,11
1714626326634,AESE 279B,A00,494370,Wade; Jon P,0,0,33,33
1714626327664,AIP 197,001,627712,Vespa; Emanuel Ignacio,9998,0,9999,1
1714626328689,ANAR 135S,A00,494369,Braswell; Geoffrey E.,0,0,0,0
1714626329716,BENG 196,001,628496,Engler; Adam J.,9998,0,9999,1
1714626330742,CAT 124RS,A01,519847,Geibel; William,0,0,20,20
1714626331769,CAT 125RS,A01,515971,Geibel; William,0,0,20,20
1714626332796,CLRE 250,A00,511389,Morris; Sheldon,9993,0,9999,6
1714626333828,CLRE 251,A00,507176,Mehta; Ravindra L.,9993,0,9999,6
1714626333828,CLRE 251,B00,511410,Mehta; Ravindra L.,9998,0,9999,1
1714626334856,CLRE 252,A00,507189,Cuomo; Raphael Eduardo,9995,0,9999,4
1714626335883,CLRE 253,A00,507199,Vaida; Florin,9994,0,9999,5
1714626335883,CLRE 253,B00,507202,Vaida; Florin,9999,0,9999,0
1714626336911,CLRE 259,A00,507211,Patel; Hemal,9996,0,9999,3
1714626337942,CLRE 260,A00,507221,Cuomo; Raphael Eduardo,9999,0,9999,0
1714626338967,CLRE 297,001,507242,Cuomo; Raphael Eduardo,9999,0,9999,0
1714626339994,COGS 197,001,638244,Voytek; Bradley Thomas,9998,0,9999,1
1714626341045,CSE 191,A00,516875,Minnes Kemp; Mor Mia,9992,0,9999,7
1714626342069,CSE 197,001,637388,Minnes Kemp; Mor Mia,9998,0,9999,1
1714626343097,CSS 201S,A01,494383,Staff,35,0,35,0
1714626344122,CSS 202S,A01,494387,Staff,35,0,35,0
1714626345149,DSC 197,001,628532,Eldridge; Justin Matthew,9996,0,9999,3
1714626346177,EAP 100,A00,516065,Staff,9797,0,9999,202
1714626347201,ECE 45,A01,507414,Staff,33,0,60,27
1714626349254,ECE 111,A01,507420,Staff,15,0,50,35
1714626350279,ECE 197,001,548057,Sievenpiper; Daniel F.,9993,0,9999,6
1714626351304,EDS 115,A00,507243,Choi; Bailey Miyeon,10,0,28,18
1714626352334,EDS 117,A01,494379,Staff,1,5,30,29
1714626353359,EDS 125,A00,507246,Hopkins; Megan Beth,9,0,30,21
1714626354384,EDS 128A,A01,507264,Fargason; Sharon Gayle,8,0,26,18
1714626355408,EDS 128B,A01,507293,Pappas; Elizabeth,12,0,30,18
1714626356434,EDS 139,A00,507294,Fargason; Sharon Gayle,13,0,30,17
1714626356434,EDS 139,B00,507313,Pappas; Elizabeth,13,0,30,17
1714626357459,EDS 201,A00,507315,Staff,13,0,30,17
1714626358484,EDS 203,A01,507317,Halter; Christopher P.,12,0,30,18
1714626359516,EDS 204R,A01,507319,Halter; Christopher P.,0,3,30,30
1714626359516,EDS 204R,B01,507331,Heinzman; Erica M.,16,0,30,14
1714626360545,EDS 206R,A00,507332,Staff,0,4,30,30
1714626360545,EDS 206R,B00,507343,Staff,17,0,30,13
1714626361570,EDS 250,A00,507344,Hemans; Patricia Ann Benitez,22,0,40,18
1714626362594,EDS 281,A00,507345,Daly; Alan J.,18,0,18,0
1714626363621,EDS 284,A00,507350,Daly; Alan J.,16,0,16,0
1714626364649,EDS 286,A00,507359,Fine; Sarah,18,0,18,0
1714626365678,EDS 289C,A01,507361,Daly; Alan J.,18,0,18,0
1714626366708,EDS 290,A00,507366,Hofstetter; Carolyn,15,0,15,0
1714626367736,LIGM 5A,A00,507421,Fischer-Grunski; Eva K,18,0,20,2
1714626368761,LIGM 5B,A00,507423,Fischer-Grunski; Eva K,19,0,20,1
1714626369787,LIGM 5C,A00,507425,Fischer-Grunski; Eva K,19,0,20,1
1714626370817,LIIT 5AS,A00,507427,Carnelos; Chiara,20,0,20,0
1714626371844,LIIT 5BS,A00,507430,Carnelos; Chiara,20,0,20,0
1714626372868,LIIT 5CS,A00,507432,Carnelos; Chiara,20,0,20,0
1714626373896,LISP 5A,A00,507541,Munoz Sanchez; Alicia,11,0,20,9
1714626374921,LISP 5B,A00,507671,Munoz Sanchez; Alicia,8,0,20,12
1714626375949,LISP 5C,A00,507696,Munoz Sanchez; Alicia,9,0,20,11
1714626376977,MAE 197,001,528363,Boechler; Nicholas Sebastia,9998,0,9999,1
1714626378008,MATH 197,001,523477,Kedlaya; Kiran S.,9995,0,9999,4
1714626378008,MATH 197,002,563811,Zhang; Danna,9995,0,9999,4
1714626378008,MATH 197,003,628552,Dumitriu; Ioana,9998,0,9999,1
1714626379033,MCWP 40R,A00,518780,Staff,2,0,20,18
1714626379033,MCWP 40R,B00,518781,Staff,8,0,20,12
1714626379033,MCWP 40R,C00,518783,Staff,6,0,20,14
1714626380059,MCWP 50R,A00,518791,Staff,0,0,20,20
1714626380059,MCWP 50R,B00,518792,Staff,0,2,20,20
1714626380059,MCWP 50R,C00,518793,Staff,0,2,20,20
1714626380059,MCWP 50R,D00,518794,Staff,0,0,20,20
1714626380059,MCWP 50R,E00,518795,Staff,0,2,20,20
1714626380059,MCWP 50R,F00,518796,Staff,0,0,20,20
1714626380059,MCWP 50R,G00,518797,Staff,0,1,20,20
1714626381083,MMW 12R,A01,514034,Herbst; Matthew,0,0,16,16
1714626381083,MMW 12R,A02,514035,Herbst; Matthew,1,0,16,15
1714626382112,MMW 13R,A01,514037,Staff,0,4,16,16
1714626382112,MMW 13R,A02,514039,Staff,0,2,16,16
1714626382112,MMW 13R,A03,628519,Staff,0,2,16,16
1714626384167,SIO 295LS,A00,523233,Staff,10,0,30,20
1714626385191,SIO 295S,A00,523232,Staff,10,0,30,20
1714626386222,SIOC 290S,A01,637330,Merrifield; Mark A,23,0,30,7
1714626387250,SIOC 291S,A01,637333,Gabriel; Corey John,23,0,30,7
1714626388277,SOCI 117,A01,494376,Staff,0,4,5,5
1714626389305,WES 237B,A00,494380,Staff,9,0,20,11
1714626391376,AESE 279B,A00,494370,Wade; Jon P,0,0,33,33
1714626392405,AIP 197,001,627712,Vespa; Emanuel Ignacio,9998,0,9999,1
1714626393431,ANAR 135S,A00,494369,Braswell; Geoffrey E.,0,0,0,0
1714626394461,BENG 196,001,628496,Engler; Adam J.,9998,0,9999,1
1714626395486,CAT 124RS,A01,519847,Geibel; William,0,0,20,20
1714626396515,CAT 125RS,A01,515971,Geibel; William,0,0,20,20
1714626397539,CLRE 250,A00,511389,Morris; Sheldon,9993,0,9999,6
1714626398573,CLRE 251,A00,507176,Mehta; Ravindra L.,9993,0,9999,6
1714626398573,CLRE 251,B00,511410,Mehta; Ravindra L.,9998,0,9999,1
1714626399599,CLRE 252,A00,507189,Cuomo; Raphael Eduardo,9995,0,9999,4
1714626400625,CLRE 253,A00,507199,Vaida; Florin,9994,0,9999,5
1714626400625,CLRE 253,B00,507202,Vaida; Florin,9999,0,9999,0
1714626401650,CLRE 259,A00,507211,Patel; Hemal,9996,0,9999,3
1714626402746,CLRE 260,A00,507221,Cuomo; Raphael Eduardo,9999,0,9999,0
1714626403772,CLRE 297,001,507242,Cuomo; Raphael Eduardo,9999,0,9999,0
1714626404800,COGS 197,001,638244,Voytek; Bradley Thomas,9998,0,9999,1
1714626405825,CSE 191,A00,516875,Minnes Kemp; Mor Mia,9992,0,9999,7
1714626406851,CSE 197,001,637388,Minnes Kemp; Mor Mia,9998,0,9999,1
1714626407880,CSS 201S,A01,494383,Staff,35,0,35,0
1714626408909,CSS 202S,A01,494387,Staff,35,0,35,0
1714626409933,DSC 197,001,628532,Eldridge; Justin Matthew,9996,0,9999,3
1714626410957,EAP 100,A00,516065,Staff,9797,0,9999,202
1714626411984,ECE 45,A01,507414,Staff,33,0,60,27
1714626414038,ECE 111,A01,507420,Staff,15,0,50,35
1714626415063,ECE 197,001,548057,Sievenpiper; Daniel F.,9993,0,9999,6
1714626416090,EDS 115,A00,507243,Choi; Bailey Miyeon,10,0,28,18
1714626417120,EDS 117,A01,494379,Staff,1,5,30,29
1714626418144,EDS 125,A00,507246,Hopkins; Megan Beth,9,0,30,21
1714626419171,EDS 128A,A01,507264,Fargason; Sharon Gayle,8,0,26,18
1714626420220,EDS 128B,A01,507293,Pappas; Elizabeth,12,0,30,18
1714626421246,EDS 139,A00,507294,Fargason; Sharon Gayle,13,0,30,17
1714626421246,EDS 139,B00,507313,Pappas; Elizabeth,13,0,30,17
1714626422275,EDS 201,A00,507315,Staff,13,0,30,17
1714626423308,EDS 203,A01,507317,Halter; Christopher P.,12,0,30,18
1714626424333,EDS 204R,A01,507319,Halter; Christopher P.,0,3,30,30
1714626424333,EDS 204R,B01,507331,Heinzman; Erica M.,16,0,30,14
1714626425359,EDS 206R,A00,507332,Staff,0,4,30,30
1714626425359,EDS 206R,B00,507343,Staff,17,0,30,13
1714626426386,EDS 250,A00,507344,Hemans; Patricia Ann Benitez,22,0,40,18
1714626427413,EDS 281,A00,507345,Daly; Alan J.,18,0,18,0
1714626428439,EDS 284,A00,507350,Daly; Alan J.,16,0,16,0
1714626429464,EDS 286,A00,507359,Fine; Sarah,18,0,18,0
1714626430493,EDS 289C,A01,507361,Daly; Alan J.,18,0,18,0
1714626431519,EDS 290,A00,507366,Hofstetter; Carolyn,15,0,15,0
1714626432549,LIGM 5A,A00,507421,Fischer-Grunski; Eva K,18,0,20,2
1714626433576,LIGM 5B,A00,507423,Fischer-Grunski; Eva K,19,0,20,1
1714626434606,LIGM 5C,A00,507425,Fischer-Grunski; Eva K,19,0,20,1
1714626435636,LIIT 5AS,A00,507427,Carnelos; Chiara,20,0,20,0
1714626436661,LIIT 5BS,A00,507430,Carnelos; Chiara,20,0,20,0
1714626437691,LIIT 5CS,A00,507432,Carnelos; Chiara,20,0,20,0
1714626438716,LISP 5A,A00,507541,Munoz Sanchez; Alicia,11,0,20,9
1714626439742,LISP 5B,A00,507671,Munoz Sanchez; Alicia,8,0,20,12
1714626440767,LISP 5C,A00,507696,Munoz Sanchez; Alicia,9,0,20,11
1714626441796,MAE 197,001,528363,Boechler; Nicholas Sebastia,9998,0,9999,1
1714626442826,MATH 197,001,523477,Kedlaya; Kiran S.,9995,0,9999,4
1714626442826,MATH 197,002,563811,Zhang; Danna,9995,0,9999,4
1714626442826,MATH 197,003,628552,Dumitriu; Ioana,9998,0,9999,1
1714626443850,MCWP 40R,A00,518780,Staff,2,0,20,18
1714626443850,MCWP 40R,B00,518781,Staff,8,0,20,12
1714626443850,MCWP 40R,C00,518783,Staff,6,0,20,14
1714626444876,MCWP 50R,A00,518791,Staff,0,0,20,20
1714626444876,MCWP 50R,B00,518792,Staff,0,2,20,20
1714626444876,MCWP 50R,C00,518793,Staff,0,2,20,20
1714626444876,MCWP 50R,D00,518794,Staff,0,0,20,20
1714626444876,MCWP 50R,E00,518795,Staff,0,2,20,20
1714626444876,MCWP 50R,F00,518796,Staff,0,0,20,20
1714626444876,MCWP 50R,G00,518797,Staff,0,1,20,20
1714626445902,MMW 12R,A01,514034,Herbst; Matthew,0,0,16,16
1714626445902,MMW 12R,A02,514035,Herbst; Matthew,1,0,16,15
1714626446926,MMW 13R,A01,514037,Staff,0,4,16,16
1714626446926,MMW 13R,A02,514039,Staff,0,2,16,16
1714626446926,MMW 13R,A03,628519,Staff,0,2,16,16
1714626448983,SIO 295LS,A00,523233,Staff,10,0,30,20
1714626450008,SIO 295S,A00,523232,Staff,10,0,30,20
1714626451033,SIOC 290S,A01,637330,Merrifield; Mark A,23,0,30,7
1714626452064,SIOC 291S,A01,637333,Gabriel; Corey John,23,0,30,7
1714626453090,SOCI 117,A01,494376,Staff,0,4,5,5
1714626454117,WES 237B,A00,494380,Staff,9,0,20,11
1714626456194,AESE 279B,A00,494370,Wade; Jon P,0,0,33,33
1714626457218,AIP 197,001,627712,Vespa; Emanuel Ignacio,9998,0,9999,1
1714626458266,ANAR 135S,A00,494369,Braswell; Geoffrey E.,0,0,0,0
1714626459291,BENG 196,001,628496,Engler; Adam J.,9998,0,9999,1
1714626460317,CAT 124RS,A01,519847,Geibel; William,0,0,20,20
1714626461342,CAT 125RS,A01,515971,Geibel; William,0,0,20,20
1714626462371,CLRE 250,A00,511389,Morris; Sheldon,9993,0,9999,6
1714626463402,CLRE 251,A00,507176,Mehta; Ravindra L.,9993,0,9999,6
1714626463402,CLRE 251,B00,511410,Mehta; Ravindra L.,9998,0,9999,1
1714626464426,CLRE 252,A00,507189,Cuomo; Raphael Eduardo,9995,0,9999,4
1714626465450,CLRE 253,A00,507199,Vaida; Florin,9994,0,9999,5
1714626465450,CLRE 253,B00,507202,Vaida; Florin,9999,0,9999,0
1714626466478,CLRE 259,A00,507211,Patel; Hemal,9996,0,9999,3
1714626467501,CLRE 260,A00,507221,Cuomo; Raphael Eduardo,9999,0,9999,0
1714626468527,CLRE 297,001,507242,Cuomo; Raphael Eduardo,9999,0,9999,0
1714626469552,COGS 197,001,638244,Voytek; Bradley Thomas,9998,0,9999,1
1714626470577,CSE 191,A00,516875,Minnes Kemp; Mor Mia,9992,0,9999,7
1714626471600,CSE 197,001,637388,Minnes Kemp; Mor Mia,9998,0,9999,1
1714626472625,CSS 201S,A01,494383,Staff,35,0,35,0
1714626473652,CSS 202S,A01,494387,Staff,35,0,35,0
1714626474678,DSC 197,001,628532,Eldridge; Justin Matthew,9996,0,9999,3
1714626475701,EAP 100,A00,516065,Staff,9797,0,9999,202
1714626476732,ECE 45,A01,507414,Staff,33,0,60,27
1714626478787,ECE 111,A01,507420,Staff,15,0,50,35
1714626479817,ECE 197,001,548057,Sievenpiper; Daniel F.,9993,0,9999,6
1714626480848,EDS 115,A00,507243,Choi; Bailey Miyeon,10,0,28,18
1714626481871,EDS 117,A01,494379,Staff,1,5,30,29
1714626482903,EDS 125,A00,507246,Hopkins; Megan Beth,9,0,30,21
1714626483928,EDS 128A,A01,507264,Fargason; Sharon Gayle,8,0,26,18
1714626484979,EDS 128B,A01,507293,Pappas; Elizabeth,12,0,30,18
1714626486005,EDS 139,A00,507294,Fargason; Sharon Gayle,13,0,30,17
1714626486005,EDS 139,B00,507313,Pappas; Elizabeth,13,0,30,17
1714626487030,EDS 201,A00,507315,Staff,13,0,30,17
1714626488057,EDS 203,A01,507317,Halter; Christopher P.,12,0,30,18
1714626489083,EDS 204R,A01,507319,Halter; Christopher P.,0,3,30,30
1714626489083,EDS 204R,B01,507331,Heinzman; Erica M.,16,0,30,14
1714626490110,EDS 206R,A00,507332,Staff,0,4,30,30
1714626490110,EDS 206R,B00,507343,Staff,17,0,30,13
1714626491137,EDS 250,A00,507344,Hemans; Patricia Ann Benitez,22,0,40,18
1714626492165,EDS 281,A00,507345,Daly; Alan J.,18,0,18,0
1714626493190,EDS 284,A00,507350,Daly; Alan J.,16,0,16,0
1714626494276,EDS 286,A00,507359,Fine; Sarah,18,0,18,0
1714626495300,EDS 289C,A01,507361,Daly; Alan J.,18,0,18,0
1714626496325,EDS 290,A00,507366,Hofstetter; Carolyn,15,0,15,0
1714626497356,LIGM 5A,A00,507421,Fischer-Grunski; Eva K,18,0,20,2
1714626498385,LIGM 5B,A00,507423,Fischer-Grunski; Eva K,19,0,20,1
1714626499414,LIGM 5C,A00,507425,Fischer-Grunski; Eva K,19,0,20,1
1714626500440,LIIT 5AS,A00,507427,Carnelos; Chiara,20,0,20,0
1714626501466,LIIT 5BS,A00,507430,Carnelos; Chiara,20,0,20,0
1714626502491,LIIT 5CS,A00,507432,Carnelos; Chiara,20,0,20,0
1714626503518,LISP 5A,A00,507541,Munoz Sanchez; Alicia,11,0,20,9
1714626504547,LISP 5B,A00,507671,Munoz Sanchez; Alicia,8,0,20,12
1714626505575,LISP 5C,A00,507696,Munoz Sanchez; Alicia,9,0,20,11
1714626506602,MAE 197,001,528363,Boechler; Nicholas Sebastia,9998,0,9999,1
1714626507629,MATH 197,001,523477,Kedlaya; Kiran S.,9995,0,9999,4
1714626507629,MATH 197,002,563811,Zhang; Danna,9995,0,9999,4
1714626507629,MATH 197,003,628552,Dumitriu; Ioana,9998,0,9999,1
1714626508654,MCWP 40R,A00,518780,Staff,2,0,20,18
1714626508654,MCWP 40R,B00,518781,Staff,8,0,20,12
1714626508654,MCWP 40R,C00,518783,Staff,6,0,20,14
1714626509683,MCWP 50R,A00,518791,Staff,0,0,20,20
1714626509683,MCWP 50R,B00,518792,Staff,0,2,20,20
1714626509683,MCWP 50R,C00,518793,Staff,0,2,20,20
1714626509683,MCWP 50R,D00,518794,Staff,0,0,20,20
1714626509683,MCWP 50R,E00,518795,Staff,0,2,20,20
1714626509683,MCWP 50R,F00,518796,Staff,0,0,20,20
1714626509683,MCWP 50R,G00,518797,Staff,0,1,20,20
1714626510709,MMW 12R,A01,514034,Herbst; Matthew,0,0,16,16
1714626510709,MMW 12R,A02,514035,Herbst; Matthew,1,0,16,15
1714626511734,MMW 13R,A01,514037,Staff,0,4,16,16
1714626511734,MMW 13R,A02,514039,Staff,0,2,16,16
1714626511734,MMW 13R,A03,628519,Staff,0,2,16,16
1714626513788,SIO 295LS,A00,523233,Staff,10,0,30,20
1714626514813,SIO 295S,A00,523232,Staff,10,0,30,20
1714626515839,SIOC 290S,A01,637330,Merrifield; Mark A,23,0,30,7
1714626516864,SIOC 291S,A01,637333,Gabriel; Corey John,23,0,30,7
1714626517889,SOCI 117,A01,494376,Staff,0,4,5,5
1714626518913,WES 237B,A00,494380,Staff,9,0,20,11
1714626520983,AESE 279B,A00,494370,Wade; Jon P,0,0,33,33
1714626522008,AIP 197,001,627712,Vespa; Emanuel Ignacio,9998,0,9999,1
1714626523034,ANAR 135S,A00,494369,Braswell; Geoffrey E.,0,0,0,0
1714626524061,BENG 196,001,628496,Engler; Adam J.,9998,0,9999,1
1714626525085,CAT 124RS,A01,519847,Geibel; William,0,0,20,20
1714626526109,CAT 125RS,A01,515971,Geibel; William,0,0,20,20
1714626527133,CLRE 250,A00,511389,Morris; Sheldon,9993,0,9999,6
1714626528160,CLRE 251,A00,507176,Mehta; Ravindra L.,9993,0,9999,6
1714626528160,CLRE 251,B00,511410,Mehta; Ravindra L.,9998,0,9999,1
1714626529186,CLRE 252,A00,507189,Cuomo; Raphael Eduardo,9995,0,9999,4
1714626530214,CLRE 253,A00,507199,Vaida; Florin,9994,0,9999,5
1714626530214,CLRE 253,B00,507202,Vaida; Florin,9999,0,9999,0
1714626531243,CLRE 259,A00,507211,Patel; Hemal,9996,0,9999,3
1714626532270,CLRE 260,A00,507221,Cuomo; Raphael Eduardo,9999,0,9999,0
1714626533294,CLRE 297,001,507242,Cuomo; Raphael Eduardo,9999,0,9999,0
1714626534320,COGS 197,001,638244,Voytek; Bradley Thomas,9998,0,9999,1
1714626535349,CSE 191,A00,516875,Minnes Kemp; Mor Mia,9992,0,9999,7
1714626536373,CSE 197,001,637388,Minnes Kemp; Mor Mia,9998,0,9999,1
1714626537400,CSS 201S,A01,494383,Staff,35,0,35,0
1714626538424,CSS 202S,A01,494387,Staff,35,0,35,0
1714626539449,DSC 197,001,628532,Eldridge; Justin Matthew,9996,0,9999,3
1714626540473,EAP 100,A00,516065,Staff,9797,0,9999,202
1714626541500,ECE 45,A01,507414,Staff,33,0,60,27
1714626543549,ECE 111,A01,507420,Staff,15,0,50,35
1714626544574,ECE 197,001,548057,Sievenpiper; Daniel F.,9993,0,9999,6
1714626545603,EDS 115,A00,507243,Choi; Bailey Miyeon,10,0,28,18
1714626546629,EDS 117,A01,494379,Staff,1,5,30,29
1714626547655,EDS 125,A00,507246,Hopkins; Megan Beth,9,0,30,21
1714626548684,EDS 128A,A01,507264,Fargason; Sharon Gayle,8,0,26,18
1714626549714,EDS 128B,A01,507293,Pappas; Elizabeth,12,0,30,18
1714626550740,EDS 139,A00,507294,Fargason; Sharon Gayle,13,0,30,17
1714626550740,EDS 139,B00,507313,Pappas; Elizabeth,13,0,30,17
1714626551765,EDS 201,A00,507315,Staff,13,0,30,17
1714626552791,EDS 203,A01,507317,Halter; Christopher P.,12,0,30,18
1714626553817,EDS 204R,A01,507319,Halter; Christopher P.,0,3,30,30
1714626553817,EDS 204R,B01,507331,Heinzman; Erica M.,16,0,30,14
1714626554846,EDS 206R,A00,507332,Staff,0,4,30,30
1714626554846,EDS 206R,B00,507343,Staff,17,0,30,13
1714626555871,EDS 250,A00,507344,Hemans; Patricia Ann Benitez,22,0,40,18
1714626556898,EDS 281,A00,507345,Daly; Alan J.,18,0,18,0
1714626557921,EDS 284,A00,507350,Daly; Alan J.,16,0,16,0
1714626558946,EDS 286,A00,507359,Fine; Sarah,18,0,18,0
1714626559972,EDS 289C,A01,507361,Daly; Alan J.,18,0,18,0
1714626561000,EDS 290,A00,507366,Hofstetter; Carolyn,15,0,15,0
1714626562025,LIGM 5A,A00,507421,Fischer-Grunski; Eva K,18,0,20,2
1714626563051,LIGM 5B,A00,507423,Fischer-Grunski; Eva K,19,0,20,1
1714626564076,LIGM 5C,A00,507425,Fischer-Grunski; Eva K,19,0,20,1
1714626565105,LIIT 5AS,A00,507427,Carnelos; Chiara,20,0,20,0
1714626566130,LIIT 5BS,A00,507430,Carnelos; Chiara,20,0,20,0
1714626567156,LIIT 5CS,A00,507432,Carnelos; Chiara,20,0,20,0
1714626568185,LISP 5A,A00,507541,Munoz Sanchez; Alicia,11,0,20,9
1714626569209,LISP 5B,A00,507671,Munoz Sanchez; Alicia,8,0,20,12
1714626570235,LISP 5C,A00,507696,Munoz Sanchez; Alicia,9,0,20,11
1714626571263,MAE 197,001,528363,Boechler; Nicholas Sebastia,9998,0,9999,1
1714626572296,MATH 197,001,523477,Kedlaya; Kiran S.,9995,0,9999,4
1714626572296,MATH 197,002,563811,Zhang; Danna,9995,0,9999,4
1714626572296,MATH 197,003,628552,Dumitriu; Ioana,9998,0,9999,1
1714626573321,MCWP 40R,A00,518780,Staff,2,0,20,18
1714626573321,MCWP 40R,B00,518781,Staff,8,0,20,12
1714626573321,MCWP 40R,C00,518783,Staff,6,0,20,14
1714626574349,MCWP 50R,A00,518791,Staff,0,0,20,20
1714626574349,MCWP 50R,B00,518792,Staff,0,2,20,20
1714626574349,MCWP 50R,C00,518793,Staff,0,2,20,20
1714626574349,MCWP 50R,D00,518794,Staff,0,0,20,20
1714626574349,MCWP 50R,E00,518795,Staff,0,2,20,20
1714626574349,MCWP 50R,F00,518796,Staff,0,0,20,20
1714626574349,MCWP 50R,G00,518797,Staff,0,1,20,20
1714626575377,MMW 12R,A01,514034,Herbst; Matthew,0,0,16,16
1714626575377,MMW 12R,A02,514035,Herbst; Matthew,1,0,16,15
1714626576404,MMW 13R,A01,514037,Staff,0,4,16,16
1714626576404,MMW 13R,A02,514039,Staff,0,2,16,16
1714626576404,MMW 13R,A03,628519,Staff,0,2,16,16
1714626578452,SIO 295LS,A00,523233,Staff,10,0,30,20
1714626579480,SIO 295S,A00,523232,Staff,10,0,30,20
1714626580505,SIOC 290S,A01,637330,Merrifield; Mark A,23,0,30,7
1714626581532,SIOC 291S,A01,637333,Gabriel; Corey John,23,0,30,7
1714626582562,SOCI 117,A01,494376,Staff,0,4,5,5
1714626583588,WES 237B,A00,494380,Staff,9,0,20,11
1714626585660,AESE 279B,A00,494370,Wade; Jon P,0,0,33,33
1714626586685,AIP 197,001,627712,Vespa; Emanuel Ignacio,9998,0,9999,1
1714626587714,ANAR 135S,A00,494369,Braswell; Geoffrey E.,0,0,0,0
1714626588744,BENG 196,001,628496,Engler; Adam J.,9998,0,9999,1
1714626589773,CAT 124RS,A01,519847,Geibel; William,0,0,20,20
1714626590800,CAT 125RS,A01,515971,Geibel; William,0,0,20,20
1714626591827,CLRE 250,A00,511389,Morris; Sheldon,9993,0,9999,6
1714626592855,CLRE 251,A00,507176,Mehta; Ravindra L.,9993,0,9999,6
1714626592855,CLRE 251,B00,511410,Mehta; Ravindra L.,9998,0,9999,1
1714626593880,CLRE 252,A00,507189,Cuomo; Raphael Eduardo,9995,0,9999,4
1714626594914,CLRE 253,A00,507199,Vaida; Florin,9994,0,9999,5
1714626594914,CLRE 253,B00,507202,Vaida; Florin,9999,0,9999,0
1714626595938,CLRE 259,A00,507211,Patel; Hemal,9996,0,9999,3
1714626596964,CLRE 260,A00,507221,Cuomo; Raphael Eduardo,9999,0,9999,0
1714626597989,CLRE 297,001,507242,Cuomo; Raphael Eduardo,9999,0,9999,0
1714626599016,COGS 197,001,638244,Voytek; Bradley Thomas,9998,0,9999,1
1714626600040,CSE 191,A00,516875,Minnes Kemp; Mor Mia,9992,0,9999,7
1714626601069,CSE 197,001,637388,Minnes Kemp; Mor Mia,9998,0,9999,1
1714626602098,CSS 201S,A01,494383,Staff,35,0,35,0
1714626603123,CSS 202S,A01,494387,Staff,35,0,35,0
1714626604149,DSC 197,001,628532,Eldridge; Justin Matthew,9996,0,9999,3
1714626605174,EAP 100,A00,516065,Staff,9797,0,9999,202
1714626606204,ECE 45,A01,507414,Staff,33,0,60,27
1714626608255,ECE 111,A01,507420,Staff,15,0,50,35
1714626609282,ECE 197,001,548057,Sievenpiper; Daniel F.,9993,0,9999,6
1714626610314,EDS 115,A00,507243,Choi; Bailey Miyeon,10,0,28,18
1714626611339,EDS 117,A01,494379,Staff,1,5,30,29
1714626612368,EDS 125,A00,507246,Hopkins; Megan Beth,9,0,30,21
1714626613396,EDS 128A,A01,507264,Fargason; Sharon Gayle,8,0,26,18
1714626614425,EDS 128B,A01,507293,Pappas; Elizabeth,12,0,30,18
1714626615452,EDS 139,A00,507294,Fargason; Sharon Gayle,13,0,30,17
1714626615452,EDS 139,B00,507313,Pappas; Elizabeth,13,0,30,17
1714626616476,EDS 201,A00,507315,Staff,13,0,30,17
1714626617506,EDS 203,A01,507317,Halter; Christopher P.,12,0,30,18
1714626618536,EDS 204R,A01,507319,Halter; Christopher P.,0,3,30,30
1714626618536,EDS 204R,B01,507331,Heinzman; Erica M.,16,0,30,14
1714626619562,EDS 206R,A00,507332,Staff,0,4,30,30
1714626619562,EDS 206R,B00,507343,Staff,17,0,30,13
1714626620589,EDS 250,A00,507344,Hemans; Patricia Ann Benitez,22,0,40,18
1714626621618,EDS 281,A00,507345,Daly; Alan J.,18,0,18,0
1714626622643,EDS 284,A00,507350,Daly; Alan J.,16,0,16,0
1714626623667,EDS 286,A00,507359,Fine; Sarah,18,0,18,0
1714626624691,EDS 289C,A01,507361,Daly; Alan J.,18,0,18,0
1714626625717,EDS 290,A00,507366,Hofstetter; Carolyn,15,0,15,0
1714626626743,LIGM 5A,A00,507421,Fischer-Grunski; Eva K,18,0,20,2
1714626627771,LIGM 5B,A00,507423,Fischer-Grunski; Eva K,19,0,20,1
1714626628795,LIGM 5C,A00,507425,Fischer-Grunski; Eva K,19,0,20,1
1714626629824,LIIT 5AS,A00,507427,Carnelos; Chiara,20,0,20,0
1714626630850,LIIT 5BS,A00,507430,Carnelos; Chiara,20,0,20,0
1714626631876,LIIT 5CS,A00,507432,Carnelos; Chiara,20,0,20,0
1714626632901,LISP 5A,A00,507541,Munoz Sanchez; Alicia,11,0,20,9
1714626633930,LISP 5B,A00,507671,Munoz Sanchez; Alicia,8,0,20,12
1714626634955,LISP 5C,A00,507696,Munoz Sanchez; Alicia,9,0,20,11
1714626635985,MAE 197,001,528363,Boechler; Nicholas Sebastia,9998,0,9999,1
1714626637011,MATH 197,001,523477,Kedlaya; Kiran S.,9995,0,9999,4
1714626637011,MATH 197,002,563811,Zhang; Danna,9995,0,9999,4
1714626637011,MATH 197,003,628552,Dumitriu; Ioana,9998,0,9999,1
1714626638036,MCWP 40R,A00,518780,Staff,2,0,20,18
1714626638036,MCWP 40R,B00,518781,Staff,8,0,20,12
1714626638036,MCWP 40R,C00,518783,Staff,6,0,20,14
1714626639063,MCWP 50R,A00,518791,Staff,0,0,20,20
1714626639063,MCWP 50R,B00,518792,Staff,0,2,20,20
1714626639063,MCWP 50R,C00,518793,Staff,0,2,20,20
1714626639063,MCWP 50R,D00,518794,Staff,0,0,20,20
1714626639063,MCWP 50R,E00,518795,Staff,0,2,20,20
1714626639063,MCWP 50R,F00,518796,Staff,0,0,20,20
1714626639063,MCWP 50R,G00,518797,Staff,0,1,20,20
1714626640089,MMW 12R,A01,514034,Herbst; Matthew,0,0,16,16
1714626640089,MMW 12R,A02,514035,Herbst; Matthew,1,0,16,15
1714626641113,MMW 13R,A01,514037,Staff,0,4,16,16
1714626641113,MMW 13R,A02,514039,Staff,0,2,16,16
1714626641113,MMW 13R,A03,628519,Staff,0,2,16,16
1714626643167,SIO 295LS,A00,523233,Staff,10,0,30,20
1714626644194,SIO 295S,A00,523232,Staff,10,0,30,20
1714626645220,SIOC 290S,A01,637330,Merrifield; Mark A,23,0,30,7
1714626646246,SIOC 291S,A01,637333,Gabriel; Corey John,23,0,30,7
1714626647270,SOCI 117,A01,494376,Staff,0,4,5,5
1714626648295,WES 237B,A00,494380,Staff,9,0,20,11
1714626650377,AESE 279B,A00,494370,Wade; Jon P,0,0,33,33
1714626651403,AIP 197,001,627712,Vespa; Emanuel Ignacio,9998,0,9999,1
1714626652429,ANAR 135S,A00,494369,Braswell; Geoffrey E.,0,0,0,0
1714626653458,BENG 196,001,628496,Engler; Adam J.,9998,0,9999,1
1714626654484,CAT 124RS,A01,519847,Geibel; William,0,0,20,20
1714626655513,CAT 125RS,A01,515971,Geibel; William,0,0,20,20
1714626656538,CLRE 250,A00,511389,Morris; Sheldon,9993,0,9999,6
1714626657566,CLRE 251,A00,507176,Mehta; Ravindra L.,9993,0,9999,6
1714626657566,CLRE 251,B00,511410,Mehta; Ravindra L.,9998,0,9999,1
1714626658594,CLRE 252,A00,507189,Cuomo; Raphael Eduardo,9995,0,9999,4
1714626659619,CLRE 253,A00,507199,Vaida; Florin,9994,0,9999,5
1714626659619,CLRE 253,B00,507202,Vaida; Florin,9999,0,9999,0
1714626660648,CLRE 259,A00,507211,Patel; Hemal,9996,0,9999,3
1714626661674,CLRE 260,A00,507221,Cuomo; Raphael Eduardo,9999,0,9999,0
1714626662699,CLRE 297,001,507242,Cuomo; Raphael Eduardo,9999,0,9999,0
1714626663727,COGS 197,001,638244,Voytek; Bradley Thomas,9998,0,9999,1
1714626664756,CSE 191,A00,516875,Minnes Kemp; Mor Mia,9992,0,9999,7
1714626665785,CSE 197,001,637388,Minnes Kemp; Mor Mia,9998,0,9999,1
1714626666813,CSS 201S,A01,494383,Staff,35,0,35,0
1714626667837,CSS 202S,A01,494387,Staff,35,0,35,0
1714626668861,DSC 197,001,628532,Eldridge; Justin Matthew,9996,0,9999,3
1714626669890,EAP 100,A00,516065,Staff,9797,0,9999,202
1714626670915,ECE 45,A01,507414,Staff,33,0,60,27
1714626673016,ECE 111,A01,507420,Staff,15,0,50,35
1714626674042,ECE 197,001,548057,Sievenpiper; Daniel F.,9993,0,9999,6
1714626675068,EDS 115,A00,507243,Choi; Bailey Miyeon,10,0,28,18
1714626676095,EDS 117,A01,494379,Staff,1,5,30,29
1714626677119,EDS 125,A00,507246,Hopkins; Megan Beth,9,0,30,21
1714626678145,EDS 128A,A01,507264,Fargason; Sharon Gayle,8,0,26,18
1714626679225,EDS 128B,A01,507293,Pappas; Elizabeth,12,0,30,18
1714626680255,EDS 139,A00,507294,Fargason; Sharon Gayle,13,0,30,17
1714626680255,EDS 139,B00,507313,Pappas; Elizabeth,13,0,30,17
1714626681281,EDS 201,A00,507315,Staff,13,0,30,17
1714626682314,EDS 203,A01,507317,Halter; Christopher P.,12,0,30,18
1714626683343,EDS 204R,A01,507319,Halter; Christopher P.,0,3,30,30
1714626683343,EDS 204R,B01,507331,Heinzman; Erica M.,16,0,30,14
1714626684371,EDS 206R,A00,507332,Staff,0,4,30,30
1714626684371,EDS 206R,B00,507343,Staff,17,0,30,13
1714626685399,EDS 250,A00,507344,Hemans; Patricia Ann Benitez,22,0,40,18
1714626686424,EDS 281,A00,507345,Daly; Alan J.,18,0,18,0
1714626687451,EDS 284,A00,507350,Daly; Alan J.,16,0,16,0
1714626688476,EDS 286,A00,507359,Fine; Sarah,18,0,18,0
1714626689499,EDS 289C,A01,507361,Daly; Alan J.,18,0,18,0
1714626690528,EDS 290,A00,507366,Hofstetter; Carolyn,15,0,15,0
1714626691558,LIGM 5A,A00,507421,Fischer-Grunski; Eva K,18,0,20,2
1714626692586,LIGM 5B,A00,507423,Fischer-Grunski; Eva K,19,0,20,1
1714626693610,LIGM 5C,A00,507425,Fischer-Grunski; Eva K,19,0,20,1
1714626694640,LIIT 5AS,A00,507427,Carnelos; Chiara,20,0,20,0
1714626695665,LIIT 5BS,A00,507430,Carnelos; Chiara,20,0,20,0
1714626696691,LIIT 5CS,A00,507432,Carnelos; Chiara,20,0,20,0
1714626697718,LISP 5A,A00,507541,Munoz Sanchez; Alicia,11,0,20,9
1714626698748,LISP 5B,A00,507671,Munoz Sanchez; Alicia,8,0,20,12
1714626699774,LISP 5C,A00,507696,Munoz Sanchez; Alicia,9,0,20,11
1714626700802,MAE 197,001,528363,Boechler; Nicholas Sebastia,9998,0,9999,1
1714626701829,MATH 197,001,523477,Kedlaya; Kiran S.,9995,0,9999,4
1714626701829,MATH 197,002,563811,Zhang; Danna,9995,0,9999,4
1714626701829,MATH 197,003,628552,Dumitriu; Ioana,9998,0,9999,1
1714626702861,MCWP 40R,A00,518780,Staff,2,0,20,18
1714626702861,MCWP 40R,B00,518781,Staff,8,0,20,12
1714626702861,MCWP 40R,C00,518783,Staff,6,0,20,14
1714626703891,MCWP 50R,A00,518791,Staff,0,0,20,20
1714626703891,MCWP 50R,B00,518792,Staff,0,2,20,20
1714626703891,MCWP 50R,C00,518793,Staff,0,2,20,20
1714626703891,MCWP 50R,D00,518794,Staff,0,0,20,20
1714626703891,MCWP 50R,E00,518795,Staff,0,2,20,20
1714626703891,MCWP 50R,F00,518796,Staff,0,0,20,20
1714626703891,MCWP 50R,G00,518797,Staff,0,1,20,20
1714626704915,MMW 12R,A01,514034,Herbst; Matthew,0,0,16,16
1714626704915,MMW 12R,A02,514035,Herbst; Matthew,1,0,16,15
1714626705944,MMW 13R,A01,514037,Staff,0,4,16,16
1714626705944,MMW 13R,A02,514039,Staff,0,2,16,16
1714626705944,MMW 13R,A03,628519,Staff,0,2,16,16
1714626707995,SIO 295LS,A00,523233,Staff,10,0,30,20
1714626709020,SIO 295S,A00,523232,Staff,10,0,30,20
1714626710047,SIOC 290S,A01,637330,Merrifield; Mark A,23,0,30,7
1714626711073,SIOC 291S,A01,637333,Gabriel; Corey John,23,0,30,7
1714626712100,SOCI 117,A01,494376,Staff,0,4,5,5
1714626713127,WES 237B,A00,494380,Staff,9,0,20,11
1714626715196,AESE 279B,A00,494370,Wade; Jon P,0,0,33,33
1714626716221,AIP 197,001,627712,Vespa; Emanuel Ignacio,9998,0,9999,1
1714626717246,ANAR 135S,A00,494369,Braswell; Geoffrey E.,0,0,0,0
1714626718271,BENG 196,001,628496,Engler; Adam J.,9998,0,9999,1
1714626719296,CAT 124RS,A01,519847,Geibel; William,0,0,20,20
1714626720322,CAT 125RS,A01,515971,Geibel; William,0,0,20,20
1714626721349,CLRE 250,A00,511389,Morris; Sheldon,9993,0,9999,6
1714626722377,CLRE 251,A00,507176,Mehta; Ravindra L.,9993,0,9999,6
1714626722377,CLRE 251,B00,511410,Mehta; Ravindra L.,9998,0,9999,1
1714626723405,CLRE 252,A00,507189,Cuomo; Raphael Eduardo,9995,0,9999,4
1714626724430,CLRE 253,A00,507199,Vaida; Florin,9994,0,9999,5
1714626724430,CLRE 253,B00,507202,Vaida; Florin,9999,0,9999,0
1714626725459,CLRE 259,A00,507211,Patel; Hemal,9996,0,9999,3
1714626726483,CLRE 260,A00,507221,Cuomo; Raphael Eduardo,9999,0,9999,0
1714626727508,CLRE 297,001,507242,Cuomo; Raphael Eduardo,9999,0,9999,0
1714626728536,COGS 197,001,638244,Voytek; Bradley Thomas,9998,0,9999,1
1714626729564,CSE 191,A00,516875,Minnes Kemp; Mor Mia,9992,0,9999,7
1714626730593,CSE 197,001,637388,Minnes Kemp; Mor Mia,9998,0,9999,1
1714626731619,CSS 201S,A01,494383,Staff,35,0,35,0
1714626732642,CSS 202S,A01,494387,Staff,35,0,35,0
1714626733670,DSC 197,001,628532,Eldridge; Justin Matthew,9996,0,9999,3
1714626734694,EAP 100,A00,516065,Staff,9797,0,9999,202
1714626735720,ECE 45,A01,507414,Staff,33,0,60,27
1714626737777,ECE 111,A01,507420,Staff,15,0,50,35
1714626738805,ECE 197,001,548057,Sievenpiper; Daniel F.,9993,0,9999,6
1714626739833,EDS 115,A00,507243,Choi; Bailey Miyeon,10,0,28,18
1714626740862,EDS 117,A01,494379,Staff,1,5,30,29
1714626741889,EDS 125,A00,507246,Hopkins; Megan Beth,9,0,30,21
1714626742916,EDS 128A,A01,507264,Fargason; Sharon Gayle,8,0,26,18
1714626743941,EDS 128B,A01,507293,Pappas; Elizabeth,12,0,30,18
1714626744967,EDS 139,A00,507294,Fargason; Sharon Gayle,13,0,30,17
1714626744967,EDS 139,B00,507313,Pappas; Elizabeth,13,0,30,17
1714626745991,EDS 201,A00,507315,Staff,13,0,30,17
1714626747019,EDS 203,A01,507317,Halter; Christopher P.,12,0,30,18
1714626748044,EDS 204R,A01,507319,Halter; Christopher P.,0,3,30,30
1714626748044,EDS 204R,B01,507331,Heinzman; Erica M.,16,0,30,14
1714626749072,EDS 206R,A00,507332,Staff,0,4,30,30
1714626749072,EDS 206R,B00,507343,Staff,17,0,30,13
1714626750099,EDS 250,A00,507344,Hemans; Patricia Ann Benitez,22,0,40,18
1714626751125,EDS 281,A00,507345,Daly; Alan J.,18,0,18,0
1714626752152,EDS 284,A00,507350,Daly; Alan J.,16,0,16,0
1714626753180,EDS 286,A00,507359,Fine; Sarah,18,0,18,0
1714626754205,EDS 289C,A01,507361,Daly; Alan J.,18,0,18,0
1714626755231,EDS 290,A00,507366,Hofstetter; Carolyn,15,0,15,0
1714626756258,LIGM 5A,A00,507421,Fischer-Grunski; Eva K,18,0,20,2
1714626757283,LIGM 5B,A00,507423,Fischer-Grunski; Eva K,19,0,20,1
1714626758308,LIGM 5C,A00,507425,Fischer-Grunski; Eva K,19,0,20,1
1714626759339,LIIT 5AS,A00,507427,Carnelos; Chiara,20,0,20,0
1714626760365,LIIT 5BS,A00,507430,Carnelos; Chiara,20,0,20,0
1714626761391,LIIT 5CS,A00,507432,Carnelos; Chiara,20,0,20,0
1714626762416,LISP 5A,A00,507541,Munoz Sanchez; Alicia,11,0,20,9
1714626763445,LISP 5B,A00,507671,Munoz Sanchez; Alicia,8,0,20,12
1714626764471,LISP 5C,A00,507696,Munoz Sanchez; Alicia,9,0,20,11
1714626765497,MAE 197,001,528363,Boechler; Nicholas Sebastia,9998,0,9999,1
1714626766523,MATH 197,001,523477,Kedlaya; Kiran S.,9995,0,9999,4
1714626766523,MATH 197,002,563811,Zhang; Danna,9995,0,9999,4
1714626766523,MATH 197,003,628552,Dumitriu; Ioana,9998,0,9999,1
1714626767548,MCWP 40R,A00,518780,Staff,2,0,20,18
1714626767548,MCWP 40R,B00,518781,Staff,8,0,20,12
1714626767548,MCWP 40R,C00,518783,Staff,6,0,20,14
1714626768574,MCWP 50R,A00,518791,Staff,0,0,20,20
1714626768574,MCWP 50R,B00,518792,Staff,0,2,20,20
1714626768574,MCWP 50R,C00,518793,Staff,0,2,20,20
1714626768574,MCWP 50R,D00,518794,Staff,0,0,20,20
1714626768574,MCWP 50R,E00,518795,Staff,0,2,20,20
1714626768574,MCWP 50R,F00,518796,Staff,0,0,20,20
1714626768574,MCWP 50R,G00,518797,Staff,0,1,20,20
1714626769603,MMW 12R,A01,514034,Herbst; Matthew,0,0,16,16
1714626769603,MMW 12R,A02,514035,Herbst; Matthew,1,0,16,15
1714626770645,MMW 13R,A01,514037,Staff,0,4,16,16
1714626770645,MMW 13R,A02,514039,Staff,0,2,16,16
1714626770645,MMW 13R,A03,628519,Staff,0,2,16,16
1714626772697,SIO 295LS,A00,523233,Staff,10,0,30,20
1714626773723,SIO 295S,A00,523232,Staff,10,0,30,20
1714626774750,SIOC 290S,A01,637330,Merrifield; Mark A,23,0,30,7
1714626775774,SIOC 291S,A01,637333,Gabriel; Corey John,23,0,30,7
1714626776799,SOCI 117,A01,494376,Staff,0,4,5,5
1714626777825,WES 237B,A00,494380,Staff,9,0,20,11
1714626779905,AESE 279B,A00,494370,Wade; Jon P,0,0,33,33
1714626780933,AIP 197,001,627712,Vespa; Emanuel Ignacio,9998,0,9999,1
1714626781958,ANAR 135S,A00,494369,Braswell; Geoffrey E.,0,0,0,0
1714626782985,BENG 196,001,628496,Engler; Adam J.,9998,0,9999,1
1714626784012,CAT 124RS,A01,519847,Geibel; William,0,0,20,20
1714626785040,CAT 125RS,A01,515971,Geibel; William,0,0,20,20
1714626786065,CLRE 250,A00,511389,Morris; Sheldon,9993,0,9999,6
1714626787094,CLRE 251,A00,507176,Mehta; Ravindra L.,9993,0,9999,6
1714626787094,CLRE 251,B00,511410,Mehta; Ravindra L.,9998,0,9999,1
1714626788122,CLRE 252,A00,507189,Cuomo; Raphael Eduardo,9995,0,9999,4
1714626789147,CLRE 253,A00,507199,Vaida; Florin,9994,0,9999,5
1714626789147,CLRE 253,B00,507202,Vaida; Florin,9999,0,9999,0
1714626790172,CLRE 259,A00,507211,Patel; Hemal,9996,0,9999,3
1714626791196,CLRE 260,A00,507221,Cuomo; Raphael Eduardo,9999,0,9999,0
1714626792223,CLRE 297,001,507242,Cuomo; Raphael Eduardo,9999,0,9999,0
1714626793248,COGS 197,001,638244,Voytek; Bradley Thomas,9998,0,9999,1
1714626794274,CSE 191,A00,516875,Minnes Kemp; Mor Mia,9992,0,9999,7
1714626795301,CSE 197,001,637388,Minnes Kemp; Mor Mia,9998,0,9999,1
1714626796328,CSS 201S,A01,494383,Staff,35,0,35,0
1714626797355,CSS 202S,A01,494387,Staff,35,0,35,0
1714626798379,DSC 197,001,628532,Eldridge; Justin Matthew,9996,0,9999,3
1714626799407,EAP 100,A00,516065,Staff,9797,0,9999,202
1714626800432,ECE 45,A01,507414,Staff,33,0,60,27
1714626802482,ECE 111,A01,507420,Staff,15,0,50,35
1714626803510,ECE 197,001,548057,Sievenpiper; Daniel F.,9993,0,9999,6
1714626804534,EDS 115,A00,507243,Choi; Bailey Miyeon,10,0,28,18
1714626805560,EDS 117,A01,494379,Staff,1,5,30,29
1714626806585,EDS 125,A00,507246,Hopkins; Megan Beth,9,0,30,21
1714626807611,EDS 128A,A01,507264,Fargason; Sharon Gayle,8,0,26,18
1714626808636,EDS 128B,A01,507293,Pappas; Elizabeth,12,0,30,18
1714626809662,EDS 139,A00,507294,Fargason; Sharon Gayle,13,0,30,17
1714626809662,EDS 139,B00,507313,Pappas; Elizabeth,13,0,30,17
1714626810692,EDS 201,A00,507315,Staff,13,0,30,17
1714626811716,EDS 203,A01,507317,Halter; Christopher P.,12,0,30,18
1714626812742,EDS 204R,A01,507319,Halter; Christopher P.,0,3,30,30
1714626812742,EDS 204R,B01,507331,Heinzman; Erica M.,16,0,30,14
1714626813769,EDS 206R,A00,507332,Staff,0,4,30,30
1714626813769,EDS 206R,B00,507343,Staff,17,0,30,13
1714626814795,EDS 250,A00,507344,Hemans; Patricia Ann Benitez,22,0,40,18
1714626815821,EDS 281,A00,507345,Daly; Alan J.,18,0,18,0
1714626816847,EDS 284,A00,507350,Daly; Alan J.,16,0,16,0
1714626817872,EDS 286,A00,507359,Fine; Sarah,18,0,18,0
1714626818900,EDS 289C,A01,507361,Daly; Alan J.,18,0,18,0
1714626819925,EDS 290,A00,507366,Hofstetter; Carolyn,15,0,15,0
1714626820955,LIGM 5A,A00,507421,Fischer-Grunski; Eva K,18,0,20,2
1714626821981,LIGM 5B,A00,507423,Fischer-Grunski; Eva K,19,0,20,1
1714626823010,LIGM 5C,A00,507425,Fischer-Grunski; Eva K,19,0,20,1
1714626824037,LIIT 5AS,A00,507427,Carnelos; Chiara,20,0,20,0
1714626825062,LIIT 5BS,A00,507430,Carnelos; Chiara,20,0,20,0
1714626826086,LIIT 5CS,A00,507432,Carnelos; Chiara,20,0,20,0
1714626827116,LISP 5A,A00,507541,Munoz Sanchez; Alicia,11,0,20,9
1714626828144,LISP 5B,A00,507671,Munoz Sanchez; Alicia,8,0,20,12
1714626829172,LISP 5C,A00,507696,Munoz Sanchez; Alicia,9,0,20,11
1714626830202,MAE 197,001,528363,Boechler; Nicholas Sebastia,9998,0,9999,1
1714626831229,MATH 197,001,523477,Kedlaya; Kiran S.,9995,0,9999,4
1714626831229,MATH 197,002,563811,Zhang; Danna,9995,0,9999,4
1714626831229,MATH 197,003,628552,Dumitriu; Ioana,9998,0,9999,1
1714626832255,MCWP 40R,A00,518780,Staff,2,0,20,18
1714626832255,MCWP 40R,B00,518781,Staff,8,0,20,12
1714626832255,MCWP 40R,C00,518783,Staff,6,0,20,14
1714626833279,MCWP 50R,A00,518791,Staff,0,0,20,20
1714626833279,MCWP 50R,B00,518792,Staff,0,2,20,20
1714626833279,MCWP 50R,C00,518793,Staff,0,2,20,20
1714626833279,MCWP 50R,D00,518794,Staff,0,0,20,20
1714626833279,MCWP 50R,E00,518795,Staff,0,2,20,20
1714626833279,MCWP 50R,F00,518796,Staff,0,0,20,20
1714626833279,MCWP 50R,G00,518797,Staff,0,1,20,20
1714626834307,MMW 12R,A01,514034,Herbst; Matthew,0,0,16,16
1714626834307,MMW 12R,A02,514035,Herbst; Matthew,1,0,16,15
1714626835333,MMW 13R,A01,514037,Staff,0,4,16,16
1714626835333,MMW 13R,A02,514039,Staff,0,2,16,16
1714626835333,MMW 13R,A03,628519,Staff,0,2,16,16
1714626837382,SIO 295LS,A00,523233,Staff,10,0,30,20
1714626838410,SIO 295S,A00,523232,Staff,10,0,30,20
1714626839440,SIOC 290S,A01,637330,Merrifield; Mark A,23,0,30,7
1714626840470,SIOC 291S,A01,637333,Gabriel; Corey John,23,0,30,7
1714626841498,SOCI 117,A01,494376,Staff,0,4,5,5
1714626842527,WES 237B,A00,494380,Staff,9,0,20,11
1714626844599,AESE 279B,A00,494370,Wade; Jon P,0,0,33,33
1714626845627,AIP 197,001,627712,Vespa; Emanuel Ignacio,9998,0,9999,1
1714626846654,ANAR 135S,A00,494369,Braswell; Geoffrey E.,0,0,0,0
1714626847680,BENG 196,001,628496,Engler; Adam J.,9998,0,9999,1
1714626848707,CAT 124RS,A01,519847,Geibel; William,0,0,20,20
1714626849732,CAT 125RS,A01,515971,Geibel; William,0,0,20,20
1714626850762,CLRE 250,A00,511389,Morris; Sheldon,9993,0,9999,6
1714626851792,CLRE 251,A00,507176,Mehta; Ravindra L.,9993,0,9999,6
1714626851792,CLRE 251,B00,511410,Mehta; Ravindra L.,9998,0,9999,1
1714626852816,CLRE 252,A00,507189,Cuomo; Raphael Eduardo,9995,0,9999,4
1714626853845,CLRE 253,A00,507199,Vaida; Florin,9994,0,9999,5
1714626853845,CLRE 253,B00,507202,Vaida; Florin,9999,0,9999,0
1714626854869,CLRE 259,A00,507211,Patel; Hemal,9996,0,9999,3
1714626855896,CLRE 260,A00,507221,Cuomo; Raphael Eduardo,9999,0,9999,0
1714626856920,CLRE 297,001,507242,Cuomo; Raphael Eduardo,9999,0,9999,0
1714626857946,COGS 197,001,638244,Voytek; Bradley Thomas,9998,0,9999,1
1714626858971,CSE 191,A00,516875,Minnes Kemp; Mor Mia,9992,0,9999,7
1714626859996,CSE 197,001,637388,Minnes Kemp; Mor Mia,9998,0,9999,1
1714626861022,CSS 201S,A01,494383,Staff,35,0,35,0
1714626862053,CSS 202S,A01,494387,Staff,35,0,35,0
1714626863086,DSC 197,001,628532,Eldridge; Justin Matthew,9996,0,9999,3
1714626864111,EAP 100,A00,516065,Staff,9797,0,9999,202
1714626865136,ECE 45,A01,507414,Staff,33,0,60,27
1714626867190,ECE 111,A01,507420,Staff,15,0,50,35
1714626868216,ECE 197,001,548057,Sievenpiper; Daniel F.,9993,0,9999,6
1714626869245,EDS 115,A00,507243,Choi; Bailey Miyeon,10,0,28,18
1714626870269,EDS 117,A01,494379,Staff,1,5,30,29
1714626871295,EDS 125,A00,507246,Hopkins; Megan Beth,9,0,30,21
1714626872321,EDS 128A,A01,507264,Fargason; Sharon Gayle,8,0,26,18
1714626873349,EDS 128B,A01,507293,Pappas; Elizabeth,12,0,30,18
1714626874375,EDS 139,A00,507294,Fargason; Sharon Gayle,13,0,30,17
1714626874375,EDS 139,B00,507313,Pappas; Elizabeth,13,0,30,17
1714626875399,EDS 201,A00,507315,Staff,13,0,30,17
1714626876425,EDS 203,A01,507317,Halter; Christopher P.,12,0,30,18
1714626877449,EDS 204R,A01,507319,Halter; Christopher P.,0,3,30,30
1714626877449,EDS 204R,B01,507331,Heinzman; Erica M.,16,0,30,14
1714626878474,EDS 206R,A00,507332,Staff,0,4,30,30
1714626878474,EDS 206R,B00,507343,Staff,17,0,30,13
1714626879498,EDS 250,A00,507344,Hemans; Patricia Ann Benitez,22,0,40,18
1714626880524,EDS 281,A00,507345,Daly; Alan J.,18,0,18,0
1714626881551,EDS 284,A00,507350,Daly; Alan J.,16,0,16,0
1714626882581,EDS 286,A00,507359,Fine; Sarah,18,0,18,0
1714626883606,EDS 289C,A01,507361,Daly; Alan J.,18,0,18,0
1714626884634,EDS 290,A00,507366,Hofstetter; Carolyn,15,0,15,0
1714626885664,LIGM 5A,A00,507421,Fischer-Grunski; Eva K,18,0,20,2
1714626886692,LIGM 5B,A00,507423,Fischer-Grunski; Eva K,19,0,20,1
1714626887720,LIGM 5C,A00,507425,Fischer-Grunski; Eva K,19,0,20,1
1714626888749,LIIT 5AS,A00,507427,Carnelos; Chiara,20,0,20,0
1714626889775,LIIT 5BS,A00,507430,Carnelos; Chiara,20,0,20,0
1714626890802,LIIT 5CS,A00,507432,Carnelos; Chiara,20,0,20,0
1714626891829,LISP 5A,A00,507541,Munoz Sanchez; Alicia,11,0,20,9
1714626892858,LISP 5B,A00,507671,Munoz Sanchez; Alicia,8,0,20,12
1714626893891,LISP 5C,A00,507696,Munoz Sanchez; Alicia,9,0,20,11
1714626894927,MAE 197,001,528363,Boechler; Nicholas Sebastia,9998,0,9999,1
1714626895953,MATH 197,001,523477,Kedlaya; Kiran S.,9995,0,9999,4
1714626895953,MATH 197,002,563811,Zhang; Danna,9995,0,9999,4
1714626895953,MATH 197,003,628552,Dumitriu; Ioana,9998,0,9999,1
1714626896977,MCWP 40R,A00,518780,Staff,2,0,20,18
1714626896977,MCWP 40R,B00,518781,Staff,8,0,20,12
1714626896977,MCWP 40R,C00,518783,Staff,6,0,20,14
1714626898007,MCWP 50R,A00,518791,Staff,0,0,20,20
1714626898007,MCWP 50R,B00,518792,Staff,0,2,20,20
1714626898007,MCWP 50R,C00,518793,Staff,0,2,20,20
1714626898007,MCWP 50R,D00,518794,Staff,0,0,20,20
1714626898007,MCWP 50R,E00,518795,Staff,0,2,20,20
1714626898007,MCWP 50R,F00,518796,Staff,0,0,20,20
1714626898007,MCWP 50R,G00,518797,Staff,0,1,20,20
1714626899034,MMW 12R,A01,514034,Herbst; Matthew,0,0,16,16
1714626899034,MMW 12R,A02,514035,Herbst; Matthew,1,0,16,15
1714626900060,MMW 13R,A01,514037,Staff,0,4,16,16
1714626900060,MMW 13R,A02,514039,Staff,0,2,16,16
1714626900060,MMW 13R,A03,628519,Staff,0,2,16,16
1714626902114,SIO 295LS,A00,523233,Staff,10,0,30,20
1714626903140,SIO 295S,A00,523232,Staff,10,0,30,20
1714626904165,SIOC 290S,A01,637330,Merrifield; Mark A,23,0,30,7
1714626905192,SIOC 291S,A01,637333,Gabriel; Corey John,23,0,30,7
1714626906219,SOCI 117,A01,494376,Staff,0,4,5,5
1714626907244,WES 237B,A00,494380,Staff,9,0,20,11
1714626909326,AESE 279B,A00,494370,Wade; Jon P,0,0,33,33
1714626910364,AIP 197,001,627712,Vespa; Emanuel Ignacio,9998,0,9999,1
1714626911389,ANAR 135S,A00,494369,Braswell; Geoffrey E.,0,0,0,0
1714626912414,BENG 196,001,628496,Engler; Adam J.,9998,0,9999,1
1714626913438,CAT 124RS,A01,519847,Geibel; William,0,0,20,20
1714626914472,CAT 125RS,A01,515971,Geibel; William,0,0,20,20
1714626915497,CLRE 250,A00,511389,Morris; Sheldon,9993,0,9999,6
1714626916523,CLRE 251,A00,507176,Mehta; Ravindra L.,9993,0,9999,6
1714626916523,CLRE 251,B00,511410,Mehta; Ravindra L.,9998,0,9999,1
1714626917547,CLRE 252,A00,507189,Cuomo; Raphael Eduardo,9995,0,9999,4
1714626918573,CLRE 253,A00,507199,Vaida; Florin,9994,0,9999,5
1714626918573,CLRE 253,B00,507202,Vaida; Florin,9999,0,9999,0
1714626919599,CLRE 259,A00,507211,Patel; Hemal,9996,0,9999,3
1714626920626,CLRE 260,A00,507221,Cuomo; Raphael Eduardo,9999,0,9999,0
1714626921653,CLRE 297,001,507242,Cuomo; Raphael Eduardo,9999,0,9999,0
1714626922677,COGS 197,001,638244,Voytek; Bradley Thomas,9998,0,9999,1
1714626923705,CSE 191,A00,516875,Minnes Kemp; Mor Mia,9992,0,9999,7
1714626924728,CSE 197,001,637388,Minnes Kemp; Mor Mia,9998,0,9999,1
1714626925754,CSS 201S,A01,494383,Staff,35,0,35,0
1714626926782,CSS 202S,A01,494387,Staff,35,0,35,0
1714626927805,DSC 197,001,628532,Eldridge; Justin Matthew,9996,0,9999,3
1714626928831,EAP 100,A00,516065,Staff,9797,0,9999,202
1714626929860,ECE 45,A01,507414,Staff,33,0,60,27
1714626931908,ECE 111,A01,507420,Staff,15,0,50,35
1714626932935,ECE 197,001,548057,Sievenpiper; Daniel F.,9993,0,9999,6
1714626933959,EDS 115,A00,507243,Choi; Bailey Miyeon,10,0,28,18
1714626934990,EDS 117,A01,494379,Staff,1,5,30,29
1714626936014,EDS 125,A00,507246,Hopkins; Megan Beth,9,0,30,21
1714626937040,EDS 128A,A01,507264,Fargason; Sharon Gayle,8,0,26,18
1714626938063,EDS 128B,A01,507293,Pappas; Elizabeth,12,0,30,18
1714626939088,EDS 139,A00,507294,Fargason; Sharon Gayle,13,0,30,17
1714626939088,EDS 139,B00,507313,Pappas; Elizabeth,13,0,30,17
1714626940112,EDS 201,A00,507315,Staff,13,0,30,17
1714626941137,EDS 203,A01,507317,Halter; Christopher P.,12,0,30,18
1714626942163,EDS 204R,A01,507319,Halter; Christopher P.,0,3,30,30
1714626942163,EDS 204R,B01,507331,Heinzman; Erica M.,16,0,30,14
1714626943191,EDS 206R,A00,507332,Staff,0,4,30,30
1714626943191,EDS 206R,B00,507343,Staff,17,0,30,13
1714626944216,EDS 250,A00,507344,Hemans; Patricia Ann Benitez,22,0,40,18
1714626945244,EDS 281,A00,507345,Daly; Alan J.,18,0,18,0
1714626946273,EDS 284,A00,507350,Daly; Alan J.,16,0,16,0
1714626947299,EDS 286,A00,507359,Fine; Sarah,18,0,18,0
1714626948341,EDS 289C,A01,507361,Daly; Alan J.,18,0,18,0
1714626949365,EDS 290,A00,507366,Hofstetter; Carolyn,15,0,15,0
1714626950393,LIGM 5A,A00,507421,Fischer-Grunski; Eva K,18,0,20,2
1714626951423,LIGM 5B,A00,507423,Fischer-Grunski; Eva K,19,0,20,1
1714626952450,LIGM 5C,A00,507425,Fischer-Grunski; Eva K,19,0,20,1
1714626953476,LIIT 5AS,A00,507427,Carnelos; Chiara,20,0,20,0
1714626954502,LIIT 5BS,A00,507430,Carnelos; Chiara,20,0,20,0
1714626955531,LIIT 5CS,A00,507432,Carnelos; Chiara,20,0,20,0
1714626956561,LISP 5A,A00,507541,Munoz Sanchez; Alicia,11,0,20,9
1714626957590,LISP 5B,A00,507671,Munoz Sanchez; Alicia,8,0,20,12
1714626958615,LISP 5C,A00,507696,Munoz Sanchez; Alicia,9,0,20,11
1714626959641,MAE 197,001,528363,Boechler; Nicholas Sebastia,9998,0,9999,1
1714626960670,MATH 197,001,523477,Kedlaya; Kiran S.,9995,0,9999,4
1714626960670,MATH 197,002,563811,Zhang; Danna,9995,0,9999,4
1714626960670,MATH 197,003,628552,Dumitriu; Ioana,9998,0,9999,1
1714626961696,MCWP 40R,A00,518780,Staff,2,0,20,18
1714626961696,MCWP 40R,B00,518781,Staff,8,0,20,12
1714626961696,MCWP 40R,C00,518783,Staff,6,0,20,14
1714626962726,MCWP 50R,A00,518791,Staff,0,0,20,20
1714626962726,MCWP 50R,B00,518792,Staff,0,2,20,20
1714626962726,MCWP 50R,C00,518793,Staff,0,2,20,20
1714626962726,MCWP 50R,D00,518794,Staff,0,0,20,20
1714626962726,MCWP 50R,E00,518795,Staff,0,2,20,20
1714626962726,MCWP 50R,F00,518796,Staff,0,0,20,20
1714626962726,MCWP 50R,G00,518797,Staff,0,1,20,20
1714626963752,MMW 12R,A01,514034,Herbst; Matthew,0,0,16,16
1714626963752,MMW 12R,A02,514035,Herbst; Matthew,1,0,16,15
1714626964781,MMW 13R,A01,514037,Staff,0,4,16,16
1714626964781,MMW 13R,A02,514039,Staff,0,2,16,16
1714626964781,MMW 13R,A03,628519,Staff,0,2,16,16
1714626966837,SIO 295LS,A00,523233,Staff,10,0,30,20
1714626967862,SIO 295S,A00,523232,Staff,10,0,30,20
1714626968888,SIOC 290S,A01,637330,Merrifield; Mark A,23,0,30,7
1714626969920,SIOC 291S,A01,637333,Gabriel; Corey John,23,0,30,7
1714626970947,SOCI 117,A01,494376,Staff,0,4,5,5
1714626971974,WES 237B,A00,494380,Staff,9,0,20,11
1714626974037,AESE 279B,A00,494370,Wade; Jon P,0,0,33,33
1714626975064,AIP 197,001,627712,Vespa; Emanuel Ignacio,9998,0,9999,1
1714626976092,ANAR 135S,A00,494369,Braswell; Geoffrey E.,0,0,0,0
1714626977116,BENG 196,001,628496,Engler; Adam J.,9998,0,9999,1
1714626978144,CAT 124RS,A01,519847,Geibel; William,0,0,20,20
1714626979172,CAT 125RS,A01,515971,Geibel; William,0,0,20,20
1714626980197,CLRE 250,A00,511389,Morris; Sheldon,9993,0,9999,6
1714626981225,CLRE 251,A00,507176,Mehta; Ravindra L.,9993,0,9999,6
1714626981225,CLRE 251,B00,511410,Mehta; Ravindra L.,9998,0,9999,1
1714626982254,CLRE 252,A00,507189,Cuomo; Raphael Eduardo,9995,0,9999,4
1714626983282,CLRE 253,A00,507199,Vaida; Florin,9994,0,9999,5
1714626983282,CLRE 253,B00,507202,Vaida; Florin,9999,0,9999,0
1714626984307,CLRE 259,A00,507211,Patel; Hemal,9996,0,9999,3
1714626985332,CLRE 260,A00,507221,Cuomo; Raphael Eduardo,9999,0,9999,0
1714626986360,CLRE 297,001,507242,Cuomo; Raphael Eduardo,9999,0,9999,0
1714626987386,COGS 197,001,638244,Voytek; Bradley Thomas,9998,0,9999,1
1714626988411,CSE 191,A00,516875,Minnes Kemp; Mor Mia,9992,0,9999,7
1714626989441,CSE 197,001,637388,Minnes Kemp; Mor Mia,9998,0,9999,1
1714626990471,CSS 201S,A01,494383,Staff,35,0,35,0
1714626991497,CSS 202S,A01,494387,Staff,35,0,35,0
1714626992523,DSC 197,001,628532,Eldridge; Justin Matthew,9996,0,9999,3
1714626993547,EAP 100,A00,516065,Staff,9797,0,9999,202
1714626994573,ECE 45,A01,507414,Staff,33,0,60,27
1714626996624,ECE 111,A01,507420,Staff,15,0,50,35
1714626997652,ECE 197,001,548057,Sievenpiper; Daniel F.,9993,0,9999,6
1714626998682,EDS 115,A00,507243,Choi; Bailey Miyeon,10,0,28,18
1714626999712,EDS 117,A01,494379,Staff,1,5,30,29
1714627000737,EDS 125,A00,507246,Hopkins; Megan Beth,9,0,30,21
1714627001764,EDS 128A,A01,507264,Fargason; Sharon Gayle,8,0,26,18
1714627002790,EDS 128B,A01,507293,Pappas; Elizabeth,12,0,30,18
1714627003815,EDS 139,A00,507294,Fargason; Sharon Gayle,13,0,30,17
1714627003815,EDS 139,B00,507313,Pappas; Elizabeth,13,0,30,17
1714627004841,EDS 201,A00,507315,Staff,13,0,30,17
1714627005871,EDS 203,A01,507317,Halter; Christopher P.,12,0,30,18
1714627006897,EDS 204R,A01,507319,Halter; Christopher P.,0,3,30,30
1714627006897,EDS 204R,B01,507331,Heinzman; Erica M.,16,0,30,14
1714627007922,EDS 206R,A00,507332,Staff,0,4,30,30
1714627007922,EDS 206R,B00,507343,Staff,17,0,30,13
1714627008951,EDS 250,A00,507344,Hemans; Patricia Ann Benitez,22,0,40,18
1714627009977,EDS 281,A00,507345,Daly; Alan J.,18,0,18,0
1714627011007,EDS 284,A00,507350,Daly; Alan J.,16,0,16,0
1714627012034,EDS 286,A00,507359,Fine; Sarah,18,0,18,0
1714627013062,EDS 289C,A01,507361,Daly; Alan J.,18,0,18,0
1714627014089,EDS 290,A00,507366,Hofstetter; Carolyn,15,0,15,0
1714627015119,LIGM 5A,A00,507421,Fischer-Grunski; Eva K,18,0,20,2
1714627016143,LIGM 5B,A00,507423,Fischer-Grunski; Eva K,19,0,20,1
1714627017170,LIGM 5C,A00,507425,Fischer-Grunski; Eva K,19,0,20,1
1714627018201,LIIT 5AS,A00,507427,Carnelos; Chiara,20,0,20,0
1714627019227,LIIT 5BS,A00,507430,Carnelos; Chiara,20,0,20,0
1714627020258,LIIT 5CS,A00,507432,Carnelos; Chiara,20,0,20,0
1714627021284,LISP 5A,A00,507541,Munoz Sanchez; Alicia,11,0,20,9
1714627022310,LISP 5B,A00,507671,Munoz Sanchez; Alicia,8,0,20,12
1714627023336,LISP 5C,A00,507696,Munoz Sanchez; Alicia,9,0,20,11
1714627024362,MAE 197,001,528363,Boechler; Nicholas Sebastia,9998,0,9999,1
1714627025392,MATH 197,001,523477,Kedlaya; Kiran S.,9995,0,9999,4
1714627025392,MATH 197,002,563811,Zhang; Danna,9995,0,9999,4
1714627025392,MATH 197,003,628552,Dumitriu; Ioana,9998,0,9999,1
1714627026420,MCWP 40R,A00,518780,Staff,2,0,20,18
1714627026420,MCWP 40R,B00,518781,Staff,8,0,20,12
1714627026420,MCWP 40R,C00,518783,Staff,6,0,20,14
1714627027451,MCWP 50R,A00,518791,Staff,0,0,20,20
1714627027451,MCWP 50R,B00,518792,Staff,0,2,20,20
1714627027451,MCWP 50R,C00,518793,Staff,0,2,20,20
1714627027451,MCWP 50R,D00,518794,Staff,0,0,20,20
1714627027451,MCWP 50R,E00,518795,Staff,0,2,20,20
1714627027451,MCWP 50R,F00,518796,Staff,0,0,20,20
1714627027451,MCWP 50R,G00,518797,Staff,0,1,20,20
1714627028478,MMW 12R,A01,514034,Herbst; Matthew,0,0,16,16
1714627028478,MMW 12R,A02,514035,Herbst; Matthew,1,0,16,15
1714627029503,MMW 13R,A01,514037,Staff,0,4,16,16
1714627029503,MMW 13R,A02,514039,Staff,0,2,16,16
1714627029503,MMW 13R,A03,628519,Staff,0,2,16,16
1714627031555,SIO 295LS,A00,523233,Staff,10,0,30,20
1714627032585,SIO 295S,A00,523232,Staff,10,0,30,20
1714627033610,SIOC 290S,A01,637330,Merrifield; Mark A,23,0,30,7
1714627034638,SIOC 291S,A01,637333,Gabriel; Corey John,23,0,30,7
1714627035664,SOCI 117,A01,494376,Staff,0,4,5,5
1714627036687,WES 237B,A00,494380,Staff,9,0,20,11
1714627038756,AESE 279B,A00,494370,Wade; Jon P,0,0,33,33
1714627039781,AIP 197,001,627712,Vespa; Emanuel Ignacio,9998,0,9999,1
1714627040805,ANAR 135S,A00,494369,Braswell; Geoffrey E.,0,0,0,0
1714627041832,BENG 196,001,628496,Engler; Adam J.,9998,0,9999,1
1714627042856,CAT 124RS,A01,519847,Geibel; William,0,0,20,20
1714627043896,CAT 125RS,A01,515971,Geibel; William,0,0,20,20
1714627044923,CLRE 250,A00,511389,Morris; Sheldon,9993,0,9999,6
1714627045949,CLRE 251,A00,507176,Mehta; Ravindra L.,9993,0,9999,6
1714627045949,CLRE 251,B00,511410,Mehta; Ravindra L.,9998,0,9999,1
1714627046975,CLRE 252,A00,507189,Cuomo; Raphael Eduardo,9995,0,9999,4
1714627048025,CLRE 253,A00,507199,Vaida; Florin,9994,0,9999,5
1714627048025,CLRE 253,B00,507202,Vaida; Florin,9999,0,9999,0
1714627049053,CLRE 259,A00,507211,Patel; Hemal,9996,0,9999,3
1714627050080,CLRE 260,A00,507221,Cuomo; Raphael Eduardo,9999,0,9999,0
1714627051107,CLRE 297,001,507242,Cuomo; Raphael Eduardo,9999,0,9999,0
1714627052132,COGS 197,001,638244,Voytek; Bradley Thomas,9998,0,9999,1
1714627053160,CSE 191,A00,516875,Minnes Kemp; Mor Mia,9992,0,9999,7
1714627054185,CSE 197,001,637388,Minnes Kemp; Mor Mia,9998,0,9999,1
1714627055214,CSS 201S,A01,494383,Staff,35,0,35,0
1714627056242,CSS 202S,A01,494387,Staff,35,0,35,0
1714627057269,DSC 197,001,628532,Eldridge; Justin Matthew,9996,0,9999,3
1714627058293,EAP 100,A00,516065,Staff,9797,0,9999,202
1714627059318,ECE 45,A01,507414,Staff,33,0,60,27
1714627061370,ECE 111,A01,507420,Staff,15,0,50,35
1714627062396,ECE 197,001,548057,Sievenpiper; Daniel F.,9993,0,9999,6
1714627063421,EDS 115,A00,507243,Choi; Bailey Miyeon,10,0,28,18
1714627064448,EDS 117,A01,494379,Staff,1,5,30,29
1714627065475,EDS 125,A00,507246,Hopkins; Megan Beth,9,0,30,21
1714627066504,EDS 128A,A01,507264,Fargason; Sharon Gayle,8,0,26,18
1714627067533,EDS 128B,A01,507293,Pappas; Elizabeth,12,0,30,18
1714627068561,EDS 139,A00,507294,Fargason; Sharon Gayle,13,0,30,17
1714627068561,EDS 139,B00,507313,Pappas; Elizabeth,13,0,30,17
1714627069592,EDS 201,A00,507315,Staff,13,0,30,17
1714627070619,EDS 203,A01,507317,Halter; Christopher P.,12,0,30,18
1714627071644,EDS 204R,A01,507319,Halter; Christopher P.,0,3,30,30
1714627071644,EDS 204R,B01,507331,Heinzman; Erica M.,16,0,30,14
1714627072672,EDS 206R,A00,507332,Staff,0,4,30,30
1714627072672,EDS 206R,B00,507343,Staff,17,0,30,13
1714627073701,EDS 250,A00,507344,Hemans; Patricia Ann Benitez,22,0,40,18
1714627074728,EDS 281,A00,507345,Daly; Alan J.,18,0,18,0
1714627075752,EDS 284,A00,507350,Daly; Alan J.,16,0,16,0
1714627076781,EDS 286,A00,507359,Fine; Sarah,18,0,18,0
1714627077806,EDS 289C,A01,507361,Daly; Alan J.,18,0,18,0
1714627078830,EDS 290,A00,507366,Hofstetter; Carolyn,15,0,15,0
1714627079860,LIGM 5A,A00,507421,Fischer-Grunski; Eva K,18,0,20,2
1714627080885,LIGM 5B,A00,507423,Fischer-Grunski; Eva K,19,0,20,1
1714627081915,LIGM 5C,A00,507425,Fischer-Grunski; Eva K,19,0,20,1
1714627082940,LIIT 5AS,A00,507427,Carnelos; Chiara,20,0,20,0
1714627083966,LIIT 5BS,A00,507430,Carnelos; Chiara,20,0,20,0
1714627084990,LIIT 5CS,A00,507432,Carnelos; Chiara,20,0,20,0
1714627086021,LISP 5A,A00,507541,Munoz Sanchez; Alicia,11,0,20,9
1714627087049,LISP 5B,A00,507671,Munoz Sanchez; Alicia,8,0,20,12
1714627088078,LISP 5C,A00,507696,Munoz Sanchez; Alicia,9,0,20,11
1714627089106,MAE 197,001,528363,Boechler; Nicholas Sebastia,9998,0,9999,1
1714627090134,MATH 197,001,523477,Kedlaya; Kiran S.,9995,0,9999,4
1714627090134,MATH 197,002,563811,Zhang; Danna,9995,0,9999,4
1714627090134,MATH 197,003,628552,Dumitriu; Ioana,9998,0,9999,1
1714627091160,MCWP 40R,A00,518780,Staff,2,0,20,18
1714627091160,MCWP 40R,B00,518781,Staff,8,0,20,12
1714627091160,MCWP 40R,C00,518783,Staff,6,0,20,14
1714627092190,MCWP 50R,A00,518791,Staff,0,0,20,20
1714627092190,MCWP 50R,B00,518792,Staff,0,2,20,20
1714627092190,MCWP 50R,C00,518793,Staff,0,2,20,20
1714627092190,MCWP 50R,D00,518794,Staff,0,0,20,20
1714627092190,MCWP 50R,E00,518795,Staff,0,2,20,20
1714627092190,MCWP 50R,F00,518796,Staff,0,0,20,20
1714627092190,MCWP 50R,G00,518797,Staff,0,1,20,20
1714627093219,MMW 12R,A01,514034,Herbst; Matthew,0,0,16,16
1714627093219,MMW 12R,A02,514035,Herbst; Matthew,1,0,16,15
1714627094249,MMW 13R,A01,514037,Staff,0,4,16,16
1714627094249,MMW 13R,A02,514039,Staff,0,2,16,16
1714627094249,MMW 13R,A03,628519,Staff,0,2,16,16
1714627096301,SIO 295LS,A00,523233,Staff,10,0,30,20
1714627097325,SIO 295S,A00,523232,Staff,10,0,30,20
1714627098352,SIOC 290S,A01,637330,Merrifield; Mark A,23,0,30,7
1714627099377,SIOC 291S,A01,637333,Gabriel; Corey John,23,0,30,7
1714627100403,SOCI 117,A01,494376,Staff,0,4,5,5
1714627101434,WES 237B,A00,494380,Staff,9,0,20,11
1714627103502,AESE 279B,A00,494370,Wade; Jon P,0,0,33,33
1714627104528,AIP 197,001,627712,Vespa; Emanuel Ignacio,9998,0,9999,1
1714627105556,ANAR 135S,A00,494369,Braswell; Geoffrey E.,0,0,0,0
1714627106581,BENG 196,001,628496,Engler; Adam J.,9998,0,9999,1
1714627107606,CAT 124RS,A01,519847,Geibel; William,0,0,20,20
1714627108632,CAT 125RS,A01,515971,Geibel; William,0,0,20,20
1714627109662,CLRE 250,A00,511389,Morris; Sheldon,9993,0,9999,6
1714627110687,CLRE 251,A00,507176,Mehta; Ravindra L.,9993,0,9999,6
1714627110687,CLRE 251,B00,511410,Mehta; Ravindra L.,9998,0,9999,1
1714627111715,CLRE 252,A00,507189,Cuomo; Raphael Eduardo,9995,0,9999,4
1714627112743,CLRE 253,A00,507199,Vaida; Florin,9994,0,9999,5
1714627112743,CLRE 253,B00,507202,Vaida; Florin,9999,0,9999,0
1714627113771,CLRE 259,A00,507211,Patel; Hemal,9996,0,9999,3
1714627114797,CLRE 260,A00,507221,Cuomo; Raphael Eduardo,9999,0,9999,0
1714627115821,CLRE 297,001,507242,Cuomo; Raphael Eduardo,9999,0,9999,0
1714627116846,COGS 197,001,638244,Voytek; Bradley Thomas,9998,0,9999,1
1714627117872,CSE 191,A00,516875,Minnes Kemp; Mor Mia,9992,0,9999,7
1714627118896,CSE 197,001,637388,Minnes Kemp; Mor Mia,9998,0,9999,1
1714627119924,CSS 201S,A01,494383,Staff,35,0,35,0
1714627120948,CSS 202S,A01,494387,Staff,35,0,35,0
1714627121973,DSC 197,001,628532,Eldridge; Justin Matthew,9996,0,9999,3
1714627122997,EAP 100,A00,516065,Staff,9797,0,9999,202
1714627124022,ECE 45,A01,507414,Staff,33,0,60,27
1714627126078,ECE 111,A01,507420,Staff,15,0,50,35
1714627127105,ECE 197,001,548057,Sievenpiper; Daniel F.,9993,0,9999,6
1714627128131,EDS 115,A00,507243,Choi; Bailey Miyeon,10,0,28,18
1714627129160,EDS 117,A01,494379,Staff,1,5,30,29
1714627130186,EDS 125,A00,507246,Hopkins; Megan Beth,9,0,30,21
1714627131217,EDS 128A,A01,507264,Fargason; Sharon Gayle,8,0,26,18
1714627132242,EDS 128B,A01,507293,Pappas; Elizabeth,12,0,30,18
1714627133268,EDS 139,A00,507294,Fargason; Sharon Gayle,13,0,30,17
1714627133268,EDS 139,B00,507313,Pappas; Elizabeth,13,0,30,17
1714627134295,EDS 201,A00,507315,Staff,13,0,30,17
1714627135320,EDS 203,A01,507317,Halter; Christopher P.,12,0,30,18
1714627136348,EDS 204R,A01,507319,Halter; Christopher P.,0,3,30,30
1714627136348,EDS 204R,B01,507331,Heinzman; Erica M.,16,0,30,14
1714627137374,EDS 206R,A00,507332,Staff,0,4,30,30
1714627137374,EDS 206R,B00,507343,Staff,17,0,30,13
1714627138401,EDS 250,A00,507344,Hemans; Patricia Ann Benitez,22,0,40,18
1714627139426,EDS 281,A00,507345,Daly; Alan J.,18,0,18,0
1714627140452,EDS 284,A00,507350,Daly; Alan J.,16,0,16,0
1714627141478,EDS 286,A00,507359,Fine; Sarah,18,0,18,0
1714627142502,EDS 289C,A01,507361,Daly; Alan J.,18,0,18,0
1714627143526,EDS 290,A00,507366,Hofstetter; Carolyn,15,0,15,0
1714627144755,LIGM 5A,A00,507421,Fischer-Grunski; Eva K,18,0,20,2
1714627145784,LIGM 5B,A00,507423,Fischer-Grunski; Eva K,19,0,20,1
1714627146810,LIGM 5C,A00,507425,Fischer-Grunski; Eva K,19,0,20,1
1714627147836,LIIT 5AS,A00,507427,Carnelos; Chiara,20,0,20,0
1714627148861,LIIT 5BS,A00,507430,Carnelos; Chiara,20,0,20,0
1714627149888,LIIT 5CS,A00,507432,Carnelos; Chiara,20,0,20,0
1714627150918,LISP 5A,A00,507541,Munoz Sanchez; Alicia,11,0,20,9
1714627151945,LISP 5B,A00,507671,Munoz Sanchez; Alicia,8,0,20,12
1714627152972,LISP 5C,A00,507696,Munoz Sanchez; Alicia,9,0,20,11
1714627153999,MAE 197,001,528363,Boechler; Nicholas Sebastia,9998,0,9999,1
1714627155028,MATH 197,001,523477,Kedlaya; Kiran S.,9995,0,9999,4
1714627155028,MATH 197,002,563811,Zhang; Danna,9995,0,9999,4
1714627155028,MATH 197,003,628552,Dumitriu; Ioana,9998,0,9999,1
1714627156053,MCWP 40R,A00,518780,Staff,2,0,20,18
1714627156053,MCWP 40R,B00,518781,Staff,8,0,20,12
1714627156053,MCWP 40R,C00,518783,Staff,6,0,20,14
1714627157083,MCWP 50R,A00,518791,Staff,0,0,20,20
1714627157083,MCWP 50R,B00,518792,Staff,0,2,20,20
1714627157083,MCWP 50R,C00,518793,Staff,0,2,20,20
1714627157083,MCWP 50R,D00,518794,Staff,0,0,20,20
1714627157083,MCWP 50R,E00,518795,Staff,0,2,20,20
1714627157083,MCWP 50R,F00,518796,Staff,0,0,20,20
1714627157083,MCWP 50R,G00,518797,Staff,0,1,20,20
1714627158111,MMW 12R,A01,514034,Herbst; Matthew,0,0,16,16
1714627158111,MMW 12R,A02,514035,Herbst; Matthew,1,0,16,15
1714627159140,MMW 13R,A01,514037,Staff,0,4,16,16
1714627159140,MMW 13R,A02,514039,Staff,0,2,16,16
1714627159140,MMW 13R,A03,628519,Staff,0,2,16,16
1714627161189,SIO 295LS,A00,523233,Staff,10,0,30,20
1714627162215,SIO 295S,A00,523232,Staff,10,0,30,20
1714627163244,SIOC 290S,A01,637330,Merrifield; Mark A,23,0,30,7
1714627164270,SIOC 291S,A01,637333,Gabriel; Corey John,23,0,30,7
1714627165296,SOCI 117,A01,494376,Staff,0,4,5,5
1714627166322,WES 237B,A00,494380,Staff,9,0,20,11
1714627168408,AESE 279B,A00,494370,Wade; Jon P,0,0,33,33
1714627169433,AIP 197,001,627712,Vespa; Emanuel Ignacio,9998,0,9999,1
1714627170460,ANAR 135S,A00,494369,Braswell; Geoffrey E.,0,0,0,0
1714627171488,BENG 196,001,628496,Engler; Adam J.,9998,0,9999,1
1714627172516,CAT 124RS,A01,519847,Geibel; William,0,0,20,20
1714627173540,CAT 125RS,A01,515971,Geibel; William,0,0,20,20
1714627174570,CLRE 250,A00,511389,Morris; Sheldon,9993,0,9999,6
1714627175596,CLRE 251,A00,507176,Mehta; Ravindra L.,9993,0,9999,6
1714627175596,CLRE 251,B00,511410,Mehta; Ravindra L.,9998,0,9999,1
1714627176622,CLRE 252,A00,507189,Cuomo; Raphael Eduardo,9995,0,9999,4
1714627177646,CLRE 253,A00,507199,Vaida; Florin,9994,0,9999,5
1714627177646,CLRE 253,B00,507202,Vaida; Florin,9999,0,9999,0
1714627178675,CLRE 259,A00,507211,Patel; Hemal,9996,0,9999,3
1714627179700,CLRE 260,A00,507221,Cuomo; Raphael Eduardo,9999,0,9999,0
1714627180726,CLRE 297,001,507242,Cuomo; Raphael Eduardo,9999,0,9999,0
1714627181750,COGS 197,001,638244,Voytek; Bradley Thomas,9998,0,9999,1
1714627182777,CSE 191,A00,516875,Minnes Kemp; Mor Mia,9992,0,9999,7
1714627183804,CSE 197,001,637388,Minnes Kemp; Mor Mia,9998,0,9999,1
1714627184830,CSS 201S,A01,494383,Staff,35,0,35,0
1714627185854,CSS 202S,A01,494387,Staff,35,0,35,0
1714627186883,DSC 197,001,628532,Eldridge; Justin Matthew,9996,0,9999,3
1714627187907,EAP 100,A00,516065,Staff,9797,0,9999,202
1714627188934,ECE 45,A01,507414,Staff,33,0,60,27
1714627190989,ECE 111,A01,507420,Staff,15,0,50,35
1714627192014,ECE 197,001,548057,Sievenpiper; Daniel F.,9993,0,9999,6
1714627193046,EDS 115,A00,507243,Choi; Bailey Miyeon,10,0,28,18
1714627194075,EDS 117,A01,494379,Staff,1,5,30,29
1714627195104,EDS 125,A00,507246,Hopkins; Megan Beth,9,0,30,21
1714627196132,EDS 128A,A01,507264,Fargason; Sharon Gayle,8,0,26,18
1714627197160,EDS 128B,A01,507293,Pappas; Elizabeth,12,0,30,18
1714627198184,EDS 139,A00,507294,Fargason; Sharon Gayle,13,0,30,17
1714627198184,EDS 139,B00,507313,Pappas; Elizabeth,13,0,30,17
1714627199214,EDS 201,A00,507315,Staff,13,0,30,17
1714627200239,EDS 203,A01,507317,Halter; Christopher P.,12,0,30,18
1714627201263,EDS 204R,A01,507319,Halter; Christopher P.,0,3,30,30
1714627201263,EDS 204R,B01,507331,Heinzman; Erica M.,16,0,30,14
1714627202289,EDS 206R,A00,507332,Staff,0,4,30,30
1714627202289,EDS 206R,B00,507343,Staff,17,0,30,13
1714627203315,EDS 250,A00,507344,Hemans; Patricia Ann Benitez,22,0,40,18
1714627204339,EDS 281,A00,507345,Daly; Alan J.,18,0,18,0
1714627205367,EDS 284,A00,507350,Daly; Alan J.,16,0,16,0
1714627206395,EDS 286,A00,507359,Fine; Sarah,18,0,18,0
1714627207421,EDS 289C,A01,507361,Daly; Alan J.,18,0,18,0
1714627208448,EDS 290,A00,507366,Hofstetter; Carolyn,15,0,15,0
1714627209478,LIGM 5A,A00,507421,Fischer-Grunski; Eva K,18,0,20,2
1714627210501,LIGM 5B,A00,507423,Fischer-Grunski; Eva K,19,0,20,1
1714627211525,LIGM 5C,A00,507425,Fischer-Grunski; Eva K,19,0,20,1
1714627212554,LIIT 5AS,A00,507427,Carnelos; Chiara,20,0,20,0
1714627213579,LIIT 5BS,A00,507430,Carnelos; Chiara,20,0,20,0
1714627214603,LIIT 5CS,A00,507432,Carnelos; Chiara,20,0,20,0
1714627215632,LISP 5A,A00,507541,Munoz Sanchez; Alicia,11,0,20,9
1714627216657,LISP 5B,A00,507671,Munoz Sanchez; Alicia,8,0,20,12
1714627217685,LISP 5C,A00,507696,Munoz Sanchez; Alicia,9,0,20,11
1714627218715,MAE 197,001,528363,Boechler; Nicholas Sebastia,9998,0,9999,1
1714627219747,MATH 197,001,523477,Kedlaya; Kiran S.,9995,0,9999,4
1714627219747,MATH 197,002,563811,Zhang; Danna,9995,0,9999,4
1714627219747,MATH 197,003,628552,Dumitriu; Ioana,9998,0,9999,1
1714627220772,MCWP 40R,A00,518780,Staff,2,0,20,18
1714627220772,MCWP 40R,B00,518781,Staff,8,0,20,12
1714627220772,MCWP 40R,C00,518783,Staff,6,0,20,14
1714627221800,MCWP 50R,A00,518791,Staff,0,0,20,20
1714627221800,MCWP 50R,B00,518792,Staff,0,2,20,20
1714627221800,MCWP 50R,C00,518793,Staff,0,2,20,20
1714627221800,MCWP 50R,D00,518794,Staff,0,0,20,20
1714627221800,MCWP 50R,E00,518795,Staff,0,2,20,20
1714627221800,MCWP 50R,F00,518796,Staff,0,0,20,20
1714627221800,MCWP 50R,G00,518797,Staff,0,1,20,20
1714627222824,MMW 12R,A01,514034,Herbst; Matthew,0,0,16,16
1714627222824,MMW 12R,A02,514035,Herbst; Matthew,1,0,16,15
1714627223849,MMW 13R,A01,514037,Staff,0,4,16,16
1714627223849,MMW 13R,A02,514039,Staff,0,2,16,16
1714627223849,MMW 13R,A03,628519,Staff,0,2,16,16
1714627225900,SIO 295LS,A00,523233,Staff,10,0,30,20
1714627226925,SIO 295S,A00,523232,Staff,10,0,30,20
1714627227951,SIOC 290S,A01,637330,Merrifield; Mark A,23,0,30,7
1714627228978,SIOC 291S,A01,637333,Gabriel; Corey John,23,0,30,7
1714627230004,SOCI 117,A01,494376,Staff,0,4,5,5
1714627231032,WES 237B,A00,494380,Staff,9,0,20,11
1714627233098,AESE 279B,A00,494370,Wade; Jon P,0,0,33,33
1714627234123,AIP 197,001,627712,Vespa; Emanuel Ignacio,9998,0,9999,1
1714627235148,ANAR 135S,A00,494369,Braswell; Geoffrey E.,0,0,0,0
1714627236171,BENG 196,001,628496,Engler; Adam J.,9998,0,9999,1
1714627237197,CAT 124RS,A01,519847,Geibel; William,0,0,20,20
1714627238223,CAT 125RS,A01,515971,Geibel; William,0,0,20,20
1714627239252,CLRE 250,A00,511389,Morris; Sheldon,9993,0,9999,6
1714627240283,CLRE 251,A00,507176,Mehta; Ravindra L.,9993,0,9999,6
1714627240283,CLRE 251,B00,511410,Mehta; Ravindra L.,9998,0,9999,1
1714627241308,CLRE 252,A00,507189,Cuomo; Raphael Eduardo,9995,0,9999,4
1714627242335,CLRE 253,A00,507199,Vaida; Florin,9994,0,9999,5
1714627242335,CLRE 253,B00,507202,Vaida; Florin,9999,0,9999,0
1714627243364,CLRE 259,A00,507211,Patel; Hemal,9996,0,9999,3
1714627244392,CLRE 260,A00,507221,Cuomo; Raphael Eduardo,9999,0,9999,0
1714627245418,CLRE 297,001,507242,Cuomo; Raphael Eduardo,9999,0,9999,0
1714627246447,COGS 197,001,638244,Voytek; Bradley Thomas,9998,0,9999,1
1714627247475,CSE 191,A00,516875,Minnes Kemp; Mor Mia,9992,0,9999,7
1714627248531,CSE 197,001,637388,Minnes Kemp; Mor Mia,9998,0,9999,1
1714627249557,CSS 201S,A01,494383,Staff,35,0,35,0
1714627250586,CSS 202S,A01,494387,Staff,35,0,35,0
1714627251614,DSC 197,001,628532,Eldridge; Justin Matthew,9996,0,9999,3
1714627252637,EAP 100,A00,516065,Staff,9797,0,9999,202
1714627253663,ECE 45,A01,507414,Staff,33,0,60,27
1714627255714,ECE 111,A01,507420,Staff,15,0,50,35
1714627256741,ECE 197,001,548057,Sievenpiper; Daniel F.,9993,0,9999,6
1714627257772,EDS 115,A00,507243,Choi; Bailey Miyeon,10,0,28,18
1714627258798,EDS 117,A01,494379,Staff,1,5,30,29
1714627259829,EDS 125,A00,507246,Hopkins; Megan Beth,9,0,30,21
1714627260855,EDS 128A,A01,507264,Fargason; Sharon Gayle,8,0,26,18
1714627261879,EDS 128B,A01,507293,Pappas; Elizabeth,12,0,30,18
1714627262904,EDS 139,A00,507294,Fargason; Sharon Gayle,13,0,30,17
1714627262904,EDS 139,B00,507313,Pappas; Elizabeth,13,0,30,17
1714627263933,EDS 201,A00,507315,Staff,13,0,30,17
1714627264962,EDS 203,A01,507317,Halter; Christopher P.,12,0,30,18
1714627265988,EDS 204R,A01,507319,Halter; Christopher P.,0,3,30,30
1714627265988,EDS 204R,B01,507331,Heinzman; Erica M.,16,0,30,14
1714627267016,EDS 206R,A00,507332,Staff,0,4,30,30
1714627267016,EDS 206R,B00,507343,Staff,17,0,30,13
1714627268040,EDS 250,A00,507344,Hemans; Patricia Ann Benitez,22,0,40,18
1714627269065,EDS 281,A00,507345,Daly; Alan J.,18,0,18,0
1714627270089,EDS 284,A00,507350,Daly; Alan J.,16,0,16,0
1714627271114,EDS 286,A00,507359,Fine; Sarah,18,0,18,0
1714627272141,EDS 289C,A01,507361,Daly; Alan J.,18,0,18,0
1714627273171,EDS 290,A00,507366,Hofstetter; Carolyn,15,0,15,0
1714627274199,LIGM 5A,A00,507421,Fischer-Grunski; Eva K,18,0,20,2
1714627275223,LIGM 5B,A00,507423,Fischer-Grunski; Eva K,19,0,20,1
1714627276252,LIGM 5C,A00,507425,Fischer-Grunski; Eva K,19,0,20,1
1714627277278,LIIT 5AS,A00,507427,Carnelos; Chiara,20,0,20,0
1714627278303,LIIT 5BS,A00,507430,Carnelos; Chiara,20,0,20,0
1714627279331,LIIT 5CS,A00,507432,Carnelos; Chiara,20,0,20,0
1714627280357,LISP 5A,A00,507541,Munoz Sanchez; Alicia,11,0,20,9
1714627281382,LISP 5B,A00,507671,Munoz Sanchez; Alicia,8,0,20,12
1714627282407,LISP 5C,A00,507696,Munoz Sanchez; Alicia,9,0,20,11
1714627283432,MAE 197,001,528363,Boechler; Nicholas Sebastia,9998,0,9999,1
1714627284459,MATH 197,001,523477,Kedlaya; Kiran S.,9995,0,9999,4
1714627284459,MATH 197,002,563811,Zhang; Danna,9995,0,9999,4
1714627284459,MATH 197,003,628552,Dumitriu; Ioana,9998,0,9999,1
1714627285486,MCWP 40R,A00,518780,Staff,2,0,20,18
1714627285486,MCWP 40R,B00,518781,Staff,8,0,20,12
1714627285486,MCWP 40R,C00,518783,Staff,6,0,20,14
1714627286516,MCWP 50R,A00,518791,Staff,0,0,20,20
1714627286516,MCWP 50R,B00,518792,Staff,0,2,20,20
1714627286516,MCWP 50R,C00,518793,Staff,0,2,20,20
1714627286516,MCWP 50R,D00,518794,Staff,0,0,20,20
1714627286516,MCWP 50R,E00,518795,Staff,0,2,20,20
1714627286516,MCWP 50R,F00,518796,Staff,0,0,20,20
1714627286516,MCWP 50R,G00,518797,Staff,0,1,20,20
1714627287545,MMW 12R,A01,514034,Herbst; Matthew,0,0,16,16
1714627287545,MMW 12R,A02,514035,Herbst; Matthew,1,0,16,15
1714627288570,MMW 13R,A01,514037,Staff,0,4,16,16
1714627288570,MMW 13R,A02,514039,Staff,0,2,16,16
1714627288570,MMW 13R,A03,628519,Staff,0,2,16,16
1714627290620,SIO 295LS,A00,523233,Staff,10,0,30,20
1714627291648,SIO 295S,A00,523232,Staff,10,0,30,20
1714627292676,SIOC 290S,A01,637330,Merrifield; Mark A,23,0,30,7
1714627293707,SIOC 291S,A01,637333,Gabriel; Corey John,23,0,30,7
1714627294733,SOCI 117,A01,494376,Staff,0,4,5,5
1714627295756,WES 237B,A00,494380,Staff,9,0,20,11
1714627297830,AESE 279B,A00,494370,Wade; Jon P,0,0,33,33
1714627298855,AIP 197,001,627712,Vespa; Emanuel Ignacio,9998,0,9999,1
1714627299881,ANAR 135S,A00,494369,Braswell; Geoffrey E.,0,0,0,0
1714627300905,BENG 196,001,628496,Engler; Adam J.,9998,0,9999,1
1714627301928,CAT 124RS,A01,519847,Geibel; William,0,0,20,20
1714627302956,CAT 125RS,A01,515971,Geibel; William,0,0,20,20
1714627303984,CLRE 250,A00,511389,Morris; Sheldon,9993,0,9999,6
1714627305009,CLRE 251,A00,507176,Mehta; Ravindra L.,9993,0,9999,6
1714627305009,CLRE 251,B00,511410,Mehta; Ravindra L.,9998,0,9999,1
1714627306039,CLRE 252,A00,507189,Cuomo; Raphael Eduardo,9995,0,9999,4
1714627307064,CLRE 253,A00,507199,Vaida; Florin,9994,0,9999,5
1714627307064,CLRE 253,B00,507202,Vaida; Florin,9999,0,9999,0
1714627308088,CLRE 259,A00,507211,Patel; Hemal,9996,0,9999,3
1714627309116,CLRE 260,A00,507221,Cuomo; Raphael Eduardo,9999,0,9999,0
1714627310143,CLRE 297,001,507242,Cuomo; Raphael Eduardo,9999,0,9999,0
1714627311169,COGS 197,001,638244,Voytek; Bradley Thomas,9998,0,9999,1
1714627312197,CSE 191,A00,516875,Minnes Kemp; Mor Mia,9992,0,9999,7
1714627313221,CSE 197,001,637388,Minnes Kemp; Mor Mia,9998,0,9999,1
1714627314247,CSS 201S,A01,494383,Staff,35,0,35,0
1714627315272,CSS 202S,A01,494387,Staff,35,0,35,0
1714627316297,DSC 197,001,628532,Eldridge; Justin Matthew,9996,0,9999,3
1714627317324,EAP 100,A00,516065,Staff,9797,0,9999,202
1714627318352,ECE 45,A01,507414,Staff,33,0,60,27
1714627320405,ECE 111,A01,507420,Staff,15,0,50,35
1714627321484,ECE 197,001,548057,Sievenpiper; Daniel F.,9993,0,9999,6
1714627322510,EDS 115,A00,507243,Choi; Bailey Miyeon,10,0,28,18
1714627323538,EDS 117,A01,494379,Staff,1,5,30,29
1714627324564,EDS 125,A00,507246,Hopkins; Megan Beth,9,0,30,21
1714627325592,EDS 128A,A01,507264,Fargason; Sharon Gayle,8,0,26,18
1714627326674,EDS 128B,A01,507293,Pappas; Elizabeth,12,0,30,18
1714627327703,EDS 139,A00,507294,Fargason; Sharon Gayle,13,0,30,17
1714627327703,EDS 139,B00,507313,Pappas; Elizabeth,13,0,30,17
1714627328728,EDS 201,A00,507315,Staff,13,0,30,17
1714627329752,EDS 203,A01,507317,Halter; Christopher P.,12,0,30,18
1714627330778,EDS 204R,A01,507319,Halter; Christopher P.,0,3,30,30
1714627330778,EDS 204R,B01,507331,Heinzman; Erica M.,16,0,30,14
1714627331808,EDS 206R,A00,507332,Staff,0,4,30,30
1714627331808,EDS 206R,B00,507343,Staff,17,0,30,13
1714627332834,EDS 250,A00,507344,Hemans; Patricia Ann Benitez,22,0,40,18
1714627333872,EDS 281,A00,507345,Daly; Alan J.,18,0,18,0
1714627334896,EDS 284,A00,507350,Daly; Alan J.,16,0,16,0
1714627335920,EDS 286,A00,507359,Fine; Sarah,18,0,18,0
1714627336944,EDS 289C,A01,507361,Daly; Alan J.,18,0,18,0
1714627337974,EDS 290,A00,507366,Hofstetter; Carolyn,15,0,15,0
1714627339064,LIGM 5A,A00,507421,Fischer-Grunski; Eva K,18,0,20,2
1714627340088,LIGM 5B,A00,507423,Fischer-Grunski; Eva K,19,0,20,1
1714627341119,LIGM 5C,A00,507425,Fischer-Grunski; Eva K,19,0,20,1
1714627342145,LIIT 5AS,A00,507427,Carnelos; Chiara,20,0,20,0
1714627343174,LIIT 5BS,A00,507430,Carnelos; Chiara,20,0,20,0
1714627344198,LIIT 5CS,A00,507432,Carnelos; Chiara,20,0,20,0
1714627345227,LISP 5A,A00,507541,Munoz Sanchez; Alicia,11,0,20,9
1714627346254,LISP 5B,A00,507671,Munoz Sanchez; Alicia,8,0,20,12
1714627347280,LISP 5C,A00,507696,Munoz Sanchez; Alicia,9,0,20,11
1714627348305,MAE 197,001,528363,Boechler; Nicholas Sebastia,9998,0,9999,1
1714627349331,MATH 197,001,523477,Kedlaya; Kiran S.,9995,0,9999,4
1714627349331,MATH 197,002,563811,Zhang; Danna,9995,0,9999,4
1714627349331,MATH 197,003,628552,Dumitriu; Ioana,9998,0,9999,1
1714627350357,MCWP 40R,A00,518780,Staff,2,0,20,18
1714627350357,MCWP 40R,B00,518781,Staff,8,0,20,12
1714627350357,MCWP 40R,C00,518783,Staff,6,0,20,14
1714627351383,MCWP 50R,A00,518791,Staff,0,0,20,20
1714627351383,MCWP 50R,B00,518792,Staff,0,2,20,20
1714627351383,MCWP 50R,C00,518793,Staff,0,2,20,20
1714627351383,MCWP 50R,D00,518794,Staff,0,0,20,20
1714627351383,MCWP 50R,E00,518795,Staff,0,2,20,20
1714627351383,MCWP 50R,F00,518796,Staff,0,0,20,20
1714627351383,MCWP 50R,G00,518797,Staff,0,1,20,20
1714627352411,MMW 12R,A01,514034,Herbst; Matthew,0,0,16,16
1714627352411,MMW 12R,A02,514035,Herbst; Matthew,1,0,16,15
1714627353438,MMW 13R,A01,514037,Staff,0,4,16,16
1714627353438,MMW 13R,A02,514039,Staff,0,2,16,16
1714627353438,MMW 13R,A03,628519,Staff,0,2,16,16
1714627355489,SIO 295LS,A00,523233,Staff,10,0,30,20
1714627356518,SIO 295S,A00,523232,Staff,10,0,30,20
1714627357543,SIOC 290S,A01,637330,Merrifield; Mark A,23,0,30,7
1714627358569,SIOC 291S,A01,637333,Gabriel; Corey John,23,0,30,7
1714627359597,SOCI 117,A01,494376,Staff,0,4,5,5
1714627360622,WES 237B,A00,494380,Staff,9,0,20,11
1714627362691,AESE 279B,A00,494370,Wade; Jon P,0,0,33,33
1714627363719,AIP 197,001,627712,Vespa; Emanuel Ignacio,9998,0,9999,1
1714627364744,ANAR 135S,A00,494369,Braswell; Geoffrey E.,0,0,0,0
1714627365773,BENG 196,001,628496,Engler; Adam J.,9998,0,9999,1
1714627366800,CAT 124RS,A01,519847,Geibel; William,0,0,20,20
1714627367825,CAT 125RS,A01,515971,Geibel; William,0,0,20,20
1714627368853,CLRE 250,A00,511389,Morris; Sheldon,9993,0,9999,6
1714627369882,CLRE 251,A00,507176,Mehta; Ravindra L.,9993,0,9999,6
1714627369882,CLRE 251,B00,511410,Mehta; Ravindra L.,9998,0,9999,1
1714627370909,CLRE 252,A00,507189,Cuomo; Raphael Eduardo,9995,0,9999,4
1714627371938,CLRE 253,A00,507199,Vaida; Florin,9994,0,9999,5
1714627371938,CLRE 253,B00,507202,Vaida; Florin,9999,0,9999,0
1714627372969,CLRE 259,A00,507211,Patel; Hemal,9996,0,9999,3
1714627373993,CLRE 260,A00,507221,Cuomo; Raphael Eduardo,9999,0,9999,0
1714627375019,CLRE 297,001,507242,Cuomo; Raphael Eduardo,9999,0,9999,0
1714627376044,COGS 197,001,638244,Voytek; Bradley Thomas,9998,0,9999,1
1714627377073,CSE 191,A00,516875,Minnes Kemp; Mor Mia,9992,0,9999,7
1714627378099,CSE 197,001,637388,Minnes Kemp; Mor Mia,9998,0,9999,1
1714627379128,CSS 201S,A01,494383,Staff,35,0,35,0
1714627380152,CSS 202S,A01,494387,Staff,35,0,35,0
1714627381181,DSC 197,001,628532,Eldridge; Justin Matthew,9996,0,9999,3
1714627382207,EAP 100,A00,516065,Staff,9797,0,9999,202
1714627383235,ECE 45,A01,507414,Staff,33,0,60,27
1714627385288,ECE 111,A01,507420,Staff,15,0,50,35
1714627386314,ECE 197,001,548057,Sievenpiper; Daniel F.,9993,0,9999,6
1714627387344,EDS 115,A00,507243,Choi; Bailey Miyeon,10,0,28,18
1714627388371,EDS 117,A01,494379,Staff,1,5,30,29
1714627389398,EDS 125,A00,507246,Hopkins; Megan Beth,9,0,30,21
1714627390427,EDS 128A,A01,507264,Fargason; Sharon Gayle,8,0,26,18
1714627391452,EDS 128B,A01,507293,Pappas; Elizabeth,12,0,30,18
1714627392476,EDS 139,A00,507294,Fargason; Sharon Gayle,13,0,30,17
1714627392476,EDS 139,B00,507313,Pappas; Elizabeth,13,0,30,17
1714627393504,EDS 201,A00,507315,Staff,13,0,30,17
1714627394529,EDS 203,A01,507317,Halter; Christopher P.,12,0,30,18
1714627395557,EDS 204R,A01,507319,Halter; Christopher P.,0,3,30,30
1714627395557,EDS 204R,B01,507331,Heinzman; Erica M.,16,0,30,14
1714627396586,EDS 206R,A00,507332,Staff,0,4,30,30
1714627396586,EDS 206R,B00,507343,Staff,17,0,30,13
1714627397612,EDS 250,A00,507344,Hemans; Patricia Ann Benitez,22,0,40,18
1714627398643,EDS 281,A00,507345,Daly; Alan J.,18,0,18,0
1714627399669,EDS 284,A00,507350,Daly; Alan J.,16,0,16,0
1714627400694,EDS 286,A00,507359,Fine; Sarah,18,0,18,0
1714627401721,EDS 289C,A01,507361,Daly; Alan J.,18,0,18,0
1714627402747,EDS 290,A00,507366,Hofstetter; Carolyn,15,0,15,0
1714627403779,LIGM 5A,A00,507421,Fischer-Grunski; Eva K,18,0,20,2
1714627404804,LIGM 5B,A00,507423,Fischer-Grunski; Eva K,19,0,20,1
1714627405828,LIGM 5C,A00,507425,Fischer-Grunski; Eva K,19,0,20,1
1714627406854,LIIT 5AS,A00,507427,Carnelos; Chiara,20,0,20,0
1714627407882,LIIT 5BS,A00,507430,Carnelos; Chiara,20,0,20,0
1714627408910,LIIT 5CS,A00,507432,Carnelos; Chiara,20,0,20,0
1714627409935,LISP 5A,A00,507541,Munoz Sanchez; Alicia,11,0,20,9
1714627410959,LISP 5B,A00,507671,Munoz Sanchez; Alicia,8,0,20,12
1714627411989,LISP 5C,A00,507696,Munoz Sanchez; Alicia,9,0,20,11
1714627413015,MAE 197,001,528363,Boechler; Nicholas Sebastia,9998,0,9999,1
1714627414041,MATH 197,001,523477,Kedlaya; Kiran S.,9995,0,9999,4
1714627414041,MATH 197,002,563811,Zhang; Danna,9995,0,9999,4
1714627414041,MATH 197,003,628552,Dumitriu; Ioana,9998,0,9999,1
1714627415069,MCWP 40R,A00,518780,Staff,2,0,20,18
1714627415069,MCWP 40R,B00,518781,Staff,8,0,20,12
1714627415069,MCWP 40R,C00,518783,Staff,6,0,20,14
1714627416098,MCWP 50R,A00,518791,Staff,0,0,20,20
1714627416098,MCWP 50R,B00,518792,Staff,0,2,20,20
1714627416098,MCWP 50R,C00,518793,Staff,0,2,20,20
1714627416098,MCWP 50R,D00,518794,Staff,0,0,20,20
1714627416098,MCWP 50R,E00,518795,Staff,0,2,20,20
1714627416098,MCWP 50R,F00,518796,Staff,0,0,20,20
1714627416098,MCWP 50R,G00,518797,Staff,0,1,20,20
1714627417124,MMW 12R,A01,514034,Herbst; Matthew,0,0,16,16
1714627417124,MMW 12R,A02,514035,Herbst; Matthew,1,0,16,15
1714627418148,MMW 13R,A01,514037,Staff,0,4,16,16
1714627418148,MMW 13R,A02,514039,Staff,0,2,16,16
1714627418148,MMW 13R,A03,628519,Staff,0,2,16,16
1714627420197,SIO 295LS,A00,523233,Staff,10,0,30,20
1714627421222,SIO 295S,A00,523232,Staff,10,0,30,20
1714627422246,SIOC 290S,A01,637330,Merrifield; Mark A,23,0,30,7
1714627423273,SIOC 291S,A01,637333,Gabriel; Corey John,23,0,30,7
1714627424299,SOCI 117,A01,494376,Staff,0,4,5,5
1714627425327,WES 237B,A00,494380,Staff,9,0,20,11
1714627427397,AESE 279B,A00,494370,Wade; Jon P,0,0,33,33
1714627428426,AIP 197,001,627712,Vespa; Emanuel Ignacio,9998,0,9999,1
1714627429456,ANAR 135S,A00,494369,Braswell; Geoffrey E.,0,0,0,0
1714627430481,BENG 196,001,628496,Engler; Adam J.,9998,0,9999,1
1714627431507,CAT 124RS,A01,519847,Geibel; William,0,0,20,20
1714627432535,CAT 125RS,A01,515971,Geibel; William,0,0,20,20
1714627433561,CLRE 250,A00,511389,Morris; Sheldon,9993,0,9999,6
1714627434592,CLRE 251,A00,507176,Mehta; Ravindra L.,9993,0,9999,6
1714627434592,CLRE 251,B00,511410,Mehta; Ravindra L.,9998,0,9999,1
1714627435619,CLRE 252,A00,507189,Cuomo; Raphael Eduardo,9995,0,9999,4
1714627436647,CLRE 253,A00,507199,Vaida; Florin,9994,0,9999,5
1714627436647,CLRE 253,B00,507202,Vaida; Florin,9999,0,9999,0
1714627437672,CLRE 259,A00,507211,Patel; Hemal,9996,0,9999,3
1714627438699,CLRE 260,A00,507221,Cuomo; Raphael Eduardo,9999,0,9999,0
1714627439723,CLRE 297,001,507242,Cuomo; Raphael Eduardo,9999,0,9999,0
1714627440748,COGS 197,001,638244,Voytek; Bradley Thomas,9998,0,9999,1
1714627441773,CSE 191,A00,516875,Minnes Kemp; Mor Mia,9992,0,9999,7
1714627442800,CSE 197,001,637388,Minnes Kemp; Mor Mia,9998,0,9999,1
1714627443830,CSS 201S,A01,494383,Staff,35,0,35,0
1714627444853,CSS 202S,A01,494387,Staff,35,0,35,0
1714627445880,DSC 197,001,628532,Eldridge; Justin Matthew,9996,0,9999,3
1714627446909,EAP 100,A00,516065,Staff,9797,0,9999,202
1714627447938,ECE 45,A01,507414,Staff,33,0,60,27
1714627449990,ECE 111,A01,507420,Staff,15,0,50,35
1714627451020,ECE 197,001,548057,Sievenpiper; Daniel F.,9993,0,9999,6
1714627452050,EDS 115,A00,507243,Choi; Bailey Miyeon,10,0,28,18
1714627453078,EDS 117,A01,494379,Staff,1,5,30,29
1714627454165,EDS 125,A00,507246,Hopkins; Megan Beth,9,0,30,21
1714627455190,EDS 128A,A01,507264,Fargason; Sharon Gayle,8,0,26,18
1714627456219,EDS 128B,A01,507293,Pappas; Elizabeth,12,0,30,18
1714627457246,EDS 139,A00,507294,Fargason; Sharon Gayle,13,0,30,17
1714627457246,EDS 139,B00,507313,Pappas; Elizabeth,13,0,30,17
1714627458272,EDS 201,A00,507315,Staff,13,0,30,17
1714627459301,EDS 203,A01,507317,Halter; Christopher P.,12,0,30,18
1714627460328,EDS 204R,A01,507319,Halter; Christopher P.,0,3,30,30
1714627460328,EDS 204R,B01,507331,Heinzman; Erica M.,16,0,30,14
1714627461356,EDS 206R,A00,507332,Staff,0,4,30,30
1714627461356,EDS 206R,B00,507343,Staff,17,0,30,13
1714627462380,EDS 250,A00,507344,Hemans; Patricia Ann Benitez,22,0,40,18
1714627463410,EDS 281,A00,507345,Daly; Alan J.,18,0,18,0
1714627464433,EDS 284,A00,507350,Daly; Alan J.,16,0,16,0
1714627465460,EDS 286,A00,507359,Fine; Sarah,18,0,18,0
1714627466485,EDS 289C,A01,507361,Daly; Alan J.,18,0,18,0
1714627467514,EDS 290,A00,507366,Hofstetter; Carolyn,15,0,15,0
1714627468544,LIGM 5A,A00,507421,Fischer-Grunski; Eva K,18,0,20,2
1714627469572,LIGM 5B,A00,507423,Fischer-Grunski; Eva K,19,0,20,1
1714627470597,LIGM 5C,A00,507425,Fischer-Grunski; Eva K,19,0,20,1
1714627471628,LIIT 5AS,A00,507427,Carnelos; Chiara,20,0,20,0
1714627472653,LIIT 5BS,A00,507430,Carnelos; Chiara,20,0,20,0
1714627473682,LIIT 5CS,A00,507432,Carnelos; Chiara,20,0,20,0
1714627474707,LISP 5A,A00,507541,Munoz Sanchez; Alicia,11,0,20,9
1714627475737,LISP 5B,A00,507671,Munoz Sanchez; Alicia,8,0,20,12
1714627476768,LISP 5C,A00,507696,Munoz Sanchez; Alicia,9,0,20,11
1714627477796,MAE 197,001,528363,Boechler; Nicholas Sebastia,9998,0,9999,1
1714627478823,MATH 197,001,523477,Kedlaya; Kiran S.,9995,0,9999,4
1714627478823,MATH 197,002,563811,Zhang; Danna,9995,0,9999,4
1714627478823,MATH 197,003,628552,Dumitriu; Ioana,9998,0,9999,1
1714627479853,MCWP 40R,A00,518780,Staff,2,0,20,18
1714627479853,MCWP 40R,B00,518781,Staff,8,0,20,12
1714627479853,MCWP 40R,C00,518783,Staff,6,0,20,14
1714627480877,MCWP 50R,A00,518791,Staff,0,0,20,20
1714627480877,MCWP 50R,B00,518792,Staff,0,2,20,20
1714627480877,MCWP 50R,C00,518793,Staff,0,2,20,20
1714627480877,MCWP 50R,D00,518794,Staff,0,0,20,20
1714627480877,MCWP 50R,E00,518795,Staff,0,2,20,20
1714627480877,MCWP 50R,F00,518796,Staff,0,0,20,20
1714627480877,MCWP 50R,G00,518797,Staff,0,1,20,20
1714627481905,MMW 12R,A01,514034,Herbst; Matthew,0,0,16,16
1714627481905,MMW 12R,A02,514035,Herbst; Matthew,1,0,16,15
1714627482930,MMW 13R,A01,514037,Staff,0,4,16,16
1714627482930,MMW 13R,A02,514039,Staff,0,2,16,16
1714627482930,MMW 13R,A03,628519,Staff,0,2,16,16
1714627484980,SIO 295LS,A00,523233,Staff,10,0,30,20
1714627486005,SIO 295S,A00,523232,Staff,10,0,30,20
1714627487030,SIOC 290S,A01,637330,Merrifield; Mark A,23,0,30,7
1714627488059,SIOC 291S,A01,637333,Gabriel; Corey John,23,0,30,7
1714627489085,SOCI 117,A01,494376,Staff,0,4,5,5
1714627490114,WES 237B,A00,494380,Staff,9,0,20,11
1714627492196,AESE 279B,A00,494370,Wade; Jon P,0,0,33,33
1714627493222,AIP 197,001,627712,Vespa; Emanuel Ignacio,9998,0,9999,1
1714627494247,ANAR 135S,A00,494369,Braswell; Geoffrey E.,0,0,0,0
1714627495274,BENG 196,001,628496,Engler; Adam J.,9998,0,9999,1
1714627496300,CAT 124RS,A01,519847,Geibel; William,0,0,20,20
1714627497323,CAT 125RS,A01,515971,Geibel; William,0,0,20,20
1714627498349,CLRE 250,A00,511389,Morris; Sheldon,9993,0,9999,6
1714627499377,CLRE 251,A00,507176,Mehta; Ravindra L.,9993,0,9999,6
1714627499377,CLRE 251,B00,511410,Mehta; Ravindra L.,9998,0,9999,1
1714627500408,CLRE 252,A00,507189,Cuomo; Raphael Eduardo,9995,0,9999,4
1714627501437,CLRE 253,A00,507199,Vaida; Florin,9994,0,9999,5
1714627501437,CLRE 253,B00,507202,Vaida; Florin,9999,0,9999,0
1714627502469,CLRE 259,A00,507211,Patel; Hemal,9996,0,9999,3
1714627503494,CLRE 260,A00,507221,Cuomo; Raphael Eduardo,9999,0,9999,0
1714627504521,CLRE 297,001,507242,Cuomo; Raphael Eduardo,9999,0,9999,0
1714627505550,COGS 197,001,638244,Voytek; Bradley Thomas,9998,0,9999,1
1714627506577,CSE 191,A00,516875,Minnes Kemp; Mor Mia,9992,0,9999,7
1714627507604,CSE 197,001,637388,Minnes Kemp; Mor Mia,9998,0,9999,1
1714627508633,CSS 201S,A01,494383,Staff,35,0,35,0
1714627509659,CSS 202S,A01,494387,Staff,35,0,35,0
1714627510683,DSC 197,001,628532,Eldridge; Justin Matthew,9996,0,9999,3
1714627511709,EAP 100,A00,516065,Staff,9797,0,9999,202
1714627512737,ECE 45,A01,507414,Staff,33,0,60,27
1714627514786,ECE 111,A01,507420,Staff,15,0,50,35
1714627515813,ECE 197,001,548057,Sievenpiper; Daniel F.,9993,0,9999,6
1714627516837,EDS 115,A00,507243,Choi; Bailey Miyeon,10,0,28,18
1714627517864,EDS 117,A01,494379,Staff,1,5,30,29
1714627518890,EDS 125,A00,507246,Hopkins; Megan Beth,9,0,30,21
1714627519914,EDS 128A,A01,507264,Fargason; Sharon Gayle,8,0,26,18
1714627520942,EDS 128B,A01,507293,Pappas; Elizabeth,12,0,30,18
1714627521967,EDS 139,A00,507294,Fargason; Sharon Gayle,13,0,30,17
1714627521967,EDS 139,B00,507313,Pappas; Elizabeth,13,0,30,17
1714627522995,EDS 201,A00,507315,Staff,13,0,30,17
1714627524022,EDS 203,A01,507317,Halter; Christopher P.,12,0,30,18
1714627525048,EDS 204R,A01,507319,Halter; Christopher P.,0,3,30,30
1714627525048,EDS 204R,B01,507331,Heinzman; Erica M.,16,0,30,14
1714627526074,EDS 206R,A00,507332,Staff,0,4,30,30
1714627526074,EDS 206R,B00,507343,Staff,17,0,30,13
1714627527104,EDS 250,A00,507344,Hemans; Patricia Ann Benitez,22,0,40,18
1714627528129,EDS 281,A00,507345,Daly; Alan J.,18,0,18,0
1714627529156,EDS 284,A00,507350,Daly; Alan J.,16,0,16,0
1714627530182,EDS 286,A00,507359,Fine; Sarah,18,0,18,0
1714627531207,EDS 289C,A01,507361,Daly; Alan J.,18,0,18,0
1714627532232,EDS 290,A00,507366,Hofstetter; Carolyn,15,0,15,0
1714627533259,LIGM 5A,A00,507421,Fischer-Grunski; Eva K,18,0,20,2
1714627534288,LIGM 5B,A00,507423,Fischer-Grunski; Eva K,19,0,20,1
1714627535315,LIGM 5C,A00,507425,Fischer-Grunski; Eva K,19,0,20,1
1714627536343,LIIT 5AS,A00,507427,Carnelos; Chiara,20,0,20,0
1714627537369,LIIT 5BS,A00,507430,Carnelos; Chiara,20,0,20,0
1714627538394,LIIT 5CS,A00,507432,Carnelos; Chiara,20,0,20,0
1714627539420,LISP 5A,A00,507541,Munoz Sanchez; Alicia,11,0,20,9
1714627540448,LISP 5B,A00,507671,Munoz Sanchez; Alicia,8,0,20,12
1714627541477,LISP 5C,A00,507696,Munoz Sanchez; Alicia,9,0,20,11
1714627542504,MAE 197,001,528363,Boechler; Nicholas Sebastia,9998,0,9999,1
1714627543534,MATH 197,001,523477,Kedlaya; Kiran S.,9995,0,9999,4
1714627543534,MATH 197,002,563811,Zhang; Danna,9995,0,9999,4
1714627543534,MATH 197,003,628552,Dumitriu; Ioana,9998,0,9999,1
1714627544565,MCWP 40R,A00,518780,Staff,2,0,20,18
1714627544565,MCWP 40R,B00,518781,Staff,8,0,20,12
1714627544565,MCWP 40R,C00,518783,Staff,6,0,20,14
1714627545594,MCWP 50R,A00,518791,Staff,0,0,20,20
1714627545594,MCWP 50R,B00,518792,Staff,0,2,20,20
1714627545594,MCWP 50R,C00,518793,Staff,0,2,20,20
1714627545594,MCWP 50R,D00,518794,Staff,0,0,20,20
1714627545594,MCWP 50R,E00,518795,Staff,0,2,20,20
1714627545594,MCWP 50R,F00,518796,Staff,0,0,20,20
1714627545594,MCWP 50R,G00,518797,Staff,0,1,20,20
1714627546618,MMW 12R,A01,514034,Herbst; Matthew,0,0,16,16
1714627546618,MMW 12R,A02,514035,Herbst; Matthew,1,0,16,15
1714627547644,MMW 13R,A01,514037,Staff,0,4,16,16
1714627547644,MMW 13R,A02,514039,Staff,0,2,16,16
1714627547644,MMW 13R,A03,628519,Staff,0,2,16,16
1714627549699,SIO 295LS,A00,523233,Staff,10,0,30,20
1714627550727,SIO 295S,A00,523232,Staff,10,0,30,20
1714627551753,SIOC 290S,A01,637330,Merrifield; Mark A,23,0,30,7
1714627552779,SIOC 291S,A01,637333,Gabriel; Corey John,23,0,30,7
1714627553806,SOCI 117,A01,494376,Staff,0,4,5,5
1714627554832,WES 237B,A00,494380,Staff,9,0,20,11
1714627556896,AESE 279B,A00,494370,Wade; Jon P,0,0,33,33
1714627557921,AIP 197,001,627712,Vespa; Emanuel Ignacio,9998,0,9999,1
1714627558947,ANAR 135S,A00,494369,Braswell; Geoffrey E.,0,0,0,0
1714627559973,BENG 196,001,628496,Engler; Adam J.,9998,0,9999,1
1714627561003,CAT 124RS,A01,519847,Geibel; William,0,0,20,20
1714627562028,CAT 125RS,A01,515971,Geibel; William,0,0,20,20
1714627563054,CLRE 250,A00,511389,Morris; Sheldon,9993,0,9999,6
1714627564086,CLRE 251,A00,507176,Mehta; Ravindra L.,9993,0,9999,6
1714627564086,CLRE 251,B00,511410,Mehta; Ravindra L.,9998,0,9999,1
1714627565115,CLRE 252,A00,507189,Cuomo; Raphael Eduardo,9995,0,9999,4
1714627566146,CLRE 253,A00,507199,Vaida; Florin,9994,0,9999,5
1714627566146,CLRE 253,B00,507202,Vaida; Florin,9999,0,9999,0
1714627567172,CLRE 259,A00,507211,Patel; Hemal,9996,0,9999,3
1714627568200,CLRE 260,A00,507221,Cuomo; Raphael Eduardo,9999,0,9999,0
1714627569226,CLRE 297,001,507242,Cuomo; Raphael Eduardo,9999,0,9999,0
1714627570252,COGS 197,001,638244,Voytek; Bradley Thomas,9998,0,9999,1
1714627571276,CSE 191,A00,516875,Minnes Kemp; Mor Mia,9992,0,9999,7
1714627572300,CSE 197,001,637388,Minnes Kemp; Mor Mia,9998,0,9999,1
1714627573325,CSS 201S,A01,494383,Staff,35,0,35,0
1714627574352,CSS 202S,A01,494387,Staff,35,0,35,0
1714627575376,DSC 197,001,628532,Eldridge; Justin Matthew,9996,0,9999,3
1714627576400,EAP 100,A00,516065,Staff,9797,0,9999,202
1714627577432,ECE 45,A01,507414,Staff,33,0,60,27
1714627579488,ECE 111,A01,507420,Staff,15,0,50,35
1714627580518,ECE 197,001,548057,Sievenpiper; Daniel F.,9993,0,9999,6
1714627581550,EDS 115,A00,507243,Choi; Bailey Miyeon,10,0,28,18
1714627582576,EDS 117,A01,494379,Staff,1,5,30,29
1714627583606,EDS 125,A00,507246,Hopkins; Megan Beth,9,0,30,21
1714627584632,EDS 128A,A01,507264,Fargason; Sharon Gayle,8,0,26,18
1714627585660,EDS 128B,A01,507293,Pappas; Elizabeth,12,0,30,18
1714627586694,EDS 139,A00,507294,Fargason; Sharon Gayle,13,0,30,17
1714627586694,EDS 139,B00,507313,Pappas; Elizabeth,13,0,30,17
1714627587721,EDS 201,A00,507315,Staff,13,0,30,17
1714627588748,EDS 203,A01,507317,Halter; Christopher P.,12,0,30,18
1714627589778,EDS 204R,A01,507319,Halter; Christopher P.,0,3,30,30
1714627589778,EDS 204R,B01,507331,Heinzman; Erica M.,16,0,30,14
1714627590802,EDS 206R,A00,507332,Staff,0,4,30,30
1714627590802,EDS 206R,B00,507343,Staff,17,0,30,13
1714627591826,EDS 250,A00,507344,Hemans; Patricia Ann Benitez,22,0,40,18
1714627592858,EDS 281,A00,507345,Daly; Alan J.,18,0,18,0
1714627593881,EDS 284,A00,507350,Daly; Alan J.,16,0,16,0
1714627594905,EDS 286,A00,507359,Fine; Sarah,18,0,18,0
1714627595932,EDS 289C,A01,507361,Daly; Alan J.,18,0,18,0
1714627596956,EDS 290,A00,507366,Hofstetter; Carolyn,15,0,15,0
1714627597983,LIGM 5A,A00,507421,Fischer-Grunski; Eva K,18,0,20,2
1714627599009,LIGM 5B,A00,507423,Fischer-Grunski; Eva K,19,0,20,1
1714627600035,LIGM 5C,A00,507425,Fischer-Grunski; Eva K,19,0,20,1
1714627601061,LIIT 5AS,A00,507427,Carnelos; Chiara,20,0,20,0
1714627602092,LIIT 5BS,A00,507430,Carnelos; Chiara,20,0,20,0
1714627603120,LIIT 5CS,A00,507432,Carnelos; Chiara,20,0,20,0
1714627604149,LISP 5A,A00,507541,Munoz Sanchez; Alicia,11,0,20,9
1714627605175,LISP 5B,A00,507671,Munoz Sanchez; Alicia,8,0,20,12
1714627606204,LISP 5C,A00,507696,Munoz Sanchez; Alicia,9,0,20,11
1714627607234,MAE 197,001,528363,Boechler; Nicholas Sebastia,9998,0,9999,1
1714627608261,MATH 197,001,523477,Kedlaya; Kiran S.,9995,0,9999,4
1714627608261,MATH 197,002,563811,Zhang; Danna,9995,0,9999,4
1714627608261,MATH 197,003,628552,Dumitriu; Ioana,9998,0,9999,1
1714627609286,MCWP 40R,A00,518780,Staff,2,0,20,18
1714627609286,MCWP 40R,B00,518781,Staff,8,0,20,12
1714627609286,MCWP 40R,C00,518783,Staff,6,0,20,14
1714627610312,MCWP 50R,A00,518791,Staff,0,0,20,20
1714627610312,MCWP 50R,B00,518792,Staff,0,2,20,20
1714627610312,MCWP 50R,C00,518793,Staff,0,2,20,20
1714627610312,MCWP 50R,D00,518794,Staff,0,0,20,20
1714627610312,MCWP 50R,E00,518795,Staff,0,2,20,20
1714627610312,MCWP 50R,F00,518796,Staff,0,0,20,20
1714627610312,MCWP 50R,G00,518797,Staff,0,1,20,20
1714627611341,MMW 12R,A01,514034,Herbst; Matthew,0,0,16,16
1714627611341,MMW 12R,A02,514035,Herbst; Matthew,1,0,16,15
1714627612368,MMW 13R,A01,514037,Staff,0,4,16,16
1714627612368,MMW 13R,A02,514039,Staff,0,2,16,16
1714627612368,MMW 13R,A03,628519,Staff,0,2,16,16
1714627614420,SIO 295LS,A00,523233,Staff,10,0,30,20
1714627615444,SIO 295S,A00,523232,Staff,10,0,30,20
1714627616476,SIOC 290S,A01,637330,Merrifield; Mark A,23,0,30,7
1714627617501,SIOC 291S,A01,637333,Gabriel; Corey John,23,0,30,7
1714627618531,SOCI 117,A01,494376,Staff,0,4,5,5
1714627619558,WES 237B,A00,494380,Staff,9,0,20,11
1714627621629,AESE 279B,A00,494370,Wade; Jon P,0,0,33,33
1714627622658,AIP 197,001,627712,Vespa; Emanuel Ignacio,9998,0,9999,1
1714627623686,ANAR 135S,A00,494369,Braswell; Geoffrey E.,0,0,0,0
1714627624712,BENG 196,001,628496,Engler; Adam J.,9998,0,9999,1
1714627625739,CAT 124RS,A01,519847,Geibel; William,0,0,20,20
1714627626764,CAT 125RS,A01,515971,Geibel; William,0,0,20,20
1714627627790,CLRE 250,A00,511389,Morris; Sheldon,9993,0,9999,6
1714627628820,CLRE 251,A00,507176,Mehta; Ravindra L.,9993,0,9999,6
1714627628820,CLRE 251,B00,511410,Mehta; Ravindra L.,9998,0,9999,1
1714627629846,CLRE 252,A00,507189,Cuomo; Raphael Eduardo,9995,0,9999,4
1714627630870,CLRE 253,A00,507199,Vaida; Florin,9994,0,9999,5
1714627630870,CLRE 253,B00,507202,Vaida; Florin,9999,0,9999,0
1714627631899,CLRE 259,A00,507211,Patel; Hemal,9996,0,9999,3
1714627632928,CLRE 260,A00,507221,Cuomo; Raphael Eduardo,9999,0,9999,0
1714627633954,CLRE 297,001,507242,Cuomo; Raphael Eduardo,9999,0,9999,0
1714627634979,COGS 197,001,638244,Voytek; Bradley Thomas,9998,0,9999,1
1714627636006,CSE 191,A00,516875,Minnes Kemp; Mor Mia,9992,0,9999,7
1714627637031,CSE 197,001,637388,Minnes Kemp; Mor Mia,9998,0,9999,1
1714627638057,CSS 201S,A01,494383,Staff,35,0,35,0
1714627639081,CSS 202S,A01,494387,Staff,35,0,35,0
1714627640110,DSC 197,001,628532,Eldridge; Justin Matthew,9996,0,9999,3
1714627641135,EAP 100,A00,516065,Staff,9797,0,9999,202
1714627642166,ECE 45,A01,507414,Staff,33,0,60,27
1714627644216,ECE 111,A01,507420,Staff,15,0,50,35
1714627645243,ECE 197,001,548057,Sievenpiper; Daniel F.,9993,0,9999,6
1714627646268,EDS 115,A00,507243,Choi; Bailey Miyeon,10,0,28,18
1714627647296,EDS 117,A01,494379,Staff,0,4,30,30
1714627648347,EDS 125,A00,507246,Hopkins; Megan Beth,9,0,30,21
1714627649374,EDS 128A,A01,507264,Fargason; Sharon Gayle,8,0,26,18
1714627650403,EDS 128B,A01,507293,Pappas; Elizabeth,12,0,30,18
1714627651429,EDS 139,A00,507294,Fargason; Sharon Gayle,13,0,30,17
1714627651429,EDS 139,B00,507313,Pappas; Elizabeth,13,0,30,17
1714627652455,EDS 201,A00,507315,Staff,13,0,30,17
1714627653484,EDS 203,A01,507317,Halter; Christopher P.,12,0,30,18
1714627654516,EDS 204R,A01,507319,Halter; Christopher P.,0,3,30,30
1714627654516,EDS 204R,B01,507331,Heinzman; Erica M.,16,0,30,14
1714627655540,EDS 206R,A00,507332,Staff,0,4,30,30
1714627655540,EDS 206R,B00,507343,Staff,17,0,30,13
1714627656569,EDS 250,A00,507344,Hemans; Patricia Ann Benitez,22,0,40,18
1714627657595,EDS 281,A00,507345,Daly; Alan J.,18,0,18,0
1714627658621,EDS 284,A00,507350,Daly; Alan J.,16,0,16,0
1714627659651,EDS 286,A00,507359,Fine; Sarah,18,0,18,0
1714627660674,EDS 289C,A01,507361,Daly; Alan J.,18,0,18,0
1714627661701,EDS 290,A00,507366,Hofstetter; Carolyn,15,0,15,0
1714627662728,LIGM 5A,A00,507421,Fischer-Grunski; Eva K,18,0,20,2
1714627663752,LIGM 5B,A00,507423,Fischer-Grunski; Eva K,19,0,20,1
1714627664778,LIGM 5C,A00,507425,Fischer-Grunski; Eva K,19,0,20,1
1714627665807,LIIT 5AS,A00,507427,Carnelos; Chiara,20,0,20,0
1714627666835,LIIT 5BS,A00,507430,Carnelos; Chiara,20,0,20,0
1714627667861,LIIT 5CS,A00,507432,Carnelos; Chiara,20,0,20,0
1714627668891,LISP 5A,A00,507541,Munoz Sanchez; Alicia,11,0,20,9
1714627669916,LISP 5B,A00,507671,Munoz Sanchez; Alicia,8,0,20,12
1714627670942,LISP 5C,A00,507696,Munoz Sanchez; Alicia,9,0,20,11
1714627671969,MAE 197,001,528363,Boechler; Nicholas Sebastia,9998,0,9999,1
1714627673002,MATH 197,001,523477,Kedlaya; Kiran S.,9995,0,9999,4
1714627673002,MATH 197,002,563811,Zhang; Danna,9995,0,9999,4
1714627673002,MATH 197,003,628552,Dumitriu; Ioana,9998,0,9999,1
1714627674030,MCWP 40R,A00,518780,Staff,2,0,20,18
1714627674030,MCWP 40R,B00,518781,Staff,8,0,20,12
1714627674030,MCWP 40R,C00,518783,Staff,6,0,20,14
1714627675053,MCWP 50R,A00,518791,Staff,0,0,20,20
1714627675053,MCWP 50R,B00,518792,Staff,0,2,20,20
1714627675053,MCWP 50R,C00,518793,Staff,0,2,20,20
1714627675053,MCWP 50R,D00,518794,Staff,0,0,20,20
1714627675053,MCWP 50R,E00,518795,Staff,0,2,20,20
1714627675053,MCWP 50R,F00,518796,Staff,0,0,20,20
1714627675053,MCWP 50R,G00,518797,Staff,0,1,20,20
1714627676079,MMW 12R,A01,514034,Herbst; Matthew,0,0,16,16
1714627676079,MMW 12R,A02,514035,Herbst; Matthew,1,0,16,15
1714627677106,MMW 13R,A01,514037,Staff,0,4,16,16
1714627677106,MMW 13R,A02,514039,Staff,0,2,16,16
1714627677106,MMW 13R,A03,628519,Staff,0,2,16,16
1714627679156,SIO 295LS,A00,523233,Staff,10,0,30,20
1714627680183,SIO 295S,A00,523232,Staff,10,0,30,20
1714627681209,SIOC 290S,A01,637330,Merrifield; Mark A,23,0,30,7
1714627682234,SIOC 291S,A01,637333,Gabriel; Corey John,23,0,30,7
1714627683262,SOCI 117,A01,494376,Staff,0,4,5,5
1714627684290,WES 237B,A00,494380,Staff,9,0,20,11
1714627686366,AESE 279B,A00,494370,Wade; Jon P,0,0,33,33
1714627687395,AIP 197,001,627712,Vespa; Emanuel Ignacio,9998,0,9999,1
1714627688421,ANAR 135S,A00,494369,Braswell; Geoffrey E.,0,0,0,0
1714627689448,BENG 196,001,628496,Engler; Adam J.,9998,0,9999,1
1714627690478,CAT 124RS,A01,519847,Geibel; William,0,0,20,20
1714627691504,CAT 125RS,A01,515971,Geibel; William,0,0,20,20
1714627692533,CLRE 250,A00,511389,Morris; Sheldon,9993,0,9999,6
1714627693560,CLRE 251,A00,507176,Mehta; Ravindra L.,9993,0,9999,6
1714627693560,CLRE 251,B00,511410,Mehta; Ravindra L.,9998,0,9999,1
1714627694592,CLRE 252,A00,507189,Cuomo; Raphael Eduardo,9995,0,9999,4
1714627695618,CLRE 253,A00,507199,Vaida; Florin,9994,0,9999,5
1714627695618,CLRE 253,B00,507202,Vaida; Florin,9999,0,9999,0
1714627696644,CLRE 259,A00,507211,Patel; Hemal,9996,0,9999,3
1714627697668,CLRE 260,A00,507221,Cuomo; Raphael Eduardo,9999,0,9999,0
1714627698695,CLRE 297,001,507242,Cuomo; Raphael Eduardo,9999,0,9999,0
1714627699720,COGS 197,001,638244,Voytek; Bradley Thomas,9998,0,9999,1
1714627700749,CSE 191,A00,516875,Minnes Kemp; Mor Mia,9992,0,9999,7
1714627701774,CSE 197,001,637388,Minnes Kemp; Mor Mia,9998,0,9999,1
1714627702800,CSS 201S,A01,494383,Staff,35,0,35,0
1714627703826,CSS 202S,A01,494387,Staff,35,0,35,0
1714627704853,DSC 197,001,628532,Eldridge; Justin Matthew,9996,0,9999,3
1714627705878,EAP 100,A00,516065,Staff,9797,0,9999,202
1714627706907,ECE 45,A01,507414,Staff,33,0,60,27
1714627708968,ECE 111,A01,507420,Staff,15,0,50,35
1714627709993,ECE 197,001,548057,Sievenpiper; Daniel F.,9993,0,9999,6
1714627711022,EDS 115,A00,507243,Choi; Bailey Miyeon,10,0,28,18
1714627712048,EDS 117,A01,494379,Staff,0,4,30,30
1714627713078,EDS 125,A00,507246,Hopkins; Megan Beth,9,0,30,21
1714627714107,EDS 128A,A01,507264,Fargason; Sharon Gayle,8,0,26,18
1714627715135,EDS 128B,A01,507293,Pappas; Elizabeth,12,0,30,18
1714627716159,EDS 139,A00,507294,Fargason; Sharon Gayle,13,0,30,17
1714627716159,EDS 139,B00,507313,Pappas; Elizabeth,13,0,30,17
1714627717186,EDS 201,A00,507315,Staff,13,0,30,17
1714627718211,EDS 203,A01,507317,Halter; Christopher P.,12,0,30,18
1714627719239,EDS 204R,A01,507319,Halter; Christopher P.,0,3,30,30
1714627719239,EDS 204R,B01,507331,Heinzman; Erica M.,16,0,30,14
1714627720265,EDS 206R,A00,507332,Staff,0,4,30,30
1714627720265,EDS 206R,B00,507343,Staff,17,0,30,13
1714627721295,EDS 250,A00,507344,Hemans; Patricia Ann Benitez,22,0,40,18
1714627722320,EDS 281,A00,507345,Daly; Alan J.,18,0,18,0
1714627723344,EDS 284,A00,507350,Daly; Alan J.,16,0,16,0
1714627724370,EDS 286,A00,507359,Fine; Sarah,18,0,18,0
1714627725396,EDS 289C,A01,507361,Daly; Alan J.,18,0,18,0
1714627726424,EDS 290,A00,507366,Hofstetter; Carolyn,15,0,15,0
1714627727452,LIGM 5A,A00,507421,Fischer-Grunski; Eva K,18,0,20,2
1714627728478,LIGM 5B,A00,507423,Fischer-Grunski; Eva K,19,0,20,1
1714627729504,LIGM 5C,A00,507425,Fischer-Grunski; Eva K,19,0,20,1
1714627730536,LIIT 5AS,A00,507427,Carnelos; Chiara,20,0,20,0
1714627731566,LIIT 5BS,A00,507430,Carnelos; Chiara,20,0,20,0
1714627732591,LIIT 5CS,A00,507432,Carnelos; Chiara,20,0,20,0
1714627733620,LISP 5A,A00,507541,Munoz Sanchez; Alicia,11,0,20,9
1714627734645,LISP 5B,A00,507671,Munoz Sanchez; Alicia,8,0,20,12
1714627735671,LISP 5C,A00,507696,Munoz Sanchez; Alicia,9,0,20,11
1714627736701,MAE 197,001,528363,Boechler; Nicholas Sebastia,9998,0,9999,1
1714627737728,MATH 197,001,523477,Kedlaya; Kiran S.,9995,0,9999,4
1714627737728,MATH 197,002,563811,Zhang; Danna,9995,0,9999,4
1714627737728,MATH 197,003,628552,Dumitriu; Ioana,9998,0,9999,1
1714627738759,MCWP 40R,A00,518780,Staff,2,0,20,18
1714627738759,MCWP 40R,B00,518781,Staff,8,0,20,12
1714627738759,MCWP 40R,C00,518783,Staff,6,0,20,14
1714627739812,MCWP 50R,A00,518791,Staff,0,0,20,20
1714627739812,MCWP 50R,B00,518792,Staff,0,2,20,20
1714627739812,MCWP 50R,C00,518793,Staff,0,2,20,20
1714627739812,MCWP 50R,D00,518794,Staff,0,0,20,20
1714627739812,MCWP 50R,E00,518795,Staff,0,2,20,20
1714627739812,MCWP 50R,F00,518796,Staff,0,0,20,20
1714627739812,MCWP 50R,G00,518797,Staff,0,1,20,20
1714627740837,MMW 12R,A01,514034,Herbst; Matthew,0,0,16,16
1714627740837,MMW 12R,A02,514035,Herbst; Matthew,1,0,16,15
1714627741863,MMW 13R,A01,514037,Staff,0,4,16,16
1714627741863,MMW 13R,A02,514039,Staff,0,2,16,16
1714627741863,MMW 13R,A03,628519,Staff,0,2,16,16
1714627743913,SIO 295LS,A00,523233,Staff,10,0,30,20
1714627744944,SIO 295S,A00,523232,Staff,10,0,30,20
1714627745970,SIOC 290S,A01,637330,Merrifield; Mark A,23,0,30,7
1714627747000,SIOC 291S,A01,637333,Gabriel; Corey John,23,0,30,7
1714627748029,SOCI 117,A01,494376,Staff,0,4,5,5
1714627749056,WES 237B,A00,494380,Staff,9,0,20,11
1714627751127,AESE 279B,A00,494370,Wade; Jon P,0,0,33,33
1714627752152,AIP 197,001,627712,Vespa; Emanuel Ignacio,9998,0,9999,1
1714627753180,ANAR 135S,A00,494369,Braswell; Geoffrey E.,0,0,0,0
1714627754205,BENG 196,001,628496,Engler; Adam J.,9998,0,9999,1
1714627755229,CAT 124RS,A01,519847,Geibel; William,0,0,20,20
1714627756257,CAT 125RS,A01,515971,Geibel; William,0,0,20,20
1714627757283,CLRE 250,A00,511389,Morris; Sheldon,9993,0,9999,6
1714627758318,CLRE 251,A00,507176,Mehta; Ravindra L.,9993,0,9999,6
1714627758318,CLRE 251,B00,511410,Mehta; Ravindra L.,9998,0,9999,1
1714627759347,CLRE 252,A00,507189,Cuomo; Raphael Eduardo,9995,0,9999,4
1714627760374,CLRE 253,A00,507199,Vaida; Florin,9994,0,9999,5
1714627760374,CLRE 253,B00,507202,Vaida; Florin,9999,0,9999,0
1714627761401,CLRE 259,A00,507211,Patel; Hemal,9996,0,9999,3
1714627762430,CLRE 260,A00,507221,Cuomo; Raphael Eduardo,9999,0,9999,0
1714627763460,CLRE 297,001,507242,Cuomo; Raphael Eduardo,9999,0,9999,0
1714627764489,COGS 197,001,638244,Voytek; Bradley Thomas,9998,0,9999,1
1714627765514,CSE 191,A00,516875,Minnes Kemp; Mor Mia,9992,0,9999,7
1714627766539,CSE 197,001,637388,Minnes Kemp; Mor Mia,9998,0,9999,1
1714627767571,CSS 201S,A01,494383,Staff,35,0,35,0
1714627768595,CSS 202S,A01,494387,Staff,35,0,35,0
1714627769620,DSC 197,001,628532,Eldridge; Justin Matthew,9996,0,9999,3
1714627770644,EAP 100,A00,516065,Staff,9797,0,9999,202
1714627771669,ECE 45,A01,507414,Staff,33,0,60,27
1714627773718,ECE 111,A01,507420,Staff,15,0,50,35
1714627774744,ECE 197,001,548057,Sievenpiper; Daniel F.,9993,0,9999,6
1714627775774,EDS 115,A00,507243,Choi; Bailey Miyeon,10,0,28,18
1714627776799,EDS 117,A01,494379,Staff,0,4,30,30
1714627777824,EDS 125,A00,507246,Hopkins; Megan Beth,9,0,30,21
1714627778861,EDS 128A,A01,507264,Fargason; Sharon Gayle,8,0,26,18
1714627779891,EDS 128B,A01,507293,Pappas; Elizabeth,12,0,30,18
1714627780918,EDS 139,A00,507294,Fargason; Sharon Gayle,13,0,30,17
1714627780918,EDS 139,B00,507313,Pappas; Elizabeth,13,0,30,17
1714627781946,EDS 201,A00,507315,Staff,13,0,30,17
1714627782974,EDS 203,A01,507317,Halter; Christopher P.,12,0,30,18
1714627784003,EDS 204R,A01,507319,Halter; Christopher P.,0,3,30,30
1714627784003,EDS 204R,B01,507331,Heinzman; Erica M.,16,0,30,14
1714627785029,EDS 206R,A00,507332,Staff,0,4,30,30
1714627785029,EDS 206R,B00,507343,Staff,17,0,30,13
1714627786057,EDS 250,A00,507344,Hemans; Patricia Ann Benitez,22,0,40,18
1714627787082,EDS 281,A00,507345,Daly; Alan J.,18,0,18,0
1714627788109,EDS 284,A00,507350,Daly; Alan J.,16,0,16,0
1714627789135,EDS 286,A00,507359,Fine; Sarah,18,0,18,0
1714627790160,EDS 289C,A01,507361,Daly; Alan J.,18,0,18,0
1714627791186,EDS 290,A00,507366,Hofstetter; Carolyn,15,0,15,0
1714627792212,LIGM 5A,A00,507421,Fischer-Grunski; Eva K,18,0,20,2
1714627793239,LIGM 5B,A00,507423,Fischer-Grunski; Eva K,19,0,20,1
1714627794265,LIGM 5C,A00,507425,Fischer-Grunski; Eva K,19,0,20,1
1714627795292,LIIT 5AS,A00,507427,Carnelos; Chiara,20,0,20,0
1714627796322,LIIT 5BS,A00,507430,Carnelos; Chiara,20,0,20,0
1714627797347,LIIT 5CS,A00,507432,Carnelos; Chiara,20,0,20,0
1714627798373,LISP 5A,A00,507541,Munoz Sanchez; Alicia,11,0,20,9
1714627799400,LISP 5B,A00,507671,Munoz Sanchez; Alicia,8,0,20,12
1714627800430,LISP 5C,A00,507696,Munoz Sanchez; Alicia,9,0,20,11
1714627801460,MAE 197,001,528363,Boechler; Nicholas Sebastia,9998,0,9999,1
1714627802494,MATH 197,001,523477,Kedlaya; Kiran S.,9995,0,9999,4
1714627802494,MATH 197,002,563811,Zhang; Danna,9995,0,9999,4
1714627802494,MATH 197,003,628552,Dumitriu; Ioana,9998,0,9999,1
1714627803525,MCWP 40R,A00,518780,Staff,2,0,20,18
1714627803525,MCWP 40R,B00,518781,Staff,8,0,20,12
1714627803525,MCWP 40R,C00,518783,Staff,6,0,20,14
1714627804550,MCWP 50R,A00,518791,Staff,0,0,20,20
1714627804550,MCWP 50R,B00,518792,Staff,0,2,20,20
1714627804550,MCWP 50R,C00,518793,Staff,0,2,20,20
1714627804550,MCWP 50R,D00,518794,Staff,0,0,20,20
1714627804550,MCWP 50R,E00,518795,Staff,0,2,20,20
1714627804550,MCWP 50R,F00,518796,Staff,0,0,20,20
1714627804550,MCWP 50R,G00,518797,Staff,0,1,20,20
1714627805574,MMW 12R,A01,514034,Herbst; Matthew,0,0,16,16
1714627805574,MMW 12R,A02,514035,Herbst; Matthew,1,0,16,15
1714627806604,MMW 13R,A01,514037,Staff,0,4,16,16
1714627806604,MMW 13R,A02,514039,Staff,0,2,16,16
1714627806604,MMW 13R,A03,628519,Staff,0,2,16,16
1714627808699,SIO 295LS,A00,523233,Staff,10,0,30,20
1714627809725,SIO 295S,A00,523232,Staff,10,0,30,20
1714627810753,SIOC 290S,A01,637330,Merrifield; Mark A,23,0,30,7
1714627811783,SIOC 291S,A01,637333,Gabriel; Corey John,23,0,30,7
1714627812810,SOCI 117,A01,494376,Staff,0,4,5,5
1714627813839,WES 237B,A00,494380,Staff,9,0,20,11
1714627815920,AESE 279B,A00,494370,Wade; Jon P,0,0,33,33
1714627816948,AIP 197,001,627712,Vespa; Emanuel Ignacio,9998,0,9999,1
1714627817974,ANAR 135S,A00,494369,Braswell; Geoffrey E.,0,0,0,0
1714627818999,BENG 196,001,628496,Engler; Adam J.,9998,0,9999,1
1714627820028,CAT 124RS,A01,519847,Geibel; William,0,0,20,20
1714627821054,CAT 125RS,A01,515971,Geibel; William,0,0,20,20
1714627822080,CLRE 250,A00,511389,Morris; Sheldon,9993,0,9999,6
1714627823109,CLRE 251,A00,507176,Mehta; Ravindra L.,9993,0,9999,6
1714627823109,CLRE 251,B00,511410,Mehta; Ravindra L.,9998,0,9999,1
1714627824136,CLRE 252,A00,507189,Cuomo; Raphael Eduardo,9995,0,9999,4
1714627825166,CLRE 253,A00,507199,Vaida; Florin,9994,0,9999,5
1714627825166,CLRE 253,B00,507202,Vaida; Florin,9999,0,9999,0
1714627826191,CLRE 259,A00,507211,Patel; Hemal,9996,0,9999,3
1714627827216,CLRE 260,A00,507221,Cuomo; Raphael Eduardo,9999,0,9999,0
1714627828240,CLRE 297,001,507242,Cuomo; Raphael Eduardo,9999,0,9999,0
1714627829265,COGS 197,001,638244,Voytek; Bradley Thomas,9998,0,9999,1
1714627830290,CSE 191,A00,516875,Minnes Kemp; Mor Mia,9992,0,9999,7
1714627831320,CSE 197,001,637388,Minnes Kemp; Mor Mia,9998,0,9999,1
1714627832346,CSS 201S,A01,494383,Staff,35,0,35,0
1714627833377,CSS 202S,A01,494387,Staff,35,0,35,0
1714627834400,DSC 197,001,628532,Eldridge; Justin Matthew,9996,0,9999,3
1714627835426,EAP 100,A00,516065,Staff,9797,0,9999,202
1714627836452,ECE 45,A01,507414,Staff,33,0,60,27
1714627838500,ECE 111,A01,507420,Staff,15,0,50,35
1714627839530,ECE 197,001,548057,Sievenpiper; Daniel F.,9993,0,9999,6
1714627840557,EDS 115,A00,507243,Choi; Bailey Miyeon,10,0,28,18
1714627841582,EDS 117,A01,494379,Staff,0,4,30,30
1714627842608,EDS 125,A00,507246,Hopkins; Megan Beth,9,0,30,21
1714627843636,EDS 128A,A01,507264,Fargason; Sharon Gayle,8,0,26,18
1714627844666,EDS 128B,A01,507293,Pappas; Elizabeth,12,0,30,18
1714627845692,EDS 139,A00,507294,Fargason; Sharon Gayle,13,0,30,17
1714627845692,EDS 139,B00,507313,Pappas; Elizabeth,13,0,30,17
1714627846720,EDS 201,A00,507315,Staff,13,0,30,17
1714627847750,EDS 203,A01,507317,Halter; Christopher P.,12,0,30,18
1714627848780,EDS 204R,A01,507319,Halter; Christopher P.,0,3,30,30
1714627848780,EDS 204R,B01,507331,Heinzman; Erica M.,16,0,30,14
1714627849807,EDS 206R,A00,507332,Staff,0,4,30,30
1714627849807,EDS 206R,B00,507343,Staff,17,0,30,13
1714627850833,EDS 250,A00,507344,Hemans; Patricia Ann Benitez,22,0,40,18
1714627851858,EDS 281,A00,507345,Daly; Alan J.,18,0,18,0
1714627852885,EDS 284,A00,507350,Daly; Alan J.,16,0,16,0
1714627853915,EDS 286,A00,507359,Fine; Sarah,18,0,18,0
1714627854942,EDS 289C,A01,507361,Daly; Alan J.,18,0,18,0
1714627855968,EDS 290,A00,507366,Hofstetter; Carolyn,15,0,15,0
1714627856998,LIGM 5A,A00,507421,Fischer-Grunski; Eva K,18,0,20,2
1714627858022,LIGM 5B,A00,507423,Fischer-Grunski; Eva K,19,0,20,1
1714627859050,LIGM 5C,A00,507425,Fischer-Grunski; Eva K,19,0,20,1
1714627860083,LIIT 5AS,A00,507427,Carnelos; Chiara,20,0,20,0
1714627861112,LIIT 5BS,A00,507430,Carnelos; Chiara,20,0,20,0
1714627862141,LIIT 5CS,A00,507432,Carnelos; Chiara,20,0,20,0
1714627863170,LISP 5A,A00,507541,Munoz Sanchez; Alicia,11,0,20,9
1714627864196,LISP 5B,A00,507671,Munoz Sanchez; Alicia,8,0,20,12
1714627865224,LISP 5C,A00,507696,Munoz Sanchez; Alicia,9,0,20,11
1714627866251,MAE 197,001,528363,Boechler; Nicholas Sebastia,9998,0,9999,1
1714627867277,MATH 197,001,523477,Kedlaya; Kiran S.,9995,0,9999,4
1714627867277,MATH 197,002,563811,Zhang; Danna,9995,0,9999,4
1714627867277,MATH 197,003,628552,Dumitriu; Ioana,9998,0,9999,1
1714627868308,MCWP 40R,A00,518780,Staff,2,0,20,18
1714627868308,MCWP 40R,B00,518781,Staff,8,0,20,12
1714627868308,MCWP 40R,C00,518783,Staff,6,0,20,14
1714627869338,MCWP 50R,A00,518791,Staff,0,0,20,20
1714627869338,MCWP 50R,B00,518792,Staff,0,2,20,20
1714627869338,MCWP 50R,C00,518793,Staff,0,2,20,20
1714627869338,MCWP 50R,D00,518794,Staff,0,0,20,20
1714627869338,MCWP 50R,E00,518795,Staff,0,2,20,20
1714627869338,MCWP 50R,F00,518796,Staff,0,0,20,20
1714627869338,MCWP 50R,G00,518797,Staff,0,1,20,20
1714627870368,MMW 12R,A01,514034,Herbst; Matthew,0,0,16,16
1714627870368,MMW 12R,A02,514035,Herbst; Matthew,1,0,16,15
1714627871394,MMW 13R,A01,514037,Staff,0,4,16,16
1714627871394,MMW 13R,A02,514039,Staff,0,2,16,16
1714627871394,MMW 13R,A03,628519,Staff,0,2,16,16
1714627873443,SIO 295LS,A00,523233,Staff,10,0,30,20
1714627874469,SIO 295S,A00,523232,Staff,10,0,30,20
1714627875495,SIOC 290S,A01,637330,Merrifield; Mark A,23,0,30,7
1714627876522,SIOC 291S,A01,637333,Gabriel; Corey John,23,0,30,7
1714627877550,SOCI 117,A01,494376,Staff,0,4,5,5
1714627878579,WES 237B,A00,494380,Staff,9,0,20,11
1714627880652,AESE 279B,A00,494370,Wade; Jon P,0,0,33,33
1714627881678,AIP 197,001,627712,Vespa; Emanuel Ignacio,9998,0,9999,1
1714627882703,ANAR 135S,A00,494369,Braswell; Geoffrey E.,0,0,0,0
1714627883728,BENG 196,001,628496,Engler; Adam J.,9998,0,9999,1
1714627884758,CAT 124RS,A01,519847,Geibel; William,0,0,20,20
1714627885785,CAT 125RS,A01,515971,Geibel; William,0,0,20,20
1714627886811,CLRE 250,A00,511389,Morris; Sheldon,9993,0,9999,6
1714627887839,CLRE 251,A00,507176,Mehta; Ravindra L.,9993,0,9999,6
1714627887839,CLRE 251,B00,511410,Mehta; Ravindra L.,9998,0,9999,1
1714627888864,CLRE 252,A00,507189,Cuomo; Raphael Eduardo,9995,0,9999,4
1714627889891,CLRE 253,A00,507199,Vaida; Florin,9994,0,9999,5
1714627889891,CLRE 253,B00,507202,Vaida; Florin,9999,0,9999,0
1714627890920,CLRE 259,A00,507211,Patel; Hemal,9996,0,9999,3
1714627891944,CLRE 260,A00,507221,Cuomo; Raphael Eduardo,9999,0,9999,0
1714627892972,CLRE 297,001,507242,Cuomo; Raphael Eduardo,9999,0,9999,0
1714627894000,COGS 197,001,638244,Voytek; Bradley Thomas,9998,0,9999,1
1714627895026,CSE 191,A00,516875,Minnes Kemp; Mor Mia,9992,0,9999,7
1714627896051,CSE 197,001,637388,Minnes Kemp; Mor Mia,9998,0,9999,1
1714627897077,CSS 201S,A01,494383,Staff,35,0,35,0
1714627898103,CSS 202S,A01,494387,Staff,35,0,35,0
1714627899130,DSC 197,001,628532,Eldridge; Justin Matthew,9996,0,9999,3
1714627900157,EAP 100,A00,516065,Staff,9797,0,9999,202
1714627901183,ECE 45,A01,507414,Staff,33,0,60,27
1714627903231,ECE 111,A01,507420,Staff,15,0,50,35
1714627904259,ECE 197,001,548057,Sievenpiper; Daniel F.,9993,0,9999,6
1714627905284,EDS 115,A00,507243,Choi; Bailey Miyeon,10,0,28,18
1714627906308,EDS 117,A01,494379,Staff,0,4,30,30
1714627907336,EDS 125,A00,507246,Hopkins; Megan Beth,9,0,30,21
1714627908366,EDS 128A,A01,507264,Fargason; Sharon Gayle,8,0,26,18
1714627909392,EDS 128B,A01,507293,Pappas; Elizabeth,12,0,30,18
1714627910416,EDS 139,A00,507294,Fargason; Sharon Gayle,13,0,30,17
1714627910416,EDS 139,B00,507313,Pappas; Elizabeth,13,0,30,17
1714627911445,EDS 201,A00,507315,Staff,13,0,30,17
1714627912476,EDS 203,A01,507317,Halter; Christopher P.,12,0,30,18
1714627913502,EDS 204R,A01,507319,Halter; Christopher P.,0,3,30,30
1714627913502,EDS 204R,B01,507331,Heinzman; Erica M.,16,0,30,14
1714627914528,EDS 206R,A00,507332,Staff,0,4,30,30
1714627914528,EDS 206R,B00,507343,Staff,17,0,30,13
1714627915555,EDS 250,A00,507344,Hemans; Patricia Ann Benitez,22,0,40,18
1714627916582,EDS 281,A00,507345,Daly; Alan J.,18,0,18,0
1714627917610,EDS 284,A00,507350,Daly; Alan J.,16,0,16,0
1714627918640,EDS 286,A00,507359,Fine; Sarah,18,0,18,0
1714627919668,EDS 289C,A01,507361,Daly; Alan J.,18,0,18,0
1714627920695,EDS 290,A00,507366,Hofstetter; Carolyn,15,0,15,0
1714627921722,LIGM 5A,A00,507421,Fischer-Grunski; Eva K,18,0,20,2
1714627922753,LIGM 5B,A00,507423,Fischer-Grunski; Eva K,19,0,20,1
1714627923779,LIGM 5C,A00,507425,Fischer-Grunski; Eva K,19,0,20,1
1714627924804,LIIT 5AS,A00,507427,Carnelos; Chiara,20,0,20,0
1714627925829,LIIT 5BS,A00,507430,Carnelos; Chiara,20,0,20,0
1714627926854,LIIT 5CS,A00,507432,Carnelos; Chiara,20,0,20,0
1714627927879,LISP 5A,A00,507541,Munoz Sanchez; Alicia,11,0,20,9
1714627928904,LISP 5B,A00,507671,Munoz Sanchez; Alicia,8,0,20,12
1714627929930,LISP 5C,A00,507696,Munoz Sanchez; Alicia,9,0,20,11
1714627930957,MAE 197,001,528363,Boechler; Nicholas Sebastia,9998,0,9999,1
1714627931985,MATH 197,001,523477,Kedlaya; Kiran S.,9995,0,9999,4
1714627931985,MATH 197,002,563811,Zhang; Danna,9995,0,9999,4
1714627931985,MATH 197,003,628552,Dumitriu; Ioana,9998,0,9999,1
1714627933011,MCWP 40R,A00,518780,Staff,2,0,20,18
1714627933011,MCWP 40R,B00,518781,Staff,8,0,20,12
1714627933011,MCWP 40R,C00,518783,Staff,6,0,20,14
1714627934037,MCWP 50R,A00,518791,Staff,0,0,20,20
1714627934037,MCWP 50R,B00,518792,Staff,0,2,20,20
1714627934037,MCWP 50R,C00,518793,Staff,0,2,20,20
1714627934037,MCWP 50R,D00,518794,Staff,0,0,20,20
1714627934037,MCWP 50R,E00,518795,Staff,0,2,20,20
1714627934037,MCWP 50R,F00,518796,Staff,0,0,20,20
1714627934037,MCWP 50R,G00,518797,Staff,0,1,20,20
1714627935062,MMW 12R,A01,514034,Herbst; Matthew,0,0,16,16
1714627935062,MMW 12R,A02,514035,Herbst; Matthew,1,0,16,15
1714627936087,MMW 13R,A01,514037,Staff,0,4,16,16
1714627936087,MMW 13R,A02,514039,Staff,0,2,16,16
1714627936087,MMW 13R,A03,628519,Staff,0,2,16,16
1714627938140,SIO 295LS,A00,523233,Staff,10,0,30,20
1714627939167,SIO 295S,A00,523232,Staff,10,0,30,20
1714627940198,SIOC 290S,A01,637330,Merrifield; Mark A,23,0,30,7
1714627941225,SIOC 291S,A01,637333,Gabriel; Corey John,23,0,30,7
1714627942254,SOCI 117,A01,494376,Staff,0,4,5,5
1714627943278,WES 237B,A00,494380,Staff,9,0,20,11
1714627945335,AESE 279B,A00,494370,Wade; Jon P,0,0,33,33
1714627946362,AIP 197,001,627712,Vespa; Emanuel Ignacio,9998,0,9999,1
1714627947388,ANAR 135S,A00,494369,Braswell; Geoffrey E.,0,0,0,0
1714627948413,BENG 196,001,628496,Engler; Adam J.,9998,0,9999,1
1714627949438,CAT 124RS,A01,519847,Geibel; William,0,0,20,20
1714627950466,CAT 125RS,A01,515971,Geibel; William,0,0,20,20
1714627951495,CLRE 250,A00,511389,Morris; Sheldon,9993,0,9999,6
1714627952525,CLRE 251,A00,507176,Mehta; Ravindra L.,9993,0,9999,6
1714627952525,CLRE 251,B00,511410,Mehta; Ravindra L.,9998,0,9999,1
1714627953557,CLRE 252,A00,507189,Cuomo; Raphael Eduardo,9995,0,9999,4
1714627954584,CLRE 253,A00,507199,Vaida; Florin,9994,0,9999,5
1714627954584,CLRE 253,B00,507202,Vaida; Florin,9999,0,9999,0
1714627955608,CLRE 259,A00,507211,Patel; Hemal,9996,0,9999,3
1714627956634,CLRE 260,A00,507221,Cuomo; Raphael Eduardo,9999,0,9999,0
1714627957662,CLRE 297,001,507242,Cuomo; Raphael Eduardo,9999,0,9999,0
1714627958688,COGS 197,001,638244,Voytek; Bradley Thomas,9998,0,9999,1
1714627959718,CSE 191,A00,516875,Minnes Kemp; Mor Mia,9992,0,9999,7
1714627960746,CSE 197,001,637388,Minnes Kemp; Mor Mia,9998,0,9999,1
1714627961772,CSS 201S,A01,494383,Staff,35,0,35,0
1714627962798,CSS 202S,A01,494387,Staff,35,0,35,0
1714627963827,DSC 197,001,628532,Eldridge; Justin Matthew,9996,0,9999,3
1714627964853,EAP 100,A00,516065,Staff,9797,0,9999,202
1714627965881,ECE 45,A01,507414,Staff,33,0,60,27
1714627967935,ECE 111,A01,507420,Staff,15,0,50,35
1714627969015,ECE 197,001,548057,Sievenpiper; Daniel F.,9993,0,9999,6
1714627970042,EDS 115,A00,507243,Choi; Bailey Miyeon,10,0,28,18
1714627971068,EDS 117,A01,494379,Staff,0,4,30,30
1714627972096,EDS 125,A00,507246,Hopkins; Megan Beth,9,0,30,21
1714627973125,EDS 128A,A01,507264,Fargason; Sharon Gayle,8,0,26,18
1714627974152,EDS 128B,A01,507293,Pappas; Elizabeth,12,0,30,18
1714627975177,EDS 139,A00,507294,Fargason; Sharon Gayle,13,0,30,17
1714627975177,EDS 139,B00,507313,Pappas; Elizabeth,13,0,30,17
1714627976205,EDS 201,A00,507315,Staff,13,0,30,17
1714627977234,EDS 203,A01,507317,Halter; Christopher P.,12,0,30,18
1714627978260,EDS 204R,A01,507319,Halter; Christopher P.,0,3,30,30
1714627978260,EDS 204R,B01,507331,Heinzman; Erica M.,16,0,30,14
1714627979285,EDS 206R,A00,507332,Staff,0,4,30,30
1714627979285,EDS 206R,B00,507343,Staff,17,0,30,13
1714627980312,EDS 250,A00,507344,Hemans; Patricia Ann Benitez,22,0,40,18
1714627981338,EDS 281,A00,507345,Daly; Alan J.,18,0,18,0
1714627982363,EDS 284,A00,507350,Daly; Alan J.,16,0,16,0
1714627983394,EDS 286,A00,507359,Fine; Sarah,18,0,18,0
1714627984417,EDS 289C,A01,507361,Daly; Alan J.,18,0,18,0
1714627985443,EDS 290,A00,507366,Hofstetter; Carolyn,15,0,15,0
1714627986470,LIGM 5A,A00,507421,Fischer-Grunski; Eva K,18,0,20,2
1714627987494,LIGM 5B,A00,507423,Fischer-Grunski; Eva K,19,0,20,1
1714627988519,LIGM 5C,A00,507425,Fischer-Grunski; Eva K,19,0,20,1
1714627989549,LIIT 5AS,A00,507427,Carnelos; Chiara,20,0,20,0
1714627990573,LIIT 5BS,A00,507430,Carnelos; Chiara,20,0,20,0
1714627991606,LIIT 5CS,A00,507432,Carnelos; Chiara,20,0,20,0
1714627992632,LISP 5A,A00,507541,Munoz Sanchez; Alicia,11,0,20,9
1714627993657,LISP 5B,A00,507671,Munoz Sanchez; Alicia,8,0,20,12
1714627994682,LISP 5C,A00,507696,Munoz Sanchez; Alicia,9,0,20,11
1714627995710,MAE 197,001,528363,Boechler; Nicholas Sebastia,9998,0,9999,1
1714627996735,MATH 197,001,523477,Kedlaya; Kiran S.,9995,0,9999,4
1714627996735,MATH 197,002,563811,Zhang; Danna,9995,0,9999,4
1714627996735,MATH 197,003,628552,Dumitriu; Ioana,9998,0,9999,1
1714627997760,MCWP 40R,A00,518780,Staff,2,0,20,18
1714627997760,MCWP 40R,B00,518781,Staff,8,0,20,12
1714627997760,MCWP 40R,C00,518783,Staff,6,0,20,14
1714627998786,MCWP 50R,A00,518791,Staff,0,0,20,20
1714627998786,MCWP 50R,B00,518792,Staff,0,2,20,20
1714627998786,MCWP 50R,C00,518793,Staff,0,2,20,20
1714627998786,MCWP 50R,D00,518794,Staff,0,0,20,20
1714627998786,MCWP 50R,E00,518795,Staff,0,2,20,20
1714627998786,MCWP 50R,F00,518796,Staff,0,0,20,20
1714627998786,MCWP 50R,G00,518797,Staff,0,1,20,20
1714627999812,MMW 12R,A01,514034,Herbst; Matthew,0,0,16,16
1714627999812,MMW 12R,A02,514035,Herbst; Matthew,1,0,16,15
1714628000839,MMW 13R,A01,514037,Staff,0,4,16,16
1714628000839,MMW 13R,A02,514039,Staff,0,2,16,16
1714628000839,MMW 13R,A03,628519,Staff,0,2,16,16
1714628002890,SIO 295LS,A00,523233,Staff,10,0,30,20
1714628003916,SIO 295S,A00,523232,Staff,10,0,30,20
1714628004945,SIOC 290S,A01,637330,Merrifield; Mark A,23,0,30,7
1714628005972,SIOC 291S,A01,637333,Gabriel; Corey John,23,0,30,7
1714628006997,SOCI 117,A01,494376,Staff,0,4,5,5
1714628008023,WES 237B,A00,494380,Staff,9,0,20,11
1714628010102,AESE 279B,A00,494370,Wade; Jon P,0,0,33,33
1714628011131,AIP 197,001,627712,Vespa; Emanuel Ignacio,9998,0,9999,1
1714628012156,ANAR 135S,A00,494369,Braswell; Geoffrey E.,0,0,0,0
1714628013179,BENG 196,001,628496,Engler; Adam J.,9998,0,9999,1
1714628014208,CAT 124RS,A01,519847,Geibel; William,0,0,20,20
1714628015234,CAT 125RS,A01,515971,Geibel; William,0,0,20,20
1714628016262,CLRE 250,A00,511389,Morris; Sheldon,9993,0,9999,6
1714628017294,CLRE 251,A00,507176,Mehta; Ravindra L.,9993,0,9999,6
1714628017294,CLRE 251,B00,511410,Mehta; Ravindra L.,9998,0,9999,1
1714628018318,CLRE 252,A00,507189,Cuomo; Raphael Eduardo,9995,0,9999,4
1714628019345,CLRE 253,A00,507199,Vaida; Florin,9994,0,9999,5
1714628019345,CLRE 253,B00,507202,Vaida; Florin,9999,0,9999,0
1714628020369,CLRE 259,A00,507211,Patel; Hemal,9996,0,9999,3
1714628021396,CLRE 260,A00,507221,Cuomo; Raphael Eduardo,9999,0,9999,0
1714628022424,CLRE 297,001,507242,Cuomo; Raphael Eduardo,9999,0,9999,0
1714628023453,COGS 197,001,638244,Voytek; Bradley Thomas,9998,0,9999,1
1714628024479,CSE 191,A00,516875,Minnes Kemp; Mor Mia,9992,0,9999,7
1714628025506,CSE 197,001,637388,Minnes Kemp; Mor Mia,9998,0,9999,1
1714628026535,CSS 201S,A01,494383,Staff,35,0,35,0
1714628027560,CSS 202S,A01,494387,Staff,35,0,35,0
1714628028587,DSC 197,001,628532,Eldridge; Justin Matthew,9996,0,9999,3
1714628029615,EAP 100,A00,516065,Staff,9797,0,9999,202
1714628030643,ECE 45,A01,507414,Staff,33,0,60,27
1714628032694,ECE 111,A01,507420,Staff,15,0,50,35
1714628033719,ECE 197,001,548057,Sievenpiper; Daniel F.,9993,0,9999,6
1714628034750,EDS 115,A00,507243,Choi; Bailey Miyeon,10,0,28,18
1714628035777,EDS 117,A01,494379,Staff,0,4,30,30
1714628036802,EDS 125,A00,507246,Hopkins; Megan Beth,9,0,30,21
1714628037831,EDS 128A,A01,507264,Fargason; Sharon Gayle,8,0,26,18
1714628038859,EDS 128B,A01,507293,Pappas; Elizabeth,12,0,30,18
1714628039884,EDS 139,A00,507294,Fargason; Sharon Gayle,13,0,30,17
1714628039884,EDS 139,B00,507313,Pappas; Elizabeth,13,0,30,17
1714628040908,EDS 201,A00,507315,Staff,13,0,30,17
1714628041994,EDS 203,A01,507317,Halter; Christopher P.,12,0,30,18
1714628043021,EDS 204R,A01,507319,Halter; Christopher P.,0,3,30,30
1714628043021,EDS 204R,B01,507331,Heinzman; Erica M.,16,0,30,14
1714628044051,EDS 206R,A00,507332,Staff,0,4,30,30
1714628044051,EDS 206R,B00,507343,Staff,17,0,30,13
1714628045076,EDS 250,A00,507344,Hemans; Patricia Ann Benitez,22,0,40,18
1714628046101,EDS 281,A00,507345,Daly; Alan J.,18,0,18,0
1714628047128,EDS 284,A00,507350,Daly; Alan J.,16,0,16,0
1714628048153,EDS 286,A00,507359,Fine; Sarah,18,0,18,0
1714628049179,EDS 289C,A01,507361,Daly; Alan J.,18,0,18,0
1714628050204,EDS 290,A00,507366,Hofstetter; Carolyn,15,0,15,0
1714628051230,LIGM 5A,A00,507421,Fischer-Grunski; Eva K,18,0,20,2
1714628052256,LIGM 5B,A00,507423,Fischer-Grunski; Eva K,19,0,20,1
1714628053280,LIGM 5C,A00,507425,Fischer-Grunski; Eva K,19,0,20,1
1714628054310,LIIT 5AS,A00,507427,Carnelos; Chiara,20,0,20,0
1714628055339,LIIT 5BS,A00,507430,Carnelos; Chiara,20,0,20,0
1714628056365,LIIT 5CS,A00,507432,Carnelos; Chiara,20,0,20,0
1714628057389,LISP 5A,A00,507541,Munoz Sanchez; Alicia,11,0,20,9
1714628058415,LISP 5B,A00,507671,Munoz Sanchez; Alicia,8,0,20,12
1714628059443,LISP 5C,A00,507696,Munoz Sanchez; Alicia,9,0,20,11
1714628060470,MAE 197,001,528363,Boechler; Nicholas Sebastia,9998,0,9999,1
1714628061498,MATH 197,001,523477,Kedlaya; Kiran S.,9995,0,9999,4
1714628061498,MATH 197,002,563811,Zhang; Danna,9995,0,9999,4
1714628061498,MATH 197,003,628552,Dumitriu; Ioana,9998,0,9999,1
1714628062527,MCWP 40R,A00,518780,Staff,2,0,20,18
1714628062527,MCWP 40R,B00,518781,Staff,8,0,20,12
1714628062527,MCWP 40R,C00,518783,Staff,6,0,20,14
1714628063712,MCWP 50R,A00,518791,Staff,0,0,20,20
1714628063712,MCWP 50R,B00,518792,Staff,0,2,20,20
1714628063712,MCWP 50R,C00,518793,Staff,0,2,20,20
1714628063712,MCWP 50R,D00,518794,Staff,0,0,20,20
1714628063712,MCWP 50R,E00,518795,Staff,0,2,20,20
1714628063712,MCWP 50R,F00,518796,Staff,0,0,20,20
1714628063712,MCWP 50R,G00,518797,Staff,0,1,20,20
1714628064738,MMW 12R,A01,514034,Herbst; Matthew,0,0,16,16
1714628064738,MMW 12R,A02,514035,Herbst; Matthew,1,0,16,15
1714628065764,MMW 13R,A01,514037,Staff,0,4,16,16
1714628065764,MMW 13R,A02,514039,Staff,0,2,16,16
1714628065764,MMW 13R,A03,628519,Staff,0,2,16,16
1714628067817,SIO 295LS,A00,523233,Staff,10,0,30,20
1714628068844,SIO 295S,A00,523232,Staff,10,0,30,20
1714628069871,SIOC 290S,A01,637330,Merrifield; Mark A,23,0,30,7
1714628070900,SIOC 291S,A01,637333,Gabriel; Corey John,23,0,30,7
1714628071925,SOCI 117,A01,494376,Staff,0,4,5,5
1714628072952,WES 237B,A00,494380,Staff,9,0,20,11
1714628075027,AESE 279B,A00,494370,Wade; Jon P,0,0,33,33
1714628076053,AIP 197,001,627712,Vespa; Emanuel Ignacio,9998,0,9999,1
1714628077083,ANAR 135S,A00,494369,Braswell; Geoffrey E.,0,0,0,0
1714628078108,BENG 196,001,628496,Engler; Adam J.,9998,0,9999,1
1714628079134,CAT 124RS,A01,519847,Geibel; William,0,0,20,20
1714628080160,CAT 125RS,A01,515971,Geibel; William,0,0,20,20
1714628081186,CLRE 250,A00,511389,Morris; Sheldon,9993,0,9999,6
1714628082217,CLRE 251,A00,507176,Mehta; Ravindra L.,9993,0,9999,6
1714628082217,CLRE 251,B00,511410,Mehta; Ravindra L.,9998,0,9999,1
1714628083242,CLRE 252,A00,507189,Cuomo; Raphael Eduardo,9995,0,9999,4
1714628084268,CLRE 253,A00,507199,Vaida; Florin,9994,0,9999,5
1714628084268,CLRE 253,B00,507202,Vaida; Florin,9999,0,9999,0
1714628085294,CLRE 259,A00,507211,Patel; Hemal,9996,0,9999,3
1714628086318,CLRE 260,A00,507221,Cuomo; Raphael Eduardo,9999,0,9999,0
1714628087343,CLRE 297,001,507242,Cuomo; Raphael Eduardo,9999,0,9999,0
1714628088372,COGS 197,001,638244,Voytek; Bradley Thomas,9998,0,9999,1
1714628089398,CSE 191,A00,516875,Minnes Kemp; Mor Mia,9992,0,9999,7
1714628090426,CSE 197,001,637388,Minnes Kemp; Mor Mia,9998,0,9999,1
1714628091456,CSS 201S,A01,494383,Staff,35,0,35,0
1714628092536,CSS 202S,A01,494387,Staff,35,0,35,0
1714628093564,DSC 197,001,628532,Eldridge; Justin Matthew,9996,0,9999,3
1714628094590,EAP 100,A00,516065,Staff,9797,0,9999,202
1714628095616,ECE 45,A01,507414,Staff,33,0,60,27
1714628097667,ECE 111,A01,507420,Staff,15,0,50,35
1714628098691,ECE 197,001,548057,Sievenpiper; Daniel F.,9993,0,9999,6
1714628099716,EDS 115,A00,507243,Choi; Bailey Miyeon,10,0,28,18
1714628100745,EDS 117,A01,494379,Staff,0,4,30,30
1714628101770,EDS 125,A00,507246,Hopkins; Megan Beth,9,0,30,21
1714628102800,EDS 128A,A01,507264,Fargason; Sharon Gayle,8,0,26,18
1714628103830,EDS 128B,A01,507293,Pappas; Elizabeth,12,0,30,18
1714628104856,EDS 139,A00,507294,Fargason; Sharon Gayle,13,0,30,17
1714628104856,EDS 139,B00,507313,Pappas; Elizabeth,13,0,30,17
1714628105882,EDS 201,A00,507315,Staff,13,0,30,17
1714628106913,EDS 203,A01,507317,Halter; Christopher P.,12,0,30,18
1714628107945,EDS 204R,A01,507319,Halter; Christopher P.,0,3,30,30
1714628107945,EDS 204R,B01,507331,Heinzman; Erica M.,16,0,30,14
1714628108969,EDS 206R,A00,507332,Staff,0,4,30,30
1714628108969,EDS 206R,B00,507343,Staff,17,0,30,13
1714628109996,EDS 250,A00,507344,Hemans; Patricia Ann Benitez,22,0,40,18
1714628111022,EDS 281,A00,507345,Daly; Alan J.,18,0,18,0
1714628112050,EDS 284,A00,507350,Daly; Alan J.,16,0,16,0
1714628113074,EDS 286,A00,507359,Fine; Sarah,18,0,18,0
1714628114101,EDS 289C,A01,507361,Daly; Alan J.,18,0,18,0
1714628115131,EDS 290,A00,507366,Hofstetter; Carolyn,15,0,15,0
1714628116157,LIGM 5A,A00,507421,Fischer-Grunski; Eva K,18,0,20,2
1714628117186,LIGM 5B,A00,507423,Fischer-Grunski; Eva K,19,0,20,1
1714628118210,LIGM 5C,A00,507425,Fischer-Grunski; Eva K,19,0,20,1
1714628119239,LIIT 5AS,A00,507427,Carnelos; Chiara,20,0,20,0
1714628120264,LIIT 5BS,A00,507430,Carnelos; Chiara,20,0,20,0
1714628121289,LIIT 5CS,A00,507432,Carnelos; Chiara,20,0,20,0
1714628122314,LISP 5A,A00,507541,Munoz Sanchez; Alicia,11,0,20,9
1714628123343,LISP 5B,A00,507671,Munoz Sanchez; Alicia,8,0,20,12
1714628124370,LISP 5C,A00,507696,Munoz Sanchez; Alicia,9,0,20,11
1714628125394,MAE 197,001,528363,Boechler; Nicholas Sebastia,9998,0,9999,1
1714628126421,MATH 197,001,523477,Kedlaya; Kiran S.,9995,0,9999,4
1714628126421,MATH 197,002,563811,Zhang; Danna,9995,0,9999,4
1714628126421,MATH 197,003,628552,Dumitriu; Ioana,9998,0,9999,1
1714628127451,MCWP 40R,A00,518780,Staff,2,0,20,18
1714628127451,MCWP 40R,B00,518781,Staff,8,0,20,12
1714628127451,MCWP 40R,C00,518783,Staff,6,0,20,14
1714628128476,MCWP 50R,A00,518791,Staff,0,0,20,20
1714628128476,MCWP 50R,B00,518792,Staff,0,2,20,20
1714628128476,MCWP 50R,C00,518793,Staff,0,2,20,20
1714628128476,MCWP 50R,D00,518794,Staff,0,0,20,20
1714628128476,MCWP 50R,E00,518795,Staff,0,2,20,20
1714628128476,MCWP 50R,F00,518796,Staff,0,0,20,20
1714628128476,MCWP 50R,G00,518797,Staff,0,1,20,20
1714628129505,MMW 12R,A01,514034,Herbst; Matthew,0,0,16,16
1714628129505,MMW 12R,A02,514035,Herbst; Matthew,1,0,16,15
1714628130530,MMW 13R,A01,514037,Staff,0,4,16,16
1714628130530,MMW 13R,A02,514039,Staff,0,2,16,16
1714628130530,MMW 13R,A03,628519,Staff,0,2,16,16
1714628132584,SIO 295LS,A00,523233,Staff,10,0,30,20
1714628133612,SIO 295S,A00,523232,Staff,10,0,30,20
1714628134638,SIOC 290S,A01,637330,Merrifield; Mark A,23,0,30,7
1714628135668,SIOC 291S,A01,637333,Gabriel; Corey John,23,0,30,7
1714628136752,SOCI 117,A01,494376,Staff,0,4,5,5
1714628137780,WES 237B,A00,494380,Staff,9,0,20,11
1714628139845,AESE 279B,A00,494370,Wade; Jon P,0,0,33,33
1714628140871,AIP 197,001,627712,Vespa; Emanuel Ignacio,9998,0,9999,1
1714628141896,ANAR 135S,A00,494369,Braswell; Geoffrey E.,0,0,0,0
1714628142924,BENG 196,001,628496,Engler; Adam J.,9998,0,9999,1
1714628143951,CAT 124RS,A01,519847,Geibel; William,0,0,20,20
1714628144977,CAT 125RS,A01,515971,Geibel; William,0,0,20,20
1714628146006,CLRE 250,A00,511389,Morris; Sheldon,9993,0,9999,6
1714628147037,CLRE 251,A00,507176,Mehta; Ravindra L.,9993,0,9999,6
1714628147037,CLRE 251,B00,511410,Mehta; Ravindra L.,9998,0,9999,1
1714628148066,CLRE 252,A00,507189,Cuomo; Raphael Eduardo,9995,0,9999,4
1714628149090,CLRE 253,A00,507199,Vaida; Florin,9994,0,9999,5
1714628149090,CLRE 253,B00,507202,Vaida; Florin,9999,0,9999,0
1714628150119,CLRE 259,A00,507211,Patel; Hemal,9996,0,9999,3
1714628151147,CLRE 260,A00,507221,Cuomo; Raphael Eduardo,9999,0,9999,0
1714628152172,CLRE 297,001,507242,Cuomo; Raphael Eduardo,9999,0,9999,0
1714628153198,COGS 197,001,638244,Voytek; Bradley Thomas,9998,0,9999,1
1714628154224,CSE 191,A00,516875,Minnes Kemp; Mor Mia,9992,0,9999,7
1714628155252,CSE 197,001,637388,Minnes Kemp; Mor Mia,9998,0,9999,1
1714628156281,CSS 201S,A01,494383,Staff,35,0,35,0
1714628157309,CSS 202S,A01,494387,Staff,35,0,35,0
1714628158337,DSC 197,001,628532,Eldridge; Justin Matthew,9996,0,9999,3
1714628159362,EAP 100,A00,516065,Staff,9797,0,9999,202
1714628160394,ECE 45,A01,507414,Staff,33,0,60,27
1714628162444,ECE 111,A01,507420,Staff,15,0,50,35
1714628163469,ECE 197,001,548057,Sievenpiper; Daniel F.,9993,0,9999,6
1714628164498,EDS 115,A00,507243,Choi; Bailey Miyeon,10,0,28,18
1714628165522,EDS 117,A01,494379,Staff,0,4,30,30
1714628166552,EDS 125,A00,507246,Hopkins; Megan Beth,9,0,30,21
1714628167576,EDS 128A,A01,507264,Fargason; Sharon Gayle,8,0,26,18
1714628168605,EDS 128B,A01,507293,Pappas; Elizabeth,12,0,30,18
1714628169632,EDS 139,A00,507294,Fargason; Sharon Gayle,13,0,30,17
1714628169632,EDS 139,B00,507313,Pappas; Elizabeth,13,0,30,17
1714628170659,EDS 201,A00,507315,Staff,13,0,30,17
1714628171685,EDS 203,A01,507317,Halter; Christopher P.,12,0,30,18
1714628172711,EDS 204R,A01,507319,Halter; Christopher P.,0,3,30,30
1714628172711,EDS 204R,B01,507331,Heinzman; Erica M.,16,0,30,14
1714628173742,EDS 206R,A00,507332,Staff,0,4,30,30
1714628173742,EDS 206R,B00,507343,Staff,17,0,30,13
1714628174768,EDS 250,A00,507344,Hemans; Patricia Ann Benitez,22,0,40,18
1714628175795,EDS 281,A00,507345,Daly; Alan J.,18,0,18,0
1714628176819,EDS 284,A00,507350,Daly; Alan J.,16,0,16,0
1714628177847,EDS 286,A00,507359,Fine; Sarah,18,0,18,0
1714628178875,EDS 289C,A01,507361,Daly; Alan J.,18,0,18,0
1714628179900,EDS 290,A00,507366,Hofstetter; Carolyn,15,0,15,0
1714628180931,LIGM 5A,A00,507421,Fischer-Grunski; Eva K,18,0,20,2
1714628181960,LIGM 5B,A00,507423,Fischer-Grunski; Eva K,19,0,20,1
1714628182986,LIGM 5C,A00,507425,Fischer-Grunski; Eva K,19,0,20,1
1714628184011,LIIT 5AS,A00,507427,Carnelos; Chiara,20,0,20,0
1714628185036,LIIT 5BS,A00,507430,Carnelos; Chiara,20,0,20,0
1714628186063,LIIT 5CS,A00,507432,Carnelos; Chiara,20,0,20,0
1714628187096,LISP 5A,A00,507541,Munoz Sanchez; Alicia,11,0,20,9
1714628188119,LISP 5B,A00,507671,Munoz Sanchez; Alicia,8,0,20,12
1714628189157,LISP 5C,A00,507696,Munoz Sanchez; Alicia,9,0,20,11
1714628190184,MAE 197,001,528363,Boechler; Nicholas Sebastia,9998,0,9999,1
1714628191210,MATH 197,001,523477,Kedlaya; Kiran S.,9995,0,9999,4
1714628191210,MATH 197,002,563811,Zhang; Danna,9995,0,9999,4
1714628191210,MATH 197,003,628552,Dumitriu; Ioana,9998,0,9999,1
1714628192240,MCWP 40R,A00,518780,Staff,2,0,20,18
1714628192240,MCWP 40R,B00,518781,Staff,8,0,20,12
1714628192240,MCWP 40R,C00,518783,Staff,6,0,20,14
1714628193266,MCWP 50R,A00,518791,Staff,0,0,20,20
1714628193266,MCWP 50R,B00,518792,Staff,0,2,20,20
1714628193266,MCWP 50R,C00,518793,Staff,0,2,20,20
1714628193266,MCWP 50R,D00,518794,Staff,0,0,20,20
1714628193266,MCWP 50R,E00,518795,Staff,0,2,20,20
1714628193266,MCWP 50R,F00,518796,Staff,0,0,20,20
1714628193266,MCWP 50R,G00,518797,Staff,0,1,20,20
1714628194292,MMW 12R,A01,514034,Herbst; Matthew,0,0,16,16
1714628194292,MMW 12R,A02,514035,Herbst; Matthew,1,0,16,15
1714628195320,MMW 13R,A01,514037,Staff,0,4,16,16
1714628195320,MMW 13R,A02,514039,Staff,0,2,16,16
1714628195320,MMW 13R,A03,628519,Staff,0,2,16,16
1714628197371,SIO 295LS,A00,523233,Staff,10,0,30,20
1714628198396,SIO 295S,A00,523232,Staff,10,0,30,20
1714628199425,SIOC 290S,A01,637330,Merrifield; Mark A,23,0,30,7
1714628200453,SIOC 291S,A01,637333,Gabriel; Corey John,23,0,30,7
1714628201479,SOCI 117,A01,494376,Staff,0,4,5,5
1714628202504,WES 237B,A00,494380,Staff,9,0,20,11
1714628204568,AESE 279B,A00,494370,Wade; Jon P,0,0,33,33
1714628205594,AIP 197,001,627712,Vespa; Emanuel Ignacio,9998,0,9999,1
1714628206622,ANAR 135S,A00,494369,Braswell; Geoffrey E.,0,0,0,0
1714628207648,BENG 196,001,628496,Engler; Adam J.,9998,0,9999,1
1714628208676,CAT 124RS,A01,519847,Geibel; William,0,0,20,20
1714628209701,CAT 125RS,A01,515971,Geibel; William,0,0,20,20
1714628210726,CLRE 250,A00,511389,Morris; Sheldon,9993,0,9999,6
1714628211757,CLRE 251,A00,507176,Mehta; Ravindra L.,9993,0,9999,6
1714628211757,CLRE 251,B00,511410,Mehta; Ravindra L.,9998,0,9999,1
1714628212784,CLRE 252,A00,507189,Cuomo; Raphael Eduardo,9995,0,9999,4
1714628213812,CLRE 253,A00,507199,Vaida; Florin,9994,0,9999,5
1714628213812,CLRE 253,B00,507202,Vaida; Florin,9999,0,9999,0
1714628214838,CLRE 259,A00,507211,Patel; Hemal,9996,0,9999,3
1714628215863,CLRE 260,A00,507221,Cuomo; Raphael Eduardo,9999,0,9999,0
1714628216890,CLRE 297,001,507242,Cuomo; Raphael Eduardo,9999,0,9999,0
1714628217915,COGS 197,001,638244,Voytek; Bradley Thomas,9998,0,9999,1
1714628218940,CSE 191,A00,516875,Minnes Kemp; Mor Mia,9992,0,9999,7
1714628219970,CSE 197,001,637388,Minnes Kemp; Mor Mia,9998,0,9999,1
1714628220997,CSS 201S,A01,494383,Staff,35,0,35,0
1714628222022,CSS 202S,A01,494387,Staff,35,0,35,0
1714628223051,DSC 197,001,628532,Eldridge; Justin Matthew,9996,0,9999,3
1714628224076,EAP 100,A00,516065,Staff,9797,0,9999,202
1714628225102,ECE 45,A01,507414,Staff,33,0,60,27
1714628227157,ECE 111,A01,507420,Staff,15,0,50,35
1714628228186,ECE 197,001,548057,Sievenpiper; Daniel F.,9993,0,9999,6
1714628229214,EDS 115,A00,507243,Choi; Bailey Miyeon,10,0,28,18
1714628230240,EDS 117,A01,494379,Staff,0,4,30,30
1714628231265,EDS 125,A00,507246,Hopkins; Megan Beth,9,0,30,21
1714628232294,EDS 128A,A01,507264,Fargason; Sharon Gayle,8,0,26,18
1714628233318,EDS 128B,A01,507293,Pappas; Elizabeth,12,0,30,18
1714628234342,EDS 139,A00,507294,Fargason; Sharon Gayle,13,0,30,17
1714628234342,EDS 139,B00,507313,Pappas; Elizabeth,13,0,30,17
1714628235366,EDS 201,A00,507315,Staff,13,0,30,17
1714628236393,EDS 203,A01,507317,Halter; Christopher P.,12,0,30,18
1714628237418,EDS 204R,A01,507319,Halter; Christopher P.,0,3,30,30
1714628237418,EDS 204R,B01,507331,Heinzman; Erica M.,16,0,30,14
1714628238443,EDS 206R,A00,507332,Staff,0,4,30,30
1714628238443,EDS 206R,B00,507343,Staff,17,0,30,13
1714628239469,EDS 250,A00,507344,Hemans; Patricia Ann Benitez,22,0,40,18
1714628240563,EDS 281,A00,507345,Daly; Alan J.,18,0,18,0
1714628241591,EDS 284,A00,507350,Daly; Alan J.,16,0,16,0
1714628242620,EDS 286,A00,507359,Fine; Sarah,18,0,18,0
1714628243644,EDS 289C,A01,507361,Daly; Alan J.,18,0,18,0
1714628244676,EDS 290,A00,507366,Hofstetter; Carolyn,15,0,15,0
1714628245701,LIGM 5A,A00,507421,Fischer-Grunski; Eva K,18,0,20,2
1714628246727,LIGM 5B,A00,507423,Fischer-Grunski; Eva K,19,0,20,1
1714628247753,LIGM 5C,A00,507425,Fischer-Grunski; Eva K,19,0,20,1
1714628248782,LIIT 5AS,A00,507427,Carnelos; Chiara,20,0,20,0
1714628249808,LIIT 5BS,A00,507430,Carnelos; Chiara,20,0,20,0
1714628250836,LIIT 5CS,A00,507432,Carnelos; Chiara,20,0,20,0
1714628251863,LISP 5A,A00,507541,Munoz Sanchez; Alicia,11,0,20,9
1714628252888,LISP 5B,A00,507671,Munoz Sanchez; Alicia,8,0,20,12
1714628253918,LISP 5C,A00,507696,Munoz Sanchez; Alicia,9,0,20,11
1714628254945,MAE 197,001,528363,Boechler; Nicholas Sebastia,9998,0,9999,1
1714628255976,MATH 197,001,523477,Kedlaya; Kiran S.,9995,0,9999,4
1714628255976,MATH 197,002,563811,Zhang; Danna,9995,0,9999,4
1714628255976,MATH 197,003,628552,Dumitriu; Ioana,9998,0,9999,1
1714628257005,MCWP 40R,A00,518780,Staff,2,0,20,18
1714628257005,MCWP 40R,B00,518781,Staff,8,0,20,12
1714628257005,MCWP 40R,C00,518783,Staff,6,0,20,14
1714628258030,MCWP 50R,A00,518791,Staff,0,0,20,20
1714628258030,MCWP 50R,B00,518792,Staff,0,2,20,20
1714628258030,MCWP 50R,C00,518793,Staff,0,2,20,20
1714628258030,MCWP 50R,D00,518794,Staff,0,0,20,20
1714628258030,MCWP 50R,E00,518795,Staff,0,2,20,20
1714628258030,MCWP 50R,F00,518796,Staff,0,0,20,20
1714628258030,MCWP 50R,G00,518797,Staff,0,1,20,20
1714628259072,MMW 12R,A01,514034,Herbst; Matthew,0,0,16,16
1714628259072,MMW 12R,A02,514035,Herbst; Matthew,1,0,16,15
1714628260100,MMW 13R,A01,514037,Staff,0,4,16,16
1714628260100,MMW 13R,A02,514039,Staff,0,2,16,16
1714628260100,MMW 13R,A03,628519,Staff,0,2,16,16
1714628262151,SIO 295LS,A00,523233,Staff,10,0,30,20
1714628263176,SIO 295S,A00,523232,Staff,10,0,30,20
1714628264202,SIOC 290S,A01,637330,Merrifield; Mark A,23,0,30,7
1714628265233,SIOC 291S,A01,637333,Gabriel; Corey John,23,0,30,7
1714628266257,SOCI 117,A01,494376,Staff,0,4,5,5
1714628267282,WES 237B,A00,494380,Staff,9,0,20,11
1714628269362,AESE 279B,A00,494370,Wade; Jon P,0,0,33,33
1714628270388,AIP 197,001,627712,Vespa; Emanuel Ignacio,9998,0,9999,1
1714628271413,ANAR 135S,A00,494369,Braswell; Geoffrey E.,0,0,0,0
1714628272443,BENG 196,001,628496,Engler; Adam J.,9998,0,9999,1
1714628273469,CAT 124RS,A01,519847,Geibel; William,0,0,20,20
1714628274495,CAT 125RS,A01,515971,Geibel; William,0,0,20,20
1714628275521,CLRE 250,A00,511389,Morris; Sheldon,9993,0,9999,6
1714628276547,CLRE 251,A00,507176,Mehta; Ravindra L.,9993,0,9999,6
1714628276547,CLRE 251,B00,511410,Mehta; Ravindra L.,9998,0,9999,1
1714628277574,CLRE 252,A00,507189,Cuomo; Raphael Eduardo,9995,0,9999,4
1714628278601,CLRE 253,A00,507199,Vaida; Florin,9994,0,9999,5
1714628278601,CLRE 253,B00,507202,Vaida; Florin,9999,0,9999,0
1714628279628,CLRE 259,A00,507211,Patel; Hemal,9996,0,9999,3
1714628280657,CLRE 260,A00,507221,Cuomo; Raphael Eduardo,9999,0,9999,0
1714628281685,CLRE 297,001,507242,Cuomo; Raphael Eduardo,9999,0,9999,0
1714628282709,COGS 197,001,638244,Voytek; Bradley Thomas,9998,0,9999,1
1714628283737,CSE 191,A00,516875,Minnes Kemp; Mor Mia,9992,0,9999,7
1714628284764,CSE 197,001,637388,Minnes Kemp; Mor Mia,9998,0,9999,1
1714628285790,CSS 201S,A01,494383,Staff,35,0,35,0
1714628286816,CSS 202S,A01,494387,Staff,35,0,35,0
1714628287841,DSC 197,001,628532,Eldridge; Justin Matthew,9996,0,9999,3
1714628288866,EAP 100,A00,516065,Staff,9797,0,9999,202
1714628289894,ECE 45,A01,507414,Staff,33,0,60,27
1714628291947,ECE 111,A01,507420,Staff,15,0,50,35
1714628292977,ECE 197,001,548057,Sievenpiper; Daniel F.,9993,0,9999,6
1714628294004,EDS 115,A00,507243,Choi; Bailey Miyeon,10,0,28,18
1714628295029,EDS 117,A01,494379,Staff,0,4,30,30
1714628296055,EDS 125,A00,507246,Hopkins; Megan Beth,9,0,30,21
1714628297080,EDS 128A,A01,507264,Fargason; Sharon Gayle,8,0,26,18
1714628298106,EDS 128B,A01,507293,Pappas; Elizabeth,12,0,30,18
1714628299134,EDS 139,A00,507294,Fargason; Sharon Gayle,13,0,30,17
1714628299134,EDS 139,B00,507313,Pappas; Elizabeth,13,0,30,17
1714628300159,EDS 201,A00,507315,Staff,13,0,30,17
1714628301185,EDS 203,A01,507317,Halter; Christopher P.,12,0,30,18
1714628302213,EDS 204R,A01,507319,Halter; Christopher P.,0,3,30,30
1714628302213,EDS 204R,B01,507331,Heinzman; Erica M.,16,0,30,14
1714628303241,EDS 206R,A00,507332,Staff,0,4,30,30
1714628303241,EDS 206R,B00,507343,Staff,17,0,30,13
1714628304266,EDS 250,A00,507344,Hemans; Patricia Ann Benitez,22,0,40,18
1714628305289,EDS 281,A00,507345,Daly; Alan J.,18,0,18,0
1714628306320,EDS 284,A00,507350,Daly; Alan J.,16,0,16,0
1714628307345,EDS 286,A00,507359,Fine; Sarah,18,0,18,0
1714628308373,EDS 289C,A01,507361,Daly; Alan J.,18,0,18,0
1714628309398,EDS 290,A00,507366,Hofstetter; Carolyn,15,0,15,0
1714628310424,LIGM 5A,A00,507421,Fischer-Grunski; Eva K,18,0,20,2
1714628311447,LIGM 5B,A00,507423,Fischer-Grunski; Eva K,19,0,20,1
1714628312477,LIGM 5C,A00,507425,Fischer-Grunski; Eva K,19,0,20,1
1714628313503,LIIT 5AS,A00,507427,Carnelos; Chiara,20,0,20,0
1714628314527,LIIT 5BS,A00,507430,Carnelos; Chiara,20,0,20,0
1714628315552,LIIT 5CS,A00,507432,Carnelos; Chiara,20,0,20,0
1714628316579,LISP 5A,A00,507541,Munoz Sanchez; Alicia,11,0,20,9
1714628317603,LISP 5B,A00,507671,Munoz Sanchez; Alicia,8,0,20,12
1714628318632,LISP 5C,A00,507696,Munoz Sanchez; Alicia,9,0,20,11
1714628319657,MAE 197,001,528363,Boechler; Nicholas Sebastia,9998,0,9999,1
1714628320684,MATH 197,001,523477,Kedlaya; Kiran S.,9995,0,9999,4
1714628320684,MATH 197,002,563811,Zhang; Danna,9995,0,9999,4
1714628320684,MATH 197,003,628552,Dumitriu; Ioana,9998,0,9999,1
1714628321713,MCWP 40R,A00,518780,Staff,2,0,20,18
1714628321713,MCWP 40R,B00,518781,Staff,8,0,20,12
1714628321713,MCWP 40R,C00,518783,Staff,6,0,20,14
1714628322741,MCWP 50R,A00,518791,Staff,0,0,20,20
1714628322741,MCWP 50R,B00,518792,Staff,0,2,20,20
1714628322741,MCWP 50R,C00,518793,Staff,0,2,20,20
1714628322741,MCWP 50R,D00,518794,Staff,0,0,20,20
1714628322741,MCWP 50R,E00,518795,Staff,0,2,20,20
1714628322741,MCWP 50R,F00,518796,Staff,0,0,20,20
1714628322741,MCWP 50R,G00,518797,Staff,0,1,20,20
1714628323769,MMW 12R,A01,514034,Herbst; Matthew,0,0,16,16
1714628323769,MMW 12R,A02,514035,Herbst; Matthew,1,0,16,15
1714628324794,MMW 13R,A01,514037,Staff,0,4,16,16
1714628324794,MMW 13R,A02,514039,Staff,0,2,16,16
1714628324794,MMW 13R,A03,628519,Staff,0,2,16,16
1714628326845,SIO 295LS,A00,523233,Staff,10,0,30,20
1714628327873,SIO 295S,A00,523232,Staff,10,0,30,20
1714628328900,SIOC 290S,A01,637330,Merrifield; Mark A,23,0,30,7
1714628329925,SIOC 291S,A01,637333,Gabriel; Corey John,23,0,30,7
1714628330953,SOCI 117,A01,494376,Staff,0,4,5,5
1714628331979,WES 237B,A00,494380,Staff,9,0,20,11
1714628334058,AESE 279B,A00,494370,Wade; Jon P,0,0,33,33
1714628335083,AIP 197,001,627712,Vespa; Emanuel Ignacio,9998,0,9999,1
1714628336112,ANAR 135S,A00,494369,Braswell; Geoffrey E.,0,0,0,0
1714628337137,BENG 196,001,628496,Engler; Adam J.,9998,0,9999,1
1714628338161,CAT 124RS,A01,519847,Geibel; William,0,0,20,20
1714628339184,CAT 125RS,A01,515971,Geibel; William,0,0,20,20
1714628340212,CLRE 250,A00,511389,Morris; Sheldon,9993,0,9999,6
1714628341246,CLRE 251,A00,507176,Mehta; Ravindra L.,9993,0,9999,6
1714628341246,CLRE 251,B00,511410,Mehta; Ravindra L.,9998,0,9999,1
1714628342274,CLRE 252,A00,507189,Cuomo; Raphael Eduardo,9995,0,9999,4
1714628343303,CLRE 253,A00,507199,Vaida; Florin,9994,0,9999,5
1714628343303,CLRE 253,B00,507202,Vaida; Florin,9999,0,9999,0
1714628344384,CLRE 259,A00,507211,Patel; Hemal,9996,0,9999,3
1714628345410,CLRE 260,A00,507221,Cuomo; Raphael Eduardo,9999,0,9999,0
1714628346439,CLRE 297,001,507242,Cuomo; Raphael Eduardo,9999,0,9999,0
1714628347468,COGS 197,001,638244,Voytek; Bradley Thomas,9998,0,9999,1
1714628348496,CSE 191,A00,516875,Minnes Kemp; Mor Mia,9992,0,9999,7
1714628349521,CSE 197,001,637388,Minnes Kemp; Mor Mia,9998,0,9999,1
1714628350548,CSS 201S,A01,494383,Staff,35,0,35,0
1714628351576,CSS 202S,A01,494387,Staff,35,0,35,0
1714628352604,DSC 197,001,628532,Eldridge; Justin Matthew,9996,0,9999,3
1714628353629,EAP 100,A00,516065,Staff,9797,0,9999,202
1714628354659,ECE 45,A01,507414,Staff,33,0,60,27
1714628356713,ECE 111,A01,507420,Staff,15,0,50,35
1714628357740,ECE 197,001,548057,Sievenpiper; Daniel F.,9993,0,9999,6
1714628358766,EDS 115,A00,507243,Choi; Bailey Miyeon,10,0,28,18
1714628359793,EDS 117,A01,494379,Staff,0,4,30,30
1714628360817,EDS 125,A00,507246,Hopkins; Megan Beth,9,0,30,21
1714628361846,EDS 128A,A01,507264,Fargason; Sharon Gayle,8,0,26,18
1714628362875,EDS 128B,A01,507293,Pappas; Elizabeth,12,0,30,18
1714628363906,EDS 139,A00,507294,Fargason; Sharon Gayle,13,0,30,17
1714628363906,EDS 139,B00,507313,Pappas; Elizabeth,13,0,30,17
1714628364932,EDS 201,A00,507315,Staff,13,0,30,17
1714628365962,EDS 203,A01,507317,Halter; Christopher P.,12,0,30,18
1714628366986,EDS 204R,A01,507319,Halter; Christopher P.,0,3,30,30
1714628366986,EDS 204R,B01,507331,Heinzman; Erica M.,16,0,30,14
1714628368015,EDS 206R,A00,507332,Staff,0,4,30,30
1714628368015,EDS 206R,B00,507343,Staff,17,0,30,13
1714628369040,EDS 250,A00,507344,Hemans; Patricia Ann Benitez,22,0,40,18
1714628370065,EDS 281,A00,507345,Daly; Alan J.,18,0,18,0
1714628371089,EDS 284,A00,507350,Daly; Alan J.,16,0,16,0
1714628372119,EDS 286,A00,507359,Fine; Sarah,18,0,18,0
1714628373144,EDS 289C,A01,507361,Daly; Alan J.,18,0,18,0
1714628374170,EDS 290,A00,507366,Hofstetter; Carolyn,15,0,15,0
1714628375197,LIGM 5A,A00,507421,Fischer-Grunski; Eva K,18,0,20,2
1714628376221,LIGM 5B,A00,507423,Fischer-Grunski; Eva K,19,0,20,1
1714628377245,LIGM 5C,A00,507425,Fischer-Grunski; Eva K,19,0,20,1
1714628378274,LIIT 5AS,A00,507427,Carnelos; Chiara,20,0,20,0
1714628379310,LIIT 5BS,A00,507430,Carnelos; Chiara,20,0,20,0
1714628380334,LIIT 5CS,A00,507432,Carnelos; Chiara,20,0,20,0
1714628381365,LISP 5A,A00,507541,Munoz Sanchez; Alicia,11,0,20,9
1714628382390,LISP 5B,A00,507671,Munoz Sanchez; Alicia,8,0,20,12
1714628383420,LISP 5C,A00,507696,Munoz Sanchez; Alicia,9,0,20,11
1714628384448,MAE 197,001,528363,Boechler; Nicholas Sebastia,9998,0,9999,1
1714628385476,MATH 197,001,523477,Kedlaya; Kiran S.,9995,0,9999,4
1714628385476,MATH 197,002,563811,Zhang; Danna,9995,0,9999,4
1714628385476,MATH 197,003,628552,Dumitriu; Ioana,9998,0,9999,1
1714628386504,MCWP 40R,A00,518780,Staff,2,0,20,18
1714628386504,MCWP 40R,B00,518781,Staff,8,0,20,12
1714628386504,MCWP 40R,C00,518783,Staff,6,0,20,14
1714628387536,MCWP 50R,A00,518791,Staff,0,0,20,20
1714628387536,MCWP 50R,B00,518792,Staff,0,2,20,20
1714628387536,MCWP 50R,C00,518793,Staff,0,2,20,20
1714628387536,MCWP 50R,D00,518794,Staff,0,0,20,20
1714628387536,MCWP 50R,E00,518795,Staff,0,2,20,20
1714628387536,MCWP 50R,F00,518796,Staff,0,0,20,20
1714628387536,MCWP 50R,G00,518797,Staff,0,1,20,20
1714628388561,MMW 12R,A01,514034,Herbst; Matthew,0,0,16,16
1714628388561,MMW 12R,A02,514035,Herbst; Matthew,1,0,16,15
1714628389587,MMW 13R,A01,514037,Staff,0,4,16,16
1714628389587,MMW 13R,A02,514039,Staff,0,2,16,16
1714628389587,MMW 13R,A03,628519,Staff,0,2,16,16
1714628391639,SIO 295LS,A00,523233,Staff,10,0,30,20
1714628392664,SIO 295S,A00,523232,Staff,10,0,30,20
1714628393691,SIOC 290S,A01,637330,Merrifield; Mark A,23,0,30,7
1714628394717,SIOC 291S,A01,637333,Gabriel; Corey John,23,0,30,7
1714628395742,SOCI 117,A01,494376,Staff,0,4,5,5
1714628396768,WES 237B,A00,494380,Staff,9,0,20,11
1714628398840,AESE 279B,A00,494370,Wade; Jon P,0,0,33,33
1714628399869,AIP 197,001,627712,Vespa; Emanuel Ignacio,9998,0,9999,1
1714628400897,ANAR 135S,A00,494369,Braswell; Geoffrey E.,0,0,0,0
1714628401924,BENG 196,001,628496,Engler; Adam J.,9998,0,9999,1
1714628402952,CAT 124RS,A01,519847,Geibel; William,0,0,20,20
1714628403980,CAT 125RS,A01,515971,Geibel; William,0,0,20,20
1714628405011,CLRE 250,A00,511389,Morris; Sheldon,9993,0,9999,6
1714628406041,CLRE 251,A00,507176,Mehta; Ravindra L.,9993,0,9999,6
1714628406041,CLRE 251,B00,511410,Mehta; Ravindra L.,9998,0,9999,1
1714628407071,CLRE 252,A00,507189,Cuomo; Raphael Eduardo,9995,0,9999,4
1714628408099,CLRE 253,A00,507199,Vaida; Florin,9994,0,9999,5
1714628408099,CLRE 253,B00,507202,Vaida; Florin,9999,0,9999,0
1714628409124,CLRE 259,A00,507211,Patel; Hemal,9996,0,9999,3
1714628410150,CLRE 260,A00,507221,Cuomo; Raphael Eduardo,9999,0,9999,0
1714628411178,CLRE 297,001,507242,Cuomo; Raphael Eduardo,9999,0,9999,0
1714628412202,COGS 197,001,638244,Voytek; Bradley Thomas,9998,0,9999,1
1714628413230,CSE 191,A00,516875,Minnes Kemp; Mor Mia,9992,0,9999,7
1714628414259,CSE 197,001,637388,Minnes Kemp; Mor Mia,9998,0,9999,1
1714628415284,CSS 201S,A01,494383,Staff,35,0,35,0
1714628416309,CSS 202S,A01,494387,Staff,35,0,35,0
1714628417339,DSC 197,001,628532,Eldridge; Justin Matthew,9996,0,9999,3
1714628418365,EAP 100,A00,516065,Staff,9797,0,9999,202
1714628419394,ECE 45,A01,507414,Staff,33,0,60,27
1714628421452,ECE 111,A01,507420,Staff,15,0,50,35
1714628422479,ECE 197,001,548057,Sievenpiper; Daniel F.,9993,0,9999,6
1714628423509,EDS 115,A00,507243,Choi; Bailey Miyeon,10,0,28,18
1714628424538,EDS 117,A01,494379,Staff,0,4,30,30
1714628425566,EDS 125,A00,507246,Hopkins; Megan Beth,9,0,30,21
1714628426597,EDS 128A,A01,507264,Fargason; Sharon Gayle,8,0,26,18
1714628427625,EDS 128B,A01,507293,Pappas; Elizabeth,12,0,30,18
1714628428649,EDS 139,A00,507294,Fargason; Sharon Gayle,13,0,30,17
1714628428649,EDS 139,B00,507313,Pappas; Elizabeth,13,0,30,17
1714628429673,EDS 201,A00,507315,Staff,13,0,30,17
1714628430698,EDS 203,A01,507317,Halter; Christopher P.,12,0,30,18
1714628431726,EDS 204R,A01,507319,Halter; Christopher P.,0,3,30,30
1714628431726,EDS 204R,B01,507331,Heinzman; Erica M.,16,0,30,14
1714628432753,EDS 206R,A00,507332,Staff,0,4,30,30
1714628432753,EDS 206R,B00,507343,Staff,17,0,30,13
1714628433779,EDS 250,A00,507344,Hemans; Patricia Ann Benitez,22,0,40,18
1714628434805,EDS 281,A00,507345,Daly; Alan J.,18,0,18,0
1714628435831,EDS 284,A00,507350,Daly; Alan J.,16,0,16,0
1714628436858,EDS 286,A00,507359,Fine; Sarah,18,0,18,0
1714628437888,EDS 289C,A01,507361,Daly; Alan J.,18,0,18,0
1714628438922,EDS 290,A00,507366,Hofstetter; Carolyn,15,0,15,0
1714628439949,LIGM 5A,A00,507421,Fischer-Grunski; Eva K,18,0,20,2
1714628440980,LIGM 5B,A00,507423,Fischer-Grunski; Eva K,19,0,20,1
1714628442005,LIGM 5C,A00,507425,Fischer-Grunski; Eva K,19,0,20,1
1714628443031,LIIT 5AS,A00,507427,Carnelos; Chiara,20,0,20,0
1714628444057,LIIT 5BS,A00,507430,Carnelos; Chiara,20,0,20,0
1714628445085,LIIT 5CS,A00,507432,Carnelos; Chiara,20,0,20,0
1714628446110,LISP 5A,A00,507541,Munoz Sanchez; Alicia,11,0,20,9
1714628447135,LISP 5B,A00,507671,Munoz Sanchez; Alicia,8,0,20,12
1714628448216,LISP 5C,A00,507696,Munoz Sanchez; Alicia,9,0,20,11
1714628449240,MAE 197,001,528363,Boechler; Nicholas Sebastia,9998,0,9999,1
1714628450266,MATH 197,001,523477,Kedlaya; Kiran S.,9995,0,9999,4
1714628450266,MATH 197,002,563811,Zhang; Danna,9995,0,9999,4
1714628450266,MATH 197,003,628552,Dumitriu; Ioana,9998,0,9999,1
1714628451296,MCWP 40R,A00,518780,Staff,2,0,20,18
1714628451296,MCWP 40R,B00,518781,Staff,8,0,20,12
1714628451296,MCWP 40R,C00,518783,Staff,6,0,20,14
1714628452325,MCWP 50R,A00,518791,Staff,0,0,20,20
1714628452325,MCWP 50R,B00,518792,Staff,0,2,20,20
1714628452325,MCWP 50R,C00,518793,Staff,0,2,20,20
1714628452325,MCWP 50R,D00,518794,Staff,0,0,20,20
1714628452325,MCWP 50R,E00,518795,Staff,0,2,20,20
1714628452325,MCWP 50R,F00,518796,Staff,0,0,20,20
1714628452325,MCWP 50R,G00,518797,Staff,0,1,20,20
1714628453349,MMW 12R,A01,514034,Herbst; Matthew,0,0,16,16
1714628453349,MMW 12R,A02,514035,Herbst; Matthew,1,0,16,15
1714628454375,MMW 13R,A01,514037,Staff,0,4,16,16
1714628454375,MMW 13R,A02,514039,Staff,0,2,16,16
1714628454375,MMW 13R,A03,628519,Staff,0,2,16,16
1714628456426,SIO 295LS,A00,523233,Staff,10,0,30,20
1714628457452,SIO 295S,A00,523232,Staff,10,0,30,20
1714628458482,SIOC 290S,A01,637330,Merrifield; Mark A,23,0,30,7
1714628459507,SIOC 291S,A01,637333,Gabriel; Corey John,23,0,30,7
1714628460532,SOCI 117,A01,494376,Staff,0,4,5,5
1714628461560,WES 237B,A00,494380,Staff,9,0,20,11
1714628463633,AESE 279B,A00,494370,Wade; Jon P,0,0,33,33
1714628464659,AIP 197,001,627712,Vespa; Emanuel Ignacio,9998,0,9999,1
1714628465684,ANAR 135S,A00,494369,Braswell; Geoffrey E.,0,0,0,0
1714628466712,BENG 196,001,628496,Engler; Adam J.,9998,0,9999,1
1714628467741,CAT 124RS,A01,519847,Geibel; William,0,0,20,20
1714628468765,CAT 125RS,A01,515971,Geibel; William,0,0,20,20
1714628469796,CLRE 250,A00,511389,Morris; Sheldon,9993,0,9999,6
1714628470824,CLRE 251,A00,507176,Mehta; Ravindra L.,9993,0,9999,6
1714628470824,CLRE 251,B00,511410,Mehta; Ravindra L.,9998,0,9999,1
1714628471850,CLRE 252,A00,507189,Cuomo; Raphael Eduardo,9995,0,9999,4
1714628472880,CLRE 253,A00,507199,Vaida; Florin,9994,0,9999,5
1714628472880,CLRE 253,B00,507202,Vaida; Florin,9999,0,9999,0
1714628473907,CLRE 259,A00,507211,Patel; Hemal,9996,0,9999,3
1714628474930,CLRE 260,A00,507221,Cuomo; Raphael Eduardo,9999,0,9999,0
1714628475955,CLRE 297,001,507242,Cuomo; Raphael Eduardo,9999,0,9999,0
1714628477405,COGS 197,001,638244,Voytek; Bradley Thomas,9998,0,9999,1
1714628478430,CSE 191,A00,516875,Minnes Kemp; Mor Mia,9992,0,9999,7
1714628479454,CSE 197,001,637388,Minnes Kemp; Mor Mia,9998,0,9999,1
1714628480484,CSS 201S,A01,494383,Staff,35,0,35,0
1714628481511,CSS 202S,A01,494387,Staff,35,0,35,0
1714628482537,DSC 197,001,628532,Eldridge; Justin Matthew,9996,0,9999,3
1714628483563,EAP 100,A00,516065,Staff,9797,0,9999,202
1714628484587,ECE 45,A01,507414,Staff,33,0,60,27
1714628486641,ECE 111,A01,507420,Staff,15,0,50,35
1714628487668,ECE 197,001,548057,Sievenpiper; Daniel F.,9993,0,9999,6
1714628488693,EDS 115,A00,507243,Choi; Bailey Miyeon,10,0,28,18
1714628489723,EDS 117,A01,494379,Staff,0,4,30,30
1714628490752,EDS 125,A00,507246,Hopkins; Megan Beth,9,0,30,21
1714628491776,EDS 128A,A01,507264,Fargason; Sharon Gayle,8,0,26,18
1714628492802,EDS 128B,A01,507293,Pappas; Elizabeth,12,0,30,18
1714628493826,EDS 139,A00,507294,Fargason; Sharon Gayle,13,0,30,17
1714628493826,EDS 139,B00,507313,Pappas; Elizabeth,13,0,30,17
1714628494853,EDS 201,A00,507315,Staff,13,0,30,17
1714628495879,EDS 203,A01,507317,Halter; Christopher P.,12,0,30,18
1714628496904,EDS 204R,A01,507319,Halter; Christopher P.,0,3,30,30
1714628496904,EDS 204R,B01,507331,Heinzman; Erica M.,16,0,30,14
1714628497929,EDS 206R,A00,507332,Staff,0,4,30,30
1714628497929,EDS 206R,B00,507343,Staff,17,0,30,13
1714628498955,EDS 250,A00,507344,Hemans; Patricia Ann Benitez,22,0,40,18
1714628499981,EDS 281,A00,507345,Daly; Alan J.,18,0,18,0
1714628501009,EDS 284,A00,507350,Daly; Alan J.,16,0,16,0
1714628502035,EDS 286,A00,507359,Fine; Sarah,18,0,18,0
1714628503060,EDS 289C,A01,507361,Daly; Alan J.,18,0,18,0
1714628504084,EDS 290,A00,507366,Hofstetter; Carolyn,15,0,15,0
1714628505109,LIGM 5A,A00,507421,Fischer-Grunski; Eva K,18,0,20,2
1714628506133,LIGM 5B,A00,507423,Fischer-Grunski; Eva K,19,0,20,1
1714628507159,LIGM 5C,A00,507425,Fischer-Grunski; Eva K,19,0,20,1
1714628508186,LIIT 5AS,A00,507427,Carnelos; Chiara,20,0,20,0
1714628509215,LIIT 5BS,A00,507430,Carnelos; Chiara,20,0,20,0
1714628510243,LIIT 5CS,A00,507432,Carnelos; Chiara,20,0,20,0
1714628511272,LISP 5A,A00,507541,Munoz Sanchez; Alicia,11,0,20,9
1714628512297,LISP 5B,A00,507671,Munoz Sanchez; Alicia,8,0,20,12
1714628513322,LISP 5C,A00,507696,Munoz Sanchez; Alicia,9,0,20,11
1714628514348,MAE 197,001,528363,Boechler; Nicholas Sebastia,9998,0,9999,1
1714628515373,MATH 197,001,523477,Kedlaya; Kiran S.,9995,0,9999,4
1714628515373,MATH 197,002,563811,Zhang; Danna,9995,0,9999,4
1714628515373,MATH 197,003,628552,Dumitriu; Ioana,9998,0,9999,1
1714628516402,MCWP 40R,A00,518780,Staff,2,0,20,18
1714628516402,MCWP 40R,B00,518781,Staff,8,0,20,12
1714628516402,MCWP 40R,C00,518783,Staff,6,0,20,14
1714628517428,MCWP 50R,A00,518791,Staff,0,0,20,20
1714628517428,MCWP 50R,B00,518792,Staff,0,2,20,20
1714628517428,MCWP 50R,C00,518793,Staff,0,2,20,20
1714628517428,MCWP 50R,D00,518794,Staff,0,0,20,20
1714628517428,MCWP 50R,E00,518795,Staff,0,2,20,20
1714628517428,MCWP 50R,F00,518796,Staff,0,0,20,20
1714628517428,MCWP 50R,G00,518797,Staff,0,1,20,20
1714628518455,MMW 12R,A01,514034,Herbst; Matthew,0,0,16,16
1714628518455,MMW 12R,A02,514035,Herbst; Matthew,1,0,16,15
1714628519484,MMW 13R,A01,514037,Staff,0,4,16,16
1714628519484,MMW 13R,A02,514039,Staff,0,2,16,16
1714628519484,MMW 13R,A03,628519,Staff,0,2,16,16
1714628521536,SIO 295LS,A00,523233,Staff,10,0,30,20
1714628522559,SIO 295S,A00,523232,Staff,10,0,30,20
1714628523585,SIOC 290S,A01,637330,Merrifield; Mark A,23,0,30,7
1714628524612,SIOC 291S,A01,637333,Gabriel; Corey John,23,0,30,7
1714628525640,SOCI 117,A01,494376,Staff,0,4,5,5
1714628526666,WES 237B,A00,494380,Staff,9,0,20,11
1714628528732,AESE 279B,A00,494370,Wade; Jon P,0,0,33,33
1714628529756,AIP 197,001,627712,Vespa; Emanuel Ignacio,9998,0,9999,1
1714628530785,ANAR 135S,A00,494369,Braswell; Geoffrey E.,0,0,0,0
1714628531810,BENG 196,001,628496,Engler; Adam J.,9998,0,9999,1
1714628532836,CAT 124RS,A01,519847,Geibel; William,0,0,20,20
1714628533872,CAT 125RS,A01,515971,Geibel; William,0,0,20,20
1714628534898,CLRE 250,A00,511389,Morris; Sheldon,9993,0,9999,6
1714628535926,CLRE 251,A00,507176,Mehta; Ravindra L.,9993,0,9999,6
1714628535926,CLRE 251,B00,511410,Mehta; Ravindra L.,9998,0,9999,1
1714628536952,CLRE 252,A00,507189,Cuomo; Raphael Eduardo,9995,0,9999,4
1714628537979,CLRE 253,A00,507199,Vaida; Florin,9994,0,9999,5
1714628537979,CLRE 253,B00,507202,Vaida; Florin,9999,0,9999,0
1714628539006,CLRE 259,A00,507211,Patel; Hemal,9996,0,9999,3
1714628540031,CLRE 260,A00,507221,Cuomo; Raphael Eduardo,9999,0,9999,0
1714628541054,CLRE 297,001,507242,Cuomo; Raphael Eduardo,9999,0,9999,0
1714628542081,COGS 197,001,638244,Voytek; Bradley Thomas,9998,0,9999,1
1714628543108,CSE 191,A00,516875,Minnes Kemp; Mor Mia,9992,0,9999,7
1714628544332,CSE 197,001,637388,Minnes Kemp; Mor Mia,9998,0,9999,1
1714628545359,CSS 201S,A01,494383,Staff,35,0,35,0
1714628546383,CSS 202S,A01,494387,Staff,35,0,35,0
1714628547464,DSC 197,001,628532,Eldridge; Justin Matthew,9996,0,9999,3
1714628548490,EAP 100,A00,516065,Staff,9797,0,9999,202
1714628549515,ECE 45,A01,507414,Staff,33,0,60,27
1714628551566,ECE 111,A01,507420,Staff,15,0,50,35
1714628552593,ECE 197,001,548057,Sievenpiper; Daniel F.,9993,0,9999,6
1714628553620,EDS 115,A00,507243,Choi; Bailey Miyeon,10,0,28,18
1714628554644,EDS 117,A01,494379,Staff,0,4,30,30
1714628555670,EDS 125,A00,507246,Hopkins; Megan Beth,9,0,30,21
1714628556697,EDS 128A,A01,507264,Fargason; Sharon Gayle,8,0,26,18
1714628557722,EDS 128B,A01,507293,Pappas; Elizabeth,12,0,30,18
1714628558749,EDS 139,A00,507294,Fargason; Sharon Gayle,13,0,30,17
1714628558749,EDS 139,B00,507313,Pappas; Elizabeth,13,0,30,17
1714628559774,EDS 201,A00,507315,Staff,13,0,30,17
1714628560804,EDS 203,A01,507317,Halter; Christopher P.,12,0,30,18
1714628561834,EDS 204R,A01,507319,Halter; Christopher P.,0,3,30,30
1714628561834,EDS 204R,B01,507331,Heinzman; Erica M.,16,0,30,14
1714628562859,EDS 206R,A00,507332,Staff,0,4,30,30
1714628562859,EDS 206R,B00,507343,Staff,17,0,30,13
1714628563896,EDS 250,A00,507344,Hemans; Patricia Ann Benitez,22,0,40,18
1714628564922,EDS 281,A00,507345,Daly; Alan J.,18,0,18,0
1714628565947,EDS 284,A00,507350,Daly; Alan J.,16,0,16,0
1714628566972,EDS 286,A00,507359,Fine; Sarah,18,0,18,0
1714628567996,EDS 289C,A01,507361,Daly; Alan J.,18,0,18,0
1714628569022,EDS 290,A00,507366,Hofstetter; Carolyn,15,0,15,0
1714628570047,LIGM 5A,A00,507421,Fischer-Grunski; Eva K,18,0,20,2
1714628571075,LIGM 5B,A00,507423,Fischer-Grunski; Eva K,19,0,20,1
1714628572099,LIGM 5C,A00,507425,Fischer-Grunski; Eva K,19,0,20,1
1714628573128,LIIT 5AS,A00,507427,Carnelos; Chiara,20,0,20,0
1714628574153,LIIT 5BS,A00,507430,Carnelos; Chiara,20,0,20,0
1714628575183,LIIT 5CS,A00,507432,Carnelos; Chiara,20,0,20,0
1714628576209,LISP 5A,A00,507541,Munoz Sanchez; Alicia,11,0,20,9
1714628577236,LISP 5B,A00,507671,Munoz Sanchez; Alicia,8,0,20,12
1714628578261,LISP 5C,A00,507696,Munoz Sanchez; Alicia,9,0,20,11
1714628579287,MAE 197,001,528363,Boechler; Nicholas Sebastia,9998,0,9999,1
1714628580319,MATH 197,001,523477,Kedlaya; Kiran S.,9995,0,9999,4
1714628580319,MATH 197,002,563811,Zhang; Danna,9995,0,9999,4
1714628580319,MATH 197,003,628552,Dumitriu; Ioana,9998,0,9999,1
1714628581346,MCWP 40R,A00,518780,Staff,2,0,20,18
1714628581346,MCWP 40R,B00,518781,Staff,8,0,20,12
1714628581346,MCWP 40R,C00,518783,Staff,6,0,20,14
1714628582372,MCWP 50R,A00,518791,Staff,0,0,20,20
1714628582372,MCWP 50R,B00,518792,Staff,0,2,20,20
1714628582372,MCWP 50R,C00,518793,Staff,0,2,20,20
1714628582372,MCWP 50R,D00,518794,Staff,0,0,20,20
1714628582372,MCWP 50R,E00,518795,Staff,0,2,20,20
1714628582372,MCWP 50R,F00,518796,Staff,0,0,20,20
1714628582372,MCWP 50R,G00,518797,Staff,0,1,20,20
1714628583398,MMW 12R,A01,514034,Herbst; Matthew,0,0,16,16
1714628583398,MMW 12R,A02,514035,Herbst; Matthew,1,0,16,15
1714628584422,MMW 13R,A01,514037,Staff,0,4,16,16
1714628584422,MMW 13R,A02,514039,Staff,0,2,16,16
1714628584422,MMW 13R,A03,628519,Staff,0,2,16,16
1714628586472,SIO 295LS,A00,523233,Staff,10,0,30,20
1714628587495,SIO 295S,A00,523232,Staff,10,0,30,20
1714628588522,SIOC 290S,A01,637330,Merrifield; Mark A,23,0,30,7
1714628589548,SIOC 291S,A01,637333,Gabriel; Corey John,23,0,30,7
1714628590576,SOCI 117,A01,494376,Staff,0,4,5,5
1714628591601,WES 237B,A00,494380,Staff,9,0,20,11
1714628593683,AESE 279B,A00,494370,Wade; Jon P,0,0,33,33
1714628594711,AIP 197,001,627712,Vespa; Emanuel Ignacio,9998,0,9999,1
1714628595739,ANAR 135S,A00,494369,Braswell; Geoffrey E.,0,0,0,0
1714628596763,BENG 196,001,628496,Engler; Adam J.,9998,0,9999,1
1714628597791,CAT 124RS,A01,519847,Geibel; William,0,0,20,20
1714628598819,CAT 125RS,A01,515971,Geibel; William,0,0,20,20
1714628599846,CLRE 250,A00,511389,Morris; Sheldon,9993,0,9999,6
1714628600872,CLRE 251,A00,507176,Mehta; Ravindra L.,9993,0,9999,6
1714628600872,CLRE 251,B00,511410,Mehta; Ravindra L.,9998,0,9999,1
1714628601897,CLRE 252,A00,507189,Cuomo; Raphael Eduardo,9995,0,9999,4
1714628602927,CLRE 253,A00,507199,Vaida; Florin,9994,0,9999,5
1714628602927,CLRE 253,B00,507202,Vaida; Florin,9999,0,9999,0
1714628603956,CLRE 259,A00,507211,Patel; Hemal,9996,0,9999,3
1714628604983,CLRE 260,A00,507221,Cuomo; Raphael Eduardo,9999,0,9999,0
1714628606009,CLRE 297,001,507242,Cuomo; Raphael Eduardo,9999,0,9999,0
1714628607034,COGS 197,001,638244,Voytek; Bradley Thomas,9998,0,9999,1
1714628608063,CSE 191,A00,516875,Minnes Kemp; Mor Mia,9992,0,9999,7
1714628609090,CSE 197,001,637388,Minnes Kemp; Mor Mia,9998,0,9999,1
1714628610116,CSS 201S,A01,494383,Staff,35,0,35,0
1714628611140,CSS 202S,A01,494387,Staff,35,0,35,0
1714628612164,DSC 197,001,628532,Eldridge; Justin Matthew,9996,0,9999,3
1714628613188,EAP 100,A00,516065,Staff,9797,0,9999,202
1714628614213,ECE 45,A01,507414,Staff,33,0,60,27
1714628616271,ECE 111,A01,507420,Staff,15,0,50,35
1714628617298,ECE 197,001,548057,Sievenpiper; Daniel F.,9993,0,9999,6
1714628618326,EDS 115,A00,507243,Choi; Bailey Miyeon,10,0,28,18
1714628619352,EDS 117,A01,494379,Staff,0,4,30,30
1714628620379,EDS 125,A00,507246,Hopkins; Megan Beth,9,0,30,21
1714628621405,EDS 128A,A01,507264,Fargason; Sharon Gayle,8,0,26,18
1714628622435,EDS 128B,A01,507293,Pappas; Elizabeth,12,0,30,18
1714628623459,EDS 139,A00,507294,Fargason; Sharon Gayle,13,0,30,17
1714628623459,EDS 139,B00,507313,Pappas; Elizabeth,13,0,30,17
1714628624483,EDS 201,A00,507315,Staff,13,0,30,17
1714628625513,EDS 203,A01,507317,Halter; Christopher P.,12,0,30,18
1714628626542,EDS 204R,A01,507319,Halter; Christopher P.,0,3,30,30
1714628626542,EDS 204R,B01,507331,Heinzman; Erica M.,16,0,30,14
1714628627567,EDS 206R,A00,507332,Staff,0,4,30,30
1714628627567,EDS 206R,B00,507343,Staff,17,0,30,13
1714628628592,EDS 250,A00,507344,Hemans; Patricia Ann Benitez,22,0,40,18
1714628629617,EDS 281,A00,507345,Daly; Alan J.,18,0,18,0
1714628630642,EDS 284,A00,507350,Daly; Alan J.,16,0,16,0
1714628631669,EDS 286,A00,507359,Fine; Sarah,18,0,18,0
1714628632695,EDS 289C,A01,507361,Daly; Alan J.,18,0,18,0
1714628633722,EDS 290,A00,507366,Hofstetter; Carolyn,15,0,15,0
1714628634752,LIGM 5A,A00,507421,Fischer-Grunski; Eva K,18,0,20,2
1714628635781,LIGM 5B,A00,507423,Fischer-Grunski; Eva K,19,0,20,1
1714628636809,LIGM 5C,A00,507425,Fischer-Grunski; Eva K,19,0,20,1
1714628637839,LIIT 5AS,A00,507427,Carnelos; Chiara,20,0,20,0
1714628638863,LIIT 5BS,A00,507430,Carnelos; Chiara,20,0,20,0
1714628639888,LIIT 5CS,A00,507432,Carnelos; Chiara,20,0,20,0
1714628640915,LISP 5A,A00,507541,Munoz Sanchez; Alicia,11,0,20,9
1714628641940,LISP 5B,A00,507671,Munoz Sanchez; Alicia,8,0,20,12
1714628642970,LISP 5C,A00,507696,Munoz Sanchez; Alicia,9,0,20,11
1714628643999,MAE 197,001,528363,Boechler; Nicholas Sebastia,9998,0,9999,1
1714628645030,MATH 197,001,523477,Kedlaya; Kiran S.,9995,0,9999,4
1714628645030,MATH 197,002,563811,Zhang; Danna,9995,0,9999,4
1714628645030,MATH 197,003,628552,Dumitriu; Ioana,9998,0,9999,1
1714628646055,MCWP 40R,A00,518780,Staff,2,0,20,18
1714628646055,MCWP 40R,B00,518781,Staff,8,0,20,12
1714628646055,MCWP 40R,C00,518783,Staff,6,0,20,14
1714628647084,MCWP 50R,A00,518791,Staff,0,0,20,20
1714628647084,MCWP 50R,B00,518792,Staff,0,2,20,20
1714628647084,MCWP 50R,C00,518793,Staff,0,2,20,20
1714628647084,MCWP 50R,D00,518794,Staff,0,0,20,20
1714628647084,MCWP 50R,E00,518795,Staff,0,2,20,20
1714628647084,MCWP 50R,F00,518796,Staff,0,0,20,20
1714628647084,MCWP 50R,G00,518797,Staff,0,1,20,20
1714628648109,MMW 12R,A01,514034,Herbst; Matthew,0,0,16,16
1714628648109,MMW 12R,A02,514035,Herbst; Matthew,1,0,16,15
1714628649135,MMW 13R,A01,514037,Staff,0,4,16,16
1714628649135,MMW 13R,A02,514039,Staff,0,2,16,16
1714628649135,MMW 13R,A03,628519,Staff,0,2,16,16
1714628651191,SIO 295LS,A00,523233,Staff,10,0,30,20
1714628652219,SIO 295S,A00,523232,Staff,10,0,30,20
1714628653248,SIOC 290S,A01,637330,Merrifield; Mark A,23,0,30,7
1714628654275,SIOC 291S,A01,637333,Gabriel; Corey John,23,0,30,7
1714628655299,SOCI 117,A01,494376,Staff,0,4,5,5
1714628656328,WES 237B,A00,494380,Staff,9,0,20,11
1714628658395,AESE 279B,A00,494370,Wade; Jon P,0,0,33,33
1714628659428,AIP 197,001,627712,Vespa; Emanuel Ignacio,9998,0,9999,1
1714628660453,ANAR 135S,A00,494369,Braswell; Geoffrey E.,0,0,0,0
1714628661478,BENG 196,001,628496,Engler; Adam J.,9998,0,9999,1
1714628662503,CAT 124RS,A01,519847,Geibel; William,0,0,20,20
1714628663528,CAT 125RS,A01,515971,Geibel; William,0,0,20,20
1714628664554,CLRE 250,A00,511389,Morris; Sheldon,9993,0,9999,6
1714628665581,CLRE 251,A00,507176,Mehta; Ravindra L.,9993,0,9999,6
1714628665581,CLRE 251,B00,511410,Mehta; Ravindra L.,9998,0,9999,1
1714628666609,CLRE 252,A00,507189,Cuomo; Raphael Eduardo,9995,0,9999,4
1714628667638,CLRE 253,A00,507199,Vaida; Florin,9994,0,9999,5
1714628667638,CLRE 253,B00,507202,Vaida; Florin,9999,0,9999,0
1714628668664,CLRE 259,A00,507211,Patel; Hemal,9996,0,9999,3
1714628669688,CLRE 260,A00,507221,Cuomo; Raphael Eduardo,9999,0,9999,0
1714628670713,CLRE 297,001,507242,Cuomo; Raphael Eduardo,9999,0,9999,0
1714628671742,COGS 197,001,638244,Voytek; Bradley Thomas,9998,0,9999,1
1714628672768,CSE 191,A00,516875,Minnes Kemp; Mor Mia,9992,0,9999,7
1714628673793,CSE 197,001,637388,Minnes Kemp; Mor Mia,9998,0,9999,1
1714628674824,CSS 201S,A01,494383,Staff,35,0,35,0
1714628675853,CSS 202S,A01,494387,Staff,35,0,35,0
1714628676879,DSC 197,001,628532,Eldridge; Justin Matthew,9996,0,9999,3
1714628677904,EAP 100,A00,516065,Staff,9797,0,9999,202
1714628678930,ECE 45,A01,507414,Staff,33,0,60,27
1714628680988,ECE 111,A01,507420,Staff,15,0,50,35
1714628682019,ECE 197,001,548057,Sievenpiper; Daniel F.,9993,0,9999,6
1714628683049,EDS 115,A00,507243,Choi; Bailey Miyeon,10,0,28,18
1714628684075,EDS 117,A01,494379,Staff,0,4,30,30
1714628685101,EDS 125,A00,507246,Hopkins; Megan Beth,9,0,30,21
1714628686125,EDS 128A,A01,507264,Fargason; Sharon Gayle,8,0,26,18
1714628687149,EDS 128B,A01,507293,Pappas; Elizabeth,12,0,30,18
1714628688174,EDS 139,A00,507294,Fargason; Sharon Gayle,13,0,30,17
1714628688174,EDS 139,B00,507313,Pappas; Elizabeth,13,0,30,17
1714628689198,EDS 201,A00,507315,Staff,13,0,30,17
1714628690223,EDS 203,A01,507317,Halter; Christopher P.,12,0,30,18
1714628691248,EDS 204R,A01,507319,Halter; Christopher P.,0,3,30,30
1714628691248,EDS 204R,B01,507331,Heinzman; Erica M.,16,0,30,14
1714628692273,EDS 206R,A00,507332,Staff,0,4,30,30
1714628692273,EDS 206R,B00,507343,Staff,17,0,30,13
1714628693299,EDS 250,A00,507344,Hemans; Patricia Ann Benitez,22,0,40,18
1714628694323,EDS 281,A00,507345,Daly; Alan J.,18,0,18,0
1714628695351,EDS 284,A00,507350,Daly; Alan J.,16,0,16,0
1714628696380,EDS 286,A00,507359,Fine; Sarah,18,0,18,0
1714628697405,EDS 289C,A01,507361,Daly; Alan J.,18,0,18,0
1714628698433,EDS 290,A00,507366,Hofstetter; Carolyn,15,0,15,0
1714628699466,LIGM 5A,A00,507421,Fischer-Grunski; Eva K,18,0,20,2
1714628700495,LIGM 5B,A00,507423,Fischer-Grunski; Eva K,19,0,20,1
1714628701523,LIGM 5C,A00,507425,Fischer-Grunski; Eva K,19,0,20,1
1714628702548,LIIT 5AS,A00,507427,Carnelos; Chiara,20,0,20,0
1714628703630,LIIT 5BS,A00,507430,Carnelos; Chiara,20,0,20,0
1714628704659,LIIT 5CS,A00,507432,Carnelos; Chiara,20,0,20,0
1714628705687,LISP 5A,A00,507541,Munoz Sanchez; Alicia,11,0,20,9
1714628706714,LISP 5B,A00,507671,Munoz Sanchez; Alicia,8,0,20,12
1714628707738,LISP 5C,A00,507696,Munoz Sanchez; Alicia,9,0,20,11
1714628708762,MAE 197,001,528363,Boechler; Nicholas Sebastia,9998,0,9999,1
1714628709790,MATH 197,001,523477,Kedlaya; Kiran S.,9995,0,9999,4
1714628709790,MATH 197,002,563811,Zhang; Danna,9995,0,9999,4
1714628709790,MATH 197,003,628552,Dumitriu; Ioana,9998,0,9999,1
1714628710818,MCWP 40R,A00,518780,Staff,2,0,20,18
1714628710818,MCWP 40R,B00,518781,Staff,8,0,20,12
1714628710818,MCWP 40R,C00,518783,Staff,6,0,20,14
1714628711844,MCWP 50R,A00,518791,Staff,0,0,20,20
1714628711844,MCWP 50R,B00,518792,Staff,0,2,20,20
1714628711844,MCWP 50R,C00,518793,Staff,0,2,20,20
1714628711844,MCWP 50R,D00,518794,Staff,0,0,20,20
1714628711844,MCWP 50R,E00,518795,Staff,0,2,20,20
1714628711844,MCWP 50R,F00,518796,Staff,0,0,20,20
1714628711844,MCWP 50R,G00,518797,Staff,0,1,20,20
1714628712872,MMW 12R,A01,514034,Herbst; Matthew,0,0,16,16
1714628712872,MMW 12R,A02,514035,Herbst; Matthew,1,0,16,15
1714628713906,MMW 13R,A01,514037,Staff,0,4,16,16
1714628713906,MMW 13R,A02,514039,Staff,0,2,16,16
1714628713906,MMW 13R,A03,628519,Staff,0,2,16,16
1714628715960,SIO 295LS,A00,523233,Staff,10,0,30,20
1714628716988,SIO 295S,A00,523232,Staff,10,0,30,20
1714628718016,SIOC 290S,A01,637330,Merrifield; Mark A,23,0,30,7
1714628719045,SIOC 291S,A01,637333,Gabriel; Corey John,23,0,30,7
1714628720077,SOCI 117,A01,494376,Staff,0,4,5,5
1714628721104,WES 237B,A00,494380,Staff,9,0,20,11
1714628723175,AESE 279B,A00,494370,Wade; Jon P,0,0,33,33
1714628724201,AIP 197,001,627712,Vespa; Emanuel Ignacio,9998,0,9999,1
1714628725229,ANAR 135S,A00,494369,Braswell; Geoffrey E.,0,0,0,0
1714628726307,BENG 196,001,628496,Engler; Adam J.,9998,0,9999,1
1714628727336,CAT 124RS,A01,519847,Geibel; William,0,0,20,20
1714628728360,CAT 125RS,A01,515971,Geibel; William,0,0,20,20
1714628729389,CLRE 250,A00,511389,Morris; Sheldon,9993,0,9999,6
1714628730415,CLRE 251,A00,507176,Mehta; Ravindra L.,9993,0,9999,6
1714628730415,CLRE 251,B00,511410,Mehta; Ravindra L.,9998,0,9999,1
1714628731444,CLRE 252,A00,507189,Cuomo; Raphael Eduardo,9995,0,9999,4
1714628732474,CLRE 253,A00,507199,Vaida; Florin,9994,0,9999,5
1714628732474,CLRE 253,B00,507202,Vaida; Florin,9999,0,9999,0
1714628733499,CLRE 259,A00,507211,Patel; Hemal,9996,0,9999,3
1714628734523,CLRE 260,A00,507221,Cuomo; Raphael Eduardo,9999,0,9999,0
1714628735549,CLRE 297,001,507242,Cuomo; Raphael Eduardo,9999,0,9999,0
1714628736575,COGS 197,001,638244,Voytek; Bradley Thomas,9998,0,9999,1
1714628737598,CSE 191,A00,516875,Minnes Kemp; Mor Mia,9992,0,9999,7
1714628738626,CSE 197,001,637388,Minnes Kemp; Mor Mia,9998,0,9999,1
1714628739656,CSS 201S,A01,494383,Staff,35,0,35,0
1714628740681,CSS 202S,A01,494387,Staff,35,0,35,0
1714628741710,DSC 197,001,628532,Eldridge; Justin Matthew,9996,0,9999,3
1714628742739,EAP 100,A00,516065,Staff,9797,0,9999,202
1714628743764,ECE 45,A01,507414,Staff,33,0,60,27
1714628745814,ECE 111,A01,507420,Staff,15,0,50,35
1714628746838,ECE 197,001,548057,Sievenpiper; Daniel F.,9993,0,9999,6
1714628747869,EDS 115,A00,507243,Choi; Bailey Miyeon,10,0,28,18
1714628748894,EDS 117,A01,494379,Staff,0,4,30,30
1714628749922,EDS 125,A00,507246,Hopkins; Megan Beth,9,0,30,21
1714628750951,EDS 128A,A01,507264,Fargason; Sharon Gayle,8,0,26,18
1714628751979,EDS 128B,A01,507293,Pappas; Elizabeth,12,0,30,18
1714628753005,EDS 139,A00,507294,Fargason; Sharon Gayle,13,0,30,17
1714628753005,EDS 139,B00,507313,Pappas; Elizabeth,13,0,30,17
1714628754031,EDS 201,A00,507315,Staff,13,0,30,17
1714628755060,EDS 203,A01,507317,Halter; Christopher P.,12,0,30,18
1714628756087,EDS 204R,A01,507319,Halter; Christopher P.,0,3,30,30
1714628756087,EDS 204R,B01,507331,Heinzman; Erica M.,16,0,30,14
1714628757115,EDS 206R,A00,507332,Staff,0,4,30,30
1714628757115,EDS 206R,B00,507343,Staff,17,0,30,13
1714628758139,EDS 250,A00,507344,Hemans; Patricia Ann Benitez,22,0,40,18
1714628759165,EDS 281,A00,507345,Daly; Alan J.,18,0,18,0
1714628760192,EDS 284,A00,507350,Daly; Alan J.,16,0,16,0
1714628761217,EDS 286,A00,507359,Fine; Sarah,18,0,18,0
1714628762246,EDS 289C,A01,507361,Daly; Alan J.,18,0,18,0
1714628763272,EDS 290,A00,507366,Hofstetter; Carolyn,15,0,15,0
1714628764304,LIGM 5A,A00,507421,Fischer-Grunski; Eva K,18,0,20,2
1714628765329,LIGM 5B,A00,507423,Fischer-Grunski; Eva K,19,0,20,1
1714628766356,LIGM 5C,A00,507425,Fischer-Grunski; Eva K,19,0,20,1
1714628767387,LIIT 5AS,A00,507427,Carnelos; Chiara,20,0,20,0
1714628768415,LIIT 5BS,A00,507430,Carnelos; Chiara,20,0,20,0
1714628769445,LIIT 5CS,A00,507432,Carnelos; Chiara,20,0,20,0
1714628770470,LISP 5A,A00,507541,Munoz Sanchez; Alicia,11,0,20,9
1714628771494,LISP 5B,A00,507671,Munoz Sanchez; Alicia,8,0,20,12
1714628772517,LISP 5C,A00,507696,Munoz Sanchez; Alicia,9,0,20,11
1714628773546,MAE 197,001,528363,Boechler; Nicholas Sebastia,9998,0,9999,1
1714628774574,MATH 197,001,523477,Kedlaya; Kiran S.,9995,0,9999,4
1714628774574,MATH 197,002,563811,Zhang; Danna,9995,0,9999,4
1714628774574,MATH 197,003,628552,Dumitriu; Ioana,9998,0,9999,1
1714628775599,MCWP 40R,A00,518780,Staff,2,0,20,18
1714628775599,MCWP 40R,B00,518781,Staff,8,0,20,12
1714628775599,MCWP 40R,C00,518783,Staff,6,0,20,14
1714628776654,MCWP 50R,A00,518791,Staff,0,0,20,20
1714628776654,MCWP 50R,B00,518792,Staff,0,2,20,20
1714628776654,MCWP 50R,C00,518793,Staff,0,2,20,20
1714628776654,MCWP 50R,D00,518794,Staff,0,0,20,20
1714628776654,MCWP 50R,E00,518795,Staff,0,2,20,20
1714628776654,MCWP 50R,F00,518796,Staff,0,0,20,20
1714628776654,MCWP 50R,G00,518797,Staff,0,1,20,20
1714628777681,MMW 12R,A01,514034,Herbst; Matthew,0,0,16,16
1714628777681,MMW 12R,A02,514035,Herbst; Matthew,1,0,16,15
1714628778706,MMW 13R,A01,514037,Staff,0,4,16,16
1714628778706,MMW 13R,A02,514039,Staff,0,2,16,16
1714628778706,MMW 13R,A03,628519,Staff,0,2,16,16
1714628780760,SIO 295LS,A00,523233,Staff,10,0,30,20
1714628781786,SIO 295S,A00,523232,Staff,10,0,30,20
1714628782816,SIOC 290S,A01,637330,Merrifield; Mark A,23,0,30,7
1714628783842,SIOC 291S,A01,637333,Gabriel; Corey John,23,0,30,7
1714628784869,SOCI 117,A01,494376,Staff,0,4,5,5
1714628785895,WES 237B,A00,494380,Staff,9,0,20,11
1714628787961,AESE 279B,A00,494370,Wade; Jon P,0,0,33,33
1714628788987,AIP 197,001,627712,Vespa; Emanuel Ignacio,9998,0,9999,1
1714628790015,ANAR 135S,A00,494369,Braswell; Geoffrey E.,0,0,0,0
1714628791042,BENG 196,001,628496,Engler; Adam J.,9998,0,9999,1
1714628792069,CAT 124RS,A01,519847,Geibel; William,0,0,20,20
1714628793097,CAT 125RS,A01,515971,Geibel; William,0,0,20,20
1714628794123,CLRE 250,A00,511389,Morris; Sheldon,9993,0,9999,6
1714628795150,CLRE 251,A00,507176,Mehta; Ravindra L.,9993,0,9999,6
1714628795150,CLRE 251,B00,511410,Mehta; Ravindra L.,9998,0,9999,1
1714628796175,CLRE 252,A00,507189,Cuomo; Raphael Eduardo,9995,0,9999,4
1714628797204,CLRE 253,A00,507199,Vaida; Florin,9994,0,9999,5
1714628797204,CLRE 253,B00,507202,Vaida; Florin,9999,0,9999,0
1714628798231,CLRE 259,A00,507211,Patel; Hemal,9996,0,9999,3
1714628799258,CLRE 260,A00,507221,Cuomo; Raphael Eduardo,9999,0,9999,0
1714628800285,CLRE 297,001,507242,Cuomo; Raphael Eduardo,9999,0,9999,0
1714628801309,COGS 197,001,638244,Voytek; Bradley Thomas,9998,0,9999,1
1714628802336,CSE 191,A00,516875,Minnes Kemp; Mor Mia,9992,0,9999,7
1714628803360,CSE 197,001,637388,Minnes Kemp; Mor Mia,9998,0,9999,1
1714628804388,CSS 201S,A01,494383,Staff,35,0,35,0
1714628805418,CSS 202S,A01,494387,Staff,35,0,35,0
1714628806442,DSC 197,001,628532,Eldridge; Justin Matthew,9996,0,9999,3
1714628807469,EAP 100,A00,516065,Staff,9797,0,9999,202
1714628808494,ECE 45,A01,507414,Staff,33,0,60,27
1714628810548,ECE 111,A01,507420,Staff,15,0,50,35
1714628811576,ECE 197,001,548057,Sievenpiper; Daniel F.,9993,0,9999,6
1714628812604,EDS 115,A00,507243,Choi; Bailey Miyeon,10,0,28,18
1714628813635,EDS 117,A01,494379,Staff,0,4,30,30
1714628814662,EDS 125,A00,507246,Hopkins; Megan Beth,9,0,30,21
1714628815691,EDS 128A,A01,507264,Fargason; Sharon Gayle,8,0,26,18
1714628816717,EDS 128B,A01,507293,Pappas; Elizabeth,12,0,30,18
1714628817743,EDS 139,A00,507294,Fargason; Sharon Gayle,13,0,30,17
1714628817743,EDS 139,B00,507313,Pappas; Elizabeth,13,0,30,17
1714628818768,EDS 201,A00,507315,Staff,13,0,30,17
1714628819793,EDS 203,A01,507317,Halter; Christopher P.,12,0,30,18
1714628820817,EDS 204R,A01,507319,Halter; Christopher P.,0,3,30,30
1714628820817,EDS 204R,B01,507331,Heinzman; Erica M.,16,0,30,14
1714628821844,EDS 206R,A00,507332,Staff,0,4,30,30
1714628821844,EDS 206R,B00,507343,Staff,17,0,30,13
1714628822873,EDS 250,A00,507344,Hemans; Patricia Ann Benitez,22,0,40,18
1714628823896,EDS 281,A00,507345,Daly; Alan J.,18,0,18,0
1714628824921,EDS 284,A00,507350,Daly; Alan J.,16,0,16,0
1714628825950,EDS 286,A00,507359,Fine; Sarah,18,0,18,0
1714628826974,EDS 289C,A01,507361,Daly; Alan J.,18,0,18,0
1714628828003,EDS 290,A00,507366,Hofstetter; Carolyn,15,0,15,0
1714628829029,LIGM 5A,A00,507421,Fischer-Grunski; Eva K,18,0,20,2
1714628830054,LIGM 5B,A00,507423,Fischer-Grunski; Eva K,19,0,20,1
1714628831078,LIGM 5C,A00,507425,Fischer-Grunski; Eva K,19,0,20,1
1714628832109,LIIT 5AS,A00,507427,Carnelos; Chiara,20,0,20,0
1714628833138,LIIT 5BS,A00,507430,Carnelos; Chiara,20,0,20,0
1714628834163,LIIT 5CS,A00,507432,Carnelos; Chiara,20,0,20,0
1714628835188,LISP 5A,A00,507541,Munoz Sanchez; Alicia,11,0,20,9
1714628836214,LISP 5B,A00,507671,Munoz Sanchez; Alicia,8,0,20,12
1714628837243,LISP 5C,A00,507696,Munoz Sanchez; Alicia,9,0,20,11
1714628838268,MAE 197,001,528363,Boechler; Nicholas Sebastia,9998,0,9999,1
1714628839293,MATH 197,001,523477,Kedlaya; Kiran S.,9995,0,9999,4
1714628839293,MATH 197,002,563811,Zhang; Danna,9995,0,9999,4
1714628839293,MATH 197,003,628552,Dumitriu; Ioana,9998,0,9999,1
1714628840320,MCWP 40R,A00,518780,Staff,2,0,20,18
1714628840320,MCWP 40R,B00,518781,Staff,8,0,20,12
1714628840320,MCWP 40R,C00,518783,Staff,6,0,20,14
1714628841347,MCWP 50R,A00,518791,Staff,0,0,20,20
1714628841347,MCWP 50R,B00,518792,Staff,0,2,20,20
1714628841347,MCWP 50R,C00,518793,Staff,0,2,20,20
1714628841347,MCWP 50R,D00,518794,Staff,0,0,20,20
1714628841347,MCWP 50R,E00,518795,Staff,0,2,20,20
1714628841347,MCWP 50R,F00,518796,Staff,0,0,20,20
1714628841347,MCWP 50R,G00,518797,Staff,0,1,20,20
1714628842371,MMW 12R,A01,514034,Herbst; Matthew,0,0,16,16
1714628842371,MMW 12R,A02,514035,Herbst; Matthew,1,0,16,15
1714628843400,MMW 13R,A01,514037,Staff,0,4,16,16
1714628843400,MMW 13R,A02,514039,Staff,0,2,16,16
1714628843400,MMW 13R,A03,628519,Staff,0,2,16,16
1714628845451,SIO 295LS,A00,523233,Staff,10,0,30,20
1714628846477,SIO 295S,A00,523232,Staff,10,0,30,20
1714628847503,SIOC 290S,A01,637330,Merrifield; Mark A,23,0,30,7
1714628848527,SIOC 291S,A01,637333,Gabriel; Corey John,23,0,30,7
1714628849561,SOCI 117,A01,494376,Staff,0,4,5,5
1714628850591,WES 237B,A00,494380,Staff,9,0,20,11
1714628852662,AESE 279B,A00,494370,Wade; Jon P,0,0,33,33
1714628853688,AIP 197,001,627712,Vespa; Emanuel Ignacio,9998,0,9999,1
1714628854713,ANAR 135S,A00,494369,Braswell; Geoffrey E.,0,0,0,0
1714628855738,BENG 196,001,628496,Engler; Adam J.,9998,0,9999,1
1714628856765,CAT 124RS,A01,519847,Geibel; William,0,0,20,20
1714628857792,CAT 125RS,A01,515971,Geibel; William,0,0,20,20
1714628858821,CLRE 250,A00,511389,Morris; Sheldon,9993,0,9999,6
1714628859854,CLRE 251,A00,507176,Mehta; Ravindra L.,9993,0,9999,6
1714628859854,CLRE 251,B00,511410,Mehta; Ravindra L.,9998,0,9999,1
1714628860880,CLRE 252,A00,507189,Cuomo; Raphael Eduardo,9995,0,9999,4
1714628861909,CLRE 253,A00,507199,Vaida; Florin,9994,0,9999,5
1714628861909,CLRE 253,B00,507202,Vaida; Florin,9999,0,9999,0
1714628862936,CLRE 259,A00,507211,Patel; Hemal,9996,0,9999,3
1714628863962,CLRE 260,A00,507221,Cuomo; Raphael Eduardo,9999,0,9999,0
1714628864989,CLRE 297,001,507242,Cuomo; Raphael Eduardo,9999,0,9999,0
1714628866015,COGS 197,001,638244,Voytek; Bradley Thomas,9998,0,9999,1
1714628867038,CSE 191,A00,516875,Minnes Kemp; Mor Mia,9992,0,9999,7
1714628868065,CSE 197,001,637388,Minnes Kemp; Mor Mia,9998,0,9999,1
1714628869096,CSS 201S,A01,494383,Staff,35,0,35,0
1714628870121,CSS 202S,A01,494387,Staff,35,0,35,0
1714628871148,DSC 197,001,628532,Eldridge; Justin Matthew,9996,0,9999,3
1714628872176,EAP 100,A00,516065,Staff,9797,0,9999,202
1714628873201,ECE 45,A01,507414,Staff,33,0,60,27
1714628875262,ECE 111,A01,507420,Staff,15,0,50,35
1714628876286,ECE 197,001,548057,Sievenpiper; Daniel F.,9993,0,9999,6
1714628877312,EDS 115,A00,507243,Choi; Bailey Miyeon,10,0,28,18
1714628878338,EDS 117,A01,494379,Staff,0,4,30,30
1714628879367,EDS 125,A00,507246,Hopkins; Megan Beth,9,0,30,21
1714628880390,EDS 128A,A01,507264,Fargason; Sharon Gayle,8,0,26,18
1714628881416,EDS 128B,A01,507293,Pappas; Elizabeth,12,0,30,18
1714628882443,EDS 139,A00,507294,Fargason; Sharon Gayle,13,0,30,17
1714628882443,EDS 139,B00,507313,Pappas; Elizabeth,13,0,30,17
1714628883469,EDS 201,A00,507315,Staff,13,0,30,17
1714628884499,EDS 203,A01,507317,Halter; Christopher P.,12,0,30,18
1714628885526,EDS 204R,A01,507319,Halter; Christopher P.,0,3,30,30
1714628885526,EDS 204R,B01,507331,Heinzman; Erica M.,16,0,30,14
1714628886550,EDS 206R,A00,507332,Staff,0,4,30,30
1714628886550,EDS 206R,B00,507343,Staff,17,0,30,13
1714628887574,EDS 250,A00,507344,Hemans; Patricia Ann Benitez,22,0,40,18
1714628888598,EDS 281,A00,507345,Daly; Alan J.,18,0,18,0
1714628889632,EDS 284,A00,507350,Daly; Alan J.,16,0,16,0
1714628890656,EDS 286,A00,507359,Fine; Sarah,18,0,18,0
1714628891684,EDS 289C,A01,507361,Daly; Alan J.,18,0,18,0
1714628892712,EDS 290,A00,507366,Hofstetter; Carolyn,15,0,15,0
1714628893743,LIGM 5A,A00,507421,Fischer-Grunski; Eva K,18,0,20,2
1714628894770,LIGM 5B,A00,507423,Fischer-Grunski; Eva K,19,0,20,1
1714628895794,LIGM 5C,A00,507425,Fischer-Grunski; Eva K,19,0,20,1
1714628896824,LIIT 5AS,A00,507427,Carnelos; Chiara,20,0,20,0
1714628897850,LIIT 5BS,A00,507430,Carnelos; Chiara,20,0,20,0
1714628898877,LIIT 5CS,A00,507432,Carnelos; Chiara,20,0,20,0
1714628899902,LISP 5A,A00,507541,Munoz Sanchez; Alicia,11,0,20,9
1714628900929,LISP 5B,A00,507671,Munoz Sanchez; Alicia,8,0,20,12
1714628901957,LISP 5C,A00,507696,Munoz Sanchez; Alicia,9,0,20,11
1714628902989,MAE 197,001,528363,Boechler; Nicholas Sebastia,9998,0,9999,1
1714628904015,MATH 197,001,523477,Kedlaya; Kiran S.,9995,0,9999,4
1714628904015,MATH 197,002,563811,Zhang; Danna,9995,0,9999,4
1714628904015,MATH 197,003,628552,Dumitriu; Ioana,9998,0,9999,1
1714628905040,MCWP 40R,A00,518780,Staff,2,0,20,18
1714628905040,MCWP 40R,B00,518781,Staff,8,0,20,12
1714628905040,MCWP 40R,C00,518783,Staff,6,0,20,14
1714628906066,MCWP 50R,A00,518791,Staff,0,0,20,20
1714628906066,MCWP 50R,B00,518792,Staff,0,2,20,20
1714628906066,MCWP 50R,C00,518793,Staff,0,2,20,20
1714628906066,MCWP 50R,D00,518794,Staff,0,0,20,20
1714628906066,MCWP 50R,E00,518795,Staff,0,2,20,20
1714628906066,MCWP 50R,F00,518796,Staff,0,0,20,20
1714628906066,MCWP 50R,G00,518797,Staff,0,1,20,20
1714628907097,MMW 12R,A01,514034,Herbst; Matthew,0,0,16,16
1714628907097,MMW 12R,A02,514035,Herbst; Matthew,1,0,16,15
1714628908122,MMW 13R,A01,514037,Staff,0,4,16,16
1714628908122,MMW 13R,A02,514039,Staff,0,2,16,16
1714628908122,MMW 13R,A03,628519,Staff,0,2,16,16
1714628910172,SIO 295LS,A00,523233,Staff,10,0,30,20
1714628911198,SIO 295S,A00,523232,Staff,10,0,30,20
1714628912224,SIOC 290S,A01,637330,Merrifield; Mark A,23,0,30,7
1714628913249,SIOC 291S,A01,637333,Gabriel; Corey John,23,0,30,7
1714628914275,SOCI 117,A01,494376,Staff,0,4,5,5
1714628915300,WES 237B,A00,494380,Staff,9,0,20,11
1714628917370,AESE 279B,A00,494370,Wade; Jon P,0,0,33,33
1714628918394,AIP 197,001,627712,Vespa; Emanuel Ignacio,9998,0,9999,1
1714628919418,ANAR 135S,A00,494369,Braswell; Geoffrey E.,0,0,0,0
1714628920444,BENG 196,001,628496,Engler; Adam J.,9998,0,9999,1
1714628921472,CAT 124RS,A01,519847,Geibel; William,0,0,20,20
1714628922504,CAT 125RS,A01,515971,Geibel; William,0,0,20,20
1714628923530,CLRE 250,A00,511389,Morris; Sheldon,9993,0,9999,6
1714628924558,CLRE 251,A00,507176,Mehta; Ravindra L.,9993,0,9999,6
1714628924558,CLRE 251,B00,511410,Mehta; Ravindra L.,9998,0,9999,1
1714628925586,CLRE 252,A00,507189,Cuomo; Raphael Eduardo,9995,0,9999,4
1714628926610,CLRE 253,A00,507199,Vaida; Florin,9994,0,9999,5
1714628926610,CLRE 253,B00,507202,Vaida; Florin,9999,0,9999,0
1714628927635,CLRE 259,A00,507211,Patel; Hemal,9996,0,9999,3
1714628928663,CLRE 260,A00,507221,Cuomo; Raphael Eduardo,9999,0,9999,0
1714628929686,CLRE 297,001,507242,Cuomo; Raphael Eduardo,9999,0,9999,0
1714628930710,COGS 197,001,638244,Voytek; Bradley Thomas,9998,0,9999,1
1714628931735,CSE 191,A00,516875,Minnes Kemp; Mor Mia,9992,0,9999,7
1714628932760,CSE 197,001,637388,Minnes Kemp; Mor Mia,9998,0,9999,1
1714628933787,CSS 201S,A01,494383,Staff,35,0,35,0
1714628934812,CSS 202S,A01,494387,Staff,35,0,35,0
1714628935836,DSC 197,001,628532,Eldridge; Justin Matthew,9996,0,9999,3
1714628936885,EAP 100,A00,516065,Staff,9797,0,9999,202
1714628937915,ECE 45,A01,507414,Staff,33,0,60,27
1714628939967,ECE 111,A01,507420,Staff,15,0,50,35
1714628940993,ECE 197,001,548057,Sievenpiper; Daniel F.,9993,0,9999,6
1714628942021,EDS 115,A00,507243,Choi; Bailey Miyeon,10,0,28,18
1714628943046,EDS 117,A01,494379,Staff,0,4,30,30
1714628944071,EDS 125,A00,507246,Hopkins; Megan Beth,9,0,30,21
1714628945099,EDS 128A,A01,507264,Fargason; Sharon Gayle,8,0,26,18
1714628946124,EDS 128B,A01,507293,Pappas; Elizabeth,12,0,30,18
1714628947150,EDS 139,A00,507294,Fargason; Sharon Gayle,13,0,30,17
1714628947150,EDS 139,B00,507313,Pappas; Elizabeth,13,0,30,17
1714628948173,EDS 201,A00,507315,Staff,13,0,30,17
1714628949201,EDS 203,A01,507317,Halter; Christopher P.,12,0,30,18
1714628950231,EDS 204R,A01,507319,Halter; Christopher P.,0,3,30,30
1714628950231,EDS 204R,B01,507331,Heinzman; Erica M.,16,0,30,14
1714628951254,EDS 206R,A00,507332,Staff,0,4,30,30
1714628951254,EDS 206R,B00,507343,Staff,17,0,30,13
1714628952284,EDS 250,A00,507344,Hemans; Patricia Ann Benitez,22,0,40,18
1714628953307,EDS 281,A00,507345,Daly; Alan J.,18,0,18,0
1714628954331,EDS 284,A00,507350,Daly; Alan J.,16,0,16,0
1714628955359,EDS 286,A00,507359,Fine; Sarah,18,0,18,0
1714628956385,EDS 289C,A01,507361,Daly; Alan J.,18,0,18,0
1714628957411,EDS 290,A00,507366,Hofstetter; Carolyn,15,0,15,0
1714628958442,LIGM 5A,A00,507421,Fischer-Grunski; Eva K,18,0,20,2
1714628959468,LIGM 5B,A00,507423,Fischer-Grunski; Eva K,19,0,20,1
1714628960493,LIGM 5C,A00,507425,Fischer-Grunski; Eva K,19,0,20,1
1714628961522,LIIT 5AS,A00,507427,Carnelos; Chiara,20,0,20,0
1714628962547,LIIT 5BS,A00,507430,Carnelos; Chiara,20,0,20,0
1714628963573,LIIT 5CS,A00,507432,Carnelos; Chiara,20,0,20,0
1714628964605,LISP 5A,A00,507541,Munoz Sanchez; Alicia,11,0,20,9
1714628965628,LISP 5B,A00,507671,Munoz Sanchez; Alicia,8,0,20,12
1714628966655,LISP 5C,A00,507696,Munoz Sanchez; Alicia,9,0,20,11
1714628967684,MAE 197,001,528363,Boechler; Nicholas Sebastia,9998,0,9999,1
1714628968715,MATH 197,001,523477,Kedlaya; Kiran S.,9995,0,9999,4
1714628968715,MATH 197,002,563811,Zhang; Danna,9995,0,9999,4
1714628968715,MATH 197,003,628552,Dumitriu; Ioana,9998,0,9999,1
1714628969739,MCWP 40R,A00,518780,Staff,2,0,20,18
1714628969739,MCWP 40R,B00,518781,Staff,8,0,20,12
1714628969739,MCWP 40R,C00,518783,Staff,6,0,20,14
1714628970764,MCWP 50R,A00,518791,Staff,0,0,20,20
1714628970764,MCWP 50R,B00,518792,Staff,0,2,20,20
1714628970764,MCWP 50R,C00,518793,Staff,0,2,20,20
1714628970764,MCWP 50R,D00,518794,Staff,0,0,20,20
1714628970764,MCWP 50R,E00,518795,Staff,0,2,20,20
1714628970764,MCWP 50R,F00,518796,Staff,0,0,20,20
1714628970764,MCWP 50R,G00,518797,Staff,0,1,20,20
1714628971793,MMW 12R,A01,514034,Herbst; Matthew,0,0,16,16
1714628971793,MMW 12R,A02,514035,Herbst; Matthew,1,0,16,15
1714628972823,MMW 13R,A01,514037,Staff,0,4,16,16
1714628972823,MMW 13R,A02,514039,Staff,0,2,16,16
1714628972823,MMW 13R,A03,628519,Staff,0,2,16,16
1714628974874,SIO 295LS,A00,523233,Staff,10,0,30,20
1714628975899,SIO 295S,A00,523232,Staff,10,0,30,20
1714628976925,SIOC 290S,A01,637330,Merrifield; Mark A,23,0,30,7
1714628977951,SIOC 291S,A01,637333,Gabriel; Corey John,23,0,30,7
1714628978977,SOCI 117,A01,494376,Staff,0,4,5,5
1714628980002,WES 237B,A00,494380,Staff,9,0,20,11
1714628982081,AESE 279B,A00,494370,Wade; Jon P,0,0,33,33
1714628983106,AIP 197,001,627712,Vespa; Emanuel Ignacio,9998,0,9999,1
1714628984134,ANAR 135S,A00,494369,Braswell; Geoffrey E.,0,0,0,0
1714628985162,BENG 196,001,628496,Engler; Adam J.,9998,0,9999,1
1714628986189,CAT 124RS,A01,519847,Geibel; William,0,0,20,20
1714628987215,CAT 125RS,A01,515971,Geibel; William,0,0,20,20
1714628988245,CLRE 250,A00,511389,Morris; Sheldon,9993,0,9999,6
1714628989277,CLRE 251,A00,507176,Mehta; Ravindra L.,9993,0,9999,6
1714628989277,CLRE 251,B00,511410,Mehta; Ravindra L.,9998,0,9999,1
1714628990302,CLRE 252,A00,507189,Cuomo; Raphael Eduardo,9995,0,9999,4
1714628991331,CLRE 253,A00,507199,Vaida; Florin,9994,0,9999,5
1714628991331,CLRE 253,B00,507202,Vaida; Florin,9999,0,9999,0
1714628992356,CLRE 259,A00,507211,Patel; Hemal,9996,0,9999,3
1714628993380,CLRE 260,A00,507221,Cuomo; Raphael Eduardo,9999,0,9999,0
1714628994405,CLRE 297,001,507242,Cuomo; Raphael Eduardo,9999,0,9999,0
1714628995435,COGS 197,001,638244,Voytek; Bradley Thomas,9998,0,9999,1
1714628996460,CSE 191,A00,516875,Minnes Kemp; Mor Mia,9992,0,9999,7
1714628997488,CSE 197,001,637388,Minnes Kemp; Mor Mia,9998,0,9999,1
1714628998513,CSS 201S,A01,494383,Staff,35,0,35,0
1714628999543,CSS 202S,A01,494387,Staff,35,0,35,0
1714629000568,DSC 197,001,628532,Eldridge; Justin Matthew,9996,0,9999,3
1714629001594,EAP 100,A00,516065,Staff,9797,0,9999,202
1714629002621,ECE 45,A01,507414,Staff,33,0,60,27
1714629004672,ECE 111,A01,507420,Staff,15,0,50,35
1714629005697,ECE 197,001,548057,Sievenpiper; Daniel F.,9993,0,9999,6
1714629006723,EDS 115,A00,507243,Choi; Bailey Miyeon,10,0,28,18
1714629007748,EDS 117,A01,494379,Staff,0,4,30,30
1714629008776,EDS 125,A00,507246,Hopkins; Megan Beth,9,0,30,21
1714629009800,EDS 128A,A01,507264,Fargason; Sharon Gayle,8,0,26,18
1714629010825,EDS 128B,A01,507293,Pappas; Elizabeth,12,0,30,18
1714629011850,EDS 139,A00,507294,Fargason; Sharon Gayle,13,0,30,17
1714629011850,EDS 139,B00,507313,Pappas; Elizabeth,13,0,30,17
1714629012874,EDS 201,A00,507315,Staff,13,0,30,17
1714629013907,EDS 203,A01,507317,Halter; Christopher P.,12,0,30,18
1714629014934,EDS 204R,A01,507319,Halter; Christopher P.,0,3,30,30
1714629014934,EDS 204R,B01,507331,Heinzman; Erica M.,16,0,30,14
1714629015963,EDS 206R,A00,507332,Staff,0,4,30,30
1714629015963,EDS 206R,B00,507343,Staff,17,0,30,13
1714629016989,EDS 250,A00,507344,Hemans; Patricia Ann Benitez,22,0,40,18
1714629018014,EDS 281,A00,507345,Daly; Alan J.,18,0,18,0
1714629019039,EDS 284,A00,507350,Daly; Alan J.,16,0,16,0
1714629020067,EDS 286,A00,507359,Fine; Sarah,18,0,18,0
1714629021093,EDS 289C,A01,507361,Daly; Alan J.,18,0,18,0
1714629022119,EDS 290,A00,507366,Hofstetter; Carolyn,15,0,15,0
1714629023145,LIGM 5A,A00,507421,Fischer-Grunski; Eva K,18,0,20,2
1714629024171,LIGM 5B,A00,507423,Fischer-Grunski; Eva K,19,0,20,1
1714629025200,LIGM 5C,A00,507425,Fischer-Grunski; Eva K,19,0,20,1
1714629026225,LIIT 5AS,A00,507427,Carnelos; Chiara,20,0,20,0
1714629027251,LIIT 5BS,A00,507430,Carnelos; Chiara,20,0,20,0
1714629028282,LIIT 5CS,A00,507432,Carnelos; Chiara,20,0,20,0
1714629029308,LISP 5A,A00,507541,Munoz Sanchez; Alicia,11,0,20,9
1714629030332,LISP 5B,A00,507671,Munoz Sanchez; Alicia,8,0,20,12
1714629031357,LISP 5C,A00,507696,Munoz Sanchez; Alicia,9,0,20,11
1714629032384,MAE 197,001,528363,Boechler; Nicholas Sebastia,9998,0,9999,1
1714629033415,MATH 197,001,523477,Kedlaya; Kiran S.,9995,0,9999,4
1714629033415,MATH 197,002,563811,Zhang; Danna,9995,0,9999,4
1714629033415,MATH 197,003,628552,Dumitriu; Ioana,9998,0,9999,1
1714629034443,MCWP 40R,A00,518780,Staff,2,0,20,18
1714629034443,MCWP 40R,B00,518781,Staff,8,0,20,12
1714629034443,MCWP 40R,C00,518783,Staff,6,0,20,14
1714629035469,MCWP 50R,A00,518791,Staff,0,0,20,20
1714629035469,MCWP 50R,B00,518792,Staff,0,2,20,20
1714629035469,MCWP 50R,C00,518793,Staff,0,2,20,20
1714629035469,MCWP 50R,D00,518794,Staff,0,0,20,20
1714629035469,MCWP 50R,E00,518795,Staff,0,2,20,20
1714629035469,MCWP 50R,F00,518796,Staff,0,0,20,20
1714629035469,MCWP 50R,G00,518797,Staff,0,1,20,20
1714629036498,MMW 12R,A01,514034,Herbst; Matthew,0,0,16,16
1714629036498,MMW 12R,A02,514035,Herbst; Matthew,1,0,16,15
1714629037522,MMW 13R,A01,514037,Staff,0,4,16,16
1714629037522,MMW 13R,A02,514039,Staff,0,2,16,16
1714629037522,MMW 13R,A03,628519,Staff,0,2,16,16
1714629039574,SIO 295LS,A00,523233,Staff,10,0,30,20
1714629040599,SIO 295S,A00,523232,Staff,10,0,30,20
1714629041624,SIOC 290S,A01,637330,Merrifield; Mark A,23,0,30,7
1714629042655,SIOC 291S,A01,637333,Gabriel; Corey John,23,0,30,7
1714629043680,SOCI 117,A01,494376,Staff,0,4,5,5
1714629044708,WES 237B,A00,494380,Staff,9,0,20,11
1714629046789,AESE 279B,A00,494370,Wade; Jon P,0,0,33,33
1714629047815,AIP 197,001,627712,Vespa; Emanuel Ignacio,9998,0,9999,1
1714629048841,ANAR 135S,A00,494369,Braswell; Geoffrey E.,0,0,0,0
1714629049870,BENG 196,001,628496,Engler; Adam J.,9998,0,9999,1
1714629050897,CAT 124RS,A01,519847,Geibel; William,0,0,20,20
1714629051922,CAT 125RS,A01,515971,Geibel; William,0,0,20,20
1714629052952,CLRE 250,A00,511389,Morris; Sheldon,9993,0,9999,6
1714629053980,CLRE 251,A00,507176,Mehta; Ravindra L.,9993,0,9999,6
1714629053980,CLRE 251,B00,511410,Mehta; Ravindra L.,9998,0,9999,1
1714629055007,CLRE 252,A00,507189,Cuomo; Raphael Eduardo,9995,0,9999,4
1714629056036,CLRE 253,A00,507199,Vaida; Florin,9994,0,9999,5
1714629056036,CLRE 253,B00,507202,Vaida; Florin,9999,0,9999,0
1714629057060,CLRE 259,A00,507211,Patel; Hemal,9996,0,9999,3
1714629058087,CLRE 260,A00,507221,Cuomo; Raphael Eduardo,9999,0,9999,0
1714629059115,CLRE 297,001,507242,Cuomo; Raphael Eduardo,9999,0,9999,0
1714629060142,COGS 197,001,638244,Voytek; Bradley Thomas,9998,0,9999,1
1714629061168,CSE 191,A00,516875,Minnes Kemp; Mor Mia,9992,0,9999,7
1714629062193,CSE 197,001,637388,Minnes Kemp; Mor Mia,9998,0,9999,1
1714629063219,CSS 201S,A01,494383,Staff,35,0,35,0
1714629064243,CSS 202S,A01,494387,Staff,35,0,35,0
1714629065269,DSC 197,001,628532,Eldridge; Justin Matthew,9996,0,9999,3
1714629066293,EAP 100,A00,516065,Staff,9797,0,9999,202
1714629067320,ECE 45,A01,507414,Staff,33,0,60,27
1714629069370,ECE 111,A01,507420,Staff,15,0,50,35
1714629070401,ECE 197,001,548057,Sievenpiper; Daniel F.,9993,0,9999,6
1714629071430,EDS 115,A00,507243,Choi; Bailey Miyeon,10,0,28,18
1714629072458,EDS 117,A01,494379,Staff,0,4,30,30
1714629073483,EDS 125,A00,507246,Hopkins; Megan Beth,9,0,30,21
1714629074515,EDS 128A,A01,507264,Fargason; Sharon Gayle,8,0,26,18
1714629075539,EDS 128B,A01,507293,Pappas; Elizabeth,12,0,30,18
1714629076565,EDS 139,A00,507294,Fargason; Sharon Gayle,13,0,30,17
1714629076565,EDS 139,B00,507313,Pappas; Elizabeth,13,0,30,17
1714629077590,EDS 201,A00,507315,Staff,13,0,30,17
1714629078621,EDS 203,A01,507317,Halter; Christopher P.,12,0,30,18
1714629079647,EDS 204R,A01,507319,Halter; Christopher P.,0,3,30,30
1714629079647,EDS 204R,B01,507331,Heinzman; Erica M.,16,0,30,14
1714629080673,EDS 206R,A00,507332,Staff,0,4,30,30
1714629080673,EDS 206R,B00,507343,Staff,17,0,30,13
1714629081700,EDS 250,A00,507344,Hemans; Patricia Ann Benitez,22,0,40,18
1714629082728,EDS 281,A00,507345,Daly; Alan J.,18,0,18,0
1714629083757,EDS 284,A00,507350,Daly; Alan J.,16,0,16,0
1714629084786,EDS 286,A00,507359,Fine; Sarah,18,0,18,0
1714629085813,EDS 289C,A01,507361,Daly; Alan J.,18,0,18,0
1714629086839,EDS 290,A00,507366,Hofstetter; Carolyn,15,0,15,0
1714629087865,LIGM 5A,A00,507421,Fischer-Grunski; Eva K,18,0,20,2
1714629088891,LIGM 5B,A00,507423,Fischer-Grunski; Eva K,19,0,20,1
1714629089916,LIGM 5C,A00,507425,Fischer-Grunski; Eva K,19,0,20,1
1714629090941,LIIT 5AS,A00,507427,Carnelos; Chiara,20,0,20,0
1714629091966,LIIT 5BS,A00,507430,Carnelos; Chiara,20,0,20,0
1714629092991,LIIT 5CS,A00,507432,Carnelos; Chiara,20,0,20,0
1714629094020,LISP 5A,A00,507541,Munoz Sanchez; Alicia,11,0,20,9
1714629095044,LISP 5B,A00,507671,Munoz Sanchez; Alicia,8,0,20,12
1714629096068,LISP 5C,A00,507696,Munoz Sanchez; Alicia,9,0,20,11
1714629097094,MAE 197,001,528363,Boechler; Nicholas Sebastia,9998,0,9999,1
1714629098126,MATH 197,001,523477,Kedlaya; Kiran S.,9995,0,9999,4
1714629098126,MATH 197,002,563811,Zhang; Danna,9995,0,9999,4
1714629098126,MATH 197,003,628552,Dumitriu; Ioana,9998,0,9999,1
1714629099152,MCWP 40R,A00,518780,Staff,2,0,20,18
1714629099152,MCWP 40R,B00,518781,Staff,8,0,20,12
1714629099152,MCWP 40R,C00,518783,Staff,6,0,20,14
1714629100183,MCWP 50R,A00,518791,Staff,0,0,20,20
1714629100183,MCWP 50R,B00,518792,Staff,0,2,20,20
1714629100183,MCWP 50R,C00,518793,Staff,0,2,20,20
1714629100183,MCWP 50R,D00,518794,Staff,0,0,20,20
1714629100183,MCWP 50R,E00,518795,Staff,0,2,20,20
1714629100183,MCWP 50R,F00,518796,Staff,0,0,20,20
1714629100183,MCWP 50R,G00,518797,Staff,0,1,20,20
1714629101210,MMW 12R,A01,514034,Herbst; Matthew,0,0,16,16
1714629101210,MMW 12R,A02,514035,Herbst; Matthew,1,0,16,15
1714629102234,MMW 13R,A01,514037,Staff,0,4,16,16
1714629102234,MMW 13R,A02,514039,Staff,0,2,16,16
1714629102234,MMW 13R,A03,628519,Staff,0,2,16,16
1714629104289,SIO 295LS,A00,523233,Staff,10,0,30,20
1714629105318,SIO 295S,A00,523232,Staff,10,0,30,20
1714629106345,SIOC 290S,A01,637330,Merrifield; Mark A,23,0,30,7
1714629107374,SIOC 291S,A01,637333,Gabriel; Corey John,23,0,30,7
1714629108402,SOCI 117,A01,494376,Staff,0,4,5,5
1714629109426,WES 237B,A00,494380,Staff,9,0,20,11
1714629111495,AESE 279B,A00,494370,Wade; Jon P,0,0,33,33
1714629112525,AIP 197,001,627712,Vespa; Emanuel Ignacio,9998,0,9999,1
1714629113551,ANAR 135S,A00,494369,Braswell; Geoffrey E.,0,0,0,0
1714629114578,BENG 196,001,628496,Engler; Adam J.,9998,0,9999,1
1714629115604,CAT 124RS,A01,519847,Geibel; William,0,0,20,20
1714629116627,CAT 125RS,A01,515971,Geibel; William,0,0,20,20
1714629117653,CLRE 250,A00,511389,Morris; Sheldon,9993,0,9999,6
1714629118681,CLRE 251,A00,507176,Mehta; Ravindra L.,9993,0,9999,6
1714629118681,CLRE 251,B00,511410,Mehta; Ravindra L.,9998,0,9999,1
1714629119704,CLRE 252,A00,507189,Cuomo; Raphael Eduardo,9995,0,9999,4
1714629120729,CLRE 253,A00,507199,Vaida; Florin,9994,0,9999,5
1714629120729,CLRE 253,B00,507202,Vaida; Florin,9999,0,9999,0
1714629121759,CLRE 259,A00,507211,Patel; Hemal,9996,0,9999,3
1714629122785,CLRE 260,A00,507221,Cuomo; Raphael Eduardo,9999,0,9999,0
1714629123812,CLRE 297,001,507242,Cuomo; Raphael Eduardo,9999,0,9999,0
1714629124842,COGS 197,001,638244,Voytek; Bradley Thomas,9998,0,9999,1
1714629125866,CSE 191,A00,516875,Minnes Kemp; Mor Mia,9992,0,9999,7
1714629126892,CSE 197,001,637388,Minnes Kemp; Mor Mia,9998,0,9999,1
1714629127919,CSS 201S,A01,494383,Staff,35,0,35,0
1714629128946,CSS 202S,A01,494387,Staff,35,0,35,0
1714629129975,DSC 197,001,628532,Eldridge; Justin Matthew,9996,0,9999,3
1714629131002,EAP 100,A00,516065,Staff,9797,0,9999,202
1714629132035,ECE 45,A01,507414,Staff,33,0,60,27
1714629134086,ECE 111,A01,507420,Staff,15,0,50,35
1714629135117,ECE 197,001,548057,Sievenpiper; Daniel F.,9993,0,9999,6
1714629136143,EDS 115,A00,507243,Choi; Bailey Miyeon,10,0,28,18
1714629137168,EDS 117,A01,494379,Staff,0,4,30,30
1714629138200,EDS 125,A00,507246,Hopkins; Megan Beth,9,0,30,21
1714629139228,EDS 128A,A01,507264,Fargason; Sharon Gayle,8,0,26,18
1714629140253,EDS 128B,A01,507293,Pappas; Elizabeth,12,0,30,18
1714629141282,EDS 139,A00,507294,Fargason; Sharon Gayle,13,0,30,17
1714629141282,EDS 139,B00,507313,Pappas; Elizabeth,13,0,30,17
1714629142307,EDS 201,A00,507315,Staff,13,0,30,17
1714629143336,EDS 203,A01,507317,Halter; Christopher P.,12,0,30,18
1714629144361,EDS 204R,A01,507319,Halter; Christopher P.,0,3,30,30
1714629144361,EDS 204R,B01,507331,Heinzman; Erica M.,16,0,30,14
1714629145386,EDS 206R,A00,507332,Staff,0,4,30,30
1714629145386,EDS 206R,B00,507343,Staff,17,0,30,13
1714629146412,EDS 250,A00,507344,Hemans; Patricia Ann Benitez,22,0,40,18
1714629147436,EDS 281,A00,507345,Daly; Alan J.,18,0,18,0
1714629148463,EDS 284,A00,507350,Daly; Alan J.,16,0,16,0
1714629149490,EDS 286,A00,507359,Fine; Sarah,18,0,18,0
1714629150514,EDS 289C,A01,507361,Daly; Alan J.,18,0,18,0
1714629151544,EDS 290,A00,507366,Hofstetter; Carolyn,15,0,15,0
1714629152570,LIGM 5A,A00,507421,Fischer-Grunski; Eva K,18,0,20,2
1714629153594,LIGM 5B,A00,507423,Fischer-Grunski; Eva K,19,0,20,1
1714629154620,LIGM 5C,A00,507425,Fischer-Grunski; Eva K,19,0,20,1
1714629155646,LIIT 5AS,A00,507427,Carnelos; Chiara,20,0,20,0
1714629156671,LIIT 5BS,A00,507430,Carnelos; Chiara,20,0,20,0
1714629157694,LIIT 5CS,A00,507432,Carnelos; Chiara,20,0,20,0
1714629158719,LISP 5A,A00,507541,Munoz Sanchez; Alicia,11,0,20,9
1714629159746,LISP 5B,A00,507671,Munoz Sanchez; Alicia,8,0,20,12
1714629160776,LISP 5C,A00,507696,Munoz Sanchez; Alicia,9,0,20,11
1714629161806,MAE 197,001,528363,Boechler; Nicholas Sebastia,9998,0,9999,1
1714629162833,MATH 197,001,523477,Kedlaya; Kiran S.,9995,0,9999,4
1714629162833,MATH 197,002,563811,Zhang; Danna,9995,0,9999,4
1714629162833,MATH 197,003,628552,Dumitriu; Ioana,9998,0,9999,1
1714629163862,MCWP 40R,A00,518780,Staff,2,0,20,18
1714629163862,MCWP 40R,B00,518781,Staff,8,0,20,12
1714629163862,MCWP 40R,C00,518783,Staff,6,0,20,14
1714629164887,MCWP 50R,A00,518791,Staff,0,0,20,20
1714629164887,MCWP 50R,B00,518792,Staff,0,2,20,20
1714629164887,MCWP 50R,C00,518793,Staff,0,2,20,20
1714629164887,MCWP 50R,D00,518794,Staff,0,0,20,20
1714629164887,MCWP 50R,E00,518795,Staff,0,2,20,20
1714629164887,MCWP 50R,F00,518796,Staff,0,0,20,20
1714629164887,MCWP 50R,G00,518797,Staff,0,1,20,20
1714629165916,MMW 12R,A01,514034,Herbst; Matthew,0,0,16,16
1714629165916,MMW 12R,A02,514035,Herbst; Matthew,1,0,16,15
1714629166946,MMW 13R,A01,514037,Staff,0,4,16,16
1714629166946,MMW 13R,A02,514039,Staff,0,2,16,16
1714629166946,MMW 13R,A03,628519,Staff,0,2,16,16
1714629168996,SIO 295LS,A00,523233,Staff,10,0,30,20
1714629170023,SIO 295S,A00,523232,Staff,10,0,30,20
1714629171049,SIOC 290S,A01,637330,Merrifield; Mark A,23,0,30,7
1714629172075,SIOC 291S,A01,637333,Gabriel; Corey John,23,0,30,7
1714629173099,SOCI 117,A01,494376,Staff,0,4,5,5
1714629174127,WES 237B,A00,494380,Staff,9,0,20,11
1714629176198,AESE 279B,A00,494370,Wade; Jon P,0,0,33,33
1714629177228,AIP 197,001,627712,Vespa; Emanuel Ignacio,9998,0,9999,1
1714629178252,ANAR 135S,A00,494369,Braswell; Geoffrey E.,0,0,0,0
1714629179277,BENG 196,001,628496,Engler; Adam J.,9998,0,9999,1
1714629180305,CAT 124RS,A01,519847,Geibel; William,0,0,20,20
1714629181330,CAT 125RS,A01,515971,Geibel; William,0,0,20,20
1714629182356,CLRE 250,A00,511389,Morris; Sheldon,9993,0,9999,6
1714629183387,CLRE 251,A00,507176,Mehta; Ravindra L.,9993,0,9999,6
1714629183387,CLRE 251,B00,511410,Mehta; Ravindra L.,9998,0,9999,1
1714629184418,CLRE 252,A00,507189,Cuomo; Raphael Eduardo,9995,0,9999,4
1714629185444,CLRE 253,A00,507199,Vaida; Florin,9994,0,9999,5
1714629185444,CLRE 253,B00,507202,Vaida; Florin,9999,0,9999,0
1714629186471,CLRE 259,A00,507211,Patel; Hemal,9996,0,9999,3
1714629187498,CLRE 260,A00,507221,Cuomo; Raphael Eduardo,9999,0,9999,0
1714629188526,CLRE 297,001,507242,Cuomo; Raphael Eduardo,9999,0,9999,0
1714629189554,COGS 197,001,638244,Voytek; Bradley Thomas,9998,0,9999,1
1714629190578,CSE 191,A00,516875,Minnes Kemp; Mor Mia,9992,0,9999,7
1714629191675,CSE 197,001,637388,Minnes Kemp; Mor Mia,9998,0,9999,1
1714629192701,CSS 201S,A01,494383,Staff,35,0,35,0
1714629193731,CSS 202S,A01,494387,Staff,35,0,35,0
1714629194756,DSC 197,001,628532,Eldridge; Justin Matthew,9996,0,9999,3
1714629195781,EAP 100,A00,516065,Staff,9797,0,9999,202
1714629196806,ECE 45,A01,507414,Staff,33,0,60,27
1714629198861,ECE 111,A01,507420,Staff,15,0,50,35
1714629199888,ECE 197,001,548057,Sievenpiper; Daniel F.,9993,0,9999,6
1714629200918,EDS 115,A00,507243,Choi; Bailey Miyeon,10,0,28,18
1714629201950,EDS 117,A01,494379,Staff,0,4,30,30
1714629202976,EDS 125,A00,507246,Hopkins; Megan Beth,9,0,30,21
1714629204006,EDS 128A,A01,507264,Fargason; Sharon Gayle,8,0,26,18
1714629205036,EDS 128B,A01,507293,Pappas; Elizabeth,12,0,30,18
1714629206065,EDS 139,A00,507294,Fargason; Sharon Gayle,13,0,30,17
1714629206065,EDS 139,B00,507313,Pappas; Elizabeth,13,0,30,17
1714629207092,EDS 201,A00,507315,Staff,13,0,30,17
1714629208122,EDS 203,A01,507317,Halter; Christopher P.,12,0,30,18
1714629209150,EDS 204R,A01,507319,Halter; Christopher P.,0,3,30,30
1714629209150,EDS 204R,B01,507331,Heinzman; Erica M.,16,0,30,14
1714629210174,EDS 206R,A00,507332,Staff,0,4,30,30
1714629210174,EDS 206R,B00,507343,Staff,17,0,30,13
1714629211198,EDS 250,A00,507344,Hemans; Patricia Ann Benitez,22,0,40,18
1714629212222,EDS 281,A00,507345,Daly; Alan J.,18,0,18,0
1714629213250,EDS 284,A00,507350,Daly; Alan J.,16,0,16,0
1714629214277,EDS 286,A00,507359,Fine; Sarah,18,0,18,0
1714629215306,EDS 289C,A01,507361,Daly; Alan J.,18,0,18,0
1714629216335,EDS 290,A00,507366,Hofstetter; Carolyn,15,0,15,0
1714629217360,LIGM 5A,A00,507421,Fischer-Grunski; Eva K,18,0,20,2
1714629218385,LIGM 5B,A00,507423,Fischer-Grunski; Eva K,19,0,20,1
1714629219415,LIGM 5C,A00,507425,Fischer-Grunski; Eva K,19,0,20,1
1714629220439,LIIT 5AS,A00,507427,Carnelos; Chiara,20,0,20,0
1714629221468,LIIT 5BS,A00,507430,Carnelos; Chiara,20,0,20,0
1714629222494,LIIT 5CS,A00,507432,Carnelos; Chiara,20,0,20,0
1714629223520,LISP 5A,A00,507541,Munoz Sanchez; Alicia,11,0,20,9
1714629224545,LISP 5B,A00,507671,Munoz Sanchez; Alicia,8,0,20,12
1714629225574,LISP 5C,A00,507696,Munoz Sanchez; Alicia,9,0,20,11
1714629226602,MAE 197,001,528363,Boechler; Nicholas Sebastia,9998,0,9999,1
1714629227632,MATH 197,001,523477,Kedlaya; Kiran S.,9995,0,9999,4
1714629227632,MATH 197,002,563811,Zhang; Danna,9995,0,9999,4
1714629227632,MATH 197,003,628552,Dumitriu; Ioana,9998,0,9999,1
1714629228660,MCWP 40R,A00,518780,Staff,2,0,20,18
1714629228660,MCWP 40R,B00,518781,Staff,8,0,20,12
1714629228660,MCWP 40R,C00,518783,Staff,6,0,20,14
1714629229686,MCWP 50R,A00,518791,Staff,0,0,20,20
1714629229686,MCWP 50R,B00,518792,Staff,0,2,20,20
1714629229686,MCWP 50R,C00,518793,Staff,0,2,20,20
1714629229686,MCWP 50R,D00,518794,Staff,0,0,20,20
1714629229686,MCWP 50R,E00,518795,Staff,0,2,20,20
1714629229686,MCWP 50R,F00,518796,Staff,0,0,20,20
1714629229686,MCWP 50R,G00,518797,Staff,0,1,20,20
1714629230722,MMW 12R,A01,514034,Herbst; Matthew,0,0,16,16
1714629230722,MMW 12R,A02,514035,Herbst; Matthew,1,0,16,15
1714629231746,MMW 13R,A01,514037,Staff,0,4,16,16
1714629231746,MMW 13R,A02,514039,Staff,0,2,16,16
1714629231746,MMW 13R,A03,628519,Staff,0,2,16,16
1714629233800,SIO 295LS,A00,523233,Staff,10,0,30,20
1714629234824,SIO 295S,A00,523232,Staff,10,0,30,20
1714629235856,SIOC 290S,A01,637330,Merrifield; Mark A,23,0,30,7
1714629236886,SIOC 291S,A01,637333,Gabriel; Corey John,23,0,30,7
1714629237915,SOCI 117,A01,494376,Staff,0,4,5,5
1714629238941,WES 237B,A00,494380,Staff,9,0,20,11
1714629241015,AESE 279B,A00,494370,Wade; Jon P,0,0,33,33
1714629242039,AIP 197,001,627712,Vespa; Emanuel Ignacio,9998,0,9999,1
1714629243064,ANAR 135S,A00,494369,Braswell; Geoffrey E.,0,0,0,0
1714629244147,BENG 196,001,628496,Engler; Adam J.,9998,0,9999,1
1714629245175,CAT 124RS,A01,519847,Geibel; William,0,0,20,20
1714629246203,CAT 125RS,A01,515971,Geibel; William,0,0,20,20
1714629247232,CLRE 250,A00,511389,Morris; Sheldon,9993,0,9999,6
1714629248259,CLRE 251,A00,507176,Mehta; Ravindra L.,9993,0,9999,6
1714629248259,CLRE 251,B00,511410,Mehta; Ravindra L.,9998,0,9999,1
1714629249285,CLRE 252,A00,507189,Cuomo; Raphael Eduardo,9995,0,9999,4
1714629250312,CLRE 253,A00,507199,Vaida; Florin,9994,0,9999,5
1714629250312,CLRE 253,B00,507202,Vaida; Florin,9999,0,9999,0
1714629251339,CLRE 259,A00,507211,Patel; Hemal,9996,0,9999,3
1714629252365,CLRE 260,A00,507221,Cuomo; Raphael Eduardo,9999,0,9999,0
1714629253391,CLRE 297,001,507242,Cuomo; Raphael Eduardo,9999,0,9999,0
1714629254415,COGS 197,001,638244,Voytek; Bradley Thomas,9998,0,9999,1
1714629255441,CSE 191,A00,516875,Minnes Kemp; Mor Mia,9992,0,9999,7
1714629256468,CSE 197,001,637388,Minnes Kemp; Mor Mia,9998,0,9999,1
1714629257500,CSS 201S,A01,494383,Staff,35,0,35,0
1714629258525,CSS 202S,A01,494387,Staff,35,0,35,0
1714629259550,DSC 197,001,628532,Eldridge; Justin Matthew,9996,0,9999,3
1714629260575,EAP 100,A00,516065,Staff,9797,0,9999,202
1714629261606,ECE 45,A01,507414,Staff,33,0,60,27
1714629263659,ECE 111,A01,507420,Staff,15,0,50,35
1714629264685,ECE 197,001,548057,Sievenpiper; Daniel F.,9993,0,9999,6
1714629265712,EDS 115,A00,507243,Choi; Bailey Miyeon,10,0,28,18
1714629266738,EDS 117,A01,494379,Staff,0,4,30,30
1714629267765,EDS 125,A00,507246,Hopkins; Megan Beth,9,0,30,21
1714629268790,EDS 128A,A01,507264,Fargason; Sharon Gayle,8,0,26,18
1714629269813,EDS 128B,A01,507293,Pappas; Elizabeth,12,0,30,18
1714629270841,EDS 139,A00,507294,Fargason; Sharon Gayle,13,0,30,17
1714629270841,EDS 139,B00,507313,Pappas; Elizabeth,13,0,30,17
1714629271869,EDS 201,A00,507315,Staff,13,0,30,17
1714629272894,EDS 203,A01,507317,Halter; Christopher P.,12,0,30,18
1714629273920,EDS 204R,A01,507319,Halter; Christopher P.,0,3,30,30
1714629273920,EDS 204R,B01,507331,Heinzman; Erica M.,16,0,30,14
1714629274947,EDS 206R,A00,507332,Staff,0,4,30,30
1714629274947,EDS 206R,B00,507343,Staff,17,0,30,13
1714629275973,EDS 250,A00,507344,Hemans; Patricia Ann Benitez,22,0,40,18
1714629277000,EDS 281,A00,507345,Daly; Alan J.,18,0,18,0
1714629278028,EDS 284,A00,507350,Daly; Alan J.,16,0,16,0
1714629279053,EDS 286,A00,507359,Fine; Sarah,18,0,18,0
1714629280079,EDS 289C,A01,507361,Daly; Alan J.,18,0,18,0
1714629281109,EDS 290,A00,507366,Hofstetter; Carolyn,15,0,15,0
1714629282139,LIGM 5A,A00,507421,Fischer-Grunski; Eva K,18,0,20,2
1714629283165,LIGM 5B,A00,507423,Fischer-Grunski; Eva K,19,0,20,1
1714629284189,LIGM 5C,A00,507425,Fischer-Grunski; Eva K,19,0,20,1
1714629285219,LIIT 5AS,A00,507427,Carnelos; Chiara,20,0,20,0
1714629286247,LIIT 5BS,A00,507430,Carnelos; Chiara,20,0,20,0
1714629287275,LIIT 5CS,A00,507432,Carnelos; Chiara,20,0,20,0
1714629288304,LISP 5A,A00,507541,Munoz Sanchez; Alicia,11,0,20,9
1714629289330,LISP 5B,A00,507671,Munoz Sanchez; Alicia,8,0,20,12
1714629290357,LISP 5C,A00,507696,Munoz Sanchez; Alicia,9,0,20,11
1714629291382,MAE 197,001,528363,Boechler; Nicholas Sebastia,9998,0,9999,1
1714629292410,MATH 197,001,523477,Kedlaya; Kiran S.,9995,0,9999,4
1714629292410,MATH 197,002,563811,Zhang; Danna,9995,0,9999,4
1714629292410,MATH 197,003,628552,Dumitriu; Ioana,9998,0,9999,1
1714629293436,MCWP 40R,A00,518780,Staff,2,0,20,18
1714629293436,MCWP 40R,B00,518781,Staff,8,0,20,12
1714629293436,MCWP 40R,C00,518783,Staff,6,0,20,14
1714629294460,MCWP 50R,A00,518791,Staff,0,0,20,20
1714629294460,MCWP 50R,B00,518792,Staff,0,2,20,20
1714629294460,MCWP 50R,C00,518793,Staff,0,2,20,20
1714629294460,MCWP 50R,D00,518794,Staff,0,0,20,20
1714629294460,MCWP 50R,E00,518795,Staff,0,2,20,20
1714629294460,MCWP 50R,F00,518796,Staff,0,0,20,20
1714629294460,MCWP 50R,G00,518797,Staff,0,1,20,20
1714629295488,MMW 12R,A01,514034,Herbst; Matthew,0,0,16,16
1714629295488,MMW 12R,A02,514035,Herbst; Matthew,1,0,16,15
1714629296514,MMW 13R,A01,514037,Staff,0,4,16,16
1714629296514,MMW 13R,A02,514039,Staff,0,2,16,16
1714629296514,MMW 13R,A03,628519,Staff,0,2,16,16
1714629298565,SIO 295LS,A00,523233,Staff,10,0,30,20
1714629299588,SIO 295S,A00,523232,Staff,10,0,30,20
1714629300615,SIOC 290S,A01,637330,Merrifield; Mark A,23,0,30,7
1714629301644,SIOC 291S,A01,637333,Gabriel; Corey John,23,0,30,7
1714629302671,SOCI 117,A01,494376,Staff,0,4,5,5
1714629303696,WES 237B,A00,494380,Staff,9,0,20,11
1714629305761,AESE 279B,A00,494370,Wade; Jon P,0,0,33,33
1714629306787,AIP 197,001,627712,Vespa; Emanuel Ignacio,9998,0,9999,1
1714629307812,ANAR 135S,A00,494369,Braswell; Geoffrey E.,0,0,0,0
1714629308837,BENG 196,001,628496,Engler; Adam J.,9998,0,9999,1
1714629309864,CAT 124RS,A01,519847,Geibel; William,0,0,20,20
1714629310890,CAT 125RS,A01,515971,Geibel; William,0,0,20,20
1714629311917,CLRE 250,A00,511389,Morris; Sheldon,9993,0,9999,6
1714629312948,CLRE 251,A00,507176,Mehta; Ravindra L.,9993,0,9999,6
1714629312948,CLRE 251,B00,511410,Mehta; Ravindra L.,9998,0,9999,1
1714629313978,CLRE 252,A00,507189,Cuomo; Raphael Eduardo,9995,0,9999,4
1714629315007,CLRE 253,A00,507199,Vaida; Florin,9994,0,9999,5
1714629315007,CLRE 253,B00,507202,Vaida; Florin,9999,0,9999,0
1714629316034,CLRE 259,A00,507211,Patel; Hemal,9996,0,9999,3
1714629317058,CLRE 260,A00,507221,Cuomo; Raphael Eduardo,9999,0,9999,0
1714629318086,CLRE 297,001,507242,Cuomo; Raphael Eduardo,9999,0,9999,0
1714629319114,COGS 197,001,638244,Voytek; Bradley Thomas,9998,0,9999,1
1714629320142,CSE 191,A00,516875,Minnes Kemp; Mor Mia,9992,0,9999,7
1714629321166,CSE 197,001,637388,Minnes Kemp; Mor Mia,9998,0,9999,1
1714629322191,CSS 201S,A01,494383,Staff,35,0,35,0
1714629323216,CSS 202S,A01,494387,Staff,35,0,35,0
1714629324245,DSC 197,001,628532,Eldridge; Justin Matthew,9996,0,9999,3
1714629325270,EAP 100,A00,516065,Staff,9797,0,9999,202
1714629326296,ECE 45,A01,507414,Staff,33,0,60,27
1714629328348,ECE 111,A01,507420,Staff,15,0,50,35
1714629329373,ECE 197,001,548057,Sievenpiper; Daniel F.,9993,0,9999,6
1714629330399,EDS 115,A00,507243,Choi; Bailey Miyeon,10,0,28,18
1714629331425,EDS 117,A01,494379,Staff,0,4,30,30
1714629332448,EDS 125,A00,507246,Hopkins; Megan Beth,9,0,30,21
1714629333477,EDS 128A,A01,507264,Fargason; Sharon Gayle,8,0,26,18
1714629334503,EDS 128B,A01,507293,Pappas; Elizabeth,12,0,30,18
1714629335529,EDS 139,A00,507294,Fargason; Sharon Gayle,13,0,30,17
1714629335529,EDS 139,B00,507313,Pappas; Elizabeth,13,0,30,17
1714629336553,EDS 201,A00,507315,Staff,13,0,30,17
1714629337580,EDS 203,A01,507317,Halter; Christopher P.,12,0,30,18
1714629338611,EDS 204R,A01,507319,Halter; Christopher P.,0,3,30,30
1714629338611,EDS 204R,B01,507331,Heinzman; Erica M.,16,0,30,14
1714629339636,EDS 206R,A00,507332,Staff,0,4,30,30
1714629339636,EDS 206R,B00,507343,Staff,17,0,30,13
1714629340662,EDS 250,A00,507344,Hemans; Patricia Ann Benitez,22,0,40,18
1714629341687,EDS 281,A00,507345,Daly; Alan J.,18,0,18,0
1714629342712,EDS 284,A00,507350,Daly; Alan J.,16,0,16,0
1714629343737,EDS 286,A00,507359,Fine; Sarah,18,0,18,0
1714629344762,EDS 289C,A01,507361,Daly; Alan J.,18,0,18,0
1714629345789,EDS 290,A00,507366,Hofstetter; Carolyn,15,0,15,0
1714629346815,LIGM 5A,A00,507421,Fischer-Grunski; Eva K,18,0,20,2
1714629347898,LIGM 5B,A00,507423,Fischer-Grunski; Eva K,19,0,20,1
1714629348924,LIGM 5C,A00,507425,Fischer-Grunski; Eva K,19,0,20,1
1714629349949,LIIT 5AS,A00,507427,Carnelos; Chiara,20,0,20,0
1714629350975,LIIT 5BS,A00,507430,Carnelos; Chiara,20,0,20,0
1714629352002,LIIT 5CS,A00,507432,Carnelos; Chiara,20,0,20,0
1714629353028,LISP 5A,A00,507541,Munoz Sanchez; Alicia,11,0,20,9
1714629354056,LISP 5B,A00,507671,Munoz Sanchez; Alicia,8,0,20,12
1714629355083,LISP 5C,A00,507696,Munoz Sanchez; Alicia,9,0,20,11
1714629356109,MAE 197,001,528363,Boechler; Nicholas Sebastia,9998,0,9999,1
1714629357137,MATH 197,001,523477,Kedlaya; Kiran S.,9995,0,9999,4
1714629357137,MATH 197,002,563811,Zhang; Danna,9995,0,9999,4
1714629357137,MATH 197,003,628552,Dumitriu; Ioana,9998,0,9999,1
1714629358164,MCWP 40R,A00,518780,Staff,2,0,20,18
1714629358164,MCWP 40R,B00,518781,Staff,8,0,20,12
1714629358164,MCWP 40R,C00,518783,Staff,6,0,20,14
1714629359190,MCWP 50R,A00,518791,Staff,0,0,20,20
1714629359190,MCWP 50R,B00,518792,Staff,0,2,20,20
1714629359190,MCWP 50R,C00,518793,Staff,0,2,20,20
1714629359190,MCWP 50R,D00,518794,Staff,0,0,20,20
1714629359190,MCWP 50R,E00,518795,Staff,0,2,20,20
1714629359190,MCWP 50R,F00,518796,Staff,0,0,20,20
1714629359190,MCWP 50R,G00,518797,Staff,0,1,20,20
1714629360216,MMW 12R,A01,514034,Herbst; Matthew,0,0,16,16
1714629360216,MMW 12R,A02,514035,Herbst; Matthew,1,0,16,15
1714629361245,MMW 13R,A01,514037,Staff,0,4,16,16
1714629361245,MMW 13R,A02,514039,Staff,0,2,16,16
1714629361245,MMW 13R,A03,628519,Staff,0,2,16,16
1714629363295,SIO 295LS,A00,523233,Staff,10,0,30,20
1714629364321,SIO 295S,A00,523232,Staff,10,0,30,20
1714629365346,SIOC 290S,A01,637330,Merrifield; Mark A,23,0,30,7
1714629366375,SIOC 291S,A01,637333,Gabriel; Corey John,23,0,30,7
1714629367399,SOCI 117,A01,494376,Staff,0,4,5,5
1714629368424,WES 237B,A00,494380,Staff,9,0,20,11
1714629370500,AESE 279B,A00,494370,Wade; Jon P,0,0,33,33
1714629371524,AIP 197,001,627712,Vespa; Emanuel Ignacio,9998,0,9999,1
1714629372551,ANAR 135S,A00,494369,Braswell; Geoffrey E.,0,0,0,0
1714629373582,BENG 196,001,628496,Engler; Adam J.,9998,0,9999,1
1714629374608,CAT 124RS,A01,519847,Geibel; William,0,0,20,20
1714629375634,CAT 125RS,A01,515971,Geibel; William,0,0,20,20
1714629376660,CLRE 250,A00,511389,Morris; Sheldon,9993,0,9999,6
1714629377692,CLRE 251,A00,507176,Mehta; Ravindra L.,9993,0,9999,6
1714629377692,CLRE 251,B00,511410,Mehta; Ravindra L.,9998,0,9999,1
1714629378718,CLRE 252,A00,507189,Cuomo; Raphael Eduardo,9995,0,9999,4
1714629379754,CLRE 253,A00,507199,Vaida; Florin,9994,0,9999,5
1714629379754,CLRE 253,B00,507202,Vaida; Florin,9999,0,9999,0
1714629380782,CLRE 259,A00,507211,Patel; Hemal,9996,0,9999,3
1714629381809,CLRE 260,A00,507221,Cuomo; Raphael Eduardo,9999,0,9999,0
1714629382835,CLRE 297,001,507242,Cuomo; Raphael Eduardo,9999,0,9999,0
1714629383876,COGS 197,001,638244,Voytek; Bradley Thomas,9998,0,9999,1
1714629384905,CSE 191,A00,516875,Minnes Kemp; Mor Mia,9992,0,9999,7
1714629385931,CSE 197,001,637388,Minnes Kemp; Mor Mia,9998,0,9999,1
1714629386957,CSS 201S,A01,494383,Staff,35,0,35,0
1714629387983,CSS 202S,A01,494387,Staff,35,0,35,0
1714629389012,DSC 197,001,628532,Eldridge; Justin Matthew,9996,0,9999,3
1714629390036,EAP 100,A00,516065,Staff,9797,0,9999,202
1714629391061,ECE 45,A01,507414,Staff,33,0,60,27
1714629393116,ECE 111,A01,507420,Staff,15,0,50,35
1714629394142,ECE 197,001,548057,Sievenpiper; Daniel F.,9993,0,9999,6
1714629395170,EDS 115,A00,507243,Choi; Bailey Miyeon,10,0,28,18
1714629396198,EDS 117,A01,494379,Staff,0,4,30,30
1714629397228,EDS 125,A00,507246,Hopkins; Megan Beth,9,0,30,21
1714629398260,EDS 128A,A01,507264,Fargason; Sharon Gayle,8,0,26,18
1714629399285,EDS 128B,A01,507293,Pappas; Elizabeth,12,0,30,18
1714629400314,EDS 139,A00,507294,Fargason; Sharon Gayle,13,0,30,17
1714629400314,EDS 139,B00,507313,Pappas; Elizabeth,13,0,30,17
1714629401340,EDS 201,A00,507315,Staff,13,0,30,17
1714629402365,EDS 203,A01,507317,Halter; Christopher P.,12,0,30,18
1714629403396,EDS 204R,A01,507319,Halter; Christopher P.,0,3,30,30
1714629403396,EDS 204R,B01,507331,Heinzman; Erica M.,16,0,30,14
1714629404421,EDS 206R,A00,507332,Staff,0,4,30,30
1714629404421,EDS 206R,B00,507343,Staff,17,0,30,13
1714629405445,EDS 250,A00,507344,Hemans; Patricia Ann Benitez,22,0,40,18
1714629406471,EDS 281,A00,507345,Daly; Alan J.,18,0,18,0
1714629407500,EDS 284,A00,507350,Daly; Alan J.,16,0,16,0
1714629408529,EDS 286,A00,507359,Fine; Sarah,18,0,18,0
1714629409553,EDS 289C,A01,507361,Daly; Alan J.,18,0,18,0
1714629410582,EDS 290,A00,507366,Hofstetter; Carolyn,15,0,15,0
1714629411611,LIGM 5A,A00,507421,Fischer-Grunski; Eva K,18,0,20,2
1714629412637,LIGM 5B,A00,507423,Fischer-Grunski; Eva K,19,0,20,1
1714629413662,LIGM 5C,A00,507425,Fischer-Grunski; Eva K,19,0,20,1
1714629414689,LIIT 5AS,A00,507427,Carnelos; Chiara,20,0,20,0
1714629415717,LIIT 5BS,A00,507430,Carnelos; Chiara,20,0,20,0
1714629416747,LIIT 5CS,A00,507432,Carnelos; Chiara,20,0,20,0
1714629417771,LISP 5A,A00,507541,Munoz Sanchez; Alicia,11,0,20,9
1714629418796,LISP 5B,A00,507671,Munoz Sanchez; Alicia,8,0,20,12
1714629419822,LISP 5C,A00,507696,Munoz Sanchez; Alicia,9,0,20,11
1714629420851,MAE 197,001,528363,Boechler; Nicholas Sebastia,9998,0,9999,1
1714629421876,MATH 197,001,523477,Kedlaya; Kiran S.,9995,0,9999,4
1714629421876,MATH 197,002,563811,Zhang; Danna,9995,0,9999,4
1714629421876,MATH 197,003,628552,Dumitriu; Ioana,9998,0,9999,1
1714629422905,MCWP 40R,A00,518780,Staff,2,0,20,18
1714629422905,MCWP 40R,B00,518781,Staff,8,0,20,12
1714629422905,MCWP 40R,C00,518783,Staff,6,0,20,14
1714629423933,MCWP 50R,A00,518791,Staff,0,0,20,20
1714629423933,MCWP 50R,B00,518792,Staff,0,2,20,20
1714629423933,MCWP 50R,C00,518793,Staff,0,2,20,20
1714629423933,MCWP 50R,D00,518794,Staff,0,0,20,20
1714629423933,MCWP 50R,E00,518795,Staff,0,2,20,20
1714629423933,MCWP 50R,F00,518796,Staff,0,0,20,20
1714629423933,MCWP 50R,G00,518797,Staff,0,1,20,20
1714629424960,MMW 12R,A01,514034,Herbst; Matthew,0,0,16,16
1714629424960,MMW 12R,A02,514035,Herbst; Matthew,1,0,16,15
1714629425985,MMW 13R,A01,514037,Staff,0,4,16,16
1714629425985,MMW 13R,A02,514039,Staff,0,2,16,16
1714629425985,MMW 13R,A03,628519,Staff,0,2,16,16
1714629428039,SIO 295LS,A00,523233,Staff,10,0,30,20
1714629429064,SIO 295S,A00,523232,Staff,10,0,30,20
1714629430095,SIOC 290S,A01,637330,Merrifield; Mark A,23,0,30,7
1714629431120,SIOC 291S,A01,637333,Gabriel; Corey John,23,0,30,7
1714629432149,SOCI 117,A01,494376,Staff,0,4,5,5
1714629433174,WES 237B,A00,494380,Staff,9,0,20,11
1714629435248,AESE 279B,A00,494370,Wade; Jon P,0,0,33,33
1714629436274,AIP 197,001,627712,Vespa; Emanuel Ignacio,9998,0,9999,1
1714629437298,ANAR 135S,A00,494369,Braswell; Geoffrey E.,0,0,0,0
1714629438326,BENG 196,001,628496,Engler; Adam J.,9998,0,9999,1
1714629439351,CAT 124RS,A01,519847,Geibel; William,0,0,20,20
1714629440378,CAT 125RS,A01,515971,Geibel; William,0,0,20,20
1714629441406,CLRE 250,A00,511389,Morris; Sheldon,9993,0,9999,6
1714629442432,CLRE 251,A00,507176,Mehta; Ravindra L.,9993,0,9999,6
1714629442432,CLRE 251,B00,511410,Mehta; Ravindra L.,9998,0,9999,1
1714629443460,CLRE 252,A00,507189,Cuomo; Raphael Eduardo,9995,0,9999,4
1714629444485,CLRE 253,A00,507199,Vaida; Florin,9994,0,9999,5
1714629444485,CLRE 253,B00,507202,Vaida; Florin,9999,0,9999,0
1714629445512,CLRE 259,A00,507211,Patel; Hemal,9996,0,9999,3
1714629446536,CLRE 260,A00,507221,Cuomo; Raphael Eduardo,9999,0,9999,0
1714629447564,CLRE 297,001,507242,Cuomo; Raphael Eduardo,9999,0,9999,0
1714629448593,COGS 197,001,638244,Voytek; Bradley Thomas,9998,0,9999,1
1714629449620,CSE 191,A00,516875,Minnes Kemp; Mor Mia,9992,0,9999,7
1714629450644,CSE 197,001,637388,Minnes Kemp; Mor Mia,9998,0,9999,1
1714629451725,CSS 201S,A01,494383,Staff,35,0,35,0
1714629452754,CSS 202S,A01,494387,Staff,35,0,35,0
1714629453779,DSC 197,001,628532,Eldridge; Justin Matthew,9996,0,9999,3
1714629454807,EAP 100,A00,516065,Staff,9797,0,9999,202
1714629455836,ECE 45,A01,507414,Staff,33,0,60,27
1714629457887,ECE 111,A01,507420,Staff,15,0,50,35
1714629458917,ECE 197,001,548057,Sievenpiper; Daniel F.,9993,0,9999,6
1714629459942,EDS 115,A00,507243,Choi; Bailey Miyeon,10,0,28,18
1714629460969,EDS 117,A01,494379,Staff,0,4,30,30
1714629461998,EDS 125,A00,507246,Hopkins; Megan Beth,9,0,30,21
1714629463027,EDS 128A,A01,507264,Fargason; Sharon Gayle,8,0,26,18
1714629464054,EDS 128B,A01,507293,Pappas; Elizabeth,12,0,30,18
1714629465080,EDS 139,A00,507294,Fargason; Sharon Gayle,13,0,30,17
1714629465080,EDS 139,B00,507313,Pappas; Elizabeth,13,0,30,17
1714629466105,EDS 201,A00,507315,Staff,13,0,30,17
1714629467131,EDS 203,A01,507317,Halter; Christopher P.,12,0,30,18
1714629468164,EDS 204R,A01,507319,Halter; Christopher P.,0,3,30,30
1714629468164,EDS 204R,B01,507331,Heinzman; Erica M.,16,0,30,14
1714629469190,EDS 206R,A00,507332,Staff,0,4,30,30
1714629469190,EDS 206R,B00,507343,Staff,17,0,30,13
1714629470219,EDS 250,A00,507344,Hemans; Patricia Ann Benitez,22,0,40,18
1714629471245,EDS 281,A00,507345,Daly; Alan J.,18,0,18,0
1714629472271,EDS 284,A00,507350,Daly; Alan J.,16,0,16,0
1714629473347,EDS 286,A00,507359,Fine; Sarah,18,0,18,0
1714629474371,EDS 289C,A01,507361,Daly; Alan J.,18,0,18,0
1714629475396,EDS 290,A00,507366,Hofstetter; Carolyn,15,0,15,0
1714629476423,LIGM 5A,A00,507421,Fischer-Grunski; Eva K,18,0,20,2
1714629477450,LIGM 5B,A00,507423,Fischer-Grunski; Eva K,19,0,20,1
1714629478475,LIGM 5C,A00,507425,Fischer-Grunski; Eva K,19,0,20,1
1714629479500,LIIT 5AS,A00,507427,Carnelos; Chiara,20,0,20,0
1714629480525,LIIT 5BS,A00,507430,Carnelos; Chiara,20,0,20,0
1714629481553,LIIT 5CS,A00,507432,Carnelos; Chiara,20,0,20,0
1714629482583,LISP 5A,A00,507541,Munoz Sanchez; Alicia,11,0,20,9
1714629483608,LISP 5B,A00,507671,Munoz Sanchez; Alicia,8,0,20,12
1714629484632,LISP 5C,A00,507696,Munoz Sanchez; Alicia,9,0,20,11
1714629485655,MAE 197,001,528363,Boechler; Nicholas Sebastia,9998,0,9999,1
1714629486682,MATH 197,001,523477,Kedlaya; Kiran S.,9995,0,9999,4
1714629486682,MATH 197,002,563811,Zhang; Danna,9995,0,9999,4
1714629486682,MATH 197,003,628552,Dumitriu; Ioana,9998,0,9999,1
1714629487709,MCWP 40R,A00,518780,Staff,2,0,20,18
1714629487709,MCWP 40R,B00,518781,Staff,8,0,20,12
1714629487709,MCWP 40R,C00,518783,Staff,6,0,20,14
1714629488738,MCWP 50R,A00,518791,Staff,0,0,20,20
1714629488738,MCWP 50R,B00,518792,Staff,0,2,20,20
1714629488738,MCWP 50R,C00,518793,Staff,0,2,20,20
1714629488738,MCWP 50R,D00,518794,Staff,0,0,20,20
1714629488738,MCWP 50R,E00,518795,Staff,0,2,20,20
1714629488738,MCWP 50R,F00,518796,Staff,0,0,20,20
1714629488738,MCWP 50R,G00,518797,Staff,0,1,20,20
1714629489767,MMW 12R,A01,514034,Herbst; Matthew,0,0,16,16
1714629489767,MMW 12R,A02,514035,Herbst; Matthew,1,0,16,15
1714629490793,MMW 13R,A01,514037,Staff,0,4,16,16
1714629490793,MMW 13R,A02,514039,Staff,0,2,16,16
1714629490793,MMW 13R,A03,628519,Staff,0,2,16,16
1714629492846,SIO 295LS,A00,523233,Staff,10,0,30,20
1714629493871,SIO 295S,A00,523232,Staff,10,0,30,20
1714629494900,SIOC 290S,A01,637330,Merrifield; Mark A,23,0,30,7
1714629495927,SIOC 291S,A01,637333,Gabriel; Corey John,23,0,30,7
1714629496957,SOCI 117,A01,494376,Staff,0,4,5,5
1714629497987,WES 237B,A00,494380,Staff,9,0,20,11
1714629500058,AESE 279B,A00,494370,Wade; Jon P,0,0,33,33
1714629501083,AIP 197,001,627712,Vespa; Emanuel Ignacio,9998,0,9999,1
1714629502114,ANAR 135S,A00,494369,Braswell; Geoffrey E.,0,0,0,0
1714629503140,BENG 196,001,628496,Engler; Adam J.,9998,0,9999,1
1714629504167,CAT 124RS,A01,519847,Geibel; William,0,0,20,20
1714629505194,CAT 125RS,A01,515971,Geibel; William,0,0,20,20
1714629506218,CLRE 250,A00,511389,Morris; Sheldon,9993,0,9999,6
1714629507250,CLRE 251,A00,507176,Mehta; Ravindra L.,9993,0,9999,6
1714629507250,CLRE 251,B00,511410,Mehta; Ravindra L.,9998,0,9999,1
1714629508275,CLRE 252,A00,507189,Cuomo; Raphael Eduardo,9995,0,9999,4
1714629509304,CLRE 253,A00,507199,Vaida; Florin,9994,0,9999,5
1714629509304,CLRE 253,B00,507202,Vaida; Florin,9999,0,9999,0
1714629510335,CLRE 259,A00,507211,Patel; Hemal,9996,0,9999,3
1714629511361,CLRE 260,A00,507221,Cuomo; Raphael Eduardo,9999,0,9999,0
1714629512387,CLRE 297,001,507242,Cuomo; Raphael Eduardo,9999,0,9999,0
1714629513415,COGS 197,001,638244,Voytek; Bradley Thomas,9998,0,9999,1
1714629514442,CSE 191,A00,516875,Minnes Kemp; Mor Mia,9992,0,9999,7
1714629515468,CSE 197,001,637388,Minnes Kemp; Mor Mia,9998,0,9999,1
1714629516498,CSS 201S,A01,494383,Staff,35,0,35,0
1714629517525,CSS 202S,A01,494387,Staff,35,0,35,0
1714629518553,DSC 197,001,628532,Eldridge; Justin Matthew,9996,0,9999,3
1714629519581,EAP 100,A00,516065,Staff,9797,0,9999,202
1714629520607,ECE 45,A01,507414,Staff,33,0,60,27
1714629522663,ECE 111,A01,507420,Staff,15,0,50,35
1714629523687,ECE 197,001,548057,Sievenpiper; Daniel F.,9993,0,9999,6
1714629524713,EDS 115,A00,507243,Choi; Bailey Miyeon,10,0,28,18
1714629525742,EDS 117,A01,494379,Staff,0,4,30,30
1714629526768,EDS 125,A00,507246,Hopkins; Megan Beth,9,0,30,21
1714629527796,EDS 128A,A01,507264,Fargason; Sharon Gayle,8,0,26,18
1714629528824,EDS 128B,A01,507293,Pappas; Elizabeth,12,0,30,18
1714629529849,EDS 139,A00,507294,Fargason; Sharon Gayle,13,0,30,17
1714629529849,EDS 139,B00,507313,Pappas; Elizabeth,13,0,30,17
1714629530878,EDS 201,A00,507315,Staff,13,0,30,17
1714629531908,EDS 203,A01,507317,Halter; Christopher P.,12,0,30,18
1714629532938,EDS 204R,A01,507319,Halter; Christopher P.,0,3,30,30
1714629532938,EDS 204R,B01,507331,Heinzman; Erica M.,16,0,30,14
1714629533967,EDS 206R,A00,507332,Staff,0,4,30,30
1714629533967,EDS 206R,B00,507343,Staff,17,0,30,13
1714629534996,EDS 250,A00,507344,Hemans; Patricia Ann Benitez,22,0,40,18
1714629536022,EDS 281,A00,507345,Daly; Alan J.,18,0,18,0
1714629537048,EDS 284,A00,507350,Daly; Alan J.,16,0,16,0
1714629538073,EDS 286,A00,507359,Fine; Sarah,18,0,18,0
1714629539099,EDS 289C,A01,507361,Daly; Alan J.,18,0,18,0
1714629540126,EDS 290,A00,507366,Hofstetter; Carolyn,15,0,15,0
1714629541152,LIGM 5A,A00,507421,Fischer-Grunski; Eva K,18,0,20,2
1714629542182,LIGM 5B,A00,507423,Fischer-Grunski; Eva K,19,0,20,1
1714629543206,LIGM 5C,A00,507425,Fischer-Grunski; Eva K,19,0,20,1
1714629544240,LIIT 5AS,A00,507427,Carnelos; Chiara,20,0,20,0
1714629545269,LIIT 5BS,A00,507430,Carnelos; Chiara,20,0,20,0
1714629546293,LIIT 5CS,A00,507432,Carnelos; Chiara,20,0,20,0
1714629547319,LISP 5A,A00,507541,Munoz Sanchez; Alicia,11,0,20,9
1714629548345,LISP 5B,A00,507671,Munoz Sanchez; Alicia,8,0,20,12
1714629549370,LISP 5C,A00,507696,Munoz Sanchez; Alicia,9,0,20,11
1714629550396,MAE 197,001,528363,Boechler; Nicholas Sebastia,9998,0,9999,1
1714629551426,MATH 197,001,523477,Kedlaya; Kiran S.,9995,0,9999,4
1714629551426,MATH 197,002,563811,Zhang; Danna,9995,0,9999,4
1714629551426,MATH 197,003,628552,Dumitriu; Ioana,9998,0,9999,1
1714629552451,MCWP 40R,A00,518780,Staff,2,0,20,18
1714629552451,MCWP 40R,B00,518781,Staff,8,0,20,12
1714629552451,MCWP 40R,C00,518783,Staff,6,0,20,14
1714629553481,MCWP 50R,A00,518791,Staff,0,0,20,20
1714629553481,MCWP 50R,B00,518792,Staff,0,2,20,20
1714629553481,MCWP 50R,C00,518793,Staff,0,2,20,20
1714629553481,MCWP 50R,D00,518794,Staff,0,0,20,20
1714629553481,MCWP 50R,E00,518795,Staff,0,2,20,20
1714629553481,MCWP 50R,F00,518796,Staff,0,0,20,20
1714629553481,MCWP 50R,G00,518797,Staff,0,1,20,20
1714629554507,MMW 12R,A01,514034,Herbst; Matthew,0,0,16,16
1714629554507,MMW 12R,A02,514035,Herbst; Matthew,1,0,16,15
1714629555588,MMW 13R,A01,514037,Staff,0,4,16,16
1714629555588,MMW 13R,A02,514039,Staff,0,2,16,16
1714629555588,MMW 13R,A03,628519,Staff,0,2,16,16
1714629557639,SIO 295LS,A00,523233,Staff,10,0,30,20
1714629558664,SIO 295S,A00,523232,Staff,10,0,30,20
1714629559690,SIOC 290S,A01,637330,Merrifield; Mark A,23,0,30,7
1714629560714,SIOC 291S,A01,637333,Gabriel; Corey John,23,0,30,7
1714629561740,SOCI 117,A01,494376,Staff,0,4,5,5
1714629562769,WES 237B,A00,494380,Staff,9,0,20,11
1714629564844,AESE 279B,A00,494370,Wade; Jon P,0,0,33,33
1714629565869,AIP 197,001,627712,Vespa; Emanuel Ignacio,9998,0,9999,1
1714629566897,ANAR 135S,A00,494369,Braswell; Geoffrey E.,0,0,0,0
1714629567922,BENG 196,001,628496,Engler; Adam J.,9998,0,9999,1
1714629568951,CAT 124RS,A01,519847,Geibel; William,0,0,20,20
1714629569974,CAT 125RS,A01,515971,Geibel; William,0,0,20,20
1714629571000,CLRE 250,A00,511389,Morris; Sheldon,9993,0,9999,6
1714629572026,CLRE 251,A00,507176,Mehta; Ravindra L.,9993,0,9999,6
1714629572026,CLRE 251,B00,511410,Mehta; Ravindra L.,9998,0,9999,1
1714629573052,CLRE 252,A00,507189,Cuomo; Raphael Eduardo,9995,0,9999,4
1714629574079,CLRE 253,A00,507199,Vaida; Florin,9994,0,9999,5
1714629574079,CLRE 253,B00,507202,Vaida; Florin,9999,0,9999,0
1714629575104,CLRE 259,A00,507211,Patel; Hemal,9996,0,9999,3
1714629576129,CLRE 260,A00,507221,Cuomo; Raphael Eduardo,9999,0,9999,0
1714629577155,CLRE 297,001,507242,Cuomo; Raphael Eduardo,9999,0,9999,0
1714629578183,COGS 197,001,638244,Voytek; Bradley Thomas,9998,0,9999,1
1714629579210,CSE 191,A00,516875,Minnes Kemp; Mor Mia,9992,0,9999,7
1714629580234,CSE 197,001,637388,Minnes Kemp; Mor Mia,9998,0,9999,1
1714629581260,CSS 201S,A01,494383,Staff,35,0,35,0
1714629582285,CSS 202S,A01,494387,Staff,35,0,35,0
1714629583309,DSC 197,001,628532,Eldridge; Justin Matthew,9996,0,9999,3
1714629584336,EAP 100,A00,516065,Staff,9797,0,9999,202
1714629585360,ECE 45,A01,507414,Staff,33,0,60,27
1714629587413,ECE 111,A01,507420,Staff,15,0,50,35
1714629588438,ECE 197,001,548057,Sievenpiper; Daniel F.,9993,0,9999,6
1714629589469,EDS 115,A00,507243,Choi; Bailey Miyeon,10,0,28,18
1714629590498,EDS 117,A01,494379,Staff,0,4,30,30
1714629591523,EDS 125,A00,507246,Hopkins; Megan Beth,9,0,30,21
1714629592549,EDS 128A,A01,507264,Fargason; Sharon Gayle,8,0,26,18
1714629593578,EDS 128B,A01,507293,Pappas; Elizabeth,12,0,30,18
1714629594603,EDS 139,A00,507294,Fargason; Sharon Gayle,13,0,30,17
1714629594603,EDS 139,B00,507313,Pappas; Elizabeth,13,0,30,17
1714629595626,EDS 201,A00,507315,Staff,13,0,30,17
1714629596651,EDS 203,A01,507317,Halter; Christopher P.,12,0,30,18
1714629597677,EDS 204R,A01,507319,Halter; Christopher P.,0,3,30,30
1714629597677,EDS 204R,B01,507331,Heinzman; Erica M.,16,0,30,14
1714629598756,EDS 206R,A00,507332,Staff,0,4,30,30
1714629598756,EDS 206R,B00,507343,Staff,17,0,30,13
1714629599784,EDS 250,A00,507344,Hemans; Patricia Ann Benitez,22,0,40,18
1714629600810,EDS 281,A00,507345,Daly; Alan J.,18,0,18,0
1714629601834,EDS 284,A00,507350,Daly; Alan J.,16,0,16,0
1714629602863,EDS 286,A00,507359,Fine; Sarah,18,0,18,0
1714629603892,EDS 289C,A01,507361,Daly; Alan J.,18,0,18,0
1714629604920,EDS 290,A00,507366,Hofstetter; Carolyn,15,0,15,0
1714629605946,LIGM 5A,A00,507421,Fischer-Grunski; Eva K,18,0,20,2
1714629606972,LIGM 5B,A00,507423,Fischer-Grunski; Eva K,19,0,20,1
1714629607996,LIGM 5C,A00,507425,Fischer-Grunski; Eva K,19,0,20,1
1714629609025,LIIT 5AS,A00,507427,Carnelos; Chiara,20,0,20,0
1714629610049,LIIT 5BS,A00,507430,Carnelos; Chiara,20,0,20,0
1714629611073,LIIT 5CS,A00,507432,Carnelos; Chiara,20,0,20,0
1714629612104,LISP 5A,A00,507541,Munoz Sanchez; Alicia,11,0,20,9
1714629613128,LISP 5B,A00,507671,Munoz Sanchez; Alicia,8,0,20,12
1714629614155,LISP 5C,A00,507696,Munoz Sanchez; Alicia,9,0,20,11
1714629615182,MAE 197,001,528363,Boechler; Nicholas Sebastia,9998,0,9999,1
1714629616210,MATH 197,001,523477,Kedlaya; Kiran S.,9995,0,9999,4
1714629616210,MATH 197,002,563811,Zhang; Danna,9995,0,9999,4
1714629616210,MATH 197,003,628552,Dumitriu; Ioana,9998,0,9999,1
1714629617236,MCWP 40R,A00,518780,Staff,2,0,20,18
1714629617236,MCWP 40R,B00,518781,Staff,8,0,20,12
1714629617236,MCWP 40R,C00,518783,Staff,6,0,20,14
1714629618266,MCWP 50R,A00,518791,Staff,0,0,20,20
1714629618266,MCWP 50R,B00,518792,Staff,0,2,20,20
1714629618266,MCWP 50R,C00,518793,Staff,0,2,20,20
1714629618266,MCWP 50R,D00,518794,Staff,0,0,20,20
1714629618266,MCWP 50R,E00,518795,Staff,0,2,20,20
1714629618266,MCWP 50R,F00,518796,Staff,0,0,20,20
1714629618266,MCWP 50R,G00,518797,Staff,0,1,20,20
1714629619291,MMW 12R,A01,514034,Herbst; Matthew,0,0,16,16
1714629619291,MMW 12R,A02,514035,Herbst; Matthew,1,0,16,15
1714629620315,MMW 13R,A01,514037,Staff,0,4,16,16
1714629620315,MMW 13R,A02,514039,Staff,0,2,16,16
1714629620315,MMW 13R,A03,628519,Staff,0,2,16,16
1714629622369,SIO 295LS,A00,523233,Staff,10,0,30,20
1714629623395,SIO 295S,A00,523232,Staff,10,0,30,20
1714629624421,SIOC 290S,A01,637330,Merrifield; Mark A,23,0,30,7
1714629625452,SIOC 291S,A01,637333,Gabriel; Corey John,23,0,30,7
1714629626484,SOCI 117,A01,494376,Staff,0,4,5,5
1714629627516,WES 237B,A00,494380,Staff,9,0,20,11
1714629629587,AESE 279B,A00,494370,Wade; Jon P,0,0,33,33
1714629630617,AIP 197,001,627712,Vespa; Emanuel Ignacio,9998,0,9999,1
1714629631643,ANAR 135S,A00,494369,Braswell; Geoffrey E.,0,0,0,0
1714629632669,BENG 196,001,628496,Engler; Adam J.,9998,0,9999,1
1714629633698,CAT 124RS,A01,519847,Geibel; William,0,0,20,20
1714629634723,CAT 125RS,A01,515971,Geibel; William,0,0,20,20
1714629635748,CLRE 250,A00,511389,Morris; Sheldon,9993,0,9999,6
1714629636776,CLRE 251,A00,507176,Mehta; Ravindra L.,9993,0,9999,6
1714629636776,CLRE 251,B00,511410,Mehta; Ravindra L.,9998,0,9999,1
1714629637806,CLRE 252,A00,507189,Cuomo; Raphael Eduardo,9995,0,9999,4
1714629638838,CLRE 253,A00,507199,Vaida; Florin,9994,0,9999,5
1714629638838,CLRE 253,B00,507202,Vaida; Florin,9999,0,9999,0
1714629639864,CLRE 259,A00,507211,Patel; Hemal,9996,0,9999,3
1714629640890,CLRE 260,A00,507221,Cuomo; Raphael Eduardo,9999,0,9999,0
1714629641914,CLRE 297,001,507242,Cuomo; Raphael Eduardo,9999,0,9999,0
1714629642940,COGS 197,001,638244,Voytek; Bradley Thomas,9998,0,9999,1
1714629643968,CSE 191,A00,516875,Minnes Kemp; Mor Mia,9992,0,9999,7
1714629644992,CSE 197,001,637388,Minnes Kemp; Mor Mia,9998,0,9999,1
1714629646022,CSS 201S,A01,494383,Staff,35,0,35,0
1714629647046,CSS 202S,A01,494387,Staff,35,0,35,0
1714629648071,DSC 197,001,628532,Eldridge; Justin Matthew,9996,0,9999,3
1714629649096,EAP 100,A00,516065,Staff,9797,0,9999,202
1714629650126,ECE 45,A01,507414,Staff,33,0,60,27
1714629652178,ECE 111,A01,507420,Staff,15,0,50,35
1714629653204,ECE 197,001,548057,Sievenpiper; Daniel F.,9993,0,9999,6
1714629654230,EDS 115,A00,507243,Choi; Bailey Miyeon,10,0,28,18
1714629655258,EDS 117,A01,494379,Staff,0,4,30,30
1714629656284,EDS 125,A00,507246,Hopkins; Megan Beth,9,0,30,21
1714629657311,EDS 128A,A01,507264,Fargason; Sharon Gayle,8,0,26,18
1714629658340,EDS 128B,A01,507293,Pappas; Elizabeth,12,0,30,18
1714629659366,EDS 139,A00,507294,Fargason; Sharon Gayle,13,0,30,17
1714629659366,EDS 139,B00,507313,Pappas; Elizabeth,13,0,30,17
1714629660392,EDS 201,A00,507315,Staff,13,0,30,17
1714629661417,EDS 203,A01,507317,Halter; Christopher P.,12,0,30,18
1714629662443,EDS 204R,A01,507319,Halter; Christopher P.,0,3,30,30
1714629662443,EDS 204R,B01,507331,Heinzman; Erica M.,16,0,30,14
1714629663472,EDS 206R,A00,507332,Staff,0,4,30,30
1714629663472,EDS 206R,B00,507343,Staff,17,0,30,13
1714629664497,EDS 250,A00,507344,Hemans; Patricia Ann Benitez,22,0,40,18
1714629665523,EDS 281,A00,507345,Daly; Alan J.,18,0,18,0
1714629666551,EDS 284,A00,507350,Daly; Alan J.,16,0,16,0
1714629667574,EDS 286,A00,507359,Fine; Sarah,18,0,18,0
1714629668598,EDS 289C,A01,507361,Daly; Alan J.,18,0,18,0
1714629669626,EDS 290,A00,507366,Hofstetter; Carolyn,15,0,15,0
1714629670663,LIGM 5A,A00,507421,Fischer-Grunski; Eva K,18,0,20,2
1714629671694,LIGM 5B,A00,507423,Fischer-Grunski; Eva K,19,0,20,1
1714629672720,LIGM 5C,A00,507425,Fischer-Grunski; Eva K,19,0,20,1
1714629673746,LIIT 5AS,A00,507427,Carnelos; Chiara,20,0,20,0
1714629674772,LIIT 5BS,A00,507430,Carnelos; Chiara,20,0,20,0
1714629675804,LIIT 5CS,A00,507432,Carnelos; Chiara,20,0,20,0
1714629676829,LISP 5A,A00,507541,Munoz Sanchez; Alicia,11,0,20,9
1714629677865,LISP 5B,A00,507671,Munoz Sanchez; Alicia,8,0,20,12
1714629678895,LISP 5C,A00,507696,Munoz Sanchez; Alicia,9,0,20,11
1714629679927,MAE 197,001,528363,Boechler; Nicholas Sebastia,9998,0,9999,1
1714629680953,MATH 197,001,523477,Kedlaya; Kiran S.,9995,0,9999,4
1714629680953,MATH 197,002,563811,Zhang; Danna,9995,0,9999,4
1714629680953,MATH 197,003,628552,Dumitriu; Ioana,9998,0,9999,1
1714629681981,MCWP 40R,A00,518780,Staff,2,0,20,18
1714629681981,MCWP 40R,B00,518781,Staff,8,0,20,12
1714629681981,MCWP 40R,C00,518783,Staff,6,0,20,14
1714629683013,MCWP 50R,A00,518791,Staff,0,0,20,20
1714629683013,MCWP 50R,B00,518792,Staff,0,2,20,20
1714629683013,MCWP 50R,C00,518793,Staff,0,2,20,20
1714629683013,MCWP 50R,D00,518794,Staff,0,0,20,20
1714629683013,MCWP 50R,E00,518795,Staff,0,2,20,20
1714629683013,MCWP 50R,F00,518796,Staff,0,0,20,20
1714629683013,MCWP 50R,G00,518797,Staff,0,1,20,20
1714629684040,MMW 12R,A01,514034,Herbst; Matthew,0,0,16,16
1714629684040,MMW 12R,A02,514035,Herbst; Matthew,1,0,16,15
1714629685072,MMW 13R,A01,514037,Staff,0,4,16,16
1714629685072,MMW 13R,A02,514039,Staff,0,2,16,16
1714629685072,MMW 13R,A03,628519,Staff,0,2,16,16
1714629687126,SIO 295LS,A00,523233,Staff,10,0,30,20
1714629688151,SIO 295S,A00,523232,Staff,10,0,30,20
1714629689180,SIOC 290S,A01,637330,Merrifield; Mark A,23,0,30,7
1714629690206,SIOC 291S,A01,637333,Gabriel; Corey John,23,0,30,7
1714629691232,SOCI 117,A01,494376,Staff,0,4,5,5
1714629692258,WES 237B,A00,494380,Staff,9,0,20,11
1714629694330,AESE 279B,A00,494370,Wade; Jon P,0,0,33,33
1714629695355,AIP 197,001,627712,Vespa; Emanuel Ignacio,9998,0,9999,1
1714629696381,ANAR 135S,A00,494369,Braswell; Geoffrey E.,0,0,0,0
1714629697407,BENG 196,001,628496,Engler; Adam J.,9998,0,9999,1
1714629698432,CAT 124RS,A01,519847,Geibel; William,0,0,20,20
1714629699457,CAT 125RS,A01,515971,Geibel; William,0,0,20,20
1714629700481,CLRE 250,A00,511389,Morris; Sheldon,9993,0,9999,6
1714629701507,CLRE 251,A00,507176,Mehta; Ravindra L.,9993,0,9999,6
1714629701507,CLRE 251,B00,511410,Mehta; Ravindra L.,9998,0,9999,1
1714629702535,CLRE 252,A00,507189,Cuomo; Raphael Eduardo,9995,0,9999,4
1714629703563,CLRE 253,A00,507199,Vaida; Florin,9994,0,9999,5
1714629703563,CLRE 253,B00,507202,Vaida; Florin,9999,0,9999,0
1714629704593,CLRE 259,A00,507211,Patel; Hemal,9996,0,9999,3
1714629705618,CLRE 260,A00,507221,Cuomo; Raphael Eduardo,9999,0,9999,0
1714629706642,CLRE 297,001,507242,Cuomo; Raphael Eduardo,9999,0,9999,0
1714629707669,COGS 197,001,638244,Voytek; Bradley Thomas,9998,0,9999,1
1714629708694,CSE 191,A00,516875,Minnes Kemp; Mor Mia,9992,0,9999,7
1714629709719,CSE 197,001,637388,Minnes Kemp; Mor Mia,9998,0,9999,1
1714629710746,CSS 201S,A01,494383,Staff,35,0,35,0
1714629711776,CSS 202S,A01,494387,Staff,35,0,35,0
1714629712806,DSC 197,001,628532,Eldridge; Justin Matthew,9996,0,9999,3
1714629713834,EAP 100,A00,516065,Staff,9797,0,9999,202
1714629714860,ECE 45,A01,507414,Staff,33,0,60,27
1714629716918,ECE 111,A01,507420,Staff,15,0,50,35
1714629717949,ECE 197,001,548057,Sievenpiper; Daniel F.,9993,0,9999,6
1714629718975,EDS 115,A00,507243,Choi; Bailey Miyeon,10,0,28,18
1714629720004,EDS 117,A01,494379,Staff,0,4,30,30
1714629721030,EDS 125,A00,507246,Hopkins; Megan Beth,9,0,30,21
1714629722056,EDS 128A,A01,507264,Fargason; Sharon Gayle,8,0,26,18
1714629723082,EDS 128B,A01,507293,Pappas; Elizabeth,12,0,30,18
1714629724112,EDS 139,A00,507294,Fargason; Sharon Gayle,13,0,30,17
1714629724112,EDS 139,B00,507313,Pappas; Elizabeth,13,0,30,17
1714629725140,EDS 201,A00,507315,Staff,13,0,30,17
1714629726166,EDS 203,A01,507317,Halter; Christopher P.,12,0,30,18
1714629727193,EDS 204R,A01,507319,Halter; Christopher P.,0,3,30,30
1714629727193,EDS 204R,B01,507331,Heinzman; Erica M.,16,0,30,14
1714629728223,EDS 206R,A00,507332,Staff,0,4,30,30
1714629728223,EDS 206R,B00,507343,Staff,17,0,30,13
1714629729251,EDS 250,A00,507344,Hemans; Patricia Ann Benitez,22,0,40,18
1714629730276,EDS 281,A00,507345,Daly; Alan J.,18,0,18,0
1714629731307,EDS 284,A00,507350,Daly; Alan J.,16,0,16,0
1714629732333,EDS 286,A00,507359,Fine; Sarah,18,0,18,0
1714629733358,EDS 289C,A01,507361,Daly; Alan J.,18,0,18,0
1714629734446,EDS 290,A00,507366,Hofstetter; Carolyn,15,0,15,0
1714629735471,LIGM 5A,A00,507421,Fischer-Grunski; Eva K,18,0,20,2
1714629736499,LIGM 5B,A00,507423,Fischer-Grunski; Eva K,19,0,20,1
1714629737524,LIGM 5C,A00,507425,Fischer-Grunski; Eva K,19,0,20,1
1714629738555,LIIT 5AS,A00,507427,Carnelos; Chiara,20,0,20,0
1714629739581,LIIT 5BS,A00,507430,Carnelos; Chiara,20,0,20,0
1714629740606,LIIT 5CS,A00,507432,Carnelos; Chiara,20,0,20,0
1714629741632,LISP 5A,A00,507541,Munoz Sanchez; Alicia,11,0,20,9
1714629742657,LISP 5B,A00,507671,Munoz Sanchez; Alicia,8,0,20,12
1714629743687,LISP 5C,A00,507696,Munoz Sanchez; Alicia,9,0,20,11
1714629744715,MAE 197,001,528363,Boechler; Nicholas Sebastia,9998,0,9999,1
1714629745757,MATH 197,001,523477,Kedlaya; Kiran S.,9995,0,9999,4
1714629745757,MATH 197,002,563811,Zhang; Danna,9995,0,9999,4
1714629745757,MATH 197,003,628552,Dumitriu; Ioana,9998,0,9999,1
1714629746782,MCWP 40R,A00,518780,Staff,2,0,20,18
1714629746782,MCWP 40R,B00,518781,Staff,8,0,20,12
1714629746782,MCWP 40R,C00,518783,Staff,6,0,20,14
1714629747818,MCWP 50R,A00,518791,Staff,0,0,20,20
1714629747818,MCWP 50R,B00,518792,Staff,0,2,20,20
1714629747818,MCWP 50R,C00,518793,Staff,0,2,20,20
1714629747818,MCWP 50R,D00,518794,Staff,0,0,20,20
1714629747818,MCWP 50R,E00,518795,Staff,0,2,20,20
1714629747818,MCWP 50R,F00,518796,Staff,0,0,20,20
1714629747818,MCWP 50R,G00,518797,Staff,0,1,20,20
1714629748843,MMW 12R,A01,514034,Herbst; Matthew,0,0,16,16
1714629748843,MMW 12R,A02,514035,Herbst; Matthew,1,0,16,15
1714629749868,MMW 13R,A01,514037,Staff,0,4,16,16
1714629749868,MMW 13R,A02,514039,Staff,0,2,16,16
1714629749868,MMW 13R,A03,628519,Staff,0,2,16,16
1714629751921,SIO 295LS,A00,523233,Staff,10,0,30,20
1714629752947,SIO 295S,A00,523232,Staff,10,0,30,20
1714629753973,SIOC 290S,A01,637330,Merrifield; Mark A,23,0,30,7
1714629755000,SIOC 291S,A01,637333,Gabriel; Corey John,23,0,30,7
1714629756028,SOCI 117,A01,494376,Staff,0,4,5,5
1714629757055,WES 237B,A00,494380,Staff,9,0,20,11
1714629759125,AESE 279B,A00,494370,Wade; Jon P,0,0,33,33
1714629760150,AIP 197,001,627712,Vespa; Emanuel Ignacio,9998,0,9999,1
1714629761179,ANAR 135S,A00,494369,Braswell; Geoffrey E.,0,0,0,0
1714629762209,BENG 196,001,628496,Engler; Adam J.,9998,0,9999,1
1714629763239,CAT 124RS,A01,519847,Geibel; William,0,0,20,20
1714629764267,CAT 125RS,A01,515971,Geibel; William,0,0,20,20
1714629765292,CLRE 250,A00,511389,Morris; Sheldon,9993,0,9999,6
1714629766319,CLRE 251,A00,507176,Mehta; Ravindra L.,9993,0,9999,6
1714629766319,CLRE 251,B00,511410,Mehta; Ravindra L.,9998,0,9999,1
1714629767345,CLRE 252,A00,507189,Cuomo; Raphael Eduardo,9995,0,9999,4
1714629768375,CLRE 253,A00,507199,Vaida; Florin,9994,0,9999,5
1714629768375,CLRE 253,B00,507202,Vaida; Florin,9999,0,9999,0
1714629769398,CLRE 259,A00,507211,Patel; Hemal,9996,0,9999,3
1714629770430,CLRE 260,A00,507221,Cuomo; Raphael Eduardo,9999,0,9999,0
1714629771455,CLRE 297,001,507242,Cuomo; Raphael Eduardo,9999,0,9999,0
1714629772489,COGS 197,001,638244,Voytek; Bradley Thomas,9998,0,9999,1
1714629773518,CSE 191,A00,516875,Minnes Kemp; Mor Mia,9992,0,9999,7
1714629774548,CSE 197,001,637388,Minnes Kemp; Mor Mia,9998,0,9999,1
1714629775579,CSS 201S,A01,494383,Staff,35,0,35,0
1714629776603,CSS 202S,A01,494387,Staff,35,0,35,0
1714629777628,DSC 197,001,628532,Eldridge; Justin Matthew,9996,0,9999,3
1714629778652,EAP 100,A00,516065,Staff,9797,0,9999,202
1714629779677,ECE 45,A01,507414,Staff,33,0,60,27
1714629781736,ECE 111,A01,507420,Staff,15,0,50,35
1714629782763,ECE 197,001,548057,Sievenpiper; Daniel F.,9993,0,9999,6
1714629783798,EDS 115,A00,507243,Choi; Bailey Miyeon,10,0,28,18
1714629784824,EDS 117,A01,494379,Staff,0,4,30,30
1714629785854,EDS 125,A00,507246,Hopkins; Megan Beth,9,0,30,21
1714629786881,EDS 128A,A01,507264,Fargason; Sharon Gayle,8,0,26,18
1714629787911,EDS 128B,A01,507293,Pappas; Elizabeth,12,0,30,18
1714629788937,EDS 139,A00,507294,Fargason; Sharon Gayle,13,0,30,17
1714629788937,EDS 139,B00,507313,Pappas; Elizabeth,13,0,30,17
1714629789963,EDS 201,A00,507315,Staff,13,0,30,17
1714629790991,EDS 203,A01,507317,Halter; Christopher P.,12,0,30,18
1714629792017,EDS 204R,A01,507319,Halter; Christopher P.,0,3,30,30
1714629792017,EDS 204R,B01,507331,Heinzman; Erica M.,16,0,30,14
1714629793048,EDS 206R,A00,507332,Staff,0,4,30,30
1714629793048,EDS 206R,B00,507343,Staff,17,0,30,13
1714629794074,EDS 250,A00,507344,Hemans; Patricia Ann Benitez,22,0,40,18
1714629795108,EDS 281,A00,507345,Daly; Alan J.,18,0,18,0
1714629796135,EDS 284,A00,507350,Daly; Alan J.,16,0,16,0
1714629797160,EDS 286,A00,507359,Fine; Sarah,18,0,18,0
1714629798188,EDS 289C,A01,507361,Daly; Alan J.,18,0,18,0
1714629799216,EDS 290,A00,507366,Hofstetter; Carolyn,15,0,15,0
1714629800249,LIGM 5A,A00,507421,Fischer-Grunski; Eva K,18,0,20,2
1714629801275,LIGM 5B,A00,507423,Fischer-Grunski; Eva K,19,0,20,1
1714629802301,LIGM 5C,A00,507425,Fischer-Grunski; Eva K,19,0,20,1
1714629803334,LIIT 5AS,A00,507427,Carnelos; Chiara,20,0,20,0
1714629804366,LIIT 5BS,A00,507430,Carnelos; Chiara,20,0,20,0
1714629805393,LIIT 5CS,A00,507432,Carnelos; Chiara,20,0,20,0
1714629806426,LISP 5A,A00,507541,Munoz Sanchez; Alicia,11,0,20,9
1714629807450,LISP 5B,A00,507671,Munoz Sanchez; Alicia,8,0,20,12
1714629808475,LISP 5C,A00,507696,Munoz Sanchez; Alicia,9,0,20,11
1714629809500,MAE 197,001,528363,Boechler; Nicholas Sebastia,9998,0,9999,1
1714629810532,MATH 197,001,523477,Kedlaya; Kiran S.,9995,0,9999,4
1714629810532,MATH 197,002,563811,Zhang; Danna,9995,0,9999,4
1714629810532,MATH 197,003,628552,Dumitriu; Ioana,9998,0,9999,1
1714629811556,MCWP 40R,A00,518780,Staff,2,0,20,18
1714629811556,MCWP 40R,B00,518781,Staff,8,0,20,12
1714629811556,MCWP 40R,C00,518783,Staff,6,0,20,14
1714629812581,MCWP 50R,A00,518791,Staff,0,0,20,20
1714629812581,MCWP 50R,B00,518792,Staff,0,2,20,20
1714629812581,MCWP 50R,C00,518793,Staff,0,2,20,20
1714629812581,MCWP 50R,D00,518794,Staff,0,0,20,20
1714629812581,MCWP 50R,E00,518795,Staff,0,2,20,20
1714629812581,MCWP 50R,F00,518796,Staff,0,0,20,20
1714629812581,MCWP 50R,G00,518797,Staff,0,1,20,20
1714629813612,MMW 12R,A01,514034,Herbst; Matthew,0,0,16,16
1714629813612,MMW 12R,A02,514035,Herbst; Matthew,1,0,16,15
1714629814640,MMW 13R,A01,514037,Staff,0,4,16,16
1714629814640,MMW 13R,A02,514039,Staff,0,2,16,16
1714629814640,MMW 13R,A03,628519,Staff,0,2,16,16
1714629816689,SIO 295LS,A00,523233,Staff,10,0,30,20
1714629817714,SIO 295S,A00,523232,Staff,10,0,30,20
1714629818741,SIOC 290S,A01,637330,Merrifield; Mark A,23,0,30,7
1714629819766,SIOC 291S,A01,637333,Gabriel; Corey John,23,0,30,7
1714629820793,SOCI 117,A01,494376,Staff,0,4,5,5
1714629821819,WES 237B,A00,494380,Staff,9,0,20,11
1714629823897,AESE 279B,A00,494370,Wade; Jon P,0,0,33,33
1714629824925,AIP 197,001,627712,Vespa; Emanuel Ignacio,9998,0,9999,1
1714629825954,ANAR 135S,A00,494369,Braswell; Geoffrey E.,0,0,0,0
1714629826984,BENG 196,001,628496,Engler; Adam J.,9998,0,9999,1
1714629828009,CAT 124RS,A01,519847,Geibel; William,0,0,20,20
1714629829039,CAT 125RS,A01,515971,Geibel; William,0,0,20,20
1714629830070,CLRE 250,A00,511389,Morris; Sheldon,9993,0,9999,6
1714629831101,CLRE 251,A00,507176,Mehta; Ravindra L.,9993,0,9999,6
1714629831101,CLRE 251,B00,511410,Mehta; Ravindra L.,9998,0,9999,1
1714629832129,CLRE 252,A00,507189,Cuomo; Raphael Eduardo,9995,0,9999,4
1714629833158,CLRE 253,A00,507199,Vaida; Florin,9994,0,9999,5
1714629833158,CLRE 253,B00,507202,Vaida; Florin,9999,0,9999,0
1714629834184,CLRE 259,A00,507211,Patel; Hemal,9996,0,9999,3
1714629835211,CLRE 260,A00,507221,Cuomo; Raphael Eduardo,9999,0,9999,0
1714629836236,CLRE 297,001,507242,Cuomo; Raphael Eduardo,9999,0,9999,0
1714629837266,COGS 197,001,638244,Voytek; Bradley Thomas,9998,0,9999,1
1714629838349,CSE 191,A00,516875,Minnes Kemp; Mor Mia,9992,0,9999,7
1714629839388,CSE 197,001,637388,Minnes Kemp; Mor Mia,9998,0,9999,1
1714629840415,CSS 201S,A01,494383,Staff,35,0,35,0
1714629841441,CSS 202S,A01,494387,Staff,35,0,35,0
1714629842476,DSC 197,001,628532,Eldridge; Justin Matthew,9996,0,9999,3
1714629843501,EAP 100,A00,516065,Staff,9797,0,9999,202
1714629844535,ECE 45,A01,507414,Staff,33,0,60,27
1714629846606,ECE 111,A01,507420,Staff,15,0,50,35
1714629847631,ECE 197,001,548057,Sievenpiper; Daniel F.,9993,0,9999,6
1714629848665,EDS 115,A00,507243,Choi; Bailey Miyeon,10,0,28,18
1714629849692,EDS 117,A01,494379,Staff,0,4,30,30
1714629850722,EDS 125,A00,507246,Hopkins; Megan Beth,9,0,30,21
1714629851746,EDS 128A,A01,507264,Fargason; Sharon Gayle,8,0,26,18
1714629852772,EDS 128B,A01,507293,Pappas; Elizabeth,12,0,30,18
1714629853798,EDS 139,A00,507294,Fargason; Sharon Gayle,13,0,30,17
1714629853798,EDS 139,B00,507313,Pappas; Elizabeth,13,0,30,17
1714629854824,EDS 201,A00,507315,Staff,13,0,30,17
1714629855850,EDS 203,A01,507317,Halter; Christopher P.,12,0,30,18
1714629856878,EDS 204R,A01,507319,Halter; Christopher P.,0,3,30,30
1714629856878,EDS 204R,B01,507331,Heinzman; Erica M.,16,0,30,14
1714629857906,EDS 206R,A00,507332,Staff,0,4,30,30
1714629857906,EDS 206R,B00,507343,Staff,17,0,30,13
1714629858935,EDS 250,A00,507344,Hemans; Patricia Ann Benitez,22,0,40,18
1714629859964,EDS 281,A00,507345,Daly; Alan J.,18,0,18,0
1714629860993,EDS 284,A00,507350,Daly; Alan J.,16,0,16,0
1714629862019,EDS 286,A00,507359,Fine; Sarah,18,0,18,0
1714629863043,EDS 289C,A01,507361,Daly; Alan J.,18,0,18,0
1714629864071,EDS 290,A00,507366,Hofstetter; Carolyn,15,0,15,0
1714629865102,LIGM 5A,A00,507421,Fischer-Grunski; Eva K,18,0,20,2
1714629866127,LIGM 5B,A00,507423,Fischer-Grunski; Eva K,19,0,20,1
1714629867157,LIGM 5C,A00,507425,Fischer-Grunski; Eva K,19,0,20,1
1714629868193,LIIT 5AS,A00,507427,Carnelos; Chiara,20,0,20,0
1714629869221,LIIT 5BS,A00,507430,Carnelos; Chiara,20,0,20,0
1714629870248,LIIT 5CS,A00,507432,Carnelos; Chiara,20,0,20,0
1714629871273,LISP 5A,A00,507541,Munoz Sanchez; Alicia,11,0,20,9
1714629872299,LISP 5B,A00,507671,Munoz Sanchez; Alicia,8,0,20,12
1714629873327,LISP 5C,A00,507696,Munoz Sanchez; Alicia,9,0,20,11
1714629874353,MAE 197,001,528363,Boechler; Nicholas Sebastia,9998,0,9999,1
1714629875385,MATH 197,001,523477,Kedlaya; Kiran S.,9995,0,9999,4
1714629875385,MATH 197,002,563811,Zhang; Danna,9995,0,9999,4
1714629875385,MATH 197,003,628552,Dumitriu; Ioana,9998,0,9999,1
1714629876413,MCWP 40R,A00,518780,Staff,2,0,20,18
1714629876413,MCWP 40R,B00,518781,Staff,8,0,20,12
1714629876413,MCWP 40R,C00,518783,Staff,6,0,20,14
1714629877445,MCWP 50R,A00,518791,Staff,0,0,20,20
1714629877445,MCWP 50R,B00,518792,Staff,0,2,20,20
1714629877445,MCWP 50R,C00,518793,Staff,0,2,20,20
1714629877445,MCWP 50R,D00,518794,Staff,0,0,20,20
1714629877445,MCWP 50R,E00,518795,Staff,0,2,20,20
1714629877445,MCWP 50R,F00,518796,Staff,0,0,20,20
1714629877445,MCWP 50R,G00,518797,Staff,0,1,20,20
1714629878472,MMW 12R,A01,514034,Herbst; Matthew,0,0,16,16
1714629878472,MMW 12R,A02,514035,Herbst; Matthew,1,0,16,15
1714629879500,MMW 13R,A01,514037,Staff,0,4,16,16
1714629879500,MMW 13R,A02,514039,Staff,0,2,16,16
1714629879500,MMW 13R,A03,628519,Staff,0,2,16,16
1714629881551,SIO 295LS,A00,523233,Staff,10,0,30,20
1714629882578,SIO 295S,A00,523232,Staff,10,0,30,20
1714629883607,SIOC 290S,A01,637330,Merrifield; Mark A,23,0,30,7
1714629884636,SIOC 291S,A01,637333,Gabriel; Corey John,23,0,30,7
1714629885664,SOCI 117,A01,494376,Staff,0,4,5,5
1714629886694,WES 237B,A00,494380,Staff,9,0,20,11
1714629888756,AESE 279B,A00,494370,Wade; Jon P,0,0,33,33
1714629889781,AIP 197,001,627712,Vespa; Emanuel Ignacio,9998,0,9999,1
1714629890805,ANAR 135S,A00,494369,Braswell; Geoffrey E.,0,0,0,0
1714629891831,BENG 196,001,628496,Engler; Adam J.,9998,0,9999,1
1714629892857,CAT 124RS,A01,519847,Geibel; William,0,0,20,20
1714629893884,CAT 125RS,A01,515971,Geibel; William,0,0,20,20
1714629894914,CLRE 250,A00,511389,Morris; Sheldon,9993,0,9999,6
1714629895940,CLRE 251,A00,507176,Mehta; Ravindra L.,9993,0,9999,6
1714629895940,CLRE 251,B00,511410,Mehta; Ravindra L.,9998,0,9999,1
1714629896966,CLRE 252,A00,507189,Cuomo; Raphael Eduardo,9995,0,9999,4
1714629897994,CLRE 253,A00,507199,Vaida; Florin,9994,0,9999,5
1714629897994,CLRE 253,B00,507202,Vaida; Florin,9999,0,9999,0
1714629899019,CLRE 259,A00,507211,Patel; Hemal,9996,0,9999,3
1714629900084,CLRE 260,A00,507221,Cuomo; Raphael Eduardo,9999,0,9999,0
1714629901114,CLRE 297,001,507242,Cuomo; Raphael Eduardo,9999,0,9999,0
1714629902140,COGS 197,001,638244,Voytek; Bradley Thomas,9998,0,9999,1
1714629903166,CSE 191,A00,516875,Minnes Kemp; Mor Mia,9992,0,9999,7
1714629904193,CSE 197,001,637388,Minnes Kemp; Mor Mia,9998,0,9999,1
1714629905228,CSS 201S,A01,494383,Staff,35,0,35,0
1714629906261,CSS 202S,A01,494387,Staff,35,0,35,0
1714629907287,DSC 197,001,628532,Eldridge; Justin Matthew,9996,0,9999,3
1714629908314,EAP 100,A00,516065,Staff,9797,0,9999,202
1714629909350,ECE 45,A01,507414,Staff,33,0,60,27
1714629911407,ECE 111,A01,507420,Staff,15,0,50,35
1714629912434,ECE 197,001,548057,Sievenpiper; Daniel F.,9993,0,9999,6
1714629913468,EDS 115,A00,507243,Choi; Bailey Miyeon,10,0,28,18
1714629914501,EDS 117,A01,494379,Staff,0,4,30,30
1714629915530,EDS 125,A00,507246,Hopkins; Megan Beth,9,0,30,21
1714629916556,EDS 128A,A01,507264,Fargason; Sharon Gayle,8,0,26,18
1714629917582,EDS 128B,A01,507293,Pappas; Elizabeth,12,0,30,18
1714629918611,EDS 139,A00,507294,Fargason; Sharon Gayle,13,0,30,17
1714629918611,EDS 139,B00,507313,Pappas; Elizabeth,13,0,30,17
1714629919635,EDS 201,A00,507315,Staff,13,0,30,17
1714629920660,EDS 203,A01,507317,Halter; Christopher P.,12,0,30,18
1714629921685,EDS 204R,A01,507319,Halter; Christopher P.,0,3,30,30
1714629921685,EDS 204R,B01,507331,Heinzman; Erica M.,16,0,30,14
1714629922709,EDS 206R,A00,507332,Staff,0,4,30,30
1714629922709,EDS 206R,B00,507343,Staff,17,0,30,13
1714629923734,EDS 250,A00,507344,Hemans; Patricia Ann Benitez,22,0,40,18
1714629924760,EDS 281,A00,507345,Daly; Alan J.,18,0,18,0
1714629925789,EDS 284,A00,507350,Daly; Alan J.,16,0,16,0
1714629926815,EDS 286,A00,507359,Fine; Sarah,18,0,18,0
1714629927839,EDS 289C,A01,507361,Daly; Alan J.,18,0,18,0
1714629928864,EDS 290,A00,507366,Hofstetter; Carolyn,15,0,15,0
1714629929889,LIGM 5A,A00,507421,Fischer-Grunski; Eva K,18,0,20,2
1714629930915,LIGM 5B,A00,507423,Fischer-Grunski; Eva K,19,0,20,1
1714629931941,LIGM 5C,A00,507425,Fischer-Grunski; Eva K,19,0,20,1
1714629932971,LIIT 5AS,A00,507427,Carnelos; Chiara,20,0,20,0
1714629933996,LIIT 5BS,A00,507430,Carnelos; Chiara,20,0,20,0
1714629935022,LIIT 5CS,A00,507432,Carnelos; Chiara,20,0,20,0
1714629936054,LISP 5A,A00,507541,Munoz Sanchez; Alicia,11,0,20,9
1714629937083,LISP 5B,A00,507671,Munoz Sanchez; Alicia,8,0,20,12
1714629938108,LISP 5C,A00,507696,Munoz Sanchez; Alicia,9,0,20,11
1714629939135,MAE 197,001,528363,Boechler; Nicholas Sebastia,9998,0,9999,1
1714629940162,MATH 197,001,523477,Kedlaya; Kiran S.,9995,0,9999,4
1714629940162,MATH 197,002,563811,Zhang; Danna,9995,0,9999,4
1714629940162,MATH 197,003,628552,Dumitriu; Ioana,9998,0,9999,1
1714629941192,MCWP 40R,A00,518780,Staff,2,0,20,18
1714629941192,MCWP 40R,B00,518781,Staff,8,0,20,12
1714629941192,MCWP 40R,C00,518783,Staff,6,0,20,14
1714629942223,MCWP 50R,A00,518791,Staff,0,0,20,20
1714629942223,MCWP 50R,B00,518792,Staff,0,2,20,20
1714629942223,MCWP 50R,C00,518793,Staff,0,2,20,20
1714629942223,MCWP 50R,D00,518794,Staff,0,0,20,20
1714629942223,MCWP 50R,E00,518795,Staff,0,2,20,20
1714629942223,MCWP 50R,F00,518796,Staff,0,0,20,20
1714629942223,MCWP 50R,G00,518797,Staff,0,1,20,20
1714629943249,MMW 12R,A01,514034,Herbst; Matthew,0,0,16,16
1714629943249,MMW 12R,A02,514035,Herbst; Matthew,1,0,16,15
1714629944278,MMW 13R,A01,514037,Staff,0,4,16,16
1714629944278,MMW 13R,A02,514039,Staff,0,2,16,16
1714629944278,MMW 13R,A03,628519,Staff,0,2,16,16
1714629946335,SIO 295LS,A00,523233,Staff,10,0,30,20
1714629947359,SIO 295S,A00,523232,Staff,10,0,30,20
1714629948384,SIOC 290S,A01,637330,Merrifield; Mark A,23,0,30,7
1714629949415,SIOC 291S,A01,637333,Gabriel; Corey John,23,0,30,7
1714629950441,SOCI 117,A01,494376,Staff,0,4,5,5
1714629951467,WES 237B,A00,494380,Staff,9,0,20,11
1714629953611,AESE 279B,A00,494370,Wade; Jon P,0,0,33,33
1714629954636,AIP 197,001,627712,Vespa; Emanuel Ignacio,9998,0,9999,1
1714629955666,ANAR 135S,A00,494369,Braswell; Geoffrey E.,0,0,0,0
1714629956700,BENG 196,001,628496,Engler; Adam J.,9998,0,9999,1
1714629957729,CAT 124RS,A01,519847,Geibel; William,0,0,20,20
1714629958759,CAT 125RS,A01,515971,Geibel; William,0,0,20,20
1714629959784,CLRE 250,A00,511389,Morris; Sheldon,9993,0,9999,6
1714629960817,CLRE 251,A00,507176,Mehta; Ravindra L.,9993,0,9999,6
1714629960817,CLRE 251,B00,511410,Mehta; Ravindra L.,9998,0,9999,1
1714629961844,CLRE 252,A00,507189,Cuomo; Raphael Eduardo,9995,0,9999,4
1714629962869,CLRE 253,A00,507199,Vaida; Florin,9994,0,9999,5
1714629962869,CLRE 253,B00,507202,Vaida; Florin,9999,0,9999,0
1714629963906,CLRE 259,A00,507211,Patel; Hemal,9996,0,9999,3
1714629964934,CLRE 260,A00,507221,Cuomo; Raphael Eduardo,9999,0,9999,0
1714629965963,CLRE 297,001,507242,Cuomo; Raphael Eduardo,9999,0,9999,0
1714629966993,COGS 197,001,638244,Voytek; Bradley Thomas,9998,0,9999,1
1714629968024,CSE 191,A00,516875,Minnes Kemp; Mor Mia,9992,0,9999,7
1714629969051,CSE 197,001,637388,Minnes Kemp; Mor Mia,9998,0,9999,1
1714629970082,CSS 201S,A01,494383,Staff,35,0,35,0
1714629971115,CSS 202S,A01,494387,Staff,35,0,35,0
1714629972144,DSC 197,001,628532,Eldridge; Justin Matthew,9996,0,9999,3
1714629973170,EAP 100,A00,516065,Staff,9797,0,9999,202
1714629974198,ECE 45,A01,507414,Staff,33,0,60,27
1714629976254,ECE 111,A01,507420,Staff,15,0,50,35
1714629977281,ECE 197,001,548057,Sievenpiper; Daniel F.,9993,0,9999,6
1714629978306,EDS 115,A00,507243,Choi; Bailey Miyeon,10,0,28,18
1714629979334,EDS 117,A01,494379,Staff,0,4,30,30
1714629980360,EDS 125,A00,507246,Hopkins; Megan Beth,9,0,30,21
1714629981391,EDS 128A,A01,507264,Fargason; Sharon Gayle,8,0,26,18
1714629982422,EDS 128B,A01,507293,Pappas; Elizabeth,12,0,30,18
1714629983450,EDS 139,A00,507294,Fargason; Sharon Gayle,13,0,30,17
1714629983450,EDS 139,B00,507313,Pappas; Elizabeth,13,0,30,17
1714629984476,EDS 201,A00,507315,Staff,13,0,30,17
1714629985501,EDS 203,A01,507317,Halter; Christopher P.,12,0,30,18
1714629986530,EDS 204R,A01,507319,Halter; Christopher P.,0,3,30,30
1714629986530,EDS 204R,B01,507331,Heinzman; Erica M.,16,0,30,14
1714629987554,EDS 206R,A00,507332,Staff,0,4,30,30
1714629987554,EDS 206R,B00,507343,Staff,17,0,30,13
1714629988580,EDS 250,A00,507344,Hemans; Patricia Ann Benitez,22,0,40,18
1714629989608,EDS 281,A00,507345,Daly; Alan J.,18,0,18,0
1714629990635,EDS 284,A00,507350,Daly; Alan J.,16,0,16,0
1714629991663,EDS 286,A00,507359,Fine; Sarah,18,0,18,0
1714629992689,EDS 289C,A01,507361,Daly; Alan J.,18,0,18,0
1714629993715,EDS 290,A00,507366,Hofstetter; Carolyn,15,0,15,0
1714629994746,LIGM 5A,A00,507421,Fischer-Grunski; Eva K,18,0,20,2
1714629995771,LIGM 5B,A00,507423,Fischer-Grunski; Eva K,19,0,20,1
1714629996797,LIGM 5C,A00,507425,Fischer-Grunski; Eva K,19,0,20,1
1714629997822,LIIT 5AS,A00,507427,Carnelos; Chiara,20,0,20,0
1714629998851,LIIT 5BS,A00,507430,Carnelos; Chiara,20,0,20,0
1714629999877,LIIT 5CS,A00,507432,Carnelos; Chiara,20,0,20,0
1714630000905,LISP 5A,A00,507541,Munoz Sanchez; Alicia,11,0,20,9
1714630001933,LISP 5B,A00,507671,Munoz Sanchez; Alicia,8,0,20,12
1714630002959,LISP 5C,A00,507696,Munoz Sanchez; Alicia,9,0,20,11
1714630003987,MAE 197,001,528363,Boechler; Nicholas Sebastia,9998,0,9999,1
1714630005020,MATH 197,001,523477,Kedlaya; Kiran S.,9995,0,9999,4
1714630005020,MATH 197,002,563811,Zhang; Danna,9995,0,9999,4
1714630005020,MATH 197,003,628552,Dumitriu; Ioana,9998,0,9999,1
1714630006050,MCWP 40R,A00,518780,Staff,2,0,20,18
1714630006050,MCWP 40R,B00,518781,Staff,8,0,20,12
1714630006050,MCWP 40R,C00,518783,Staff,6,0,20,14
1714630007079,MCWP 50R,A00,518791,Staff,0,0,20,20
1714630007079,MCWP 50R,B00,518792,Staff,0,2,20,20
1714630007079,MCWP 50R,C00,518793,Staff,0,2,20,20
1714630007079,MCWP 50R,D00,518794,Staff,0,0,20,20
1714630007079,MCWP 50R,E00,518795,Staff,0,2,20,20
1714630007079,MCWP 50R,F00,518796,Staff,0,0,20,20
1714630007079,MCWP 50R,G00,518797,Staff,0,1,20,20
1714630008105,MMW 12R,A01,514034,Herbst; Matthew,0,0,16,16
1714630008105,MMW 12R,A02,514035,Herbst; Matthew,1,0,16,15
1714630009133,MMW 13R,A01,514037,Staff,0,4,16,16
1714630009133,MMW 13R,A02,514039,Staff,0,2,16,16
1714630009133,MMW 13R,A03,628519,Staff,0,2,16,16
1714630011181,SIO 295LS,A00,523233,Staff,10,0,30,20
1714630012209,SIO 295S,A00,523232,Staff,10,0,30,20
1714630013233,SIOC 290S,A01,637330,Merrifield; Mark A,23,0,30,7
1714630014262,SIOC 291S,A01,637333,Gabriel; Corey John,23,0,30,7
1714630015293,SOCI 117,A01,494376,Staff,0,4,5,5
1714630016318,WES 237B,A00,494380,Staff,9,0,20,11
1714630018386,AESE 279B,A00,494370,Wade; Jon P,0,0,33,33
1714630019413,AIP 197,001,627712,Vespa; Emanuel Ignacio,9998,0,9999,1
1714630020439,ANAR 135S,A00,494369,Braswell; Geoffrey E.,0,0,0,0
1714630021464,BENG 196,001,628496,Engler; Adam J.,9998,0,9999,1
1714630022499,CAT 124RS,A01,519847,Geibel; William,0,0,20,20
1714630023524,CAT 125RS,A01,515971,Geibel; William,0,0,20,20
1714630024552,CLRE 250,A00,511389,Morris; Sheldon,9993,0,9999,6
1714630025580,CLRE 251,A00,507176,Mehta; Ravindra L.,9993,0,9999,6
1714630025580,CLRE 251,B00,511410,Mehta; Ravindra L.,9998,0,9999,1
1714630026609,CLRE 252,A00,507189,Cuomo; Raphael Eduardo,9995,0,9999,4
1714630027633,CLRE 253,A00,507199,Vaida; Florin,9994,0,9999,5
1714630027633,CLRE 253,B00,507202,Vaida; Florin,9999,0,9999,0
1714630028663,CLRE 259,A00,507211,Patel; Hemal,9996,0,9999,3
1714630029688,CLRE 260,A00,507221,Cuomo; Raphael Eduardo,9999,0,9999,0
1714630030714,CLRE 297,001,507242,Cuomo; Raphael Eduardo,9999,0,9999,0
1714630031740,COGS 197,001,638244,Voytek; Bradley Thomas,9998,0,9999,1
1714630032768,CSE 191,A00,516875,Minnes Kemp; Mor Mia,9992,0,9999,7
1714630033792,CSE 197,001,637388,Minnes Kemp; Mor Mia,9998,0,9999,1
1714630034816,CSS 201S,A01,494383,Staff,35,0,35,0
1714630035845,CSS 202S,A01,494387,Staff,35,0,35,0
1714630036869,DSC 197,001,628532,Eldridge; Justin Matthew,9996,0,9999,3
1714630037897,EAP 100,A00,516065,Staff,9797,0,9999,202
1714630038924,ECE 45,A01,507414,Staff,33,0,60,27
1714630040976,ECE 111,A01,507420,Staff,15,0,50,35
1714630042003,ECE 197,001,548057,Sievenpiper; Daniel F.,9993,0,9999,6
1714630043030,EDS 115,A00,507243,Choi; Bailey Miyeon,10,0,28,18
1714630044056,EDS 117,A01,494379,Staff,0,4,30,30
1714630045080,EDS 125,A00,507246,Hopkins; Megan Beth,9,0,30,21
1714630046110,EDS 128A,A01,507264,Fargason; Sharon Gayle,8,0,26,18
1714630047138,EDS 128B,A01,507293,Pappas; Elizabeth,12,0,30,18
1714630048165,EDS 139,A00,507294,Fargason; Sharon Gayle,13,0,30,17
1714630048165,EDS 139,B00,507313,Pappas; Elizabeth,13,0,30,17
1714630049189,EDS 201,A00,507315,Staff,13,0,30,17
1714630050214,EDS 203,A01,507317,Halter; Christopher P.,12,0,30,18
1714630051241,EDS 204R,A01,507319,Halter; Christopher P.,0,3,30,30
1714630051241,EDS 204R,B01,507331,Heinzman; Erica M.,16,0,30,14
1714630052266,EDS 206R,A00,507332,Staff,0,4,30,30
1714630052266,EDS 206R,B00,507343,Staff,17,0,30,13
1714630053292,EDS 250,A00,507344,Hemans; Patricia Ann Benitez,22,0,40,18
1714630054320,EDS 281,A00,507345,Daly; Alan J.,18,0,18,0
1714630055343,EDS 284,A00,507350,Daly; Alan J.,16,0,16,0
1714630056369,EDS 286,A00,507359,Fine; Sarah,18,0,18,0
1714630057395,EDS 289C,A01,507361,Daly; Alan J.,18,0,18,0
1714630058420,EDS 290,A00,507366,Hofstetter; Carolyn,15,0,15,0
1714630059446,LIGM 5A,A00,507421,Fischer-Grunski; Eva K,18,0,20,2
1714630060470,LIGM 5B,A00,507423,Fischer-Grunski; Eva K,19,0,20,1
1714630061496,LIGM 5C,A00,507425,Fischer-Grunski; Eva K,19,0,20,1
1714630062520,LIIT 5AS,A00,507427,Carnelos; Chiara,20,0,20,0
1714630063546,LIIT 5BS,A00,507430,Carnelos; Chiara,20,0,20,0
1714630064571,LIIT 5CS,A00,507432,Carnelos; Chiara,20,0,20,0
1714630065601,LISP 5A,A00,507541,Munoz Sanchez; Alicia,11,0,20,9
1714630066626,LISP 5B,A00,507671,Munoz Sanchez; Alicia,8,0,20,12
1714630067652,LISP 5C,A00,507696,Munoz Sanchez; Alicia,9,0,20,11
1714630068681,MAE 197,001,528363,Boechler; Nicholas Sebastia,9998,0,9999,1
1714630069715,MATH 197,001,523477,Kedlaya; Kiran S.,9995,0,9999,4
1714630069715,MATH 197,002,563811,Zhang; Danna,9995,0,9999,4
1714630069715,MATH 197,003,628552,Dumitriu; Ioana,9998,0,9999,1
1714630070744,MCWP 40R,A00,518780,Staff,2,0,20,18
1714630070744,MCWP 40R,B00,518781,Staff,8,0,20,12
1714630070744,MCWP 40R,C00,518783,Staff,6,0,20,14
1714630071775,MCWP 50R,A00,518791,Staff,0,0,20,20
1714630071775,MCWP 50R,B00,518792,Staff,0,2,20,20
1714630071775,MCWP 50R,C00,518793,Staff,0,2,20,20
1714630071775,MCWP 50R,D00,518794,Staff,0,0,20,20
1714630071775,MCWP 50R,E00,518795,Staff,0,2,20,20
1714630071775,MCWP 50R,F00,518796,Staff,0,0,20,20
1714630071775,MCWP 50R,G00,518797,Staff,0,1,20,20
1714630072803,MMW 12R,A01,514034,Herbst; Matthew,0,0,16,16
1714630072803,MMW 12R,A02,514035,Herbst; Matthew,1,0,16,15
1714630073831,MMW 13R,A01,514037,Staff,0,4,16,16
1714630073831,MMW 13R,A02,514039,Staff,0,2,16,16
1714630073831,MMW 13R,A03,628519,Staff,0,2,16,16
1714630075882,SIO 295LS,A00,523233,Staff,10,0,30,20
1714630076908,SIO 295S,A00,523232,Staff,10,0,30,20
1714630077936,SIOC 290S,A01,637330,Merrifield; Mark A,23,0,30,7
1714630078963,SIOC 291S,A01,637333,Gabriel; Corey John,23,0,30,7
1714630079989,SOCI 117,A01,494376,Staff,0,4,5,5
1714630081015,WES 237B,A00,494380,Staff,9,0,20,11
1714630083096,AESE 279B,A00,494370,Wade; Jon P,0,0,33,33
1714630084121,AIP 197,001,627712,Vespa; Emanuel Ignacio,9998,0,9999,1
1714630085151,ANAR 135S,A00,494369,Braswell; Geoffrey E.,0,0,0,0
1714630086180,BENG 196,001,628496,Engler; Adam J.,9998,0,9999,1
1714630087209,CAT 124RS,A01,519847,Geibel; William,0,0,20,20
1714630088233,CAT 125RS,A01,515971,Geibel; William,0,0,20,20
1714630089260,CLRE 250,A00,511389,Morris; Sheldon,9993,0,9999,6
1714630090293,CLRE 251,A00,507176,Mehta; Ravindra L.,9993,0,9999,6
1714630090293,CLRE 251,B00,511410,Mehta; Ravindra L.,9998,0,9999,1
1714630091321,CLRE 252,A00,507189,Cuomo; Raphael Eduardo,9995,0,9999,4
1714630092346,CLRE 253,A00,507199,Vaida; Florin,9994,0,9999,5
1714630092346,CLRE 253,B00,507202,Vaida; Florin,9999,0,9999,0
1714630093372,CLRE 259,A00,507211,Patel; Hemal,9996,0,9999,3
1714630094398,CLRE 260,A00,507221,Cuomo; Raphael Eduardo,9999,0,9999,0
1714630095422,CLRE 297,001,507242,Cuomo; Raphael Eduardo,9999,0,9999,0
1714630096450,COGS 197,001,638244,Voytek; Bradley Thomas,9998,0,9999,1
1714630097480,CSE 191,A00,516875,Minnes Kemp; Mor Mia,9992,0,9999,7
1714630098504,CSE 197,001,637388,Minnes Kemp; Mor Mia,9998,0,9999,1
1714630099530,CSS 201S,A01,494383,Staff,35,0,35,0
1714630100555,CSS 202S,A01,494387,Staff,35,0,35,0
1714630101583,DSC 197,001,628532,Eldridge; Justin Matthew,9996,0,9999,3
1714630102610,EAP 100,A00,516065,Staff,9797,0,9999,202
1714630103638,ECE 45,A01,507414,Staff,33,0,60,27
1714630105688,ECE 111,A01,507420,Staff,15,0,50,35
1714630106715,ECE 197,001,548057,Sievenpiper; Daniel F.,9993,0,9999,6
1714630107742,EDS 115,A00,507243,Choi; Bailey Miyeon,10,0,28,18
1714630108769,EDS 117,A01,494379,Staff,0,4,30,30
1714630109798,EDS 125,A00,507246,Hopkins; Megan Beth,9,0,30,21
1714630110827,EDS 128A,A01,507264,Fargason; Sharon Gayle,8,0,26,18
1714630111856,EDS 128B,A01,507293,Pappas; Elizabeth,12,0,30,18
1714630112885,EDS 139,A00,507294,Fargason; Sharon Gayle,13,0,30,17
1714630112885,EDS 139,B00,507313,Pappas; Elizabeth,13,0,30,17
1714630113912,EDS 201,A00,507315,Staff,13,0,30,17
1714630114940,EDS 203,A01,507317,Halter; Christopher P.,12,0,30,18
1714630115966,EDS 204R,A01,507319,Halter; Christopher P.,0,3,30,30
1714630115966,EDS 204R,B01,507331,Heinzman; Erica M.,16,0,30,14
1714630116995,EDS 206R,A00,507332,Staff,0,4,30,30
1714630116995,EDS 206R,B00,507343,Staff,17,0,30,13
1714630118020,EDS 250,A00,507344,Hemans; Patricia Ann Benitez,22,0,40,18
1714630119049,EDS 281,A00,507345,Daly; Alan J.,18,0,18,0
1714630120074,EDS 284,A00,507350,Daly; Alan J.,16,0,16,0
1714630121101,EDS 286,A00,507359,Fine; Sarah,18,0,18,0
1714630122129,EDS 289C,A01,507361,Daly; Alan J.,18,0,18,0
1714630123158,EDS 290,A00,507366,Hofstetter; Carolyn,15,0,15,0
1714630124185,LIGM 5A,A00,507421,Fischer-Grunski; Eva K,18,0,20,2
1714630125212,LIGM 5B,A00,507423,Fischer-Grunski; Eva K,19,0,20,1
1714630126240,LIGM 5C,A00,507425,Fischer-Grunski; Eva K,19,0,20,1
1714630127272,LIIT 5AS,A00,507427,Carnelos; Chiara,20,0,20,0
1714630128300,LIIT 5BS,A00,507430,Carnelos; Chiara,20,0,20,0
1714630129328,LIIT 5CS,A00,507432,Carnelos; Chiara,20,0,20,0
1714630130359,LISP 5A,A00,507541,Munoz Sanchez; Alicia,11,0,20,9
1714630131388,LISP 5B,A00,507671,Munoz Sanchez; Alicia,8,0,20,12
1714630132416,LISP 5C,A00,507696,Munoz Sanchez; Alicia,9,0,20,11
1714630133444,MAE 197,001,528363,Boechler; Nicholas Sebastia,9998,0,9999,1
1714630134476,MATH 197,001,523477,Kedlaya; Kiran S.,9995,0,9999,4
1714630134476,MATH 197,002,563811,Zhang; Danna,9995,0,9999,4
1714630134476,MATH 197,003,628552,Dumitriu; Ioana,9998,0,9999,1
1714630135501,MCWP 40R,A00,518780,Staff,2,0,20,18
1714630135501,MCWP 40R,B00,518781,Staff,8,0,20,12
1714630135501,MCWP 40R,C00,518783,Staff,6,0,20,14
1714630136526,MCWP 50R,A00,518791,Staff,0,0,20,20
1714630136526,MCWP 50R,B00,518792,Staff,0,2,20,20
1714630136526,MCWP 50R,C00,518793,Staff,0,2,20,20
1714630136526,MCWP 50R,D00,518794,Staff,0,0,20,20
1714630136526,MCWP 50R,E00,518795,Staff,0,2,20,20
1714630136526,MCWP 50R,F00,518796,Staff,0,0,20,20
1714630136526,MCWP 50R,G00,518797,Staff,0,1,20,20
1714630137552,MMW 12R,A01,514034,Herbst; Matthew,0,0,16,16
1714630137552,MMW 12R,A02,514035,Herbst; Matthew,1,0,16,15
1714630138577,MMW 13R,A01,514037,Staff,0,4,16,16
1714630138577,MMW 13R,A02,514039,Staff,0,2,16,16
1714630138577,MMW 13R,A03,628519,Staff,0,2,16,16
1714630140631,SIO 295LS,A00,523233,Staff,10,0,30,20
1714630141654,SIO 295S,A00,523232,Staff,10,0,30,20
1714630142685,SIOC 290S,A01,637330,Merrifield; Mark A,23,0,30,7
1714630143714,SIOC 291S,A01,637333,Gabriel; Corey John,23,0,30,7
1714630144740,SOCI 117,A01,494376,Staff,0,4,5,5
1714630145767,WES 237B,A00,494380,Staff,9,0,20,11
1714630147849,AESE 279B,A00,494370,Wade; Jon P,0,0,33,33
1714630148874,AIP 197,001,627712,Vespa; Emanuel Ignacio,9998,0,9999,1
1714630149900,ANAR 135S,A00,494369,Braswell; Geoffrey E.,0,0,0,0
1714630150925,BENG 196,001,628496,Engler; Adam J.,9998,0,9999,1
1714630151955,CAT 124RS,A01,519847,Geibel; William,0,0,20,20
1714630152980,CAT 125RS,A01,515971,Geibel; William,0,0,20,20
1714630154006,CLRE 250,A00,511389,Morris; Sheldon,9993,0,9999,6
1714630155034,CLRE 251,A00,507176,Mehta; Ravindra L.,9993,0,9999,6
1714630155034,CLRE 251,B00,511410,Mehta; Ravindra L.,9998,0,9999,1
1714630156060,CLRE 252,A00,507189,Cuomo; Raphael Eduardo,9995,0,9999,4
1714630157086,CLRE 253,A00,507199,Vaida; Florin,9994,0,9999,5
1714630157086,CLRE 253,B00,507202,Vaida; Florin,9999,0,9999,0
1714630158114,CLRE 259,A00,507211,Patel; Hemal,9996,0,9999,3
1714630159142,CLRE 260,A00,507221,Cuomo; Raphael Eduardo,9999,0,9999,0
1714630160166,CLRE 297,001,507242,Cuomo; Raphael Eduardo,9999,0,9999,0
1714630161254,COGS 197,001,638244,Voytek; Bradley Thomas,9998,0,9999,1
1714630162283,CSE 191,A00,516875,Minnes Kemp; Mor Mia,9992,0,9999,7
1714630163310,CSE 197,001,637388,Minnes Kemp; Mor Mia,9998,0,9999,1
1714630164336,CSS 201S,A01,494383,Staff,35,0,35,0
1714630165366,CSS 202S,A01,494387,Staff,35,0,35,0
1714630166394,DSC 197,001,628532,Eldridge; Justin Matthew,9996,0,9999,3
1714630167421,EAP 100,A00,516065,Staff,9797,0,9999,202
1714630168445,ECE 45,A01,507414,Staff,33,0,60,27
1714630170498,ECE 111,A01,507420,Staff,15,0,50,35
1714630171523,ECE 197,001,548057,Sievenpiper; Daniel F.,9993,0,9999,6
1714630172549,EDS 115,A00,507243,Choi; Bailey Miyeon,10,0,28,18
1714630173575,EDS 117,A01,494379,Staff,0,4,30,30
1714630174599,EDS 125,A00,507246,Hopkins; Megan Beth,9,0,30,21
1714630175629,EDS 128A,A01,507264,Fargason; Sharon Gayle,8,0,26,18
1714630176654,EDS 128B,A01,507293,Pappas; Elizabeth,12,0,30,18
1714630177678,EDS 139,A00,507294,Fargason; Sharon Gayle,13,0,30,17
1714630177678,EDS 139,B00,507313,Pappas; Elizabeth,13,0,30,17
1714630178705,EDS 201,A00,507315,Staff,13,0,30,17
1714630179740,EDS 203,A01,507317,Halter; Christopher P.,12,0,30,18
1714630180767,EDS 204R,A01,507319,Halter; Christopher P.,0,3,30,30
1714630180767,EDS 204R,B01,507331,Heinzman; Erica M.,16,0,30,14
1714630181793,EDS 206R,A00,507332,Staff,0,4,30,30
1714630181793,EDS 206R,B00,507343,Staff,17,0,30,13
1714630182818,EDS 250,A00,507344,Hemans; Patricia Ann Benitez,22,0,40,18
1714630183847,EDS 281,A00,507345,Daly; Alan J.,18,0,18,0
1714630184870,EDS 284,A00,507350,Daly; Alan J.,16,0,16,0
1714630185896,EDS 286,A00,507359,Fine; Sarah,18,0,18,0
1714630186922,EDS 289C,A01,507361,Daly; Alan J.,18,0,18,0
1714630187948,EDS 290,A00,507366,Hofstetter; Carolyn,15,0,15,0
1714630188973,LIGM 5A,A00,507421,Fischer-Grunski; Eva K,18,0,20,2
1714630189998,LIGM 5B,A00,507423,Fischer-Grunski; Eva K,19,0,20,1
1714630191025,LIGM 5C,A00,507425,Fischer-Grunski; Eva K,19,0,20,1
1714630192051,LIIT 5AS,A00,507427,Carnelos; Chiara,20,0,20,0
1714630193076,LIIT 5BS,A00,507430,Carnelos; Chiara,20,0,20,0
1714630194101,LIIT 5CS,A00,507432,Carnelos; Chiara,20,0,20,0
1714630195133,LISP 5A,A00,507541,Munoz Sanchez; Alicia,11,0,20,9
1714630196158,LISP 5B,A00,507671,Munoz Sanchez; Alicia,8,0,20,12
1714630197185,LISP 5C,A00,507696,Munoz Sanchez; Alicia,9,0,20,11
1714630198211,MAE 197,001,528363,Boechler; Nicholas Sebastia,9998,0,9999,1
1714630199243,MATH 197,001,523477,Kedlaya; Kiran S.,9995,0,9999,4
1714630199243,MATH 197,002,563811,Zhang; Danna,9995,0,9999,4
1714630199243,MATH 197,003,628552,Dumitriu; Ioana,9998,0,9999,1
1714630200272,MCWP 40R,A00,518780,Staff,2,0,20,18
1714630200272,MCWP 40R,B00,518781,Staff,8,0,20,12
1714630200272,MCWP 40R,C00,518783,Staff,6,0,20,14
1714630201503,MCWP 50R,A00,518791,Staff,0,0,20,20
1714630201503,MCWP 50R,B00,518792,Staff,0,2,20,20
1714630201503,MCWP 50R,C00,518793,Staff,0,2,20,20
1714630201503,MCWP 50R,D00,518794,Staff,0,0,20,20
1714630201503,MCWP 50R,E00,518795,Staff,0,2,20,20
1714630201503,MCWP 50R,F00,518796,Staff,0,0,20,20
1714630201503,MCWP 50R,G00,518797,Staff,0,1,20,20
1714630202529,MMW 12R,A01,514034,Herbst; Matthew,0,0,16,16
1714630202529,MMW 12R,A02,514035,Herbst; Matthew,1,0,16,15
1714630203559,MMW 13R,A01,514037,Staff,0,4,16,16
1714630203559,MMW 13R,A02,514039,Staff,0,2,16,16
1714630203559,MMW 13R,A03,628519,Staff,0,2,16,16
1714630205610,SIO 295LS,A00,523233,Staff,10,0,30,20
1714630206635,SIO 295S,A00,523232,Staff,10,0,30,20
1714630207663,SIOC 290S,A01,637330,Merrifield; Mark A,23,0,30,7
1714630208691,SIOC 291S,A01,637333,Gabriel; Corey John,23,0,30,7
1714630209717,SOCI 117,A01,494376,Staff,0,4,5,5
1714630210742,WES 237B,A00,494380,Staff,9,0,20,11
1714630212812,AESE 279B,A00,494370,Wade; Jon P,0,0,33,33
1714630213837,AIP 197,001,627712,Vespa; Emanuel Ignacio,9998,0,9999,1
1714630214864,ANAR 135S,A00,494369,Braswell; Geoffrey E.,0,0,0,0
1714630215892,BENG 196,001,628496,Engler; Adam J.,9998,0,9999,1
1714630216918,CAT 124RS,A01,519847,Geibel; William,0,0,20,20
1714630217946,CAT 125RS,A01,515971,Geibel; William,0,0,20,20
1714630218972,CLRE 250,A00,511389,Morris; Sheldon,9993,0,9999,6
1714630219998,CLRE 251,A00,507176,Mehta; Ravindra L.,9993,0,9999,6
1714630219998,CLRE 251,B00,511410,Mehta; Ravindra L.,9998,0,9999,1
1714630221024,CLRE 252,A00,507189,Cuomo; Raphael Eduardo,9995,0,9999,4
1714630222052,CLRE 253,A00,507199,Vaida; Florin,9994,0,9999,5
1714630222052,CLRE 253,B00,507202,Vaida; Florin,9999,0,9999,0
1714630223080,CLRE 259,A00,507211,Patel; Hemal,9996,0,9999,3
1714630224106,CLRE 260,A00,507221,Cuomo; Raphael Eduardo,9999,0,9999,0
1714630225131,CLRE 297,001,507242,Cuomo; Raphael Eduardo,9999,0,9999,0
1714630226157,COGS 197,001,638244,Voytek; Bradley Thomas,9998,0,9999,1
1714630227184,CSE 191,A00,516875,Minnes Kemp; Mor Mia,9992,0,9999,7
1714630228209,CSE 197,001,637388,Minnes Kemp; Mor Mia,9998,0,9999,1
1714630229239,CSS 201S,A01,494383,Staff,35,0,35,0
1714630230268,CSS 202S,A01,494387,Staff,35,0,35,0
1714630231293,DSC 197,001,628532,Eldridge; Justin Matthew,9996,0,9999,3
1714630232317,EAP 100,A00,516065,Staff,9797,0,9999,202
1714630233343,ECE 45,A01,507414,Staff,33,0,60,27
1714630235392,ECE 111,A01,507420,Staff,15,0,50,35
1714630236417,ECE 197,001,548057,Sievenpiper; Daniel F.,9993,0,9999,6
1714630237442,EDS 115,A00,507243,Choi; Bailey Miyeon,10,0,28,18
1714630238469,EDS 117,A01,494379,Staff,0,4,30,30
1714630239507,EDS 125,A00,507246,Hopkins; Megan Beth,9,0,30,21
1714630240533,EDS 128A,A01,507264,Fargason; Sharon Gayle,8,0,26,18
1714630241557,EDS 128B,A01,507293,Pappas; Elizabeth,12,0,30,18
1714630242580,EDS 139,A00,507294,Fargason; Sharon Gayle,13,0,30,17
1714630242580,EDS 139,B00,507313,Pappas; Elizabeth,13,0,30,17
1714630243606,EDS 201,A00,507315,Staff,13,0,30,17
1714630244631,EDS 203,A01,507317,Halter; Christopher P.,12,0,30,18
1714630245657,EDS 204R,A01,507319,Halter; Christopher P.,0,3,30,30
1714630245657,EDS 204R,B01,507331,Heinzman; Erica M.,16,0,30,14
1714630246738,EDS 206R,A00,507332,Staff,0,4,30,30
1714630246738,EDS 206R,B00,507343,Staff,17,0,30,13
1714630247762,EDS 250,A00,507344,Hemans; Patricia Ann Benitez,22,0,40,18
1714630248787,EDS 281,A00,507345,Daly; Alan J.,18,0,18,0
1714630249816,EDS 284,A00,507350,Daly; Alan J.,16,0,16,0
1714630250840,EDS 286,A00,507359,Fine; Sarah,18,0,18,0
1714630251865,EDS 289C,A01,507361,Daly; Alan J.,18,0,18,0
1714630252894,EDS 290,A00,507366,Hofstetter; Carolyn,15,0,15,0
1714630253924,LIGM 5A,A00,507421,Fischer-Grunski; Eva K,18,0,20,2
1714630254952,LIGM 5B,A00,507423,Fischer-Grunski; Eva K,19,0,20,1
1714630255979,LIGM 5C,A00,507425,Fischer-Grunski; Eva K,19,0,20,1
1714630257007,LIIT 5AS,A00,507427,Carnelos; Chiara,20,0,20,0
1714630258032,LIIT 5BS,A00,507430,Carnelos; Chiara,20,0,20,0
1714630259058,LIIT 5CS,A00,507432,Carnelos; Chiara,20,0,20,0
1714630260092,LISP 5A,A00,507541,Munoz Sanchez; Alicia,11,0,20,9
1714630261118,LISP 5B,A00,507671,Munoz Sanchez; Alicia,8,0,20,12
1714630262143,LISP 5C,A00,507696,Munoz Sanchez; Alicia,9,0,20,11
1714630263172,MAE 197,001,528363,Boechler; Nicholas Sebastia,9998,0,9999,1
1714630264204,MATH 197,001,523477,Kedlaya; Kiran S.,9995,0,9999,4
1714630264204,MATH 197,002,563811,Zhang; Danna,9995,0,9999,4
1714630264204,MATH 197,003,628552,Dumitriu; Ioana,9998,0,9999,1
1714630265229,MCWP 40R,A00,518780,Staff,2,0,20,18
1714630265229,MCWP 40R,B00,518781,Staff,8,0,20,12
1714630265229,MCWP 40R,C00,518783,Staff,6,0,20,14
1714630266256,MCWP 50R,A00,518791,Staff,0,0,20,20
1714630266256,MCWP 50R,B00,518792,Staff,0,2,20,20
1714630266256,MCWP 50R,C00,518793,Staff,0,2,20,20
1714630266256,MCWP 50R,D00,518794,Staff,0,0,20,20
1714630266256,MCWP 50R,E00,518795,Staff,0,2,20,20
1714630266256,MCWP 50R,F00,518796,Staff,0,0,20,20
1714630266256,MCWP 50R,G00,518797,Staff,0,1,20,20
1714630267286,MMW 12R,A01,514034,Herbst; Matthew,0,0,16,16
1714630267286,MMW 12R,A02,514035,Herbst; Matthew,1,0,16,15
1714630268317,MMW 13R,A01,514037,Staff,0,4,16,16
1714630268317,MMW 13R,A02,514039,Staff,0,2,16,16
1714630268317,MMW 13R,A03,628519,Staff,0,2,16,16
1714630270366,SIO 295LS,A00,523233,Staff,10,0,30,20
1714630271393,SIO 295S,A00,523232,Staff,10,0,30,20
1714630272420,SIOC 290S,A01,637330,Merrifield; Mark A,23,0,30,7
1714630273446,SIOC 291S,A01,637333,Gabriel; Corey John,23,0,30,7
1714630274478,SOCI 117,A01,494376,Staff,0,4,5,5
1714630275504,WES 237B,A00,494380,Staff,9,0,20,11
1714630277589,AESE 279B,A00,494370,Wade; Jon P,0,0,33,33
1714630278614,AIP 197,001,627712,Vespa; Emanuel Ignacio,9998,0,9999,1
1714630279645,ANAR 135S,A00,494369,Braswell; Geoffrey E.,0,0,0,0
1714630280670,BENG 196,001,628496,Engler; Adam J.,9998,0,9999,1
1714630281696,CAT 124RS,A01,519847,Geibel; William,0,0,20,20
1714630282722,CAT 125RS,A01,515971,Geibel; William,0,0,20,20
1714630283747,CLRE 250,A00,511389,Morris; Sheldon,9993,0,9999,6
1714630284773,CLRE 251,A00,507176,Mehta; Ravindra L.,9993,0,9999,6
1714630284773,CLRE 251,B00,511410,Mehta; Ravindra L.,9998,0,9999,1
1714630285798,CLRE 252,A00,507189,Cuomo; Raphael Eduardo,9995,0,9999,4
1714630286828,CLRE 253,A00,507199,Vaida; Florin,9994,0,9999,5
1714630286828,CLRE 253,B00,507202,Vaida; Florin,9999,0,9999,0
1714630287854,CLRE 259,A00,507211,Patel; Hemal,9996,0,9999,3
1714630288882,CLRE 260,A00,507221,Cuomo; Raphael Eduardo,9999,0,9999,0
1714630289907,CLRE 297,001,507242,Cuomo; Raphael Eduardo,9999,0,9999,0
1714630290933,COGS 197,001,638244,Voytek; Bradley Thomas,9998,0,9999,1
1714630291957,CSE 191,A00,516875,Minnes Kemp; Mor Mia,9992,0,9999,7
1714630292982,CSE 197,001,637388,Minnes Kemp; Mor Mia,9998,0,9999,1
1714630294011,CSS 201S,A01,494383,Staff,35,0,35,0
1714630295036,CSS 202S,A01,494387,Staff,35,0,35,0
1714630296065,DSC 197,001,628532,Eldridge; Justin Matthew,9996,0,9999,3
1714630297089,EAP 100,A00,516065,Staff,9797,0,9999,202
1714630298116,ECE 45,A01,507414,Staff,33,0,60,27
1714630300178,ECE 111,A01,507420,Staff,15,0,50,35
1714630301207,ECE 197,001,548057,Sievenpiper; Daniel F.,9993,0,9999,6
1714630302233,EDS 115,A00,507243,Choi; Bailey Miyeon,10,0,28,18
1714630303264,EDS 117,A01,494379,Staff,0,4,30,30
1714630304290,EDS 125,A00,507246,Hopkins; Megan Beth,9,0,30,21
1714630305320,EDS 128A,A01,507264,Fargason; Sharon Gayle,8,0,26,18
1714630306346,EDS 128B,A01,507293,Pappas; Elizabeth,12,0,30,18
1714630307374,EDS 139,A00,507294,Fargason; Sharon Gayle,13,0,30,17
1714630307374,EDS 139,B00,507313,Pappas; Elizabeth,13,0,30,17
1714630308400,EDS 201,A00,507315,Staff,13,0,30,17
1714630309426,EDS 203,A01,507317,Halter; Christopher P.,12,0,30,18
1714630310451,EDS 204R,A01,507319,Halter; Christopher P.,0,3,30,30
1714630310451,EDS 204R,B01,507331,Heinzman; Erica M.,16,0,30,14
1714630311478,EDS 206R,A00,507332,Staff,0,4,30,30
1714630311478,EDS 206R,B00,507343,Staff,17,0,30,13
1714630312505,EDS 250,A00,507344,Hemans; Patricia Ann Benitez,22,0,40,18
1714630313536,EDS 281,A00,507345,Daly; Alan J.,18,0,18,0
1714630314561,EDS 284,A00,507350,Daly; Alan J.,16,0,16,0
1714630315586,EDS 286,A00,507359,Fine; Sarah,18,0,18,0
1714630316611,EDS 289C,A01,507361,Daly; Alan J.,18,0,18,0
1714630317636,EDS 290,A00,507366,Hofstetter; Carolyn,15,0,15,0
1714630318660,LIGM 5A,A00,507421,Fischer-Grunski; Eva K,18,0,20,2
1714630319685,LIGM 5B,A00,507423,Fischer-Grunski; Eva K,19,0,20,1
1714630320721,LIGM 5C,A00,507425,Fischer-Grunski; Eva K,19,0,20,1
1714630321747,LIIT 5AS,A00,507427,Carnelos; Chiara,20,0,20,0
1714630322777,LIIT 5BS,A00,507430,Carnelos; Chiara,20,0,20,0
1714630323806,LIIT 5CS,A00,507432,Carnelos; Chiara,20,0,20,0
1714630324837,LISP 5A,A00,507541,Munoz Sanchez; Alicia,11,0,20,9
1714630325861,LISP 5B,A00,507671,Munoz Sanchez; Alicia,8,0,20,12
1714630326888,LISP 5C,A00,507696,Munoz Sanchez; Alicia,9,0,20,11
1714630327973,MAE 197,001,528363,Boechler; Nicholas Sebastia,9998,0,9999,1
1714630329008,MATH 197,001,523477,Kedlaya; Kiran S.,9995,0,9999,4
1714630329008,MATH 197,002,563811,Zhang; Danna,9995,0,9999,4
1714630329008,MATH 197,003,628552,Dumitriu; Ioana,9998,0,9999,1
1714630330035,MCWP 40R,A00,518780,Staff,2,0,20,18
1714630330035,MCWP 40R,B00,518781,Staff,8,0,20,12
1714630330035,MCWP 40R,C00,518783,Staff,6,0,20,14
1714630331060,MCWP 50R,A00,518791,Staff,0,0,20,20
1714630331060,MCWP 50R,B00,518792,Staff,0,2,20,20
1714630331060,MCWP 50R,C00,518793,Staff,0,2,20,20
1714630331060,MCWP 50R,D00,518794,Staff,0,0,20,20
1714630331060,MCWP 50R,E00,518795,Staff,0,2,20,20
1714630331060,MCWP 50R,F00,518796,Staff,0,0,20,20
1714630331060,MCWP 50R,G00,518797,Staff,0,1,20,20
1714630332086,MMW 12R,A01,514034,Herbst; Matthew,0,0,16,16
1714630332086,MMW 12R,A02,514035,Herbst; Matthew,1,0,16,15
1714630333111,MMW 13R,A01,514037,Staff,0,4,16,16
1714630333111,MMW 13R,A02,514039,Staff,0,2,16,16
1714630333111,MMW 13R,A03,628519,Staff,0,2,16,16
1714630335161,SIO 295LS,A00,523233,Staff,10,0,30,20
1714630336186,SIO 295S,A00,523232,Staff,10,0,30,20
1714630337215,SIOC 290S,A01,637330,Merrifield; Mark A,23,0,30,7
1714630338248,SIOC 291S,A01,637333,Gabriel; Corey John,23,0,30,7
1714630339272,SOCI 117,A01,494376,Staff,0,4,5,5
1714630340300,WES 237B,A00,494380,Staff,9,0,20,11
1714630342380,AESE 279B,A00,494370,Wade; Jon P,0,0,33,33
1714630343405,AIP 197,001,627712,Vespa; Emanuel Ignacio,9998,0,9999,1
1714630344432,ANAR 135S,A00,494369,Braswell; Geoffrey E.,0,0,0,0
1714630345458,BENG 196,001,628496,Engler; Adam J.,9998,0,9999,1
1714630346485,CAT 124RS,A01,519847,Geibel; William,0,0,20,20
1714630347510,CAT 125RS,A01,515971,Geibel; William,0,0,20,20
1714630348536,CLRE 250,A00,511389,Morris; Sheldon,9993,0,9999,6
1714630349567,CLRE 251,A00,507176,Mehta; Ravindra L.,9993,0,9999,6
1714630349567,CLRE 251,B00,511410,Mehta; Ravindra L.,9998,0,9999,1
1714630350594,CLRE 252,A00,507189,Cuomo; Raphael Eduardo,9995,0,9999,4
1714630351626,CLRE 253,A00,507199,Vaida; Florin,9994,0,9999,5
1714630351626,CLRE 253,B00,507202,Vaida; Florin,9999,0,9999,0
1714630352654,CLRE 259,A00,507211,Patel; Hemal,9996,0,9999,3
1714630353678,CLRE 260,A00,507221,Cuomo; Raphael Eduardo,9999,0,9999,0
1714630354702,CLRE 297,001,507242,Cuomo; Raphael Eduardo,9999,0,9999,0
1714630355729,COGS 197,001,638244,Voytek; Bradley Thomas,9998,0,9999,1
1714630356759,CSE 191,A00,516875,Minnes Kemp; Mor Mia,9992,0,9999,7
1714630357786,CSE 197,001,637388,Minnes Kemp; Mor Mia,9998,0,9999,1
1714630358810,CSS 201S,A01,494383,Staff,35,0,35,0
1714630359838,CSS 202S,A01,494387,Staff,35,0,35,0
1714630360864,DSC 197,001,628532,Eldridge; Justin Matthew,9996,0,9999,3
1714630361887,EAP 100,A00,516065,Staff,9797,0,9999,202
1714630362917,ECE 45,A01,507414,Staff,33,0,60,27
1714630364968,ECE 111,A01,507420,Staff,15,0,50,35
1714630365995,ECE 197,001,548057,Sievenpiper; Daniel F.,9993,0,9999,6
1714630367021,EDS 115,A00,507243,Choi; Bailey Miyeon,10,0,28,18
1714630368048,EDS 117,A01,494379,Staff,0,4,30,30
1714630369076,EDS 125,A00,507246,Hopkins; Megan Beth,9,0,30,21
1714630370101,EDS 128A,A01,507264,Fargason; Sharon Gayle,8,0,26,18
1714630371125,EDS 128B,A01,507293,Pappas; Elizabeth,12,0,30,18
1714630372149,EDS 139,A00,507294,Fargason; Sharon Gayle,13,0,30,17
1714630372149,EDS 139,B00,507313,Pappas; Elizabeth,13,0,30,17
1714630373178,EDS 201,A00,507315,Staff,13,0,30,17
1714630374206,EDS 203,A01,507317,Halter; Christopher P.,12,0,30,18
1714630375230,EDS 204R,A01,507319,Halter; Christopher P.,0,3,30,30
1714630375230,EDS 204R,B01,507331,Heinzman; Erica M.,16,0,30,14
1714630376255,EDS 206R,A00,507332,Staff,0,4,30,30
1714630376255,EDS 206R,B00,507343,Staff,17,0,30,13
1714630377280,EDS 250,A00,507344,Hemans; Patricia Ann Benitez,22,0,40,18
1714630378305,EDS 281,A00,507345,Daly; Alan J.,18,0,18,0
1714630379329,EDS 284,A00,507350,Daly; Alan J.,16,0,16,0
1714630380357,EDS 286,A00,507359,Fine; Sarah,18,0,18,0
1714630381381,EDS 289C,A01,507361,Daly; Alan J.,18,0,18,0
1714630382405,EDS 290,A00,507366,Hofstetter; Carolyn,15,0,15,0
1714630383437,LIGM 5A,A00,507421,Fischer-Grunski; Eva K,18,0,20,2
1714630384463,LIGM 5B,A00,507423,Fischer-Grunski; Eva K,19,0,20,1
1714630385490,LIGM 5C,A00,507425,Fischer-Grunski; Eva K,19,0,20,1
1714630386517,LIIT 5AS,A00,507427,Carnelos; Chiara,20,0,20,0
1714630387540,LIIT 5BS,A00,507430,Carnelos; Chiara,20,0,20,0
1714630388570,LIIT 5CS,A00,507432,Carnelos; Chiara,20,0,20,0
1714630389597,LISP 5A,A00,507541,Munoz Sanchez; Alicia,11,0,20,9
1714630390621,LISP 5B,A00,507671,Munoz Sanchez; Alicia,8,0,20,12
1714630391651,LISP 5C,A00,507696,Munoz Sanchez; Alicia,9,0,20,11
1714630392677,MAE 197,001,528363,Boechler; Nicholas Sebastia,9998,0,9999,1
1714630393705,MATH 197,001,523477,Kedlaya; Kiran S.,9995,0,9999,4
1714630393705,MATH 197,002,563811,Zhang; Danna,9995,0,9999,4
1714630393705,MATH 197,003,628552,Dumitriu; Ioana,9998,0,9999,1
1714630394734,MCWP 40R,A00,518780,Staff,2,0,20,18
1714630394734,MCWP 40R,B00,518781,Staff,8,0,20,12
1714630394734,MCWP 40R,C00,518783,Staff,6,0,20,14
1714630395760,MCWP 50R,A00,518791,Staff,0,0,20,20
1714630395760,MCWP 50R,B00,518792,Staff,0,2,20,20
1714630395760,MCWP 50R,C00,518793,Staff,0,2,20,20
1714630395760,MCWP 50R,D00,518794,Staff,0,0,20,20
1714630395760,MCWP 50R,E00,518795,Staff,0,2,20,20
1714630395760,MCWP 50R,F00,518796,Staff,0,0,20,20
1714630395760,MCWP 50R,G00,518797,Staff,0,1,20,20
1714630396788,MMW 12R,A01,514034,Herbst; Matthew,0,0,16,16
1714630396788,MMW 12R,A02,514035,Herbst; Matthew,1,0,16,15
1714630397815,MMW 13R,A01,514037,Staff,0,4,16,16
1714630397815,MMW 13R,A02,514039,Staff,0,2,16,16
1714630397815,MMW 13R,A03,628519,Staff,0,2,16,16
1714630399865,SIO 295LS,A00,523233,Staff,10,0,30,20
1714630400889,SIO 295S,A00,523232,Staff,10,0,30,20
1714630401915,SIOC 290S,A01,637330,Merrifield; Mark A,23,0,30,7
1714630402944,SIOC 291S,A01,637333,Gabriel; Corey John,23,0,30,7
1714630403971,SOCI 117,A01,494376,Staff,0,4,5,5
1714630404998,WES 237B,A00,494380,Staff,9,0,20,11
1714630407070,AESE 279B,A00,494370,Wade; Jon P,0,0,33,33
1714630408096,AIP 197,001,627712,Vespa; Emanuel Ignacio,9998,0,9999,1
1714630409122,ANAR 135S,A00,494369,Braswell; Geoffrey E.,0,0,0,0
1714630410149,BENG 196,001,628496,Engler; Adam J.,9998,0,9999,1
1714630411173,CAT 124RS,A01,519847,Geibel; William,0,0,20,20
1714630412198,CAT 125RS,A01,515971,Geibel; William,0,0,20,20
1714630413224,CLRE 250,A00,511389,Morris; Sheldon,9993,0,9999,6
1714630414255,CLRE 251,A00,507176,Mehta; Ravindra L.,9993,0,9999,6
1714630414255,CLRE 251,B00,511410,Mehta; Ravindra L.,9998,0,9999,1
1714630415280,CLRE 252,A00,507189,Cuomo; Raphael Eduardo,9995,0,9999,4
1714630416310,CLRE 253,A00,507199,Vaida; Florin,9994,0,9999,5
1714630416310,CLRE 253,B00,507202,Vaida; Florin,9999,0,9999,0
1714630417335,CLRE 259,A00,507211,Patel; Hemal,9996,0,9999,3
1714630418359,CLRE 260,A00,507221,Cuomo; Raphael Eduardo,9999,0,9999,0
1714630419383,CLRE 297,001,507242,Cuomo; Raphael Eduardo,9999,0,9999,0
1714630420413,COGS 197,001,638244,Voytek; Bradley Thomas,9998,0,9999,1
1714630421437,CSE 191,A00,516875,Minnes Kemp; Mor Mia,9992,0,9999,7
1714630422465,CSE 197,001,637388,Minnes Kemp; Mor Mia,9998,0,9999,1
1714630423490,CSS 201S,A01,494383,Staff,35,0,35,0
1714630424514,CSS 202S,A01,494387,Staff,35,0,35,0
1714630425540,DSC 197,001,628532,Eldridge; Justin Matthew,9996,0,9999,3
1714630426567,EAP 100,A00,516065,Staff,9797,0,9999,202
1714630427596,ECE 45,A01,507414,Staff,33,0,60,27
1714630429646,ECE 111,A01,507420,Staff,15,0,50,35
1714630430671,ECE 197,001,548057,Sievenpiper; Daniel F.,9993,0,9999,6
1714630431696,EDS 115,A00,507243,Choi; Bailey Miyeon,10,0,28,18
1714630432721,EDS 117,A01,494379,Staff,0,4,30,30
1714630433747,EDS 125,A00,507246,Hopkins; Megan Beth,9,0,30,21
1714630434773,EDS 128A,A01,507264,Fargason; Sharon Gayle,8,0,26,18
1714630435801,EDS 128B,A01,507293,Pappas; Elizabeth,12,0,30,18
1714630436825,EDS 139,A00,507294,Fargason; Sharon Gayle,13,0,30,17
1714630436825,EDS 139,B00,507313,Pappas; Elizabeth,13,0,30,17
1714630437850,EDS 201,A00,507315,Staff,13,0,30,17
1714630438874,EDS 203,A01,507317,Halter; Christopher P.,12,0,30,18
1714630439903,EDS 204R,A01,507319,Halter; Christopher P.,0,3,30,30
1714630439903,EDS 204R,B01,507331,Heinzman; Erica M.,16,0,30,14
1714630440926,EDS 206R,A00,507332,Staff,0,4,30,30
1714630440926,EDS 206R,B00,507343,Staff,17,0,30,13
1714630441955,EDS 250,A00,507344,Hemans; Patricia Ann Benitez,22,0,40,18
1714630442981,EDS 281,A00,507345,Daly; Alan J.,18,0,18,0
1714630444010,EDS 284,A00,507350,Daly; Alan J.,16,0,16,0
1714630445036,EDS 286,A00,507359,Fine; Sarah,18,0,18,0
1714630446062,EDS 289C,A01,507361,Daly; Alan J.,18,0,18,0
1714630447086,EDS 290,A00,507366,Hofstetter; Carolyn,15,0,15,0
1714630448117,LIGM 5A,A00,507421,Fischer-Grunski; Eva K,18,0,20,2
1714630449145,LIGM 5B,A00,507423,Fischer-Grunski; Eva K,19,0,20,1
1714630450169,LIGM 5C,A00,507425,Fischer-Grunski; Eva K,19,0,20,1
1714630451195,LIIT 5AS,A00,507427,Carnelos; Chiara,20,0,20,0
1714630452223,LIIT 5BS,A00,507430,Carnelos; Chiara,20,0,20,0
1714630453248,LIIT 5CS,A00,507432,Carnelos; Chiara,20,0,20,0
1714630454278,LISP 5A,A00,507541,Munoz Sanchez; Alicia,11,0,20,9
1714630455308,LISP 5B,A00,507671,Munoz Sanchez; Alicia,8,0,20,12
1714630456332,LISP 5C,A00,507696,Munoz Sanchez; Alicia,9,0,20,11
1714630457361,MAE 197,001,528363,Boechler; Nicholas Sebastia,9998,0,9999,1
1714630458385,MATH 197,001,523477,Kedlaya; Kiran S.,9995,0,9999,4
1714630458385,MATH 197,002,563811,Zhang; Danna,9995,0,9999,4
1714630458385,MATH 197,003,628552,Dumitriu; Ioana,9998,0,9999,1
1714630459414,MCWP 40R,A00,518780,Staff,2,0,20,18
1714630459414,MCWP 40R,B00,518781,Staff,8,0,20,12
1714630459414,MCWP 40R,C00,518783,Staff,6,0,20,14
1714630460439,MCWP 50R,A00,518791,Staff,0,0,20,20
1714630460439,MCWP 50R,B00,518792,Staff,0,2,20,20
1714630460439,MCWP 50R,C00,518793,Staff,0,2,20,20
1714630460439,MCWP 50R,D00,518794,Staff,0,0,20,20
1714630460439,MCWP 50R,E00,518795,Staff,0,2,20,20
1714630460439,MCWP 50R,F00,518796,Staff,0,0,20,20
1714630460439,MCWP 50R,G00,518797,Staff,0,1,20,20
1714630461463,MMW 12R,A01,514034,Herbst; Matthew,0,0,16,16
1714630461463,MMW 12R,A02,514035,Herbst; Matthew,1,0,16,15
1714630462490,MMW 13R,A01,514037,Staff,0,4,16,16
1714630462490,MMW 13R,A02,514039,Staff,0,2,16,16
1714630462490,MMW 13R,A03,628519,Staff,0,2,16,16
1714630464540,SIO 295LS,A00,523233,Staff,10,0,30,20
1714630465569,SIO 295S,A00,523232,Staff,10,0,30,20
1714630466596,SIOC 290S,A01,637330,Merrifield; Mark A,23,0,30,7
1714630467620,SIOC 291S,A01,637333,Gabriel; Corey John,23,0,30,7
1714630468648,SOCI 117,A01,494376,Staff,0,4,5,5
1714630469671,WES 237B,A00,494380,Staff,9,0,20,11
1714630471751,AESE 279B,A00,494370,Wade; Jon P,0,0,33,33
1714630472775,AIP 197,001,627712,Vespa; Emanuel Ignacio,9998,0,9999,1
1714630473799,ANAR 135S,A00,494369,Braswell; Geoffrey E.,0,0,0,0
1714630474829,BENG 196,001,628496,Engler; Adam J.,9998,0,9999,1
1714630475858,CAT 124RS,A01,519847,Geibel; William,0,0,20,20
1714630476882,CAT 125RS,A01,515971,Geibel; William,0,0,20,20
1714630477909,CLRE 250,A00,511389,Morris; Sheldon,9993,0,9999,6
1714630478936,CLRE 251,A00,507176,Mehta; Ravindra L.,9993,0,9999,6
1714630478936,CLRE 251,B00,511410,Mehta; Ravindra L.,9998,0,9999,1
1714630479963,CLRE 252,A00,507189,Cuomo; Raphael Eduardo,9995,0,9999,4
1714630480991,CLRE 253,A00,507199,Vaida; Florin,9994,0,9999,5
1714630480991,CLRE 253,B00,507202,Vaida; Florin,9999,0,9999,0
1714630482016,CLRE 259,A00,507211,Patel; Hemal,9996,0,9999,3
1714630483044,CLRE 260,A00,507221,Cuomo; Raphael Eduardo,9999,0,9999,0
1714630484071,CLRE 297,001,507242,Cuomo; Raphael Eduardo,9999,0,9999,0
1714630485096,COGS 197,001,638244,Voytek; Bradley Thomas,9998,0,9999,1
1714630486123,CSE 191,A00,516875,Minnes Kemp; Mor Mia,9992,0,9999,7
1714630487149,CSE 197,001,637388,Minnes Kemp; Mor Mia,9998,0,9999,1
1714630488178,CSS 201S,A01,494383,Staff,35,0,35,0
1714630489207,CSS 202S,A01,494387,Staff,35,0,35,0
1714630490232,DSC 197,001,628532,Eldridge; Justin Matthew,9996,0,9999,3
1714630491260,EAP 100,A00,516065,Staff,9797,0,9999,202
1714630492286,ECE 45,A01,507414,Staff,33,0,60,27
1714630494341,ECE 111,A01,507420,Staff,15,0,50,35
1714630495365,ECE 197,001,548057,Sievenpiper; Daniel F.,9993,0,9999,6
1714630496392,EDS 115,A00,507243,Choi; Bailey Miyeon,10,0,28,18
1714630497417,EDS 117,A01,494379,Staff,0,4,30,30
1714630498445,EDS 125,A00,507246,Hopkins; Megan Beth,9,0,30,21
1714630499471,EDS 128A,A01,507264,Fargason; Sharon Gayle,8,0,26,18
1714630500500,EDS 128B,A01,507293,Pappas; Elizabeth,12,0,30,18
1714630501526,EDS 139,A00,507294,Fargason; Sharon Gayle,13,0,30,17
1714630501526,EDS 139,B00,507313,Pappas; Elizabeth,13,0,30,17
1714630502554,EDS 201,A00,507315,Staff,13,0,30,17
1714630503585,EDS 203,A01,507317,Halter; Christopher P.,12,0,30,18
1714630504610,EDS 204R,A01,507319,Halter; Christopher P.,0,3,30,30
1714630504610,EDS 204R,B01,507331,Heinzman; Erica M.,16,0,30,14
1714630505636,EDS 206R,A00,507332,Staff,0,4,30,30
1714630505636,EDS 206R,B00,507343,Staff,17,0,30,13
1714630506662,EDS 250,A00,507344,Hemans; Patricia Ann Benitez,22,0,40,18
1714630507686,EDS 281,A00,507345,Daly; Alan J.,18,0,18,0
1714630508711,EDS 284,A00,507350,Daly; Alan J.,16,0,16,0
1714630509794,EDS 286,A00,507359,Fine; Sarah,18,0,18,0
1714630510823,EDS 289C,A01,507361,Daly; Alan J.,18,0,18,0
1714630511848,EDS 290,A00,507366,Hofstetter; Carolyn,15,0,15,0
1714630512877,LIGM 5A,A00,507421,Fischer-Grunski; Eva K,18,0,20,2
1714630513904,LIGM 5B,A00,507423,Fischer-Grunski; Eva K,19,0,20,1
1714630514931,LIGM 5C,A00,507425,Fischer-Grunski; Eva K,19,0,20,1
1714630515956,LIIT 5AS,A00,507427,Carnelos; Chiara,20,0,20,0
1714630516982,LIIT 5BS,A00,507430,Carnelos; Chiara,20,0,20,0
1714630518010,LIIT 5CS,A00,507432,Carnelos; Chiara,20,0,20,0
1714630519038,LISP 5A,A00,507541,Munoz Sanchez; Alicia,11,0,20,9
1714630520063,LISP 5B,A00,507671,Munoz Sanchez; Alicia,8,0,20,12
1714630521086,LISP 5C,A00,507696,Munoz Sanchez; Alicia,9,0,20,11
1714630522112,MAE 197,001,528363,Boechler; Nicholas Sebastia,9998,0,9999,1
1714630523139,MATH 197,001,523477,Kedlaya; Kiran S.,9995,0,9999,4
1714630523139,MATH 197,002,563811,Zhang; Danna,9995,0,9999,4
1714630523139,MATH 197,003,628552,Dumitriu; Ioana,9998,0,9999,1
1714630524164,MCWP 40R,A00,518780,Staff,2,0,20,18
1714630524164,MCWP 40R,B00,518781,Staff,8,0,20,12
1714630524164,MCWP 40R,C00,518783,Staff,6,0,20,14
1714630525190,MCWP 50R,A00,518791,Staff,0,0,20,20
1714630525190,MCWP 50R,B00,518792,Staff,0,2,20,20
1714630525190,MCWP 50R,C00,518793,Staff,0,2,20,20
1714630525190,MCWP 50R,D00,518794,Staff,0,0,20,20
1714630525190,MCWP 50R,E00,518795,Staff,0,2,20,20
1714630525190,MCWP 50R,F00,518796,Staff,0,0,20,20
1714630525190,MCWP 50R,G00,518797,Staff,0,1,20,20
1714630526216,MMW 12R,A01,514034,Herbst; Matthew,0,0,16,16
1714630526216,MMW 12R,A02,514035,Herbst; Matthew,1,0,16,15
1714630527243,MMW 13R,A01,514037,Staff,0,4,16,16
1714630527243,MMW 13R,A02,514039,Staff,0,2,16,16
1714630527243,MMW 13R,A03,628519,Staff,0,2,16,16
1714630529299,SIO 295LS,A00,523233,Staff,10,0,30,20
1714630530335,SIO 295S,A00,523232,Staff,10,0,30,20
1714630531363,SIOC 290S,A01,637330,Merrifield; Mark A,23,0,30,7
1714630532392,SIOC 291S,A01,637333,Gabriel; Corey John,23,0,30,7
1714630533421,SOCI 117,A01,494376,Staff,0,4,5,5
1714630534447,WES 237B,A00,494380,Staff,9,0,20,11
1714630536519,AESE 279B,A00,494370,Wade; Jon P,0,0,33,33
1714630537547,AIP 197,001,627712,Vespa; Emanuel Ignacio,9998,0,9999,1
1714630538572,ANAR 135S,A00,494369,Braswell; Geoffrey E.,0,0,0,0
1714630539596,BENG 196,001,628496,Engler; Adam J.,9998,0,9999,1
1714630540620,CAT 124RS,A01,519847,Geibel; William,0,0,20,20
1714630541646,CAT 125RS,A01,515971,Geibel; William,0,0,20,20
1714630542678,CLRE 250,A00,511389,Morris; Sheldon,9993,0,9999,6
1714630543705,CLRE 251,A00,507176,Mehta; Ravindra L.,9993,0,9999,6
1714630543705,CLRE 251,B00,511410,Mehta; Ravindra L.,9998,0,9999,1
1714630544730,CLRE 252,A00,507189,Cuomo; Raphael Eduardo,9995,0,9999,4
1714630545756,CLRE 253,A00,507199,Vaida; Florin,9994,0,9999,5
1714630545756,CLRE 253,B00,507202,Vaida; Florin,9999,0,9999,0
1714630546782,CLRE 259,A00,507211,Patel; Hemal,9996,0,9999,3
1714630547810,CLRE 260,A00,507221,Cuomo; Raphael Eduardo,9999,0,9999,0
1714630548838,CLRE 297,001,507242,Cuomo; Raphael Eduardo,9999,0,9999,0
1714630549863,COGS 197,001,638244,Voytek; Bradley Thomas,9998,0,9999,1
1714630550887,CSE 191,A00,516875,Minnes Kemp; Mor Mia,9992,0,9999,7
1714630551912,CSE 197,001,637388,Minnes Kemp; Mor Mia,9998,0,9999,1
1714630552942,CSS 201S,A01,494383,Staff,35,0,35,0
1714630553970,CSS 202S,A01,494387,Staff,35,0,35,0
1714630554995,DSC 197,001,628532,Eldridge; Justin Matthew,9996,0,9999,3
1714630556020,EAP 100,A00,516065,Staff,9797,0,9999,202
1714630557049,ECE 45,A01,507414,Staff,33,0,60,27
1714630559162,ECE 111,A01,507420,Staff,15,0,50,35
1714630560188,ECE 197,001,548057,Sievenpiper; Daniel F.,9993,0,9999,6
1714630561214,EDS 115,A00,507243,Choi; Bailey Miyeon,10,0,28,18
1714630562244,EDS 117,A01,494379,Staff,0,4,30,30
1714630563270,EDS 125,A00,507246,Hopkins; Megan Beth,9,0,30,21
1714630564295,EDS 128A,A01,507264,Fargason; Sharon Gayle,8,0,26,18
1714630565319,EDS 128B,A01,507293,Pappas; Elizabeth,12,0,30,18
1714630566348,EDS 139,A00,507294,Fargason; Sharon Gayle,13,0,30,17
1714630566348,EDS 139,B00,507313,Pappas; Elizabeth,13,0,30,17
1714630567377,EDS 201,A00,507315,Staff,13,0,30,17
1714630568406,EDS 203,A01,507317,Halter; Christopher P.,12,0,30,18
1714630569431,EDS 204R,A01,507319,Halter; Christopher P.,0,3,30,30
1714630569431,EDS 204R,B01,507331,Heinzman; Erica M.,16,0,30,14
1714630570461,EDS 206R,A00,507332,Staff,0,4,30,30
1714630570461,EDS 206R,B00,507343,Staff,17,0,30,13
1714630571491,EDS 250,A00,507344,Hemans; Patricia Ann Benitez,22,0,40,18
1714630572516,EDS 281,A00,507345,Daly; Alan J.,18,0,18,0
1714630573541,EDS 284,A00,507350,Daly; Alan J.,16,0,16,0
1714630574568,EDS 286,A00,507359,Fine; Sarah,18,0,18,0
1714630575836,EDS 289C,A01,507361,Daly; Alan J.,18,0,18,0
1714630576862,EDS 290,A00,507366,Hofstetter; Carolyn,15,0,15,0
1714630577888,LIGM 5A,A00,507421,Fischer-Grunski; Eva K,18,0,20,2
1714630578916,LIGM 5B,A00,507423,Fischer-Grunski; Eva K,19,0,20,1
1714630579941,LIGM 5C,A00,507425,Fischer-Grunski; Eva K,19,0,20,1
1714630580970,LIIT 5AS,A00,507427,Carnelos; Chiara,20,0,20,0
1714630581999,LIIT 5BS,A00,507430,Carnelos; Chiara,20,0,20,0
1714630583029,LIIT 5CS,A00,507432,Carnelos; Chiara,20,0,20,0
1714630584054,LISP 5A,A00,507541,Munoz Sanchez; Alicia,11,0,20,9
1714630585085,LISP 5B,A00,507671,Munoz Sanchez; Alicia,8,0,20,12
1714630586110,LISP 5C,A00,507696,Munoz Sanchez; Alicia,9,0,20,11
1714630587135,MAE 197,001,528363,Boechler; Nicholas Sebastia,9998,0,9999,1
1714630588163,MATH 197,001,523477,Kedlaya; Kiran S.,9995,0,9999,4
1714630588163,MATH 197,002,563811,Zhang; Danna,9995,0,9999,4
1714630588163,MATH 197,003,628552,Dumitriu; Ioana,9998,0,9999,1
1714630589193,MCWP 40R,A00,518780,Staff,2,0,20,18
1714630589193,MCWP 40R,B00,518781,Staff,8,0,20,12
1714630589193,MCWP 40R,C00,518783,Staff,6,0,20,14
1714630590225,MCWP 50R,A00,518791,Staff,0,0,20,20
1714630590225,MCWP 50R,B00,518792,Staff,0,2,20,20
1714630590225,MCWP 50R,C00,518793,Staff,0,2,20,20
1714630590225,MCWP 50R,D00,518794,Staff,0,0,20,20
1714630590225,MCWP 50R,E00,518795,Staff,0,2,20,20
1714630590225,MCWP 50R,F00,518796,Staff,0,0,20,20
1714630590225,MCWP 50R,G00,518797,Staff,0,1,20,20
1714630591251,MMW 12R,A01,514034,Herbst; Matthew,0,0,16,16
1714630591251,MMW 12R,A02,514035,Herbst; Matthew,1,0,16,15
1714630592276,MMW 13R,A01,514037,Staff,0,4,16,16
1714630592276,MMW 13R,A02,514039,Staff,0,2,16,16
1714630592276,MMW 13R,A03,628519,Staff,0,2,16,16
1714630594330,SIO 295LS,A00,523233,Staff,10,0,30,20
1714630595356,SIO 295S,A00,523232,Staff,10,0,30,20
1714630596383,SIOC 290S,A01,637330,Merrifield; Mark A,23,0,30,7
1714630597408,SIOC 291S,A01,637333,Gabriel; Corey John,23,0,30,7
1714630598433,SOCI 117,A01,494376,Staff,0,4,5,5
1714630599463,WES 237B,A00,494380,Staff,9,0,20,11
1714630601531,AESE 279B,A00,494370,Wade; Jon P,0,0,33,33
1714630602557,AIP 197,001,627712,Vespa; Emanuel Ignacio,9998,0,9999,1
1714630603585,ANAR 135S,A00,494369,Braswell; Geoffrey E.,0,0,0,0
1714630604613,BENG 196,001,628496,Engler; Adam J.,9998,0,9999,1
1714630605638,CAT 124RS,A01,519847,Geibel; William,0,0,20,20
1714630606666,CAT 125RS,A01,515971,Geibel; William,0,0,20,20
1714630607694,CLRE 250,A00,511389,Morris; Sheldon,9993,0,9999,6
1714630608725,CLRE 251,A00,507176,Mehta; Ravindra L.,9993,0,9999,6
1714630608725,CLRE 251,B00,511410,Mehta; Ravindra L.,9998,0,9999,1
1714630609752,CLRE 252,A00,507189,Cuomo; Raphael Eduardo,9995,0,9999,4
1714630610777,CLRE 253,A00,507199,Vaida; Florin,9994,0,9999,5
1714630610777,CLRE 253,B00,507202,Vaida; Florin,9999,0,9999,0
1714630611804,CLRE 259,A00,507211,Patel; Hemal,9996,0,9999,3
1714630612829,CLRE 260,A00,507221,Cuomo; Raphael Eduardo,9999,0,9999,0
1714630613854,CLRE 297,001,507242,Cuomo; Raphael Eduardo,9999,0,9999,0
1714630614882,COGS 197,001,638244,Voytek; Bradley Thomas,9998,0,9999,1
1714630615911,CSE 191,A00,516875,Minnes Kemp; Mor Mia,9992,0,9999,7
1714630616939,CSE 197,001,637388,Minnes Kemp; Mor Mia,9998,0,9999,1
1714630617964,CSS 201S,A01,494383,Staff,35,0,35,0
1714630618993,CSS 202S,A01,494387,Staff,35,0,35,0
1714630620028,DSC 197,001,628532,Eldridge; Justin Matthew,9996,0,9999,3
1714630621054,EAP 100,A00,516065,Staff,9797,0,9999,202
1714630622085,ECE 45,A01,507414,Staff,33,0,60,27
1714630624149,ECE 111,A01,507420,Staff,15,0,50,35
1714630625178,ECE 197,001,548057,Sievenpiper; Daniel F.,9993,0,9999,6
1714630626207,EDS 115,A00,507243,Choi; Bailey Miyeon,10,0,28,18
1714630627233,EDS 117,A01,494379,Staff,0,4,30,30
1714630628262,EDS 125,A00,507246,Hopkins; Megan Beth,9,0,30,21
1714630629292,EDS 128A,A01,507264,Fargason; Sharon Gayle,8,0,26,18
1714630630319,EDS 128B,A01,507293,Pappas; Elizabeth,12,0,30,18
1714630631348,EDS 139,A00,507294,Fargason; Sharon Gayle,13,0,30,17
1714630631348,EDS 139,B00,507313,Pappas; Elizabeth,13,0,30,17
1714630632376,EDS 201,A00,507315,Staff,13,0,30,17
1714630633401,EDS 203,A01,507317,Halter; Christopher P.,12,0,30,18
1714630634426,EDS 204R,A01,507319,Halter; Christopher P.,0,3,30,30
1714630634426,EDS 204R,B01,507331,Heinzman; Erica M.,16,0,30,14
1714630635452,EDS 206R,A00,507332,Staff,0,4,30,30
1714630635452,EDS 206R,B00,507343,Staff,17,0,30,13
1714630636477,EDS 250,A00,507344,Hemans; Patricia Ann Benitez,22,0,40,18
1714630637504,EDS 281,A00,507345,Daly; Alan J.,18,0,18,0
1714630638533,EDS 284,A00,507350,Daly; Alan J.,16,0,16,0
1714630639558,EDS 286,A00,507359,Fine; Sarah,18,0,18,0
1714630640584,EDS 289C,A01,507361,Daly; Alan J.,18,0,18,0
1714630641608,EDS 290,A00,507366,Hofstetter; Carolyn,15,0,15,0
1714630642635,LIGM 5A,A00,507421,Fischer-Grunski; Eva K,18,0,20,2
1714630643663,LIGM 5B,A00,507423,Fischer-Grunski; Eva K,19,0,20,1
1714630644688,LIGM 5C,A00,507425,Fischer-Grunski; Eva K,19,0,20,1
1714630645719,LIIT 5AS,A00,507427,Carnelos; Chiara,20,0,20,0
1714630646747,LIIT 5BS,A00,507430,Carnelos; Chiara,20,0,20,0
1714630647774,LIIT 5CS,A00,507432,Carnelos; Chiara,20,0,20,0
1714630648806,LISP 5A,A00,507541,Munoz Sanchez; Alicia,11,0,20,9
1714630649836,LISP 5B,A00,507671,Munoz Sanchez; Alicia,8,0,20,12
1714630650861,LISP 5C,A00,507696,Munoz Sanchez; Alicia,9,0,20,11
1714630651887,MAE 197,001,528363,Boechler; Nicholas Sebastia,9998,0,9999,1
1714630652915,MATH 197,001,523477,Kedlaya; Kiran S.,9995,0,9999,4
1714630652915,MATH 197,002,563811,Zhang; Danna,9995,0,9999,4
1714630652915,MATH 197,003,628552,Dumitriu; Ioana,9998,0,9999,1
1714630653940,MCWP 40R,A00,518780,Staff,2,0,20,18
1714630653940,MCWP 40R,B00,518781,Staff,8,0,20,12
1714630653940,MCWP 40R,C00,518783,Staff,6,0,20,14
1714630654969,MCWP 50R,A00,518791,Staff,0,0,20,20
1714630654969,MCWP 50R,B00,518792,Staff,0,2,20,20
1714630654969,MCWP 50R,C00,518793,Staff,0,2,20,20
1714630654969,MCWP 50R,D00,518794,Staff,0,0,20,20
1714630654969,MCWP 50R,E00,518795,Staff,0,2,20,20
1714630654969,MCWP 50R,F00,518796,Staff,0,0,20,20
1714630654969,MCWP 50R,G00,518797,Staff,0,1,20,20
1714630655995,MMW 12R,A01,514034,Herbst; Matthew,0,0,16,16
1714630655995,MMW 12R,A02,514035,Herbst; Matthew,1,0,16,15
1714630657023,MMW 13R,A01,514037,Staff,0,4,16,16
1714630657023,MMW 13R,A02,514039,Staff,0,2,16,16
1714630657023,MMW 13R,A03,628519,Staff,0,2,16,16
1714630659079,SIO 295LS,A00,523233,Staff,10,0,30,20
1714630660106,SIO 295S,A00,523232,Staff,10,0,30,20
1714630661133,SIOC 290S,A01,637330,Merrifield; Mark A,23,0,30,7
1714630662167,SIOC 291S,A01,637333,Gabriel; Corey John,23,0,30,7
1714630663196,SOCI 117,A01,494376,Staff,0,4,5,5
1714630664221,WES 237B,A00,494380,Staff,9,0,20,11
1714630666289,AESE 279B,A00,494370,Wade; Jon P,0,0,33,33
1714630667314,AIP 197,001,627712,Vespa; Emanuel Ignacio,9998,0,9999,1
1714630668340,ANAR 135S,A00,494369,Braswell; Geoffrey E.,0,0,0,0
1714630669369,BENG 196,001,628496,Engler; Adam J.,9998,0,9999,1
1714630670400,CAT 124RS,A01,519847,Geibel; William,0,0,20,20
1714630671429,CAT 125RS,A01,515971,Geibel; William,0,0,20,20
1714630672458,CLRE 250,A00,511389,Morris; Sheldon,9993,0,9999,6
1714630673492,CLRE 251,A00,507176,Mehta; Ravindra L.,9993,0,9999,6
1714630673492,CLRE 251,B00,511410,Mehta; Ravindra L.,9998,0,9999,1
1714630674522,CLRE 252,A00,507189,Cuomo; Raphael Eduardo,9995,0,9999,4
1714630675548,CLRE 253,A00,507199,Vaida; Florin,9994,0,9999,5
1714630675548,CLRE 253,B00,507202,Vaida; Florin,9999,0,9999,0
1714630676572,CLRE 259,A00,507211,Patel; Hemal,9996,0,9999,3
1714630677599,CLRE 260,A00,507221,Cuomo; Raphael Eduardo,9999,0,9999,0
1714630678624,CLRE 297,001,507242,Cuomo; Raphael Eduardo,9999,0,9999,0
1714630679653,COGS 197,001,638244,Voytek; Bradley Thomas,9998,0,9999,1
1714630680678,CSE 191,A00,516875,Minnes Kemp; Mor Mia,9992,0,9999,7
1714630681703,CSE 197,001,637388,Minnes Kemp; Mor Mia,9998,0,9999,1
1714630682734,CSS 201S,A01,494383,Staff,35,0,35,0
1714630683761,CSS 202S,A01,494387,Staff,35,0,35,0
1714630684792,DSC 197,001,628532,Eldridge; Justin Matthew,9996,0,9999,3
1714630685817,EAP 100,A00,516065,Staff,9797,0,9999,202
1714630686844,ECE 45,A01,507414,Staff,33,0,60,27
1714630688893,ECE 111,A01,507420,Staff,15,0,50,35
1714630689920,ECE 197,001,548057,Sievenpiper; Daniel F.,9993,0,9999,6
1714630690947,EDS 115,A00,507243,Choi; Bailey Miyeon,10,0,28,18
1714630691973,EDS 117,A01,494379,Staff,0,4,30,30
1714630692998,EDS 125,A00,507246,Hopkins; Megan Beth,9,0,30,21
1714630694026,EDS 128A,A01,507264,Fargason; Sharon Gayle,8,0,26,18
1714630695055,EDS 128B,A01,507293,Pappas; Elizabeth,12,0,30,18
1714630696082,EDS 139,A00,507294,Fargason; Sharon Gayle,13,0,30,17
1714630696082,EDS 139,B00,507313,Pappas; Elizabeth,13,0,30,17
1714630697108,EDS 201,A00,507315,Staff,13,0,30,17
1714630698140,EDS 203,A01,507317,Halter; Christopher P.,12,0,30,18
1714630699169,EDS 204R,A01,507319,Halter; Christopher P.,0,3,30,30
1714630699169,EDS 204R,B01,507331,Heinzman; Erica M.,16,0,30,14
1714630700195,EDS 206R,A00,507332,Staff,0,4,30,30
1714630700195,EDS 206R,B00,507343,Staff,17,0,30,13
1714630701221,EDS 250,A00,507344,Hemans; Patricia Ann Benitez,22,0,40,18
1714630702248,EDS 281,A00,507345,Daly; Alan J.,18,0,18,0
1714630703273,EDS 284,A00,507350,Daly; Alan J.,16,0,16,0
1714630704299,EDS 286,A00,507359,Fine; Sarah,18,0,18,0
1714630705324,EDS 289C,A01,507361,Daly; Alan J.,18,0,18,0
1714630706352,EDS 290,A00,507366,Hofstetter; Carolyn,15,0,15,0
1714630707431,LIGM 5A,A00,507421,Fischer-Grunski; Eva K,18,0,20,2
1714630708457,LIGM 5B,A00,507423,Fischer-Grunski; Eva K,19,0,20,1
1714630709482,LIGM 5C,A00,507425,Fischer-Grunski; Eva K,19,0,20,1
1714630710507,LIIT 5AS,A00,507427,Carnelos; Chiara,20,0,20,0
1714630711537,LIIT 5BS,A00,507430,Carnelos; Chiara,20,0,20,0
1714630712567,LIIT 5CS,A00,507432,Carnelos; Chiara,20,0,20,0
1714630713597,LISP 5A,A00,507541,Munoz Sanchez; Alicia,11,0,20,9
1714630714621,LISP 5B,A00,507671,Munoz Sanchez; Alicia,8,0,20,12
1714630715647,LISP 5C,A00,507696,Munoz Sanchez; Alicia,9,0,20,11
1714630716674,MAE 197,001,528363,Boechler; Nicholas Sebastia,9998,0,9999,1
1714630717701,MATH 197,001,523477,Kedlaya; Kiran S.,9995,0,9999,4
1714630717701,MATH 197,002,563811,Zhang; Danna,9995,0,9999,4
1714630717701,MATH 197,003,628552,Dumitriu; Ioana,9998,0,9999,1
1714630718727,MCWP 40R,A00,518780,Staff,2,0,20,18
1714630718727,MCWP 40R,B00,518781,Staff,8,0,20,12
1714630718727,MCWP 40R,C00,518783,Staff,6,0,20,14
1714630719752,MCWP 50R,A00,518791,Staff,0,0,20,20
1714630719752,MCWP 50R,B00,518792,Staff,0,2,20,20
1714630719752,MCWP 50R,C00,518793,Staff,0,2,20,20
1714630719752,MCWP 50R,D00,518794,Staff,0,0,20,20
1714630719752,MCWP 50R,E00,518795,Staff,0,2,20,20
1714630719752,MCWP 50R,F00,518796,Staff,0,0,20,20
1714630719752,MCWP 50R,G00,518797,Staff,0,1,20,20
1714630720776,MMW 12R,A01,514034,Herbst; Matthew,0,0,16,16
1714630720776,MMW 12R,A02,514035,Herbst; Matthew,1,0,16,15
1714630721807,MMW 13R,A01,514037,Staff,0,4,16,16
1714630721807,MMW 13R,A02,514039,Staff,0,2,16,16
1714630721807,MMW 13R,A03,628519,Staff,0,2,16,16
1714630723864,SIO 295LS,A00,523233,Staff,10,0,30,20
1714630724891,SIO 295S,A00,523232,Staff,10,0,30,20
1714630725921,SIOC 290S,A01,637330,Merrifield; Mark A,23,0,30,7
1714630726948,SIOC 291S,A01,637333,Gabriel; Corey John,23,0,30,7
1714630727977,SOCI 117,A01,494376,Staff,0,4,5,5
1714630729000,WES 237B,A00,494380,Staff,9,0,20,11
1714630731087,AESE 279B,A00,494370,Wade; Jon P,0,0,33,33
1714630732112,AIP 197,001,627712,Vespa; Emanuel Ignacio,9998,0,9999,1
1714630733138,ANAR 135S,A00,494369,Braswell; Geoffrey E.,0,0,0,0
1714630734166,BENG 196,001,628496,Engler; Adam J.,9998,0,9999,1
1714630735192,CAT 124RS,A01,519847,Geibel; William,0,0,20,20
1714630736218,CAT 125RS,A01,515971,Geibel; William,0,0,20,20
1714630737244,CLRE 250,A00,511389,Morris; Sheldon,9993,0,9999,6
1714630738271,CLRE 251,A00,507176,Mehta; Ravindra L.,9993,0,9999,6
1714630738271,CLRE 251,B00,511410,Mehta; Ravindra L.,9998,0,9999,1
1714630739298,CLRE 252,A00,507189,Cuomo; Raphael Eduardo,9995,0,9999,4
1714630740324,CLRE 253,A00,507199,Vaida; Florin,9994,0,9999,5
1714630740324,CLRE 253,B00,507202,Vaida; Florin,9999,0,9999,0
1714630741349,CLRE 259,A00,507211,Patel; Hemal,9996,0,9999,3
1714630742378,CLRE 260,A00,507221,Cuomo; Raphael Eduardo,9999,0,9999,0
1714630743403,CLRE 297,001,507242,Cuomo; Raphael Eduardo,9999,0,9999,0
1714630744432,COGS 197,001,638244,Voytek; Bradley Thomas,9998,0,9999,1
1714630745458,CSE 191,A00,516875,Minnes Kemp; Mor Mia,9992,0,9999,7
1714630746483,CSE 197,001,637388,Minnes Kemp; Mor Mia,9998,0,9999,1
1714630747507,CSS 201S,A01,494383,Staff,35,0,35,0
1714630748537,CSS 202S,A01,494387,Staff,35,0,35,0
1714630749563,DSC 197,001,628532,Eldridge; Justin Matthew,9996,0,9999,3
1714630750589,EAP 100,A00,516065,Staff,9797,0,9999,202
1714630751614,ECE 45,A01,507414,Staff,33,0,60,27
1714630753666,ECE 111,A01,507420,Staff,15,0,50,35
1714630754691,ECE 197,001,548057,Sievenpiper; Daniel F.,9993,0,9999,6
1714630755721,EDS 115,A00,507243,Choi; Bailey Miyeon,10,0,28,18
1714630756745,EDS 117,A01,494379,Staff,0,4,30,30
1714630757772,EDS 125,A00,507246,Hopkins; Megan Beth,9,0,30,21
1714630758803,EDS 128A,A01,507264,Fargason; Sharon Gayle,8,0,26,18
1714630759836,EDS 128B,A01,507293,Pappas; Elizabeth,12,0,30,18
1714630760860,EDS 139,A00,507294,Fargason; Sharon Gayle,13,0,30,17
1714630760860,EDS 139,B00,507313,Pappas; Elizabeth,13,0,30,17
1714630761885,EDS 201,A00,507315,Staff,13,0,30,17
1714630762909,EDS 203,A01,507317,Halter; Christopher P.,12,0,30,18
1714630763934,EDS 204R,A01,507319,Halter; Christopher P.,0,3,30,30
1714630763934,EDS 204R,B01,507331,Heinzman; Erica M.,16,0,30,14
1714630764958,EDS 206R,A00,507332,Staff,0,4,30,30
1714630764958,EDS 206R,B00,507343,Staff,17,0,30,13
1714630765982,EDS 250,A00,507344,Hemans; Patricia Ann Benitez,22,0,40,18
1714630767007,EDS 281,A00,507345,Daly; Alan J.,18,0,18,0
1714630768032,EDS 284,A00,507350,Daly; Alan J.,16,0,16,0
1714630769056,EDS 286,A00,507359,Fine; Sarah,18,0,18,0
1714630770081,EDS 289C,A01,507361,Daly; Alan J.,18,0,18,0
1714630771105,EDS 290,A00,507366,Hofstetter; Carolyn,15,0,15,0
1714630772130,LIGM 5A,A00,507421,Fischer-Grunski; Eva K,18,0,20,2
1714630773159,LIGM 5B,A00,507423,Fischer-Grunski; Eva K,19,0,20,1
1714630774183,LIGM 5C,A00,507425,Fischer-Grunski; Eva K,19,0,20,1
1714630775211,LIIT 5AS,A00,507427,Carnelos; Chiara,20,0,20,0
1714630776242,LIIT 5BS,A00,507430,Carnelos; Chiara,20,0,20,0
1714630777268,LIIT 5CS,A00,507432,Carnelos; Chiara,20,0,20,0
1714630778294,LISP 5A,A00,507541,Munoz Sanchez; Alicia,11,0,20,9
1714630779320,LISP 5B,A00,507671,Munoz Sanchez; Alicia,8,0,20,12
1714630780352,LISP 5C,A00,507696,Munoz Sanchez; Alicia,9,0,20,11
1714630781381,MAE 197,001,528363,Boechler; Nicholas Sebastia,9998,0,9999,1
1714630782413,MATH 197,001,523477,Kedlaya; Kiran S.,9995,0,9999,4
1714630782413,MATH 197,002,563811,Zhang; Danna,9995,0,9999,4
1714630782413,MATH 197,003,628552,Dumitriu; Ioana,9998,0,9999,1
1714630783439,MCWP 40R,A00,518780,Staff,2,0,20,18
1714630783439,MCWP 40R,B00,518781,Staff,8,0,20,12
1714630783439,MCWP 40R,C00,518783,Staff,6,0,20,14
1714630784465,MCWP 50R,A00,518791,Staff,0,0,20,20
1714630784465,MCWP 50R,B00,518792,Staff,0,2,20,20
1714630784465,MCWP 50R,C00,518793,Staff,0,2,20,20
1714630784465,MCWP 50R,D00,518794,Staff,0,0,20,20
1714630784465,MCWP 50R,E00,518795,Staff,0,2,20,20
1714630784465,MCWP 50R,F00,518796,Staff,0,0,20,20
1714630784465,MCWP 50R,G00,518797,Staff,0,1,20,20
1714630785495,MMW 12R,A01,514034,Herbst; Matthew,0,0,16,16
1714630785495,MMW 12R,A02,514035,Herbst; Matthew,1,0,16,15
1714630786541,MMW 13R,A01,514037,Staff,0,4,16,16
1714630786541,MMW 13R,A02,514039,Staff,0,2,16,16
1714630786541,MMW 13R,A03,628519,Staff,0,2,16,16
1714630788599,SIO 295LS,A00,523233,Staff,10,0,30,20
1714630789623,SIO 295S,A00,523232,Staff,10,0,30,20
1714630790649,SIOC 290S,A01,637330,Merrifield; Mark A,23,0,30,7
1714630791680,SIOC 291S,A01,637333,Gabriel; Corey John,23,0,30,7
1714630792705,SOCI 117,A01,494376,Staff,0,4,5,5
1714630793731,WES 237B,A00,494380,Staff,9,0,20,11
1714630795813,AESE 279B,A00,494370,Wade; Jon P,0,0,33,33
1714630796837,AIP 197,001,627712,Vespa; Emanuel Ignacio,9998,0,9999,1
1714630797862,ANAR 135S,A00,494369,Braswell; Geoffrey E.,0,0,0,0
1714630798888,BENG 196,001,628496,Engler; Adam J.,9998,0,9999,1
1714630799915,CAT 124RS,A01,519847,Geibel; William,0,0,20,20
1714630800943,CAT 125RS,A01,515971,Geibel; William,0,0,20,20
1714630801968,CLRE 250,A00,511389,Morris; Sheldon,9993,0,9999,6
1714630802998,CLRE 251,A00,507176,Mehta; Ravindra L.,9993,0,9999,6
1714630802998,CLRE 251,B00,511410,Mehta; Ravindra L.,9998,0,9999,1
1714630804024,CLRE 252,A00,507189,Cuomo; Raphael Eduardo,9995,0,9999,4
1714630805055,CLRE 253,A00,507199,Vaida; Florin,9994,0,9999,5
1714630805055,CLRE 253,B00,507202,Vaida; Florin,9999,0,9999,0
1714630806083,CLRE 259,A00,507211,Patel; Hemal,9996,0,9999,3
1714630807112,CLRE 260,A00,507221,Cuomo; Raphael Eduardo,9999,0,9999,0
1714630808137,CLRE 297,001,507242,Cuomo; Raphael Eduardo,9999,0,9999,0
1714630809162,COGS 197,001,638244,Voytek; Bradley Thomas,9998,0,9999,1
1714630810188,CSE 191,A00,516875,Minnes Kemp; Mor Mia,9992,0,9999,7
1714630811215,CSE 197,001,637388,Minnes Kemp; Mor Mia,9998,0,9999,1
1714630812240,CSS 201S,A01,494383,Staff,35,0,35,0
1714630813280,CSS 202S,A01,494387,Staff,35,0,35,0
1714630814307,DSC 197,001,628532,Eldridge; Justin Matthew,9996,0,9999,3
1714630815340,EAP 100,A00,516065,Staff,9797,0,9999,202
1714630816418,ECE 45,A01,507414,Staff,33,0,60,27
1714630818476,ECE 111,A01,507420,Staff,15,0,50,35
1714630819520,ECE 197,001,548057,Sievenpiper; Daniel F.,9993,0,9999,6
1714630820550,EDS 115,A00,507243,Choi; Bailey Miyeon,10,0,28,18
1714630821578,EDS 117,A01,494379,Staff,0,4,30,30
1714630822602,EDS 125,A00,507246,Hopkins; Megan Beth,9,0,30,21
1714630823628,EDS 128A,A01,507264,Fargason; Sharon Gayle,8,0,26,18
1714630824654,EDS 128B,A01,507293,Pappas; Elizabeth,12,0,30,18
1714630825679,EDS 139,A00,507294,Fargason; Sharon Gayle,13,0,30,17
1714630825679,EDS 139,B00,507313,Pappas; Elizabeth,13,0,30,17
1714630826704,EDS 201,A00,507315,Staff,13,0,30,17
1714630827730,EDS 203,A01,507317,Halter; Christopher P.,12,0,30,18
1714630828756,EDS 204R,A01,507319,Halter; Christopher P.,0,3,30,30
1714630828756,EDS 204R,B01,507331,Heinzman; Erica M.,16,0,30,14
1714630829782,EDS 206R,A00,507332,Staff,0,4,30,30
1714630829782,EDS 206R,B00,507343,Staff,17,0,30,13
1714630830808,EDS 250,A00,507344,Hemans; Patricia Ann Benitez,22,0,40,18
1714630831836,EDS 281,A00,507345,Daly; Alan J.,18,0,18,0
1714630832864,EDS 284,A00,507350,Daly; Alan J.,16,0,16,0
1714630833905,EDS 286,A00,507359,Fine; Sarah,18,0,18,0
1714630834934,EDS 289C,A01,507361,Daly; Alan J.,18,0,18,0
1714630835959,EDS 290,A00,507366,Hofstetter; Carolyn,15,0,15,0
1714630836987,LIGM 5A,A00,507421,Fischer-Grunski; Eva K,18,0,20,2
1714630838013,LIGM 5B,A00,507423,Fischer-Grunski; Eva K,19,0,20,1
1714630839039,LIGM 5C,A00,507425,Fischer-Grunski; Eva K,19,0,20,1
1714630840064,LIIT 5AS,A00,507427,Carnelos; Chiara,20,0,20,0
1714630841089,LIIT 5BS,A00,507430,Carnelos; Chiara,20,0,20,0
1714630842116,LIIT 5CS,A00,507432,Carnelos; Chiara,20,0,20,0
1714630843141,LISP 5A,A00,507541,Munoz Sanchez; Alicia,11,0,20,9
1714630844167,LISP 5B,A00,507671,Munoz Sanchez; Alicia,8,0,20,12
1714630845192,LISP 5C,A00,507696,Munoz Sanchez; Alicia,9,0,20,11
1714630846224,MAE 197,001,528363,Boechler; Nicholas Sebastia,9998,0,9999,1
1714630847252,MATH 197,001,523477,Kedlaya; Kiran S.,9995,0,9999,4
1714630847252,MATH 197,002,563811,Zhang; Danna,9995,0,9999,4
1714630847252,MATH 197,003,628552,Dumitriu; Ioana,9998,0,9999,1
1714630848278,MCWP 40R,A00,518780,Staff,2,0,20,18
1714630848278,MCWP 40R,B00,518781,Staff,8,0,20,12
1714630848278,MCWP 40R,C00,518783,Staff,6,0,20,14
1714630849308,MCWP 50R,A00,518791,Staff,0,0,20,20
1714630849308,MCWP 50R,B00,518792,Staff,0,2,20,20
1714630849308,MCWP 50R,C00,518793,Staff,0,2,20,20
1714630849308,MCWP 50R,D00,518794,Staff,0,0,20,20
1714630849308,MCWP 50R,E00,518795,Staff,0,2,20,20
1714630849308,MCWP 50R,F00,518796,Staff,0,0,20,20
1714630849308,MCWP 50R,G00,518797,Staff,0,1,20,20
1714630850333,MMW 12R,A01,514034,Herbst; Matthew,0,0,16,16
1714630850333,MMW 12R,A02,514035,Herbst; Matthew,1,0,16,15
1714630851363,MMW 13R,A01,514037,Staff,0,4,16,16
1714630851363,MMW 13R,A02,514039,Staff,0,2,16,16
1714630851363,MMW 13R,A03,628519,Staff,0,2,16,16
1714630853416,SIO 295LS,A00,523233,Staff,10,0,30,20
1714630854441,SIO 295S,A00,523232,Staff,10,0,30,20
1714630855467,SIOC 290S,A01,637330,Merrifield; Mark A,23,0,30,7
1714630856497,SIOC 291S,A01,637333,Gabriel; Corey John,23,0,30,7
1714630857526,SOCI 117,A01,494376,Staff,0,4,5,5
1714630858556,WES 237B,A00,494380,Staff,9,0,20,11
1714630860618,AESE 279B,A00,494370,Wade; Jon P,0,0,33,33
1714630861644,AIP 197,001,627712,Vespa; Emanuel Ignacio,9998,0,9999,1
1714630862670,ANAR 135S,A00,494369,Braswell; Geoffrey E.,0,0,0,0
1714630863694,BENG 196,001,628496,Engler; Adam J.,9998,0,9999,1
1714630864723,CAT 124RS,A01,519847,Geibel; William,0,0,20,20
1714630865748,CAT 125RS,A01,515971,Geibel; William,0,0,20,20
1714630866776,CLRE 250,A00,511389,Morris; Sheldon,9993,0,9999,6
1714630867803,CLRE 251,A00,507176,Mehta; Ravindra L.,9993,0,9999,6
1714630867803,CLRE 251,B00,511410,Mehta; Ravindra L.,9998,0,9999,1
1714630868829,CLRE 252,A00,507189,Cuomo; Raphael Eduardo,9995,0,9999,4
1714630869855,CLRE 253,A00,507199,Vaida; Florin,9994,0,9999,5
1714630869855,CLRE 253,B00,507202,Vaida; Florin,9999,0,9999,0
1714630870884,CLRE 259,A00,507211,Patel; Hemal,9996,0,9999,3
1714630871912,CLRE 260,A00,507221,Cuomo; Raphael Eduardo,9999,0,9999,0
1714630872960,CLRE 297,001,507242,Cuomo; Raphael Eduardo,9999,0,9999,0
1714630873986,COGS 197,001,638244,Voytek; Bradley Thomas,9998,0,9999,1
1714630875015,CSE 191,A00,516875,Minnes Kemp; Mor Mia,9992,0,9999,7
1714630876044,CSE 197,001,637388,Minnes Kemp; Mor Mia,9998,0,9999,1
1714630877077,CSS 201S,A01,494383,Staff,35,0,35,0
1714630878102,CSS 202S,A01,494387,Staff,35,0,35,0
1714630879132,DSC 197,001,628532,Eldridge; Justin Matthew,9996,0,9999,3
1714630880160,EAP 100,A00,516065,Staff,9797,0,9999,202
1714630881188,ECE 45,A01,507414,Staff,33,0,60,27
1714630883246,ECE 111,A01,507420,Staff,15,0,50,35
1714630884270,ECE 197,001,548057,Sievenpiper; Daniel F.,9993,0,9999,6
1714630885302,EDS 115,A00,507243,Choi; Bailey Miyeon,10,0,28,18
1714630886327,EDS 117,A01,494379,Staff,0,4,30,30
1714630887356,EDS 125,A00,507246,Hopkins; Megan Beth,9,0,30,21
1714630888385,EDS 128A,A01,507264,Fargason; Sharon Gayle,8,0,26,18
1714630889410,EDS 128B,A01,507293,Pappas; Elizabeth,12,0,30,18
1714630890439,EDS 139,A00,507294,Fargason; Sharon Gayle,13,0,30,17
1714630890439,EDS 139,B00,507313,Pappas; Elizabeth,13,0,30,17
1714630891462,EDS 201,A00,507315,Staff,13,0,30,17
1714630892492,EDS 203,A01,507317,Halter; Christopher P.,12,0,30,18
1714630893517,EDS 204R,A01,507319,Halter; Christopher P.,0,3,30,30
1714630893517,EDS 204R,B01,507331,Heinzman; Erica M.,16,0,30,14
1714630894545,EDS 206R,A00,507332,Staff,0,4,30,30
1714630894545,EDS 206R,B00,507343,Staff,17,0,30,13
1714630895576,EDS 250,A00,507344,Hemans; Patricia Ann Benitez,22,0,40,18
1714630896604,EDS 281,A00,507345,Daly; Alan J.,18,0,18,0
1714630897628,EDS 284,A00,507350,Daly; Alan J.,16,0,16,0
1714630898653,EDS 286,A00,507359,Fine; Sarah,18,0,18,0
1714630899678,EDS 289C,A01,507361,Daly; Alan J.,18,0,18,0
1714630900703,EDS 290,A00,507366,Hofstetter; Carolyn,15,0,15,0
1714630901728,LIGM 5A,A00,507421,Fischer-Grunski; Eva K,18,0,20,2
1714630902752,LIGM 5B,A00,507423,Fischer-Grunski; Eva K,19,0,20,1
1714630903777,LIGM 5C,A00,507425,Fischer-Grunski; Eva K,19,0,20,1
1714630904805,LIIT 5AS,A00,507427,Carnelos; Chiara,20,0,20,0
1714630905833,LIIT 5BS,A00,507430,Carnelos; Chiara,20,0,20,0
1714630906862,LIIT 5CS,A00,507432,Carnelos; Chiara,20,0,20,0
1714630907886,LISP 5A,A00,507541,Munoz Sanchez; Alicia,11,0,20,9
1714630908914,LISP 5B,A00,507671,Munoz Sanchez; Alicia,8,0,20,12
1714630909940,LISP 5C,A00,507696,Munoz Sanchez; Alicia,9,0,20,11
1714630910965,MAE 197,001,528363,Boechler; Nicholas Sebastia,9998,0,9999,1
1714630911992,MATH 197,001,523477,Kedlaya; Kiran S.,9995,0,9999,4
1714630911992,MATH 197,002,563811,Zhang; Danna,9995,0,9999,4
1714630911992,MATH 197,003,628552,Dumitriu; Ioana,9998,0,9999,1
1714630913026,MCWP 40R,A00,518780,Staff,2,0,20,18
1714630913026,MCWP 40R,B00,518781,Staff,8,0,20,12
1714630913026,MCWP 40R,C00,518783,Staff,6,0,20,14
1714630914058,MCWP 50R,A00,518791,Staff,0,0,20,20
1714630914058,MCWP 50R,B00,518792,Staff,0,2,20,20
1714630914058,MCWP 50R,C00,518793,Staff,0,2,20,20
1714630914058,MCWP 50R,D00,518794,Staff,0,0,20,20
1714630914058,MCWP 50R,E00,518795,Staff,0,2,20,20
1714630914058,MCWP 50R,F00,518796,Staff,0,0,20,20
1714630914058,MCWP 50R,G00,518797,Staff,0,1,20,20
1714630915084,MMW 12R,A01,514034,Herbst; Matthew,0,0,16,16
1714630915084,MMW 12R,A02,514035,Herbst; Matthew,1,0,16,15
1714630916112,MMW 13R,A01,514037,Staff,0,4,16,16
1714630916112,MMW 13R,A02,514039,Staff,0,2,16,16
1714630916112,MMW 13R,A03,628519,Staff,0,2,16,16
1714630918161,SIO 295LS,A00,523233,Staff,10,0,30,20
1714630919188,SIO 295S,A00,523232,Staff,10,0,30,20
1714630920219,SIOC 290S,A01,637330,Merrifield; Mark A,23,0,30,7
1714630921245,SIOC 291S,A01,637333,Gabriel; Corey John,23,0,30,7
1714630922275,SOCI 117,A01,494376,Staff,0,4,5,5
1714630923301,WES 237B,A00,494380,Staff,9,0,20,11
1714630925371,AESE 279B,A00,494370,Wade; Jon P,0,0,33,33
1714630926396,AIP 197,001,627712,Vespa; Emanuel Ignacio,9998,0,9999,1
1714630927421,ANAR 135S,A00,494369,Braswell; Geoffrey E.,0,0,0,0
1714630928447,BENG 196,001,628496,Engler; Adam J.,9998,0,9999,1
1714630929476,CAT 124RS,A01,519847,Geibel; William,0,0,20,20
1714630930500,CAT 125RS,A01,515971,Geibel; William,0,0,20,20
1714630931530,CLRE 250,A00,511389,Morris; Sheldon,9993,0,9999,6
1714630932557,CLRE 251,A00,507176,Mehta; Ravindra L.,9993,0,9999,6
1714630932557,CLRE 251,B00,511410,Mehta; Ravindra L.,9998,0,9999,1
1714630933582,CLRE 252,A00,507189,Cuomo; Raphael Eduardo,9995,0,9999,4
1714630934608,CLRE 253,A00,507199,Vaida; Florin,9994,0,9999,5
1714630934608,CLRE 253,B00,507202,Vaida; Florin,9999,0,9999,0
1714630935638,CLRE 259,A00,507211,Patel; Hemal,9996,0,9999,3
1714630936662,CLRE 260,A00,507221,Cuomo; Raphael Eduardo,9999,0,9999,0
1714630937690,CLRE 297,001,507242,Cuomo; Raphael Eduardo,9999,0,9999,0
1714630938715,COGS 197,001,638244,Voytek; Bradley Thomas,9998,0,9999,1
1714630939741,CSE 191,A00,516875,Minnes Kemp; Mor Mia,9992,0,9999,7
1714630940768,CSE 197,001,637388,Minnes Kemp; Mor Mia,9998,0,9999,1
1714630941792,CSS 201S,A01,494383,Staff,35,0,35,0
1714630942820,CSS 202S,A01,494387,Staff,35,0,35,0
1714630943845,DSC 197,001,628532,Eldridge; Justin Matthew,9996,0,9999,3
1714630944870,EAP 100,A00,516065,Staff,9797,0,9999,202
1714630945898,ECE 45,A01,507414,Staff,33,0,60,27
1714630947954,ECE 111,A01,507420,Staff,15,0,50,35
1714630948984,ECE 197,001,548057,Sievenpiper; Daniel F.,9993,0,9999,6
1714630950015,EDS 115,A00,507243,Choi; Bailey Miyeon,10,0,28,18
1714630951045,EDS 117,A01,494379,Staff,0,4,30,30
1714630952069,EDS 125,A00,507246,Hopkins; Megan Beth,9,0,30,21
1714630953100,EDS 128A,A01,507264,Fargason; Sharon Gayle,8,0,26,18
1714630954125,EDS 128B,A01,507293,Pappas; Elizabeth,12,0,30,18
1714630955148,EDS 139,A00,507294,Fargason; Sharon Gayle,13,0,30,17
1714630955148,EDS 139,B00,507313,Pappas; Elizabeth,13,0,30,17
1714630956176,EDS 201,A00,507315,Staff,13,0,30,17
1714630957201,EDS 203,A01,507317,Halter; Christopher P.,12,0,30,18
1714630958226,EDS 204R,A01,507319,Halter; Christopher P.,0,3,30,30
1714630958226,EDS 204R,B01,507331,Heinzman; Erica M.,16,0,30,14
1714630959255,EDS 206R,A00,507332,Staff,0,4,30,30
1714630959255,EDS 206R,B00,507343,Staff,17,0,30,13
1714630960280,EDS 250,A00,507344,Hemans; Patricia Ann Benitez,22,0,40,18
1714630961306,EDS 281,A00,507345,Daly; Alan J.,18,0,18,0
1714630962330,EDS 284,A00,507350,Daly; Alan J.,16,0,16,0
1714630963354,EDS 286,A00,507359,Fine; Sarah,18,0,18,0
1714630964384,EDS 289C,A01,507361,Daly; Alan J.,18,0,18,0
1714630965413,EDS 290,A00,507366,Hofstetter; Carolyn,15,0,15,0
1714630966438,LIGM 5A,A00,507421,Fischer-Grunski; Eva K,18,0,20,2
1714630967468,LIGM 5B,A00,507423,Fischer-Grunski; Eva K,19,0,20,1
1714630968493,LIGM 5C,A00,507425,Fischer-Grunski; Eva K,19,0,20,1
1714630969520,LIIT 5AS,A00,507427,Carnelos; Chiara,20,0,20,0
1714630970544,LIIT 5BS,A00,507430,Carnelos; Chiara,20,0,20,0
1714630971574,LIIT 5CS,A00,507432,Carnelos; Chiara,20,0,20,0
1714630972598,LISP 5A,A00,507541,Munoz Sanchez; Alicia,11,0,20,9
1714630973629,LISP 5B,A00,507671,Munoz Sanchez; Alicia,8,0,20,12
1714630974655,LISP 5C,A00,507696,Munoz Sanchez; Alicia,9,0,20,11
1714630975684,MAE 197,001,528363,Boechler; Nicholas Sebastia,9998,0,9999,1
1714630976710,MATH 197,001,523477,Kedlaya; Kiran S.,9995,0,9999,4
1714630976710,MATH 197,002,563811,Zhang; Danna,9995,0,9999,4
1714630976710,MATH 197,003,628552,Dumitriu; Ioana,9998,0,9999,1
1714630977735,MCWP 40R,A00,518780,Staff,2,0,20,18
1714630977735,MCWP 40R,B00,518781,Staff,8,0,20,12
1714630977735,MCWP 40R,C00,518783,Staff,6,0,20,14
1714630978766,MCWP 50R,A00,518791,Staff,0,0,20,20
1714630978766,MCWP 50R,B00,518792,Staff,0,2,20,20
1714630978766,MCWP 50R,C00,518793,Staff,0,2,20,20
1714630978766,MCWP 50R,D00,518794,Staff,0,0,20,20
1714630978766,MCWP 50R,E00,518795,Staff,0,2,20,20
1714630978766,MCWP 50R,F00,518796,Staff,0,0,20,20
1714630978766,MCWP 50R,G00,518797,Staff,0,1,20,20
1714630979792,MMW 12R,A01,514034,Herbst; Matthew,0,0,16,16
1714630979792,MMW 12R,A02,514035,Herbst; Matthew,1,0,16,15
1714630980820,MMW 13R,A01,514037,Staff,0,4,16,16
1714630980820,MMW 13R,A02,514039,Staff,0,2,16,16
1714630980820,MMW 13R,A03,628519,Staff,0,2,16,16
1714630982875,SIO 295LS,A00,523233,Staff,10,0,30,20
1714630983905,SIO 295S,A00,523232,Staff,10,0,30,20
1714630984932,SIOC 290S,A01,637330,Merrifield; Mark A,23,0,30,7
1714630985957,SIOC 291S,A01,637333,Gabriel; Corey John,23,0,30,7
1714630986986,SOCI 117,A01,494376,Staff,0,4,5,5
1714630988011,WES 237B,A00,494380,Staff,9,0,20,11
1714630990093,AESE 279B,A00,494370,Wade; Jon P,0,0,33,33
1714630991121,AIP 197,001,627712,Vespa; Emanuel Ignacio,9998,0,9999,1
1714630992149,ANAR 135S,A00,494369,Braswell; Geoffrey E.,0,0,0,0
1714630993175,BENG 196,001,628496,Engler; Adam J.,9998,0,9999,1
1714630994200,CAT 124RS,A01,519847,Geibel; William,0,0,20,20
1714630995225,CAT 125RS,A01,515971,Geibel; William,0,0,20,20
1714630996250,CLRE 250,A00,511389,Morris; Sheldon,9993,0,9999,6
1714630997277,CLRE 251,A00,507176,Mehta; Ravindra L.,9993,0,9999,6
1714630997277,CLRE 251,B00,511410,Mehta; Ravindra L.,9998,0,9999,1
1714630998302,CLRE 252,A00,507189,Cuomo; Raphael Eduardo,9995,0,9999,4
1714630999326,CLRE 253,A00,507199,Vaida; Florin,9994,0,9999,5
1714630999326,CLRE 253,B00,507202,Vaida; Florin,9999,0,9999,0
1714631000352,CLRE 259,A00,507211,Patel; Hemal,9996,0,9999,3
1714631001376,CLRE 260,A00,507221,Cuomo; Raphael Eduardo,9999,0,9999,0
1714631002401,CLRE 297,001,507242,Cuomo; Raphael Eduardo,9999,0,9999,0
1714631003426,COGS 197,001,638244,Voytek; Bradley Thomas,9998,0,9999,1
1714631004450,CSE 191,A00,516875,Minnes Kemp; Mor Mia,9992,0,9999,7
1714631005493,CSE 197,001,637388,Minnes Kemp; Mor Mia,9998,0,9999,1
1714631006519,CSS 201S,A01,494383,Staff,35,0,35,0
1714631007544,CSS 202S,A01,494387,Staff,35,0,35,0
1714631008570,DSC 197,001,628532,Eldridge; Justin Matthew,9996,0,9999,3
1714631009598,EAP 100,A00,516065,Staff,9797,0,9999,202
1714631010628,ECE 45,A01,507414,Staff,33,0,60,27
1714631012680,ECE 111,A01,507420,Staff,15,0,50,35
1714631013709,ECE 197,001,548057,Sievenpiper; Daniel F.,9993,0,9999,6
1714631014735,EDS 115,A00,507243,Choi; Bailey Miyeon,10,0,28,18
1714631015761,EDS 117,A01,494379,Staff,0,4,30,30
1714631016793,EDS 125,A00,507246,Hopkins; Megan Beth,9,0,30,21
1714631017823,EDS 128A,A01,507264,Fargason; Sharon Gayle,8,0,26,18
1714631018848,EDS 128B,A01,507293,Pappas; Elizabeth,12,0,30,18
1714631019874,EDS 139,A00,507294,Fargason; Sharon Gayle,13,0,30,17
1714631019874,EDS 139,B00,507313,Pappas; Elizabeth,13,0,30,17
1714631020902,EDS 201,A00,507315,Staff,13,0,30,17
1714631021928,EDS 203,A01,507317,Halter; Christopher P.,12,0,30,18
1714631022956,EDS 204R,A01,507319,Halter; Christopher P.,0,3,30,30
1714631022956,EDS 204R,B01,507331,Heinzman; Erica M.,16,0,30,14
1714631023985,EDS 206R,A00,507332,Staff,0,4,30,30
1714631023985,EDS 206R,B00,507343,Staff,17,0,30,13
1714631025012,EDS 250,A00,507344,Hemans; Patricia Ann Benitez,22,0,40,18
1714631026037,EDS 281,A00,507345,Daly; Alan J.,18,0,18,0
1714631027061,EDS 284,A00,507350,Daly; Alan J.,16,0,16,0
1714631028087,EDS 286,A00,507359,Fine; Sarah,18,0,18,0
1714631029116,EDS 289C,A01,507361,Daly; Alan J.,18,0,18,0
1714631030141,EDS 290,A00,507366,Hofstetter; Carolyn,15,0,15,0
1714631031173,LIGM 5A,A00,507421,Fischer-Grunski; Eva K,18,0,20,2
1714631032200,LIGM 5B,A00,507423,Fischer-Grunski; Eva K,19,0,20,1
1714631033225,LIGM 5C,A00,507425,Fischer-Grunski; Eva K,19,0,20,1
1714631034256,LIIT 5AS,A00,507427,Carnelos; Chiara,20,0,20,0
1714631035281,LIIT 5BS,A00,507430,Carnelos; Chiara,20,0,20,0
1714631036310,LIIT 5CS,A00,507432,Carnelos; Chiara,20,0,20,0
1714631037335,LISP 5A,A00,507541,Munoz Sanchez; Alicia,11,0,20,9
1714631038361,LISP 5B,A00,507671,Munoz Sanchez; Alicia,8,0,20,12
1714631039389,LISP 5C,A00,507696,Munoz Sanchez; Alicia,9,0,20,11
1714631040436,MAE 197,001,528363,Boechler; Nicholas Sebastia,9998,0,9999,1
1714631041462,MATH 197,001,523477,Kedlaya; Kiran S.,9995,0,9999,4
1714631041462,MATH 197,002,563811,Zhang; Danna,9995,0,9999,4
1714631041462,MATH 197,003,628552,Dumitriu; Ioana,9998,0,9999,1
1714631042495,MCWP 40R,A00,518780,Staff,2,0,20,18
1714631042495,MCWP 40R,B00,518781,Staff,8,0,20,12
1714631042495,MCWP 40R,C00,518783,Staff,6,0,20,14
1714631043521,MCWP 50R,A00,518791,Staff,0,0,20,20
1714631043521,MCWP 50R,B00,518792,Staff,0,2,20,20
1714631043521,MCWP 50R,C00,518793,Staff,0,2,20,20
1714631043521,MCWP 50R,D00,518794,Staff,0,0,20,20
1714631043521,MCWP 50R,E00,518795,Staff,0,2,20,20
1714631043521,MCWP 50R,F00,518796,Staff,0,0,20,20
1714631043521,MCWP 50R,G00,518797,Staff,0,1,20,20
1714631044553,MMW 12R,A01,514034,Herbst; Matthew,0,0,16,16
1714631044553,MMW 12R,A02,514035,Herbst; Matthew,1,0,16,15
1714631045578,MMW 13R,A01,514037,Staff,0,4,16,16
1714631045578,MMW 13R,A02,514039,Staff,0,2,16,16
1714631045578,MMW 13R,A03,628519,Staff,0,2,16,16
1714631047633,SIO 295LS,A00,523233,Staff,10,0,30,20
1714631048656,SIO 295S,A00,523232,Staff,10,0,30,20
1714631049684,SIOC 290S,A01,637330,Merrifield; Mark A,23,0,30,7
1714631050710,SIOC 291S,A01,637333,Gabriel; Corey John,23,0,30,7
1714631051738,SOCI 117,A01,494376,Staff,0,4,5,5
1714631052764,WES 237B,A00,494380,Staff,9,0,20,11
1714631054840,AESE 279B,A00,494370,Wade; Jon P,0,0,33,33
1714631055866,AIP 197,001,627712,Vespa; Emanuel Ignacio,9998,0,9999,1
1714631056891,ANAR 135S,A00,494369,Braswell; Geoffrey E.,0,0,0,0
1714631057917,BENG 196,001,628496,Engler; Adam J.,9998,0,9999,1
1714631058946,CAT 124RS,A01,519847,Geibel; William,0,0,20,20
1714631059971,CAT 125RS,A01,515971,Geibel; William,0,0,20,20
1714631061000,CLRE 250,A00,511389,Morris; Sheldon,9993,0,9999,6
1714631062028,CLRE 251,A00,507176,Mehta; Ravindra L.,9993,0,9999,6
1714631062028,CLRE 251,B00,511410,Mehta; Ravindra L.,9998,0,9999,1
1714631063052,CLRE 252,A00,507189,Cuomo; Raphael Eduardo,9995,0,9999,4
1714631064078,CLRE 253,A00,507199,Vaida; Florin,9994,0,9999,5
1714631064078,CLRE 253,B00,507202,Vaida; Florin,9999,0,9999,0
1714631065102,CLRE 259,A00,507211,Patel; Hemal,9996,0,9999,3
1714631066130,CLRE 260,A00,507221,Cuomo; Raphael Eduardo,9999,0,9999,0
1714631067156,CLRE 297,001,507242,Cuomo; Raphael Eduardo,9999,0,9999,0
1714631068181,COGS 197,001,638244,Voytek; Bradley Thomas,9998,0,9999,1
1714631069210,CSE 191,A00,516875,Minnes Kemp; Mor Mia,9992,0,9999,7
1714631070237,CSE 197,001,637388,Minnes Kemp; Mor Mia,9998,0,9999,1
1714631071263,CSS 201S,A01,494383,Staff,35,0,35,0
1714631072289,CSS 202S,A01,494387,Staff,35,0,35,0
1714631073319,DSC 197,001,628532,Eldridge; Justin Matthew,9996,0,9999,3
1714631074343,EAP 100,A00,516065,Staff,9797,0,9999,202
1714631075370,ECE 45,A01,507414,Staff,33,0,60,27
1714631077478,ECE 111,A01,507420,Staff,15,0,50,35
1714631078503,ECE 197,001,548057,Sievenpiper; Daniel F.,9993,0,9999,6
1714631079530,EDS 115,A00,507243,Choi; Bailey Miyeon,10,0,28,18
1714631080560,EDS 117,A01,494379,Staff,0,4,30,30
1714631081593,EDS 125,A00,507246,Hopkins; Megan Beth,9,0,30,21
1714631082618,EDS 128A,A01,507264,Fargason; Sharon Gayle,8,0,26,18
1714631083648,EDS 128B,A01,507293,Pappas; Elizabeth,12,0,30,18
1714631084676,EDS 139,A00,507294,Fargason; Sharon Gayle,13,0,30,17
1714631084676,EDS 139,B00,507313,Pappas; Elizabeth,13,0,30,17
1714631085702,EDS 201,A00,507315,Staff,13,0,30,17
1714631086729,EDS 203,A01,507317,Halter; Christopher P.,12,0,30,18
1714631087754,EDS 204R,A01,507319,Halter; Christopher P.,0,3,30,30
1714631087754,EDS 204R,B01,507331,Heinzman; Erica M.,16,0,30,14
1714631088780,EDS 206R,A00,507332,Staff,0,4,30,30
1714631088780,EDS 206R,B00,507343,Staff,17,0,30,13
1714631089808,EDS 250,A00,507344,Hemans; Patricia Ann Benitez,22,0,40,18
1714631090833,EDS 281,A00,507345,Daly; Alan J.,18,0,18,0
1714631091861,EDS 284,A00,507350,Daly; Alan J.,16,0,16,0
1714631092888,EDS 286,A00,507359,Fine; Sarah,18,0,18,0
1714631093912,EDS 289C,A01,507361,Daly; Alan J.,18,0,18,0
1714631094939,EDS 290,A00,507366,Hofstetter; Carolyn,15,0,15,0
1714631095971,LIGM 5A,A00,507421,Fischer-Grunski; Eva K,18,0,20,2
1714631096996,LIGM 5B,A00,507423,Fischer-Grunski; Eva K,19,0,20,1
1714631098024,LIGM 5C,A00,507425,Fischer-Grunski; Eva K,19,0,20,1
1714631099048,LIIT 5AS,A00,507427,Carnelos; Chiara,20,0,20,0
1714631100083,LIIT 5BS,A00,507430,Carnelos; Chiara,20,0,20,0
1714631101112,LIIT 5CS,A00,507432,Carnelos; Chiara,20,0,20,0
1714631102138,LISP 5A,A00,507541,Munoz Sanchez; Alicia,11,0,20,9
1714631103169,LISP 5B,A00,507671,Munoz Sanchez; Alicia,8,0,20,12
1714631104197,LISP 5C,A00,507696,Munoz Sanchez; Alicia,9,0,20,11
1714631105226,MAE 197,001,528363,Boechler; Nicholas Sebastia,9998,0,9999,1
1714631106253,MATH 197,001,523477,Kedlaya; Kiran S.,9995,0,9999,4
1714631106253,MATH 197,002,563811,Zhang; Danna,9995,0,9999,4
1714631106253,MATH 197,003,628552,Dumitriu; Ioana,9998,0,9999,1
1714631107279,MCWP 40R,A00,518780,Staff,2,0,20,18
1714631107279,MCWP 40R,B00,518781,Staff,8,0,20,12
1714631107279,MCWP 40R,C00,518783,Staff,6,0,20,14
1714631108306,MCWP 50R,A00,518791,Staff,0,0,20,20
1714631108306,MCWP 50R,B00,518792,Staff,0,2,20,20
1714631108306,MCWP 50R,C00,518793,Staff,0,2,20,20
1714631108306,MCWP 50R,D00,518794,Staff,0,0,20,20
1714631108306,MCWP 50R,E00,518795,Staff,0,2,20,20
1714631108306,MCWP 50R,F00,518796,Staff,0,0,20,20
1714631108306,MCWP 50R,G00,518797,Staff,0,1,20,20
1714631109333,MMW 12R,A01,514034,Herbst; Matthew,0,0,16,16
1714631109333,MMW 12R,A02,514035,Herbst; Matthew,1,0,16,15
1714631110358,MMW 13R,A01,514037,Staff,0,4,16,16
1714631110358,MMW 13R,A02,514039,Staff,0,2,16,16
1714631110358,MMW 13R,A03,628519,Staff,0,2,16,16
1714631112412,SIO 295LS,A00,523233,Staff,10,0,30,20
1714631113439,SIO 295S,A00,523232,Staff,10,0,30,20
1714631114465,SIOC 290S,A01,637330,Merrifield; Mark A,23,0,30,7
1714631115492,SIOC 291S,A01,637333,Gabriel; Corey John,23,0,30,7
1714631116520,SOCI 117,A01,494376,Staff,0,4,5,5
1714631117549,WES 237B,A00,494380,Staff,9,0,20,11
1714631119630,AESE 279B,A00,494370,Wade; Jon P,0,0,33,33
1714631120656,AIP 197,001,627712,Vespa; Emanuel Ignacio,9998,0,9999,1
1714631121684,ANAR 135S,A00,494369,Braswell; Geoffrey E.,0,0,0,0
1714631122709,BENG 196,001,628496,Engler; Adam J.,9998,0,9999,1
1714631123734,CAT 124RS,A01,519847,Geibel; William,0,0,20,20
1714631124757,CAT 125RS,A01,515971,Geibel; William,0,0,20,20
1714631125783,CLRE 250,A00,511389,Morris; Sheldon,9993,0,9999,6
1714631126809,CLRE 251,A00,507176,Mehta; Ravindra L.,9993,0,9999,6
1714631126809,CLRE 251,B00,511410,Mehta; Ravindra L.,9998,0,9999,1
1714631127834,CLRE 252,A00,507189,Cuomo; Raphael Eduardo,9995,0,9999,4
1714631128864,CLRE 253,A00,507199,Vaida; Florin,9994,0,9999,5
1714631128864,CLRE 253,B00,507202,Vaida; Florin,9999,0,9999,0
1714631129888,CLRE 259,A00,507211,Patel; Hemal,9996,0,9999,3
1714631130913,CLRE 260,A00,507221,Cuomo; Raphael Eduardo,9999,0,9999,0
1714631131941,CLRE 297,001,507242,Cuomo; Raphael Eduardo,9999,0,9999,0
1714631132968,COGS 197,001,638244,Voytek; Bradley Thomas,9998,0,9999,1
1714631133995,CSE 191,A00,516875,Minnes Kemp; Mor Mia,9992,0,9999,7
1714631135020,CSE 197,001,637388,Minnes Kemp; Mor Mia,9998,0,9999,1
1714631136046,CSS 201S,A01,494383,Staff,35,0,35,0
1714631137077,CSS 202S,A01,494387,Staff,35,0,35,0
1714631138106,DSC 197,001,628532,Eldridge; Justin Matthew,9996,0,9999,3
1714631139134,EAP 100,A00,516065,Staff,9797,0,9999,202
1714631140160,ECE 45,A01,507414,Staff,33,0,60,27
1714631142213,ECE 111,A01,507420,Staff,15,0,50,35
1714631143239,ECE 197,001,548057,Sievenpiper; Daniel F.,9993,0,9999,6
1714631144267,EDS 115,A00,507243,Choi; Bailey Miyeon,10,0,28,18
1714631145296,EDS 117,A01,494379,Staff,0,4,30,30
1714631146323,EDS 125,A00,507246,Hopkins; Megan Beth,9,0,30,21
1714631147348,EDS 128A,A01,507264,Fargason; Sharon Gayle,8,0,26,18
1714631148375,EDS 128B,A01,507293,Pappas; Elizabeth,12,0,30,18
1714631149405,EDS 139,A00,507294,Fargason; Sharon Gayle,13,0,30,17
1714631149405,EDS 139,B00,507313,Pappas; Elizabeth,13,0,30,17
1714631150428,EDS 201,A00,507315,Staff,13,0,30,17
1714631151454,EDS 203,A01,507317,Halter; Christopher P.,12,0,30,18
1714631152484,EDS 204R,A01,507319,Halter; Christopher P.,0,3,30,30
1714631152484,EDS 204R,B01,507331,Heinzman; Erica M.,16,0,30,14
1714631153509,EDS 206R,A00,507332,Staff,0,4,30,30
1714631153509,EDS 206R,B00,507343,Staff,17,0,30,13
1714631154534,EDS 250,A00,507344,Hemans; Patricia Ann Benitez,22,0,40,18
1714631155562,EDS 281,A00,507345,Daly; Alan J.,18,0,18,0
1714631156587,EDS 284,A00,507350,Daly; Alan J.,16,0,16,0
1714631157613,EDS 286,A00,507359,Fine; Sarah,18,0,18,0
1714631158640,EDS 289C,A01,507361,Daly; Alan J.,18,0,18,0
1714631159669,EDS 290,A00,507366,Hofstetter; Carolyn,15,0,15,0
1714631160697,LIGM 5A,A00,507421,Fischer-Grunski; Eva K,18,0,20,2
1714631161737,LIGM 5B,A00,507423,Fischer-Grunski; Eva K,19,0,20,1
1714631162762,LIGM 5C,A00,507425,Fischer-Grunski; Eva K,19,0,20,1
1714631163792,LIIT 5AS,A00,507427,Carnelos; Chiara,20,0,20,0
1714631164818,LIIT 5BS,A00,507430,Carnelos; Chiara,20,0,20,0
1714631165844,LIIT 5CS,A00,507432,Carnelos; Chiara,20,0,20,0
1714631166871,LISP 5A,A00,507541,Munoz Sanchez; Alicia,11,0,20,9
1714631167896,LISP 5B,A00,507671,Munoz Sanchez; Alicia,8,0,20,12
1714631168925,LISP 5C,A00,507696,Munoz Sanchez; Alicia,9,0,20,11
1714631169950,MAE 197,001,528363,Boechler; Nicholas Sebastia,9998,0,9999,1
1714631170976,MATH 197,001,523477,Kedlaya; Kiran S.,9995,0,9999,4
1714631170976,MATH 197,002,563811,Zhang; Danna,9995,0,9999,4
1714631170976,MATH 197,003,628552,Dumitriu; Ioana,9998,0,9999,1
1714631172001,MCWP 40R,A00,518780,Staff,2,0,20,18
1714631172001,MCWP 40R,B00,518781,Staff,8,0,20,12
1714631172001,MCWP 40R,C00,518783,Staff,6,0,20,14
1714631173029,MCWP 50R,A00,518791,Staff,0,0,20,20
1714631173029,MCWP 50R,B00,518792,Staff,0,2,20,20
1714631173029,MCWP 50R,C00,518793,Staff,0,2,20,20
1714631173029,MCWP 50R,D00,518794,Staff,0,0,20,20
1714631173029,MCWP 50R,E00,518795,Staff,0,2,20,20
1714631173029,MCWP 50R,F00,518796,Staff,0,0,20,20
1714631173029,MCWP 50R,G00,518797,Staff,0,1,20,20
1714631174054,MMW 12R,A01,514034,Herbst; Matthew,0,0,16,16
1714631174054,MMW 12R,A02,514035,Herbst; Matthew,1,0,16,15
1714631175079,MMW 13R,A01,514037,Staff,0,4,16,16
1714631175079,MMW 13R,A02,514039,Staff,0,2,16,16
1714631175079,MMW 13R,A03,628519,Staff,0,2,16,16
1714631177126,SIO 295LS,A00,523233,Staff,10,0,30,20
1714631178152,SIO 295S,A00,523232,Staff,10,0,30,20
1714631179179,SIOC 290S,A01,637330,Merrifield; Mark A,23,0,30,7
1714631180258,SIOC 291S,A01,637333,Gabriel; Corey John,23,0,30,7
1714631181284,SOCI 117,A01,494376,Staff,0,4,5,5
1714631182310,WES 237B,A00,494380,Staff,9,0,20,11
1714631184386,AESE 279B,A00,494370,Wade; Jon P,0,0,33,33
1714631185413,AIP 197,001,627712,Vespa; Emanuel Ignacio,9998,0,9999,1
1714631186443,ANAR 135S,A00,494369,Braswell; Geoffrey E.,0,0,0,0
1714631187472,BENG 196,001,628496,Engler; Adam J.,9998,0,9999,1
1714631188500,CAT 124RS,A01,519847,Geibel; William,0,0,20,20
1714631189525,CAT 125RS,A01,515971,Geibel; William,0,0,20,20
1714631190550,CLRE 250,A00,511389,Morris; Sheldon,9993,0,9999,6
1714631191578,CLRE 251,A00,507176,Mehta; Ravindra L.,9993,0,9999,6
1714631191578,CLRE 251,B00,511410,Mehta; Ravindra L.,9998,0,9999,1
1714631192603,CLRE 252,A00,507189,Cuomo; Raphael Eduardo,9995,0,9999,4
1714631193629,CLRE 253,A00,507199,Vaida; Florin,9994,0,9999,5
1714631193629,CLRE 253,B00,507202,Vaida; Florin,9999,0,9999,0
1714631194656,CLRE 259,A00,507211,Patel; Hemal,9996,0,9999,3
1714631195684,CLRE 260,A00,507221,Cuomo; Raphael Eduardo,9999,0,9999,0
1714631196710,CLRE 297,001,507242,Cuomo; Raphael Eduardo,9999,0,9999,0
1714631197739,COGS 197,001,638244,Voytek; Bradley Thomas,9998,0,9999,1
1714631198765,CSE 191,A00,516875,Minnes Kemp; Mor Mia,9992,0,9999,7
1714631199790,CSE 197,001,637388,Minnes Kemp; Mor Mia,9998,0,9999,1
1714631200820,CSS 201S,A01,494383,Staff,35,0,35,0
1714631201849,CSS 202S,A01,494387,Staff,35,0,35,0
1714631202876,DSC 197,001,628532,Eldridge; Justin Matthew,9996,0,9999,3
1714631203901,EAP 100,A00,516065,Staff,9797,0,9999,202
1714631204927,ECE 45,A01,507414,Staff,33,0,60,27
1714631206977,ECE 111,A01,507420,Staff,15,0,50,35
1714631208001,ECE 197,001,548057,Sievenpiper; Daniel F.,9993,0,9999,6
1714631209036,EDS 115,A00,507243,Choi; Bailey Miyeon,10,0,28,18
1714631210061,EDS 117,A01,494379,Staff,0,4,30,30
1714631211085,EDS 125,A00,507246,Hopkins; Megan Beth,9,0,30,21
1714631212114,EDS 128A,A01,507264,Fargason; Sharon Gayle,8,0,26,18
1714631213144,EDS 128B,A01,507293,Pappas; Elizabeth,12,0,30,18
1714631214170,EDS 139,A00,507294,Fargason; Sharon Gayle,13,0,30,17
1714631214170,EDS 139,B00,507313,Pappas; Elizabeth,13,0,30,17
1714631215195,EDS 201,A00,507315,Staff,13,0,30,17
1714631216221,EDS 203,A01,507317,Halter; Christopher P.,12,0,30,18
1714631217248,EDS 204R,A01,507319,Halter; Christopher P.,0,3,30,30
1714631217248,EDS 204R,B01,507331,Heinzman; Erica M.,16,0,30,14
1714631218272,EDS 206R,A00,507332,Staff,0,4,30,30
1714631218272,EDS 206R,B00,507343,Staff,17,0,30,13
1714631219300,EDS 250,A00,507344,Hemans; Patricia Ann Benitez,22,0,40,18
1714631220327,EDS 281,A00,507345,Daly; Alan J.,18,0,18,0
1714631221354,EDS 284,A00,507350,Daly; Alan J.,16,0,16,0
1714631222380,EDS 286,A00,507359,Fine; Sarah,18,0,18,0
1714631223404,EDS 289C,A01,507361,Daly; Alan J.,18,0,18,0
1714631224435,EDS 290,A00,507366,Hofstetter; Carolyn,15,0,15,0
1714631225467,LIGM 5A,A00,507421,Fischer-Grunski; Eva K,18,0,20,2
1714631226493,LIGM 5B,A00,507423,Fischer-Grunski; Eva K,19,0,20,1
1714631227524,LIGM 5C,A00,507425,Fischer-Grunski; Eva K,19,0,20,1
1714631228549,LIIT 5AS,A00,507427,Carnelos; Chiara,20,0,20,0
1714631229576,LIIT 5BS,A00,507430,Carnelos; Chiara,20,0,20,0
1714631230599,LIIT 5CS,A00,507432,Carnelos; Chiara,20,0,20,0
1714631231630,LISP 5A,A00,507541,Munoz Sanchez; Alicia,11,0,20,9
1714631232655,LISP 5B,A00,507671,Munoz Sanchez; Alicia,8,0,20,12
1714631233684,LISP 5C,A00,507696,Munoz Sanchez; Alicia,9,0,20,11
1714631234709,MAE 197,001,528363,Boechler; Nicholas Sebastia,9998,0,9999,1
1714631235742,MATH 197,001,523477,Kedlaya; Kiran S.,9995,0,9999,4
1714631235742,MATH 197,002,563811,Zhang; Danna,9995,0,9999,4
1714631235742,MATH 197,003,628552,Dumitriu; Ioana,9998,0,9999,1
1714631236770,MCWP 40R,A00,518780,Staff,2,0,20,18
1714631236770,MCWP 40R,B00,518781,Staff,8,0,20,12
1714631236770,MCWP 40R,C00,518783,Staff,6,0,20,14
1714631237796,MCWP 50R,A00,518791,Staff,0,0,20,20
1714631237796,MCWP 50R,B00,518792,Staff,0,2,20,20
1714631237796,MCWP 50R,C00,518793,Staff,0,2,20,20
1714631237796,MCWP 50R,D00,518794,Staff,0,0,20,20
1714631237796,MCWP 50R,E00,518795,Staff,0,2,20,20
1714631237796,MCWP 50R,F00,518796,Staff,0,0,20,20
1714631237796,MCWP 50R,G00,518797,Staff,0,1,20,20
1714631238825,MMW 12R,A01,514034,Herbst; Matthew,0,0,16,16
1714631238825,MMW 12R,A02,514035,Herbst; Matthew,1,0,16,15
1714631239852,MMW 13R,A01,514037,Staff,0,4,16,16
1714631239852,MMW 13R,A02,514039,Staff,0,2,16,16
1714631239852,MMW 13R,A03,628519,Staff,0,2,16,16
1714631241907,SIO 295LS,A00,523233,Staff,10,0,30,20
1714631242937,SIO 295S,A00,523232,Staff,10,0,30,20
1714631243968,SIOC 290S,A01,637330,Merrifield; Mark A,23,0,30,7
1714631244998,SIOC 291S,A01,637333,Gabriel; Corey John,23,0,30,7
1714631246024,SOCI 117,A01,494376,Staff,0,4,5,5
1714631247051,WES 237B,A00,494380,Staff,9,0,20,11
1714631249122,AESE 279B,A00,494370,Wade; Jon P,0,0,33,33
1714631250147,AIP 197,001,627712,Vespa; Emanuel Ignacio,9998,0,9999,1
1714631251174,ANAR 135S,A00,494369,Braswell; Geoffrey E.,0,0,0,0
1714631252199,BENG 196,001,628496,Engler; Adam J.,9998,0,9999,1
1714631253225,CAT 124RS,A01,519847,Geibel; William,0,0,20,20
1714631254254,CAT 125RS,A01,515971,Geibel; William,0,0,20,20
1714631255280,CLRE 250,A00,511389,Morris; Sheldon,9993,0,9999,6
1714631256318,CLRE 251,A00,507176,Mehta; Ravindra L.,9993,0,9999,6
1714631256318,CLRE 251,B00,511410,Mehta; Ravindra L.,9998,0,9999,1
1714631257352,CLRE 252,A00,507189,Cuomo; Raphael Eduardo,9995,0,9999,4
1714631258383,CLRE 253,A00,507199,Vaida; Florin,9994,0,9999,5
1714631258383,CLRE 253,B00,507202,Vaida; Florin,9999,0,9999,0
1714631259407,CLRE 259,A00,507211,Patel; Hemal,9996,0,9999,3
1714631260437,CLRE 260,A00,507221,Cuomo; Raphael Eduardo,9999,0,9999,0
1714631261465,CLRE 297,001,507242,Cuomo; Raphael Eduardo,9999,0,9999,0
1714631262491,COGS 197,001,638244,Voytek; Bradley Thomas,9998,0,9999,1
1714631263515,CSE 191,A00,516875,Minnes Kemp; Mor Mia,9992,0,9999,7
1714631264539,CSE 197,001,637388,Minnes Kemp; Mor Mia,9998,0,9999,1
1714631265567,CSS 201S,A01,494383,Staff,35,0,35,0
1714631266591,CSS 202S,A01,494387,Staff,35,0,35,0
1714631267621,DSC 197,001,628532,Eldridge; Justin Matthew,9996,0,9999,3
1714631268649,EAP 100,A00,516065,Staff,9797,0,9999,202
1714631269675,ECE 45,A01,507414,Staff,33,0,60,27
1714631271728,ECE 111,A01,507420,Staff,15,0,50,35
1714631272757,ECE 197,001,548057,Sievenpiper; Daniel F.,9993,0,9999,6
1714631273782,EDS 115,A00,507243,Choi; Bailey Miyeon,10,0,28,18
1714631274808,EDS 117,A01,494379,Staff,0,4,30,30
1714631275833,EDS 125,A00,507246,Hopkins; Megan Beth,9,0,30,21
1714631276860,EDS 128A,A01,507264,Fargason; Sharon Gayle,8,0,26,18
1714631277889,EDS 128B,A01,507293,Pappas; Elizabeth,12,0,30,18
1714631278918,EDS 139,A00,507294,Fargason; Sharon Gayle,13,0,30,17
1714631278918,EDS 139,B00,507313,Pappas; Elizabeth,13,0,30,17
1714631279947,EDS 201,A00,507315,Staff,13,0,30,17
1714631280972,EDS 203,A01,507317,Halter; Christopher P.,12,0,30,18
1714631282000,EDS 204R,A01,507319,Halter; Christopher P.,0,3,30,30
1714631282000,EDS 204R,B01,507331,Heinzman; Erica M.,16,0,30,14
1714631283028,EDS 206R,A00,507332,Staff,0,4,30,30
1714631283028,EDS 206R,B00,507343,Staff,17,0,30,13
1714631284108,EDS 250,A00,507344,Hemans; Patricia Ann Benitez,22,0,40,18
1714631285133,EDS 281,A00,507345,Daly; Alan J.,18,0,18,0
1714631286156,EDS 284,A00,507350,Daly; Alan J.,16,0,16,0
1714631287181,EDS 286,A00,507359,Fine; Sarah,18,0,18,0
1714631288207,EDS 289C,A01,507361,Daly; Alan J.,18,0,18,0
1714631289232,EDS 290,A00,507366,Hofstetter; Carolyn,15,0,15,0
1714631290260,LIGM 5A,A00,507421,Fischer-Grunski; Eva K,18,0,20,2
1714631291288,LIGM 5B,A00,507423,Fischer-Grunski; Eva K,19,0,20,1
1714631292315,LIGM 5C,A00,507425,Fischer-Grunski; Eva K,19,0,20,1
1714631293343,LIIT 5AS,A00,507427,Carnelos; Chiara,20,0,20,0
1714631294368,LIIT 5BS,A00,507430,Carnelos; Chiara,20,0,20,0
1714631295398,LIIT 5CS,A00,507432,Carnelos; Chiara,20,0,20,0
1714631296424,LISP 5A,A00,507541,Munoz Sanchez; Alicia,11,0,20,9
1714631297449,LISP 5B,A00,507671,Munoz Sanchez; Alicia,8,0,20,12
1714631298474,LISP 5C,A00,507696,Munoz Sanchez; Alicia,9,0,20,11
1714631299500,MAE 197,001,528363,Boechler; Nicholas Sebastia,9998,0,9999,1
1714631300533,MATH 197,001,523477,Kedlaya; Kiran S.,9995,0,9999,4
1714631300533,MATH 197,002,563811,Zhang; Danna,9995,0,9999,4
1714631300533,MATH 197,003,628552,Dumitriu; Ioana,9998,0,9999,1
1714631301559,MCWP 40R,A00,518780,Staff,2,0,20,18
1714631301559,MCWP 40R,B00,518781,Staff,8,0,20,12
1714631301559,MCWP 40R,C00,518783,Staff,6,0,20,14
1714631302582,MCWP 50R,A00,518791,Staff,0,0,20,20
1714631302582,MCWP 50R,B00,518792,Staff,0,2,20,20
1714631302582,MCWP 50R,C00,518793,Staff,0,2,20,20
1714631302582,MCWP 50R,D00,518794,Staff,0,0,20,20
1714631302582,MCWP 50R,E00,518795,Staff,0,2,20,20
1714631302582,MCWP 50R,F00,518796,Staff,0,0,20,20
1714631302582,MCWP 50R,G00,518797,Staff,0,1,20,20
1714631303609,MMW 12R,A01,514034,Herbst; Matthew,0,0,16,16
1714631303609,MMW 12R,A02,514035,Herbst; Matthew,1,0,16,15
1714631304637,MMW 13R,A01,514037,Staff,0,4,16,16
1714631304637,MMW 13R,A02,514039,Staff,0,2,16,16
1714631304637,MMW 13R,A03,628519,Staff,0,2,16,16
1714631306687,SIO 295LS,A00,523233,Staff,10,0,30,20
1714631307713,SIO 295S,A00,523232,Staff,10,0,30,20
1714631308745,SIOC 290S,A01,637330,Merrifield; Mark A,23,0,30,7
1714631309773,SIOC 291S,A01,637333,Gabriel; Corey John,23,0,30,7
1714631310808,SOCI 117,A01,494376,Staff,0,4,5,5
1714631311837,WES 237B,A00,494380,Staff,9,0,20,11
1714631313912,AESE 279B,A00,494370,Wade; Jon P,0,0,33,33
1714631314938,AIP 197,001,627712,Vespa; Emanuel Ignacio,9998,0,9999,1
1714631315967,ANAR 135S,A00,494369,Braswell; Geoffrey E.,0,0,0,0
1714631316996,BENG 196,001,628496,Engler; Adam J.,9998,0,9999,1
1714631318023,CAT 124RS,A01,519847,Geibel; William,0,0,20,20
1714631319050,CAT 125RS,A01,515971,Geibel; William,0,0,20,20
1714631320074,CLRE 250,A00,511389,Morris; Sheldon,9993,0,9999,6
1714631321105,CLRE 251,A00,507176,Mehta; Ravindra L.,9993,0,9999,6
1714631321105,CLRE 251,B00,511410,Mehta; Ravindra L.,9998,0,9999,1
1714631322134,CLRE 252,A00,507189,Cuomo; Raphael Eduardo,9995,0,9999,4
1714631323161,CLRE 253,A00,507199,Vaida; Florin,9994,0,9999,5
1714631323161,CLRE 253,B00,507202,Vaida; Florin,9999,0,9999,0
1714631324186,CLRE 259,A00,507211,Patel; Hemal,9996,0,9999,3
1714631325215,CLRE 260,A00,507221,Cuomo; Raphael Eduardo,9999,0,9999,0
1714631326241,CLRE 297,001,507242,Cuomo; Raphael Eduardo,9999,0,9999,0
1714631327266,COGS 197,001,638244,Voytek; Bradley Thomas,9998,0,9999,1
1714631328295,CSE 191,A00,516875,Minnes Kemp; Mor Mia,9992,0,9999,7
1714631329320,CSE 197,001,637388,Minnes Kemp; Mor Mia,9998,0,9999,1
1714631330347,CSS 201S,A01,494383,Staff,35,0,35,0
1714631331376,CSS 202S,A01,494387,Staff,35,0,35,0
1714631332406,DSC 197,001,628532,Eldridge; Justin Matthew,9996,0,9999,3
1714631333432,EAP 100,A00,516065,Staff,9797,0,9999,202
1714631334461,ECE 45,A01,507414,Staff,33,0,60,27
1714631336513,ECE 111,A01,507420,Staff,15,0,50,35
1714631337544,ECE 197,001,548057,Sievenpiper; Daniel F.,9993,0,9999,6
1714631338569,EDS 115,A00,507243,Choi; Bailey Miyeon,10,0,28,18
1714631339743,EDS 117,A01,494379,Staff,0,4,30,30
1714631340775,EDS 125,A00,507246,Hopkins; Megan Beth,9,0,30,21
1714631341809,EDS 128A,A01,507264,Fargason; Sharon Gayle,8,0,26,18
1714631342840,EDS 128B,A01,507293,Pappas; Elizabeth,12,0,30,18
1714631343872,EDS 139,A00,507294,Fargason; Sharon Gayle,13,0,30,17
1714631343872,EDS 139,B00,507313,Pappas; Elizabeth,13,0,30,17
1714631344900,EDS 201,A00,507315,Staff,13,0,30,17
1714631345926,EDS 203,A01,507317,Halter; Christopher P.,12,0,30,18
1714631346953,EDS 204R,A01,507319,Halter; Christopher P.,0,3,30,30
1714631346953,EDS 204R,B01,507331,Heinzman; Erica M.,16,0,30,14
1714631347979,EDS 206R,A00,507332,Staff,0,4,30,30
1714631347979,EDS 206R,B00,507343,Staff,17,0,30,13
1714631349005,EDS 250,A00,507344,Hemans; Patricia Ann Benitez,22,0,40,18
1714631350030,EDS 281,A00,507345,Daly; Alan J.,18,0,18,0
1714631351057,EDS 284,A00,507350,Daly; Alan J.,16,0,16,0
1714631352086,EDS 286,A00,507359,Fine; Sarah,18,0,18,0
1714631353113,EDS 289C,A01,507361,Daly; Alan J.,18,0,18,0
1714631354136,EDS 290,A00,507366,Hofstetter; Carolyn,15,0,15,0
1714631355163,LIGM 5A,A00,507421,Fischer-Grunski; Eva K,18,0,20,2
1714631356193,LIGM 5B,A00,507423,Fischer-Grunski; Eva K,19,0,20,1
1714631357223,LIGM 5C,A00,507425,Fischer-Grunski; Eva K,19,0,20,1
1714631358249,LIIT 5AS,A00,507427,Carnelos; Chiara,20,0,20,0
1714631359280,LIIT 5BS,A00,507430,Carnelos; Chiara,20,0,20,0
1714631360306,LIIT 5CS,A00,507432,Carnelos; Chiara,20,0,20,0
1714631361332,LISP 5A,A00,507541,Munoz Sanchez; Alicia,11,0,20,9
1714631362363,LISP 5B,A00,507671,Munoz Sanchez; Alicia,8,0,20,12
1714631363388,LISP 5C,A00,507696,Munoz Sanchez; Alicia,9,0,20,11
1714631364414,MAE 197,001,528363,Boechler; Nicholas Sebastia,9998,0,9999,1
1714631365444,MATH 197,001,523477,Kedlaya; Kiran S.,9995,0,9999,4
1714631365444,MATH 197,002,563811,Zhang; Danna,9995,0,9999,4
1714631365444,MATH 197,003,628552,Dumitriu; Ioana,9998,0,9999,1
1714631366469,MCWP 40R,A00,518780,Staff,2,0,20,18
1714631366469,MCWP 40R,B00,518781,Staff,8,0,20,12
1714631366469,MCWP 40R,C00,518783,Staff,6,0,20,14
1714631367494,MCWP 50R,A00,518791,Staff,0,0,20,20
1714631367494,MCWP 50R,B00,518792,Staff,0,2,20,20
1714631367494,MCWP 50R,C00,518793,Staff,0,2,20,20
1714631367494,MCWP 50R,D00,518794,Staff,0,0,20,20
1714631367494,MCWP 50R,E00,518795,Staff,0,2,20,20
1714631367494,MCWP 50R,F00,518796,Staff,0,0,20,20
1714631367494,MCWP 50R,G00,518797,Staff,0,1,20,20
1714631368519,MMW 12R,A01,514034,Herbst; Matthew,0,0,16,16
1714631368519,MMW 12R,A02,514035,Herbst; Matthew,1,0,16,15
1714631369548,MMW 13R,A01,514037,Staff,0,4,16,16
1714631369548,MMW 13R,A02,514039,Staff,0,2,16,16
1714631369548,MMW 13R,A03,628519,Staff,0,2,16,16
1714631371601,SIO 295LS,A00,523233,Staff,10,0,30,20
1714631372627,SIO 295S,A00,523232,Staff,10,0,30,20
1714631373652,SIOC 290S,A01,637330,Merrifield; Mark A,23,0,30,7
1714631374678,SIOC 291S,A01,637333,Gabriel; Corey John,23,0,30,7
1714631375706,SOCI 117,A01,494376,Staff,0,4,5,5
1714631376733,WES 237B,A00,494380,Staff,9,0,20,11
1714631378821,AESE 279B,A00,494370,Wade; Jon P,0,0,33,33
1714631379854,AIP 197,001,627712,Vespa; Emanuel Ignacio,9998,0,9999,1
1714631380880,ANAR 135S,A00,494369,Braswell; Geoffrey E.,0,0,0,0
1714631381908,BENG 196,001,628496,Engler; Adam J.,9998,0,9999,1
1714631382932,CAT 124RS,A01,519847,Geibel; William,0,0,20,20
1714631383961,CAT 125RS,A01,515971,Geibel; William,0,0,20,20
1714631384993,CLRE 250,A00,511389,Morris; Sheldon,9993,0,9999,6
1714631386025,CLRE 251,A00,507176,Mehta; Ravindra L.,9993,0,9999,6
1714631386025,CLRE 251,B00,511410,Mehta; Ravindra L.,9998,0,9999,1
1714631387051,CLRE 252,A00,507189,Cuomo; Raphael Eduardo,9995,0,9999,4
1714631388136,CLRE 253,A00,507199,Vaida; Florin,9994,0,9999,5
1714631388136,CLRE 253,B00,507202,Vaida; Florin,9999,0,9999,0
1714631389160,CLRE 259,A00,507211,Patel; Hemal,9996,0,9999,3
1714631390189,CLRE 260,A00,507221,Cuomo; Raphael Eduardo,9999,0,9999,0
1714631391214,CLRE 297,001,507242,Cuomo; Raphael Eduardo,9999,0,9999,0
1714631392240,COGS 197,001,638244,Voytek; Bradley Thomas,9998,0,9999,1
1714631393265,CSE 191,A00,516875,Minnes Kemp; Mor Mia,9992,0,9999,7
1714631394290,CSE 197,001,637388,Minnes Kemp; Mor Mia,9998,0,9999,1
1714631395319,CSS 201S,A01,494383,Staff,35,0,35,0
1714631396345,CSS 202S,A01,494387,Staff,35,0,35,0
1714631397374,DSC 197,001,628532,Eldridge; Justin Matthew,9996,0,9999,3
1714631398401,EAP 100,A00,516065,Staff,9797,0,9999,202
1714631399431,ECE 45,A01,507414,Staff,33,0,60,27
1714631401483,ECE 111,A01,507420,Staff,15,0,50,35
1714631402508,ECE 197,001,548057,Sievenpiper; Daniel F.,9993,0,9999,6
1714631403538,EDS 115,A00,507243,Choi; Bailey Miyeon,10,0,28,18
1714631404564,EDS 117,A01,494379,Staff,0,4,30,30
1714631405589,EDS 125,A00,507246,Hopkins; Megan Beth,9,0,30,21
1714631406618,EDS 128A,A01,507264,Fargason; Sharon Gayle,8,0,26,18
1714631407646,EDS 128B,A01,507293,Pappas; Elizabeth,12,0,30,18
1714631408671,EDS 139,A00,507294,Fargason; Sharon Gayle,13,0,30,17
1714631408671,EDS 139,B00,507313,Pappas; Elizabeth,13,0,30,17
1714631409697,EDS 201,A00,507315,Staff,13,0,30,17
1714631410723,EDS 203,A01,507317,Halter; Christopher P.,12,0,30,18
1714631411749,EDS 204R,A01,507319,Halter; Christopher P.,0,3,30,30
1714631411749,EDS 204R,B01,507331,Heinzman; Erica M.,16,0,30,14
1714631412777,EDS 206R,A00,507332,Staff,0,4,30,30
1714631412777,EDS 206R,B00,507343,Staff,17,0,30,13
1714631413806,EDS 250,A00,507344,Hemans; Patricia Ann Benitez,22,0,40,18
1714631414832,EDS 281,A00,507345,Daly; Alan J.,18,0,18,0
1714631415856,EDS 284,A00,507350,Daly; Alan J.,16,0,16,0
1714631416885,EDS 286,A00,507359,Fine; Sarah,18,0,18,0
1714631417909,EDS 289C,A01,507361,Daly; Alan J.,18,0,18,0
1714631418935,EDS 290,A00,507366,Hofstetter; Carolyn,15,0,15,0
1714631419962,LIGM 5A,A00,507421,Fischer-Grunski; Eva K,18,0,20,2
1714631420988,LIGM 5B,A00,507423,Fischer-Grunski; Eva K,19,0,20,1
1714631422013,LIGM 5C,A00,507425,Fischer-Grunski; Eva K,19,0,20,1
1714631423039,LIIT 5AS,A00,507427,Carnelos; Chiara,20,0,20,0
1714631424064,LIIT 5BS,A00,507430,Carnelos; Chiara,20,0,20,0
1714631425096,LIIT 5CS,A00,507432,Carnelos; Chiara,20,0,20,0
1714631426126,LISP 5A,A00,507541,Munoz Sanchez; Alicia,11,0,20,9
1714631427155,LISP 5B,A00,507671,Munoz Sanchez; Alicia,8,0,20,12
1714631428183,LISP 5C,A00,507696,Munoz Sanchez; Alicia,9,0,20,11
1714631429209,MAE 197,001,528363,Boechler; Nicholas Sebastia,9998,0,9999,1
1714631430236,MATH 197,001,523477,Kedlaya; Kiran S.,9995,0,9999,4
1714631430236,MATH 197,002,563811,Zhang; Danna,9995,0,9999,4
1714631430236,MATH 197,003,628552,Dumitriu; Ioana,9998,0,9999,1
1714631431266,MCWP 40R,A00,518780,Staff,2,0,20,18
1714631431266,MCWP 40R,B00,518781,Staff,8,0,20,12
1714631431266,MCWP 40R,C00,518783,Staff,6,0,20,14
1714631432293,MCWP 50R,A00,518791,Staff,0,0,20,20
1714631432293,MCWP 50R,B00,518792,Staff,0,2,20,20
1714631432293,MCWP 50R,C00,518793,Staff,0,2,20,20
1714631432293,MCWP 50R,D00,518794,Staff,0,0,20,20
1714631432293,MCWP 50R,E00,518795,Staff,0,2,20,20
1714631432293,MCWP 50R,F00,518796,Staff,0,0,20,20
1714631432293,MCWP 50R,G00,518797,Staff,0,1,20,20
1714631433321,MMW 12R,A01,514034,Herbst; Matthew,0,0,16,16
1714631433321,MMW 12R,A02,514035,Herbst; Matthew,1,0,16,15
1714631434346,MMW 13R,A01,514037,Staff,0,4,16,16
1714631434346,MMW 13R,A02,514039,Staff,0,2,16,16
1714631434346,MMW 13R,A03,628519,Staff,0,2,16,16
1714631436404,SIO 295LS,A00,523233,Staff,10,0,30,20
1714631437429,SIO 295S,A00,523232,Staff,10,0,30,20
1714631438456,SIOC 290S,A01,637330,Merrifield; Mark A,23,0,30,7
1714631439482,SIOC 291S,A01,637333,Gabriel; Corey John,23,0,30,7
1714631440510,SOCI 117,A01,494376,Staff,0,4,5,5
1714631441540,WES 237B,A00,494380,Staff,9,0,20,11
1714631443609,AESE 279B,A00,494370,Wade; Jon P,0,0,33,33
1714631444635,AIP 197,001,627712,Vespa; Emanuel Ignacio,9998,0,9999,1
1714631445661,ANAR 135S,A00,494369,Braswell; Geoffrey E.,0,0,0,0
1714631446686,BENG 196,001,628496,Engler; Adam J.,9998,0,9999,1
1714631447717,CAT 124RS,A01,519847,Geibel; William,0,0,20,20
1714631448742,CAT 125RS,A01,515971,Geibel; William,0,0,20,20
1714631449771,CLRE 250,A00,511389,Morris; Sheldon,9993,0,9999,6
1714631450804,CLRE 251,A00,507176,Mehta; Ravindra L.,9993,0,9999,6
1714631450804,CLRE 251,B00,511410,Mehta; Ravindra L.,9998,0,9999,1
1714631451833,CLRE 252,A00,507189,Cuomo; Raphael Eduardo,9995,0,9999,4
1714631452858,CLRE 253,A00,507199,Vaida; Florin,9994,0,9999,5
1714631452858,CLRE 253,B00,507202,Vaida; Florin,9999,0,9999,0
1714631453890,CLRE 259,A00,507211,Patel; Hemal,9996,0,9999,3
1714631454916,CLRE 260,A00,507221,Cuomo; Raphael Eduardo,9999,0,9999,0
1714631455941,CLRE 297,001,507242,Cuomo; Raphael Eduardo,9999,0,9999,0
1714631456967,COGS 197,001,638244,Voytek; Bradley Thomas,9998,0,9999,1
1714631457992,CSE 191,A00,516875,Minnes Kemp; Mor Mia,9992,0,9999,7
1714631459019,CSE 197,001,637388,Minnes Kemp; Mor Mia,9998,0,9999,1
1714631460084,CSS 201S,A01,494383,Staff,35,0,35,0
1714631461111,CSS 202S,A01,494387,Staff,35,0,35,0
1714631462138,DSC 197,001,628532,Eldridge; Justin Matthew,9996,0,9999,3
1714631463162,EAP 100,A00,516065,Staff,9797,0,9999,202
1714631464192,ECE 45,A01,507414,Staff,33,0,60,27
1714631466245,ECE 111,A01,507420,Staff,15,0,50,35
1714631467270,ECE 197,001,548057,Sievenpiper; Daniel F.,9993,0,9999,6
1714631468296,EDS 115,A00,507243,Choi; Bailey Miyeon,10,0,28,18
1714631469324,EDS 117,A01,494379,Staff,0,4,30,30
1714631470352,EDS 125,A00,507246,Hopkins; Megan Beth,9,0,30,21
1714631471382,EDS 128A,A01,507264,Fargason; Sharon Gayle,8,0,26,18
1714631472407,EDS 128B,A01,507293,Pappas; Elizabeth,12,0,30,18
1714631473434,EDS 139,A00,507294,Fargason; Sharon Gayle,13,0,30,17
1714631473434,EDS 139,B00,507313,Pappas; Elizabeth,13,0,30,17
1714631474459,EDS 201,A00,507315,Staff,13,0,30,17
1714631475483,EDS 203,A01,507317,Halter; Christopher P.,12,0,30,18
1714631476508,EDS 204R,A01,507319,Halter; Christopher P.,0,3,30,30
1714631476508,EDS 204R,B01,507331,Heinzman; Erica M.,16,0,30,14
1714631477537,EDS 206R,A00,507332,Staff,0,4,30,30
1714631477537,EDS 206R,B00,507343,Staff,17,0,30,13
1714631478565,EDS 250,A00,507344,Hemans; Patricia Ann Benitez,22,0,40,18
1714631479594,EDS 281,A00,507345,Daly; Alan J.,18,0,18,0
1714631480619,EDS 284,A00,507350,Daly; Alan J.,16,0,16,0
1714631481644,EDS 286,A00,507359,Fine; Sarah,18,0,18,0
1714631482668,EDS 289C,A01,507361,Daly; Alan J.,18,0,18,0
1714631483694,EDS 290,A00,507366,Hofstetter; Carolyn,15,0,15,0
1714631484797,LIGM 5A,A00,507421,Fischer-Grunski; Eva K,18,0,20,2
1714631485826,LIGM 5B,A00,507423,Fischer-Grunski; Eva K,19,0,20,1
1714631486854,LIGM 5C,A00,507425,Fischer-Grunski; Eva K,19,0,20,1
1714631487879,LIIT 5AS,A00,507427,Carnelos; Chiara,20,0,20,0
1714631488909,LIIT 5BS,A00,507430,Carnelos; Chiara,20,0,20,0
1714631489938,LIIT 5CS,A00,507432,Carnelos; Chiara,20,0,20,0
1714631490964,LISP 5A,A00,507541,Munoz Sanchez; Alicia,11,0,20,9
1714631492114,LISP 5B,A00,507671,Munoz Sanchez; Alicia,8,0,20,12
1714631493143,LISP 5C,A00,507696,Munoz Sanchez; Alicia,9,0,20,11
1714631494174,MAE 197,001,528363,Boechler; Nicholas Sebastia,9998,0,9999,1
1714631495200,MATH 197,001,523477,Kedlaya; Kiran S.,9995,0,9999,4
1714631495200,MATH 197,002,563811,Zhang; Danna,9995,0,9999,4
1714631495200,MATH 197,003,628552,Dumitriu; Ioana,9998,0,9999,1
1714631496230,MCWP 40R,A00,518780,Staff,2,0,20,18
1714631496230,MCWP 40R,B00,518781,Staff,8,0,20,12
1714631496230,MCWP 40R,C00,518783,Staff,6,0,20,14
1714631497259,MCWP 50R,A00,518791,Staff,0,0,20,20
1714631497259,MCWP 50R,B00,518792,Staff,0,2,20,20
1714631497259,MCWP 50R,C00,518793,Staff,0,2,20,20
1714631497259,MCWP 50R,D00,518794,Staff,0,0,20,20
1714631497259,MCWP 50R,E00,518795,Staff,0,2,20,20
1714631497259,MCWP 50R,F00,518796,Staff,0,0,20,20
1714631497259,MCWP 50R,G00,518797,Staff,0,1,20,20
1714631498287,MMW 12R,A01,514034,Herbst; Matthew,0,0,16,16
1714631498287,MMW 12R,A02,514035,Herbst; Matthew,1,0,16,15
1714631499315,MMW 13R,A01,514037,Staff,0,4,16,16
1714631499315,MMW 13R,A02,514039,Staff,0,2,16,16
1714631499315,MMW 13R,A03,628519,Staff,0,2,16,16
1714631501369,SIO 295LS,A00,523233,Staff,10,0,30,20
1714631502396,SIO 295S,A00,523232,Staff,10,0,30,20
1714631503425,SIOC 290S,A01,637330,Merrifield; Mark A,23,0,30,7
1714631504456,SIOC 291S,A01,637333,Gabriel; Corey John,23,0,30,7
1714631505486,SOCI 117,A01,494376,Staff,0,4,5,5
1714631506516,WES 237B,A00,494380,Staff,9,0,20,11
1714631508590,AESE 279B,A00,494370,Wade; Jon P,0,0,33,33
1714631509616,AIP 197,001,627712,Vespa; Emanuel Ignacio,9998,0,9999,1
1714631510645,ANAR 135S,A00,494369,Braswell; Geoffrey E.,0,0,0,0
1714631511670,BENG 196,001,628496,Engler; Adam J.,9998,0,9999,1
1714631512697,CAT 124RS,A01,519847,Geibel; William,0,0,20,20
1714631513725,CAT 125RS,A01,515971,Geibel; William,0,0,20,20
1714631514755,CLRE 250,A00,511389,Morris; Sheldon,9993,0,9999,6
1714631515781,CLRE 251,A00,507176,Mehta; Ravindra L.,9993,0,9999,6
1714631515781,CLRE 251,B00,511410,Mehta; Ravindra L.,9998,0,9999,1
1714631516815,CLRE 252,A00,507189,Cuomo; Raphael Eduardo,9995,0,9999,4
1714631517846,CLRE 253,A00,507199,Vaida; Florin,9994,0,9999,5
1714631517846,CLRE 253,B00,507202,Vaida; Florin,9999,0,9999,0
1714631518873,CLRE 259,A00,507211,Patel; Hemal,9996,0,9999,3
1714631519898,CLRE 260,A00,507221,Cuomo; Raphael Eduardo,9999,0,9999,0
1714631520923,CLRE 297,001,507242,Cuomo; Raphael Eduardo,9999,0,9999,0
1714631521951,COGS 197,001,638244,Voytek; Bradley Thomas,9998,0,9999,1
1714631522977,CSE 191,A00,516875,Minnes Kemp; Mor Mia,9992,0,9999,7
1714631524009,CSE 197,001,637388,Minnes Kemp; Mor Mia,9998,0,9999,1
1714631525038,CSS 201S,A01,494383,Staff,35,0,35,0
1714631526062,CSS 202S,A01,494387,Staff,35,0,35,0
1714631527086,DSC 197,001,628532,Eldridge; Justin Matthew,9996,0,9999,3
1714631528112,EAP 100,A00,516065,Staff,9797,0,9999,202
1714631529138,ECE 45,A01,507414,Staff,33,0,60,27
1714631531191,ECE 111,A01,507420,Staff,15,0,50,35
1714631532221,ECE 197,001,548057,Sievenpiper; Daniel F.,9993,0,9999,6
1714631533251,EDS 115,A00,507243,Choi; Bailey Miyeon,10,0,28,18
1714631534278,EDS 117,A01,494379,Staff,0,4,30,30
1714631535306,EDS 125,A00,507246,Hopkins; Megan Beth,9,0,30,21
1714631536337,EDS 128A,A01,507264,Fargason; Sharon Gayle,8,0,26,18
1714631537361,EDS 128B,A01,507293,Pappas; Elizabeth,12,0,30,18
1714631538386,EDS 139,A00,507294,Fargason; Sharon Gayle,13,0,30,17
1714631538386,EDS 139,B00,507313,Pappas; Elizabeth,13,0,30,17
1714631539414,EDS 201,A00,507315,Staff,13,0,30,17
1714631540443,EDS 203,A01,507317,Halter; Christopher P.,12,0,30,18
1714631541467,EDS 204R,A01,507319,Halter; Christopher P.,0,3,30,30
1714631541467,EDS 204R,B01,507331,Heinzman; Erica M.,16,0,30,14
1714631542491,EDS 206R,A00,507332,Staff,0,4,30,30
1714631542491,EDS 206R,B00,507343,Staff,17,0,30,13
1714631543522,EDS 250,A00,507344,Hemans; Patricia Ann Benitez,22,0,40,18
1714631544547,EDS 281,A00,507345,Daly; Alan J.,18,0,18,0
1714631545571,EDS 284,A00,507350,Daly; Alan J.,16,0,16,0
1714631546600,EDS 286,A00,507359,Fine; Sarah,18,0,18,0
1714631547625,EDS 289C,A01,507361,Daly; Alan J.,18,0,18,0
1714631548653,EDS 290,A00,507366,Hofstetter; Carolyn,15,0,15,0
1714631549679,LIGM 5A,A00,507421,Fischer-Grunski; Eva K,18,0,20,2
1714631550704,LIGM 5B,A00,507423,Fischer-Grunski; Eva K,19,0,20,1
1714631551735,LIGM 5C,A00,507425,Fischer-Grunski; Eva K,19,0,20,1
1714631552765,LIIT 5AS,A00,507427,Carnelos; Chiara,20,0,20,0
1714631553791,LIIT 5BS,A00,507430,Carnelos; Chiara,20,0,20,0
1714631554815,LIIT 5CS,A00,507432,Carnelos; Chiara,20,0,20,0
1714631555841,LISP 5A,A00,507541,Munoz Sanchez; Alicia,11,0,20,9
1714631556868,LISP 5B,A00,507671,Munoz Sanchez; Alicia,8,0,20,12
1714631557893,LISP 5C,A00,507696,Munoz Sanchez; Alicia,9,0,20,11
1714631558921,MAE 197,001,528363,Boechler; Nicholas Sebastia,9998,0,9999,1
1714631559957,MATH 197,001,523477,Kedlaya; Kiran S.,9995,0,9999,4
1714631559957,MATH 197,002,563811,Zhang; Danna,9995,0,9999,4
1714631559957,MATH 197,003,628552,Dumitriu; Ioana,9998,0,9999,1
1714631560985,MCWP 40R,A00,518780,Staff,2,0,20,18
1714631560985,MCWP 40R,B00,518781,Staff,8,0,20,12
1714631560985,MCWP 40R,C00,518783,Staff,6,0,20,14
1714631562014,MCWP 50R,A00,518791,Staff,0,0,20,20
1714631562014,MCWP 50R,B00,518792,Staff,0,2,20,20
1714631562014,MCWP 50R,C00,518793,Staff,0,2,20,20
1714631562014,MCWP 50R,D00,518794,Staff,0,0,20,20
1714631562014,MCWP 50R,E00,518795,Staff,0,2,20,20
1714631562014,MCWP 50R,F00,518796,Staff,0,0,20,20
1714631562014,MCWP 50R,G00,518797,Staff,0,1,20,20
1714631563040,MMW 12R,A01,514034,Herbst; Matthew,0,0,16,16
1714631563040,MMW 12R,A02,514035,Herbst; Matthew,1,0,16,15
1714631564067,MMW 13R,A01,514037,Staff,0,4,16,16
1714631564067,MMW 13R,A02,514039,Staff,0,2,16,16
1714631564067,MMW 13R,A03,628519,Staff,0,2,16,16
1714631566116,SIO 295LS,A00,523233,Staff,10,0,30,20
1714631567142,SIO 295S,A00,523232,Staff,10,0,30,20
1714631568169,SIOC 290S,A01,637330,Merrifield; Mark A,23,0,30,7
1714631569195,SIOC 291S,A01,637333,Gabriel; Corey John,23,0,30,7
1714631570220,SOCI 117,A01,494376,Staff,0,4,5,5
1714631571246,WES 237B,A00,494380,Staff,9,0,20,11
1714631573327,AESE 279B,A00,494370,Wade; Jon P,0,0,33,33
1714631574356,AIP 197,001,627712,Vespa; Emanuel Ignacio,9998,0,9999,1
1714631575382,ANAR 135S,A00,494369,Braswell; Geoffrey E.,0,0,0,0
1714631576407,BENG 196,001,628496,Engler; Adam J.,9998,0,9999,1
1714631577438,CAT 124RS,A01,519847,Geibel; William,0,0,20,20
1714631578462,CAT 125RS,A01,515971,Geibel; William,0,0,20,20
1714631579489,CLRE 250,A00,511389,Morris; Sheldon,9993,0,9999,6
1714631580517,CLRE 251,A00,507176,Mehta; Ravindra L.,9993,0,9999,6
1714631580517,CLRE 251,B00,511410,Mehta; Ravindra L.,9998,0,9999,1
1714631581541,CLRE 252,A00,507189,Cuomo; Raphael Eduardo,9995,0,9999,4
1714631582570,CLRE 253,A00,507199,Vaida; Florin,9994,0,9999,5
1714631582570,CLRE 253,B00,507202,Vaida; Florin,9999,0,9999,0
1714631583598,CLRE 259,A00,507211,Patel; Hemal,9996,0,9999,3
1714631584623,CLRE 260,A00,507221,Cuomo; Raphael Eduardo,9999,0,9999,0
1714631585648,CLRE 297,001,507242,Cuomo; Raphael Eduardo,9999,0,9999,0
1714631586673,COGS 197,001,638244,Voytek; Bradley Thomas,9998,0,9999,1
1714631587701,CSE 191,A00,516875,Minnes Kemp; Mor Mia,9992,0,9999,7
1714631588726,CSE 197,001,637388,Minnes Kemp; Mor Mia,9998,0,9999,1
1714631589754,CSS 201S,A01,494383,Staff,35,0,35,0
1714631590781,CSS 202S,A01,494387,Staff,35,0,35,0
1714631591810,DSC 197,001,628532,Eldridge; Justin Matthew,9996,0,9999,3
1714631592834,EAP 100,A00,516065,Staff,9797,0,9999,202
1714631593875,ECE 45,A01,507414,Staff,33,0,60,27
1714631595982,ECE 111,A01,507420,Staff,15,0,50,35
1714631597009,ECE 197,001,548057,Sievenpiper; Daniel F.,9993,0,9999,6
1714631598037,EDS 115,A00,507243,Choi; Bailey Miyeon,10,0,28,18
1714631599066,EDS 117,A01,494379,Staff,0,4,30,30
1714631600091,EDS 125,A00,507246,Hopkins; Megan Beth,9,0,30,21
1714631601119,EDS 128A,A01,507264,Fargason; Sharon Gayle,8,0,26,18
1714631602145,EDS 128B,A01,507293,Pappas; Elizabeth,12,0,30,18
1714631603168,EDS 139,A00,507294,Fargason; Sharon Gayle,13,0,30,17
1714631603168,EDS 139,B00,507313,Pappas; Elizabeth,13,0,30,17
1714631604193,EDS 201,A00,507315,Staff,13,0,30,17
1714631605218,EDS 203,A01,507317,Halter; Christopher P.,12,0,30,18
1714631606244,EDS 204R,A01,507319,Halter; Christopher P.,0,3,30,30
1714631606244,EDS 204R,B01,507331,Heinzman; Erica M.,16,0,30,14
1714631607268,EDS 206R,A00,507332,Staff,0,4,30,30
1714631607268,EDS 206R,B00,507343,Staff,17,0,30,13
1714631608294,EDS 250,A00,507344,Hemans; Patricia Ann Benitez,22,0,40,18
1714631609320,EDS 281,A00,507345,Daly; Alan J.,18,0,18,0
1714631610343,EDS 284,A00,507350,Daly; Alan J.,16,0,16,0
1714631611372,EDS 286,A00,507359,Fine; Sarah,18,0,18,0
1714631612397,EDS 289C,A01,507361,Daly; Alan J.,18,0,18,0
1714631613422,EDS 290,A00,507366,Hofstetter; Carolyn,15,0,15,0
1714631614452,LIGM 5A,A00,507421,Fischer-Grunski; Eva K,18,0,20,2
1714631615477,LIGM 5B,A00,507423,Fischer-Grunski; Eva K,19,0,20,1
1714631616501,LIGM 5C,A00,507425,Fischer-Grunski; Eva K,19,0,20,1
1714631617526,LIIT 5AS,A00,507427,Carnelos; Chiara,20,0,20,0
1714631618555,LIIT 5BS,A00,507430,Carnelos; Chiara,20,0,20,0
1714631619583,LIIT 5CS,A00,507432,Carnelos; Chiara,20,0,20,0
1714631620608,LISP 5A,A00,507541,Munoz Sanchez; Alicia,11,0,20,9
1714631621636,LISP 5B,A00,507671,Munoz Sanchez; Alicia,8,0,20,12
1714631622661,LISP 5C,A00,507696,Munoz Sanchez; Alicia,9,0,20,11
1714631623686,MAE 197,001,528363,Boechler; Nicholas Sebastia,9998,0,9999,1
1714631624720,MATH 197,001,523477,Kedlaya; Kiran S.,9995,0,9999,4
1714631624720,MATH 197,002,563811,Zhang; Danna,9995,0,9999,4
1714631624720,MATH 197,003,628552,Dumitriu; Ioana,9998,0,9999,1
1714631625745,MCWP 40R,A00,518780,Staff,2,0,20,18
1714631625745,MCWP 40R,B00,518781,Staff,8,0,20,12
1714631625745,MCWP 40R,C00,518783,Staff,6,0,20,14
1714631626777,MCWP 50R,A00,518791,Staff,0,0,20,20
1714631626777,MCWP 50R,B00,518792,Staff,0,2,20,20
1714631626777,MCWP 50R,C00,518793,Staff,0,2,20,20
1714631626777,MCWP 50R,D00,518794,Staff,0,0,20,20
1714631626777,MCWP 50R,E00,518795,Staff,0,2,20,20
1714631626777,MCWP 50R,F00,518796,Staff,0,0,20,20
1714631626777,MCWP 50R,G00,518797,Staff,0,1,20,20
1714631627805,MMW 12R,A01,514034,Herbst; Matthew,0,0,16,16
1714631627805,MMW 12R,A02,514035,Herbst; Matthew,1,0,16,15
1714631628829,MMW 13R,A01,514037,Staff,0,4,16,16
1714631628829,MMW 13R,A02,514039,Staff,0,2,16,16
1714631628829,MMW 13R,A03,628519,Staff,0,2,16,16
1714631630879,SIO 295LS,A00,523233,Staff,10,0,30,20
1714631631906,SIO 295S,A00,523232,Staff,10,0,30,20
1714631632932,SIOC 290S,A01,637330,Merrifield; Mark A,23,0,30,7
1714631633959,SIOC 291S,A01,637333,Gabriel; Corey John,23,0,30,7
1714631634988,SOCI 117,A01,494376,Staff,0,4,5,5
1714631636013,WES 237B,A00,494380,Staff,9,0,20,11
1714631638092,AESE 279B,A00,494370,Wade; Jon P,0,0,33,33
1714631639118,AIP 197,001,627712,Vespa; Emanuel Ignacio,9998,0,9999,1
1714631640142,ANAR 135S,A00,494369,Braswell; Geoffrey E.,0,0,0,0
1714631641169,BENG 196,001,628496,Engler; Adam J.,9998,0,9999,1
1714631642197,CAT 124RS,A01,519847,Geibel; William,0,0,20,20
1714631643223,CAT 125RS,A01,515971,Geibel; William,0,0,20,20
1714631644249,CLRE 250,A00,511389,Morris; Sheldon,9993,0,9999,6
1714631645275,CLRE 251,A00,507176,Mehta; Ravindra L.,9993,0,9999,6
1714631645275,CLRE 251,B00,511410,Mehta; Ravindra L.,9998,0,9999,1
1714631646302,CLRE 252,A00,507189,Cuomo; Raphael Eduardo,9995,0,9999,4
1714631647327,CLRE 253,A00,507199,Vaida; Florin,9994,0,9999,5
1714631647327,CLRE 253,B00,507202,Vaida; Florin,9999,0,9999,0
1714631648351,CLRE 259,A00,507211,Patel; Hemal,9996,0,9999,3
1714631649379,CLRE 260,A00,507221,Cuomo; Raphael Eduardo,9999,0,9999,0
1714631650407,CLRE 297,001,507242,Cuomo; Raphael Eduardo,9999,0,9999,0
1714631651436,COGS 197,001,638244,Voytek; Bradley Thomas,9998,0,9999,1
1714631652464,CSE 191,A00,516875,Minnes Kemp; Mor Mia,9992,0,9999,7
1714631653489,CSE 197,001,637388,Minnes Kemp; Mor Mia,9998,0,9999,1
1714631654515,CSS 201S,A01,494383,Staff,35,0,35,0
1714631655542,CSS 202S,A01,494387,Staff,35,0,35,0
1714631656566,DSC 197,001,628532,Eldridge; Justin Matthew,9996,0,9999,3
1714631657591,EAP 100,A00,516065,Staff,9797,0,9999,202
1714631658616,ECE 45,A01,507414,Staff,33,0,60,27
1714631660669,ECE 111,A01,507420,Staff,15,0,50,35
1714631661695,ECE 197,001,548057,Sievenpiper; Daniel F.,9993,0,9999,6
1714631662719,EDS 115,A00,507243,Choi; Bailey Miyeon,10,0,28,18
1714631663747,EDS 117,A01,494379,Staff,0,4,30,30
1714631664771,EDS 125,A00,507246,Hopkins; Megan Beth,9,0,30,21
1714631665795,EDS 128A,A01,507264,Fargason; Sharon Gayle,8,0,26,18
1714631666821,EDS 128B,A01,507293,Pappas; Elizabeth,12,0,30,18
1714631667849,EDS 139,A00,507294,Fargason; Sharon Gayle,13,0,30,17
1714631667849,EDS 139,B00,507313,Pappas; Elizabeth,13,0,30,17
1714631668874,EDS 201,A00,507315,Staff,13,0,30,17
1714631669901,EDS 203,A01,507317,Halter; Christopher P.,12,0,30,18
1714631670933,EDS 204R,A01,507319,Halter; Christopher P.,0,3,30,30
1714631670933,EDS 204R,B01,507331,Heinzman; Erica M.,16,0,30,14
1714631671961,EDS 206R,A00,507332,Staff,0,4,30,30
1714631671961,EDS 206R,B00,507343,Staff,17,0,30,13
1714631672987,EDS 250,A00,507344,Hemans; Patricia Ann Benitez,22,0,40,18
1714631674017,EDS 281,A00,507345,Daly; Alan J.,18,0,18,0
1714631675102,EDS 284,A00,507350,Daly; Alan J.,16,0,16,0
1714631676129,EDS 286,A00,507359,Fine; Sarah,18,0,18,0
1714631677156,EDS 289C,A01,507361,Daly; Alan J.,18,0,18,0
1714631678183,EDS 290,A00,507366,Hofstetter; Carolyn,15,0,15,0
1714631679212,LIGM 5A,A00,507421,Fischer-Grunski; Eva K,18,0,20,2
1714631680238,LIGM 5B,A00,507423,Fischer-Grunski; Eva K,19,0,20,1
1714631681263,LIGM 5C,A00,507425,Fischer-Grunski; Eva K,19,0,20,1
1714631682290,LIIT 5AS,A00,507427,Carnelos; Chiara,20,0,20,0
1714631683316,LIIT 5BS,A00,507430,Carnelos; Chiara,20,0,20,0
1714631684346,LIIT 5CS,A00,507432,Carnelos; Chiara,20,0,20,0
1714631685371,LISP 5A,A00,507541,Munoz Sanchez; Alicia,11,0,20,9
1714631686397,LISP 5B,A00,507671,Munoz Sanchez; Alicia,8,0,20,12
1714631687424,LISP 5C,A00,507696,Munoz Sanchez; Alicia,9,0,20,11
1714631688452,MAE 197,001,528363,Boechler; Nicholas Sebastia,9998,0,9999,1
1714631689482,MATH 197,001,523477,Kedlaya; Kiran S.,9995,0,9999,4
1714631689482,MATH 197,002,563811,Zhang; Danna,9995,0,9999,4
1714631689482,MATH 197,003,628552,Dumitriu; Ioana,9998,0,9999,1
1714631690508,MCWP 40R,A00,518780,Staff,2,0,20,18
1714631690508,MCWP 40R,B00,518781,Staff,8,0,20,12
1714631690508,MCWP 40R,C00,518783,Staff,6,0,20,14
1714631691539,MCWP 50R,A00,518791,Staff,0,0,20,20
1714631691539,MCWP 50R,B00,518792,Staff,0,2,20,20
1714631691539,MCWP 50R,C00,518793,Staff,0,2,20,20
1714631691539,MCWP 50R,D00,518794,Staff,0,0,20,20
1714631691539,MCWP 50R,E00,518795,Staff,0,2,20,20
1714631691539,MCWP 50R,F00,518796,Staff,0,0,20,20
1714631691539,MCWP 50R,G00,518797,Staff,0,1,20,20
1714631692568,MMW 12R,A01,514034,Herbst; Matthew,0,0,16,16
1714631692568,MMW 12R,A02,514035,Herbst; Matthew,1,0,16,15
1714631693597,MMW 13R,A01,514037,Staff,0,4,16,16
1714631693597,MMW 13R,A02,514039,Staff,0,2,16,16
1714631693597,MMW 13R,A03,628519,Staff,0,2,16,16
1714631695650,SIO 295LS,A00,523233,Staff,10,0,30,20
1714631696677,SIO 295S,A00,523232,Staff,10,0,30,20
1714631697709,SIOC 290S,A01,637330,Merrifield; Mark A,23,0,30,7
1714631698738,SIOC 291S,A01,637333,Gabriel; Corey John,23,0,30,7
1714631699823,SOCI 117,A01,494376,Staff,0,4,5,5
1714631700847,WES 237B,A00,494380,Staff,9,0,20,11
1714631702941,AESE 279B,A00,494370,Wade; Jon P,0,0,33,33
1714631703971,AIP 197,001,627712,Vespa; Emanuel Ignacio,9998,0,9999,1
1714631704997,ANAR 135S,A00,494369,Braswell; Geoffrey E.,0,0,0,0
1714631706022,BENG 196,001,628496,Engler; Adam J.,9998,0,9999,1
1714631707052,CAT 124RS,A01,519847,Geibel; William,0,0,20,20
1714631708076,CAT 125RS,A01,515971,Geibel; William,0,0,20,20
1714631709106,CLRE 250,A00,511389,Morris; Sheldon,9993,0,9999,6
1714631710132,CLRE 251,A00,507176,Mehta; Ravindra L.,9993,0,9999,6
1714631710132,CLRE 251,B00,511410,Mehta; Ravindra L.,9998,0,9999,1
1714631711157,CLRE 252,A00,507189,Cuomo; Raphael Eduardo,9995,0,9999,4
1714631712180,CLRE 253,A00,507199,Vaida; Florin,9994,0,9999,5
1714631712180,CLRE 253,B00,507202,Vaida; Florin,9999,0,9999,0
1714631713205,CLRE 259,A00,507211,Patel; Hemal,9996,0,9999,3
1714631714232,CLRE 260,A00,507221,Cuomo; Raphael Eduardo,9999,0,9999,0
1714631715257,CLRE 297,001,507242,Cuomo; Raphael Eduardo,9999,0,9999,0
1714631716286,COGS 197,001,638244,Voytek; Bradley Thomas,9998,0,9999,1
1714631717316,CSE 191,A00,516875,Minnes Kemp; Mor Mia,9992,0,9999,7
1714631718346,CSE 197,001,637388,Minnes Kemp; Mor Mia,9998,0,9999,1
1714631719374,CSS 201S,A01,494383,Staff,35,0,35,0
1714631720404,CSS 202S,A01,494387,Staff,35,0,35,0
1714631721439,DSC 197,001,628532,Eldridge; Justin Matthew,9996,0,9999,3
1714631722465,EAP 100,A00,516065,Staff,9797,0,9999,202
1714631723497,ECE 45,A01,507414,Staff,33,0,60,27
1714631725546,ECE 111,A01,507420,Staff,15,0,50,35
1714631726578,ECE 197,001,548057,Sievenpiper; Daniel F.,9993,0,9999,6
1714631727604,EDS 115,A00,507243,Choi; Bailey Miyeon,10,0,28,18
1714631728632,EDS 117,A01,494379,Staff,0,4,30,30
1714631729658,EDS 125,A00,507246,Hopkins; Megan Beth,9,0,30,21
1714631730688,EDS 128A,A01,507264,Fargason; Sharon Gayle,8,0,26,18
1714631731712,EDS 128B,A01,507293,Pappas; Elizabeth,12,0,30,18
1714631732736,EDS 139,A00,507294,Fargason; Sharon Gayle,13,0,30,17
1714631732736,EDS 139,B00,507313,Pappas; Elizabeth,13,0,30,17
1714631733761,EDS 201,A00,507315,Staff,13,0,30,17
1714631734791,EDS 203,A01,507317,Halter; Christopher P.,12,0,30,18
1714631735817,EDS 204R,A01,507319,Halter; Christopher P.,0,3,30,30
1714631735817,EDS 204R,B01,507331,Heinzman; Erica M.,16,0,30,14
1714631736841,EDS 206R,A00,507332,Staff,0,4,30,30
1714631736841,EDS 206R,B00,507343,Staff,17,0,30,13
1714631737868,EDS 250,A00,507344,Hemans; Patricia Ann Benitez,22,0,40,18
1714631738892,EDS 281,A00,507345,Daly; Alan J.,18,0,18,0
1714631739917,EDS 284,A00,507350,Daly; Alan J.,16,0,16,0
1714631740945,EDS 286,A00,507359,Fine; Sarah,18,0,18,0
1714631741973,EDS 289C,A01,507361,Daly; Alan J.,18,0,18,0
1714631742997,EDS 290,A00,507366,Hofstetter; Carolyn,15,0,15,0
1714631744023,LIGM 5A,A00,507421,Fischer-Grunski; Eva K,18,0,20,2
1714631745052,LIGM 5B,A00,507423,Fischer-Grunski; Eva K,19,0,20,1
1714631746079,LIGM 5C,A00,507425,Fischer-Grunski; Eva K,19,0,20,1
1714631747104,LIIT 5AS,A00,507427,Carnelos; Chiara,20,0,20,0
1714631748131,LIIT 5BS,A00,507430,Carnelos; Chiara,20,0,20,0
1714631749156,LIIT 5CS,A00,507432,Carnelos; Chiara,20,0,20,0
1714631750185,LISP 5A,A00,507541,Munoz Sanchez; Alicia,11,0,20,9
1714631751211,LISP 5B,A00,507671,Munoz Sanchez; Alicia,8,0,20,12
1714631752235,LISP 5C,A00,507696,Munoz Sanchez; Alicia,9,0,20,11
1714631753260,MAE 197,001,528363,Boechler; Nicholas Sebastia,9998,0,9999,1
1714631754287,MATH 197,001,523477,Kedlaya; Kiran S.,9995,0,9999,4
1714631754287,MATH 197,002,563811,Zhang; Danna,9995,0,9999,4
1714631754287,MATH 197,003,628552,Dumitriu; Ioana,9998,0,9999,1
1714631755319,MCWP 40R,A00,518780,Staff,2,0,20,18
1714631755319,MCWP 40R,B00,518781,Staff,8,0,20,12
1714631755319,MCWP 40R,C00,518783,Staff,6,0,20,14
1714631756346,MCWP 50R,A00,518791,Staff,0,0,20,20
1714631756346,MCWP 50R,B00,518792,Staff,0,2,20,20
1714631756346,MCWP 50R,C00,518793,Staff,0,2,20,20
1714631756346,MCWP 50R,D00,518794,Staff,0,0,20,20
1714631756346,MCWP 50R,E00,518795,Staff,0,2,20,20
1714631756346,MCWP 50R,F00,518796,Staff,0,0,20,20
1714631756346,MCWP 50R,G00,518797,Staff,0,1,20,20
1714631757371,MMW 12R,A01,514034,Herbst; Matthew,0,0,16,16
1714631757371,MMW 12R,A02,514035,Herbst; Matthew,1,0,16,15
1714631758397,MMW 13R,A01,514037,Staff,0,4,16,16
1714631758397,MMW 13R,A02,514039,Staff,0,2,16,16
1714631758397,MMW 13R,A03,628519,Staff,0,2,16,16
1714631760450,SIO 295LS,A00,523233,Staff,10,0,30,20
1714631761474,SIO 295S,A00,523232,Staff,10,0,30,20
1714631762504,SIOC 290S,A01,637330,Merrifield; Mark A,23,0,30,7
1714631763533,SIOC 291S,A01,637333,Gabriel; Corey John,23,0,30,7
1714631764561,SOCI 117,A01,494376,Staff,0,4,5,5
1714631765586,WES 237B,A00,494380,Staff,9,0,20,11
1714631767660,AESE 279B,A00,494370,Wade; Jon P,0,0,33,33
1714631768688,AIP 197,001,627712,Vespa; Emanuel Ignacio,9998,0,9999,1
1714631769716,ANAR 135S,A00,494369,Braswell; Geoffrey E.,0,0,0,0
1714631770741,BENG 196,001,628496,Engler; Adam J.,9998,0,9999,1
1714631771771,CAT 124RS,A01,519847,Geibel; William,0,0,20,20
1714631772797,CAT 125RS,A01,515971,Geibel; William,0,0,20,20
1714631773823,CLRE 250,A00,511389,Morris; Sheldon,9993,0,9999,6
1714631774849,CLRE 251,A00,507176,Mehta; Ravindra L.,9993,0,9999,6
1714631774849,CLRE 251,B00,511410,Mehta; Ravindra L.,9998,0,9999,1
1714631775877,CLRE 252,A00,507189,Cuomo; Raphael Eduardo,9995,0,9999,4
1714631776907,CLRE 253,A00,507199,Vaida; Florin,9994,0,9999,5
1714631776907,CLRE 253,B00,507202,Vaida; Florin,9999,0,9999,0
1714631777936,CLRE 259,A00,507211,Patel; Hemal,9996,0,9999,3
1714631778964,CLRE 260,A00,507221,Cuomo; Raphael Eduardo,9999,0,9999,0
1714631779990,CLRE 297,001,507242,Cuomo; Raphael Eduardo,9999,0,9999,0
1714631781016,COGS 197,001,638244,Voytek; Bradley Thomas,9998,0,9999,1
1714631782046,CSE 191,A00,516875,Minnes Kemp; Mor Mia,9992,0,9999,7
1714631783072,CSE 197,001,637388,Minnes Kemp; Mor Mia,9998,0,9999,1
1714631784101,CSS 201S,A01,494383,Staff,35,0,35,0
1714631785127,CSS 202S,A01,494387,Staff,35,0,35,0
1714631786152,DSC 197,001,628532,Eldridge; Justin Matthew,9996,0,9999,3
1714631787178,EAP 100,A00,516065,Staff,9797,0,9999,202
1714631788207,ECE 45,A01,507414,Staff,33,0,60,27
1714631790262,ECE 111,A01,507420,Staff,15,0,50,35
1714631791286,ECE 197,001,548057,Sievenpiper; Daniel F.,9993,0,9999,6
1714631792321,EDS 115,A00,507243,Choi; Bailey Miyeon,10,0,28,18
1714631793349,EDS 117,A01,494379,Staff,0,4,30,30
1714631794374,EDS 125,A00,507246,Hopkins; Megan Beth,9,0,30,21
1714631795403,EDS 128A,A01,507264,Fargason; Sharon Gayle,8,0,26,18
1714631796428,EDS 128B,A01,507293,Pappas; Elizabeth,12,0,30,18
1714631797453,EDS 139,A00,507294,Fargason; Sharon Gayle,13,0,30,17
1714631797453,EDS 139,B00,507313,Pappas; Elizabeth,13,0,30,17
1714631798477,EDS 201,A00,507315,Staff,13,0,30,17
1714631799507,EDS 203,A01,507317,Halter; Christopher P.,12,0,30,18
1714631800536,EDS 204R,A01,507319,Halter; Christopher P.,0,3,30,30
1714631800536,EDS 204R,B01,507331,Heinzman; Erica M.,16,0,30,14
1714631801563,EDS 206R,A00,507332,Staff,0,4,30,30
1714631801563,EDS 206R,B00,507343,Staff,17,0,30,13
1714631802592,EDS 250,A00,507344,Hemans; Patricia Ann Benitez,22,0,40,18
1714631803671,EDS 281,A00,507345,Daly; Alan J.,18,0,18,0
1714631804698,EDS 284,A00,507350,Daly; Alan J.,16,0,16,0
1714631805727,EDS 286,A00,507359,Fine; Sarah,18,0,18,0
1714631806751,EDS 289C,A01,507361,Daly; Alan J.,18,0,18,0
1714631807775,EDS 290,A00,507366,Hofstetter; Carolyn,15,0,15,0
1714631808802,LIGM 5A,A00,507421,Fischer-Grunski; Eva K,18,0,20,2
1714631809831,LIGM 5B,A00,507423,Fischer-Grunski; Eva K,19,0,20,1
1714631810859,LIGM 5C,A00,507425,Fischer-Grunski; Eva K,19,0,20,1
1714631811889,LIIT 5AS,A00,507427,Carnelos; Chiara,20,0,20,0
1714631812920,LIIT 5BS,A00,507430,Carnelos; Chiara,20,0,20,0
1714631813948,LIIT 5CS,A00,507432,Carnelos; Chiara,20,0,20,0
1714631814973,LISP 5A,A00,507541,Munoz Sanchez; Alicia,11,0,20,9
1714631816003,LISP 5B,A00,507671,Munoz Sanchez; Alicia,8,0,20,12
1714631817029,LISP 5C,A00,507696,Munoz Sanchez; Alicia,9,0,20,11
1714631818057,MAE 197,001,528363,Boechler; Nicholas Sebastia,9998,0,9999,1
1714631819085,MATH 197,001,523477,Kedlaya; Kiran S.,9995,0,9999,4
1714631819085,MATH 197,002,563811,Zhang; Danna,9995,0,9999,4
1714631819085,MATH 197,003,628552,Dumitriu; Ioana,9998,0,9999,1
1714631820112,MCWP 40R,A00,518780,Staff,2,0,20,18
1714631820112,MCWP 40R,B00,518781,Staff,8,0,20,12
1714631820112,MCWP 40R,C00,518783,Staff,6,0,20,14
1714631821139,MCWP 50R,A00,518791,Staff,0,0,20,20
1714631821139,MCWP 50R,B00,518792,Staff,0,2,20,20
1714631821139,MCWP 50R,C00,518793,Staff,0,2,20,20
1714631821139,MCWP 50R,D00,518794,Staff,0,0,20,20
1714631821139,MCWP 50R,E00,518795,Staff,0,2,20,20
1714631821139,MCWP 50R,F00,518796,Staff,0,0,20,20
1714631821139,MCWP 50R,G00,518797,Staff,0,1,20,20
1714631822168,MMW 12R,A01,514034,Herbst; Matthew,0,0,16,16
1714631822168,MMW 12R,A02,514035,Herbst; Matthew,1,0,16,15
1714631823194,MMW 13R,A01,514037,Staff,0,4,16,16
1714631823194,MMW 13R,A02,514039,Staff,0,2,16,16
1714631823194,MMW 13R,A03,628519,Staff,0,2,16,16
1714631825244,SIO 295LS,A00,523233,Staff,10,0,30,20
1714631826272,SIO 295S,A00,523232,Staff,10,0,30,20
1714631827300,SIOC 290S,A01,637330,Merrifield; Mark A,23,0,30,7
1714631828325,SIOC 291S,A01,637333,Gabriel; Corey John,23,0,30,7
1714631829352,SOCI 117,A01,494376,Staff,0,4,5,5
1714631830377,WES 237B,A00,494380,Staff,9,0,20,11
1714631832433,AESE 279B,A00,494370,Wade; Jon P,0,0,33,33
1714631833460,AIP 197,001,627712,Vespa; Emanuel Ignacio,9998,0,9999,1
1714631834485,ANAR 135S,A00,494369,Braswell; Geoffrey E.,0,0,0,0
1714631835510,BENG 196,001,628496,Engler; Adam J.,9998,0,9999,1
1714631836589,CAT 124RS,A01,519847,Geibel; William,0,0,20,20
1714631837614,CAT 125RS,A01,515971,Geibel; William,0,0,20,20
1714631838644,CLRE 250,A00,511389,Morris; Sheldon,9993,0,9999,6
1714631839678,CLRE 251,A00,507176,Mehta; Ravindra L.,9993,0,9999,6
1714631839678,CLRE 251,B00,511410,Mehta; Ravindra L.,9998,0,9999,1
1714631840704,CLRE 252,A00,507189,Cuomo; Raphael Eduardo,9995,0,9999,4
1714631841731,CLRE 253,A00,507199,Vaida; Florin,9994,0,9999,5
1714631841731,CLRE 253,B00,507202,Vaida; Florin,9999,0,9999,0
1714631842763,CLRE 259,A00,507211,Patel; Hemal,9996,0,9999,3
1714631843788,CLRE 260,A00,507221,Cuomo; Raphael Eduardo,9999,0,9999,0
1714631844816,CLRE 297,001,507242,Cuomo; Raphael Eduardo,9999,0,9999,0
1714631845842,COGS 197,001,638244,Voytek; Bradley Thomas,9998,0,9999,1
1714631846867,CSE 191,A00,516875,Minnes Kemp; Mor Mia,9992,0,9999,7
1714631847894,CSE 197,001,637388,Minnes Kemp; Mor Mia,9998,0,9999,1
1714631848920,CSS 201S,A01,494383,Staff,35,0,35,0
1714631849946,CSS 202S,A01,494387,Staff,35,0,35,0
1714631850971,DSC 197,001,628532,Eldridge; Justin Matthew,9996,0,9999,3
1714631851998,EAP 100,A00,516065,Staff,9797,0,9999,202
1714631853025,ECE 45,A01,507414,Staff,33,0,60,27
1714631855080,ECE 111,A01,507420,Staff,15,0,50,35
1714631856104,ECE 197,001,548057,Sievenpiper; Daniel F.,9993,0,9999,6
1714631857131,EDS 115,A00,507243,Choi; Bailey Miyeon,10,0,28,18
1714631858159,EDS 117,A01,494379,Staff,0,4,30,30
1714631859185,EDS 125,A00,507246,Hopkins; Megan Beth,9,0,30,21
1714631860213,EDS 128A,A01,507264,Fargason; Sharon Gayle,8,0,26,18
1714631861241,EDS 128B,A01,507293,Pappas; Elizabeth,12,0,30,18
1714631862268,EDS 139,A00,507294,Fargason; Sharon Gayle,13,0,30,17
1714631862268,EDS 139,B00,507313,Pappas; Elizabeth,13,0,30,17
1714631863295,EDS 201,A00,507315,Staff,13,0,30,17
1714631864320,EDS 203,A01,507317,Halter; Christopher P.,12,0,30,18
1714631865345,EDS 204R,A01,507319,Halter; Christopher P.,0,3,30,30
1714631865345,EDS 204R,B01,507331,Heinzman; Erica M.,16,0,30,14
1714631866370,EDS 206R,A00,507332,Staff,0,4,30,30
1714631866370,EDS 206R,B00,507343,Staff,17,0,30,13
1714631867396,EDS 250,A00,507344,Hemans; Patricia Ann Benitez,22,0,40,18
1714631868423,EDS 281,A00,507345,Daly; Alan J.,18,0,18,0
1714631869446,EDS 284,A00,507350,Daly; Alan J.,16,0,16,0
1714631870476,EDS 286,A00,507359,Fine; Sarah,18,0,18,0
1714631871502,EDS 289C,A01,507361,Daly; Alan J.,18,0,18,0
1714631872528,EDS 290,A00,507366,Hofstetter; Carolyn,15,0,15,0
1714631873554,LIGM 5A,A00,507421,Fischer-Grunski; Eva K,18,0,20,2
1714631874585,LIGM 5B,A00,507423,Fischer-Grunski; Eva K,19,0,20,1
1714631875613,LIGM 5C,A00,507425,Fischer-Grunski; Eva K,19,0,20,1
1714631876639,LIIT 5AS,A00,507427,Carnelos; Chiara,20,0,20,0
1714631877668,LIIT 5BS,A00,507430,Carnelos; Chiara,20,0,20,0
1714631878697,LIIT 5CS,A00,507432,Carnelos; Chiara,20,0,20,0
1714631879722,LISP 5A,A00,507541,Munoz Sanchez; Alicia,11,0,20,9
1714631880748,LISP 5B,A00,507671,Munoz Sanchez; Alicia,8,0,20,12
1714631881774,LISP 5C,A00,507696,Munoz Sanchez; Alicia,9,0,20,11
1714631882804,MAE 197,001,528363,Boechler; Nicholas Sebastia,9998,0,9999,1
1714631883830,MATH 197,001,523477,Kedlaya; Kiran S.,9995,0,9999,4
1714631883830,MATH 197,002,563811,Zhang; Danna,9995,0,9999,4
1714631883830,MATH 197,003,628552,Dumitriu; Ioana,9998,0,9999,1
1714631884855,MCWP 40R,A00,518780,Staff,2,0,20,18
1714631884855,MCWP 40R,B00,518781,Staff,8,0,20,12
1714631884855,MCWP 40R,C00,518783,Staff,6,0,20,14
1714631885882,MCWP 50R,A00,518791,Staff,0,0,20,20
1714631885882,MCWP 50R,B00,518792,Staff,0,2,20,20
1714631885882,MCWP 50R,C00,518793,Staff,0,2,20,20
1714631885882,MCWP 50R,D00,518794,Staff,0,0,20,20
1714631885882,MCWP 50R,E00,518795,Staff,0,2,20,20
1714631885882,MCWP 50R,F00,518796,Staff,0,0,20,20
1714631885882,MCWP 50R,G00,518797,Staff,0,1,20,20
1714631886905,MMW 12R,A01,514034,Herbst; Matthew,0,0,16,16
1714631886905,MMW 12R,A02,514035,Herbst; Matthew,1,0,16,15
1714631887930,MMW 13R,A01,514037,Staff,0,4,16,16
1714631887930,MMW 13R,A02,514039,Staff,0,2,16,16
1714631887930,MMW 13R,A03,628519,Staff,0,2,16,16
1714631889979,SIO 295LS,A00,523233,Staff,10,0,30,20
1714631891007,SIO 295S,A00,523232,Staff,10,0,30,20
1714631892034,SIOC 290S,A01,637330,Merrifield; Mark A,23,0,30,7
1714631893059,SIOC 291S,A01,637333,Gabriel; Corey John,23,0,30,7
1714631894085,SOCI 117,A01,494376,Staff,0,4,5,5
1714631895112,WES 237B,A00,494380,Staff,9,0,20,11
1714631897179,AESE 279B,A00,494370,Wade; Jon P,0,0,33,33
1714631898208,AIP 197,001,627712,Vespa; Emanuel Ignacio,9998,0,9999,1
1714631899240,ANAR 135S,A00,494369,Braswell; Geoffrey E.,0,0,0,0
1714631900265,BENG 196,001,628496,Engler; Adam J.,9998,0,9999,1
1714631901291,CAT 124RS,A01,519847,Geibel; William,0,0,20,20
1714631902325,CAT 125RS,A01,515971,Geibel; William,0,0,20,20
1714631903352,CLRE 250,A00,511389,Morris; Sheldon,9993,0,9999,6
1714631904380,CLRE 251,A00,507176,Mehta; Ravindra L.,9993,0,9999,6
1714631904380,CLRE 251,B00,511410,Mehta; Ravindra L.,9998,0,9999,1
1714631905405,CLRE 252,A00,507189,Cuomo; Raphael Eduardo,9995,0,9999,4
1714631906433,CLRE 253,A00,507199,Vaida; Florin,9994,0,9999,5
1714631906433,CLRE 253,B00,507202,Vaida; Florin,9999,0,9999,0
1714631907514,CLRE 259,A00,507211,Patel; Hemal,9996,0,9999,3
1714631908538,CLRE 260,A00,507221,Cuomo; Raphael Eduardo,9999,0,9999,0
1714631909566,CLRE 297,001,507242,Cuomo; Raphael Eduardo,9999,0,9999,0
1714631910596,COGS 197,001,638244,Voytek; Bradley Thomas,9998,0,9999,1
1714631911625,CSE 191,A00,516875,Minnes Kemp; Mor Mia,9992,0,9999,7
1714631912650,CSE 197,001,637388,Minnes Kemp; Mor Mia,9998,0,9999,1
1714631913679,CSS 201S,A01,494383,Staff,35,0,35,0
1714631914705,CSS 202S,A01,494387,Staff,35,0,35,0
1714631915730,DSC 197,001,628532,Eldridge; Justin Matthew,9996,0,9999,3
1714631916758,EAP 100,A00,516065,Staff,9797,0,9999,202
1714631917785,ECE 45,A01,507414,Staff,33,0,60,27
1714631919835,ECE 111,A01,507420,Staff,15,0,50,35
1714631920861,ECE 197,001,548057,Sievenpiper; Daniel F.,9993,0,9999,6
1714631921892,EDS 115,A00,507243,Choi; Bailey Miyeon,10,0,28,18
1714631922918,EDS 117,A01,494379,Staff,0,4,30,30
1714631923943,EDS 125,A00,507246,Hopkins; Megan Beth,9,0,30,21
1714631924968,EDS 128A,A01,507264,Fargason; Sharon Gayle,8,0,26,18
1714631925998,EDS 128B,A01,507293,Pappas; Elizabeth,12,0,30,18
1714631927025,EDS 139,A00,507294,Fargason; Sharon Gayle,13,0,30,17
1714631927025,EDS 139,B00,507313,Pappas; Elizabeth,13,0,30,17
1714631928053,EDS 201,A00,507315,Staff,13,0,30,17
1714631929083,EDS 203,A01,507317,Halter; Christopher P.,12,0,30,18
1714631930109,EDS 204R,A01,507319,Halter; Christopher P.,0,3,30,30
1714631930109,EDS 204R,B01,507331,Heinzman; Erica M.,16,0,30,14
1714631931138,EDS 206R,A00,507332,Staff,0,4,30,30
1714631931138,EDS 206R,B00,507343,Staff,17,0,30,13
1714631932168,EDS 250,A00,507344,Hemans; Patricia Ann Benitez,22,0,40,18
1714631933196,EDS 281,A00,507345,Daly; Alan J.,18,0,18,0
1714631934225,EDS 284,A00,507350,Daly; Alan J.,16,0,16,0
1714631935254,EDS 286,A00,507359,Fine; Sarah,18,0,18,0
1714631936279,EDS 289C,A01,507361,Daly; Alan J.,18,0,18,0
1714631937303,EDS 290,A00,507366,Hofstetter; Carolyn,15,0,15,0
1714631938330,LIGM 5A,A00,507421,Fischer-Grunski; Eva K,18,0,20,2
1714631939356,LIGM 5B,A00,507423,Fischer-Grunski; Eva K,19,0,20,1
1714631940390,LIGM 5C,A00,507425,Fischer-Grunski; Eva K,19,0,20,1
1714631941416,LIIT 5AS,A00,507427,Carnelos; Chiara,20,0,20,0
1714631942452,LIIT 5BS,A00,507430,Carnelos; Chiara,20,0,20,0
1714631943494,LIIT 5CS,A00,507432,Carnelos; Chiara,20,0,20,0
1714631944525,LISP 5A,A00,507541,Munoz Sanchez; Alicia,11,0,20,9
1714631945550,LISP 5B,A00,507671,Munoz Sanchez; Alicia,8,0,20,12
1714631946579,LISP 5C,A00,507696,Munoz Sanchez; Alicia,9,0,20,11
1714631947608,MAE 197,001,528363,Boechler; Nicholas Sebastia,9998,0,9999,1
1714631948648,MATH 197,001,523477,Kedlaya; Kiran S.,9995,0,9999,4
1714631948648,MATH 197,002,563811,Zhang; Danna,9995,0,9999,4
1714631948648,MATH 197,003,628552,Dumitriu; Ioana,9998,0,9999,1
1714631949672,MCWP 40R,A00,518780,Staff,2,0,20,18
1714631949672,MCWP 40R,B00,518781,Staff,8,0,20,12
1714631949672,MCWP 40R,C00,518783,Staff,6,0,20,14
1714631950698,MCWP 50R,A00,518791,Staff,0,0,20,20
1714631950698,MCWP 50R,B00,518792,Staff,0,2,20,20
1714631950698,MCWP 50R,C00,518793,Staff,0,2,20,20
1714631950698,MCWP 50R,D00,518794,Staff,0,0,20,20
1714631950698,MCWP 50R,E00,518795,Staff,0,2,20,20
1714631950698,MCWP 50R,F00,518796,Staff,0,0,20,20
1714631950698,MCWP 50R,G00,518797,Staff,0,1,20,20
1714631951724,MMW 12R,A01,514034,Herbst; Matthew,0,0,16,16
1714631951724,MMW 12R,A02,514035,Herbst; Matthew,1,0,16,15
1714631952749,MMW 13R,A01,514037,Staff,0,4,16,16
1714631952749,MMW 13R,A02,514039,Staff,0,2,16,16
1714631952749,MMW 13R,A03,628519,Staff,0,2,16,16
1714631954800,SIO 295LS,A00,523233,Staff,10,0,30,20
1714631955826,SIO 295S,A00,523232,Staff,10,0,30,20
1714631956852,SIOC 290S,A01,637330,Merrifield; Mark A,23,0,30,7
1714631957883,SIOC 291S,A01,637333,Gabriel; Corey John,23,0,30,7
1714631958910,SOCI 117,A01,494376,Staff,0,4,5,5
1714631959936,WES 237B,A00,494380,Staff,9,0,20,11
1714631962018,AESE 279B,A00,494370,Wade; Jon P,0,0,33,33
1714631963044,AIP 197,001,627712,Vespa; Emanuel Ignacio,9998,0,9999,1
1714631964069,ANAR 135S,A00,494369,Braswell; Geoffrey E.,0,0,0,0
1714631965096,BENG 196,001,628496,Engler; Adam J.,9998,0,9999,1
1714631966121,CAT 124RS,A01,519847,Geibel; William,0,0,20,20
1714631967153,CAT 125RS,A01,515971,Geibel; William,0,0,20,20
1714631968177,CLRE 250,A00,511389,Morris; Sheldon,9993,0,9999,6
1714631969203,CLRE 251,A00,507176,Mehta; Ravindra L.,9993,0,9999,6
1714631969203,CLRE 251,B00,511410,Mehta; Ravindra L.,9998,0,9999,1
1714631970227,CLRE 252,A00,507189,Cuomo; Raphael Eduardo,9995,0,9999,4
1714631971252,CLRE 253,A00,507199,Vaida; Florin,9994,0,9999,5
1714631971252,CLRE 253,B00,507202,Vaida; Florin,9999,0,9999,0
1714631972280,CLRE 259,A00,507211,Patel; Hemal,9996,0,9999,3
1714631973307,CLRE 260,A00,507221,Cuomo; Raphael Eduardo,9999,0,9999,0
1714631974333,CLRE 297,001,507242,Cuomo; Raphael Eduardo,9999,0,9999,0
1714631975358,COGS 197,001,638244,Voytek; Bradley Thomas,9998,0,9999,1
1714631976384,CSE 191,A00,516875,Minnes Kemp; Mor Mia,9992,0,9999,7
1714631977409,CSE 197,001,637388,Minnes Kemp; Mor Mia,9998,0,9999,1
1714631978441,CSS 201S,A01,494383,Staff,35,0,35,0
1714631979466,CSS 202S,A01,494387,Staff,35,0,35,0
1714631980493,DSC 197,001,628532,Eldridge; Justin Matthew,9996,0,9999,3
1714631981518,EAP 100,A00,516065,Staff,9797,0,9999,202
1714631982548,ECE 45,A01,507414,Staff,33,0,60,27
1714631984600,ECE 111,A01,507420,Staff,15,0,50,35
1714631985624,ECE 197,001,548057,Sievenpiper; Daniel F.,9993,0,9999,6
1714631986650,EDS 115,A00,507243,Choi; Bailey Miyeon,10,0,28,18
1714631987677,EDS 117,A01,494379,Staff,0,4,30,30
1714631988702,EDS 125,A00,507246,Hopkins; Megan Beth,9,0,30,21
1714631989728,EDS 128A,A01,507264,Fargason; Sharon Gayle,8,0,26,18
1714631990756,EDS 128B,A01,507293,Pappas; Elizabeth,12,0,30,18
1714631991781,EDS 139,A00,507294,Fargason; Sharon Gayle,13,0,30,17
1714631991781,EDS 139,B00,507313,Pappas; Elizabeth,13,0,30,17
1714631992806,EDS 201,A00,507315,Staff,13,0,30,17
1714631993836,EDS 203,A01,507317,Halter; Christopher P.,12,0,30,18
1714631994864,EDS 204R,A01,507319,Halter; Christopher P.,0,3,30,30
1714631994864,EDS 204R,B01,507331,Heinzman; Erica M.,16,0,30,14
1714631995889,EDS 206R,A00,507332,Staff,0,4,30,30
1714631995889,EDS 206R,B00,507343,Staff,17,0,30,13
1714631996921,EDS 250,A00,507344,Hemans; Patricia Ann Benitez,22,0,40,18
1714631997946,EDS 281,A00,507345,Daly; Alan J.,18,0,18,0
1714631998976,EDS 284,A00,507350,Daly; Alan J.,16,0,16,0
1714632000020,EDS 286,A00,507359,Fine; Sarah,18,0,18,0
1714632001046,EDS 289C,A01,507361,Daly; Alan J.,18,0,18,0
1714632002071,EDS 290,A00,507366,Hofstetter; Carolyn,15,0,15,0
1714632003102,LIGM 5A,A00,507421,Fischer-Grunski; Eva K,18,0,20,2
1714632004132,LIGM 5B,A00,507423,Fischer-Grunski; Eva K,19,0,20,1
1714632005156,LIGM 5C,A00,507425,Fischer-Grunski; Eva K,19,0,20,1
1714632006183,LIIT 5AS,A00,507427,Carnelos; Chiara,20,0,20,0
1714632007209,LIIT 5BS,A00,507430,Carnelos; Chiara,20,0,20,0
1714632008238,LIIT 5CS,A00,507432,Carnelos; Chiara,20,0,20,0
1714632009269,LISP 5A,A00,507541,Munoz Sanchez; Alicia,11,0,20,9
1714632010296,LISP 5B,A00,507671,Munoz Sanchez; Alicia,8,0,20,12
1714632011377,LISP 5C,A00,507696,Munoz Sanchez; Alicia,9,0,20,11
1714632012407,MAE 197,001,528363,Boechler; Nicholas Sebastia,9998,0,9999,1
1714632013439,MATH 197,001,523477,Kedlaya; Kiran S.,9995,0,9999,4
1714632013439,MATH 197,002,563811,Zhang; Danna,9995,0,9999,4
1714632013439,MATH 197,003,628552,Dumitriu; Ioana,9998,0,9999,1
1714632014466,MCWP 40R,A00,518780,Staff,2,0,20,18
1714632014466,MCWP 40R,B00,518781,Staff,8,0,20,12
1714632014466,MCWP 40R,C00,518783,Staff,6,0,20,14
1714632015492,MCWP 50R,A00,518791,Staff,0,0,20,20
1714632015492,MCWP 50R,B00,518792,Staff,0,2,20,20
1714632015492,MCWP 50R,C00,518793,Staff,0,2,20,20
1714632015492,MCWP 50R,D00,518794,Staff,0,0,20,20
1714632015492,MCWP 50R,E00,518795,Staff,0,2,20,20
1714632015492,MCWP 50R,F00,518796,Staff,0,0,20,20
1714632015492,MCWP 50R,G00,518797,Staff,0,1,20,20
1714632016518,MMW 12R,A01,514034,Herbst; Matthew,0,0,16,16
1714632016518,MMW 12R,A02,514035,Herbst; Matthew,1,0,16,15
1714632017544,MMW 13R,A01,514037,Staff,0,4,16,16
1714632017544,MMW 13R,A02,514039,Staff,0,2,16,16
1714632017544,MMW 13R,A03,628519,Staff,0,2,16,16
1714632019593,SIO 295LS,A00,523233,Staff,10,0,30,20
1714632020617,SIO 295S,A00,523232,Staff,10,0,30,20
1714632021648,SIOC 290S,A01,637330,Merrifield; Mark A,23,0,30,7
1714632022675,SIOC 291S,A01,637333,Gabriel; Corey John,23,0,30,7
1714632023699,SOCI 117,A01,494376,Staff,0,4,5,5
1714632024724,WES 237B,A00,494380,Staff,9,0,20,11
1714632026796,AESE 279B,A00,494370,Wade; Jon P,0,0,33,33
1714632027821,AIP 197,001,627712,Vespa; Emanuel Ignacio,9998,0,9999,1
1714632028845,ANAR 135S,A00,494369,Braswell; Geoffrey E.,0,0,0,0
1714632029870,BENG 196,001,628496,Engler; Adam J.,9998,0,9999,1
1714632030929,CAT 124RS,A01,519847,Geibel; William,0,0,20,20
1714632031956,CAT 125RS,A01,515971,Geibel; William,0,0,20,20
1714632032983,CLRE 250,A00,511389,Morris; Sheldon,9993,0,9999,6
1714632034009,CLRE 251,A00,507176,Mehta; Ravindra L.,9993,0,9999,6
1714632034009,CLRE 251,B00,511410,Mehta; Ravindra L.,9998,0,9999,1
1714632035038,CLRE 252,A00,507189,Cuomo; Raphael Eduardo,9995,0,9999,4
1714632036067,CLRE 253,A00,507199,Vaida; Florin,9994,0,9999,5
1714632036067,CLRE 253,B00,507202,Vaida; Florin,9999,0,9999,0
1714632037093,CLRE 259,A00,507211,Patel; Hemal,9996,0,9999,3
1714632038120,CLRE 260,A00,507221,Cuomo; Raphael Eduardo,9999,0,9999,0
1714632039146,CLRE 297,001,507242,Cuomo; Raphael Eduardo,9999,0,9999,0
1714632040171,COGS 197,001,638244,Voytek; Bradley Thomas,9998,0,9999,1
1714632041197,CSE 191,A00,516875,Minnes Kemp; Mor Mia,9992,0,9999,7
1714632042226,CSE 197,001,637388,Minnes Kemp; Mor Mia,9998,0,9999,1
1714632043258,CSS 201S,A01,494383,Staff,35,0,35,0
1714632044287,CSS 202S,A01,494387,Staff,35,0,35,0
1714632045315,DSC 197,001,628532,Eldridge; Justin Matthew,9996,0,9999,3
1714632046340,EAP 100,A00,516065,Staff,9797,0,9999,202
1714632047623,ECE 45,A01,507414,Staff,33,0,60,27
1714632049673,ECE 111,A01,507420,Staff,15,0,50,35
1714632050700,ECE 197,001,548057,Sievenpiper; Daniel F.,9993,0,9999,6
1714632051726,EDS 115,A00,507243,Choi; Bailey Miyeon,10,0,28,18
1714632052754,EDS 117,A01,494379,Staff,0,4,30,30
1714632053784,EDS 125,A00,507246,Hopkins; Megan Beth,9,0,30,21
1714632054811,EDS 128A,A01,507264,Fargason; Sharon Gayle,8,0,26,18
1714632055836,EDS 128B,A01,507293,Pappas; Elizabeth,12,0,30,18
1714632056862,EDS 139,A00,507294,Fargason; Sharon Gayle,13,0,30,17
1714632056862,EDS 139,B00,507313,Pappas; Elizabeth,13,0,30,17
1714632057887,EDS 201,A00,507315,Staff,13,0,30,17
1714632058913,EDS 203,A01,507317,Halter; Christopher P.,12,0,30,18
1714632059940,EDS 204R,A01,507319,Halter; Christopher P.,0,3,30,30
1714632059940,EDS 204R,B01,507331,Heinzman; Erica M.,16,0,30,14
1714632060965,EDS 206R,A00,507332,Staff,0,4,30,30
1714632060965,EDS 206R,B00,507343,Staff,17,0,30,13
1714632061991,EDS 250,A00,507344,Hemans; Patricia Ann Benitez,22,0,40,18
1714632063018,EDS 281,A00,507345,Daly; Alan J.,18,0,18,0
1714632064043,EDS 284,A00,507350,Daly; Alan J.,16,0,16,0
1714632065073,EDS 286,A00,507359,Fine; Sarah,18,0,18,0
1714632066099,EDS 289C,A01,507361,Daly; Alan J.,18,0,18,0
1714632067127,EDS 290,A00,507366,Hofstetter; Carolyn,15,0,15,0
1714632068158,LIGM 5A,A00,507421,Fischer-Grunski; Eva K,18,0,20,2
1714632069182,LIGM 5B,A00,507423,Fischer-Grunski; Eva K,19,0,20,1
1714632070208,LIGM 5C,A00,507425,Fischer-Grunski; Eva K,19,0,20,1
1714632071235,LIIT 5AS,A00,507427,Carnelos; Chiara,20,0,20,0
1714632072261,LIIT 5BS,A00,507430,Carnelos; Chiara,20,0,20,0
1714632073291,LIIT 5CS,A00,507432,Carnelos; Chiara,20,0,20,0
1714632074321,LISP 5A,A00,507541,Munoz Sanchez; Alicia,11,0,20,9
1714632075350,LISP 5B,A00,507671,Munoz Sanchez; Alicia,8,0,20,12
1714632076379,LISP 5C,A00,507696,Munoz Sanchez; Alicia,9,0,20,11
1714632077408,MAE 197,001,528363,Boechler; Nicholas Sebastia,9998,0,9999,1
1714632078442,MATH 197,001,523477,Kedlaya; Kiran S.,9995,0,9999,4
1714632078442,MATH 197,002,563811,Zhang; Danna,9995,0,9999,4
1714632078442,MATH 197,003,628552,Dumitriu; Ioana,9998,0,9999,1
1714632079473,MCWP 40R,A00,518780,Staff,2,0,20,18
1714632079473,MCWP 40R,B00,518781,Staff,8,0,20,12
1714632079473,MCWP 40R,C00,518783,Staff,6,0,20,14
1714632080504,MCWP 50R,A00,518791,Staff,0,0,20,20
1714632080504,MCWP 50R,B00,518792,Staff,0,2,20,20
1714632080504,MCWP 50R,C00,518793,Staff,0,2,20,20
1714632080504,MCWP 50R,D00,518794,Staff,0,0,20,20
1714632080504,MCWP 50R,E00,518795,Staff,0,2,20,20
1714632080504,MCWP 50R,F00,518796,Staff,0,0,20,20
1714632080504,MCWP 50R,G00,518797,Staff,0,1,20,20
1714632081529,MMW 12R,A01,514034,Herbst; Matthew,0,0,16,16
1714632081529,MMW 12R,A02,514035,Herbst; Matthew,1,0,16,15
1714632082555,MMW 13R,A01,514037,Staff,0,4,16,16
1714632082555,MMW 13R,A02,514039,Staff,0,2,16,16
1714632082555,MMW 13R,A03,628519,Staff,0,2,16,16
1714632084610,SIO 295LS,A00,523233,Staff,10,0,30,20
1714632085635,SIO 295S,A00,523232,Staff,10,0,30,20
1714632086661,SIOC 290S,A01,637330,Merrifield; Mark A,23,0,30,7
1714632087686,SIOC 291S,A01,637333,Gabriel; Corey John,23,0,30,7
1714632088715,SOCI 117,A01,494376,Staff,0,4,5,5
1714632089745,WES 237B,A00,494380,Staff,9,0,20,11
1714632091827,AESE 279B,A00,494370,Wade; Jon P,0,0,33,33
1714632092851,AIP 197,001,627712,Vespa; Emanuel Ignacio,9998,0,9999,1
1714632093875,ANAR 135S,A00,494369,Braswell; Geoffrey E.,0,0,0,0
1714632094902,BENG 196,001,628496,Engler; Adam J.,9998,0,9999,1
1714632095927,CAT 124RS,A01,519847,Geibel; William,0,0,20,20
1714632096955,CAT 125RS,A01,515971,Geibel; William,0,0,20,20
1714632097980,CLRE 250,A00,511389,Morris; Sheldon,9993,0,9999,6
1714632099012,CLRE 251,A00,507176,Mehta; Ravindra L.,9993,0,9999,6
1714632099012,CLRE 251,B00,511410,Mehta; Ravindra L.,9998,0,9999,1
1714632100039,CLRE 252,A00,507189,Cuomo; Raphael Eduardo,9995,0,9999,4
1714632101066,CLRE 253,A00,507199,Vaida; Florin,9994,0,9999,5
1714632101066,CLRE 253,B00,507202,Vaida; Florin,9999,0,9999,0
1714632102092,CLRE 259,A00,507211,Patel; Hemal,9996,0,9999,3
1714632103120,CLRE 260,A00,507221,Cuomo; Raphael Eduardo,9999,0,9999,0
1714632104147,CLRE 297,001,507242,Cuomo; Raphael Eduardo,9999,0,9999,0
1714632105199,COGS 197,001,638244,Voytek; Bradley Thomas,9998,0,9999,1
1714632106226,CSE 191,A00,516875,Minnes Kemp; Mor Mia,9992,0,9999,7
1714632107254,CSE 197,001,637388,Minnes Kemp; Mor Mia,9998,0,9999,1
1714632108284,CSS 201S,A01,494383,Staff,35,0,35,0
1714632109308,CSS 202S,A01,494387,Staff,35,0,35,0
1714632110335,DSC 197,001,628532,Eldridge; Justin Matthew,9996,0,9999,3
1714632111370,EAP 100,A00,516065,Staff,9797,0,9999,202
1714632112400,ECE 45,A01,507414,Staff,33,0,60,27
1714632114450,ECE 111,A01,507420,Staff,15,0,50,35
1714632115478,ECE 197,001,548057,Sievenpiper; Daniel F.,9993,0,9999,6
1714632116504,EDS 115,A00,507243,Choi; Bailey Miyeon,10,0,28,18
1714632117528,EDS 117,A01,494379,Staff,0,4,30,30
1714632118554,EDS 125,A00,507246,Hopkins; Megan Beth,9,0,30,21
1714632119580,EDS 128A,A01,507264,Fargason; Sharon Gayle,8,0,26,18
1714632120606,EDS 128B,A01,507293,Pappas; Elizabeth,12,0,30,18
1714632121629,EDS 139,A00,507294,Fargason; Sharon Gayle,13,0,30,17
1714632121629,EDS 139,B00,507313,Pappas; Elizabeth,13,0,30,17
1714632122656,EDS 201,A00,507315,Staff,13,0,30,17
1714632123682,EDS 203,A01,507317,Halter; Christopher P.,12,0,30,18
1714632124707,EDS 204R,A01,507319,Halter; Christopher P.,0,3,30,30
1714632124707,EDS 204R,B01,507331,Heinzman; Erica M.,16,0,30,14
1714632125733,EDS 206R,A00,507332,Staff,0,4,30,30
1714632125733,EDS 206R,B00,507343,Staff,17,0,30,13
1714632126760,EDS 250,A00,507344,Hemans; Patricia Ann Benitez,22,0,40,18
1714632127785,EDS 281,A00,507345,Daly; Alan J.,18,0,18,0
1714632128809,EDS 284,A00,507350,Daly; Alan J.,16,0,16,0
1714632129838,EDS 286,A00,507359,Fine; Sarah,18,0,18,0
1714632130862,EDS 289C,A01,507361,Daly; Alan J.,18,0,18,0
1714632131889,EDS 290,A00,507366,Hofstetter; Carolyn,15,0,15,0
1714632132915,LIGM 5A,A00,507421,Fischer-Grunski; Eva K,18,0,20,2
1714632133942,LIGM 5B,A00,507423,Fischer-Grunski; Eva K,19,0,20,1
1714632134969,LIGM 5C,A00,507425,Fischer-Grunski; Eva K,19,0,20,1
1714632136001,LIIT 5AS,A00,507427,Carnelos; Chiara,20,0,20,0
1714632137029,LIIT 5BS,A00,507430,Carnelos; Chiara,20,0,20,0
1714632138057,LIIT 5CS,A00,507432,Carnelos; Chiara,20,0,20,0
1714632139083,LISP 5A,A00,507541,Munoz Sanchez; Alicia,11,0,20,9
1714632140112,LISP 5B,A00,507671,Munoz Sanchez; Alicia,8,0,20,12
1714632141136,LISP 5C,A00,507696,Munoz Sanchez; Alicia,9,0,20,11
1714632142191,MAE 197,001,528363,Boechler; Nicholas Sebastia,9998,0,9999,1
1714632143217,MATH 197,001,523477,Kedlaya; Kiran S.,9995,0,9999,4
1714632143217,MATH 197,002,563811,Zhang; Danna,9995,0,9999,4
1714632143217,MATH 197,003,628552,Dumitriu; Ioana,9998,0,9999,1
1714632144243,MCWP 40R,A00,518780,Staff,2,0,20,18
1714632144243,MCWP 40R,B00,518781,Staff,8,0,20,12
1714632144243,MCWP 40R,C00,518783,Staff,6,0,20,14
1714632145269,MCWP 50R,A00,518791,Staff,0,0,20,20
1714632145269,MCWP 50R,B00,518792,Staff,0,2,20,20
1714632145269,MCWP 50R,C00,518793,Staff,0,2,20,20
1714632145269,MCWP 50R,D00,518794,Staff,0,0,20,20
1714632145269,MCWP 50R,E00,518795,Staff,0,2,20,20
1714632145269,MCWP 50R,F00,518796,Staff,0,0,20,20
1714632145269,MCWP 50R,G00,518797,Staff,0,1,20,20
1714632146292,MMW 12R,A01,514034,Herbst; Matthew,0,0,16,16
1714632146292,MMW 12R,A02,514035,Herbst; Matthew,1,0,16,15
1714632147319,MMW 13R,A01,514037,Staff,0,4,16,16
1714632147319,MMW 13R,A02,514039,Staff,0,2,16,16
1714632147319,MMW 13R,A03,628519,Staff,0,2,16,16
1714632149368,SIO 295LS,A00,523233,Staff,10,0,30,20
1714632150395,SIO 295S,A00,523232,Staff,10,0,30,20
1714632151420,SIOC 290S,A01,637330,Merrifield; Mark A,23,0,30,7
1714632152450,SIOC 291S,A01,637333,Gabriel; Corey John,23,0,30,7
1714632153475,SOCI 117,A01,494376,Staff,0,4,5,5
1714632154502,WES 237B,A00,494380,Staff,9,0,20,11
1714632156577,AESE 279B,A00,494370,Wade; Jon P,0,0,33,33
1714632157604,AIP 197,001,627712,Vespa; Emanuel Ignacio,9998,0,9999,1
1714632158631,ANAR 135S,A00,494369,Braswell; Geoffrey E.,0,0,0,0
1714632159658,BENG 196,001,628496,Engler; Adam J.,9998,0,9999,1
1714632160687,CAT 124RS,A01,519847,Geibel; William,0,0,20,20
1714632161713,CAT 125RS,A01,515971,Geibel; William,0,0,20,20
1714632162742,CLRE 250,A00,511389,Morris; Sheldon,9993,0,9999,6
1714632163772,CLRE 251,A00,507176,Mehta; Ravindra L.,9993,0,9999,6
1714632163772,CLRE 251,B00,511410,Mehta; Ravindra L.,9998,0,9999,1
1714632164797,CLRE 252,A00,507189,Cuomo; Raphael Eduardo,9995,0,9999,4
1714632165822,CLRE 253,A00,507199,Vaida; Florin,9994,0,9999,5
1714632165822,CLRE 253,B00,507202,Vaida; Florin,9999,0,9999,0
1714632166853,CLRE 259,A00,507211,Patel; Hemal,9996,0,9999,3
1714632167878,CLRE 260,A00,507221,Cuomo; Raphael Eduardo,9999,0,9999,0
1714632168904,CLRE 297,001,507242,Cuomo; Raphael Eduardo,9999,0,9999,0
1714632169934,COGS 197,001,638244,Voytek; Bradley Thomas,9998,0,9999,1
1714632170958,CSE 191,A00,516875,Minnes Kemp; Mor Mia,9992,0,9999,7
1714632171983,CSE 197,001,637388,Minnes Kemp; Mor Mia,9998,0,9999,1
1714632173012,CSS 201S,A01,494383,Staff,35,0,35,0
1714632174036,CSS 202S,A01,494387,Staff,35,0,35,0
1714632175060,DSC 197,001,628532,Eldridge; Justin Matthew,9996,0,9999,3
1714632176092,EAP 100,A00,516065,Staff,9797,0,9999,202
1714632177122,ECE 45,A01,507414,Staff,33,0,60,27
1714632179172,ECE 111,A01,507420,Staff,15,0,50,35
1714632180210,ECE 197,001,548057,Sievenpiper; Daniel F.,9993,0,9999,6
1714632181236,EDS 115,A00,507243,Choi; Bailey Miyeon,10,0,28,18
1714632182264,EDS 117,A01,494379,Staff,0,4,30,30
1714632183295,EDS 125,A00,507246,Hopkins; Megan Beth,9,0,30,21
1714632184324,EDS 128A,A01,507264,Fargason; Sharon Gayle,8,0,26,18
1714632185353,EDS 128B,A01,507293,Pappas; Elizabeth,12,0,30,18
1714632186381,EDS 139,A00,507294,Fargason; Sharon Gayle,13,0,30,17
1714632186381,EDS 139,B00,507313,Pappas; Elizabeth,13,0,30,17
1714632187405,EDS 201,A00,507315,Staff,13,0,30,17
1714632188434,EDS 203,A01,507317,Halter; Christopher P.,12,0,30,18
1714632189458,EDS 204R,A01,507319,Halter; Christopher P.,0,3,30,30
1714632189458,EDS 204R,B01,507331,Heinzman; Erica M.,16,0,30,14
1714632190486,EDS 206R,A00,507332,Staff,0,4,30,30
1714632190486,EDS 206R,B00,507343,Staff,17,0,30,13
1714632191512,EDS 250,A00,507344,Hemans; Patricia Ann Benitez,22,0,40,18
1714632192535,EDS 281,A00,507345,Daly; Alan J.,18,0,18,0
1714632193565,EDS 284,A00,507350,Daly; Alan J.,16,0,16,0
1714632194590,EDS 286,A00,507359,Fine; Sarah,18,0,18,0
1714632195617,EDS 289C,A01,507361,Daly; Alan J.,18,0,18,0
1714632196642,EDS 290,A00,507366,Hofstetter; Carolyn,15,0,15,0
1714632197674,LIGM 5A,A00,507421,Fischer-Grunski; Eva K,18,0,20,2
1714632198701,LIGM 5B,A00,507423,Fischer-Grunski; Eva K,19,0,20,1
1714632199730,LIGM 5C,A00,507425,Fischer-Grunski; Eva K,19,0,20,1
1714632200756,LIIT 5AS,A00,507427,Carnelos; Chiara,20,0,20,0
1714632201783,LIIT 5BS,A00,507430,Carnelos; Chiara,20,0,20,0
1714632202809,LIIT 5CS,A00,507432,Carnelos; Chiara,20,0,20,0
1714632203837,LISP 5A,A00,507541,Munoz Sanchez; Alicia,11,0,20,9
1714632204862,LISP 5B,A00,507671,Munoz Sanchez; Alicia,8,0,20,12
1714632205892,LISP 5C,A00,507696,Munoz Sanchez; Alicia,9,0,20,11
1714632206921,MAE 197,001,528363,Boechler; Nicholas Sebastia,9998,0,9999,1
1714632207948,MATH 197,001,523477,Kedlaya; Kiran S.,9995,0,9999,4
1714632207948,MATH 197,002,563811,Zhang; Danna,9995,0,9999,4
1714632207948,MATH 197,003,628552,Dumitriu; Ioana,9998,0,9999,1
1714632208974,MCWP 40R,A00,518780,Staff,2,0,20,18
1714632208974,MCWP 40R,B00,518781,Staff,8,0,20,12
1714632208974,MCWP 40R,C00,518783,Staff,6,0,20,14
1714632210003,MCWP 50R,A00,518791,Staff,0,0,20,20
1714632210003,MCWP 50R,B00,518792,Staff,0,2,20,20
1714632210003,MCWP 50R,C00,518793,Staff,0,2,20,20
1714632210003,MCWP 50R,D00,518794,Staff,0,0,20,20
1714632210003,MCWP 50R,E00,518795,Staff,0,2,20,20
1714632210003,MCWP 50R,F00,518796,Staff,0,0,20,20
1714632210003,MCWP 50R,G00,518797,Staff,0,1,20,20
1714632211032,MMW 12R,A01,514034,Herbst; Matthew,0,0,16,16
1714632211032,MMW 12R,A02,514035,Herbst; Matthew,1,0,16,15
1714632212056,MMW 13R,A01,514037,Staff,0,4,16,16
1714632212056,MMW 13R,A02,514039,Staff,0,2,16,16
1714632212056,MMW 13R,A03,628519,Staff,0,2,16,16
1714632214106,SIO 295LS,A00,523233,Staff,10,0,30,20
1714632215132,SIO 295S,A00,523232,Staff,10,0,30,20
1714632216160,SIOC 290S,A01,637330,Merrifield; Mark A,23,0,30,7
1714632217191,SIOC 291S,A01,637333,Gabriel; Corey John,23,0,30,7
1714632218219,SOCI 117,A01,494376,Staff,0,4,5,5
1714632219243,WES 237B,A00,494380,Staff,9,0,20,11
1714632221327,AESE 279B,A00,494370,Wade; Jon P,0,0,33,33
1714632222351,AIP 197,001,627712,Vespa; Emanuel Ignacio,9998,0,9999,1
1714632223374,ANAR 135S,A00,494369,Braswell; Geoffrey E.,0,0,0,0
1714632224400,BENG 196,001,628496,Engler; Adam J.,9998,0,9999,1
1714632225427,CAT 124RS,A01,519847,Geibel; William,0,0,20,20
1714632226452,CAT 125RS,A01,515971,Geibel; William,0,0,20,20
1714632227481,CLRE 250,A00,511389,Morris; Sheldon,9993,0,9999,6
1714632228509,CLRE 251,A00,507176,Mehta; Ravindra L.,9993,0,9999,6
1714632228509,CLRE 251,B00,511410,Mehta; Ravindra L.,9998,0,9999,1
1714632229534,CLRE 252,A00,507189,Cuomo; Raphael Eduardo,9995,0,9999,4
1714632230558,CLRE 253,A00,507199,Vaida; Florin,9994,0,9999,5
1714632230558,CLRE 253,B00,507202,Vaida; Florin,9999,0,9999,0
1714632231583,CLRE 259,A00,507211,Patel; Hemal,9996,0,9999,3
1714632232608,CLRE 260,A00,507221,Cuomo; Raphael Eduardo,9999,0,9999,0
1714632233636,CLRE 297,001,507242,Cuomo; Raphael Eduardo,9999,0,9999,0
1714632234664,COGS 197,001,638244,Voytek; Bradley Thomas,9998,0,9999,1
1714632235688,CSE 191,A00,516875,Minnes Kemp; Mor Mia,9992,0,9999,7
1714632236716,CSE 197,001,637388,Minnes Kemp; Mor Mia,9998,0,9999,1
1714632237743,CSS 201S,A01,494383,Staff,35,0,35,0
1714632238773,CSS 202S,A01,494387,Staff,35,0,35,0
1714632239799,DSC 197,001,628532,Eldridge; Justin Matthew,9996,0,9999,3
1714632240827,EAP 100,A00,516065,Staff,9797,0,9999,202
1714632241857,ECE 45,A01,507414,Staff,33,0,60,27
1714632243938,ECE 111,A01,507420,Staff,15,0,50,35
1714632244962,ECE 197,001,548057,Sievenpiper; Daniel F.,9993,0,9999,6
1714632245986,EDS 115,A00,507243,Choi; Bailey Miyeon,10,0,28,18
1714632247013,EDS 117,A01,494379,Staff,0,4,30,30
1714632248039,EDS 125,A00,507246,Hopkins; Megan Beth,9,0,30,21
1714632249064,EDS 128A,A01,507264,Fargason; Sharon Gayle,8,0,26,18
1714632250089,EDS 128B,A01,507293,Pappas; Elizabeth,12,0,30,18
1714632251114,EDS 139,A00,507294,Fargason; Sharon Gayle,13,0,30,17
1714632251114,EDS 139,B00,507313,Pappas; Elizabeth,13,0,30,17
1714632252138,EDS 201,A00,507315,Staff,13,0,30,17
1714632253163,EDS 203,A01,507317,Halter; Christopher P.,12,0,30,18
1714632254189,EDS 204R,A01,507319,Halter; Christopher P.,0,3,30,30
1714632254189,EDS 204R,B01,507331,Heinzman; Erica M.,16,0,30,14
1714632255213,EDS 206R,A00,507332,Staff,0,4,30,30
1714632255213,EDS 206R,B00,507343,Staff,17,0,30,13
1714632256241,EDS 250,A00,507344,Hemans; Patricia Ann Benitez,22,0,40,18
1714632257267,EDS 281,A00,507345,Daly; Alan J.,18,0,18,0
1714632258292,EDS 284,A00,507350,Daly; Alan J.,16,0,16,0
1714632259318,EDS 286,A00,507359,Fine; Sarah,18,0,18,0
1714632260344,EDS 289C,A01,507361,Daly; Alan J.,18,0,18,0
1714632261369,EDS 290,A00,507366,Hofstetter; Carolyn,15,0,15,0
1714632262395,LIGM 5A,A00,507421,Fischer-Grunski; Eva K,18,0,20,2
1714632263418,LIGM 5B,A00,507423,Fischer-Grunski; Eva K,19,0,20,1
1714632264445,LIGM 5C,A00,507425,Fischer-Grunski; Eva K,19,0,20,1
1714632265476,LIIT 5AS,A00,507427,Carnelos; Chiara,20,0,20,0
1714632266504,LIIT 5BS,A00,507430,Carnelos; Chiara,20,0,20,0
1714632267534,LIIT 5CS,A00,507432,Carnelos; Chiara,20,0,20,0
1714632268560,LISP 5A,A00,507541,Munoz Sanchez; Alicia,11,0,20,9
1714632269590,LISP 5B,A00,507671,Munoz Sanchez; Alicia,8,0,20,12
1714632270616,LISP 5C,A00,507696,Munoz Sanchez; Alicia,9,0,20,11
1714632271647,MAE 197,001,528363,Boechler; Nicholas Sebastia,9998,0,9999,1
1714632272675,MATH 197,001,523477,Kedlaya; Kiran S.,9995,0,9999,4
1714632272675,MATH 197,002,563811,Zhang; Danna,9995,0,9999,4
1714632272675,MATH 197,003,628552,Dumitriu; Ioana,9998,0,9999,1
1714632273705,MCWP 40R,A00,518780,Staff,2,0,20,18
1714632273705,MCWP 40R,B00,518781,Staff,8,0,20,12
1714632273705,MCWP 40R,C00,518783,Staff,6,0,20,14
1714632274731,MCWP 50R,A00,518791,Staff,0,0,20,20
1714632274731,MCWP 50R,B00,518792,Staff,0,2,20,20
1714632274731,MCWP 50R,C00,518793,Staff,0,2,20,20
1714632274731,MCWP 50R,D00,518794,Staff,0,0,20,20
1714632274731,MCWP 50R,E00,518795,Staff,0,2,20,20
1714632274731,MCWP 50R,F00,518796,Staff,0,0,20,20
1714632274731,MCWP 50R,G00,518797,Staff,0,1,20,20
1714632275757,MMW 12R,A01,514034,Herbst; Matthew,0,0,16,16
1714632275757,MMW 12R,A02,514035,Herbst; Matthew,1,0,16,15
1714632276788,MMW 13R,A01,514037,Staff,0,4,16,16
1714632276788,MMW 13R,A02,514039,Staff,0,2,16,16
1714632276788,MMW 13R,A03,628519,Staff,0,2,16,16
1714632278841,SIO 295LS,A00,523233,Staff,10,0,30,20
1714632279869,SIO 295S,A00,523232,Staff,10,0,30,20
1714632280896,SIOC 290S,A01,637330,Merrifield; Mark A,23,0,30,7
1714632281929,SIOC 291S,A01,637333,Gabriel; Corey John,23,0,30,7
1714632282954,SOCI 117,A01,494376,Staff,0,4,5,5
1714632283983,WES 237B,A00,494380,Staff,9,0,20,11
1714632286070,AESE 279B,A00,494370,Wade; Jon P,0,0,33,33
1714632287100,AIP 197,001,627712,Vespa; Emanuel Ignacio,9998,0,9999,1
1714632288128,ANAR 135S,A00,494369,Braswell; Geoffrey E.,0,0,0,0
1714632289214,BENG 196,001,628496,Engler; Adam J.,9998,0,9999,1
1714632290244,CAT 124RS,A01,519847,Geibel; William,0,0,20,20
1714632291270,CAT 125RS,A01,515971,Geibel; William,0,0,20,20
1714632292298,CLRE 250,A00,511389,Morris; Sheldon,9993,0,9999,6
1714632293326,CLRE 251,A00,507176,Mehta; Ravindra L.,9993,0,9999,6
1714632293326,CLRE 251,B00,511410,Mehta; Ravindra L.,9998,0,9999,1
1714632294357,CLRE 252,A00,507189,Cuomo; Raphael Eduardo,9995,0,9999,4
1714632295391,CLRE 253,A00,507199,Vaida; Florin,9994,0,9999,5
1714632295391,CLRE 253,B00,507202,Vaida; Florin,9999,0,9999,0
1714632296421,CLRE 259,A00,507211,Patel; Hemal,9996,0,9999,3
1714632297446,CLRE 260,A00,507221,Cuomo; Raphael Eduardo,9999,0,9999,0
1714632298471,CLRE 297,001,507242,Cuomo; Raphael Eduardo,9999,0,9999,0
1714632299497,COGS 197,001,638244,Voytek; Bradley Thomas,9998,0,9999,1
1714632300523,CSE 191,A00,516875,Minnes Kemp; Mor Mia,9992,0,9999,7
1714632301552,CSE 197,001,637388,Minnes Kemp; Mor Mia,9998,0,9999,1
1714632302578,CSS 201S,A01,494383,Staff,35,0,35,0
1714632303606,CSS 202S,A01,494387,Staff,35,0,35,0
1714632304632,DSC 197,001,628532,Eldridge; Justin Matthew,9996,0,9999,3
1714632305658,EAP 100,A00,516065,Staff,9797,0,9999,202
1714632306684,ECE 45,A01,507414,Staff,33,0,60,27
1714632308738,ECE 111,A01,507420,Staff,15,0,50,35
1714632309766,ECE 197,001,548057,Sievenpiper; Daniel F.,9993,0,9999,6
1714632310797,EDS 115,A00,507243,Choi; Bailey Miyeon,10,0,28,18
1714632311827,EDS 117,A01,494379,Staff,0,4,30,30
1714632312859,EDS 125,A00,507246,Hopkins; Megan Beth,9,0,30,21
1714632313901,EDS 128A,A01,507264,Fargason; Sharon Gayle,8,0,26,18
1714632314927,EDS 128B,A01,507293,Pappas; Elizabeth,12,0,30,18
1714632315951,EDS 139,A00,507294,Fargason; Sharon Gayle,13,0,30,17
1714632315951,EDS 139,B00,507313,Pappas; Elizabeth,13,0,30,17
1714632316976,EDS 201,A00,507315,Staff,13,0,30,17
1714632318002,EDS 203,A01,507317,Halter; Christopher P.,12,0,30,18
1714632319029,EDS 204R,A01,507319,Halter; Christopher P.,0,3,30,30
1714632319029,EDS 204R,B01,507331,Heinzman; Erica M.,16,0,30,14
1714632320053,EDS 206R,A00,507332,Staff,0,4,30,30
1714632320053,EDS 206R,B00,507343,Staff,17,0,30,13
1714632321078,EDS 250,A00,507344,Hemans; Patricia Ann Benitez,22,0,40,18
1714632322109,EDS 281,A00,507345,Daly; Alan J.,18,0,18,0
1714632323134,EDS 284,A00,507350,Daly; Alan J.,16,0,16,0
1714632324162,EDS 286,A00,507359,Fine; Sarah,18,0,18,0
1714632325186,EDS 289C,A01,507361,Daly; Alan J.,18,0,18,0
1714632326215,EDS 290,A00,507366,Hofstetter; Carolyn,15,0,15,0
1714632327239,LIGM 5A,A00,507421,Fischer-Grunski; Eva K,18,0,20,2
1714632328269,LIGM 5B,A00,507423,Fischer-Grunski; Eva K,19,0,20,1
1714632329295,LIGM 5C,A00,507425,Fischer-Grunski; Eva K,19,0,20,1
1714632330320,LIIT 5AS,A00,507427,Carnelos; Chiara,20,0,20,0
1714632331347,LIIT 5BS,A00,507430,Carnelos; Chiara,20,0,20,0
1714632332373,LIIT 5CS,A00,507432,Carnelos; Chiara,20,0,20,0
1714632333399,LISP 5A,A00,507541,Munoz Sanchez; Alicia,11,0,20,9
1714632334425,LISP 5B,A00,507671,Munoz Sanchez; Alicia,8,0,20,12
1714632335453,LISP 5C,A00,507696,Munoz Sanchez; Alicia,9,0,20,11
1714632336484,MAE 197,001,528363,Boechler; Nicholas Sebastia,9998,0,9999,1
1714632337518,MATH 197,001,523477,Kedlaya; Kiran S.,9995,0,9999,4
1714632337518,MATH 197,002,563811,Zhang; Danna,9995,0,9999,4
1714632337518,MATH 197,003,628552,Dumitriu; Ioana,9998,0,9999,1
1714632338548,MCWP 40R,A00,518780,Staff,2,0,20,18
1714632338548,MCWP 40R,B00,518781,Staff,8,0,20,12
1714632338548,MCWP 40R,C00,518783,Staff,6,0,20,14
1714632339575,MCWP 50R,A00,518791,Staff,0,0,20,20
1714632339575,MCWP 50R,B00,518792,Staff,0,2,20,20
1714632339575,MCWP 50R,C00,518793,Staff,0,2,20,20
1714632339575,MCWP 50R,D00,518794,Staff,0,0,20,20
1714632339575,MCWP 50R,E00,518795,Staff,0,2,20,20
1714632339575,MCWP 50R,F00,518796,Staff,0,0,20,20
1714632339575,MCWP 50R,G00,518797,Staff,0,1,20,20
1714632340600,MMW 12R,A01,514034,Herbst; Matthew,0,0,16,16
1714632340600,MMW 12R,A02,514035,Herbst; Matthew,1,0,16,15
1714632341631,MMW 13R,A01,514037,Staff,0,4,16,16
1714632341631,MMW 13R,A02,514039,Staff,0,2,16,16
1714632341631,MMW 13R,A03,628519,Staff,0,2,16,16
1714632343682,SIO 295LS,A00,523233,Staff,10,0,30,20
1714632344710,SIO 295S,A00,523232,Staff,10,0,30,20
1714632345737,SIOC 290S,A01,637330,Merrifield; Mark A,23,0,30,7
1714632346763,SIOC 291S,A01,637333,Gabriel; Corey John,23,0,30,7
1714632347788,SOCI 117,A01,494376,Staff,0,4,5,5
1714632348812,WES 237B,A00,494380,Staff,9,0,20,11
1714632350893,AESE 279B,A00,494370,Wade; Jon P,0,0,33,33
1714632351921,AIP 197,001,627712,Vespa; Emanuel Ignacio,9998,0,9999,1
1714632352946,ANAR 135S,A00,494369,Braswell; Geoffrey E.,0,0,0,0
1714632353972,BENG 196,001,628496,Engler; Adam J.,9998,0,9999,1
1714632355001,CAT 124RS,A01,519847,Geibel; William,0,0,20,20
1714632356027,CAT 125RS,A01,515971,Geibel; William,0,0,20,20
1714632357053,CLRE 250,A00,511389,Morris; Sheldon,9993,0,9999,6
1714632358161,CLRE 251,A00,507176,Mehta; Ravindra L.,9993,0,9999,6
1714632358161,CLRE 251,B00,511410,Mehta; Ravindra L.,9998,0,9999,1
1714632359187,CLRE 252,A00,507189,Cuomo; Raphael Eduardo,9995,0,9999,4
1714632360213,CLRE 253,A00,507199,Vaida; Florin,9994,0,9999,5
1714632360213,CLRE 253,B00,507202,Vaida; Florin,9999,0,9999,0
1714632361239,CLRE 259,A00,507211,Patel; Hemal,9996,0,9999,3
1714632362268,CLRE 260,A00,507221,Cuomo; Raphael Eduardo,9999,0,9999,0
1714632363292,CLRE 297,001,507242,Cuomo; Raphael Eduardo,9999,0,9999,0
1714632364321,COGS 197,001,638244,Voytek; Bradley Thomas,9998,0,9999,1
1714632365349,CSE 191,A00,516875,Minnes Kemp; Mor Mia,9992,0,9999,7
1714632366374,CSE 197,001,637388,Minnes Kemp; Mor Mia,9998,0,9999,1
1714632367399,CSS 201S,A01,494383,Staff,35,0,35,0
1714632368424,CSS 202S,A01,494387,Staff,35,0,35,0
1714632369451,DSC 197,001,628532,Eldridge; Justin Matthew,9996,0,9999,3
1714632370480,EAP 100,A00,516065,Staff,9797,0,9999,202
1714632371506,ECE 45,A01,507414,Staff,33,0,60,27
1714632373554,ECE 111,A01,507420,Staff,15,0,50,35
1714632374583,ECE 197,001,548057,Sievenpiper; Daniel F.,9993,0,9999,6
1714632375610,EDS 115,A00,507243,Choi; Bailey Miyeon,10,0,28,18
1714632376638,EDS 117,A01,494379,Staff,0,4,30,30
1714632377714,EDS 125,A00,507246,Hopkins; Megan Beth,9,0,30,21
1714632378794,EDS 128A,A01,507264,Fargason; Sharon Gayle,8,0,26,18
1714632379819,EDS 128B,A01,507293,Pappas; Elizabeth,12,0,30,18
1714632380846,EDS 139,A00,507294,Fargason; Sharon Gayle,13,0,30,17
1714632380846,EDS 139,B00,507313,Pappas; Elizabeth,13,0,30,17
1714632381874,EDS 201,A00,507315,Staff,13,0,30,17
1714632382899,EDS 203,A01,507317,Halter; Christopher P.,12,0,30,18
1714632383927,EDS 204R,A01,507319,Halter; Christopher P.,0,3,30,30
1714632383927,EDS 204R,B01,507331,Heinzman; Erica M.,16,0,30,14
1714632384956,EDS 206R,A00,507332,Staff,0,4,30,30
1714632384956,EDS 206R,B00,507343,Staff,17,0,30,13
1714632385983,EDS 250,A00,507344,Hemans; Patricia Ann Benitez,22,0,40,18
1714632387014,EDS 281,A00,507345,Daly; Alan J.,18,0,18,0
1714632388036,EDS 284,A00,507350,Daly; Alan J.,16,0,16,0
1714632389067,EDS 286,A00,507359,Fine; Sarah,18,0,18,0
1714632390091,EDS 289C,A01,507361,Daly; Alan J.,18,0,18,0
1714632391116,EDS 290,A00,507366,Hofstetter; Carolyn,15,0,15,0
1714632392149,LIGM 5A,A00,507421,Fischer-Grunski; Eva K,18,0,20,2
1714632393175,LIGM 5B,A00,507423,Fischer-Grunski; Eva K,19,0,20,1
1714632394202,LIGM 5C,A00,507425,Fischer-Grunski; Eva K,19,0,20,1
1714632395231,LIIT 5AS,A00,507427,Carnelos; Chiara,20,0,20,0
1714632396256,LIIT 5BS,A00,507430,Carnelos; Chiara,20,0,20,0
1714632397279,LIIT 5CS,A00,507432,Carnelos; Chiara,20,0,20,0
1714632398308,LISP 5A,A00,507541,Munoz Sanchez; Alicia,11,0,20,9
1714632399334,LISP 5B,A00,507671,Munoz Sanchez; Alicia,8,0,20,12
1714632400361,LISP 5C,A00,507696,Munoz Sanchez; Alicia,9,0,20,11
1714632401388,MAE 197,001,528363,Boechler; Nicholas Sebastia,9998,0,9999,1
1714632402419,MATH 197,001,523477,Kedlaya; Kiran S.,9995,0,9999,4
1714632402419,MATH 197,002,563811,Zhang; Danna,9995,0,9999,4
1714632402419,MATH 197,003,628552,Dumitriu; Ioana,9998,0,9999,1
1714632403442,MCWP 40R,A00,518780,Staff,2,0,20,18
1714632403442,MCWP 40R,B00,518781,Staff,8,0,20,12
1714632403442,MCWP 40R,C00,518783,Staff,6,0,20,14
1714632404468,MCWP 50R,A00,518791,Staff,0,0,20,20
1714632404468,MCWP 50R,B00,518792,Staff,0,2,20,20
1714632404468,MCWP 50R,C00,518793,Staff,0,2,20,20
1714632404468,MCWP 50R,D00,518794,Staff,0,0,20,20
1714632404468,MCWP 50R,E00,518795,Staff,0,2,20,20
1714632404468,MCWP 50R,F00,518796,Staff,0,0,20,20
1714632404468,MCWP 50R,G00,518797,Staff,0,1,20,20
1714632405497,MMW 12R,A01,514034,Herbst; Matthew,0,0,16,16
1714632405497,MMW 12R,A02,514035,Herbst; Matthew,1,0,16,15
1714632406520,MMW 13R,A01,514037,Staff,0,4,16,16
1714632406520,MMW 13R,A02,514039,Staff,0,2,16,16
1714632406520,MMW 13R,A03,628519,Staff,0,2,16,16
1714632408574,SIO 295LS,A00,523233,Staff,10,0,30,20
1714632409599,SIO 295S,A00,523232,Staff,10,0,30,20
1714632410625,SIOC 290S,A01,637330,Merrifield; Mark A,23,0,30,7
1714632411652,SIOC 291S,A01,637333,Gabriel; Corey John,23,0,30,7
1714632412678,SOCI 117,A01,494376,Staff,0,4,5,5
1714632413705,WES 237B,A00,494380,Staff,9,0,20,11
1714632415773,AESE 279B,A00,494370,Wade; Jon P,0,0,33,33
1714632416798,AIP 197,001,627712,Vespa; Emanuel Ignacio,9998,0,9999,1
1714632417826,ANAR 135S,A00,494369,Braswell; Geoffrey E.,0,0,0,0
1714632418854,BENG 196,001,628496,Engler; Adam J.,9998,0,9999,1
1714632419879,CAT 124RS,A01,519847,Geibel; William,0,0,20,20
1714632420906,CAT 125RS,A01,515971,Geibel; William,0,0,20,20
1714632421933,CLRE 250,A00,511389,Morris; Sheldon,9993,0,9999,6
1714632422958,CLRE 251,A00,507176,Mehta; Ravindra L.,9993,0,9999,6
1714632422958,CLRE 251,B00,511410,Mehta; Ravindra L.,9998,0,9999,1
1714632423987,CLRE 252,A00,507189,Cuomo; Raphael Eduardo,9995,0,9999,4
1714632425016,CLRE 253,A00,507199,Vaida; Florin,9994,0,9999,5
1714632425016,CLRE 253,B00,507202,Vaida; Florin,9999,0,9999,0
1714632426041,CLRE 259,A00,507211,Patel; Hemal,9996,0,9999,3
1714632427067,CLRE 260,A00,507221,Cuomo; Raphael Eduardo,9999,0,9999,0
1714632428091,CLRE 297,001,507242,Cuomo; Raphael Eduardo,9999,0,9999,0
1714632429116,COGS 197,001,638244,Voytek; Bradley Thomas,9998,0,9999,1
1714632430145,CSE 191,A00,516875,Minnes Kemp; Mor Mia,9992,0,9999,7
1714632431172,CSE 197,001,637388,Minnes Kemp; Mor Mia,9998,0,9999,1
1714632432197,CSS 201S,A01,494383,Staff,35,0,35,0
1714632433226,CSS 202S,A01,494387,Staff,35,0,35,0
1714632434250,DSC 197,001,628532,Eldridge; Justin Matthew,9996,0,9999,3
1714632435274,EAP 100,A00,516065,Staff,9797,0,9999,202
1714632436304,ECE 45,A01,507414,Staff,33,0,60,27
1714632438354,ECE 111,A01,507420,Staff,15,0,50,35
1714632439378,ECE 197,001,548057,Sievenpiper; Daniel F.,9993,0,9999,6
1714632440406,EDS 115,A00,507243,Choi; Bailey Miyeon,10,0,28,18
1714632441436,EDS 117,A01,494379,Staff,0,4,30,30
1714632442461,EDS 125,A00,507246,Hopkins; Megan Beth,9,0,30,21
1714632443487,EDS 128A,A01,507264,Fargason; Sharon Gayle,8,0,26,18
1714632444515,EDS 128B,A01,507293,Pappas; Elizabeth,12,0,30,18
1714632445540,EDS 139,A00,507294,Fargason; Sharon Gayle,13,0,30,17
1714632445540,EDS 139,B00,507313,Pappas; Elizabeth,13,0,30,17
1714632446564,EDS 201,A00,507315,Staff,13,0,30,17
1714632447588,EDS 203,A01,507317,Halter; Christopher P.,12,0,30,18
1714632448612,EDS 204R,A01,507319,Halter; Christopher P.,0,3,30,30
1714632448612,EDS 204R,B01,507331,Heinzman; Erica M.,16,0,30,14
1714632449638,EDS 206R,A00,507332,Staff,0,4,30,30
1714632449638,EDS 206R,B00,507343,Staff,17,0,30,13
1714632450663,EDS 250,A00,507344,Hemans; Patricia Ann Benitez,22,0,40,18
1714632451687,EDS 281,A00,507345,Daly; Alan J.,18,0,18,0
1714632452718,EDS 284,A00,507350,Daly; Alan J.,16,0,16,0
1714632453745,EDS 286,A00,507359,Fine; Sarah,18,0,18,0
1714632454773,EDS 289C,A01,507361,Daly; Alan J.,18,0,18,0
1714632455803,EDS 290,A00,507366,Hofstetter; Carolyn,15,0,15,0
1714632456834,LIGM 5A,A00,507421,Fischer-Grunski; Eva K,18,0,20,2
1714632457859,LIGM 5B,A00,507423,Fischer-Grunski; Eva K,19,0,20,1
1714632458883,LIGM 5C,A00,507425,Fischer-Grunski; Eva K,19,0,20,1
1714632459908,LIIT 5AS,A00,507427,Carnelos; Chiara,20,0,20,0
1714632460931,LIIT 5BS,A00,507430,Carnelos; Chiara,20,0,20,0
1714632461955,LIIT 5CS,A00,507432,Carnelos; Chiara,20,0,20,0
1714632462980,LISP 5A,A00,507541,Munoz Sanchez; Alicia,11,0,20,9
1714632464006,LISP 5B,A00,507671,Munoz Sanchez; Alicia,8,0,20,12
1714632465036,LISP 5C,A00,507696,Munoz Sanchez; Alicia,9,0,20,11
1714632466065,MAE 197,001,528363,Boechler; Nicholas Sebastia,9998,0,9999,1
1714632467098,MATH 197,001,523477,Kedlaya; Kiran S.,9995,0,9999,4
1714632467098,MATH 197,002,563811,Zhang; Danna,9995,0,9999,4
1714632467098,MATH 197,003,628552,Dumitriu; Ioana,9998,0,9999,1
1714632468123,MCWP 40R,A00,518780,Staff,2,0,20,18
1714632468123,MCWP 40R,B00,518781,Staff,8,0,20,12
1714632468123,MCWP 40R,C00,518783,Staff,6,0,20,14
1714632469151,MCWP 50R,A00,518791,Staff,0,0,20,20
1714632469151,MCWP 50R,B00,518792,Staff,0,2,20,20
1714632469151,MCWP 50R,C00,518793,Staff,0,2,20,20
1714632469151,MCWP 50R,D00,518794,Staff,0,0,20,20
1714632469151,MCWP 50R,E00,518795,Staff,0,2,20,20
1714632469151,MCWP 50R,F00,518796,Staff,0,0,20,20
1714632469151,MCWP 50R,G00,518797,Staff,0,1,20,20
1714632470179,MMW 12R,A01,514034,Herbst; Matthew,0,0,16,16
1714632470179,MMW 12R,A02,514035,Herbst; Matthew,1,0,16,15
1714632471204,MMW 13R,A01,514037,Staff,0,4,16,16
1714632471204,MMW 13R,A02,514039,Staff,0,2,16,16
1714632471204,MMW 13R,A03,628519,Staff,0,2,16,16
1714632473260,SIO 295LS,A00,523233,Staff,10,0,30,20
1714632474284,SIO 295S,A00,523232,Staff,10,0,30,20
1714632475315,SIOC 290S,A01,637330,Merrifield; Mark A,23,0,30,7
1714632476340,SIOC 291S,A01,637333,Gabriel; Corey John,23,0,30,7
1714632477366,SOCI 117,A01,494376,Staff,0,4,5,5
1714632478395,WES 237B,A00,494380,Staff,9,0,20,11
1714632480486,AESE 279B,A00,494370,Wade; Jon P,0,0,33,33
1714632481510,AIP 197,001,627712,Vespa; Emanuel Ignacio,9998,0,9999,1
1714632482592,ANAR 135S,A00,494369,Braswell; Geoffrey E.,0,0,0,0
1714632483618,BENG 196,001,628496,Engler; Adam J.,9998,0,9999,1
1714632484646,CAT 124RS,A01,519847,Geibel; William,0,0,20,20
1714632485671,CAT 125RS,A01,515971,Geibel; William,0,0,20,20
1714632486707,CLRE 250,A00,511389,Morris; Sheldon,9993,0,9999,6
1714632487734,CLRE 251,A00,507176,Mehta; Ravindra L.,9993,0,9999,6
1714632487734,CLRE 251,B00,511410,Mehta; Ravindra L.,9998,0,9999,1
1714632488760,CLRE 252,A00,507189,Cuomo; Raphael Eduardo,9995,0,9999,4
1714632489788,CLRE 253,A00,507199,Vaida; Florin,9994,0,9999,5
1714632489788,CLRE 253,B00,507202,Vaida; Florin,9999,0,9999,0
1714632490813,CLRE 259,A00,507211,Patel; Hemal,9996,0,9999,3
1714632491842,CLRE 260,A00,507221,Cuomo; Raphael Eduardo,9999,0,9999,0
1714632492870,CLRE 297,001,507242,Cuomo; Raphael Eduardo,9999,0,9999,0
1714632493909,COGS 197,001,638244,Voytek; Bradley Thomas,9998,0,9999,1
1714632494937,CSE 191,A00,516875,Minnes Kemp; Mor Mia,9992,0,9999,7
1714632495962,CSE 197,001,637388,Minnes Kemp; Mor Mia,9998,0,9999,1
1714632496989,CSS 201S,A01,494383,Staff,35,0,35,0
1714632498021,CSS 202S,A01,494387,Staff,35,0,35,0
1714632499047,DSC 197,001,628532,Eldridge; Justin Matthew,9996,0,9999,3
1714632500072,EAP 100,A00,516065,Staff,9797,0,9999,202
1714632501099,ECE 45,A01,507414,Staff,33,0,60,27
1714632503154,ECE 111,A01,507420,Staff,15,0,50,35
1714632504184,ECE 197,001,548057,Sievenpiper; Daniel F.,9993,0,9999,6
1714632505210,EDS 115,A00,507243,Choi; Bailey Miyeon,10,0,28,18
1714632506239,EDS 117,A01,494379,Staff,0,4,30,30
1714632507264,EDS 125,A00,507246,Hopkins; Megan Beth,9,0,30,21
1714632508289,EDS 128A,A01,507264,Fargason; Sharon Gayle,8,0,26,18
1714632509316,EDS 128B,A01,507293,Pappas; Elizabeth,12,0,30,18
1714632510341,EDS 139,A00,507294,Fargason; Sharon Gayle,13,0,30,17
1714632510341,EDS 139,B00,507313,Pappas; Elizabeth,13,0,30,17
1714632511367,EDS 201,A00,507315,Staff,13,0,30,17
1714632512397,EDS 203,A01,507317,Halter; Christopher P.,12,0,30,18
1714632513423,EDS 204R,A01,507319,Halter; Christopher P.,0,3,30,30
1714632513423,EDS 204R,B01,507331,Heinzman; Erica M.,16,0,30,14
1714632514448,EDS 206R,A00,507332,Staff,0,4,30,30
1714632514448,EDS 206R,B00,507343,Staff,17,0,30,13
1714632515474,EDS 250,A00,507344,Hemans; Patricia Ann Benitez,22,0,40,18
1714632516501,EDS 281,A00,507345,Daly; Alan J.,18,0,18,0
1714632517524,EDS 284,A00,507350,Daly; Alan J.,16,0,16,0
1714632518552,EDS 286,A00,507359,Fine; Sarah,18,0,18,0
1714632519576,EDS 289C,A01,507361,Daly; Alan J.,18,0,18,0
1714632520604,EDS 290,A00,507366,Hofstetter; Carolyn,15,0,15,0
1714632521633,LIGM 5A,A00,507421,Fischer-Grunski; Eva K,18,0,20,2
1714632522660,LIGM 5B,A00,507423,Fischer-Grunski; Eva K,19,0,20,1
1714632523685,LIGM 5C,A00,507425,Fischer-Grunski; Eva K,19,0,20,1
1714632524712,LIIT 5AS,A00,507427,Carnelos; Chiara,20,0,20,0
1714632525737,LIIT 5BS,A00,507430,Carnelos; Chiara,20,0,20,0
1714632526768,LIIT 5CS,A00,507432,Carnelos; Chiara,20,0,20,0
1714632527792,LISP 5A,A00,507541,Munoz Sanchez; Alicia,11,0,20,9
1714632528817,LISP 5B,A00,507671,Munoz Sanchez; Alicia,8,0,20,12
1714632529840,LISP 5C,A00,507696,Munoz Sanchez; Alicia,9,0,20,11
1714632530866,MAE 197,001,528363,Boechler; Nicholas Sebastia,9998,0,9999,1
1714632531892,MATH 197,001,523477,Kedlaya; Kiran S.,9995,0,9999,4
1714632531892,MATH 197,002,563811,Zhang; Danna,9995,0,9999,4
1714632531892,MATH 197,003,628552,Dumitriu; Ioana,9998,0,9999,1
1714632532917,MCWP 40R,A00,518780,Staff,2,0,20,18
1714632532917,MCWP 40R,B00,518781,Staff,8,0,20,12
1714632532917,MCWP 40R,C00,518783,Staff,6,0,20,14
1714632533946,MCWP 50R,A00,518791,Staff,0,0,20,20
1714632533946,MCWP 50R,B00,518792,Staff,0,2,20,20
1714632533946,MCWP 50R,C00,518793,Staff,0,2,20,20
1714632533946,MCWP 50R,D00,518794,Staff,0,0,20,20
1714632533946,MCWP 50R,E00,518795,Staff,0,2,20,20
1714632533946,MCWP 50R,F00,518796,Staff,0,0,20,20
1714632533946,MCWP 50R,G00,518797,Staff,0,1,20,20
1714632534972,MMW 12R,A01,514034,Herbst; Matthew,0,0,16,16
1714632534972,MMW 12R,A02,514035,Herbst; Matthew,1,0,16,15
1714632535998,MMW 13R,A01,514037,Staff,0,4,16,16
1714632535998,MMW 13R,A02,514039,Staff,0,2,16,16
1714632535998,MMW 13R,A03,628519,Staff,0,2,16,16
1714632538051,SIO 295LS,A00,523233,Staff,10,0,30,20
1714632539080,SIO 295S,A00,523232,Staff,10,0,30,20
1714632540108,SIOC 290S,A01,637330,Merrifield; Mark A,23,0,30,7
1714632541133,SIOC 291S,A01,637333,Gabriel; Corey John,23,0,30,7
1714632542160,SOCI 117,A01,494376,Staff,0,4,5,5
1714632543184,WES 237B,A00,494380,Staff,9,0,20,11
1714632545269,AESE 279B,A00,494370,Wade; Jon P,0,0,33,33
1714632546295,AIP 197,001,627712,Vespa; Emanuel Ignacio,9998,0,9999,1
1714632547327,ANAR 135S,A00,494369,Braswell; Geoffrey E.,0,0,0,0
1714632548355,BENG 196,001,628496,Engler; Adam J.,9998,0,9999,1
1714632549379,CAT 124RS,A01,519847,Geibel; William,0,0,20,20
1714632550407,CAT 125RS,A01,515971,Geibel; William,0,0,20,20
1714632551432,CLRE 250,A00,511389,Morris; Sheldon,9993,0,9999,6
1714632552457,CLRE 251,A00,507176,Mehta; Ravindra L.,9993,0,9999,6
1714632552457,CLRE 251,B00,511410,Mehta; Ravindra L.,9998,0,9999,1
1714632553486,CLRE 252,A00,507189,Cuomo; Raphael Eduardo,9995,0,9999,4
1714632554518,CLRE 253,A00,507199,Vaida; Florin,9994,0,9999,5
1714632554518,CLRE 253,B00,507202,Vaida; Florin,9999,0,9999,0
1714632555545,CLRE 259,A00,507211,Patel; Hemal,9996,0,9999,3
1714632556569,CLRE 260,A00,507221,Cuomo; Raphael Eduardo,9999,0,9999,0
1714632557596,CLRE 297,001,507242,Cuomo; Raphael Eduardo,9999,0,9999,0
1714632558620,COGS 197,001,638244,Voytek; Bradley Thomas,9998,0,9999,1
1714632559648,CSE 191,A00,516875,Minnes Kemp; Mor Mia,9992,0,9999,7
1714632560674,CSE 197,001,637388,Minnes Kemp; Mor Mia,9998,0,9999,1
1714632561703,CSS 201S,A01,494383,Staff,35,0,35,0
1714632562729,CSS 202S,A01,494387,Staff,35,0,35,0
1714632563753,DSC 197,001,628532,Eldridge; Justin Matthew,9996,0,9999,3
1714632564779,EAP 100,A00,516065,Staff,9797,0,9999,202
1714632565807,ECE 45,A01,507414,Staff,33,0,60,27
1714632567859,ECE 111,A01,507420,Staff,15,0,50,35
1714632568885,ECE 197,001,548057,Sievenpiper; Daniel F.,9993,0,9999,6
1714632569916,EDS 115,A00,507243,Choi; Bailey Miyeon,10,0,28,18
1714632570942,EDS 117,A01,494379,Staff,0,4,30,30
1714632571974,EDS 125,A00,507246,Hopkins; Megan Beth,9,0,30,21
1714632573000,EDS 128A,A01,507264,Fargason; Sharon Gayle,8,0,26,18
1714632574025,EDS 128B,A01,507293,Pappas; Elizabeth,12,0,30,18
1714632575053,EDS 139,A00,507294,Fargason; Sharon Gayle,13,0,30,17
1714632575053,EDS 139,B00,507313,Pappas; Elizabeth,13,0,30,17
1714632576079,EDS 201,A00,507315,Staff,13,0,30,17
1714632577108,EDS 203,A01,507317,Halter; Christopher P.,12,0,30,18
1714632578139,EDS 204R,A01,507319,Halter; Christopher P.,0,3,30,30
1714632578139,EDS 204R,B01,507331,Heinzman; Erica M.,16,0,30,14
1714632579171,EDS 206R,A00,507332,Staff,0,4,30,30
1714632579171,EDS 206R,B00,507343,Staff,17,0,30,13
1714632580195,EDS 250,A00,507344,Hemans; Patricia Ann Benitez,22,0,40,18
1714632581221,EDS 281,A00,507345,Daly; Alan J.,18,0,18,0
1714632582248,EDS 284,A00,507350,Daly; Alan J.,16,0,16,0
1714632583278,EDS 286,A00,507359,Fine; Sarah,18,0,18,0
1714632584306,EDS 289C,A01,507361,Daly; Alan J.,18,0,18,0
1714632585331,EDS 290,A00,507366,Hofstetter; Carolyn,15,0,15,0
1714632586409,LIGM 5A,A00,507421,Fischer-Grunski; Eva K,18,0,20,2
1714632587434,LIGM 5B,A00,507423,Fischer-Grunski; Eva K,19,0,20,1
1714632588461,LIGM 5C,A00,507425,Fischer-Grunski; Eva K,19,0,20,1
1714632589489,LIIT 5AS,A00,507427,Carnelos; Chiara,20,0,20,0
1714632590518,LIIT 5BS,A00,507430,Carnelos; Chiara,20,0,20,0
1714632591541,LIIT 5CS,A00,507432,Carnelos; Chiara,20,0,20,0
1714632592571,LISP 5A,A00,507541,Munoz Sanchez; Alicia,11,0,20,9
1714632593596,LISP 5B,A00,507671,Munoz Sanchez; Alicia,8,0,20,12
1714632594622,LISP 5C,A00,507696,Munoz Sanchez; Alicia,9,0,20,11
1714632595646,MAE 197,001,528363,Boechler; Nicholas Sebastia,9998,0,9999,1
1714632596683,MATH 197,001,523477,Kedlaya; Kiran S.,9995,0,9999,4
1714632596683,MATH 197,002,563811,Zhang; Danna,9995,0,9999,4
1714632596683,MATH 197,003,628552,Dumitriu; Ioana,9998,0,9999,1
1714632597708,MCWP 40R,A00,518780,Staff,2,0,20,18
1714632597708,MCWP 40R,B00,518781,Staff,8,0,20,12
1714632597708,MCWP 40R,C00,518783,Staff,6,0,20,14
1714632598739,MCWP 50R,A00,518791,Staff,0,0,20,20
1714632598739,MCWP 50R,B00,518792,Staff,0,2,20,20
1714632598739,MCWP 50R,C00,518793,Staff,0,2,20,20
1714632598739,MCWP 50R,D00,518794,Staff,0,0,20,20
1714632598739,MCWP 50R,E00,518795,Staff,0,2,20,20
1714632598739,MCWP 50R,F00,518796,Staff,0,0,20,20
1714632598739,MCWP 50R,G00,518797,Staff,0,1,20,20
1714632599765,MMW 12R,A01,514034,Herbst; Matthew,0,0,16,16
1714632599765,MMW 12R,A02,514035,Herbst; Matthew,1,0,16,15
1714632600796,MMW 13R,A01,514037,Staff,0,4,16,16
1714632600796,MMW 13R,A02,514039,Staff,0,2,16,16
1714632600796,MMW 13R,A03,628519,Staff,0,2,16,16
1714632602848,SIO 295LS,A00,523233,Staff,10,0,30,20
1714632603875,SIO 295S,A00,523232,Staff,10,0,30,20
1714632604903,SIOC 290S,A01,637330,Merrifield; Mark A,23,0,30,7
1714632605933,SIOC 291S,A01,637333,Gabriel; Corey John,23,0,30,7
1714632606958,SOCI 117,A01,494376,Staff,0,4,5,5
1714632607986,WES 237B,A00,494380,Staff,9,0,20,11
1714632610067,AESE 279B,A00,494370,Wade; Jon P,0,0,33,33
1714632611092,AIP 197,001,627712,Vespa; Emanuel Ignacio,9998,0,9999,1
1714632612122,ANAR 135S,A00,494369,Braswell; Geoffrey E.,0,0,0,0
1714632613149,BENG 196,001,628496,Engler; Adam J.,9998,0,9999,1
1714632614178,CAT 124RS,A01,519847,Geibel; William,0,0,20,20
1714632615206,CAT 125RS,A01,515971,Geibel; William,0,0,20,20
1714632616236,CLRE 250,A00,511389,Morris; Sheldon,9993,0,9999,6
1714632617266,CLRE 251,A00,507176,Mehta; Ravindra L.,9993,0,9999,6
1714632617266,CLRE 251,B00,511410,Mehta; Ravindra L.,9998,0,9999,1
1714632618293,CLRE 252,A00,507189,Cuomo; Raphael Eduardo,9995,0,9999,4
1714632619325,CLRE 253,A00,507199,Vaida; Florin,9994,0,9999,5
1714632619325,CLRE 253,B00,507202,Vaida; Florin,9999,0,9999,0
1714632620350,CLRE 259,A00,507211,Patel; Hemal,9996,0,9999,3
1714632621376,CLRE 260,A00,507221,Cuomo; Raphael Eduardo,9999,0,9999,0
1714632622403,CLRE 297,001,507242,Cuomo; Raphael Eduardo,9999,0,9999,0
1714632623434,COGS 197,001,638244,Voytek; Bradley Thomas,9998,0,9999,1
1714632624460,CSE 191,A00,516875,Minnes Kemp; Mor Mia,9992,0,9999,7
1714632625487,CSE 197,001,637388,Minnes Kemp; Mor Mia,9998,0,9999,1
1714632626514,CSS 201S,A01,494383,Staff,35,0,35,0
1714632627538,CSS 202S,A01,494387,Staff,35,0,35,0
1714632628567,DSC 197,001,628532,Eldridge; Justin Matthew,9996,0,9999,3
1714632629590,EAP 100,A00,516065,Staff,9797,0,9999,202
1714632630617,ECE 45,A01,507414,Staff,33,0,60,27
1714632632672,ECE 111,A01,507420,Staff,15,0,50,35
1714632633697,ECE 197,001,548057,Sievenpiper; Daniel F.,9993,0,9999,6
1714632634728,EDS 115,A00,507243,Choi; Bailey Miyeon,10,0,28,18
1714632635753,EDS 117,A01,494379,Staff,0,4,30,30
1714632636783,EDS 125,A00,507246,Hopkins; Megan Beth,9,0,30,21
1714632637813,EDS 128A,A01,507264,Fargason; Sharon Gayle,8,0,26,18
1714632638842,EDS 128B,A01,507293,Pappas; Elizabeth,12,0,30,18
1714632639869,EDS 139,A00,507294,Fargason; Sharon Gayle,13,0,30,17
1714632639869,EDS 139,B00,507313,Pappas; Elizabeth,13,0,30,17
1714632640898,EDS 201,A00,507315,Staff,13,0,30,17
1714632641924,EDS 203,A01,507317,Halter; Christopher P.,12,0,30,18
1714632642955,EDS 204R,A01,507319,Halter; Christopher P.,0,3,30,30
1714632642955,EDS 204R,B01,507331,Heinzman; Erica M.,16,0,30,14
1714632643982,EDS 206R,A00,507332,Staff,0,4,30,30
1714632643982,EDS 206R,B00,507343,Staff,17,0,30,13
1714632645009,EDS 250,A00,507344,Hemans; Patricia Ann Benitez,22,0,40,18
1714632646033,EDS 281,A00,507345,Daly; Alan J.,18,0,18,0
1714632647060,EDS 284,A00,507350,Daly; Alan J.,16,0,16,0
1714632648090,EDS 286,A00,507359,Fine; Sarah,18,0,18,0
1714632649114,EDS 289C,A01,507361,Daly; Alan J.,18,0,18,0
1714632650140,EDS 290,A00,507366,Hofstetter; Carolyn,15,0,15,0
1714632651169,LIGM 5A,A00,507421,Fischer-Grunski; Eva K,18,0,20,2
1714632652195,LIGM 5B,A00,507423,Fischer-Grunski; Eva K,19,0,20,1
1714632653224,LIGM 5C,A00,507425,Fischer-Grunski; Eva K,19,0,20,1
1714632654249,LIIT 5AS,A00,507427,Carnelos; Chiara,20,0,20,0
1714632655280,LIIT 5BS,A00,507430,Carnelos; Chiara,20,0,20,0
1714632656306,LIIT 5CS,A00,507432,Carnelos; Chiara,20,0,20,0
1714632657333,LISP 5A,A00,507541,Munoz Sanchez; Alicia,11,0,20,9
1714632658357,LISP 5B,A00,507671,Munoz Sanchez; Alicia,8,0,20,12
1714632659383,LISP 5C,A00,507696,Munoz Sanchez; Alicia,9,0,20,11
1714632660413,MAE 197,001,528363,Boechler; Nicholas Sebastia,9998,0,9999,1
1714632661441,MATH 197,001,523477,Kedlaya; Kiran S.,9995,0,9999,4
1714632661441,MATH 197,002,563811,Zhang; Danna,9995,0,9999,4
1714632661441,MATH 197,003,628552,Dumitriu; Ioana,9998,0,9999,1
1714632662467,MCWP 40R,A00,518780,Staff,2,0,20,18
1714632662467,MCWP 40R,B00,518781,Staff,8,0,20,12
1714632662467,MCWP 40R,C00,518783,Staff,6,0,20,14
1714632663496,MCWP 50R,A00,518791,Staff,0,0,20,20
1714632663496,MCWP 50R,B00,518792,Staff,0,2,20,20
1714632663496,MCWP 50R,C00,518793,Staff,0,2,20,20
1714632663496,MCWP 50R,D00,518794,Staff,0,0,20,20
1714632663496,MCWP 50R,E00,518795,Staff,0,2,20,20
1714632663496,MCWP 50R,F00,518796,Staff,0,0,20,20
1714632663496,MCWP 50R,G00,518797,Staff,0,1,20,20
1714632664521,MMW 12R,A01,514034,Herbst; Matthew,0,0,16,16
1714632664521,MMW 12R,A02,514035,Herbst; Matthew,1,0,16,15
1714632665546,MMW 13R,A01,514037,Staff,0,4,16,16
1714632665546,MMW 13R,A02,514039,Staff,0,2,16,16
1714632665546,MMW 13R,A03,628519,Staff,0,2,16,16
1714632667594,SIO 295LS,A00,523233,Staff,10,0,30,20
1714632668618,SIO 295S,A00,523232,Staff,10,0,30,20
1714632669644,SIOC 290S,A01,637330,Merrifield; Mark A,23,0,30,7
1714632670669,SIOC 291S,A01,637333,Gabriel; Corey John,23,0,30,7
1714632671694,SOCI 117,A01,494376,Staff,0,4,5,5
1714632672720,WES 237B,A00,494380,Staff,9,0,20,11
1714632674802,AESE 279B,A00,494370,Wade; Jon P,0,0,33,33
1714632675832,AIP 197,001,627712,Vespa; Emanuel Ignacio,9998,0,9999,1
1714632676861,ANAR 135S,A00,494369,Braswell; Geoffrey E.,0,0,0,0
1714632677891,BENG 196,001,628496,Engler; Adam J.,9998,0,9999,1
1714632678917,CAT 124RS,A01,519847,Geibel; William,0,0,20,20
1714632679942,CAT 125RS,A01,515971,Geibel; William,0,0,20,20
1714632680970,CLRE 250,A00,511389,Morris; Sheldon,9993,0,9999,6
1714632681996,CLRE 251,A00,507176,Mehta; Ravindra L.,9993,0,9999,6
1714632681996,CLRE 251,B00,511410,Mehta; Ravindra L.,9998,0,9999,1
1714632683020,CLRE 252,A00,507189,Cuomo; Raphael Eduardo,9995,0,9999,4
1714632684045,CLRE 253,A00,507199,Vaida; Florin,9994,0,9999,5
1714632684045,CLRE 253,B00,507202,Vaida; Florin,9999,0,9999,0
1714632685072,CLRE 259,A00,507211,Patel; Hemal,9996,0,9999,3
1714632686098,CLRE 260,A00,507221,Cuomo; Raphael Eduardo,9999,0,9999,0
1714632687125,CLRE 297,001,507242,Cuomo; Raphael Eduardo,9999,0,9999,0
1714632688153,COGS 197,001,638244,Voytek; Bradley Thomas,9998,0,9999,1
1714632689179,CSE 191,A00,516875,Minnes Kemp; Mor Mia,9992,0,9999,7
1714632690257,CSE 197,001,637388,Minnes Kemp; Mor Mia,9998,0,9999,1
1714632691282,CSS 201S,A01,494383,Staff,35,0,35,0
1714632692308,CSS 202S,A01,494387,Staff,35,0,35,0
1714632693335,DSC 197,001,628532,Eldridge; Justin Matthew,9996,0,9999,3
1714632694360,EAP 100,A00,516065,Staff,9797,0,9999,202
1714632695386,ECE 45,A01,507414,Staff,33,0,60,27
1714632697443,ECE 111,A01,507420,Staff,15,0,50,35
1714632698468,ECE 197,001,548057,Sievenpiper; Daniel F.,9993,0,9999,6
1714632699495,EDS 115,A00,507243,Choi; Bailey Miyeon,10,0,28,18
1714632700519,EDS 117,A01,494379,Staff,0,4,30,30
1714632701545,EDS 125,A00,507246,Hopkins; Megan Beth,9,0,30,21
1714632702572,EDS 128A,A01,507264,Fargason; Sharon Gayle,8,0,26,18
1714632703597,EDS 128B,A01,507293,Pappas; Elizabeth,12,0,30,18
1714632704624,EDS 139,A00,507294,Fargason; Sharon Gayle,13,0,30,17
1714632704624,EDS 139,B00,507313,Pappas; Elizabeth,13,0,30,17
1714632705651,EDS 201,A00,507315,Staff,13,0,30,17
1714632706677,EDS 203,A01,507317,Halter; Christopher P.,12,0,30,18
1714632707707,EDS 204R,A01,507319,Halter; Christopher P.,0,3,30,30
1714632707707,EDS 204R,B01,507331,Heinzman; Erica M.,16,0,30,14
1714632708733,EDS 206R,A00,507332,Staff,0,4,30,30
1714632708733,EDS 206R,B00,507343,Staff,17,0,30,13
1714632709759,EDS 250,A00,507344,Hemans; Patricia Ann Benitez,22,0,40,18
1714632710790,EDS 281,A00,507345,Daly; Alan J.,18,0,18,0
1714632711818,EDS 284,A00,507350,Daly; Alan J.,16,0,16,0
1714632712843,EDS 286,A00,507359,Fine; Sarah,18,0,18,0
1714632713868,EDS 289C,A01,507361,Daly; Alan J.,18,0,18,0
1714632714898,EDS 290,A00,507366,Hofstetter; Carolyn,15,0,15,0
1714632715927,LIGM 5A,A00,507421,Fischer-Grunski; Eva K,18,0,20,2
1714632716953,LIGM 5B,A00,507423,Fischer-Grunski; Eva K,19,0,20,1
1714632717985,LIGM 5C,A00,507425,Fischer-Grunski; Eva K,19,0,20,1
1714632719011,LIIT 5AS,A00,507427,Carnelos; Chiara,20,0,20,0
1714632720037,LIIT 5BS,A00,507430,Carnelos; Chiara,20,0,20,0
1714632721064,LIIT 5CS,A00,507432,Carnelos; Chiara,20,0,20,0
1714632722096,LISP 5A,A00,507541,Munoz Sanchez; Alicia,11,0,20,9
1714632723122,LISP 5B,A00,507671,Munoz Sanchez; Alicia,8,0,20,12
1714632724148,LISP 5C,A00,507696,Munoz Sanchez; Alicia,9,0,20,11
1714632725174,MAE 197,001,528363,Boechler; Nicholas Sebastia,9998,0,9999,1
1714632726201,MATH 197,001,523477,Kedlaya; Kiran S.,9995,0,9999,4
1714632726201,MATH 197,002,563811,Zhang; Danna,9995,0,9999,4
1714632726201,MATH 197,003,628552,Dumitriu; Ioana,9998,0,9999,1
1714632727230,MCWP 40R,A00,518780,Staff,2,0,20,18
1714632727230,MCWP 40R,B00,518781,Staff,8,0,20,12
1714632727230,MCWP 40R,C00,518783,Staff,6,0,20,14
1714632728255,MCWP 50R,A00,518791,Staff,0,0,20,20
1714632728255,MCWP 50R,B00,518792,Staff,0,2,20,20
1714632728255,MCWP 50R,C00,518793,Staff,0,2,20,20
1714632728255,MCWP 50R,D00,518794,Staff,0,0,20,20
1714632728255,MCWP 50R,E00,518795,Staff,0,2,20,20
1714632728255,MCWP 50R,F00,518796,Staff,0,0,20,20
1714632728255,MCWP 50R,G00,518797,Staff,0,1,20,20
1714632729279,MMW 12R,A01,514034,Herbst; Matthew,0,0,16,16
1714632729279,MMW 12R,A02,514035,Herbst; Matthew,1,0,16,15
1714632730306,MMW 13R,A01,514037,Staff,0,4,16,16
1714632730306,MMW 13R,A02,514039,Staff,0,2,16,16
1714632730306,MMW 13R,A03,628519,Staff,0,2,16,16
1714632732358,SIO 295LS,A00,523233,Staff,10,0,30,20
1714632733386,SIO 295S,A00,523232,Staff,10,0,30,20
1714632734412,SIOC 290S,A01,637330,Merrifield; Mark A,23,0,30,7
1714632735439,SIOC 291S,A01,637333,Gabriel; Corey John,23,0,30,7
1714632736464,SOCI 117,A01,494376,Staff,0,4,5,5
1714632737491,WES 237B,A00,494380,Staff,9,0,20,11
1714632739570,AESE 279B,A00,494370,Wade; Jon P,0,0,33,33
1714632740596,AIP 197,001,627712,Vespa; Emanuel Ignacio,9998,0,9999,1
1714632741622,ANAR 135S,A00,494369,Braswell; Geoffrey E.,0,0,0,0
1714632742646,BENG 196,001,628496,Engler; Adam J.,9998,0,9999,1
1714632743672,CAT 124RS,A01,519847,Geibel; William,0,0,20,20
1714632744697,CAT 125RS,A01,515971,Geibel; William,0,0,20,20
1714632745723,CLRE 250,A00,511389,Morris; Sheldon,9993,0,9999,6
1714632746762,CLRE 251,A00,507176,Mehta; Ravindra L.,9993,0,9999,6
1714632746762,CLRE 251,B00,511410,Mehta; Ravindra L.,9998,0,9999,1
1714632747791,CLRE 252,A00,507189,Cuomo; Raphael Eduardo,9995,0,9999,4
1714632748822,CLRE 253,A00,507199,Vaida; Florin,9994,0,9999,5
1714632748822,CLRE 253,B00,507202,Vaida; Florin,9999,0,9999,0
1714632749846,CLRE 259,A00,507211,Patel; Hemal,9996,0,9999,3
1714632750871,CLRE 260,A00,507221,Cuomo; Raphael Eduardo,9999,0,9999,0
1714632751900,CLRE 297,001,507242,Cuomo; Raphael Eduardo,9999,0,9999,0
1714632752924,COGS 197,001,638244,Voytek; Bradley Thomas,9998,0,9999,1
1714632753950,CSE 191,A00,516875,Minnes Kemp; Mor Mia,9992,0,9999,7
1714632754979,CSE 197,001,637388,Minnes Kemp; Mor Mia,9998,0,9999,1
1714632756005,CSS 201S,A01,494383,Staff,35,0,35,0
1714632757031,CSS 202S,A01,494387,Staff,35,0,35,0
1714632758059,DSC 197,001,628532,Eldridge; Justin Matthew,9996,0,9999,3
1714632759084,EAP 100,A00,516065,Staff,9797,0,9999,202
1714632760111,ECE 45,A01,507414,Staff,33,0,60,27
1714632762167,ECE 111,A01,507420,Staff,15,0,50,35
1714632763196,ECE 197,001,548057,Sievenpiper; Daniel F.,9993,0,9999,6
1714632764225,EDS 115,A00,507243,Choi; Bailey Miyeon,10,0,28,18
1714632765251,EDS 117,A01,494379,Staff,0,4,30,30
1714632766279,EDS 125,A00,507246,Hopkins; Megan Beth,9,0,30,21
1714632767305,EDS 128A,A01,507264,Fargason; Sharon Gayle,8,0,26,18
1714632768330,EDS 128B,A01,507293,Pappas; Elizabeth,12,0,30,18
1714632769353,EDS 139,A00,507294,Fargason; Sharon Gayle,13,0,30,17
1714632769353,EDS 139,B00,507313,Pappas; Elizabeth,13,0,30,17
1714632770381,EDS 201,A00,507315,Staff,13,0,30,17
1714632771407,EDS 203,A01,507317,Halter; Christopher P.,12,0,30,18
1714632772435,EDS 204R,A01,507319,Halter; Christopher P.,0,3,30,30
1714632772435,EDS 204R,B01,507331,Heinzman; Erica M.,16,0,30,14
1714632773464,EDS 206R,A00,507332,Staff,0,4,30,30
1714632773464,EDS 206R,B00,507343,Staff,17,0,30,13
1714632774491,EDS 250,A00,507344,Hemans; Patricia Ann Benitez,22,0,40,18
1714632775516,EDS 281,A00,507345,Daly; Alan J.,18,0,18,0
1714632776540,EDS 284,A00,507350,Daly; Alan J.,16,0,16,0
1714632777569,EDS 286,A00,507359,Fine; Sarah,18,0,18,0
1714632778597,EDS 289C,A01,507361,Daly; Alan J.,18,0,18,0
1714632779621,EDS 290,A00,507366,Hofstetter; Carolyn,15,0,15,0
1714632780646,LIGM 5A,A00,507421,Fischer-Grunski; Eva K,18,0,20,2
1714632781672,LIGM 5B,A00,507423,Fischer-Grunski; Eva K,19,0,20,1
1714632782697,LIGM 5C,A00,507425,Fischer-Grunski; Eva K,19,0,20,1
1714632783727,LIIT 5AS,A00,507427,Carnelos; Chiara,20,0,20,0
1714632784752,LIIT 5BS,A00,507430,Carnelos; Chiara,20,0,20,0
1714632785778,LIIT 5CS,A00,507432,Carnelos; Chiara,20,0,20,0
1714632786804,LISP 5A,A00,507541,Munoz Sanchez; Alicia,11,0,20,9
1714632787836,LISP 5B,A00,507671,Munoz Sanchez; Alicia,8,0,20,12
1714632788869,LISP 5C,A00,507696,Munoz Sanchez; Alicia,9,0,20,11
1714632789900,MAE 197,001,528363,Boechler; Nicholas Sebastia,9998,0,9999,1
1714632790927,MATH 197,001,523477,Kedlaya; Kiran S.,9995,0,9999,4
1714632790927,MATH 197,002,563811,Zhang; Danna,9995,0,9999,4
1714632790927,MATH 197,003,628552,Dumitriu; Ioana,9998,0,9999,1
1714632791953,MCWP 40R,A00,518780,Staff,2,0,20,18
1714632791953,MCWP 40R,B00,518781,Staff,8,0,20,12
1714632791953,MCWP 40R,C00,518783,Staff,6,0,20,14
1714632792983,MCWP 50R,A00,518791,Staff,0,0,20,20
1714632792983,MCWP 50R,B00,518792,Staff,0,2,20,20
1714632792983,MCWP 50R,C00,518793,Staff,0,2,20,20
1714632792983,MCWP 50R,D00,518794,Staff,0,0,20,20
1714632792983,MCWP 50R,E00,518795,Staff,0,2,20,20
1714632792983,MCWP 50R,F00,518796,Staff,0,0,20,20
1714632792983,MCWP 50R,G00,518797,Staff,0,1,20,20
1714632794067,MMW 12R,A01,514034,Herbst; Matthew,0,0,16,16
1714632794067,MMW 12R,A02,514035,Herbst; Matthew,1,0,16,15
1714632795093,MMW 13R,A01,514037,Staff,0,4,16,16
1714632795093,MMW 13R,A02,514039,Staff,0,2,16,16
1714632795093,MMW 13R,A03,628519,Staff,0,2,16,16
1714632797145,SIO 295LS,A00,523233,Staff,10,0,30,20
1714632798170,SIO 295S,A00,523232,Staff,10,0,30,20
1714632799196,SIOC 290S,A01,637330,Merrifield; Mark A,23,0,30,7
1714632800223,SIOC 291S,A01,637333,Gabriel; Corey John,23,0,30,7
1714632801251,SOCI 117,A01,494376,Staff,0,4,5,5
1714632802276,WES 237B,A00,494380,Staff,9,0,20,11
1714632804345,AESE 279B,A00,494370,Wade; Jon P,0,0,33,33
1714632805372,AIP 197,001,627712,Vespa; Emanuel Ignacio,9998,0,9999,1
1714632806399,ANAR 135S,A00,494369,Braswell; Geoffrey E.,0,0,0,0
1714632807423,BENG 196,001,628496,Engler; Adam J.,9998,0,9999,1
1714632808449,CAT 124RS,A01,519847,Geibel; William,0,0,20,20
1714632809477,CAT 125RS,A01,515971,Geibel; William,0,0,20,20
1714632810504,CLRE 250,A00,511389,Morris; Sheldon,9993,0,9999,6
1714632811585,CLRE 251,A00,507176,Mehta; Ravindra L.,9993,0,9999,6
1714632811585,CLRE 251,B00,511410,Mehta; Ravindra L.,9998,0,9999,1
1714632812611,CLRE 252,A00,507189,Cuomo; Raphael Eduardo,9995,0,9999,4
1714632813642,CLRE 253,A00,507199,Vaida; Florin,9994,0,9999,5
1714632813642,CLRE 253,B00,507202,Vaida; Florin,9999,0,9999,0
1714632814670,CLRE 259,A00,507211,Patel; Hemal,9996,0,9999,3
1714632815695,CLRE 260,A00,507221,Cuomo; Raphael Eduardo,9999,0,9999,0
1714632816719,CLRE 297,001,507242,Cuomo; Raphael Eduardo,9999,0,9999,0
1714632817742,COGS 197,001,638244,Voytek; Bradley Thomas,9998,0,9999,1
1714632818772,CSE 191,A00,516875,Minnes Kemp; Mor Mia,9992,0,9999,7
1714632819797,CSE 197,001,637388,Minnes Kemp; Mor Mia,9998,0,9999,1
1714632820830,CSS 201S,A01,494383,Staff,35,0,35,0
1714632821855,CSS 202S,A01,494387,Staff,35,0,35,0
1714632822881,DSC 197,001,628532,Eldridge; Justin Matthew,9996,0,9999,3
1714632823906,EAP 100,A00,516065,Staff,9797,0,9999,202
1714632824933,ECE 45,A01,507414,Staff,33,0,60,27
1714632826984,ECE 111,A01,507420,Staff,15,0,50,35
1714632828015,ECE 197,001,548057,Sievenpiper; Daniel F.,9993,0,9999,6
1714632829041,EDS 115,A00,507243,Choi; Bailey Miyeon,10,0,28,18
1714632830067,EDS 117,A01,494379,Staff,0,4,30,30
1714632831098,EDS 125,A00,507246,Hopkins; Megan Beth,9,0,30,21
1714632832122,EDS 128A,A01,507264,Fargason; Sharon Gayle,8,0,26,18
1714632833146,EDS 128B,A01,507293,Pappas; Elizabeth,12,0,30,18
1714632834178,EDS 139,A00,507294,Fargason; Sharon Gayle,13,0,30,17
1714632834178,EDS 139,B00,507313,Pappas; Elizabeth,13,0,30,17
1714632835203,EDS 201,A00,507315,Staff,13,0,30,17
1714632836227,EDS 203,A01,507317,Halter; Christopher P.,12,0,30,18
1714632837258,EDS 204R,A01,507319,Halter; Christopher P.,0,3,30,30
1714632837258,EDS 204R,B01,507331,Heinzman; Erica M.,16,0,30,14
1714632838284,EDS 206R,A00,507332,Staff,0,4,30,30
1714632838284,EDS 206R,B00,507343,Staff,17,0,30,13
1714632839312,EDS 250,A00,507344,Hemans; Patricia Ann Benitez,22,0,40,18
1714632840340,EDS 281,A00,507345,Daly; Alan J.,18,0,18,0
1714632841365,EDS 284,A00,507350,Daly; Alan J.,16,0,16,0
1714632842390,EDS 286,A00,507359,Fine; Sarah,18,0,18,0
1714632843418,EDS 289C,A01,507361,Daly; Alan J.,18,0,18,0
1714632844445,EDS 290,A00,507366,Hofstetter; Carolyn,15,0,15,0
1714632845473,LIGM 5A,A00,507421,Fischer-Grunski; Eva K,18,0,20,2
1714632846499,LIGM 5B,A00,507423,Fischer-Grunski; Eva K,19,0,20,1
1714632847523,LIGM 5C,A00,507425,Fischer-Grunski; Eva K,19,0,20,1
1714632848548,LIIT 5AS,A00,507427,Carnelos; Chiara,20,0,20,0
1714632849577,LIIT 5BS,A00,507430,Carnelos; Chiara,20,0,20,0
1714632850624,LIIT 5CS,A00,507432,Carnelos; Chiara,20,0,20,0
1714632851657,LISP 5A,A00,507541,Munoz Sanchez; Alicia,11,0,20,9
1714632852684,LISP 5B,A00,507671,Munoz Sanchez; Alicia,8,0,20,12
1714632853708,LISP 5C,A00,507696,Munoz Sanchez; Alicia,9,0,20,11
1714632854738,MAE 197,001,528363,Boechler; Nicholas Sebastia,9998,0,9999,1
1714632855770,MATH 197,001,523477,Kedlaya; Kiran S.,9995,0,9999,4
1714632855770,MATH 197,002,563811,Zhang; Danna,9995,0,9999,4
1714632855770,MATH 197,003,628552,Dumitriu; Ioana,9998,0,9999,1
1714632856795,MCWP 40R,A00,518780,Staff,2,0,20,18
1714632856795,MCWP 40R,B00,518781,Staff,8,0,20,12
1714632856795,MCWP 40R,C00,518783,Staff,6,0,20,14
1714632857821,MCWP 50R,A00,518791,Staff,0,0,20,20
1714632857821,MCWP 50R,B00,518792,Staff,0,2,20,20
1714632857821,MCWP 50R,C00,518793,Staff,0,2,20,20
1714632857821,MCWP 50R,D00,518794,Staff,0,0,20,20
1714632857821,MCWP 50R,E00,518795,Staff,0,2,20,20
1714632857821,MCWP 50R,F00,518796,Staff,0,0,20,20
1714632857821,MCWP 50R,G00,518797,Staff,0,1,20,20
1714632858851,MMW 12R,A01,514034,Herbst; Matthew,0,0,16,16
1714632858851,MMW 12R,A02,514035,Herbst; Matthew,1,0,16,15
1714632859878,MMW 13R,A01,514037,Staff,0,4,16,16
1714632859878,MMW 13R,A02,514039,Staff,0,2,16,16
1714632859878,MMW 13R,A03,628519,Staff,0,2,16,16
1714632861932,SIO 295LS,A00,523233,Staff,10,0,30,20
1714632862957,SIO 295S,A00,523232,Staff,10,0,30,20
1714632863990,SIOC 290S,A01,637330,Merrifield; Mark A,23,0,30,7
1714632865015,SIOC 291S,A01,637333,Gabriel; Corey John,23,0,30,7
1714632866043,SOCI 117,A01,494376,Staff,0,4,5,5
1714632867073,WES 237B,A00,494380,Staff,9,0,20,11
1714632869154,AESE 279B,A00,494370,Wade; Jon P,0,0,33,33
1714632870179,AIP 197,001,627712,Vespa; Emanuel Ignacio,9998,0,9999,1
1714632871204,ANAR 135S,A00,494369,Braswell; Geoffrey E.,0,0,0,0
1714632872232,BENG 196,001,628496,Engler; Adam J.,9998,0,9999,1
1714632873257,CAT 124RS,A01,519847,Geibel; William,0,0,20,20
1714632874281,CAT 125RS,A01,515971,Geibel; William,0,0,20,20
1714632875309,CLRE 250,A00,511389,Morris; Sheldon,9993,0,9999,6
1714632876340,CLRE 251,A00,507176,Mehta; Ravindra L.,9993,0,9999,6
1714632876340,CLRE 251,B00,511410,Mehta; Ravindra L.,9998,0,9999,1
1714632877366,CLRE 252,A00,507189,Cuomo; Raphael Eduardo,9995,0,9999,4
1714632878393,CLRE 253,A00,507199,Vaida; Florin,9994,0,9999,5
1714632878393,CLRE 253,B00,507202,Vaida; Florin,9999,0,9999,0
1714632879418,CLRE 259,A00,507211,Patel; Hemal,9996,0,9999,3
1714632880446,CLRE 260,A00,507221,Cuomo; Raphael Eduardo,9999,0,9999,0
1714632881493,CLRE 297,001,507242,Cuomo; Raphael Eduardo,9999,0,9999,0
1714632882520,COGS 197,001,638244,Voytek; Bradley Thomas,9998,0,9999,1
1714632883544,CSE 191,A00,516875,Minnes Kemp; Mor Mia,9992,0,9999,7
1714632884571,CSE 197,001,637388,Minnes Kemp; Mor Mia,9998,0,9999,1
1714632885600,CSS 201S,A01,494383,Staff,35,0,35,0
1714632886625,CSS 202S,A01,494387,Staff,35,0,35,0
1714632887660,DSC 197,001,628532,Eldridge; Justin Matthew,9996,0,9999,3
1714632888685,EAP 100,A00,516065,Staff,9797,0,9999,202
1714632889711,ECE 45,A01,507414,Staff,33,0,60,27
1714632891759,ECE 111,A01,507420,Staff,15,0,50,35
1714632892783,ECE 197,001,548057,Sievenpiper; Daniel F.,9993,0,9999,6
1714632893811,EDS 115,A00,507243,Choi; Bailey Miyeon,10,0,28,18
1714632894838,EDS 117,A01,494379,Staff,0,4,30,30
1714632895863,EDS 125,A00,507246,Hopkins; Megan Beth,9,0,30,21
1714632896889,EDS 128A,A01,507264,Fargason; Sharon Gayle,8,0,26,18
1714632897914,EDS 128B,A01,507293,Pappas; Elizabeth,12,0,30,18
1714632898943,EDS 139,A00,507294,Fargason; Sharon Gayle,13,0,30,17
1714632898943,EDS 139,B00,507313,Pappas; Elizabeth,13,0,30,17
1714632899968,EDS 201,A00,507315,Staff,13,0,30,17
1714632900996,EDS 203,A01,507317,Halter; Christopher P.,12,0,30,18
1714632902024,EDS 204R,A01,507319,Halter; Christopher P.,0,3,30,30
1714632902024,EDS 204R,B01,507331,Heinzman; Erica M.,16,0,30,14
1714632903048,EDS 206R,A00,507332,Staff,0,4,30,30
1714632903048,EDS 206R,B00,507343,Staff,17,0,30,13
1714632904074,EDS 250,A00,507344,Hemans; Patricia Ann Benitez,22,0,40,18
1714632905099,EDS 281,A00,507345,Daly; Alan J.,18,0,18,0
1714632906124,EDS 284,A00,507350,Daly; Alan J.,16,0,16,0
1714632907150,EDS 286,A00,507359,Fine; Sarah,18,0,18,0
1714632908177,EDS 289C,A01,507361,Daly; Alan J.,18,0,18,0
1714632909203,EDS 290,A00,507366,Hofstetter; Carolyn,15,0,15,0
1714632910232,LIGM 5A,A00,507421,Fischer-Grunski; Eva K,18,0,20,2
1714632911261,LIGM 5B,A00,507423,Fischer-Grunski; Eva K,19,0,20,1
1714632912298,LIGM 5C,A00,507425,Fischer-Grunski; Eva K,19,0,20,1
1714632913325,LIIT 5AS,A00,507427,Carnelos; Chiara,20,0,20,0
1714632914354,LIIT 5BS,A00,507430,Carnelos; Chiara,20,0,20,0
1714632915379,LIIT 5CS,A00,507432,Carnelos; Chiara,20,0,20,0
1714632916407,LISP 5A,A00,507541,Munoz Sanchez; Alicia,11,0,20,9
1714632917439,LISP 5B,A00,507671,Munoz Sanchez; Alicia,8,0,20,12
1714632918465,LISP 5C,A00,507696,Munoz Sanchez; Alicia,9,0,20,11
1714632919498,MAE 197,001,528363,Boechler; Nicholas Sebastia,9998,0,9999,1
1714632920527,MATH 197,001,523477,Kedlaya; Kiran S.,9995,0,9999,4
1714632920527,MATH 197,002,563811,Zhang; Danna,9995,0,9999,4
1714632920527,MATH 197,003,628552,Dumitriu; Ioana,9998,0,9999,1
1714632921556,MCWP 40R,A00,518780,Staff,2,0,20,18
1714632921556,MCWP 40R,B00,518781,Staff,8,0,20,12
1714632921556,MCWP 40R,C00,518783,Staff,6,0,20,14
1714632922582,MCWP 50R,A00,518791,Staff,0,0,20,20
1714632922582,MCWP 50R,B00,518792,Staff,0,2,20,20
1714632922582,MCWP 50R,C00,518793,Staff,0,2,20,20
1714632922582,MCWP 50R,D00,518794,Staff,0,0,20,20
1714632922582,MCWP 50R,E00,518795,Staff,0,2,20,20
1714632922582,MCWP 50R,F00,518796,Staff,0,0,20,20
1714632922582,MCWP 50R,G00,518797,Staff,0,1,20,20
1714632923611,MMW 12R,A01,514034,Herbst; Matthew,0,0,16,16
1714632923611,MMW 12R,A02,514035,Herbst; Matthew,1,0,16,15
1714632924637,MMW 13R,A01,514037,Staff,0,4,16,16
1714632924637,MMW 13R,A02,514039,Staff,0,2,16,16
1714632924637,MMW 13R,A03,628519,Staff,0,2,16,16
1714632926701,SIO 295LS,A00,523233,Staff,10,0,30,20
1714632927735,SIO 295S,A00,523232,Staff,10,0,30,20
1714632928761,SIOC 290S,A01,637330,Merrifield; Mark A,23,0,30,7
1714632929790,SIOC 291S,A01,637333,Gabriel; Corey John,23,0,30,7
1714632930817,SOCI 117,A01,494376,Staff,0,4,5,5
1714632931845,WES 237B,A00,494380,Staff,9,0,20,11
1714632933992,AESE 279B,A00,494370,Wade; Jon P,0,0,33,33
1714632935030,AIP 197,001,627712,Vespa; Emanuel Ignacio,9998,0,9999,1
1714632936061,ANAR 135S,A00,494369,Braswell; Geoffrey E.,0,0,0,0
1714632937086,BENG 196,001,628496,Engler; Adam J.,9998,0,9999,1
1714632938111,CAT 124RS,A01,519847,Geibel; William,0,0,20,20
1714632939135,CAT 125RS,A01,515971,Geibel; William,0,0,20,20
1714632940161,CLRE 250,A00,511389,Morris; Sheldon,9993,0,9999,6
1714632941188,CLRE 251,A00,507176,Mehta; Ravindra L.,9993,0,9999,6
1714632941188,CLRE 251,B00,511410,Mehta; Ravindra L.,9998,0,9999,1
1714632942220,CLRE 252,A00,507189,Cuomo; Raphael Eduardo,9995,0,9999,4
1714632943246,CLRE 253,A00,507199,Vaida; Florin,9994,0,9999,5
1714632943246,CLRE 253,B00,507202,Vaida; Florin,9999,0,9999,0
1714632944292,CLRE 259,A00,507211,Patel; Hemal,9996,0,9999,3
1714632945318,CLRE 260,A00,507221,Cuomo; Raphael Eduardo,9999,0,9999,0
1714632946343,CLRE 297,001,507242,Cuomo; Raphael Eduardo,9999,0,9999,0
1714632947370,COGS 197,001,638244,Voytek; Bradley Thomas,9998,0,9999,1
1714632948399,CSE 191,A00,516875,Minnes Kemp; Mor Mia,9992,0,9999,7
1714632949424,CSE 197,001,637388,Minnes Kemp; Mor Mia,9998,0,9999,1
1714632950453,CSS 201S,A01,494383,Staff,35,0,35,0
1714632951479,CSS 202S,A01,494387,Staff,35,0,35,0
1714632952503,DSC 197,001,628532,Eldridge; Justin Matthew,9996,0,9999,3
1714632953531,EAP 100,A00,516065,Staff,9797,0,9999,202
1714632954558,ECE 45,A01,507414,Staff,33,0,60,27
1714632956612,ECE 111,A01,507420,Staff,15,0,50,35
1714632957641,ECE 197,001,548057,Sievenpiper; Daniel F.,9993,0,9999,6
1714632958669,EDS 115,A00,507243,Choi; Bailey Miyeon,10,0,28,18
1714632959696,EDS 117,A01,494379,Staff,0,4,30,30
1714632960721,EDS 125,A00,507246,Hopkins; Megan Beth,9,0,30,21
1714632961747,EDS 128A,A01,507264,Fargason; Sharon Gayle,8,0,26,18
1714632962776,EDS 128B,A01,507293,Pappas; Elizabeth,12,0,30,18
1714632963802,EDS 139,A00,507294,Fargason; Sharon Gayle,13,0,30,17
1714632963802,EDS 139,B00,507313,Pappas; Elizabeth,13,0,30,17
1714632964829,EDS 201,A00,507315,Staff,13,0,30,17
1714632965858,EDS 203,A01,507317,Halter; Christopher P.,12,0,30,18
1714632966883,EDS 204R,A01,507319,Halter; Christopher P.,0,3,30,30
1714632966883,EDS 204R,B01,507331,Heinzman; Erica M.,16,0,30,14
1714632967907,EDS 206R,A00,507332,Staff,0,4,30,30
1714632967907,EDS 206R,B00,507343,Staff,17,0,30,13
1714632968934,EDS 250,A00,507344,Hemans; Patricia Ann Benitez,22,0,40,18
1714632969960,EDS 281,A00,507345,Daly; Alan J.,18,0,18,0
1714632970983,EDS 284,A00,507350,Daly; Alan J.,16,0,16,0
1714632972017,EDS 286,A00,507359,Fine; Sarah,18,0,18,0
1714632973042,EDS 289C,A01,507361,Daly; Alan J.,18,0,18,0
1714632974067,EDS 290,A00,507366,Hofstetter; Carolyn,15,0,15,0
1714632975093,LIGM 5A,A00,507421,Fischer-Grunski; Eva K,18,0,20,2
1714632976119,LIGM 5B,A00,507423,Fischer-Grunski; Eva K,19,0,20,1
1714632977144,LIGM 5C,A00,507425,Fischer-Grunski; Eva K,19,0,20,1
1714632978173,LIIT 5AS,A00,507427,Carnelos; Chiara,20,0,20,0
1714632979198,LIIT 5BS,A00,507430,Carnelos; Chiara,20,0,20,0
1714632980223,LIIT 5CS,A00,507432,Carnelos; Chiara,20,0,20,0
1714632981248,LISP 5A,A00,507541,Munoz Sanchez; Alicia,11,0,20,9
1714632982273,LISP 5B,A00,507671,Munoz Sanchez; Alicia,8,0,20,12
1714632983298,LISP 5C,A00,507696,Munoz Sanchez; Alicia,9,0,20,11
1714632984323,MAE 197,001,528363,Boechler; Nicholas Sebastia,9998,0,9999,1
1714632985351,MATH 197,001,523477,Kedlaya; Kiran S.,9995,0,9999,4
1714632985351,MATH 197,002,563811,Zhang; Danna,9995,0,9999,4
1714632985351,MATH 197,003,628552,Dumitriu; Ioana,9998,0,9999,1
1714632986381,MCWP 40R,A00,518780,Staff,2,0,20,18
1714632986381,MCWP 40R,B00,518781,Staff,8,0,20,12
1714632986381,MCWP 40R,C00,518783,Staff,6,0,20,14
1714632987412,MCWP 50R,A00,518791,Staff,0,0,20,20
1714632987412,MCWP 50R,B00,518792,Staff,0,2,20,20
1714632987412,MCWP 50R,C00,518793,Staff,0,2,20,20
1714632987412,MCWP 50R,D00,518794,Staff,0,0,20,20
1714632987412,MCWP 50R,E00,518795,Staff,0,2,20,20
1714632987412,MCWP 50R,F00,518796,Staff,0,0,20,20
1714632987412,MCWP 50R,G00,518797,Staff,0,1,20,20
1714632988440,MMW 12R,A01,514034,Herbst; Matthew,0,0,16,16
1714632988440,MMW 12R,A02,514035,Herbst; Matthew,1,0,16,15
1714632989467,MMW 13R,A01,514037,Staff,0,4,16,16
1714632989467,MMW 13R,A02,514039,Staff,0,2,16,16
1714632989467,MMW 13R,A03,628519,Staff,0,2,16,16
1714632991519,SIO 295LS,A00,523233,Staff,10,0,30,20
1714632992546,SIO 295S,A00,523232,Staff,10,0,30,20
1714632993576,SIOC 290S,A01,637330,Merrifield; Mark A,23,0,30,7
1714632994607,SIOC 291S,A01,637333,Gabriel; Corey John,23,0,30,7
1714632995634,SOCI 117,A01,494376,Staff,0,4,5,5
1714632996659,WES 237B,A00,494380,Staff,9,0,20,11
1714632998733,AESE 279B,A00,494370,Wade; Jon P,0,0,33,33
1714632999772,AIP 197,001,627712,Vespa; Emanuel Ignacio,9998,0,9999,1
1714633000800,ANAR 135S,A00,494369,Braswell; Geoffrey E.,0,0,0,0
1714633001826,BENG 196,001,628496,Engler; Adam J.,9998,0,9999,1
1714633002853,CAT 124RS,A01,519847,Geibel; William,0,0,20,20
1714633003879,CAT 125RS,A01,515971,Geibel; William,0,0,20,20
1714633004907,CLRE 250,A00,511389,Morris; Sheldon,9993,0,9999,6
1714633005934,CLRE 251,A00,507176,Mehta; Ravindra L.,9993,0,9999,6
1714633005934,CLRE 251,B00,511410,Mehta; Ravindra L.,9998,0,9999,1
1714633006962,CLRE 252,A00,507189,Cuomo; Raphael Eduardo,9995,0,9999,4
1714633007989,CLRE 253,A00,507199,Vaida; Florin,9994,0,9999,5
1714633007989,CLRE 253,B00,507202,Vaida; Florin,9999,0,9999,0
1714633009014,CLRE 259,A00,507211,Patel; Hemal,9996,0,9999,3
1714633010038,CLRE 260,A00,507221,Cuomo; Raphael Eduardo,9999,0,9999,0
1714633011063,CLRE 297,001,507242,Cuomo; Raphael Eduardo,9999,0,9999,0
1714633012089,COGS 197,001,638244,Voytek; Bradley Thomas,9998,0,9999,1
1714633013113,CSE 191,A00,516875,Minnes Kemp; Mor Mia,9992,0,9999,7
1714633014138,CSE 197,001,637388,Minnes Kemp; Mor Mia,9998,0,9999,1
1714633015169,CSS 201S,A01,494383,Staff,35,0,35,0
1714633016198,CSS 202S,A01,494387,Staff,35,0,35,0
1714633017227,DSC 197,001,628532,Eldridge; Justin Matthew,9996,0,9999,3
1714633018251,EAP 100,A00,516065,Staff,9797,0,9999,202
1714633019276,ECE 45,A01,507414,Staff,33,0,60,27
1714633021329,ECE 111,A01,507420,Staff,15,0,50,35
1714633022354,ECE 197,001,548057,Sievenpiper; Daniel F.,9993,0,9999,6
1714633023385,EDS 115,A00,507243,Choi; Bailey Miyeon,10,0,28,18
1714633024415,EDS 117,A01,494379,Staff,0,4,30,30
1714633025443,EDS 125,A00,507246,Hopkins; Megan Beth,9,0,30,21
1714633026471,EDS 128A,A01,507264,Fargason; Sharon Gayle,8,0,26,18
1714633027500,EDS 128B,A01,507293,Pappas; Elizabeth,12,0,30,18
1714633028526,EDS 139,A00,507294,Fargason; Sharon Gayle,13,0,30,17
1714633028526,EDS 139,B00,507313,Pappas; Elizabeth,13,0,30,17
1714633029554,EDS 201,A00,507315,Staff,13,0,30,17
1714633030579,EDS 203,A01,507317,Halter; Christopher P.,12,0,30,18
1714633031605,EDS 204R,A01,507319,Halter; Christopher P.,0,3,30,30
1714633031605,EDS 204R,B01,507331,Heinzman; Erica M.,16,0,30,14
1714633032630,EDS 206R,A00,507332,Staff,0,4,30,30
1714633032630,EDS 206R,B00,507343,Staff,17,0,30,13
1714633033655,EDS 250,A00,507344,Hemans; Patricia Ann Benitez,22,0,40,18
1714633034683,EDS 281,A00,507345,Daly; Alan J.,18,0,18,0
1714633035712,EDS 284,A00,507350,Daly; Alan J.,16,0,16,0
1714633036741,EDS 286,A00,507359,Fine; Sarah,18,0,18,0
1714633037769,EDS 289C,A01,507361,Daly; Alan J.,18,0,18,0
1714633038794,EDS 290,A00,507366,Hofstetter; Carolyn,15,0,15,0
1714633039826,LIGM 5A,A00,507421,Fischer-Grunski; Eva K,18,0,20,2
1714633040852,LIGM 5B,A00,507423,Fischer-Grunski; Eva K,19,0,20,1
1714633041884,LIGM 5C,A00,507425,Fischer-Grunski; Eva K,19,0,20,1
1714633042914,LIIT 5AS,A00,507427,Carnelos; Chiara,20,0,20,0
1714633043939,LIIT 5BS,A00,507430,Carnelos; Chiara,20,0,20,0
1714633044965,LIIT 5CS,A00,507432,Carnelos; Chiara,20,0,20,0
1714633045991,LISP 5A,A00,507541,Munoz Sanchez; Alicia,11,0,20,9
1714633047016,LISP 5B,A00,507671,Munoz Sanchez; Alicia,8,0,20,12
1714633048048,LISP 5C,A00,507696,Munoz Sanchez; Alicia,9,0,20,11
1714633049075,MAE 197,001,528363,Boechler; Nicholas Sebastia,9998,0,9999,1
1714633050107,MATH 197,001,523477,Kedlaya; Kiran S.,9995,0,9999,4
1714633050107,MATH 197,002,563811,Zhang; Danna,9995,0,9999,4
1714633050107,MATH 197,003,628552,Dumitriu; Ioana,9998,0,9999,1
1714633051132,MCWP 40R,A00,518780,Staff,2,0,20,18
1714633051132,MCWP 40R,B00,518781,Staff,8,0,20,12
1714633051132,MCWP 40R,C00,518783,Staff,6,0,20,14
1714633052164,MCWP 50R,A00,518791,Staff,0,0,20,20
1714633052164,MCWP 50R,B00,518792,Staff,0,2,20,20
1714633052164,MCWP 50R,C00,518793,Staff,0,2,20,20
1714633052164,MCWP 50R,D00,518794,Staff,0,0,20,20
1714633052164,MCWP 50R,E00,518795,Staff,0,2,20,20
1714633052164,MCWP 50R,F00,518796,Staff,0,0,20,20
1714633052164,MCWP 50R,G00,518797,Staff,0,1,20,20
1714633053189,MMW 12R,A01,514034,Herbst; Matthew,0,0,16,16
1714633053189,MMW 12R,A02,514035,Herbst; Matthew,1,0,16,15
1714633054214,MMW 13R,A01,514037,Staff,0,4,16,16
1714633054214,MMW 13R,A02,514039,Staff,0,2,16,16
1714633054214,MMW 13R,A03,628519,Staff,0,2,16,16
1714633056270,SIO 295LS,A00,523233,Staff,10,0,30,20
1714633057295,SIO 295S,A00,523232,Staff,10,0,30,20
1714633058322,SIOC 290S,A01,637330,Merrifield; Mark A,23,0,30,7
1714633059351,SIOC 291S,A01,637333,Gabriel; Corey John,23,0,30,7
1714633060380,SOCI 117,A01,494376,Staff,0,4,5,5
1714633061409,WES 237B,A00,494380,Staff,9,0,20,11
1714633063487,AESE 279B,A00,494370,Wade; Jon P,0,0,33,33
1714633064514,AIP 197,001,627712,Vespa; Emanuel Ignacio,9998,0,9999,1
1714633065538,ANAR 135S,A00,494369,Braswell; Geoffrey E.,0,0,0,0
1714633066563,BENG 196,001,628496,Engler; Adam J.,9998,0,9999,1
1714633067590,CAT 124RS,A01,519847,Geibel; William,0,0,20,20
1714633068613,CAT 125RS,A01,515971,Geibel; William,0,0,20,20
1714633069653,CLRE 250,A00,511389,Morris; Sheldon,9993,0,9999,6
1714633070680,CLRE 251,A00,507176,Mehta; Ravindra L.,9993,0,9999,6
1714633070680,CLRE 251,B00,511410,Mehta; Ravindra L.,9998,0,9999,1
1714633071705,CLRE 252,A00,507189,Cuomo; Raphael Eduardo,9995,0,9999,4
1714633072731,CLRE 253,A00,507199,Vaida; Florin,9994,0,9999,5
1714633072731,CLRE 253,B00,507202,Vaida; Florin,9999,0,9999,0
1714633073756,CLRE 259,A00,507211,Patel; Hemal,9996,0,9999,3
1714633074780,CLRE 260,A00,507221,Cuomo; Raphael Eduardo,9999,0,9999,0
1714633075805,CLRE 297,001,507242,Cuomo; Raphael Eduardo,9999,0,9999,0
1714633076841,COGS 197,001,638244,Voytek; Bradley Thomas,9998,0,9999,1
1714633077866,CSE 191,A00,516875,Minnes Kemp; Mor Mia,9992,0,9999,7
1714633078892,CSE 197,001,637388,Minnes Kemp; Mor Mia,9998,0,9999,1
1714633079918,CSS 201S,A01,494383,Staff,35,0,35,0
1714633080944,CSS 202S,A01,494387,Staff,35,0,35,0
1714633081972,DSC 197,001,628532,Eldridge; Justin Matthew,9996,0,9999,3
1714633082998,EAP 100,A00,516065,Staff,9797,0,9999,202
1714633084023,ECE 45,A01,507414,Staff,33,0,60,27
1714633086072,ECE 111,A01,507420,Staff,15,0,50,35
1714633087098,ECE 197,001,548057,Sievenpiper; Daniel F.,9993,0,9999,6
1714633088126,EDS 115,A00,507243,Choi; Bailey Miyeon,10,0,28,18
1714633089151,EDS 117,A01,494379,Staff,0,4,30,30
1714633090180,EDS 125,A00,507246,Hopkins; Megan Beth,9,0,30,21
1714633091208,EDS 128A,A01,507264,Fargason; Sharon Gayle,8,0,26,18
1714633092233,EDS 128B,A01,507293,Pappas; Elizabeth,12,0,30,18
1714633093257,EDS 139,A00,507294,Fargason; Sharon Gayle,13,0,30,17
1714633093257,EDS 139,B00,507313,Pappas; Elizabeth,13,0,30,17
1714633094285,EDS 201,A00,507315,Staff,13,0,30,17
1714633095312,EDS 203,A01,507317,Halter; Christopher P.,12,0,30,18
1714633096339,EDS 204R,A01,507319,Halter; Christopher P.,0,3,30,30
1714633096339,EDS 204R,B01,507331,Heinzman; Erica M.,16,0,30,14
1714633097363,EDS 206R,A00,507332,Staff,0,4,30,30
1714633097363,EDS 206R,B00,507343,Staff,17,0,30,13
1714633098392,EDS 250,A00,507344,Hemans; Patricia Ann Benitez,22,0,40,18
1714633099418,EDS 281,A00,507345,Daly; Alan J.,18,0,18,0
1714633100441,EDS 284,A00,507350,Daly; Alan J.,16,0,16,0
1714633101468,EDS 286,A00,507359,Fine; Sarah,18,0,18,0
1714633102495,EDS 289C,A01,507361,Daly; Alan J.,18,0,18,0
1714633103523,EDS 290,A00,507366,Hofstetter; Carolyn,15,0,15,0
1714633104551,LIGM 5A,A00,507421,Fischer-Grunski; Eva K,18,0,20,2
1714633105575,LIGM 5B,A00,507423,Fischer-Grunski; Eva K,19,0,20,1
1714633106604,LIGM 5C,A00,507425,Fischer-Grunski; Eva K,19,0,20,1
1714633107632,LIIT 5AS,A00,507427,Carnelos; Chiara,20,0,20,0
1714633108656,LIIT 5BS,A00,507430,Carnelos; Chiara,20,0,20,0
1714633109685,LIIT 5CS,A00,507432,Carnelos; Chiara,20,0,20,0
1714633110711,LISP 5A,A00,507541,Munoz Sanchez; Alicia,11,0,20,9
1714633111742,LISP 5B,A00,507671,Munoz Sanchez; Alicia,8,0,20,12
1714633112766,LISP 5C,A00,507696,Munoz Sanchez; Alicia,9,0,20,11
1714633113789,MAE 197,001,528363,Boechler; Nicholas Sebastia,9998,0,9999,1
1714633114816,MATH 197,001,523477,Kedlaya; Kiran S.,9995,0,9999,4
1714633114816,MATH 197,002,563811,Zhang; Danna,9995,0,9999,4
1714633114816,MATH 197,003,628552,Dumitriu; Ioana,9998,0,9999,1
1714633115843,MCWP 40R,A00,518780,Staff,2,0,20,18
1714633115843,MCWP 40R,B00,518781,Staff,8,0,20,12
1714633115843,MCWP 40R,C00,518783,Staff,6,0,20,14
1714633116868,MCWP 50R,A00,518791,Staff,0,0,20,20
1714633116868,MCWP 50R,B00,518792,Staff,0,2,20,20
1714633116868,MCWP 50R,C00,518793,Staff,0,2,20,20
1714633116868,MCWP 50R,D00,518794,Staff,0,0,20,20
1714633116868,MCWP 50R,E00,518795,Staff,0,2,20,20
1714633116868,MCWP 50R,F00,518796,Staff,0,0,20,20
1714633116868,MCWP 50R,G00,518797,Staff,0,1,20,20
1714633117894,MMW 12R,A01,514034,Herbst; Matthew,0,0,16,16
1714633117894,MMW 12R,A02,514035,Herbst; Matthew,1,0,16,15
1714633118918,MMW 13R,A01,514037,Staff,0,4,16,16
1714633118918,MMW 13R,A02,514039,Staff,0,2,16,16
1714633118918,MMW 13R,A03,628519,Staff,0,2,16,16
1714633120973,SIO 295LS,A00,523233,Staff,10,0,30,20
1714633121996,SIO 295S,A00,523232,Staff,10,0,30,20
1714633123022,SIOC 290S,A01,637330,Merrifield; Mark A,23,0,30,7
1714633124053,SIOC 291S,A01,637333,Gabriel; Corey John,23,0,30,7
1714633125082,SOCI 117,A01,494376,Staff,0,4,5,5
1714633126109,WES 237B,A00,494380,Staff,9,0,20,11
1714633128174,AESE 279B,A00,494370,Wade; Jon P,0,0,33,33
1714633129202,AIP 197,001,627712,Vespa; Emanuel Ignacio,9998,0,9999,1
1714633130229,ANAR 135S,A00,494369,Braswell; Geoffrey E.,0,0,0,0
1714633131253,BENG 196,001,628496,Engler; Adam J.,9998,0,9999,1
1714633132282,CAT 124RS,A01,519847,Geibel; William,0,0,20,20
1714633133309,CAT 125RS,A01,515971,Geibel; William,0,0,20,20
1714633134339,CLRE 250,A00,511389,Morris; Sheldon,9993,0,9999,6
1714633135365,CLRE 251,A00,507176,Mehta; Ravindra L.,9993,0,9999,6
1714633135365,CLRE 251,B00,511410,Mehta; Ravindra L.,9998,0,9999,1
1714633136393,CLRE 252,A00,507189,Cuomo; Raphael Eduardo,9995,0,9999,4
1714633137420,CLRE 253,A00,507199,Vaida; Florin,9994,0,9999,5
1714633137420,CLRE 253,B00,507202,Vaida; Florin,9999,0,9999,0
1714633138451,CLRE 259,A00,507211,Patel; Hemal,9996,0,9999,3
1714633139476,CLRE 260,A00,507221,Cuomo; Raphael Eduardo,9999,0,9999,0
1714633140501,CLRE 297,001,507242,Cuomo; Raphael Eduardo,9999,0,9999,0
1714633141530,COGS 197,001,638244,Voytek; Bradley Thomas,9998,0,9999,1
1714633142557,CSE 191,A00,516875,Minnes Kemp; Mor Mia,9992,0,9999,7
1714633143583,CSE 197,001,637388,Minnes Kemp; Mor Mia,9998,0,9999,1
1714633144610,CSS 201S,A01,494383,Staff,35,0,35,0
1714633145636,CSS 202S,A01,494387,Staff,35,0,35,0
1714633146659,DSC 197,001,628532,Eldridge; Justin Matthew,9996,0,9999,3
1714633147684,EAP 100,A00,516065,Staff,9797,0,9999,202
1714633148714,ECE 45,A01,507414,Staff,33,0,60,27
1714633150770,ECE 111,A01,507420,Staff,15,0,50,35
1714633151799,ECE 197,001,548057,Sievenpiper; Daniel F.,9993,0,9999,6
1714633152830,EDS 115,A00,507243,Choi; Bailey Miyeon,10,0,28,18
1714633153866,EDS 117,A01,494379,Staff,0,4,30,30
1714633154893,EDS 125,A00,507246,Hopkins; Megan Beth,9,0,30,21
1714633155919,EDS 128A,A01,507264,Fargason; Sharon Gayle,8,0,26,18
1714633156950,EDS 128B,A01,507293,Pappas; Elizabeth,12,0,30,18
1714633157977,EDS 139,A00,507294,Fargason; Sharon Gayle,13,0,30,17
1714633157977,EDS 139,B00,507313,Pappas; Elizabeth,13,0,30,17
1714633159008,EDS 201,A00,507315,Staff,13,0,30,17
1714633160034,EDS 203,A01,507317,Halter; Christopher P.,12,0,30,18
1714633161060,EDS 204R,A01,507319,Halter; Christopher P.,0,3,30,30
1714633161060,EDS 204R,B01,507331,Heinzman; Erica M.,16,0,30,14
1714633162084,EDS 206R,A00,507332,Staff,0,4,30,30
1714633162084,EDS 206R,B00,507343,Staff,17,0,30,13
1714633163111,EDS 250,A00,507344,Hemans; Patricia Ann Benitez,22,0,40,18
1714633164140,EDS 281,A00,507345,Daly; Alan J.,18,0,18,0
1714633165165,EDS 284,A00,507350,Daly; Alan J.,16,0,16,0
1714633166192,EDS 286,A00,507359,Fine; Sarah,18,0,18,0
1714633167217,EDS 289C,A01,507361,Daly; Alan J.,18,0,18,0
1714633168245,EDS 290,A00,507366,Hofstetter; Carolyn,15,0,15,0
1714633169275,LIGM 5A,A00,507421,Fischer-Grunski; Eva K,18,0,20,2
1714633170302,LIGM 5B,A00,507423,Fischer-Grunski; Eva K,19,0,20,1
1714633171329,LIGM 5C,A00,507425,Fischer-Grunski; Eva K,19,0,20,1
1714633172355,LIIT 5AS,A00,507427,Carnelos; Chiara,20,0,20,0
1714633173384,LIIT 5BS,A00,507430,Carnelos; Chiara,20,0,20,0
1714633174413,LIIT 5CS,A00,507432,Carnelos; Chiara,20,0,20,0
1714633175440,LISP 5A,A00,507541,Munoz Sanchez; Alicia,11,0,20,9
1714633176468,LISP 5B,A00,507671,Munoz Sanchez; Alicia,8,0,20,12
1714633177497,LISP 5C,A00,507696,Munoz Sanchez; Alicia,9,0,20,11
1714633178523,MAE 197,001,528363,Boechler; Nicholas Sebastia,9998,0,9999,1
1714633179556,MATH 197,001,523477,Kedlaya; Kiran S.,9995,0,9999,4
1714633179556,MATH 197,002,563811,Zhang; Danna,9995,0,9999,4
1714633179556,MATH 197,003,628552,Dumitriu; Ioana,9998,0,9999,1
1714633180585,MCWP 40R,A00,518780,Staff,2,0,20,18
1714633180585,MCWP 40R,B00,518781,Staff,8,0,20,12
1714633180585,MCWP 40R,C00,518783,Staff,6,0,20,14
1714633181611,MCWP 50R,A00,518791,Staff,0,0,20,20
1714633181611,MCWP 50R,B00,518792,Staff,0,2,20,20
1714633181611,MCWP 50R,C00,518793,Staff,0,2,20,20
1714633181611,MCWP 50R,D00,518794,Staff,0,0,20,20
1714633181611,MCWP 50R,E00,518795,Staff,0,2,20,20
1714633181611,MCWP 50R,F00,518796,Staff,0,0,20,20
1714633181611,MCWP 50R,G00,518797,Staff,0,1,20,20
1714633182640,MMW 12R,A01,514034,Herbst; Matthew,0,0,16,16
1714633182640,MMW 12R,A02,514035,Herbst; Matthew,1,0,16,15
1714633183684,MMW 13R,A01,514037,Staff,0,4,16,16
1714633183684,MMW 13R,A02,514039,Staff,0,2,16,16
1714633183684,MMW 13R,A03,628519,Staff,0,2,16,16
1714633185738,SIO 295LS,A00,523233,Staff,10,0,30,20
1714633186762,SIO 295S,A00,523232,Staff,10,0,30,20
1714633187790,SIOC 290S,A01,637330,Merrifield; Mark A,23,0,30,7
1714633188818,SIOC 291S,A01,637333,Gabriel; Corey John,23,0,30,7
1714633189842,SOCI 117,A01,494376,Staff,0,4,5,5
1714633190868,WES 237B,A00,494380,Staff,9,0,20,11
1714633192942,AESE 279B,A00,494370,Wade; Jon P,0,0,33,33
1714633193967,AIP 197,001,627712,Vespa; Emanuel Ignacio,9998,0,9999,1
1714633194995,ANAR 135S,A00,494369,Braswell; Geoffrey E.,0,0,0,0
1714633196022,BENG 196,001,628496,Engler; Adam J.,9998,0,9999,1
1714633197046,CAT 124RS,A01,519847,Geibel; William,0,0,20,20
1714633198070,CAT 125RS,A01,515971,Geibel; William,0,0,20,20
1714633199096,CLRE 250,A00,511389,Morris; Sheldon,9993,0,9999,6
1714633200123,CLRE 251,A00,507176,Mehta; Ravindra L.,9993,0,9999,6
1714633200123,CLRE 251,B00,511410,Mehta; Ravindra L.,9998,0,9999,1
1714633201149,CLRE 252,A00,507189,Cuomo; Raphael Eduardo,9995,0,9999,4
1714633202173,CLRE 253,A00,507199,Vaida; Florin,9994,0,9999,5
1714633202173,CLRE 253,B00,507202,Vaida; Florin,9999,0,9999,0
1714633203206,CLRE 259,A00,507211,Patel; Hemal,9996,0,9999,3
1714633204233,CLRE 260,A00,507221,Cuomo; Raphael Eduardo,9999,0,9999,0
1714633205259,CLRE 297,001,507242,Cuomo; Raphael Eduardo,9999,0,9999,0
1714633206284,COGS 197,001,638244,Voytek; Bradley Thomas,9998,0,9999,1
1714633207310,CSE 191,A00,516875,Minnes Kemp; Mor Mia,9992,0,9999,7
1714633208334,CSE 197,001,637388,Minnes Kemp; Mor Mia,9998,0,9999,1
1714633209359,CSS 201S,A01,494383,Staff,35,0,35,0
1714633210385,CSS 202S,A01,494387,Staff,35,0,35,0
1714633211412,DSC 197,001,628532,Eldridge; Justin Matthew,9996,0,9999,3
1714633212439,EAP 100,A00,516065,Staff,9797,0,9999,202
1714633213462,ECE 45,A01,507414,Staff,33,0,60,27
1714633215512,ECE 111,A01,507420,Staff,15,0,50,35
1714633216537,ECE 197,001,548057,Sievenpiper; Daniel F.,9993,0,9999,6
1714633217566,EDS 115,A00,507243,Choi; Bailey Miyeon,10,0,28,18
1714633218591,EDS 117,A01,494379,Staff,0,4,30,30
1714633219616,EDS 125,A00,507246,Hopkins; Megan Beth,9,0,30,21
1714633220644,EDS 128A,A01,507264,Fargason; Sharon Gayle,8,0,26,18
1714633221670,EDS 128B,A01,507293,Pappas; Elizabeth,12,0,30,18
1714633222697,EDS 139,A00,507294,Fargason; Sharon Gayle,13,0,30,17
1714633222697,EDS 139,B00,507313,Pappas; Elizabeth,13,0,30,17
1714633223727,EDS 201,A00,507315,Staff,13,0,30,17
1714633224758,EDS 203,A01,507317,Halter; Christopher P.,12,0,30,18
1714633225785,EDS 204R,A01,507319,Halter; Christopher P.,0,3,30,30
1714633225785,EDS 204R,B01,507331,Heinzman; Erica M.,16,0,30,14
1714633226810,EDS 206R,A00,507332,Staff,0,4,30,30
1714633226810,EDS 206R,B00,507343,Staff,17,0,30,13
1714633227840,EDS 250,A00,507344,Hemans; Patricia Ann Benitez,22,0,40,18
1714633228865,EDS 281,A00,507345,Daly; Alan J.,18,0,18,0
1714633229891,EDS 284,A00,507350,Daly; Alan J.,16,0,16,0
1714633230921,EDS 286,A00,507359,Fine; Sarah,18,0,18,0
1714633231946,EDS 289C,A01,507361,Daly; Alan J.,18,0,18,0
1714633232974,EDS 290,A00,507366,Hofstetter; Carolyn,15,0,15,0
1714633234007,LIGM 5A,A00,507421,Fischer-Grunski; Eva K,18,0,20,2
1714633235030,LIGM 5B,A00,507423,Fischer-Grunski; Eva K,19,0,20,1
1714633236053,LIGM 5C,A00,507425,Fischer-Grunski; Eva K,19,0,20,1
1714633237083,LIIT 5AS,A00,507427,Carnelos; Chiara,20,0,20,0
1714633238112,LIIT 5BS,A00,507430,Carnelos; Chiara,20,0,20,0
1714633239142,LIIT 5CS,A00,507432,Carnelos; Chiara,20,0,20,0
1714633240173,LISP 5A,A00,507541,Munoz Sanchez; Alicia,11,0,20,9
1714633241202,LISP 5B,A00,507671,Munoz Sanchez; Alicia,8,0,20,12
1714633242231,LISP 5C,A00,507696,Munoz Sanchez; Alicia,9,0,20,11
1714633243257,MAE 197,001,528363,Boechler; Nicholas Sebastia,9998,0,9999,1
1714633244285,MATH 197,001,523477,Kedlaya; Kiran S.,9995,0,9999,4
1714633244285,MATH 197,002,563811,Zhang; Danna,9995,0,9999,4
1714633244285,MATH 197,003,628552,Dumitriu; Ioana,9998,0,9999,1
1714633245327,MCWP 40R,A00,518780,Staff,2,0,20,18
1714633245327,MCWP 40R,B00,518781,Staff,8,0,20,12
1714633245327,MCWP 40R,C00,518783,Staff,6,0,20,14
1714633246356,MCWP 50R,A00,518791,Staff,0,0,20,20
1714633246356,MCWP 50R,B00,518792,Staff,0,2,20,20
1714633246356,MCWP 50R,C00,518793,Staff,0,2,20,20
1714633246356,MCWP 50R,D00,518794,Staff,0,0,20,20
1714633246356,MCWP 50R,E00,518795,Staff,0,2,20,20
1714633246356,MCWP 50R,F00,518796,Staff,0,0,20,20
1714633246356,MCWP 50R,G00,518797,Staff,0,1,20,20
1714633247385,MMW 12R,A01,514034,Herbst; Matthew,0,0,16,16
1714633247385,MMW 12R,A02,514035,Herbst; Matthew,1,0,16,15
1714633248414,MMW 13R,A01,514037,Staff,0,4,16,16
1714633248414,MMW 13R,A02,514039,Staff,0,2,16,16
1714633248414,MMW 13R,A03,628519,Staff,0,2,16,16
1714633250466,SIO 295LS,A00,523233,Staff,10,0,30,20
1714633251491,SIO 295S,A00,523232,Staff,10,0,30,20
1714633252521,SIOC 290S,A01,637330,Merrifield; Mark A,23,0,30,7
1714633253549,SIOC 291S,A01,637333,Gabriel; Corey John,23,0,30,7
1714633254574,SOCI 117,A01,494376,Staff,0,4,5,5
1714633255602,WES 237B,A00,494380,Staff,9,0,20,11
1714633257671,AESE 279B,A00,494370,Wade; Jon P,0,0,33,33
1714633258712,AIP 197,001,627712,Vespa; Emanuel Ignacio,9998,0,9999,1
1714633259740,ANAR 135S,A00,494369,Braswell; Geoffrey E.,0,0,0,0
1714633260772,BENG 196,001,628496,Engler; Adam J.,9998,0,9999,1
1714633261803,CAT 124RS,A01,519847,Geibel; William,0,0,20,20
1714633262832,CAT 125RS,A01,515971,Geibel; William,0,0,20,20
1714633263867,CLRE 250,A00,511389,Morris; Sheldon,9993,0,9999,6
1714633264896,CLRE 251,A00,507176,Mehta; Ravindra L.,9993,0,9999,6
1714633264896,CLRE 251,B00,511410,Mehta; Ravindra L.,9998,0,9999,1
1714633265973,CLRE 252,A00,507189,Cuomo; Raphael Eduardo,9995,0,9999,4
1714633267000,CLRE 253,A00,507199,Vaida; Florin,9994,0,9999,5
1714633267000,CLRE 253,B00,507202,Vaida; Florin,9999,0,9999,0
1714633268030,CLRE 259,A00,507211,Patel; Hemal,9996,0,9999,3
1714633269067,CLRE 260,A00,507221,Cuomo; Raphael Eduardo,9999,0,9999,0
1714633270162,CLRE 297,001,507242,Cuomo; Raphael Eduardo,9999,0,9999,0
1714633271189,COGS 197,001,638244,Voytek; Bradley Thomas,9998,0,9999,1
1714633272246,CSE 191,A00,516875,Minnes Kemp; Mor Mia,9992,0,9999,7
1714633273271,CSE 197,001,637388,Minnes Kemp; Mor Mia,9998,0,9999,1
1714633274321,CSS 201S,A01,494383,Staff,35,0,35,0
1714633275357,CSS 202S,A01,494387,Staff,35,0,35,0
1714633276382,DSC 197,001,628532,Eldridge; Justin Matthew,9996,0,9999,3
1714633277409,EAP 100,A00,516065,Staff,9797,0,9999,202
1714633278436,ECE 45,A01,507414,Staff,33,0,60,27
1714633280496,ECE 111,A01,507420,Staff,15,0,50,35
1714633281528,ECE 197,001,548057,Sievenpiper; Daniel F.,9993,0,9999,6
1714633282556,EDS 115,A00,507243,Choi; Bailey Miyeon,10,0,28,18
1714633283591,EDS 117,A01,494379,Staff,0,4,30,30
1714633284617,EDS 125,A00,507246,Hopkins; Megan Beth,9,0,30,21
1714633285654,EDS 128A,A01,507264,Fargason; Sharon Gayle,8,0,26,18
1714633286696,EDS 128B,A01,507293,Pappas; Elizabeth,12,0,30,18
1714633287721,EDS 139,A00,507294,Fargason; Sharon Gayle,13,0,30,17
1714633287721,EDS 139,B00,507313,Pappas; Elizabeth,13,0,30,17
1714633288764,EDS 201,A00,507315,Staff,13,0,30,17
1714633289792,EDS 203,A01,507317,Halter; Christopher P.,12,0,30,18
1714633290818,EDS 204R,A01,507319,Halter; Christopher P.,0,3,30,30
1714633290818,EDS 204R,B01,507331,Heinzman; Erica M.,16,0,30,14
1714633291843,EDS 206R,A00,507332,Staff,0,4,30,30
1714633291843,EDS 206R,B00,507343,Staff,17,0,30,13
1714633292869,EDS 250,A00,507344,Hemans; Patricia Ann Benitez,22,0,40,18
1714633293905,EDS 281,A00,507345,Daly; Alan J.,18,0,18,0
1714633294930,EDS 284,A00,507350,Daly; Alan J.,16,0,16,0
1714633295957,EDS 286,A00,507359,Fine; Sarah,18,0,18,0
1714633296984,EDS 289C,A01,507361,Daly; Alan J.,18,0,18,0
1714633298019,EDS 290,A00,507366,Hofstetter; Carolyn,15,0,15,0
1714633299054,LIGM 5A,A00,507421,Fischer-Grunski; Eva K,18,0,20,2
1714633300082,LIGM 5B,A00,507423,Fischer-Grunski; Eva K,19,0,20,1
1714633301107,LIGM 5C,A00,507425,Fischer-Grunski; Eva K,19,0,20,1
1714633302138,LIIT 5AS,A00,507427,Carnelos; Chiara,20,0,20,0
1714633303167,LIIT 5BS,A00,507430,Carnelos; Chiara,20,0,20,0
1714633304193,LIIT 5CS,A00,507432,Carnelos; Chiara,20,0,20,0
1714633305220,LISP 5A,A00,507541,Munoz Sanchez; Alicia,11,0,20,9
1714633306248,LISP 5B,A00,507671,Munoz Sanchez; Alicia,8,0,20,12
1714633307274,LISP 5C,A00,507696,Munoz Sanchez; Alicia,9,0,20,11
1714633308299,MAE 197,001,528363,Boechler; Nicholas Sebastia,9998,0,9999,1
1714633309327,MATH 197,001,523477,Kedlaya; Kiran S.,9995,0,9999,4
1714633309327,MATH 197,002,563811,Zhang; Danna,9995,0,9999,4
1714633309327,MATH 197,003,628552,Dumitriu; Ioana,9998,0,9999,1
1714633310353,MCWP 40R,A00,518780,Staff,2,0,20,18
1714633310353,MCWP 40R,B00,518781,Staff,8,0,20,12
1714633310353,MCWP 40R,C00,518783,Staff,6,0,20,14
1714633311381,MCWP 50R,A00,518791,Staff,0,0,20,20
1714633311381,MCWP 50R,B00,518792,Staff,0,2,20,20
1714633311381,MCWP 50R,C00,518793,Staff,0,2,20,20
1714633311381,MCWP 50R,D00,518794,Staff,0,0,20,20
1714633311381,MCWP 50R,E00,518795,Staff,0,2,20,20
1714633311381,MCWP 50R,F00,518796,Staff,0,0,20,20
1714633311381,MCWP 50R,G00,518797,Staff,0,1,20,20
1714633312416,MMW 12R,A01,514034,Herbst; Matthew,0,0,16,16
1714633312416,MMW 12R,A02,514035,Herbst; Matthew,1,0,16,15
1714633313496,MMW 13R,A01,514037,Staff,0,4,16,16
1714633313496,MMW 13R,A02,514039,Staff,0,2,16,16
1714633313496,MMW 13R,A03,628519,Staff,0,2,16,16
1714633315551,SIO 295LS,A00,523233,Staff,10,0,30,20
1714633316577,SIO 295S,A00,523232,Staff,10,0,30,20
1714633317613,SIOC 290S,A01,637330,Merrifield; Mark A,23,0,30,7
1714633318639,SIOC 291S,A01,637333,Gabriel; Corey John,23,0,30,7
1714633319664,SOCI 117,A01,494376,Staff,0,4,5,5
1714633320701,WES 237B,A00,494380,Staff,9,0,20,11
1714633322840,AESE 279B,A00,494370,Wade; Jon P,0,0,33,33
1714633323875,AIP 197,001,627712,Vespa; Emanuel Ignacio,9998,0,9999,1
1714633324910,ANAR 135S,A00,494369,Braswell; Geoffrey E.,0,0,0,0
1714633325943,BENG 196,001,628496,Engler; Adam J.,9998,0,9999,1
1714633326970,CAT 124RS,A01,519847,Geibel; William,0,0,20,20
1714633327996,CAT 125RS,A01,515971,Geibel; William,0,0,20,20
1714633329028,CLRE 250,A00,511389,Morris; Sheldon,9993,0,9999,6
1714633330056,CLRE 251,A00,507176,Mehta; Ravindra L.,9993,0,9999,6
1714633330056,CLRE 251,B00,511410,Mehta; Ravindra L.,9998,0,9999,1
1714633331082,CLRE 252,A00,507189,Cuomo; Raphael Eduardo,9995,0,9999,4
1714633332110,CLRE 253,A00,507199,Vaida; Florin,9994,0,9999,5
1714633332110,CLRE 253,B00,507202,Vaida; Florin,9999,0,9999,0
1714633333140,CLRE 259,A00,507211,Patel; Hemal,9996,0,9999,3
1714633334165,CLRE 260,A00,507221,Cuomo; Raphael Eduardo,9999,0,9999,0
1714633335196,CLRE 297,001,507242,Cuomo; Raphael Eduardo,9999,0,9999,0
1714633336234,COGS 197,001,638244,Voytek; Bradley Thomas,9998,0,9999,1
1714633337262,CSE 191,A00,516875,Minnes Kemp; Mor Mia,9992,0,9999,7
1714633338289,CSE 197,001,637388,Minnes Kemp; Mor Mia,9998,0,9999,1
1714633339314,CSS 201S,A01,494383,Staff,35,0,35,0
1714633340346,CSS 202S,A01,494387,Staff,35,0,35,0
1714633341373,DSC 197,001,628532,Eldridge; Justin Matthew,9996,0,9999,3
1714633342398,EAP 100,A00,516065,Staff,9797,0,9999,202
1714633343425,ECE 45,A01,507414,Staff,33,0,60,27
1714633345477,ECE 111,A01,507420,Staff,15,0,50,35
1714633346503,ECE 197,001,548057,Sievenpiper; Daniel F.,9993,0,9999,6
1714633347530,EDS 115,A00,507243,Choi; Bailey Miyeon,10,0,28,18
1714633348609,EDS 117,A01,494379,Staff,0,4,30,30
1714633349635,EDS 125,A00,507246,Hopkins; Megan Beth,9,0,30,21
1714633350665,EDS 128A,A01,507264,Fargason; Sharon Gayle,8,0,26,18
1714633351690,EDS 128B,A01,507293,Pappas; Elizabeth,12,0,30,18
1714633352717,EDS 139,A00,507294,Fargason; Sharon Gayle,13,0,30,17
1714633352717,EDS 139,B00,507313,Pappas; Elizabeth,13,0,30,17
1714633353742,EDS 201,A00,507315,Staff,13,0,30,17
1714633354767,EDS 203,A01,507317,Halter; Christopher P.,12,0,30,18
1714633355794,EDS 204R,A01,507319,Halter; Christopher P.,0,3,30,30
1714633355794,EDS 204R,B01,507331,Heinzman; Erica M.,16,0,30,14
1714633356820,EDS 206R,A00,507332,Staff,0,4,30,30
1714633356820,EDS 206R,B00,507343,Staff,17,0,30,13
1714633357849,EDS 250,A00,507344,Hemans; Patricia Ann Benitez,22,0,40,18
1714633358875,EDS 281,A00,507345,Daly; Alan J.,18,0,18,0
1714633359901,EDS 284,A00,507350,Daly; Alan J.,16,0,16,0
1714633360928,EDS 286,A00,507359,Fine; Sarah,18,0,18,0
1714633361961,EDS 289C,A01,507361,Daly; Alan J.,18,0,18,0
1714633362986,EDS 290,A00,507366,Hofstetter; Carolyn,15,0,15,0
1714633364014,LIGM 5A,A00,507421,Fischer-Grunski; Eva K,18,0,20,2
1714633365039,LIGM 5B,A00,507423,Fischer-Grunski; Eva K,19,0,20,1
1714633366066,LIGM 5C,A00,507425,Fischer-Grunski; Eva K,19,0,20,1
1714633367104,LIIT 5AS,A00,507427,Carnelos; Chiara,20,0,20,0
1714633368129,LIIT 5BS,A00,507430,Carnelos; Chiara,20,0,20,0
1714633369154,LIIT 5CS,A00,507432,Carnelos; Chiara,20,0,20,0
1714633370182,LISP 5A,A00,507541,Munoz Sanchez; Alicia,11,0,20,9
1714633371208,LISP 5B,A00,507671,Munoz Sanchez; Alicia,8,0,20,12
1714633372235,LISP 5C,A00,507696,Munoz Sanchez; Alicia,9,0,20,11
1714633373265,MAE 197,001,528363,Boechler; Nicholas Sebastia,9998,0,9999,1
1714633374291,MATH 197,001,523477,Kedlaya; Kiran S.,9995,0,9999,4
1714633374291,MATH 197,002,563811,Zhang; Danna,9995,0,9999,4
1714633374291,MATH 197,003,628552,Dumitriu; Ioana,9998,0,9999,1
1714633375319,MCWP 40R,A00,518780,Staff,2,0,20,18
1714633375319,MCWP 40R,B00,518781,Staff,8,0,20,12
1714633375319,MCWP 40R,C00,518783,Staff,6,0,20,14
1714633376345,MCWP 50R,A00,518791,Staff,0,0,20,20
1714633376345,MCWP 50R,B00,518792,Staff,0,2,20,20
1714633376345,MCWP 50R,C00,518793,Staff,0,2,20,20
1714633376345,MCWP 50R,D00,518794,Staff,0,0,20,20
1714633376345,MCWP 50R,E00,518795,Staff,0,2,20,20
1714633376345,MCWP 50R,F00,518796,Staff,0,0,20,20
1714633376345,MCWP 50R,G00,518797,Staff,0,1,20,20
1714633377373,MMW 12R,A01,514034,Herbst; Matthew,0,0,16,16
1714633377373,MMW 12R,A02,514035,Herbst; Matthew,1,0,16,15
1714633378399,MMW 13R,A01,514037,Staff,0,4,16,16
1714633378399,MMW 13R,A02,514039,Staff,0,2,16,16
1714633378399,MMW 13R,A03,628519,Staff,0,2,16,16
1714633380454,SIO 295LS,A00,523233,Staff,10,0,30,20
1714633381484,SIO 295S,A00,523232,Staff,10,0,30,20
1714633382512,SIOC 290S,A01,637330,Merrifield; Mark A,23,0,30,7
1714633383538,SIOC 291S,A01,637333,Gabriel; Corey John,23,0,30,7
1714633384563,SOCI 117,A01,494376,Staff,0,4,5,5
1714633385592,WES 237B,A00,494380,Staff,9,0,20,11
1714633387678,AESE 279B,A00,494370,Wade; Jon P,0,0,33,33
1714633388703,AIP 197,001,627712,Vespa; Emanuel Ignacio,9998,0,9999,1
1714633389734,ANAR 135S,A00,494369,Braswell; Geoffrey E.,0,0,0,0
1714633390766,BENG 196,001,628496,Engler; Adam J.,9998,0,9999,1
1714633391795,CAT 124RS,A01,519847,Geibel; William,0,0,20,20
1714633392819,CAT 125RS,A01,515971,Geibel; William,0,0,20,20
1714633393847,CLRE 250,A00,511389,Morris; Sheldon,9993,0,9999,6
1714633394879,CLRE 251,A00,507176,Mehta; Ravindra L.,9993,0,9999,6
1714633394879,CLRE 251,B00,511410,Mehta; Ravindra L.,9998,0,9999,1
1714633395908,CLRE 252,A00,507189,Cuomo; Raphael Eduardo,9995,0,9999,4
1714633396935,CLRE 253,A00,507199,Vaida; Florin,9994,0,9999,5
1714633396935,CLRE 253,B00,507202,Vaida; Florin,9999,0,9999,0
1714633397966,CLRE 259,A00,507211,Patel; Hemal,9996,0,9999,3
1714633398992,CLRE 260,A00,507221,Cuomo; Raphael Eduardo,9999,0,9999,0
1714633400019,CLRE 297,001,507242,Cuomo; Raphael Eduardo,9999,0,9999,0
1714633401046,COGS 197,001,638244,Voytek; Bradley Thomas,9998,0,9999,1
1714633402073,CSE 191,A00,516875,Minnes Kemp; Mor Mia,9992,0,9999,7
1714633403098,CSE 197,001,637388,Minnes Kemp; Mor Mia,9998,0,9999,1
1714633404124,CSS 201S,A01,494383,Staff,35,0,35,0
1714633405149,CSS 202S,A01,494387,Staff,35,0,35,0
1714633406183,DSC 197,001,628532,Eldridge; Justin Matthew,9996,0,9999,3
1714633407216,EAP 100,A00,516065,Staff,9797,0,9999,202
1714633408241,ECE 45,A01,507414,Staff,33,0,60,27
1714633410294,ECE 111,A01,507420,Staff,15,0,50,35
1714633411319,ECE 197,001,548057,Sievenpiper; Daniel F.,9993,0,9999,6
1714633412357,EDS 115,A00,507243,Choi; Bailey Miyeon,10,0,28,18
1714633413383,EDS 117,A01,494379,Staff,0,4,30,30
1714633414409,EDS 125,A00,507246,Hopkins; Megan Beth,9,0,30,21
1714633415987,EDS 128A,A01,507264,Fargason; Sharon Gayle,8,0,26,18
1714633417018,EDS 128B,A01,507293,Pappas; Elizabeth,12,0,30,18
1714633418043,EDS 139,A00,507294,Fargason; Sharon Gayle,13,0,30,17
1714633418043,EDS 139,B00,507313,Pappas; Elizabeth,13,0,30,17
1714633419074,EDS 201,A00,507315,Staff,13,0,30,17
1714633420100,EDS 203,A01,507317,Halter; Christopher P.,12,0,30,18
1714633421125,EDS 204R,A01,507319,Halter; Christopher P.,0,3,30,30
1714633421125,EDS 204R,B01,507331,Heinzman; Erica M.,16,0,30,14
1714633422154,EDS 206R,A00,507332,Staff,0,4,30,30
1714633422154,EDS 206R,B00,507343,Staff,17,0,30,13
1714633423182,EDS 250,A00,507344,Hemans; Patricia Ann Benitez,22,0,40,18
1714633424214,EDS 281,A00,507345,Daly; Alan J.,18,0,18,0
1714633425242,EDS 284,A00,507350,Daly; Alan J.,16,0,16,0
1714633426267,EDS 286,A00,507359,Fine; Sarah,18,0,18,0
1714633427291,EDS 289C,A01,507361,Daly; Alan J.,18,0,18,0
1714633428318,EDS 290,A00,507366,Hofstetter; Carolyn,15,0,15,0
1714633429344,LIGM 5A,A00,507421,Fischer-Grunski; Eva K,18,0,20,2
1714633430373,LIGM 5B,A00,507423,Fischer-Grunski; Eva K,19,0,20,1
1714633431398,LIGM 5C,A00,507425,Fischer-Grunski; Eva K,19,0,20,1
1714633432423,LIIT 5AS,A00,507427,Carnelos; Chiara,20,0,20,0
1714633433449,LIIT 5BS,A00,507430,Carnelos; Chiara,20,0,20,0
1714633434475,LIIT 5CS,A00,507432,Carnelos; Chiara,20,0,20,0
1714633435507,LISP 5A,A00,507541,Munoz Sanchez; Alicia,11,0,20,9
1714633436537,LISP 5B,A00,507671,Munoz Sanchez; Alicia,8,0,20,12
1714633437566,LISP 5C,A00,507696,Munoz Sanchez; Alicia,9,0,20,11
1714633438597,MAE 197,001,528363,Boechler; Nicholas Sebastia,9998,0,9999,1
1714633439629,MATH 197,001,523477,Kedlaya; Kiran S.,9995,0,9999,4
1714633439629,MATH 197,002,563811,Zhang; Danna,9995,0,9999,4
1714633439629,MATH 197,003,628552,Dumitriu; Ioana,9998,0,9999,1
1714633440667,MCWP 40R,A00,518780,Staff,2,0,20,18
1714633440667,MCWP 40R,B00,518781,Staff,8,0,20,12
1714633440667,MCWP 40R,C00,518783,Staff,6,0,20,14
1714633441693,MCWP 50R,A00,518791,Staff,0,0,20,20
1714633441693,MCWP 50R,B00,518792,Staff,0,2,20,20
1714633441693,MCWP 50R,C00,518793,Staff,0,2,20,20
1714633441693,MCWP 50R,D00,518794,Staff,0,0,20,20
1714633441693,MCWP 50R,E00,518795,Staff,0,2,20,20
1714633441693,MCWP 50R,F00,518796,Staff,0,0,20,20
1714633441693,MCWP 50R,G00,518797,Staff,0,1,20,20
1714633442725,MMW 12R,A01,514034,Herbst; Matthew,0,0,16,16
1714633442725,MMW 12R,A02,514035,Herbst; Matthew,1,0,16,15
1714633443750,MMW 13R,A01,514037,Staff,0,4,16,16
1714633443750,MMW 13R,A02,514039,Staff,0,2,16,16
1714633443750,MMW 13R,A03,628519,Staff,0,2,16,16
1714633445806,SIO 295LS,A00,523233,Staff,10,0,30,20
1714633446832,SIO 295S,A00,523232,Staff,10,0,30,20
1714633447866,SIOC 290S,A01,637330,Merrifield; Mark A,23,0,30,7
1714633448893,SIOC 291S,A01,637333,Gabriel; Corey John,23,0,30,7
1714633449920,SOCI 117,A01,494376,Staff,0,4,5,5
1714633450946,WES 237B,A00,494380,Staff,9,0,20,11
1714633453080,AESE 279B,A00,494370,Wade; Jon P,0,0,33,33
1714633454109,AIP 197,001,627712,Vespa; Emanuel Ignacio,9998,0,9999,1
1714633455140,ANAR 135S,A00,494369,Braswell; Geoffrey E.,0,0,0,0
1714633456164,BENG 196,001,628496,Engler; Adam J.,9998,0,9999,1
1714633457190,CAT 124RS,A01,519847,Geibel; William,0,0,20,20
1714633458215,CAT 125RS,A01,515971,Geibel; William,0,0,20,20
1714633459244,CLRE 250,A00,511389,Morris; Sheldon,9993,0,9999,6
1714633460270,CLRE 251,A00,507176,Mehta; Ravindra L.,9993,0,9999,6
1714633460270,CLRE 251,B00,511410,Mehta; Ravindra L.,9998,0,9999,1
1714633461297,CLRE 252,A00,507189,Cuomo; Raphael Eduardo,9995,0,9999,4
1714633462324,CLRE 253,A00,507199,Vaida; Florin,9994,0,9999,5
1714633462324,CLRE 253,B00,507202,Vaida; Florin,9999,0,9999,0
1714633463348,CLRE 259,A00,507211,Patel; Hemal,9996,0,9999,3
1714633464373,CLRE 260,A00,507221,Cuomo; Raphael Eduardo,9999,0,9999,0
1714633465405,CLRE 297,001,507242,Cuomo; Raphael Eduardo,9999,0,9999,0
1714633466433,COGS 197,001,638244,Voytek; Bradley Thomas,9998,0,9999,1
1714633467461,CSE 191,A00,516875,Minnes Kemp; Mor Mia,9992,0,9999,7
1714633468489,CSE 197,001,637388,Minnes Kemp; Mor Mia,9998,0,9999,1
1714633469519,CSS 201S,A01,494383,Staff,35,0,35,0
1714633470545,CSS 202S,A01,494387,Staff,35,0,35,0
1714633471572,DSC 197,001,628532,Eldridge; Justin Matthew,9996,0,9999,3
1714633472597,EAP 100,A00,516065,Staff,9797,0,9999,202
1714633473624,ECE 45,A01,507414,Staff,33,0,60,27
1714633475696,ECE 111,A01,507420,Staff,15,0,50,35
1714633476730,ECE 197,001,548057,Sievenpiper; Daniel F.,9993,0,9999,6
1714633477761,EDS 115,A00,507243,Choi; Bailey Miyeon,10,0,28,18
1714633478793,EDS 117,A01,494379,Staff,0,4,30,30
1714633479821,EDS 125,A00,507246,Hopkins; Megan Beth,9,0,30,21
1714633480846,EDS 128A,A01,507264,Fargason; Sharon Gayle,8,0,26,18
1714633481876,EDS 128B,A01,507293,Pappas; Elizabeth,12,0,30,18
1714633482900,EDS 139,A00,507294,Fargason; Sharon Gayle,13,0,30,17
1714633482900,EDS 139,B00,507313,Pappas; Elizabeth,13,0,30,17
1714633483925,EDS 201,A00,507315,Staff,13,0,30,17
1714633484952,EDS 203,A01,507317,Halter; Christopher P.,12,0,30,18
1714633485977,EDS 204R,A01,507319,Halter; Christopher P.,0,3,30,30
1714633485977,EDS 204R,B01,507331,Heinzman; Erica M.,16,0,30,14
1714633487002,EDS 206R,A00,507332,Staff,0,4,30,30
1714633487002,EDS 206R,B00,507343,Staff,17,0,30,13
1714633488028,EDS 250,A00,507344,Hemans; Patricia Ann Benitez,22,0,40,18
1714633489057,EDS 281,A00,507345,Daly; Alan J.,18,0,18,0
1714633490085,EDS 284,A00,507350,Daly; Alan J.,16,0,16,0
1714633491111,EDS 286,A00,507359,Fine; Sarah,18,0,18,0
1714633492135,EDS 289C,A01,507361,Daly; Alan J.,18,0,18,0
1714633493159,EDS 290,A00,507366,Hofstetter; Carolyn,15,0,15,0
1714633494186,LIGM 5A,A00,507421,Fischer-Grunski; Eva K,18,0,20,2
1714633495217,LIGM 5B,A00,507423,Fischer-Grunski; Eva K,19,0,20,1
1714633496245,LIGM 5C,A00,507425,Fischer-Grunski; Eva K,19,0,20,1
1714633497270,LIIT 5AS,A00,507427,Carnelos; Chiara,20,0,20,0
1714633498297,LIIT 5BS,A00,507430,Carnelos; Chiara,20,0,20,0
1714633499323,LIIT 5CS,A00,507432,Carnelos; Chiara,20,0,20,0
1714633500351,LISP 5A,A00,507541,Munoz Sanchez; Alicia,11,0,20,9
1714633501375,LISP 5B,A00,507671,Munoz Sanchez; Alicia,8,0,20,12
1714633502402,LISP 5C,A00,507696,Munoz Sanchez; Alicia,9,0,20,11
1714633503434,MAE 197,001,528363,Boechler; Nicholas Sebastia,9998,0,9999,1
1714633504460,MATH 197,001,523477,Kedlaya; Kiran S.,9995,0,9999,4
1714633504460,MATH 197,002,563811,Zhang; Danna,9995,0,9999,4
1714633504460,MATH 197,003,628552,Dumitriu; Ioana,9998,0,9999,1
1714633505485,MCWP 40R,A00,518780,Staff,2,0,20,18
1714633505485,MCWP 40R,B00,518781,Staff,8,0,20,12
1714633505485,MCWP 40R,C00,518783,Staff,6,0,20,14
1714633506511,MCWP 50R,A00,518791,Staff,0,0,20,20
1714633506511,MCWP 50R,B00,518792,Staff,0,2,20,20
1714633506511,MCWP 50R,C00,518793,Staff,0,2,20,20
1714633506511,MCWP 50R,D00,518794,Staff,0,0,20,20
1714633506511,MCWP 50R,E00,518795,Staff,0,2,20,20
1714633506511,MCWP 50R,F00,518796,Staff,0,0,20,20
1714633506511,MCWP 50R,G00,518797,Staff,0,1,20,20
1714633507539,MMW 12R,A01,514034,Herbst; Matthew,0,0,16,16
1714633507539,MMW 12R,A02,514035,Herbst; Matthew,1,0,16,15
1714633508565,MMW 13R,A01,514037,Staff,0,4,16,16
1714633508565,MMW 13R,A02,514039,Staff,0,2,16,16
1714633508565,MMW 13R,A03,628519,Staff,0,2,16,16
1714633510616,SIO 295LS,A00,523233,Staff,10,0,30,20
1714633511642,SIO 295S,A00,523232,Staff,10,0,30,20
1714633512668,SIOC 290S,A01,637330,Merrifield; Mark A,23,0,30,7
1714633513693,SIOC 291S,A01,637333,Gabriel; Corey John,23,0,30,7
1714633514720,SOCI 117,A01,494376,Staff,0,4,5,5
1714633515748,WES 237B,A00,494380,Staff,9,0,20,11
1714633517828,AESE 279B,A00,494370,Wade; Jon P,0,0,33,33
1714633518913,AIP 197,001,627712,Vespa; Emanuel Ignacio,9998,0,9999,1
1714633519939,ANAR 135S,A00,494369,Braswell; Geoffrey E.,0,0,0,0
1714633520970,BENG 196,001,628496,Engler; Adam J.,9998,0,9999,1
1714633521997,CAT 124RS,A01,519847,Geibel; William,0,0,20,20
1714633523022,CAT 125RS,A01,515971,Geibel; William,0,0,20,20
1714633524048,CLRE 250,A00,511389,Morris; Sheldon,9993,0,9999,6
1714633525077,CLRE 251,A00,507176,Mehta; Ravindra L.,9993,0,9999,6
1714633525077,CLRE 251,B00,511410,Mehta; Ravindra L.,9998,0,9999,1
1714633526108,CLRE 252,A00,507189,Cuomo; Raphael Eduardo,9995,0,9999,4
1714633527135,CLRE 253,A00,507199,Vaida; Florin,9994,0,9999,5
1714633527135,CLRE 253,B00,507202,Vaida; Florin,9999,0,9999,0
1714633528164,CLRE 259,A00,507211,Patel; Hemal,9996,0,9999,3
1714633529190,CLRE 260,A00,507221,Cuomo; Raphael Eduardo,9999,0,9999,0
1714633530214,CLRE 297,001,507242,Cuomo; Raphael Eduardo,9999,0,9999,0
1714633531241,COGS 197,001,638244,Voytek; Bradley Thomas,9998,0,9999,1
1714633532273,CSE 191,A00,516875,Minnes Kemp; Mor Mia,9992,0,9999,7
1714633533299,CSE 197,001,637388,Minnes Kemp; Mor Mia,9998,0,9999,1
1714633534331,CSS 201S,A01,494383,Staff,35,0,35,0
1714633535358,CSS 202S,A01,494387,Staff,35,0,35,0
1714633536391,DSC 197,001,628532,Eldridge; Justin Matthew,9996,0,9999,3
1714633537415,EAP 100,A00,516065,Staff,9797,0,9999,202
1714633538440,ECE 45,A01,507414,Staff,33,0,60,27
1714633540496,ECE 111,A01,507420,Staff,15,0,50,35
1714633541523,ECE 197,001,548057,Sievenpiper; Daniel F.,9993,0,9999,6
1714633542551,EDS 115,A00,507243,Choi; Bailey Miyeon,10,0,28,18
1714633543585,EDS 117,A01,494379,Staff,0,4,30,30
1714633544616,EDS 125,A00,507246,Hopkins; Megan Beth,9,0,30,21
1714633545645,EDS 128A,A01,507264,Fargason; Sharon Gayle,8,0,26,18
1714633546676,EDS 128B,A01,507293,Pappas; Elizabeth,12,0,30,18
1714633547704,EDS 139,A00,507294,Fargason; Sharon Gayle,13,0,30,17
1714633547704,EDS 139,B00,507313,Pappas; Elizabeth,13,0,30,17
1714633548731,EDS 201,A00,507315,Staff,13,0,30,17
1714633549758,EDS 203,A01,507317,Halter; Christopher P.,12,0,30,18
1714633550784,EDS 204R,A01,507319,Halter; Christopher P.,0,3,30,30
1714633550784,EDS 204R,B01,507331,Heinzman; Erica M.,16,0,30,14
1714633551810,EDS 206R,A00,507332,Staff,0,4,30,30
1714633551810,EDS 206R,B00,507343,Staff,17,0,30,13
1714633552838,EDS 250,A00,507344,Hemans; Patricia Ann Benitez,22,0,40,18
1714633553874,EDS 281,A00,507345,Daly; Alan J.,18,0,18,0
1714633554902,EDS 284,A00,507350,Daly; Alan J.,16,0,16,0
1714633555930,EDS 286,A00,507359,Fine; Sarah,18,0,18,0
1714633556962,EDS 289C,A01,507361,Daly; Alan J.,18,0,18,0
1714633557988,EDS 290,A00,507366,Hofstetter; Carolyn,15,0,15,0
1714633559016,LIGM 5A,A00,507421,Fischer-Grunski; Eva K,18,0,20,2
1714633560041,LIGM 5B,A00,507423,Fischer-Grunski; Eva K,19,0,20,1
1714633561077,LIGM 5C,A00,507425,Fischer-Grunski; Eva K,19,0,20,1
1714633562105,LIIT 5AS,A00,507427,Carnelos; Chiara,20,0,20,0
1714633563131,LIIT 5BS,A00,507430,Carnelos; Chiara,20,0,20,0
1714633564162,LIIT 5CS,A00,507432,Carnelos; Chiara,20,0,20,0
1714633565193,LISP 5A,A00,507541,Munoz Sanchez; Alicia,11,0,20,9
1714633566219,LISP 5B,A00,507671,Munoz Sanchez; Alicia,8,0,20,12
1714633567249,LISP 5C,A00,507696,Munoz Sanchez; Alicia,9,0,20,11
1714633568276,MAE 197,001,528363,Boechler; Nicholas Sebastia,9998,0,9999,1
1714633569316,MATH 197,001,523477,Kedlaya; Kiran S.,9995,0,9999,4
1714633569316,MATH 197,002,563811,Zhang; Danna,9995,0,9999,4
1714633569316,MATH 197,003,628552,Dumitriu; Ioana,9998,0,9999,1
1714633570345,MCWP 40R,A00,518780,Staff,2,0,20,18
1714633570345,MCWP 40R,B00,518781,Staff,8,0,20,12
1714633570345,MCWP 40R,C00,518783,Staff,6,0,20,14
1714633571380,MCWP 50R,A00,518791,Staff,0,0,20,20
1714633571380,MCWP 50R,B00,518792,Staff,0,2,20,20
1714633571380,MCWP 50R,C00,518793,Staff,0,2,20,20
1714633571380,MCWP 50R,D00,518794,Staff,0,0,20,20
1714633571380,MCWP 50R,E00,518795,Staff,0,2,20,20
1714633571380,MCWP 50R,F00,518796,Staff,0,0,20,20
1714633571380,MCWP 50R,G00,518797,Staff,0,1,20,20
1714633572414,MMW 12R,A01,514034,Herbst; Matthew,0,0,16,16
1714633572414,MMW 12R,A02,514035,Herbst; Matthew,1,0,16,15
1714633573441,MMW 13R,A01,514037,Staff,0,4,16,16
1714633573441,MMW 13R,A02,514039,Staff,0,2,16,16
1714633573441,MMW 13R,A03,628519,Staff,0,2,16,16
1714633575493,SIO 295LS,A00,523233,Staff,10,0,30,20
1714633576525,SIO 295S,A00,523232,Staff,10,0,30,20
1714633577553,SIOC 290S,A01,637330,Merrifield; Mark A,23,0,30,7
1714633578578,SIOC 291S,A01,637333,Gabriel; Corey John,23,0,30,7
1714633579609,SOCI 117,A01,494376,Staff,0,4,5,5
1714633580638,WES 237B,A00,494380,Staff,9,0,20,11
1714633582711,AESE 279B,A00,494370,Wade; Jon P,0,0,33,33
1714633583738,AIP 197,001,627712,Vespa; Emanuel Ignacio,9998,0,9999,1
1714633584765,ANAR 135S,A00,494369,Braswell; Geoffrey E.,0,0,0,0
1714633585795,BENG 196,001,628496,Engler; Adam J.,9998,0,9999,1
1714633586837,CAT 124RS,A01,519847,Geibel; William,0,0,20,20
1714633587868,CAT 125RS,A01,515971,Geibel; William,0,0,20,20
1714633588895,CLRE 250,A00,511389,Morris; Sheldon,9993,0,9999,6
1714633589921,CLRE 251,A00,507176,Mehta; Ravindra L.,9993,0,9999,6
1714633589921,CLRE 251,B00,511410,Mehta; Ravindra L.,9998,0,9999,1
1714633590950,CLRE 252,A00,507189,Cuomo; Raphael Eduardo,9995,0,9999,4
1714633591983,CLRE 253,A00,507199,Vaida; Florin,9994,0,9999,5
1714633591983,CLRE 253,B00,507202,Vaida; Florin,9999,0,9999,0
1714633593014,CLRE 259,A00,507211,Patel; Hemal,9996,0,9999,3
1714633594040,CLRE 260,A00,507221,Cuomo; Raphael Eduardo,9999,0,9999,0
1714633595067,CLRE 297,001,507242,Cuomo; Raphael Eduardo,9999,0,9999,0
1714633596093,COGS 197,001,638244,Voytek; Bradley Thomas,9998,0,9999,1
1714633597117,CSE 191,A00,516875,Minnes Kemp; Mor Mia,9992,0,9999,7
1714633598143,CSE 197,001,637388,Minnes Kemp; Mor Mia,9998,0,9999,1
1714633599169,CSS 201S,A01,494383,Staff,35,0,35,0
1714633600201,CSS 202S,A01,494387,Staff,35,0,35,0
1714633601231,DSC 197,001,628532,Eldridge; Justin Matthew,9996,0,9999,3
1714633602255,EAP 100,A00,516065,Staff,9797,0,9999,202
1714633603286,ECE 45,A01,507414,Staff,33,0,60,27
1714633605349,ECE 111,A01,507420,Staff,15,0,50,35
1714633606382,ECE 197,001,548057,Sievenpiper; Daniel F.,9993,0,9999,6
1714633607409,EDS 115,A00,507243,Choi; Bailey Miyeon,10,0,28,18
1714633608443,EDS 117,A01,494379,Staff,0,4,30,30
1714633609468,EDS 125,A00,507246,Hopkins; Megan Beth,9,0,30,21
1714633610493,EDS 128A,A01,507264,Fargason; Sharon Gayle,8,0,26,18
1714633611520,EDS 128B,A01,507293,Pappas; Elizabeth,12,0,30,18
1714633612549,EDS 139,A00,507294,Fargason; Sharon Gayle,13,0,30,17
1714633612549,EDS 139,B00,507313,Pappas; Elizabeth,13,0,30,17
1714633613577,EDS 201,A00,507315,Staff,13,0,30,17
1714633614605,EDS 203,A01,507317,Halter; Christopher P.,12,0,30,18
1714633615641,EDS 204R,A01,507319,Halter; Christopher P.,0,3,30,30
1714633615641,EDS 204R,B01,507331,Heinzman; Erica M.,16,0,30,14
1714633616666,EDS 206R,A00,507332,Staff,0,4,30,30
1714633616666,EDS 206R,B00,507343,Staff,17,0,30,13
1714633617691,EDS 250,A00,507344,Hemans; Patricia Ann Benitez,22,0,40,18
1714633618716,EDS 281,A00,507345,Daly; Alan J.,18,0,18,0
1714633619744,EDS 284,A00,507350,Daly; Alan J.,16,0,16,0
1714633620773,EDS 286,A00,507359,Fine; Sarah,18,0,18,0
1714633621797,EDS 289C,A01,507361,Daly; Alan J.,18,0,18,0
1714633622892,EDS 290,A00,507366,Hofstetter; Carolyn,15,0,15,0
1714633623924,LIGM 5A,A00,507421,Fischer-Grunski; Eva K,18,0,20,2
1714633624955,LIGM 5B,A00,507423,Fischer-Grunski; Eva K,19,0,20,1
1714633625984,LIGM 5C,A00,507425,Fischer-Grunski; Eva K,19,0,20,1
1714633627012,LIIT 5AS,A00,507427,Carnelos; Chiara,20,0,20,0
1714633628038,LIIT 5BS,A00,507430,Carnelos; Chiara,20,0,20,0
1714633629062,LIIT 5CS,A00,507432,Carnelos; Chiara,20,0,20,0
1714633630089,LISP 5A,A00,507541,Munoz Sanchez; Alicia,11,0,20,9
1714633631118,LISP 5B,A00,507671,Munoz Sanchez; Alicia,8,0,20,12
1714633632144,LISP 5C,A00,507696,Munoz Sanchez; Alicia,9,0,20,11
1714633633171,MAE 197,001,528363,Boechler; Nicholas Sebastia,9998,0,9999,1
1714633634198,MATH 197,001,523477,Kedlaya; Kiran S.,9995,0,9999,4
1714633634198,MATH 197,002,563811,Zhang; Danna,9995,0,9999,4
1714633634198,MATH 197,003,628552,Dumitriu; Ioana,9998,0,9999,1
1714633635226,MCWP 40R,A00,518780,Staff,2,0,20,18
1714633635226,MCWP 40R,B00,518781,Staff,8,0,20,12
1714633635226,MCWP 40R,C00,518783,Staff,6,0,20,14
1714633636259,MCWP 50R,A00,518791,Staff,0,0,20,20
1714633636259,MCWP 50R,B00,518792,Staff,0,2,20,20
1714633636259,MCWP 50R,C00,518793,Staff,0,2,20,20
1714633636259,MCWP 50R,D00,518794,Staff,0,0,20,20
1714633636259,MCWP 50R,E00,518795,Staff,0,2,20,20
1714633636259,MCWP 50R,F00,518796,Staff,0,0,20,20
1714633636259,MCWP 50R,G00,518797,Staff,0,1,20,20
1714633637285,MMW 12R,A01,514034,Herbst; Matthew,0,0,16,16
1714633637285,MMW 12R,A02,514035,Herbst; Matthew,1,0,16,15
1714633638310,MMW 13R,A01,514037,Staff,0,4,16,16
1714633638310,MMW 13R,A02,514039,Staff,0,2,16,16
1714633638310,MMW 13R,A03,628519,Staff,0,2,16,16
1714633640363,SIO 295LS,A00,523233,Staff,10,0,30,20
1714633641387,SIO 295S,A00,523232,Staff,10,0,30,20
1714633642413,SIOC 290S,A01,637330,Merrifield; Mark A,23,0,30,7
1714633643438,SIOC 291S,A01,637333,Gabriel; Corey John,23,0,30,7
1714633644470,SOCI 117,A01,494376,Staff,0,4,5,5
1714633645494,WES 237B,A00,494380,Staff,9,0,20,11
1714633647562,AESE 279B,A00,494370,Wade; Jon P,0,0,33,33
1714633648590,AIP 197,001,627712,Vespa; Emanuel Ignacio,9998,0,9999,1
1714633649614,ANAR 135S,A00,494369,Braswell; Geoffrey E.,0,0,0,0
1714633650644,BENG 196,001,628496,Engler; Adam J.,9998,0,9999,1
1714633651671,CAT 124RS,A01,519847,Geibel; William,0,0,20,20
1714633652697,CAT 125RS,A01,515971,Geibel; William,0,0,20,20
1714633653722,CLRE 250,A00,511389,Morris; Sheldon,9993,0,9999,6
1714633654750,CLRE 251,A00,507176,Mehta; Ravindra L.,9993,0,9999,6
1714633654750,CLRE 251,B00,511410,Mehta; Ravindra L.,9998,0,9999,1
1714633655777,CLRE 252,A00,507189,Cuomo; Raphael Eduardo,9995,0,9999,4
1714633656803,CLRE 253,A00,507199,Vaida; Florin,9994,0,9999,5
1714633656803,CLRE 253,B00,507202,Vaida; Florin,9999,0,9999,0
1714633657829,CLRE 259,A00,507211,Patel; Hemal,9996,0,9999,3
1714633658854,CLRE 260,A00,507221,Cuomo; Raphael Eduardo,9999,0,9999,0
1714633659881,CLRE 297,001,507242,Cuomo; Raphael Eduardo,9999,0,9999,0
1714633660907,COGS 197,001,638244,Voytek; Bradley Thomas,9998,0,9999,1
1714633661934,CSE 191,A00,516875,Minnes Kemp; Mor Mia,9992,0,9999,7
1714633662958,CSE 197,001,637388,Minnes Kemp; Mor Mia,9998,0,9999,1
1714633663983,CSS 201S,A01,494383,Staff,35,0,35,0
1714633665007,CSS 202S,A01,494387,Staff,35,0,35,0
1714633666036,DSC 197,001,628532,Eldridge; Justin Matthew,9996,0,9999,3
1714633667061,EAP 100,A00,516065,Staff,9797,0,9999,202
1714633668087,ECE 45,A01,507414,Staff,33,0,60,27
1714633670138,ECE 111,A01,507420,Staff,15,0,50,35
1714633671164,ECE 197,001,548057,Sievenpiper; Daniel F.,9993,0,9999,6
1714633672189,EDS 115,A00,507243,Choi; Bailey Miyeon,10,0,28,18
1714633673213,EDS 117,A01,494379,Staff,0,4,30,30
1714633674243,EDS 125,A00,507246,Hopkins; Megan Beth,9,0,30,21
1714633675269,EDS 128A,A01,507264,Fargason; Sharon Gayle,8,0,26,18
1714633676294,EDS 128B,A01,507293,Pappas; Elizabeth,12,0,30,18
1714633677320,EDS 139,A00,507294,Fargason; Sharon Gayle,13,0,30,17
1714633677320,EDS 139,B00,507313,Pappas; Elizabeth,13,0,30,17
1714633678344,EDS 201,A00,507315,Staff,13,0,30,17
1714633679371,EDS 203,A01,507317,Halter; Christopher P.,12,0,30,18
1714633680401,EDS 204R,A01,507319,Halter; Christopher P.,0,3,30,30
1714633680401,EDS 204R,B01,507331,Heinzman; Erica M.,16,0,30,14
1714633681426,EDS 206R,A00,507332,Staff,0,4,30,30
1714633681426,EDS 206R,B00,507343,Staff,17,0,30,13
1714633682452,EDS 250,A00,507344,Hemans; Patricia Ann Benitez,22,0,40,18
1714633683477,EDS 281,A00,507345,Daly; Alan J.,18,0,18,0
1714633684501,EDS 284,A00,507350,Daly; Alan J.,16,0,16,0
1714633685528,EDS 286,A00,507359,Fine; Sarah,18,0,18,0
1714633686555,EDS 289C,A01,507361,Daly; Alan J.,18,0,18,0
1714633687582,EDS 290,A00,507366,Hofstetter; Carolyn,15,0,15,0
1714633688609,LIGM 5A,A00,507421,Fischer-Grunski; Eva K,18,0,20,2
1714633689635,LIGM 5B,A00,507423,Fischer-Grunski; Eva K,19,0,20,1
1714633690664,LIGM 5C,A00,507425,Fischer-Grunski; Eva K,19,0,20,1
1714633691690,LIIT 5AS,A00,507427,Carnelos; Chiara,20,0,20,0
1714633692715,LIIT 5BS,A00,507430,Carnelos; Chiara,20,0,20,0
1714633693741,LIIT 5CS,A00,507432,Carnelos; Chiara,20,0,20,0
1714633694766,LISP 5A,A00,507541,Munoz Sanchez; Alicia,11,0,20,9
1714633695793,LISP 5B,A00,507671,Munoz Sanchez; Alicia,8,0,20,12
1714633696819,LISP 5C,A00,507696,Munoz Sanchez; Alicia,9,0,20,11
1714633697850,MAE 197,001,528363,Boechler; Nicholas Sebastia,9998,0,9999,1
1714633698877,MATH 197,001,523477,Kedlaya; Kiran S.,9995,0,9999,4
1714633698877,MATH 197,002,563811,Zhang; Danna,9995,0,9999,4
1714633698877,MATH 197,003,628552,Dumitriu; Ioana,9998,0,9999,1
1714633699906,MCWP 40R,A00,518780,Staff,2,0,20,18
1714633699906,MCWP 40R,B00,518781,Staff,8,0,20,12
1714633699906,MCWP 40R,C00,518783,Staff,6,0,20,14
1714633700931,MCWP 50R,A00,518791,Staff,0,0,20,20
1714633700931,MCWP 50R,B00,518792,Staff,0,2,20,20
1714633700931,MCWP 50R,C00,518793,Staff,0,2,20,20
1714633700931,MCWP 50R,D00,518794,Staff,0,0,20,20
1714633700931,MCWP 50R,E00,518795,Staff,0,2,20,20
1714633700931,MCWP 50R,F00,518796,Staff,0,0,20,20
1714633700931,MCWP 50R,G00,518797,Staff,0,1,20,20
1714633701958,MMW 12R,A01,514034,Herbst; Matthew,0,0,16,16
1714633701958,MMW 12R,A02,514035,Herbst; Matthew,1,0,16,15
1714633702985,MMW 13R,A01,514037,Staff,0,4,16,16
1714633702985,MMW 13R,A02,514039,Staff,0,2,16,16
1714633702985,MMW 13R,A03,628519,Staff,0,2,16,16
1714633705038,SIO 295LS,A00,523233,Staff,10,0,30,20
1714633706063,SIO 295S,A00,523232,Staff,10,0,30,20
1714633707095,SIOC 290S,A01,637330,Merrifield; Mark A,23,0,30,7
1714633708120,SIOC 291S,A01,637333,Gabriel; Corey John,23,0,30,7
1714633709146,SOCI 117,A01,494376,Staff,0,4,5,5
1714633710176,WES 237B,A00,494380,Staff,9,0,20,11
1714633712258,AESE 279B,A00,494370,Wade; Jon P,0,0,33,33
1714633713286,AIP 197,001,627712,Vespa; Emanuel Ignacio,9998,0,9999,1
1714633714316,ANAR 135S,A00,494369,Braswell; Geoffrey E.,0,0,0,0
1714633715341,BENG 196,001,628496,Engler; Adam J.,9998,0,9999,1
1714633716367,CAT 124RS,A01,519847,Geibel; William,0,0,20,20
1714633717391,CAT 125RS,A01,515971,Geibel; William,0,0,20,20
1714633718420,CLRE 250,A00,511389,Morris; Sheldon,9993,0,9999,6
1714633719451,CLRE 251,A00,507176,Mehta; Ravindra L.,9993,0,9999,6
1714633719451,CLRE 251,B00,511410,Mehta; Ravindra L.,9998,0,9999,1
1714633720477,CLRE 252,A00,507189,Cuomo; Raphael Eduardo,9995,0,9999,4
1714633721503,CLRE 253,A00,507199,Vaida; Florin,9994,0,9999,5
1714633721503,CLRE 253,B00,507202,Vaida; Florin,9999,0,9999,0
1714633722533,CLRE 259,A00,507211,Patel; Hemal,9996,0,9999,3
1714633723561,CLRE 260,A00,507221,Cuomo; Raphael Eduardo,9999,0,9999,0
1714633724586,CLRE 297,001,507242,Cuomo; Raphael Eduardo,9999,0,9999,0
1714633725615,COGS 197,001,638244,Voytek; Bradley Thomas,9998,0,9999,1
1714633726696,CSE 191,A00,516875,Minnes Kemp; Mor Mia,9992,0,9999,7
1714633727725,CSE 197,001,637388,Minnes Kemp; Mor Mia,9998,0,9999,1
1714633728752,CSS 201S,A01,494383,Staff,35,0,35,0
1714633729783,CSS 202S,A01,494387,Staff,35,0,35,0
1714633730809,DSC 197,001,628532,Eldridge; Justin Matthew,9996,0,9999,3
1714633731836,EAP 100,A00,516065,Staff,9797,0,9999,202
1714633732868,ECE 45,A01,507414,Staff,33,0,60,27
1714633734918,ECE 111,A01,507420,Staff,15,0,50,35
1714633735949,ECE 197,001,548057,Sievenpiper; Daniel F.,9993,0,9999,6
1714633736975,EDS 115,A00,507243,Choi; Bailey Miyeon,10,0,28,18
1714633738001,EDS 117,A01,494379,Staff,0,4,30,30
1714633739026,EDS 125,A00,507246,Hopkins; Megan Beth,9,0,30,21
1714633740065,EDS 128A,A01,507264,Fargason; Sharon Gayle,8,0,26,18
1714633741091,EDS 128B,A01,507293,Pappas; Elizabeth,12,0,30,18
1714633742118,EDS 139,A00,507294,Fargason; Sharon Gayle,13,0,30,17
1714633742118,EDS 139,B00,507313,Pappas; Elizabeth,13,0,30,17
1714633743144,EDS 201,A00,507315,Staff,13,0,30,17
1714633744170,EDS 203,A01,507317,Halter; Christopher P.,12,0,30,18
1714633745196,EDS 204R,A01,507319,Halter; Christopher P.,0,3,30,30
1714633745196,EDS 204R,B01,507331,Heinzman; Erica M.,16,0,30,14
1714633746222,EDS 206R,A00,507332,Staff,0,4,30,30
1714633746222,EDS 206R,B00,507343,Staff,17,0,30,13
1714633747246,EDS 250,A00,507344,Hemans; Patricia Ann Benitez,22,0,40,18
1714633748271,EDS 281,A00,507345,Daly; Alan J.,18,0,18,0
1714633749294,EDS 284,A00,507350,Daly; Alan J.,16,0,16,0
1714633750324,EDS 286,A00,507359,Fine; Sarah,18,0,18,0
1714633751355,EDS 289C,A01,507361,Daly; Alan J.,18,0,18,0
1714633752381,EDS 290,A00,507366,Hofstetter; Carolyn,15,0,15,0
1714633753406,LIGM 5A,A00,507421,Fischer-Grunski; Eva K,18,0,20,2
1714633754431,LIGM 5B,A00,507423,Fischer-Grunski; Eva K,19,0,20,1
1714633755460,LIGM 5C,A00,507425,Fischer-Grunski; Eva K,19,0,20,1
1714633756486,LIIT 5AS,A00,507427,Carnelos; Chiara,20,0,20,0
1714633757515,LIIT 5BS,A00,507430,Carnelos; Chiara,20,0,20,0
1714633758540,LIIT 5CS,A00,507432,Carnelos; Chiara,20,0,20,0
1714633759570,LISP 5A,A00,507541,Munoz Sanchez; Alicia,11,0,20,9
1714633760597,LISP 5B,A00,507671,Munoz Sanchez; Alicia,8,0,20,12
1714633761624,LISP 5C,A00,507696,Munoz Sanchez; Alicia,9,0,20,11
1714633762649,MAE 197,001,528363,Boechler; Nicholas Sebastia,9998,0,9999,1
1714633763677,MATH 197,001,523477,Kedlaya; Kiran S.,9995,0,9999,4
1714633763677,MATH 197,002,563811,Zhang; Danna,9995,0,9999,4
1714633763677,MATH 197,003,628552,Dumitriu; Ioana,9998,0,9999,1
1714633764702,MCWP 40R,A00,518780,Staff,2,0,20,18
1714633764702,MCWP 40R,B00,518781,Staff,8,0,20,12
1714633764702,MCWP 40R,C00,518783,Staff,6,0,20,14
1714633765729,MCWP 50R,A00,518791,Staff,0,0,20,20
1714633765729,MCWP 50R,B00,518792,Staff,0,2,20,20
1714633765729,MCWP 50R,C00,518793,Staff,0,2,20,20
1714633765729,MCWP 50R,D00,518794,Staff,0,0,20,20
1714633765729,MCWP 50R,E00,518795,Staff,0,2,20,20
1714633765729,MCWP 50R,F00,518796,Staff,0,0,20,20
1714633765729,MCWP 50R,G00,518797,Staff,0,1,20,20
1714633766766,MMW 12R,A01,514034,Herbst; Matthew,0,0,16,16
1714633766766,MMW 12R,A02,514035,Herbst; Matthew,1,0,16,15
1714633767796,MMW 13R,A01,514037,Staff,0,4,16,16
1714633767796,MMW 13R,A02,514039,Staff,0,2,16,16
1714633767796,MMW 13R,A03,628519,Staff,0,2,16,16
1714633769851,SIO 295LS,A00,523233,Staff,10,0,30,20
1714633770876,SIO 295S,A00,523232,Staff,10,0,30,20
1714633771902,SIOC 290S,A01,637330,Merrifield; Mark A,23,0,30,7
1714633772929,SIOC 291S,A01,637333,Gabriel; Corey John,23,0,30,7
1714633773957,SOCI 117,A01,494376,Staff,0,4,5,5
1714633774985,WES 237B,A00,494380,Staff,9,0,20,11
1714633777049,AESE 279B,A00,494370,Wade; Jon P,0,0,33,33
1714633778074,AIP 197,001,627712,Vespa; Emanuel Ignacio,9998,0,9999,1
1714633779101,ANAR 135S,A00,494369,Braswell; Geoffrey E.,0,0,0,0
1714633780133,BENG 196,001,628496,Engler; Adam J.,9998,0,9999,1
1714633781159,CAT 124RS,A01,519847,Geibel; William,0,0,20,20
1714633782191,CAT 125RS,A01,515971,Geibel; William,0,0,20,20
1714633783217,CLRE 250,A00,511389,Morris; Sheldon,9993,0,9999,6
1714633784246,CLRE 251,A00,507176,Mehta; Ravindra L.,9993,0,9999,6
1714633784246,CLRE 251,B00,511410,Mehta; Ravindra L.,9998,0,9999,1
1714633785278,CLRE 252,A00,507189,Cuomo; Raphael Eduardo,9995,0,9999,4
1714633786304,CLRE 253,A00,507199,Vaida; Florin,9994,0,9999,5
1714633786304,CLRE 253,B00,507202,Vaida; Florin,9999,0,9999,0
1714633787333,CLRE 259,A00,507211,Patel; Hemal,9996,0,9999,3
1714633788362,CLRE 260,A00,507221,Cuomo; Raphael Eduardo,9999,0,9999,0
1714633789387,CLRE 297,001,507242,Cuomo; Raphael Eduardo,9999,0,9999,0
1714633790412,COGS 197,001,638244,Voytek; Bradley Thomas,9998,0,9999,1
1714633791436,CSE 191,A00,516875,Minnes Kemp; Mor Mia,9992,0,9999,7
1714633792468,CSE 197,001,637388,Minnes Kemp; Mor Mia,9998,0,9999,1
1714633793495,CSS 201S,A01,494383,Staff,35,0,35,0
1714633794519,CSS 202S,A01,494387,Staff,35,0,35,0
1714633795546,DSC 197,001,628532,Eldridge; Justin Matthew,9996,0,9999,3
1714633796574,EAP 100,A00,516065,Staff,9797,0,9999,202
1714633797600,ECE 45,A01,507414,Staff,33,0,60,27
1714633799657,ECE 111,A01,507420,Staff,15,0,50,35
1714633800682,ECE 197,001,548057,Sievenpiper; Daniel F.,9993,0,9999,6
1714633801713,EDS 115,A00,507243,Choi; Bailey Miyeon,10,0,28,18
1714633802739,EDS 117,A01,494379,Staff,0,4,30,30
1714633803769,EDS 125,A00,507246,Hopkins; Megan Beth,9,0,30,21
1714633804797,EDS 128A,A01,507264,Fargason; Sharon Gayle,8,0,26,18
1714633805829,EDS 128B,A01,507293,Pappas; Elizabeth,12,0,30,18
1714633806855,EDS 139,A00,507294,Fargason; Sharon Gayle,13,0,30,17
1714633806855,EDS 139,B00,507313,Pappas; Elizabeth,13,0,30,17
1714633807879,EDS 201,A00,507315,Staff,13,0,30,17
1714633808905,EDS 203,A01,507317,Halter; Christopher P.,12,0,30,18
1714633809933,EDS 204R,A01,507319,Halter; Christopher P.,0,3,30,30
1714633809933,EDS 204R,B01,507331,Heinzman; Erica M.,16,0,30,14
1714633810962,EDS 206R,A00,507332,Staff,0,4,30,30
1714633810962,EDS 206R,B00,507343,Staff,17,0,30,13
1714633811986,EDS 250,A00,507344,Hemans; Patricia Ann Benitez,22,0,40,18
1714633813020,EDS 281,A00,507345,Daly; Alan J.,18,0,18,0
1714633814048,EDS 284,A00,507350,Daly; Alan J.,16,0,16,0
1714633815077,EDS 286,A00,507359,Fine; Sarah,18,0,18,0
1714633816106,EDS 289C,A01,507361,Daly; Alan J.,18,0,18,0
1714633817130,EDS 290,A00,507366,Hofstetter; Carolyn,15,0,15,0
1714633818156,LIGM 5A,A00,507421,Fischer-Grunski; Eva K,18,0,20,2
1714633819185,LIGM 5B,A00,507423,Fischer-Grunski; Eva K,19,0,20,1
1714633820211,LIGM 5C,A00,507425,Fischer-Grunski; Eva K,19,0,20,1
1714633821237,LIIT 5AS,A00,507427,Carnelos; Chiara,20,0,20,0
1714633822263,LIIT 5BS,A00,507430,Carnelos; Chiara,20,0,20,0
1714633823293,LIIT 5CS,A00,507432,Carnelos; Chiara,20,0,20,0
1714633824320,LISP 5A,A00,507541,Munoz Sanchez; Alicia,11,0,20,9
1714633825346,LISP 5B,A00,507671,Munoz Sanchez; Alicia,8,0,20,12
1714633826373,LISP 5C,A00,507696,Munoz Sanchez; Alicia,9,0,20,11
1714633827404,MAE 197,001,528363,Boechler; Nicholas Sebastia,9998,0,9999,1
1714633828436,MATH 197,001,523477,Kedlaya; Kiran S.,9995,0,9999,4
1714633828436,MATH 197,002,563811,Zhang; Danna,9995,0,9999,4
1714633828436,MATH 197,003,628552,Dumitriu; Ioana,9998,0,9999,1
1714633829467,MCWP 40R,A00,518780,Staff,2,0,20,18
1714633829467,MCWP 40R,B00,518781,Staff,8,0,20,12
1714633829467,MCWP 40R,C00,518783,Staff,6,0,20,14
1714633830562,MCWP 50R,A00,518791,Staff,0,0,20,20
1714633830562,MCWP 50R,B00,518792,Staff,0,2,20,20
1714633830562,MCWP 50R,C00,518793,Staff,0,2,20,20
1714633830562,MCWP 50R,D00,518794,Staff,0,0,20,20
1714633830562,MCWP 50R,E00,518795,Staff,0,2,20,20
1714633830562,MCWP 50R,F00,518796,Staff,0,0,20,20
1714633830562,MCWP 50R,G00,518797,Staff,0,1,20,20
1714633831588,MMW 12R,A01,514034,Herbst; Matthew,0,0,16,16
1714633831588,MMW 12R,A02,514035,Herbst; Matthew,1,0,16,15
1714633832619,MMW 13R,A01,514037,Staff,0,4,16,16
1714633832619,MMW 13R,A02,514039,Staff,0,2,16,16
1714633832619,MMW 13R,A03,628519,Staff,0,2,16,16
1714633834685,SIO 295LS,A00,523233,Staff,10,0,30,20
1714633835712,SIO 295S,A00,523232,Staff,10,0,30,20
1714633836738,SIOC 290S,A01,637330,Merrifield; Mark A,23,0,30,7
1714633837769,SIOC 291S,A01,637333,Gabriel; Corey John,23,0,30,7
1714633838799,SOCI 117,A01,494376,Staff,0,4,5,5
1714633839822,WES 237B,A00,494380,Staff,9,0,20,11
1714633841914,AESE 279B,A00,494370,Wade; Jon P,0,0,33,33
1714633842943,AIP 197,001,627712,Vespa; Emanuel Ignacio,9998,0,9999,1
1714633843968,ANAR 135S,A00,494369,Braswell; Geoffrey E.,0,0,0,0
1714633844995,BENG 196,001,628496,Engler; Adam J.,9998,0,9999,1
1714633846023,CAT 124RS,A01,519847,Geibel; William,0,0,20,20
1714633847050,CAT 125RS,A01,515971,Geibel; William,0,0,20,20
1714633848081,CLRE 250,A00,511389,Morris; Sheldon,9993,0,9999,6
1714633849107,CLRE 251,A00,507176,Mehta; Ravindra L.,9993,0,9999,6
1714633849107,CLRE 251,B00,511410,Mehta; Ravindra L.,9998,0,9999,1
1714633850137,CLRE 252,A00,507189,Cuomo; Raphael Eduardo,9995,0,9999,4
1714633851168,CLRE 253,A00,507199,Vaida; Florin,9994,0,9999,5
1714633851168,CLRE 253,B00,507202,Vaida; Florin,9999,0,9999,0
1714633852195,CLRE 259,A00,507211,Patel; Hemal,9996,0,9999,3
1714633853224,CLRE 260,A00,507221,Cuomo; Raphael Eduardo,9999,0,9999,0
1714633854252,CLRE 297,001,507242,Cuomo; Raphael Eduardo,9999,0,9999,0
1714633855278,COGS 197,001,638244,Voytek; Bradley Thomas,9998,0,9999,1
1714633856307,CSE 191,A00,516875,Minnes Kemp; Mor Mia,9992,0,9999,7
1714633857332,CSE 197,001,637388,Minnes Kemp; Mor Mia,9998,0,9999,1
1714633858356,CSS 201S,A01,494383,Staff,35,0,35,0
1714633859381,CSS 202S,A01,494387,Staff,35,0,35,0
1714633860406,DSC 197,001,628532,Eldridge; Justin Matthew,9996,0,9999,3
1714633861436,EAP 100,A00,516065,Staff,9797,0,9999,202
1714633862463,ECE 45,A01,507414,Staff,33,0,60,27
1714633864519,ECE 111,A01,507420,Staff,15,0,50,35
1714633865546,ECE 197,001,548057,Sievenpiper; Daniel F.,9993,0,9999,6
1714633866672,EDS 115,A00,507243,Choi; Bailey Miyeon,10,0,28,18
1714633867698,EDS 117,A01,494379,Staff,0,4,30,30
1714633868726,EDS 125,A00,507246,Hopkins; Megan Beth,9,0,30,21
1714633869762,EDS 128A,A01,507264,Fargason; Sharon Gayle,8,0,26,18
1714633870790,EDS 128B,A01,507293,Pappas; Elizabeth,12,0,30,18
1714633871818,EDS 139,A00,507294,Fargason; Sharon Gayle,13,0,30,17
1714633871818,EDS 139,B00,507313,Pappas; Elizabeth,13,0,30,17
1714633872859,EDS 201,A00,507315,Staff,13,0,30,17
1714633873897,EDS 203,A01,507317,Halter; Christopher P.,12,0,30,18
1714633874922,EDS 204R,A01,507319,Halter; Christopher P.,0,3,30,30
1714633874922,EDS 204R,B01,507331,Heinzman; Erica M.,16,0,30,14
1714633875948,EDS 206R,A00,507332,Staff,0,4,30,30
1714633875948,EDS 206R,B00,507343,Staff,17,0,30,13
1714633876992,EDS 250,A00,507344,Hemans; Patricia Ann Benitez,22,0,40,18
1714633878079,EDS 281,A00,507345,Daly; Alan J.,18,0,18,0
1714633879109,EDS 284,A00,507350,Daly; Alan J.,16,0,16,0
1714633880138,EDS 286,A00,507359,Fine; Sarah,18,0,18,0
1714633881176,EDS 289C,A01,507361,Daly; Alan J.,18,0,18,0
1714633882210,EDS 290,A00,507366,Hofstetter; Carolyn,15,0,15,0
1714633883246,LIGM 5A,A00,507421,Fischer-Grunski; Eva K,18,0,20,2
1714633884276,LIGM 5B,A00,507423,Fischer-Grunski; Eva K,19,0,20,1
1714633885301,LIGM 5C,A00,507425,Fischer-Grunski; Eva K,19,0,20,1
1714633886327,LIIT 5AS,A00,507427,Carnelos; Chiara,20,0,20,0
1714633887352,LIIT 5BS,A00,507430,Carnelos; Chiara,20,0,20,0
1714633888384,LIIT 5CS,A00,507432,Carnelos; Chiara,20,0,20,0
1714633889412,LISP 5A,A00,507541,Munoz Sanchez; Alicia,11,0,20,9
1714633890437,LISP 5B,A00,507671,Munoz Sanchez; Alicia,8,0,20,12
1714633891463,LISP 5C,A00,507696,Munoz Sanchez; Alicia,9,0,20,11
1714633892488,MAE 197,001,528363,Boechler; Nicholas Sebastia,9998,0,9999,1
1714633893520,MATH 197,001,523477,Kedlaya; Kiran S.,9995,0,9999,4
1714633893520,MATH 197,002,563811,Zhang; Danna,9995,0,9999,4
1714633893520,MATH 197,003,628552,Dumitriu; Ioana,9998,0,9999,1
1714633894550,MCWP 40R,A00,518780,Staff,2,0,20,18
1714633894550,MCWP 40R,B00,518781,Staff,8,0,20,12
1714633894550,MCWP 40R,C00,518783,Staff,6,0,20,14
1714633895582,MCWP 50R,A00,518791,Staff,0,0,20,20
1714633895582,MCWP 50R,B00,518792,Staff,0,2,20,20
1714633895582,MCWP 50R,C00,518793,Staff,0,2,20,20
1714633895582,MCWP 50R,D00,518794,Staff,0,0,20,20
1714633895582,MCWP 50R,E00,518795,Staff,0,2,20,20
1714633895582,MCWP 50R,F00,518796,Staff,0,0,20,20
1714633895582,MCWP 50R,G00,518797,Staff,0,1,20,20
1714633896608,MMW 12R,A01,514034,Herbst; Matthew,0,0,16,16
1714633896608,MMW 12R,A02,514035,Herbst; Matthew,1,0,16,15
1714633897634,MMW 13R,A01,514037,Staff,0,4,16,16
1714633897634,MMW 13R,A02,514039,Staff,0,2,16,16
1714633897634,MMW 13R,A03,628519,Staff,0,2,16,16
1714633899690,SIO 295LS,A00,523233,Staff,10,0,30,20
1714633900715,SIO 295S,A00,523232,Staff,10,0,30,20
1714633901753,SIOC 290S,A01,637330,Merrifield; Mark A,23,0,30,7
1714633902781,SIOC 291S,A01,637333,Gabriel; Corey John,23,0,30,7
1714633903807,SOCI 117,A01,494376,Staff,0,4,5,5
1714633904833,WES 237B,A00,494380,Staff,9,0,20,11
1714633906936,AESE 279B,A00,494370,Wade; Jon P,0,0,33,33
1714633907962,AIP 197,001,627712,Vespa; Emanuel Ignacio,9998,0,9999,1
1714633908988,ANAR 135S,A00,494369,Braswell; Geoffrey E.,0,0,0,0
1714633910015,BENG 196,001,628496,Engler; Adam J.,9998,0,9999,1
1714633911041,CAT 124RS,A01,519847,Geibel; William,0,0,20,20
1714633912066,CAT 125RS,A01,515971,Geibel; William,0,0,20,20
1714633913091,CLRE 250,A00,511389,Morris; Sheldon,9993,0,9999,6
1714633914124,CLRE 251,A00,507176,Mehta; Ravindra L.,9993,0,9999,6
1714633914124,CLRE 251,B00,511410,Mehta; Ravindra L.,9998,0,9999,1
1714633924664,CLRE 252,A00,507189,Cuomo; Raphael Eduardo,9995,0,9999,4
1714633925698,CLRE 253,A00,507199,Vaida; Florin,9994,0,9999,5
1714633925698,CLRE 253,B00,507202,Vaida; Florin,9999,0,9999,0
1714633926728,CLRE 259,A00,507211,Patel; Hemal,9996,0,9999,3
1714633927753,CLRE 260,A00,507221,Cuomo; Raphael Eduardo,9999,0,9999,0
1714633928777,CLRE 297,001,507242,Cuomo; Raphael Eduardo,9999,0,9999,0
1714633929806,COGS 197,001,638244,Voytek; Bradley Thomas,9998,0,9999,1
1714633930837,CSE 191,A00,516875,Minnes Kemp; Mor Mia,9992,0,9999,7
1714633931865,CSE 197,001,637388,Minnes Kemp; Mor Mia,9998,0,9999,1
1714633932898,CSS 201S,A01,494383,Staff,35,0,35,0
1714633933927,CSS 202S,A01,494387,Staff,35,0,35,0
1714633934961,DSC 197,001,628532,Eldridge; Justin Matthew,9996,0,9999,3
1714633935990,EAP 100,A00,516065,Staff,9797,0,9999,202
1714633937022,ECE 45,A01,507414,Staff,33,0,60,27
1714633939081,ECE 111,A01,507420,Staff,15,0,50,35
1714633940107,ECE 197,001,548057,Sievenpiper; Daniel F.,9993,0,9999,6
1714633941143,EDS 115,A00,507243,Choi; Bailey Miyeon,10,0,28,18
1714633942170,EDS 117,A01,494379,Staff,0,4,30,30
1714633943196,EDS 125,A00,507246,Hopkins; Megan Beth,9,0,30,21
1714633944231,EDS 128A,A01,507264,Fargason; Sharon Gayle,8,0,26,18
1714633945261,EDS 128B,A01,507293,Pappas; Elizabeth,12,0,30,18
1714633946291,EDS 139,A00,507294,Fargason; Sharon Gayle,13,0,30,17
1714633946291,EDS 139,B00,507313,Pappas; Elizabeth,13,0,30,17
1714633947322,EDS 201,A00,507315,Staff,13,0,30,17
1714633948358,EDS 203,A01,507317,Halter; Christopher P.,12,0,30,18
1714633949393,EDS 204R,A01,507319,Halter; Christopher P.,0,3,30,30
1714633949393,EDS 204R,B01,507331,Heinzman; Erica M.,16,0,30,14
1714633950424,EDS 206R,A00,507332,Staff,0,4,30,30
1714633950424,EDS 206R,B00,507343,Staff,17,0,30,13
1714633951453,EDS 250,A00,507344,Hemans; Patricia Ann Benitez,22,0,40,18
1714633952489,EDS 281,A00,507345,Daly; Alan J.,18,0,18,0
1714633953521,EDS 284,A00,507350,Daly; Alan J.,16,0,16,0
1714633954550,EDS 286,A00,507359,Fine; Sarah,18,0,18,0
1714633955578,EDS 289C,A01,507361,Daly; Alan J.,18,0,18,0
1714633956606,EDS 290,A00,507366,Hofstetter; Carolyn,15,0,15,0
1714633957632,LIGM 5A,A00,507421,Fischer-Grunski; Eva K,18,0,20,2
1714633958670,LIGM 5B,A00,507423,Fischer-Grunski; Eva K,19,0,20,1
1714633959706,LIGM 5C,A00,507425,Fischer-Grunski; Eva K,19,0,20,1
1714633960746,LIIT 5AS,A00,507427,Carnelos; Chiara,20,0,20,0
1714633961774,LIIT 5BS,A00,507430,Carnelos; Chiara,20,0,20,0
1714633962806,LIIT 5CS,A00,507432,Carnelos; Chiara,20,0,20,0
1714633963833,LISP 5A,A00,507541,Munoz Sanchez; Alicia,11,0,20,9
1714633964864,LISP 5B,A00,507671,Munoz Sanchez; Alicia,8,0,20,12
1714633965896,LISP 5C,A00,507696,Munoz Sanchez; Alicia,9,0,20,11
1714633966928,MAE 197,001,528363,Boechler; Nicholas Sebastia,9998,0,9999,1
1714633967956,MATH 197,001,523477,Kedlaya; Kiran S.,9995,0,9999,4
1714633967956,MATH 197,002,563811,Zhang; Danna,9995,0,9999,4
1714633967956,MATH 197,003,628552,Dumitriu; Ioana,9998,0,9999,1
1714633968989,MCWP 40R,A00,518780,Staff,2,0,20,18
1714633968989,MCWP 40R,B00,518781,Staff,8,0,20,12
1714633968989,MCWP 40R,C00,518783,Staff,6,0,20,14
1714633970024,MCWP 50R,A00,518791,Staff,0,0,20,20
1714633970024,MCWP 50R,B00,518792,Staff,0,2,20,20
1714633970024,MCWP 50R,C00,518793,Staff,0,2,20,20
1714633970024,MCWP 50R,D00,518794,Staff,0,0,20,20
1714633970024,MCWP 50R,E00,518795,Staff,0,2,20,20
1714633970024,MCWP 50R,F00,518796,Staff,0,0,20,20
1714633970024,MCWP 50R,G00,518797,Staff,0,1,20,20
1714633971060,MMW 12R,A01,514034,Herbst; Matthew,0,0,16,16
1714633971060,MMW 12R,A02,514035,Herbst; Matthew,1,0,16,15
1714633972120,MMW 13R,A01,514037,Staff,0,4,16,16
1714633972120,MMW 13R,A02,514039,Staff,0,2,16,16
1714633972120,MMW 13R,A03,628519,Staff,0,2,16,16
1714633974182,SIO 295LS,A00,523233,Staff,10,0,30,20
1714633975216,SIO 295S,A00,523232,Staff,10,0,30,20
1714633976251,SIOC 290S,A01,637330,Merrifield; Mark A,23,0,30,7
1714633977281,SIOC 291S,A01,637333,Gabriel; Corey John,23,0,30,7
1714633978309,SOCI 117,A01,494376,Staff,0,4,5,5
1714633979338,WES 237B,A00,494380,Staff,9,0,20,11
1714633981427,AESE 279B,A00,494370,Wade; Jon P,0,0,33,33
1714633982458,AIP 197,001,627712,Vespa; Emanuel Ignacio,9998,0,9999,1
1714633983487,ANAR 135S,A00,494369,Braswell; Geoffrey E.,0,0,0,0
1714633984518,BENG 196,001,628496,Engler; Adam J.,9998,0,9999,1
1714633985551,CAT 124RS,A01,519847,Geibel; William,0,0,20,20
1714633986584,CAT 125RS,A01,515971,Geibel; William,0,0,20,20
1714633987613,CLRE 250,A00,511389,Morris; Sheldon,9993,0,9999,6
1714633988644,CLRE 251,A00,507176,Mehta; Ravindra L.,9993,0,9999,6
1714633988644,CLRE 251,B00,511410,Mehta; Ravindra L.,9998,0,9999,1
1714633989678,CLRE 252,A00,507189,Cuomo; Raphael Eduardo,9995,0,9999,4
1714633990720,CLRE 253,A00,507199,Vaida; Florin,9994,0,9999,5
1714633990720,CLRE 253,B00,507202,Vaida; Florin,9999,0,9999,0
1714633991778,CLRE 259,A00,507211,Patel; Hemal,9996,0,9999,3
1714633992813,CLRE 260,A00,507221,Cuomo; Raphael Eduardo,9999,0,9999,0
1714633993866,CLRE 297,001,507242,Cuomo; Raphael Eduardo,9999,0,9999,0
1714633994894,COGS 197,001,638244,Voytek; Bradley Thomas,9998,0,9999,1
1714633995922,CSE 191,A00,516875,Minnes Kemp; Mor Mia,9992,0,9999,7
1714633996951,CSE 197,001,637388,Minnes Kemp; Mor Mia,9998,0,9999,1
1714633997993,CSS 201S,A01,494383,Staff,35,0,35,0
1714633999028,CSS 202S,A01,494387,Staff,35,0,35,0
1714634000056,DSC 197,001,628532,Eldridge; Justin Matthew,9996,0,9999,3
1714634001083,EAP 100,A00,516065,Staff,9797,0,9999,202
1714634002118,ECE 45,A01,507414,Staff,33,0,60,27
1714634004177,ECE 111,A01,507420,Staff,15,0,50,35
1714634005210,ECE 197,001,548057,Sievenpiper; Daniel F.,9993,0,9999,6
1714634006240,EDS 115,A00,507243,Choi; Bailey Miyeon,10,0,28,18
1714634007473,EDS 117,A01,494379,Staff,0,4,30,30
1714634008510,EDS 125,A00,507246,Hopkins; Megan Beth,9,0,30,21
1714634009545,EDS 128A,A01,507264,Fargason; Sharon Gayle,8,0,26,18
1714634010571,EDS 128B,A01,507293,Pappas; Elizabeth,12,0,30,18
1714634011600,EDS 139,A00,507294,Fargason; Sharon Gayle,13,0,30,17
1714634011600,EDS 139,B00,507313,Pappas; Elizabeth,13,0,30,17
1714634012627,EDS 201,A00,507315,Staff,13,0,30,17
1714634013663,EDS 203,A01,507317,Halter; Christopher P.,12,0,30,18
1714634014696,EDS 204R,A01,507319,Halter; Christopher P.,0,3,30,30
1714634014696,EDS 204R,B01,507331,Heinzman; Erica M.,16,0,30,14
1714634015726,EDS 206R,A00,507332,Staff,0,4,30,30
1714634015726,EDS 206R,B00,507343,Staff,17,0,30,13
1714634016756,EDS 250,A00,507344,Hemans; Patricia Ann Benitez,22,0,40,18
1714634017785,EDS 281,A00,507345,Daly; Alan J.,18,0,18,0
1714634018812,EDS 284,A00,507350,Daly; Alan J.,16,0,16,0
1714634019846,EDS 286,A00,507359,Fine; Sarah,18,0,18,0
1714634020881,EDS 289C,A01,507361,Daly; Alan J.,18,0,18,0
1714634021910,EDS 290,A00,507366,Hofstetter; Carolyn,15,0,15,0
1714634022949,LIGM 5A,A00,507421,Fischer-Grunski; Eva K,18,0,20,2
1714634023980,LIGM 5B,A00,507423,Fischer-Grunski; Eva K,19,0,20,1
1714634025019,LIGM 5C,A00,507425,Fischer-Grunski; Eva K,19,0,20,1
1714634026045,LIIT 5AS,A00,507427,Carnelos; Chiara,20,0,20,0
1714634027080,LIIT 5BS,A00,507430,Carnelos; Chiara,20,0,20,0
1714634028114,LIIT 5CS,A00,507432,Carnelos; Chiara,20,0,20,0
1714634029139,LISP 5A,A00,507541,Munoz Sanchez; Alicia,11,0,20,9
1714634030167,LISP 5B,A00,507671,Munoz Sanchez; Alicia,8,0,20,12
1714634031195,LISP 5C,A00,507696,Munoz Sanchez; Alicia,9,0,20,11
1714634032226,MAE 197,001,528363,Boechler; Nicholas Sebastia,9998,0,9999,1
1714634033262,MATH 197,001,523477,Kedlaya; Kiran S.,9995,0,9999,4
1714634033262,MATH 197,002,563811,Zhang; Danna,9995,0,9999,4
1714634033262,MATH 197,003,628552,Dumitriu; Ioana,9998,0,9999,1
1714634034292,MCWP 40R,A00,518780,Staff,2,0,20,18
1714634034292,MCWP 40R,B00,518781,Staff,8,0,20,12
1714634034292,MCWP 40R,C00,518783,Staff,6,0,20,14
1714634035321,MCWP 50R,A00,518791,Staff,0,0,20,20
1714634035321,MCWP 50R,B00,518792,Staff,0,2,20,20
1714634035321,MCWP 50R,C00,518793,Staff,0,2,20,20
1714634035321,MCWP 50R,D00,518794,Staff,0,0,20,20
1714634035321,MCWP 50R,E00,518795,Staff,0,2,20,20
1714634035321,MCWP 50R,F00,518796,Staff,0,0,20,20
1714634035321,MCWP 50R,G00,518797,Staff,0,1,20,20
1714634036350,MMW 12R,A01,514034,Herbst; Matthew,0,0,16,16
1714634036350,MMW 12R,A02,514035,Herbst; Matthew,1,0,16,15
1714634037378,MMW 13R,A01,514037,Staff,0,4,16,16
1714634037378,MMW 13R,A02,514039,Staff,0,2,16,16
1714634037378,MMW 13R,A03,628519,Staff,0,2,16,16
1714634039434,SIO 295LS,A00,523233,Staff,10,0,30,20
1714634040466,SIO 295S,A00,523232,Staff,10,0,30,20
1714634041502,SIOC 290S,A01,637330,Merrifield; Mark A,23,0,30,7
1714634042534,SIOC 291S,A01,637333,Gabriel; Corey John,23,0,30,7
1714634043566,SOCI 117,A01,494376,Staff,0,4,5,5
1714634044601,WES 237B,A00,494380,Staff,9,0,20,11
1714634046716,AESE 279B,A00,494370,Wade; Jon P,0,0,33,33
1714634047743,AIP 197,001,627712,Vespa; Emanuel Ignacio,9998,0,9999,1
1714634048773,ANAR 135S,A00,494369,Braswell; Geoffrey E.,0,0,0,0
1714634049805,BENG 196,001,628496,Engler; Adam J.,9998,0,9999,1
1714634050842,CAT 124RS,A01,519847,Geibel; William,0,0,20,20
1714634051877,CAT 125RS,A01,515971,Geibel; William,0,0,20,20
1714634052910,CLRE 250,A00,511389,Morris; Sheldon,9993,0,9999,6
1714634053946,CLRE 251,A00,507176,Mehta; Ravindra L.,9993,0,9999,6
1714634053946,CLRE 251,B00,511410,Mehta; Ravindra L.,9998,0,9999,1
1714634054977,CLRE 252,A00,507189,Cuomo; Raphael Eduardo,9995,0,9999,4
1714634056004,CLRE 253,A00,507199,Vaida; Florin,9994,0,9999,5
1714634056004,CLRE 253,B00,507202,Vaida; Florin,9999,0,9999,0
1714634057030,CLRE 259,A00,507211,Patel; Hemal,9996,0,9999,3
1714634058059,CLRE 260,A00,507221,Cuomo; Raphael Eduardo,9999,0,9999,0
1714634059083,CLRE 297,001,507242,Cuomo; Raphael Eduardo,9999,0,9999,0
1714634060113,COGS 197,001,638244,Voytek; Bradley Thomas,9998,0,9999,1
1714634061142,CSE 191,A00,516875,Minnes Kemp; Mor Mia,9992,0,9999,7
1714634062173,CSE 197,001,637388,Minnes Kemp; Mor Mia,9998,0,9999,1
1714634063201,CSS 201S,A01,494383,Staff,35,0,35,0
1714634064230,CSS 202S,A01,494387,Staff,35,0,35,0
1714634065261,DSC 197,001,628532,Eldridge; Justin Matthew,9996,0,9999,3
1714634066293,EAP 100,A00,516065,Staff,9797,0,9999,202
1714634067321,ECE 45,A01,507414,Staff,33,0,60,27
1714634069383,ECE 111,A01,507420,Staff,15,0,50,35
1714634070415,ECE 197,001,548057,Sievenpiper; Daniel F.,9993,0,9999,6
1714634071443,EDS 115,A00,507243,Choi; Bailey Miyeon,10,0,28,18
1714634072471,EDS 117,A01,494379,Staff,0,4,30,30
1714634073498,EDS 125,A00,507246,Hopkins; Megan Beth,9,0,30,21
1714634074524,EDS 128A,A01,507264,Fargason; Sharon Gayle,8,0,26,18
1714634075557,EDS 128B,A01,507293,Pappas; Elizabeth,12,0,30,18
1714634076583,EDS 139,A00,507294,Fargason; Sharon Gayle,13,0,30,17
1714634076583,EDS 139,B00,507313,Pappas; Elizabeth,13,0,30,17
1714634077617,EDS 201,A00,507315,Staff,13,0,30,17
1714634078644,EDS 203,A01,507317,Halter; Christopher P.,12,0,30,18
1714634079672,EDS 204R,A01,507319,Halter; Christopher P.,0,3,30,30
1714634079672,EDS 204R,B01,507331,Heinzman; Erica M.,16,0,30,14
1714634080706,EDS 206R,A00,507332,Staff,0,4,30,30
1714634080706,EDS 206R,B00,507343,Staff,17,0,30,13
1714634081736,EDS 250,A00,507344,Hemans; Patricia Ann Benitez,22,0,40,18
1714634082778,EDS 281,A00,507345,Daly; Alan J.,18,0,18,0
1714634083811,EDS 284,A00,507350,Daly; Alan J.,16,0,16,0
1714634084840,EDS 286,A00,507359,Fine; Sarah,18,0,18,0
1714634085867,EDS 289C,A01,507361,Daly; Alan J.,18,0,18,0
1714634086897,EDS 290,A00,507366,Hofstetter; Carolyn,15,0,15,0
1714634087944,LIGM 5A,A00,507421,Fischer-Grunski; Eva K,18,0,20,2
1714634088982,LIGM 5B,A00,507423,Fischer-Grunski; Eva K,19,0,20,1
1714634090011,LIGM 5C,A00,507425,Fischer-Grunski; Eva K,19,0,20,1
1714634091038,LIIT 5AS,A00,507427,Carnelos; Chiara,20,0,20,0
1714634092073,LIIT 5BS,A00,507430,Carnelos; Chiara,20,0,20,0
1714634093102,LIIT 5CS,A00,507432,Carnelos; Chiara,20,0,20,0
1714634094128,LISP 5A,A00,507541,Munoz Sanchez; Alicia,11,0,20,9
1714634095162,LISP 5B,A00,507671,Munoz Sanchez; Alicia,8,0,20,12
1714634096196,LISP 5C,A00,507696,Munoz Sanchez; Alicia,9,0,20,11
1714634097228,MAE 197,001,528363,Boechler; Nicholas Sebastia,9998,0,9999,1
1714634098258,MATH 197,001,523477,Kedlaya; Kiran S.,9995,0,9999,4
1714634098258,MATH 197,002,563811,Zhang; Danna,9995,0,9999,4
1714634098258,MATH 197,003,628552,Dumitriu; Ioana,9998,0,9999,1
1714634099286,MCWP 40R,A00,518780,Staff,2,0,20,18
1714634099286,MCWP 40R,B00,518781,Staff,8,0,20,12
1714634099286,MCWP 40R,C00,518783,Staff,6,0,20,14
1714634100316,MCWP 50R,A00,518791,Staff,0,0,20,20
1714634100316,MCWP 50R,B00,518792,Staff,0,2,20,20
1714634100316,MCWP 50R,C00,518793,Staff,0,2,20,20
1714634100316,MCWP 50R,D00,518794,Staff,0,0,20,20
1714634100316,MCWP 50R,E00,518795,Staff,0,2,20,20
1714634100316,MCWP 50R,F00,518796,Staff,0,0,20,20
1714634100316,MCWP 50R,G00,518797,Staff,0,1,20,20
1714634101344,MMW 12R,A01,514034,Herbst; Matthew,0,0,16,16
1714634101344,MMW 12R,A02,514035,Herbst; Matthew,1,0,16,15
1714634102375,MMW 13R,A01,514037,Staff,0,4,16,16
1714634102375,MMW 13R,A02,514039,Staff,0,2,16,16
1714634102375,MMW 13R,A03,628519,Staff,0,2,16,16
1714634104442,SIO 295LS,A00,523233,Staff,10,0,30,20
1714634105469,SIO 295S,A00,523232,Staff,10,0,30,20
1714634106512,SIOC 290S,A01,637330,Merrifield; Mark A,23,0,30,7
1714634107538,SIOC 291S,A01,637333,Gabriel; Corey John,23,0,30,7
1714634108567,SOCI 117,A01,494376,Staff,0,4,5,5
1714634109597,WES 237B,A00,494380,Staff,9,0,20,11
1714634111695,AESE 279B,A00,494370,Wade; Jon P,0,0,33,33
1714634112723,AIP 197,001,627712,Vespa; Emanuel Ignacio,9998,0,9999,1
1714634113751,ANAR 135S,A00,494369,Braswell; Geoffrey E.,0,0,0,0
1714634114778,BENG 196,001,628496,Engler; Adam J.,9998,0,9999,1
1714634115807,CAT 124RS,A01,519847,Geibel; William,0,0,20,20
1714634116830,CAT 125RS,A01,515971,Geibel; William,0,0,20,20
1714634117865,CLRE 250,A00,511389,Morris; Sheldon,9993,0,9999,6
1714634118966,CLRE 251,A00,507176,Mehta; Ravindra L.,9993,0,9999,6
1714634118966,CLRE 251,B00,511410,Mehta; Ravindra L.,9998,0,9999,1
1714634120005,CLRE 252,A00,507189,Cuomo; Raphael Eduardo,9995,0,9999,4
1714634121033,CLRE 253,A00,507199,Vaida; Florin,9994,0,9999,5
1714634121033,CLRE 253,B00,507202,Vaida; Florin,9999,0,9999,0
1714634122063,CLRE 259,A00,507211,Patel; Hemal,9996,0,9999,3
1714634123090,CLRE 260,A00,507221,Cuomo; Raphael Eduardo,9999,0,9999,0
1714634124122,CLRE 297,001,507242,Cuomo; Raphael Eduardo,9999,0,9999,0
1714634125154,COGS 197,001,638244,Voytek; Bradley Thomas,9998,0,9999,1
1714634126185,CSE 191,A00,516875,Minnes Kemp; Mor Mia,9992,0,9999,7
1714634127215,CSE 197,001,637388,Minnes Kemp; Mor Mia,9998,0,9999,1
1714634128262,CSS 201S,A01,494383,Staff,35,0,35,0
1714634129289,CSS 202S,A01,494387,Staff,35,0,35,0
1714634130323,DSC 197,001,628532,Eldridge; Justin Matthew,9996,0,9999,3
1714634131364,EAP 100,A00,516065,Staff,9797,0,9999,202
1714634132391,ECE 45,A01,507414,Staff,33,0,60,27
1714634134442,ECE 111,A01,507420,Staff,15,0,50,35
1714634135467,ECE 197,001,548057,Sievenpiper; Daniel F.,9993,0,9999,6
1714634136496,EDS 115,A00,507243,Choi; Bailey Miyeon,10,0,28,18
1714634137525,EDS 117,A01,494379,Staff,0,4,30,30
1714634138552,EDS 125,A00,507246,Hopkins; Megan Beth,9,0,30,21
1714634139579,EDS 128A,A01,507264,Fargason; Sharon Gayle,8,0,26,18
1714634140615,EDS 128B,A01,507293,Pappas; Elizabeth,12,0,30,18
1714634141649,EDS 139,A00,507294,Fargason; Sharon Gayle,13,0,30,17
1714634141649,EDS 139,B00,507313,Pappas; Elizabeth,13,0,30,17
1714634142675,EDS 201,A00,507315,Staff,13,0,30,17
1714634143702,EDS 203,A01,507317,Halter; Christopher P.,12,0,30,18
1714634144737,EDS 204R,A01,507319,Halter; Christopher P.,0,3,30,30
1714634144737,EDS 204R,B01,507331,Heinzman; Erica M.,16,0,30,14
1714634145767,EDS 206R,A00,507332,Staff,0,4,30,30
1714634145767,EDS 206R,B00,507343,Staff,17,0,30,13
1714634146793,EDS 250,A00,507344,Hemans; Patricia Ann Benitez,22,0,40,18
1714634147820,EDS 281,A00,507345,Daly; Alan J.,18,0,18,0
1714634148846,EDS 284,A00,507350,Daly; Alan J.,16,0,16,0
1714634149874,EDS 286,A00,507359,Fine; Sarah,18,0,18,0
1714634150899,EDS 289C,A01,507361,Daly; Alan J.,18,0,18,0
1714634151929,EDS 290,A00,507366,Hofstetter; Carolyn,15,0,15,0
1714634152961,LIGM 5A,A00,507421,Fischer-Grunski; Eva K,18,0,20,2
1714634153986,LIGM 5B,A00,507423,Fischer-Grunski; Eva K,19,0,20,1
1714634155016,LIGM 5C,A00,507425,Fischer-Grunski; Eva K,19,0,20,1
1714634156042,LIIT 5AS,A00,507427,Carnelos; Chiara,20,0,20,0
1714634157068,LIIT 5BS,A00,507430,Carnelos; Chiara,20,0,20,0
1714634158112,LIIT 5CS,A00,507432,Carnelos; Chiara,20,0,20,0
1714634159198,LISP 5A,A00,507541,Munoz Sanchez; Alicia,11,0,20,9
1714634160242,LISP 5B,A00,507671,Munoz Sanchez; Alicia,8,0,20,12
1714634161271,LISP 5C,A00,507696,Munoz Sanchez; Alicia,9,0,20,11
1714634162299,MAE 197,001,528363,Boechler; Nicholas Sebastia,9998,0,9999,1
1714634163331,MATH 197,001,523477,Kedlaya; Kiran S.,9995,0,9999,4
1714634163331,MATH 197,002,563811,Zhang; Danna,9995,0,9999,4
1714634163331,MATH 197,003,628552,Dumitriu; Ioana,9998,0,9999,1
1714634164359,MCWP 40R,A00,518780,Staff,2,0,20,18
1714634164359,MCWP 40R,B00,518781,Staff,8,0,20,12
1714634164359,MCWP 40R,C00,518783,Staff,6,0,20,14
1714634165398,MCWP 50R,A00,518791,Staff,0,0,20,20
1714634165398,MCWP 50R,B00,518792,Staff,0,2,20,20
1714634165398,MCWP 50R,C00,518793,Staff,0,2,20,20
1714634165398,MCWP 50R,D00,518794,Staff,0,0,20,20
1714634165398,MCWP 50R,E00,518795,Staff,0,2,20,20
1714634165398,MCWP 50R,F00,518796,Staff,0,0,20,20
1714634165398,MCWP 50R,G00,518797,Staff,0,1,20,20
1714634166438,MMW 12R,A01,514034,Herbst; Matthew,0,0,16,16
1714634166438,MMW 12R,A02,514035,Herbst; Matthew,1,0,16,15
1714634167478,MMW 13R,A01,514037,Staff,0,4,16,16
1714634167478,MMW 13R,A02,514039,Staff,0,2,16,16
1714634167478,MMW 13R,A03,628519,Staff,0,2,16,16
1714634169549,SIO 295LS,A00,523233,Staff,10,0,30,20
1714634170580,SIO 295S,A00,523232,Staff,10,0,30,20
1714634171614,SIOC 290S,A01,637330,Merrifield; Mark A,23,0,30,7
1714634172663,SIOC 291S,A01,637333,Gabriel; Corey John,23,0,30,7
1714634173690,SOCI 117,A01,494376,Staff,0,4,5,5
1714634174721,WES 237B,A00,494380,Staff,9,0,20,11
1714634176811,AESE 279B,A00,494370,Wade; Jon P,0,0,33,33
1714634177851,AIP 197,001,627712,Vespa; Emanuel Ignacio,9998,0,9999,1
1714634178886,ANAR 135S,A00,494369,Braswell; Geoffrey E.,0,0,0,0
1714634179914,BENG 196,001,628496,Engler; Adam J.,9998,0,9999,1
1714634180946,CAT 124RS,A01,519847,Geibel; William,0,0,20,20
1714634181973,CAT 125RS,A01,515971,Geibel; William,0,0,20,20
1714634183002,CLRE 250,A00,511389,Morris; Sheldon,9993,0,9999,6
1714634184028,CLRE 251,A00,507176,Mehta; Ravindra L.,9993,0,9999,6
1714634184028,CLRE 251,B00,511410,Mehta; Ravindra L.,9998,0,9999,1
1714634185054,CLRE 252,A00,507189,Cuomo; Raphael Eduardo,9995,0,9999,4
1714634186083,CLRE 253,A00,507199,Vaida; Florin,9994,0,9999,5
1714634186083,CLRE 253,B00,507202,Vaida; Florin,9999,0,9999,0
1714634187113,CLRE 259,A00,507211,Patel; Hemal,9996,0,9999,3
1714634188150,CLRE 260,A00,507221,Cuomo; Raphael Eduardo,9999,0,9999,0
1714634189182,CLRE 297,001,507242,Cuomo; Raphael Eduardo,9999,0,9999,0
1714634190210,COGS 197,001,638244,Voytek; Bradley Thomas,9998,0,9999,1
1714634191240,CSE 191,A00,516875,Minnes Kemp; Mor Mia,9992,0,9999,7
1714634192268,CSE 197,001,637388,Minnes Kemp; Mor Mia,9998,0,9999,1
1714634193295,CSS 201S,A01,494383,Staff,35,0,35,0
1714634194325,CSS 202S,A01,494387,Staff,35,0,35,0
1714634195351,DSC 197,001,628532,Eldridge; Justin Matthew,9996,0,9999,3
1714634196377,EAP 100,A00,516065,Staff,9797,0,9999,202
1714634197405,ECE 45,A01,507414,Staff,33,0,60,27
1714634199471,ECE 111,A01,507420,Staff,15,0,50,35
1714634200498,ECE 197,001,548057,Sievenpiper; Daniel F.,9993,0,9999,6
1714634201532,EDS 115,A00,507243,Choi; Bailey Miyeon,10,0,28,18
1714634202558,EDS 117,A01,494379,Staff,0,4,30,30
1714634203588,EDS 125,A00,507246,Hopkins; Megan Beth,9,0,30,21
1714634204614,EDS 128A,A01,507264,Fargason; Sharon Gayle,8,0,26,18
1714634205641,EDS 128B,A01,507293,Pappas; Elizabeth,12,0,30,18
1714634206667,EDS 139,A00,507294,Fargason; Sharon Gayle,13,0,30,17
1714634206667,EDS 139,B00,507313,Pappas; Elizabeth,13,0,30,17
1714634207699,EDS 201,A00,507315,Staff,13,0,30,17
1714634208726,EDS 203,A01,507317,Halter; Christopher P.,12,0,30,18
1714634209766,EDS 204R,A01,507319,Halter; Christopher P.,0,3,30,30
1714634209766,EDS 204R,B01,507331,Heinzman; Erica M.,16,0,30,14
1714634210799,EDS 206R,A00,507332,Staff,0,4,30,30
1714634210799,EDS 206R,B00,507343,Staff,17,0,30,13
1714634211825,EDS 250,A00,507344,Hemans; Patricia Ann Benitez,22,0,40,18
1714634212884,EDS 281,A00,507345,Daly; Alan J.,18,0,18,0
1714634213914,EDS 284,A00,507350,Daly; Alan J.,16,0,16,0
1714634214954,EDS 286,A00,507359,Fine; Sarah,18,0,18,0
1714634215979,EDS 289C,A01,507361,Daly; Alan J.,18,0,18,0
1714634217008,EDS 290,A00,507366,Hofstetter; Carolyn,15,0,15,0
1714634218038,LIGM 5A,A00,507421,Fischer-Grunski; Eva K,18,0,20,2
1714634219068,LIGM 5B,A00,507423,Fischer-Grunski; Eva K,19,0,20,1
1714634220167,LIGM 5C,A00,507425,Fischer-Grunski; Eva K,19,0,20,1
1714634221196,LIIT 5AS,A00,507427,Carnelos; Chiara,20,0,20,0
1714634222226,LIIT 5BS,A00,507430,Carnelos; Chiara,20,0,20,0
1714634223255,LIIT 5CS,A00,507432,Carnelos; Chiara,20,0,20,0
1714634224283,LISP 5A,A00,507541,Munoz Sanchez; Alicia,11,0,20,9
1714634225320,LISP 5B,A00,507671,Munoz Sanchez; Alicia,8,0,20,12
1714634226348,LISP 5C,A00,507696,Munoz Sanchez; Alicia,9,0,20,11
1714634227375,MAE 197,001,528363,Boechler; Nicholas Sebastia,9998,0,9999,1
1714634228404,MATH 197,001,523477,Kedlaya; Kiran S.,9995,0,9999,4
1714634228404,MATH 197,002,563811,Zhang; Danna,9995,0,9999,4
1714634228404,MATH 197,003,628552,Dumitriu; Ioana,9998,0,9999,1
1714634229436,MCWP 40R,A00,518780,Staff,2,0,20,18
1714634229436,MCWP 40R,B00,518781,Staff,8,0,20,12
1714634229436,MCWP 40R,C00,518783,Staff,6,0,20,14
1714634230470,MCWP 50R,A00,518791,Staff,0,0,20,20
1714634230470,MCWP 50R,B00,518792,Staff,0,2,20,20
1714634230470,MCWP 50R,C00,518793,Staff,0,2,20,20
1714634230470,MCWP 50R,D00,518794,Staff,0,0,20,20
1714634230470,MCWP 50R,E00,518795,Staff,0,2,20,20
1714634230470,MCWP 50R,F00,518796,Staff,0,0,20,20
1714634230470,MCWP 50R,G00,518797,Staff,0,1,20,20
1714634231498,MMW 12R,A01,514034,Herbst; Matthew,0,0,16,16
1714634231498,MMW 12R,A02,514035,Herbst; Matthew,1,0,16,15
1714634232525,MMW 13R,A01,514037,Staff,0,4,16,16
1714634232525,MMW 13R,A02,514039,Staff,0,2,16,16
1714634232525,MMW 13R,A03,628519,Staff,0,2,16,16
1714634234593,SIO 295LS,A00,523233,Staff,10,0,30,20
1714634235620,SIO 295S,A00,523232,Staff,10,0,30,20
1714634236646,SIOC 290S,A01,637330,Merrifield; Mark A,23,0,30,7
1714634237678,SIOC 291S,A01,637333,Gabriel; Corey John,23,0,30,7
1714634238708,SOCI 117,A01,494376,Staff,0,4,5,5
1714634239741,WES 237B,A00,494380,Staff,9,0,20,11
1714634241832,AESE 279B,A00,494370,Wade; Jon P,0,0,33,33
1714634242912,AIP 197,001,627712,Vespa; Emanuel Ignacio,9998,0,9999,1
1714634243942,ANAR 135S,A00,494369,Braswell; Geoffrey E.,0,0,0,0
1714634244973,BENG 196,001,628496,Engler; Adam J.,9998,0,9999,1
1714634246000,CAT 124RS,A01,519847,Geibel; William,0,0,20,20
1714634247028,CAT 125RS,A01,515971,Geibel; William,0,0,20,20
1714634248054,CLRE 250,A00,511389,Morris; Sheldon,9993,0,9999,6
1714634249082,CLRE 251,A00,507176,Mehta; Ravindra L.,9993,0,9999,6
1714634249082,CLRE 251,B00,511410,Mehta; Ravindra L.,9998,0,9999,1
1714634250109,CLRE 252,A00,507189,Cuomo; Raphael Eduardo,9995,0,9999,4
1714634251137,CLRE 253,A00,507199,Vaida; Florin,9994,0,9999,5
1714634251137,CLRE 253,B00,507202,Vaida; Florin,9999,0,9999,0
1714634252166,CLRE 259,A00,507211,Patel; Hemal,9996,0,9999,3
1714634253201,CLRE 260,A00,507221,Cuomo; Raphael Eduardo,9999,0,9999,0
1714634254229,CLRE 297,001,507242,Cuomo; Raphael Eduardo,9999,0,9999,0
1714634255273,COGS 197,001,638244,Voytek; Bradley Thomas,9998,0,9999,1
1714634256302,CSE 191,A00,516875,Minnes Kemp; Mor Mia,9992,0,9999,7
1714634257340,CSE 197,001,637388,Minnes Kemp; Mor Mia,9998,0,9999,1
1714634258373,CSS 201S,A01,494383,Staff,35,0,35,0
1714634259399,CSS 202S,A01,494387,Staff,35,0,35,0
1714634260428,DSC 197,001,628532,Eldridge; Justin Matthew,9996,0,9999,3
1714634261466,EAP 100,A00,516065,Staff,9797,0,9999,202
1714634262500,ECE 45,A01,507414,Staff,33,0,60,27
1714634264606,ECE 111,A01,507420,Staff,15,0,50,35
1714634265642,ECE 197,001,548057,Sievenpiper; Daniel F.,9993,0,9999,6
1714634266668,EDS 115,A00,507243,Choi; Bailey Miyeon,10,0,28,18
1714634267701,EDS 117,A01,494379,Staff,0,4,30,30
1714634268727,EDS 125,A00,507246,Hopkins; Megan Beth,9,0,30,21
1714634269756,EDS 128A,A01,507264,Fargason; Sharon Gayle,8,0,26,18
1714634270781,EDS 128B,A01,507293,Pappas; Elizabeth,12,0,30,18
1714634271810,EDS 139,A00,507294,Fargason; Sharon Gayle,13,0,30,17
1714634271810,EDS 139,B00,507313,Pappas; Elizabeth,13,0,30,17
1714634272838,EDS 201,A00,507315,Staff,13,0,30,17
1714634273866,EDS 203,A01,507317,Halter; Christopher P.,12,0,30,18
1714634274893,EDS 204R,A01,507319,Halter; Christopher P.,0,3,30,30
1714634274893,EDS 204R,B01,507331,Heinzman; Erica M.,16,0,30,14
1714634275917,EDS 206R,A00,507332,Staff,0,4,30,30
1714634275917,EDS 206R,B00,507343,Staff,17,0,30,13
1714634276943,EDS 250,A00,507344,Hemans; Patricia Ann Benitez,22,0,40,18
1714634277970,EDS 281,A00,507345,Daly; Alan J.,18,0,18,0
1714634278994,EDS 284,A00,507350,Daly; Alan J.,16,0,16,0
1714634280038,EDS 286,A00,507359,Fine; Sarah,18,0,18,0
1714634281066,EDS 289C,A01,507361,Daly; Alan J.,18,0,18,0
1714634282095,EDS 290,A00,507366,Hofstetter; Carolyn,15,0,15,0
1714634283147,LIGM 5A,A00,507421,Fischer-Grunski; Eva K,18,0,20,2
1714634284179,LIGM 5B,A00,507423,Fischer-Grunski; Eva K,19,0,20,1
1714634285205,LIGM 5C,A00,507425,Fischer-Grunski; Eva K,19,0,20,1
1714634286231,LIIT 5AS,A00,507427,Carnelos; Chiara,20,0,20,0
1714634287257,LIIT 5BS,A00,507430,Carnelos; Chiara,20,0,20,0
1714634288282,LIIT 5CS,A00,507432,Carnelos; Chiara,20,0,20,0
1714634289307,LISP 5A,A00,507541,Munoz Sanchez; Alicia,11,0,20,9
1714634290333,LISP 5B,A00,507671,Munoz Sanchez; Alicia,8,0,20,12
1714634291372,LISP 5C,A00,507696,Munoz Sanchez; Alicia,9,0,20,11
1714634292397,MAE 197,001,528363,Boechler; Nicholas Sebastia,9998,0,9999,1
1714634293434,MATH 197,001,523477,Kedlaya; Kiran S.,9995,0,9999,4
1714634293434,MATH 197,002,563811,Zhang; Danna,9995,0,9999,4
1714634293434,MATH 197,003,628552,Dumitriu; Ioana,9998,0,9999,1
1714634294461,MCWP 40R,A00,518780,Staff,2,0,20,18
1714634294461,MCWP 40R,B00,518781,Staff,8,0,20,12
1714634294461,MCWP 40R,C00,518783,Staff,6,0,20,14
1714634295494,MCWP 50R,A00,518791,Staff,0,0,20,20
1714634295494,MCWP 50R,B00,518792,Staff,0,2,20,20
1714634295494,MCWP 50R,C00,518793,Staff,0,2,20,20
1714634295494,MCWP 50R,D00,518794,Staff,0,0,20,20
1714634295494,MCWP 50R,E00,518795,Staff,0,2,20,20
1714634295494,MCWP 50R,F00,518796,Staff,0,0,20,20
1714634295494,MCWP 50R,G00,518797,Staff,0,1,20,20
1714634296526,MMW 12R,A01,514034,Herbst; Matthew,0,0,16,16
1714634296526,MMW 12R,A02,514035,Herbst; Matthew,1,0,16,15
1714634297564,MMW 13R,A01,514037,Staff,0,4,16,16
1714634297564,MMW 13R,A02,514039,Staff,0,2,16,16
1714634297564,MMW 13R,A03,628519,Staff,0,2,16,16
1714634299616,SIO 295LS,A00,523233,Staff,10,0,30,20
1714634300849,SIO 295S,A00,523232,Staff,10,0,30,20
1714634301876,SIOC 290S,A01,637330,Merrifield; Mark A,23,0,30,7
1714634302913,SIOC 291S,A01,637333,Gabriel; Corey John,23,0,30,7
1714634303937,SOCI 117,A01,494376,Staff,0,4,5,5
1714634304967,WES 237B,A00,494380,Staff,9,0,20,11
1714634307034,AESE 279B,A00,494370,Wade; Jon P,0,0,33,33
1714634308058,AIP 197,001,627712,Vespa; Emanuel Ignacio,9998,0,9999,1
1714634309089,ANAR 135S,A00,494369,Braswell; Geoffrey E.,0,0,0,0
1714634310114,BENG 196,001,628496,Engler; Adam J.,9998,0,9999,1
1714634311151,CAT 124RS,A01,519847,Geibel; William,0,0,20,20
1714634312177,CAT 125RS,A01,515971,Geibel; William,0,0,20,20
1714634313204,CLRE 250,A00,511389,Morris; Sheldon,9993,0,9999,6
1714634314234,CLRE 251,A00,507176,Mehta; Ravindra L.,9993,0,9999,6
1714634314234,CLRE 251,B00,511410,Mehta; Ravindra L.,9998,0,9999,1
1714634315267,CLRE 252,A00,507189,Cuomo; Raphael Eduardo,9995,0,9999,4
1714634316299,CLRE 253,A00,507199,Vaida; Florin,9994,0,9999,5
1714634316299,CLRE 253,B00,507202,Vaida; Florin,9999,0,9999,0
1714634317327,CLRE 259,A00,507211,Patel; Hemal,9996,0,9999,3
1714634318361,CLRE 260,A00,507221,Cuomo; Raphael Eduardo,9999,0,9999,0
1714634319395,CLRE 297,001,507242,Cuomo; Raphael Eduardo,9999,0,9999,0
1714634320429,COGS 197,001,638244,Voytek; Bradley Thomas,9998,0,9999,1
1714634321457,CSE 191,A00,516875,Minnes Kemp; Mor Mia,9992,0,9999,7
1714634322481,CSE 197,001,637388,Minnes Kemp; Mor Mia,9998,0,9999,1
1714634323506,CSS 201S,A01,494383,Staff,35,0,35,0
1714634324533,CSS 202S,A01,494387,Staff,35,0,35,0
1714634325561,DSC 197,001,628532,Eldridge; Justin Matthew,9996,0,9999,3
1714634326588,EAP 100,A00,516065,Staff,9797,0,9999,202
1714634327618,ECE 45,A01,507414,Staff,33,0,60,27
1714634329675,ECE 111,A01,507420,Staff,15,0,50,35
1714634330701,ECE 197,001,548057,Sievenpiper; Daniel F.,9993,0,9999,6
1714634331731,EDS 115,A00,507243,Choi; Bailey Miyeon,10,0,28,18
1714634332759,EDS 117,A01,494379,Staff,0,4,30,30
1714634333792,EDS 125,A00,507246,Hopkins; Megan Beth,9,0,30,21
1714634334820,EDS 128A,A01,507264,Fargason; Sharon Gayle,8,0,26,18
1714634335851,EDS 128B,A01,507293,Pappas; Elizabeth,12,0,30,18
1714634336879,EDS 139,A00,507294,Fargason; Sharon Gayle,13,0,30,17
1714634336879,EDS 139,B00,507313,Pappas; Elizabeth,13,0,30,17
1714634337909,EDS 201,A00,507315,Staff,13,0,30,17
1714634338943,EDS 203,A01,507317,Halter; Christopher P.,12,0,30,18
1714634339972,EDS 204R,A01,507319,Halter; Christopher P.,0,3,30,30
1714634339972,EDS 204R,B01,507331,Heinzman; Erica M.,16,0,30,14
1714634341003,EDS 206R,A00,507332,Staff,0,4,30,30
1714634341003,EDS 206R,B00,507343,Staff,17,0,30,13
1714634342035,EDS 250,A00,507344,Hemans; Patricia Ann Benitez,22,0,40,18
1714634343064,EDS 281,A00,507345,Daly; Alan J.,18,0,18,0
1714634344091,EDS 284,A00,507350,Daly; Alan J.,16,0,16,0
1714634345118,EDS 286,A00,507359,Fine; Sarah,18,0,18,0
1714634346146,EDS 289C,A01,507361,Daly; Alan J.,18,0,18,0
1714634347171,EDS 290,A00,507366,Hofstetter; Carolyn,15,0,15,0
1714634348199,LIGM 5A,A00,507421,Fischer-Grunski; Eva K,18,0,20,2
1714634349226,LIGM 5B,A00,507423,Fischer-Grunski; Eva K,19,0,20,1
1714634350256,LIGM 5C,A00,507425,Fischer-Grunski; Eva K,19,0,20,1
1714634351282,LIIT 5AS,A00,507427,Carnelos; Chiara,20,0,20,0
1714634352311,LIIT 5BS,A00,507430,Carnelos; Chiara,20,0,20,0
1714634353338,LIIT 5CS,A00,507432,Carnelos; Chiara,20,0,20,0
1714634354366,LISP 5A,A00,507541,Munoz Sanchez; Alicia,11,0,20,9
1714634355399,LISP 5B,A00,507671,Munoz Sanchez; Alicia,8,0,20,12
1714634356425,LISP 5C,A00,507696,Munoz Sanchez; Alicia,9,0,20,11
1714634357457,MAE 197,001,528363,Boechler; Nicholas Sebastia,9998,0,9999,1
1714634358488,MATH 197,001,523477,Kedlaya; Kiran S.,9995,0,9999,4
1714634358488,MATH 197,002,563811,Zhang; Danna,9995,0,9999,4
1714634358488,MATH 197,003,628552,Dumitriu; Ioana,9998,0,9999,1
1714634359516,MCWP 40R,A00,518780,Staff,2,0,20,18
1714634359516,MCWP 40R,B00,518781,Staff,8,0,20,12
1714634359516,MCWP 40R,C00,518783,Staff,6,0,20,14
1714634360541,MCWP 50R,A00,518791,Staff,0,0,20,20
1714634360541,MCWP 50R,B00,518792,Staff,0,2,20,20
1714634360541,MCWP 50R,C00,518793,Staff,0,2,20,20
1714634360541,MCWP 50R,D00,518794,Staff,0,0,20,20
1714634360541,MCWP 50R,E00,518795,Staff,0,2,20,20
1714634360541,MCWP 50R,F00,518796,Staff,0,0,20,20
1714634360541,MCWP 50R,G00,518797,Staff,0,1,20,20
1714634361568,MMW 12R,A01,514034,Herbst; Matthew,0,0,16,16
1714634361568,MMW 12R,A02,514035,Herbst; Matthew,1,0,16,15
1714634362594,MMW 13R,A01,514037,Staff,0,4,16,16
1714634362594,MMW 13R,A02,514039,Staff,0,2,16,16
1714634362594,MMW 13R,A03,628519,Staff,0,2,16,16
1714634364659,SIO 295LS,A00,523233,Staff,10,0,30,20
1714634365693,SIO 295S,A00,523232,Staff,10,0,30,20
1714634366721,SIOC 290S,A01,637330,Merrifield; Mark A,23,0,30,7
1714634367805,SIOC 291S,A01,637333,Gabriel; Corey John,23,0,30,7
1714634368829,SOCI 117,A01,494376,Staff,0,4,5,5
1714634369856,WES 237B,A00,494380,Staff,9,0,20,11
1714634371959,AESE 279B,A00,494370,Wade; Jon P,0,0,33,33
1714634372989,AIP 197,001,627712,Vespa; Emanuel Ignacio,9998,0,9999,1
1714634374023,ANAR 135S,A00,494369,Braswell; Geoffrey E.,0,0,0,0
1714634375061,BENG 196,001,628496,Engler; Adam J.,9998,0,9999,1
1714634376101,CAT 124RS,A01,519847,Geibel; William,0,0,20,20
1714634377132,CAT 125RS,A01,515971,Geibel; William,0,0,20,20
1714634378172,CLRE 250,A00,511389,Morris; Sheldon,9993,0,9999,6
1714634379202,CLRE 251,A00,507176,Mehta; Ravindra L.,9993,0,9999,6
1714634379202,CLRE 251,B00,511410,Mehta; Ravindra L.,9998,0,9999,1
1714634380229,CLRE 252,A00,507189,Cuomo; Raphael Eduardo,9995,0,9999,4
1714634381258,CLRE 253,A00,507199,Vaida; Florin,9994,0,9999,5
1714634381258,CLRE 253,B00,507202,Vaida; Florin,9999,0,9999,0
1714634382305,CLRE 259,A00,507211,Patel; Hemal,9996,0,9999,3
1714634383334,CLRE 260,A00,507221,Cuomo; Raphael Eduardo,9999,0,9999,0
1714634384364,CLRE 297,001,507242,Cuomo; Raphael Eduardo,9999,0,9999,0
1714634385392,COGS 197,001,638244,Voytek; Bradley Thomas,9998,0,9999,1
1714634386421,CSE 191,A00,516875,Minnes Kemp; Mor Mia,9992,0,9999,7
1714634387445,CSE 197,001,637388,Minnes Kemp; Mor Mia,9998,0,9999,1
1714634388477,CSS 201S,A01,494383,Staff,35,0,35,0
1714634389502,CSS 202S,A01,494387,Staff,35,0,35,0
1714634390529,DSC 197,001,628532,Eldridge; Justin Matthew,9996,0,9999,3
1714634391555,EAP 100,A00,516065,Staff,9797,0,9999,202
1714634392580,ECE 45,A01,507414,Staff,33,0,60,27
1714634394635,ECE 111,A01,507420,Staff,15,0,50,35
1714634395660,ECE 197,001,548057,Sievenpiper; Daniel F.,9993,0,9999,6
1714634396685,EDS 115,A00,507243,Choi; Bailey Miyeon,10,0,28,18
1714634397711,EDS 117,A01,494379,Staff,0,4,30,30
1714634398739,EDS 125,A00,507246,Hopkins; Megan Beth,9,0,30,21
1714634399766,EDS 128A,A01,507264,Fargason; Sharon Gayle,8,0,26,18
1714634400803,EDS 128B,A01,507293,Pappas; Elizabeth,12,0,30,18
1714634401834,EDS 139,A00,507294,Fargason; Sharon Gayle,13,0,30,17
1714634401834,EDS 139,B00,507313,Pappas; Elizabeth,13,0,30,17
1714634402861,EDS 201,A00,507315,Staff,13,0,30,17
1714634403893,EDS 203,A01,507317,Halter; Christopher P.,12,0,30,18
1714634404920,EDS 204R,A01,507319,Halter; Christopher P.,0,3,30,30
1714634404920,EDS 204R,B01,507331,Heinzman; Erica M.,16,0,30,14
1714634405946,EDS 206R,A00,507332,Staff,0,4,30,30
1714634405946,EDS 206R,B00,507343,Staff,17,0,30,13
1714634406978,EDS 250,A00,507344,Hemans; Patricia Ann Benitez,22,0,40,18
1714634408008,EDS 281,A00,507345,Daly; Alan J.,18,0,18,0
1714634409035,EDS 284,A00,507350,Daly; Alan J.,16,0,16,0
1714634410066,EDS 286,A00,507359,Fine; Sarah,18,0,18,0
1714634411098,EDS 289C,A01,507361,Daly; Alan J.,18,0,18,0
1714634412124,EDS 290,A00,507366,Hofstetter; Carolyn,15,0,15,0
1714634413159,LIGM 5A,A00,507421,Fischer-Grunski; Eva K,18,0,20,2
1714634414190,LIGM 5B,A00,507423,Fischer-Grunski; Eva K,19,0,20,1
1714634415215,LIGM 5C,A00,507425,Fischer-Grunski; Eva K,19,0,20,1
1714634416241,LIIT 5AS,A00,507427,Carnelos; Chiara,20,0,20,0
1714634417268,LIIT 5BS,A00,507430,Carnelos; Chiara,20,0,20,0
1714634418294,LIIT 5CS,A00,507432,Carnelos; Chiara,20,0,20,0
1714634419321,LISP 5A,A00,507541,Munoz Sanchez; Alicia,11,0,20,9
1714634420346,LISP 5B,A00,507671,Munoz Sanchez; Alicia,8,0,20,12
1714634421372,LISP 5C,A00,507696,Munoz Sanchez; Alicia,9,0,20,11
1714634422402,MAE 197,001,528363,Boechler; Nicholas Sebastia,9998,0,9999,1
1714634423434,MATH 197,001,523477,Kedlaya; Kiran S.,9995,0,9999,4
1714634423434,MATH 197,002,563811,Zhang; Danna,9995,0,9999,4
1714634423434,MATH 197,003,628552,Dumitriu; Ioana,9998,0,9999,1
1714634424467,MCWP 40R,A00,518780,Staff,2,0,20,18
1714634424467,MCWP 40R,B00,518781,Staff,8,0,20,12
1714634424467,MCWP 40R,C00,518783,Staff,6,0,20,14
1714634425495,MCWP 50R,A00,518791,Staff,0,0,20,20
1714634425495,MCWP 50R,B00,518792,Staff,0,2,20,20
1714634425495,MCWP 50R,C00,518793,Staff,0,2,20,20
1714634425495,MCWP 50R,D00,518794,Staff,0,0,20,20
1714634425495,MCWP 50R,E00,518795,Staff,0,2,20,20
1714634425495,MCWP 50R,F00,518796,Staff,0,0,20,20
1714634425495,MCWP 50R,G00,518797,Staff,0,1,20,20
1714634426530,MMW 12R,A01,514034,Herbst; Matthew,0,0,16,16
1714634426530,MMW 12R,A02,514035,Herbst; Matthew,1,0,16,15
1714634427565,MMW 13R,A01,514037,Staff,0,4,16,16
1714634427565,MMW 13R,A02,514039,Staff,0,2,16,16
1714634427565,MMW 13R,A03,628519,Staff,0,2,16,16
1714634429619,SIO 295LS,A00,523233,Staff,10,0,30,20
1714634430650,SIO 295S,A00,523232,Staff,10,0,30,20
1714634431676,SIOC 290S,A01,637330,Merrifield; Mark A,23,0,30,7
1714634432701,SIOC 291S,A01,637333,Gabriel; Corey John,23,0,30,7
1714634433728,SOCI 117,A01,494376,Staff,0,4,5,5
1714634434758,WES 237B,A00,494380,Staff,9,0,20,11
1714634436853,AESE 279B,A00,494370,Wade; Jon P,0,0,33,33
1714634437886,AIP 197,001,627712,Vespa; Emanuel Ignacio,9998,0,9999,1
1714634438916,ANAR 135S,A00,494369,Braswell; Geoffrey E.,0,0,0,0
1714634439946,BENG 196,001,628496,Engler; Adam J.,9998,0,9999,1
1714634440976,CAT 124RS,A01,519847,Geibel; William,0,0,20,20
1714634442009,CAT 125RS,A01,515971,Geibel; William,0,0,20,20
1714634443048,CLRE 250,A00,511389,Morris; Sheldon,9993,0,9999,6
1714634444076,CLRE 251,A00,507176,Mehta; Ravindra L.,9993,0,9999,6
1714634444076,CLRE 251,B00,511410,Mehta; Ravindra L.,9998,0,9999,1
1714634445105,CLRE 252,A00,507189,Cuomo; Raphael Eduardo,9995,0,9999,4
1714634446134,CLRE 253,A00,507199,Vaida; Florin,9994,0,9999,5
1714634446134,CLRE 253,B00,507202,Vaida; Florin,9999,0,9999,0
1714634447158,CLRE 259,A00,507211,Patel; Hemal,9996,0,9999,3
1714634448181,CLRE 260,A00,507221,Cuomo; Raphael Eduardo,9999,0,9999,0
1714634449211,CLRE 297,001,507242,Cuomo; Raphael Eduardo,9999,0,9999,0
1714634450239,COGS 197,001,638244,Voytek; Bradley Thomas,9998,0,9999,1
1714634451268,CSE 191,A00,516875,Minnes Kemp; Mor Mia,9992,0,9999,7
1714634452294,CSE 197,001,637388,Minnes Kemp; Mor Mia,9998,0,9999,1
1714634453323,CSS 201S,A01,494383,Staff,35,0,35,0
1714634454360,CSS 202S,A01,494387,Staff,35,0,35,0
1714634455394,DSC 197,001,628532,Eldridge; Justin Matthew,9996,0,9999,3
1714634456422,EAP 100,A00,516065,Staff,9797,0,9999,202
1714634457447,ECE 45,A01,507414,Staff,33,0,60,27
1714634459502,ECE 111,A01,507420,Staff,15,0,50,35
1714634460538,ECE 197,001,548057,Sievenpiper; Daniel F.,9993,0,9999,6
1714634461564,EDS 115,A00,507243,Choi; Bailey Miyeon,10,0,28,18
1714634462591,EDS 117,A01,494379,Staff,0,4,30,30
1714634463626,EDS 125,A00,507246,Hopkins; Megan Beth,9,0,30,21
1714634464650,EDS 128A,A01,507264,Fargason; Sharon Gayle,8,0,26,18
1714634465676,EDS 128B,A01,507293,Pappas; Elizabeth,12,0,30,18
1714634466703,EDS 139,A00,507294,Fargason; Sharon Gayle,13,0,30,17
1714634466703,EDS 139,B00,507313,Pappas; Elizabeth,13,0,30,17
1714634467726,EDS 201,A00,507315,Staff,13,0,30,17
1714634468752,EDS 203,A01,507317,Halter; Christopher P.,12,0,30,18
1714634469787,EDS 204R,A01,507319,Halter; Christopher P.,0,3,30,30
1714634469787,EDS 204R,B01,507331,Heinzman; Erica M.,16,0,30,14
1714634470813,EDS 206R,A00,507332,Staff,0,4,30,30
1714634470813,EDS 206R,B00,507343,Staff,17,0,30,13
1714634471838,EDS 250,A00,507344,Hemans; Patricia Ann Benitez,22,0,40,18
1714634472867,EDS 281,A00,507345,Daly; Alan J.,18,0,18,0
1714634473896,EDS 284,A00,507350,Daly; Alan J.,16,0,16,0
1714634474924,EDS 286,A00,507359,Fine; Sarah,18,0,18,0
1714634475951,EDS 289C,A01,507361,Daly; Alan J.,18,0,18,0
1714634476977,EDS 290,A00,507366,Hofstetter; Carolyn,15,0,15,0
1714634478003,LIGM 5A,A00,507421,Fischer-Grunski; Eva K,18,0,20,2
1714634479028,LIGM 5B,A00,507423,Fischer-Grunski; Eva K,19,0,20,1
1714634480052,LIGM 5C,A00,507425,Fischer-Grunski; Eva K,19,0,20,1
1714634481090,LIIT 5AS,A00,507427,Carnelos; Chiara,20,0,20,0
1714634482117,LIIT 5BS,A00,507430,Carnelos; Chiara,20,0,20,0
1714634483142,LIIT 5CS,A00,507432,Carnelos; Chiara,20,0,20,0
1714634484169,LISP 5A,A00,507541,Munoz Sanchez; Alicia,11,0,20,9
1714634485195,LISP 5B,A00,507671,Munoz Sanchez; Alicia,8,0,20,12
1714634486223,LISP 5C,A00,507696,Munoz Sanchez; Alicia,9,0,20,11
1714634487251,MAE 197,001,528363,Boechler; Nicholas Sebastia,9998,0,9999,1
1714634488283,MATH 197,001,523477,Kedlaya; Kiran S.,9995,0,9999,4
1714634488283,MATH 197,002,563811,Zhang; Danna,9995,0,9999,4
1714634488283,MATH 197,003,628552,Dumitriu; Ioana,9998,0,9999,1
1714634489310,MCWP 40R,A00,518780,Staff,2,0,20,18
1714634489310,MCWP 40R,B00,518781,Staff,8,0,20,12
1714634489310,MCWP 40R,C00,518783,Staff,6,0,20,14
1714634490340,MCWP 50R,A00,518791,Staff,0,0,20,20
1714634490340,MCWP 50R,B00,518792,Staff,0,2,20,20
1714634490340,MCWP 50R,C00,518793,Staff,0,2,20,20
1714634490340,MCWP 50R,D00,518794,Staff,0,0,20,20
1714634490340,MCWP 50R,E00,518795,Staff,0,2,20,20
1714634490340,MCWP 50R,F00,518796,Staff,0,0,20,20
1714634490340,MCWP 50R,G00,518797,Staff,0,1,20,20
1714634491367,MMW 12R,A01,514034,Herbst; Matthew,0,0,16,16
1714634491367,MMW 12R,A02,514035,Herbst; Matthew,1,0,16,15
1714634492393,MMW 13R,A01,514037,Staff,0,4,16,16
1714634492393,MMW 13R,A02,514039,Staff,0,2,16,16
1714634492393,MMW 13R,A03,628519,Staff,0,2,16,16
1714634494447,SIO 295LS,A00,523233,Staff,10,0,30,20
1714634495475,SIO 295S,A00,523232,Staff,10,0,30,20
1714634496516,SIOC 290S,A01,637330,Merrifield; Mark A,23,0,30,7
1714634497542,SIOC 291S,A01,637333,Gabriel; Corey John,23,0,30,7
1714634498573,SOCI 117,A01,494376,Staff,0,4,5,5
1714634499598,WES 237B,A00,494380,Staff,9,0,20,11
1714634501671,AESE 279B,A00,494370,Wade; Jon P,0,0,33,33
1714634502705,AIP 197,001,627712,Vespa; Emanuel Ignacio,9998,0,9999,1
1714634503733,ANAR 135S,A00,494369,Braswell; Geoffrey E.,0,0,0,0
1714634504759,BENG 196,001,628496,Engler; Adam J.,9998,0,9999,1
1714634505786,CAT 124RS,A01,519847,Geibel; William,0,0,20,20
1714634506865,CAT 125RS,A01,515971,Geibel; William,0,0,20,20
1714634507891,CLRE 250,A00,511389,Morris; Sheldon,9993,0,9999,6
1714634508919,CLRE 251,A00,507176,Mehta; Ravindra L.,9993,0,9999,6
1714634508919,CLRE 251,B00,511410,Mehta; Ravindra L.,9998,0,9999,1
1714634509946,CLRE 252,A00,507189,Cuomo; Raphael Eduardo,9995,0,9999,4
1714634510974,CLRE 253,A00,507199,Vaida; Florin,9994,0,9999,5
1714634510974,CLRE 253,B00,507202,Vaida; Florin,9999,0,9999,0
1714634512005,CLRE 259,A00,507211,Patel; Hemal,9996,0,9999,3
1714634513033,CLRE 260,A00,507221,Cuomo; Raphael Eduardo,9999,0,9999,0
1714634514058,CLRE 297,001,507242,Cuomo; Raphael Eduardo,9999,0,9999,0
1714634515086,COGS 197,001,638244,Voytek; Bradley Thomas,9998,0,9999,1
1714634516110,CSE 191,A00,516875,Minnes Kemp; Mor Mia,9992,0,9999,7
1714634517139,CSE 197,001,637388,Minnes Kemp; Mor Mia,9998,0,9999,1
1714634518163,CSS 201S,A01,494383,Staff,35,0,35,0
1714634519188,CSS 202S,A01,494387,Staff,35,0,35,0
1714634520219,DSC 197,001,628532,Eldridge; Justin Matthew,9996,0,9999,3
1714634521243,EAP 100,A00,516065,Staff,9797,0,9999,202
1714634522270,ECE 45,A01,507414,Staff,33,0,60,27
1714634524330,ECE 111,A01,507420,Staff,15,0,50,35
1714634525355,ECE 197,001,548057,Sievenpiper; Daniel F.,9993,0,9999,6
1714634526384,EDS 115,A00,507243,Choi; Bailey Miyeon,10,0,28,18
1714634527412,EDS 117,A01,494379,Staff,0,4,30,30
1714634528442,EDS 125,A00,507246,Hopkins; Megan Beth,9,0,30,21
1714634529470,EDS 128A,A01,507264,Fargason; Sharon Gayle,8,0,26,18
1714634530500,EDS 128B,A01,507293,Pappas; Elizabeth,12,0,30,18
1714634531532,EDS 139,A00,507294,Fargason; Sharon Gayle,13,0,30,17
1714634531532,EDS 139,B00,507313,Pappas; Elizabeth,13,0,30,17
1714634532559,EDS 201,A00,507315,Staff,13,0,30,17
1714634533585,EDS 203,A01,507317,Halter; Christopher P.,12,0,30,18
1714634534612,EDS 204R,A01,507319,Halter; Christopher P.,0,3,30,30
1714634534612,EDS 204R,B01,507331,Heinzman; Erica M.,16,0,30,14
1714634535642,EDS 206R,A00,507332,Staff,0,4,30,30
1714634535642,EDS 206R,B00,507343,Staff,17,0,30,13
1714634536672,EDS 250,A00,507344,Hemans; Patricia Ann Benitez,22,0,40,18
1714634537698,EDS 281,A00,507345,Daly; Alan J.,18,0,18,0
1714634538725,EDS 284,A00,507350,Daly; Alan J.,16,0,16,0
1714634539755,EDS 286,A00,507359,Fine; Sarah,18,0,18,0
1714634540787,EDS 289C,A01,507361,Daly; Alan J.,18,0,18,0
1714634541820,EDS 290,A00,507366,Hofstetter; Carolyn,15,0,15,0
1714634542849,LIGM 5A,A00,507421,Fischer-Grunski; Eva K,18,0,20,2
1714634543881,LIGM 5B,A00,507423,Fischer-Grunski; Eva K,19,0,20,1
1714634544906,LIGM 5C,A00,507425,Fischer-Grunski; Eva K,19,0,20,1
1714634545940,LIIT 5AS,A00,507427,Carnelos; Chiara,20,0,20,0
1714634546966,LIIT 5BS,A00,507430,Carnelos; Chiara,20,0,20,0
1714634547999,LIIT 5CS,A00,507432,Carnelos; Chiara,20,0,20,0
1714634549027,LISP 5A,A00,507541,Munoz Sanchez; Alicia,11,0,20,9
1714634550053,LISP 5B,A00,507671,Munoz Sanchez; Alicia,8,0,20,12
1714634551078,LISP 5C,A00,507696,Munoz Sanchez; Alicia,9,0,20,11
1714634552106,MAE 197,001,528363,Boechler; Nicholas Sebastia,9998,0,9999,1
1714634553138,MATH 197,001,523477,Kedlaya; Kiran S.,9995,0,9999,4
1714634553138,MATH 197,002,563811,Zhang; Danna,9995,0,9999,4
1714634553138,MATH 197,003,628552,Dumitriu; Ioana,9998,0,9999,1
1714634554166,MCWP 40R,A00,518780,Staff,2,0,20,18
1714634554166,MCWP 40R,B00,518781,Staff,8,0,20,12
1714634554166,MCWP 40R,C00,518783,Staff,6,0,20,14
1714634555193,MCWP 50R,A00,518791,Staff,0,0,20,20
1714634555193,MCWP 50R,B00,518792,Staff,0,2,20,20
1714634555193,MCWP 50R,C00,518793,Staff,0,2,20,20
1714634555193,MCWP 50R,D00,518794,Staff,0,0,20,20
1714634555193,MCWP 50R,E00,518795,Staff,0,2,20,20
1714634555193,MCWP 50R,F00,518796,Staff,0,0,20,20
1714634555193,MCWP 50R,G00,518797,Staff,0,1,20,20
1714634556227,MMW 12R,A01,514034,Herbst; Matthew,0,0,16,16
1714634556227,MMW 12R,A02,514035,Herbst; Matthew,1,0,16,15
1714634557258,MMW 13R,A01,514037,Staff,0,4,16,16
1714634557258,MMW 13R,A02,514039,Staff,0,2,16,16
1714634557258,MMW 13R,A03,628519,Staff,0,2,16,16
1714634559312,SIO 295LS,A00,523233,Staff,10,0,30,20
1714634560339,SIO 295S,A00,523232,Staff,10,0,30,20
1714634561365,SIOC 290S,A01,637330,Merrifield; Mark A,23,0,30,7
1714634562404,SIOC 291S,A01,637333,Gabriel; Corey John,23,0,30,7
1714634563431,SOCI 117,A01,494376,Staff,0,4,5,5
1714634564458,WES 237B,A00,494380,Staff,9,0,20,11
1714634566540,AESE 279B,A00,494370,Wade; Jon P,0,0,33,33
1714634567568,AIP 197,001,627712,Vespa; Emanuel Ignacio,9998,0,9999,1
1714634568609,ANAR 135S,A00,494369,Braswell; Geoffrey E.,0,0,0,0
1714634569640,BENG 196,001,628496,Engler; Adam J.,9998,0,9999,1
1714634570671,CAT 124RS,A01,519847,Geibel; William,0,0,20,20
1714634571696,CAT 125RS,A01,515971,Geibel; William,0,0,20,20
1714634572720,CLRE 250,A00,511389,Morris; Sheldon,9993,0,9999,6
1714634573749,CLRE 251,A00,507176,Mehta; Ravindra L.,9993,0,9999,6
1714634573749,CLRE 251,B00,511410,Mehta; Ravindra L.,9998,0,9999,1
1714634574775,CLRE 252,A00,507189,Cuomo; Raphael Eduardo,9995,0,9999,4
1714634575946,CLRE 253,A00,507199,Vaida; Florin,9994,0,9999,5
1714634575946,CLRE 253,B00,507202,Vaida; Florin,9999,0,9999,0
1714634576973,CLRE 259,A00,507211,Patel; Hemal,9996,0,9999,3
1714634578002,CLRE 260,A00,507221,Cuomo; Raphael Eduardo,9999,0,9999,0
1714634579036,CLRE 297,001,507242,Cuomo; Raphael Eduardo,9999,0,9999,0
1714634580084,COGS 197,001,638244,Voytek; Bradley Thomas,9998,0,9999,1
1714634581116,CSE 191,A00,516875,Minnes Kemp; Mor Mia,9992,0,9999,7
1714634582154,CSE 197,001,637388,Minnes Kemp; Mor Mia,9998,0,9999,1
1714634583193,CSS 201S,A01,494383,Staff,35,0,35,0
1714634584221,CSS 202S,A01,494387,Staff,35,0,35,0
1714634585251,DSC 197,001,628532,Eldridge; Justin Matthew,9996,0,9999,3
1714634586275,EAP 100,A00,516065,Staff,9797,0,9999,202
1714634587306,ECE 45,A01,507414,Staff,33,0,60,27
1714634589362,ECE 111,A01,507420,Staff,15,0,50,35
1714634590392,ECE 197,001,548057,Sievenpiper; Daniel F.,9993,0,9999,6
1714634591419,EDS 115,A00,507243,Choi; Bailey Miyeon,10,0,28,18
1714634592447,EDS 117,A01,494379,Staff,0,4,30,30
1714634593473,EDS 125,A00,507246,Hopkins; Megan Beth,9,0,30,21
1714634594499,EDS 128A,A01,507264,Fargason; Sharon Gayle,8,0,26,18
1714634595526,EDS 128B,A01,507293,Pappas; Elizabeth,12,0,30,18
1714634596550,EDS 139,A00,507294,Fargason; Sharon Gayle,13,0,30,17
1714634596550,EDS 139,B00,507313,Pappas; Elizabeth,13,0,30,17
1714634597577,EDS 201,A00,507315,Staff,13,0,30,17
1714634598603,EDS 203,A01,507317,Halter; Christopher P.,12,0,30,18
1714634599631,EDS 204R,A01,507319,Halter; Christopher P.,0,3,30,30
1714634599631,EDS 204R,B01,507331,Heinzman; Erica M.,16,0,30,14
1714634600661,EDS 206R,A00,507332,Staff,0,4,30,30
1714634600661,EDS 206R,B00,507343,Staff,17,0,30,13
1714634601689,EDS 250,A00,507344,Hemans; Patricia Ann Benitez,22,0,40,18
1714634602720,EDS 281,A00,507345,Daly; Alan J.,18,0,18,0
1714634603749,EDS 284,A00,507350,Daly; Alan J.,16,0,16,0
1714634604773,EDS 286,A00,507359,Fine; Sarah,18,0,18,0
1714634605800,EDS 289C,A01,507361,Daly; Alan J.,18,0,18,0
1714634606832,EDS 290,A00,507366,Hofstetter; Carolyn,15,0,15,0
1714634607859,LIGM 5A,A00,507421,Fischer-Grunski; Eva K,18,0,20,2
1714634608884,LIGM 5B,A00,507423,Fischer-Grunski; Eva K,19,0,20,1
1714634609908,LIGM 5C,A00,507425,Fischer-Grunski; Eva K,19,0,20,1
1714634610937,LIIT 5AS,A00,507427,Carnelos; Chiara,20,0,20,0
1714634611967,LIIT 5BS,A00,507430,Carnelos; Chiara,20,0,20,0
1714634612996,LIIT 5CS,A00,507432,Carnelos; Chiara,20,0,20,0
1714634614023,LISP 5A,A00,507541,Munoz Sanchez; Alicia,11,0,20,9
1714634615049,LISP 5B,A00,507671,Munoz Sanchez; Alicia,8,0,20,12
1714634616079,LISP 5C,A00,507696,Munoz Sanchez; Alicia,9,0,20,11
1714634617110,MAE 197,001,528363,Boechler; Nicholas Sebastia,9998,0,9999,1
1714634618138,MATH 197,001,523477,Kedlaya; Kiran S.,9995,0,9999,4
1714634618138,MATH 197,002,563811,Zhang; Danna,9995,0,9999,4
1714634618138,MATH 197,003,628552,Dumitriu; Ioana,9998,0,9999,1
1714634619171,MCWP 40R,A00,518780,Staff,2,0,20,18
1714634619171,MCWP 40R,B00,518781,Staff,8,0,20,12
1714634619171,MCWP 40R,C00,518783,Staff,6,0,20,14
1714634620204,MCWP 50R,A00,518791,Staff,0,0,20,20
1714634620204,MCWP 50R,B00,518792,Staff,0,2,20,20
1714634620204,MCWP 50R,C00,518793,Staff,0,2,20,20
1714634620204,MCWP 50R,D00,518794,Staff,0,0,20,20
1714634620204,MCWP 50R,E00,518795,Staff,0,2,20,20
1714634620204,MCWP 50R,F00,518796,Staff,0,0,20,20
1714634620204,MCWP 50R,G00,518797,Staff,0,1,20,20
1714634621231,MMW 12R,A01,514034,Herbst; Matthew,0,0,16,16
1714634621231,MMW 12R,A02,514035,Herbst; Matthew,1,0,16,15
1714634622266,MMW 13R,A01,514037,Staff,0,4,16,16
1714634622266,MMW 13R,A02,514039,Staff,0,2,16,16
1714634622266,MMW 13R,A03,628519,Staff,0,2,16,16
1714634624330,SIO 295LS,A00,523233,Staff,10,0,30,20
1714634625357,SIO 295S,A00,523232,Staff,10,0,30,20
1714634626383,SIOC 290S,A01,637330,Merrifield; Mark A,23,0,30,7
1714634627417,SIOC 291S,A01,637333,Gabriel; Corey John,23,0,30,7
1714634628452,SOCI 117,A01,494376,Staff,0,4,5,5
1714634629477,WES 237B,A00,494380,Staff,9,0,20,11
1714634631558,AESE 279B,A00,494370,Wade; Jon P,0,0,33,33
1714634632586,AIP 197,001,627712,Vespa; Emanuel Ignacio,9998,0,9999,1
1714634633618,ANAR 135S,A00,494369,Braswell; Geoffrey E.,0,0,0,0
1714634634649,BENG 196,001,628496,Engler; Adam J.,9998,0,9999,1
1714634635677,CAT 124RS,A01,519847,Geibel; William,0,0,20,20
1714634636708,CAT 125RS,A01,515971,Geibel; William,0,0,20,20
1714634637739,CLRE 250,A00,511389,Morris; Sheldon,9993,0,9999,6
1714634638773,CLRE 251,A00,507176,Mehta; Ravindra L.,9993,0,9999,6
1714634638773,CLRE 251,B00,511410,Mehta; Ravindra L.,9998,0,9999,1
1714634639804,CLRE 252,A00,507189,Cuomo; Raphael Eduardo,9995,0,9999,4
1714634640849,CLRE 253,A00,507199,Vaida; Florin,9994,0,9999,5
1714634640849,CLRE 253,B00,507202,Vaida; Florin,9999,0,9999,0
1714634641879,CLRE 259,A00,507211,Patel; Hemal,9996,0,9999,3
1714634642909,CLRE 260,A00,507221,Cuomo; Raphael Eduardo,9999,0,9999,0
1714634643933,CLRE 297,001,507242,Cuomo; Raphael Eduardo,9999,0,9999,0
1714634644961,COGS 197,001,638244,Voytek; Bradley Thomas,9998,0,9999,1
1714634645987,CSE 191,A00,516875,Minnes Kemp; Mor Mia,9992,0,9999,7
1714634647019,CSE 197,001,637388,Minnes Kemp; Mor Mia,9998,0,9999,1
1714634648052,CSS 201S,A01,494383,Staff,35,0,35,0
1714634649078,CSS 202S,A01,494387,Staff,35,0,35,0
1714634650109,DSC 197,001,628532,Eldridge; Justin Matthew,9996,0,9999,3
1714634651137,EAP 100,A00,516065,Staff,9797,0,9999,202
1714634652163,ECE 45,A01,507414,Staff,33,0,60,27
1714634654221,ECE 111,A01,507420,Staff,15,0,50,35
1714634655247,ECE 197,001,548057,Sievenpiper; Daniel F.,9993,0,9999,6
1714634656274,EDS 115,A00,507243,Choi; Bailey Miyeon,10,0,28,18
1714634657302,EDS 117,A01,494379,Staff,0,4,30,30
1714634658328,EDS 125,A00,507246,Hopkins; Megan Beth,9,0,30,21
1714634659362,EDS 128A,A01,507264,Fargason; Sharon Gayle,8,0,26,18
1714634660389,EDS 128B,A01,507293,Pappas; Elizabeth,12,0,30,18
1714634661416,EDS 139,A00,507294,Fargason; Sharon Gayle,13,0,30,17
1714634661416,EDS 139,B00,507313,Pappas; Elizabeth,13,0,30,17
1714634662446,EDS 201,A00,507315,Staff,13,0,30,17
1714634663476,EDS 203,A01,507317,Halter; Christopher P.,12,0,30,18
1714634664502,EDS 204R,A01,507319,Halter; Christopher P.,0,3,30,30
1714634664502,EDS 204R,B01,507331,Heinzman; Erica M.,16,0,30,14
1714634665532,EDS 206R,A00,507332,Staff,0,4,30,30
1714634665532,EDS 206R,B00,507343,Staff,17,0,30,13
1714634666557,EDS 250,A00,507344,Hemans; Patricia Ann Benitez,22,0,40,18
1714634667584,EDS 281,A00,507345,Daly; Alan J.,18,0,18,0
1714634668609,EDS 284,A00,507350,Daly; Alan J.,16,0,16,0
1714634669634,EDS 286,A00,507359,Fine; Sarah,18,0,18,0
1714634670662,EDS 289C,A01,507361,Daly; Alan J.,18,0,18,0
1714634671688,EDS 290,A00,507366,Hofstetter; Carolyn,15,0,15,0
1714634672721,LIGM 5A,A00,507421,Fischer-Grunski; Eva K,18,0,20,2
1714634673745,LIGM 5B,A00,507423,Fischer-Grunski; Eva K,19,0,20,1
1714634674772,LIGM 5C,A00,507425,Fischer-Grunski; Eva K,19,0,20,1
1714634675806,LIIT 5AS,A00,507427,Carnelos; Chiara,20,0,20,0
1714634676836,LIIT 5BS,A00,507430,Carnelos; Chiara,20,0,20,0
1714634677861,LIIT 5CS,A00,507432,Carnelos; Chiara,20,0,20,0
1714634678886,LISP 5A,A00,507541,Munoz Sanchez; Alicia,11,0,20,9
1714634679912,LISP 5B,A00,507671,Munoz Sanchez; Alicia,8,0,20,12
1714634680943,LISP 5C,A00,507696,Munoz Sanchez; Alicia,9,0,20,11
1714634681971,MAE 197,001,528363,Boechler; Nicholas Sebastia,9998,0,9999,1
1714634682999,MATH 197,001,523477,Kedlaya; Kiran S.,9995,0,9999,4
1714634682999,MATH 197,002,563811,Zhang; Danna,9995,0,9999,4
1714634682999,MATH 197,003,628552,Dumitriu; Ioana,9998,0,9999,1
1714634684029,MCWP 40R,A00,518780,Staff,2,0,20,18
1714634684029,MCWP 40R,B00,518781,Staff,8,0,20,12
1714634684029,MCWP 40R,C00,518783,Staff,6,0,20,14
1714634685057,MCWP 50R,A00,518791,Staff,0,0,20,20
1714634685057,MCWP 50R,B00,518792,Staff,0,2,20,20
1714634685057,MCWP 50R,C00,518793,Staff,0,2,20,20
1714634685057,MCWP 50R,D00,518794,Staff,0,0,20,20
1714634685057,MCWP 50R,E00,518795,Staff,0,2,20,20
1714634685057,MCWP 50R,F00,518796,Staff,0,0,20,20
1714634685057,MCWP 50R,G00,518797,Staff,0,1,20,20
1714634686089,MMW 12R,A01,514034,Herbst; Matthew,0,0,16,16
1714634686089,MMW 12R,A02,514035,Herbst; Matthew,1,0,16,15
1714634687114,MMW 13R,A01,514037,Staff,0,4,16,16
1714634687114,MMW 13R,A02,514039,Staff,0,2,16,16
1714634687114,MMW 13R,A03,628519,Staff,0,2,16,16
1714634689180,SIO 295LS,A00,523233,Staff,10,0,30,20
1714634690205,SIO 295S,A00,523232,Staff,10,0,30,20
1714634691234,SIOC 290S,A01,637330,Merrifield; Mark A,23,0,30,7
1714634692260,SIOC 291S,A01,637333,Gabriel; Corey John,23,0,30,7
1714634693287,SOCI 117,A01,494376,Staff,0,4,5,5
1714634694317,WES 237B,A00,494380,Staff,9,0,20,11
1714634696397,AESE 279B,A00,494370,Wade; Jon P,0,0,33,33
1714634697426,AIP 197,001,627712,Vespa; Emanuel Ignacio,9998,0,9999,1
1714634698453,ANAR 135S,A00,494369,Braswell; Geoffrey E.,0,0,0,0
1714634699481,BENG 196,001,628496,Engler; Adam J.,9998,0,9999,1
1714634700517,CAT 124RS,A01,519847,Geibel; William,0,0,20,20
1714634701547,CAT 125RS,A01,515971,Geibel; William,0,0,20,20
1714634702573,CLRE 250,A00,511389,Morris; Sheldon,9993,0,9999,6
1714634703599,CLRE 251,A00,507176,Mehta; Ravindra L.,9993,0,9999,6
1714634703599,CLRE 251,B00,511410,Mehta; Ravindra L.,9998,0,9999,1
1714634704631,CLRE 252,A00,507189,Cuomo; Raphael Eduardo,9995,0,9999,4
1714634705658,CLRE 253,A00,507199,Vaida; Florin,9994,0,9999,5
1714634705658,CLRE 253,B00,507202,Vaida; Florin,9999,0,9999,0
1714634706684,CLRE 259,A00,507211,Patel; Hemal,9996,0,9999,3
1714634707707,CLRE 260,A00,507221,Cuomo; Raphael Eduardo,9999,0,9999,0
1714634708733,CLRE 297,001,507242,Cuomo; Raphael Eduardo,9999,0,9999,0
1714634709765,COGS 197,001,638244,Voytek; Bradley Thomas,9998,0,9999,1
1714634710790,CSE 191,A00,516875,Minnes Kemp; Mor Mia,9992,0,9999,7
1714634711816,CSE 197,001,637388,Minnes Kemp; Mor Mia,9998,0,9999,1
1714634712848,CSS 201S,A01,494383,Staff,35,0,35,0
1714634713874,CSS 202S,A01,494387,Staff,35,0,35,0
1714634714906,DSC 197,001,628532,Eldridge; Justin Matthew,9996,0,9999,3
1714634715936,EAP 100,A00,516065,Staff,9797,0,9999,202
1714634716967,ECE 45,A01,507414,Staff,33,0,60,27
1714634719021,ECE 111,A01,507420,Staff,15,0,50,35
1714634720048,ECE 197,001,548057,Sievenpiper; Daniel F.,9993,0,9999,6
1714634721075,EDS 115,A00,507243,Choi; Bailey Miyeon,10,0,28,18
1714634722102,EDS 117,A01,494379,Staff,0,4,30,30
1714634723130,EDS 125,A00,507246,Hopkins; Megan Beth,9,0,30,21
1714634724156,EDS 128A,A01,507264,Fargason; Sharon Gayle,8,0,26,18
1714634725187,EDS 128B,A01,507293,Pappas; Elizabeth,12,0,30,18
1714634726217,EDS 139,A00,507294,Fargason; Sharon Gayle,13,0,30,17
1714634726217,EDS 139,B00,507313,Pappas; Elizabeth,13,0,30,17
1714634727247,EDS 201,A00,507315,Staff,13,0,30,17
1714634728279,EDS 203,A01,507317,Halter; Christopher P.,12,0,30,18
1714634729308,EDS 204R,A01,507319,Halter; Christopher P.,0,3,30,30
1714634729308,EDS 204R,B01,507331,Heinzman; Erica M.,16,0,30,14
1714634730332,EDS 206R,A00,507332,Staff,0,4,30,30
1714634730332,EDS 206R,B00,507343,Staff,17,0,30,13
1714634731358,EDS 250,A00,507344,Hemans; Patricia Ann Benitez,22,0,40,18
1714634732386,EDS 281,A00,507345,Daly; Alan J.,18,0,18,0
1714634733412,EDS 284,A00,507350,Daly; Alan J.,16,0,16,0
1714634734439,EDS 286,A00,507359,Fine; Sarah,18,0,18,0
1714634735465,EDS 289C,A01,507361,Daly; Alan J.,18,0,18,0
1714634736497,EDS 290,A00,507366,Hofstetter; Carolyn,15,0,15,0
1714634737524,LIGM 5A,A00,507421,Fischer-Grunski; Eva K,18,0,20,2
1714634738557,LIGM 5B,A00,507423,Fischer-Grunski; Eva K,19,0,20,1
1714634739591,LIGM 5C,A00,507425,Fischer-Grunski; Eva K,19,0,20,1
1714634740624,LIIT 5AS,A00,507427,Carnelos; Chiara,20,0,20,0
1714634741650,LIIT 5BS,A00,507430,Carnelos; Chiara,20,0,20,0
1714634742682,LIIT 5CS,A00,507432,Carnelos; Chiara,20,0,20,0
1714634743708,LISP 5A,A00,507541,Munoz Sanchez; Alicia,11,0,20,9
1714634744742,LISP 5B,A00,507671,Munoz Sanchez; Alicia,8,0,20,12
1714634745767,LISP 5C,A00,507696,Munoz Sanchez; Alicia,9,0,20,11
1714634746794,MAE 197,001,528363,Boechler; Nicholas Sebastia,9998,0,9999,1
1714634747822,MATH 197,001,523477,Kedlaya; Kiran S.,9995,0,9999,4
1714634747822,MATH 197,002,563811,Zhang; Danna,9995,0,9999,4
1714634747822,MATH 197,003,628552,Dumitriu; Ioana,9998,0,9999,1
1714634748856,MCWP 40R,A00,518780,Staff,2,0,20,18
1714634748856,MCWP 40R,B00,518781,Staff,8,0,20,12
1714634748856,MCWP 40R,C00,518783,Staff,6,0,20,14
1714634749953,MCWP 50R,A00,518791,Staff,0,0,20,20
1714634749953,MCWP 50R,B00,518792,Staff,0,2,20,20
1714634749953,MCWP 50R,C00,518793,Staff,0,2,20,20
1714634749953,MCWP 50R,D00,518794,Staff,0,0,20,20
1714634749953,MCWP 50R,E00,518795,Staff,0,2,20,20
1714634749953,MCWP 50R,F00,518796,Staff,0,0,20,20
1714634749953,MCWP 50R,G00,518797,Staff,0,1,20,20
1714634750978,MMW 12R,A01,514034,Herbst; Matthew,0,0,16,16
1714634750978,MMW 12R,A02,514035,Herbst; Matthew,1,0,16,15
1714634752003,MMW 13R,A01,514037,Staff,0,4,16,16
1714634752003,MMW 13R,A02,514039,Staff,0,2,16,16
1714634752003,MMW 13R,A03,628519,Staff,0,2,16,16
1714634754056,SIO 295LS,A00,523233,Staff,10,0,30,20
1714634755080,SIO 295S,A00,523232,Staff,10,0,30,20
1714634756108,SIOC 290S,A01,637330,Merrifield; Mark A,23,0,30,7
1714634757135,SIOC 291S,A01,637333,Gabriel; Corey John,23,0,30,7
1714634758165,SOCI 117,A01,494376,Staff,0,4,5,5
1714634759192,WES 237B,A00,494380,Staff,9,0,20,11
1714634761266,AESE 279B,A00,494370,Wade; Jon P,0,0,33,33
1714634762293,AIP 197,001,627712,Vespa; Emanuel Ignacio,9998,0,9999,1
1714634763321,ANAR 135S,A00,494369,Braswell; Geoffrey E.,0,0,0,0
1714634764349,BENG 196,001,628496,Engler; Adam J.,9998,0,9999,1
1714634765381,CAT 124RS,A01,519847,Geibel; William,0,0,20,20
1714634766408,CAT 125RS,A01,515971,Geibel; William,0,0,20,20
1714634767437,CLRE 250,A00,511389,Morris; Sheldon,9993,0,9999,6
1714634768465,CLRE 251,A00,507176,Mehta; Ravindra L.,9993,0,9999,6
1714634768465,CLRE 251,B00,511410,Mehta; Ravindra L.,9998,0,9999,1
1714634769494,CLRE 252,A00,507189,Cuomo; Raphael Eduardo,9995,0,9999,4
1714634770528,CLRE 253,A00,507199,Vaida; Florin,9994,0,9999,5
1714634770528,CLRE 253,B00,507202,Vaida; Florin,9999,0,9999,0
1714634771561,CLRE 259,A00,507211,Patel; Hemal,9996,0,9999,3
1714634772595,CLRE 260,A00,507221,Cuomo; Raphael Eduardo,9999,0,9999,0
1714634773622,CLRE 297,001,507242,Cuomo; Raphael Eduardo,9999,0,9999,0
1714634774647,COGS 197,001,638244,Voytek; Bradley Thomas,9998,0,9999,1
1714634775674,CSE 191,A00,516875,Minnes Kemp; Mor Mia,9992,0,9999,7
1714634776697,CSE 197,001,637388,Minnes Kemp; Mor Mia,9998,0,9999,1
1714634777724,CSS 201S,A01,494383,Staff,35,0,35,0
1714634778754,CSS 202S,A01,494387,Staff,35,0,35,0
1714634779781,DSC 197,001,628532,Eldridge; Justin Matthew,9996,0,9999,3
1714634780807,EAP 100,A00,516065,Staff,9797,0,9999,202
1714634781836,ECE 45,A01,507414,Staff,33,0,60,27
1714634783890,ECE 111,A01,507420,Staff,15,0,50,35
1714634784916,ECE 197,001,548057,Sievenpiper; Daniel F.,9993,0,9999,6
1714634785949,EDS 115,A00,507243,Choi; Bailey Miyeon,10,0,28,18
1714634786980,EDS 117,A01,494379,Staff,0,4,30,30
1714634788013,EDS 125,A00,507246,Hopkins; Megan Beth,9,0,30,21
1714634789045,EDS 128A,A01,507264,Fargason; Sharon Gayle,8,0,26,18
1714634790074,EDS 128B,A01,507293,Pappas; Elizabeth,12,0,30,18
1714634791105,EDS 139,A00,507294,Fargason; Sharon Gayle,13,0,30,17
1714634791105,EDS 139,B00,507313,Pappas; Elizabeth,13,0,30,17
1714634792134,EDS 201,A00,507315,Staff,13,0,30,17
1714634793162,EDS 203,A01,507317,Halter; Christopher P.,12,0,30,18
1714634794189,EDS 204R,A01,507319,Halter; Christopher P.,0,3,30,30
1714634794189,EDS 204R,B01,507331,Heinzman; Erica M.,16,0,30,14
1714634795221,EDS 206R,A00,507332,Staff,0,4,30,30
1714634795221,EDS 206R,B00,507343,Staff,17,0,30,13
1714634796256,EDS 250,A00,507344,Hemans; Patricia Ann Benitez,22,0,40,18
1714634797284,EDS 281,A00,507345,Daly; Alan J.,18,0,18,0
1714634798317,EDS 284,A00,507350,Daly; Alan J.,16,0,16,0
1714634799343,EDS 286,A00,507359,Fine; Sarah,18,0,18,0
1714634800370,EDS 289C,A01,507361,Daly; Alan J.,18,0,18,0
1714634801400,EDS 290,A00,507366,Hofstetter; Carolyn,15,0,15,0
1714634802426,LIGM 5A,A00,507421,Fischer-Grunski; Eva K,18,0,20,2
1714634803450,LIGM 5B,A00,507423,Fischer-Grunski; Eva K,19,0,20,1
1714634804484,LIGM 5C,A00,507425,Fischer-Grunski; Eva K,19,0,20,1
1714634805511,LIIT 5AS,A00,507427,Carnelos; Chiara,20,0,20,0
1714634806537,LIIT 5BS,A00,507430,Carnelos; Chiara,20,0,20,0
1714634807563,LIIT 5CS,A00,507432,Carnelos; Chiara,20,0,20,0
1714634808590,LISP 5A,A00,507541,Munoz Sanchez; Alicia,11,0,20,9
1714634809617,LISP 5B,A00,507671,Munoz Sanchez; Alicia,8,0,20,12
1714634810649,LISP 5C,A00,507696,Munoz Sanchez; Alicia,9,0,20,11
1714634811676,MAE 197,001,528363,Boechler; Nicholas Sebastia,9998,0,9999,1
1714634812704,MATH 197,001,523477,Kedlaya; Kiran S.,9995,0,9999,4
1714634812704,MATH 197,002,563811,Zhang; Danna,9995,0,9999,4
1714634812704,MATH 197,003,628552,Dumitriu; Ioana,9998,0,9999,1
1714634813739,MCWP 40R,A00,518780,Staff,2,0,20,18
1714634813739,MCWP 40R,B00,518781,Staff,8,0,20,12
1714634813739,MCWP 40R,C00,518783,Staff,6,0,20,14
1714634814763,MCWP 50R,A00,518791,Staff,0,0,20,20
1714634814763,MCWP 50R,B00,518792,Staff,0,2,20,20
1714634814763,MCWP 50R,C00,518793,Staff,0,2,20,20
1714634814763,MCWP 50R,D00,518794,Staff,0,0,20,20
1714634814763,MCWP 50R,E00,518795,Staff,0,2,20,20
1714634814763,MCWP 50R,F00,518796,Staff,0,0,20,20
1714634814763,MCWP 50R,G00,518797,Staff,0,1,20,20
1714634815790,MMW 12R,A01,514034,Herbst; Matthew,0,0,16,16
1714634815790,MMW 12R,A02,514035,Herbst; Matthew,1,0,16,15
1714634816817,MMW 13R,A01,514037,Staff,0,4,16,16
1714634816817,MMW 13R,A02,514039,Staff,0,2,16,16
1714634816817,MMW 13R,A03,628519,Staff,0,2,16,16
1714634818870,SIO 295LS,A00,523233,Staff,10,0,30,20
1714634819900,SIO 295S,A00,523232,Staff,10,0,30,20
1714634820929,SIOC 290S,A01,637330,Merrifield; Mark A,23,0,30,7
1714634821963,SIOC 291S,A01,637333,Gabriel; Corey John,23,0,30,7
1714634822991,SOCI 117,A01,494376,Staff,0,4,5,5
1714634824018,WES 237B,A00,494380,Staff,9,0,20,11
1714634826093,AESE 279B,A00,494370,Wade; Jon P,0,0,33,33
1714634827123,AIP 197,001,627712,Vespa; Emanuel Ignacio,9998,0,9999,1
1714634828154,ANAR 135S,A00,494369,Braswell; Geoffrey E.,0,0,0,0
1714634829181,BENG 196,001,628496,Engler; Adam J.,9998,0,9999,1
1714634830212,CAT 124RS,A01,519847,Geibel; William,0,0,20,20
1714634831243,CAT 125RS,A01,515971,Geibel; William,0,0,20,20
1714634832269,CLRE 250,A00,511389,Morris; Sheldon,9993,0,9999,6
1714634833299,CLRE 251,A00,507176,Mehta; Ravindra L.,9993,0,9999,6
1714634833299,CLRE 251,B00,511410,Mehta; Ravindra L.,9998,0,9999,1
1714634834327,CLRE 252,A00,507189,Cuomo; Raphael Eduardo,9995,0,9999,4
1714634835356,CLRE 253,A00,507199,Vaida; Florin,9994,0,9999,5
1714634835356,CLRE 253,B00,507202,Vaida; Florin,9999,0,9999,0
1714634836384,CLRE 259,A00,507211,Patel; Hemal,9996,0,9999,3
1714634837409,CLRE 260,A00,507221,Cuomo; Raphael Eduardo,9999,0,9999,0
1714634838434,CLRE 297,001,507242,Cuomo; Raphael Eduardo,9999,0,9999,0
1714634839461,COGS 197,001,638244,Voytek; Bradley Thomas,9998,0,9999,1
1714634840488,CSE 191,A00,516875,Minnes Kemp; Mor Mia,9992,0,9999,7
1714634841517,CSE 197,001,637388,Minnes Kemp; Mor Mia,9998,0,9999,1
1714634842551,CSS 201S,A01,494383,Staff,35,0,35,0
1714634843586,CSS 202S,A01,494387,Staff,35,0,35,0
1714634844616,DSC 197,001,628532,Eldridge; Justin Matthew,9996,0,9999,3
1714634845642,EAP 100,A00,516065,Staff,9797,0,9999,202
1714634846672,ECE 45,A01,507414,Staff,33,0,60,27
1714634848721,ECE 111,A01,507420,Staff,15,0,50,35
1714634849753,ECE 197,001,548057,Sievenpiper; Daniel F.,9993,0,9999,6
1714634850780,EDS 115,A00,507243,Choi; Bailey Miyeon,10,0,28,18
1714634851811,EDS 117,A01,494379,Staff,0,4,30,30
1714634852837,EDS 125,A00,507246,Hopkins; Megan Beth,9,0,30,21
1714634853870,EDS 128A,A01,507264,Fargason; Sharon Gayle,8,0,26,18
1714634854903,EDS 128B,A01,507293,Pappas; Elizabeth,12,0,30,18
1714634855929,EDS 139,A00,507294,Fargason; Sharon Gayle,13,0,30,17
1714634855929,EDS 139,B00,507313,Pappas; Elizabeth,13,0,30,17
1714634856956,EDS 201,A00,507315,Staff,13,0,30,17
1714634857982,EDS 203,A01,507317,Halter; Christopher P.,12,0,30,18
1714634859010,EDS 204R,A01,507319,Halter; Christopher P.,0,3,30,30
1714634859010,EDS 204R,B01,507331,Heinzman; Erica M.,16,0,30,14
1714634860035,EDS 206R,A00,507332,Staff,0,4,30,30
1714634860035,EDS 206R,B00,507343,Staff,17,0,30,13
1714634861062,EDS 250,A00,507344,Hemans; Patricia Ann Benitez,22,0,40,18
1714634862089,EDS 281,A00,507345,Daly; Alan J.,18,0,18,0
1714634863113,EDS 284,A00,507350,Daly; Alan J.,16,0,16,0
1714634864138,EDS 286,A00,507359,Fine; Sarah,18,0,18,0
1714634865164,EDS 289C,A01,507361,Daly; Alan J.,18,0,18,0
1714634866190,EDS 290,A00,507366,Hofstetter; Carolyn,15,0,15,0
1714634867224,LIGM 5A,A00,507421,Fischer-Grunski; Eva K,18,0,20,2
1714634868255,LIGM 5B,A00,507423,Fischer-Grunski; Eva K,19,0,20,1
1714634869285,LIGM 5C,A00,507425,Fischer-Grunski; Eva K,19,0,20,1
1714634870312,LIIT 5AS,A00,507427,Carnelos; Chiara,20,0,20,0
1714634871344,LIIT 5BS,A00,507430,Carnelos; Chiara,20,0,20,0
1714634872369,LIIT 5CS,A00,507432,Carnelos; Chiara,20,0,20,0
1714634873405,LISP 5A,A00,507541,Munoz Sanchez; Alicia,11,0,20,9
1714634874440,LISP 5B,A00,507671,Munoz Sanchez; Alicia,8,0,20,12
1714634875467,LISP 5C,A00,507696,Munoz Sanchez; Alicia,9,0,20,11
1714634876494,MAE 197,001,528363,Boechler; Nicholas Sebastia,9998,0,9999,1
1714634877524,MATH 197,001,523477,Kedlaya; Kiran S.,9995,0,9999,4
1714634877524,MATH 197,002,563811,Zhang; Danna,9995,0,9999,4
1714634877524,MATH 197,003,628552,Dumitriu; Ioana,9998,0,9999,1
1714634878552,MCWP 40R,A00,518780,Staff,2,0,20,18
1714634878552,MCWP 40R,B00,518781,Staff,8,0,20,12
1714634878552,MCWP 40R,C00,518783,Staff,6,0,20,14
1714634879586,MCWP 50R,A00,518791,Staff,0,0,20,20
1714634879586,MCWP 50R,B00,518792,Staff,0,2,20,20
1714634879586,MCWP 50R,C00,518793,Staff,0,2,20,20
1714634879586,MCWP 50R,D00,518794,Staff,0,0,20,20
1714634879586,MCWP 50R,E00,518795,Staff,0,2,20,20
1714634879586,MCWP 50R,F00,518796,Staff,0,0,20,20
1714634879586,MCWP 50R,G00,518797,Staff,0,1,20,20
1714634880612,MMW 12R,A01,514034,Herbst; Matthew,0,0,16,16
1714634880612,MMW 12R,A02,514035,Herbst; Matthew,1,0,16,15
1714634881637,MMW 13R,A01,514037,Staff,0,4,16,16
1714634881637,MMW 13R,A02,514039,Staff,0,2,16,16
1714634881637,MMW 13R,A03,628519,Staff,0,2,16,16
1714634883693,SIO 295LS,A00,523233,Staff,10,0,30,20
1714634884723,SIO 295S,A00,523232,Staff,10,0,30,20
1714634885756,SIOC 290S,A01,637330,Merrifield; Mark A,23,0,30,7
1714634886783,SIOC 291S,A01,637333,Gabriel; Corey John,23,0,30,7
1714634887810,SOCI 117,A01,494376,Staff,0,4,5,5
1714634888841,WES 237B,A00,494380,Staff,9,0,20,11
1714634890937,AESE 279B,A00,494370,Wade; Jon P,0,0,33,33
1714634891963,AIP 197,001,627712,Vespa; Emanuel Ignacio,9998,0,9999,1
1714634892996,ANAR 135S,A00,494369,Braswell; Geoffrey E.,0,0,0,0
1714634894028,BENG 196,001,628496,Engler; Adam J.,9998,0,9999,1
1714634895056,CAT 124RS,A01,519847,Geibel; William,0,0,20,20
1714634896083,CAT 125RS,A01,515971,Geibel; William,0,0,20,20
1714634897109,CLRE 250,A00,511389,Morris; Sheldon,9993,0,9999,6
1714634898145,CLRE 251,A00,507176,Mehta; Ravindra L.,9993,0,9999,6
1714634898145,CLRE 251,B00,511410,Mehta; Ravindra L.,9998,0,9999,1
1714634899181,CLRE 252,A00,507189,Cuomo; Raphael Eduardo,9995,0,9999,4
1714634900213,CLRE 253,A00,507199,Vaida; Florin,9994,0,9999,5
1714634900213,CLRE 253,B00,507202,Vaida; Florin,9999,0,9999,0
1714634901240,CLRE 259,A00,507211,Patel; Hemal,9996,0,9999,3
1714634902272,CLRE 260,A00,507221,Cuomo; Raphael Eduardo,9999,0,9999,0
1714634903316,CLRE 297,001,507242,Cuomo; Raphael Eduardo,9999,0,9999,0
1714634904353,COGS 197,001,638244,Voytek; Bradley Thomas,9998,0,9999,1
1714634905379,CSE 191,A00,516875,Minnes Kemp; Mor Mia,9992,0,9999,7
1714634906406,CSE 197,001,637388,Minnes Kemp; Mor Mia,9998,0,9999,1
1714634907431,CSS 201S,A01,494383,Staff,35,0,35,0
1714634908496,CSS 202S,A01,494387,Staff,35,0,35,0
1714634909526,DSC 197,001,628532,Eldridge; Justin Matthew,9996,0,9999,3
1714634910550,EAP 100,A00,516065,Staff,9797,0,9999,202
1714634911578,ECE 45,A01,507414,Staff,33,0,60,27
1714634913628,ECE 111,A01,507420,Staff,15,0,50,35
1714634914659,ECE 197,001,548057,Sievenpiper; Daniel F.,9993,0,9999,6
1714634915695,EDS 115,A00,507243,Choi; Bailey Miyeon,10,0,28,18
1714634916722,EDS 117,A01,494379,Staff,0,4,30,30
1714634917754,EDS 125,A00,507246,Hopkins; Megan Beth,9,0,30,21
1714634918782,EDS 128A,A01,507264,Fargason; Sharon Gayle,8,0,26,18
1714634919812,EDS 128B,A01,507293,Pappas; Elizabeth,12,0,30,18
1714634920839,EDS 139,A00,507294,Fargason; Sharon Gayle,13,0,30,17
1714634920839,EDS 139,B00,507313,Pappas; Elizabeth,13,0,30,17
1714634921867,EDS 201,A00,507315,Staff,13,0,30,17
1714634922895,EDS 203,A01,507317,Halter; Christopher P.,12,0,30,18
1714634923931,EDS 204R,A01,507319,Halter; Christopher P.,0,3,30,30
1714634923931,EDS 204R,B01,507331,Heinzman; Erica M.,16,0,30,14
1714634924959,EDS 206R,A00,507332,Staff,0,4,30,30
1714634924959,EDS 206R,B00,507343,Staff,17,0,30,13
1714634925991,EDS 250,A00,507344,Hemans; Patricia Ann Benitez,22,0,40,18
1714634927026,EDS 281,A00,507345,Daly; Alan J.,18,0,18,0
1714634928056,EDS 284,A00,507350,Daly; Alan J.,16,0,16,0
1714634929085,EDS 286,A00,507359,Fine; Sarah,18,0,18,0
1714634930111,EDS 289C,A01,507361,Daly; Alan J.,18,0,18,0
1714634931144,EDS 290,A00,507366,Hofstetter; Carolyn,15,0,15,0
1714634932171,LIGM 5A,A00,507421,Fischer-Grunski; Eva K,18,0,20,2
1714634933199,LIGM 5B,A00,507423,Fischer-Grunski; Eva K,19,0,20,1
1714634934228,LIGM 5C,A00,507425,Fischer-Grunski; Eva K,19,0,20,1
1714634935259,LIIT 5AS,A00,507427,Carnelos; Chiara,20,0,20,0
1714634936287,LIIT 5BS,A00,507430,Carnelos; Chiara,20,0,20,0
1714634937313,LIIT 5CS,A00,507432,Carnelos; Chiara,20,0,20,0
1714634938340,LISP 5A,A00,507541,Munoz Sanchez; Alicia,11,0,20,9
1714634939365,LISP 5B,A00,507671,Munoz Sanchez; Alicia,8,0,20,12
1714634940408,LISP 5C,A00,507696,Munoz Sanchez; Alicia,9,0,20,11
1714634941435,MAE 197,001,528363,Boechler; Nicholas Sebastia,9998,0,9999,1
1714634942472,MATH 197,001,523477,Kedlaya; Kiran S.,9995,0,9999,4
1714634942472,MATH 197,002,563811,Zhang; Danna,9995,0,9999,4
1714634942472,MATH 197,003,628552,Dumitriu; Ioana,9998,0,9999,1
1714634943500,MCWP 40R,A00,518780,Staff,2,0,20,18
1714634943500,MCWP 40R,B00,518781,Staff,8,0,20,12
1714634943500,MCWP 40R,C00,518783,Staff,6,0,20,14
1714634944525,MCWP 50R,A00,518791,Staff,0,0,20,20
1714634944525,MCWP 50R,B00,518792,Staff,0,2,20,20
1714634944525,MCWP 50R,C00,518793,Staff,0,2,20,20
1714634944525,MCWP 50R,D00,518794,Staff,0,0,20,20
1714634944525,MCWP 50R,E00,518795,Staff,0,2,20,20
1714634944525,MCWP 50R,F00,518796,Staff,0,0,20,20
1714634944525,MCWP 50R,G00,518797,Staff,0,1,20,20
1714634945558,MMW 12R,A01,514034,Herbst; Matthew,0,0,16,16
1714634945558,MMW 12R,A02,514035,Herbst; Matthew,1,0,16,15
1714634946585,MMW 13R,A01,514037,Staff,0,4,16,16
1714634946585,MMW 13R,A02,514039,Staff,0,2,16,16
1714634946585,MMW 13R,A03,628519,Staff,0,2,16,16
1714634948640,SIO 295LS,A00,523233,Staff,10,0,30,20
1714634949666,SIO 295S,A00,523232,Staff,10,0,30,20
1714634950693,SIOC 290S,A01,637330,Merrifield; Mark A,23,0,30,7
1714634951720,SIOC 291S,A01,637333,Gabriel; Corey John,23,0,30,7
1714634952745,SOCI 117,A01,494376,Staff,0,4,5,5
1714634953773,WES 237B,A00,494380,Staff,9,0,20,11
1714634955858,AESE 279B,A00,494370,Wade; Jon P,0,0,33,33
1714634956884,AIP 197,001,627712,Vespa; Emanuel Ignacio,9998,0,9999,1
1714634957910,ANAR 135S,A00,494369,Braswell; Geoffrey E.,0,0,0,0
1714634958940,BENG 196,001,628496,Engler; Adam J.,9998,0,9999,1
1714634959966,CAT 124RS,A01,519847,Geibel; William,0,0,20,20
1714634960998,CAT 125RS,A01,515971,Geibel; William,0,0,20,20
1714634962032,CLRE 250,A00,511389,Morris; Sheldon,9993,0,9999,6
1714634963059,CLRE 251,A00,507176,Mehta; Ravindra L.,9993,0,9999,6
1714634963059,CLRE 251,B00,511410,Mehta; Ravindra L.,9998,0,9999,1
1714634964084,CLRE 252,A00,507189,Cuomo; Raphael Eduardo,9995,0,9999,4
1714634965111,CLRE 253,A00,507199,Vaida; Florin,9994,0,9999,5
1714634965111,CLRE 253,B00,507202,Vaida; Florin,9999,0,9999,0
1714634966161,CLRE 259,A00,507211,Patel; Hemal,9996,0,9999,3
1714634967189,CLRE 260,A00,507221,Cuomo; Raphael Eduardo,9999,0,9999,0
1714634968213,CLRE 297,001,507242,Cuomo; Raphael Eduardo,9999,0,9999,0
1714634969241,COGS 197,001,638244,Voytek; Bradley Thomas,9998,0,9999,1
1714634970277,CSE 191,A00,516875,Minnes Kemp; Mor Mia,9992,0,9999,7
1714634971302,CSE 197,001,637388,Minnes Kemp; Mor Mia,9998,0,9999,1
1714634972333,CSS 201S,A01,494383,Staff,35,0,35,0
1714634973359,CSS 202S,A01,494387,Staff,35,0,35,0
1714634974385,DSC 197,001,628532,Eldridge; Justin Matthew,9996,0,9999,3
1714634975412,EAP 100,A00,516065,Staff,9797,0,9999,202
1714634976438,ECE 45,A01,507414,Staff,33,0,60,27
1714634978488,ECE 111,A01,507420,Staff,15,0,50,35
1714634979516,ECE 197,001,548057,Sievenpiper; Daniel F.,9993,0,9999,6
1714634980545,EDS 115,A00,507243,Choi; Bailey Miyeon,10,0,28,18
1714634981572,EDS 117,A01,494379,Staff,0,4,30,30
1714634982602,EDS 125,A00,507246,Hopkins; Megan Beth,9,0,30,21
1714634983628,EDS 128A,A01,507264,Fargason; Sharon Gayle,8,0,26,18
1714634984654,EDS 128B,A01,507293,Pappas; Elizabeth,12,0,30,18
1714634985680,EDS 139,A00,507294,Fargason; Sharon Gayle,13,0,30,17
1714634985680,EDS 139,B00,507313,Pappas; Elizabeth,13,0,30,17
1714634986709,EDS 201,A00,507315,Staff,13,0,30,17
1714634987734,EDS 203,A01,507317,Halter; Christopher P.,12,0,30,18
1714634988787,EDS 204R,A01,507319,Halter; Christopher P.,0,3,30,30
1714634988787,EDS 204R,B01,507331,Heinzman; Erica M.,16,0,30,14
1714634989816,EDS 206R,A00,507332,Staff,0,4,30,30
1714634989816,EDS 206R,B00,507343,Staff,17,0,30,13
1714634990843,EDS 250,A00,507344,Hemans; Patricia Ann Benitez,22,0,40,18
1714634991870,EDS 281,A00,507345,Daly; Alan J.,18,0,18,0
1714634992899,EDS 284,A00,507350,Daly; Alan J.,16,0,16,0
1714634993930,EDS 286,A00,507359,Fine; Sarah,18,0,18,0
1714634994956,EDS 289C,A01,507361,Daly; Alan J.,18,0,18,0
1714634995981,EDS 290,A00,507366,Hofstetter; Carolyn,15,0,15,0
1714634997008,LIGM 5A,A00,507421,Fischer-Grunski; Eva K,18,0,20,2
1714634998037,LIGM 5B,A00,507423,Fischer-Grunski; Eva K,19,0,20,1
1714634999069,LIGM 5C,A00,507425,Fischer-Grunski; Eva K,19,0,20,1
1714635000095,LIIT 5AS,A00,507427,Carnelos; Chiara,20,0,20,0
1714635001124,LIIT 5BS,A00,507430,Carnelos; Chiara,20,0,20,0
1714635002153,LIIT 5CS,A00,507432,Carnelos; Chiara,20,0,20,0
1714635003179,LISP 5A,A00,507541,Munoz Sanchez; Alicia,11,0,20,9
1714635004204,LISP 5B,A00,507671,Munoz Sanchez; Alicia,8,0,20,12
1714635005230,LISP 5C,A00,507696,Munoz Sanchez; Alicia,9,0,20,11
1714635006259,MAE 197,001,528363,Boechler; Nicholas Sebastia,9998,0,9999,1
1714635007298,MATH 197,001,523477,Kedlaya; Kiran S.,9995,0,9999,4
1714635007298,MATH 197,002,563811,Zhang; Danna,9995,0,9999,4
1714635007298,MATH 197,003,628552,Dumitriu; Ioana,9998,0,9999,1
1714635008330,MCWP 40R,A00,518780,Staff,2,0,20,18
1714635008330,MCWP 40R,B00,518781,Staff,8,0,20,12
1714635008330,MCWP 40R,C00,518783,Staff,6,0,20,14
1714635009362,MCWP 50R,A00,518791,Staff,0,0,20,20
1714635009362,MCWP 50R,B00,518792,Staff,0,2,20,20
1714635009362,MCWP 50R,C00,518793,Staff,0,2,20,20
1714635009362,MCWP 50R,D00,518794,Staff,0,0,20,20
1714635009362,MCWP 50R,E00,518795,Staff,0,2,20,20
1714635009362,MCWP 50R,F00,518796,Staff,0,0,20,20
1714635009362,MCWP 50R,G00,518797,Staff,0,1,20,20
1714635010389,MMW 12R,A01,514034,Herbst; Matthew,0,0,16,16
1714635010389,MMW 12R,A02,514035,Herbst; Matthew,1,0,16,15
1714635011421,MMW 13R,A01,514037,Staff,0,4,16,16
1714635011421,MMW 13R,A02,514039,Staff,0,2,16,16
1714635011421,MMW 13R,A03,628519,Staff,0,2,16,16
1714635013479,SIO 295LS,A00,523233,Staff,10,0,30,20
1714635014504,SIO 295S,A00,523232,Staff,10,0,30,20
1714635015538,SIOC 290S,A01,637330,Merrifield; Mark A,23,0,30,7
1714635016565,SIOC 291S,A01,637333,Gabriel; Corey John,23,0,30,7
1714635017592,SOCI 117,A01,494376,Staff,0,4,5,5
1714635018617,WES 237B,A00,494380,Staff,9,0,20,11
1714635020697,AESE 279B,A00,494370,Wade; Jon P,0,0,33,33
1714635021727,AIP 197,001,627712,Vespa; Emanuel Ignacio,9998,0,9999,1
1714635022757,ANAR 135S,A00,494369,Braswell; Geoffrey E.,0,0,0,0
1714635023786,BENG 196,001,628496,Engler; Adam J.,9998,0,9999,1
1714635024811,CAT 124RS,A01,519847,Geibel; William,0,0,20,20
1714635025840,CAT 125RS,A01,515971,Geibel; William,0,0,20,20
1714635026873,CLRE 250,A00,511389,Morris; Sheldon,9993,0,9999,6
1714635027902,CLRE 251,A00,507176,Mehta; Ravindra L.,9993,0,9999,6
1714635027902,CLRE 251,B00,511410,Mehta; Ravindra L.,9998,0,9999,1
1714635028928,CLRE 252,A00,507189,Cuomo; Raphael Eduardo,9995,0,9999,4
1714635029958,CLRE 253,A00,507199,Vaida; Florin,9994,0,9999,5
1714635029958,CLRE 253,B00,507202,Vaida; Florin,9999,0,9999,0
1714635030985,CLRE 259,A00,507211,Patel; Hemal,9996,0,9999,3
1714635032009,CLRE 260,A00,507221,Cuomo; Raphael Eduardo,9999,0,9999,0
1714635033035,CLRE 297,001,507242,Cuomo; Raphael Eduardo,9999,0,9999,0
1714635034060,COGS 197,001,638244,Voytek; Bradley Thomas,9998,0,9999,1
1714635035085,CSE 191,A00,516875,Minnes Kemp; Mor Mia,9992,0,9999,7
1714635036113,CSE 197,001,637388,Minnes Kemp; Mor Mia,9998,0,9999,1
1714635037140,CSS 201S,A01,494383,Staff,35,0,35,0
1714635038166,CSS 202S,A01,494387,Staff,35,0,35,0
1714635039193,DSC 197,001,628532,Eldridge; Justin Matthew,9996,0,9999,3
1714635040220,EAP 100,A00,516065,Staff,9797,0,9999,202
1714635041249,ECE 45,A01,507414,Staff,33,0,60,27
1714635043300,ECE 111,A01,507420,Staff,15,0,50,35
1714635044329,ECE 197,001,548057,Sievenpiper; Daniel F.,9993,0,9999,6
1714635045354,EDS 115,A00,507243,Choi; Bailey Miyeon,10,0,28,18
1714635046380,EDS 117,A01,494379,Staff,0,4,30,30
1714635047409,EDS 125,A00,507246,Hopkins; Megan Beth,9,0,30,21
1714635048435,EDS 128A,A01,507264,Fargason; Sharon Gayle,8,0,26,18
1714635049460,EDS 128B,A01,507293,Pappas; Elizabeth,12,0,30,18
1714635050488,EDS 139,A00,507294,Fargason; Sharon Gayle,13,0,30,17
1714635050488,EDS 139,B00,507313,Pappas; Elizabeth,13,0,30,17
1714635051516,EDS 201,A00,507315,Staff,13,0,30,17
1714635052542,EDS 203,A01,507317,Halter; Christopher P.,12,0,30,18
1714635053569,EDS 204R,A01,507319,Halter; Christopher P.,0,3,30,30
1714635053569,EDS 204R,B01,507331,Heinzman; Erica M.,16,0,30,14
1714635054595,EDS 206R,A00,507332,Staff,0,4,30,30
1714635054595,EDS 206R,B00,507343,Staff,17,0,30,13
1714635055619,EDS 250,A00,507344,Hemans; Patricia Ann Benitez,22,0,40,18
1714635056648,EDS 281,A00,507345,Daly; Alan J.,18,0,18,0
1714635057673,EDS 284,A00,507350,Daly; Alan J.,16,0,16,0
1714635058705,EDS 286,A00,507359,Fine; Sarah,18,0,18,0
1714635059732,EDS 289C,A01,507361,Daly; Alan J.,18,0,18,0
1714635060764,EDS 290,A00,507366,Hofstetter; Carolyn,15,0,15,0
1714635061796,LIGM 5A,A00,507421,Fischer-Grunski; Eva K,18,0,20,2
1714635062821,LIGM 5B,A00,507423,Fischer-Grunski; Eva K,19,0,20,1
1714635063846,LIGM 5C,A00,507425,Fischer-Grunski; Eva K,19,0,20,1
1714635064877,LIIT 5AS,A00,507427,Carnelos; Chiara,20,0,20,0
1714635065903,LIIT 5BS,A00,507430,Carnelos; Chiara,20,0,20,0
1714635066930,LIIT 5CS,A00,507432,Carnelos; Chiara,20,0,20,0
1714635067957,LISP 5A,A00,507541,Munoz Sanchez; Alicia,11,0,20,9
1714635068989,LISP 5B,A00,507671,Munoz Sanchez; Alicia,8,0,20,12
1714635070017,LISP 5C,A00,507696,Munoz Sanchez; Alicia,9,0,20,11
1714635071047,MAE 197,001,528363,Boechler; Nicholas Sebastia,9998,0,9999,1
1714635072084,MATH 197,001,523477,Kedlaya; Kiran S.,9995,0,9999,4
1714635072084,MATH 197,002,563811,Zhang; Danna,9995,0,9999,4
1714635072084,MATH 197,003,628552,Dumitriu; Ioana,9998,0,9999,1
1714635073110,MCWP 40R,A00,518780,Staff,2,0,20,18
1714635073110,MCWP 40R,B00,518781,Staff,8,0,20,12
1714635073110,MCWP 40R,C00,518783,Staff,6,0,20,14
1714635074137,MCWP 50R,A00,518791,Staff,0,0,20,20
1714635074137,MCWP 50R,B00,518792,Staff,0,2,20,20
1714635074137,MCWP 50R,C00,518793,Staff,0,2,20,20
1714635074137,MCWP 50R,D00,518794,Staff,0,0,20,20
1714635074137,MCWP 50R,E00,518795,Staff,0,2,20,20
1714635074137,MCWP 50R,F00,518796,Staff,0,0,20,20
1714635074137,MCWP 50R,G00,518797,Staff,0,1,20,20
1714635075169,MMW 12R,A01,514034,Herbst; Matthew,0,0,16,16
1714635075169,MMW 12R,A02,514035,Herbst; Matthew,1,0,16,15
1714635076196,MMW 13R,A01,514037,Staff,0,4,16,16
1714635076196,MMW 13R,A02,514039,Staff,0,2,16,16
1714635076196,MMW 13R,A03,628519,Staff,0,2,16,16
1714635078253,SIO 295LS,A00,523233,Staff,10,0,30,20
1714635079278,SIO 295S,A00,523232,Staff,10,0,30,20
1714635080363,SIOC 290S,A01,637330,Merrifield; Mark A,23,0,30,7
1714635081395,SIOC 291S,A01,637333,Gabriel; Corey John,23,0,30,7
1714635082425,SOCI 117,A01,494376,Staff,0,4,5,5
1714635083450,WES 237B,A00,494380,Staff,9,0,20,11
1714635085546,AESE 279B,A00,494370,Wade; Jon P,0,0,33,33
1714635086574,AIP 197,001,627712,Vespa; Emanuel Ignacio,9998,0,9999,1
1714635087601,ANAR 135S,A00,494369,Braswell; Geoffrey E.,0,0,0,0
1714635088629,BENG 196,001,628496,Engler; Adam J.,9998,0,9999,1
1714635089660,CAT 124RS,A01,519847,Geibel; William,0,0,20,20
1714635090690,CAT 125RS,A01,515971,Geibel; William,0,0,20,20
1714635091717,CLRE 250,A00,511389,Morris; Sheldon,9993,0,9999,6
1714635092753,CLRE 251,A00,507176,Mehta; Ravindra L.,9993,0,9999,6
1714635092753,CLRE 251,B00,511410,Mehta; Ravindra L.,9998,0,9999,1
1714635093789,CLRE 252,A00,507189,Cuomo; Raphael Eduardo,9995,0,9999,4
1714635094816,CLRE 253,A00,507199,Vaida; Florin,9994,0,9999,5
1714635094816,CLRE 253,B00,507202,Vaida; Florin,9999,0,9999,0
1714635095849,CLRE 259,A00,507211,Patel; Hemal,9996,0,9999,3
1714635096876,CLRE 260,A00,507221,Cuomo; Raphael Eduardo,9999,0,9999,0
1714635097905,CLRE 297,001,507242,Cuomo; Raphael Eduardo,9999,0,9999,0
1714635098941,COGS 197,001,638244,Voytek; Bradley Thomas,9998,0,9999,1
1714635099968,CSE 191,A00,516875,Minnes Kemp; Mor Mia,9992,0,9999,7
1714635100994,CSE 197,001,637388,Minnes Kemp; Mor Mia,9998,0,9999,1
1714635102031,CSS 201S,A01,494383,Staff,35,0,35,0
1714635103064,CSS 202S,A01,494387,Staff,35,0,35,0
1714635104097,DSC 197,001,628532,Eldridge; Justin Matthew,9996,0,9999,3
1714635105124,EAP 100,A00,516065,Staff,9797,0,9999,202
1714635106151,ECE 45,A01,507414,Staff,33,0,60,27
1714635108207,ECE 111,A01,507420,Staff,15,0,50,35
1714635109240,ECE 197,001,548057,Sievenpiper; Daniel F.,9993,0,9999,6
1714635110268,EDS 115,A00,507243,Choi; Bailey Miyeon,10,0,28,18
1714635111293,EDS 117,A01,494379,Staff,0,4,30,30
1714635112321,EDS 125,A00,507246,Hopkins; Megan Beth,9,0,30,21
1714635113357,EDS 128A,A01,507264,Fargason; Sharon Gayle,8,0,26,18
1714635114390,EDS 128B,A01,507293,Pappas; Elizabeth,12,0,30,18
1714635115425,EDS 139,A00,507294,Fargason; Sharon Gayle,13,0,30,17
1714635115425,EDS 139,B00,507313,Pappas; Elizabeth,13,0,30,17
1714635116450,EDS 201,A00,507315,Staff,13,0,30,17
1714635117489,EDS 203,A01,507317,Halter; Christopher P.,12,0,30,18
1714635118515,EDS 204R,A01,507319,Halter; Christopher P.,0,3,30,30
1714635118515,EDS 204R,B01,507331,Heinzman; Erica M.,16,0,30,14
1714635119545,EDS 206R,A00,507332,Staff,0,4,30,30
1714635119545,EDS 206R,B00,507343,Staff,17,0,30,13
1714635120582,EDS 250,A00,507344,Hemans; Patricia Ann Benitez,22,0,40,18
1714635121614,EDS 281,A00,507345,Daly; Alan J.,18,0,18,0
1714635122638,EDS 284,A00,507350,Daly; Alan J.,16,0,16,0
1714635123664,EDS 286,A00,507359,Fine; Sarah,18,0,18,0
1714635124688,EDS 289C,A01,507361,Daly; Alan J.,18,0,18,0
1714635125715,EDS 290,A00,507366,Hofstetter; Carolyn,15,0,15,0
1714635126744,LIGM 5A,A00,507421,Fischer-Grunski; Eva K,18,0,20,2
1714635127770,LIGM 5B,A00,507423,Fischer-Grunski; Eva K,19,0,20,1
1714635128801,LIGM 5C,A00,507425,Fischer-Grunski; Eva K,19,0,20,1
1714635129833,LIIT 5AS,A00,507427,Carnelos; Chiara,20,0,20,0
1714635130864,LIIT 5BS,A00,507430,Carnelos; Chiara,20,0,20,0
1714635131897,LIIT 5CS,A00,507432,Carnelos; Chiara,20,0,20,0
1714635132926,LISP 5A,A00,507541,Munoz Sanchez; Alicia,11,0,20,9
1714635133955,LISP 5B,A00,507671,Munoz Sanchez; Alicia,8,0,20,12
1714635134980,LISP 5C,A00,507696,Munoz Sanchez; Alicia,9,0,20,11
1714635136018,MAE 197,001,528363,Boechler; Nicholas Sebastia,9998,0,9999,1
1714635137055,MATH 197,001,523477,Kedlaya; Kiran S.,9995,0,9999,4
1714635137055,MATH 197,002,563811,Zhang; Danna,9995,0,9999,4
1714635137055,MATH 197,003,628552,Dumitriu; Ioana,9998,0,9999,1
1714635138086,MCWP 40R,A00,518780,Staff,2,0,20,18
1714635138086,MCWP 40R,B00,518781,Staff,8,0,20,12
1714635138086,MCWP 40R,C00,518783,Staff,6,0,20,14
1714635139113,MCWP 50R,A00,518791,Staff,0,0,20,20
1714635139113,MCWP 50R,B00,518792,Staff,0,2,20,20
1714635139113,MCWP 50R,C00,518793,Staff,0,2,20,20
1714635139113,MCWP 50R,D00,518794,Staff,0,0,20,20
1714635139113,MCWP 50R,E00,518795,Staff,0,2,20,20
1714635139113,MCWP 50R,F00,518796,Staff,0,0,20,20
1714635139113,MCWP 50R,G00,518797,Staff,0,1,20,20
1714635140142,MMW 12R,A01,514034,Herbst; Matthew,0,0,16,16
1714635140142,MMW 12R,A02,514035,Herbst; Matthew,1,0,16,15
1714635141169,MMW 13R,A01,514037,Staff,0,4,16,16
1714635141169,MMW 13R,A02,514039,Staff,0,2,16,16
1714635141169,MMW 13R,A03,628519,Staff,0,2,16,16
1714635143225,SIO 295LS,A00,523233,Staff,10,0,30,20
1714635144256,SIO 295S,A00,523232,Staff,10,0,30,20
1714635145289,SIOC 290S,A01,637330,Merrifield; Mark A,23,0,30,7
1714635146316,SIOC 291S,A01,637333,Gabriel; Corey John,23,0,30,7
1714635147343,SOCI 117,A01,494376,Staff,0,4,5,5
1714635148368,WES 237B,A00,494380,Staff,9,0,20,11
1714635150476,AESE 279B,A00,494370,Wade; Jon P,0,0,33,33
1714635151507,AIP 197,001,627712,Vespa; Emanuel Ignacio,9998,0,9999,1
1714635152539,ANAR 135S,A00,494369,Braswell; Geoffrey E.,0,0,0,0
1714635153565,BENG 196,001,628496,Engler; Adam J.,9998,0,9999,1
1714635154592,CAT 124RS,A01,519847,Geibel; William,0,0,20,20
1714635155620,CAT 125RS,A01,515971,Geibel; William,0,0,20,20
1714635156647,CLRE 250,A00,511389,Morris; Sheldon,9993,0,9999,6
1714635157675,CLRE 251,A00,507176,Mehta; Ravindra L.,9993,0,9999,6
1714635157675,CLRE 251,B00,511410,Mehta; Ravindra L.,9998,0,9999,1
1714635158701,CLRE 252,A00,507189,Cuomo; Raphael Eduardo,9995,0,9999,4
1714635159785,CLRE 253,A00,507199,Vaida; Florin,9994,0,9999,5
1714635159785,CLRE 253,B00,507202,Vaida; Florin,9999,0,9999,0
1714635160810,CLRE 259,A00,507211,Patel; Hemal,9996,0,9999,3
1714635161839,CLRE 260,A00,507221,Cuomo; Raphael Eduardo,9999,0,9999,0
1714635162870,CLRE 297,001,507242,Cuomo; Raphael Eduardo,9999,0,9999,0
1714635163908,COGS 197,001,638244,Voytek; Bradley Thomas,9998,0,9999,1
1714635164932,CSE 191,A00,516875,Minnes Kemp; Mor Mia,9992,0,9999,7
1714635165966,CSE 197,001,637388,Minnes Kemp; Mor Mia,9998,0,9999,1
1714635167000,CSS 201S,A01,494383,Staff,35,0,35,0
1714635168032,CSS 202S,A01,494387,Staff,35,0,35,0
1714635169062,DSC 197,001,628532,Eldridge; Justin Matthew,9996,0,9999,3
1714635170091,EAP 100,A00,516065,Staff,9797,0,9999,202
1714635171120,ECE 45,A01,507414,Staff,33,0,60,27
1714635173176,ECE 111,A01,507420,Staff,15,0,50,35
1714635174202,ECE 197,001,548057,Sievenpiper; Daniel F.,9993,0,9999,6
1714635175233,EDS 115,A00,507243,Choi; Bailey Miyeon,10,0,28,18
1714635176278,EDS 117,A01,494379,Staff,0,4,30,30
1714635177305,EDS 125,A00,507246,Hopkins; Megan Beth,9,0,30,21
1714635178338,EDS 128A,A01,507264,Fargason; Sharon Gayle,8,0,26,18
1714635179371,EDS 128B,A01,507293,Pappas; Elizabeth,12,0,30,18
1714635180407,EDS 139,A00,507294,Fargason; Sharon Gayle,13,0,30,17
1714635180407,EDS 139,B00,507313,Pappas; Elizabeth,13,0,30,17
1714635181431,EDS 201,A00,507315,Staff,13,0,30,17
1714635182458,EDS 203,A01,507317,Halter; Christopher P.,12,0,30,18
1714635183511,EDS 204R,A01,507319,Halter; Christopher P.,0,3,30,30
1714635183511,EDS 204R,B01,507331,Heinzman; Erica M.,16,0,30,14
1714635184542,EDS 206R,A00,507332,Staff,0,4,30,30
1714635184542,EDS 206R,B00,507343,Staff,17,0,30,13
1714635185569,EDS 250,A00,507344,Hemans; Patricia Ann Benitez,22,0,40,18
1714635186598,EDS 281,A00,507345,Daly; Alan J.,18,0,18,0
1714635187628,EDS 284,A00,507350,Daly; Alan J.,16,0,16,0
1714635188662,EDS 286,A00,507359,Fine; Sarah,18,0,18,0
1714635189688,EDS 289C,A01,507361,Daly; Alan J.,18,0,18,0
1714635190713,EDS 290,A00,507366,Hofstetter; Carolyn,15,0,15,0
1714635191748,LIGM 5A,A00,507421,Fischer-Grunski; Eva K,18,0,20,2
1714635192780,LIGM 5B,A00,507423,Fischer-Grunski; Eva K,19,0,20,1
1714635193811,LIGM 5C,A00,507425,Fischer-Grunski; Eva K,19,0,20,1
1714635194844,LIIT 5AS,A00,507427,Carnelos; Chiara,20,0,20,0
1714635195872,LIIT 5BS,A00,507430,Carnelos; Chiara,20,0,20,0
1714635196896,LIIT 5CS,A00,507432,Carnelos; Chiara,20,0,20,0
1714635197925,LISP 5A,A00,507541,Munoz Sanchez; Alicia,11,0,20,9
1714635198951,LISP 5B,A00,507671,Munoz Sanchez; Alicia,8,0,20,12
1714635199983,LISP 5C,A00,507696,Munoz Sanchez; Alicia,9,0,20,11
1714635201017,MAE 197,001,528363,Boechler; Nicholas Sebastia,9998,0,9999,1
1714635202054,MATH 197,001,523477,Kedlaya; Kiran S.,9995,0,9999,4
1714635202054,MATH 197,002,563811,Zhang; Danna,9995,0,9999,4
1714635202054,MATH 197,003,628552,Dumitriu; Ioana,9998,0,9999,1
1714635203080,MCWP 40R,A00,518780,Staff,2,0,20,18
1714635203080,MCWP 40R,B00,518781,Staff,8,0,20,12
1714635203080,MCWP 40R,C00,518783,Staff,6,0,20,14
1714635204107,MCWP 50R,A00,518791,Staff,0,0,20,20
1714635204107,MCWP 50R,B00,518792,Staff,0,2,20,20
1714635204107,MCWP 50R,C00,518793,Staff,0,2,20,20
1714635204107,MCWP 50R,D00,518794,Staff,0,0,20,20
1714635204107,MCWP 50R,E00,518795,Staff,0,2,20,20
1714635204107,MCWP 50R,F00,518796,Staff,0,0,20,20
1714635204107,MCWP 50R,G00,518797,Staff,0,1,20,20
1714635205138,MMW 12R,A01,514034,Herbst; Matthew,0,0,16,16
1714635205138,MMW 12R,A02,514035,Herbst; Matthew,1,0,16,15
1714635206165,MMW 13R,A01,514037,Staff,0,4,16,16
1714635206165,MMW 13R,A02,514039,Staff,0,2,16,16
1714635206165,MMW 13R,A03,628519,Staff,0,2,16,16
1714635208219,SIO 295LS,A00,523233,Staff,10,0,30,20
1714635209249,SIO 295S,A00,523232,Staff,10,0,30,20
1714635210276,SIOC 290S,A01,637330,Merrifield; Mark A,23,0,30,7
1714635211302,SIOC 291S,A01,637333,Gabriel; Corey John,23,0,30,7
1714635212339,SOCI 117,A01,494376,Staff,0,4,5,5
1714635213365,WES 237B,A00,494380,Staff,9,0,20,11
1714635215453,AESE 279B,A00,494370,Wade; Jon P,0,0,33,33
1714635216485,AIP 197,001,627712,Vespa; Emanuel Ignacio,9998,0,9999,1
1714635217511,ANAR 135S,A00,494369,Braswell; Geoffrey E.,0,0,0,0
1714635218545,BENG 196,001,628496,Engler; Adam J.,9998,0,9999,1
1714635219584,CAT 124RS,A01,519847,Geibel; William,0,0,20,20
1714635220610,CAT 125RS,A01,515971,Geibel; William,0,0,20,20
1714635221640,CLRE 250,A00,511389,Morris; Sheldon,9993,0,9999,6
1714635222671,CLRE 251,A00,507176,Mehta; Ravindra L.,9993,0,9999,6
1714635222671,CLRE 251,B00,511410,Mehta; Ravindra L.,9998,0,9999,1
1714635223702,CLRE 252,A00,507189,Cuomo; Raphael Eduardo,9995,0,9999,4
1714635224733,CLRE 253,A00,507199,Vaida; Florin,9994,0,9999,5
1714635224733,CLRE 253,B00,507202,Vaida; Florin,9999,0,9999,0
1714635225766,CLRE 259,A00,507211,Patel; Hemal,9996,0,9999,3
1714635226793,CLRE 260,A00,507221,Cuomo; Raphael Eduardo,9999,0,9999,0
1714635227825,CLRE 297,001,507242,Cuomo; Raphael Eduardo,9999,0,9999,0
1714635228855,COGS 197,001,638244,Voytek; Bradley Thomas,9998,0,9999,1
1714635229881,CSE 191,A00,516875,Minnes Kemp; Mor Mia,9992,0,9999,7
1714635230907,CSE 197,001,637388,Minnes Kemp; Mor Mia,9998,0,9999,1
1714635231933,CSS 201S,A01,494383,Staff,35,0,35,0
1714635232959,CSS 202S,A01,494387,Staff,35,0,35,0
1714635233989,DSC 197,001,628532,Eldridge; Justin Matthew,9996,0,9999,3
1714635235014,EAP 100,A00,516065,Staff,9797,0,9999,202
1714635236046,ECE 45,A01,507414,Staff,33,0,60,27
1714635238101,ECE 111,A01,507420,Staff,15,0,50,35
1714635239128,ECE 197,001,548057,Sievenpiper; Daniel F.,9993,0,9999,6
1714635240160,EDS 115,A00,507243,Choi; Bailey Miyeon,10,0,28,18
1714635241191,EDS 117,A01,494379,Staff,0,4,30,30
1714635242223,EDS 125,A00,507246,Hopkins; Megan Beth,9,0,30,21
1714635243249,EDS 128A,A01,507264,Fargason; Sharon Gayle,8,0,26,18
1714635244275,EDS 128B,A01,507293,Pappas; Elizabeth,12,0,30,18
1714635245304,EDS 139,A00,507294,Fargason; Sharon Gayle,13,0,30,17
1714635245304,EDS 139,B00,507313,Pappas; Elizabeth,13,0,30,17
1714635246330,EDS 201,A00,507315,Staff,13,0,30,17
1714635247362,EDS 203,A01,507317,Halter; Christopher P.,12,0,30,18
1714635248392,EDS 204R,A01,507319,Halter; Christopher P.,0,3,30,30
1714635248392,EDS 204R,B01,507331,Heinzman; Erica M.,16,0,30,14
1714635249418,EDS 206R,A00,507332,Staff,0,4,30,30
1714635249418,EDS 206R,B00,507343,Staff,17,0,30,13
1714635250446,EDS 250,A00,507344,Hemans; Patricia Ann Benitez,22,0,40,18
1714635251472,EDS 281,A00,507345,Daly; Alan J.,18,0,18,0
1714635252498,EDS 284,A00,507350,Daly; Alan J.,16,0,16,0
1714635253529,EDS 286,A00,507359,Fine; Sarah,18,0,18,0
1714635254553,EDS 289C,A01,507361,Daly; Alan J.,18,0,18,0
1714635255581,EDS 290,A00,507366,Hofstetter; Carolyn,15,0,15,0
1714635256606,LIGM 5A,A00,507421,Fischer-Grunski; Eva K,18,0,20,2
1714635257632,LIGM 5B,A00,507423,Fischer-Grunski; Eva K,19,0,20,1
1714635258657,LIGM 5C,A00,507425,Fischer-Grunski; Eva K,19,0,20,1
1714635259689,LIIT 5AS,A00,507427,Carnelos; Chiara,20,0,20,0
1714635260717,LIIT 5BS,A00,507430,Carnelos; Chiara,20,0,20,0
1714635261745,LIIT 5CS,A00,507432,Carnelos; Chiara,20,0,20,0
1714635262778,LISP 5A,A00,507541,Munoz Sanchez; Alicia,11,0,20,9
1714635263806,LISP 5B,A00,507671,Munoz Sanchez; Alicia,8,0,20,12
1714635264838,LISP 5C,A00,507696,Munoz Sanchez; Alicia,9,0,20,11
1714635265866,MAE 197,001,528363,Boechler; Nicholas Sebastia,9998,0,9999,1
1714635266895,MATH 197,001,523477,Kedlaya; Kiran S.,9995,0,9999,4
1714635266895,MATH 197,002,563811,Zhang; Danna,9995,0,9999,4
1714635266895,MATH 197,003,628552,Dumitriu; Ioana,9998,0,9999,1
1714635267921,MCWP 40R,A00,518780,Staff,2,0,20,18
1714635267921,MCWP 40R,B00,518781,Staff,8,0,20,12
1714635267921,MCWP 40R,C00,518783,Staff,6,0,20,14
1714635268953,MCWP 50R,A00,518791,Staff,0,0,20,20
1714635268953,MCWP 50R,B00,518792,Staff,0,2,20,20
1714635268953,MCWP 50R,C00,518793,Staff,0,2,20,20
1714635268953,MCWP 50R,D00,518794,Staff,0,0,20,20
1714635268953,MCWP 50R,E00,518795,Staff,0,2,20,20
1714635268953,MCWP 50R,F00,518796,Staff,0,0,20,20
1714635268953,MCWP 50R,G00,518797,Staff,0,1,20,20
1714635269983,MMW 12R,A01,514034,Herbst; Matthew,0,0,16,16
1714635269983,MMW 12R,A02,514035,Herbst; Matthew,1,0,16,15
1714635271010,MMW 13R,A01,514037,Staff,0,4,16,16
1714635271010,MMW 13R,A02,514039,Staff,0,2,16,16
1714635271010,MMW 13R,A03,628519,Staff,0,2,16,16
1714635273067,SIO 295LS,A00,523233,Staff,10,0,30,20
1714635274093,SIO 295S,A00,523232,Staff,10,0,30,20
1714635275134,SIOC 290S,A01,637330,Merrifield; Mark A,23,0,30,7
1714635276160,SIOC 291S,A01,637333,Gabriel; Corey John,23,0,30,7
1714635277192,SOCI 117,A01,494376,Staff,0,4,5,5
1714635278222,WES 237B,A00,494380,Staff,9,0,20,11
1714635280310,AESE 279B,A00,494370,Wade; Jon P,0,0,33,33
1714635281334,AIP 197,001,627712,Vespa; Emanuel Ignacio,9998,0,9999,1
1714635282364,ANAR 135S,A00,494369,Braswell; Geoffrey E.,0,0,0,0
1714635283390,BENG 196,001,628496,Engler; Adam J.,9998,0,9999,1
1714635284422,CAT 124RS,A01,519847,Geibel; William,0,0,20,20
1714635285446,CAT 125RS,A01,515971,Geibel; William,0,0,20,20
1714635286476,CLRE 250,A00,511389,Morris; Sheldon,9993,0,9999,6
1714635287516,CLRE 251,A00,507176,Mehta; Ravindra L.,9993,0,9999,6
1714635287516,CLRE 251,B00,511410,Mehta; Ravindra L.,9998,0,9999,1
1714635288549,CLRE 252,A00,507189,Cuomo; Raphael Eduardo,9995,0,9999,4
1714635289575,CLRE 253,A00,507199,Vaida; Florin,9994,0,9999,5
1714635289575,CLRE 253,B00,507202,Vaida; Florin,9999,0,9999,0
1714635290603,CLRE 259,A00,507211,Patel; Hemal,9996,0,9999,3
1714635291631,CLRE 260,A00,507221,Cuomo; Raphael Eduardo,9999,0,9999,0
1714635292659,CLRE 297,001,507242,Cuomo; Raphael Eduardo,9999,0,9999,0
1714635293688,COGS 197,001,638244,Voytek; Bradley Thomas,9998,0,9999,1
1714635294719,CSE 191,A00,516875,Minnes Kemp; Mor Mia,9992,0,9999,7
1714635295746,CSE 197,001,637388,Minnes Kemp; Mor Mia,9998,0,9999,1
1714635296773,CSS 201S,A01,494383,Staff,35,0,35,0
1714635297799,CSS 202S,A01,494387,Staff,35,0,35,0
1714635298826,DSC 197,001,628532,Eldridge; Justin Matthew,9996,0,9999,3
1714635299854,EAP 100,A00,516065,Staff,9797,0,9999,202
1714635300883,ECE 45,A01,507414,Staff,33,0,60,27
1714635302938,ECE 111,A01,507420,Staff,15,0,50,35
1714635303965,ECE 197,001,548057,Sievenpiper; Daniel F.,9993,0,9999,6
1714635304996,EDS 115,A00,507243,Choi; Bailey Miyeon,10,0,28,18
1714635306029,EDS 117,A01,494379,Staff,0,4,30,30
1714635307065,EDS 125,A00,507246,Hopkins; Megan Beth,9,0,30,21
1714635308092,EDS 128A,A01,507264,Fargason; Sharon Gayle,8,0,26,18
1714635309121,EDS 128B,A01,507293,Pappas; Elizabeth,12,0,30,18
1714635310146,EDS 139,A00,507294,Fargason; Sharon Gayle,13,0,30,17
1714635310146,EDS 139,B00,507313,Pappas; Elizabeth,13,0,30,17
1714635311176,EDS 201,A00,507315,Staff,13,0,30,17
1714635312205,EDS 203,A01,507317,Halter; Christopher P.,12,0,30,18
1714635313239,EDS 204R,A01,507319,Halter; Christopher P.,0,3,30,30
1714635313239,EDS 204R,B01,507331,Heinzman; Erica M.,16,0,30,14
1714635314269,EDS 206R,A00,507332,Staff,0,4,30,30
1714635314269,EDS 206R,B00,507343,Staff,17,0,30,13
1714635315294,EDS 250,A00,507344,Hemans; Patricia Ann Benitez,22,0,40,18
1714635316324,EDS 281,A00,507345,Daly; Alan J.,18,0,18,0
1714635317354,EDS 284,A00,507350,Daly; Alan J.,16,0,16,0
1714635318385,EDS 286,A00,507359,Fine; Sarah,18,0,18,0
1714635319410,EDS 289C,A01,507361,Daly; Alan J.,18,0,18,0
1714635320441,EDS 290,A00,507366,Hofstetter; Carolyn,15,0,15,0
1714635321472,LIGM 5A,A00,507421,Fischer-Grunski; Eva K,18,0,20,2
1714635322500,LIGM 5B,A00,507423,Fischer-Grunski; Eva K,19,0,20,1
1714635323527,LIGM 5C,A00,507425,Fischer-Grunski; Eva K,19,0,20,1
1714635324553,LIIT 5AS,A00,507427,Carnelos; Chiara,20,0,20,0
1714635325580,LIIT 5BS,A00,507430,Carnelos; Chiara,20,0,20,0
1714635326605,LIIT 5CS,A00,507432,Carnelos; Chiara,20,0,20,0
1714635327640,LISP 5A,A00,507541,Munoz Sanchez; Alicia,11,0,20,9
1714635328672,LISP 5B,A00,507671,Munoz Sanchez; Alicia,8,0,20,12
1714635329702,LISP 5C,A00,507696,Munoz Sanchez; Alicia,9,0,20,11
1714635330744,MAE 197,001,528363,Boechler; Nicholas Sebastia,9998,0,9999,1
1714635331778,MATH 197,001,523477,Kedlaya; Kiran S.,9995,0,9999,4
1714635331778,MATH 197,002,563811,Zhang; Danna,9995,0,9999,4
1714635331778,MATH 197,003,628552,Dumitriu; Ioana,9998,0,9999,1
1714635332813,MCWP 40R,A00,518780,Staff,2,0,20,18
1714635332813,MCWP 40R,B00,518781,Staff,8,0,20,12
1714635332813,MCWP 40R,C00,518783,Staff,6,0,20,14
1714635333843,MCWP 50R,A00,518791,Staff,0,0,20,20
1714635333843,MCWP 50R,B00,518792,Staff,0,2,20,20
1714635333843,MCWP 50R,C00,518793,Staff,0,2,20,20
1714635333843,MCWP 50R,D00,518794,Staff,0,0,20,20
1714635333843,MCWP 50R,E00,518795,Staff,0,2,20,20
1714635333843,MCWP 50R,F00,518796,Staff,0,0,20,20
1714635333843,MCWP 50R,G00,518797,Staff,0,1,20,20
1714635334877,MMW 12R,A01,514034,Herbst; Matthew,0,0,16,16
1714635334877,MMW 12R,A02,514035,Herbst; Matthew,1,0,16,15
1714635335903,MMW 13R,A01,514037,Staff,0,4,16,16
1714635335903,MMW 13R,A02,514039,Staff,0,2,16,16
1714635335903,MMW 13R,A03,628519,Staff,0,2,16,16
1714635337958,SIO 295LS,A00,523233,Staff,10,0,30,20
1714635339010,SIO 295S,A00,523232,Staff,10,0,30,20
1714635340041,SIOC 290S,A01,637330,Merrifield; Mark A,23,0,30,7
1714635341067,SIOC 291S,A01,637333,Gabriel; Corey John,23,0,30,7
1714635342100,SOCI 117,A01,494376,Staff,0,4,5,5
1714635343127,WES 237B,A00,494380,Staff,9,0,20,11
1714635345210,AESE 279B,A00,494370,Wade; Jon P,0,0,33,33
1714635346238,AIP 197,001,627712,Vespa; Emanuel Ignacio,9998,0,9999,1
1714635347271,ANAR 135S,A00,494369,Braswell; Geoffrey E.,0,0,0,0
1714635348298,BENG 196,001,628496,Engler; Adam J.,9998,0,9999,1
1714635349330,CAT 124RS,A01,519847,Geibel; William,0,0,20,20
1714635350361,CAT 125RS,A01,515971,Geibel; William,0,0,20,20
1714635351387,CLRE 250,A00,511389,Morris; Sheldon,9993,0,9999,6
1714635352424,CLRE 251,A00,507176,Mehta; Ravindra L.,9993,0,9999,6
1714635352424,CLRE 251,B00,511410,Mehta; Ravindra L.,9998,0,9999,1
1714635353459,CLRE 252,A00,507189,Cuomo; Raphael Eduardo,9995,0,9999,4
1714635354487,CLRE 253,A00,507199,Vaida; Florin,9994,0,9999,5
1714635354487,CLRE 253,B00,507202,Vaida; Florin,9999,0,9999,0
1714635355513,CLRE 259,A00,507211,Patel; Hemal,9996,0,9999,3
1714635356543,CLRE 260,A00,507221,Cuomo; Raphael Eduardo,9999,0,9999,0
1714635357570,CLRE 297,001,507242,Cuomo; Raphael Eduardo,9999,0,9999,0
1714635358610,COGS 197,001,638244,Voytek; Bradley Thomas,9998,0,9999,1
1714635359641,CSE 191,A00,516875,Minnes Kemp; Mor Mia,9992,0,9999,7
1714635360673,CSE 197,001,637388,Minnes Kemp; Mor Mia,9998,0,9999,1
1714635361702,CSS 201S,A01,494383,Staff,35,0,35,0
1714635362729,CSS 202S,A01,494387,Staff,35,0,35,0
1714635363759,DSC 197,001,628532,Eldridge; Justin Matthew,9996,0,9999,3
1714635364783,EAP 100,A00,516065,Staff,9797,0,9999,202
1714635365815,ECE 45,A01,507414,Staff,33,0,60,27
1714635367867,ECE 111,A01,507420,Staff,15,0,50,35
1714635368901,ECE 197,001,548057,Sievenpiper; Daniel F.,9993,0,9999,6
1714635369929,EDS 115,A00,507243,Choi; Bailey Miyeon,10,0,28,18
1714635370960,EDS 117,A01,494379,Staff,0,4,30,30
1714635371987,EDS 125,A00,507246,Hopkins; Megan Beth,9,0,30,21
1714635373017,EDS 128A,A01,507264,Fargason; Sharon Gayle,8,0,26,18
1714635374046,EDS 128B,A01,507293,Pappas; Elizabeth,12,0,30,18
1714635375075,EDS 139,A00,507294,Fargason; Sharon Gayle,13,0,30,17
1714635375075,EDS 139,B00,507313,Pappas; Elizabeth,13,0,30,17
1714635376102,EDS 201,A00,507315,Staff,13,0,30,17
1714635377127,EDS 203,A01,507317,Halter; Christopher P.,12,0,30,18
1714635378155,EDS 204R,A01,507319,Halter; Christopher P.,0,3,30,30
1714635378155,EDS 204R,B01,507331,Heinzman; Erica M.,16,0,30,14
1714635379182,EDS 206R,A00,507332,Staff,0,4,30,30
1714635379182,EDS 206R,B00,507343,Staff,17,0,30,13
1714635380217,EDS 250,A00,507344,Hemans; Patricia Ann Benitez,22,0,40,18
1714635381244,EDS 281,A00,507345,Daly; Alan J.,18,0,18,0
1714635382268,EDS 284,A00,507350,Daly; Alan J.,16,0,16,0
1714635383297,EDS 286,A00,507359,Fine; Sarah,18,0,18,0
1714635384324,EDS 289C,A01,507361,Daly; Alan J.,18,0,18,0
1714635385349,EDS 290,A00,507366,Hofstetter; Carolyn,15,0,15,0
1714635386398,LIGM 5A,A00,507421,Fischer-Grunski; Eva K,18,0,20,2
1714635387426,LIGM 5B,A00,507423,Fischer-Grunski; Eva K,19,0,20,1
1714635388458,LIGM 5C,A00,507425,Fischer-Grunski; Eva K,19,0,20,1
1714635389489,LIIT 5AS,A00,507427,Carnelos; Chiara,20,0,20,0
1714635390521,LIIT 5BS,A00,507430,Carnelos; Chiara,20,0,20,0
1714635391550,LIIT 5CS,A00,507432,Carnelos; Chiara,20,0,20,0
1714635392578,LISP 5A,A00,507541,Munoz Sanchez; Alicia,11,0,20,9
1714635393613,LISP 5B,A00,507671,Munoz Sanchez; Alicia,8,0,20,12
1714635394640,LISP 5C,A00,507696,Munoz Sanchez; Alicia,9,0,20,11
1714635395671,MAE 197,001,528363,Boechler; Nicholas Sebastia,9998,0,9999,1
1714635396704,MATH 197,001,523477,Kedlaya; Kiran S.,9995,0,9999,4
1714635396704,MATH 197,002,563811,Zhang; Danna,9995,0,9999,4
1714635396704,MATH 197,003,628552,Dumitriu; Ioana,9998,0,9999,1
1714635397731,MCWP 40R,A00,518780,Staff,2,0,20,18
1714635397731,MCWP 40R,B00,518781,Staff,8,0,20,12
1714635397731,MCWP 40R,C00,518783,Staff,6,0,20,14
1714635398817,MCWP 50R,A00,518791,Staff,0,0,20,20
1714635398817,MCWP 50R,B00,518792,Staff,0,2,20,20
1714635398817,MCWP 50R,C00,518793,Staff,0,2,20,20
1714635398817,MCWP 50R,D00,518794,Staff,0,0,20,20
1714635398817,MCWP 50R,E00,518795,Staff,0,2,20,20
1714635398817,MCWP 50R,F00,518796,Staff,0,0,20,20
1714635398817,MCWP 50R,G00,518797,Staff,0,1,20,20
1714635399849,MMW 12R,A01,514034,Herbst; Matthew,0,0,16,16
1714635399849,MMW 12R,A02,514035,Herbst; Matthew,1,0,16,15
1714635400881,MMW 13R,A01,514037,Staff,0,4,16,16
1714635400881,MMW 13R,A02,514039,Staff,0,2,16,16
1714635400881,MMW 13R,A03,628519,Staff,0,2,16,16
1714635402939,SIO 295LS,A00,523233,Staff,10,0,30,20
1714635403968,SIO 295S,A00,523232,Staff,10,0,30,20
1714635405011,SIOC 290S,A01,637330,Merrifield; Mark A,23,0,30,7
1714635406037,SIOC 291S,A01,637333,Gabriel; Corey John,23,0,30,7
1714635407065,SOCI 117,A01,494376,Staff,0,4,5,5
1714635408097,WES 237B,A00,494380,Staff,9,0,20,11
1714635410187,AESE 279B,A00,494370,Wade; Jon P,0,0,33,33
1714635411216,AIP 197,001,627712,Vespa; Emanuel Ignacio,9998,0,9999,1
1714635412244,ANAR 135S,A00,494369,Braswell; Geoffrey E.,0,0,0,0
1714635413276,BENG 196,001,628496,Engler; Adam J.,9998,0,9999,1
1714635414308,CAT 124RS,A01,519847,Geibel; William,0,0,20,20
1714635415335,CAT 125RS,A01,515971,Geibel; William,0,0,20,20
1714635416362,CLRE 250,A00,511389,Morris; Sheldon,9993,0,9999,6
1714635417397,CLRE 251,A00,507176,Mehta; Ravindra L.,9993,0,9999,6
1714635417397,CLRE 251,B00,511410,Mehta; Ravindra L.,9998,0,9999,1
1714635418421,CLRE 252,A00,507189,Cuomo; Raphael Eduardo,9995,0,9999,4
1714635419448,CLRE 253,A00,507199,Vaida; Florin,9994,0,9999,5
1714635419448,CLRE 253,B00,507202,Vaida; Florin,9999,0,9999,0
1714635420495,CLRE 259,A00,507211,Patel; Hemal,9996,0,9999,3
1714635421526,CLRE 260,A00,507221,Cuomo; Raphael Eduardo,9999,0,9999,0
1714635422551,CLRE 297,001,507242,Cuomo; Raphael Eduardo,9999,0,9999,0
1714635423586,COGS 197,001,638244,Voytek; Bradley Thomas,9998,0,9999,1
1714635424621,CSE 191,A00,516875,Minnes Kemp; Mor Mia,9992,0,9999,7
1714635425651,CSE 197,001,637388,Minnes Kemp; Mor Mia,9998,0,9999,1
1714635426678,CSS 201S,A01,494383,Staff,35,0,35,0
1714635427704,CSS 202S,A01,494387,Staff,35,0,35,0
1714635428730,DSC 197,001,628532,Eldridge; Justin Matthew,9996,0,9999,3
1714635429755,EAP 100,A00,516065,Staff,9797,0,9999,202
1714635430783,ECE 45,A01,507414,Staff,33,0,60,27
1714635432844,ECE 111,A01,507420,Staff,15,0,50,35
1714635433876,ECE 197,001,548057,Sievenpiper; Daniel F.,9993,0,9999,6
1714635434915,EDS 115,A00,507243,Choi; Bailey Miyeon,10,0,28,18
1714635435947,EDS 117,A01,494379,Staff,0,4,30,30
1714635436976,EDS 125,A00,507246,Hopkins; Megan Beth,9,0,30,21
1714635438002,EDS 128A,A01,507264,Fargason; Sharon Gayle,8,0,26,18
1714635439030,EDS 128B,A01,507293,Pappas; Elizabeth,12,0,30,18
1714635440059,EDS 139,A00,507294,Fargason; Sharon Gayle,13,0,30,17
1714635440059,EDS 139,B00,507313,Pappas; Elizabeth,13,0,30,17
1714635441088,EDS 201,A00,507315,Staff,13,0,30,17
1714635442114,EDS 203,A01,507317,Halter; Christopher P.,12,0,30,18
1714635443142,EDS 204R,A01,507319,Halter; Christopher P.,0,3,30,30
1714635443142,EDS 204R,B01,507331,Heinzman; Erica M.,16,0,30,14
1714635444169,EDS 206R,A00,507332,Staff,0,4,30,30
1714635444169,EDS 206R,B00,507343,Staff,17,0,30,13
1714635445201,EDS 250,A00,507344,Hemans; Patricia Ann Benitez,22,0,40,18
1714635446226,EDS 281,A00,507345,Daly; Alan J.,18,0,18,0
1714635447252,EDS 284,A00,507350,Daly; Alan J.,16,0,16,0
1714635448283,EDS 286,A00,507359,Fine; Sarah,18,0,18,0
1714635449309,EDS 289C,A01,507361,Daly; Alan J.,18,0,18,0
1714635450347,EDS 290,A00,507366,Hofstetter; Carolyn,15,0,15,0
1714635451392,LIGM 5A,A00,507421,Fischer-Grunski; Eva K,18,0,20,2
1714635452422,LIGM 5B,A00,507423,Fischer-Grunski; Eva K,19,0,20,1
1714635453452,LIGM 5C,A00,507425,Fischer-Grunski; Eva K,19,0,20,1
1714635454487,LIIT 5AS,A00,507427,Carnelos; Chiara,20,0,20,0
1714635455516,LIIT 5BS,A00,507430,Carnelos; Chiara,20,0,20,0
1714635456547,LIIT 5CS,A00,507432,Carnelos; Chiara,20,0,20,0
1714635457577,LISP 5A,A00,507541,Munoz Sanchez; Alicia,11,0,20,9
1714635458609,LISP 5B,A00,507671,Munoz Sanchez; Alicia,8,0,20,12
1714635459640,LISP 5C,A00,507696,Munoz Sanchez; Alicia,9,0,20,11
1714635460667,MAE 197,001,528363,Boechler; Nicholas Sebastia,9998,0,9999,1
1714635461705,MATH 197,001,523477,Kedlaya; Kiran S.,9995,0,9999,4
1714635461705,MATH 197,002,563811,Zhang; Danna,9995,0,9999,4
1714635461705,MATH 197,003,628552,Dumitriu; Ioana,9998,0,9999,1
1714635462733,MCWP 40R,A00,518780,Staff,2,0,20,18
1714635462733,MCWP 40R,B00,518781,Staff,8,0,20,12
1714635462733,MCWP 40R,C00,518783,Staff,6,0,20,14
1714635463762,MCWP 50R,A00,518791,Staff,0,0,20,20
1714635463762,MCWP 50R,B00,518792,Staff,0,2,20,20
1714635463762,MCWP 50R,C00,518793,Staff,0,2,20,20
1714635463762,MCWP 50R,D00,518794,Staff,0,0,20,20
1714635463762,MCWP 50R,E00,518795,Staff,0,2,20,20
1714635463762,MCWP 50R,F00,518796,Staff,0,0,20,20
1714635463762,MCWP 50R,G00,518797,Staff,0,1,20,20
1714635464788,MMW 12R,A01,514034,Herbst; Matthew,0,0,16,16
1714635464788,MMW 12R,A02,514035,Herbst; Matthew,1,0,16,15
1714635465817,MMW 13R,A01,514037,Staff,0,4,16,16
1714635465817,MMW 13R,A02,514039,Staff,0,2,16,16
1714635465817,MMW 13R,A03,628519,Staff,0,2,16,16
1714635467873,SIO 295LS,A00,523233,Staff,10,0,30,20
1714635468902,SIO 295S,A00,523232,Staff,10,0,30,20
1714635469935,SIOC 290S,A01,637330,Merrifield; Mark A,23,0,30,7
1714635470960,SIOC 291S,A01,637333,Gabriel; Corey John,23,0,30,7
1714635471990,SOCI 117,A01,494376,Staff,0,4,5,5
1714635473019,WES 237B,A00,494380,Staff,9,0,20,11
1714635475111,AESE 279B,A00,494370,Wade; Jon P,0,0,33,33
1714635476141,AIP 197,001,627712,Vespa; Emanuel Ignacio,9998,0,9999,1
1714635477169,ANAR 135S,A00,494369,Braswell; Geoffrey E.,0,0,0,0
1714635478195,BENG 196,001,628496,Engler; Adam J.,9998,0,9999,1
1714635479222,CAT 124RS,A01,519847,Geibel; William,0,0,20,20
1714635480254,CAT 125RS,A01,515971,Geibel; William,0,0,20,20
1714635481285,CLRE 250,A00,511389,Morris; Sheldon,9993,0,9999,6
1714635482322,CLRE 251,A00,507176,Mehta; Ravindra L.,9993,0,9999,6
1714635482322,CLRE 251,B00,511410,Mehta; Ravindra L.,9998,0,9999,1
1714635483369,CLRE 252,A00,507189,Cuomo; Raphael Eduardo,9995,0,9999,4
1714635484394,CLRE 253,A00,507199,Vaida; Florin,9994,0,9999,5
1714635484394,CLRE 253,B00,507202,Vaida; Florin,9999,0,9999,0
1714635485421,CLRE 259,A00,507211,Patel; Hemal,9996,0,9999,3
1714635486446,CLRE 260,A00,507221,Cuomo; Raphael Eduardo,9999,0,9999,0
1714635487474,CLRE 297,001,507242,Cuomo; Raphael Eduardo,9999,0,9999,0
1714635488503,COGS 197,001,638244,Voytek; Bradley Thomas,9998,0,9999,1
1714635489530,CSE 191,A00,516875,Minnes Kemp; Mor Mia,9992,0,9999,7
1714635490557,CSE 197,001,637388,Minnes Kemp; Mor Mia,9998,0,9999,1
1714635491583,CSS 201S,A01,494383,Staff,35,0,35,0
1714635492614,CSS 202S,A01,494387,Staff,35,0,35,0
1714635493639,DSC 197,001,628532,Eldridge; Justin Matthew,9996,0,9999,3
1714635494664,EAP 100,A00,516065,Staff,9797,0,9999,202
1714635495702,ECE 45,A01,507414,Staff,33,0,60,27
1714635497758,ECE 111,A01,507420,Staff,15,0,50,35
1714635498783,ECE 197,001,548057,Sievenpiper; Daniel F.,9993,0,9999,6
1714635499814,EDS 115,A00,507243,Choi; Bailey Miyeon,10,0,28,18
1714635500843,EDS 117,A01,494379,Staff,0,4,30,30
1714635501869,EDS 125,A00,507246,Hopkins; Megan Beth,9,0,30,21
1714635502909,EDS 128A,A01,507264,Fargason; Sharon Gayle,8,0,26,18
1714635503939,EDS 128B,A01,507293,Pappas; Elizabeth,12,0,30,18
1714635504968,EDS 139,A00,507294,Fargason; Sharon Gayle,13,0,30,17
1714635504968,EDS 139,B00,507313,Pappas; Elizabeth,13,0,30,17
1714635505996,EDS 201,A00,507315,Staff,13,0,30,17
1714635507024,EDS 203,A01,507317,Halter; Christopher P.,12,0,30,18
1714635508054,EDS 204R,A01,507319,Halter; Christopher P.,0,3,30,30
1714635508054,EDS 204R,B01,507331,Heinzman; Erica M.,16,0,30,14
1714635509081,EDS 206R,A00,507332,Staff,0,4,30,30
1714635509081,EDS 206R,B00,507343,Staff,17,0,30,13
1714635510109,EDS 250,A00,507344,Hemans; Patricia Ann Benitez,22,0,40,18
1714635511135,EDS 281,A00,507345,Daly; Alan J.,18,0,18,0
1714635512160,EDS 284,A00,507350,Daly; Alan J.,16,0,16,0
1714635513187,EDS 286,A00,507359,Fine; Sarah,18,0,18,0
1714635514213,EDS 289C,A01,507361,Daly; Alan J.,18,0,18,0
1714635515239,EDS 290,A00,507366,Hofstetter; Carolyn,15,0,15,0
1714635516267,LIGM 5A,A00,507421,Fischer-Grunski; Eva K,18,0,20,2
1714635517301,LIGM 5B,A00,507423,Fischer-Grunski; Eva K,19,0,20,1
1714635518330,LIGM 5C,A00,507425,Fischer-Grunski; Eva K,19,0,20,1
1714635519362,LIIT 5AS,A00,507427,Carnelos; Chiara,20,0,20,0
1714635520395,LIIT 5BS,A00,507430,Carnelos; Chiara,20,0,20,0
1714635521426,LIIT 5CS,A00,507432,Carnelos; Chiara,20,0,20,0
1714635522457,LISP 5A,A00,507541,Munoz Sanchez; Alicia,11,0,20,9
1714635523481,LISP 5B,A00,507671,Munoz Sanchez; Alicia,8,0,20,12
1714635524512,LISP 5C,A00,507696,Munoz Sanchez; Alicia,9,0,20,11
1714635525542,MAE 197,001,528363,Boechler; Nicholas Sebastia,9998,0,9999,1
1714635526571,MATH 197,001,523477,Kedlaya; Kiran S.,9995,0,9999,4
1714635526571,MATH 197,002,563811,Zhang; Danna,9995,0,9999,4
1714635526571,MATH 197,003,628552,Dumitriu; Ioana,9998,0,9999,1
1714635527599,MCWP 40R,A00,518780,Staff,2,0,20,18
1714635527599,MCWP 40R,B00,518781,Staff,8,0,20,12
1714635527599,MCWP 40R,C00,518783,Staff,6,0,20,14
1714635528649,MCWP 50R,A00,518791,Staff,0,0,20,20
1714635528649,MCWP 50R,B00,518792,Staff,0,2,20,20
1714635528649,MCWP 50R,C00,518793,Staff,0,2,20,20
1714635528649,MCWP 50R,D00,518794,Staff,0,0,20,20
1714635528649,MCWP 50R,E00,518795,Staff,0,2,20,20
1714635528649,MCWP 50R,F00,518796,Staff,0,0,20,20
1714635528649,MCWP 50R,G00,518797,Staff,0,1,20,20
1714635529674,MMW 12R,A01,514034,Herbst; Matthew,0,0,16,16
1714635529674,MMW 12R,A02,514035,Herbst; Matthew,1,0,16,15
1714635530702,MMW 13R,A01,514037,Staff,0,4,16,16
1714635530702,MMW 13R,A02,514039,Staff,0,2,16,16
1714635530702,MMW 13R,A03,628519,Staff,0,2,16,16
1714635532759,SIO 295LS,A00,523233,Staff,10,0,30,20
1714635533784,SIO 295S,A00,523232,Staff,10,0,30,20
1714635534811,SIOC 290S,A01,637330,Merrifield; Mark A,23,0,30,7
1714635535838,SIOC 291S,A01,637333,Gabriel; Corey John,23,0,30,7
1714635536875,SOCI 117,A01,494376,Staff,0,4,5,5
1714635537900,WES 237B,A00,494380,Staff,9,0,20,11
1714635539985,AESE 279B,A00,494370,Wade; Jon P,0,0,33,33
1714635541012,AIP 197,001,627712,Vespa; Emanuel Ignacio,9998,0,9999,1
1714635542044,ANAR 135S,A00,494369,Braswell; Geoffrey E.,0,0,0,0
1714635543102,BENG 196,001,628496,Engler; Adam J.,9998,0,9999,1
1714635544132,CAT 124RS,A01,519847,Geibel; William,0,0,20,20
1714635545158,CAT 125RS,A01,515971,Geibel; William,0,0,20,20
1714635546187,CLRE 250,A00,511389,Morris; Sheldon,9993,0,9999,6
1714635547217,CLRE 251,A00,507176,Mehta; Ravindra L.,9993,0,9999,6
1714635547217,CLRE 251,B00,511410,Mehta; Ravindra L.,9998,0,9999,1
1714635548249,CLRE 252,A00,507189,Cuomo; Raphael Eduardo,9995,0,9999,4
1714635549277,CLRE 253,A00,507199,Vaida; Florin,9994,0,9999,5
1714635549277,CLRE 253,B00,507202,Vaida; Florin,9999,0,9999,0
1714635550311,CLRE 259,A00,507211,Patel; Hemal,9996,0,9999,3
1714635551335,CLRE 260,A00,507221,Cuomo; Raphael Eduardo,9999,0,9999,0
1714635552365,CLRE 297,001,507242,Cuomo; Raphael Eduardo,9999,0,9999,0
1714635553397,COGS 197,001,638244,Voytek; Bradley Thomas,9998,0,9999,1
1714635554425,CSE 191,A00,516875,Minnes Kemp; Mor Mia,9992,0,9999,7
1714635555450,CSE 197,001,637388,Minnes Kemp; Mor Mia,9998,0,9999,1
1714635556478,CSS 201S,A01,494383,Staff,35,0,35,0
1714635557509,CSS 202S,A01,494387,Staff,35,0,35,0
1714635558536,DSC 197,001,628532,Eldridge; Justin Matthew,9996,0,9999,3
1714635559566,EAP 100,A00,516065,Staff,9797,0,9999,202
1714635560595,ECE 45,A01,507414,Staff,33,0,60,27
1714635562659,ECE 111,A01,507420,Staff,15,0,50,35
1714635563689,ECE 197,001,548057,Sievenpiper; Daniel F.,9993,0,9999,6
1714635564714,EDS 115,A00,507243,Choi; Bailey Miyeon,10,0,28,18
1714635565777,EDS 117,A01,494379,Staff,0,4,30,30
1714635566804,EDS 125,A00,507246,Hopkins; Megan Beth,9,0,30,21
1714635567839,EDS 128A,A01,507264,Fargason; Sharon Gayle,8,0,26,18
1714635568875,EDS 128B,A01,507293,Pappas; Elizabeth,12,0,30,18
1714635569905,EDS 139,A00,507294,Fargason; Sharon Gayle,13,0,30,17
1714635569905,EDS 139,B00,507313,Pappas; Elizabeth,13,0,30,17
1714635570937,EDS 201,A00,507315,Staff,13,0,30,17
1714635571971,EDS 203,A01,507317,Halter; Christopher P.,12,0,30,18
1714635572999,EDS 204R,A01,507319,Halter; Christopher P.,0,3,30,30
1714635572999,EDS 204R,B01,507331,Heinzman; Erica M.,16,0,30,14
1714635574026,EDS 206R,A00,507332,Staff,0,4,30,30
1714635574026,EDS 206R,B00,507343,Staff,17,0,30,13
1714635575052,EDS 250,A00,507344,Hemans; Patricia Ann Benitez,22,0,40,18
1714635576087,EDS 281,A00,507345,Daly; Alan J.,18,0,18,0
1714635577113,EDS 284,A00,507350,Daly; Alan J.,16,0,16,0
1714635578139,EDS 286,A00,507359,Fine; Sarah,18,0,18,0
1714635579170,EDS 289C,A01,507361,Daly; Alan J.,18,0,18,0
1714635580199,EDS 290,A00,507366,Hofstetter; Carolyn,15,0,15,0
1714635581255,LIGM 5A,A00,507421,Fischer-Grunski; Eva K,18,0,20,2
1714635582280,LIGM 5B,A00,507423,Fischer-Grunski; Eva K,19,0,20,1
1714635583311,LIGM 5C,A00,507425,Fischer-Grunski; Eva K,19,0,20,1
1714635584340,LIIT 5AS,A00,507427,Carnelos; Chiara,20,0,20,0
1714635585366,LIIT 5BS,A00,507430,Carnelos; Chiara,20,0,20,0
1714635586400,LIIT 5CS,A00,507432,Carnelos; Chiara,20,0,20,0
1714635587431,LISP 5A,A00,507541,Munoz Sanchez; Alicia,11,0,20,9
1714635588465,LISP 5B,A00,507671,Munoz Sanchez; Alicia,8,0,20,12
1714635589489,LISP 5C,A00,507696,Munoz Sanchez; Alicia,9,0,20,11
1714635590520,MAE 197,001,528363,Boechler; Nicholas Sebastia,9998,0,9999,1
1714635591553,MATH 197,001,523477,Kedlaya; Kiran S.,9995,0,9999,4
1714635591553,MATH 197,002,563811,Zhang; Danna,9995,0,9999,4
1714635591553,MATH 197,003,628552,Dumitriu; Ioana,9998,0,9999,1
1714635592587,MCWP 40R,A00,518780,Staff,2,0,20,18
1714635592587,MCWP 40R,B00,518781,Staff,8,0,20,12
1714635592587,MCWP 40R,C00,518783,Staff,6,0,20,14
1714635593619,MCWP 50R,A00,518791,Staff,0,0,20,20
1714635593619,MCWP 50R,B00,518792,Staff,0,2,20,20
1714635593619,MCWP 50R,C00,518793,Staff,0,2,20,20
1714635593619,MCWP 50R,D00,518794,Staff,0,0,20,20
1714635593619,MCWP 50R,E00,518795,Staff,0,2,20,20
1714635593619,MCWP 50R,F00,518796,Staff,0,0,20,20
1714635593619,MCWP 50R,G00,518797,Staff,0,1,20,20
1714635594648,MMW 12R,A01,514034,Herbst; Matthew,0,0,16,16
1714635594648,MMW 12R,A02,514035,Herbst; Matthew,1,0,16,15
1714635595676,MMW 13R,A01,514037,Staff,0,4,16,16
1714635595676,MMW 13R,A02,514039,Staff,0,2,16,16
1714635595676,MMW 13R,A03,628519,Staff,0,2,16,16
1714635597729,SIO 295LS,A00,523233,Staff,10,0,30,20
1714635598764,SIO 295S,A00,523232,Staff,10,0,30,20
1714635599793,SIOC 290S,A01,637330,Merrifield; Mark A,23,0,30,7
1714635600820,SIOC 291S,A01,637333,Gabriel; Corey John,23,0,30,7
1714635601850,SOCI 117,A01,494376,Staff,0,4,5,5
1714635602877,WES 237B,A00,494380,Staff,9,0,20,11
1714635604977,AESE 279B,A00,494370,Wade; Jon P,0,0,33,33
1714635606009,AIP 197,001,627712,Vespa; Emanuel Ignacio,9998,0,9999,1
1714635607036,ANAR 135S,A00,494369,Braswell; Geoffrey E.,0,0,0,0
1714635608063,BENG 196,001,628496,Engler; Adam J.,9998,0,9999,1
1714635609091,CAT 124RS,A01,519847,Geibel; William,0,0,20,20
1714635610116,CAT 125RS,A01,515971,Geibel; William,0,0,20,20
1714635611147,CLRE 250,A00,511389,Morris; Sheldon,9993,0,9999,6
1714635612181,CLRE 251,A00,507176,Mehta; Ravindra L.,9993,0,9999,6
1714635612181,CLRE 251,B00,511410,Mehta; Ravindra L.,9998,0,9999,1
1714635613211,CLRE 252,A00,507189,Cuomo; Raphael Eduardo,9995,0,9999,4
1714635614238,CLRE 253,A00,507199,Vaida; Florin,9994,0,9999,5
1714635614238,CLRE 253,B00,507202,Vaida; Florin,9999,0,9999,0
1714635615269,CLRE 259,A00,507211,Patel; Hemal,9996,0,9999,3
1714635616299,CLRE 260,A00,507221,Cuomo; Raphael Eduardo,9999,0,9999,0
1714635617325,CLRE 297,001,507242,Cuomo; Raphael Eduardo,9999,0,9999,0
1714635618353,COGS 197,001,638244,Voytek; Bradley Thomas,9998,0,9999,1
1714635619382,CSE 191,A00,516875,Minnes Kemp; Mor Mia,9992,0,9999,7
1714635620413,CSE 197,001,637388,Minnes Kemp; Mor Mia,9998,0,9999,1
1714635621440,CSS 201S,A01,494383,Staff,35,0,35,0
1714635622474,CSS 202S,A01,494387,Staff,35,0,35,0
1714635623503,DSC 197,001,628532,Eldridge; Justin Matthew,9996,0,9999,3
1714635624534,EAP 100,A00,516065,Staff,9797,0,9999,202
1714635625561,ECE 45,A01,507414,Staff,33,0,60,27
1714635627621,ECE 111,A01,507420,Staff,15,0,50,35
1714635628648,ECE 197,001,548057,Sievenpiper; Daniel F.,9993,0,9999,6
1714635629675,EDS 115,A00,507243,Choi; Bailey Miyeon,10,0,28,18
1714635630709,EDS 117,A01,494379,Staff,0,4,30,30
1714635631737,EDS 125,A00,507246,Hopkins; Megan Beth,9,0,30,21
1714635632767,EDS 128A,A01,507264,Fargason; Sharon Gayle,8,0,26,18
1714635633801,EDS 128B,A01,507293,Pappas; Elizabeth,12,0,30,18
1714635634831,EDS 139,A00,507294,Fargason; Sharon Gayle,13,0,30,17
1714635634831,EDS 139,B00,507313,Pappas; Elizabeth,13,0,30,17
1714635635857,EDS 201,A00,507315,Staff,13,0,30,17
1714635636882,EDS 203,A01,507317,Halter; Christopher P.,12,0,30,18
1714635637911,EDS 204R,A01,507319,Halter; Christopher P.,0,3,30,30
1714635637911,EDS 204R,B01,507331,Heinzman; Erica M.,16,0,30,14
1714635638942,EDS 206R,A00,507332,Staff,0,4,30,30
1714635638942,EDS 206R,B00,507343,Staff,17,0,30,13
1714635639967,EDS 250,A00,507344,Hemans; Patricia Ann Benitez,22,0,40,18
1714635640993,EDS 281,A00,507345,Daly; Alan J.,18,0,18,0
1714635642023,EDS 284,A00,507350,Daly; Alan J.,16,0,16,0
1714635643053,EDS 286,A00,507359,Fine; Sarah,18,0,18,0
1714635644079,EDS 289C,A01,507361,Daly; Alan J.,18,0,18,0
1714635645105,EDS 290,A00,507366,Hofstetter; Carolyn,15,0,15,0
1714635646139,LIGM 5A,A00,507421,Fischer-Grunski; Eva K,18,0,20,2
1714635647170,LIGM 5B,A00,507423,Fischer-Grunski; Eva K,19,0,20,1
1714635648196,LIGM 5C,A00,507425,Fischer-Grunski; Eva K,19,0,20,1
1714635649227,LIIT 5AS,A00,507427,Carnelos; Chiara,20,0,20,0
1714635650261,LIIT 5BS,A00,507430,Carnelos; Chiara,20,0,20,0
1714635651296,LIIT 5CS,A00,507432,Carnelos; Chiara,20,0,20,0
1714635652343,LISP 5A,A00,507541,Munoz Sanchez; Alicia,11,0,20,9
1714635653376,LISP 5B,A00,507671,Munoz Sanchez; Alicia,8,0,20,12
1714635654407,LISP 5C,A00,507696,Munoz Sanchez; Alicia,9,0,20,11
1714635655434,MAE 197,001,528363,Boechler; Nicholas Sebastia,9998,0,9999,1
1714635656471,MATH 197,001,523477,Kedlaya; Kiran S.,9995,0,9999,4
1714635656471,MATH 197,002,563811,Zhang; Danna,9995,0,9999,4
1714635656471,MATH 197,003,628552,Dumitriu; Ioana,9998,0,9999,1
1714635657502,MCWP 40R,A00,518780,Staff,2,0,20,18
1714635657502,MCWP 40R,B00,518781,Staff,8,0,20,12
1714635657502,MCWP 40R,C00,518783,Staff,6,0,20,14
1714635658530,MCWP 50R,A00,518791,Staff,0,0,20,20
1714635658530,MCWP 50R,B00,518792,Staff,0,2,20,20
1714635658530,MCWP 50R,C00,518793,Staff,0,2,20,20
1714635658530,MCWP 50R,D00,518794,Staff,0,0,20,20
1714635658530,MCWP 50R,E00,518795,Staff,0,2,20,20
1714635658530,MCWP 50R,F00,518796,Staff,0,0,20,20
1714635658530,MCWP 50R,G00,518797,Staff,0,1,20,20
1714635659562,MMW 12R,A01,514034,Herbst; Matthew,0,0,16,16
1714635659562,MMW 12R,A02,514035,Herbst; Matthew,1,0,16,15
1714635660593,MMW 13R,A01,514037,Staff,0,4,16,16
1714635660593,MMW 13R,A02,514039,Staff,0,2,16,16
1714635660593,MMW 13R,A03,628519,Staff,0,2,16,16
1714635662653,SIO 295LS,A00,523233,Staff,10,0,30,20
1714635663683,SIO 295S,A00,523232,Staff,10,0,30,20
1714635664709,SIOC 290S,A01,637330,Merrifield; Mark A,23,0,30,7
1714635665738,SIOC 291S,A01,637333,Gabriel; Corey John,23,0,30,7
1714635666765,SOCI 117,A01,494376,Staff,0,4,5,5
1714635667792,WES 237B,A00,494380,Staff,9,0,20,11
1714635669876,AESE 279B,A00,494370,Wade; Jon P,0,0,33,33
1714635670906,AIP 197,001,627712,Vespa; Emanuel Ignacio,9998,0,9999,1
1714635671931,ANAR 135S,A00,494369,Braswell; Geoffrey E.,0,0,0,0
1714635672962,BENG 196,001,628496,Engler; Adam J.,9998,0,9999,1
1714635673993,CAT 124RS,A01,519847,Geibel; William,0,0,20,20
1714635675019,CAT 125RS,A01,515971,Geibel; William,0,0,20,20
1714635676047,CLRE 250,A00,511389,Morris; Sheldon,9993,0,9999,6
1714635677081,CLRE 251,A00,507176,Mehta; Ravindra L.,9993,0,9999,6
1714635677081,CLRE 251,B00,511410,Mehta; Ravindra L.,9998,0,9999,1
1714635678110,CLRE 252,A00,507189,Cuomo; Raphael Eduardo,9995,0,9999,4
1714635679144,CLRE 253,A00,507199,Vaida; Florin,9994,0,9999,5
1714635679144,CLRE 253,B00,507202,Vaida; Florin,9999,0,9999,0
1714635680174,CLRE 259,A00,507211,Patel; Hemal,9996,0,9999,3
1714635681207,CLRE 260,A00,507221,Cuomo; Raphael Eduardo,9999,0,9999,0
1714635682234,CLRE 297,001,507242,Cuomo; Raphael Eduardo,9999,0,9999,0
1714635683263,COGS 197,001,638244,Voytek; Bradley Thomas,9998,0,9999,1
1714635684294,CSE 191,A00,516875,Minnes Kemp; Mor Mia,9992,0,9999,7
1714635685320,CSE 197,001,637388,Minnes Kemp; Mor Mia,9998,0,9999,1
1714635686348,CSS 201S,A01,494383,Staff,35,0,35,0
1714635687382,CSS 202S,A01,494387,Staff,35,0,35,0
1714635688412,DSC 197,001,628532,Eldridge; Justin Matthew,9996,0,9999,3
1714635689440,EAP 100,A00,516065,Staff,9797,0,9999,202
1714635690472,ECE 45,A01,507414,Staff,33,0,60,27
1714635692530,ECE 111,A01,507420,Staff,15,0,50,35
1714635693557,ECE 197,001,548057,Sievenpiper; Daniel F.,9993,0,9999,6
1714635694589,EDS 115,A00,507243,Choi; Bailey Miyeon,10,0,28,18
1714635695618,EDS 117,A01,494379,Staff,0,4,30,30
1714635696651,EDS 125,A00,507246,Hopkins; Megan Beth,9,0,30,21
1714635697677,EDS 128A,A01,507264,Fargason; Sharon Gayle,8,0,26,18
1714635698702,EDS 128B,A01,507293,Pappas; Elizabeth,12,0,30,18
1714635699728,EDS 139,A00,507294,Fargason; Sharon Gayle,13,0,30,17
1714635699728,EDS 139,B00,507313,Pappas; Elizabeth,13,0,30,17
1714635700758,EDS 201,A00,507315,Staff,13,0,30,17
1714635701788,EDS 203,A01,507317,Halter; Christopher P.,12,0,30,18
1714635702815,EDS 204R,A01,507319,Halter; Christopher P.,0,3,30,30
1714635702815,EDS 204R,B01,507331,Heinzman; Erica M.,16,0,30,14
1714635703866,EDS 206R,A00,507332,Staff,0,4,30,30
1714635703866,EDS 206R,B00,507343,Staff,17,0,30,13
1714635704995,EDS 250,A00,507344,Hemans; Patricia Ann Benitez,22,0,40,18
1714635706027,EDS 281,A00,507345,Daly; Alan J.,18,0,18,0
1714635707051,EDS 284,A00,507350,Daly; Alan J.,16,0,16,0
1714635708080,EDS 286,A00,507359,Fine; Sarah,18,0,18,0
1714635709106,EDS 289C,A01,507361,Daly; Alan J.,18,0,18,0
1714635710133,EDS 290,A00,507366,Hofstetter; Carolyn,15,0,15,0
1714635711161,LIGM 5A,A00,507421,Fischer-Grunski; Eva K,18,0,20,2
1714635712189,LIGM 5B,A00,507423,Fischer-Grunski; Eva K,19,0,20,1
1714635713215,LIGM 5C,A00,507425,Fischer-Grunski; Eva K,19,0,20,1
1714635714247,LIIT 5AS,A00,507427,Carnelos; Chiara,20,0,20,0
1714635715272,LIIT 5BS,A00,507430,Carnelos; Chiara,20,0,20,0
1714635716303,LIIT 5CS,A00,507432,Carnelos; Chiara,20,0,20,0
1714635717330,LISP 5A,A00,507541,Munoz Sanchez; Alicia,11,0,20,9
1714635718359,LISP 5B,A00,507671,Munoz Sanchez; Alicia,8,0,20,12
1714635719388,LISP 5C,A00,507696,Munoz Sanchez; Alicia,9,0,20,11
1714635720416,MAE 197,001,528363,Boechler; Nicholas Sebastia,9998,0,9999,1
1714635721450,MATH 197,001,523477,Kedlaya; Kiran S.,9995,0,9999,4
1714635721450,MATH 197,002,563811,Zhang; Danna,9995,0,9999,4
1714635721450,MATH 197,003,628552,Dumitriu; Ioana,9998,0,9999,1
1714635722485,MCWP 40R,A00,518780,Staff,2,0,20,18
1714635722485,MCWP 40R,B00,518781,Staff,8,0,20,12
1714635722485,MCWP 40R,C00,518783,Staff,6,0,20,14
1714635723510,MCWP 50R,A00,518791,Staff,0,0,20,20
1714635723510,MCWP 50R,B00,518792,Staff,0,2,20,20
1714635723510,MCWP 50R,C00,518793,Staff,0,2,20,20
1714635723510,MCWP 50R,D00,518794,Staff,0,0,20,20
1714635723510,MCWP 50R,E00,518795,Staff,0,2,20,20
1714635723510,MCWP 50R,F00,518796,Staff,0,0,20,20
1714635723510,MCWP 50R,G00,518797,Staff,0,1,20,20
1714635724544,MMW 12R,A01,514034,Herbst; Matthew,0,0,16,16
1714635724544,MMW 12R,A02,514035,Herbst; Matthew,1,0,16,15
1714635725575,MMW 13R,A01,514037,Staff,0,4,16,16
1714635725575,MMW 13R,A02,514039,Staff,0,2,16,16
1714635725575,MMW 13R,A03,628519,Staff,0,2,16,16
1714635727627,SIO 295LS,A00,523233,Staff,10,0,30,20
1714635728652,SIO 295S,A00,523232,Staff,10,0,30,20
1714635729685,SIOC 290S,A01,637330,Merrifield; Mark A,23,0,30,7
1714635730712,SIOC 291S,A01,637333,Gabriel; Corey John,23,0,30,7
1714635731759,SOCI 117,A01,494376,Staff,0,4,5,5
1714635732787,WES 237B,A00,494380,Staff,9,0,20,11
1714635734864,AESE 279B,A00,494370,Wade; Jon P,0,0,33,33
1714635735896,AIP 197,001,627712,Vespa; Emanuel Ignacio,9998,0,9999,1
1714635736923,ANAR 135S,A00,494369,Braswell; Geoffrey E.,0,0,0,0
1714635737951,BENG 196,001,628496,Engler; Adam J.,9998,0,9999,1
1714635738982,CAT 124RS,A01,519847,Geibel; William,0,0,20,20
1714635740017,CAT 125RS,A01,515971,Geibel; William,0,0,20,20
1714635741055,CLRE 250,A00,511389,Morris; Sheldon,9993,0,9999,6
1714635742142,CLRE 251,A00,507176,Mehta; Ravindra L.,9993,0,9999,6
1714635742142,CLRE 251,B00,511410,Mehta; Ravindra L.,9998,0,9999,1
1714635743176,CLRE 252,A00,507189,Cuomo; Raphael Eduardo,9995,0,9999,4
1714635744207,CLRE 253,A00,507199,Vaida; Florin,9994,0,9999,5
1714635744207,CLRE 253,B00,507202,Vaida; Florin,9999,0,9999,0
1714635745237,CLRE 259,A00,507211,Patel; Hemal,9996,0,9999,3
1714635746267,CLRE 260,A00,507221,Cuomo; Raphael Eduardo,9999,0,9999,0
1714635747295,CLRE 297,001,507242,Cuomo; Raphael Eduardo,9999,0,9999,0
1714635748322,COGS 197,001,638244,Voytek; Bradley Thomas,9998,0,9999,1
1714635749350,CSE 191,A00,516875,Minnes Kemp; Mor Mia,9992,0,9999,7
1714635750378,CSE 197,001,637388,Minnes Kemp; Mor Mia,9998,0,9999,1
1714635751406,CSS 201S,A01,494383,Staff,35,0,35,0
1714635752433,CSS 202S,A01,494387,Staff,35,0,35,0
1714635753463,DSC 197,001,628532,Eldridge; Justin Matthew,9996,0,9999,3
1714635754492,EAP 100,A00,516065,Staff,9797,0,9999,202
1714635755519,ECE 45,A01,507414,Staff,33,0,60,27
1714635757573,ECE 111,A01,507420,Staff,15,0,50,35
1714635758601,ECE 197,001,548057,Sievenpiper; Daniel F.,9993,0,9999,6
1714635759663,EDS 115,A00,507243,Choi; Bailey Miyeon,10,0,28,18
1714635760690,EDS 117,A01,494379,Staff,0,4,30,30
1714635761717,EDS 125,A00,507246,Hopkins; Megan Beth,9,0,30,21
1714635762743,EDS 128A,A01,507264,Fargason; Sharon Gayle,8,0,26,18
1714635763772,EDS 128B,A01,507293,Pappas; Elizabeth,12,0,30,18
1714635764796,EDS 139,A00,507294,Fargason; Sharon Gayle,13,0,30,17
1714635764796,EDS 139,B00,507313,Pappas; Elizabeth,13,0,30,17
1714635765821,EDS 201,A00,507315,Staff,13,0,30,17
1714635766852,EDS 203,A01,507317,Halter; Christopher P.,12,0,30,18
1714635767880,EDS 204R,A01,507319,Halter; Christopher P.,0,3,30,30
1714635767880,EDS 204R,B01,507331,Heinzman; Erica M.,16,0,30,14
1714635768908,EDS 206R,A00,507332,Staff,0,4,30,30
1714635768908,EDS 206R,B00,507343,Staff,17,0,30,13
1714635769942,EDS 250,A00,507344,Hemans; Patricia Ann Benitez,22,0,40,18
1714635770969,EDS 281,A00,507345,Daly; Alan J.,18,0,18,0
1714635771995,EDS 284,A00,507350,Daly; Alan J.,16,0,16,0
1714635773021,EDS 286,A00,507359,Fine; Sarah,18,0,18,0
1714635774047,EDS 289C,A01,507361,Daly; Alan J.,18,0,18,0
1714635775079,EDS 290,A00,507366,Hofstetter; Carolyn,15,0,15,0
1714635776110,LIGM 5A,A00,507421,Fischer-Grunski; Eva K,18,0,20,2
1714635777143,LIGM 5B,A00,507423,Fischer-Grunski; Eva K,19,0,20,1
1714635778171,LIGM 5C,A00,507425,Fischer-Grunski; Eva K,19,0,20,1
1714635779198,LIIT 5AS,A00,507427,Carnelos; Chiara,20,0,20,0
1714635780227,LIIT 5BS,A00,507430,Carnelos; Chiara,20,0,20,0
1714635781254,LIIT 5CS,A00,507432,Carnelos; Chiara,20,0,20,0
1714635782283,LISP 5A,A00,507541,Munoz Sanchez; Alicia,11,0,20,9
1714635783314,LISP 5B,A00,507671,Munoz Sanchez; Alicia,8,0,20,12
1714635784345,LISP 5C,A00,507696,Munoz Sanchez; Alicia,9,0,20,11
1714635785373,MAE 197,001,528363,Boechler; Nicholas Sebastia,9998,0,9999,1
1714635786402,MATH 197,001,523477,Kedlaya; Kiran S.,9995,0,9999,4
1714635786402,MATH 197,002,563811,Zhang; Danna,9995,0,9999,4
1714635786402,MATH 197,003,628552,Dumitriu; Ioana,9998,0,9999,1
1714635787426,MCWP 40R,A00,518780,Staff,2,0,20,18
1714635787426,MCWP 40R,B00,518781,Staff,8,0,20,12
1714635787426,MCWP 40R,C00,518783,Staff,6,0,20,14
1714635788461,MCWP 50R,A00,518791,Staff,0,0,20,20
1714635788461,MCWP 50R,B00,518792,Staff,0,2,20,20
1714635788461,MCWP 50R,C00,518793,Staff,0,2,20,20
1714635788461,MCWP 50R,D00,518794,Staff,0,0,20,20
1714635788461,MCWP 50R,E00,518795,Staff,0,2,20,20
1714635788461,MCWP 50R,F00,518796,Staff,0,0,20,20
1714635788461,MCWP 50R,G00,518797,Staff,0,1,20,20
1714635789489,MMW 12R,A01,514034,Herbst; Matthew,0,0,16,16
1714635789489,MMW 12R,A02,514035,Herbst; Matthew,1,0,16,15
1714635790518,MMW 13R,A01,514037,Staff,0,4,16,16
1714635790518,MMW 13R,A02,514039,Staff,0,2,16,16
1714635790518,MMW 13R,A03,628519,Staff,0,2,16,16
1714635792572,SIO 295LS,A00,523233,Staff,10,0,30,20
1714635793600,SIO 295S,A00,523232,Staff,10,0,30,20
1714635794645,SIOC 290S,A01,637330,Merrifield; Mark A,23,0,30,7
1714635795677,SIOC 291S,A01,637333,Gabriel; Corey John,23,0,30,7
1714635796705,SOCI 117,A01,494376,Staff,0,4,5,5
1714635797788,WES 237B,A00,494380,Staff,9,0,20,11
1714635799886,AESE 279B,A00,494370,Wade; Jon P,0,0,33,33
1714635800917,AIP 197,001,627712,Vespa; Emanuel Ignacio,9998,0,9999,1
1714635801945,ANAR 135S,A00,494369,Braswell; Geoffrey E.,0,0,0,0
1714635802972,BENG 196,001,628496,Engler; Adam J.,9998,0,9999,1
1714635804002,CAT 124RS,A01,519847,Geibel; William,0,0,20,20
1714635805031,CAT 125RS,A01,515971,Geibel; William,0,0,20,20
1714635806059,CLRE 250,A00,511389,Morris; Sheldon,9993,0,9999,6
1714635807089,CLRE 251,A00,507176,Mehta; Ravindra L.,9993,0,9999,6
1714635807089,CLRE 251,B00,511410,Mehta; Ravindra L.,9998,0,9999,1
1714635808116,CLRE 252,A00,507189,Cuomo; Raphael Eduardo,9995,0,9999,4
1714635809143,CLRE 253,A00,507199,Vaida; Florin,9994,0,9999,5
1714635809143,CLRE 253,B00,507202,Vaida; Florin,9999,0,9999,0
1714635810172,CLRE 259,A00,507211,Patel; Hemal,9996,0,9999,3
1714635811202,CLRE 260,A00,507221,Cuomo; Raphael Eduardo,9999,0,9999,0
1714635812226,CLRE 297,001,507242,Cuomo; Raphael Eduardo,9999,0,9999,0
1714635813254,COGS 197,001,638244,Voytek; Bradley Thomas,9998,0,9999,1
1714635814284,CSE 191,A00,516875,Minnes Kemp; Mor Mia,9992,0,9999,7
1714635815314,CSE 197,001,637388,Minnes Kemp; Mor Mia,9998,0,9999,1
1714635816344,CSS 201S,A01,494383,Staff,35,0,35,0
1714635817369,CSS 202S,A01,494387,Staff,35,0,35,0
1714635818394,DSC 197,001,628532,Eldridge; Justin Matthew,9996,0,9999,3
1714635819419,EAP 100,A00,516065,Staff,9797,0,9999,202
1714635820450,ECE 45,A01,507414,Staff,33,0,60,27
1714635822522,ECE 111,A01,507420,Staff,15,0,50,35
1714635823550,ECE 197,001,548057,Sievenpiper; Daniel F.,9993,0,9999,6
1714635824576,EDS 115,A00,507243,Choi; Bailey Miyeon,10,0,28,18
1714635825608,EDS 117,A01,494379,Staff,0,4,30,30
1714635826635,EDS 125,A00,507246,Hopkins; Megan Beth,9,0,30,21
1714635827668,EDS 128A,A01,507264,Fargason; Sharon Gayle,8,0,26,18
1714635828699,EDS 128B,A01,507293,Pappas; Elizabeth,12,0,30,18
1714635829726,EDS 139,A00,507294,Fargason; Sharon Gayle,13,0,30,17
1714635829726,EDS 139,B00,507313,Pappas; Elizabeth,13,0,30,17
1714635830751,EDS 201,A00,507315,Staff,13,0,30,17
1714635831804,EDS 203,A01,507317,Halter; Christopher P.,12,0,30,18
1714635832830,EDS 204R,A01,507319,Halter; Christopher P.,0,3,30,30
1714635832830,EDS 204R,B01,507331,Heinzman; Erica M.,16,0,30,14
1714635833855,EDS 206R,A00,507332,Staff,0,4,30,30
1714635833855,EDS 206R,B00,507343,Staff,17,0,30,13
1714635834882,EDS 250,A00,507344,Hemans; Patricia Ann Benitez,22,0,40,18
1714635835911,EDS 281,A00,507345,Daly; Alan J.,18,0,18,0
1714635836941,EDS 284,A00,507350,Daly; Alan J.,16,0,16,0
1714635837969,EDS 286,A00,507359,Fine; Sarah,18,0,18,0
1714635838994,EDS 289C,A01,507361,Daly; Alan J.,18,0,18,0
1714635840023,EDS 290,A00,507366,Hofstetter; Carolyn,15,0,15,0
1714635841060,LIGM 5A,A00,507421,Fischer-Grunski; Eva K,18,0,20,2
1714635842084,LIGM 5B,A00,507423,Fischer-Grunski; Eva K,19,0,20,1
1714635843113,LIGM 5C,A00,507425,Fischer-Grunski; Eva K,19,0,20,1
1714635844149,LIIT 5AS,A00,507427,Carnelos; Chiara,20,0,20,0
1714635845178,LIIT 5BS,A00,507430,Carnelos; Chiara,20,0,20,0
1714635846210,LIIT 5CS,A00,507432,Carnelos; Chiara,20,0,20,0
1714635847244,LISP 5A,A00,507541,Munoz Sanchez; Alicia,11,0,20,9
1714635848271,LISP 5B,A00,507671,Munoz Sanchez; Alicia,8,0,20,12
1714635849297,LISP 5C,A00,507696,Munoz Sanchez; Alicia,9,0,20,11
1714635850328,MAE 197,001,528363,Boechler; Nicholas Sebastia,9998,0,9999,1
1714635851358,MATH 197,001,523477,Kedlaya; Kiran S.,9995,0,9999,4
1714635851358,MATH 197,002,563811,Zhang; Danna,9995,0,9999,4
1714635851358,MATH 197,003,628552,Dumitriu; Ioana,9998,0,9999,1
1714635852385,MCWP 40R,A00,518780,Staff,2,0,20,18
1714635852385,MCWP 40R,B00,518781,Staff,8,0,20,12
1714635852385,MCWP 40R,C00,518783,Staff,6,0,20,14
1714635853419,MCWP 50R,A00,518791,Staff,0,0,20,20
1714635853419,MCWP 50R,B00,518792,Staff,0,2,20,20
1714635853419,MCWP 50R,C00,518793,Staff,0,2,20,20
1714635853419,MCWP 50R,D00,518794,Staff,0,0,20,20
1714635853419,MCWP 50R,E00,518795,Staff,0,2,20,20
1714635853419,MCWP 50R,F00,518796,Staff,0,0,20,20
1714635853419,MCWP 50R,G00,518797,Staff,0,1,20,20
1714635854444,MMW 12R,A01,514034,Herbst; Matthew,0,0,16,16
1714635854444,MMW 12R,A02,514035,Herbst; Matthew,1,0,16,15
1714635855473,MMW 13R,A01,514037,Staff,0,4,16,16
1714635855473,MMW 13R,A02,514039,Staff,0,2,16,16
1714635855473,MMW 13R,A03,628519,Staff,0,2,16,16
1714635857528,SIO 295LS,A00,523233,Staff,10,0,30,20
1714635858555,SIO 295S,A00,523232,Staff,10,0,30,20
1714635859583,SIOC 290S,A01,637330,Merrifield; Mark A,23,0,30,7
1714635860612,SIOC 291S,A01,637333,Gabriel; Corey John,23,0,30,7
1714635861639,SOCI 117,A01,494376,Staff,0,4,5,5
1714635862666,WES 237B,A00,494380,Staff,9,0,20,11
1714635864755,AESE 279B,A00,494370,Wade; Jon P,0,0,33,33
1714635865782,AIP 197,001,627712,Vespa; Emanuel Ignacio,9998,0,9999,1
1714635866811,ANAR 135S,A00,494369,Braswell; Geoffrey E.,0,0,0,0
1714635867841,BENG 196,001,628496,Engler; Adam J.,9998,0,9999,1
1714635868876,CAT 124RS,A01,519847,Geibel; William,0,0,20,20
1714635869901,CAT 125RS,A01,515971,Geibel; William,0,0,20,20
1714635870931,CLRE 250,A00,511389,Morris; Sheldon,9993,0,9999,6
1714635871965,CLRE 251,A00,507176,Mehta; Ravindra L.,9993,0,9999,6
1714635871965,CLRE 251,B00,511410,Mehta; Ravindra L.,9998,0,9999,1
1714635872990,CLRE 252,A00,507189,Cuomo; Raphael Eduardo,9995,0,9999,4
1714635874017,CLRE 253,A00,507199,Vaida; Florin,9994,0,9999,5
1714635874017,CLRE 253,B00,507202,Vaida; Florin,9999,0,9999,0
1714635875043,CLRE 259,A00,507211,Patel; Hemal,9996,0,9999,3
1714635876068,CLRE 260,A00,507221,Cuomo; Raphael Eduardo,9999,0,9999,0
1714635877095,CLRE 297,001,507242,Cuomo; Raphael Eduardo,9999,0,9999,0
1714635878123,COGS 197,001,638244,Voytek; Bradley Thomas,9998,0,9999,1
1714635879153,CSE 191,A00,516875,Minnes Kemp; Mor Mia,9992,0,9999,7
1714635880186,CSE 197,001,637388,Minnes Kemp; Mor Mia,9998,0,9999,1
1714635881219,CSS 201S,A01,494383,Staff,35,0,35,0
1714635882245,CSS 202S,A01,494387,Staff,35,0,35,0
1714635883274,DSC 197,001,628532,Eldridge; Justin Matthew,9996,0,9999,3
1714635884304,EAP 100,A00,516065,Staff,9797,0,9999,202
1714635885331,ECE 45,A01,507414,Staff,33,0,60,27
1714635887388,ECE 111,A01,507420,Staff,15,0,50,35
1714635888421,ECE 197,001,548057,Sievenpiper; Daniel F.,9993,0,9999,6
1714635889455,EDS 115,A00,507243,Choi; Bailey Miyeon,10,0,28,18
1714635890484,EDS 117,A01,494379,Staff,0,4,30,30
1714635891511,EDS 125,A00,507246,Hopkins; Megan Beth,9,0,30,21
1714635892541,EDS 128A,A01,507264,Fargason; Sharon Gayle,8,0,26,18
1714635893566,EDS 128B,A01,507293,Pappas; Elizabeth,12,0,30,18
1714635894592,EDS 139,A00,507294,Fargason; Sharon Gayle,13,0,30,17
1714635894592,EDS 139,B00,507313,Pappas; Elizabeth,13,0,30,17
1714635895669,EDS 201,A00,507315,Staff,13,0,30,17
1714635896701,EDS 203,A01,507317,Halter; Christopher P.,12,0,30,18
1714635897729,EDS 204R,A01,507319,Halter; Christopher P.,0,3,30,30
1714635897729,EDS 204R,B01,507331,Heinzman; Erica M.,16,0,30,14
1714635898768,EDS 206R,A00,507332,Staff,0,4,30,30
1714635898768,EDS 206R,B00,507343,Staff,17,0,30,13
1714635899797,EDS 250,A00,507344,Hemans; Patricia Ann Benitez,22,0,40,18
1714635900823,EDS 281,A00,507345,Daly; Alan J.,18,0,18,0
1714635901851,EDS 284,A00,507350,Daly; Alan J.,16,0,16,0
1714635902889,EDS 286,A00,507359,Fine; Sarah,18,0,18,0
1714635903919,EDS 289C,A01,507361,Daly; Alan J.,18,0,18,0
1714635904946,EDS 290,A00,507366,Hofstetter; Carolyn,15,0,15,0
1714635905973,LIGM 5A,A00,507421,Fischer-Grunski; Eva K,18,0,20,2
1714635907000,LIGM 5B,A00,507423,Fischer-Grunski; Eva K,19,0,20,1
1714635908026,LIGM 5C,A00,507425,Fischer-Grunski; Eva K,19,0,20,1
1714635909053,LIIT 5AS,A00,507427,Carnelos; Chiara,20,0,20,0
1714635910079,LIIT 5BS,A00,507430,Carnelos; Chiara,20,0,20,0
1714635911114,LIIT 5CS,A00,507432,Carnelos; Chiara,20,0,20,0
1714635912152,LISP 5A,A00,507541,Munoz Sanchez; Alicia,11,0,20,9
1714635913184,LISP 5B,A00,507671,Munoz Sanchez; Alicia,8,0,20,12
1714635914210,LISP 5C,A00,507696,Munoz Sanchez; Alicia,9,0,20,11
1714635915241,MAE 197,001,528363,Boechler; Nicholas Sebastia,9998,0,9999,1
1714635916275,MATH 197,001,523477,Kedlaya; Kiran S.,9995,0,9999,4
1714635916275,MATH 197,002,563811,Zhang; Danna,9995,0,9999,4
1714635916275,MATH 197,003,628552,Dumitriu; Ioana,9998,0,9999,1
1714635917303,MCWP 40R,A00,518780,Staff,2,0,20,18
1714635917303,MCWP 40R,B00,518781,Staff,8,0,20,12
1714635917303,MCWP 40R,C00,518783,Staff,6,0,20,14
1714635918330,MCWP 50R,A00,518791,Staff,0,0,20,20
1714635918330,MCWP 50R,B00,518792,Staff,0,2,20,20
1714635918330,MCWP 50R,C00,518793,Staff,0,2,20,20
1714635918330,MCWP 50R,D00,518794,Staff,0,0,20,20
1714635918330,MCWP 50R,E00,518795,Staff,0,2,20,20
1714635918330,MCWP 50R,F00,518796,Staff,0,0,20,20
1714635918330,MCWP 50R,G00,518797,Staff,0,1,20,20
1714635919358,MMW 12R,A01,514034,Herbst; Matthew,0,0,16,16
1714635919358,MMW 12R,A02,514035,Herbst; Matthew,1,0,16,15
1714635920383,MMW 13R,A01,514037,Staff,0,4,16,16
1714635920383,MMW 13R,A02,514039,Staff,0,2,16,16
1714635920383,MMW 13R,A03,628519,Staff,0,2,16,16
1714635922548,SIO 295LS,A00,523233,Staff,10,0,30,20
1714635923574,SIO 295S,A00,523232,Staff,10,0,30,20
1714635924601,SIOC 290S,A01,637330,Merrifield; Mark A,23,0,30,7
1714635925633,SIOC 291S,A01,637333,Gabriel; Corey John,23,0,30,7
1714635926667,SOCI 117,A01,494376,Staff,0,4,5,5
1714635927692,WES 237B,A00,494380,Staff,9,0,20,11
1714635929767,AESE 279B,A00,494370,Wade; Jon P,0,0,33,33
1714635930794,AIP 197,001,627712,Vespa; Emanuel Ignacio,9998,0,9999,1
1714635931825,ANAR 135S,A00,494369,Braswell; Geoffrey E.,0,0,0,0
1714635932849,BENG 196,001,628496,Engler; Adam J.,9998,0,9999,1
1714635933880,CAT 124RS,A01,519847,Geibel; William,0,0,20,20
1714635934911,CAT 125RS,A01,515971,Geibel; William,0,0,20,20
1714635935939,CLRE 250,A00,511389,Morris; Sheldon,9993,0,9999,6
1714635936979,CLRE 251,A00,507176,Mehta; Ravindra L.,9993,0,9999,6
1714635936979,CLRE 251,B00,511410,Mehta; Ravindra L.,9998,0,9999,1
1714635938010,CLRE 252,A00,507189,Cuomo; Raphael Eduardo,9995,0,9999,4
1714635939040,CLRE 253,A00,507199,Vaida; Florin,9994,0,9999,5
1714635939040,CLRE 253,B00,507202,Vaida; Florin,9999,0,9999,0
1714635940066,CLRE 259,A00,507211,Patel; Hemal,9996,0,9999,3
1714635941092,CLRE 260,A00,507221,Cuomo; Raphael Eduardo,9999,0,9999,0
1714635942121,CLRE 297,001,507242,Cuomo; Raphael Eduardo,9999,0,9999,0
1714635943148,COGS 197,001,638244,Voytek; Bradley Thomas,9998,0,9999,1
1714635944173,CSE 191,A00,516875,Minnes Kemp; Mor Mia,9992,0,9999,7
1714635945202,CSE 197,001,637388,Minnes Kemp; Mor Mia,9998,0,9999,1
1714635946233,CSS 201S,A01,494383,Staff,35,0,35,0
1714635947261,CSS 202S,A01,494387,Staff,35,0,35,0
1714635948290,DSC 197,001,628532,Eldridge; Justin Matthew,9996,0,9999,3
1714635949319,EAP 100,A00,516065,Staff,9797,0,9999,202
1714635950411,ECE 45,A01,507414,Staff,33,0,60,27
1714635952466,ECE 111,A01,507420,Staff,15,0,50,35
1714635953499,ECE 197,001,548057,Sievenpiper; Daniel F.,9993,0,9999,6
1714635954532,EDS 115,A00,507243,Choi; Bailey Miyeon,10,0,28,18
1714635955562,EDS 117,A01,494379,Staff,0,4,30,30
1714635956589,EDS 125,A00,507246,Hopkins; Megan Beth,9,0,30,21
1714635957626,EDS 128A,A01,507264,Fargason; Sharon Gayle,8,0,26,18
1714635958657,EDS 128B,A01,507293,Pappas; Elizabeth,12,0,30,18
1714635959686,EDS 139,A00,507294,Fargason; Sharon Gayle,13,0,30,17
1714635959686,EDS 139,B00,507313,Pappas; Elizabeth,13,0,30,17
1714635960715,EDS 201,A00,507315,Staff,13,0,30,17
1714635961746,EDS 203,A01,507317,Halter; Christopher P.,12,0,30,18
1714635962773,EDS 204R,A01,507319,Halter; Christopher P.,0,3,30,30
1714635962773,EDS 204R,B01,507331,Heinzman; Erica M.,16,0,30,14
1714635963806,EDS 206R,A00,507332,Staff,0,4,30,30
1714635963806,EDS 206R,B00,507343,Staff,17,0,30,13
1714635964836,EDS 250,A00,507344,Hemans; Patricia Ann Benitez,22,0,40,18
1714635965864,EDS 281,A00,507345,Daly; Alan J.,18,0,18,0
1714635966895,EDS 284,A00,507350,Daly; Alan J.,16,0,16,0
1714635967932,EDS 286,A00,507359,Fine; Sarah,18,0,18,0
1714635968962,EDS 289C,A01,507361,Daly; Alan J.,18,0,18,0
1714635969988,EDS 290,A00,507366,Hofstetter; Carolyn,15,0,15,0
1714635971017,LIGM 5A,A00,507421,Fischer-Grunski; Eva K,18,0,20,2
1714635972045,LIGM 5B,A00,507423,Fischer-Grunski; Eva K,19,0,20,1
1714635973075,LIGM 5C,A00,507425,Fischer-Grunski; Eva K,19,0,20,1
1714635974102,LIIT 5AS,A00,507427,Carnelos; Chiara,20,0,20,0
1714635975132,LIIT 5BS,A00,507430,Carnelos; Chiara,20,0,20,0
1714635976162,LIIT 5CS,A00,507432,Carnelos; Chiara,20,0,20,0
1714635977199,LISP 5A,A00,507541,Munoz Sanchez; Alicia,11,0,20,9
1714635978230,LISP 5B,A00,507671,Munoz Sanchez; Alicia,8,0,20,12
1714635979262,LISP 5C,A00,507696,Munoz Sanchez; Alicia,9,0,20,11
1714635980297,MAE 197,001,528363,Boechler; Nicholas Sebastia,9998,0,9999,1
1714635981325,MATH 197,001,523477,Kedlaya; Kiran S.,9995,0,9999,4
1714635981325,MATH 197,002,563811,Zhang; Danna,9995,0,9999,4
1714635981325,MATH 197,003,628552,Dumitriu; Ioana,9998,0,9999,1
1714635982356,MCWP 40R,A00,518780,Staff,2,0,20,18
1714635982356,MCWP 40R,B00,518781,Staff,8,0,20,12
1714635982356,MCWP 40R,C00,518783,Staff,6,0,20,14
1714635983384,MCWP 50R,A00,518791,Staff,0,0,20,20
1714635983384,MCWP 50R,B00,518792,Staff,0,2,20,20
1714635983384,MCWP 50R,C00,518793,Staff,0,2,20,20
1714635983384,MCWP 50R,D00,518794,Staff,0,0,20,20
1714635983384,MCWP 50R,E00,518795,Staff,0,2,20,20
1714635983384,MCWP 50R,F00,518796,Staff,0,0,20,20
1714635983384,MCWP 50R,G00,518797,Staff,0,1,20,20
1714635984410,MMW 12R,A01,514034,Herbst; Matthew,0,0,16,16
1714635984410,MMW 12R,A02,514035,Herbst; Matthew,1,0,16,15
1714635985439,MMW 13R,A01,514037,Staff,0,4,16,16
1714635985439,MMW 13R,A02,514039,Staff,0,2,16,16
1714635985439,MMW 13R,A03,628519,Staff,0,2,16,16
1714635987490,SIO 295LS,A00,523233,Staff,10,0,30,20
1714635988516,SIO 295S,A00,523232,Staff,10,0,30,20
1714635989545,SIOC 290S,A01,637330,Merrifield; Mark A,23,0,30,7
1714635990576,SIOC 291S,A01,637333,Gabriel; Corey John,23,0,30,7
1714635991605,SOCI 117,A01,494376,Staff,0,4,5,5
1714635992634,WES 237B,A00,494380,Staff,9,0,20,11
1714635994715,AESE 279B,A00,494370,Wade; Jon P,0,0,33,33
1714635995746,AIP 197,001,627712,Vespa; Emanuel Ignacio,9998,0,9999,1
1714635996779,ANAR 135S,A00,494369,Braswell; Geoffrey E.,0,0,0,0
1714635997810,BENG 196,001,628496,Engler; Adam J.,9998,0,9999,1
1714635998841,CAT 124RS,A01,519847,Geibel; William,0,0,20,20
1714635999867,CAT 125RS,A01,515971,Geibel; William,0,0,20,20
1714636000919,CLRE 250,A00,511389,Morris; Sheldon,9993,0,9999,6
1714636001952,CLRE 251,A00,507176,Mehta; Ravindra L.,9993,0,9999,6
1714636001952,CLRE 251,B00,511410,Mehta; Ravindra L.,9998,0,9999,1
1714636002978,CLRE 252,A00,507189,Cuomo; Raphael Eduardo,9995,0,9999,4
1714636004013,CLRE 253,A00,507199,Vaida; Florin,9994,0,9999,5
1714636004013,CLRE 253,B00,507202,Vaida; Florin,9999,0,9999,0
1714636005039,CLRE 259,A00,507211,Patel; Hemal,9996,0,9999,3
1714636006067,CLRE 260,A00,507221,Cuomo; Raphael Eduardo,9999,0,9999,0
1714636007093,CLRE 297,001,507242,Cuomo; Raphael Eduardo,9999,0,9999,0
1714636008121,COGS 197,001,638244,Voytek; Bradley Thomas,9998,0,9999,1
1714636009146,CSE 191,A00,516875,Minnes Kemp; Mor Mia,9992,0,9999,7
1714636010179,CSE 197,001,637388,Minnes Kemp; Mor Mia,9998,0,9999,1
1714636011206,CSS 201S,A01,494383,Staff,35,0,35,0
1714636012241,CSS 202S,A01,494387,Staff,35,0,35,0
1714636013266,DSC 197,001,628532,Eldridge; Justin Matthew,9996,0,9999,3
1714636014294,EAP 100,A00,516065,Staff,9797,0,9999,202
1714636015327,ECE 45,A01,507414,Staff,33,0,60,27
1714636017379,ECE 111,A01,507420,Staff,15,0,50,35
1714636018408,ECE 197,001,548057,Sievenpiper; Daniel F.,9993,0,9999,6
1714636019440,EDS 115,A00,507243,Choi; Bailey Miyeon,10,0,28,18
1714636020472,EDS 117,A01,494379,Staff,0,4,30,30
1714636021502,EDS 125,A00,507246,Hopkins; Megan Beth,9,0,30,21
1714636022530,EDS 128A,A01,507264,Fargason; Sharon Gayle,8,0,26,18
1714636023563,EDS 128B,A01,507293,Pappas; Elizabeth,12,0,30,18
1714636024601,EDS 139,A00,507294,Fargason; Sharon Gayle,13,0,30,17
1714636024601,EDS 139,B00,507313,Pappas; Elizabeth,13,0,30,17
1714636025627,EDS 201,A00,507315,Staff,13,0,30,17
1714636026653,EDS 203,A01,507317,Halter; Christopher P.,12,0,30,18
1714636027681,EDS 204R,A01,507319,Halter; Christopher P.,0,3,30,30
1714636027681,EDS 204R,B01,507331,Heinzman; Erica M.,16,0,30,14
1714636028711,EDS 206R,A00,507332,Staff,0,4,30,30
1714636028711,EDS 206R,B00,507343,Staff,17,0,30,13
1714636029743,EDS 250,A00,507344,Hemans; Patricia Ann Benitez,22,0,40,18
1714636030772,EDS 281,A00,507345,Daly; Alan J.,18,0,18,0
1714636031802,EDS 284,A00,507350,Daly; Alan J.,16,0,16,0
1714636032868,EDS 286,A00,507359,Fine; Sarah,18,0,18,0
1714636033895,EDS 289C,A01,507361,Daly; Alan J.,18,0,18,0
1714636034924,EDS 290,A00,507366,Hofstetter; Carolyn,15,0,15,0
1714636035971,LIGM 5A,A00,507421,Fischer-Grunski; Eva K,18,0,20,2
1714636036997,LIGM 5B,A00,507423,Fischer-Grunski; Eva K,19,0,20,1
1714636038022,LIGM 5C,A00,507425,Fischer-Grunski; Eva K,19,0,20,1
1714636039051,LIIT 5AS,A00,507427,Carnelos; Chiara,20,0,20,0
1714636040079,LIIT 5BS,A00,507430,Carnelos; Chiara,20,0,20,0
1714636041108,LIIT 5CS,A00,507432,Carnelos; Chiara,20,0,20,0
1714636042134,LISP 5A,A00,507541,Munoz Sanchez; Alicia,11,0,20,9
1714636043163,LISP 5B,A00,507671,Munoz Sanchez; Alicia,8,0,20,12
1714636044192,LISP 5C,A00,507696,Munoz Sanchez; Alicia,9,0,20,11
1714636045222,MAE 197,001,528363,Boechler; Nicholas Sebastia,9998,0,9999,1
1714636046309,MATH 197,001,523477,Kedlaya; Kiran S.,9995,0,9999,4
1714636046309,MATH 197,002,563811,Zhang; Danna,9995,0,9999,4
1714636046309,MATH 197,003,628552,Dumitriu; Ioana,9998,0,9999,1
1714636047340,MCWP 40R,A00,518780,Staff,2,0,20,18
1714636047340,MCWP 40R,B00,518781,Staff,8,0,20,12
1714636047340,MCWP 40R,C00,518783,Staff,6,0,20,14
1714636048371,MCWP 50R,A00,518791,Staff,0,0,20,20
1714636048371,MCWP 50R,B00,518792,Staff,0,2,20,20
1714636048371,MCWP 50R,C00,518793,Staff,0,2,20,20
1714636048371,MCWP 50R,D00,518794,Staff,0,0,20,20
1714636048371,MCWP 50R,E00,518795,Staff,0,2,20,20
1714636048371,MCWP 50R,F00,518796,Staff,0,0,20,20
1714636048371,MCWP 50R,G00,518797,Staff,0,1,20,20
1714636049401,MMW 12R,A01,514034,Herbst; Matthew,0,0,16,16
1714636049401,MMW 12R,A02,514035,Herbst; Matthew,1,0,16,15
1714636050455,MMW 13R,A01,514037,Staff,0,4,16,16
1714636050455,MMW 13R,A02,514039,Staff,0,2,16,16
1714636050455,MMW 13R,A03,628519,Staff,0,2,16,16
1714636052517,SIO 295LS,A00,523233,Staff,10,0,30,20
1714636053543,SIO 295S,A00,523232,Staff,10,0,30,20
1714636054571,SIOC 290S,A01,637330,Merrifield; Mark A,23,0,30,7
1714636055597,SIOC 291S,A01,637333,Gabriel; Corey John,23,0,30,7
1714636056622,SOCI 117,A01,494376,Staff,0,4,5,5
1714636057662,WES 237B,A00,494380,Staff,9,0,20,11
1714636059742,AESE 279B,A00,494370,Wade; Jon P,0,0,33,33
1714636060770,AIP 197,001,627712,Vespa; Emanuel Ignacio,9998,0,9999,1
1714636061807,ANAR 135S,A00,494369,Braswell; Geoffrey E.,0,0,0,0
1714636062837,BENG 196,001,628496,Engler; Adam J.,9998,0,9999,1
1714636063864,CAT 124RS,A01,519847,Geibel; William,0,0,20,20
1714636064891,CAT 125RS,A01,515971,Geibel; William,0,0,20,20
1714636065918,CLRE 250,A00,511389,Morris; Sheldon,9993,0,9999,6
1714636066959,CLRE 251,A00,507176,Mehta; Ravindra L.,9993,0,9999,6
1714636066959,CLRE 251,B00,511410,Mehta; Ravindra L.,9998,0,9999,1
1714636067992,CLRE 252,A00,507189,Cuomo; Raphael Eduardo,9995,0,9999,4
1714636069025,CLRE 253,A00,507199,Vaida; Florin,9994,0,9999,5
1714636069025,CLRE 253,B00,507202,Vaida; Florin,9999,0,9999,0
1714636070049,CLRE 259,A00,507211,Patel; Hemal,9996,0,9999,3
1714636071080,CLRE 260,A00,507221,Cuomo; Raphael Eduardo,9999,0,9999,0
1714636072105,CLRE 297,001,507242,Cuomo; Raphael Eduardo,9999,0,9999,0
1714636073134,COGS 197,001,638244,Voytek; Bradley Thomas,9998,0,9999,1
1714636074162,CSE 191,A00,516875,Minnes Kemp; Mor Mia,9992,0,9999,7
1714636075188,CSE 197,001,637388,Minnes Kemp; Mor Mia,9998,0,9999,1
1714636076220,CSS 201S,A01,494383,Staff,35,0,35,0
1714636077250,CSS 202S,A01,494387,Staff,35,0,35,0
1714636078281,DSC 197,001,628532,Eldridge; Justin Matthew,9996,0,9999,3
1714636079327,EAP 100,A00,516065,Staff,9797,0,9999,202
1714636080362,ECE 45,A01,507414,Staff,33,0,60,27
1714636082420,ECE 111,A01,507420,Staff,15,0,50,35
1714636083447,ECE 197,001,548057,Sievenpiper; Daniel F.,9993,0,9999,6
1714636084473,EDS 115,A00,507243,Choi; Bailey Miyeon,10,0,28,18
1714636085503,EDS 117,A01,494379,Staff,0,4,30,30
1714636086533,EDS 125,A00,507246,Hopkins; Megan Beth,9,0,30,21
1714636087562,EDS 128A,A01,507264,Fargason; Sharon Gayle,8,0,26,18
1714636088591,EDS 128B,A01,507293,Pappas; Elizabeth,12,0,30,18
1714636089616,EDS 139,A00,507294,Fargason; Sharon Gayle,13,0,30,17
1714636089616,EDS 139,B00,507313,Pappas; Elizabeth,13,0,30,17
1714636090639,EDS 201,A00,507315,Staff,13,0,30,17
1714636091677,EDS 203,A01,507317,Halter; Christopher P.,12,0,30,18
1714636092704,EDS 204R,A01,507319,Halter; Christopher P.,0,3,30,30
1714636092704,EDS 204R,B01,507331,Heinzman; Erica M.,16,0,30,14
1714636093733,EDS 206R,A00,507332,Staff,0,4,30,30
1714636093733,EDS 206R,B00,507343,Staff,17,0,30,13
1714636094757,EDS 250,A00,507344,Hemans; Patricia Ann Benitez,22,0,40,18
1714636095782,EDS 281,A00,507345,Daly; Alan J.,18,0,18,0
1714636096807,EDS 284,A00,507350,Daly; Alan J.,16,0,16,0
1714636097833,EDS 286,A00,507359,Fine; Sarah,18,0,18,0
1714636098857,EDS 289C,A01,507361,Daly; Alan J.,18,0,18,0
1714636099894,EDS 290,A00,507366,Hofstetter; Carolyn,15,0,15,0
1714636100925,LIGM 5A,A00,507421,Fischer-Grunski; Eva K,18,0,20,2
1714636101953,LIGM 5B,A00,507423,Fischer-Grunski; Eva K,19,0,20,1
1714636103009,LIGM 5C,A00,507425,Fischer-Grunski; Eva K,19,0,20,1
1714636104042,LIIT 5AS,A00,507427,Carnelos; Chiara,20,0,20,0
1714636105074,LIIT 5BS,A00,507430,Carnelos; Chiara,20,0,20,0
1714636106101,LIIT 5CS,A00,507432,Carnelos; Chiara,20,0,20,0
1714636107151,LISP 5A,A00,507541,Munoz Sanchez; Alicia,11,0,20,9
1714636108182,LISP 5B,A00,507671,Munoz Sanchez; Alicia,8,0,20,12
1714636109207,LISP 5C,A00,507696,Munoz Sanchez; Alicia,9,0,20,11
1714636110234,MAE 197,001,528363,Boechler; Nicholas Sebastia,9998,0,9999,1
1714636111264,MATH 197,001,523477,Kedlaya; Kiran S.,9995,0,9999,4
1714636111264,MATH 197,002,563811,Zhang; Danna,9995,0,9999,4
1714636111264,MATH 197,003,628552,Dumitriu; Ioana,9998,0,9999,1
1714636112288,MCWP 40R,A00,518780,Staff,2,0,20,18
1714636112288,MCWP 40R,B00,518781,Staff,8,0,20,12
1714636112288,MCWP 40R,C00,518783,Staff,6,0,20,14
1714636113348,MCWP 50R,A00,518791,Staff,0,0,20,20
1714636113348,MCWP 50R,B00,518792,Staff,0,2,20,20
1714636113348,MCWP 50R,C00,518793,Staff,0,2,20,20
1714636113348,MCWP 50R,D00,518794,Staff,0,0,20,20
1714636113348,MCWP 50R,E00,518795,Staff,0,2,20,20
1714636113348,MCWP 50R,F00,518796,Staff,0,0,20,20
1714636113348,MCWP 50R,G00,518797,Staff,0,1,20,20
1714636114376,MMW 12R,A01,514034,Herbst; Matthew,0,0,16,16
1714636114376,MMW 12R,A02,514035,Herbst; Matthew,1,0,16,15
1714636115409,MMW 13R,A01,514037,Staff,0,4,16,16
1714636115409,MMW 13R,A02,514039,Staff,0,2,16,16
1714636115409,MMW 13R,A03,628519,Staff,0,2,16,16
1714636117460,SIO 295LS,A00,523233,Staff,10,0,30,20
1714636118489,SIO 295S,A00,523232,Staff,10,0,30,20
1714636119523,SIOC 290S,A01,637330,Merrifield; Mark A,23,0,30,7
1714636120553,SIOC 291S,A01,637333,Gabriel; Corey John,23,0,30,7
1714636121581,SOCI 117,A01,494376,Staff,0,4,5,5
1714636122607,WES 237B,A00,494380,Staff,9,0,20,11
1714636124698,AESE 279B,A00,494370,Wade; Jon P,0,0,33,33
1714636125722,AIP 197,001,627712,Vespa; Emanuel Ignacio,9998,0,9999,1
1714636126752,ANAR 135S,A00,494369,Braswell; Geoffrey E.,0,0,0,0
1714636127783,BENG 196,001,628496,Engler; Adam J.,9998,0,9999,1
1714636128809,CAT 124RS,A01,519847,Geibel; William,0,0,20,20
1714636129835,CAT 125RS,A01,515971,Geibel; William,0,0,20,20
1714636130863,CLRE 250,A00,511389,Morris; Sheldon,9993,0,9999,6
1714636131893,CLRE 251,A00,507176,Mehta; Ravindra L.,9993,0,9999,6
1714636131893,CLRE 251,B00,511410,Mehta; Ravindra L.,9998,0,9999,1
1714636132925,CLRE 252,A00,507189,Cuomo; Raphael Eduardo,9995,0,9999,4
1714636133957,CLRE 253,A00,507199,Vaida; Florin,9994,0,9999,5
1714636133957,CLRE 253,B00,507202,Vaida; Florin,9999,0,9999,0
1714636134982,CLRE 259,A00,507211,Patel; Hemal,9996,0,9999,3
1714636136011,CLRE 260,A00,507221,Cuomo; Raphael Eduardo,9999,0,9999,0
1714636137094,CLRE 297,001,507242,Cuomo; Raphael Eduardo,9999,0,9999,0
1714636138124,COGS 197,001,638244,Voytek; Bradley Thomas,9998,0,9999,1
1714636139154,CSE 191,A00,516875,Minnes Kemp; Mor Mia,9992,0,9999,7
1714636140187,CSE 197,001,637388,Minnes Kemp; Mor Mia,9998,0,9999,1
1714636141224,CSS 201S,A01,494383,Staff,35,0,35,0
1714636142252,CSS 202S,A01,494387,Staff,35,0,35,0
1714636143285,DSC 197,001,628532,Eldridge; Justin Matthew,9996,0,9999,3
1714636144313,EAP 100,A00,516065,Staff,9797,0,9999,202
1714636145345,ECE 45,A01,507414,Staff,33,0,60,27
1714636147397,ECE 111,A01,507420,Staff,15,0,50,35
1714636148424,ECE 197,001,548057,Sievenpiper; Daniel F.,9993,0,9999,6
1714636149453,EDS 115,A00,507243,Choi; Bailey Miyeon,10,0,28,18
1714636150484,EDS 117,A01,494379,Staff,0,4,30,30
1714636151511,EDS 125,A00,507246,Hopkins; Megan Beth,9,0,30,21
1714636152542,EDS 128A,A01,507264,Fargason; Sharon Gayle,8,0,26,18
1714636153568,EDS 128B,A01,507293,Pappas; Elizabeth,12,0,30,18
1714636154595,EDS 139,A00,507294,Fargason; Sharon Gayle,13,0,30,17
1714636154595,EDS 139,B00,507313,Pappas; Elizabeth,13,0,30,17
1714636155622,EDS 201,A00,507315,Staff,13,0,30,17
1714636156647,EDS 203,A01,507317,Halter; Christopher P.,12,0,30,18
1714636157678,EDS 204R,A01,507319,Halter; Christopher P.,0,3,30,30
1714636157678,EDS 204R,B01,507331,Heinzman; Erica M.,16,0,30,14
1714636158702,EDS 206R,A00,507332,Staff,0,4,30,30
1714636158702,EDS 206R,B00,507343,Staff,17,0,30,13
1714636159730,EDS 250,A00,507344,Hemans; Patricia Ann Benitez,22,0,40,18
1714636160756,EDS 281,A00,507345,Daly; Alan J.,18,0,18,0
1714636161782,EDS 284,A00,507350,Daly; Alan J.,16,0,16,0
1714636162811,EDS 286,A00,507359,Fine; Sarah,18,0,18,0
1714636163837,EDS 289C,A01,507361,Daly; Alan J.,18,0,18,0
1714636164861,EDS 290,A00,507366,Hofstetter; Carolyn,15,0,15,0
1714636165891,LIGM 5A,A00,507421,Fischer-Grunski; Eva K,18,0,20,2
1714636166915,LIGM 5B,A00,507423,Fischer-Grunski; Eva K,19,0,20,1
1714636167941,LIGM 5C,A00,507425,Fischer-Grunski; Eva K,19,0,20,1
1714636168974,LIIT 5AS,A00,507427,Carnelos; Chiara,20,0,20,0
1714636169999,LIIT 5BS,A00,507430,Carnelos; Chiara,20,0,20,0
1714636171025,LIIT 5CS,A00,507432,Carnelos; Chiara,20,0,20,0
1714636172051,LISP 5A,A00,507541,Munoz Sanchez; Alicia,11,0,20,9
1714636173081,LISP 5B,A00,507671,Munoz Sanchez; Alicia,8,0,20,12
1714636174107,LISP 5C,A00,507696,Munoz Sanchez; Alicia,9,0,20,11
1714636175138,MAE 197,001,528363,Boechler; Nicholas Sebastia,9998,0,9999,1
1714636176173,MATH 197,001,523477,Kedlaya; Kiran S.,9995,0,9999,4
1714636176173,MATH 197,002,563811,Zhang; Danna,9995,0,9999,4
1714636176173,MATH 197,003,628552,Dumitriu; Ioana,9998,0,9999,1
1714636177205,MCWP 40R,A00,518780,Staff,2,0,20,18
1714636177205,MCWP 40R,B00,518781,Staff,8,0,20,12
1714636177205,MCWP 40R,C00,518783,Staff,6,0,20,14
1714636178237,MCWP 50R,A00,518791,Staff,0,0,20,20
1714636178237,MCWP 50R,B00,518792,Staff,0,2,20,20
1714636178237,MCWP 50R,C00,518793,Staff,0,2,20,20
1714636178237,MCWP 50R,D00,518794,Staff,0,0,20,20
1714636178237,MCWP 50R,E00,518795,Staff,0,2,20,20
1714636178237,MCWP 50R,F00,518796,Staff,0,0,20,20
1714636178237,MCWP 50R,G00,518797,Staff,0,1,20,20
1714636179263,MMW 12R,A01,514034,Herbst; Matthew,0,0,16,16
1714636179263,MMW 12R,A02,514035,Herbst; Matthew,1,0,16,15
1714636180294,MMW 13R,A01,514037,Staff,0,4,16,16
1714636180294,MMW 13R,A02,514039,Staff,0,2,16,16
1714636180294,MMW 13R,A03,628519,Staff,0,2,16,16
1714636182348,SIO 295LS,A00,523233,Staff,10,0,30,20
1714636183374,SIO 295S,A00,523232,Staff,10,0,30,20
1714636184405,SIOC 290S,A01,637330,Merrifield; Mark A,23,0,30,7
1714636185434,SIOC 291S,A01,637333,Gabriel; Corey John,23,0,30,7
1714636186462,SOCI 117,A01,494376,Staff,0,4,5,5
1714636187499,WES 237B,A00,494380,Staff,9,0,20,11
1714636189586,AESE 279B,A00,494370,Wade; Jon P,0,0,33,33
1714636190615,AIP 197,001,627712,Vespa; Emanuel Ignacio,9998,0,9999,1
1714636191641,ANAR 135S,A00,494369,Braswell; Geoffrey E.,0,0,0,0
1714636192666,BENG 196,001,628496,Engler; Adam J.,9998,0,9999,1
1714636193697,CAT 124RS,A01,519847,Geibel; William,0,0,20,20
1714636194728,CAT 125RS,A01,515971,Geibel; William,0,0,20,20
1714636195760,CLRE 250,A00,511389,Morris; Sheldon,9993,0,9999,6
1714636196797,CLRE 251,A00,507176,Mehta; Ravindra L.,9993,0,9999,6
1714636196797,CLRE 251,B00,511410,Mehta; Ravindra L.,9998,0,9999,1
1714636197825,CLRE 252,A00,507189,Cuomo; Raphael Eduardo,9995,0,9999,4
1714636198855,CLRE 253,A00,507199,Vaida; Florin,9994,0,9999,5
1714636198855,CLRE 253,B00,507202,Vaida; Florin,9999,0,9999,0
1714636199885,CLRE 259,A00,507211,Patel; Hemal,9996,0,9999,3
1714636200910,CLRE 260,A00,507221,Cuomo; Raphael Eduardo,9999,0,9999,0
1714636201938,CLRE 297,001,507242,Cuomo; Raphael Eduardo,9999,0,9999,0
1714636202968,COGS 197,001,638244,Voytek; Bradley Thomas,9998,0,9999,1
1714636203993,CSE 191,A00,516875,Minnes Kemp; Mor Mia,9992,0,9999,7
1714636205028,CSE 197,001,637388,Minnes Kemp; Mor Mia,9998,0,9999,1
1714636206059,CSS 201S,A01,494383,Staff,35,0,35,0
1714636207086,CSS 202S,A01,494387,Staff,35,0,35,0
1714636208111,DSC 197,001,628532,Eldridge; Justin Matthew,9996,0,9999,3
1714636209136,EAP 100,A00,516065,Staff,9797,0,9999,202
1714636210166,ECE 45,A01,507414,Staff,33,0,60,27
1714636212224,ECE 111,A01,507420,Staff,15,0,50,35
1714636213258,ECE 197,001,548057,Sievenpiper; Daniel F.,9993,0,9999,6
1714636214286,EDS 115,A00,507243,Choi; Bailey Miyeon,10,0,28,18
1714636215313,EDS 117,A01,494379,Staff,0,4,30,30
1714636216338,EDS 125,A00,507246,Hopkins; Megan Beth,9,0,30,21
1714636217364,EDS 128A,A01,507264,Fargason; Sharon Gayle,8,0,26,18
1714636218390,EDS 128B,A01,507293,Pappas; Elizabeth,12,0,30,18
1714636219417,EDS 139,A00,507294,Fargason; Sharon Gayle,13,0,30,17
1714636219417,EDS 139,B00,507313,Pappas; Elizabeth,13,0,30,17
1714636220442,EDS 201,A00,507315,Staff,13,0,30,17
1714636221470,EDS 203,A01,507317,Halter; Christopher P.,12,0,30,18
1714636222500,EDS 204R,A01,507319,Halter; Christopher P.,0,3,30,30
1714636222500,EDS 204R,B01,507331,Heinzman; Erica M.,16,0,30,14
1714636223534,EDS 206R,A00,507332,Staff,0,4,30,30
1714636223534,EDS 206R,B00,507343,Staff,17,0,30,13
1714636224577,EDS 250,A00,507344,Hemans; Patricia Ann Benitez,22,0,40,18
1714636225605,EDS 281,A00,507345,Daly; Alan J.,18,0,18,0
1714636226632,EDS 284,A00,507350,Daly; Alan J.,16,0,16,0
1714636227663,EDS 286,A00,507359,Fine; Sarah,18,0,18,0
1714636228688,EDS 289C,A01,507361,Daly; Alan J.,18,0,18,0
1714636229713,EDS 290,A00,507366,Hofstetter; Carolyn,15,0,15,0
1714636230746,LIGM 5A,A00,507421,Fischer-Grunski; Eva K,18,0,20,2
1714636231773,LIGM 5B,A00,507423,Fischer-Grunski; Eva K,19,0,20,1
1714636232803,LIGM 5C,A00,507425,Fischer-Grunski; Eva K,19,0,20,1
1714636233838,LIIT 5AS,A00,507427,Carnelos; Chiara,20,0,20,0
1714636234865,LIIT 5BS,A00,507430,Carnelos; Chiara,20,0,20,0
1714636235891,LIIT 5CS,A00,507432,Carnelos; Chiara,20,0,20,0
1714636236918,LISP 5A,A00,507541,Munoz Sanchez; Alicia,11,0,20,9
1714636237945,LISP 5B,A00,507671,Munoz Sanchez; Alicia,8,0,20,12
1714636238972,LISP 5C,A00,507696,Munoz Sanchez; Alicia,9,0,20,11
1714636239998,MAE 197,001,528363,Boechler; Nicholas Sebastia,9998,0,9999,1
1714636241026,MATH 197,001,523477,Kedlaya; Kiran S.,9995,0,9999,4
1714636241026,MATH 197,002,563811,Zhang; Danna,9995,0,9999,4
1714636241026,MATH 197,003,628552,Dumitriu; Ioana,9998,0,9999,1
1714636242053,MCWP 40R,A00,518780,Staff,2,0,20,18
1714636242053,MCWP 40R,B00,518781,Staff,8,0,20,12
1714636242053,MCWP 40R,C00,518783,Staff,6,0,20,14
1714636243085,MCWP 50R,A00,518791,Staff,0,0,20,20
1714636243085,MCWP 50R,B00,518792,Staff,0,2,20,20
1714636243085,MCWP 50R,C00,518793,Staff,0,2,20,20
1714636243085,MCWP 50R,D00,518794,Staff,0,0,20,20
1714636243085,MCWP 50R,E00,518795,Staff,0,2,20,20
1714636243085,MCWP 50R,F00,518796,Staff,0,0,20,20
1714636243085,MCWP 50R,G00,518797,Staff,0,1,20,20
1714636244110,MMW 12R,A01,514034,Herbst; Matthew,0,0,16,16
1714636244110,MMW 12R,A02,514035,Herbst; Matthew,1,0,16,15
1714636245136,MMW 13R,A01,514037,Staff,0,4,16,16
1714636245136,MMW 13R,A02,514039,Staff,0,2,16,16
1714636245136,MMW 13R,A03,628519,Staff,0,2,16,16
1714636247189,SIO 295LS,A00,523233,Staff,10,0,30,20
1714636248213,SIO 295S,A00,523232,Staff,10,0,30,20
1714636249245,SIOC 290S,A01,637330,Merrifield; Mark A,23,0,30,7
1714636250276,SIOC 291S,A01,637333,Gabriel; Corey John,23,0,30,7
1714636251304,SOCI 117,A01,494376,Staff,0,4,5,5
1714636252329,WES 237B,A00,494380,Staff,9,0,20,11
1714636254403,AESE 279B,A00,494370,Wade; Jon P,0,0,33,33
1714636255430,AIP 197,001,627712,Vespa; Emanuel Ignacio,9998,0,9999,1
1714636256460,ANAR 135S,A00,494369,Braswell; Geoffrey E.,0,0,0,0
1714636257488,BENG 196,001,628496,Engler; Adam J.,9998,0,9999,1
1714636258522,CAT 124RS,A01,519847,Geibel; William,0,0,20,20
1714636259548,CAT 125RS,A01,515971,Geibel; William,0,0,20,20
1714636260582,CLRE 250,A00,511389,Morris; Sheldon,9993,0,9999,6
1714636261611,CLRE 251,A00,507176,Mehta; Ravindra L.,9993,0,9999,6
1714636261611,CLRE 251,B00,511410,Mehta; Ravindra L.,9998,0,9999,1
1714636262638,CLRE 252,A00,507189,Cuomo; Raphael Eduardo,9995,0,9999,4
1714636263670,CLRE 253,A00,507199,Vaida; Florin,9994,0,9999,5
1714636263670,CLRE 253,B00,507202,Vaida; Florin,9999,0,9999,0
1714636264701,CLRE 259,A00,507211,Patel; Hemal,9996,0,9999,3
1714636265730,CLRE 260,A00,507221,Cuomo; Raphael Eduardo,9999,0,9999,0
1714636266758,CLRE 297,001,507242,Cuomo; Raphael Eduardo,9999,0,9999,0
1714636267788,COGS 197,001,638244,Voytek; Bradley Thomas,9998,0,9999,1
1714636268823,CSE 191,A00,516875,Minnes Kemp; Mor Mia,9992,0,9999,7
1714636269854,CSE 197,001,637388,Minnes Kemp; Mor Mia,9998,0,9999,1
1714636270887,CSS 201S,A01,494383,Staff,35,0,35,0
1714636271919,CSS 202S,A01,494387,Staff,35,0,35,0
1714636272947,DSC 197,001,628532,Eldridge; Justin Matthew,9996,0,9999,3
1714636273975,EAP 100,A00,516065,Staff,9797,0,9999,202
1714636275014,ECE 45,A01,507414,Staff,33,0,60,27
1714636277142,ECE 111,A01,507420,Staff,15,0,50,35
1714636278168,ECE 197,001,548057,Sievenpiper; Daniel F.,9993,0,9999,6
1714636279195,EDS 115,A00,507243,Choi; Bailey Miyeon,10,0,28,18
1714636280224,EDS 117,A01,494379,Staff,0,4,30,30
1714636281251,EDS 125,A00,507246,Hopkins; Megan Beth,9,0,30,21
1714636282277,EDS 128A,A01,507264,Fargason; Sharon Gayle,8,0,26,18
1714636283302,EDS 128B,A01,507293,Pappas; Elizabeth,12,0,30,18
1714636284332,EDS 139,A00,507294,Fargason; Sharon Gayle,13,0,30,17
1714636284332,EDS 139,B00,507313,Pappas; Elizabeth,13,0,30,17
1714636285365,EDS 201,A00,507315,Staff,13,0,30,17
1714636286400,EDS 203,A01,507317,Halter; Christopher P.,12,0,30,18
1714636287427,EDS 204R,A01,507319,Halter; Christopher P.,0,3,30,30
1714636287427,EDS 204R,B01,507331,Heinzman; Erica M.,16,0,30,14
1714636288453,EDS 206R,A00,507332,Staff,0,4,30,30
1714636288453,EDS 206R,B00,507343,Staff,17,0,30,13
1714636289483,EDS 250,A00,507344,Hemans; Patricia Ann Benitez,22,0,40,18
1714636290514,EDS 281,A00,507345,Daly; Alan J.,18,0,18,0
1714636291540,EDS 284,A00,507350,Daly; Alan J.,16,0,16,0
1714636292566,EDS 286,A00,507359,Fine; Sarah,18,0,18,0
1714636293593,EDS 289C,A01,507361,Daly; Alan J.,18,0,18,0
1714636294618,EDS 290,A00,507366,Hofstetter; Carolyn,15,0,15,0
1714636295646,LIGM 5A,A00,507421,Fischer-Grunski; Eva K,18,0,20,2
1714636296676,LIGM 5B,A00,507423,Fischer-Grunski; Eva K,19,0,20,1
1714636297706,LIGM 5C,A00,507425,Fischer-Grunski; Eva K,19,0,20,1
1714636298734,LIIT 5AS,A00,507427,Carnelos; Chiara,20,0,20,0
1714636299766,LIIT 5BS,A00,507430,Carnelos; Chiara,20,0,20,0
1714636300797,LIIT 5CS,A00,507432,Carnelos; Chiara,20,0,20,0
1714636301829,LISP 5A,A00,507541,Munoz Sanchez; Alicia,11,0,20,9
1714636302860,LISP 5B,A00,507671,Munoz Sanchez; Alicia,8,0,20,12
1714636303897,LISP 5C,A00,507696,Munoz Sanchez; Alicia,9,0,20,11
1714636304924,MAE 197,001,528363,Boechler; Nicholas Sebastia,9998,0,9999,1
1714636305953,MATH 197,001,523477,Kedlaya; Kiran S.,9995,0,9999,4
1714636305953,MATH 197,002,563811,Zhang; Danna,9995,0,9999,4
1714636305953,MATH 197,003,628552,Dumitriu; Ioana,9998,0,9999,1
1714636306979,MCWP 40R,A00,518780,Staff,2,0,20,18
1714636306979,MCWP 40R,B00,518781,Staff,8,0,20,12
1714636306979,MCWP 40R,C00,518783,Staff,6,0,20,14
1714636308007,MCWP 50R,A00,518791,Staff,0,0,20,20
1714636308007,MCWP 50R,B00,518792,Staff,0,2,20,20
1714636308007,MCWP 50R,C00,518793,Staff,0,2,20,20
1714636308007,MCWP 50R,D00,518794,Staff,0,0,20,20
1714636308007,MCWP 50R,E00,518795,Staff,0,2,20,20
1714636308007,MCWP 50R,F00,518796,Staff,0,0,20,20
1714636308007,MCWP 50R,G00,518797,Staff,0,1,20,20
1714636309035,MMW 12R,A01,514034,Herbst; Matthew,0,0,16,16
1714636309035,MMW 12R,A02,514035,Herbst; Matthew,1,0,16,15
1714636310061,MMW 13R,A01,514037,Staff,0,4,16,16
1714636310061,MMW 13R,A02,514039,Staff,0,2,16,16
1714636310061,MMW 13R,A03,628519,Staff,0,2,16,16
1714636312115,SIO 295LS,A00,523233,Staff,10,0,30,20
1714636313142,SIO 295S,A00,523232,Staff,10,0,30,20
1714636314177,SIOC 290S,A01,637330,Merrifield; Mark A,23,0,30,7
1714636315203,SIOC 291S,A01,637333,Gabriel; Corey John,23,0,30,7
1714636316230,SOCI 117,A01,494376,Staff,0,4,5,5
1714636317256,WES 237B,A00,494380,Staff,9,0,20,11
1714636319342,AESE 279B,A00,494370,Wade; Jon P,0,0,33,33
1714636320371,AIP 197,001,627712,Vespa; Emanuel Ignacio,9998,0,9999,1
1714636321397,ANAR 135S,A00,494369,Braswell; Geoffrey E.,0,0,0,0
1714636322426,BENG 196,001,628496,Engler; Adam J.,9998,0,9999,1
1714636323451,CAT 124RS,A01,519847,Geibel; William,0,0,20,20
1714636324477,CAT 125RS,A01,515971,Geibel; William,0,0,20,20
1714636325509,CLRE 250,A00,511389,Morris; Sheldon,9993,0,9999,6
1714636326542,CLRE 251,A00,507176,Mehta; Ravindra L.,9993,0,9999,6
1714636326542,CLRE 251,B00,511410,Mehta; Ravindra L.,9998,0,9999,1
1714636327573,CLRE 252,A00,507189,Cuomo; Raphael Eduardo,9995,0,9999,4
1714636328603,CLRE 253,A00,507199,Vaida; Florin,9994,0,9999,5
1714636328603,CLRE 253,B00,507202,Vaida; Florin,9999,0,9999,0
1714636329633,CLRE 259,A00,507211,Patel; Hemal,9996,0,9999,3
1714636330664,CLRE 260,A00,507221,Cuomo; Raphael Eduardo,9999,0,9999,0
1714636331690,CLRE 297,001,507242,Cuomo; Raphael Eduardo,9999,0,9999,0
1714636332722,COGS 197,001,638244,Voytek; Bradley Thomas,9998,0,9999,1
1714636333748,CSE 191,A00,516875,Minnes Kemp; Mor Mia,9992,0,9999,7
1714636334779,CSE 197,001,637388,Minnes Kemp; Mor Mia,9998,0,9999,1
1714636335813,CSS 201S,A01,494383,Staff,35,0,35,0
1714636336839,CSS 202S,A01,494387,Staff,35,0,35,0
1714636337868,DSC 197,001,628532,Eldridge; Justin Matthew,9996,0,9999,3
1714636338894,EAP 100,A00,516065,Staff,9797,0,9999,202
1714636339920,ECE 45,A01,507414,Staff,33,0,60,27
1714636341981,ECE 111,A01,507420,Staff,15,0,50,35
1714636343015,ECE 197,001,548057,Sievenpiper; Daniel F.,9993,0,9999,6
1714636344045,EDS 115,A00,507243,Choi; Bailey Miyeon,10,0,28,18
1714636345078,EDS 117,A01,494379,Staff,0,4,30,30
1714636346103,EDS 125,A00,507246,Hopkins; Megan Beth,9,0,30,21
1714636347128,EDS 128A,A01,507264,Fargason; Sharon Gayle,8,0,26,18
1714636348154,EDS 128B,A01,507293,Pappas; Elizabeth,12,0,30,18
1714636349180,EDS 139,A00,507294,Fargason; Sharon Gayle,13,0,30,17
1714636349180,EDS 139,B00,507313,Pappas; Elizabeth,13,0,30,17
1714636350205,EDS 201,A00,507315,Staff,13,0,30,17
1714636351233,EDS 203,A01,507317,Halter; Christopher P.,12,0,30,18
1714636352264,EDS 204R,A01,507319,Halter; Christopher P.,0,3,30,30
1714636352264,EDS 204R,B01,507331,Heinzman; Erica M.,16,0,30,14
1714636353289,EDS 206R,A00,507332,Staff,0,4,30,30
1714636353289,EDS 206R,B00,507343,Staff,17,0,30,13
1714636354316,EDS 250,A00,507344,Hemans; Patricia Ann Benitez,22,0,40,18
1714636355346,EDS 281,A00,507345,Daly; Alan J.,18,0,18,0
1714636356392,EDS 284,A00,507350,Daly; Alan J.,16,0,16,0
1714636357422,EDS 286,A00,507359,Fine; Sarah,18,0,18,0
1714636358447,EDS 289C,A01,507361,Daly; Alan J.,18,0,18,0
1714636359477,EDS 290,A00,507366,Hofstetter; Carolyn,15,0,15,0
1714636360504,LIGM 5A,A00,507421,Fischer-Grunski; Eva K,18,0,20,2
1714636361530,LIGM 5B,A00,507423,Fischer-Grunski; Eva K,19,0,20,1
1714636362561,LIGM 5C,A00,507425,Fischer-Grunski; Eva K,19,0,20,1
1714636363588,LIIT 5AS,A00,507427,Carnelos; Chiara,20,0,20,0
1714636364614,LIIT 5BS,A00,507430,Carnelos; Chiara,20,0,20,0
1714636365645,LIIT 5CS,A00,507432,Carnelos; Chiara,20,0,20,0
1714636366680,LISP 5A,A00,507541,Munoz Sanchez; Alicia,11,0,20,9
1714636367705,LISP 5B,A00,507671,Munoz Sanchez; Alicia,8,0,20,12
1714636368736,LISP 5C,A00,507696,Munoz Sanchez; Alicia,9,0,20,11
1714636369768,MAE 197,001,528363,Boechler; Nicholas Sebastia,9998,0,9999,1
1714636370797,MATH 197,001,523477,Kedlaya; Kiran S.,9995,0,9999,4
1714636370797,MATH 197,002,563811,Zhang; Danna,9995,0,9999,4
1714636370797,MATH 197,003,628552,Dumitriu; Ioana,9998,0,9999,1
1714636371824,MCWP 40R,A00,518780,Staff,2,0,20,18
1714636371824,MCWP 40R,B00,518781,Staff,8,0,20,12
1714636371824,MCWP 40R,C00,518783,Staff,6,0,20,14
1714636372859,MCWP 50R,A00,518791,Staff,0,0,20,20
1714636372859,MCWP 50R,B00,518792,Staff,0,2,20,20
1714636372859,MCWP 50R,C00,518793,Staff,0,2,20,20
1714636372859,MCWP 50R,D00,518794,Staff,0,0,20,20
1714636372859,MCWP 50R,E00,518795,Staff,0,2,20,20
1714636372859,MCWP 50R,F00,518796,Staff,0,0,20,20
1714636372859,MCWP 50R,G00,518797,Staff,0,1,20,20
1714636373896,MMW 12R,A01,514034,Herbst; Matthew,0,0,16,16
1714636373896,MMW 12R,A02,514035,Herbst; Matthew,1,0,16,15
1714636374926,MMW 13R,A01,514037,Staff,0,4,16,16
1714636374926,MMW 13R,A02,514039,Staff,0,2,16,16
1714636374926,MMW 13R,A03,628519,Staff,0,2,16,16
1714636376986,SIO 295LS,A00,523233,Staff,10,0,30,20
1714636378012,SIO 295S,A00,523232,Staff,10,0,30,20
1714636379047,SIOC 290S,A01,637330,Merrifield; Mark A,23,0,30,7
1714636380133,SIOC 291S,A01,637333,Gabriel; Corey John,23,0,30,7
1714636381159,SOCI 117,A01,494376,Staff,0,4,5,5
1714636382185,WES 237B,A00,494380,Staff,9,0,20,11
1714636384276,AESE 279B,A00,494370,Wade; Jon P,0,0,33,33
1714636385314,AIP 197,001,627712,Vespa; Emanuel Ignacio,9998,0,9999,1
1714636386351,ANAR 135S,A00,494369,Braswell; Geoffrey E.,0,0,0,0
1714636387383,BENG 196,001,628496,Engler; Adam J.,9998,0,9999,1
1714636388410,CAT 124RS,A01,519847,Geibel; William,0,0,20,20
1714636389435,CAT 125RS,A01,515971,Geibel; William,0,0,20,20
1714636390463,CLRE 250,A00,511389,Morris; Sheldon,9993,0,9999,6
1714636391491,CLRE 251,A00,507176,Mehta; Ravindra L.,9993,0,9999,6
1714636391491,CLRE 251,B00,511410,Mehta; Ravindra L.,9998,0,9999,1
1714636392522,CLRE 252,A00,507189,Cuomo; Raphael Eduardo,9995,0,9999,4
1714636393548,CLRE 253,A00,507199,Vaida; Florin,9994,0,9999,5
1714636393548,CLRE 253,B00,507202,Vaida; Florin,9999,0,9999,0
1714636394573,CLRE 259,A00,507211,Patel; Hemal,9996,0,9999,3
1714636395599,CLRE 260,A00,507221,Cuomo; Raphael Eduardo,9999,0,9999,0
1714636396625,CLRE 297,001,507242,Cuomo; Raphael Eduardo,9999,0,9999,0
1714636397651,COGS 197,001,638244,Voytek; Bradley Thomas,9998,0,9999,1
1714636398678,CSE 191,A00,516875,Minnes Kemp; Mor Mia,9992,0,9999,7
1714636399702,CSE 197,001,637388,Minnes Kemp; Mor Mia,9998,0,9999,1
1714636400732,CSS 201S,A01,494383,Staff,35,0,35,0
1714636401763,CSS 202S,A01,494387,Staff,35,0,35,0
1714636402790,DSC 197,001,628532,Eldridge; Justin Matthew,9996,0,9999,3
1714636403815,EAP 100,A00,516065,Staff,9797,0,9999,202
1714636404843,ECE 45,A01,507414,Staff,33,0,60,27
1714636406909,ECE 111,A01,507420,Staff,15,0,50,35
1714636407942,ECE 197,001,548057,Sievenpiper; Daniel F.,9993,0,9999,6
1714636408972,EDS 115,A00,507243,Choi; Bailey Miyeon,10,0,28,18
1714636409999,EDS 117,A01,494379,Staff,0,4,30,30
1714636411027,EDS 125,A00,507246,Hopkins; Megan Beth,9,0,30,21
1714636412053,EDS 128A,A01,507264,Fargason; Sharon Gayle,8,0,26,18
1714636413079,EDS 128B,A01,507293,Pappas; Elizabeth,12,0,30,18
1714636414107,EDS 139,A00,507294,Fargason; Sharon Gayle,13,0,30,17
1714636414107,EDS 139,B00,507313,Pappas; Elizabeth,13,0,30,17
1714636415136,EDS 201,A00,507315,Staff,13,0,30,17
1714636416168,EDS 203,A01,507317,Halter; Christopher P.,12,0,30,18
1714636417196,EDS 204R,A01,507319,Halter; Christopher P.,0,3,30,30
1714636417196,EDS 204R,B01,507331,Heinzman; Erica M.,16,0,30,14
1714636418223,EDS 206R,A00,507332,Staff,0,4,30,30
1714636418223,EDS 206R,B00,507343,Staff,17,0,30,13
1714636419255,EDS 250,A00,507344,Hemans; Patricia Ann Benitez,22,0,40,18
1714636420280,EDS 281,A00,507345,Daly; Alan J.,18,0,18,0
1714636421307,EDS 284,A00,507350,Daly; Alan J.,16,0,16,0
1714636422338,EDS 286,A00,507359,Fine; Sarah,18,0,18,0
1714636423369,EDS 289C,A01,507361,Daly; Alan J.,18,0,18,0
1714636424395,EDS 290,A00,507366,Hofstetter; Carolyn,15,0,15,0
1714636425423,LIGM 5A,A00,507421,Fischer-Grunski; Eva K,18,0,20,2
1714636426448,LIGM 5B,A00,507423,Fischer-Grunski; Eva K,19,0,20,1
1714636427474,LIGM 5C,A00,507425,Fischer-Grunski; Eva K,19,0,20,1
1714636428510,LIIT 5AS,A00,507427,Carnelos; Chiara,20,0,20,0
1714636429542,LIIT 5BS,A00,507430,Carnelos; Chiara,20,0,20,0
1714636430573,LIIT 5CS,A00,507432,Carnelos; Chiara,20,0,20,0
1714636431602,LISP 5A,A00,507541,Munoz Sanchez; Alicia,11,0,20,9
1714636432627,LISP 5B,A00,507671,Munoz Sanchez; Alicia,8,0,20,12
1714636433657,LISP 5C,A00,507696,Munoz Sanchez; Alicia,9,0,20,11
1714636434688,MAE 197,001,528363,Boechler; Nicholas Sebastia,9998,0,9999,1
1714636435726,MATH 197,001,523477,Kedlaya; Kiran S.,9995,0,9999,4
1714636435726,MATH 197,002,563811,Zhang; Danna,9995,0,9999,4
1714636435726,MATH 197,003,628552,Dumitriu; Ioana,9998,0,9999,1
1714636436756,MCWP 40R,A00,518780,Staff,2,0,20,18
1714636436756,MCWP 40R,B00,518781,Staff,8,0,20,12
1714636436756,MCWP 40R,C00,518783,Staff,6,0,20,14
1714636437790,MCWP 50R,A00,518791,Staff,0,0,20,20
1714636437790,MCWP 50R,B00,518792,Staff,0,2,20,20
1714636437790,MCWP 50R,C00,518793,Staff,0,2,20,20
1714636437790,MCWP 50R,D00,518794,Staff,0,0,20,20
1714636437790,MCWP 50R,E00,518795,Staff,0,2,20,20
1714636437790,MCWP 50R,F00,518796,Staff,0,0,20,20
1714636437790,MCWP 50R,G00,518797,Staff,0,1,20,20
1714636438817,MMW 12R,A01,514034,Herbst; Matthew,0,0,16,16
1714636438817,MMW 12R,A02,514035,Herbst; Matthew,1,0,16,15
1714636439848,MMW 13R,A01,514037,Staff,0,4,16,16
1714636439848,MMW 13R,A02,514039,Staff,0,2,16,16
1714636439848,MMW 13R,A03,628519,Staff,0,2,16,16
1714636441912,SIO 295LS,A00,523233,Staff,10,0,30,20
1714636442941,SIO 295S,A00,523232,Staff,10,0,30,20
1714636443969,SIOC 290S,A01,637330,Merrifield; Mark A,23,0,30,7
1714636445000,SIOC 291S,A01,637333,Gabriel; Corey John,23,0,30,7
1714636446037,SOCI 117,A01,494376,Staff,0,4,5,5
1714636447063,WES 237B,A00,494380,Staff,9,0,20,11
1714636449163,AESE 279B,A00,494370,Wade; Jon P,0,0,33,33
1714636450194,AIP 197,001,627712,Vespa; Emanuel Ignacio,9998,0,9999,1
1714636451223,ANAR 135S,A00,494369,Braswell; Geoffrey E.,0,0,0,0
1714636452249,BENG 196,001,628496,Engler; Adam J.,9998,0,9999,1
1714636453274,CAT 124RS,A01,519847,Geibel; William,0,0,20,20
1714636454299,CAT 125RS,A01,515971,Geibel; William,0,0,20,20
1714636455327,CLRE 250,A00,511389,Morris; Sheldon,9993,0,9999,6
1714636456361,CLRE 251,A00,507176,Mehta; Ravindra L.,9993,0,9999,6
1714636456361,CLRE 251,B00,511410,Mehta; Ravindra L.,9998,0,9999,1
1714636457390,CLRE 252,A00,507189,Cuomo; Raphael Eduardo,9995,0,9999,4
1714636458421,CLRE 253,A00,507199,Vaida; Florin,9994,0,9999,5
1714636458421,CLRE 253,B00,507202,Vaida; Florin,9999,0,9999,0
1714636459450,CLRE 259,A00,507211,Patel; Hemal,9996,0,9999,3
1714636460476,CLRE 260,A00,507221,Cuomo; Raphael Eduardo,9999,0,9999,0
1714636461504,CLRE 297,001,507242,Cuomo; Raphael Eduardo,9999,0,9999,0
1714636462539,COGS 197,001,638244,Voytek; Bradley Thomas,9998,0,9999,1
1714636463564,CSE 191,A00,516875,Minnes Kemp; Mor Mia,9992,0,9999,7
1714636464592,CSE 197,001,637388,Minnes Kemp; Mor Mia,9998,0,9999,1
1714636465620,CSS 201S,A01,494383,Staff,35,0,35,0
1714636466648,CSS 202S,A01,494387,Staff,35,0,35,0
1714636467672,DSC 197,001,628532,Eldridge; Justin Matthew,9996,0,9999,3
1714636468698,EAP 100,A00,516065,Staff,9797,0,9999,202
1714636469734,ECE 45,A01,507414,Staff,33,0,60,27
1714636471786,ECE 111,A01,507420,Staff,15,0,50,35
1714636472819,ECE 197,001,548057,Sievenpiper; Daniel F.,9993,0,9999,6
1714636473846,EDS 115,A00,507243,Choi; Bailey Miyeon,10,0,28,18
1714636474874,EDS 117,A01,494379,Staff,0,4,30,30
1714636475903,EDS 125,A00,507246,Hopkins; Megan Beth,9,0,30,21
1714636476930,EDS 128A,A01,507264,Fargason; Sharon Gayle,8,0,26,18
1714636477963,EDS 128B,A01,507293,Pappas; Elizabeth,12,0,30,18
1714636478989,EDS 139,A00,507294,Fargason; Sharon Gayle,13,0,30,17
1714636478989,EDS 139,B00,507313,Pappas; Elizabeth,13,0,30,17
1714636480016,EDS 201,A00,507315,Staff,13,0,30,17
1714636481042,EDS 203,A01,507317,Halter; Christopher P.,12,0,30,18
1714636482072,EDS 204R,A01,507319,Halter; Christopher P.,0,3,30,30
1714636482072,EDS 204R,B01,507331,Heinzman; Erica M.,16,0,30,14
1714636483099,EDS 206R,A00,507332,Staff,0,4,30,30
1714636483099,EDS 206R,B00,507343,Staff,17,0,30,13
1714636484182,EDS 250,A00,507344,Hemans; Patricia Ann Benitez,22,0,40,18
1714636485213,EDS 281,A00,507345,Daly; Alan J.,18,0,18,0
1714636486242,EDS 284,A00,507350,Daly; Alan J.,16,0,16,0
1714636487273,EDS 286,A00,507359,Fine; Sarah,18,0,18,0
1714636488298,EDS 289C,A01,507361,Daly; Alan J.,18,0,18,0
1714636489325,EDS 290,A00,507366,Hofstetter; Carolyn,15,0,15,0
1714636490360,LIGM 5A,A00,507421,Fischer-Grunski; Eva K,18,0,20,2
1714636491387,LIGM 5B,A00,507423,Fischer-Grunski; Eva K,19,0,20,1
1714636492414,LIGM 5C,A00,507425,Fischer-Grunski; Eva K,19,0,20,1
1714636493441,LIIT 5AS,A00,507427,Carnelos; Chiara,20,0,20,0
1714636494470,LIIT 5BS,A00,507430,Carnelos; Chiara,20,0,20,0
1714636495494,LIIT 5CS,A00,507432,Carnelos; Chiara,20,0,20,0
1714636496522,LISP 5A,A00,507541,Munoz Sanchez; Alicia,11,0,20,9
1714636497548,LISP 5B,A00,507671,Munoz Sanchez; Alicia,8,0,20,12
1714636498579,LISP 5C,A00,507696,Munoz Sanchez; Alicia,9,0,20,11
1714636499608,MAE 197,001,528363,Boechler; Nicholas Sebastia,9998,0,9999,1
1714636500646,MATH 197,001,523477,Kedlaya; Kiran S.,9995,0,9999,4
1714636500646,MATH 197,002,563811,Zhang; Danna,9995,0,9999,4
1714636500646,MATH 197,003,628552,Dumitriu; Ioana,9998,0,9999,1
1714636501674,MCWP 40R,A00,518780,Staff,2,0,20,18
1714636501674,MCWP 40R,B00,518781,Staff,8,0,20,12
1714636501674,MCWP 40R,C00,518783,Staff,6,0,20,14
1714636502705,MCWP 50R,A00,518791,Staff,0,0,20,20
1714636502705,MCWP 50R,B00,518792,Staff,0,2,20,20
1714636502705,MCWP 50R,C00,518793,Staff,0,2,20,20
1714636502705,MCWP 50R,D00,518794,Staff,0,0,20,20
1714636502705,MCWP 50R,E00,518795,Staff,0,2,20,20
1714636502705,MCWP 50R,F00,518796,Staff,0,0,20,20
1714636502705,MCWP 50R,G00,518797,Staff,0,1,20,20
1714636503736,MMW 12R,A01,514034,Herbst; Matthew,0,0,16,16
1714636503736,MMW 12R,A02,514035,Herbst; Matthew,1,0,16,15
1714636504763,MMW 13R,A01,514037,Staff,0,4,16,16
1714636504763,MMW 13R,A02,514039,Staff,0,2,16,16
1714636504763,MMW 13R,A03,628519,Staff,0,2,16,16
1714636506822,SIO 295LS,A00,523233,Staff,10,0,30,20
1714636507847,SIO 295S,A00,523232,Staff,10,0,30,20
1714636508876,SIOC 290S,A01,637330,Merrifield; Mark A,23,0,30,7
1714636509905,SIOC 291S,A01,637333,Gabriel; Corey John,23,0,30,7
1714636510934,SOCI 117,A01,494376,Staff,0,4,5,5
1714636511961,WES 237B,A00,494380,Staff,9,0,20,11
1714636514044,AESE 279B,A00,494370,Wade; Jon P,0,0,33,33
1714636515074,AIP 197,001,627712,Vespa; Emanuel Ignacio,9998,0,9999,1
1714636516105,ANAR 135S,A00,494369,Braswell; Geoffrey E.,0,0,0,0
1714636517138,BENG 196,001,628496,Engler; Adam J.,9998,0,9999,1
1714636518180,CAT 124RS,A01,519847,Geibel; William,0,0,20,20
1714636519206,CAT 125RS,A01,515971,Geibel; William,0,0,20,20
1714636520235,CLRE 250,A00,511389,Morris; Sheldon,9993,0,9999,6
1714636521264,CLRE 251,A00,507176,Mehta; Ravindra L.,9993,0,9999,6
1714636521264,CLRE 251,B00,511410,Mehta; Ravindra L.,9998,0,9999,1
1714636522302,CLRE 252,A00,507189,Cuomo; Raphael Eduardo,9995,0,9999,4
1714636523334,CLRE 253,A00,507199,Vaida; Florin,9994,0,9999,5
1714636523334,CLRE 253,B00,507202,Vaida; Florin,9999,0,9999,0
1714636524368,CLRE 259,A00,507211,Patel; Hemal,9996,0,9999,3
1714636525394,CLRE 260,A00,507221,Cuomo; Raphael Eduardo,9999,0,9999,0
1714636526418,CLRE 297,001,507242,Cuomo; Raphael Eduardo,9999,0,9999,0
1714636527449,COGS 197,001,638244,Voytek; Bradley Thomas,9998,0,9999,1
1714636528475,CSE 191,A00,516875,Minnes Kemp; Mor Mia,9992,0,9999,7
1714636529501,CSE 197,001,637388,Minnes Kemp; Mor Mia,9998,0,9999,1
1714636530529,CSS 201S,A01,494383,Staff,35,0,35,0
1714636531556,CSS 202S,A01,494387,Staff,35,0,35,0
1714636532581,DSC 197,001,628532,Eldridge; Justin Matthew,9996,0,9999,3
1714636533607,EAP 100,A00,516065,Staff,9797,0,9999,202
1714636534641,ECE 45,A01,507414,Staff,33,0,60,27
1714636536698,ECE 111,A01,507420,Staff,15,0,50,35
1714636537724,ECE 197,001,548057,Sievenpiper; Daniel F.,9993,0,9999,6
1714636538751,EDS 115,A00,507243,Choi; Bailey Miyeon,10,0,28,18
1714636539778,EDS 117,A01,494379,Staff,0,4,30,30
1714636540804,EDS 125,A00,507246,Hopkins; Megan Beth,9,0,30,21
1714636541832,EDS 128A,A01,507264,Fargason; Sharon Gayle,8,0,26,18
1714636542860,EDS 128B,A01,507293,Pappas; Elizabeth,12,0,30,18
1714636543891,EDS 139,A00,507294,Fargason; Sharon Gayle,13,0,30,17
1714636543891,EDS 139,B00,507313,Pappas; Elizabeth,13,0,30,17
1714636544915,EDS 201,A00,507315,Staff,13,0,30,17
1714636545945,EDS 203,A01,507317,Halter; Christopher P.,12,0,30,18
1714636546976,EDS 204R,A01,507319,Halter; Christopher P.,0,3,30,30
1714636546976,EDS 204R,B01,507331,Heinzman; Erica M.,16,0,30,14
1714636548030,EDS 206R,A00,507332,Staff,0,4,30,30
1714636548030,EDS 206R,B00,507343,Staff,17,0,30,13
1714636549056,EDS 250,A00,507344,Hemans; Patricia Ann Benitez,22,0,40,18
1714636550085,EDS 281,A00,507345,Daly; Alan J.,18,0,18,0
1714636551114,EDS 284,A00,507350,Daly; Alan J.,16,0,16,0
1714636552141,EDS 286,A00,507359,Fine; Sarah,18,0,18,0
1714636553170,EDS 289C,A01,507361,Daly; Alan J.,18,0,18,0
1714636554202,EDS 290,A00,507366,Hofstetter; Carolyn,15,0,15,0
1714636555283,LIGM 5A,A00,507421,Fischer-Grunski; Eva K,18,0,20,2
1714636556317,LIGM 5B,A00,507423,Fischer-Grunski; Eva K,19,0,20,1
1714636557342,LIGM 5C,A00,507425,Fischer-Grunski; Eva K,19,0,20,1
1714636558369,LIIT 5AS,A00,507427,Carnelos; Chiara,20,0,20,0
1714636559396,LIIT 5BS,A00,507430,Carnelos; Chiara,20,0,20,0
1714636560423,LIIT 5CS,A00,507432,Carnelos; Chiara,20,0,20,0
1714636561451,LISP 5A,A00,507541,Munoz Sanchez; Alicia,11,0,20,9
1714636562476,LISP 5B,A00,507671,Munoz Sanchez; Alicia,8,0,20,12
1714636563504,LISP 5C,A00,507696,Munoz Sanchez; Alicia,9,0,20,11
1714636564531,MAE 197,001,528363,Boechler; Nicholas Sebastia,9998,0,9999,1
1714636565560,MATH 197,001,523477,Kedlaya; Kiran S.,9995,0,9999,4
1714636565560,MATH 197,002,563811,Zhang; Danna,9995,0,9999,4
1714636565560,MATH 197,003,628552,Dumitriu; Ioana,9998,0,9999,1
1714636566600,MCWP 40R,A00,518780,Staff,2,0,20,18
1714636566600,MCWP 40R,B00,518781,Staff,8,0,20,12
1714636566600,MCWP 40R,C00,518783,Staff,6,0,20,14
1714636567625,MCWP 50R,A00,518791,Staff,0,0,20,20
1714636567625,MCWP 50R,B00,518792,Staff,0,2,20,20
1714636567625,MCWP 50R,C00,518793,Staff,0,2,20,20
1714636567625,MCWP 50R,D00,518794,Staff,0,0,20,20
1714636567625,MCWP 50R,E00,518795,Staff,0,2,20,20
1714636567625,MCWP 50R,F00,518796,Staff,0,0,20,20
1714636567625,MCWP 50R,G00,518797,Staff,0,1,20,20
1714636568655,MMW 12R,A01,514034,Herbst; Matthew,0,0,16,16
1714636568655,MMW 12R,A02,514035,Herbst; Matthew,1,0,16,15
1714636569686,MMW 13R,A01,514037,Staff,0,4,16,16
1714636569686,MMW 13R,A02,514039,Staff,0,2,16,16
1714636569686,MMW 13R,A03,628519,Staff,0,2,16,16
1714636571737,SIO 295LS,A00,523233,Staff,10,0,30,20
1714636572763,SIO 295S,A00,523232,Staff,10,0,30,20
1714636573791,SIOC 290S,A01,637330,Merrifield; Mark A,23,0,30,7
1714636574820,SIOC 291S,A01,637333,Gabriel; Corey John,23,0,30,7
1714636575858,SOCI 117,A01,494376,Staff,0,4,5,5
1714636576893,WES 237B,A00,494380,Staff,9,0,20,11
1714636578978,AESE 279B,A00,494370,Wade; Jon P,0,0,33,33
1714636580005,AIP 197,001,627712,Vespa; Emanuel Ignacio,9998,0,9999,1
1714636581037,ANAR 135S,A00,494369,Braswell; Geoffrey E.,0,0,0,0
1714636582066,BENG 196,001,628496,Engler; Adam J.,9998,0,9999,1
1714636583093,CAT 124RS,A01,519847,Geibel; William,0,0,20,20
1714636584126,CAT 125RS,A01,515971,Geibel; William,0,0,20,20
1714636585157,CLRE 250,A00,511389,Morris; Sheldon,9993,0,9999,6
1714636586191,CLRE 251,A00,507176,Mehta; Ravindra L.,9993,0,9999,6
1714636586191,CLRE 251,B00,511410,Mehta; Ravindra L.,9998,0,9999,1
1714636587226,CLRE 252,A00,507189,Cuomo; Raphael Eduardo,9995,0,9999,4
1714636588254,CLRE 253,A00,507199,Vaida; Florin,9994,0,9999,5
1714636588254,CLRE 253,B00,507202,Vaida; Florin,9999,0,9999,0
1714636589285,CLRE 259,A00,507211,Patel; Hemal,9996,0,9999,3
1714636590319,CLRE 260,A00,507221,Cuomo; Raphael Eduardo,9999,0,9999,0
1714636591344,CLRE 297,001,507242,Cuomo; Raphael Eduardo,9999,0,9999,0
1714636592375,COGS 197,001,638244,Voytek; Bradley Thomas,9998,0,9999,1
1714636593402,CSE 191,A00,516875,Minnes Kemp; Mor Mia,9992,0,9999,7
1714636594431,CSE 197,001,637388,Minnes Kemp; Mor Mia,9998,0,9999,1
1714636595464,CSS 201S,A01,494383,Staff,35,0,35,0
1714636596491,CSS 202S,A01,494387,Staff,35,0,35,0
1714636597521,DSC 197,001,628532,Eldridge; Justin Matthew,9996,0,9999,3
1714636598549,EAP 100,A00,516065,Staff,9797,0,9999,202
1714636599580,ECE 45,A01,507414,Staff,33,0,60,27
1714636601636,ECE 111,A01,507420,Staff,15,0,50,35
1714636602662,ECE 197,001,548057,Sievenpiper; Daniel F.,9993,0,9999,6
1714636603688,EDS 115,A00,507243,Choi; Bailey Miyeon,10,0,28,18
1714636604717,EDS 117,A01,494379,Staff,0,4,30,30
1714636605754,EDS 125,A00,507246,Hopkins; Megan Beth,9,0,30,21
1714636606789,EDS 128A,A01,507264,Fargason; Sharon Gayle,8,0,26,18
1714636607816,EDS 128B,A01,507293,Pappas; Elizabeth,12,0,30,18
1714636608844,EDS 139,A00,507294,Fargason; Sharon Gayle,13,0,30,17
1714636608844,EDS 139,B00,507313,Pappas; Elizabeth,13,0,30,17
1714636609871,EDS 201,A00,507315,Staff,13,0,30,17
1714636610904,EDS 203,A01,507317,Halter; Christopher P.,12,0,30,18
1714636611933,EDS 204R,A01,507319,Halter; Christopher P.,0,3,30,30
1714636611933,EDS 204R,B01,507331,Heinzman; Erica M.,16,0,30,14
1714636612960,EDS 206R,A00,507332,Staff,0,4,30,30
1714636612960,EDS 206R,B00,507343,Staff,17,0,30,13
1714636613989,EDS 250,A00,507344,Hemans; Patricia Ann Benitez,22,0,40,18
1714636615016,EDS 281,A00,507345,Daly; Alan J.,18,0,18,0
1714636616042,EDS 284,A00,507350,Daly; Alan J.,16,0,16,0
1714636617074,EDS 286,A00,507359,Fine; Sarah,18,0,18,0
1714636618100,EDS 289C,A01,507361,Daly; Alan J.,18,0,18,0
1714636619129,EDS 290,A00,507366,Hofstetter; Carolyn,15,0,15,0
1714636620171,LIGM 5A,A00,507421,Fischer-Grunski; Eva K,18,0,20,2
1714636621199,LIGM 5B,A00,507423,Fischer-Grunski; Eva K,19,0,20,1
1714636622228,LIGM 5C,A00,507425,Fischer-Grunski; Eva K,19,0,20,1
1714636623258,LIIT 5AS,A00,507427,Carnelos; Chiara,20,0,20,0
1714636624287,LIIT 5BS,A00,507430,Carnelos; Chiara,20,0,20,0
1714636625317,LIIT 5CS,A00,507432,Carnelos; Chiara,20,0,20,0
1714636626348,LISP 5A,A00,507541,Munoz Sanchez; Alicia,11,0,20,9
1714636627374,LISP 5B,A00,507671,Munoz Sanchez; Alicia,8,0,20,12
1714636628400,LISP 5C,A00,507696,Munoz Sanchez; Alicia,9,0,20,11
1714636629436,MAE 197,001,528363,Boechler; Nicholas Sebastia,9998,0,9999,1
1714636630474,MATH 197,001,523477,Kedlaya; Kiran S.,9995,0,9999,4
1714636630474,MATH 197,002,563811,Zhang; Danna,9995,0,9999,4
1714636630474,MATH 197,003,628552,Dumitriu; Ioana,9998,0,9999,1
1714636631501,MCWP 40R,A00,518780,Staff,2,0,20,18
1714636631501,MCWP 40R,B00,518781,Staff,8,0,20,12
1714636631501,MCWP 40R,C00,518783,Staff,6,0,20,14
1714636632527,MCWP 50R,A00,518791,Staff,0,0,20,20
1714636632527,MCWP 50R,B00,518792,Staff,0,2,20,20
1714636632527,MCWP 50R,C00,518793,Staff,0,2,20,20
1714636632527,MCWP 50R,D00,518794,Staff,0,0,20,20
1714636632527,MCWP 50R,E00,518795,Staff,0,2,20,20
1714636632527,MCWP 50R,F00,518796,Staff,0,0,20,20
1714636632527,MCWP 50R,G00,518797,Staff,0,1,20,20
1714636633560,MMW 12R,A01,514034,Herbst; Matthew,0,0,16,16
1714636633560,MMW 12R,A02,514035,Herbst; Matthew,1,0,16,15
1714636634586,MMW 13R,A01,514037,Staff,0,4,16,16
1714636634586,MMW 13R,A02,514039,Staff,0,2,16,16
1714636634586,MMW 13R,A03,628519,Staff,0,2,16,16
1714636636638,SIO 295LS,A00,523233,Staff,10,0,30,20
1714636637663,SIO 295S,A00,523232,Staff,10,0,30,20
1714636638695,SIOC 290S,A01,637330,Merrifield; Mark A,23,0,30,7
1714636639722,SIOC 291S,A01,637333,Gabriel; Corey John,23,0,30,7
1714636640751,SOCI 117,A01,494376,Staff,0,4,5,5
1714636641778,WES 237B,A00,494380,Staff,9,0,20,11
1714636643880,AESE 279B,A00,494370,Wade; Jon P,0,0,33,33
1714636644910,AIP 197,001,627712,Vespa; Emanuel Ignacio,9998,0,9999,1
1714636645934,ANAR 135S,A00,494369,Braswell; Geoffrey E.,0,0,0,0
1714636646960,BENG 196,001,628496,Engler; Adam J.,9998,0,9999,1
1714636647990,CAT 124RS,A01,519847,Geibel; William,0,0,20,20
1714636649019,CAT 125RS,A01,515971,Geibel; William,0,0,20,20
1714636650051,CLRE 250,A00,511389,Morris; Sheldon,9993,0,9999,6
1714636651088,CLRE 251,A00,507176,Mehta; Ravindra L.,9993,0,9999,6
1714636651088,CLRE 251,B00,511410,Mehta; Ravindra L.,9998,0,9999,1
1714636652116,CLRE 252,A00,507189,Cuomo; Raphael Eduardo,9995,0,9999,4
1714636653148,CLRE 253,A00,507199,Vaida; Florin,9994,0,9999,5
1714636653148,CLRE 253,B00,507202,Vaida; Florin,9999,0,9999,0
1714636654175,CLRE 259,A00,507211,Patel; Hemal,9996,0,9999,3
1714636655201,CLRE 260,A00,507221,Cuomo; Raphael Eduardo,9999,0,9999,0
1714636656230,CLRE 297,001,507242,Cuomo; Raphael Eduardo,9999,0,9999,0
1714636657260,COGS 197,001,638244,Voytek; Bradley Thomas,9998,0,9999,1
1714636658345,CSE 191,A00,516875,Minnes Kemp; Mor Mia,9992,0,9999,7
1714636659372,CSE 197,001,637388,Minnes Kemp; Mor Mia,9998,0,9999,1
1714636660399,CSS 201S,A01,494383,Staff,35,0,35,0
1714636661426,CSS 202S,A01,494387,Staff,35,0,35,0
1714636662452,DSC 197,001,628532,Eldridge; Justin Matthew,9996,0,9999,3
1714636663479,EAP 100,A00,516065,Staff,9797,0,9999,202
1714636664506,ECE 45,A01,507414,Staff,33,0,60,27
1714636666560,ECE 111,A01,507420,Staff,15,0,50,35
1714636667592,ECE 197,001,548057,Sievenpiper; Daniel F.,9993,0,9999,6
1714636668620,EDS 115,A00,507243,Choi; Bailey Miyeon,10,0,28,18
1714636669648,EDS 117,A01,494379,Staff,0,4,30,30
1714636670680,EDS 125,A00,507246,Hopkins; Megan Beth,9,0,30,21
1714636671706,EDS 128A,A01,507264,Fargason; Sharon Gayle,8,0,26,18
1714636672735,EDS 128B,A01,507293,Pappas; Elizabeth,12,0,30,18
1714636673760,EDS 139,A00,507294,Fargason; Sharon Gayle,13,0,30,17
1714636673760,EDS 139,B00,507313,Pappas; Elizabeth,13,0,30,17
1714636674790,EDS 201,A00,507315,Staff,13,0,30,17
1714636675823,EDS 203,A01,507317,Halter; Christopher P.,12,0,30,18
1714636676849,EDS 204R,A01,507319,Halter; Christopher P.,0,3,30,30
1714636676849,EDS 204R,B01,507331,Heinzman; Erica M.,16,0,30,14
1714636677875,EDS 206R,A00,507332,Staff,0,4,30,30
1714636677875,EDS 206R,B00,507343,Staff,17,0,30,13
1714636678900,EDS 250,A00,507344,Hemans; Patricia Ann Benitez,22,0,40,18
1714636679929,EDS 281,A00,507345,Daly; Alan J.,18,0,18,0
1714636680956,EDS 284,A00,507350,Daly; Alan J.,16,0,16,0
1714636681992,EDS 286,A00,507359,Fine; Sarah,18,0,18,0
1714636683072,EDS 289C,A01,507361,Daly; Alan J.,18,0,18,0
1714636684098,EDS 290,A00,507366,Hofstetter; Carolyn,15,0,15,0
1714636685130,LIGM 5A,A00,507421,Fischer-Grunski; Eva K,18,0,20,2
1714636686160,LIGM 5B,A00,507423,Fischer-Grunski; Eva K,19,0,20,1
1714636687394,LIGM 5C,A00,507425,Fischer-Grunski; Eva K,19,0,20,1
1714636688421,LIIT 5AS,A00,507427,Carnelos; Chiara,20,0,20,0
1714636689454,LIIT 5BS,A00,507430,Carnelos; Chiara,20,0,20,0
1714636690481,LIIT 5CS,A00,507432,Carnelos; Chiara,20,0,20,0
1714636691513,LISP 5A,A00,507541,Munoz Sanchez; Alicia,11,0,20,9
1714636692540,LISP 5B,A00,507671,Munoz Sanchez; Alicia,8,0,20,12
1714636693567,LISP 5C,A00,507696,Munoz Sanchez; Alicia,9,0,20,11
1714636694598,MAE 197,001,528363,Boechler; Nicholas Sebastia,9998,0,9999,1
1714636695632,MATH 197,001,523477,Kedlaya; Kiran S.,9995,0,9999,4
1714636695632,MATH 197,002,563811,Zhang; Danna,9995,0,9999,4
1714636695632,MATH 197,003,628552,Dumitriu; Ioana,9998,0,9999,1
1714636696663,MCWP 40R,A00,518780,Staff,2,0,20,18
1714636696663,MCWP 40R,B00,518781,Staff,8,0,20,12
1714636696663,MCWP 40R,C00,518783,Staff,6,0,20,14
1714636697691,MCWP 50R,A00,518791,Staff,0,0,20,20
1714636697691,MCWP 50R,B00,518792,Staff,0,2,20,20
1714636697691,MCWP 50R,C00,518793,Staff,0,2,20,20
1714636697691,MCWP 50R,D00,518794,Staff,0,0,20,20
1714636697691,MCWP 50R,E00,518795,Staff,0,2,20,20
1714636697691,MCWP 50R,F00,518796,Staff,0,0,20,20
1714636697691,MCWP 50R,G00,518797,Staff,0,1,20,20
1714636698748,MMW 12R,A01,514034,Herbst; Matthew,0,0,16,16
1714636698748,MMW 12R,A02,514035,Herbst; Matthew,1,0,16,15
1714636699773,MMW 13R,A01,514037,Staff,0,4,16,16
1714636699773,MMW 13R,A02,514039,Staff,0,2,16,16
1714636699773,MMW 13R,A03,628519,Staff,0,2,16,16
1714636701833,SIO 295LS,A00,523233,Staff,10,0,30,20
1714636702857,SIO 295S,A00,523232,Staff,10,0,30,20
1714636703897,SIOC 290S,A01,637330,Merrifield; Mark A,23,0,30,7
1714636704922,SIOC 291S,A01,637333,Gabriel; Corey John,23,0,30,7
1714636705951,SOCI 117,A01,494376,Staff,0,4,5,5
1714636706980,WES 237B,A00,494380,Staff,9,0,20,11
1714636709067,AESE 279B,A00,494370,Wade; Jon P,0,0,33,33
1714636710095,AIP 197,001,627712,Vespa; Emanuel Ignacio,9998,0,9999,1
1714636711125,ANAR 135S,A00,494369,Braswell; Geoffrey E.,0,0,0,0
1714636712153,BENG 196,001,628496,Engler; Adam J.,9998,0,9999,1
1714636713197,CAT 124RS,A01,519847,Geibel; William,0,0,20,20
1714636714226,CAT 125RS,A01,515971,Geibel; William,0,0,20,20
1714636715258,CLRE 250,A00,511389,Morris; Sheldon,9993,0,9999,6
1714636716292,CLRE 251,A00,507176,Mehta; Ravindra L.,9993,0,9999,6
1714636716292,CLRE 251,B00,511410,Mehta; Ravindra L.,9998,0,9999,1
1714636717318,CLRE 252,A00,507189,Cuomo; Raphael Eduardo,9995,0,9999,4
1714636718345,CLRE 253,A00,507199,Vaida; Florin,9994,0,9999,5
1714636718345,CLRE 253,B00,507202,Vaida; Florin,9999,0,9999,0
1714636719377,CLRE 259,A00,507211,Patel; Hemal,9996,0,9999,3
1714636720401,CLRE 260,A00,507221,Cuomo; Raphael Eduardo,9999,0,9999,0
1714636721429,CLRE 297,001,507242,Cuomo; Raphael Eduardo,9999,0,9999,0
1714636722458,COGS 197,001,638244,Voytek; Bradley Thomas,9998,0,9999,1
1714636723484,CSE 191,A00,516875,Minnes Kemp; Mor Mia,9992,0,9999,7
1714636724510,CSE 197,001,637388,Minnes Kemp; Mor Mia,9998,0,9999,1
1714636725537,CSS 201S,A01,494383,Staff,35,0,35,0
1714636726566,CSS 202S,A01,494387,Staff,35,0,35,0
1714636727592,DSC 197,001,628532,Eldridge; Justin Matthew,9996,0,9999,3
1714636728671,EAP 100,A00,516065,Staff,9797,0,9999,202
1714636729696,ECE 45,A01,507414,Staff,33,0,60,27
1714636731746,ECE 111,A01,507420,Staff,15,0,50,35
1714636732776,ECE 197,001,548057,Sievenpiper; Daniel F.,9993,0,9999,6
1714636733804,EDS 115,A00,507243,Choi; Bailey Miyeon,10,0,28,18
1714636734831,EDS 117,A01,494379,Staff,0,4,30,30
1714636735860,EDS 125,A00,507246,Hopkins; Megan Beth,9,0,30,21
1714636736888,EDS 128A,A01,507264,Fargason; Sharon Gayle,8,0,26,18
1714636737914,EDS 128B,A01,507293,Pappas; Elizabeth,12,0,30,18
1714636738943,EDS 139,A00,507294,Fargason; Sharon Gayle,13,0,30,17
1714636738943,EDS 139,B00,507313,Pappas; Elizabeth,13,0,30,17
1714636739970,EDS 201,A00,507315,Staff,13,0,30,17
1714636740996,EDS 203,A01,507317,Halter; Christopher P.,12,0,30,18
1714636742023,EDS 204R,A01,507319,Halter; Christopher P.,0,3,30,30
1714636742023,EDS 204R,B01,507331,Heinzman; Erica M.,16,0,30,14
1714636743050,EDS 206R,A00,507332,Staff,0,4,30,30
1714636743050,EDS 206R,B00,507343,Staff,17,0,30,13
1714636744076,EDS 250,A00,507344,Hemans; Patricia Ann Benitez,22,0,40,18
1714636745104,EDS 281,A00,507345,Daly; Alan J.,18,0,18,0
1714636746130,EDS 284,A00,507350,Daly; Alan J.,16,0,16,0
1714636747158,EDS 286,A00,507359,Fine; Sarah,18,0,18,0
1714636748183,EDS 289C,A01,507361,Daly; Alan J.,18,0,18,0
1714636749211,EDS 290,A00,507366,Hofstetter; Carolyn,15,0,15,0
1714636750237,LIGM 5A,A00,507421,Fischer-Grunski; Eva K,18,0,20,2
1714636751266,LIGM 5B,A00,507423,Fischer-Grunski; Eva K,19,0,20,1
1714636752297,LIGM 5C,A00,507425,Fischer-Grunski; Eva K,19,0,20,1
1714636753327,LIIT 5AS,A00,507427,Carnelos; Chiara,20,0,20,0
1714636754353,LIIT 5BS,A00,507430,Carnelos; Chiara,20,0,20,0
1714636755379,LIIT 5CS,A00,507432,Carnelos; Chiara,20,0,20,0
1714636756407,LISP 5A,A00,507541,Munoz Sanchez; Alicia,11,0,20,9
1714636757438,LISP 5B,A00,507671,Munoz Sanchez; Alicia,8,0,20,12
1714636758462,LISP 5C,A00,507696,Munoz Sanchez; Alicia,9,0,20,11
1714636759488,MAE 197,001,528363,Boechler; Nicholas Sebastia,9998,0,9999,1
1714636760517,MATH 197,001,523477,Kedlaya; Kiran S.,9995,0,9999,4
1714636760517,MATH 197,002,563811,Zhang; Danna,9995,0,9999,4
1714636760517,MATH 197,003,628552,Dumitriu; Ioana,9998,0,9999,1
1714636761543,MCWP 40R,A00,518780,Staff,2,0,20,18
1714636761543,MCWP 40R,B00,518781,Staff,8,0,20,12
1714636761543,MCWP 40R,C00,518783,Staff,6,0,20,14
1714636762569,MCWP 50R,A00,518791,Staff,0,0,20,20
1714636762569,MCWP 50R,B00,518792,Staff,0,2,20,20
1714636762569,MCWP 50R,C00,518793,Staff,0,2,20,20
1714636762569,MCWP 50R,D00,518794,Staff,0,0,20,20
1714636762569,MCWP 50R,E00,518795,Staff,0,2,20,20
1714636762569,MCWP 50R,F00,518796,Staff,0,0,20,20
1714636762569,MCWP 50R,G00,518797,Staff,0,1,20,20
1714636763594,MMW 12R,A01,514034,Herbst; Matthew,0,0,16,16
1714636763594,MMW 12R,A02,514035,Herbst; Matthew,1,0,16,15
1714636764623,MMW 13R,A01,514037,Staff,0,4,16,16
1714636764623,MMW 13R,A02,514039,Staff,0,2,16,16
1714636764623,MMW 13R,A03,628519,Staff,0,2,16,16
1714636766673,SIO 295LS,A00,523233,Staff,10,0,30,20
1714636767697,SIO 295S,A00,523232,Staff,10,0,30,20
1714636768726,SIOC 290S,A01,637330,Merrifield; Mark A,23,0,30,7
1714636769751,SIOC 291S,A01,637333,Gabriel; Corey John,23,0,30,7
1714636770784,SOCI 117,A01,494376,Staff,0,4,5,5
1714636771810,WES 237B,A00,494380,Staff,9,0,20,11
1714636773890,AESE 279B,A00,494370,Wade; Jon P,0,0,33,33
1714636774917,AIP 197,001,627712,Vespa; Emanuel Ignacio,9998,0,9999,1
1714636775942,ANAR 135S,A00,494369,Braswell; Geoffrey E.,0,0,0,0
1714636776968,BENG 196,001,628496,Engler; Adam J.,9998,0,9999,1
1714636777998,CAT 124RS,A01,519847,Geibel; William,0,0,20,20
1714636779024,CAT 125RS,A01,515971,Geibel; William,0,0,20,20
1714636780050,CLRE 250,A00,511389,Morris; Sheldon,9993,0,9999,6
1714636781084,CLRE 251,A00,507176,Mehta; Ravindra L.,9993,0,9999,6
1714636781084,CLRE 251,B00,511410,Mehta; Ravindra L.,9998,0,9999,1
1714636782109,CLRE 252,A00,507189,Cuomo; Raphael Eduardo,9995,0,9999,4
1714636783137,CLRE 253,A00,507199,Vaida; Florin,9994,0,9999,5
1714636783137,CLRE 253,B00,507202,Vaida; Florin,9999,0,9999,0
1714636784165,CLRE 259,A00,507211,Patel; Hemal,9996,0,9999,3
1714636785189,CLRE 260,A00,507221,Cuomo; Raphael Eduardo,9999,0,9999,0
1714636786214,CLRE 297,001,507242,Cuomo; Raphael Eduardo,9999,0,9999,0
1714636787242,COGS 197,001,638244,Voytek; Bradley Thomas,9998,0,9999,1
1714636788267,CSE 191,A00,516875,Minnes Kemp; Mor Mia,9992,0,9999,7
1714636789293,CSE 197,001,637388,Minnes Kemp; Mor Mia,9998,0,9999,1
1714636790319,CSS 201S,A01,494383,Staff,35,0,35,0
1714636791349,CSS 202S,A01,494387,Staff,35,0,35,0
1714636792375,DSC 197,001,628532,Eldridge; Justin Matthew,9996,0,9999,3
1714636793406,EAP 100,A00,516065,Staff,9797,0,9999,202
1714636794438,ECE 45,A01,507414,Staff,33,0,60,27
1714636796489,ECE 111,A01,507420,Staff,15,0,50,35
1714636797514,ECE 197,001,548057,Sievenpiper; Daniel F.,9993,0,9999,6
1714636798544,EDS 115,A00,507243,Choi; Bailey Miyeon,10,0,28,18
1714636799569,EDS 117,A01,494379,Staff,0,4,30,30
1714636800600,EDS 125,A00,507246,Hopkins; Megan Beth,9,0,30,21
1714636801630,EDS 128A,A01,507264,Fargason; Sharon Gayle,8,0,26,18
1714636802658,EDS 128B,A01,507293,Pappas; Elizabeth,12,0,30,18
1714636803688,EDS 139,A00,507294,Fargason; Sharon Gayle,13,0,30,17
1714636803688,EDS 139,B00,507313,Pappas; Elizabeth,13,0,30,17
1714636804716,EDS 201,A00,507315,Staff,13,0,30,17
1714636805747,EDS 203,A01,507317,Halter; Christopher P.,12,0,30,18
1714636806773,EDS 204R,A01,507319,Halter; Christopher P.,0,3,30,30
1714636806773,EDS 204R,B01,507331,Heinzman; Erica M.,16,0,30,14
1714636807800,EDS 206R,A00,507332,Staff,0,4,30,30
1714636807800,EDS 206R,B00,507343,Staff,17,0,30,13
1714636808827,EDS 250,A00,507344,Hemans; Patricia Ann Benitez,22,0,40,18
1714636809856,EDS 281,A00,507345,Daly; Alan J.,18,0,18,0
1714636810879,EDS 284,A00,507350,Daly; Alan J.,16,0,16,0
1714636811906,EDS 286,A00,507359,Fine; Sarah,18,0,18,0
1714636812935,EDS 289C,A01,507361,Daly; Alan J.,18,0,18,0
1714636813964,EDS 290,A00,507366,Hofstetter; Carolyn,15,0,15,0
1714636814991,LIGM 5A,A00,507421,Fischer-Grunski; Eva K,18,0,20,2
1714636816017,LIGM 5B,A00,507423,Fischer-Grunski; Eva K,19,0,20,1
1714636817042,LIGM 5C,A00,507425,Fischer-Grunski; Eva K,19,0,20,1
1714636818072,LIIT 5AS,A00,507427,Carnelos; Chiara,20,0,20,0
1714636819103,LIIT 5BS,A00,507430,Carnelos; Chiara,20,0,20,0
1714636820132,LIIT 5CS,A00,507432,Carnelos; Chiara,20,0,20,0
1714636821160,LISP 5A,A00,507541,Munoz Sanchez; Alicia,11,0,20,9
1714636822189,LISP 5B,A00,507671,Munoz Sanchez; Alicia,8,0,20,12
1714636823215,LISP 5C,A00,507696,Munoz Sanchez; Alicia,9,0,20,11
1714636824247,MAE 197,001,528363,Boechler; Nicholas Sebastia,9998,0,9999,1
1714636825281,MATH 197,001,523477,Kedlaya; Kiran S.,9995,0,9999,4
1714636825281,MATH 197,002,563811,Zhang; Danna,9995,0,9999,4
1714636825281,MATH 197,003,628552,Dumitriu; Ioana,9998,0,9999,1
1714636826364,MCWP 40R,A00,518780,Staff,2,0,20,18
1714636826364,MCWP 40R,B00,518781,Staff,8,0,20,12
1714636826364,MCWP 40R,C00,518783,Staff,6,0,20,14
1714636827390,MCWP 50R,A00,518791,Staff,0,0,20,20
1714636827390,MCWP 50R,B00,518792,Staff,0,2,20,20
1714636827390,MCWP 50R,C00,518793,Staff,0,2,20,20
1714636827390,MCWP 50R,D00,518794,Staff,0,0,20,20
1714636827390,MCWP 50R,E00,518795,Staff,0,2,20,20
1714636827390,MCWP 50R,F00,518796,Staff,0,0,20,20
1714636827390,MCWP 50R,G00,518797,Staff,0,1,20,20
1714636828416,MMW 12R,A01,514034,Herbst; Matthew,0,0,16,16
1714636828416,MMW 12R,A02,514035,Herbst; Matthew,1,0,16,15
1714636829444,MMW 13R,A01,514037,Staff,0,4,16,16
1714636829444,MMW 13R,A02,514039,Staff,0,2,16,16
1714636829444,MMW 13R,A03,628519,Staff,0,2,16,16
1714636831496,SIO 295LS,A00,523233,Staff,10,0,30,20
1714636832525,SIO 295S,A00,523232,Staff,10,0,30,20
1714636833553,SIOC 290S,A01,637330,Merrifield; Mark A,23,0,30,7
1714636834586,SIOC 291S,A01,637333,Gabriel; Corey John,23,0,30,7
1714636835619,SOCI 117,A01,494376,Staff,0,4,5,5
1714636836646,WES 237B,A00,494380,Staff,9,0,20,11
1714636838728,AESE 279B,A00,494370,Wade; Jon P,0,0,33,33
1714636839759,AIP 197,001,627712,Vespa; Emanuel Ignacio,9998,0,9999,1
1714636840784,ANAR 135S,A00,494369,Braswell; Geoffrey E.,0,0,0,0
1714636841809,BENG 196,001,628496,Engler; Adam J.,9998,0,9999,1
1714636842840,CAT 124RS,A01,519847,Geibel; William,0,0,20,20
1714636843877,CAT 125RS,A01,515971,Geibel; William,0,0,20,20
1714636844904,CLRE 250,A00,511389,Morris; Sheldon,9993,0,9999,6
1714636845937,CLRE 251,A00,507176,Mehta; Ravindra L.,9993,0,9999,6
1714636845937,CLRE 251,B00,511410,Mehta; Ravindra L.,9998,0,9999,1
1714636846967,CLRE 252,A00,507189,Cuomo; Raphael Eduardo,9995,0,9999,4
1714636847997,CLRE 253,A00,507199,Vaida; Florin,9994,0,9999,5
1714636847997,CLRE 253,B00,507202,Vaida; Florin,9999,0,9999,0
1714636849023,CLRE 259,A00,507211,Patel; Hemal,9996,0,9999,3
1714636850048,CLRE 260,A00,507221,Cuomo; Raphael Eduardo,9999,0,9999,0
1714636851080,CLRE 297,001,507242,Cuomo; Raphael Eduardo,9999,0,9999,0
1714636852105,COGS 197,001,638244,Voytek; Bradley Thomas,9998,0,9999,1
1714636853136,CSE 191,A00,516875,Minnes Kemp; Mor Mia,9992,0,9999,7
1714636854164,CSE 197,001,637388,Minnes Kemp; Mor Mia,9998,0,9999,1
1714636855196,CSS 201S,A01,494383,Staff,35,0,35,0
1714636856222,CSS 202S,A01,494387,Staff,35,0,35,0
1714636857251,DSC 197,001,628532,Eldridge; Justin Matthew,9996,0,9999,3
1714636858277,EAP 100,A00,516065,Staff,9797,0,9999,202
1714636859310,ECE 45,A01,507414,Staff,33,0,60,27
1714636861370,ECE 111,A01,507420,Staff,15,0,50,35
1714636862397,ECE 197,001,548057,Sievenpiper; Daniel F.,9993,0,9999,6
1714636863434,EDS 115,A00,507243,Choi; Bailey Miyeon,10,0,28,18
1714636864461,EDS 117,A01,494379,Staff,0,4,30,30
1714636865487,EDS 125,A00,507246,Hopkins; Megan Beth,9,0,30,21
1714636866514,EDS 128A,A01,507264,Fargason; Sharon Gayle,8,0,26,18
1714636867545,EDS 128B,A01,507293,Pappas; Elizabeth,12,0,30,18
1714636868572,EDS 139,A00,507294,Fargason; Sharon Gayle,13,0,30,17
1714636868572,EDS 139,B00,507313,Pappas; Elizabeth,13,0,30,17
1714636869602,EDS 201,A00,507315,Staff,13,0,30,17
1714636870627,EDS 203,A01,507317,Halter; Christopher P.,12,0,30,18
1714636871654,EDS 204R,A01,507319,Halter; Christopher P.,0,3,30,30
1714636871654,EDS 204R,B01,507331,Heinzman; Erica M.,16,0,30,14
1714636872681,EDS 206R,A00,507332,Staff,0,4,30,30
1714636872681,EDS 206R,B00,507343,Staff,17,0,30,13
1714636873706,EDS 250,A00,507344,Hemans; Patricia Ann Benitez,22,0,40,18
1714636874733,EDS 281,A00,507345,Daly; Alan J.,18,0,18,0
1714636875765,EDS 284,A00,507350,Daly; Alan J.,16,0,16,0
1714636876790,EDS 286,A00,507359,Fine; Sarah,18,0,18,0
1714636877818,EDS 289C,A01,507361,Daly; Alan J.,18,0,18,0
1714636878847,EDS 290,A00,507366,Hofstetter; Carolyn,15,0,15,0
1714636879873,LIGM 5A,A00,507421,Fischer-Grunski; Eva K,18,0,20,2
1714636880899,LIGM 5B,A00,507423,Fischer-Grunski; Eva K,19,0,20,1
1714636881928,LIGM 5C,A00,507425,Fischer-Grunski; Eva K,19,0,20,1
1714636882958,LIIT 5AS,A00,507427,Carnelos; Chiara,20,0,20,0
1714636883990,LIIT 5BS,A00,507430,Carnelos; Chiara,20,0,20,0
1714636885016,LIIT 5CS,A00,507432,Carnelos; Chiara,20,0,20,0
1714636886048,LISP 5A,A00,507541,Munoz Sanchez; Alicia,11,0,20,9
1714636887073,LISP 5B,A00,507671,Munoz Sanchez; Alicia,8,0,20,12
1714636888104,LISP 5C,A00,507696,Munoz Sanchez; Alicia,9,0,20,11
1714636889130,MAE 197,001,528363,Boechler; Nicholas Sebastia,9998,0,9999,1
1714636890164,MATH 197,001,523477,Kedlaya; Kiran S.,9995,0,9999,4
1714636890164,MATH 197,002,563811,Zhang; Danna,9995,0,9999,4
1714636890164,MATH 197,003,628552,Dumitriu; Ioana,9998,0,9999,1
1714636891192,MCWP 40R,A00,518780,Staff,2,0,20,18
1714636891192,MCWP 40R,B00,518781,Staff,8,0,20,12
1714636891192,MCWP 40R,C00,518783,Staff,6,0,20,14
1714636892221,MCWP 50R,A00,518791,Staff,0,0,20,20
1714636892221,MCWP 50R,B00,518792,Staff,0,2,20,20
1714636892221,MCWP 50R,C00,518793,Staff,0,2,20,20
1714636892221,MCWP 50R,D00,518794,Staff,0,0,20,20
1714636892221,MCWP 50R,E00,518795,Staff,0,2,20,20
1714636892221,MCWP 50R,F00,518796,Staff,0,0,20,20
1714636892221,MCWP 50R,G00,518797,Staff,0,1,20,20
1714636893246,MMW 12R,A01,514034,Herbst; Matthew,0,0,16,16
1714636893246,MMW 12R,A02,514035,Herbst; Matthew,1,0,16,15
1714636894274,MMW 13R,A01,514037,Staff,0,4,16,16
1714636894274,MMW 13R,A02,514039,Staff,0,2,16,16
1714636894274,MMW 13R,A03,628519,Staff,0,2,16,16
1714636896392,SIO 295LS,A00,523233,Staff,10,0,30,20
1714636897416,SIO 295S,A00,523232,Staff,10,0,30,20
1714636898446,SIOC 290S,A01,637330,Merrifield; Mark A,23,0,30,7
1714636899473,SIOC 291S,A01,637333,Gabriel; Corey John,23,0,30,7
1714636900503,SOCI 117,A01,494376,Staff,0,4,5,5
1714636901529,WES 237B,A00,494380,Staff,9,0,20,11
1714636903629,AESE 279B,A00,494370,Wade; Jon P,0,0,33,33
1714636904658,AIP 197,001,627712,Vespa; Emanuel Ignacio,9998,0,9999,1
1714636905684,ANAR 135S,A00,494369,Braswell; Geoffrey E.,0,0,0,0
1714636906712,BENG 196,001,628496,Engler; Adam J.,9998,0,9999,1
1714636907736,CAT 124RS,A01,519847,Geibel; William,0,0,20,20
1714636908765,CAT 125RS,A01,515971,Geibel; William,0,0,20,20
1714636909791,CLRE 250,A00,511389,Morris; Sheldon,9993,0,9999,6
1714636910822,CLRE 251,A00,507176,Mehta; Ravindra L.,9993,0,9999,6
1714636910822,CLRE 251,B00,511410,Mehta; Ravindra L.,9998,0,9999,1
1714636911852,CLRE 252,A00,507189,Cuomo; Raphael Eduardo,9995,0,9999,4
1714636912886,CLRE 253,A00,507199,Vaida; Florin,9994,0,9999,5
1714636912886,CLRE 253,B00,507202,Vaida; Florin,9999,0,9999,0
1714636913911,CLRE 259,A00,507211,Patel; Hemal,9996,0,9999,3
1714636914936,CLRE 260,A00,507221,Cuomo; Raphael Eduardo,9999,0,9999,0
1714636915964,CLRE 297,001,507242,Cuomo; Raphael Eduardo,9999,0,9999,0
1714636916989,COGS 197,001,638244,Voytek; Bradley Thomas,9998,0,9999,1
1714636918017,CSE 191,A00,516875,Minnes Kemp; Mor Mia,9992,0,9999,7
1714636919041,CSE 197,001,637388,Minnes Kemp; Mor Mia,9998,0,9999,1
1714636920077,CSS 201S,A01,494383,Staff,35,0,35,0
1714636921102,CSS 202S,A01,494387,Staff,35,0,35,0
1714636922131,DSC 197,001,628532,Eldridge; Justin Matthew,9996,0,9999,3
1714636923160,EAP 100,A00,516065,Staff,9797,0,9999,202
1714636924191,ECE 45,A01,507414,Staff,33,0,60,27
1714636926245,ECE 111,A01,507420,Staff,15,0,50,35
1714636927270,ECE 197,001,548057,Sievenpiper; Daniel F.,9993,0,9999,6
1714636928295,EDS 115,A00,507243,Choi; Bailey Miyeon,10,0,28,18
1714636929326,EDS 117,A01,494379,Staff,0,4,30,30
1714636930406,EDS 125,A00,507246,Hopkins; Megan Beth,9,0,30,21
1714636931431,EDS 128A,A01,507264,Fargason; Sharon Gayle,8,0,26,18
1714636932455,EDS 128B,A01,507293,Pappas; Elizabeth,12,0,30,18
1714636933481,EDS 139,A00,507294,Fargason; Sharon Gayle,13,0,30,17
1714636933481,EDS 139,B00,507313,Pappas; Elizabeth,13,0,30,17
1714636934509,EDS 201,A00,507315,Staff,13,0,30,17
1714636935536,EDS 203,A01,507317,Halter; Christopher P.,12,0,30,18
1714636936561,EDS 204R,A01,507319,Halter; Christopher P.,0,3,30,30
1714636936561,EDS 204R,B01,507331,Heinzman; Erica M.,16,0,30,14
1714636937585,EDS 206R,A00,507332,Staff,0,4,30,30
1714636937585,EDS 206R,B00,507343,Staff,17,0,30,13
1714636938614,EDS 250,A00,507344,Hemans; Patricia Ann Benitez,22,0,40,18
1714636939639,EDS 281,A00,507345,Daly; Alan J.,18,0,18,0
1714636940667,EDS 284,A00,507350,Daly; Alan J.,16,0,16,0
1714636941694,EDS 286,A00,507359,Fine; Sarah,18,0,18,0
1714636942720,EDS 289C,A01,507361,Daly; Alan J.,18,0,18,0
1714636943746,EDS 290,A00,507366,Hofstetter; Carolyn,15,0,15,0
1714636944776,LIGM 5A,A00,507421,Fischer-Grunski; Eva K,18,0,20,2
1714636945810,LIGM 5B,A00,507423,Fischer-Grunski; Eva K,19,0,20,1
1714636946835,LIGM 5C,A00,507425,Fischer-Grunski; Eva K,19,0,20,1
1714636947861,LIIT 5AS,A00,507427,Carnelos; Chiara,20,0,20,0
1714636948886,LIIT 5BS,A00,507430,Carnelos; Chiara,20,0,20,0
1714636949919,LIIT 5CS,A00,507432,Carnelos; Chiara,20,0,20,0
1714636950949,LISP 5A,A00,507541,Munoz Sanchez; Alicia,11,0,20,9
1714636951977,LISP 5B,A00,507671,Munoz Sanchez; Alicia,8,0,20,12
1714636953005,LISP 5C,A00,507696,Munoz Sanchez; Alicia,9,0,20,11
1714636954031,MAE 197,001,528363,Boechler; Nicholas Sebastia,9998,0,9999,1
1714636955056,MATH 197,001,523477,Kedlaya; Kiran S.,9995,0,9999,4
1714636955056,MATH 197,002,563811,Zhang; Danna,9995,0,9999,4
1714636955056,MATH 197,003,628552,Dumitriu; Ioana,9998,0,9999,1
1714636956082,MCWP 40R,A00,518780,Staff,2,0,20,18
1714636956082,MCWP 40R,B00,518781,Staff,8,0,20,12
1714636956082,MCWP 40R,C00,518783,Staff,6,0,20,14
1714636957107,MCWP 50R,A00,518791,Staff,0,0,20,20
1714636957107,MCWP 50R,B00,518792,Staff,0,2,20,20
1714636957107,MCWP 50R,C00,518793,Staff,0,2,20,20
1714636957107,MCWP 50R,D00,518794,Staff,0,0,20,20
1714636957107,MCWP 50R,E00,518795,Staff,0,2,20,20
1714636957107,MCWP 50R,F00,518796,Staff,0,0,20,20
1714636957107,MCWP 50R,G00,518797,Staff,0,1,20,20
1714636958133,MMW 12R,A01,514034,Herbst; Matthew,0,0,16,16
1714636958133,MMW 12R,A02,514035,Herbst; Matthew,1,0,16,15
1714636959163,MMW 13R,A01,514037,Staff,0,4,16,16
1714636959163,MMW 13R,A02,514039,Staff,0,2,16,16
1714636959163,MMW 13R,A03,628519,Staff,0,2,16,16
1714636961218,SIO 295LS,A00,523233,Staff,10,0,30,20
1714636962250,SIO 295S,A00,523232,Staff,10,0,30,20
1714636963285,SIOC 290S,A01,637330,Merrifield; Mark A,23,0,30,7
1714636964313,SIOC 291S,A01,637333,Gabriel; Corey John,23,0,30,7
1714636965339,SOCI 117,A01,494376,Staff,0,4,5,5
1714636966364,WES 237B,A00,494380,Staff,9,0,20,11
1714636968450,AESE 279B,A00,494370,Wade; Jon P,0,0,33,33
1714636969499,AIP 197,001,627712,Vespa; Emanuel Ignacio,9998,0,9999,1
1714636970527,ANAR 135S,A00,494369,Braswell; Geoffrey E.,0,0,0,0
1714636971555,BENG 196,001,628496,Engler; Adam J.,9998,0,9999,1
1714636972583,CAT 124RS,A01,519847,Geibel; William,0,0,20,20
1714636973610,CAT 125RS,A01,515971,Geibel; William,0,0,20,20
1714636974640,CLRE 250,A00,511389,Morris; Sheldon,9993,0,9999,6
1714636975675,CLRE 251,A00,507176,Mehta; Ravindra L.,9993,0,9999,6
1714636975675,CLRE 251,B00,511410,Mehta; Ravindra L.,9998,0,9999,1
1714636976699,CLRE 252,A00,507189,Cuomo; Raphael Eduardo,9995,0,9999,4
1714636977731,CLRE 253,A00,507199,Vaida; Florin,9994,0,9999,5
1714636977731,CLRE 253,B00,507202,Vaida; Florin,9999,0,9999,0
1714636978757,CLRE 259,A00,507211,Patel; Hemal,9996,0,9999,3
1714636979785,CLRE 260,A00,507221,Cuomo; Raphael Eduardo,9999,0,9999,0
1714636980814,CLRE 297,001,507242,Cuomo; Raphael Eduardo,9999,0,9999,0
1714636981841,COGS 197,001,638244,Voytek; Bradley Thomas,9998,0,9999,1
1714636982867,CSE 191,A00,516875,Minnes Kemp; Mor Mia,9992,0,9999,7
1714636983892,CSE 197,001,637388,Minnes Kemp; Mor Mia,9998,0,9999,1
1714636984922,CSS 201S,A01,494383,Staff,35,0,35,0
1714636985950,CSS 202S,A01,494387,Staff,35,0,35,0
1714636986975,DSC 197,001,628532,Eldridge; Justin Matthew,9996,0,9999,3
1714636988001,EAP 100,A00,516065,Staff,9797,0,9999,202
1714636989030,ECE 45,A01,507414,Staff,33,0,60,27
1714636991090,ECE 111,A01,507420,Staff,15,0,50,35
1714636992119,ECE 197,001,548057,Sievenpiper; Daniel F.,9993,0,9999,6
1714636993144,EDS 115,A00,507243,Choi; Bailey Miyeon,10,0,28,18
1714636994171,EDS 117,A01,494379,Staff,0,4,30,30
1714636995202,EDS 125,A00,507246,Hopkins; Megan Beth,9,0,30,21
1714636996227,EDS 128A,A01,507264,Fargason; Sharon Gayle,8,0,26,18
1714636997252,EDS 128B,A01,507293,Pappas; Elizabeth,12,0,30,18
1714636998277,EDS 139,A00,507294,Fargason; Sharon Gayle,13,0,30,17
1714636998277,EDS 139,B00,507313,Pappas; Elizabeth,13,0,30,17
1714636999303,EDS 201,A00,507315,Staff,13,0,30,17
1714637000330,EDS 203,A01,507317,Halter; Christopher P.,12,0,30,18
1714637001356,EDS 204R,A01,507319,Halter; Christopher P.,0,3,30,30
1714637001356,EDS 204R,B01,507331,Heinzman; Erica M.,16,0,30,14
1714637002433,EDS 206R,A00,507332,Staff,0,4,30,30
1714637002433,EDS 206R,B00,507343,Staff,17,0,30,13
1714637003458,EDS 250,A00,507344,Hemans; Patricia Ann Benitez,22,0,40,18
1714637004487,EDS 281,A00,507345,Daly; Alan J.,18,0,18,0
1714637005512,EDS 284,A00,507350,Daly; Alan J.,16,0,16,0
1714637006538,EDS 286,A00,507359,Fine; Sarah,18,0,18,0
1714637007568,EDS 289C,A01,507361,Daly; Alan J.,18,0,18,0
1714637008592,EDS 290,A00,507366,Hofstetter; Carolyn,15,0,15,0
1714637009622,LIGM 5A,A00,507421,Fischer-Grunski; Eva K,18,0,20,2
1714637010651,LIGM 5B,A00,507423,Fischer-Grunski; Eva K,19,0,20,1
1714637011682,LIGM 5C,A00,507425,Fischer-Grunski; Eva K,19,0,20,1
1714637012773,LIIT 5AS,A00,507427,Carnelos; Chiara,20,0,20,0
1714637013798,LIIT 5BS,A00,507430,Carnelos; Chiara,20,0,20,0
1714637014823,LIIT 5CS,A00,507432,Carnelos; Chiara,20,0,20,0
1714637015854,LISP 5A,A00,507541,Munoz Sanchez; Alicia,11,0,20,9
1714637016880,LISP 5B,A00,507671,Munoz Sanchez; Alicia,8,0,20,12
1714637017905,LISP 5C,A00,507696,Munoz Sanchez; Alicia,9,0,20,11
1714637018934,MAE 197,001,528363,Boechler; Nicholas Sebastia,9998,0,9999,1
1714637019959,MATH 197,001,523477,Kedlaya; Kiran S.,9995,0,9999,4
1714637019959,MATH 197,002,563811,Zhang; Danna,9995,0,9999,4
1714637019959,MATH 197,003,628552,Dumitriu; Ioana,9998,0,9999,1
1714637020988,MCWP 40R,A00,518780,Staff,2,0,20,18
1714637020988,MCWP 40R,B00,518781,Staff,8,0,20,12
1714637020988,MCWP 40R,C00,518783,Staff,6,0,20,14
1714637022017,MCWP 50R,A00,518791,Staff,0,0,20,20
1714637022017,MCWP 50R,B00,518792,Staff,0,2,20,20
1714637022017,MCWP 50R,C00,518793,Staff,0,2,20,20
1714637022017,MCWP 50R,D00,518794,Staff,0,0,20,20
1714637022017,MCWP 50R,E00,518795,Staff,0,2,20,20
1714637022017,MCWP 50R,F00,518796,Staff,0,0,20,20
1714637022017,MCWP 50R,G00,518797,Staff,0,1,20,20
1714637023057,MMW 12R,A01,514034,Herbst; Matthew,0,0,16,16
1714637023057,MMW 12R,A02,514035,Herbst; Matthew,1,0,16,15
1714637024082,MMW 13R,A01,514037,Staff,0,4,16,16
1714637024082,MMW 13R,A02,514039,Staff,0,2,16,16
1714637024082,MMW 13R,A03,628519,Staff,0,2,16,16
1714637026141,SIO 295LS,A00,523233,Staff,10,0,30,20
1714637027167,SIO 295S,A00,523232,Staff,10,0,30,20
1714637028194,SIOC 290S,A01,637330,Merrifield; Mark A,23,0,30,7
1714637029226,SIOC 291S,A01,637333,Gabriel; Corey John,23,0,30,7
1714637030252,SOCI 117,A01,494376,Staff,0,4,5,5
1714637031279,WES 237B,A00,494380,Staff,9,0,20,11
1714637033355,AESE 279B,A00,494370,Wade; Jon P,0,0,33,33
1714637034381,AIP 197,001,627712,Vespa; Emanuel Ignacio,9998,0,9999,1
1714637035404,ANAR 135S,A00,494369,Braswell; Geoffrey E.,0,0,0,0
1714637036429,BENG 196,001,628496,Engler; Adam J.,9998,0,9999,1
1714637037460,CAT 124RS,A01,519847,Geibel; William,0,0,20,20
1714637038486,CAT 125RS,A01,515971,Geibel; William,0,0,20,20
1714637039519,CLRE 250,A00,511389,Morris; Sheldon,9993,0,9999,6
1714637040546,CLRE 251,A00,507176,Mehta; Ravindra L.,9993,0,9999,6
1714637040546,CLRE 251,B00,511410,Mehta; Ravindra L.,9998,0,9999,1
1714637041571,CLRE 252,A00,507189,Cuomo; Raphael Eduardo,9995,0,9999,4
1714637042602,CLRE 253,A00,507199,Vaida; Florin,9994,0,9999,5
1714637042602,CLRE 253,B00,507202,Vaida; Florin,9999,0,9999,0
1714637043628,CLRE 259,A00,507211,Patel; Hemal,9996,0,9999,3
1714637044650,CLRE 260,A00,507221,Cuomo; Raphael Eduardo,9999,0,9999,0
1714637045676,CLRE 297,001,507242,Cuomo; Raphael Eduardo,9999,0,9999,0
1714637046701,COGS 197,001,638244,Voytek; Bradley Thomas,9998,0,9999,1
1714637047728,CSE 191,A00,516875,Minnes Kemp; Mor Mia,9992,0,9999,7
1714637048751,CSE 197,001,637388,Minnes Kemp; Mor Mia,9998,0,9999,1
1714637049783,CSS 201S,A01,494383,Staff,35,0,35,0
1714637050809,CSS 202S,A01,494387,Staff,35,0,35,0
1714637051836,DSC 197,001,628532,Eldridge; Justin Matthew,9996,0,9999,3
1714637052861,EAP 100,A00,516065,Staff,9797,0,9999,202
1714637053890,ECE 45,A01,507414,Staff,33,0,60,27
1714637055953,ECE 111,A01,507420,Staff,15,0,50,35
1714637056979,ECE 197,001,548057,Sievenpiper; Daniel F.,9993,0,9999,6
1714637058010,EDS 115,A00,507243,Choi; Bailey Miyeon,10,0,28,18
1714637059041,EDS 117,A01,494379,Staff,0,4,30,30
1714637060067,EDS 125,A00,507246,Hopkins; Megan Beth,9,0,30,21
1714637061095,EDS 128A,A01,507264,Fargason; Sharon Gayle,8,0,26,18
1714637062124,EDS 128B,A01,507293,Pappas; Elizabeth,12,0,30,18
1714637063148,EDS 139,A00,507294,Fargason; Sharon Gayle,13,0,30,17
1714637063148,EDS 139,B00,507313,Pappas; Elizabeth,13,0,30,17
1714637064173,EDS 201,A00,507315,Staff,13,0,30,17
1714637065203,EDS 203,A01,507317,Halter; Christopher P.,12,0,30,18
1714637066229,EDS 204R,A01,507319,Halter; Christopher P.,0,3,30,30
1714637066229,EDS 204R,B01,507331,Heinzman; Erica M.,16,0,30,14
1714637067258,EDS 206R,A00,507332,Staff,0,4,30,30
1714637067258,EDS 206R,B00,507343,Staff,17,0,30,13
1714637068283,EDS 250,A00,507344,Hemans; Patricia Ann Benitez,22,0,40,18
1714637069309,EDS 281,A00,507345,Daly; Alan J.,18,0,18,0
1714637070337,EDS 284,A00,507350,Daly; Alan J.,16,0,16,0
1714637071364,EDS 286,A00,507359,Fine; Sarah,18,0,18,0
1714637072388,EDS 289C,A01,507361,Daly; Alan J.,18,0,18,0
1714637073413,EDS 290,A00,507366,Hofstetter; Carolyn,15,0,15,0
1714637074443,LIGM 5A,A00,507421,Fischer-Grunski; Eva K,18,0,20,2
1714637075468,LIGM 5B,A00,507423,Fischer-Grunski; Eva K,19,0,20,1
1714637076494,LIGM 5C,A00,507425,Fischer-Grunski; Eva K,19,0,20,1
1714637077523,LIIT 5AS,A00,507427,Carnelos; Chiara,20,0,20,0
1714637078555,LIIT 5BS,A00,507430,Carnelos; Chiara,20,0,20,0
1714637079581,LIIT 5CS,A00,507432,Carnelos; Chiara,20,0,20,0
1714637080611,LISP 5A,A00,507541,Munoz Sanchez; Alicia,11,0,20,9
1714637081637,LISP 5B,A00,507671,Munoz Sanchez; Alicia,8,0,20,12
1714637082670,LISP 5C,A00,507696,Munoz Sanchez; Alicia,9,0,20,11
1714637083697,MAE 197,001,528363,Boechler; Nicholas Sebastia,9998,0,9999,1
1714637084781,MATH 197,001,523477,Kedlaya; Kiran S.,9995,0,9999,4
1714637084781,MATH 197,002,563811,Zhang; Danna,9995,0,9999,4
1714637084781,MATH 197,003,628552,Dumitriu; Ioana,9998,0,9999,1
1714637085811,MCWP 40R,A00,518780,Staff,2,0,20,18
1714637085811,MCWP 40R,B00,518781,Staff,8,0,20,12
1714637085811,MCWP 40R,C00,518783,Staff,6,0,20,14
1714637086840,MCWP 50R,A00,518791,Staff,0,0,20,20
1714637086840,MCWP 50R,B00,518792,Staff,0,2,20,20
1714637086840,MCWP 50R,C00,518793,Staff,0,2,20,20
1714637086840,MCWP 50R,D00,518794,Staff,0,0,20,20
1714637086840,MCWP 50R,E00,518795,Staff,0,2,20,20
1714637086840,MCWP 50R,F00,518796,Staff,0,0,20,20
1714637086840,MCWP 50R,G00,518797,Staff,0,1,20,20
1714637087869,MMW 12R,A01,514034,Herbst; Matthew,0,0,16,16
1714637087869,MMW 12R,A02,514035,Herbst; Matthew,1,0,16,15
1714637088897,MMW 13R,A01,514037,Staff,0,4,16,16
1714637088897,MMW 13R,A02,514039,Staff,0,2,16,16
1714637088897,MMW 13R,A03,628519,Staff,0,2,16,16
1714637090951,SIO 295LS,A00,523233,Staff,10,0,30,20
1714637091979,SIO 295S,A00,523232,Staff,10,0,30,20
1714637093010,SIOC 290S,A01,637330,Merrifield; Mark A,23,0,30,7
1714637094037,SIOC 291S,A01,637333,Gabriel; Corey John,23,0,30,7
1714637095069,SOCI 117,A01,494376,Staff,0,4,5,5
1714637096095,WES 237B,A00,494380,Staff,9,0,20,11
1714637098173,AESE 279B,A00,494370,Wade; Jon P,0,0,33,33
1714637099201,AIP 197,001,627712,Vespa; Emanuel Ignacio,9998,0,9999,1
1714637100227,ANAR 135S,A00,494369,Braswell; Geoffrey E.,0,0,0,0
1714637101254,BENG 196,001,628496,Engler; Adam J.,9998,0,9999,1
1714637102280,CAT 124RS,A01,519847,Geibel; William,0,0,20,20
1714637103310,CAT 125RS,A01,515971,Geibel; William,0,0,20,20
1714637104341,CLRE 250,A00,511389,Morris; Sheldon,9993,0,9999,6
1714637105368,CLRE 251,A00,507176,Mehta; Ravindra L.,9993,0,9999,6
1714637105368,CLRE 251,B00,511410,Mehta; Ravindra L.,9998,0,9999,1
1714637106394,CLRE 252,A00,507189,Cuomo; Raphael Eduardo,9995,0,9999,4
1714637107420,CLRE 253,A00,507199,Vaida; Florin,9994,0,9999,5
1714637107420,CLRE 253,B00,507202,Vaida; Florin,9999,0,9999,0
1714637108448,CLRE 259,A00,507211,Patel; Hemal,9996,0,9999,3
1714637109473,CLRE 260,A00,507221,Cuomo; Raphael Eduardo,9999,0,9999,0
1714637110501,CLRE 297,001,507242,Cuomo; Raphael Eduardo,9999,0,9999,0
1714637111528,COGS 197,001,638244,Voytek; Bradley Thomas,9998,0,9999,1
1714637112553,CSE 191,A00,516875,Minnes Kemp; Mor Mia,9992,0,9999,7
1714637113578,CSE 197,001,637388,Minnes Kemp; Mor Mia,9998,0,9999,1
1714637114608,CSS 201S,A01,494383,Staff,35,0,35,0
1714637115638,CSS 202S,A01,494387,Staff,35,0,35,0
1714637116666,DSC 197,001,628532,Eldridge; Justin Matthew,9996,0,9999,3
1714637117691,EAP 100,A00,516065,Staff,9797,0,9999,202
1714637118718,ECE 45,A01,507414,Staff,33,0,60,27
1714637120768,ECE 111,A01,507420,Staff,15,0,50,35
1714637121795,ECE 197,001,548057,Sievenpiper; Daniel F.,9993,0,9999,6
1714637122822,EDS 115,A00,507243,Choi; Bailey Miyeon,10,0,28,18
1714637123849,EDS 117,A01,494379,Staff,0,4,30,30
1714637124881,EDS 125,A00,507246,Hopkins; Megan Beth,9,0,30,21
1714637125909,EDS 128A,A01,507264,Fargason; Sharon Gayle,8,0,26,18
1714637126939,EDS 128B,A01,507293,Pappas; Elizabeth,12,0,30,18
1714637127964,EDS 139,A00,507294,Fargason; Sharon Gayle,13,0,30,17
1714637127964,EDS 139,B00,507313,Pappas; Elizabeth,13,0,30,17
1714637128989,EDS 201,A00,507315,Staff,13,0,30,17
1714637130014,EDS 203,A01,507317,Halter; Christopher P.,12,0,30,18
1714637131044,EDS 204R,A01,507319,Halter; Christopher P.,0,3,30,30
1714637131044,EDS 204R,B01,507331,Heinzman; Erica M.,16,0,30,14
1714637132069,EDS 206R,A00,507332,Staff,0,4,30,30
1714637132069,EDS 206R,B00,507343,Staff,17,0,30,13
1714637133095,EDS 250,A00,507344,Hemans; Patricia Ann Benitez,22,0,40,18
1714637134124,EDS 281,A00,507345,Daly; Alan J.,18,0,18,0
1714637135154,EDS 284,A00,507350,Daly; Alan J.,16,0,16,0
1714637136180,EDS 286,A00,507359,Fine; Sarah,18,0,18,0
1714637137210,EDS 289C,A01,507361,Daly; Alan J.,18,0,18,0
1714637138236,EDS 290,A00,507366,Hofstetter; Carolyn,15,0,15,0
1714637139264,LIGM 5A,A00,507421,Fischer-Grunski; Eva K,18,0,20,2
1714637140288,LIGM 5B,A00,507423,Fischer-Grunski; Eva K,19,0,20,1
1714637141316,LIGM 5C,A00,507425,Fischer-Grunski; Eva K,19,0,20,1
1714637142352,LIIT 5AS,A00,507427,Carnelos; Chiara,20,0,20,0
1714637143381,LIIT 5BS,A00,507430,Carnelos; Chiara,20,0,20,0
1714637144411,LIIT 5CS,A00,507432,Carnelos; Chiara,20,0,20,0
1714637145442,LISP 5A,A00,507541,Munoz Sanchez; Alicia,11,0,20,9
1714637146470,LISP 5B,A00,507671,Munoz Sanchez; Alicia,8,0,20,12
1714637147500,LISP 5C,A00,507696,Munoz Sanchez; Alicia,9,0,20,11
1714637148526,MAE 197,001,528363,Boechler; Nicholas Sebastia,9998,0,9999,1
1714637149553,MATH 197,001,523477,Kedlaya; Kiran S.,9995,0,9999,4
1714637149553,MATH 197,002,563811,Zhang; Danna,9995,0,9999,4
1714637149553,MATH 197,003,628552,Dumitriu; Ioana,9998,0,9999,1
1714637150577,MCWP 40R,A00,518780,Staff,2,0,20,18
1714637150577,MCWP 40R,B00,518781,Staff,8,0,20,12
1714637150577,MCWP 40R,C00,518783,Staff,6,0,20,14
1714637151603,MCWP 50R,A00,518791,Staff,0,0,20,20
1714637151603,MCWP 50R,B00,518792,Staff,0,2,20,20
1714637151603,MCWP 50R,C00,518793,Staff,0,2,20,20
1714637151603,MCWP 50R,D00,518794,Staff,0,0,20,20
1714637151603,MCWP 50R,E00,518795,Staff,0,2,20,20
1714637151603,MCWP 50R,F00,518796,Staff,0,0,20,20
1714637151603,MCWP 50R,G00,518797,Staff,0,1,20,20
1714637152632,MMW 12R,A01,514034,Herbst; Matthew,0,0,16,16
1714637152632,MMW 12R,A02,514035,Herbst; Matthew,1,0,16,15
1714637153663,MMW 13R,A01,514037,Staff,0,4,16,16
1714637153663,MMW 13R,A02,514039,Staff,0,2,16,16
1714637153663,MMW 13R,A03,628519,Staff,0,2,16,16
1714637155723,SIO 295LS,A00,523233,Staff,10,0,30,20
1714637156748,SIO 295S,A00,523232,Staff,10,0,30,20
1714637157774,SIOC 290S,A01,637330,Merrifield; Mark A,23,0,30,7
1714637158800,SIOC 291S,A01,637333,Gabriel; Corey John,23,0,30,7
1714637159830,SOCI 117,A01,494376,Staff,0,4,5,5
1714637160861,WES 237B,A00,494380,Staff,9,0,20,11
1714637162945,AESE 279B,A00,494370,Wade; Jon P,0,0,33,33
1714637163972,AIP 197,001,627712,Vespa; Emanuel Ignacio,9998,0,9999,1
1714637164997,ANAR 135S,A00,494369,Braswell; Geoffrey E.,0,0,0,0
1714637166023,BENG 196,001,628496,Engler; Adam J.,9998,0,9999,1
1714637167048,CAT 124RS,A01,519847,Geibel; William,0,0,20,20
1714637168075,CAT 125RS,A01,515971,Geibel; William,0,0,20,20
1714637169101,CLRE 250,A00,511389,Morris; Sheldon,9993,0,9999,6
1714637170130,CLRE 251,A00,507176,Mehta; Ravindra L.,9993,0,9999,6
1714637170130,CLRE 251,B00,511410,Mehta; Ravindra L.,9998,0,9999,1
1714637171159,CLRE 252,A00,507189,Cuomo; Raphael Eduardo,9995,0,9999,4
1714637172187,CLRE 253,A00,507199,Vaida; Florin,9994,0,9999,5
1714637172187,CLRE 253,B00,507202,Vaida; Florin,9999,0,9999,0
1714637173213,CLRE 259,A00,507211,Patel; Hemal,9996,0,9999,3
1714637174238,CLRE 260,A00,507221,Cuomo; Raphael Eduardo,9999,0,9999,0
1714637175262,CLRE 297,001,507242,Cuomo; Raphael Eduardo,9999,0,9999,0
1714637176291,COGS 197,001,638244,Voytek; Bradley Thomas,9998,0,9999,1
1714637177316,CSE 191,A00,516875,Minnes Kemp; Mor Mia,9992,0,9999,7
1714637178343,CSE 197,001,637388,Minnes Kemp; Mor Mia,9998,0,9999,1
1714637179373,CSS 201S,A01,494383,Staff,35,0,35,0
1714637180404,CSS 202S,A01,494387,Staff,35,0,35,0
1714637181430,DSC 197,001,628532,Eldridge; Justin Matthew,9996,0,9999,3
1714637182455,EAP 100,A00,516065,Staff,9797,0,9999,202
1714637183481,ECE 45,A01,507414,Staff,33,0,60,27
1714637185533,ECE 111,A01,507420,Staff,15,0,50,35
1714637186558,ECE 197,001,548057,Sievenpiper; Daniel F.,9993,0,9999,6
1714637187589,EDS 115,A00,507243,Choi; Bailey Miyeon,10,0,28,18
1714637188666,EDS 117,A01,494379,Staff,0,4,30,30
1714637189693,EDS 125,A00,507246,Hopkins; Megan Beth,9,0,30,21
1714637190717,EDS 128A,A01,507264,Fargason; Sharon Gayle,8,0,26,18
1714637191744,EDS 128B,A01,507293,Pappas; Elizabeth,12,0,30,18
1714637192768,EDS 139,A00,507294,Fargason; Sharon Gayle,13,0,30,17
1714637192768,EDS 139,B00,507313,Pappas; Elizabeth,13,0,30,17
1714637193795,EDS 201,A00,507315,Staff,13,0,30,17
1714637194819,EDS 203,A01,507317,Halter; Christopher P.,12,0,30,18
1714637195851,EDS 204R,A01,507319,Halter; Christopher P.,0,3,30,30
1714637195851,EDS 204R,B01,507331,Heinzman; Erica M.,16,0,30,14
1714637196876,EDS 206R,A00,507332,Staff,0,4,30,30
1714637196876,EDS 206R,B00,507343,Staff,17,0,30,13
1714637197904,EDS 250,A00,507344,Hemans; Patricia Ann Benitez,22,0,40,18
1714637198933,EDS 281,A00,507345,Daly; Alan J.,18,0,18,0
1714637199957,EDS 284,A00,507350,Daly; Alan J.,16,0,16,0
1714637200981,EDS 286,A00,507359,Fine; Sarah,18,0,18,0
1714637202012,EDS 289C,A01,507361,Daly; Alan J.,18,0,18,0
1714637203043,EDS 290,A00,507366,Hofstetter; Carolyn,15,0,15,0
1714637204069,LIGM 5A,A00,507421,Fischer-Grunski; Eva K,18,0,20,2
1714637205094,LIGM 5B,A00,507423,Fischer-Grunski; Eva K,19,0,20,1
1714637206120,LIGM 5C,A00,507425,Fischer-Grunski; Eva K,19,0,20,1
1714637207149,LIIT 5AS,A00,507427,Carnelos; Chiara,20,0,20,0
1714637208174,LIIT 5BS,A00,507430,Carnelos; Chiara,20,0,20,0
1714637209199,LIIT 5CS,A00,507432,Carnelos; Chiara,20,0,20,0
1714637210225,LISP 5A,A00,507541,Munoz Sanchez; Alicia,11,0,20,9
1714637211252,LISP 5B,A00,507671,Munoz Sanchez; Alicia,8,0,20,12
1714637212280,LISP 5C,A00,507696,Munoz Sanchez; Alicia,9,0,20,11
1714637213309,MAE 197,001,528363,Boechler; Nicholas Sebastia,9998,0,9999,1
1714637214341,MATH 197,001,523477,Kedlaya; Kiran S.,9995,0,9999,4
1714637214341,MATH 197,002,563811,Zhang; Danna,9995,0,9999,4
1714637214341,MATH 197,003,628552,Dumitriu; Ioana,9998,0,9999,1
1714637215364,MCWP 40R,A00,518780,Staff,2,0,20,18
1714637215364,MCWP 40R,B00,518781,Staff,8,0,20,12
1714637215364,MCWP 40R,C00,518783,Staff,6,0,20,14
1714637216394,MCWP 50R,A00,518791,Staff,0,0,20,20
1714637216394,MCWP 50R,B00,518792,Staff,0,2,20,20
1714637216394,MCWP 50R,C00,518793,Staff,0,2,20,20
1714637216394,MCWP 50R,D00,518794,Staff,0,0,20,20
1714637216394,MCWP 50R,E00,518795,Staff,0,2,20,20
1714637216394,MCWP 50R,F00,518796,Staff,0,0,20,20
1714637216394,MCWP 50R,G00,518797,Staff,0,1,20,20
1714637217420,MMW 12R,A01,514034,Herbst; Matthew,0,0,16,16
1714637217420,MMW 12R,A02,514035,Herbst; Matthew,1,0,16,15
1714637218444,MMW 13R,A01,514037,Staff,0,4,16,16
1714637218444,MMW 13R,A02,514039,Staff,0,2,16,16
1714637218444,MMW 13R,A03,628519,Staff,0,2,16,16
1714637220494,SIO 295LS,A00,523233,Staff,10,0,30,20
1714637221517,SIO 295S,A00,523232,Staff,10,0,30,20
1714637222547,SIOC 290S,A01,637330,Merrifield; Mark A,23,0,30,7
1714637223575,SIOC 291S,A01,637333,Gabriel; Corey John,23,0,30,7
1714637224604,SOCI 117,A01,494376,Staff,0,4,5,5
1714637225631,WES 237B,A00,494380,Staff,9,0,20,11
1714637227720,AESE 279B,A00,494370,Wade; Jon P,0,0,33,33
1714637228746,AIP 197,001,627712,Vespa; Emanuel Ignacio,9998,0,9999,1
1714637229770,ANAR 135S,A00,494369,Braswell; Geoffrey E.,0,0,0,0
1714637230800,BENG 196,001,628496,Engler; Adam J.,9998,0,9999,1
1714637231824,CAT 124RS,A01,519847,Geibel; William,0,0,20,20
1714637232850,CAT 125RS,A01,515971,Geibel; William,0,0,20,20
1714637233880,CLRE 250,A00,511389,Morris; Sheldon,9993,0,9999,6
1714637234907,CLRE 251,A00,507176,Mehta; Ravindra L.,9993,0,9999,6
1714637234907,CLRE 251,B00,511410,Mehta; Ravindra L.,9998,0,9999,1
1714637235933,CLRE 252,A00,507189,Cuomo; Raphael Eduardo,9995,0,9999,4
1714637236960,CLRE 253,A00,507199,Vaida; Florin,9994,0,9999,5
1714637236960,CLRE 253,B00,507202,Vaida; Florin,9999,0,9999,0
1714637237989,CLRE 259,A00,507211,Patel; Hemal,9996,0,9999,3
1714637239016,CLRE 260,A00,507221,Cuomo; Raphael Eduardo,9999,0,9999,0
1714637240042,CLRE 297,001,507242,Cuomo; Raphael Eduardo,9999,0,9999,0
1714637241068,COGS 197,001,638244,Voytek; Bradley Thomas,9998,0,9999,1
1714637242097,CSE 191,A00,516875,Minnes Kemp; Mor Mia,9992,0,9999,7
1714637243121,CSE 197,001,637388,Minnes Kemp; Mor Mia,9998,0,9999,1
1714637244146,CSS 201S,A01,494383,Staff,35,0,35,0
1714637245175,CSS 202S,A01,494387,Staff,35,0,35,0
1714637246202,DSC 197,001,628532,Eldridge; Justin Matthew,9996,0,9999,3
1714637247229,EAP 100,A00,516065,Staff,9797,0,9999,202
1714637248261,ECE 45,A01,507414,Staff,33,0,60,27
1714637250315,ECE 111,A01,507420,Staff,15,0,50,35
1714637251344,ECE 197,001,548057,Sievenpiper; Daniel F.,9993,0,9999,6
1714637252372,EDS 115,A00,507243,Choi; Bailey Miyeon,10,0,28,18
1714637253398,EDS 117,A01,494379,Staff,0,4,30,30
1714637254423,EDS 125,A00,507246,Hopkins; Megan Beth,9,0,30,21
1714637255448,EDS 128A,A01,507264,Fargason; Sharon Gayle,8,0,26,18
1714637256479,EDS 128B,A01,507293,Pappas; Elizabeth,12,0,30,18
1714637257504,EDS 139,A00,507294,Fargason; Sharon Gayle,13,0,30,17
1714637257504,EDS 139,B00,507313,Pappas; Elizabeth,13,0,30,17
1714637258532,EDS 201,A00,507315,Staff,13,0,30,17
1714637259563,EDS 203,A01,507317,Halter; Christopher P.,12,0,30,18
1714637260596,EDS 204R,A01,507319,Halter; Christopher P.,0,3,30,30
1714637260596,EDS 204R,B01,507331,Heinzman; Erica M.,16,0,30,14
1714637261622,EDS 206R,A00,507332,Staff,0,4,30,30
1714637261622,EDS 206R,B00,507343,Staff,17,0,30,13
1714637262649,EDS 250,A00,507344,Hemans; Patricia Ann Benitez,22,0,40,18
1714637263676,EDS 281,A00,507345,Daly; Alan J.,18,0,18,0
1714637264702,EDS 284,A00,507350,Daly; Alan J.,16,0,16,0
1714637265726,EDS 286,A00,507359,Fine; Sarah,18,0,18,0
1714637266754,EDS 289C,A01,507361,Daly; Alan J.,18,0,18,0
1714637267779,EDS 290,A00,507366,Hofstetter; Carolyn,15,0,15,0
1714637268810,LIGM 5A,A00,507421,Fischer-Grunski; Eva K,18,0,20,2
1714637269840,LIGM 5B,A00,507423,Fischer-Grunski; Eva K,19,0,20,1
1714637270868,LIGM 5C,A00,507425,Fischer-Grunski; Eva K,19,0,20,1
1714637271894,LIIT 5AS,A00,507427,Carnelos; Chiara,20,0,20,0
1714637272920,LIIT 5BS,A00,507430,Carnelos; Chiara,20,0,20,0
1714637273953,LIIT 5CS,A00,507432,Carnelos; Chiara,20,0,20,0
1714637274982,LISP 5A,A00,507541,Munoz Sanchez; Alicia,11,0,20,9
1714637276014,LISP 5B,A00,507671,Munoz Sanchez; Alicia,8,0,20,12
1714637277049,LISP 5C,A00,507696,Munoz Sanchez; Alicia,9,0,20,11
1714637278078,MAE 197,001,528363,Boechler; Nicholas Sebastia,9998,0,9999,1
1714637279112,MATH 197,001,523477,Kedlaya; Kiran S.,9995,0,9999,4
1714637279112,MATH 197,002,563811,Zhang; Danna,9995,0,9999,4
1714637279112,MATH 197,003,628552,Dumitriu; Ioana,9998,0,9999,1
1714637280142,MCWP 40R,A00,518780,Staff,2,0,20,18
1714637280142,MCWP 40R,B00,518781,Staff,8,0,20,12
1714637280142,MCWP 40R,C00,518783,Staff,6,0,20,14
1714637281171,MCWP 50R,A00,518791,Staff,0,0,20,20
1714637281171,MCWP 50R,B00,518792,Staff,0,2,20,20
1714637281171,MCWP 50R,C00,518793,Staff,0,2,20,20
1714637281171,MCWP 50R,D00,518794,Staff,0,0,20,20
1714637281171,MCWP 50R,E00,518795,Staff,0,2,20,20
1714637281171,MCWP 50R,F00,518796,Staff,0,0,20,20
1714637281171,MCWP 50R,G00,518797,Staff,0,1,20,20
1714637282196,MMW 12R,A01,514034,Herbst; Matthew,0,0,16,16
1714637282196,MMW 12R,A02,514035,Herbst; Matthew,1,0,16,15
1714637283223,MMW 13R,A01,514037,Staff,0,4,16,16
1714637283223,MMW 13R,A02,514039,Staff,0,2,16,16
1714637283223,MMW 13R,A03,628519,Staff,0,2,16,16
1714637285276,SIO 295LS,A00,523233,Staff,10,0,30,20
1714637286301,SIO 295S,A00,523232,Staff,10,0,30,20
1714637287330,SIOC 290S,A01,637330,Merrifield; Mark A,23,0,30,7
1714637288357,SIOC 291S,A01,637333,Gabriel; Corey John,23,0,30,7
1714637289384,SOCI 117,A01,494376,Staff,0,4,5,5
1714637290413,WES 237B,A00,494380,Staff,9,0,20,11
1714637292540,AESE 279B,A00,494370,Wade; Jon P,0,0,33,33
1714637293568,AIP 197,001,627712,Vespa; Emanuel Ignacio,9998,0,9999,1
1714637294594,ANAR 135S,A00,494369,Braswell; Geoffrey E.,0,0,0,0
1714637295625,BENG 196,001,628496,Engler; Adam J.,9998,0,9999,1
1714637296652,CAT 124RS,A01,519847,Geibel; William,0,0,20,20
1714637297678,CAT 125RS,A01,515971,Geibel; William,0,0,20,20
1714637298705,CLRE 250,A00,511389,Morris; Sheldon,9993,0,9999,6
1714637299733,CLRE 251,A00,507176,Mehta; Ravindra L.,9993,0,9999,6
1714637299733,CLRE 251,B00,511410,Mehta; Ravindra L.,9998,0,9999,1
1714637300759,CLRE 252,A00,507189,Cuomo; Raphael Eduardo,9995,0,9999,4
1714637301790,CLRE 253,A00,507199,Vaida; Florin,9994,0,9999,5
1714637301790,CLRE 253,B00,507202,Vaida; Florin,9999,0,9999,0
1714637302816,CLRE 259,A00,507211,Patel; Hemal,9996,0,9999,3
1714637303842,CLRE 260,A00,507221,Cuomo; Raphael Eduardo,9999,0,9999,0
1714637304867,CLRE 297,001,507242,Cuomo; Raphael Eduardo,9999,0,9999,0
1714637305896,COGS 197,001,638244,Voytek; Bradley Thomas,9998,0,9999,1
1714637306921,CSE 191,A00,516875,Minnes Kemp; Mor Mia,9992,0,9999,7
1714637307949,CSE 197,001,637388,Minnes Kemp; Mor Mia,9998,0,9999,1
1714637308980,CSS 201S,A01,494383,Staff,35,0,35,0
1714637310006,CSS 202S,A01,494387,Staff,35,0,35,0
1714637311032,DSC 197,001,628532,Eldridge; Justin Matthew,9996,0,9999,3
1714637312058,EAP 100,A00,516065,Staff,9797,0,9999,202
1714637313086,ECE 45,A01,507414,Staff,33,0,60,27
1714637315178,ECE 111,A01,507420,Staff,15,0,50,35
1714637316208,ECE 197,001,548057,Sievenpiper; Daniel F.,9993,0,9999,6
1714637317238,EDS 115,A00,507243,Choi; Bailey Miyeon,10,0,28,18
1714637318268,EDS 117,A01,494379,Staff,0,4,30,30
1714637319298,EDS 125,A00,507246,Hopkins; Megan Beth,9,0,30,21
1714637320335,EDS 128A,A01,507264,Fargason; Sharon Gayle,8,0,26,18
1714637321361,EDS 128B,A01,507293,Pappas; Elizabeth,12,0,30,18
1714637322386,EDS 139,A00,507294,Fargason; Sharon Gayle,13,0,30,17
1714637322386,EDS 139,B00,507313,Pappas; Elizabeth,13,0,30,17
1714637323412,EDS 201,A00,507315,Staff,13,0,30,17
1714637324440,EDS 203,A01,507317,Halter; Christopher P.,12,0,30,18
1714637325467,EDS 204R,A01,507319,Halter; Christopher P.,0,3,30,30
1714637325467,EDS 204R,B01,507331,Heinzman; Erica M.,16,0,30,14
1714637326490,EDS 206R,A00,507332,Staff,0,4,30,30
1714637326490,EDS 206R,B00,507343,Staff,17,0,30,13
1714637327519,EDS 250,A00,507344,Hemans; Patricia Ann Benitez,22,0,40,18
1714637328549,EDS 281,A00,507345,Daly; Alan J.,18,0,18,0
1714637329573,EDS 284,A00,507350,Daly; Alan J.,16,0,16,0
1714637330596,EDS 286,A00,507359,Fine; Sarah,18,0,18,0
1714637331627,EDS 289C,A01,507361,Daly; Alan J.,18,0,18,0
1714637332652,EDS 290,A00,507366,Hofstetter; Carolyn,15,0,15,0
1714637333685,LIGM 5A,A00,507421,Fischer-Grunski; Eva K,18,0,20,2
1714637334711,LIGM 5B,A00,507423,Fischer-Grunski; Eva K,19,0,20,1
1714637335736,LIGM 5C,A00,507425,Fischer-Grunski; Eva K,19,0,20,1
1714637336761,LIIT 5AS,A00,507427,Carnelos; Chiara,20,0,20,0
1714637337787,LIIT 5BS,A00,507430,Carnelos; Chiara,20,0,20,0
1714637338812,LIIT 5CS,A00,507432,Carnelos; Chiara,20,0,20,0
1714637339848,LISP 5A,A00,507541,Munoz Sanchez; Alicia,11,0,20,9
1714637340875,LISP 5B,A00,507671,Munoz Sanchez; Alicia,8,0,20,12
1714637341905,LISP 5C,A00,507696,Munoz Sanchez; Alicia,9,0,20,11
1714637342934,MAE 197,001,528363,Boechler; Nicholas Sebastia,9998,0,9999,1
1714637343969,MATH 197,001,523477,Kedlaya; Kiran S.,9995,0,9999,4
1714637343969,MATH 197,002,563811,Zhang; Danna,9995,0,9999,4
1714637343969,MATH 197,003,628552,Dumitriu; Ioana,9998,0,9999,1
1714637344995,MCWP 40R,A00,518780,Staff,2,0,20,18
1714637344995,MCWP 40R,B00,518781,Staff,8,0,20,12
1714637344995,MCWP 40R,C00,518783,Staff,6,0,20,14
1714637346021,MCWP 50R,A00,518791,Staff,0,0,20,20
1714637346021,MCWP 50R,B00,518792,Staff,0,2,20,20
1714637346021,MCWP 50R,C00,518793,Staff,0,2,20,20
1714637346021,MCWP 50R,D00,518794,Staff,0,0,20,20
1714637346021,MCWP 50R,E00,518795,Staff,0,2,20,20
1714637346021,MCWP 50R,F00,518796,Staff,0,0,20,20
1714637346021,MCWP 50R,G00,518797,Staff,0,1,20,20
1714637347053,MMW 12R,A01,514034,Herbst; Matthew,0,0,16,16
1714637347053,MMW 12R,A02,514035,Herbst; Matthew,1,0,16,15
1714637348083,MMW 13R,A01,514037,Staff,0,4,16,16
1714637348083,MMW 13R,A02,514039,Staff,0,2,16,16
1714637348083,MMW 13R,A03,628519,Staff,0,2,16,16
1714637350133,SIO 295LS,A00,523233,Staff,10,0,30,20
1714637351159,SIO 295S,A00,523232,Staff,10,0,30,20
1714637352191,SIOC 290S,A01,637330,Merrifield; Mark A,23,0,30,7
1714637353222,SIOC 291S,A01,637333,Gabriel; Corey John,23,0,30,7
1714637354247,SOCI 117,A01,494376,Staff,0,4,5,5
1714637355279,WES 237B,A00,494380,Staff,9,0,20,11
1714637357356,AESE 279B,A00,494370,Wade; Jon P,0,0,33,33
1714637358382,AIP 197,001,627712,Vespa; Emanuel Ignacio,9998,0,9999,1
1714637359407,ANAR 135S,A00,494369,Braswell; Geoffrey E.,0,0,0,0
1714637360431,BENG 196,001,628496,Engler; Adam J.,9998,0,9999,1
1714637361457,CAT 124RS,A01,519847,Geibel; William,0,0,20,20
1714637362482,CAT 125RS,A01,515971,Geibel; William,0,0,20,20
1714637363513,CLRE 250,A00,511389,Morris; Sheldon,9993,0,9999,6
1714637364540,CLRE 251,A00,507176,Mehta; Ravindra L.,9993,0,9999,6
1714637364540,CLRE 251,B00,511410,Mehta; Ravindra L.,9998,0,9999,1
1714637365571,CLRE 252,A00,507189,Cuomo; Raphael Eduardo,9995,0,9999,4
1714637366598,CLRE 253,A00,507199,Vaida; Florin,9994,0,9999,5
1714637366598,CLRE 253,B00,507202,Vaida; Florin,9999,0,9999,0
1714637367624,CLRE 259,A00,507211,Patel; Hemal,9996,0,9999,3
1714637368648,CLRE 260,A00,507221,Cuomo; Raphael Eduardo,9999,0,9999,0
1714637369676,CLRE 297,001,507242,Cuomo; Raphael Eduardo,9999,0,9999,0
1714637370702,COGS 197,001,638244,Voytek; Bradley Thomas,9998,0,9999,1
1714637371727,CSE 191,A00,516875,Minnes Kemp; Mor Mia,9992,0,9999,7
1714637372758,CSE 197,001,637388,Minnes Kemp; Mor Mia,9998,0,9999,1
1714637373786,CSS 201S,A01,494383,Staff,35,0,35,0
1714637374811,CSS 202S,A01,494387,Staff,35,0,35,0
1714637375840,DSC 197,001,628532,Eldridge; Justin Matthew,9996,0,9999,3
1714637376866,EAP 100,A00,516065,Staff,9797,0,9999,202
1714637377896,ECE 45,A01,507414,Staff,33,0,60,27
1714637379949,ECE 111,A01,507420,Staff,15,0,50,35
1714637380977,ECE 197,001,548057,Sievenpiper; Daniel F.,9993,0,9999,6
1714637382002,EDS 115,A00,507243,Choi; Bailey Miyeon,10,0,28,18
1714637383027,EDS 117,A01,494379,Staff,0,4,30,30
1714637384056,EDS 125,A00,507246,Hopkins; Megan Beth,9,0,30,21
1714637385086,EDS 128A,A01,507264,Fargason; Sharon Gayle,8,0,26,18
1714637386111,EDS 128B,A01,507293,Pappas; Elizabeth,12,0,30,18
1714637387138,EDS 139,A00,507294,Fargason; Sharon Gayle,13,0,30,17
1714637387138,EDS 139,B00,507313,Pappas; Elizabeth,13,0,30,17
1714637388165,EDS 201,A00,507315,Staff,13,0,30,17
1714637389190,EDS 203,A01,507317,Halter; Christopher P.,12,0,30,18
1714637390217,EDS 204R,A01,507319,Halter; Christopher P.,0,3,30,30
1714637390217,EDS 204R,B01,507331,Heinzman; Erica M.,16,0,30,14
1714637391245,EDS 206R,A00,507332,Staff,0,4,30,30
1714637391245,EDS 206R,B00,507343,Staff,17,0,30,13
1714637392271,EDS 250,A00,507344,Hemans; Patricia Ann Benitez,22,0,40,18
1714637393301,EDS 281,A00,507345,Daly; Alan J.,18,0,18,0
1714637394326,EDS 284,A00,507350,Daly; Alan J.,16,0,16,0
1714637395355,EDS 286,A00,507359,Fine; Sarah,18,0,18,0
1714637396437,EDS 289C,A01,507361,Daly; Alan J.,18,0,18,0
1714637397463,EDS 290,A00,507366,Hofstetter; Carolyn,15,0,15,0
1714637398493,LIGM 5A,A00,507421,Fischer-Grunski; Eva K,18,0,20,2
1714637399522,LIGM 5B,A00,507423,Fischer-Grunski; Eva K,19,0,20,1
1714637400548,LIGM 5C,A00,507425,Fischer-Grunski; Eva K,19,0,20,1
1714637401574,LIIT 5AS,A00,507427,Carnelos; Chiara,20,0,20,0
1714637402598,LIIT 5BS,A00,507430,Carnelos; Chiara,20,0,20,0
1714637403624,LIIT 5CS,A00,507432,Carnelos; Chiara,20,0,20,0
1714637404649,LISP 5A,A00,507541,Munoz Sanchez; Alicia,11,0,20,9
1714637405675,LISP 5B,A00,507671,Munoz Sanchez; Alicia,8,0,20,12
1714637406705,LISP 5C,A00,507696,Munoz Sanchez; Alicia,9,0,20,11
1714637407734,MAE 197,001,528363,Boechler; Nicholas Sebastia,9998,0,9999,1
1714637408760,MATH 197,001,523477,Kedlaya; Kiran S.,9995,0,9999,4
1714637408760,MATH 197,002,563811,Zhang; Danna,9995,0,9999,4
1714637408760,MATH 197,003,628552,Dumitriu; Ioana,9998,0,9999,1
1714637409787,MCWP 40R,A00,518780,Staff,2,0,20,18
1714637409787,MCWP 40R,B00,518781,Staff,8,0,20,12
1714637409787,MCWP 40R,C00,518783,Staff,6,0,20,14
1714637410815,MCWP 50R,A00,518791,Staff,0,0,20,20
1714637410815,MCWP 50R,B00,518792,Staff,0,2,20,20
1714637410815,MCWP 50R,C00,518793,Staff,0,2,20,20
1714637410815,MCWP 50R,D00,518794,Staff,0,0,20,20
1714637410815,MCWP 50R,E00,518795,Staff,0,2,20,20
1714637410815,MCWP 50R,F00,518796,Staff,0,0,20,20
1714637410815,MCWP 50R,G00,518797,Staff,0,1,20,20
1714637411842,MMW 12R,A01,514034,Herbst; Matthew,0,0,16,16
1714637411842,MMW 12R,A02,514035,Herbst; Matthew,1,0,16,15
1714637412867,MMW 13R,A01,514037,Staff,0,4,16,16
1714637412867,MMW 13R,A02,514039,Staff,0,2,16,16
1714637412867,MMW 13R,A03,628519,Staff,0,2,16,16
1714637414919,SIO 295LS,A00,523233,Staff,10,0,30,20
1714637415946,SIO 295S,A00,523232,Staff,10,0,30,20
1714637416972,SIOC 290S,A01,637330,Merrifield; Mark A,23,0,30,7
1714637417997,SIOC 291S,A01,637333,Gabriel; Corey John,23,0,30,7
1714637419024,SOCI 117,A01,494376,Staff,0,4,5,5
1714637420048,WES 237B,A00,494380,Staff,9,0,20,11
1714637422121,AESE 279B,A00,494370,Wade; Jon P,0,0,33,33
1714637423146,AIP 197,001,627712,Vespa; Emanuel Ignacio,9998,0,9999,1
1714637424175,ANAR 135S,A00,494369,Braswell; Geoffrey E.,0,0,0,0
1714637425213,BENG 196,001,628496,Engler; Adam J.,9998,0,9999,1
1714637426238,CAT 124RS,A01,519847,Geibel; William,0,0,20,20
1714637427275,CAT 125RS,A01,515971,Geibel; William,0,0,20,20
1714637428305,CLRE 250,A00,511389,Morris; Sheldon,9993,0,9999,6
1714637429338,CLRE 251,A00,507176,Mehta; Ravindra L.,9993,0,9999,6
1714637429338,CLRE 251,B00,511410,Mehta; Ravindra L.,9998,0,9999,1
1714637430368,CLRE 252,A00,507189,Cuomo; Raphael Eduardo,9995,0,9999,4
1714637431399,CLRE 253,A00,507199,Vaida; Florin,9994,0,9999,5
1714637431399,CLRE 253,B00,507202,Vaida; Florin,9999,0,9999,0
1714637432424,CLRE 259,A00,507211,Patel; Hemal,9996,0,9999,3
1714637433452,CLRE 260,A00,507221,Cuomo; Raphael Eduardo,9999,0,9999,0
1714637434477,CLRE 297,001,507242,Cuomo; Raphael Eduardo,9999,0,9999,0
1714637435502,COGS 197,001,638244,Voytek; Bradley Thomas,9998,0,9999,1
1714637436532,CSE 191,A00,516875,Minnes Kemp; Mor Mia,9992,0,9999,7
1714637437559,CSE 197,001,637388,Minnes Kemp; Mor Mia,9998,0,9999,1
1714637438585,CSS 201S,A01,494383,Staff,35,0,35,0
1714637439612,CSS 202S,A01,494387,Staff,35,0,35,0
1714637440637,DSC 197,001,628532,Eldridge; Justin Matthew,9996,0,9999,3
1714637441664,EAP 100,A00,516065,Staff,9797,0,9999,202
1714637442690,ECE 45,A01,507414,Staff,33,0,60,27
1714637444746,ECE 111,A01,507420,Staff,15,0,50,35
1714637445776,ECE 197,001,548057,Sievenpiper; Daniel F.,9993,0,9999,6
1714637446803,EDS 115,A00,507243,Choi; Bailey Miyeon,10,0,28,18
1714637447829,EDS 117,A01,494379,Staff,0,4,30,30
1714637448860,EDS 125,A00,507246,Hopkins; Megan Beth,9,0,30,21
1714637449894,EDS 128A,A01,507264,Fargason; Sharon Gayle,8,0,26,18
1714637450919,EDS 128B,A01,507293,Pappas; Elizabeth,12,0,30,18
1714637451948,EDS 139,A00,507294,Fargason; Sharon Gayle,13,0,30,17
1714637451948,EDS 139,B00,507313,Pappas; Elizabeth,13,0,30,17
1714637452972,EDS 201,A00,507315,Staff,13,0,30,17
1714637454006,EDS 203,A01,507317,Halter; Christopher P.,12,0,30,18
1714637455032,EDS 204R,A01,507319,Halter; Christopher P.,0,3,30,30
1714637455032,EDS 204R,B01,507331,Heinzman; Erica M.,16,0,30,14
1714637456058,EDS 206R,A00,507332,Staff,0,4,30,30
1714637456058,EDS 206R,B00,507343,Staff,17,0,30,13
1714637457088,EDS 250,A00,507344,Hemans; Patricia Ann Benitez,22,0,40,18
1714637458117,EDS 281,A00,507345,Daly; Alan J.,18,0,18,0
1714637459143,EDS 284,A00,507350,Daly; Alan J.,16,0,16,0
1714637460171,EDS 286,A00,507359,Fine; Sarah,18,0,18,0
1714637461197,EDS 289C,A01,507361,Daly; Alan J.,18,0,18,0
1714637462223,EDS 290,A00,507366,Hofstetter; Carolyn,15,0,15,0
1714637463262,LIGM 5A,A00,507421,Fischer-Grunski; Eva K,18,0,20,2
1714637464290,LIGM 5B,A00,507423,Fischer-Grunski; Eva K,19,0,20,1
1714637465316,LIGM 5C,A00,507425,Fischer-Grunski; Eva K,19,0,20,1
1714637466345,LIIT 5AS,A00,507427,Carnelos; Chiara,20,0,20,0
1714637467374,LIIT 5BS,A00,507430,Carnelos; Chiara,20,0,20,0
1714637468399,LIIT 5CS,A00,507432,Carnelos; Chiara,20,0,20,0
1714637469426,LISP 5A,A00,507541,Munoz Sanchez; Alicia,11,0,20,9
1714637470455,LISP 5B,A00,507671,Munoz Sanchez; Alicia,8,0,20,12
1714637471483,LISP 5C,A00,507696,Munoz Sanchez; Alicia,9,0,20,11
1714637472514,MAE 197,001,528363,Boechler; Nicholas Sebastia,9998,0,9999,1
1714637473547,MATH 197,001,523477,Kedlaya; Kiran S.,9995,0,9999,4
1714637473547,MATH 197,002,563811,Zhang; Danna,9995,0,9999,4
1714637473547,MATH 197,003,628552,Dumitriu; Ioana,9998,0,9999,1
1714637474633,MCWP 40R,A00,518780,Staff,2,0,20,18
1714637474633,MCWP 40R,B00,518781,Staff,8,0,20,12
1714637474633,MCWP 40R,C00,518783,Staff,6,0,20,14
1714637475658,MCWP 50R,A00,518791,Staff,0,0,20,20
1714637475658,MCWP 50R,B00,518792,Staff,0,2,20,20
1714637475658,MCWP 50R,C00,518793,Staff,0,2,20,20
1714637475658,MCWP 50R,D00,518794,Staff,0,0,20,20
1714637475658,MCWP 50R,E00,518795,Staff,0,2,20,20
1714637475658,MCWP 50R,F00,518796,Staff,0,0,20,20
1714637475658,MCWP 50R,G00,518797,Staff,0,1,20,20
1714637476684,MMW 12R,A01,514034,Herbst; Matthew,0,0,16,16
1714637476684,MMW 12R,A02,514035,Herbst; Matthew,1,0,16,15
1714637477710,MMW 13R,A01,514037,Staff,0,4,16,16
1714637477710,MMW 13R,A02,514039,Staff,0,2,16,16
1714637477710,MMW 13R,A03,628519,Staff,0,2,16,16
1714637479764,SIO 295LS,A00,523233,Staff,10,0,30,20
1714637480791,SIO 295S,A00,523232,Staff,10,0,30,20
1714637481818,SIOC 290S,A01,637330,Merrifield; Mark A,23,0,30,7
1714637482846,SIOC 291S,A01,637333,Gabriel; Corey John,23,0,30,7
1714637483872,SOCI 117,A01,494376,Staff,0,4,5,5
1714637484897,WES 237B,A00,494380,Staff,9,0,20,11
1714637486974,AESE 279B,A00,494370,Wade; Jon P,0,0,33,33
1714637488004,AIP 197,001,627712,Vespa; Emanuel Ignacio,9998,0,9999,1
1714637489030,ANAR 135S,A00,494369,Braswell; Geoffrey E.,0,0,0,0
1714637490060,BENG 196,001,628496,Engler; Adam J.,9998,0,9999,1
1714637491090,CAT 124RS,A01,519847,Geibel; William,0,0,20,20
1714637492117,CAT 125RS,A01,515971,Geibel; William,0,0,20,20
1714637493144,CLRE 250,A00,511389,Morris; Sheldon,9993,0,9999,6
1714637494178,CLRE 251,A00,507176,Mehta; Ravindra L.,9993,0,9999,6
1714637494178,CLRE 251,B00,511410,Mehta; Ravindra L.,9998,0,9999,1
1714637495208,CLRE 252,A00,507189,Cuomo; Raphael Eduardo,9995,0,9999,4
1714637496240,CLRE 253,A00,507199,Vaida; Florin,9994,0,9999,5
1714637496240,CLRE 253,B00,507202,Vaida; Florin,9999,0,9999,0
1714637497265,CLRE 259,A00,507211,Patel; Hemal,9996,0,9999,3
1714637498291,CLRE 260,A00,507221,Cuomo; Raphael Eduardo,9999,0,9999,0
1714637499322,CLRE 297,001,507242,Cuomo; Raphael Eduardo,9999,0,9999,0
1714637500419,COGS 197,001,638244,Voytek; Bradley Thomas,9998,0,9999,1
1714637501447,CSE 191,A00,516875,Minnes Kemp; Mor Mia,9992,0,9999,7
1714637502471,CSE 197,001,637388,Minnes Kemp; Mor Mia,9998,0,9999,1
1714637503498,CSS 201S,A01,494383,Staff,35,0,35,0
1714637504528,CSS 202S,A01,494387,Staff,35,0,35,0
1714637505553,DSC 197,001,628532,Eldridge; Justin Matthew,9996,0,9999,3
1714637506581,EAP 100,A00,516065,Staff,9797,0,9999,202
1714637507607,ECE 45,A01,507414,Staff,33,0,60,27
1714637509656,ECE 111,A01,507420,Staff,15,0,50,35
1714637510686,ECE 197,001,548057,Sievenpiper; Daniel F.,9993,0,9999,6
1714637511712,EDS 115,A00,507243,Choi; Bailey Miyeon,10,0,28,18
1714637512737,EDS 117,A01,494379,Staff,0,4,30,30
1714637513768,EDS 125,A00,507246,Hopkins; Megan Beth,9,0,30,21
1714637514797,EDS 128A,A01,507264,Fargason; Sharon Gayle,8,0,26,18
1714637515828,EDS 128B,A01,507293,Pappas; Elizabeth,12,0,30,18
1714637516855,EDS 139,A00,507294,Fargason; Sharon Gayle,13,0,30,17
1714637516855,EDS 139,B00,507313,Pappas; Elizabeth,13,0,30,17
1714637517880,EDS 201,A00,507315,Staff,13,0,30,17
1714637518906,EDS 203,A01,507317,Halter; Christopher P.,12,0,30,18
1714637519934,EDS 204R,A01,507319,Halter; Christopher P.,0,3,30,30
1714637519934,EDS 204R,B01,507331,Heinzman; Erica M.,16,0,30,14
1714637520965,EDS 206R,A00,507332,Staff,0,4,30,30
1714637520965,EDS 206R,B00,507343,Staff,17,0,30,13
1714637521993,EDS 250,A00,507344,Hemans; Patricia Ann Benitez,22,0,40,18
1714637523020,EDS 281,A00,507345,Daly; Alan J.,18,0,18,0
1714637524046,EDS 284,A00,507350,Daly; Alan J.,16,0,16,0
1714637525078,EDS 286,A00,507359,Fine; Sarah,18,0,18,0
1714637526103,EDS 289C,A01,507361,Daly; Alan J.,18,0,18,0
1714637527130,EDS 290,A00,507366,Hofstetter; Carolyn,15,0,15,0
1714637528157,LIGM 5A,A00,507421,Fischer-Grunski; Eva K,18,0,20,2
1714637529186,LIGM 5B,A00,507423,Fischer-Grunski; Eva K,19,0,20,1
1714637530215,LIGM 5C,A00,507425,Fischer-Grunski; Eva K,19,0,20,1
1714637531246,LIIT 5AS,A00,507427,Carnelos; Chiara,20,0,20,0
1714637532272,LIIT 5BS,A00,507430,Carnelos; Chiara,20,0,20,0
1714637533301,LIIT 5CS,A00,507432,Carnelos; Chiara,20,0,20,0
1714637534331,LISP 5A,A00,507541,Munoz Sanchez; Alicia,11,0,20,9
1714637535360,LISP 5B,A00,507671,Munoz Sanchez; Alicia,8,0,20,12
1714637536390,LISP 5C,A00,507696,Munoz Sanchez; Alicia,9,0,20,11
1714637537415,MAE 197,001,528363,Boechler; Nicholas Sebastia,9998,0,9999,1
1714637538445,MATH 197,001,523477,Kedlaya; Kiran S.,9995,0,9999,4
1714637538445,MATH 197,002,563811,Zhang; Danna,9995,0,9999,4
1714637538445,MATH 197,003,628552,Dumitriu; Ioana,9998,0,9999,1
1714637539471,MCWP 40R,A00,518780,Staff,2,0,20,18
1714637539471,MCWP 40R,B00,518781,Staff,8,0,20,12
1714637539471,MCWP 40R,C00,518783,Staff,6,0,20,14
1714637540501,MCWP 50R,A00,518791,Staff,0,0,20,20
1714637540501,MCWP 50R,B00,518792,Staff,0,2,20,20
1714637540501,MCWP 50R,C00,518793,Staff,0,2,20,20
1714637540501,MCWP 50R,D00,518794,Staff,0,0,20,20
1714637540501,MCWP 50R,E00,518795,Staff,0,2,20,20
1714637540501,MCWP 50R,F00,518796,Staff,0,0,20,20
1714637540501,MCWP 50R,G00,518797,Staff,0,1,20,20
1714637541534,MMW 12R,A01,514034,Herbst; Matthew,0,0,16,16
1714637541534,MMW 12R,A02,514035,Herbst; Matthew,1,0,16,15
1714637542561,MMW 13R,A01,514037,Staff,0,4,16,16
1714637542561,MMW 13R,A02,514039,Staff,0,2,16,16
1714637542561,MMW 13R,A03,628519,Staff,0,2,16,16
1714637544620,SIO 295LS,A00,523233,Staff,10,0,30,20
1714637545649,SIO 295S,A00,523232,Staff,10,0,30,20
1714637546674,SIOC 290S,A01,637330,Merrifield; Mark A,23,0,30,7
1714637547699,SIOC 291S,A01,637333,Gabriel; Corey John,23,0,30,7
1714637548725,SOCI 117,A01,494376,Staff,0,4,5,5
1714637549749,WES 237B,A00,494380,Staff,9,0,20,11
1714637551832,AESE 279B,A00,494370,Wade; Jon P,0,0,33,33
1714637552860,AIP 197,001,627712,Vespa; Emanuel Ignacio,9998,0,9999,1
1714637553884,ANAR 135S,A00,494369,Braswell; Geoffrey E.,0,0,0,0
1714637554914,BENG 196,001,628496,Engler; Adam J.,9998,0,9999,1
1714637555947,CAT 124RS,A01,519847,Geibel; William,0,0,20,20
1714637556981,CAT 125RS,A01,515971,Geibel; William,0,0,20,20
1714637558008,CLRE 250,A00,511389,Morris; Sheldon,9993,0,9999,6
1714637559037,CLRE 251,A00,507176,Mehta; Ravindra L.,9993,0,9999,6
1714637559037,CLRE 251,B00,511410,Mehta; Ravindra L.,9998,0,9999,1
1714637560066,CLRE 252,A00,507189,Cuomo; Raphael Eduardo,9995,0,9999,4
1714637561091,CLRE 253,A00,507199,Vaida; Florin,9994,0,9999,5
1714637561091,CLRE 253,B00,507202,Vaida; Florin,9999,0,9999,0
1714637562117,CLRE 259,A00,507211,Patel; Hemal,9996,0,9999,3
1714637563141,CLRE 260,A00,507221,Cuomo; Raphael Eduardo,9999,0,9999,0
1714637564165,CLRE 297,001,507242,Cuomo; Raphael Eduardo,9999,0,9999,0
1714637565190,COGS 197,001,638244,Voytek; Bradley Thomas,9998,0,9999,1
1714637566217,CSE 191,A00,516875,Minnes Kemp; Mor Mia,9992,0,9999,7
1714637567243,CSE 197,001,637388,Minnes Kemp; Mor Mia,9998,0,9999,1
1714637568273,CSS 201S,A01,494383,Staff,35,0,35,0
1714637569303,CSS 202S,A01,494387,Staff,35,0,35,0
1714637570334,DSC 197,001,628532,Eldridge; Justin Matthew,9996,0,9999,3
1714637571359,EAP 100,A00,516065,Staff,9797,0,9999,202
1714637572384,ECE 45,A01,507414,Staff,33,0,60,27
1714637574445,ECE 111,A01,507420,Staff,15,0,50,35
1714637575471,ECE 197,001,548057,Sievenpiper; Daniel F.,9993,0,9999,6
1714637576505,EDS 115,A00,507243,Choi; Bailey Miyeon,10,0,28,18
1714637577531,EDS 117,A01,494379,Staff,0,4,30,30
1714637578557,EDS 125,A00,507246,Hopkins; Megan Beth,9,0,30,21
1714637579582,EDS 128A,A01,507264,Fargason; Sharon Gayle,8,0,26,18
1714637580607,EDS 128B,A01,507293,Pappas; Elizabeth,12,0,30,18
1714637581631,EDS 139,A00,507294,Fargason; Sharon Gayle,13,0,30,17
1714637581631,EDS 139,B00,507313,Pappas; Elizabeth,13,0,30,17
1714637582661,EDS 201,A00,507315,Staff,13,0,30,17
1714637583686,EDS 203,A01,507317,Halter; Christopher P.,12,0,30,18
1714637584714,EDS 204R,A01,507319,Halter; Christopher P.,0,3,30,30
1714637584714,EDS 204R,B01,507331,Heinzman; Erica M.,16,0,30,14
1714637585743,EDS 206R,A00,507332,Staff,0,4,30,30
1714637585743,EDS 206R,B00,507343,Staff,17,0,30,13
1714637586767,EDS 250,A00,507344,Hemans; Patricia Ann Benitez,22,0,40,18
1714637587795,EDS 281,A00,507345,Daly; Alan J.,18,0,18,0
1714637588821,EDS 284,A00,507350,Daly; Alan J.,16,0,16,0
1714637589847,EDS 286,A00,507359,Fine; Sarah,18,0,18,0
1714637590877,EDS 289C,A01,507361,Daly; Alan J.,18,0,18,0
1714637591907,EDS 290,A00,507366,Hofstetter; Carolyn,15,0,15,0
1714637592939,LIGM 5A,A00,507421,Fischer-Grunski; Eva K,18,0,20,2
1714637593968,LIGM 5B,A00,507423,Fischer-Grunski; Eva K,19,0,20,1
1714637594995,LIGM 5C,A00,507425,Fischer-Grunski; Eva K,19,0,20,1
1714637596020,LIIT 5AS,A00,507427,Carnelos; Chiara,20,0,20,0
1714637597044,LIIT 5BS,A00,507430,Carnelos; Chiara,20,0,20,0
1714637598069,LIIT 5CS,A00,507432,Carnelos; Chiara,20,0,20,0
1714637599097,LISP 5A,A00,507541,Munoz Sanchez; Alicia,11,0,20,9
1714637600124,LISP 5B,A00,507671,Munoz Sanchez; Alicia,8,0,20,12
1714637601153,LISP 5C,A00,507696,Munoz Sanchez; Alicia,9,0,20,11
1714637602177,MAE 197,001,528363,Boechler; Nicholas Sebastia,9998,0,9999,1
1714637603203,MATH 197,001,523477,Kedlaya; Kiran S.,9995,0,9999,4
1714637603203,MATH 197,002,563811,Zhang; Danna,9995,0,9999,4
1714637603203,MATH 197,003,628552,Dumitriu; Ioana,9998,0,9999,1
1714637604288,MCWP 40R,A00,518780,Staff,2,0,20,18
1714637604288,MCWP 40R,B00,518781,Staff,8,0,20,12
1714637604288,MCWP 40R,C00,518783,Staff,6,0,20,14
1714637605315,MCWP 50R,A00,518791,Staff,0,0,20,20
1714637605315,MCWP 50R,B00,518792,Staff,0,2,20,20
1714637605315,MCWP 50R,C00,518793,Staff,0,2,20,20
1714637605315,MCWP 50R,D00,518794,Staff,0,0,20,20
1714637605315,MCWP 50R,E00,518795,Staff,0,2,20,20
1714637605315,MCWP 50R,F00,518796,Staff,0,0,20,20
1714637605315,MCWP 50R,G00,518797,Staff,0,1,20,20
1714637606340,MMW 12R,A01,514034,Herbst; Matthew,0,0,16,16
1714637606340,MMW 12R,A02,514035,Herbst; Matthew,1,0,16,15
1714637607366,MMW 13R,A01,514037,Staff,0,4,16,16
1714637607366,MMW 13R,A02,514039,Staff,0,2,16,16
1714637607366,MMW 13R,A03,628519,Staff,0,2,16,16
1714637609425,SIO 295LS,A00,523233,Staff,10,0,30,20
1714637610449,SIO 295S,A00,523232,Staff,10,0,30,20
1714637611474,SIOC 290S,A01,637330,Merrifield; Mark A,23,0,30,7
1714637612505,SIOC 291S,A01,637333,Gabriel; Corey John,23,0,30,7
1714637613538,SOCI 117,A01,494376,Staff,0,4,5,5
1714637614565,WES 237B,A00,494380,Staff,9,0,20,11
1714637616636,AESE 279B,A00,494370,Wade; Jon P,0,0,33,33
1714637617663,AIP 197,001,627712,Vespa; Emanuel Ignacio,9998,0,9999,1
1714637618689,ANAR 135S,A00,494369,Braswell; Geoffrey E.,0,0,0,0
1714637619719,BENG 196,001,628496,Engler; Adam J.,9998,0,9999,1
1714637620747,CAT 124RS,A01,519847,Geibel; William,0,0,20,20
1714637621771,CAT 125RS,A01,515971,Geibel; William,0,0,20,20
1714637622800,CLRE 250,A00,511389,Morris; Sheldon,9993,0,9999,6
1714637623827,CLRE 251,A00,507176,Mehta; Ravindra L.,9993,0,9999,6
1714637623827,CLRE 251,B00,511410,Mehta; Ravindra L.,9998,0,9999,1
1714637624852,CLRE 252,A00,507189,Cuomo; Raphael Eduardo,9995,0,9999,4
1714637625884,CLRE 253,A00,507199,Vaida; Florin,9994,0,9999,5
1714637625884,CLRE 253,B00,507202,Vaida; Florin,9999,0,9999,0
1714637626914,CLRE 259,A00,507211,Patel; Hemal,9996,0,9999,3
1714637627938,CLRE 260,A00,507221,Cuomo; Raphael Eduardo,9999,0,9999,0
1714637628965,CLRE 297,001,507242,Cuomo; Raphael Eduardo,9999,0,9999,0
1714637629995,COGS 197,001,638244,Voytek; Bradley Thomas,9998,0,9999,1
1714637631021,CSE 191,A00,516875,Minnes Kemp; Mor Mia,9992,0,9999,7
1714637632046,CSE 197,001,637388,Minnes Kemp; Mor Mia,9998,0,9999,1
1714637633074,CSS 201S,A01,494383,Staff,35,0,35,0
1714637634104,CSS 202S,A01,494387,Staff,35,0,35,0
1714637635128,DSC 197,001,628532,Eldridge; Justin Matthew,9996,0,9999,3
1714637636154,EAP 100,A00,516065,Staff,9797,0,9999,202
1714637637186,ECE 45,A01,507414,Staff,33,0,60,27
1714637639237,ECE 111,A01,507420,Staff,15,0,50,35
1714637640269,ECE 197,001,548057,Sievenpiper; Daniel F.,9993,0,9999,6
1714637641299,EDS 115,A00,507243,Choi; Bailey Miyeon,10,0,28,18
1714637642327,EDS 117,A01,494379,Staff,0,4,30,30
1714637643353,EDS 125,A00,507246,Hopkins; Megan Beth,9,0,30,21
1714637644381,EDS 128A,A01,507264,Fargason; Sharon Gayle,8,0,26,18
1714637645406,EDS 128B,A01,507293,Pappas; Elizabeth,12,0,30,18
1714637646436,EDS 139,A00,507294,Fargason; Sharon Gayle,13,0,30,17
1714637646436,EDS 139,B00,507313,Pappas; Elizabeth,13,0,30,17
1714637647460,EDS 201,A00,507315,Staff,13,0,30,17
1714637648486,EDS 203,A01,507317,Halter; Christopher P.,12,0,30,18
1714637649511,EDS 204R,A01,507319,Halter; Christopher P.,0,3,30,30
1714637649511,EDS 204R,B01,507331,Heinzman; Erica M.,16,0,30,14
1714637650539,EDS 206R,A00,507332,Staff,0,4,30,30
1714637650539,EDS 206R,B00,507343,Staff,17,0,30,13
1714637651563,EDS 250,A00,507344,Hemans; Patricia Ann Benitez,22,0,40,18
1714637652588,EDS 281,A00,507345,Daly; Alan J.,18,0,18,0
1714637653613,EDS 284,A00,507350,Daly; Alan J.,16,0,16,0
1714637654641,EDS 286,A00,507359,Fine; Sarah,18,0,18,0
1714637655669,EDS 289C,A01,507361,Daly; Alan J.,18,0,18,0
1714637656694,EDS 290,A00,507366,Hofstetter; Carolyn,15,0,15,0
1714637657723,LIGM 5A,A00,507421,Fischer-Grunski; Eva K,18,0,20,2
1714637658747,LIGM 5B,A00,507423,Fischer-Grunski; Eva K,19,0,20,1
1714637659773,LIGM 5C,A00,507425,Fischer-Grunski; Eva K,19,0,20,1
1714637660805,LIIT 5AS,A00,507427,Carnelos; Chiara,20,0,20,0
1714637661833,LIIT 5BS,A00,507430,Carnelos; Chiara,20,0,20,0
1714637662859,LIIT 5CS,A00,507432,Carnelos; Chiara,20,0,20,0
1714637663885,LISP 5A,A00,507541,Munoz Sanchez; Alicia,11,0,20,9
1714637664909,LISP 5B,A00,507671,Munoz Sanchez; Alicia,8,0,20,12
1714637665941,LISP 5C,A00,507696,Munoz Sanchez; Alicia,9,0,20,11
1714637666967,MAE 197,001,528363,Boechler; Nicholas Sebastia,9998,0,9999,1
1714637667995,MATH 197,001,523477,Kedlaya; Kiran S.,9995,0,9999,4
1714637667995,MATH 197,002,563811,Zhang; Danna,9995,0,9999,4
1714637667995,MATH 197,003,628552,Dumitriu; Ioana,9998,0,9999,1
1714637669025,MCWP 40R,A00,518780,Staff,2,0,20,18
1714637669025,MCWP 40R,B00,518781,Staff,8,0,20,12
1714637669025,MCWP 40R,C00,518783,Staff,6,0,20,14
1714637670057,MCWP 50R,A00,518791,Staff,0,0,20,20
1714637670057,MCWP 50R,B00,518792,Staff,0,2,20,20
1714637670057,MCWP 50R,C00,518793,Staff,0,2,20,20
1714637670057,MCWP 50R,D00,518794,Staff,0,0,20,20
1714637670057,MCWP 50R,E00,518795,Staff,0,2,20,20
1714637670057,MCWP 50R,F00,518796,Staff,0,0,20,20
1714637670057,MCWP 50R,G00,518797,Staff,0,1,20,20
1714637671083,MMW 12R,A01,514034,Herbst; Matthew,0,0,16,16
1714637671083,MMW 12R,A02,514035,Herbst; Matthew,1,0,16,15
1714637672109,MMW 13R,A01,514037,Staff,0,4,16,16
1714637672109,MMW 13R,A02,514039,Staff,0,2,16,16
1714637672109,MMW 13R,A03,628519,Staff,0,2,16,16
1714637674163,SIO 295LS,A00,523233,Staff,10,0,30,20
1714637675188,SIO 295S,A00,523232,Staff,10,0,30,20
1714637676222,SIOC 290S,A01,637330,Merrifield; Mark A,23,0,30,7
1714637677248,SIOC 291S,A01,637333,Gabriel; Corey John,23,0,30,7
1714637678275,SOCI 117,A01,494376,Staff,0,4,5,5
1714637679314,WES 237B,A00,494380,Staff,9,0,20,11
1714637681405,AESE 279B,A00,494370,Wade; Jon P,0,0,33,33
1714637682435,AIP 197,001,627712,Vespa; Emanuel Ignacio,9998,0,9999,1
1714637683459,ANAR 135S,A00,494369,Braswell; Geoffrey E.,0,0,0,0
1714637684484,BENG 196,001,628496,Engler; Adam J.,9998,0,9999,1
1714637685515,CAT 124RS,A01,519847,Geibel; William,0,0,20,20
1714637686541,CAT 125RS,A01,515971,Geibel; William,0,0,20,20
1714637687572,CLRE 250,A00,511389,Morris; Sheldon,9993,0,9999,6
1714637688605,CLRE 251,A00,507176,Mehta; Ravindra L.,9993,0,9999,6
1714637688605,CLRE 251,B00,511410,Mehta; Ravindra L.,9998,0,9999,1
1714637689639,CLRE 252,A00,507189,Cuomo; Raphael Eduardo,9995,0,9999,4
1714637690696,CLRE 253,A00,507199,Vaida; Florin,9994,0,9999,5
1714637690696,CLRE 253,B00,507202,Vaida; Florin,9999,0,9999,0
1714637691723,CLRE 259,A00,507211,Patel; Hemal,9996,0,9999,3
1714637692750,CLRE 260,A00,507221,Cuomo; Raphael Eduardo,9999,0,9999,0
1714637693776,CLRE 297,001,507242,Cuomo; Raphael Eduardo,9999,0,9999,0
1714637694804,COGS 197,001,638244,Voytek; Bradley Thomas,9998,0,9999,1
1714637695834,CSE 191,A00,516875,Minnes Kemp; Mor Mia,9992,0,9999,7
1714637696858,CSE 197,001,637388,Minnes Kemp; Mor Mia,9998,0,9999,1
1714637697890,CSS 201S,A01,494383,Staff,35,0,35,0
1714637698920,CSS 202S,A01,494387,Staff,35,0,35,0
1714637699948,DSC 197,001,628532,Eldridge; Justin Matthew,9996,0,9999,3
1714637700973,EAP 100,A00,516065,Staff,9797,0,9999,202
1714637702000,ECE 45,A01,507414,Staff,33,0,60,27
1714637704057,ECE 111,A01,507420,Staff,15,0,50,35
1714637705081,ECE 197,001,548057,Sievenpiper; Daniel F.,9993,0,9999,6
1714637706107,EDS 115,A00,507243,Choi; Bailey Miyeon,10,0,28,18
1714637707133,EDS 117,A01,494379,Staff,0,4,30,30
1714637708216,EDS 125,A00,507246,Hopkins; Megan Beth,9,0,30,21
1714637709243,EDS 128A,A01,507264,Fargason; Sharon Gayle,8,0,26,18
1714637710270,EDS 128B,A01,507293,Pappas; Elizabeth,12,0,30,18
1714637711296,EDS 139,A00,507294,Fargason; Sharon Gayle,13,0,30,17
1714637711296,EDS 139,B00,507313,Pappas; Elizabeth,13,0,30,17
1714637712322,EDS 201,A00,507315,Staff,13,0,30,17
1714637713348,EDS 203,A01,507317,Halter; Christopher P.,12,0,30,18
1714637714374,EDS 204R,A01,507319,Halter; Christopher P.,0,3,30,30
1714637714374,EDS 204R,B01,507331,Heinzman; Erica M.,16,0,30,14
1714637715403,EDS 206R,A00,507332,Staff,0,4,30,30
1714637715403,EDS 206R,B00,507343,Staff,17,0,30,13
1714637716431,EDS 250,A00,507344,Hemans; Patricia Ann Benitez,22,0,40,18
1714637717455,EDS 281,A00,507345,Daly; Alan J.,18,0,18,0
1714637718484,EDS 284,A00,507350,Daly; Alan J.,16,0,16,0
1714637719516,EDS 286,A00,507359,Fine; Sarah,18,0,18,0
1714637720545,EDS 289C,A01,507361,Daly; Alan J.,18,0,18,0
1714637721573,EDS 290,A00,507366,Hofstetter; Carolyn,15,0,15,0
1714637722598,LIGM 5A,A00,507421,Fischer-Grunski; Eva K,18,0,20,2
1714637723625,LIGM 5B,A00,507423,Fischer-Grunski; Eva K,19,0,20,1
1714637724649,LIGM 5C,A00,507425,Fischer-Grunski; Eva K,19,0,20,1
1714637725680,LIIT 5AS,A00,507427,Carnelos; Chiara,20,0,20,0
1714637726708,LIIT 5BS,A00,507430,Carnelos; Chiara,20,0,20,0
1714637727736,LIIT 5CS,A00,507432,Carnelos; Chiara,20,0,20,0
1714637728762,LISP 5A,A00,507541,Munoz Sanchez; Alicia,11,0,20,9
1714637729788,LISP 5B,A00,507671,Munoz Sanchez; Alicia,8,0,20,12
1714637730816,LISP 5C,A00,507696,Munoz Sanchez; Alicia,9,0,20,11
1714637731844,MAE 197,001,528363,Boechler; Nicholas Sebastia,9998,0,9999,1
1714637732871,MATH 197,001,523477,Kedlaya; Kiran S.,9995,0,9999,4
1714637732871,MATH 197,002,563811,Zhang; Danna,9995,0,9999,4
1714637732871,MATH 197,003,628552,Dumitriu; Ioana,9998,0,9999,1
1714637733902,MCWP 40R,A00,518780,Staff,2,0,20,18
1714637733902,MCWP 40R,B00,518781,Staff,8,0,20,12
1714637733902,MCWP 40R,C00,518783,Staff,6,0,20,14
1714637734933,MCWP 50R,A00,518791,Staff,0,0,20,20
1714637734933,MCWP 50R,B00,518792,Staff,0,2,20,20
1714637734933,MCWP 50R,C00,518793,Staff,0,2,20,20
1714637734933,MCWP 50R,D00,518794,Staff,0,1,20,20
1714637734933,MCWP 50R,E00,518795,Staff,0,2,20,20
1714637734933,MCWP 50R,F00,518796,Staff,0,0,20,20
1714637734933,MCWP 50R,G00,518797,Staff,0,1,20,20
1714637735960,MMW 12R,A01,514034,Herbst; Matthew,0,0,16,16
1714637735960,MMW 12R,A02,514035,Herbst; Matthew,1,0,16,15
1714637736985,MMW 13R,A01,514037,Staff,0,4,16,16
1714637736985,MMW 13R,A02,514039,Staff,0,2,16,16
1714637736985,MMW 13R,A03,628519,Staff,0,2,16,16
1714637739040,SIO 295LS,A00,523233,Staff,10,0,30,20
1714637740066,SIO 295S,A00,523232,Staff,10,0,30,20
1714637741092,SIOC 290S,A01,637330,Merrifield; Mark A,23,0,30,7
1714637742121,SIOC 291S,A01,637333,Gabriel; Corey John,23,0,30,7
1714637743147,SOCI 117,A01,494376,Staff,0,4,5,5
1714637744177,WES 237B,A00,494380,Staff,9,0,20,11
1714637746263,AESE 279B,A00,494370,Wade; Jon P,0,0,33,33
1714637747296,AIP 197,001,627712,Vespa; Emanuel Ignacio,9998,0,9999,1
1714637748324,ANAR 135S,A00,494369,Braswell; Geoffrey E.,0,0,0,0
1714637749353,BENG 196,001,628496,Engler; Adam J.,9998,0,9999,1
1714637750383,CAT 124RS,A01,519847,Geibel; William,0,0,20,20
1714637751410,CAT 125RS,A01,515971,Geibel; William,0,0,20,20
1714637752437,CLRE 250,A00,511389,Morris; Sheldon,9993,0,9999,6
1714637753468,CLRE 251,A00,507176,Mehta; Ravindra L.,9993,0,9999,6
1714637753468,CLRE 251,B00,511410,Mehta; Ravindra L.,9998,0,9999,1
1714637754494,CLRE 252,A00,507189,Cuomo; Raphael Eduardo,9995,0,9999,4
1714637755523,CLRE 253,A00,507199,Vaida; Florin,9994,0,9999,5
1714637755523,CLRE 253,B00,507202,Vaida; Florin,9999,0,9999,0
1714637756548,CLRE 259,A00,507211,Patel; Hemal,9996,0,9999,3
1714637757573,CLRE 260,A00,507221,Cuomo; Raphael Eduardo,9999,0,9999,0
1714637758603,CLRE 297,001,507242,Cuomo; Raphael Eduardo,9999,0,9999,0
1714637759629,COGS 197,001,638244,Voytek; Bradley Thomas,9998,0,9999,1
1714637760653,CSE 191,A00,516875,Minnes Kemp; Mor Mia,9992,0,9999,7
1714637761678,CSE 197,001,637388,Minnes Kemp; Mor Mia,9998,0,9999,1
1714637762704,CSS 201S,A01,494383,Staff,35,0,35,0
1714637763730,CSS 202S,A01,494387,Staff,35,0,35,0
1714637764754,DSC 197,001,628532,Eldridge; Justin Matthew,9996,0,9999,3
1714637765784,EAP 100,A00,516065,Staff,9797,0,9999,202
1714637766812,ECE 45,A01,507414,Staff,33,0,60,27
1714637768867,ECE 111,A01,507420,Staff,15,0,50,35
1714637769891,ECE 197,001,548057,Sievenpiper; Daniel F.,9993,0,9999,6
1714637770923,EDS 115,A00,507243,Choi; Bailey Miyeon,10,0,28,18
1714637771948,EDS 117,A01,494379,Staff,0,4,30,30
1714637772979,EDS 125,A00,507246,Hopkins; Megan Beth,9,0,30,21
1714637774005,EDS 128A,A01,507264,Fargason; Sharon Gayle,8,0,26,18
1714637775034,EDS 128B,A01,507293,Pappas; Elizabeth,12,0,30,18
1714637776059,EDS 139,A00,507294,Fargason; Sharon Gayle,13,0,30,17
1714637776059,EDS 139,B00,507313,Pappas; Elizabeth,13,0,30,17
1714637777084,EDS 201,A00,507315,Staff,13,0,30,17
1714637778110,EDS 203,A01,507317,Halter; Christopher P.,12,0,30,18
1714637779142,EDS 204R,A01,507319,Halter; Christopher P.,0,3,30,30
1714637779142,EDS 204R,B01,507331,Heinzman; Erica M.,16,0,30,14
1714637780167,EDS 206R,A00,507332,Staff,0,4,30,30
1714637780167,EDS 206R,B00,507343,Staff,17,0,30,13
1714637781193,EDS 250,A00,507344,Hemans; Patricia Ann Benitez,22,0,40,18
1714637782223,EDS 281,A00,507345,Daly; Alan J.,18,0,18,0
1714637783248,EDS 284,A00,507350,Daly; Alan J.,16,0,16,0
1714637784275,EDS 286,A00,507359,Fine; Sarah,18,0,18,0
1714637785305,EDS 289C,A01,507361,Daly; Alan J.,18,0,18,0
1714637786328,EDS 290,A00,507366,Hofstetter; Carolyn,15,0,15,0
1714637787354,LIGM 5A,A00,507421,Fischer-Grunski; Eva K,18,0,20,2
1714637788380,LIGM 5B,A00,507423,Fischer-Grunski; Eva K,19,0,20,1
1714637789413,LIGM 5C,A00,507425,Fischer-Grunski; Eva K,19,0,20,1
1714637790444,LIIT 5AS,A00,507427,Carnelos; Chiara,20,0,20,0
1714637791473,LIIT 5BS,A00,507430,Carnelos; Chiara,20,0,20,0
1714637792498,LIIT 5CS,A00,507432,Carnelos; Chiara,20,0,20,0
1714637793525,LISP 5A,A00,507541,Munoz Sanchez; Alicia,11,0,20,9
1714637794557,LISP 5B,A00,507671,Munoz Sanchez; Alicia,8,0,20,12
1714637795583,LISP 5C,A00,507696,Munoz Sanchez; Alicia,9,0,20,11
1714637796609,MAE 197,001,528363,Boechler; Nicholas Sebastia,9998,0,9999,1
1714637797638,MATH 197,001,523477,Kedlaya; Kiran S.,9995,0,9999,4
1714637797638,MATH 197,002,563811,Zhang; Danna,9995,0,9999,4
1714637797638,MATH 197,003,628552,Dumitriu; Ioana,9998,0,9999,1
1714637798666,MCWP 40R,A00,518780,Staff,2,0,20,18
1714637798666,MCWP 40R,B00,518781,Staff,8,0,20,12
1714637798666,MCWP 40R,C00,518783,Staff,6,0,20,14
1714637799697,MCWP 50R,A00,518791,Staff,0,0,20,20
1714637799697,MCWP 50R,B00,518792,Staff,0,2,20,20
1714637799697,MCWP 50R,C00,518793,Staff,0,2,20,20
1714637799697,MCWP 50R,D00,518794,Staff,0,1,20,20
1714637799697,MCWP 50R,E00,518795,Staff,0,2,20,20
1714637799697,MCWP 50R,F00,518796,Staff,0,0,20,20
1714637799697,MCWP 50R,G00,518797,Staff,0,1,20,20
1714637800726,MMW 12R,A01,514034,Herbst; Matthew,0,0,16,16
1714637800726,MMW 12R,A02,514035,Herbst; Matthew,1,0,16,15
1714637801751,MMW 13R,A01,514037,Staff,0,4,16,16
1714637801751,MMW 13R,A02,514039,Staff,0,2,16,16
1714637801751,MMW 13R,A03,628519,Staff,0,2,16,16
1714637803801,SIO 295LS,A00,523233,Staff,10,0,30,20
1714637804827,SIO 295S,A00,523232,Staff,10,0,30,20
1714637805857,SIOC 290S,A01,637330,Merrifield; Mark A,23,0,30,7
1714637806884,SIOC 291S,A01,637333,Gabriel; Corey John,23,0,30,7
1714637807915,SOCI 117,A01,494376,Staff,0,4,5,5
1714637808942,WES 237B,A00,494380,Staff,9,0,20,11
1714637811010,AESE 279B,A00,494370,Wade; Jon P,0,0,33,33
1714637812036,AIP 197,001,627712,Vespa; Emanuel Ignacio,9998,0,9999,1
1714637813062,ANAR 135S,A00,494369,Braswell; Geoffrey E.,0,0,0,0
1714637814089,BENG 196,001,628496,Engler; Adam J.,9998,0,9999,1
1714637815114,CAT 124RS,A01,519847,Geibel; William,0,0,20,20
1714637816140,CAT 125RS,A01,515971,Geibel; William,0,0,20,20
1714637817169,CLRE 250,A00,511389,Morris; Sheldon,9993,0,9999,6
1714637818196,CLRE 251,A00,507176,Mehta; Ravindra L.,9993,0,9999,6
1714637818196,CLRE 251,B00,511410,Mehta; Ravindra L.,9998,0,9999,1
1714637819221,CLRE 252,A00,507189,Cuomo; Raphael Eduardo,9995,0,9999,4
1714637820248,CLRE 253,A00,507199,Vaida; Florin,9994,0,9999,5
1714637820248,CLRE 253,B00,507202,Vaida; Florin,9999,0,9999,0
1714637821280,CLRE 259,A00,507211,Patel; Hemal,9996,0,9999,3
1714637822305,CLRE 260,A00,507221,Cuomo; Raphael Eduardo,9999,0,9999,0
1714637823334,CLRE 297,001,507242,Cuomo; Raphael Eduardo,9999,0,9999,0
1714637824360,COGS 197,001,638244,Voytek; Bradley Thomas,9998,0,9999,1
1714637825386,CSE 191,A00,516875,Minnes Kemp; Mor Mia,9992,0,9999,7
1714637826411,CSE 197,001,637388,Minnes Kemp; Mor Mia,9998,0,9999,1
1714637827446,CSS 201S,A01,494383,Staff,35,0,35,0
1714637828474,CSS 202S,A01,494387,Staff,35,0,35,0
1714637829509,DSC 197,001,628532,Eldridge; Justin Matthew,9996,0,9999,3
1714637830535,EAP 100,A00,516065,Staff,9797,0,9999,202
1714637831560,ECE 45,A01,507414,Staff,33,0,60,27
1714637833612,ECE 111,A01,507420,Staff,15,0,50,35
1714637834641,ECE 197,001,548057,Sievenpiper; Daniel F.,9993,0,9999,6
1714637835673,EDS 115,A00,507243,Choi; Bailey Miyeon,10,0,28,18
1714637836702,EDS 117,A01,494379,Staff,0,4,30,30
1714637837727,EDS 125,A00,507246,Hopkins; Megan Beth,9,0,30,21
1714637838757,EDS 128A,A01,507264,Fargason; Sharon Gayle,8,0,26,18
1714637839784,EDS 128B,A01,507293,Pappas; Elizabeth,12,0,30,18
1714637840813,EDS 139,A00,507294,Fargason; Sharon Gayle,13,0,30,17
1714637840813,EDS 139,B00,507313,Pappas; Elizabeth,13,0,30,17
1714637841840,EDS 201,A00,507315,Staff,13,0,30,17
1714637842869,EDS 203,A01,507317,Halter; Christopher P.,12,0,30,18
1714637843900,EDS 204R,A01,507319,Halter; Christopher P.,0,3,30,30
1714637843900,EDS 204R,B01,507331,Heinzman; Erica M.,16,0,30,14
1714637844923,EDS 206R,A00,507332,Staff,0,4,30,30
1714637844923,EDS 206R,B00,507343,Staff,17,0,30,13
1714637845951,EDS 250,A00,507344,Hemans; Patricia Ann Benitez,22,0,40,18
1714637846974,EDS 281,A00,507345,Daly; Alan J.,18,0,18,0
1714637847999,EDS 284,A00,507350,Daly; Alan J.,16,0,16,0
1714637849026,EDS 286,A00,507359,Fine; Sarah,18,0,18,0
1714637850050,EDS 289C,A01,507361,Daly; Alan J.,18,0,18,0
1714637851080,EDS 290,A00,507366,Hofstetter; Carolyn,15,0,15,0
1714637852104,LIGM 5A,A00,507421,Fischer-Grunski; Eva K,18,0,20,2
1714637853134,LIGM 5B,A00,507423,Fischer-Grunski; Eva K,19,0,20,1
1714637854163,LIGM 5C,A00,507425,Fischer-Grunski; Eva K,19,0,20,1
1714637855189,LIIT 5AS,A00,507427,Carnelos; Chiara,20,0,20,0
1714637856218,LIIT 5BS,A00,507430,Carnelos; Chiara,20,0,20,0
1714637857247,LIIT 5CS,A00,507432,Carnelos; Chiara,20,0,20,0
1714637858280,LISP 5A,A00,507541,Munoz Sanchez; Alicia,11,0,20,9
1714637859310,LISP 5B,A00,507671,Munoz Sanchez; Alicia,8,0,20,12
1714637860339,LISP 5C,A00,507696,Munoz Sanchez; Alicia,9,0,20,11
1714637861370,MAE 197,001,528363,Boechler; Nicholas Sebastia,9998,0,9999,1
1714637862398,MATH 197,001,523477,Kedlaya; Kiran S.,9995,0,9999,4
1714637862398,MATH 197,002,563811,Zhang; Danna,9995,0,9999,4
1714637862398,MATH 197,003,628552,Dumitriu; Ioana,9998,0,9999,1
1714637863424,MCWP 40R,A00,518780,Staff,2,0,20,18
1714637863424,MCWP 40R,B00,518781,Staff,8,0,20,12
1714637863424,MCWP 40R,C00,518783,Staff,6,0,20,14
1714637864455,MCWP 50R,A00,518791,Staff,0,0,20,20
1714637864455,MCWP 50R,B00,518792,Staff,0,2,20,20
1714637864455,MCWP 50R,C00,518793,Staff,0,2,20,20
1714637864455,MCWP 50R,D00,518794,Staff,0,1,20,20
1714637864455,MCWP 50R,E00,518795,Staff,0,2,20,20
1714637864455,MCWP 50R,F00,518796,Staff,0,0,20,20
1714637864455,MCWP 50R,G00,518797,Staff,0,1,20,20
1714637865482,MMW 12R,A01,514034,Herbst; Matthew,0,0,16,16
1714637865482,MMW 12R,A02,514035,Herbst; Matthew,1,0,16,15
1714637866505,MMW 13R,A01,514037,Staff,0,4,16,16
1714637866505,MMW 13R,A02,514039,Staff,0,2,16,16
1714637866505,MMW 13R,A03,628519,Staff,0,2,16,16
1714637868559,SIO 295LS,A00,523233,Staff,10,0,30,20
1714637869585,SIO 295S,A00,523232,Staff,10,0,30,20
1714637870616,SIOC 290S,A01,637330,Merrifield; Mark A,23,0,30,7
1714637871642,SIOC 291S,A01,637333,Gabriel; Corey John,23,0,30,7
1714637872666,SOCI 117,A01,494376,Staff,0,4,5,5
1714637873696,WES 237B,A00,494380,Staff,9,0,20,11
1714637875780,AESE 279B,A00,494370,Wade; Jon P,0,0,33,33
1714637876809,AIP 197,001,627712,Vespa; Emanuel Ignacio,9998,0,9999,1
1714637877838,ANAR 135S,A00,494369,Braswell; Geoffrey E.,0,0,0,0
1714637878864,BENG 196,001,628496,Engler; Adam J.,9998,0,9999,1
1714637879941,CAT 124RS,A01,519847,Geibel; William,0,0,20,20
1714637880965,CAT 125RS,A01,515971,Geibel; William,0,0,20,20
1714637881990,CLRE 250,A00,511389,Morris; Sheldon,9993,0,9999,6
1714637883026,CLRE 251,A00,507176,Mehta; Ravindra L.,9993,0,9999,6
1714637883026,CLRE 251,B00,511410,Mehta; Ravindra L.,9998,0,9999,1
1714637884052,CLRE 252,A00,507189,Cuomo; Raphael Eduardo,9995,0,9999,4
1714637885079,CLRE 253,A00,507199,Vaida; Florin,9994,0,9999,5
1714637885079,CLRE 253,B00,507202,Vaida; Florin,9999,0,9999,0
1714637886106,CLRE 259,A00,507211,Patel; Hemal,9996,0,9999,3
1714637887134,CLRE 260,A00,507221,Cuomo; Raphael Eduardo,9999,0,9999,0
1714637888160,CLRE 297,001,507242,Cuomo; Raphael Eduardo,9999,0,9999,0
1714637889185,COGS 197,001,638244,Voytek; Bradley Thomas,9998,0,9999,1
1714637890211,CSE 191,A00,516875,Minnes Kemp; Mor Mia,9992,0,9999,7
1714637891241,CSE 197,001,637388,Minnes Kemp; Mor Mia,9998,0,9999,1
1714637892268,CSS 201S,A01,494383,Staff,35,0,35,0
1714637893292,CSS 202S,A01,494387,Staff,35,0,35,0
1714637894318,DSC 197,001,628532,Eldridge; Justin Matthew,9996,0,9999,3
1714637895360,EAP 100,A00,516065,Staff,9797,0,9999,202
1714637896387,ECE 45,A01,507414,Staff,33,0,60,27
1714637898437,ECE 111,A01,507420,Staff,15,0,50,35
1714637899463,ECE 197,001,548057,Sievenpiper; Daniel F.,9993,0,9999,6
1714637900490,EDS 115,A00,507243,Choi; Bailey Miyeon,10,0,28,18
1714637901516,EDS 117,A01,494379,Staff,0,4,30,30
1714637902542,EDS 125,A00,507246,Hopkins; Megan Beth,9,0,30,21
1714637903568,EDS 128A,A01,507264,Fargason; Sharon Gayle,8,0,26,18
1714637904594,EDS 128B,A01,507293,Pappas; Elizabeth,12,0,30,18
1714637905666,EDS 139,A00,507294,Fargason; Sharon Gayle,13,0,30,17
1714637905666,EDS 139,B00,507313,Pappas; Elizabeth,13,0,30,17
1714637906693,EDS 201,A00,507315,Staff,13,0,30,17
1714637907721,EDS 203,A01,507317,Halter; Christopher P.,12,0,30,18
1714637908748,EDS 204R,A01,507319,Halter; Christopher P.,0,3,30,30
1714637908748,EDS 204R,B01,507331,Heinzman; Erica M.,16,0,30,14
1714637909774,EDS 206R,A00,507332,Staff,0,4,30,30
1714637909774,EDS 206R,B00,507343,Staff,17,0,30,13
1714637910802,EDS 250,A00,507344,Hemans; Patricia Ann Benitez,22,0,40,18
1714637911831,EDS 281,A00,507345,Daly; Alan J.,18,0,18,0
1714637912855,EDS 284,A00,507350,Daly; Alan J.,16,0,16,0
1714637913882,EDS 286,A00,507359,Fine; Sarah,18,0,18,0
1714637914907,EDS 289C,A01,507361,Daly; Alan J.,18,0,18,0
1714637915933,EDS 290,A00,507366,Hofstetter; Carolyn,15,0,15,0
1714637916957,LIGM 5A,A00,507421,Fischer-Grunski; Eva K,18,0,20,2
1714637917987,LIGM 5B,A00,507423,Fischer-Grunski; Eva K,19,0,20,1
1714637919014,LIGM 5C,A00,507425,Fischer-Grunski; Eva K,19,0,20,1
1714637920045,LIIT 5AS,A00,507427,Carnelos; Chiara,20,0,20,0
1714637921073,LIIT 5BS,A00,507430,Carnelos; Chiara,20,0,20,0
1714637922098,LIIT 5CS,A00,507432,Carnelos; Chiara,20,0,20,0
1714637923123,LISP 5A,A00,507541,Munoz Sanchez; Alicia,11,0,20,9
1714637924147,LISP 5B,A00,507671,Munoz Sanchez; Alicia,8,0,20,12
1714637925177,LISP 5C,A00,507696,Munoz Sanchez; Alicia,9,0,20,11
1714637926205,MAE 197,001,528363,Boechler; Nicholas Sebastia,9998,0,9999,1
1714637927234,MATH 197,001,523477,Kedlaya; Kiran S.,9995,0,9999,4
1714637927234,MATH 197,002,563811,Zhang; Danna,9995,0,9999,4
1714637927234,MATH 197,003,628552,Dumitriu; Ioana,9998,0,9999,1
1714637928260,MCWP 40R,A00,518780,Staff,2,0,20,18
1714637928260,MCWP 40R,B00,518781,Staff,8,0,20,12
1714637928260,MCWP 40R,C00,518783,Staff,6,0,20,14
1714637929291,MCWP 50R,A00,518791,Staff,0,0,20,20
1714637929291,MCWP 50R,B00,518792,Staff,0,2,20,20
1714637929291,MCWP 50R,C00,518793,Staff,0,2,20,20
1714637929291,MCWP 50R,D00,518794,Staff,0,1,20,20
1714637929291,MCWP 50R,E00,518795,Staff,0,2,20,20
1714637929291,MCWP 50R,F00,518796,Staff,0,0,20,20
1714637929291,MCWP 50R,G00,518797,Staff,0,1,20,20
1714637930317,MMW 12R,A01,514034,Herbst; Matthew,0,0,16,16
1714637930317,MMW 12R,A02,514035,Herbst; Matthew,1,0,16,15
1714637931344,MMW 13R,A01,514037,Staff,0,4,16,16
1714637931344,MMW 13R,A02,514039,Staff,0,2,16,16
1714637931344,MMW 13R,A03,628519,Staff,0,2,16,16
1714637933396,SIO 295LS,A00,523233,Staff,10,0,30,20
1714637934424,SIO 295S,A00,523232,Staff,10,0,30,20
1714637935448,SIOC 290S,A01,637330,Merrifield; Mark A,23,0,30,7
1714637936478,SIOC 291S,A01,637333,Gabriel; Corey John,23,0,30,7
1714637937504,SOCI 117,A01,494376,Staff,0,4,5,5
1714637938531,WES 237B,A00,494380,Staff,9,0,20,11
1714637940603,AESE 279B,A00,494370,Wade; Jon P,0,0,33,33
1714637941630,AIP 197,001,627712,Vespa; Emanuel Ignacio,9998,0,9999,1
1714637942660,ANAR 135S,A00,494369,Braswell; Geoffrey E.,0,0,0,0
1714637943690,BENG 196,001,628496,Engler; Adam J.,9998,0,9999,1
1714637944719,CAT 124RS,A01,519847,Geibel; William,0,0,20,20
1714637945743,CAT 125RS,A01,515971,Geibel; William,0,0,20,20
1714637946768,CLRE 250,A00,511389,Morris; Sheldon,9993,0,9999,6
1714637947796,CLRE 251,A00,507176,Mehta; Ravindra L.,9993,0,9999,6
1714637947796,CLRE 251,B00,511410,Mehta; Ravindra L.,9998,0,9999,1
1714637948822,CLRE 252,A00,507189,Cuomo; Raphael Eduardo,9995,0,9999,4
1714637949851,CLRE 253,A00,507199,Vaida; Florin,9994,0,9999,5
1714637949851,CLRE 253,B00,507202,Vaida; Florin,9999,0,9999,0
1714637950878,CLRE 259,A00,507211,Patel; Hemal,9996,0,9999,3
1714637951903,CLRE 260,A00,507221,Cuomo; Raphael Eduardo,9999,0,9999,0
1714637952929,CLRE 297,001,507242,Cuomo; Raphael Eduardo,9999,0,9999,0
1714637953953,COGS 197,001,638244,Voytek; Bradley Thomas,9998,0,9999,1
1714637954983,CSE 191,A00,516875,Minnes Kemp; Mor Mia,9992,0,9999,7
1714637956012,CSE 197,001,637388,Minnes Kemp; Mor Mia,9998,0,9999,1
1714637957041,CSS 201S,A01,494383,Staff,35,0,35,0
1714637958068,CSS 202S,A01,494387,Staff,35,0,35,0
1714637959096,DSC 197,001,628532,Eldridge; Justin Matthew,9996,0,9999,3
1714637960123,EAP 100,A00,516065,Staff,9797,0,9999,202
1714637961153,ECE 45,A01,507414,Staff,33,0,60,27
1714637963211,ECE 111,A01,507420,Staff,15,0,50,35
1714637964239,ECE 197,001,548057,Sievenpiper; Daniel F.,9993,0,9999,6
1714637965264,EDS 115,A00,507243,Choi; Bailey Miyeon,10,0,28,18
1714637966292,EDS 117,A01,494379,Staff,0,4,30,30
1714637967318,EDS 125,A00,507246,Hopkins; Megan Beth,9,0,30,21
1714637968343,EDS 128A,A01,507264,Fargason; Sharon Gayle,8,0,26,18
1714637969369,EDS 128B,A01,507293,Pappas; Elizabeth,12,0,30,18
1714637970396,EDS 139,A00,507294,Fargason; Sharon Gayle,13,0,30,17
1714637970396,EDS 139,B00,507313,Pappas; Elizabeth,13,0,30,17
1714637971422,EDS 201,A00,507315,Staff,13,0,30,17
1714637972449,EDS 203,A01,507317,Halter; Christopher P.,12,0,30,18
1714637973474,EDS 204R,A01,507319,Halter; Christopher P.,0,3,30,30
1714637973474,EDS 204R,B01,507331,Heinzman; Erica M.,16,0,30,14
1714637974499,EDS 206R,A00,507332,Staff,0,4,30,30
1714637974499,EDS 206R,B00,507343,Staff,17,0,30,13
1714637975528,EDS 250,A00,507344,Hemans; Patricia Ann Benitez,22,0,40,18
1714637976556,EDS 281,A00,507345,Daly; Alan J.,18,0,18,0
1714637977579,EDS 284,A00,507350,Daly; Alan J.,16,0,16,0
1714637978605,EDS 286,A00,507359,Fine; Sarah,18,0,18,0
1714637979631,EDS 289C,A01,507361,Daly; Alan J.,18,0,18,0
1714637980655,EDS 290,A00,507366,Hofstetter; Carolyn,15,0,15,0
1714637981687,LIGM 5A,A00,507421,Fischer-Grunski; Eva K,18,0,20,2
1714637982713,LIGM 5B,A00,507423,Fischer-Grunski; Eva K,19,0,20,1
1714637983743,LIGM 5C,A00,507425,Fischer-Grunski; Eva K,19,0,20,1
1714637984768,LIIT 5AS,A00,507427,Carnelos; Chiara,20,0,20,0
1714637985797,LIIT 5BS,A00,507430,Carnelos; Chiara,20,0,20,0
1714637986822,LIIT 5CS,A00,507432,Carnelos; Chiara,20,0,20,0
1714637987847,LISP 5A,A00,507541,Munoz Sanchez; Alicia,11,0,20,9
1714637988872,LISP 5B,A00,507671,Munoz Sanchez; Alicia,8,0,20,12
1714637989898,LISP 5C,A00,507696,Munoz Sanchez; Alicia,9,0,20,11
1714637990925,MAE 197,001,528363,Boechler; Nicholas Sebastia,9998,0,9999,1
1714637991956,MATH 197,001,523477,Kedlaya; Kiran S.,9995,0,9999,4
1714637991956,MATH 197,002,563811,Zhang; Danna,9995,0,9999,4
1714637991956,MATH 197,003,628552,Dumitriu; Ioana,9998,0,9999,1
1714637992986,MCWP 40R,A00,518780,Staff,2,0,20,18
1714637992986,MCWP 40R,B00,518781,Staff,8,0,20,12
1714637992986,MCWP 40R,C00,518783,Staff,6,0,20,14
1714637994018,MCWP 50R,A00,518791,Staff,0,0,20,20
1714637994018,MCWP 50R,B00,518792,Staff,0,2,20,20
1714637994018,MCWP 50R,C00,518793,Staff,0,2,20,20
1714637994018,MCWP 50R,D00,518794,Staff,0,1,20,20
1714637994018,MCWP 50R,E00,518795,Staff,0,2,20,20
1714637994018,MCWP 50R,F00,518796,Staff,0,0,20,20
1714637994018,MCWP 50R,G00,518797,Staff,0,1,20,20
1714637995044,MMW 12R,A01,514034,Herbst; Matthew,0,0,16,16
1714637995044,MMW 12R,A02,514035,Herbst; Matthew,1,0,16,15
1714637996069,MMW 13R,A01,514037,Staff,0,4,16,16
1714637996069,MMW 13R,A02,514039,Staff,0,2,16,16
1714637996069,MMW 13R,A03,628519,Staff,0,2,16,16
1714637998122,SIO 295LS,A00,523233,Staff,10,0,30,20
1714637999146,SIO 295S,A00,523232,Staff,10,0,30,20
1714638000173,SIOC 290S,A01,637330,Merrifield; Mark A,23,0,30,7
1714638001204,SIOC 291S,A01,637333,Gabriel; Corey John,23,0,30,7
1714638002230,SOCI 117,A01,494376,Staff,0,4,5,5
1714638003262,WES 237B,A00,494380,Staff,9,0,20,11
1714638005344,AESE 279B,A00,494370,Wade; Jon P,0,0,33,33
1714638006370,AIP 197,001,627712,Vespa; Emanuel Ignacio,9998,0,9999,1
1714638007396,ANAR 135S,A00,494369,Braswell; Geoffrey E.,0,0,0,0
1714638008424,BENG 196,001,628496,Engler; Adam J.,9998,0,9999,1
1714638009450,CAT 124RS,A01,519847,Geibel; William,0,0,20,20
1714638010477,CAT 125RS,A01,515971,Geibel; William,0,0,20,20
1714638011508,CLRE 250,A00,511389,Morris; Sheldon,9993,0,9999,6
1714638012537,CLRE 251,A00,507176,Mehta; Ravindra L.,9993,0,9999,6
1714638012537,CLRE 251,B00,511410,Mehta; Ravindra L.,9998,0,9999,1
1714638013563,CLRE 252,A00,507189,Cuomo; Raphael Eduardo,9995,0,9999,4
1714638014594,CLRE 253,A00,507199,Vaida; Florin,9994,0,9999,5
1714638014594,CLRE 253,B00,507202,Vaida; Florin,9999,0,9999,0
1714638015620,CLRE 259,A00,507211,Patel; Hemal,9996,0,9999,3
1714638016649,CLRE 260,A00,507221,Cuomo; Raphael Eduardo,9999,0,9999,0
1714638017677,CLRE 297,001,507242,Cuomo; Raphael Eduardo,9999,0,9999,0
1714638018703,COGS 197,001,638244,Voytek; Bradley Thomas,9998,0,9999,1
1714638019730,CSE 191,A00,516875,Minnes Kemp; Mor Mia,9992,0,9999,7
1714638020756,CSE 197,001,637388,Minnes Kemp; Mor Mia,9998,0,9999,1
1714638021787,CSS 201S,A01,494383,Staff,35,0,35,0
1714638022816,CSS 202S,A01,494387,Staff,35,0,35,0
1714638023842,DSC 197,001,628532,Eldridge; Justin Matthew,9996,0,9999,3
1714638024867,EAP 100,A00,516065,Staff,9797,0,9999,202
1714638025896,ECE 45,A01,507414,Staff,33,0,60,27
1714638027955,ECE 111,A01,507420,Staff,15,0,50,35
1714638028981,ECE 197,001,548057,Sievenpiper; Daniel F.,9993,0,9999,6
1714638030006,EDS 115,A00,507243,Choi; Bailey Miyeon,10,0,28,18
1714638031033,EDS 117,A01,494379,Staff,0,4,30,30
1714638032069,EDS 125,A00,507246,Hopkins; Megan Beth,9,0,30,21
1714638033096,EDS 128A,A01,507264,Fargason; Sharon Gayle,8,0,26,18
1714638034120,EDS 128B,A01,507293,Pappas; Elizabeth,12,0,30,18
1714638035149,EDS 139,A00,507294,Fargason; Sharon Gayle,13,0,30,17
1714638035149,EDS 139,B00,507313,Pappas; Elizabeth,13,0,30,17
1714638036178,EDS 201,A00,507315,Staff,13,0,30,17
1714638037209,EDS 203,A01,507317,Halter; Christopher P.,12,0,30,18
1714638038239,EDS 204R,A01,507319,Halter; Christopher P.,0,3,30,30
1714638038239,EDS 204R,B01,507331,Heinzman; Erica M.,16,0,30,14
1714638039267,EDS 206R,A00,507332,Staff,0,4,30,30
1714638039267,EDS 206R,B00,507343,Staff,17,0,30,13
1714638040293,EDS 250,A00,507344,Hemans; Patricia Ann Benitez,22,0,40,18
1714638041320,EDS 281,A00,507345,Daly; Alan J.,18,0,18,0
1714638042347,EDS 284,A00,507350,Daly; Alan J.,16,0,16,0
1714638043375,EDS 286,A00,507359,Fine; Sarah,18,0,18,0
1714638044404,EDS 289C,A01,507361,Daly; Alan J.,18,0,18,0
1714638045429,EDS 290,A00,507366,Hofstetter; Carolyn,15,0,15,0
1714638046459,LIGM 5A,A00,507421,Fischer-Grunski; Eva K,18,0,20,2
1714638047484,LIGM 5B,A00,507423,Fischer-Grunski; Eva K,19,0,20,1
1714638048510,LIGM 5C,A00,507425,Fischer-Grunski; Eva K,19,0,20,1
1714638049537,LIIT 5AS,A00,507427,Carnelos; Chiara,20,0,20,0
1714638050562,LIIT 5BS,A00,507430,Carnelos; Chiara,20,0,20,0
1714638051588,LIIT 5CS,A00,507432,Carnelos; Chiara,20,0,20,0
1714638052619,LISP 5A,A00,507541,Munoz Sanchez; Alicia,11,0,20,9
1714638053645,LISP 5B,A00,507671,Munoz Sanchez; Alicia,8,0,20,12
1714638054669,LISP 5C,A00,507696,Munoz Sanchez; Alicia,9,0,20,11
1714638055695,MAE 197,001,528363,Boechler; Nicholas Sebastia,9998,0,9999,1
1714638056724,MATH 197,001,523477,Kedlaya; Kiran S.,9995,0,9999,4
1714638056724,MATH 197,002,563811,Zhang; Danna,9995,0,9999,4
1714638056724,MATH 197,003,628552,Dumitriu; Ioana,9998,0,9999,1
1714638057751,MCWP 40R,A00,518780,Staff,2,0,20,18
1714638057751,MCWP 40R,B00,518781,Staff,8,0,20,12
1714638057751,MCWP 40R,C00,518783,Staff,6,0,20,14
1714638058777,MCWP 50R,A00,518791,Staff,0,0,20,20
1714638058777,MCWP 50R,B00,518792,Staff,0,2,20,20
1714638058777,MCWP 50R,C00,518793,Staff,0,2,20,20
1714638058777,MCWP 50R,D00,518794,Staff,0,1,20,20
1714638058777,MCWP 50R,E00,518795,Staff,0,2,20,20
1714638058777,MCWP 50R,F00,518796,Staff,0,0,20,20
1714638058777,MCWP 50R,G00,518797,Staff,0,1,20,20
1714638059807,MMW 12R,A01,514034,Herbst; Matthew,0,0,16,16
1714638059807,MMW 12R,A02,514035,Herbst; Matthew,1,0,16,15
1714638060832,MMW 13R,A01,514037,Staff,0,4,16,16
1714638060832,MMW 13R,A02,514039,Staff,0,2,16,16
1714638060832,MMW 13R,A03,628519,Staff,0,2,16,16
1714638062890,SIO 295LS,A00,523233,Staff,10,0,30,20
1714638063916,SIO 295S,A00,523232,Staff,10,0,30,20
1714638064946,SIOC 290S,A01,637330,Merrifield; Mark A,23,0,30,7
1714638065973,SIOC 291S,A01,637333,Gabriel; Corey John,23,0,30,7
1714638067002,SOCI 117,A01,494376,Staff,0,4,5,5
1714638068027,WES 237B,A00,494380,Staff,9,0,20,11
1714638070116,AESE 279B,A00,494370,Wade; Jon P,0,0,33,33
1714638071145,AIP 197,001,627712,Vespa; Emanuel Ignacio,9998,0,9999,1
1714638072172,ANAR 135S,A00,494369,Braswell; Geoffrey E.,0,0,0,0
1714638073203,BENG 196,001,628496,Engler; Adam J.,9998,0,9999,1
1714638074229,CAT 124RS,A01,519847,Geibel; William,0,0,20,20
1714638075254,CAT 125RS,A01,515971,Geibel; William,0,0,20,20
1714638076281,CLRE 250,A00,511389,Morris; Sheldon,9993,0,9999,6
1714638077308,CLRE 251,A00,507176,Mehta; Ravindra L.,9993,0,9999,6
1714638077308,CLRE 251,B00,511410,Mehta; Ravindra L.,9998,0,9999,1
1714638078334,CLRE 252,A00,507189,Cuomo; Raphael Eduardo,9995,0,9999,4
1714638079360,CLRE 253,A00,507199,Vaida; Florin,9994,0,9999,5
1714638079360,CLRE 253,B00,507202,Vaida; Florin,9999,0,9999,0
1714638080383,CLRE 259,A00,507211,Patel; Hemal,9996,0,9999,3
1714638081409,CLRE 260,A00,507221,Cuomo; Raphael Eduardo,9999,0,9999,0
1714638082433,CLRE 297,001,507242,Cuomo; Raphael Eduardo,9999,0,9999,0
1714638083460,COGS 197,001,638244,Voytek; Bradley Thomas,9998,0,9999,1
1714638084485,CSE 191,A00,516875,Minnes Kemp; Mor Mia,9992,0,9999,7
1714638085514,CSE 197,001,637388,Minnes Kemp; Mor Mia,9998,0,9999,1
1714638086540,CSS 201S,A01,494383,Staff,35,0,35,0
1714638087567,CSS 202S,A01,494387,Staff,35,0,35,0
1714638088597,DSC 197,001,628532,Eldridge; Justin Matthew,9996,0,9999,3
1714638089621,EAP 100,A00,516065,Staff,9797,0,9999,202
1714638090653,ECE 45,A01,507414,Staff,33,0,60,27
1714638092705,ECE 111,A01,507420,Staff,15,0,50,35
1714638093732,ECE 197,001,548057,Sievenpiper; Daniel F.,9993,0,9999,6
1714638094758,EDS 115,A00,507243,Choi; Bailey Miyeon,10,0,28,18
1714638095788,EDS 117,A01,494379,Staff,0,4,30,30
1714638096819,EDS 125,A00,507246,Hopkins; Megan Beth,9,0,30,21
1714638097848,EDS 128A,A01,507264,Fargason; Sharon Gayle,8,0,26,18
1714638098876,EDS 128B,A01,507293,Pappas; Elizabeth,12,0,30,18
1714638099904,EDS 139,A00,507294,Fargason; Sharon Gayle,13,0,30,17
1714638099904,EDS 139,B00,507313,Pappas; Elizabeth,13,0,30,17
1714638100928,EDS 201,A00,507315,Staff,13,0,30,17
1714638101954,EDS 203,A01,507317,Halter; Christopher P.,12,0,30,18
1714638102978,EDS 204R,A01,507319,Halter; Christopher P.,0,3,30,30
1714638102978,EDS 204R,B01,507331,Heinzman; Erica M.,16,0,30,14
1714638104004,EDS 206R,A00,507332,Staff,0,4,30,30
1714638104004,EDS 206R,B00,507343,Staff,17,0,30,13
1714638105031,EDS 250,A00,507344,Hemans; Patricia Ann Benitez,22,0,40,18
1714638106059,EDS 281,A00,507345,Daly; Alan J.,18,0,18,0
1714638107085,EDS 284,A00,507350,Daly; Alan J.,16,0,16,0
1714638108116,EDS 286,A00,507359,Fine; Sarah,18,0,18,0
1714638109142,EDS 289C,A01,507361,Daly; Alan J.,18,0,18,0
1714638110170,EDS 290,A00,507366,Hofstetter; Carolyn,15,0,15,0
1714638111199,LIGM 5A,A00,507421,Fischer-Grunski; Eva K,18,0,20,2
1714638112225,LIGM 5B,A00,507423,Fischer-Grunski; Eva K,19,0,20,1
1714638113250,LIGM 5C,A00,507425,Fischer-Grunski; Eva K,19,0,20,1
1714638114331,LIIT 5AS,A00,507427,Carnelos; Chiara,20,0,20,0
1714638115356,LIIT 5BS,A00,507430,Carnelos; Chiara,20,0,20,0
1714638116386,LIIT 5CS,A00,507432,Carnelos; Chiara,20,0,20,0
1714638117412,LISP 5A,A00,507541,Munoz Sanchez; Alicia,11,0,20,9
1714638118440,LISP 5B,A00,507671,Munoz Sanchez; Alicia,8,0,20,12
1714638119470,LISP 5C,A00,507696,Munoz Sanchez; Alicia,9,0,20,11
1714638120498,MAE 197,001,528363,Boechler; Nicholas Sebastia,9998,0,9999,1
1714638121525,MATH 197,001,523477,Kedlaya; Kiran S.,9995,0,9999,4
1714638121525,MATH 197,002,563811,Zhang; Danna,9995,0,9999,4
1714638121525,MATH 197,003,628552,Dumitriu; Ioana,9998,0,9999,1
1714638122553,MCWP 40R,A00,518780,Staff,2,0,20,18
1714638122553,MCWP 40R,B00,518781,Staff,8,0,20,12
1714638122553,MCWP 40R,C00,518783,Staff,6,0,20,14
1714638123580,MCWP 50R,A00,518791,Staff,0,0,20,20
1714638123580,MCWP 50R,B00,518792,Staff,0,2,20,20
1714638123580,MCWP 50R,C00,518793,Staff,0,2,20,20
1714638123580,MCWP 50R,D00,518794,Staff,0,1,20,20
1714638123580,MCWP 50R,E00,518795,Staff,0,2,20,20
1714638123580,MCWP 50R,F00,518796,Staff,0,0,20,20
1714638123580,MCWP 50R,G00,518797,Staff,0,1,20,20
1714638124604,MMW 12R,A01,514034,Herbst; Matthew,0,0,16,16
1714638124604,MMW 12R,A02,514035,Herbst; Matthew,1,0,16,15
1714638125629,MMW 13R,A01,514037,Staff,0,4,16,16
1714638125629,MMW 13R,A02,514039,Staff,0,2,16,16
1714638125629,MMW 13R,A03,628519,Staff,0,2,16,16
1714638127687,SIO 295LS,A00,523233,Staff,10,0,30,20
1714638128713,SIO 295S,A00,523232,Staff,10,0,30,20
1714638129741,SIOC 290S,A01,637330,Merrifield; Mark A,23,0,30,7
1714638130773,SIOC 291S,A01,637333,Gabriel; Corey John,23,0,30,7
1714638131804,SOCI 117,A01,494376,Staff,0,4,5,5
1714638132830,WES 237B,A00,494380,Staff,9,0,20,11
1714638134917,AESE 279B,A00,494370,Wade; Jon P,0,0,33,33
1714638135942,AIP 197,001,627712,Vespa; Emanuel Ignacio,9998,0,9999,1
1714638136971,ANAR 135S,A00,494369,Braswell; Geoffrey E.,0,0,0,0
1714638137997,BENG 196,001,628496,Engler; Adam J.,9998,0,9999,1
1714638139027,CAT 124RS,A01,519847,Geibel; William,0,0,20,20
1714638140052,CAT 125RS,A01,515971,Geibel; William,0,0,20,20
1714638141081,CLRE 250,A00,511389,Morris; Sheldon,9993,0,9999,6
1714638142114,CLRE 251,A00,507176,Mehta; Ravindra L.,9993,0,9999,6
1714638142114,CLRE 251,B00,511410,Mehta; Ravindra L.,9998,0,9999,1
1714638143139,CLRE 252,A00,507189,Cuomo; Raphael Eduardo,9995,0,9999,4
1714638144166,CLRE 253,A00,507199,Vaida; Florin,9994,0,9999,5
1714638144166,CLRE 253,B00,507202,Vaida; Florin,9999,0,9999,0
1714638145193,CLRE 259,A00,507211,Patel; Hemal,9996,0,9999,3
1714638146222,CLRE 260,A00,507221,Cuomo; Raphael Eduardo,9999,0,9999,0
1714638147247,CLRE 297,001,507242,Cuomo; Raphael Eduardo,9999,0,9999,0
1714638148277,COGS 197,001,638244,Voytek; Bradley Thomas,9998,0,9999,1
1714638149302,CSE 191,A00,516875,Minnes Kemp; Mor Mia,9992,0,9999,7
1714638150326,CSE 197,001,637388,Minnes Kemp; Mor Mia,9998,0,9999,1
1714638151353,CSS 201S,A01,494383,Staff,35,0,35,0
1714638152378,CSS 202S,A01,494387,Staff,35,0,35,0
1714638153403,DSC 197,001,628532,Eldridge; Justin Matthew,9996,0,9999,3
1714638154427,EAP 100,A00,516065,Staff,9797,0,9999,202
1714638155456,ECE 45,A01,507414,Staff,33,0,60,27
1714638157507,ECE 111,A01,507420,Staff,15,0,50,35
1714638158533,ECE 197,001,548057,Sievenpiper; Daniel F.,9993,0,9999,6
1714638159561,EDS 115,A00,507243,Choi; Bailey Miyeon,10,0,28,18
1714638160588,EDS 117,A01,494379,Staff,0,4,30,30
1714638161615,EDS 125,A00,507246,Hopkins; Megan Beth,9,0,30,21
1714638162641,EDS 128A,A01,507264,Fargason; Sharon Gayle,8,0,26,18
1714638163666,EDS 128B,A01,507293,Pappas; Elizabeth,12,0,30,18
1714638164692,EDS 139,A00,507294,Fargason; Sharon Gayle,13,0,30,17
1714638164692,EDS 139,B00,507313,Pappas; Elizabeth,13,0,30,17
1714638165719,EDS 201,A00,507315,Staff,13,0,30,17
1714638166746,EDS 203,A01,507317,Halter; Christopher P.,12,0,30,18
1714638167776,EDS 204R,A01,507319,Halter; Christopher P.,0,3,30,30
1714638167776,EDS 204R,B01,507331,Heinzman; Erica M.,16,0,30,14
1714638168802,EDS 206R,A00,507332,Staff,0,4,30,30
1714638168802,EDS 206R,B00,507343,Staff,17,0,30,13
1714638169829,EDS 250,A00,507344,Hemans; Patricia Ann Benitez,22,0,40,18
1714638170855,EDS 281,A00,507345,Daly; Alan J.,18,0,18,0
1714638171880,EDS 284,A00,507350,Daly; Alan J.,16,0,16,0
1714638172906,EDS 286,A00,507359,Fine; Sarah,18,0,18,0
1714638173930,EDS 289C,A01,507361,Daly; Alan J.,18,0,18,0
1714638174960,EDS 290,A00,507366,Hofstetter; Carolyn,15,0,15,0
1714638175987,LIGM 5A,A00,507421,Fischer-Grunski; Eva K,18,0,20,2
1714638177012,LIGM 5B,A00,507423,Fischer-Grunski; Eva K,19,0,20,1
1714638178038,LIGM 5C,A00,507425,Fischer-Grunski; Eva K,19,0,20,1
1714638179062,LIIT 5AS,A00,507427,Carnelos; Chiara,20,0,20,0
1714638180094,LIIT 5BS,A00,507430,Carnelos; Chiara,20,0,20,0
1714638181121,LIIT 5CS,A00,507432,Carnelos; Chiara,20,0,20,0
1714638182148,LISP 5A,A00,507541,Munoz Sanchez; Alicia,11,0,20,9
1714638183178,LISP 5B,A00,507671,Munoz Sanchez; Alicia,8,0,20,12
1714638184203,LISP 5C,A00,507696,Munoz Sanchez; Alicia,9,0,20,11
1714638185229,MAE 197,001,528363,Boechler; Nicholas Sebastia,9998,0,9999,1
1714638186262,MATH 197,001,523477,Kedlaya; Kiran S.,9995,0,9999,4
1714638186262,MATH 197,002,563811,Zhang; Danna,9995,0,9999,4
1714638186262,MATH 197,003,628552,Dumitriu; Ioana,9998,0,9999,1
1714638187287,MCWP 40R,A00,518780,Staff,2,0,20,18
1714638187287,MCWP 40R,B00,518781,Staff,8,0,20,12
1714638187287,MCWP 40R,C00,518783,Staff,6,0,20,14
1714638188320,MCWP 50R,A00,518791,Staff,0,0,20,20
1714638188320,MCWP 50R,B00,518792,Staff,0,2,20,20
1714638188320,MCWP 50R,C00,518793,Staff,0,2,20,20
1714638188320,MCWP 50R,D00,518794,Staff,0,1,20,20
1714638188320,MCWP 50R,E00,518795,Staff,0,2,20,20
1714638188320,MCWP 50R,F00,518796,Staff,0,0,20,20
1714638188320,MCWP 50R,G00,518797,Staff,0,1,20,20
1714638189349,MMW 12R,A01,514034,Herbst; Matthew,0,0,16,16
1714638189349,MMW 12R,A02,514035,Herbst; Matthew,1,0,16,15
1714638190376,MMW 13R,A01,514037,Staff,0,4,16,16
1714638190376,MMW 13R,A02,514039,Staff,0,2,16,16
1714638190376,MMW 13R,A03,628519,Staff,0,2,16,16
1714638192434,SIO 295LS,A00,523233,Staff,10,0,30,20
1714638193458,SIO 295S,A00,523232,Staff,10,0,30,20
1714638194486,SIOC 290S,A01,637330,Merrifield; Mark A,23,0,30,7
1714638195513,SIOC 291S,A01,637333,Gabriel; Corey John,23,0,30,7
1714638196539,SOCI 117,A01,494376,Staff,0,4,5,5
1714638197567,WES 237B,A00,494380,Staff,9,0,20,11
1714638199644,AESE 279B,A00,494370,Wade; Jon P,0,0,33,33
1714638200672,AIP 197,001,627712,Vespa; Emanuel Ignacio,9998,0,9999,1
1714638201700,ANAR 135S,A00,494369,Braswell; Geoffrey E.,0,0,0,0
1714638202724,BENG 196,001,628496,Engler; Adam J.,9998,0,9999,1
1714638203751,CAT 124RS,A01,519847,Geibel; William,0,0,20,20
1714638204776,CAT 125RS,A01,515971,Geibel; William,0,0,20,20
1714638205811,CLRE 250,A00,511389,Morris; Sheldon,9993,0,9999,6
1714638206836,CLRE 251,A00,507176,Mehta; Ravindra L.,9993,0,9999,6
1714638206836,CLRE 251,B00,511410,Mehta; Ravindra L.,9998,0,9999,1
1714638207866,CLRE 252,A00,507189,Cuomo; Raphael Eduardo,9995,0,9999,4
1714638208893,CLRE 253,A00,507199,Vaida; Florin,9994,0,9999,5
1714638208893,CLRE 253,B00,507202,Vaida; Florin,9999,0,9999,0
1714638209922,CLRE 259,A00,507211,Patel; Hemal,9996,0,9999,3
1714638210948,CLRE 260,A00,507221,Cuomo; Raphael Eduardo,9999,0,9999,0
1714638211973,CLRE 297,001,507242,Cuomo; Raphael Eduardo,9999,0,9999,0
1714638212999,COGS 197,001,638244,Voytek; Bradley Thomas,9998,0,9999,1
1714638214028,CSE 191,A00,516875,Minnes Kemp; Mor Mia,9992,0,9999,7
1714638215057,CSE 197,001,637388,Minnes Kemp; Mor Mia,9998,0,9999,1
1714638216086,CSS 201S,A01,494383,Staff,35,0,35,0
1714638217113,CSS 202S,A01,494387,Staff,35,0,35,0
1714638218192,DSC 197,001,628532,Eldridge; Justin Matthew,9996,0,9999,3
1714638219219,EAP 100,A00,516065,Staff,9797,0,9999,202
1714638220247,ECE 45,A01,507414,Staff,33,0,60,27
1714638222298,ECE 111,A01,507420,Staff,15,0,50,35
1714638223325,ECE 197,001,548057,Sievenpiper; Daniel F.,9993,0,9999,6
1714638224354,EDS 115,A00,507243,Choi; Bailey Miyeon,10,0,28,18
1714638225380,EDS 117,A01,494379,Staff,0,4,30,30
1714638226407,EDS 125,A00,507246,Hopkins; Megan Beth,9,0,30,21
1714638227435,EDS 128A,A01,507264,Fargason; Sharon Gayle,8,0,26,18
1714638228460,EDS 128B,A01,507293,Pappas; Elizabeth,12,0,30,18
1714638229485,EDS 139,A00,507294,Fargason; Sharon Gayle,13,0,30,17
1714638229485,EDS 139,B00,507313,Pappas; Elizabeth,13,0,30,17
1714638230513,EDS 201,A00,507315,Staff,13,0,30,17
1714638231543,EDS 203,A01,507317,Halter; Christopher P.,12,0,30,18
1714638232568,EDS 204R,A01,507319,Halter; Christopher P.,0,3,30,30
1714638232568,EDS 204R,B01,507331,Heinzman; Erica M.,16,0,30,14
1714638233597,EDS 206R,A00,507332,Staff,0,4,30,30
1714638233597,EDS 206R,B00,507343,Staff,17,0,30,13
1714638234621,EDS 250,A00,507344,Hemans; Patricia Ann Benitez,22,0,40,18
1714638235645,EDS 281,A00,507345,Daly; Alan J.,18,0,18,0
1714638236673,EDS 284,A00,507350,Daly; Alan J.,16,0,16,0
1714638237703,EDS 286,A00,507359,Fine; Sarah,18,0,18,0
1714638238730,EDS 289C,A01,507361,Daly; Alan J.,18,0,18,0
1714638239758,EDS 290,A00,507366,Hofstetter; Carolyn,15,0,15,0
1714638240785,LIGM 5A,A00,507421,Fischer-Grunski; Eva K,18,0,20,2
1714638241809,LIGM 5B,A00,507423,Fischer-Grunski; Eva K,19,0,20,1
1714638242834,LIGM 5C,A00,507425,Fischer-Grunski; Eva K,19,0,20,1
1714638243860,LIIT 5AS,A00,507427,Carnelos; Chiara,20,0,20,0
1714638244888,LIIT 5BS,A00,507430,Carnelos; Chiara,20,0,20,0
1714638245918,LIIT 5CS,A00,507432,Carnelos; Chiara,20,0,20,0
1714638246947,LISP 5A,A00,507541,Munoz Sanchez; Alicia,11,0,20,9
1714638247972,LISP 5B,A00,507671,Munoz Sanchez; Alicia,8,0,20,12
1714638249001,LISP 5C,A00,507696,Munoz Sanchez; Alicia,9,0,20,11
1714638250030,MAE 197,001,528363,Boechler; Nicholas Sebastia,9998,0,9999,1
1714638251060,MATH 197,001,523477,Kedlaya; Kiran S.,9995,0,9999,4
1714638251060,MATH 197,002,563811,Zhang; Danna,9995,0,9999,4
1714638251060,MATH 197,003,628552,Dumitriu; Ioana,9998,0,9999,1
1714638252085,MCWP 40R,A00,518780,Staff,2,0,20,18
1714638252085,MCWP 40R,B00,518781,Staff,8,0,20,12
1714638252085,MCWP 40R,C00,518783,Staff,6,0,20,14
1714638253115,MCWP 50R,A00,518791,Staff,0,0,20,20
1714638253115,MCWP 50R,B00,518792,Staff,0,2,20,20
1714638253115,MCWP 50R,C00,518793,Staff,0,2,20,20
1714638253115,MCWP 50R,D00,518794,Staff,0,1,20,20
1714638253115,MCWP 50R,E00,518795,Staff,0,2,20,20
1714638253115,MCWP 50R,F00,518796,Staff,0,0,20,20
1714638253115,MCWP 50R,G00,518797,Staff,0,1,20,20
1714638254143,MMW 12R,A01,514034,Herbst; Matthew,0,0,16,16
1714638254143,MMW 12R,A02,514035,Herbst; Matthew,1,0,16,15
1714638255170,MMW 13R,A01,514037,Staff,0,4,16,16
1714638255170,MMW 13R,A02,514039,Staff,0,2,16,16
1714638255170,MMW 13R,A03,628519,Staff,0,2,16,16
1714638257221,SIO 295LS,A00,523233,Staff,10,0,30,20
1714638258246,SIO 295S,A00,523232,Staff,10,0,30,20
1714638259274,SIOC 290S,A01,637330,Merrifield; Mark A,23,0,30,7
1714638260306,SIOC 291S,A01,637333,Gabriel; Corey John,23,0,30,7
1714638261334,SOCI 117,A01,494376,Staff,0,4,5,5
1714638262363,WES 237B,A00,494380,Staff,9,0,20,11
1714638264446,AESE 279B,A00,494370,Wade; Jon P,0,0,33,33
1714638265474,AIP 197,001,627712,Vespa; Emanuel Ignacio,9998,0,9999,1
1714638266503,ANAR 135S,A00,494369,Braswell; Geoffrey E.,0,0,0,0
1714638267529,BENG 196,001,628496,Engler; Adam J.,9998,0,9999,1
1714638268558,CAT 124RS,A01,519847,Geibel; William,0,0,20,20
1714638269586,CAT 125RS,A01,515971,Geibel; William,0,0,20,20
1714638270614,CLRE 250,A00,511389,Morris; Sheldon,9993,0,9999,6
1714638271642,CLRE 251,A00,507176,Mehta; Ravindra L.,9993,0,9999,6
1714638271642,CLRE 251,B00,511410,Mehta; Ravindra L.,9998,0,9999,1
1714638272668,CLRE 252,A00,507189,Cuomo; Raphael Eduardo,9995,0,9999,4
1714638273694,CLRE 253,A00,507199,Vaida; Florin,9994,0,9999,5
1714638273694,CLRE 253,B00,507202,Vaida; Florin,9999,0,9999,0
1714638274722,CLRE 259,A00,507211,Patel; Hemal,9996,0,9999,3
1714638275750,CLRE 260,A00,507221,Cuomo; Raphael Eduardo,9999,0,9999,0
1714638276774,CLRE 297,001,507242,Cuomo; Raphael Eduardo,9999,0,9999,0
1714638277810,COGS 197,001,638244,Voytek; Bradley Thomas,9998,0,9999,1
1714638278841,CSE 191,A00,516875,Minnes Kemp; Mor Mia,9992,0,9999,7
1714638279867,CSE 197,001,637388,Minnes Kemp; Mor Mia,9998,0,9999,1
1714638280892,CSS 201S,A01,494383,Staff,35,0,35,0
1714638281927,CSS 202S,A01,494387,Staff,35,0,35,0
1714638282951,DSC 197,001,628532,Eldridge; Justin Matthew,9996,0,9999,3
1714638283975,EAP 100,A00,516065,Staff,9797,0,9999,202
1714638285011,ECE 45,A01,507414,Staff,33,0,60,27
1714638287064,ECE 111,A01,507420,Staff,15,0,50,35
1714638288089,ECE 197,001,548057,Sievenpiper; Daniel F.,9993,0,9999,6
1714638289117,EDS 115,A00,507243,Choi; Bailey Miyeon,10,0,28,18
1714638290143,EDS 117,A01,494379,Staff,0,4,30,30
1714638291176,EDS 125,A00,507246,Hopkins; Megan Beth,9,0,30,21
1714638292209,EDS 128A,A01,507264,Fargason; Sharon Gayle,8,0,26,18
1714638293240,EDS 128B,A01,507293,Pappas; Elizabeth,12,0,30,18
1714638294268,EDS 139,A00,507294,Fargason; Sharon Gayle,13,0,30,17
1714638294268,EDS 139,B00,507313,Pappas; Elizabeth,13,0,30,17
1714638295295,EDS 201,A00,507315,Staff,13,0,30,17
1714638296331,EDS 203,A01,507317,Halter; Christopher P.,12,0,30,18
1714638297357,EDS 204R,A01,507319,Halter; Christopher P.,0,3,30,30
1714638297357,EDS 204R,B01,507331,Heinzman; Erica M.,16,0,30,14
1714638298382,EDS 206R,A00,507332,Staff,0,4,30,30
1714638298382,EDS 206R,B00,507343,Staff,17,0,30,13
1714638299412,EDS 250,A00,507344,Hemans; Patricia Ann Benitez,22,0,40,18
1714638300444,EDS 281,A00,507345,Daly; Alan J.,18,0,18,0
1714638301470,EDS 284,A00,507350,Daly; Alan J.,16,0,16,0
1714638302495,EDS 286,A00,507359,Fine; Sarah,18,0,18,0
1714638303524,EDS 289C,A01,507361,Daly; Alan J.,18,0,18,0
1714638304550,EDS 290,A00,507366,Hofstetter; Carolyn,15,0,15,0
1714638305577,LIGM 5A,A00,507421,Fischer-Grunski; Eva K,18,0,20,2
1714638306605,LIGM 5B,A00,507423,Fischer-Grunski; Eva K,19,0,20,1
1714638307638,LIGM 5C,A00,507425,Fischer-Grunski; Eva K,19,0,20,1
1714638308668,LIIT 5AS,A00,507427,Carnelos; Chiara,20,0,20,0
1714638309698,LIIT 5BS,A00,507430,Carnelos; Chiara,20,0,20,0
1714638310724,LIIT 5CS,A00,507432,Carnelos; Chiara,20,0,20,0
1714638311750,LISP 5A,A00,507541,Munoz Sanchez; Alicia,11,0,20,9
1714638312781,LISP 5B,A00,507671,Munoz Sanchez; Alicia,8,0,20,12
1714638313807,LISP 5C,A00,507696,Munoz Sanchez; Alicia,9,0,20,11
1714638314833,MAE 197,001,528363,Boechler; Nicholas Sebastia,9998,0,9999,1
1714638315875,MATH 197,001,523477,Kedlaya; Kiran S.,9995,0,9999,4
1714638315875,MATH 197,002,563811,Zhang; Danna,9995,0,9999,4
1714638315875,MATH 197,003,628552,Dumitriu; Ioana,9998,0,9999,1
1714638316901,MCWP 40R,A00,518780,Staff,2,0,20,18
1714638316901,MCWP 40R,B00,518781,Staff,8,0,20,12
1714638316901,MCWP 40R,C00,518783,Staff,6,0,20,14
1714638317931,MCWP 50R,A00,518791,Staff,0,0,20,20
1714638317931,MCWP 50R,B00,518792,Staff,0,2,20,20
1714638317931,MCWP 50R,C00,518793,Staff,0,2,20,20
1714638317931,MCWP 50R,D00,518794,Staff,0,1,20,20
1714638317931,MCWP 50R,E00,518795,Staff,0,2,20,20
1714638317931,MCWP 50R,F00,518796,Staff,0,0,20,20
1714638317931,MCWP 50R,G00,518797,Staff,0,1,20,20
1714638318957,MMW 12R,A01,514034,Herbst; Matthew,0,0,16,16
1714638318957,MMW 12R,A02,514035,Herbst; Matthew,1,0,16,15
1714638319983,MMW 13R,A01,514037,Staff,0,4,16,16
1714638319983,MMW 13R,A02,514039,Staff,0,2,16,16
1714638319983,MMW 13R,A03,628519,Staff,0,2,16,16
1714638322096,SIO 295LS,A00,523233,Staff,10,0,30,20
1714638323122,SIO 295S,A00,523232,Staff,10,0,30,20
1714638324149,SIOC 290S,A01,637330,Merrifield; Mark A,23,0,30,7
1714638325174,SIOC 291S,A01,637333,Gabriel; Corey John,23,0,30,7
1714638326204,SOCI 117,A01,494376,Staff,0,4,5,5
1714638327232,WES 237B,A00,494380,Staff,9,0,20,11
1714638329309,AESE 279B,A00,494370,Wade; Jon P,0,0,33,33
1714638330334,AIP 197,001,627712,Vespa; Emanuel Ignacio,9998,0,9999,1
1714638331361,ANAR 135S,A00,494369,Braswell; Geoffrey E.,0,0,0,0
1714638332386,BENG 196,001,628496,Engler; Adam J.,9998,0,9999,1
1714638333412,CAT 124RS,A01,519847,Geibel; William,0,0,20,20
1714638334438,CAT 125RS,A01,515971,Geibel; William,0,0,20,20
1714638335464,CLRE 250,A00,511389,Morris; Sheldon,9993,0,9999,6
1714638336499,CLRE 251,A00,507176,Mehta; Ravindra L.,9993,0,9999,6
1714638336499,CLRE 251,B00,511410,Mehta; Ravindra L.,9998,0,9999,1
1714638337523,CLRE 252,A00,507189,Cuomo; Raphael Eduardo,9995,0,9999,4
1714638338549,CLRE 253,A00,507199,Vaida; Florin,9994,0,9999,5
1714638338549,CLRE 253,B00,507202,Vaida; Florin,9999,0,9999,0
1714638339575,CLRE 259,A00,507211,Patel; Hemal,9996,0,9999,3
1714638340602,CLRE 260,A00,507221,Cuomo; Raphael Eduardo,9999,0,9999,0
1714638341626,CLRE 297,001,507242,Cuomo; Raphael Eduardo,9999,0,9999,0
1714638342656,COGS 197,001,638244,Voytek; Bradley Thomas,9998,0,9999,1
1714638343681,CSE 191,A00,516875,Minnes Kemp; Mor Mia,9992,0,9999,7
1714638344706,CSE 197,001,637388,Minnes Kemp; Mor Mia,9998,0,9999,1
1714638345731,CSS 201S,A01,494383,Staff,35,0,35,0
1714638346761,CSS 202S,A01,494387,Staff,35,0,35,0
1714638347787,DSC 197,001,628532,Eldridge; Justin Matthew,9996,0,9999,3
1714638348812,EAP 100,A00,516065,Staff,9797,0,9999,202
1714638349839,ECE 45,A01,507414,Staff,33,0,60,27
1714638351890,ECE 111,A01,507420,Staff,15,0,50,35
1714638352919,ECE 197,001,548057,Sievenpiper; Daniel F.,9993,0,9999,6
1714638353947,EDS 115,A00,507243,Choi; Bailey Miyeon,10,0,28,18
1714638354974,EDS 117,A01,494379,Staff,0,4,30,30
1714638356000,EDS 125,A00,507246,Hopkins; Megan Beth,9,0,30,21
1714638357030,EDS 128A,A01,507264,Fargason; Sharon Gayle,8,0,26,18
1714638358058,EDS 128B,A01,507293,Pappas; Elizabeth,12,0,30,18
1714638359086,EDS 139,A00,507294,Fargason; Sharon Gayle,13,0,30,17
1714638359086,EDS 139,B00,507313,Pappas; Elizabeth,13,0,30,17
1714638360110,EDS 201,A00,507315,Staff,13,0,30,17
1714638361136,EDS 203,A01,507317,Halter; Christopher P.,12,0,30,18
1714638362166,EDS 204R,A01,507319,Halter; Christopher P.,0,3,30,30
1714638362166,EDS 204R,B01,507331,Heinzman; Erica M.,16,0,30,14
1714638363200,EDS 206R,A00,507332,Staff,0,4,30,30
1714638363200,EDS 206R,B00,507343,Staff,17,0,30,13
1714638364224,EDS 250,A00,507344,Hemans; Patricia Ann Benitez,22,0,40,18
1714638365251,EDS 281,A00,507345,Daly; Alan J.,18,0,18,0
1714638366275,EDS 284,A00,507350,Daly; Alan J.,16,0,16,0
1714638367302,EDS 286,A00,507359,Fine; Sarah,18,0,18,0
1714638368328,EDS 289C,A01,507361,Daly; Alan J.,18,0,18,0
1714638369356,EDS 290,A00,507366,Hofstetter; Carolyn,15,0,15,0
1714638370388,LIGM 5A,A00,507421,Fischer-Grunski; Eva K,18,0,20,2
1714638371419,LIGM 5B,A00,507423,Fischer-Grunski; Eva K,19,0,20,1
1714638372444,LIGM 5C,A00,507425,Fischer-Grunski; Eva K,19,0,20,1
1714638373470,LIIT 5AS,A00,507427,Carnelos; Chiara,20,0,20,0
1714638374495,LIIT 5BS,A00,507430,Carnelos; Chiara,20,0,20,0
1714638375521,LIIT 5CS,A00,507432,Carnelos; Chiara,20,0,20,0
1714638376551,LISP 5A,A00,507541,Munoz Sanchez; Alicia,11,0,20,9
1714638377574,LISP 5B,A00,507671,Munoz Sanchez; Alicia,8,0,20,12
1714638378598,LISP 5C,A00,507696,Munoz Sanchez; Alicia,9,0,20,11
1714638379625,MAE 197,001,528363,Boechler; Nicholas Sebastia,9998,0,9999,1
1714638380652,MATH 197,001,523477,Kedlaya; Kiran S.,9995,0,9999,4
1714638380652,MATH 197,002,563811,Zhang; Danna,9995,0,9999,4
1714638380652,MATH 197,003,628552,Dumitriu; Ioana,9998,0,9999,1
1714638381677,MCWP 40R,A00,518780,Staff,2,0,20,18
1714638381677,MCWP 40R,B00,518781,Staff,8,0,20,12
1714638381677,MCWP 40R,C00,518783,Staff,6,0,20,14
1714638382706,MCWP 50R,A00,518791,Staff,0,0,20,20
1714638382706,MCWP 50R,B00,518792,Staff,0,2,20,20
1714638382706,MCWP 50R,C00,518793,Staff,0,2,20,20
1714638382706,MCWP 50R,D00,518794,Staff,0,1,20,20
1714638382706,MCWP 50R,E00,518795,Staff,0,2,20,20
1714638382706,MCWP 50R,F00,518796,Staff,0,0,20,20
1714638382706,MCWP 50R,G00,518797,Staff,0,1,20,20
1714638383732,MMW 12R,A01,514034,Herbst; Matthew,0,0,16,16
1714638383732,MMW 12R,A02,514035,Herbst; Matthew,1,0,16,15
1714638384760,MMW 13R,A01,514037,Staff,0,4,16,16
1714638384760,MMW 13R,A02,514039,Staff,0,2,16,16
1714638384760,MMW 13R,A03,628519,Staff,0,2,16,16
1714638386814,SIO 295LS,A00,523233,Staff,10,0,30,20
1714638387841,SIO 295S,A00,523232,Staff,10,0,30,20
1714638388867,SIOC 290S,A01,637330,Merrifield; Mark A,23,0,30,7
1714638389892,SIOC 291S,A01,637333,Gabriel; Corey John,23,0,30,7
1714638390918,SOCI 117,A01,494376,Staff,0,4,5,5
1714638391946,WES 237B,A00,494380,Staff,9,0,20,11
1714638394022,AESE 279B,A00,494370,Wade; Jon P,0,0,33,33
1714638395049,AIP 197,001,627712,Vespa; Emanuel Ignacio,9998,0,9999,1
1714638396078,ANAR 135S,A00,494369,Braswell; Geoffrey E.,0,0,0,0
1714638397104,BENG 196,001,628496,Engler; Adam J.,9998,0,9999,1
1714638398133,CAT 124RS,A01,519847,Geibel; William,0,0,20,20
1714638399161,CAT 125RS,A01,515971,Geibel; William,0,0,20,20
1714638400187,CLRE 250,A00,511389,Morris; Sheldon,9993,0,9999,6
1714638401218,CLRE 251,A00,507176,Mehta; Ravindra L.,9993,0,9999,6
1714638401218,CLRE 251,B00,511410,Mehta; Ravindra L.,9998,0,9999,1
1714638402251,CLRE 252,A00,507189,Cuomo; Raphael Eduardo,9995,0,9999,4
1714638403283,CLRE 253,A00,507199,Vaida; Florin,9994,0,9999,5
1714638403283,CLRE 253,B00,507202,Vaida; Florin,9999,0,9999,0
1714638404308,CLRE 259,A00,507211,Patel; Hemal,9996,0,9999,3
1714638405333,CLRE 260,A00,507221,Cuomo; Raphael Eduardo,9999,0,9999,0
1714638406357,CLRE 297,001,507242,Cuomo; Raphael Eduardo,9999,0,9999,0
1714638407382,COGS 197,001,638244,Voytek; Bradley Thomas,9998,0,9999,1
1714638408407,CSE 191,A00,516875,Minnes Kemp; Mor Mia,9992,0,9999,7
1714638409437,CSE 197,001,637388,Minnes Kemp; Mor Mia,9998,0,9999,1
1714638410469,CSS 201S,A01,494383,Staff,35,0,35,0
1714638411494,CSS 202S,A01,494387,Staff,35,0,35,0
1714638412524,DSC 197,001,628532,Eldridge; Justin Matthew,9996,0,9999,3
1714638413550,EAP 100,A00,516065,Staff,9797,0,9999,202
1714638414584,ECE 45,A01,507414,Staff,33,0,60,27
1714638416645,ECE 111,A01,507420,Staff,15,0,50,35
1714638417678,ECE 197,001,548057,Sievenpiper; Daniel F.,9993,0,9999,6
1714638418704,EDS 115,A00,507243,Choi; Bailey Miyeon,10,0,28,18
1714638419732,EDS 117,A01,494379,Staff,0,4,30,30
1714638420768,EDS 125,A00,507246,Hopkins; Megan Beth,9,0,30,21
1714638421801,EDS 128A,A01,507264,Fargason; Sharon Gayle,8,0,26,18
1714638422827,EDS 128B,A01,507293,Pappas; Elizabeth,12,0,30,18
1714638423866,EDS 139,A00,507294,Fargason; Sharon Gayle,13,0,30,17
1714638423866,EDS 139,B00,507313,Pappas; Elizabeth,13,0,30,17
1714638424893,EDS 201,A00,507315,Staff,13,0,30,17
1714638425977,EDS 203,A01,507317,Halter; Christopher P.,12,0,30,18
1714638427013,EDS 204R,A01,507319,Halter; Christopher P.,0,3,30,30
1714638427013,EDS 204R,B01,507331,Heinzman; Erica M.,16,0,30,14
1714638428038,EDS 206R,A00,507332,Staff,0,4,30,30
1714638428038,EDS 206R,B00,507343,Staff,17,0,30,13
1714638429072,EDS 250,A00,507344,Hemans; Patricia Ann Benitez,22,0,40,18
1714638430096,EDS 281,A00,507345,Daly; Alan J.,18,0,18,0
1714638431123,EDS 284,A00,507350,Daly; Alan J.,16,0,16,0
1714638432148,EDS 286,A00,507359,Fine; Sarah,18,0,18,0
1714638433178,EDS 289C,A01,507361,Daly; Alan J.,18,0,18,0
1714638434212,EDS 290,A00,507366,Hofstetter; Carolyn,15,0,15,0
1714638435245,LIGM 5A,A00,507421,Fischer-Grunski; Eva K,18,0,20,2
1714638436275,LIGM 5B,A00,507423,Fischer-Grunski; Eva K,19,0,20,1
1714638437299,LIGM 5C,A00,507425,Fischer-Grunski; Eva K,19,0,20,1
1714638438325,LIIT 5AS,A00,507427,Carnelos; Chiara,20,0,20,0
1714638439350,LIIT 5BS,A00,507430,Carnelos; Chiara,20,0,20,0
1714638440377,LIIT 5CS,A00,507432,Carnelos; Chiara,20,0,20,0
1714638441405,LISP 5A,A00,507541,Munoz Sanchez; Alicia,11,0,20,9
1714638442434,LISP 5B,A00,507671,Munoz Sanchez; Alicia,8,0,20,12
1714638443467,LISP 5C,A00,507696,Munoz Sanchez; Alicia,9,0,20,11
1714638444493,MAE 197,001,528363,Boechler; Nicholas Sebastia,9998,0,9999,1
1714638445528,MATH 197,001,523477,Kedlaya; Kiran S.,9995,0,9999,4
1714638445528,MATH 197,002,563811,Zhang; Danna,9995,0,9999,4
1714638445528,MATH 197,003,628552,Dumitriu; Ioana,9998,0,9999,1
1714638446554,MCWP 40R,A00,518780,Staff,2,0,20,18
1714638446554,MCWP 40R,B00,518781,Staff,8,0,20,12
1714638446554,MCWP 40R,C00,518783,Staff,6,0,20,14
1714638447579,MCWP 50R,A00,518791,Staff,0,0,20,20
1714638447579,MCWP 50R,B00,518792,Staff,0,2,20,20
1714638447579,MCWP 50R,C00,518793,Staff,0,2,20,20
1714638447579,MCWP 50R,D00,518794,Staff,0,1,20,20
1714638447579,MCWP 50R,E00,518795,Staff,0,2,20,20
1714638447579,MCWP 50R,F00,518796,Staff,0,0,20,20
1714638447579,MCWP 50R,G00,518797,Staff,0,1,20,20
1714638448605,MMW 12R,A01,514034,Herbst; Matthew,0,0,16,16
1714638448605,MMW 12R,A02,514035,Herbst; Matthew,1,0,16,15
1714638449632,MMW 13R,A01,514037,Staff,0,4,16,16
1714638449632,MMW 13R,A02,514039,Staff,0,2,16,16
1714638449632,MMW 13R,A03,628519,Staff,0,2,16,16
1714638451696,SIO 295LS,A00,523233,Staff,10,0,30,20
1714638452725,SIO 295S,A00,523232,Staff,10,0,30,20
1714638453750,SIOC 290S,A01,637330,Merrifield; Mark A,23,0,30,7
1714638454777,SIOC 291S,A01,637333,Gabriel; Corey John,23,0,30,7
1714638455808,SOCI 117,A01,494376,Staff,0,4,5,5
1714638456834,WES 237B,A00,494380,Staff,9,0,20,11
1714638458918,AESE 279B,A00,494370,Wade; Jon P,0,0,33,33
1714638459946,AIP 197,001,627712,Vespa; Emanuel Ignacio,9998,0,9999,1
1714638460978,ANAR 135S,A00,494369,Braswell; Geoffrey E.,0,0,0,0
1714638462010,BENG 196,001,628496,Engler; Adam J.,9998,0,9999,1
1714638463044,CAT 124RS,A01,519847,Geibel; William,0,0,20,20
1714638464075,CAT 125RS,A01,515971,Geibel; William,0,0,20,20
1714638465106,CLRE 250,A00,511389,Morris; Sheldon,9993,0,9999,6
1714638466134,CLRE 251,A00,507176,Mehta; Ravindra L.,9993,0,9999,6
1714638466134,CLRE 251,B00,511410,Mehta; Ravindra L.,9998,0,9999,1
1714638467166,CLRE 252,A00,507189,Cuomo; Raphael Eduardo,9995,0,9999,4
1714638468197,CLRE 253,A00,507199,Vaida; Florin,9994,0,9999,5
1714638468197,CLRE 253,B00,507202,Vaida; Florin,9999,0,9999,0
1714638469225,CLRE 259,A00,507211,Patel; Hemal,9996,0,9999,3
1714638470252,CLRE 260,A00,507221,Cuomo; Raphael Eduardo,9999,0,9999,0
1714638471280,CLRE 297,001,507242,Cuomo; Raphael Eduardo,9999,0,9999,0
1714638472306,COGS 197,001,638244,Voytek; Bradley Thomas,9998,0,9999,1
1714638473331,CSE 191,A00,516875,Minnes Kemp; Mor Mia,9992,0,9999,7
1714638474363,CSE 197,001,637388,Minnes Kemp; Mor Mia,9998,0,9999,1
1714638475389,CSS 201S,A01,494383,Staff,35,0,35,0
1714638476414,CSS 202S,A01,494387,Staff,35,0,35,0
1714638477445,DSC 197,001,628532,Eldridge; Justin Matthew,9996,0,9999,3
1714638478475,EAP 100,A00,516065,Staff,9797,0,9999,202
1714638479505,ECE 45,A01,507414,Staff,33,0,60,27
1714638481558,ECE 111,A01,507420,Staff,15,0,50,35
1714638482584,ECE 197,001,548057,Sievenpiper; Daniel F.,9993,0,9999,6
1714638483614,EDS 115,A00,507243,Choi; Bailey Miyeon,10,0,28,18
1714638484641,EDS 117,A01,494379,Staff,0,4,30,30
1714638485672,EDS 125,A00,507246,Hopkins; Megan Beth,9,0,30,21
1714638486698,EDS 128A,A01,507264,Fargason; Sharon Gayle,8,0,26,18
1714638487723,EDS 128B,A01,507293,Pappas; Elizabeth,12,0,30,18
1714638488748,EDS 139,A00,507294,Fargason; Sharon Gayle,13,0,30,17
1714638488748,EDS 139,B00,507313,Pappas; Elizabeth,13,0,30,17
1714638489776,EDS 201,A00,507315,Staff,13,0,30,17
1714638490808,EDS 203,A01,507317,Halter; Christopher P.,12,0,30,18
1714638491834,EDS 204R,A01,507319,Halter; Christopher P.,0,3,30,30
1714638491834,EDS 204R,B01,507331,Heinzman; Erica M.,16,0,30,14
1714638492860,EDS 206R,A00,507332,Staff,0,4,30,30
1714638492860,EDS 206R,B00,507343,Staff,17,0,30,13
1714638493885,EDS 250,A00,507344,Hemans; Patricia Ann Benitez,22,0,40,18
1714638494912,EDS 281,A00,507345,Daly; Alan J.,18,0,18,0
1714638495940,EDS 284,A00,507350,Daly; Alan J.,16,0,16,0
1714638496967,EDS 286,A00,507359,Fine; Sarah,18,0,18,0
1714638497995,EDS 289C,A01,507361,Daly; Alan J.,18,0,18,0
1714638499021,EDS 290,A00,507366,Hofstetter; Carolyn,15,0,15,0
1714638500048,LIGM 5A,A00,507421,Fischer-Grunski; Eva K,18,0,20,2
1714638501071,LIGM 5B,A00,507423,Fischer-Grunski; Eva K,19,0,20,1
1714638502106,LIGM 5C,A00,507425,Fischer-Grunski; Eva K,19,0,20,1
1714638503138,LIIT 5AS,A00,507427,Carnelos; Chiara,20,0,20,0
1714638504164,LIIT 5BS,A00,507430,Carnelos; Chiara,20,0,20,0
1714638505198,LIIT 5CS,A00,507432,Carnelos; Chiara,20,0,20,0
1714638506223,LISP 5A,A00,507541,Munoz Sanchez; Alicia,11,0,20,9
1714638507249,LISP 5B,A00,507671,Munoz Sanchez; Alicia,8,0,20,12
1714638508274,LISP 5C,A00,507696,Munoz Sanchez; Alicia,9,0,20,11
1714638509299,MAE 197,001,528363,Boechler; Nicholas Sebastia,9998,0,9999,1
1714638510327,MATH 197,001,523477,Kedlaya; Kiran S.,9995,0,9999,4
1714638510327,MATH 197,002,563811,Zhang; Danna,9995,0,9999,4
1714638510327,MATH 197,003,628552,Dumitriu; Ioana,9998,0,9999,1
1714638511353,MCWP 40R,A00,518780,Staff,2,0,20,18
1714638511353,MCWP 40R,B00,518781,Staff,8,0,20,12
1714638511353,MCWP 40R,C00,518783,Staff,6,0,20,14
1714638512385,MCWP 50R,A00,518791,Staff,0,0,20,20
1714638512385,MCWP 50R,B00,518792,Staff,0,2,20,20
1714638512385,MCWP 50R,C00,518793,Staff,0,2,20,20
1714638512385,MCWP 50R,D00,518794,Staff,0,1,20,20
1714638512385,MCWP 50R,E00,518795,Staff,0,2,20,20
1714638512385,MCWP 50R,F00,518796,Staff,0,0,20,20
1714638512385,MCWP 50R,G00,518797,Staff,0,1,20,20
1714638513418,MMW 12R,A01,514034,Herbst; Matthew,0,0,16,16
1714638513418,MMW 12R,A02,514035,Herbst; Matthew,1,0,16,15
1714638514443,MMW 13R,A01,514037,Staff,0,4,16,16
1714638514443,MMW 13R,A02,514039,Staff,0,2,16,16
1714638514443,MMW 13R,A03,628519,Staff,0,2,16,16
1714638516499,SIO 295LS,A00,523233,Staff,10,0,30,20
1714638517522,SIO 295S,A00,523232,Staff,10,0,30,20
1714638518560,SIOC 290S,A01,637330,Merrifield; Mark A,23,0,30,7
1714638519586,SIOC 291S,A01,637333,Gabriel; Corey John,23,0,30,7
1714638520611,SOCI 117,A01,494376,Staff,0,4,5,5
1714638521636,WES 237B,A00,494380,Staff,9,0,20,11
1714638523700,AESE 279B,A00,494370,Wade; Jon P,0,0,33,33
1714638524726,AIP 197,001,627712,Vespa; Emanuel Ignacio,9998,0,9999,1
1714638525753,ANAR 135S,A00,494369,Braswell; Geoffrey E.,0,0,0,0
1714638526779,BENG 196,001,628496,Engler; Adam J.,9998,0,9999,1
1714638527809,CAT 124RS,A01,519847,Geibel; William,0,0,20,20
1714638528835,CAT 125RS,A01,515971,Geibel; William,0,0,20,20
1714638529921,CLRE 250,A00,511389,Morris; Sheldon,9993,0,9999,6
1714638530955,CLRE 251,A00,507176,Mehta; Ravindra L.,9993,0,9999,6
1714638530955,CLRE 251,B00,511410,Mehta; Ravindra L.,9998,0,9999,1
1714638531985,CLRE 252,A00,507189,Cuomo; Raphael Eduardo,9995,0,9999,4
1714638533012,CLRE 253,A00,507199,Vaida; Florin,9994,0,9999,5
1714638533012,CLRE 253,B00,507202,Vaida; Florin,9999,0,9999,0
1714638534037,CLRE 259,A00,507211,Patel; Hemal,9996,0,9999,3
1714638535068,CLRE 260,A00,507221,Cuomo; Raphael Eduardo,9999,0,9999,0
1714638536098,CLRE 297,001,507242,Cuomo; Raphael Eduardo,9999,0,9999,0
1714638537123,COGS 197,001,638244,Voytek; Bradley Thomas,9998,0,9999,1
1714638538155,CSE 191,A00,516875,Minnes Kemp; Mor Mia,9992,0,9999,7
1714638539238,CSE 197,001,637388,Minnes Kemp; Mor Mia,9998,0,9999,1
1714638540265,CSS 201S,A01,494383,Staff,35,0,35,0
1714638541295,CSS 202S,A01,494387,Staff,35,0,35,0
1714638542323,DSC 197,001,628532,Eldridge; Justin Matthew,9996,0,9999,3
1714638543352,EAP 100,A00,516065,Staff,9797,0,9999,202
1714638544375,ECE 45,A01,507414,Staff,33,0,60,27
1714638546426,ECE 111,A01,507420,Staff,15,0,50,35
1714638547458,ECE 197,001,548057,Sievenpiper; Daniel F.,9993,0,9999,6
1714638548484,EDS 115,A00,507243,Choi; Bailey Miyeon,10,0,28,18
1714638549516,EDS 117,A01,494379,Staff,0,4,30,30
1714638550542,EDS 125,A00,507246,Hopkins; Megan Beth,9,0,30,21
1714638551575,EDS 128A,A01,507264,Fargason; Sharon Gayle,8,0,26,18
1714638552604,EDS 128B,A01,507293,Pappas; Elizabeth,12,0,30,18
1714638553629,EDS 139,A00,507294,Fargason; Sharon Gayle,13,0,30,17
1714638553629,EDS 139,B00,507313,Pappas; Elizabeth,13,0,30,17
1714638554656,EDS 201,A00,507315,Staff,13,0,30,17
1714638555682,EDS 203,A01,507317,Halter; Christopher P.,12,0,30,18
1714638556714,EDS 204R,A01,507319,Halter; Christopher P.,0,3,30,30
1714638556714,EDS 204R,B01,507331,Heinzman; Erica M.,16,0,30,14
1714638557740,EDS 206R,A00,507332,Staff,0,4,30,30
1714638557740,EDS 206R,B00,507343,Staff,17,0,30,13
1714638558769,EDS 250,A00,507344,Hemans; Patricia Ann Benitez,22,0,40,18
1714638559794,EDS 281,A00,507345,Daly; Alan J.,18,0,18,0
1714638560823,EDS 284,A00,507350,Daly; Alan J.,16,0,16,0
1714638561854,EDS 286,A00,507359,Fine; Sarah,18,0,18,0
1714638562880,EDS 289C,A01,507361,Daly; Alan J.,18,0,18,0
1714638563906,EDS 290,A00,507366,Hofstetter; Carolyn,15,0,15,0
1714638564932,LIGM 5A,A00,507421,Fischer-Grunski; Eva K,18,0,20,2
1714638565958,LIGM 5B,A00,507423,Fischer-Grunski; Eva K,19,0,20,1
1714638566985,LIGM 5C,A00,507425,Fischer-Grunski; Eva K,19,0,20,1
1714638568015,LIIT 5AS,A00,507427,Carnelos; Chiara,20,0,20,0
1714638569045,LIIT 5BS,A00,507430,Carnelos; Chiara,20,0,20,0
1714638570073,LIIT 5CS,A00,507432,Carnelos; Chiara,20,0,20,0
1714638571102,LISP 5A,A00,507541,Munoz Sanchez; Alicia,11,0,20,9
1714638572134,LISP 5B,A00,507671,Munoz Sanchez; Alicia,8,0,20,12
1714638573161,LISP 5C,A00,507696,Munoz Sanchez; Alicia,9,0,20,11
1714638574189,MAE 197,001,528363,Boechler; Nicholas Sebastia,9998,0,9999,1
1714638575222,MATH 197,001,523477,Kedlaya; Kiran S.,9995,0,9999,4
1714638575222,MATH 197,002,563811,Zhang; Danna,9995,0,9999,4
1714638575222,MATH 197,003,628552,Dumitriu; Ioana,9998,0,9999,1
1714638576249,MCWP 40R,A00,518780,Staff,2,0,20,18
1714638576249,MCWP 40R,B00,518781,Staff,8,0,20,12
1714638576249,MCWP 40R,C00,518783,Staff,6,0,20,14
1714638577281,MCWP 50R,A00,518791,Staff,0,0,20,20
1714638577281,MCWP 50R,B00,518792,Staff,0,2,20,20
1714638577281,MCWP 50R,C00,518793,Staff,0,2,20,20
1714638577281,MCWP 50R,D00,518794,Staff,0,1,20,20
1714638577281,MCWP 50R,E00,518795,Staff,0,2,20,20
1714638577281,MCWP 50R,F00,518796,Staff,0,0,20,20
1714638577281,MCWP 50R,G00,518797,Staff,0,1,20,20
1714638578309,MMW 12R,A01,514034,Herbst; Matthew,0,0,16,16
1714638578309,MMW 12R,A02,514035,Herbst; Matthew,1,0,16,15
1714638579333,MMW 13R,A01,514037,Staff,0,4,16,16
1714638579333,MMW 13R,A02,514039,Staff,0,2,16,16
1714638579333,MMW 13R,A03,628519,Staff,0,2,16,16
1714638581389,SIO 295LS,A00,523233,Staff,10,0,30,20
1714638582431,SIO 295S,A00,523232,Staff,10,0,30,20
1714638583470,SIOC 290S,A01,637330,Merrifield; Mark A,23,0,30,7
1714638584495,SIOC 291S,A01,637333,Gabriel; Corey John,23,0,30,7
1714638585526,SOCI 117,A01,494376,Staff,0,4,5,5
1714638586551,WES 237B,A00,494380,Staff,9,0,20,11
1714638588621,AESE 279B,A00,494370,Wade; Jon P,0,0,33,33
1714638589650,AIP 197,001,627712,Vespa; Emanuel Ignacio,9998,0,9999,1
1714638590674,ANAR 135S,A00,494369,Braswell; Geoffrey E.,0,0,0,0
1714638591706,BENG 196,001,628496,Engler; Adam J.,9998,0,9999,1
1714638592732,CAT 124RS,A01,519847,Geibel; William,0,0,20,20
1714638593756,CAT 125RS,A01,515971,Geibel; William,0,0,20,20
1714638594786,CLRE 250,A00,511389,Morris; Sheldon,9993,0,9999,6
1714638595813,CLRE 251,A00,507176,Mehta; Ravindra L.,9993,0,9999,6
1714638595813,CLRE 251,B00,511410,Mehta; Ravindra L.,9998,0,9999,1
1714638596846,CLRE 252,A00,507189,Cuomo; Raphael Eduardo,9995,0,9999,4
1714638597875,CLRE 253,A00,507199,Vaida; Florin,9994,0,9999,5
1714638597875,CLRE 253,B00,507202,Vaida; Florin,9999,0,9999,0
1714638598901,CLRE 259,A00,507211,Patel; Hemal,9996,0,9999,3
1714638599929,CLRE 260,A00,507221,Cuomo; Raphael Eduardo,9999,0,9999,0
1714638601491,CLRE 297,001,507242,Cuomo; Raphael Eduardo,9999,0,9999,0
1714638602516,COGS 197,001,638244,Voytek; Bradley Thomas,9998,0,9999,1
1714638603545,CSE 191,A00,516875,Minnes Kemp; Mor Mia,9992,0,9999,7
1714638604575,CSE 197,001,637388,Minnes Kemp; Mor Mia,9998,0,9999,1
1714638605601,CSS 201S,A01,494383,Staff,35,0,35,0
1714638606627,CSS 202S,A01,494387,Staff,35,0,35,0
1714638607653,DSC 197,001,628532,Eldridge; Justin Matthew,9996,0,9999,3
1714638608682,EAP 100,A00,516065,Staff,9797,0,9999,202
1714638609710,ECE 45,A01,507414,Staff,33,0,60,27
1714638611762,ECE 111,A01,507420,Staff,15,0,50,35
1714638612787,ECE 197,001,548057,Sievenpiper; Daniel F.,9993,0,9999,6
1714638613815,EDS 115,A00,507243,Choi; Bailey Miyeon,10,0,28,18
1714638614842,EDS 117,A01,494379,Staff,0,4,30,30
1714638615870,EDS 125,A00,507246,Hopkins; Megan Beth,9,0,30,21
1714638616895,EDS 128A,A01,507264,Fargason; Sharon Gayle,8,0,26,18
1714638617929,EDS 128B,A01,507293,Pappas; Elizabeth,12,0,30,18
1714638618955,EDS 139,A00,507294,Fargason; Sharon Gayle,13,0,30,17
1714638618955,EDS 139,B00,507313,Pappas; Elizabeth,13,0,30,17
1714638619983,EDS 201,A00,507315,Staff,13,0,30,17
1714638621010,EDS 203,A01,507317,Halter; Christopher P.,12,0,30,18
1714638622037,EDS 204R,A01,507319,Halter; Christopher P.,0,3,30,30
1714638622037,EDS 204R,B01,507331,Heinzman; Erica M.,16,0,30,14
1714638623065,EDS 206R,A00,507332,Staff,0,4,30,30
1714638623065,EDS 206R,B00,507343,Staff,17,0,30,13
1714638624089,EDS 250,A00,507344,Hemans; Patricia Ann Benitez,22,0,40,18
1714638625114,EDS 281,A00,507345,Daly; Alan J.,18,0,18,0
1714638626139,EDS 284,A00,507350,Daly; Alan J.,16,0,16,0
1714638627165,EDS 286,A00,507359,Fine; Sarah,18,0,18,0
1714638628192,EDS 289C,A01,507361,Daly; Alan J.,18,0,18,0
1714638629219,EDS 290,A00,507366,Hofstetter; Carolyn,15,0,15,0
1714638630247,LIGM 5A,A00,507421,Fischer-Grunski; Eva K,18,0,20,2
1714638631272,LIGM 5B,A00,507423,Fischer-Grunski; Eva K,19,0,20,1
1714638632300,LIGM 5C,A00,507425,Fischer-Grunski; Eva K,19,0,20,1
1714638633329,LIIT 5AS,A00,507427,Carnelos; Chiara,20,0,20,0
1714638634357,LIIT 5BS,A00,507430,Carnelos; Chiara,20,0,20,0
1714638635387,LIIT 5CS,A00,507432,Carnelos; Chiara,20,0,20,0
1714638636418,LISP 5A,A00,507541,Munoz Sanchez; Alicia,11,0,20,9
1714638637448,LISP 5B,A00,507671,Munoz Sanchez; Alicia,8,0,20,12
1714638638473,LISP 5C,A00,507696,Munoz Sanchez; Alicia,9,0,20,11
1714638639503,MAE 197,001,528363,Boechler; Nicholas Sebastia,9998,0,9999,1
1714638640532,MATH 197,001,523477,Kedlaya; Kiran S.,9995,0,9999,4
1714638640532,MATH 197,002,563811,Zhang; Danna,9995,0,9999,4
1714638640532,MATH 197,003,628552,Dumitriu; Ioana,9998,0,9999,1
1714638641562,MCWP 40R,A00,518780,Staff,2,0,20,18
1714638641562,MCWP 40R,B00,518781,Staff,8,0,20,12
1714638641562,MCWP 40R,C00,518783,Staff,6,0,20,14
1714638642594,MCWP 50R,A00,518791,Staff,0,0,20,20
1714638642594,MCWP 50R,B00,518792,Staff,0,2,20,20
1714638642594,MCWP 50R,C00,518793,Staff,0,2,20,20
1714638642594,MCWP 50R,D00,518794,Staff,0,1,20,20
1714638642594,MCWP 50R,E00,518795,Staff,0,2,20,20
1714638642594,MCWP 50R,F00,518796,Staff,0,0,20,20
1714638642594,MCWP 50R,G00,518797,Staff,0,1,20,20
1714638643624,MMW 12R,A01,514034,Herbst; Matthew,0,0,16,16
1714638643624,MMW 12R,A02,514035,Herbst; Matthew,1,0,16,15
1714638644650,MMW 13R,A01,514037,Staff,0,4,16,16
1714638644650,MMW 13R,A02,514039,Staff,0,2,16,16
1714638644650,MMW 13R,A03,628519,Staff,0,2,16,16
1714638646703,SIO 295LS,A00,523233,Staff,10,0,30,20
1714638647728,SIO 295S,A00,523232,Staff,10,0,30,20
1714638648754,SIOC 290S,A01,637330,Merrifield; Mark A,23,0,30,7
1714638649779,SIOC 291S,A01,637333,Gabriel; Corey John,23,0,30,7
1714638650805,SOCI 117,A01,494376,Staff,0,4,5,5
1714638651830,WES 237B,A00,494380,Staff,9,0,20,11
1714638653908,AESE 279B,A00,494370,Wade; Jon P,0,0,33,33
1714638654934,AIP 197,001,627712,Vespa; Emanuel Ignacio,9998,0,9999,1
1714638655960,ANAR 135S,A00,494369,Braswell; Geoffrey E.,0,0,0,0
1714638656986,BENG 196,001,628496,Engler; Adam J.,9998,0,9999,1
1714638658012,CAT 124RS,A01,519847,Geibel; William,0,0,20,20
1714638659036,CAT 125RS,A01,515971,Geibel; William,0,0,20,20
1714638660122,CLRE 250,A00,511389,Morris; Sheldon,9993,0,9999,6
1714638661150,CLRE 251,A00,507176,Mehta; Ravindra L.,9993,0,9999,6
1714638661150,CLRE 251,B00,511410,Mehta; Ravindra L.,9998,0,9999,1
1714638662183,CLRE 252,A00,507189,Cuomo; Raphael Eduardo,9995,0,9999,4
1714638663219,CLRE 253,A00,507199,Vaida; Florin,9994,0,9999,5
1714638663219,CLRE 253,B00,507202,Vaida; Florin,9999,0,9999,0
1714638664251,CLRE 259,A00,507211,Patel; Hemal,9996,0,9999,3
1714638665284,CLRE 260,A00,507221,Cuomo; Raphael Eduardo,9999,0,9999,0
1714638666315,CLRE 297,001,507242,Cuomo; Raphael Eduardo,9999,0,9999,0
1714638667338,COGS 197,001,638244,Voytek; Bradley Thomas,9998,0,9999,1
1714638668364,CSE 191,A00,516875,Minnes Kemp; Mor Mia,9992,0,9999,7
1714638669390,CSE 197,001,637388,Minnes Kemp; Mor Mia,9998,0,9999,1
1714638670413,CSS 201S,A01,494383,Staff,35,0,35,0
1714638671438,CSS 202S,A01,494387,Staff,35,0,35,0
1714638672470,DSC 197,001,628532,Eldridge; Justin Matthew,9996,0,9999,3
1714638673493,EAP 100,A00,516065,Staff,9797,0,9999,202
1714638674519,ECE 45,A01,507414,Staff,33,0,60,27
1714638676567,ECE 111,A01,507420,Staff,15,0,50,35
1714638677596,ECE 197,001,548057,Sievenpiper; Daniel F.,9993,0,9999,6
1714638678630,EDS 115,A00,507243,Choi; Bailey Miyeon,10,0,28,18
1714638679659,EDS 117,A01,494379,Staff,0,4,30,30
1714638680686,EDS 125,A00,507246,Hopkins; Megan Beth,9,0,30,21
1714638681712,EDS 128A,A01,507264,Fargason; Sharon Gayle,8,0,26,18
1714638682740,EDS 128B,A01,507293,Pappas; Elizabeth,12,0,30,18
1714638683765,EDS 139,A00,507294,Fargason; Sharon Gayle,13,0,30,17
1714638683765,EDS 139,B00,507313,Pappas; Elizabeth,13,0,30,17
1714638684794,EDS 201,A00,507315,Staff,13,0,30,17
1714638685822,EDS 203,A01,507317,Halter; Christopher P.,12,0,30,18
1714638686848,EDS 204R,A01,507319,Halter; Christopher P.,0,3,30,30
1714638686848,EDS 204R,B01,507331,Heinzman; Erica M.,16,0,30,14
1714638687873,EDS 206R,A00,507332,Staff,0,4,30,30
1714638687873,EDS 206R,B00,507343,Staff,17,0,30,13
1714638688908,EDS 250,A00,507344,Hemans; Patricia Ann Benitez,22,0,40,18
1714638689934,EDS 281,A00,507345,Daly; Alan J.,18,0,18,0
1714638690961,EDS 284,A00,507350,Daly; Alan J.,16,0,16,0
1714638691994,EDS 286,A00,507359,Fine; Sarah,18,0,18,0
1714638693020,EDS 289C,A01,507361,Daly; Alan J.,18,0,18,0
1714638694056,EDS 290,A00,507366,Hofstetter; Carolyn,15,0,15,0
1714638695090,LIGM 5A,A00,507421,Fischer-Grunski; Eva K,18,0,20,2
1714638696136,LIGM 5B,A00,507423,Fischer-Grunski; Eva K,19,0,20,1
1714638697161,LIGM 5C,A00,507425,Fischer-Grunski; Eva K,19,0,20,1
1714638698187,LIIT 5AS,A00,507427,Carnelos; Chiara,20,0,20,0
1714638699213,LIIT 5BS,A00,507430,Carnelos; Chiara,20,0,20,0
1714638700239,LIIT 5CS,A00,507432,Carnelos; Chiara,20,0,20,0
1714638701267,LISP 5A,A00,507541,Munoz Sanchez; Alicia,11,0,20,9
1714638702298,LISP 5B,A00,507671,Munoz Sanchez; Alicia,8,0,20,12
1714638703332,LISP 5C,A00,507696,Munoz Sanchez; Alicia,9,0,20,11
1714638704360,MAE 197,001,528363,Boechler; Nicholas Sebastia,9998,0,9999,1
1714638705389,MATH 197,001,523477,Kedlaya; Kiran S.,9995,0,9999,4
1714638705389,MATH 197,002,563811,Zhang; Danna,9995,0,9999,4
1714638705389,MATH 197,003,628552,Dumitriu; Ioana,9998,0,9999,1
1714638706418,MCWP 40R,A00,518780,Staff,2,0,20,18
1714638706418,MCWP 40R,B00,518781,Staff,8,0,20,12
1714638706418,MCWP 40R,C00,518783,Staff,6,0,20,14
1714638707447,MCWP 50R,A00,518791,Staff,0,0,20,20
1714638707447,MCWP 50R,B00,518792,Staff,0,2,20,20
1714638707447,MCWP 50R,C00,518793,Staff,0,2,20,20
1714638707447,MCWP 50R,D00,518794,Staff,0,1,20,20
1714638707447,MCWP 50R,E00,518795,Staff,0,2,20,20
1714638707447,MCWP 50R,F00,518796,Staff,0,0,20,20
1714638707447,MCWP 50R,G00,518797,Staff,0,1,20,20
1714638708474,MMW 12R,A01,514034,Herbst; Matthew,0,0,16,16
1714638708474,MMW 12R,A02,514035,Herbst; Matthew,1,0,16,15
1714638709502,MMW 13R,A01,514037,Staff,0,4,16,16
1714638709502,MMW 13R,A02,514039,Staff,0,2,16,16
1714638709502,MMW 13R,A03,628519,Staff,0,2,16,16
1714638711561,SIO 295LS,A00,523233,Staff,10,0,30,20
1714638712586,SIO 295S,A00,523232,Staff,10,0,30,20
1714638713615,SIOC 290S,A01,637330,Merrifield; Mark A,23,0,30,7
1714638714643,SIOC 291S,A01,637333,Gabriel; Corey John,23,0,30,7
1714638715669,SOCI 117,A01,494376,Staff,0,4,5,5
1714638716695,WES 237B,A00,494380,Staff,9,0,20,11
1714638718777,AESE 279B,A00,494370,Wade; Jon P,0,0,33,33
1714638719802,AIP 197,001,627712,Vespa; Emanuel Ignacio,9998,0,9999,1
1714638720828,ANAR 135S,A00,494369,Braswell; Geoffrey E.,0,0,0,0
1714638721855,BENG 196,001,628496,Engler; Adam J.,9998,0,9999,1
1714638722886,CAT 124RS,A01,519847,Geibel; William,0,0,20,20
1714638723910,CAT 125RS,A01,515971,Geibel; William,0,0,20,20
1714638724939,CLRE 250,A00,511389,Morris; Sheldon,9993,0,9999,6
1714638725976,CLRE 251,A00,507176,Mehta; Ravindra L.,9993,0,9999,6
1714638725976,CLRE 251,B00,511410,Mehta; Ravindra L.,9998,0,9999,1
1714638727005,CLRE 252,A00,507189,Cuomo; Raphael Eduardo,9995,0,9999,4
1714638728032,CLRE 253,A00,507199,Vaida; Florin,9994,0,9999,5
1714638728032,CLRE 253,B00,507202,Vaida; Florin,9999,0,9999,0
1714638729068,CLRE 259,A00,507211,Patel; Hemal,9996,0,9999,3
1714638730092,CLRE 260,A00,507221,Cuomo; Raphael Eduardo,9999,0,9999,0
1714638731147,CLRE 297,001,507242,Cuomo; Raphael Eduardo,9999,0,9999,0
1714638732173,COGS 197,001,638244,Voytek; Bradley Thomas,9998,0,9999,1
1714638733208,CSE 191,A00,516875,Minnes Kemp; Mor Mia,9992,0,9999,7
1714638734234,CSE 197,001,637388,Minnes Kemp; Mor Mia,9998,0,9999,1
1714638735269,CSS 201S,A01,494383,Staff,35,0,35,0
1714638736298,CSS 202S,A01,494387,Staff,35,0,35,0
1714638737323,DSC 197,001,628532,Eldridge; Justin Matthew,9996,0,9999,3
1714638738349,EAP 100,A00,516065,Staff,9797,0,9999,202
1714638739374,ECE 45,A01,507414,Staff,33,0,60,27
1714638741429,ECE 111,A01,507420,Staff,15,0,50,35
1714638742455,ECE 197,001,548057,Sievenpiper; Daniel F.,9993,0,9999,6
1714638743488,EDS 115,A00,507243,Choi; Bailey Miyeon,10,0,28,18
1714638744514,EDS 117,A01,494379,Staff,0,4,30,30
1714638745540,EDS 125,A00,507246,Hopkins; Megan Beth,9,0,30,21
1714638746571,EDS 128A,A01,507264,Fargason; Sharon Gayle,8,0,26,18
1714638747605,EDS 128B,A01,507293,Pappas; Elizabeth,12,0,30,18
1714638748629,EDS 139,A00,507294,Fargason; Sharon Gayle,13,0,30,17
1714638748629,EDS 139,B00,507313,Pappas; Elizabeth,13,0,30,17
1714638749674,EDS 201,A00,507315,Staff,13,0,30,17
1714638750706,EDS 203,A01,507317,Halter; Christopher P.,12,0,30,18
1714638751742,EDS 204R,A01,507319,Halter; Christopher P.,0,3,30,30
1714638751742,EDS 204R,B01,507331,Heinzman; Erica M.,16,0,30,14
1714638752767,EDS 206R,A00,507332,Staff,0,4,30,30
1714638752767,EDS 206R,B00,507343,Staff,17,0,30,13
1714638753794,EDS 250,A00,507344,Hemans; Patricia Ann Benitez,22,0,40,18
1714638754819,EDS 281,A00,507345,Daly; Alan J.,18,0,18,0
1714638755846,EDS 284,A00,507350,Daly; Alan J.,16,0,16,0
1714638756877,EDS 286,A00,507359,Fine; Sarah,18,0,18,0
1714638757902,EDS 289C,A01,507361,Daly; Alan J.,18,0,18,0
1714638758928,EDS 290,A00,507366,Hofstetter; Carolyn,15,0,15,0
1714638759955,LIGM 5A,A00,507421,Fischer-Grunski; Eva K,18,0,20,2
1714638760980,LIGM 5B,A00,507423,Fischer-Grunski; Eva K,19,0,20,1
1714638762017,LIGM 5C,A00,507425,Fischer-Grunski; Eva K,19,0,20,1
1714638763042,LIIT 5AS,A00,507427,Carnelos; Chiara,20,0,20,0
1714638764066,LIIT 5BS,A00,507430,Carnelos; Chiara,20,0,20,0
1714638765097,LIIT 5CS,A00,507432,Carnelos; Chiara,20,0,20,0
1714638766124,LISP 5A,A00,507541,Munoz Sanchez; Alicia,11,0,20,9
1714638767150,LISP 5B,A00,507671,Munoz Sanchez; Alicia,8,0,20,12
1714638768175,LISP 5C,A00,507696,Munoz Sanchez; Alicia,9,0,20,11
1714638769200,MAE 197,001,528363,Boechler; Nicholas Sebastia,9998,0,9999,1
1714638770230,MATH 197,001,523477,Kedlaya; Kiran S.,9995,0,9999,4
1714638770230,MATH 197,002,563811,Zhang; Danna,9995,0,9999,4
1714638770230,MATH 197,003,628552,Dumitriu; Ioana,9998,0,9999,1
1714638771255,MCWP 40R,A00,518780,Staff,2,0,20,18
1714638771255,MCWP 40R,B00,518781,Staff,8,0,20,12
1714638771255,MCWP 40R,C00,518783,Staff,6,0,20,14
1714638772287,MCWP 50R,A00,518791,Staff,0,0,20,20
1714638772287,MCWP 50R,B00,518792,Staff,0,2,20,20
1714638772287,MCWP 50R,C00,518793,Staff,0,2,20,20
1714638772287,MCWP 50R,D00,518794,Staff,0,1,20,20
1714638772287,MCWP 50R,E00,518795,Staff,0,2,20,20
1714638772287,MCWP 50R,F00,518796,Staff,0,0,20,20
1714638772287,MCWP 50R,G00,518797,Staff,0,1,20,20
1714638773317,MMW 12R,A01,514034,Herbst; Matthew,0,0,16,16
1714638773317,MMW 12R,A02,514035,Herbst; Matthew,1,0,16,15
1714638774342,MMW 13R,A01,514037,Staff,0,4,16,16
1714638774342,MMW 13R,A02,514039,Staff,0,2,16,16
1714638774342,MMW 13R,A03,628519,Staff,0,2,16,16
1714638776392,SIO 295LS,A00,523233,Staff,10,0,30,20
1714638777418,SIO 295S,A00,523232,Staff,10,0,30,20
1714638778445,SIOC 290S,A01,637330,Merrifield; Mark A,23,0,30,7
1714638779471,SIOC 291S,A01,637333,Gabriel; Corey John,23,0,30,7
1714638780503,SOCI 117,A01,494376,Staff,0,4,5,5
1714638781530,WES 237B,A00,494380,Staff,9,0,20,11
1714638783601,AESE 279B,A00,494370,Wade; Jon P,0,0,33,33
1714638784624,AIP 197,001,627712,Vespa; Emanuel Ignacio,9998,0,9999,1
1714638785664,ANAR 135S,A00,494369,Braswell; Geoffrey E.,0,0,0,0
1714638786691,BENG 196,001,628496,Engler; Adam J.,9998,0,9999,1
1714638787716,CAT 124RS,A01,519847,Geibel; William,0,0,20,20
1714638788744,CAT 125RS,A01,515971,Geibel; William,0,0,20,20
1714638789770,CLRE 250,A00,511389,Morris; Sheldon,9993,0,9999,6
1714638790797,CLRE 251,A00,507176,Mehta; Ravindra L.,9993,0,9999,6
1714638790797,CLRE 251,B00,511410,Mehta; Ravindra L.,9998,0,9999,1
1714638791821,CLRE 252,A00,507189,Cuomo; Raphael Eduardo,9995,0,9999,4
1714638792853,CLRE 253,A00,507199,Vaida; Florin,9994,0,9999,5
1714638792853,CLRE 253,B00,507202,Vaida; Florin,9999,0,9999,0
1714638793880,CLRE 259,A00,507211,Patel; Hemal,9996,0,9999,3
1714638794912,CLRE 260,A00,507221,Cuomo; Raphael Eduardo,9999,0,9999,0
1714638795936,CLRE 297,001,507242,Cuomo; Raphael Eduardo,9999,0,9999,0
1714638796977,COGS 197,001,638244,Voytek; Bradley Thomas,9998,0,9999,1
1714638798028,CSE 191,A00,516875,Minnes Kemp; Mor Mia,9992,0,9999,7
1714638799054,CSE 197,001,637388,Minnes Kemp; Mor Mia,9998,0,9999,1
1714638800081,CSS 201S,A01,494383,Staff,35,0,35,0
1714638801107,CSS 202S,A01,494387,Staff,35,0,35,0
1714638802133,DSC 197,001,628532,Eldridge; Justin Matthew,9996,0,9999,3
1714638803158,EAP 100,A00,516065,Staff,9797,0,9999,202
1714638804182,ECE 45,A01,507414,Staff,33,0,60,27
1714638806235,ECE 111,A01,507420,Staff,15,0,50,35
1714638807270,ECE 197,001,548057,Sievenpiper; Daniel F.,9993,0,9999,6
1714638808302,EDS 115,A00,507243,Choi; Bailey Miyeon,10,0,28,18
1714638809335,EDS 117,A01,494379,Staff,0,4,30,30
1714638810361,EDS 125,A00,507246,Hopkins; Megan Beth,9,0,30,21
1714638811386,EDS 128A,A01,507264,Fargason; Sharon Gayle,8,0,26,18
1714638812417,EDS 128B,A01,507293,Pappas; Elizabeth,12,0,30,18
1714638813446,EDS 139,A00,507294,Fargason; Sharon Gayle,13,0,30,17
1714638813446,EDS 139,B00,507313,Pappas; Elizabeth,13,0,30,17
1714638814472,EDS 201,A00,507315,Staff,13,0,30,17
1714638815499,EDS 203,A01,507317,Halter; Christopher P.,12,0,30,18
1714638816525,EDS 204R,A01,507319,Halter; Christopher P.,0,3,30,30
1714638816525,EDS 204R,B01,507331,Heinzman; Erica M.,16,0,30,14
1714638817553,EDS 206R,A00,507332,Staff,0,4,30,30
1714638817553,EDS 206R,B00,507343,Staff,17,0,30,13
1714638818586,EDS 250,A00,507344,Hemans; Patricia Ann Benitez,22,0,40,18
1714638819620,EDS 281,A00,507345,Daly; Alan J.,18,0,18,0
1714638820644,EDS 284,A00,507350,Daly; Alan J.,16,0,16,0
1714638821673,EDS 286,A00,507359,Fine; Sarah,18,0,18,0
1714638822699,EDS 289C,A01,507361,Daly; Alan J.,18,0,18,0
1714638823724,EDS 290,A00,507366,Hofstetter; Carolyn,15,0,15,0
1714638824751,LIGM 5A,A00,507421,Fischer-Grunski; Eva K,18,0,20,2
1714638825776,LIGM 5B,A00,507423,Fischer-Grunski; Eva K,19,0,20,1
1714638826806,LIGM 5C,A00,507425,Fischer-Grunski; Eva K,19,0,20,1
1714638827833,LIIT 5AS,A00,507427,Carnelos; Chiara,20,0,20,0
1714638828858,LIIT 5BS,A00,507430,Carnelos; Chiara,20,0,20,0
1714638829885,LIIT 5CS,A00,507432,Carnelos; Chiara,20,0,20,0
1714638830914,LISP 5A,A00,507541,Munoz Sanchez; Alicia,11,0,20,9
1714638831940,LISP 5B,A00,507671,Munoz Sanchez; Alicia,8,0,20,12
1714638832967,LISP 5C,A00,507696,Munoz Sanchez; Alicia,9,0,20,11
1714638833994,MAE 197,001,528363,Boechler; Nicholas Sebastia,9998,0,9999,1
1714638835021,MATH 197,001,523477,Kedlaya; Kiran S.,9995,0,9999,4
1714638835021,MATH 197,002,563811,Zhang; Danna,9995,0,9999,4
1714638835021,MATH 197,003,628552,Dumitriu; Ioana,9998,0,9999,1
1714638836048,MCWP 40R,A00,518780,Staff,2,0,20,18
1714638836048,MCWP 40R,B00,518781,Staff,8,0,20,12
1714638836048,MCWP 40R,C00,518783,Staff,6,0,20,14
1714638837076,MCWP 50R,A00,518791,Staff,0,0,20,20
1714638837076,MCWP 50R,B00,518792,Staff,0,2,20,20
1714638837076,MCWP 50R,C00,518793,Staff,0,2,20,20
1714638837076,MCWP 50R,D00,518794,Staff,0,1,20,20
1714638837076,MCWP 50R,E00,518795,Staff,0,2,20,20
1714638837076,MCWP 50R,F00,518796,Staff,0,0,20,20
1714638837076,MCWP 50R,G00,518797,Staff,0,1,20,20
1714638838110,MMW 12R,A01,514034,Herbst; Matthew,0,0,16,16
1714638838110,MMW 12R,A02,514035,Herbst; Matthew,1,0,16,15
1714638839143,MMW 13R,A01,514037,Staff,0,4,16,16
1714638839143,MMW 13R,A02,514039,Staff,0,2,16,16
1714638839143,MMW 13R,A03,628519,Staff,0,2,16,16
1714638841241,SIO 295LS,A00,523233,Staff,10,0,30,20
1714638842268,SIO 295S,A00,523232,Staff,10,0,30,20
1714638843295,SIOC 290S,A01,637330,Merrifield; Mark A,23,0,30,7
1714638844321,SIOC 291S,A01,637333,Gabriel; Corey John,23,0,30,7
1714638845348,SOCI 117,A01,494376,Staff,0,4,5,5
1714638846377,WES 237B,A00,494380,Staff,9,0,20,11
1714638848468,AESE 279B,A00,494370,Wade; Jon P,0,0,33,33
1714638849502,AIP 197,001,627712,Vespa; Emanuel Ignacio,9998,0,9999,1
1714638850526,ANAR 135S,A00,494369,Braswell; Geoffrey E.,0,0,0,0
1714638851558,BENG 196,001,628496,Engler; Adam J.,9998,0,9999,1
1714638852584,CAT 124RS,A01,519847,Geibel; William,0,0,20,20
1714638853623,CAT 125RS,A01,515971,Geibel; William,0,0,20,20
1714638854649,CLRE 250,A00,511389,Morris; Sheldon,9993,0,9999,6
1714638855676,CLRE 251,A00,507176,Mehta; Ravindra L.,9993,0,9999,6
1714638855676,CLRE 251,B00,511410,Mehta; Ravindra L.,9998,0,9999,1
1714638856703,CLRE 252,A00,507189,Cuomo; Raphael Eduardo,9995,0,9999,4
1714638857735,CLRE 253,A00,507199,Vaida; Florin,9994,0,9999,5
1714638857735,CLRE 253,B00,507202,Vaida; Florin,9999,0,9999,0
1714638858765,CLRE 259,A00,507211,Patel; Hemal,9996,0,9999,3
1714638859794,CLRE 260,A00,507221,Cuomo; Raphael Eduardo,9999,0,9999,0
1714638860820,CLRE 297,001,507242,Cuomo; Raphael Eduardo,9999,0,9999,0
1714638861849,COGS 197,001,638244,Voytek; Bradley Thomas,9998,0,9999,1
1714638862882,CSE 191,A00,516875,Minnes Kemp; Mor Mia,9992,0,9999,7
1714638863907,CSE 197,001,637388,Minnes Kemp; Mor Mia,9998,0,9999,1
1714638864931,CSS 201S,A01,494383,Staff,35,0,35,0
1714638865961,CSS 202S,A01,494387,Staff,35,0,35,0
1714638866987,DSC 197,001,628532,Eldridge; Justin Matthew,9996,0,9999,3
1714638868012,EAP 100,A00,516065,Staff,9797,0,9999,202
1714638869041,ECE 45,A01,507414,Staff,33,0,60,27
1714638871096,ECE 111,A01,507420,Staff,15,0,50,35
1714638872131,ECE 197,001,548057,Sievenpiper; Daniel F.,9993,0,9999,6
1714638873159,EDS 115,A00,507243,Choi; Bailey Miyeon,10,0,28,18
1714638874185,EDS 117,A01,494379,Staff,0,4,30,30
1714638875211,EDS 125,A00,507246,Hopkins; Megan Beth,9,0,30,21
1714638876235,EDS 128A,A01,507264,Fargason; Sharon Gayle,8,0,26,18
1714638877264,EDS 128B,A01,507293,Pappas; Elizabeth,12,0,30,18
1714638878294,EDS 139,A00,507294,Fargason; Sharon Gayle,13,0,30,17
1714638878294,EDS 139,B00,507313,Pappas; Elizabeth,13,0,30,17
1714638879318,EDS 201,A00,507315,Staff,13,0,30,17
1714638880354,EDS 203,A01,507317,Halter; Christopher P.,12,0,30,18
1714638881380,EDS 204R,A01,507319,Halter; Christopher P.,0,3,30,30
1714638881380,EDS 204R,B01,507331,Heinzman; Erica M.,16,0,30,14
1714638882404,EDS 206R,A00,507332,Staff,0,4,30,30
1714638882404,EDS 206R,B00,507343,Staff,17,0,30,13
1714638883436,EDS 250,A00,507344,Hemans; Patricia Ann Benitez,22,0,40,18
1714638884466,EDS 281,A00,507345,Daly; Alan J.,18,0,18,0
1714638885491,EDS 284,A00,507350,Daly; Alan J.,16,0,16,0
1714638886515,EDS 286,A00,507359,Fine; Sarah,18,0,18,0
1714638887541,EDS 289C,A01,507361,Daly; Alan J.,18,0,18,0
1714638888570,EDS 290,A00,507366,Hofstetter; Carolyn,15,0,15,0
1714638889596,LIGM 5A,A00,507421,Fischer-Grunski; Eva K,18,0,20,2
1714638890622,LIGM 5B,A00,507423,Fischer-Grunski; Eva K,19,0,20,1
1714638891648,LIGM 5C,A00,507425,Fischer-Grunski; Eva K,19,0,20,1
1714638892681,LIIT 5AS,A00,507427,Carnelos; Chiara,20,0,20,0
1714638893710,LIIT 5BS,A00,507430,Carnelos; Chiara,20,0,20,0
1714638894739,LIIT 5CS,A00,507432,Carnelos; Chiara,20,0,20,0
1714638895764,LISP 5A,A00,507541,Munoz Sanchez; Alicia,11,0,20,9
1714638896790,LISP 5B,A00,507671,Munoz Sanchez; Alicia,8,0,20,12
1714638897820,LISP 5C,A00,507696,Munoz Sanchez; Alicia,9,0,20,11
1714638898849,MAE 197,001,528363,Boechler; Nicholas Sebastia,9998,0,9999,1
1714638899878,MATH 197,001,523477,Kedlaya; Kiran S.,9995,0,9999,4
1714638899878,MATH 197,002,563811,Zhang; Danna,9995,0,9999,4
1714638899878,MATH 197,003,628552,Dumitriu; Ioana,9998,0,9999,1
1714638900903,MCWP 40R,A00,518780,Staff,2,0,20,18
1714638900903,MCWP 40R,B00,518781,Staff,8,0,20,12
1714638900903,MCWP 40R,C00,518783,Staff,6,0,20,14
1714638901934,MCWP 50R,A00,518791,Staff,0,0,20,20
1714638901934,MCWP 50R,B00,518792,Staff,0,2,20,20
1714638901934,MCWP 50R,C00,518793,Staff,0,2,20,20
1714638901934,MCWP 50R,D00,518794,Staff,0,1,20,20
1714638901934,MCWP 50R,E00,518795,Staff,0,2,20,20
1714638901934,MCWP 50R,F00,518796,Staff,0,0,20,20
1714638901934,MCWP 50R,G00,518797,Staff,0,1,20,20
1714638902965,MMW 12R,A01,514034,Herbst; Matthew,0,0,16,16
1714638902965,MMW 12R,A02,514035,Herbst; Matthew,1,0,16,15
1714638903991,MMW 13R,A01,514037,Staff,0,4,16,16
1714638903991,MMW 13R,A02,514039,Staff,0,2,16,16
1714638903991,MMW 13R,A03,628519,Staff,0,2,16,16
1714638906049,SIO 295LS,A00,523233,Staff,10,0,30,20
1714638907074,SIO 295S,A00,523232,Staff,10,0,30,20
1714638908104,SIOC 290S,A01,637330,Merrifield; Mark A,23,0,30,7
1714638909129,SIOC 291S,A01,637333,Gabriel; Corey John,23,0,30,7
1714638910153,SOCI 117,A01,494376,Staff,0,4,5,5
1714638911179,WES 237B,A00,494380,Staff,9,0,20,11
1714638913246,AESE 279B,A00,494370,Wade; Jon P,0,0,33,33
1714638914279,AIP 197,001,627712,Vespa; Emanuel Ignacio,9998,0,9999,1
1714638915305,ANAR 135S,A00,494369,Braswell; Geoffrey E.,0,0,0,0
1714638916333,BENG 196,001,628496,Engler; Adam J.,9998,0,9999,1
1714638917370,CAT 124RS,A01,519847,Geibel; William,0,0,20,20
1714638918395,CAT 125RS,A01,515971,Geibel; William,0,0,20,20
1714638919422,CLRE 250,A00,511389,Morris; Sheldon,9993,0,9999,6
1714638920449,CLRE 251,A00,507176,Mehta; Ravindra L.,9993,0,9999,6
1714638920449,CLRE 251,B00,511410,Mehta; Ravindra L.,9998,0,9999,1
1714638921475,CLRE 252,A00,507189,Cuomo; Raphael Eduardo,9995,0,9999,4
1714638922512,CLRE 253,A00,507199,Vaida; Florin,9994,0,9999,5
1714638922512,CLRE 253,B00,507202,Vaida; Florin,9999,0,9999,0
1714638923567,CLRE 259,A00,507211,Patel; Hemal,9996,0,9999,3
1714638924592,CLRE 260,A00,507221,Cuomo; Raphael Eduardo,9999,0,9999,0
1714638925617,CLRE 297,001,507242,Cuomo; Raphael Eduardo,9999,0,9999,0
1714638926649,COGS 197,001,638244,Voytek; Bradley Thomas,9998,0,9999,1
1714638927755,CSE 191,A00,516875,Minnes Kemp; Mor Mia,9992,0,9999,7
1714638928783,CSE 197,001,637388,Minnes Kemp; Mor Mia,9998,0,9999,1
1714638929815,CSS 201S,A01,494383,Staff,35,0,35,0
1714638930860,CSS 202S,A01,494387,Staff,35,0,35,0
1714638931891,DSC 197,001,628532,Eldridge; Justin Matthew,9996,0,9999,3
1714638932936,EAP 100,A00,516065,Staff,9797,0,9999,202
1714638933970,ECE 45,A01,507414,Staff,33,0,60,27
1714638936034,ECE 111,A01,507420,Staff,15,0,50,35
1714638937114,ECE 197,001,548057,Sievenpiper; Daniel F.,9993,0,9999,6
1714638938147,EDS 115,A00,507243,Choi; Bailey Miyeon,10,0,28,18
1714638939176,EDS 117,A01,494379,Staff,0,4,30,30
1714638940207,EDS 125,A00,507246,Hopkins; Megan Beth,9,0,30,21
1714638941237,EDS 128A,A01,507264,Fargason; Sharon Gayle,8,0,26,18
1714638942266,EDS 128B,A01,507293,Pappas; Elizabeth,12,0,30,18
1714638943295,EDS 139,A00,507294,Fargason; Sharon Gayle,13,0,30,17
1714638943295,EDS 139,B00,507313,Pappas; Elizabeth,13,0,30,17
1714638944329,EDS 201,A00,507315,Staff,13,0,30,17
1714638945354,EDS 203,A01,507317,Halter; Christopher P.,12,0,30,18
1714638946387,EDS 204R,A01,507319,Halter; Christopher P.,0,3,30,30
1714638946387,EDS 204R,B01,507331,Heinzman; Erica M.,16,0,30,14
1714638947416,EDS 206R,A00,507332,Staff,0,4,30,30
1714638947416,EDS 206R,B00,507343,Staff,17,0,30,13
1714638948446,EDS 250,A00,507344,Hemans; Patricia Ann Benitez,22,0,40,18
1714638949471,EDS 281,A00,507345,Daly; Alan J.,18,0,18,0
1714638950499,EDS 284,A00,507350,Daly; Alan J.,16,0,16,0
1714638951530,EDS 286,A00,507359,Fine; Sarah,18,0,18,0
1714638952557,EDS 289C,A01,507361,Daly; Alan J.,18,0,18,0
1714638953584,EDS 290,A00,507366,Hofstetter; Carolyn,15,0,15,0
1714638954623,LIGM 5A,A00,507421,Fischer-Grunski; Eva K,18,0,20,2
1714638955650,LIGM 5B,A00,507423,Fischer-Grunski; Eva K,19,0,20,1
1714638956677,LIGM 5C,A00,507425,Fischer-Grunski; Eva K,19,0,20,1
1714638957710,LIIT 5AS,A00,507427,Carnelos; Chiara,20,0,20,0
1714638958740,LIIT 5BS,A00,507430,Carnelos; Chiara,20,0,20,0
1714638959768,LIIT 5CS,A00,507432,Carnelos; Chiara,20,0,20,0
1714638960798,LISP 5A,A00,507541,Munoz Sanchez; Alicia,11,0,20,9
1714638961824,LISP 5B,A00,507671,Munoz Sanchez; Alicia,8,0,20,12
1714638962857,LISP 5C,A00,507696,Munoz Sanchez; Alicia,9,0,20,11
1714638963884,MAE 197,001,528363,Boechler; Nicholas Sebastia,9998,0,9999,1
1714638964920,MATH 197,001,523477,Kedlaya; Kiran S.,9995,0,9999,4
1714638964920,MATH 197,002,563811,Zhang; Danna,9995,0,9999,4
1714638964920,MATH 197,003,628552,Dumitriu; Ioana,9998,0,9999,1
1714638965953,MCWP 40R,A00,518780,Staff,2,0,20,18
1714638965953,MCWP 40R,B00,518781,Staff,8,0,20,12
1714638965953,MCWP 40R,C00,518783,Staff,6,0,20,14
1714638966980,MCWP 50R,A00,518791,Staff,0,0,20,20
1714638966980,MCWP 50R,B00,518792,Staff,0,2,20,20
1714638966980,MCWP 50R,C00,518793,Staff,0,2,20,20
1714638966980,MCWP 50R,D00,518794,Staff,0,1,20,20
1714638966980,MCWP 50R,E00,518795,Staff,0,2,20,20
1714638966980,MCWP 50R,F00,518796,Staff,0,0,20,20
1714638966980,MCWP 50R,G00,518797,Staff,0,1,20,20
1714638968012,MMW 12R,A01,514034,Herbst; Matthew,0,0,16,16
1714638968012,MMW 12R,A02,514035,Herbst; Matthew,1,0,16,15
1714638969039,MMW 13R,A01,514037,Staff,0,4,16,16
1714638969039,MMW 13R,A02,514039,Staff,0,2,16,16
1714638969039,MMW 13R,A03,628519,Staff,0,2,16,16
1714638971091,SIO 295LS,A00,523233,Staff,10,0,30,20
1714638972115,SIO 295S,A00,523232,Staff,10,0,30,20
1714638973147,SIOC 290S,A01,637330,Merrifield; Mark A,23,0,30,7
1714638974179,SIOC 291S,A01,637333,Gabriel; Corey John,23,0,30,7
1714638975206,SOCI 117,A01,494376,Staff,0,4,5,5
1714638976237,WES 237B,A00,494380,Staff,9,0,20,11
1714638978345,AESE 279B,A00,494370,Wade; Jon P,0,0,33,33
1714638979372,AIP 197,001,627712,Vespa; Emanuel Ignacio,9998,0,9999,1
1714638980398,ANAR 135S,A00,494369,Braswell; Geoffrey E.,0,0,0,0
1714638981425,BENG 196,001,628496,Engler; Adam J.,9998,0,9999,1
1714638982455,CAT 124RS,A01,519847,Geibel; William,0,0,20,20
1714638983485,CAT 125RS,A01,515971,Geibel; William,0,0,20,20
1714638984519,CLRE 250,A00,511389,Morris; Sheldon,9993,0,9999,6
1714638985552,CLRE 251,A00,507176,Mehta; Ravindra L.,9993,0,9999,6
1714638985552,CLRE 251,B00,511410,Mehta; Ravindra L.,9998,0,9999,1
1714638986576,CLRE 252,A00,507189,Cuomo; Raphael Eduardo,9995,0,9999,4
1714638987606,CLRE 253,A00,507199,Vaida; Florin,9994,0,9999,5
1714638987606,CLRE 253,B00,507202,Vaida; Florin,9999,0,9999,0
1714638988636,CLRE 259,A00,507211,Patel; Hemal,9996,0,9999,3
1714638989667,CLRE 260,A00,507221,Cuomo; Raphael Eduardo,9999,0,9999,0
1714638990692,CLRE 297,001,507242,Cuomo; Raphael Eduardo,9999,0,9999,0
1714638991719,COGS 197,001,638244,Voytek; Bradley Thomas,9998,0,9999,1
1714638992751,CSE 191,A00,516875,Minnes Kemp; Mor Mia,9992,0,9999,7
1714638993781,CSE 197,001,637388,Minnes Kemp; Mor Mia,9998,0,9999,1
1714638994813,CSS 201S,A01,494383,Staff,35,0,35,0
1714638995844,CSS 202S,A01,494387,Staff,35,0,35,0
1714638996876,DSC 197,001,628532,Eldridge; Justin Matthew,9996,0,9999,3
1714638997902,EAP 100,A00,516065,Staff,9797,0,9999,202
1714638998927,ECE 45,A01,507414,Staff,33,0,60,27
1714639000984,ECE 111,A01,507420,Staff,15,0,50,35
1714639002011,ECE 197,001,548057,Sievenpiper; Daniel F.,9993,0,9999,6
1714639003036,EDS 115,A00,507243,Choi; Bailey Miyeon,10,0,28,18
1714639004070,EDS 117,A01,494379,Staff,0,4,30,30
1714639005100,EDS 125,A00,507246,Hopkins; Megan Beth,9,0,30,21
1714639006128,EDS 128A,A01,507264,Fargason; Sharon Gayle,8,0,26,18
1714639007158,EDS 128B,A01,507293,Pappas; Elizabeth,12,0,30,18
1714639008187,EDS 139,A00,507294,Fargason; Sharon Gayle,13,0,30,17
1714639008187,EDS 139,B00,507313,Pappas; Elizabeth,13,0,30,17
1714639009214,EDS 201,A00,507315,Staff,13,0,30,17
1714639010241,EDS 203,A01,507317,Halter; Christopher P.,12,0,30,18
1714639011282,EDS 204R,A01,507319,Halter; Christopher P.,0,3,30,30
1714639011282,EDS 204R,B01,507331,Heinzman; Erica M.,16,0,30,14
1714639012314,EDS 206R,A00,507332,Staff,0,4,30,30
1714639012314,EDS 206R,B00,507343,Staff,17,0,30,13
1714639013344,EDS 250,A00,507344,Hemans; Patricia Ann Benitez,22,0,40,18
1714639014373,EDS 281,A00,507345,Daly; Alan J.,18,0,18,0
1714639015400,EDS 284,A00,507350,Daly; Alan J.,16,0,16,0
1714639016427,EDS 286,A00,507359,Fine; Sarah,18,0,18,0
1714639017459,EDS 289C,A01,507361,Daly; Alan J.,18,0,18,0
1714639018489,EDS 290,A00,507366,Hofstetter; Carolyn,15,0,15,0
1714639019515,LIGM 5A,A00,507421,Fischer-Grunski; Eva K,18,0,20,2
1714639020541,LIGM 5B,A00,507423,Fischer-Grunski; Eva K,19,0,20,1
1714639021568,LIGM 5C,A00,507425,Fischer-Grunski; Eva K,19,0,20,1
1714639022596,LIIT 5AS,A00,507427,Carnelos; Chiara,20,0,20,0
1714639023622,LIIT 5BS,A00,507430,Carnelos; Chiara,20,0,20,0
1714639024650,LIIT 5CS,A00,507432,Carnelos; Chiara,20,0,20,0
1714639025676,LISP 5A,A00,507541,Munoz Sanchez; Alicia,11,0,20,9
1714639026708,LISP 5B,A00,507671,Munoz Sanchez; Alicia,8,0,20,12
1714639027742,LISP 5C,A00,507696,Munoz Sanchez; Alicia,9,0,20,11
1714639028778,MAE 197,001,528363,Boechler; Nicholas Sebastia,9998,0,9999,1
1714639029806,MATH 197,001,523477,Kedlaya; Kiran S.,9995,0,9999,4
1714639029806,MATH 197,002,563811,Zhang; Danna,9995,0,9999,4
1714639029806,MATH 197,003,628552,Dumitriu; Ioana,9998,0,9999,1
1714639030833,MCWP 40R,A00,518780,Staff,2,0,20,18
1714639030833,MCWP 40R,B00,518781,Staff,8,0,20,12
1714639030833,MCWP 40R,C00,518783,Staff,6,0,20,14
1714639031864,MCWP 50R,A00,518791,Staff,0,0,20,20
1714639031864,MCWP 50R,B00,518792,Staff,0,2,20,20
1714639031864,MCWP 50R,C00,518793,Staff,0,2,20,20
1714639031864,MCWP 50R,D00,518794,Staff,0,1,20,20
1714639031864,MCWP 50R,E00,518795,Staff,0,2,20,20
1714639031864,MCWP 50R,F00,518796,Staff,0,0,20,20
1714639031864,MCWP 50R,G00,518797,Staff,0,1,20,20
1714639032895,MMW 12R,A01,514034,Herbst; Matthew,0,0,16,16
1714639032895,MMW 12R,A02,514035,Herbst; Matthew,1,0,16,15
1714639033923,MMW 13R,A01,514037,Staff,0,4,16,16
1714639033923,MMW 13R,A02,514039,Staff,0,2,16,16
1714639033923,MMW 13R,A03,628519,Staff,0,2,16,16
1714639035976,SIO 295LS,A00,523233,Staff,10,0,30,20
1714639037000,SIO 295S,A00,523232,Staff,10,0,30,20
1714639038027,SIOC 290S,A01,637330,Merrifield; Mark A,23,0,30,7
1714639039059,SIOC 291S,A01,637333,Gabriel; Corey John,23,0,30,7
1714639040084,SOCI 117,A01,494376,Staff,0,4,5,5
1714639041113,WES 237B,A00,494380,Staff,9,0,20,11
1714639043193,AESE 279B,A00,494370,Wade; Jon P,0,0,33,33
1714639044224,AIP 197,001,627712,Vespa; Emanuel Ignacio,9998,0,9999,1
1714639045251,ANAR 135S,A00,494369,Braswell; Geoffrey E.,0,0,0,0
1714639046281,BENG 196,001,628496,Engler; Adam J.,9998,0,9999,1
1714639047314,CAT 124RS,A01,519847,Geibel; William,0,0,20,20
1714639048345,CAT 125RS,A01,515971,Geibel; William,0,0,20,20
1714639049370,CLRE 250,A00,511389,Morris; Sheldon,9993,0,9999,6
1714639050397,CLRE 251,A00,507176,Mehta; Ravindra L.,9993,0,9999,6
1714639050397,CLRE 251,B00,511410,Mehta; Ravindra L.,9998,0,9999,1
1714639051424,CLRE 252,A00,507189,Cuomo; Raphael Eduardo,9995,0,9999,4
1714639052449,CLRE 253,A00,507199,Vaida; Florin,9994,0,9999,5
1714639052449,CLRE 253,B00,507202,Vaida; Florin,9999,0,9999,0
1714639053474,CLRE 259,A00,507211,Patel; Hemal,9996,0,9999,3
1714639054498,CLRE 260,A00,507221,Cuomo; Raphael Eduardo,9999,0,9999,0
1714639055522,CLRE 297,001,507242,Cuomo; Raphael Eduardo,9999,0,9999,0
1714639056549,COGS 197,001,638244,Voytek; Bradley Thomas,9998,0,9999,1
1714639057580,CSE 191,A00,516875,Minnes Kemp; Mor Mia,9992,0,9999,7
1714639058612,CSE 197,001,637388,Minnes Kemp; Mor Mia,9998,0,9999,1
1714639059647,CSS 201S,A01,494383,Staff,35,0,35,0
1714639060670,CSS 202S,A01,494387,Staff,35,0,35,0
1714639061695,DSC 197,001,628532,Eldridge; Justin Matthew,9996,0,9999,3
1714639062723,EAP 100,A00,516065,Staff,9797,0,9999,202
1714639063754,ECE 45,A01,507414,Staff,33,0,60,27
1714639065812,ECE 111,A01,507420,Staff,15,0,50,35
1714639066843,ECE 197,001,548057,Sievenpiper; Daniel F.,9993,0,9999,6
1714639067873,EDS 115,A00,507243,Choi; Bailey Miyeon,10,0,28,18
1714639068897,EDS 117,A01,494379,Staff,0,4,30,30
1714639069929,EDS 125,A00,507246,Hopkins; Megan Beth,9,0,30,21
1714639070956,EDS 128A,A01,507264,Fargason; Sharon Gayle,8,0,26,18
1714639071986,EDS 128B,A01,507293,Pappas; Elizabeth,12,0,30,18
1714639073018,EDS 139,A00,507294,Fargason; Sharon Gayle,13,0,30,17
1714639073018,EDS 139,B00,507313,Pappas; Elizabeth,13,0,30,17
1714639074055,EDS 201,A00,507315,Staff,13,0,30,17
1714639075088,EDS 203,A01,507317,Halter; Christopher P.,12,0,30,18
1714639076118,EDS 204R,A01,507319,Halter; Christopher P.,0,3,30,30
1714639076118,EDS 204R,B01,507331,Heinzman; Erica M.,16,0,30,14
1714639077143,EDS 206R,A00,507332,Staff,0,4,30,30
1714639077143,EDS 206R,B00,507343,Staff,17,0,30,13
1714639078170,EDS 250,A00,507344,Hemans; Patricia Ann Benitez,22,0,40,18
1714639079196,EDS 281,A00,507345,Daly; Alan J.,18,0,18,0
1714639080222,EDS 284,A00,507350,Daly; Alan J.,16,0,16,0
1714639081250,EDS 286,A00,507359,Fine; Sarah,18,0,18,0
1714639082281,EDS 289C,A01,507361,Daly; Alan J.,18,0,18,0
1714639083312,EDS 290,A00,507366,Hofstetter; Carolyn,15,0,15,0
1714639084343,LIGM 5A,A00,507421,Fischer-Grunski; Eva K,18,0,20,2
1714639085369,LIGM 5B,A00,507423,Fischer-Grunski; Eva K,19,0,20,1
1714639086396,LIGM 5C,A00,507425,Fischer-Grunski; Eva K,19,0,20,1
1714639087421,LIIT 5AS,A00,507427,Carnelos; Chiara,20,0,20,0
1714639088455,LIIT 5BS,A00,507430,Carnelos; Chiara,20,0,20,0
1714639089487,LIIT 5CS,A00,507432,Carnelos; Chiara,20,0,20,0
1714639090514,LISP 5A,A00,507541,Munoz Sanchez; Alicia,11,0,20,9
1714639091545,LISP 5B,A00,507671,Munoz Sanchez; Alicia,8,0,20,12
1714639092572,LISP 5C,A00,507696,Munoz Sanchez; Alicia,9,0,20,11
1714639093597,MAE 197,001,528363,Boechler; Nicholas Sebastia,9998,0,9999,1
1714639094631,MATH 197,001,523477,Kedlaya; Kiran S.,9995,0,9999,4
1714639094631,MATH 197,002,563811,Zhang; Danna,9995,0,9999,4
1714639094631,MATH 197,003,628552,Dumitriu; Ioana,9998,0,9999,1
1714639095662,MCWP 40R,A00,518780,Staff,2,0,20,18
1714639095662,MCWP 40R,B00,518781,Staff,8,0,20,12
1714639095662,MCWP 40R,C00,518783,Staff,6,0,20,14
1714639096688,MCWP 50R,A00,518791,Staff,0,0,20,20
1714639096688,MCWP 50R,B00,518792,Staff,0,2,20,20
1714639096688,MCWP 50R,C00,518793,Staff,0,2,20,20
1714639096688,MCWP 50R,D00,518794,Staff,0,1,20,20
1714639096688,MCWP 50R,E00,518795,Staff,0,2,20,20
1714639096688,MCWP 50R,F00,518796,Staff,0,0,20,20
1714639096688,MCWP 50R,G00,518797,Staff,0,1,20,20
1714639097720,MMW 12R,A01,514034,Herbst; Matthew,0,0,16,16
1714639097720,MMW 12R,A02,514035,Herbst; Matthew,1,0,16,15
1714639098752,MMW 13R,A01,514037,Staff,0,4,16,16
1714639098752,MMW 13R,A02,514039,Staff,0,2,16,16
1714639098752,MMW 13R,A03,628519,Staff,0,2,16,16
1714639100805,SIO 295LS,A00,523233,Staff,10,0,30,20
1714639101836,SIO 295S,A00,523232,Staff,10,0,30,20
1714639102864,SIOC 290S,A01,637330,Merrifield; Mark A,23,0,30,7
1714639103890,SIOC 291S,A01,637333,Gabriel; Corey John,23,0,30,7
1714639104921,SOCI 117,A01,494376,Staff,0,4,5,5
1714639105947,WES 237B,A00,494380,Staff,9,0,20,11
1714639108041,AESE 279B,A00,494370,Wade; Jon P,0,0,33,33
1714639109067,AIP 197,001,627712,Vespa; Emanuel Ignacio,9998,0,9999,1
1714639110096,ANAR 135S,A00,494369,Braswell; Geoffrey E.,0,0,0,0
1714639111123,BENG 196,001,628496,Engler; Adam J.,9998,0,9999,1
1714639112154,CAT 124RS,A01,519847,Geibel; William,0,0,20,20
1714639113178,CAT 125RS,A01,515971,Geibel; William,0,0,20,20
1714639114207,CLRE 250,A00,511389,Morris; Sheldon,9993,0,9999,6
1714639115234,CLRE 251,A00,507176,Mehta; Ravindra L.,9993,0,9999,6
1714639115234,CLRE 251,B00,511410,Mehta; Ravindra L.,9998,0,9999,1
1714639116260,CLRE 252,A00,507189,Cuomo; Raphael Eduardo,9995,0,9999,4
1714639117290,CLRE 253,A00,507199,Vaida; Florin,9994,0,9999,5
1714639117290,CLRE 253,B00,507202,Vaida; Florin,9999,0,9999,0
1714639118316,CLRE 259,A00,507211,Patel; Hemal,9996,0,9999,3
1714639119343,CLRE 260,A00,507221,Cuomo; Raphael Eduardo,9999,0,9999,0
1714639120366,CLRE 297,001,507242,Cuomo; Raphael Eduardo,9999,0,9999,0
1714639121392,COGS 197,001,638244,Voytek; Bradley Thomas,9998,0,9999,1
1714639122419,CSE 191,A00,516875,Minnes Kemp; Mor Mia,9992,0,9999,7
1714639123444,CSE 197,001,637388,Minnes Kemp; Mor Mia,9998,0,9999,1
1714639124477,CSS 201S,A01,494383,Staff,35,0,35,0
1714639125507,CSS 202S,A01,494387,Staff,35,0,35,0
1714639126532,DSC 197,001,628532,Eldridge; Justin Matthew,9996,0,9999,3
1714639127558,EAP 100,A00,516065,Staff,9797,0,9999,202
1714639128584,ECE 45,A01,507414,Staff,33,0,60,27
1714639130648,ECE 111,A01,507420,Staff,15,0,50,35
1714639131674,ECE 197,001,548057,Sievenpiper; Daniel F.,9993,0,9999,6
1714639132703,EDS 115,A00,507243,Choi; Bailey Miyeon,10,0,28,18
1714639133731,EDS 117,A01,494379,Staff,0,4,30,30
1714639134758,EDS 125,A00,507246,Hopkins; Megan Beth,9,0,30,21
1714639135788,EDS 128A,A01,507264,Fargason; Sharon Gayle,8,0,26,18
1714639136817,EDS 128B,A01,507293,Pappas; Elizabeth,12,0,30,18
1714639137843,EDS 139,A00,507294,Fargason; Sharon Gayle,13,0,30,17
1714639137843,EDS 139,B00,507313,Pappas; Elizabeth,13,0,30,17
1714639138866,EDS 201,A00,507315,Staff,13,0,30,17
1714639139892,EDS 203,A01,507317,Halter; Christopher P.,12,0,30,18
1714639140919,EDS 204R,A01,507319,Halter; Christopher P.,0,3,30,30
1714639140919,EDS 204R,B01,507331,Heinzman; Erica M.,16,0,30,14
1714639141945,EDS 206R,A00,507332,Staff,0,4,30,30
1714639141945,EDS 206R,B00,507343,Staff,17,0,30,13
1714639142976,EDS 250,A00,507344,Hemans; Patricia Ann Benitez,22,0,40,18
1714639144002,EDS 281,A00,507345,Daly; Alan J.,18,0,18,0
1714639145026,EDS 284,A00,507350,Daly; Alan J.,16,0,16,0
1714639146056,EDS 286,A00,507359,Fine; Sarah,18,0,18,0
1714639147082,EDS 289C,A01,507361,Daly; Alan J.,18,0,18,0
1714639148111,EDS 290,A00,507366,Hofstetter; Carolyn,15,0,15,0
1714639149143,LIGM 5A,A00,507421,Fischer-Grunski; Eva K,18,0,20,2
1714639150168,LIGM 5B,A00,507423,Fischer-Grunski; Eva K,19,0,20,1
1714639151193,LIGM 5C,A00,507425,Fischer-Grunski; Eva K,19,0,20,1
1714639152217,LIIT 5AS,A00,507427,Carnelos; Chiara,20,0,20,0
1714639153243,LIIT 5BS,A00,507430,Carnelos; Chiara,20,0,20,0
1714639154276,LIIT 5CS,A00,507432,Carnelos; Chiara,20,0,20,0
1714639155301,LISP 5A,A00,507541,Munoz Sanchez; Alicia,11,0,20,9
1714639156330,LISP 5B,A00,507671,Munoz Sanchez; Alicia,8,0,20,12
1714639157356,LISP 5C,A00,507696,Munoz Sanchez; Alicia,9,0,20,11
1714639158391,MAE 197,001,528363,Boechler; Nicholas Sebastia,9998,0,9999,1
1714639159427,MATH 197,001,523477,Kedlaya; Kiran S.,9995,0,9999,4
1714639159427,MATH 197,002,563811,Zhang; Danna,9995,0,9999,4
1714639159427,MATH 197,003,628552,Dumitriu; Ioana,9998,0,9999,1
1714639160455,MCWP 40R,A00,518780,Staff,2,0,20,18
1714639160455,MCWP 40R,B00,518781,Staff,8,0,20,12
1714639160455,MCWP 40R,C00,518783,Staff,6,0,20,14
1714639161481,MCWP 50R,A00,518791,Staff,0,0,20,20
1714639161481,MCWP 50R,B00,518792,Staff,0,2,20,20
1714639161481,MCWP 50R,C00,518793,Staff,0,2,20,20
1714639161481,MCWP 50R,D00,518794,Staff,0,1,20,20
1714639161481,MCWP 50R,E00,518795,Staff,0,2,20,20
1714639161481,MCWP 50R,F00,518796,Staff,0,0,20,20
1714639161481,MCWP 50R,G00,518797,Staff,0,1,20,20
1714639162506,MMW 12R,A01,514034,Herbst; Matthew,0,0,16,16
1714639162506,MMW 12R,A02,514035,Herbst; Matthew,1,0,16,15
1714639163531,MMW 13R,A01,514037,Staff,0,4,16,16
1714639163531,MMW 13R,A02,514039,Staff,0,2,16,16
1714639163531,MMW 13R,A03,628519,Staff,0,2,16,16
1714639165587,SIO 295LS,A00,523233,Staff,10,0,30,20
1714639166616,SIO 295S,A00,523232,Staff,10,0,30,20
1714639167649,SIOC 290S,A01,637330,Merrifield; Mark A,23,0,30,7
1714639168675,SIOC 291S,A01,637333,Gabriel; Corey John,23,0,30,7
1714639169708,SOCI 117,A01,494376,Staff,0,4,5,5
1714639170736,WES 237B,A00,494380,Staff,9,0,20,11
1714639172815,AESE 279B,A00,494370,Wade; Jon P,0,0,33,33
1714639173841,AIP 197,001,627712,Vespa; Emanuel Ignacio,9998,0,9999,1
1714639174866,ANAR 135S,A00,494369,Braswell; Geoffrey E.,0,0,0,0
1714639175891,BENG 196,001,628496,Engler; Adam J.,9998,0,9999,1
1714639176916,CAT 124RS,A01,519847,Geibel; William,0,0,20,20
1714639177945,CAT 125RS,A01,515971,Geibel; William,0,0,20,20
1714639178972,CLRE 250,A00,511389,Morris; Sheldon,9993,0,9999,6
1714639180000,CLRE 251,A00,507176,Mehta; Ravindra L.,9993,0,9999,6
1714639180000,CLRE 251,B00,511410,Mehta; Ravindra L.,9998,0,9999,1
1714639181027,CLRE 252,A00,507189,Cuomo; Raphael Eduardo,9995,0,9999,4
1714639182058,CLRE 253,A00,507199,Vaida; Florin,9994,0,9999,5
1714639182058,CLRE 253,B00,507202,Vaida; Florin,9999,0,9999,0
1714639183083,CLRE 259,A00,507211,Patel; Hemal,9996,0,9999,3
1714639184110,CLRE 260,A00,507221,Cuomo; Raphael Eduardo,9999,0,9999,0
1714639185135,CLRE 297,001,507242,Cuomo; Raphael Eduardo,9999,0,9999,0
1714639186168,COGS 197,001,638244,Voytek; Bradley Thomas,9998,0,9999,1
1714639187199,CSE 191,A00,516875,Minnes Kemp; Mor Mia,9992,0,9999,7
1714639188224,CSE 197,001,637388,Minnes Kemp; Mor Mia,9998,0,9999,1
1714639189250,CSS 201S,A01,494383,Staff,35,0,35,0
1714639190276,CSS 202S,A01,494387,Staff,35,0,35,0
1714639191308,DSC 197,001,628532,Eldridge; Justin Matthew,9996,0,9999,3
1714639192333,EAP 100,A00,516065,Staff,9797,0,9999,202
1714639193364,ECE 45,A01,507414,Staff,33,0,60,27
1714639195419,ECE 111,A01,507420,Staff,15,0,50,35
1714639196450,ECE 197,001,548057,Sievenpiper; Daniel F.,9993,0,9999,6
1714639197481,EDS 115,A00,507243,Choi; Bailey Miyeon,10,0,28,18
1714639198511,EDS 117,A01,494379,Staff,0,4,30,30
1714639199542,EDS 125,A00,507246,Hopkins; Megan Beth,9,0,30,21
1714639200567,EDS 128A,A01,507264,Fargason; Sharon Gayle,8,0,26,18
1714639201598,EDS 128B,A01,507293,Pappas; Elizabeth,12,0,30,18
1714639202624,EDS 139,A00,507294,Fargason; Sharon Gayle,13,0,30,17
1714639202624,EDS 139,B00,507313,Pappas; Elizabeth,13,0,30,17
1714639203650,EDS 201,A00,507315,Staff,13,0,30,17
1714639204678,EDS 203,A01,507317,Halter; Christopher P.,12,0,30,18
1714639205710,EDS 204R,A01,507319,Halter; Christopher P.,0,3,30,30
1714639205710,EDS 204R,B01,507331,Heinzman; Erica M.,16,0,30,14
1714639206736,EDS 206R,A00,507332,Staff,0,4,30,30
1714639206736,EDS 206R,B00,507343,Staff,17,0,30,13
1714639207766,EDS 250,A00,507344,Hemans; Patricia Ann Benitez,22,0,40,18
1714639208798,EDS 281,A00,507345,Daly; Alan J.,18,0,18,0
1714639209826,EDS 284,A00,507350,Daly; Alan J.,16,0,16,0
1714639210856,EDS 286,A00,507359,Fine; Sarah,18,0,18,0
1714639211885,EDS 289C,A01,507361,Daly; Alan J.,18,0,18,0
1714639212910,EDS 290,A00,507366,Hofstetter; Carolyn,15,0,15,0
1714639213940,LIGM 5A,A00,507421,Fischer-Grunski; Eva K,18,0,20,2
1714639214966,LIGM 5B,A00,507423,Fischer-Grunski; Eva K,19,0,20,1
1714639215991,LIGM 5C,A00,507425,Fischer-Grunski; Eva K,19,0,20,1
1714639217022,LIIT 5AS,A00,507427,Carnelos; Chiara,20,0,20,0
1714639218051,LIIT 5BS,A00,507430,Carnelos; Chiara,20,0,20,0
1714639219081,LIIT 5CS,A00,507432,Carnelos; Chiara,20,0,20,0
1714639220109,LISP 5A,A00,507541,Munoz Sanchez; Alicia,11,0,20,9
1714639221134,LISP 5B,A00,507671,Munoz Sanchez; Alicia,8,0,20,12
1714639222160,LISP 5C,A00,507696,Munoz Sanchez; Alicia,9,0,20,11
1714639223185,MAE 197,001,528363,Boechler; Nicholas Sebastia,9998,0,9999,1
1714639224211,MATH 197,001,523477,Kedlaya; Kiran S.,9995,0,9999,4
1714639224211,MATH 197,002,563811,Zhang; Danna,9995,0,9999,4
1714639224211,MATH 197,003,628552,Dumitriu; Ioana,9998,0,9999,1
1714639225241,MCWP 40R,A00,518780,Staff,2,0,20,18
1714639225241,MCWP 40R,B00,518781,Staff,8,0,20,12
1714639225241,MCWP 40R,C00,518783,Staff,6,0,20,14
1714639226272,MCWP 50R,A00,518791,Staff,0,0,20,20
1714639226272,MCWP 50R,B00,518792,Staff,0,2,20,20
1714639226272,MCWP 50R,C00,518793,Staff,0,2,20,20
1714639226272,MCWP 50R,D00,518794,Staff,0,1,20,20
1714639226272,MCWP 50R,E00,518795,Staff,0,2,20,20
1714639226272,MCWP 50R,F00,518796,Staff,0,0,20,20
1714639226272,MCWP 50R,G00,518797,Staff,0,1,20,20
1714639227299,MMW 12R,A01,514034,Herbst; Matthew,0,0,16,16
1714639227299,MMW 12R,A02,514035,Herbst; Matthew,1,0,16,15
1714639228324,MMW 13R,A01,514037,Staff,0,4,16,16
1714639228324,MMW 13R,A02,514039,Staff,0,2,16,16
1714639228324,MMW 13R,A03,628519,Staff,0,2,16,16
1714639230382,SIO 295LS,A00,523233,Staff,10,0,30,20
1714639231407,SIO 295S,A00,523232,Staff,10,0,30,20
1714639232434,SIOC 290S,A01,637330,Merrifield; Mark A,23,0,30,7
1714639233468,SIOC 291S,A01,637333,Gabriel; Corey John,23,0,30,7
1714639234498,SOCI 117,A01,494376,Staff,0,4,5,5
1714639235527,WES 237B,A00,494380,Staff,9,0,20,11
1714639237613,AESE 279B,A00,494370,Wade; Jon P,0,0,33,33
1714639238640,AIP 197,001,627712,Vespa; Emanuel Ignacio,9998,0,9999,1
1714639239665,ANAR 135S,A00,494369,Braswell; Geoffrey E.,0,0,0,0
1714639240690,BENG 196,001,628496,Engler; Adam J.,9998,0,9999,1
1714639241716,CAT 124RS,A01,519847,Geibel; William,0,0,20,20
1714639242739,CAT 125RS,A01,515971,Geibel; William,0,0,20,20
1714639243767,CLRE 250,A00,511389,Morris; Sheldon,9993,0,9999,6
1714639244792,CLRE 251,A00,507176,Mehta; Ravindra L.,9993,0,9999,6
1714639244792,CLRE 251,B00,511410,Mehta; Ravindra L.,9998,0,9999,1
1714639245817,CLRE 252,A00,507189,Cuomo; Raphael Eduardo,9995,0,9999,4
1714639246843,CLRE 253,A00,507199,Vaida; Florin,9994,0,9999,5
1714639246843,CLRE 253,B00,507202,Vaida; Florin,9999,0,9999,0
1714639247869,CLRE 259,A00,507211,Patel; Hemal,9996,0,9999,3
1714639248899,CLRE 260,A00,507221,Cuomo; Raphael Eduardo,9999,0,9999,0
1714639249924,CLRE 297,001,507242,Cuomo; Raphael Eduardo,9999,0,9999,0
1714639250952,COGS 197,001,638244,Voytek; Bradley Thomas,9998,0,9999,1
1714639251981,CSE 191,A00,516875,Minnes Kemp; Mor Mia,9992,0,9999,7
1714639253013,CSE 197,001,637388,Minnes Kemp; Mor Mia,9998,0,9999,1
1714639254040,CSS 201S,A01,494383,Staff,35,0,35,0
1714639255067,CSS 202S,A01,494387,Staff,35,0,35,0
1714639256096,DSC 197,001,628532,Eldridge; Justin Matthew,9996,0,9999,3
1714639257122,EAP 100,A00,516065,Staff,9797,0,9999,202
1714639258151,ECE 45,A01,507414,Staff,33,0,60,27
1714639260243,ECE 111,A01,507420,Staff,15,0,50,35
1714639261270,ECE 197,001,548057,Sievenpiper; Daniel F.,9993,0,9999,6
1714639262302,EDS 115,A00,507243,Choi; Bailey Miyeon,10,0,28,18
1714639263343,EDS 117,A01,494379,Staff,0,4,30,30
1714639264368,EDS 125,A00,507246,Hopkins; Megan Beth,9,0,30,21
1714639265396,EDS 128A,A01,507264,Fargason; Sharon Gayle,8,0,26,18
1714639266430,EDS 128B,A01,507293,Pappas; Elizabeth,12,0,30,18
1714639267457,EDS 139,A00,507294,Fargason; Sharon Gayle,13,0,30,17
1714639267457,EDS 139,B00,507313,Pappas; Elizabeth,13,0,30,17
1714639268484,EDS 201,A00,507315,Staff,13,0,30,17
1714639269512,EDS 203,A01,507317,Halter; Christopher P.,12,0,30,18
1714639270543,EDS 204R,A01,507319,Halter; Christopher P.,0,3,30,30
1714639270543,EDS 204R,B01,507331,Heinzman; Erica M.,16,0,30,14
1714639271579,EDS 206R,A00,507332,Staff,0,4,30,30
1714639271579,EDS 206R,B00,507343,Staff,17,0,30,13
1714639272611,EDS 250,A00,507344,Hemans; Patricia Ann Benitez,22,0,40,18
1714639273637,EDS 281,A00,507345,Daly; Alan J.,18,0,18,0
1714639274676,EDS 284,A00,507350,Daly; Alan J.,16,0,16,0
1714639275707,EDS 286,A00,507359,Fine; Sarah,18,0,18,0
1714639276733,EDS 289C,A01,507361,Daly; Alan J.,18,0,18,0
1714639277759,EDS 290,A00,507366,Hofstetter; Carolyn,15,0,15,0
1714639278786,LIGM 5A,A00,507421,Fischer-Grunski; Eva K,18,0,20,2
1714639279818,LIGM 5B,A00,507423,Fischer-Grunski; Eva K,19,0,20,1
1714639280844,LIGM 5C,A00,507425,Fischer-Grunski; Eva K,19,0,20,1
1714639281869,LIIT 5AS,A00,507427,Carnelos; Chiara,20,0,20,0
1714639282895,LIIT 5BS,A00,507430,Carnelos; Chiara,20,0,20,0
1714639283920,LIIT 5CS,A00,507432,Carnelos; Chiara,20,0,20,0
1714639284945,LISP 5A,A00,507541,Munoz Sanchez; Alicia,11,0,20,9
1714639285972,LISP 5B,A00,507671,Munoz Sanchez; Alicia,8,0,20,12
1714639286996,LISP 5C,A00,507696,Munoz Sanchez; Alicia,9,0,20,11
1714639288025,MAE 197,001,528363,Boechler; Nicholas Sebastia,9998,0,9999,1
1714639289055,MATH 197,001,523477,Kedlaya; Kiran S.,9995,0,9999,4
1714639289055,MATH 197,002,563811,Zhang; Danna,9995,0,9999,4
1714639289055,MATH 197,003,628552,Dumitriu; Ioana,9998,0,9999,1
1714639290084,MCWP 40R,A00,518780,Staff,2,0,20,18
1714639290084,MCWP 40R,B00,518781,Staff,8,0,20,12
1714639290084,MCWP 40R,C00,518783,Staff,6,0,20,14
1714639291110,MCWP 50R,A00,518791,Staff,0,0,20,20
1714639291110,MCWP 50R,B00,518792,Staff,0,2,20,20
1714639291110,MCWP 50R,C00,518793,Staff,0,2,20,20
1714639291110,MCWP 50R,D00,518794,Staff,0,1,20,20
1714639291110,MCWP 50R,E00,518795,Staff,0,2,20,20
1714639291110,MCWP 50R,F00,518796,Staff,0,0,20,20
1714639291110,MCWP 50R,G00,518797,Staff,0,1,20,20
1714639292137,MMW 12R,A01,514034,Herbst; Matthew,0,0,16,16
1714639292137,MMW 12R,A02,514035,Herbst; Matthew,1,0,16,15
1714639293165,MMW 13R,A01,514037,Staff,0,4,16,16
1714639293165,MMW 13R,A02,514039,Staff,0,2,16,16
1714639293165,MMW 13R,A03,628519,Staff,0,2,16,16
1714639295218,SIO 295LS,A00,523233,Staff,10,0,30,20
1714639296246,SIO 295S,A00,523232,Staff,10,0,30,20
1714639297273,SIOC 290S,A01,637330,Merrifield; Mark A,23,0,30,7
1714639298299,SIOC 291S,A01,637333,Gabriel; Corey John,23,0,30,7
1714639299329,SOCI 117,A01,494376,Staff,0,4,5,5
1714639300354,WES 237B,A00,494380,Staff,9,0,20,11
1714639302423,AESE 279B,A00,494370,Wade; Jon P,0,0,33,33
1714639303447,AIP 197,001,627712,Vespa; Emanuel Ignacio,9998,0,9999,1
1714639304476,ANAR 135S,A00,494369,Braswell; Geoffrey E.,0,0,0,0
1714639305500,BENG 196,001,628496,Engler; Adam J.,9998,0,9999,1
1714639306532,CAT 124RS,A01,519847,Geibel; William,0,0,20,20
1714639307560,CAT 125RS,A01,515971,Geibel; William,0,0,20,20
1714639308588,CLRE 250,A00,511389,Morris; Sheldon,9993,0,9999,6
1714639309620,CLRE 251,A00,507176,Mehta; Ravindra L.,9993,0,9999,6
1714639309620,CLRE 251,B00,511410,Mehta; Ravindra L.,9998,0,9999,1
1714639310650,CLRE 252,A00,507189,Cuomo; Raphael Eduardo,9995,0,9999,4
1714639311674,CLRE 253,A00,507199,Vaida; Florin,9994,0,9999,5
1714639311674,CLRE 253,B00,507202,Vaida; Florin,9999,0,9999,0
1714639312702,CLRE 259,A00,507211,Patel; Hemal,9996,0,9999,3
1714639313731,CLRE 260,A00,507221,Cuomo; Raphael Eduardo,9999,0,9999,0
1714639314759,CLRE 297,001,507242,Cuomo; Raphael Eduardo,9999,0,9999,0
1714639315788,COGS 197,001,638244,Voytek; Bradley Thomas,9998,0,9999,1
1714639316813,CSE 191,A00,516875,Minnes Kemp; Mor Mia,9992,0,9999,7
1714639317841,CSE 197,001,637388,Minnes Kemp; Mor Mia,9998,0,9999,1
1714639318867,CSS 201S,A01,494383,Staff,35,0,35,0
1714639319897,CSS 202S,A01,494387,Staff,35,0,35,0
1714639320925,DSC 197,001,628532,Eldridge; Justin Matthew,9996,0,9999,3
1714639321951,EAP 100,A00,516065,Staff,9797,0,9999,202
1714639322976,ECE 45,A01,507414,Staff,33,0,60,27
1714639325030,ECE 111,A01,507420,Staff,15,0,50,35
1714639326058,ECE 197,001,548057,Sievenpiper; Daniel F.,9993,0,9999,6
1714639327085,EDS 115,A00,507243,Choi; Bailey Miyeon,10,0,28,18
1714639328111,EDS 117,A01,494379,Staff,0,4,30,30
1714639329143,EDS 125,A00,507246,Hopkins; Megan Beth,9,0,30,21
1714639330167,EDS 128A,A01,507264,Fargason; Sharon Gayle,8,0,26,18
1714639331193,EDS 128B,A01,507293,Pappas; Elizabeth,12,0,30,18
1714639332220,EDS 139,A00,507294,Fargason; Sharon Gayle,13,0,30,17
1714639332220,EDS 139,B00,507313,Pappas; Elizabeth,13,0,30,17
1714639333246,EDS 201,A00,507315,Staff,13,0,30,17
1714639334270,EDS 203,A01,507317,Halter; Christopher P.,12,0,30,18
1714639335300,EDS 204R,A01,507319,Halter; Christopher P.,0,3,30,30
1714639335300,EDS 204R,B01,507331,Heinzman; Erica M.,16,0,30,14
1714639336329,EDS 206R,A00,507332,Staff,0,4,30,30
1714639336329,EDS 206R,B00,507343,Staff,17,0,30,13
1714639337359,EDS 250,A00,507344,Hemans; Patricia Ann Benitez,22,0,40,18
1714639338408,EDS 281,A00,507345,Daly; Alan J.,18,0,18,0
1714639339432,EDS 284,A00,507350,Daly; Alan J.,16,0,16,0
1714639340461,EDS 286,A00,507359,Fine; Sarah,18,0,18,0
1714639341492,EDS 289C,A01,507361,Daly; Alan J.,18,0,18,0
1714639342521,EDS 290,A00,507366,Hofstetter; Carolyn,15,0,15,0
1714639343552,LIGM 5A,A00,507421,Fischer-Grunski; Eva K,18,0,20,2
1714639344577,LIGM 5B,A00,507423,Fischer-Grunski; Eva K,19,0,20,1
1714639345602,LIGM 5C,A00,507425,Fischer-Grunski; Eva K,19,0,20,1
1714639346628,LIIT 5AS,A00,507427,Carnelos; Chiara,20,0,20,0
1714639347657,LIIT 5BS,A00,507430,Carnelos; Chiara,20,0,20,0
1714639348685,LIIT 5CS,A00,507432,Carnelos; Chiara,20,0,20,0
1714639349710,LISP 5A,A00,507541,Munoz Sanchez; Alicia,11,0,20,9
1714639350737,LISP 5B,A00,507671,Munoz Sanchez; Alicia,8,0,20,12
1714639351766,LISP 5C,A00,507696,Munoz Sanchez; Alicia,9,0,20,11
1714639352792,MAE 197,001,528363,Boechler; Nicholas Sebastia,9998,0,9999,1
1714639353820,MATH 197,001,523477,Kedlaya; Kiran S.,9995,0,9999,4
1714639353820,MATH 197,002,563811,Zhang; Danna,9995,0,9999,4
1714639353820,MATH 197,003,628552,Dumitriu; Ioana,9998,0,9999,1
1714639354846,MCWP 40R,A00,518780,Staff,2,0,20,18
1714639354846,MCWP 40R,B00,518781,Staff,8,0,20,12
1714639354846,MCWP 40R,C00,518783,Staff,6,0,20,14
1714639355872,MCWP 50R,A00,518791,Staff,0,0,20,20
1714639355872,MCWP 50R,B00,518792,Staff,0,2,20,20
1714639355872,MCWP 50R,C00,518793,Staff,0,2,20,20
1714639355872,MCWP 50R,D00,518794,Staff,0,1,20,20
1714639355872,MCWP 50R,E00,518795,Staff,0,2,20,20
1714639355872,MCWP 50R,F00,518796,Staff,0,0,20,20
1714639355872,MCWP 50R,G00,518797,Staff,0,1,20,20
1714639356897,MMW 12R,A01,514034,Herbst; Matthew,0,0,16,16
1714639356897,MMW 12R,A02,514035,Herbst; Matthew,1,0,16,15
1714639357922,MMW 13R,A01,514037,Staff,0,4,16,16
1714639357922,MMW 13R,A02,514039,Staff,0,2,16,16
1714639357922,MMW 13R,A03,628519,Staff,0,2,16,16
1714639359976,SIO 295LS,A00,523233,Staff,10,0,30,20
1714639361005,SIO 295S,A00,523232,Staff,10,0,30,20
1714639362033,SIOC 290S,A01,637330,Merrifield; Mark A,23,0,30,7
1714639363058,SIOC 291S,A01,637333,Gabriel; Corey John,23,0,30,7
1714639364084,SOCI 117,A01,494376,Staff,0,4,5,5
1714639365111,WES 237B,A00,494380,Staff,9,0,20,11
1714639367193,AESE 279B,A00,494370,Wade; Jon P,0,0,33,33
1714639368219,AIP 197,001,627712,Vespa; Emanuel Ignacio,9998,0,9999,1
1714639369252,ANAR 135S,A00,494369,Braswell; Geoffrey E.,0,0,0,0
1714639370277,BENG 196,001,628496,Engler; Adam J.,9998,0,9999,1
1714639371305,CAT 124RS,A01,519847,Geibel; William,0,0,20,20
1714639372331,CAT 125RS,A01,515971,Geibel; William,0,0,20,20
1714639373357,CLRE 250,A00,511389,Morris; Sheldon,9993,0,9999,6
1714639374391,CLRE 251,A00,507176,Mehta; Ravindra L.,9993,0,9999,6
1714639374391,CLRE 251,B00,511410,Mehta; Ravindra L.,9998,0,9999,1
1714639375420,CLRE 252,A00,507189,Cuomo; Raphael Eduardo,9995,0,9999,4
1714639376448,CLRE 253,A00,507199,Vaida; Florin,9994,0,9999,5
1714639376448,CLRE 253,B00,507202,Vaida; Florin,9999,0,9999,0
1714639377474,CLRE 259,A00,507211,Patel; Hemal,9996,0,9999,3
1714639378501,CLRE 260,A00,507221,Cuomo; Raphael Eduardo,9999,0,9999,0
1714639379532,CLRE 297,001,507242,Cuomo; Raphael Eduardo,9999,0,9999,0
1714639380558,COGS 197,001,638244,Voytek; Bradley Thomas,9998,0,9999,1
1714639381588,CSE 191,A00,516875,Minnes Kemp; Mor Mia,9992,0,9999,7
1714639382612,CSE 197,001,637388,Minnes Kemp; Mor Mia,9998,0,9999,1
1714639383644,CSS 201S,A01,494383,Staff,35,0,35,0
1714639384675,CSS 202S,A01,494387,Staff,35,0,35,0
1714639385701,DSC 197,001,628532,Eldridge; Justin Matthew,9996,0,9999,3
1714639386735,EAP 100,A00,516065,Staff,9797,0,9999,202
1714639387765,ECE 45,A01,507414,Staff,33,0,60,27
1714639389818,ECE 111,A01,507420,Staff,15,0,50,35
1714639390849,ECE 197,001,548057,Sievenpiper; Daniel F.,9993,0,9999,6
1714639391881,EDS 115,A00,507243,Choi; Bailey Miyeon,10,0,28,18
1714639392907,EDS 117,A01,494379,Staff,0,4,30,30
1714639393937,EDS 125,A00,507246,Hopkins; Megan Beth,9,0,30,21
1714639394964,EDS 128A,A01,507264,Fargason; Sharon Gayle,8,0,26,18
1714639395991,EDS 128B,A01,507293,Pappas; Elizabeth,12,0,30,18
1714639397018,EDS 139,A00,507294,Fargason; Sharon Gayle,13,0,30,17
1714639397018,EDS 139,B00,507313,Pappas; Elizabeth,13,0,30,17
1714639398045,EDS 201,A00,507315,Staff,13,0,30,17
1714639399076,EDS 203,A01,507317,Halter; Christopher P.,12,0,30,18
1714639400105,EDS 204R,A01,507319,Halter; Christopher P.,0,3,30,30
1714639400105,EDS 204R,B01,507331,Heinzman; Erica M.,16,0,30,14
1714639401131,EDS 206R,A00,507332,Staff,0,4,30,30
1714639401131,EDS 206R,B00,507343,Staff,17,0,30,13
1714639402163,EDS 250,A00,507344,Hemans; Patricia Ann Benitez,22,0,40,18
1714639403192,EDS 281,A00,507345,Daly; Alan J.,18,0,18,0
1714639404219,EDS 284,A00,507350,Daly; Alan J.,16,0,16,0
1714639405245,EDS 286,A00,507359,Fine; Sarah,18,0,18,0
1714639406276,EDS 289C,A01,507361,Daly; Alan J.,18,0,18,0
1714639407302,EDS 290,A00,507366,Hofstetter; Carolyn,15,0,15,0
1714639408328,LIGM 5A,A00,507421,Fischer-Grunski; Eva K,18,0,20,2
1714639409355,LIGM 5B,A00,507423,Fischer-Grunski; Eva K,19,0,20,1
1714639410385,LIGM 5C,A00,507425,Fischer-Grunski; Eva K,19,0,20,1
1714639411412,LIIT 5AS,A00,507427,Carnelos; Chiara,20,0,20,0
1714639412490,LIIT 5BS,A00,507430,Carnelos; Chiara,20,0,20,0
1714639413520,LIIT 5CS,A00,507432,Carnelos; Chiara,20,0,20,0
1714639414546,LISP 5A,A00,507541,Munoz Sanchez; Alicia,11,0,20,9
1714639415570,LISP 5B,A00,507671,Munoz Sanchez; Alicia,8,0,20,12
1714639416600,LISP 5C,A00,507696,Munoz Sanchez; Alicia,9,0,20,11
1714639417629,MAE 197,001,528363,Boechler; Nicholas Sebastia,9998,0,9999,1
1714639418655,MATH 197,001,523477,Kedlaya; Kiran S.,9995,0,9999,4
1714639418655,MATH 197,002,563811,Zhang; Danna,9995,0,9999,4
1714639418655,MATH 197,003,628552,Dumitriu; Ioana,9998,0,9999,1
1714639419682,MCWP 40R,A00,518780,Staff,2,0,20,18
1714639419682,MCWP 40R,B00,518781,Staff,8,0,20,12
1714639419682,MCWP 40R,C00,518783,Staff,6,0,20,14
1714639420706,MCWP 50R,A00,518791,Staff,0,0,20,20
1714639420706,MCWP 50R,B00,518792,Staff,0,2,20,20
1714639420706,MCWP 50R,C00,518793,Staff,0,2,20,20
1714639420706,MCWP 50R,D00,518794,Staff,0,1,20,20
1714639420706,MCWP 50R,E00,518795,Staff,0,2,20,20
1714639420706,MCWP 50R,F00,518796,Staff,0,0,20,20
1714639420706,MCWP 50R,G00,518797,Staff,0,1,20,20
1714639421733,MMW 12R,A01,514034,Herbst; Matthew,0,0,16,16
1714639421733,MMW 12R,A02,514035,Herbst; Matthew,1,0,16,15
1714639422760,MMW 13R,A01,514037,Staff,0,4,16,16
1714639422760,MMW 13R,A02,514039,Staff,0,2,16,16
1714639422760,MMW 13R,A03,628519,Staff,0,2,16,16
1714639424813,SIO 295LS,A00,523233,Staff,10,0,30,20
1714639425840,SIO 295S,A00,523232,Staff,10,0,30,20
1714639426871,SIOC 290S,A01,637330,Merrifield; Mark A,23,0,30,7
1714639427902,SIOC 291S,A01,637333,Gabriel; Corey John,23,0,30,7
1714639428928,SOCI 117,A01,494376,Staff,0,4,5,5
1714639429954,WES 237B,A00,494380,Staff,9,0,20,11
1714639432026,AESE 279B,A00,494370,Wade; Jon P,0,0,33,33
1714639433052,AIP 197,001,627712,Vespa; Emanuel Ignacio,9998,0,9999,1
1714639434080,ANAR 135S,A00,494369,Braswell; Geoffrey E.,0,0,0,0
1714639435106,BENG 196,001,628496,Engler; Adam J.,9998,0,9999,1
1714639436132,CAT 124RS,A01,519847,Geibel; William,0,0,20,20
1714639437158,CAT 125RS,A01,515971,Geibel; William,0,0,20,20
1714639438188,CLRE 250,A00,511389,Morris; Sheldon,9993,0,9999,6
1714639439216,CLRE 251,A00,507176,Mehta; Ravindra L.,9993,0,9999,6
1714639439216,CLRE 251,B00,511410,Mehta; Ravindra L.,9998,0,9999,1
1714639440247,CLRE 252,A00,507189,Cuomo; Raphael Eduardo,9995,0,9999,4
1714639441277,CLRE 253,A00,507199,Vaida; Florin,9994,0,9999,5
1714639441277,CLRE 253,B00,507202,Vaida; Florin,9999,0,9999,0
1714639442302,CLRE 259,A00,507211,Patel; Hemal,9996,0,9999,3
1714639443327,CLRE 260,A00,507221,Cuomo; Raphael Eduardo,9999,0,9999,0
1714639444353,CLRE 297,001,507242,Cuomo; Raphael Eduardo,9999,0,9999,0
1714639445384,COGS 197,001,638244,Voytek; Bradley Thomas,9998,0,9999,1
1714639446412,CSE 191,A00,516875,Minnes Kemp; Mor Mia,9992,0,9999,7
1714639447439,CSE 197,001,637388,Minnes Kemp; Mor Mia,9998,0,9999,1
1714639448469,CSS 201S,A01,494383,Staff,35,0,35,0
1714639449498,CSS 202S,A01,494387,Staff,35,0,35,0
1714639450553,DSC 197,001,628532,Eldridge; Justin Matthew,9996,0,9999,3
1714639451577,EAP 100,A00,516065,Staff,9797,0,9999,202
1714639452608,ECE 45,A01,507414,Staff,33,0,60,27
1714639454664,ECE 111,A01,507420,Staff,15,0,50,35
1714639455690,ECE 197,001,548057,Sievenpiper; Daniel F.,9993,0,9999,6
1714639456720,EDS 115,A00,507243,Choi; Bailey Miyeon,10,0,28,18
1714639457749,EDS 117,A01,494379,Staff,0,4,30,30
1714639458779,EDS 125,A00,507246,Hopkins; Megan Beth,9,0,30,21
1714639459806,EDS 128A,A01,507264,Fargason; Sharon Gayle,8,0,26,18
1714639460835,EDS 128B,A01,507293,Pappas; Elizabeth,12,0,30,18
1714639461864,EDS 139,A00,507294,Fargason; Sharon Gayle,13,0,30,17
1714639461864,EDS 139,B00,507313,Pappas; Elizabeth,13,0,30,17
1714639462898,EDS 201,A00,507315,Staff,13,0,30,17
1714639463924,EDS 203,A01,507317,Halter; Christopher P.,12,0,30,18
1714639464954,EDS 204R,A01,507319,Halter; Christopher P.,0,3,30,30
1714639464954,EDS 204R,B01,507331,Heinzman; Erica M.,16,0,30,14
1714639465979,EDS 206R,A00,507332,Staff,0,4,30,30
1714639465979,EDS 206R,B00,507343,Staff,17,0,30,13
1714639467004,EDS 250,A00,507344,Hemans; Patricia Ann Benitez,22,0,40,18
1714639468031,EDS 281,A00,507345,Daly; Alan J.,18,0,18,0
1714639469056,EDS 284,A00,507350,Daly; Alan J.,16,0,16,0
1714639470080,EDS 286,A00,507359,Fine; Sarah,18,0,18,0
1714639471106,EDS 289C,A01,507361,Daly; Alan J.,18,0,18,0
1714639472190,EDS 290,A00,507366,Hofstetter; Carolyn,15,0,15,0
1714639473230,LIGM 5A,A00,507421,Fischer-Grunski; Eva K,18,0,20,2
1714639474259,LIGM 5B,A00,507423,Fischer-Grunski; Eva K,19,0,20,1
1714639475291,LIGM 5C,A00,507425,Fischer-Grunski; Eva K,19,0,20,1
1714639476321,LIIT 5AS,A00,507427,Carnelos; Chiara,20,0,20,0
1714639477346,LIIT 5BS,A00,507430,Carnelos; Chiara,20,0,20,0
1714639478376,LIIT 5CS,A00,507432,Carnelos; Chiara,20,0,20,0
1714639479406,LISP 5A,A00,507541,Munoz Sanchez; Alicia,11,0,20,9
1714639480436,LISP 5B,A00,507671,Munoz Sanchez; Alicia,8,0,20,12
1714639481462,LISP 5C,A00,507696,Munoz Sanchez; Alicia,9,0,20,11
1714639482492,MAE 197,001,528363,Boechler; Nicholas Sebastia,9998,0,9999,1
1714639483527,MATH 197,001,523477,Kedlaya; Kiran S.,9995,0,9999,4
1714639483527,MATH 197,002,563811,Zhang; Danna,9995,0,9999,4
1714639483527,MATH 197,003,628552,Dumitriu; Ioana,9998,0,9999,1
1714639484554,MCWP 40R,A00,518780,Staff,2,0,20,18
1714639484554,MCWP 40R,B00,518781,Staff,8,0,20,12
1714639484554,MCWP 40R,C00,518783,Staff,6,0,20,14
1714639485588,MCWP 50R,A00,518791,Staff,0,0,20,20
1714639485588,MCWP 50R,B00,518792,Staff,0,2,20,20
1714639485588,MCWP 50R,C00,518793,Staff,0,2,20,20
1714639485588,MCWP 50R,D00,518794,Staff,0,1,20,20
1714639485588,MCWP 50R,E00,518795,Staff,0,2,20,20
1714639485588,MCWP 50R,F00,518796,Staff,0,0,20,20
1714639485588,MCWP 50R,G00,518797,Staff,0,1,20,20
1714639486614,MMW 12R,A01,514034,Herbst; Matthew,0,0,16,16
1714639486614,MMW 12R,A02,514035,Herbst; Matthew,1,0,16,15
1714639487638,MMW 13R,A01,514037,Staff,0,4,16,16
1714639487638,MMW 13R,A02,514039,Staff,0,2,16,16
1714639487638,MMW 13R,A03,628519,Staff,0,2,16,16
1714639489697,SIO 295LS,A00,523233,Staff,10,0,30,20
1714639490723,SIO 295S,A00,523232,Staff,10,0,30,20
1714639491750,SIOC 290S,A01,637330,Merrifield; Mark A,23,0,30,7
1714639492776,SIOC 291S,A01,637333,Gabriel; Corey John,23,0,30,7
1714639493802,SOCI 117,A01,494376,Staff,0,4,5,5
1714639494829,WES 237B,A00,494380,Staff,9,0,20,11
1714639496899,AESE 279B,A00,494370,Wade; Jon P,0,0,33,33
1714639497925,AIP 197,001,627712,Vespa; Emanuel Ignacio,9998,0,9999,1
1714639498950,ANAR 135S,A00,494369,Braswell; Geoffrey E.,0,0,0,0
1714639499976,BENG 196,001,628496,Engler; Adam J.,9998,0,9999,1
1714639501003,CAT 124RS,A01,519847,Geibel; William,0,0,20,20
1714639502034,CAT 125RS,A01,515971,Geibel; William,0,0,20,20
1714639503065,CLRE 250,A00,511389,Morris; Sheldon,9993,0,9999,6
1714639504093,CLRE 251,A00,507176,Mehta; Ravindra L.,9993,0,9999,6
1714639504093,CLRE 251,B00,511410,Mehta; Ravindra L.,9998,0,9999,1
1714639505118,CLRE 252,A00,507189,Cuomo; Raphael Eduardo,9995,0,9999,4
1714639506145,CLRE 253,A00,507199,Vaida; Florin,9994,0,9999,5
1714639506145,CLRE 253,B00,507202,Vaida; Florin,9999,0,9999,0
1714639507174,CLRE 259,A00,507211,Patel; Hemal,9996,0,9999,3
1714639508202,CLRE 260,A00,507221,Cuomo; Raphael Eduardo,9999,0,9999,0
1714639509228,CLRE 297,001,507242,Cuomo; Raphael Eduardo,9999,0,9999,0
1714639510258,COGS 197,001,638244,Voytek; Bradley Thomas,9998,0,9999,1
1714639511285,CSE 191,A00,516875,Minnes Kemp; Mor Mia,9992,0,9999,7
1714639512309,CSE 197,001,637388,Minnes Kemp; Mor Mia,9998,0,9999,1
1714639513340,CSS 201S,A01,494383,Staff,35,0,35,0
1714639514365,CSS 202S,A01,494387,Staff,35,0,35,0
1714639515392,DSC 197,001,628532,Eldridge; Justin Matthew,9996,0,9999,3
1714639516470,EAP 100,A00,516065,Staff,9797,0,9999,202
1714639517500,ECE 45,A01,507414,Staff,33,0,60,27
1714639519549,ECE 111,A01,507420,Staff,15,0,50,35
1714639520575,ECE 197,001,548057,Sievenpiper; Daniel F.,9993,0,9999,6
1714639521603,EDS 115,A00,507243,Choi; Bailey Miyeon,10,0,28,18
1714639522628,EDS 117,A01,494379,Staff,0,4,30,30
1714639523654,EDS 125,A00,507246,Hopkins; Megan Beth,9,0,30,21
1714639524678,EDS 128A,A01,507264,Fargason; Sharon Gayle,8,0,26,18
1714639525708,EDS 128B,A01,507293,Pappas; Elizabeth,12,0,30,18
1714639526731,EDS 139,A00,507294,Fargason; Sharon Gayle,13,0,30,17
1714639526731,EDS 139,B00,507313,Pappas; Elizabeth,13,0,30,17
1714639527757,EDS 201,A00,507315,Staff,13,0,30,17
1714639528784,EDS 203,A01,507317,Halter; Christopher P.,12,0,30,18
1714639529809,EDS 204R,A01,507319,Halter; Christopher P.,0,3,30,30
1714639529809,EDS 204R,B01,507331,Heinzman; Erica M.,16,0,30,14
1714639530837,EDS 206R,A00,507332,Staff,0,4,30,30
1714639530837,EDS 206R,B00,507343,Staff,17,0,30,13
1714639531866,EDS 250,A00,507344,Hemans; Patricia Ann Benitez,22,0,40,18
1714639532891,EDS 281,A00,507345,Daly; Alan J.,18,0,18,0
1714639533916,EDS 284,A00,507350,Daly; Alan J.,16,0,16,0
1714639534943,EDS 286,A00,507359,Fine; Sarah,18,0,18,0
1714639535971,EDS 289C,A01,507361,Daly; Alan J.,18,0,18,0
1714639536999,EDS 290,A00,507366,Hofstetter; Carolyn,15,0,15,0
1714639538025,LIGM 5A,A00,507421,Fischer-Grunski; Eva K,18,0,20,2
1714639539051,LIGM 5B,A00,507423,Fischer-Grunski; Eva K,19,0,20,1
1714639540081,LIGM 5C,A00,507425,Fischer-Grunski; Eva K,19,0,20,1
1714639541112,LIIT 5AS,A00,507427,Carnelos; Chiara,20,0,20,0
1714639542137,LIIT 5BS,A00,507430,Carnelos; Chiara,20,0,20,0
1714639543162,LIIT 5CS,A00,507432,Carnelos; Chiara,20,0,20,0
1714639544188,LISP 5A,A00,507541,Munoz Sanchez; Alicia,11,0,20,9
1714639545217,LISP 5B,A00,507671,Munoz Sanchez; Alicia,8,0,20,12
1714639546245,LISP 5C,A00,507696,Munoz Sanchez; Alicia,9,0,20,11
1714639547270,MAE 197,001,528363,Boechler; Nicholas Sebastia,9998,0,9999,1
1714639548300,MATH 197,001,523477,Kedlaya; Kiran S.,9995,0,9999,4
1714639548300,MATH 197,002,563811,Zhang; Danna,9995,0,9999,4
1714639548300,MATH 197,003,628552,Dumitriu; Ioana,9998,0,9999,1
1714639549330,MCWP 40R,A00,518780,Staff,2,0,20,18
1714639549330,MCWP 40R,B00,518781,Staff,8,0,20,12
1714639549330,MCWP 40R,C00,518783,Staff,6,0,20,14
1714639550354,MCWP 50R,A00,518791,Staff,0,0,20,20
1714639550354,MCWP 50R,B00,518792,Staff,0,2,20,20
1714639550354,MCWP 50R,C00,518793,Staff,0,2,20,20
1714639550354,MCWP 50R,D00,518794,Staff,0,1,20,20
1714639550354,MCWP 50R,E00,518795,Staff,0,2,20,20
1714639550354,MCWP 50R,F00,518796,Staff,0,0,20,20
1714639550354,MCWP 50R,G00,518797,Staff,0,1,20,20
1714639551382,MMW 12R,A01,514034,Herbst; Matthew,0,0,16,16
1714639551382,MMW 12R,A02,514035,Herbst; Matthew,1,0,16,15
1714639552408,MMW 13R,A01,514037,Staff,0,4,16,16
1714639552408,MMW 13R,A02,514039,Staff,0,2,16,16
1714639552408,MMW 13R,A03,628519,Staff,0,2,16,16
1714639554462,SIO 295LS,A00,523233,Staff,10,0,30,20
1714639555488,SIO 295S,A00,523232,Staff,10,0,30,20
1714639556517,SIOC 290S,A01,637330,Merrifield; Mark A,23,0,30,7
1714639557543,SIOC 291S,A01,637333,Gabriel; Corey John,23,0,30,7
1714639558569,SOCI 117,A01,494376,Staff,0,4,5,5
1714639559597,WES 237B,A00,494380,Staff,9,0,20,11
1714639561672,AESE 279B,A00,494370,Wade; Jon P,0,0,33,33
1714639562702,AIP 197,001,627712,Vespa; Emanuel Ignacio,9998,0,9999,1
1714639563733,ANAR 135S,A00,494369,Braswell; Geoffrey E.,0,0,0,0
1714639564762,BENG 196,001,628496,Engler; Adam J.,9998,0,9999,1
1714639565794,CAT 124RS,A01,519847,Geibel; William,0,0,20,20
1714639566820,CAT 125RS,A01,515971,Geibel; William,0,0,20,20
1714639567848,CLRE 250,A00,511389,Morris; Sheldon,9993,0,9999,6
1714639568882,CLRE 251,A00,507176,Mehta; Ravindra L.,9993,0,9999,6
1714639568882,CLRE 251,B00,511410,Mehta; Ravindra L.,9998,0,9999,1
1714639569907,CLRE 252,A00,507189,Cuomo; Raphael Eduardo,9995,0,9999,4
1714639570933,CLRE 253,A00,507199,Vaida; Florin,9994,0,9999,5
1714639570933,CLRE 253,B00,507202,Vaida; Florin,9999,0,9999,0
1714639571960,CLRE 259,A00,507211,Patel; Hemal,9996,0,9999,3
1714639572985,CLRE 260,A00,507221,Cuomo; Raphael Eduardo,9999,0,9999,0
1714639574010,CLRE 297,001,507242,Cuomo; Raphael Eduardo,9999,0,9999,0
1714639575036,COGS 197,001,638244,Voytek; Bradley Thomas,9998,0,9999,1
1714639576061,CSE 191,A00,516875,Minnes Kemp; Mor Mia,9992,0,9999,7
1714639577087,CSE 197,001,637388,Minnes Kemp; Mor Mia,9998,0,9999,1
1714639578114,CSS 201S,A01,494383,Staff,35,0,35,0
1714639579140,CSS 202S,A01,494387,Staff,35,0,35,0
1714639580165,DSC 197,001,628532,Eldridge; Justin Matthew,9996,0,9999,3
1714639581193,EAP 100,A00,516065,Staff,9797,0,9999,202
1714639582220,ECE 45,A01,507414,Staff,33,0,60,27
1714639584274,ECE 111,A01,507420,Staff,15,0,50,35
1714639585305,ECE 197,001,548057,Sievenpiper; Daniel F.,9993,0,9999,6
1714639586335,EDS 115,A00,507243,Choi; Bailey Miyeon,10,0,28,18
1714639587361,EDS 117,A01,494379,Staff,0,4,30,30
1714639588386,EDS 125,A00,507246,Hopkins; Megan Beth,9,0,30,21
1714639589415,EDS 128A,A01,507264,Fargason; Sharon Gayle,8,0,26,18
1714639590447,EDS 128B,A01,507293,Pappas; Elizabeth,12,0,30,18
1714639591472,EDS 139,A00,507294,Fargason; Sharon Gayle,13,0,30,17
1714639591472,EDS 139,B00,507313,Pappas; Elizabeth,13,0,30,17
1714639592496,EDS 201,A00,507315,Staff,13,0,30,17
1714639593523,EDS 203,A01,507317,Halter; Christopher P.,12,0,30,18
1714639594552,EDS 204R,A01,507319,Halter; Christopher P.,0,3,30,30
1714639594552,EDS 204R,B01,507331,Heinzman; Erica M.,16,0,30,14
1714639595576,EDS 206R,A00,507332,Staff,0,4,30,30
1714639595576,EDS 206R,B00,507343,Staff,17,0,30,13
1714639596603,EDS 250,A00,507344,Hemans; Patricia Ann Benitez,22,0,40,18
1714639597628,EDS 281,A00,507345,Daly; Alan J.,18,0,18,0
1714639598653,EDS 284,A00,507350,Daly; Alan J.,16,0,16,0
1714639599678,EDS 286,A00,507359,Fine; Sarah,18,0,18,0
1714639600706,EDS 289C,A01,507361,Daly; Alan J.,18,0,18,0
1714639601731,EDS 290,A00,507366,Hofstetter; Carolyn,15,0,15,0
1714639602763,LIGM 5A,A00,507421,Fischer-Grunski; Eva K,18,0,20,2
1714639603788,LIGM 5B,A00,507423,Fischer-Grunski; Eva K,19,0,20,1
1714639604813,LIGM 5C,A00,507425,Fischer-Grunski; Eva K,19,0,20,1
1714639605841,LIIT 5AS,A00,507427,Carnelos; Chiara,20,0,20,0
1714639606879,LIIT 5BS,A00,507430,Carnelos; Chiara,20,0,20,0
1714639607905,LIIT 5CS,A00,507432,Carnelos; Chiara,20,0,20,0
1714639608931,LISP 5A,A00,507541,Munoz Sanchez; Alicia,11,0,20,9
1714639609960,LISP 5B,A00,507671,Munoz Sanchez; Alicia,8,0,20,12
1714639610986,LISP 5C,A00,507696,Munoz Sanchez; Alicia,9,0,20,11
1714639612013,MAE 197,001,528363,Boechler; Nicholas Sebastia,9998,0,9999,1
1714639613041,MATH 197,001,523477,Kedlaya; Kiran S.,9995,0,9999,4
1714639613041,MATH 197,002,563811,Zhang; Danna,9995,0,9999,4
1714639613041,MATH 197,003,628552,Dumitriu; Ioana,9998,0,9999,1
1714639614070,MCWP 40R,A00,518780,Staff,2,0,20,18
1714639614070,MCWP 40R,B00,518781,Staff,8,0,20,12
1714639614070,MCWP 40R,C00,518783,Staff,6,0,20,14
1714639615096,MCWP 50R,A00,518791,Staff,0,0,20,20
1714639615096,MCWP 50R,B00,518792,Staff,0,2,20,20
1714639615096,MCWP 50R,C00,518793,Staff,0,2,20,20
1714639615096,MCWP 50R,D00,518794,Staff,0,1,20,20
1714639615096,MCWP 50R,E00,518795,Staff,0,2,20,20
1714639615096,MCWP 50R,F00,518796,Staff,0,0,20,20
1714639615096,MCWP 50R,G00,518797,Staff,0,1,20,20
1714639616122,MMW 12R,A01,514034,Herbst; Matthew,0,0,16,16
1714639616122,MMW 12R,A02,514035,Herbst; Matthew,1,0,16,15
1714639617149,MMW 13R,A01,514037,Staff,0,4,16,16
1714639617149,MMW 13R,A02,514039,Staff,0,2,16,16
1714639617149,MMW 13R,A03,628519,Staff,0,2,16,16
1714639619200,SIO 295LS,A00,523233,Staff,10,0,30,20
1714639620282,SIO 295S,A00,523232,Staff,10,0,30,20
1714639621307,SIOC 290S,A01,637330,Merrifield; Mark A,23,0,30,7
1714639622338,SIOC 291S,A01,637333,Gabriel; Corey John,23,0,30,7
1714639623370,SOCI 117,A01,494376,Staff,0,4,5,5
1714639624397,WES 237B,A00,494380,Staff,9,0,20,11
1714639626476,AESE 279B,A00,494370,Wade; Jon P,0,0,33,33
1714639627501,AIP 197,001,627712,Vespa; Emanuel Ignacio,9998,0,9999,1
1714639628526,ANAR 135S,A00,494369,Braswell; Geoffrey E.,0,0,0,0
1714639629553,BENG 196,001,628496,Engler; Adam J.,9998,0,9999,1
1714639630583,CAT 124RS,A01,519847,Geibel; William,0,0,20,20
1714639631609,CAT 125RS,A01,515971,Geibel; William,0,0,20,20
1714639632640,CLRE 250,A00,511389,Morris; Sheldon,9993,0,9999,6
1714639633672,CLRE 251,A00,507176,Mehta; Ravindra L.,9993,0,9999,6
1714639633672,CLRE 251,B00,511410,Mehta; Ravindra L.,9998,0,9999,1
1714639634698,CLRE 252,A00,507189,Cuomo; Raphael Eduardo,9995,0,9999,4
1714639635729,CLRE 253,A00,507199,Vaida; Florin,9994,0,9999,5
1714639635729,CLRE 253,B00,507202,Vaida; Florin,9999,0,9999,0
1714639636761,CLRE 259,A00,507211,Patel; Hemal,9996,0,9999,3
1714639637788,CLRE 260,A00,507221,Cuomo; Raphael Eduardo,9999,0,9999,0
1714639638814,CLRE 297,001,507242,Cuomo; Raphael Eduardo,9999,0,9999,0
1714639639844,COGS 197,001,638244,Voytek; Bradley Thomas,9998,0,9999,1
1714639640872,CSE 191,A00,516875,Minnes Kemp; Mor Mia,9992,0,9999,7
1714639641894,CSE 197,001,637388,Minnes Kemp; Mor Mia,9998,0,9999,1
1714639642922,CSS 201S,A01,494383,Staff,35,0,35,0
1714639643946,CSS 202S,A01,494387,Staff,35,0,35,0
1714639644972,DSC 197,001,628532,Eldridge; Justin Matthew,9996,0,9999,3
1714639645996,EAP 100,A00,516065,Staff,9797,0,9999,202
1714639647026,ECE 45,A01,507414,Staff,33,0,60,27
1714639649081,ECE 111,A01,507420,Staff,15,0,50,35
1714639650112,ECE 197,001,548057,Sievenpiper; Daniel F.,9993,0,9999,6
1714639651140,EDS 115,A00,507243,Choi; Bailey Miyeon,10,0,28,18
1714639652166,EDS 117,A01,494379,Staff,0,4,30,30
1714639653198,EDS 125,A00,507246,Hopkins; Megan Beth,9,0,30,21
1714639654231,EDS 128A,A01,507264,Fargason; Sharon Gayle,8,0,26,18
1714639655261,EDS 128B,A01,507293,Pappas; Elizabeth,12,0,30,18
1714639656288,EDS 139,A00,507294,Fargason; Sharon Gayle,13,0,30,17
1714639656288,EDS 139,B00,507313,Pappas; Elizabeth,13,0,30,17
1714639657312,EDS 201,A00,507315,Staff,13,0,30,17
1714639658339,EDS 203,A01,507317,Halter; Christopher P.,12,0,30,18
1714639659368,EDS 204R,A01,507319,Halter; Christopher P.,0,3,30,30
1714639659368,EDS 204R,B01,507331,Heinzman; Erica M.,16,0,30,14
1714639660393,EDS 206R,A00,507332,Staff,0,4,30,30
1714639660393,EDS 206R,B00,507343,Staff,17,0,30,13
1714639661418,EDS 250,A00,507344,Hemans; Patricia Ann Benitez,22,0,40,18
1714639662443,EDS 281,A00,507345,Daly; Alan J.,18,0,18,0
1714639663467,EDS 284,A00,507350,Daly; Alan J.,16,0,16,0
1714639664493,EDS 286,A00,507359,Fine; Sarah,18,0,18,0
1714639665518,EDS 289C,A01,507361,Daly; Alan J.,18,0,18,0
1714639666548,EDS 290,A00,507366,Hofstetter; Carolyn,15,0,15,0
1714639667574,LIGM 5A,A00,507421,Fischer-Grunski; Eva K,18,0,20,2
1714639668603,LIGM 5B,A00,507423,Fischer-Grunski; Eva K,19,0,20,1
1714639669632,LIGM 5C,A00,507425,Fischer-Grunski; Eva K,19,0,20,1
1714639670657,LIIT 5AS,A00,507427,Carnelos; Chiara,20,0,20,0
1714639671684,LIIT 5BS,A00,507430,Carnelos; Chiara,20,0,20,0
1714639672711,LIIT 5CS,A00,507432,Carnelos; Chiara,20,0,20,0
1714639673738,LISP 5A,A00,507541,Munoz Sanchez; Alicia,11,0,20,9
1714639674766,LISP 5B,A00,507671,Munoz Sanchez; Alicia,8,0,20,12
1714639675796,LISP 5C,A00,507696,Munoz Sanchez; Alicia,9,0,20,11
1714639676822,MAE 197,001,528363,Boechler; Nicholas Sebastia,9998,0,9999,1
1714639677848,MATH 197,001,523477,Kedlaya; Kiran S.,9995,0,9999,4
1714639677848,MATH 197,002,563811,Zhang; Danna,9995,0,9999,4
1714639677848,MATH 197,003,628552,Dumitriu; Ioana,9998,0,9999,1
1714639678879,MCWP 40R,A00,518780,Staff,2,0,20,18
1714639678879,MCWP 40R,B00,518781,Staff,8,0,20,12
1714639678879,MCWP 40R,C00,518783,Staff,6,0,20,14
1714639679909,MCWP 50R,A00,518791,Staff,0,0,20,20
1714639679909,MCWP 50R,B00,518792,Staff,0,2,20,20
1714639679909,MCWP 50R,C00,518793,Staff,0,2,20,20
1714639679909,MCWP 50R,D00,518794,Staff,0,1,20,20
1714639679909,MCWP 50R,E00,518795,Staff,0,2,20,20
1714639679909,MCWP 50R,F00,518796,Staff,0,0,20,20
1714639679909,MCWP 50R,G00,518797,Staff,0,1,20,20
1714639680934,MMW 12R,A01,514034,Herbst; Matthew,0,0,16,16
1714639680934,MMW 12R,A02,514035,Herbst; Matthew,1,0,16,15
1714639681960,MMW 13R,A01,514037,Staff,0,4,16,16
1714639681960,MMW 13R,A02,514039,Staff,0,2,16,16
1714639681960,MMW 13R,A03,628519,Staff,0,2,16,16
1714639684013,SIO 295LS,A00,523233,Staff,10,0,30,20
1714639685039,SIO 295S,A00,523232,Staff,10,0,30,20
1714639686068,SIOC 290S,A01,637330,Merrifield; Mark A,23,0,30,7
1714639687094,SIOC 291S,A01,637333,Gabriel; Corey John,23,0,30,7
1714639688123,SOCI 117,A01,494376,Staff,0,4,5,5
1714639689151,WES 237B,A00,494380,Staff,9,0,20,11
1714639691249,AESE 279B,A00,494370,Wade; Jon P,0,0,33,33
1714639692273,AIP 197,001,627712,Vespa; Emanuel Ignacio,9998,0,9999,1
1714639693299,ANAR 135S,A00,494369,Braswell; Geoffrey E.,0,0,0,0
1714639694323,BENG 196,001,628496,Engler; Adam J.,9998,0,9999,1
1714639695354,CAT 124RS,A01,519847,Geibel; William,0,0,20,20
1714639696380,CAT 125RS,A01,515971,Geibel; William,0,0,20,20
1714639697410,CLRE 250,A00,511389,Morris; Sheldon,9993,0,9999,6
1714639698445,CLRE 251,A00,507176,Mehta; Ravindra L.,9993,0,9999,6
1714639698445,CLRE 251,B00,511410,Mehta; Ravindra L.,9998,0,9999,1
1714639699471,CLRE 252,A00,507189,Cuomo; Raphael Eduardo,9995,0,9999,4
1714639700499,CLRE 253,A00,507199,Vaida; Florin,9994,0,9999,5
1714639700499,CLRE 253,B00,507202,Vaida; Florin,9999,0,9999,0
1714639701524,CLRE 259,A00,507211,Patel; Hemal,9996,0,9999,3
1714639702552,CLRE 260,A00,507221,Cuomo; Raphael Eduardo,9999,0,9999,0
1714639703576,CLRE 297,001,507242,Cuomo; Raphael Eduardo,9999,0,9999,0
1714639704602,COGS 197,001,638244,Voytek; Bradley Thomas,9998,0,9999,1
1714639705630,CSE 191,A00,516875,Minnes Kemp; Mor Mia,9992,0,9999,7
1714639706656,CSE 197,001,637388,Minnes Kemp; Mor Mia,9998,0,9999,1
1714639707682,CSS 201S,A01,494383,Staff,35,0,35,0
1714639708708,CSS 202S,A01,494387,Staff,35,0,35,0
1714639709732,DSC 197,001,628532,Eldridge; Justin Matthew,9996,0,9999,3
1714639710756,EAP 100,A00,516065,Staff,9797,0,9999,202
1714639711784,ECE 45,A01,507414,Staff,33,0,60,27
1714639713834,ECE 111,A01,507420,Staff,15,0,50,35
1714639714860,ECE 197,001,548057,Sievenpiper; Daniel F.,9993,0,9999,6
1714639715886,EDS 115,A00,507243,Choi; Bailey Miyeon,10,0,28,18
1714639716915,EDS 117,A01,494379,Staff,0,4,30,30
1714639717941,EDS 125,A00,507246,Hopkins; Megan Beth,9,0,30,21
1714639718967,EDS 128A,A01,507264,Fargason; Sharon Gayle,8,0,26,18
1714639719994,EDS 128B,A01,507293,Pappas; Elizabeth,12,0,30,18
1714639721022,EDS 139,A00,507294,Fargason; Sharon Gayle,13,0,30,17
1714639721022,EDS 139,B00,507313,Pappas; Elizabeth,13,0,30,17
1714639722048,EDS 201,A00,507315,Staff,13,0,30,17
1714639723078,EDS 203,A01,507317,Halter; Christopher P.,12,0,30,18
1714639724162,EDS 204R,A01,507319,Halter; Christopher P.,0,3,30,30
1714639724162,EDS 204R,B01,507331,Heinzman; Erica M.,16,0,30,14
1714639725188,EDS 206R,A00,507332,Staff,0,4,30,30
1714639725188,EDS 206R,B00,507343,Staff,17,0,30,13
1714639726213,EDS 250,A00,507344,Hemans; Patricia Ann Benitez,22,0,40,18
1714639727240,EDS 281,A00,507345,Daly; Alan J.,18,0,18,0
1714639728268,EDS 284,A00,507350,Daly; Alan J.,16,0,16,0
1714639729294,EDS 286,A00,507359,Fine; Sarah,18,0,18,0
1714639730318,EDS 289C,A01,507361,Daly; Alan J.,18,0,18,0
1714639731345,EDS 290,A00,507366,Hofstetter; Carolyn,15,0,15,0
1714639732377,LIGM 5A,A00,507421,Fischer-Grunski; Eva K,18,0,20,2
1714639733407,LIGM 5B,A00,507423,Fischer-Grunski; Eva K,19,0,20,1
1714639734437,LIGM 5C,A00,507425,Fischer-Grunski; Eva K,19,0,20,1
1714639735466,LIIT 5AS,A00,507427,Carnelos; Chiara,20,0,20,0
1714639736492,LIIT 5BS,A00,507430,Carnelos; Chiara,20,0,20,0
1714639737520,LIIT 5CS,A00,507432,Carnelos; Chiara,20,0,20,0
1714639738546,LISP 5A,A00,507541,Munoz Sanchez; Alicia,11,0,20,9
1714639739577,LISP 5B,A00,507671,Munoz Sanchez; Alicia,8,0,20,12
1714639740602,LISP 5C,A00,507696,Munoz Sanchez; Alicia,9,0,20,11
1714639741632,MAE 197,001,528363,Boechler; Nicholas Sebastia,9998,0,9999,1
1714639742659,MATH 197,001,523477,Kedlaya; Kiran S.,9995,0,9999,4
1714639742659,MATH 197,002,563811,Zhang; Danna,9995,0,9999,4
1714639742659,MATH 197,003,628552,Dumitriu; Ioana,9998,0,9999,1
1714639743686,MCWP 40R,A00,518780,Staff,2,0,20,18
1714639743686,MCWP 40R,B00,518781,Staff,8,0,20,12
1714639743686,MCWP 40R,C00,518783,Staff,6,0,20,14
1714639744712,MCWP 50R,A00,518791,Staff,0,0,20,20
1714639744712,MCWP 50R,B00,518792,Staff,0,2,20,20
1714639744712,MCWP 50R,C00,518793,Staff,0,2,20,20
1714639744712,MCWP 50R,D00,518794,Staff,0,1,20,20
1714639744712,MCWP 50R,E00,518795,Staff,0,2,20,20
1714639744712,MCWP 50R,F00,518796,Staff,0,0,20,20
1714639744712,MCWP 50R,G00,518797,Staff,0,1,20,20
1714639745738,MMW 12R,A01,514034,Herbst; Matthew,0,0,16,16
1714639745738,MMW 12R,A02,514035,Herbst; Matthew,1,0,16,15
1714639746764,MMW 13R,A01,514037,Staff,0,4,16,16
1714639746764,MMW 13R,A02,514039,Staff,0,2,16,16
1714639746764,MMW 13R,A03,628519,Staff,0,2,16,16
1714639748814,SIO 295LS,A00,523233,Staff,10,0,30,20
1714639749840,SIO 295S,A00,523232,Staff,10,0,30,20
1714639750873,SIOC 290S,A01,637330,Merrifield; Mark A,23,0,30,7
1714639751904,SIOC 291S,A01,637333,Gabriel; Corey John,23,0,30,7
1714639752934,SOCI 117,A01,494376,Staff,0,4,5,5
1714639753961,WES 237B,A00,494380,Staff,9,0,20,11
1714639756032,AESE 279B,A00,494370,Wade; Jon P,0,0,33,33
1714639757059,AIP 197,001,627712,Vespa; Emanuel Ignacio,9998,0,9999,1
1714639758086,ANAR 135S,A00,494369,Braswell; Geoffrey E.,0,0,0,0
1714639759112,BENG 196,001,628496,Engler; Adam J.,9998,0,9999,1
1714639760145,CAT 124RS,A01,519847,Geibel; William,0,0,20,20
1714639761175,CAT 125RS,A01,515971,Geibel; William,0,0,20,20
1714639762205,CLRE 250,A00,511389,Morris; Sheldon,9993,0,9999,6
1714639763240,CLRE 251,A00,507176,Mehta; Ravindra L.,9993,0,9999,6
1714639763240,CLRE 251,B00,511410,Mehta; Ravindra L.,9998,0,9999,1
1714639764269,CLRE 252,A00,507189,Cuomo; Raphael Eduardo,9995,0,9999,4
1714639765298,CLRE 253,A00,507199,Vaida; Florin,9994,0,9999,5
1714639765298,CLRE 253,B00,507202,Vaida; Florin,9999,0,9999,0
1714639766324,CLRE 259,A00,507211,Patel; Hemal,9996,0,9999,3
1714639767349,CLRE 260,A00,507221,Cuomo; Raphael Eduardo,9999,0,9999,0
1714639768374,CLRE 297,001,507242,Cuomo; Raphael Eduardo,9999,0,9999,0
1714639769403,COGS 197,001,638244,Voytek; Bradley Thomas,9998,0,9999,1
1714639770433,CSE 191,A00,516875,Minnes Kemp; Mor Mia,9992,0,9999,7
1714639771457,CSE 197,001,637388,Minnes Kemp; Mor Mia,9998,0,9999,1
1714639772483,CSS 201S,A01,494383,Staff,35,0,35,0
1714639773511,CSS 202S,A01,494387,Staff,35,0,35,0
1714639774539,DSC 197,001,628532,Eldridge; Justin Matthew,9996,0,9999,3
1714639775564,EAP 100,A00,516065,Staff,9797,0,9999,202
1714639776589,ECE 45,A01,507414,Staff,33,0,60,27
1714639778643,ECE 111,A01,507420,Staff,15,0,50,35
1714639779671,ECE 197,001,548057,Sievenpiper; Daniel F.,9993,0,9999,6
1714639780698,EDS 115,A00,507243,Choi; Bailey Miyeon,10,0,28,18
1714639781727,EDS 117,A01,494379,Staff,0,4,30,30
1714639782752,EDS 125,A00,507246,Hopkins; Megan Beth,9,0,30,21
1714639783777,EDS 128A,A01,507264,Fargason; Sharon Gayle,8,0,26,18
1714639784805,EDS 128B,A01,507293,Pappas; Elizabeth,12,0,30,18
1714639785834,EDS 139,A00,507294,Fargason; Sharon Gayle,13,0,30,17
1714639785834,EDS 139,B00,507313,Pappas; Elizabeth,13,0,30,17
1714639786862,EDS 201,A00,507315,Staff,13,0,30,17
1714639787891,EDS 203,A01,507317,Halter; Christopher P.,12,0,30,18
1714639788916,EDS 204R,A01,507319,Halter; Christopher P.,0,3,30,30
1714639788916,EDS 204R,B01,507331,Heinzman; Erica M.,16,0,30,14
1714639789944,EDS 206R,A00,507332,Staff,0,4,30,30
1714639789944,EDS 206R,B00,507343,Staff,17,0,30,13
1714639790972,EDS 250,A00,507344,Hemans; Patricia Ann Benitez,22,0,40,18
1714639791998,EDS 281,A00,507345,Daly; Alan J.,18,0,18,0
1714639793024,EDS 284,A00,507350,Daly; Alan J.,16,0,16,0
1714639794053,EDS 286,A00,507359,Fine; Sarah,18,0,18,0
1714639795079,EDS 289C,A01,507361,Daly; Alan J.,18,0,18,0
1714639796105,EDS 290,A00,507366,Hofstetter; Carolyn,15,0,15,0
1714639797132,LIGM 5A,A00,507421,Fischer-Grunski; Eva K,18,0,20,2
1714639798158,LIGM 5B,A00,507423,Fischer-Grunski; Eva K,19,0,20,1
1714639799184,LIGM 5C,A00,507425,Fischer-Grunski; Eva K,19,0,20,1
1714639800215,LIIT 5AS,A00,507427,Carnelos; Chiara,20,0,20,0
1714639801244,LIIT 5BS,A00,507430,Carnelos; Chiara,20,0,20,0
1714639802270,LIIT 5CS,A00,507432,Carnelos; Chiara,20,0,20,0
1714639803298,LISP 5A,A00,507541,Munoz Sanchez; Alicia,11,0,20,9
1714639804327,LISP 5B,A00,507671,Munoz Sanchez; Alicia,8,0,20,12
1714639805357,LISP 5C,A00,507696,Munoz Sanchez; Alicia,9,0,20,11
1714639806383,MAE 197,001,528363,Boechler; Nicholas Sebastia,9998,0,9999,1
1714639807411,MATH 197,001,523477,Kedlaya; Kiran S.,9995,0,9999,4
1714639807411,MATH 197,002,563811,Zhang; Danna,9995,0,9999,4
1714639807411,MATH 197,003,628552,Dumitriu; Ioana,9998,0,9999,1
1714639808437,MCWP 40R,A00,518780,Staff,2,0,20,18
1714639808437,MCWP 40R,B00,518781,Staff,8,0,20,12
1714639808437,MCWP 40R,C00,518783,Staff,6,0,20,14
1714639809463,MCWP 50R,A00,518791,Staff,0,0,20,20
1714639809463,MCWP 50R,B00,518792,Staff,0,2,20,20
1714639809463,MCWP 50R,C00,518793,Staff,0,2,20,20
1714639809463,MCWP 50R,D00,518794,Staff,0,1,20,20
1714639809463,MCWP 50R,E00,518795,Staff,0,2,20,20
1714639809463,MCWP 50R,F00,518796,Staff,0,0,20,20
1714639809463,MCWP 50R,G00,518797,Staff,0,1,20,20
1714639810489,MMW 12R,A01,514034,Herbst; Matthew,0,0,16,16
1714639810489,MMW 12R,A02,514035,Herbst; Matthew,1,0,16,15
1714639811514,MMW 13R,A01,514037,Staff,0,4,16,16
1714639811514,MMW 13R,A02,514039,Staff,0,2,16,16
1714639811514,MMW 13R,A03,628519,Staff,0,2,16,16
1714639813568,SIO 295LS,A00,523233,Staff,10,0,30,20
1714639814596,SIO 295S,A00,523232,Staff,10,0,30,20
1714639815626,SIOC 290S,A01,637330,Merrifield; Mark A,23,0,30,7
1714639816653,SIOC 291S,A01,637333,Gabriel; Corey John,23,0,30,7
1714639817682,SOCI 117,A01,494376,Staff,0,4,5,5
1714639818711,WES 237B,A00,494380,Staff,9,0,20,11
1714639820791,AESE 279B,A00,494370,Wade; Jon P,0,0,33,33
1714639821820,AIP 197,001,627712,Vespa; Emanuel Ignacio,9998,0,9999,1
1714639822844,ANAR 135S,A00,494369,Braswell; Geoffrey E.,0,0,0,0
1714639823872,BENG 196,001,628496,Engler; Adam J.,9998,0,9999,1
1714639824901,CAT 124RS,A01,519847,Geibel; William,0,0,20,20
1714639825926,CAT 125RS,A01,515971,Geibel; William,0,0,20,20
1714639826952,CLRE 250,A00,511389,Morris; Sheldon,9993,0,9999,6
1714639828039,CLRE 251,A00,507176,Mehta; Ravindra L.,9993,0,9999,6
1714639828039,CLRE 251,B00,511410,Mehta; Ravindra L.,9998,0,9999,1
1714639829065,CLRE 252,A00,507189,Cuomo; Raphael Eduardo,9995,0,9999,4
1714639830095,CLRE 253,A00,507199,Vaida; Florin,9994,0,9999,5
1714639830095,CLRE 253,B00,507202,Vaida; Florin,9999,0,9999,0
1714639831122,CLRE 259,A00,507211,Patel; Hemal,9996,0,9999,3
1714639832149,CLRE 260,A00,507221,Cuomo; Raphael Eduardo,9999,0,9999,0
1714639833177,CLRE 297,001,507242,Cuomo; Raphael Eduardo,9999,0,9999,0
1714639834205,COGS 197,001,638244,Voytek; Bradley Thomas,9998,0,9999,1
1714639835231,CSE 191,A00,516875,Minnes Kemp; Mor Mia,9992,0,9999,7
1714639836261,CSE 197,001,637388,Minnes Kemp; Mor Mia,9998,0,9999,1
1714639837292,CSS 201S,A01,494383,Staff,35,0,35,0
1714639838317,CSS 202S,A01,494387,Staff,35,0,35,0
1714639839345,DSC 197,001,628532,Eldridge; Justin Matthew,9996,0,9999,3
1714639840373,EAP 100,A00,516065,Staff,9797,0,9999,202
1714639841400,ECE 45,A01,507414,Staff,33,0,60,27
1714639843452,ECE 111,A01,507420,Staff,15,0,50,35
1714639844481,ECE 197,001,548057,Sievenpiper; Daniel F.,9993,0,9999,6
1714639845507,EDS 115,A00,507243,Choi; Bailey Miyeon,10,0,28,18
1714639846537,EDS 117,A01,494379,Staff,0,4,30,30
1714639847563,EDS 125,A00,507246,Hopkins; Megan Beth,9,0,30,21
1714639848591,EDS 128A,A01,507264,Fargason; Sharon Gayle,8,0,26,18
1714639849616,EDS 128B,A01,507293,Pappas; Elizabeth,12,0,30,18
1714639850645,EDS 139,A00,507294,Fargason; Sharon Gayle,13,0,30,17
1714639850645,EDS 139,B00,507313,Pappas; Elizabeth,13,0,30,17
1714639851671,EDS 201,A00,507315,Staff,13,0,30,17
1714639852701,EDS 203,A01,507317,Halter; Christopher P.,12,0,30,18
1714639853726,EDS 204R,A01,507319,Halter; Christopher P.,0,3,30,30
1714639853726,EDS 204R,B01,507331,Heinzman; Erica M.,16,0,30,14
1714639854752,EDS 206R,A00,507332,Staff,0,4,30,30
1714639854752,EDS 206R,B00,507343,Staff,17,0,30,13
1714639855782,EDS 250,A00,507344,Hemans; Patricia Ann Benitez,22,0,40,18
1714639856809,EDS 281,A00,507345,Daly; Alan J.,18,0,18,0
1714639857834,EDS 284,A00,507350,Daly; Alan J.,16,0,16,0
1714639858865,EDS 286,A00,507359,Fine; Sarah,18,0,18,0
1714639859893,EDS 289C,A01,507361,Daly; Alan J.,18,0,18,0
1714639860922,EDS 290,A00,507366,Hofstetter; Carolyn,15,0,15,0
1714639861954,LIGM 5A,A00,507421,Fischer-Grunski; Eva K,18,0,20,2
1714639862980,LIGM 5B,A00,507423,Fischer-Grunski; Eva K,19,0,20,1
1714639864005,LIGM 5C,A00,507425,Fischer-Grunski; Eva K,19,0,20,1
1714639865032,LIIT 5AS,A00,507427,Carnelos; Chiara,20,0,20,0
1714639866056,LIIT 5BS,A00,507430,Carnelos; Chiara,20,0,20,0
1714639867083,LIIT 5CS,A00,507432,Carnelos; Chiara,20,0,20,0
1714639868118,LISP 5A,A00,507541,Munoz Sanchez; Alicia,11,0,20,9
1714639869148,LISP 5B,A00,507671,Munoz Sanchez; Alicia,8,0,20,12
1714639870176,LISP 5C,A00,507696,Munoz Sanchez; Alicia,9,0,20,11
1714639871204,MAE 197,001,528363,Boechler; Nicholas Sebastia,9998,0,9999,1
1714639872228,MATH 197,001,523477,Kedlaya; Kiran S.,9995,0,9999,4
1714639872228,MATH 197,002,563811,Zhang; Danna,9995,0,9999,4
1714639872228,MATH 197,003,628552,Dumitriu; Ioana,9998,0,9999,1
1714639873255,MCWP 40R,A00,518780,Staff,2,0,20,18
1714639873255,MCWP 40R,B00,518781,Staff,8,0,20,12
1714639873255,MCWP 40R,C00,518783,Staff,6,0,20,14
1714639874281,MCWP 50R,A00,518791,Staff,0,0,20,20
1714639874281,MCWP 50R,B00,518792,Staff,0,2,20,20
1714639874281,MCWP 50R,C00,518793,Staff,0,2,20,20
1714639874281,MCWP 50R,D00,518794,Staff,0,1,20,20
1714639874281,MCWP 50R,E00,518795,Staff,0,2,20,20
1714639874281,MCWP 50R,F00,518796,Staff,0,0,20,20
1714639874281,MCWP 50R,G00,518797,Staff,0,1,20,20
1714639875312,MMW 12R,A01,514034,Herbst; Matthew,0,0,16,16
1714639875312,MMW 12R,A02,514035,Herbst; Matthew,1,0,16,15
1714639876340,MMW 13R,A01,514037,Staff,0,4,16,16
1714639876340,MMW 13R,A02,514039,Staff,0,2,16,16
1714639876340,MMW 13R,A03,628519,Staff,0,2,16,16
1714639878394,SIO 295LS,A00,523233,Staff,10,0,30,20
1714639879420,SIO 295S,A00,523232,Staff,10,0,30,20
1714639880447,SIOC 290S,A01,637330,Merrifield; Mark A,23,0,30,7
1714639881471,SIOC 291S,A01,637333,Gabriel; Corey John,23,0,30,7
1714639882497,SOCI 117,A01,494376,Staff,0,4,5,5
1714639883523,WES 237B,A00,494380,Staff,9,0,20,11
1714639885592,AESE 279B,A00,494370,Wade; Jon P,0,0,33,33
1714639886619,AIP 197,001,627712,Vespa; Emanuel Ignacio,9998,0,9999,1
1714639887644,ANAR 135S,A00,494369,Braswell; Geoffrey E.,0,0,0,0
1714639888668,BENG 196,001,628496,Engler; Adam J.,9998,0,9999,1
1714639889695,CAT 124RS,A01,519847,Geibel; William,0,0,20,20
1714639890720,CAT 125RS,A01,515971,Geibel; William,0,0,20,20
1714639891746,CLRE 250,A00,511389,Morris; Sheldon,9993,0,9999,6
1714639892772,CLRE 251,A00,507176,Mehta; Ravindra L.,9993,0,9999,6
1714639892772,CLRE 251,B00,511410,Mehta; Ravindra L.,9998,0,9999,1
1714639893801,CLRE 252,A00,507189,Cuomo; Raphael Eduardo,9995,0,9999,4
1714639894830,CLRE 253,A00,507199,Vaida; Florin,9994,0,9999,5
1714639894830,CLRE 253,B00,507202,Vaida; Florin,9999,0,9999,0
1714639895858,CLRE 259,A00,507211,Patel; Hemal,9996,0,9999,3
1714639896884,CLRE 260,A00,507221,Cuomo; Raphael Eduardo,9999,0,9999,0
1714639897910,CLRE 297,001,507242,Cuomo; Raphael Eduardo,9999,0,9999,0
1714639898938,COGS 197,001,638244,Voytek; Bradley Thomas,9998,0,9999,1
1714639899969,CSE 191,A00,516875,Minnes Kemp; Mor Mia,9992,0,9999,7
1714639900996,CSE 197,001,637388,Minnes Kemp; Mor Mia,9998,0,9999,1
1714639902023,CSS 201S,A01,494383,Staff,35,0,35,0
1714639903051,CSS 202S,A01,494387,Staff,35,0,35,0
1714639904076,DSC 197,001,628532,Eldridge; Justin Matthew,9996,0,9999,3
1714639905103,EAP 100,A00,516065,Staff,9797,0,9999,202
1714639906128,ECE 45,A01,507414,Staff,33,0,60,27
1714639908179,ECE 111,A01,507420,Staff,15,0,50,35
1714639909204,ECE 197,001,548057,Sievenpiper; Daniel F.,9993,0,9999,6
1714639910228,EDS 115,A00,507243,Choi; Bailey Miyeon,10,0,28,18
1714639911260,EDS 117,A01,494379,Staff,0,4,30,30
1714639912285,EDS 125,A00,507246,Hopkins; Megan Beth,9,0,30,21
1714639913310,EDS 128A,A01,507264,Fargason; Sharon Gayle,8,0,26,18
1714639914338,EDS 128B,A01,507293,Pappas; Elizabeth,12,0,30,18
1714639915363,EDS 139,A00,507294,Fargason; Sharon Gayle,13,0,30,17
1714639915363,EDS 139,B00,507313,Pappas; Elizabeth,13,0,30,17
1714639916391,EDS 201,A00,507315,Staff,13,0,30,17
1714639917424,EDS 203,A01,507317,Halter; Christopher P.,12,0,30,18
1714639918455,EDS 204R,A01,507319,Halter; Christopher P.,0,3,30,30
1714639918455,EDS 204R,B01,507331,Heinzman; Erica M.,16,0,30,14
1714639919480,EDS 206R,A00,507332,Staff,0,4,30,30
1714639919480,EDS 206R,B00,507343,Staff,17,0,30,13
1714639920510,EDS 250,A00,507344,Hemans; Patricia Ann Benitez,22,0,40,18
1714639921535,EDS 281,A00,507345,Daly; Alan J.,18,0,18,0
1714639922563,EDS 284,A00,507350,Daly; Alan J.,16,0,16,0
1714639923592,EDS 286,A00,507359,Fine; Sarah,18,0,18,0
1714639924619,EDS 289C,A01,507361,Daly; Alan J.,18,0,18,0
1714639925643,EDS 290,A00,507366,Hofstetter; Carolyn,15,0,15,0
1714639926676,LIGM 5A,A00,507421,Fischer-Grunski; Eva K,18,0,20,2
1714639927700,LIGM 5B,A00,507423,Fischer-Grunski; Eva K,19,0,20,1
1714639928726,LIGM 5C,A00,507425,Fischer-Grunski; Eva K,19,0,20,1
1714639929751,LIIT 5AS,A00,507427,Carnelos; Chiara,20,0,20,0
1714639930779,LIIT 5BS,A00,507430,Carnelos; Chiara,20,0,20,0
1714639931808,LIIT 5CS,A00,507432,Carnelos; Chiara,20,0,20,0
1714639932838,LISP 5A,A00,507541,Munoz Sanchez; Alicia,11,0,20,9
1714639933865,LISP 5B,A00,507671,Munoz Sanchez; Alicia,8,0,20,12
1714639934890,LISP 5C,A00,507696,Munoz Sanchez; Alicia,9,0,20,11
1714639935915,MAE 197,001,528363,Boechler; Nicholas Sebastia,9998,0,9999,1
1714639936946,MATH 197,001,523477,Kedlaya; Kiran S.,9995,0,9999,4
1714639936946,MATH 197,002,563811,Zhang; Danna,9995,0,9999,4
1714639936946,MATH 197,003,628552,Dumitriu; Ioana,9998,0,9999,1
1714639937969,MCWP 40R,A00,518780,Staff,2,0,20,18
1714639937969,MCWP 40R,B00,518781,Staff,8,0,20,12
1714639937969,MCWP 40R,C00,518783,Staff,6,0,20,14
1714639938996,MCWP 50R,A00,518791,Staff,0,0,20,20
1714639938996,MCWP 50R,B00,518792,Staff,0,2,20,20
1714639938996,MCWP 50R,C00,518793,Staff,0,2,20,20
1714639938996,MCWP 50R,D00,518794,Staff,0,1,20,20
1714639938996,MCWP 50R,E00,518795,Staff,0,2,20,20
1714639938996,MCWP 50R,F00,518796,Staff,0,0,20,20
1714639938996,MCWP 50R,G00,518797,Staff,0,1,20,20
1714639940023,MMW 12R,A01,514034,Herbst; Matthew,0,0,16,16
1714639940023,MMW 12R,A02,514035,Herbst; Matthew,1,0,16,15
1714639941048,MMW 13R,A01,514037,Staff,0,4,16,16
1714639941048,MMW 13R,A02,514039,Staff,0,2,16,16
1714639941048,MMW 13R,A03,628519,Staff,0,2,16,16
1714639943098,SIO 295LS,A00,523233,Staff,10,0,30,20
1714639944122,SIO 295S,A00,523232,Staff,10,0,30,20
1714639945147,SIOC 290S,A01,637330,Merrifield; Mark A,23,0,30,7
1714639946177,SIOC 291S,A01,637333,Gabriel; Corey John,23,0,30,7
1714639947204,SOCI 117,A01,494376,Staff,0,4,5,5
1714639948229,WES 237B,A00,494380,Staff,9,0,20,11
1714639950307,AESE 279B,A00,494370,Wade; Jon P,0,0,33,33
1714639951336,AIP 197,001,627712,Vespa; Emanuel Ignacio,9998,0,9999,1
1714639952364,ANAR 135S,A00,494369,Braswell; Geoffrey E.,0,0,0,0
1714639953389,BENG 196,001,628496,Engler; Adam J.,9998,0,9999,1
1714639954413,CAT 124RS,A01,519847,Geibel; William,0,0,20,20
1714639955442,CAT 125RS,A01,515971,Geibel; William,0,0,20,20
1714639956488,CLRE 250,A00,511389,Morris; Sheldon,9993,0,9999,6
1714639957520,CLRE 251,A00,507176,Mehta; Ravindra L.,9993,0,9999,6
1714639957520,CLRE 251,B00,511410,Mehta; Ravindra L.,9998,0,9999,1
1714639958545,CLRE 252,A00,507189,Cuomo; Raphael Eduardo,9995,0,9999,4
1714639959576,CLRE 253,A00,507199,Vaida; Florin,9994,0,9999,5
1714639959576,CLRE 253,B00,507202,Vaida; Florin,9999,0,9999,0
1714639960601,CLRE 259,A00,507211,Patel; Hemal,9996,0,9999,3
1714639961626,CLRE 260,A00,507221,Cuomo; Raphael Eduardo,9999,0,9999,0
1714639962650,CLRE 297,001,507242,Cuomo; Raphael Eduardo,9999,0,9999,0
1714639963674,COGS 197,001,638244,Voytek; Bradley Thomas,9998,0,9999,1
1714639964699,CSE 191,A00,516875,Minnes Kemp; Mor Mia,9992,0,9999,7
1714639965726,CSE 197,001,637388,Minnes Kemp; Mor Mia,9998,0,9999,1
1714639966751,CSS 201S,A01,494383,Staff,35,0,35,0
1714639967779,CSS 202S,A01,494387,Staff,35,0,35,0
1714639968805,DSC 197,001,628532,Eldridge; Justin Matthew,9996,0,9999,3
1714639969832,EAP 100,A00,516065,Staff,9797,0,9999,202
1714639970862,ECE 45,A01,507414,Staff,33,0,60,27
1714639972917,ECE 111,A01,507420,Staff,15,0,50,35
1714639973943,ECE 197,001,548057,Sievenpiper; Daniel F.,9993,0,9999,6
1714639974973,EDS 115,A00,507243,Choi; Bailey Miyeon,10,0,28,18
1714639975999,EDS 117,A01,494379,Staff,0,4,30,30
1714639977029,EDS 125,A00,507246,Hopkins; Megan Beth,9,0,30,21
1714639978056,EDS 128A,A01,507264,Fargason; Sharon Gayle,8,0,26,18
1714639979080,EDS 128B,A01,507293,Pappas; Elizabeth,12,0,30,18
1714639980108,EDS 139,A00,507294,Fargason; Sharon Gayle,13,0,30,17
1714639980108,EDS 139,B00,507313,Pappas; Elizabeth,13,0,30,17
1714639981132,EDS 201,A00,507315,Staff,13,0,30,17
1714639982161,EDS 203,A01,507317,Halter; Christopher P.,12,0,30,18
1714639983189,EDS 204R,A01,507319,Halter; Christopher P.,0,3,30,30
1714639983189,EDS 204R,B01,507331,Heinzman; Erica M.,16,0,30,14
1714639984218,EDS 206R,A00,507332,Staff,0,4,30,30
1714639984218,EDS 206R,B00,507343,Staff,17,0,30,13
1714639985242,EDS 250,A00,507344,Hemans; Patricia Ann Benitez,22,0,40,18
1714639986270,EDS 281,A00,507345,Daly; Alan J.,18,0,18,0
1714639987293,EDS 284,A00,507350,Daly; Alan J.,16,0,16,0
1714639988323,EDS 286,A00,507359,Fine; Sarah,18,0,18,0
1714639989349,EDS 289C,A01,507361,Daly; Alan J.,18,0,18,0
1714639990376,EDS 290,A00,507366,Hofstetter; Carolyn,15,0,15,0
1714639991406,LIGM 5A,A00,507421,Fischer-Grunski; Eva K,18,0,20,2
1714639992436,LIGM 5B,A00,507423,Fischer-Grunski; Eva K,19,0,20,1
1714639993459,LIGM 5C,A00,507425,Fischer-Grunski; Eva K,19,0,20,1
1714639994485,LIIT 5AS,A00,507427,Carnelos; Chiara,20,0,20,0
1714639995510,LIIT 5BS,A00,507430,Carnelos; Chiara,20,0,20,0
1714639996535,LIIT 5CS,A00,507432,Carnelos; Chiara,20,0,20,0
1714639997566,LISP 5A,A00,507541,Munoz Sanchez; Alicia,11,0,20,9
1714639998593,LISP 5B,A00,507671,Munoz Sanchez; Alicia,8,0,20,12
1714639999620,LISP 5C,A00,507696,Munoz Sanchez; Alicia,9,0,20,11
1714640000646,MAE 197,001,528363,Boechler; Nicholas Sebastia,9998,0,9999,1
1714640001676,MATH 197,001,523477,Kedlaya; Kiran S.,9995,0,9999,4
1714640001676,MATH 197,002,563811,Zhang; Danna,9995,0,9999,4
1714640001676,MATH 197,003,628552,Dumitriu; Ioana,9998,0,9999,1
1714640002702,MCWP 40R,A00,518780,Staff,2,0,20,18
1714640002702,MCWP 40R,B00,518781,Staff,8,0,20,12
1714640002702,MCWP 40R,C00,518783,Staff,6,0,20,14
1714640003729,MCWP 50R,A00,518791,Staff,0,0,20,20
1714640003729,MCWP 50R,B00,518792,Staff,0,2,20,20
1714640003729,MCWP 50R,C00,518793,Staff,0,2,20,20
1714640003729,MCWP 50R,D00,518794,Staff,0,1,20,20
1714640003729,MCWP 50R,E00,518795,Staff,0,2,20,20
1714640003729,MCWP 50R,F00,518796,Staff,0,0,20,20
1714640003729,MCWP 50R,G00,518797,Staff,0,1,20,20
1714640004757,MMW 12R,A01,514034,Herbst; Matthew,0,0,16,16
1714640004757,MMW 12R,A02,514035,Herbst; Matthew,1,0,16,15
1714640005781,MMW 13R,A01,514037,Staff,0,4,16,16
1714640005781,MMW 13R,A02,514039,Staff,0,2,16,16
1714640005781,MMW 13R,A03,628519,Staff,0,2,16,16
1714640007836,SIO 295LS,A00,523233,Staff,10,0,30,20
1714640008861,SIO 295S,A00,523232,Staff,10,0,30,20
1714640009892,SIOC 290S,A01,637330,Merrifield; Mark A,23,0,30,7
1714640010922,SIOC 291S,A01,637333,Gabriel; Corey John,23,0,30,7
1714640011948,SOCI 117,A01,494376,Staff,0,4,5,5
1714640012973,WES 237B,A00,494380,Staff,9,0,20,11
1714640015047,AESE 279B,A00,494370,Wade; Jon P,0,0,33,33
1714640016071,AIP 197,001,627712,Vespa; Emanuel Ignacio,9998,0,9999,1
1714640017140,ANAR 135S,A00,494369,Braswell; Geoffrey E.,0,0,0,0
1714640018166,BENG 196,001,628496,Engler; Adam J.,9998,0,9999,1
1714640019190,CAT 124RS,A01,519847,Geibel; William,0,0,20,20
1714640020219,CAT 125RS,A01,515971,Geibel; William,0,0,20,20
1714640021245,CLRE 250,A00,511389,Morris; Sheldon,9993,0,9999,6
1714640022278,CLRE 251,A00,507176,Mehta; Ravindra L.,9993,0,9999,6
1714640022278,CLRE 251,B00,511410,Mehta; Ravindra L.,9998,0,9999,1
1714640023304,CLRE 252,A00,507189,Cuomo; Raphael Eduardo,9995,0,9999,4
1714640024334,CLRE 253,A00,507199,Vaida; Florin,9994,0,9999,5
1714640024334,CLRE 253,B00,507202,Vaida; Florin,9999,0,9999,0
1714640025360,CLRE 259,A00,507211,Patel; Hemal,9996,0,9999,3
1714640026389,CLRE 260,A00,507221,Cuomo; Raphael Eduardo,9999,0,9999,0
1714640027413,CLRE 297,001,507242,Cuomo; Raphael Eduardo,9999,0,9999,0
1714640028440,COGS 197,001,638244,Voytek; Bradley Thomas,9998,0,9999,1
1714640029466,CSE 191,A00,516875,Minnes Kemp; Mor Mia,9992,0,9999,7
1714640030491,CSE 197,001,637388,Minnes Kemp; Mor Mia,9998,0,9999,1
1714640031518,CSS 201S,A01,494383,Staff,35,0,35,0
1714640032543,CSS 202S,A01,494387,Staff,35,0,35,0
1714640033571,DSC 197,001,628532,Eldridge; Justin Matthew,9996,0,9999,3
1714640034597,EAP 100,A00,516065,Staff,9797,0,9999,202
1714640035625,ECE 45,A01,507414,Staff,33,0,60,27
1714640037675,ECE 111,A01,507420,Staff,15,0,50,35
1714640038699,ECE 197,001,548057,Sievenpiper; Daniel F.,9993,0,9999,6
1714640039725,EDS 115,A00,507243,Choi; Bailey Miyeon,10,0,28,18
1714640040766,EDS 117,A01,494379,Staff,0,4,30,30
1714640041791,EDS 125,A00,507246,Hopkins; Megan Beth,9,0,30,21
1714640042817,EDS 128A,A01,507264,Fargason; Sharon Gayle,8,0,26,18
1714640043844,EDS 128B,A01,507293,Pappas; Elizabeth,12,0,30,18
1714640044869,EDS 139,A00,507294,Fargason; Sharon Gayle,13,0,30,17
1714640044869,EDS 139,B00,507313,Pappas; Elizabeth,13,0,30,17
1714640045893,EDS 201,A00,507315,Staff,13,0,30,17
1714640046920,EDS 203,A01,507317,Halter; Christopher P.,12,0,30,18
1714640047946,EDS 204R,A01,507319,Halter; Christopher P.,0,3,30,30
1714640047946,EDS 204R,B01,507331,Heinzman; Erica M.,16,0,30,14
1714640048972,EDS 206R,A00,507332,Staff,0,4,30,30
1714640048972,EDS 206R,B00,507343,Staff,17,0,30,13
1714640049996,EDS 250,A00,507344,Hemans; Patricia Ann Benitez,22,0,40,18
1714640051022,EDS 281,A00,507345,Daly; Alan J.,18,0,18,0
1714640052050,EDS 284,A00,507350,Daly; Alan J.,16,0,16,0
1714640053078,EDS 286,A00,507359,Fine; Sarah,18,0,18,0
1714640054104,EDS 289C,A01,507361,Daly; Alan J.,18,0,18,0
1714640055130,EDS 290,A00,507366,Hofstetter; Carolyn,15,0,15,0
1714640056157,LIGM 5A,A00,507421,Fischer-Grunski; Eva K,18,0,20,2
1714640057220,LIGM 5B,A00,507423,Fischer-Grunski; Eva K,19,0,20,1
1714640058248,LIGM 5C,A00,507425,Fischer-Grunski; Eva K,19,0,20,1
1714640059273,LIIT 5AS,A00,507427,Carnelos; Chiara,20,0,20,0
1714640060299,LIIT 5BS,A00,507430,Carnelos; Chiara,20,0,20,0
1714640061327,LIIT 5CS,A00,507432,Carnelos; Chiara,20,0,20,0
1714640062358,LISP 5A,A00,507541,Munoz Sanchez; Alicia,11,0,20,9
1714640063384,LISP 5B,A00,507671,Munoz Sanchez; Alicia,8,0,20,12
1714640064408,LISP 5C,A00,507696,Munoz Sanchez; Alicia,9,0,20,11
1714640065434,MAE 197,001,528363,Boechler; Nicholas Sebastia,9998,0,9999,1
1714640066462,MATH 197,001,523477,Kedlaya; Kiran S.,9995,0,9999,4
1714640066462,MATH 197,002,563811,Zhang; Danna,9995,0,9999,4
1714640066462,MATH 197,003,628552,Dumitriu; Ioana,9998,0,9999,1
1714640067486,MCWP 40R,A00,518780,Staff,2,0,20,18
1714640067486,MCWP 40R,B00,518781,Staff,8,0,20,12
1714640067486,MCWP 40R,C00,518783,Staff,6,0,20,14
1714640068510,MCWP 50R,A00,518791,Staff,0,0,20,20
1714640068510,MCWP 50R,B00,518792,Staff,0,2,20,20
1714640068510,MCWP 50R,C00,518793,Staff,0,2,20,20
1714640068510,MCWP 50R,D00,518794,Staff,0,1,20,20
1714640068510,MCWP 50R,E00,518795,Staff,0,2,20,20
1714640068510,MCWP 50R,F00,518796,Staff,0,0,20,20
1714640068510,MCWP 50R,G00,518797,Staff,0,1,20,20
1714640069542,MMW 12R,A01,514034,Herbst; Matthew,0,0,16,16
1714640069542,MMW 12R,A02,514035,Herbst; Matthew,1,0,16,15
1714640070571,MMW 13R,A01,514037,Staff,0,4,16,16
1714640070571,MMW 13R,A02,514039,Staff,0,2,16,16
1714640070571,MMW 13R,A03,628519,Staff,0,2,16,16
1714640072628,SIO 295LS,A00,523233,Staff,10,0,30,20
1714640073655,SIO 295S,A00,523232,Staff,10,0,30,20
1714640074686,SIOC 290S,A01,637330,Merrifield; Mark A,23,0,30,7
1714640075713,SIOC 291S,A01,637333,Gabriel; Corey John,23,0,30,7
1714640076748,SOCI 117,A01,494376,Staff,0,4,5,5
1714640077773,WES 237B,A00,494380,Staff,9,0,20,11
1714640079846,AESE 279B,A00,494370,Wade; Jon P,0,0,33,33
1714640080870,AIP 197,001,627712,Vespa; Emanuel Ignacio,9998,0,9999,1
1714640081900,ANAR 135S,A00,494369,Braswell; Geoffrey E.,0,0,0,0
1714640082926,BENG 196,001,628496,Engler; Adam J.,9998,0,9999,1
1714640083952,CAT 124RS,A01,519847,Geibel; William,0,0,20,20
1714640084978,CAT 125RS,A01,515971,Geibel; William,0,0,20,20
1714640086063,CLRE 250,A00,511389,Morris; Sheldon,9993,0,9999,6
1714640087094,CLRE 251,A00,507176,Mehta; Ravindra L.,9993,0,9999,6
1714640087094,CLRE 251,B00,511410,Mehta; Ravindra L.,9998,0,9999,1
1714640088174,CLRE 252,A00,507189,Cuomo; Raphael Eduardo,9995,0,9999,4
1714640089200,CLRE 253,A00,507199,Vaida; Florin,9994,0,9999,5
1714640089200,CLRE 253,B00,507202,Vaida; Florin,9999,0,9999,0
1714640090231,CLRE 259,A00,507211,Patel; Hemal,9996,0,9999,3
1714640091260,CLRE 260,A00,507221,Cuomo; Raphael Eduardo,9999,0,9999,0
1714640092289,CLRE 297,001,507242,Cuomo; Raphael Eduardo,9999,0,9999,0
1714640093319,COGS 197,001,638244,Voytek; Bradley Thomas,9998,0,9999,1
1714640094345,CSE 191,A00,516875,Minnes Kemp; Mor Mia,9992,0,9999,7
1714640095372,CSE 197,001,637388,Minnes Kemp; Mor Mia,9998,0,9999,1
1714640096403,CSS 201S,A01,494383,Staff,35,0,35,0
1714640097427,CSS 202S,A01,494387,Staff,35,0,35,0
1714640098453,DSC 197,001,628532,Eldridge; Justin Matthew,9996,0,9999,3
1714640099478,EAP 100,A00,516065,Staff,9797,0,9999,202
1714640100507,ECE 45,A01,507414,Staff,33,0,60,27
1714640102562,ECE 111,A01,507420,Staff,15,0,50,35
1714640103587,ECE 197,001,548057,Sievenpiper; Daniel F.,9993,0,9999,6
1714640104614,EDS 115,A00,507243,Choi; Bailey Miyeon,10,0,28,18
1714640105646,EDS 117,A01,494379,Staff,0,4,30,30
1714640106675,EDS 125,A00,507246,Hopkins; Megan Beth,9,0,30,21
1714640107703,EDS 128A,A01,507264,Fargason; Sharon Gayle,8,0,26,18
1714640108730,EDS 128B,A01,507293,Pappas; Elizabeth,12,0,30,18
1714640109756,EDS 139,A00,507294,Fargason; Sharon Gayle,13,0,30,17
1714640109756,EDS 139,B00,507313,Pappas; Elizabeth,13,0,30,17
1714640110785,EDS 201,A00,507315,Staff,13,0,30,17
1714640111814,EDS 203,A01,507317,Halter; Christopher P.,12,0,30,18
1714640112840,EDS 204R,A01,507319,Halter; Christopher P.,0,3,30,30
1714640112840,EDS 204R,B01,507331,Heinzman; Erica M.,16,0,30,14
1714640113876,EDS 206R,A00,507332,Staff,0,4,30,30
1714640113876,EDS 206R,B00,507343,Staff,17,0,30,13
1714640114904,EDS 250,A00,507344,Hemans; Patricia Ann Benitez,22,0,40,18
1714640115929,EDS 281,A00,507345,Daly; Alan J.,18,0,18,0
1714640116955,EDS 284,A00,507350,Daly; Alan J.,16,0,16,0
1714640117980,EDS 286,A00,507359,Fine; Sarah,18,0,18,0
1714640119010,EDS 289C,A01,507361,Daly; Alan J.,18,0,18,0
1714640120040,EDS 290,A00,507366,Hofstetter; Carolyn,15,0,15,0
1714640121065,LIGM 5A,A00,507421,Fischer-Grunski; Eva K,18,0,20,2
1714640122089,LIGM 5B,A00,507423,Fischer-Grunski; Eva K,19,0,20,1
1714640123118,LIGM 5C,A00,507425,Fischer-Grunski; Eva K,19,0,20,1
1714640124149,LIIT 5AS,A00,507427,Carnelos; Chiara,20,0,20,0
1714640125176,LIIT 5BS,A00,507430,Carnelos; Chiara,20,0,20,0
1714640126203,LIIT 5CS,A00,507432,Carnelos; Chiara,20,0,20,0
1714640127240,LISP 5A,A00,507541,Munoz Sanchez; Alicia,11,0,20,9
1714640128266,LISP 5B,A00,507671,Munoz Sanchez; Alicia,8,0,20,12
1714640129293,LISP 5C,A00,507696,Munoz Sanchez; Alicia,9,0,20,11
1714640130319,MAE 197,001,528363,Boechler; Nicholas Sebastia,9998,0,9999,1
1714640131347,MATH 197,001,523477,Kedlaya; Kiran S.,9995,0,9999,4
1714640131347,MATH 197,002,563811,Zhang; Danna,9995,0,9999,4
1714640131347,MATH 197,003,628552,Dumitriu; Ioana,9998,0,9999,1
1714640132378,MCWP 40R,A00,518780,Staff,2,0,20,18
1714640132378,MCWP 40R,B00,518781,Staff,8,0,20,12
1714640132378,MCWP 40R,C00,518783,Staff,6,0,20,14
1714640133403,MCWP 50R,A00,518791,Staff,0,0,20,20
1714640133403,MCWP 50R,B00,518792,Staff,0,2,20,20
1714640133403,MCWP 50R,C00,518793,Staff,0,2,20,20
1714640133403,MCWP 50R,D00,518794,Staff,0,1,20,20
1714640133403,MCWP 50R,E00,518795,Staff,0,2,20,20
1714640133403,MCWP 50R,F00,518796,Staff,0,0,20,20
1714640133403,MCWP 50R,G00,518797,Staff,0,1,20,20
1714640134428,MMW 12R,A01,514034,Herbst; Matthew,0,0,16,16
1714640134428,MMW 12R,A02,514035,Herbst; Matthew,1,0,16,15
1714640135459,MMW 13R,A01,514037,Staff,0,4,16,16
1714640135459,MMW 13R,A02,514039,Staff,0,2,16,16
1714640135459,MMW 13R,A03,628519,Staff,0,2,16,16
1714640137512,SIO 295LS,A00,523233,Staff,10,0,30,20
1714640138540,SIO 295S,A00,523232,Staff,10,0,30,20
1714640139565,SIOC 290S,A01,637330,Merrifield; Mark A,23,0,30,7
1714640140592,SIOC 291S,A01,637333,Gabriel; Corey John,23,0,30,7
1714640141617,SOCI 117,A01,494376,Staff,0,4,5,5
1714640142645,WES 237B,A00,494380,Staff,9,0,20,11
1714640144726,AESE 279B,A00,494370,Wade; Jon P,0,0,33,33
1714640145751,AIP 197,001,627712,Vespa; Emanuel Ignacio,9998,0,9999,1
1714640146776,ANAR 135S,A00,494369,Braswell; Geoffrey E.,0,0,0,0
1714640147802,BENG 196,001,628496,Engler; Adam J.,9998,0,9999,1
1714640148827,CAT 124RS,A01,519847,Geibel; William,0,0,20,20
1714640149853,CAT 125RS,A01,515971,Geibel; William,0,0,20,20
1714640150883,CLRE 250,A00,511389,Morris; Sheldon,9993,0,9999,6
1714640151911,CLRE 251,A00,507176,Mehta; Ravindra L.,9993,0,9999,6
1714640151911,CLRE 251,B00,511410,Mehta; Ravindra L.,9998,0,9999,1
1714640152936,CLRE 252,A00,507189,Cuomo; Raphael Eduardo,9995,0,9999,4
1714640153961,CLRE 253,A00,507199,Vaida; Florin,9994,0,9999,5
1714640153961,CLRE 253,B00,507202,Vaida; Florin,9999,0,9999,0
1714640154987,CLRE 259,A00,507211,Patel; Hemal,9996,0,9999,3
1714640156016,CLRE 260,A00,507221,Cuomo; Raphael Eduardo,9999,0,9999,0
1714640157044,CLRE 297,001,507242,Cuomo; Raphael Eduardo,9999,0,9999,0
1714640158069,COGS 197,001,638244,Voytek; Bradley Thomas,9998,0,9999,1
1714640159095,CSE 191,A00,516875,Minnes Kemp; Mor Mia,9992,0,9999,7
1714640160121,CSE 197,001,637388,Minnes Kemp; Mor Mia,9998,0,9999,1
1714640161150,CSS 201S,A01,494383,Staff,35,0,35,0
1714640162176,CSS 202S,A01,494387,Staff,35,0,35,0
1714640163202,DSC 197,001,628532,Eldridge; Justin Matthew,9996,0,9999,3
1714640164241,EAP 100,A00,516065,Staff,9797,0,9999,202
1714640165268,ECE 45,A01,507414,Staff,33,0,60,27
1714640167323,ECE 111,A01,507420,Staff,15,0,50,35
1714640168348,ECE 197,001,548057,Sievenpiper; Daniel F.,9993,0,9999,6
1714640169376,EDS 115,A00,507243,Choi; Bailey Miyeon,10,0,28,18
1714640170400,EDS 117,A01,494379,Staff,0,4,30,30
1714640171426,EDS 125,A00,507246,Hopkins; Megan Beth,9,0,30,21
1714640172456,EDS 128A,A01,507264,Fargason; Sharon Gayle,8,0,26,18
1714640173486,EDS 128B,A01,507293,Pappas; Elizabeth,12,0,30,18
1714640174511,EDS 139,A00,507294,Fargason; Sharon Gayle,13,0,30,17
1714640174511,EDS 139,B00,507313,Pappas; Elizabeth,13,0,30,17
1714640175540,EDS 201,A00,507315,Staff,13,0,30,17
1714640176568,EDS 203,A01,507317,Halter; Christopher P.,12,0,30,18
1714640177598,EDS 204R,A01,507319,Halter; Christopher P.,0,3,30,30
1714640177598,EDS 204R,B01,507331,Heinzman; Erica M.,16,0,30,14
1714640178627,EDS 206R,A00,507332,Staff,0,4,30,30
1714640178627,EDS 206R,B00,507343,Staff,17,0,30,13
1714640179650,EDS 250,A00,507344,Hemans; Patricia Ann Benitez,22,0,40,18
1714640180674,EDS 281,A00,507345,Daly; Alan J.,18,0,18,0
1714640181698,EDS 284,A00,507350,Daly; Alan J.,16,0,16,0
1714640182727,EDS 286,A00,507359,Fine; Sarah,18,0,18,0
1714640183752,EDS 289C,A01,507361,Daly; Alan J.,18,0,18,0
1714640184777,EDS 290,A00,507366,Hofstetter; Carolyn,15,0,15,0
1714640185808,LIGM 5A,A00,507421,Fischer-Grunski; Eva K,18,0,20,2
1714640186837,LIGM 5B,A00,507423,Fischer-Grunski; Eva K,19,0,20,1
1714640187866,LIGM 5C,A00,507425,Fischer-Grunski; Eva K,19,0,20,1
1714640188892,LIIT 5AS,A00,507427,Carnelos; Chiara,20,0,20,0
1714640189977,LIIT 5BS,A00,507430,Carnelos; Chiara,20,0,20,0
1714640191003,LIIT 5CS,A00,507432,Carnelos; Chiara,20,0,20,0
1714640192032,LISP 5A,A00,507541,Munoz Sanchez; Alicia,11,0,20,9
1714640193063,LISP 5B,A00,507671,Munoz Sanchez; Alicia,8,0,20,12
1714640194090,LISP 5C,A00,507696,Munoz Sanchez; Alicia,9,0,20,11
1714640195116,MAE 197,001,528363,Boechler; Nicholas Sebastia,9998,0,9999,1
1714640196143,MATH 197,001,523477,Kedlaya; Kiran S.,9995,0,9999,4
1714640196143,MATH 197,002,563811,Zhang; Danna,9995,0,9999,4
1714640196143,MATH 197,003,628552,Dumitriu; Ioana,9998,0,9999,1
1714640197173,MCWP 40R,A00,518780,Staff,2,0,20,18
1714640197173,MCWP 40R,B00,518781,Staff,8,0,20,12
1714640197173,MCWP 40R,C00,518783,Staff,6,0,20,14
1714640198203,MCWP 50R,A00,518791,Staff,0,0,20,20
1714640198203,MCWP 50R,B00,518792,Staff,0,2,20,20
1714640198203,MCWP 50R,C00,518793,Staff,0,2,20,20
1714640198203,MCWP 50R,D00,518794,Staff,0,1,20,20
1714640198203,MCWP 50R,E00,518795,Staff,0,2,20,20
1714640198203,MCWP 50R,F00,518796,Staff,0,0,20,20
1714640198203,MCWP 50R,G00,518797,Staff,0,1,20,20
1714640199233,MMW 12R,A01,514034,Herbst; Matthew,0,0,16,16
1714640199233,MMW 12R,A02,514035,Herbst; Matthew,1,0,16,15
1714640200260,MMW 13R,A01,514037,Staff,0,4,16,16
1714640200260,MMW 13R,A02,514039,Staff,0,2,16,16
1714640200260,MMW 13R,A03,628519,Staff,0,2,16,16
1714640202314,SIO 295LS,A00,523233,Staff,10,0,30,20
1714640203340,SIO 295S,A00,523232,Staff,10,0,30,20
1714640204367,SIOC 290S,A01,637330,Merrifield; Mark A,23,0,30,7
1714640205392,SIOC 291S,A01,637333,Gabriel; Corey John,23,0,30,7
1714640206422,SOCI 117,A01,494376,Staff,0,4,5,5
1714640207450,WES 237B,A00,494380,Staff,9,0,20,11
1714640209535,AESE 279B,A00,494370,Wade; Jon P,0,0,33,33
1714640210564,AIP 197,001,627712,Vespa; Emanuel Ignacio,9998,0,9999,1
1714640211592,ANAR 135S,A00,494369,Braswell; Geoffrey E.,0,0,0,0
1714640212617,BENG 196,001,628496,Engler; Adam J.,9998,0,9999,1
1714640213648,CAT 124RS,A01,519847,Geibel; William,0,0,20,20
1714640214679,CAT 125RS,A01,515971,Geibel; William,0,0,20,20
1714640215706,CLRE 250,A00,511389,Morris; Sheldon,9993,0,9999,6
1714640216737,CLRE 251,A00,507176,Mehta; Ravindra L.,9993,0,9999,6
1714640216737,CLRE 251,B00,511410,Mehta; Ravindra L.,9998,0,9999,1
1714640217763,CLRE 252,A00,507189,Cuomo; Raphael Eduardo,9995,0,9999,4
1714640218793,CLRE 253,A00,507199,Vaida; Florin,9994,0,9999,5
1714640218793,CLRE 253,B00,507202,Vaida; Florin,9999,0,9999,0
1714640219818,CLRE 259,A00,507211,Patel; Hemal,9996,0,9999,3
1714640220843,CLRE 260,A00,507221,Cuomo; Raphael Eduardo,9999,0,9999,0
1714640221868,CLRE 297,001,507242,Cuomo; Raphael Eduardo,9999,0,9999,0
1714640222894,COGS 197,001,638244,Voytek; Bradley Thomas,9998,0,9999,1
1714640223921,CSE 191,A00,516875,Minnes Kemp; Mor Mia,9992,0,9999,7
1714640224945,CSE 197,001,637388,Minnes Kemp; Mor Mia,9998,0,9999,1
1714640225974,CSS 201S,A01,494383,Staff,35,0,35,0
1714640227004,CSS 202S,A01,494387,Staff,35,0,35,0
1714640228031,DSC 197,001,628532,Eldridge; Justin Matthew,9996,0,9999,3
1714640229057,EAP 100,A00,516065,Staff,9797,0,9999,202
1714640230082,ECE 45,A01,507414,Staff,33,0,60,27
1714640232134,ECE 111,A01,507420,Staff,15,0,50,35
1714640233163,ECE 197,001,548057,Sievenpiper; Daniel F.,9993,0,9999,6
1714640234193,EDS 115,A00,507243,Choi; Bailey Miyeon,10,0,28,18
1714640235220,EDS 117,A01,494379,Staff,0,4,30,30
1714640236246,EDS 125,A00,507246,Hopkins; Megan Beth,9,0,30,21
1714640237274,EDS 128A,A01,507264,Fargason; Sharon Gayle,8,0,26,18
1714640238299,EDS 128B,A01,507293,Pappas; Elizabeth,12,0,30,18
1714640239327,EDS 139,A00,507294,Fargason; Sharon Gayle,13,0,30,17
1714640239327,EDS 139,B00,507313,Pappas; Elizabeth,13,0,30,17
1714640240352,EDS 201,A00,507315,Staff,13,0,30,17
1714640241380,EDS 203,A01,507317,Halter; Christopher P.,12,0,30,18
1714640242409,EDS 204R,A01,507319,Halter; Christopher P.,0,3,30,30
1714640242409,EDS 204R,B01,507331,Heinzman; Erica M.,16,0,30,14
1714640243434,EDS 206R,A00,507332,Staff,0,4,30,30
1714640243434,EDS 206R,B00,507343,Staff,17,0,30,13
1714640244461,EDS 250,A00,507344,Hemans; Patricia Ann Benitez,22,0,40,18
1714640245486,EDS 281,A00,507345,Daly; Alan J.,18,0,18,0
1714640246511,EDS 284,A00,507350,Daly; Alan J.,16,0,16,0
1714640247536,EDS 286,A00,507359,Fine; Sarah,18,0,18,0
1714640248564,EDS 289C,A01,507361,Daly; Alan J.,18,0,18,0
1714640249592,EDS 290,A00,507366,Hofstetter; Carolyn,15,0,15,0
1714640250621,LIGM 5A,A00,507421,Fischer-Grunski; Eva K,18,0,20,2
1714640251644,LIGM 5B,A00,507423,Fischer-Grunski; Eva K,19,0,20,1
1714640252675,LIGM 5C,A00,507425,Fischer-Grunski; Eva K,19,0,20,1
1714640253702,LIIT 5AS,A00,507427,Carnelos; Chiara,20,0,20,0
1714640254726,LIIT 5BS,A00,507430,Carnelos; Chiara,20,0,20,0
1714640255749,LIIT 5CS,A00,507432,Carnelos; Chiara,20,0,20,0
1714640256774,LISP 5A,A00,507541,Munoz Sanchez; Alicia,11,0,20,9
1714640257801,LISP 5B,A00,507671,Munoz Sanchez; Alicia,8,0,20,12
1714640258828,LISP 5C,A00,507696,Munoz Sanchez; Alicia,9,0,20,11
1714640259855,MAE 197,001,528363,Boechler; Nicholas Sebastia,9998,0,9999,1
1714640260882,MATH 197,001,523477,Kedlaya; Kiran S.,9995,0,9999,4
1714640260882,MATH 197,002,563811,Zhang; Danna,9995,0,9999,4
1714640260882,MATH 197,003,628552,Dumitriu; Ioana,9998,0,9999,1
1714640261910,MCWP 40R,A00,518780,Staff,2,0,20,18
1714640261910,MCWP 40R,B00,518781,Staff,8,0,20,12
1714640261910,MCWP 40R,C00,518783,Staff,6,0,20,14
1714640262940,MCWP 50R,A00,518791,Staff,0,0,20,20
1714640262940,MCWP 50R,B00,518792,Staff,0,2,20,20
1714640262940,MCWP 50R,C00,518793,Staff,0,2,20,20
1714640262940,MCWP 50R,D00,518794,Staff,0,1,20,20
1714640262940,MCWP 50R,E00,518795,Staff,0,2,20,20
1714640262940,MCWP 50R,F00,518796,Staff,0,0,20,20
1714640262940,MCWP 50R,G00,518797,Staff,0,1,20,20
1714640263966,MMW 12R,A01,514034,Herbst; Matthew,0,0,16,16
1714640263966,MMW 12R,A02,514035,Herbst; Matthew,1,0,16,15
1714640264993,MMW 13R,A01,514037,Staff,0,4,16,16
1714640264993,MMW 13R,A02,514039,Staff,0,2,16,16
1714640264993,MMW 13R,A03,628519,Staff,0,2,16,16
1714640267043,SIO 295LS,A00,523233,Staff,10,0,30,20
1714640268068,SIO 295S,A00,523232,Staff,10,0,30,20
1714640269098,SIOC 290S,A01,637330,Merrifield; Mark A,23,0,30,7
1714640270125,SIOC 291S,A01,637333,Gabriel; Corey John,23,0,30,7
1714640271150,SOCI 117,A01,494376,Staff,0,4,5,5
1714640272176,WES 237B,A00,494380,Staff,9,0,20,11
1714640274247,AESE 279B,A00,494370,Wade; Jon P,0,0,33,33
1714640275275,AIP 197,001,627712,Vespa; Emanuel Ignacio,9998,0,9999,1
1714640276305,ANAR 135S,A00,494369,Braswell; Geoffrey E.,0,0,0,0
1714640277331,BENG 196,001,628496,Engler; Adam J.,9998,0,9999,1
1714640278357,CAT 124RS,A01,519847,Geibel; William,0,0,20,20
1714640279385,CAT 125RS,A01,515971,Geibel; William,0,0,20,20
1714640280410,CLRE 250,A00,511389,Morris; Sheldon,9993,0,9999,6
1714640281437,CLRE 251,A00,507176,Mehta; Ravindra L.,9993,0,9999,6
1714640281437,CLRE 251,B00,511410,Mehta; Ravindra L.,9998,0,9999,1
1714640282464,CLRE 252,A00,507189,Cuomo; Raphael Eduardo,9995,0,9999,4
1714640283490,CLRE 253,A00,507199,Vaida; Florin,9994,0,9999,5
1714640283490,CLRE 253,B00,507202,Vaida; Florin,9999,0,9999,0
1714640284514,CLRE 259,A00,507211,Patel; Hemal,9996,0,9999,3
1714640285538,CLRE 260,A00,507221,Cuomo; Raphael Eduardo,9999,0,9999,0
1714640286563,CLRE 297,001,507242,Cuomo; Raphael Eduardo,9999,0,9999,0
1714640287592,COGS 197,001,638244,Voytek; Bradley Thomas,9998,0,9999,1
1714640288619,CSE 191,A00,516875,Minnes Kemp; Mor Mia,9992,0,9999,7
1714640289644,CSE 197,001,637388,Minnes Kemp; Mor Mia,9998,0,9999,1
1714640290672,CSS 201S,A01,494383,Staff,35,0,35,0
1714640291698,CSS 202S,A01,494387,Staff,35,0,35,0
1714640292727,DSC 197,001,628532,Eldridge; Justin Matthew,9996,0,9999,3
1714640293808,EAP 100,A00,516065,Staff,9797,0,9999,202
1714640294837,ECE 45,A01,507414,Staff,33,0,60,27
1714640296890,ECE 111,A01,507420,Staff,15,0,50,35
1714640297917,ECE 197,001,548057,Sievenpiper; Daniel F.,9993,0,9999,6
1714640298946,EDS 115,A00,507243,Choi; Bailey Miyeon,10,0,28,18
1714640299971,EDS 117,A01,494379,Staff,0,4,30,30
1714640300998,EDS 125,A00,507246,Hopkins; Megan Beth,9,0,30,21
1714640302024,EDS 128A,A01,507264,Fargason; Sharon Gayle,8,0,26,18
1714640303048,EDS 128B,A01,507293,Pappas; Elizabeth,12,0,30,18
1714640304071,EDS 139,A00,507294,Fargason; Sharon Gayle,13,0,30,17
1714640304071,EDS 139,B00,507313,Pappas; Elizabeth,13,0,30,17
1714640305097,EDS 201,A00,507315,Staff,13,0,30,17
1714640306123,EDS 203,A01,507317,Halter; Christopher P.,12,0,30,18
1714640307154,EDS 204R,A01,507319,Halter; Christopher P.,0,3,30,30
1714640307154,EDS 204R,B01,507331,Heinzman; Erica M.,16,0,30,14
1714640308180,EDS 206R,A00,507332,Staff,0,4,30,30
1714640308180,EDS 206R,B00,507343,Staff,17,0,30,13
1714640309261,EDS 250,A00,507344,Hemans; Patricia Ann Benitez,22,0,40,18
1714640310289,EDS 281,A00,507345,Daly; Alan J.,18,0,18,0
1714640311313,EDS 284,A00,507350,Daly; Alan J.,16,0,16,0
1714640312339,EDS 286,A00,507359,Fine; Sarah,18,0,18,0
1714640313368,EDS 289C,A01,507361,Daly; Alan J.,18,0,18,0
1714640314392,EDS 290,A00,507366,Hofstetter; Carolyn,15,0,15,0
1714640315421,LIGM 5A,A00,507421,Fischer-Grunski; Eva K,18,0,20,2
1714640316445,LIGM 5B,A00,507423,Fischer-Grunski; Eva K,19,0,20,1
1714640317474,LIGM 5C,A00,507425,Fischer-Grunski; Eva K,19,0,20,1
1714640318505,LIIT 5AS,A00,507427,Carnelos; Chiara,20,0,20,0
1714640319533,LIIT 5BS,A00,507430,Carnelos; Chiara,20,0,20,0
1714640320562,LIIT 5CS,A00,507432,Carnelos; Chiara,20,0,20,0
1714640321593,LISP 5A,A00,507541,Munoz Sanchez; Alicia,11,0,20,9
1714640322622,LISP 5B,A00,507671,Munoz Sanchez; Alicia,8,0,20,12
1714640323653,LISP 5C,A00,507696,Munoz Sanchez; Alicia,9,0,20,11
1714640324680,MAE 197,001,528363,Boechler; Nicholas Sebastia,9998,0,9999,1
1714640325714,MATH 197,001,523477,Kedlaya; Kiran S.,9995,0,9999,4
1714640325714,MATH 197,002,563811,Zhang; Danna,9995,0,9999,4
1714640325714,MATH 197,003,628552,Dumitriu; Ioana,9998,0,9999,1
1714640326738,MCWP 40R,A00,518780,Staff,2,0,20,18
1714640326738,MCWP 40R,B00,518781,Staff,8,0,20,12
1714640326738,MCWP 40R,C00,518783,Staff,6,0,20,14
1714640327768,MCWP 50R,A00,518791,Staff,0,0,20,20
1714640327768,MCWP 50R,B00,518792,Staff,0,2,20,20
1714640327768,MCWP 50R,C00,518793,Staff,0,2,20,20
1714640327768,MCWP 50R,D00,518794,Staff,0,1,20,20
1714640327768,MCWP 50R,E00,518795,Staff,0,2,20,20
1714640327768,MCWP 50R,F00,518796,Staff,0,0,20,20
1714640327768,MCWP 50R,G00,518797,Staff,0,1,20,20
1714640328798,MMW 12R,A01,514034,Herbst; Matthew,0,0,16,16
1714640328798,MMW 12R,A02,514035,Herbst; Matthew,1,0,16,15
1714640329826,MMW 13R,A01,514037,Staff,0,4,16,16
1714640329826,MMW 13R,A02,514039,Staff,0,2,16,16
1714640329826,MMW 13R,A03,628519,Staff,0,2,16,16
1714640331882,SIO 295LS,A00,523233,Staff,10,0,30,20
1714640332907,SIO 295S,A00,523232,Staff,10,0,30,20
1714640333935,SIOC 290S,A01,637330,Merrifield; Mark A,23,0,30,7
1714640334961,SIOC 291S,A01,637333,Gabriel; Corey John,23,0,30,7
1714640335986,SOCI 117,A01,494376,Staff,0,4,5,5
1714640337012,WES 237B,A00,494380,Staff,9,0,20,11
1714640339087,AESE 279B,A00,494370,Wade; Jon P,0,0,33,33
1714640340117,AIP 197,001,627712,Vespa; Emanuel Ignacio,9998,0,9999,1
1714640341145,ANAR 135S,A00,494369,Braswell; Geoffrey E.,0,0,0,0
1714640342172,BENG 196,001,628496,Engler; Adam J.,9998,0,9999,1
1714640343197,CAT 124RS,A01,519847,Geibel; William,0,0,20,20
1714640344222,CAT 125RS,A01,515971,Geibel; William,0,0,20,20
1714640345248,CLRE 250,A00,511389,Morris; Sheldon,9993,0,9999,6
1714640346280,CLRE 251,A00,507176,Mehta; Ravindra L.,9993,0,9999,6
1714640346280,CLRE 251,B00,511410,Mehta; Ravindra L.,9998,0,9999,1
1714640347305,CLRE 252,A00,507189,Cuomo; Raphael Eduardo,9995,0,9999,4
1714640348331,CLRE 253,A00,507199,Vaida; Florin,9994,0,9999,5
1714640348331,CLRE 253,B00,507202,Vaida; Florin,9999,0,9999,0
1714640349358,CLRE 259,A00,507211,Patel; Hemal,9996,0,9999,3
1714640350387,CLRE 260,A00,507221,Cuomo; Raphael Eduardo,9999,0,9999,0
1714640351413,CLRE 297,001,507242,Cuomo; Raphael Eduardo,9999,0,9999,0
1714640352444,COGS 197,001,638244,Voytek; Bradley Thomas,9998,0,9999,1
1714640353472,CSE 191,A00,516875,Minnes Kemp; Mor Mia,9992,0,9999,7
1714640354498,CSE 197,001,637388,Minnes Kemp; Mor Mia,9998,0,9999,1
1714640355525,CSS 201S,A01,494383,Staff,35,0,35,0
1714640356552,CSS 202S,A01,494387,Staff,35,0,35,0
1714640357579,DSC 197,001,628532,Eldridge; Justin Matthew,9996,0,9999,3
1714640358609,EAP 100,A00,516065,Staff,9797,0,9999,202
1714640359638,ECE 45,A01,507414,Staff,33,0,60,27
1714640361686,ECE 111,A01,507420,Staff,15,0,50,35
1714640362714,ECE 197,001,548057,Sievenpiper; Daniel F.,9993,0,9999,6
1714640363742,EDS 115,A00,507243,Choi; Bailey Miyeon,10,0,28,18
1714640364771,EDS 117,A01,494379,Staff,0,4,30,30
1714640365805,EDS 125,A00,507246,Hopkins; Megan Beth,9,0,30,21
1714640366830,EDS 128A,A01,507264,Fargason; Sharon Gayle,8,0,26,18
1714640367853,EDS 128B,A01,507293,Pappas; Elizabeth,12,0,30,18
1714640368877,EDS 139,A00,507294,Fargason; Sharon Gayle,13,0,30,17
1714640368877,EDS 139,B00,507313,Pappas; Elizabeth,13,0,30,17
1714640369901,EDS 201,A00,507315,Staff,13,0,30,17
1714640370927,EDS 203,A01,507317,Halter; Christopher P.,12,0,30,18
1714640371957,EDS 204R,A01,507319,Halter; Christopher P.,0,3,30,30
1714640371957,EDS 204R,B01,507331,Heinzman; Erica M.,16,0,30,14
1714640372982,EDS 206R,A00,507332,Staff,0,4,30,30
1714640372982,EDS 206R,B00,507343,Staff,17,0,30,13
1714640374009,EDS 250,A00,507344,Hemans; Patricia Ann Benitez,22,0,40,18
1714640375033,EDS 281,A00,507345,Daly; Alan J.,18,0,18,0
1714640376058,EDS 284,A00,507350,Daly; Alan J.,16,0,16,0
1714640377085,EDS 286,A00,507359,Fine; Sarah,18,0,18,0
1714640378110,EDS 289C,A01,507361,Daly; Alan J.,18,0,18,0
1714640379138,EDS 290,A00,507366,Hofstetter; Carolyn,15,0,15,0
1714640380166,LIGM 5A,A00,507421,Fischer-Grunski; Eva K,18,0,20,2
1714640381193,LIGM 5B,A00,507423,Fischer-Grunski; Eva K,19,0,20,1
1714640382219,LIGM 5C,A00,507425,Fischer-Grunski; Eva K,19,0,20,1
1714640383246,LIIT 5AS,A00,507427,Carnelos; Chiara,20,0,20,0
1714640384271,LIIT 5BS,A00,507430,Carnelos; Chiara,20,0,20,0
1714640385296,LIIT 5CS,A00,507432,Carnelos; Chiara,20,0,20,0
1714640386324,LISP 5A,A00,507541,Munoz Sanchez; Alicia,11,0,20,9
1714640387353,LISP 5B,A00,507671,Munoz Sanchez; Alicia,8,0,20,12
1714640388384,LISP 5C,A00,507696,Munoz Sanchez; Alicia,9,0,20,11
1714640389409,MAE 197,001,528363,Boechler; Nicholas Sebastia,9998,0,9999,1
1714640390436,MATH 197,001,523477,Kedlaya; Kiran S.,9995,0,9999,4
1714640390436,MATH 197,002,563811,Zhang; Danna,9995,0,9999,4
1714640390436,MATH 197,003,628552,Dumitriu; Ioana,9998,0,9999,1
1714640391464,MCWP 40R,A00,518780,Staff,2,0,20,18
1714640391464,MCWP 40R,B00,518781,Staff,8,0,20,12
1714640391464,MCWP 40R,C00,518783,Staff,6,0,20,14
1714640392511,MCWP 50R,A00,518791,Staff,0,0,20,20
1714640392511,MCWP 50R,B00,518792,Staff,0,2,20,20
1714640392511,MCWP 50R,C00,518793,Staff,0,2,20,20
1714640392511,MCWP 50R,D00,518794,Staff,0,1,20,20
1714640392511,MCWP 50R,E00,518795,Staff,0,2,20,20
1714640392511,MCWP 50R,F00,518796,Staff,0,0,20,20
1714640392511,MCWP 50R,G00,518797,Staff,0,1,20,20
1714640393542,MMW 12R,A01,514034,Herbst; Matthew,0,0,16,16
1714640393542,MMW 12R,A02,514035,Herbst; Matthew,1,0,16,15
1714640394569,MMW 13R,A01,514037,Staff,0,4,16,16
1714640394569,MMW 13R,A02,514039,Staff,0,2,16,16
1714640394569,MMW 13R,A03,628519,Staff,0,2,16,16
1714640396617,SIO 295LS,A00,523233,Staff,10,0,30,20
1714640397642,SIO 295S,A00,523232,Staff,10,0,30,20
1714640398669,SIOC 290S,A01,637330,Merrifield; Mark A,23,0,30,7
1714640399700,SIOC 291S,A01,637333,Gabriel; Corey John,23,0,30,7
1714640400725,SOCI 117,A01,494376,Staff,0,4,5,5
1714640401761,WES 237B,A00,494380,Staff,9,0,20,11
1714640403832,AESE 279B,A00,494370,Wade; Jon P,0,0,33,33
1714640404855,AIP 197,001,627712,Vespa; Emanuel Ignacio,9998,0,9999,1
1714640405884,ANAR 135S,A00,494369,Braswell; Geoffrey E.,0,0,0,0
1714640406912,BENG 196,001,628496,Engler; Adam J.,9998,0,9999,1
1714640407941,CAT 124RS,A01,519847,Geibel; William,0,0,20,20
1714640408968,CAT 125RS,A01,515971,Geibel; William,0,0,20,20
1714640409993,CLRE 250,A00,511389,Morris; Sheldon,9993,0,9999,6
1714640411019,CLRE 251,A00,507176,Mehta; Ravindra L.,9993,0,9999,6
1714640411019,CLRE 251,B00,511410,Mehta; Ravindra L.,9998,0,9999,1
1714640412049,CLRE 252,A00,507189,Cuomo; Raphael Eduardo,9995,0,9999,4
1714640413078,CLRE 253,A00,507199,Vaida; Florin,9994,0,9999,5
1714640413078,CLRE 253,B00,507202,Vaida; Florin,9999,0,9999,0
1714640414105,CLRE 259,A00,507211,Patel; Hemal,9996,0,9999,3
1714640415130,CLRE 260,A00,507221,Cuomo; Raphael Eduardo,9999,0,9999,0
1714640416154,CLRE 297,001,507242,Cuomo; Raphael Eduardo,9999,0,9999,0
1714640417184,COGS 197,001,638244,Voytek; Bradley Thomas,9998,0,9999,1
1714640418215,CSE 191,A00,516875,Minnes Kemp; Mor Mia,9992,0,9999,7
1714640419244,CSE 197,001,637388,Minnes Kemp; Mor Mia,9998,0,9999,1
1714640420269,CSS 201S,A01,494383,Staff,35,0,35,0
1714640421296,CSS 202S,A01,494387,Staff,35,0,35,0
1714640422322,DSC 197,001,628532,Eldridge; Justin Matthew,9996,0,9999,3
1714640423346,EAP 100,A00,516065,Staff,9797,0,9999,202
1714640424371,ECE 45,A01,507414,Staff,33,0,60,27
1714640426422,ECE 111,A01,507420,Staff,15,0,50,35
1714640427447,ECE 197,001,548057,Sievenpiper; Daniel F.,9993,0,9999,6
1714640428478,EDS 115,A00,507243,Choi; Bailey Miyeon,10,0,28,18
1714640429505,EDS 117,A01,494379,Staff,0,4,30,30
1714640430531,EDS 125,A00,507246,Hopkins; Megan Beth,9,0,30,21
1714640431556,EDS 128A,A01,507264,Fargason; Sharon Gayle,8,0,26,18
1714640432582,EDS 128B,A01,507293,Pappas; Elizabeth,12,0,30,18
1714640433609,EDS 139,A00,507294,Fargason; Sharon Gayle,13,0,30,17
1714640433609,EDS 139,B00,507313,Pappas; Elizabeth,13,0,30,17
1714640434846,EDS 201,A00,507315,Staff,13,0,30,17
1714640435874,EDS 203,A01,507317,Halter; Christopher P.,12,0,30,18
1714640436956,EDS 204R,A01,507319,Halter; Christopher P.,0,3,30,30
1714640436956,EDS 204R,B01,507331,Heinzman; Erica M.,16,0,30,14
1714640437984,EDS 206R,A00,507332,Staff,0,4,30,30
1714640437984,EDS 206R,B00,507343,Staff,17,0,30,13
1714640439011,EDS 250,A00,507344,Hemans; Patricia Ann Benitez,22,0,40,18
1714640440040,EDS 281,A00,507345,Daly; Alan J.,18,0,18,0
1714640441065,EDS 284,A00,507350,Daly; Alan J.,16,0,16,0
1714640442092,EDS 286,A00,507359,Fine; Sarah,18,0,18,0
1714640443120,EDS 289C,A01,507361,Daly; Alan J.,18,0,18,0
1714640444144,EDS 290,A00,507366,Hofstetter; Carolyn,15,0,15,0
1714640445177,LIGM 5A,A00,507421,Fischer-Grunski; Eva K,18,0,20,2
1714640446202,LIGM 5B,A00,507423,Fischer-Grunski; Eva K,19,0,20,1
1714640447226,LIGM 5C,A00,507425,Fischer-Grunski; Eva K,19,0,20,1
1714640448257,LIIT 5AS,A00,507427,Carnelos; Chiara,20,0,20,0
1714640449282,LIIT 5BS,A00,507430,Carnelos; Chiara,20,0,20,0
1714640450311,LIIT 5CS,A00,507432,Carnelos; Chiara,20,0,20,0
1714640451338,LISP 5A,A00,507541,Munoz Sanchez; Alicia,11,0,20,9
1714640452363,LISP 5B,A00,507671,Munoz Sanchez; Alicia,8,0,20,12
1714640453391,LISP 5C,A00,507696,Munoz Sanchez; Alicia,9,0,20,11
1714640454416,MAE 197,001,528363,Boechler; Nicholas Sebastia,9998,0,9999,1
1714640455445,MATH 197,001,523477,Kedlaya; Kiran S.,9995,0,9999,4
1714640455445,MATH 197,002,563811,Zhang; Danna,9995,0,9999,4
1714640455445,MATH 197,003,628552,Dumitriu; Ioana,9998,0,9999,1
1714640456470,MCWP 40R,A00,518780,Staff,2,0,20,18
1714640456470,MCWP 40R,B00,518781,Staff,8,0,20,12
1714640456470,MCWP 40R,C00,518783,Staff,6,0,20,14
1714640457495,MCWP 50R,A00,518791,Staff,0,0,20,20
1714640457495,MCWP 50R,B00,518792,Staff,0,2,20,20
1714640457495,MCWP 50R,C00,518793,Staff,0,2,20,20
1714640457495,MCWP 50R,D00,518794,Staff,0,1,20,20
1714640457495,MCWP 50R,E00,518795,Staff,0,2,20,20
1714640457495,MCWP 50R,F00,518796,Staff,0,0,20,20
1714640457495,MCWP 50R,G00,518797,Staff,0,1,20,20
1714640458522,MMW 12R,A01,514034,Herbst; Matthew,0,0,16,16
1714640458522,MMW 12R,A02,514035,Herbst; Matthew,1,0,16,15
1714640459547,MMW 13R,A01,514037,Staff,0,4,16,16
1714640459547,MMW 13R,A02,514039,Staff,0,2,16,16
1714640459547,MMW 13R,A03,628519,Staff,0,2,16,16
1714640461604,SIO 295LS,A00,523233,Staff,10,0,30,20
1714640462628,SIO 295S,A00,523232,Staff,10,0,30,20
1714640463656,SIOC 290S,A01,637330,Merrifield; Mark A,23,0,30,7
1714640464680,SIOC 291S,A01,637333,Gabriel; Corey John,23,0,30,7
1714640465706,SOCI 117,A01,494376,Staff,0,4,5,5
1714640466737,WES 237B,A00,494380,Staff,9,0,20,11
1714640468809,AESE 279B,A00,494370,Wade; Jon P,0,0,33,33
1714640469835,AIP 197,001,627712,Vespa; Emanuel Ignacio,9998,0,9999,1
1714640470866,ANAR 135S,A00,494369,Braswell; Geoffrey E.,0,0,0,0
1714640471893,BENG 196,001,628496,Engler; Adam J.,9998,0,9999,1
1714640472919,CAT 124RS,A01,519847,Geibel; William,0,0,20,20
1714640473944,CAT 125RS,A01,515971,Geibel; William,0,0,20,20
1714640474974,CLRE 250,A00,511389,Morris; Sheldon,9993,0,9999,6
1714640476001,CLRE 251,A00,507176,Mehta; Ravindra L.,9993,0,9999,6
1714640476001,CLRE 251,B00,511410,Mehta; Ravindra L.,9998,0,9999,1
1714640477033,CLRE 252,A00,507189,Cuomo; Raphael Eduardo,9995,0,9999,4
1714640478065,CLRE 253,A00,507199,Vaida; Florin,9994,0,9999,5
1714640478065,CLRE 253,B00,507202,Vaida; Florin,9999,0,9999,0
1714640479092,CLRE 259,A00,507211,Patel; Hemal,9996,0,9999,3
1714640480119,CLRE 260,A00,507221,Cuomo; Raphael Eduardo,9999,0,9999,0
1714640481146,CLRE 297,001,507242,Cuomo; Raphael Eduardo,9999,0,9999,0
1714640482172,COGS 197,001,638244,Voytek; Bradley Thomas,9998,0,9999,1
1714640483203,CSE 191,A00,516875,Minnes Kemp; Mor Mia,9992,0,9999,7
1714640484228,CSE 197,001,637388,Minnes Kemp; Mor Mia,9998,0,9999,1
1714640485253,CSS 201S,A01,494383,Staff,35,0,35,0
1714640486284,CSS 202S,A01,494387,Staff,35,0,35,0
1714640487308,DSC 197,001,628532,Eldridge; Justin Matthew,9996,0,9999,3
1714640488333,EAP 100,A00,516065,Staff,9797,0,9999,202
1714640489364,ECE 45,A01,507414,Staff,33,0,60,27
1714640491419,ECE 111,A01,507420,Staff,15,0,50,35
1714640492451,ECE 197,001,548057,Sievenpiper; Daniel F.,9993,0,9999,6
1714640493478,EDS 115,A00,507243,Choi; Bailey Miyeon,10,0,28,18
1714640494507,EDS 117,A01,494379,Staff,0,4,30,30
1714640495538,EDS 125,A00,507246,Hopkins; Megan Beth,9,0,30,21
1714640496568,EDS 128A,A01,507264,Fargason; Sharon Gayle,8,0,26,18
1714640497596,EDS 128B,A01,507293,Pappas; Elizabeth,12,0,30,18
1714640498622,EDS 139,A00,507294,Fargason; Sharon Gayle,13,0,30,17
1714640498622,EDS 139,B00,507313,Pappas; Elizabeth,13,0,30,17
1714640499649,EDS 201,A00,507315,Staff,13,0,30,17
1714640500678,EDS 203,A01,507317,Halter; Christopher P.,12,0,30,18
1714640501708,EDS 204R,A01,507319,Halter; Christopher P.,0,3,30,30
1714640501708,EDS 204R,B01,507331,Heinzman; Erica M.,16,0,30,14
1714640502734,EDS 206R,A00,507332,Staff,0,4,30,30
1714640502734,EDS 206R,B00,507343,Staff,17,0,30,13
1714640503760,EDS 250,A00,507344,Hemans; Patricia Ann Benitez,22,0,40,18
1714640504784,EDS 281,A00,507345,Daly; Alan J.,18,0,18,0
1714640505812,EDS 284,A00,507350,Daly; Alan J.,16,0,16,0
1714640506838,EDS 286,A00,507359,Fine; Sarah,18,0,18,0
1714640507865,EDS 289C,A01,507361,Daly; Alan J.,18,0,18,0
1714640508894,EDS 290,A00,507366,Hofstetter; Carolyn,15,0,15,0
1714640509924,LIGM 5A,A00,507421,Fischer-Grunski; Eva K,18,0,20,2
1714640510950,LIGM 5B,A00,507423,Fischer-Grunski; Eva K,19,0,20,1
1714640511979,LIGM 5C,A00,507425,Fischer-Grunski; Eva K,19,0,20,1
1714640513005,LIIT 5AS,A00,507427,Carnelos; Chiara,20,0,20,0
1714640514030,LIIT 5BS,A00,507430,Carnelos; Chiara,20,0,20,0
1714640515058,LIIT 5CS,A00,507432,Carnelos; Chiara,20,0,20,0
1714640516083,LISP 5A,A00,507541,Munoz Sanchez; Alicia,11,0,20,9
1714640517108,LISP 5B,A00,507671,Munoz Sanchez; Alicia,8,0,20,12
1714640518134,LISP 5C,A00,507696,Munoz Sanchez; Alicia,9,0,20,11
1714640519157,MAE 197,001,528363,Boechler; Nicholas Sebastia,9998,0,9999,1
1714640520186,MATH 197,001,523477,Kedlaya; Kiran S.,9995,0,9999,4
1714640520186,MATH 197,002,563811,Zhang; Danna,9995,0,9999,4
1714640520186,MATH 197,003,628552,Dumitriu; Ioana,9998,0,9999,1
1714640521212,MCWP 40R,A00,518780,Staff,2,0,20,18
1714640521212,MCWP 40R,B00,518781,Staff,8,0,20,12
1714640521212,MCWP 40R,C00,518783,Staff,6,0,20,14
1714640522238,MCWP 50R,A00,518791,Staff,0,0,20,20
1714640522238,MCWP 50R,B00,518792,Staff,0,2,20,20
1714640522238,MCWP 50R,C00,518793,Staff,0,2,20,20
1714640522238,MCWP 50R,D00,518794,Staff,0,1,20,20
1714640522238,MCWP 50R,E00,518795,Staff,0,2,20,20
1714640522238,MCWP 50R,F00,518796,Staff,0,0,20,20
1714640522238,MCWP 50R,G00,518797,Staff,0,1,20,20
1714640523264,MMW 12R,A01,514034,Herbst; Matthew,0,0,16,16
1714640523264,MMW 12R,A02,514035,Herbst; Matthew,1,0,16,15
1714640524289,MMW 13R,A01,514037,Staff,0,4,16,16
1714640524289,MMW 13R,A02,514039,Staff,0,2,16,16
1714640524289,MMW 13R,A03,628519,Staff,0,2,16,16
1714640526343,SIO 295LS,A00,523233,Staff,10,0,30,20
1714640527367,SIO 295S,A00,523232,Staff,10,0,30,20
1714640528396,SIOC 290S,A01,637330,Merrifield; Mark A,23,0,30,7
1714640529422,SIOC 291S,A01,637333,Gabriel; Corey John,23,0,30,7
1714640530448,SOCI 117,A01,494376,Staff,0,4,5,5
1714640531474,WES 237B,A00,494380,Staff,9,0,20,11
1714640533559,AESE 279B,A00,494370,Wade; Jon P,0,0,33,33
1714640534588,AIP 197,001,627712,Vespa; Emanuel Ignacio,9998,0,9999,1
1714640535614,ANAR 135S,A00,494369,Braswell; Geoffrey E.,0,0,0,0
1714640536642,BENG 196,001,628496,Engler; Adam J.,9998,0,9999,1
1714640537668,CAT 124RS,A01,519847,Geibel; William,0,0,20,20
1714640538698,CAT 125RS,A01,515971,Geibel; William,0,0,20,20
1714640539724,CLRE 250,A00,511389,Morris; Sheldon,9993,0,9999,6
1714640540823,CLRE 251,A00,507176,Mehta; Ravindra L.,9993,0,9999,6
1714640540823,CLRE 251,B00,511410,Mehta; Ravindra L.,9998,0,9999,1
1714640541854,CLRE 252,A00,507189,Cuomo; Raphael Eduardo,9995,0,9999,4
1714640542882,CLRE 253,A00,507199,Vaida; Florin,9994,0,9999,5
1714640542882,CLRE 253,B00,507202,Vaida; Florin,9999,0,9999,0
1714640543911,CLRE 259,A00,507211,Patel; Hemal,9996,0,9999,3
1714640544936,CLRE 260,A00,507221,Cuomo; Raphael Eduardo,9999,0,9999,0
1714640545965,CLRE 297,001,507242,Cuomo; Raphael Eduardo,9999,0,9999,0
1714640546996,COGS 197,001,638244,Voytek; Bradley Thomas,9998,0,9999,1
1714640548024,CSE 191,A00,516875,Minnes Kemp; Mor Mia,9992,0,9999,7
1714640549049,CSE 197,001,637388,Minnes Kemp; Mor Mia,9998,0,9999,1
1714640550074,CSS 201S,A01,494383,Staff,35,0,35,0
1714640551099,CSS 202S,A01,494387,Staff,35,0,35,0
1714640552122,DSC 197,001,628532,Eldridge; Justin Matthew,9996,0,9999,3
1714640553148,EAP 100,A00,516065,Staff,9797,0,9999,202
1714640554173,ECE 45,A01,507414,Staff,33,0,60,27
1714640556228,ECE 111,A01,507420,Staff,15,0,50,35
1714640557252,ECE 197,001,548057,Sievenpiper; Daniel F.,9993,0,9999,6
1714640558283,EDS 115,A00,507243,Choi; Bailey Miyeon,10,0,28,18
1714640559315,EDS 117,A01,494379,Staff,0,4,30,30
1714640560339,EDS 125,A00,507246,Hopkins; Megan Beth,9,0,30,21
1714640561369,EDS 128A,A01,507264,Fargason; Sharon Gayle,8,0,26,18
1714640562394,EDS 128B,A01,507293,Pappas; Elizabeth,12,0,30,18
1714640563422,EDS 139,A00,507294,Fargason; Sharon Gayle,13,0,30,17
1714640563422,EDS 139,B00,507313,Pappas; Elizabeth,13,0,30,17
1714640564447,EDS 201,A00,507315,Staff,13,0,30,17
1714640565473,EDS 203,A01,507317,Halter; Christopher P.,12,0,30,18
1714640566500,EDS 204R,A01,507319,Halter; Christopher P.,0,3,30,30
1714640566500,EDS 204R,B01,507331,Heinzman; Erica M.,16,0,30,14
1714640567525,EDS 206R,A00,507332,Staff,0,4,30,30
1714640567525,EDS 206R,B00,507343,Staff,17,0,30,13
1714640568552,EDS 250,A00,507344,Hemans; Patricia Ann Benitez,22,0,40,18
1714640569577,EDS 281,A00,507345,Daly; Alan J.,18,0,18,0
1714640570603,EDS 284,A00,507350,Daly; Alan J.,16,0,16,0
1714640571627,EDS 286,A00,507359,Fine; Sarah,18,0,18,0
1714640572653,EDS 289C,A01,507361,Daly; Alan J.,18,0,18,0
1714640573681,EDS 290,A00,507366,Hofstetter; Carolyn,15,0,15,0
1714640574709,LIGM 5A,A00,507421,Fischer-Grunski; Eva K,18,0,20,2
1714640575737,LIGM 5B,A00,507423,Fischer-Grunski; Eva K,19,0,20,1
1714640576762,LIGM 5C,A00,507425,Fischer-Grunski; Eva K,19,0,20,1
1714640577794,LIIT 5AS,A00,507427,Carnelos; Chiara,20,0,20,0
1714640578823,LIIT 5BS,A00,507430,Carnelos; Chiara,20,0,20,0
1714640579852,LIIT 5CS,A00,507432,Carnelos; Chiara,20,0,20,0
1714640580882,LISP 5A,A00,507541,Munoz Sanchez; Alicia,11,0,20,9
1714640581907,LISP 5B,A00,507671,Munoz Sanchez; Alicia,8,0,20,12
1714640582937,LISP 5C,A00,507696,Munoz Sanchez; Alicia,9,0,20,11
1714640583964,MAE 197,001,528363,Boechler; Nicholas Sebastia,9998,0,9999,1
1714640584996,MATH 197,001,523477,Kedlaya; Kiran S.,9995,0,9999,4
1714640584996,MATH 197,002,563811,Zhang; Danna,9995,0,9999,4
1714640584996,MATH 197,003,628552,Dumitriu; Ioana,9998,0,9999,1
1714640586025,MCWP 40R,A00,518780,Staff,2,0,20,18
1714640586025,MCWP 40R,B00,518781,Staff,8,0,20,12
1714640586025,MCWP 40R,C00,518783,Staff,6,0,20,14
1714640587053,MCWP 50R,A00,518791,Staff,0,0,20,20
1714640587053,MCWP 50R,B00,518792,Staff,0,2,20,20
1714640587053,MCWP 50R,C00,518793,Staff,0,2,20,20
1714640587053,MCWP 50R,D00,518794,Staff,0,1,20,20
1714640587053,MCWP 50R,E00,518795,Staff,0,2,20,20
1714640587053,MCWP 50R,F00,518796,Staff,0,0,20,20
1714640587053,MCWP 50R,G00,518797,Staff,0,1,20,20
1714640588078,MMW 12R,A01,514034,Herbst; Matthew,0,0,16,16
1714640588078,MMW 12R,A02,514035,Herbst; Matthew,1,0,16,15
1714640589102,MMW 13R,A01,514037,Staff,0,4,16,16
1714640589102,MMW 13R,A02,514039,Staff,0,2,16,16
1714640589102,MMW 13R,A03,628519,Staff,0,2,16,16
1714640591158,SIO 295LS,A00,523233,Staff,10,0,30,20
1714640592183,SIO 295S,A00,523232,Staff,10,0,30,20
1714640593210,SIOC 290S,A01,637330,Merrifield; Mark A,23,0,30,7
1714640594235,SIOC 291S,A01,637333,Gabriel; Corey John,23,0,30,7
1714640595261,SOCI 117,A01,494376,Staff,0,4,5,5
1714640596286,WES 237B,A00,494380,Staff,9,0,20,11
1714640598359,AESE 279B,A00,494370,Wade; Jon P,0,0,33,33
1714640599386,AIP 197,001,627712,Vespa; Emanuel Ignacio,9998,0,9999,1
1714640600413,ANAR 135S,A00,494369,Braswell; Geoffrey E.,0,0,0,0
1714640601440,BENG 196,001,628496,Engler; Adam J.,9998,0,9999,1
1714640602470,CAT 124RS,A01,519847,Geibel; William,0,0,20,20
1714640603494,CAT 125RS,A01,515971,Geibel; William,0,0,20,20
1714640604520,CLRE 250,A00,511389,Morris; Sheldon,9993,0,9999,6
1714640605552,CLRE 251,A00,507176,Mehta; Ravindra L.,9993,0,9999,6
1714640605552,CLRE 251,B00,511410,Mehta; Ravindra L.,9998,0,9999,1
1714640606582,CLRE 252,A00,507189,Cuomo; Raphael Eduardo,9995,0,9999,4
1714640607609,CLRE 253,A00,507199,Vaida; Florin,9994,0,9999,5
1714640607609,CLRE 253,B00,507202,Vaida; Florin,9999,0,9999,0
1714640608637,CLRE 259,A00,507211,Patel; Hemal,9996,0,9999,3
1714640609661,CLRE 260,A00,507221,Cuomo; Raphael Eduardo,9999,0,9999,0
1714640610689,CLRE 297,001,507242,Cuomo; Raphael Eduardo,9999,0,9999,0
1714640611717,COGS 197,001,638244,Voytek; Bradley Thomas,9998,0,9999,1
1714640612746,CSE 191,A00,516875,Minnes Kemp; Mor Mia,9992,0,9999,7
1714640613771,CSE 197,001,637388,Minnes Kemp; Mor Mia,9998,0,9999,1
1714640614801,CSS 201S,A01,494383,Staff,35,0,35,0
1714640615830,CSS 202S,A01,494387,Staff,35,0,35,0
1714640616858,DSC 197,001,628532,Eldridge; Justin Matthew,9996,0,9999,3
1714640617881,EAP 100,A00,516065,Staff,9797,0,9999,202
1714640618911,ECE 45,A01,507414,Staff,33,0,60,27
1714640620964,ECE 111,A01,507420,Staff,15,0,50,35
1714640621992,ECE 197,001,548057,Sievenpiper; Daniel F.,9993,0,9999,6
1714640623016,EDS 115,A00,507243,Choi; Bailey Miyeon,10,0,28,18
1714640624043,EDS 117,A01,494379,Staff,0,4,30,30
1714640625073,EDS 125,A00,507246,Hopkins; Megan Beth,9,0,30,21
1714640626099,EDS 128A,A01,507264,Fargason; Sharon Gayle,8,0,26,18
1714640627124,EDS 128B,A01,507293,Pappas; Elizabeth,12,0,30,18
1714640628154,EDS 139,A00,507294,Fargason; Sharon Gayle,13,0,30,17
1714640628154,EDS 139,B00,507313,Pappas; Elizabeth,13,0,30,17
1714640629179,EDS 201,A00,507315,Staff,13,0,30,17
1714640630205,EDS 203,A01,507317,Halter; Christopher P.,12,0,30,18
1714640631231,EDS 204R,A01,507319,Halter; Christopher P.,0,3,30,30
1714640631231,EDS 204R,B01,507331,Heinzman; Erica M.,16,0,30,14
1714640632260,EDS 206R,A00,507332,Staff,0,4,30,30
1714640632260,EDS 206R,B00,507343,Staff,17,0,30,13
1714640633288,EDS 250,A00,507344,Hemans; Patricia Ann Benitez,22,0,40,18
1714640634313,EDS 281,A00,507345,Daly; Alan J.,18,0,18,0
1714640635340,EDS 284,A00,507350,Daly; Alan J.,16,0,16,0
1714640636370,EDS 286,A00,507359,Fine; Sarah,18,0,18,0
1714640637398,EDS 289C,A01,507361,Daly; Alan J.,18,0,18,0
1714640638427,EDS 290,A00,507366,Hofstetter; Carolyn,15,0,15,0
1714640639454,LIGM 5A,A00,507421,Fischer-Grunski; Eva K,18,0,20,2
1714640640478,LIGM 5B,A00,507423,Fischer-Grunski; Eva K,19,0,20,1
1714640641504,LIGM 5C,A00,507425,Fischer-Grunski; Eva K,19,0,20,1
1714640642534,LIIT 5AS,A00,507427,Carnelos; Chiara,20,0,20,0
1714640643562,LIIT 5BS,A00,507430,Carnelos; Chiara,20,0,20,0
1714640644640,LIIT 5CS,A00,507432,Carnelos; Chiara,20,0,20,0
1714640645672,LISP 5A,A00,507541,Munoz Sanchez; Alicia,11,0,20,9
1714640646697,LISP 5B,A00,507671,Munoz Sanchez; Alicia,8,0,20,12
1714640647724,LISP 5C,A00,507696,Munoz Sanchez; Alicia,9,0,20,11
1714640648806,MAE 197,001,528363,Boechler; Nicholas Sebastia,9998,0,9999,1
1714640649836,MATH 197,001,523477,Kedlaya; Kiran S.,9995,0,9999,4
1714640649836,MATH 197,002,563811,Zhang; Danna,9995,0,9999,4
1714640649836,MATH 197,003,628552,Dumitriu; Ioana,9998,0,9999,1
1714640650860,MCWP 40R,A00,518780,Staff,2,0,20,18
1714640650860,MCWP 40R,B00,518781,Staff,8,0,20,12
1714640650860,MCWP 40R,C00,518783,Staff,6,0,20,14
1714640651893,MCWP 50R,A00,518791,Staff,0,0,20,20
1714640651893,MCWP 50R,B00,518792,Staff,0,2,20,20
1714640651893,MCWP 50R,C00,518793,Staff,0,2,20,20
1714640651893,MCWP 50R,D00,518794,Staff,0,1,20,20
1714640651893,MCWP 50R,E00,518795,Staff,0,2,20,20
1714640651893,MCWP 50R,F00,518796,Staff,0,0,20,20
1714640651893,MCWP 50R,G00,518797,Staff,0,1,20,20
1714640652921,MMW 12R,A01,514034,Herbst; Matthew,0,0,16,16
1714640652921,MMW 12R,A02,514035,Herbst; Matthew,1,0,16,15
1714640653947,MMW 13R,A01,514037,Staff,0,4,16,16
1714640653947,MMW 13R,A02,514039,Staff,0,2,16,16
1714640653947,MMW 13R,A03,628519,Staff,0,2,16,16
1714640655998,SIO 295LS,A00,523233,Staff,10,0,30,20
1714640657026,SIO 295S,A00,523232,Staff,10,0,30,20
1714640658059,SIOC 290S,A01,637330,Merrifield; Mark A,23,0,30,7
1714640659085,SIOC 291S,A01,637333,Gabriel; Corey John,23,0,30,7
1714640660112,SOCI 117,A01,494376,Staff,0,4,5,5
1714640661140,WES 237B,A00,494380,Staff,9,0,20,11
1714640663224,AESE 279B,A00,494370,Wade; Jon P,0,0,33,33
1714640664255,AIP 197,001,627712,Vespa; Emanuel Ignacio,9998,0,9999,1
1714640665282,ANAR 135S,A00,494369,Braswell; Geoffrey E.,0,0,0,0
1714640666307,BENG 196,001,628496,Engler; Adam J.,9998,0,9999,1
1714640667333,CAT 124RS,A01,519847,Geibel; William,0,0,20,20
1714640668360,CAT 125RS,A01,515971,Geibel; William,0,0,20,20
1714640669389,CLRE 250,A00,511389,Morris; Sheldon,9993,0,9999,6
1714640670416,CLRE 251,A00,507176,Mehta; Ravindra L.,9993,0,9999,6
1714640670416,CLRE 251,B00,511410,Mehta; Ravindra L.,9998,0,9999,1
1714640671441,CLRE 252,A00,507189,Cuomo; Raphael Eduardo,9995,0,9999,4
1714640672466,CLRE 253,A00,507199,Vaida; Florin,9994,0,9999,5
1714640672466,CLRE 253,B00,507202,Vaida; Florin,9999,0,9999,0
1714640673494,CLRE 259,A00,507211,Patel; Hemal,9996,0,9999,3
1714640674523,CLRE 260,A00,507221,Cuomo; Raphael Eduardo,9999,0,9999,0
1714640675550,CLRE 297,001,507242,Cuomo; Raphael Eduardo,9999,0,9999,0
1714640676575,COGS 197,001,638244,Voytek; Bradley Thomas,9998,0,9999,1
1714640677602,CSE 191,A00,516875,Minnes Kemp; Mor Mia,9992,0,9999,7
1714640678628,CSE 197,001,637388,Minnes Kemp; Mor Mia,9998,0,9999,1
1714640679659,CSS 201S,A01,494383,Staff,35,0,35,0
1714640680686,CSS 202S,A01,494387,Staff,35,0,35,0
1714640681714,DSC 197,001,628532,Eldridge; Justin Matthew,9996,0,9999,3
1714640682738,EAP 100,A00,516065,Staff,9797,0,9999,202
1714640683765,ECE 45,A01,507414,Staff,33,0,60,27
1714640685821,ECE 111,A01,507420,Staff,15,0,50,35
1714640686848,ECE 197,001,548057,Sievenpiper; Daniel F.,9993,0,9999,6
1714640687873,EDS 115,A00,507243,Choi; Bailey Miyeon,10,0,28,18
1714640688902,EDS 117,A01,494379,Staff,0,4,30,30
1714640689931,EDS 125,A00,507246,Hopkins; Megan Beth,9,0,30,21
1714640690961,EDS 128A,A01,507264,Fargason; Sharon Gayle,8,0,26,18
1714640691991,EDS 128B,A01,507293,Pappas; Elizabeth,12,0,30,18
1714640693017,EDS 139,A00,507294,Fargason; Sharon Gayle,13,0,30,17
1714640693017,EDS 139,B00,507313,Pappas; Elizabeth,13,0,30,17
1714640694041,EDS 201,A00,507315,Staff,13,0,30,17
1714640695078,EDS 203,A01,507317,Halter; Christopher P.,12,0,30,18
1714640696109,EDS 204R,A01,507319,Halter; Christopher P.,0,3,30,30
1714640696109,EDS 204R,B01,507331,Heinzman; Erica M.,16,0,30,14
1714640697135,EDS 206R,A00,507332,Staff,0,4,30,30
1714640697135,EDS 206R,B00,507343,Staff,17,0,30,13
1714640698164,EDS 250,A00,507344,Hemans; Patricia Ann Benitez,22,0,40,18
1714640699187,EDS 281,A00,507345,Daly; Alan J.,18,0,18,0
1714640700213,EDS 284,A00,507350,Daly; Alan J.,16,0,16,0
1714640701238,EDS 286,A00,507359,Fine; Sarah,18,0,18,0
1714640702263,EDS 289C,A01,507361,Daly; Alan J.,18,0,18,0
1714640703290,EDS 290,A00,507366,Hofstetter; Carolyn,15,0,15,0
1714640704319,LIGM 5A,A00,507421,Fischer-Grunski; Eva K,18,0,20,2
1714640705346,LIGM 5B,A00,507423,Fischer-Grunski; Eva K,19,0,20,1
1714640706375,LIGM 5C,A00,507425,Fischer-Grunski; Eva K,19,0,20,1
1714640707401,LIIT 5AS,A00,507427,Carnelos; Chiara,20,0,20,0
1714640708428,LIIT 5BS,A00,507430,Carnelos; Chiara,20,0,20,0
1714640709452,LIIT 5CS,A00,507432,Carnelos; Chiara,20,0,20,0
1714640710481,LISP 5A,A00,507541,Munoz Sanchez; Alicia,11,0,20,9
1714640711507,LISP 5B,A00,507671,Munoz Sanchez; Alicia,8,0,20,12
1714640712535,LISP 5C,A00,507696,Munoz Sanchez; Alicia,9,0,20,11
1714640713564,MAE 197,001,528363,Boechler; Nicholas Sebastia,9998,0,9999,1
1714640714645,MATH 197,001,523477,Kedlaya; Kiran S.,9995,0,9999,4
1714640714645,MATH 197,002,563811,Zhang; Danna,9995,0,9999,4
1714640714645,MATH 197,003,628552,Dumitriu; Ioana,9998,0,9999,1
1714640715672,MCWP 40R,A00,518780,Staff,2,0,20,18
1714640715672,MCWP 40R,B00,518781,Staff,8,0,20,12
1714640715672,MCWP 40R,C00,518783,Staff,6,0,20,14
1714640716700,MCWP 50R,A00,518791,Staff,0,0,20,20
1714640716700,MCWP 50R,B00,518792,Staff,0,2,20,20
1714640716700,MCWP 50R,C00,518793,Staff,0,2,20,20
1714640716700,MCWP 50R,D00,518794,Staff,0,1,20,20
1714640716700,MCWP 50R,E00,518795,Staff,0,2,20,20
1714640716700,MCWP 50R,F00,518796,Staff,0,0,20,20
1714640716700,MCWP 50R,G00,518797,Staff,0,1,20,20
1714640717724,MMW 12R,A01,514034,Herbst; Matthew,0,0,16,16
1714640717724,MMW 12R,A02,514035,Herbst; Matthew,1,0,16,15
1714640718749,MMW 13R,A01,514037,Staff,0,4,16,16
1714640718749,MMW 13R,A02,514039,Staff,0,2,16,16
1714640718749,MMW 13R,A03,628519,Staff,0,2,16,16
1714640720798,SIO 295LS,A00,523233,Staff,10,0,30,20
1714640721823,SIO 295S,A00,523232,Staff,10,0,30,20
1714640722855,SIOC 290S,A01,637330,Merrifield; Mark A,23,0,30,7
1714640723897,SIOC 291S,A01,637333,Gabriel; Corey John,23,0,30,7
1714640724922,SOCI 117,A01,494376,Staff,0,4,5,5
1714640725952,WES 237B,A00,494380,Staff,9,0,20,11
1714640728037,AESE 279B,A00,494370,Wade; Jon P,0,0,33,33
1714640729066,AIP 197,001,627712,Vespa; Emanuel Ignacio,9998,0,9999,1
1714640730091,ANAR 135S,A00,494369,Braswell; Geoffrey E.,0,0,0,0
1714640731118,BENG 196,001,628496,Engler; Adam J.,9998,0,9999,1
1714640732147,CAT 124RS,A01,519847,Geibel; William,0,0,20,20
1714640733172,CAT 125RS,A01,515971,Geibel; William,0,0,20,20
1714640734202,CLRE 250,A00,511389,Morris; Sheldon,9993,0,9999,6
1714640735234,CLRE 251,A00,507176,Mehta; Ravindra L.,9993,0,9999,6
1714640735234,CLRE 251,B00,511410,Mehta; Ravindra L.,9998,0,9999,1
1714640736264,CLRE 252,A00,507189,Cuomo; Raphael Eduardo,9995,0,9999,4
1714640737293,CLRE 253,A00,507199,Vaida; Florin,9994,0,9999,5
1714640737293,CLRE 253,B00,507202,Vaida; Florin,9999,0,9999,0
1714640738320,CLRE 259,A00,507211,Patel; Hemal,9996,0,9999,3
1714640739347,CLRE 260,A00,507221,Cuomo; Raphael Eduardo,9999,0,9999,0
1714640740377,CLRE 297,001,507242,Cuomo; Raphael Eduardo,9999,0,9999,0
1714640741404,COGS 197,001,638244,Voytek; Bradley Thomas,9998,0,9999,1
1714640742428,CSE 191,A00,516875,Minnes Kemp; Mor Mia,9992,0,9999,7
1714640743457,CSE 197,001,637388,Minnes Kemp; Mor Mia,9998,0,9999,1
1714640744488,CSS 201S,A01,494383,Staff,35,0,35,0
1714640745514,CSS 202S,A01,494387,Staff,35,0,35,0
1714640746541,DSC 197,001,628532,Eldridge; Justin Matthew,9996,0,9999,3
1714640747568,EAP 100,A00,516065,Staff,9797,0,9999,202
1714640748598,ECE 45,A01,507414,Staff,33,0,60,27
1714640750647,ECE 111,A01,507420,Staff,15,0,50,35
1714640751673,ECE 197,001,548057,Sievenpiper; Daniel F.,9993,0,9999,6
1714640752705,EDS 115,A00,507243,Choi; Bailey Miyeon,10,0,28,18
1714640753731,EDS 117,A01,494379,Staff,0,4,30,30
1714640754758,EDS 125,A00,507246,Hopkins; Megan Beth,9,0,30,21
1714640755787,EDS 128A,A01,507264,Fargason; Sharon Gayle,8,0,26,18
1714640756816,EDS 128B,A01,507293,Pappas; Elizabeth,12,0,30,18
1714640757841,EDS 139,A00,507294,Fargason; Sharon Gayle,13,0,30,17
1714640757841,EDS 139,B00,507313,Pappas; Elizabeth,13,0,30,17
1714640758868,EDS 201,A00,507315,Staff,13,0,30,17
1714640759893,EDS 203,A01,507317,Halter; Christopher P.,12,0,30,18
1714640760920,EDS 204R,A01,507319,Halter; Christopher P.,0,3,30,30
1714640760920,EDS 204R,B01,507331,Heinzman; Erica M.,16,0,30,14
1714640761945,EDS 206R,A00,507332,Staff,0,4,30,30
1714640761945,EDS 206R,B00,507343,Staff,17,0,30,13
1714640762971,EDS 250,A00,507344,Hemans; Patricia Ann Benitez,22,0,40,18
1714640763997,EDS 281,A00,507345,Daly; Alan J.,18,0,18,0
1714640765025,EDS 284,A00,507350,Daly; Alan J.,16,0,16,0
1714640766054,EDS 286,A00,507359,Fine; Sarah,18,0,18,0
1714640767083,EDS 289C,A01,507361,Daly; Alan J.,18,0,18,0
1714640768111,EDS 290,A00,507366,Hofstetter; Carolyn,15,0,15,0
1714640769138,LIGM 5A,A00,507421,Fischer-Grunski; Eva K,18,0,20,2
1714640770166,LIGM 5B,A00,507423,Fischer-Grunski; Eva K,19,0,20,1
1714640771194,LIGM 5C,A00,507425,Fischer-Grunski; Eva K,19,0,20,1
1714640772222,LIIT 5AS,A00,507427,Carnelos; Chiara,20,0,20,0
1714640773250,LIIT 5BS,A00,507430,Carnelos; Chiara,20,0,20,0
1714640774275,LIIT 5CS,A00,507432,Carnelos; Chiara,20,0,20,0
1714640775305,LISP 5A,A00,507541,Munoz Sanchez; Alicia,11,0,20,9
1714640776334,LISP 5B,A00,507671,Munoz Sanchez; Alicia,8,0,20,12
1714640777359,LISP 5C,A00,507696,Munoz Sanchez; Alicia,9,0,20,11
1714640778385,MAE 197,001,528363,Boechler; Nicholas Sebastia,9998,0,9999,1
1714640779416,MATH 197,001,523477,Kedlaya; Kiran S.,9995,0,9999,4
1714640779416,MATH 197,002,563811,Zhang; Danna,9995,0,9999,4
1714640779416,MATH 197,003,628552,Dumitriu; Ioana,9998,0,9999,1
1714640780443,MCWP 40R,A00,518780,Staff,2,0,20,18
1714640780443,MCWP 40R,B00,518781,Staff,8,0,20,12
1714640780443,MCWP 40R,C00,518783,Staff,6,0,20,14
1714640781473,MCWP 50R,A00,518791,Staff,0,0,20,20
1714640781473,MCWP 50R,B00,518792,Staff,0,2,20,20
1714640781473,MCWP 50R,C00,518793,Staff,0,2,20,20
1714640781473,MCWP 50R,D00,518794,Staff,0,1,20,20
1714640781473,MCWP 50R,E00,518795,Staff,0,2,20,20
1714640781473,MCWP 50R,F00,518796,Staff,0,0,20,20
1714640781473,MCWP 50R,G00,518797,Staff,0,1,20,20
1714640782499,MMW 12R,A01,514034,Herbst; Matthew,0,0,16,16
1714640782499,MMW 12R,A02,514035,Herbst; Matthew,1,0,16,15
1714640783529,MMW 13R,A01,514037,Staff,0,4,16,16
1714640783529,MMW 13R,A02,514039,Staff,0,2,16,16
1714640783529,MMW 13R,A03,628519,Staff,0,2,16,16
1714640785581,SIO 295LS,A00,523233,Staff,10,0,30,20
1714640786607,SIO 295S,A00,523232,Staff,10,0,30,20
1714640787636,SIOC 290S,A01,637330,Merrifield; Mark A,23,0,30,7
1714640788661,SIOC 291S,A01,637333,Gabriel; Corey John,23,0,30,7
1714640789686,SOCI 117,A01,494376,Staff,0,4,5,5
1714640790714,WES 237B,A00,494380,Staff,9,0,20,11
1714640792789,AESE 279B,A00,494370,Wade; Jon P,0,0,33,33
1714640793815,AIP 197,001,627712,Vespa; Emanuel Ignacio,9998,0,9999,1
1714640794840,ANAR 135S,A00,494369,Braswell; Geoffrey E.,0,0,0,0
1714640795865,BENG 196,001,628496,Engler; Adam J.,9998,0,9999,1
1714640796895,CAT 124RS,A01,519847,Geibel; William,0,0,20,20
1714640797919,CAT 125RS,A01,515971,Geibel; William,0,0,20,20
1714640798948,CLRE 250,A00,511389,Morris; Sheldon,9993,0,9999,6
1714640799975,CLRE 251,A00,507176,Mehta; Ravindra L.,9993,0,9999,6
1714640799975,CLRE 251,B00,511410,Mehta; Ravindra L.,9998,0,9999,1
1714640801002,CLRE 252,A00,507189,Cuomo; Raphael Eduardo,9995,0,9999,4
1714640802032,CLRE 253,A00,507199,Vaida; Florin,9994,0,9999,5
1714640802032,CLRE 253,B00,507202,Vaida; Florin,9999,0,9999,0
1714640803056,CLRE 259,A00,507211,Patel; Hemal,9996,0,9999,3
1714640804079,CLRE 260,A00,507221,Cuomo; Raphael Eduardo,9999,0,9999,0
1714640805104,CLRE 297,001,507242,Cuomo; Raphael Eduardo,9999,0,9999,0
1714640806130,COGS 197,001,638244,Voytek; Bradley Thomas,9998,0,9999,1
1714640807159,CSE 191,A00,516875,Minnes Kemp; Mor Mia,9992,0,9999,7
1714640808185,CSE 197,001,637388,Minnes Kemp; Mor Mia,9998,0,9999,1
1714640809210,CSS 201S,A01,494383,Staff,35,0,35,0
1714640810240,CSS 202S,A01,494387,Staff,35,0,35,0
1714640811268,DSC 197,001,628532,Eldridge; Justin Matthew,9996,0,9999,3
1714640812297,EAP 100,A00,516065,Staff,9797,0,9999,202
1714640813325,ECE 45,A01,507414,Staff,33,0,60,27
1714640815375,ECE 111,A01,507420,Staff,15,0,50,35
1714640816404,ECE 197,001,548057,Sievenpiper; Daniel F.,9993,0,9999,6
1714640817430,EDS 115,A00,507243,Choi; Bailey Miyeon,10,0,28,18
1714640818509,EDS 117,A01,494379,Staff,0,4,30,30
1714640819535,EDS 125,A00,507246,Hopkins; Megan Beth,9,0,30,21
1714640820560,EDS 128A,A01,507264,Fargason; Sharon Gayle,8,0,26,18
1714640821584,EDS 128B,A01,507293,Pappas; Elizabeth,12,0,30,18
1714640822610,EDS 139,A00,507294,Fargason; Sharon Gayle,13,0,30,17
1714640822610,EDS 139,B00,507313,Pappas; Elizabeth,13,0,30,17
1714640823635,EDS 201,A00,507315,Staff,13,0,30,17
1714640824663,EDS 203,A01,507317,Halter; Christopher P.,12,0,30,18
1714640825690,EDS 204R,A01,507319,Halter; Christopher P.,0,3,30,30
1714640825690,EDS 204R,B01,507331,Heinzman; Erica M.,16,0,30,14
1714640826716,EDS 206R,A00,507332,Staff,0,4,30,30
1714640826716,EDS 206R,B00,507343,Staff,17,0,30,13
1714640827744,EDS 250,A00,507344,Hemans; Patricia Ann Benitez,22,0,40,18
1714640828770,EDS 281,A00,507345,Daly; Alan J.,18,0,18,0
1714640829795,EDS 284,A00,507350,Daly; Alan J.,16,0,16,0
1714640830823,EDS 286,A00,507359,Fine; Sarah,18,0,18,0
1714640831850,EDS 289C,A01,507361,Daly; Alan J.,18,0,18,0
1714640832876,EDS 290,A00,507366,Hofstetter; Carolyn,15,0,15,0
1714640833907,LIGM 5A,A00,507421,Fischer-Grunski; Eva K,18,0,20,2
1714640834937,LIGM 5B,A00,507423,Fischer-Grunski; Eva K,19,0,20,1
1714640835965,LIGM 5C,A00,507425,Fischer-Grunski; Eva K,19,0,20,1
1714640836991,LIIT 5AS,A00,507427,Carnelos; Chiara,20,0,20,0
1714640838021,LIIT 5BS,A00,507430,Carnelos; Chiara,20,0,20,0
1714640839046,LIIT 5CS,A00,507432,Carnelos; Chiara,20,0,20,0
1714640840075,LISP 5A,A00,507541,Munoz Sanchez; Alicia,11,0,20,9
1714640841103,LISP 5B,A00,507671,Munoz Sanchez; Alicia,8,0,20,12
1714640842128,LISP 5C,A00,507696,Munoz Sanchez; Alicia,9,0,20,11
1714640843157,MAE 197,001,528363,Boechler; Nicholas Sebastia,9998,0,9999,1
1714640844185,MATH 197,001,523477,Kedlaya; Kiran S.,9995,0,9999,4
1714640844185,MATH 197,002,563811,Zhang; Danna,9995,0,9999,4
1714640844185,MATH 197,003,628552,Dumitriu; Ioana,9998,0,9999,1
1714640845212,MCWP 40R,A00,518780,Staff,2,0,20,18
1714640845212,MCWP 40R,B00,518781,Staff,8,0,20,12
1714640845212,MCWP 40R,C00,518783,Staff,6,0,20,14
1714640846246,MCWP 50R,A00,518791,Staff,0,0,20,20
1714640846246,MCWP 50R,B00,518792,Staff,0,2,20,20
1714640846246,MCWP 50R,C00,518793,Staff,0,2,20,20
1714640846246,MCWP 50R,D00,518794,Staff,0,1,20,20
1714640846246,MCWP 50R,E00,518795,Staff,0,2,20,20
1714640846246,MCWP 50R,F00,518796,Staff,0,0,20,20
1714640846246,MCWP 50R,G00,518797,Staff,0,1,20,20
1714640847276,MMW 12R,A01,514034,Herbst; Matthew,0,0,16,16
1714640847276,MMW 12R,A02,514035,Herbst; Matthew,1,0,16,15
1714640848304,MMW 13R,A01,514037,Staff,0,4,16,16
1714640848304,MMW 13R,A02,514039,Staff,0,2,16,16
1714640848304,MMW 13R,A03,628519,Staff,0,2,16,16
1714640850355,SIO 295LS,A00,523233,Staff,10,0,30,20
1714640851380,SIO 295S,A00,523232,Staff,10,0,30,20
1714640852409,SIOC 290S,A01,637330,Merrifield; Mark A,23,0,30,7
1714640853436,SIOC 291S,A01,637333,Gabriel; Corey John,23,0,30,7
1714640854463,SOCI 117,A01,494376,Staff,0,4,5,5
1714640855490,WES 237B,A00,494380,Staff,9,0,20,11
1714640857561,AESE 279B,A00,494370,Wade; Jon P,0,0,33,33
1714640858585,AIP 197,001,627712,Vespa; Emanuel Ignacio,9998,0,9999,1
1714640859610,ANAR 135S,A00,494369,Braswell; Geoffrey E.,0,0,0,0
1714640860638,BENG 196,001,628496,Engler; Adam J.,9998,0,9999,1
1714640861663,CAT 124RS,A01,519847,Geibel; William,0,0,20,20
1714640862690,CAT 125RS,A01,515971,Geibel; William,0,0,20,20
1714640863717,CLRE 250,A00,511389,Morris; Sheldon,9993,0,9999,6
1714640864747,CLRE 251,A00,507176,Mehta; Ravindra L.,9993,0,9999,6
1714640864747,CLRE 251,B00,511410,Mehta; Ravindra L.,9998,0,9999,1
1714640865774,CLRE 252,A00,507189,Cuomo; Raphael Eduardo,9995,0,9999,4
1714640866804,CLRE 253,A00,507199,Vaida; Florin,9994,0,9999,5
1714640866804,CLRE 253,B00,507202,Vaida; Florin,9999,0,9999,0
1714640867832,CLRE 259,A00,507211,Patel; Hemal,9996,0,9999,3
1714640868859,CLRE 260,A00,507221,Cuomo; Raphael Eduardo,9999,0,9999,0
1714640869885,CLRE 297,001,507242,Cuomo; Raphael Eduardo,9999,0,9999,0
1714640870910,COGS 197,001,638244,Voytek; Bradley Thomas,9998,0,9999,1
1714640871935,CSE 191,A00,516875,Minnes Kemp; Mor Mia,9992,0,9999,7
1714640872961,CSE 197,001,637388,Minnes Kemp; Mor Mia,9998,0,9999,1
1714640873985,CSS 201S,A01,494383,Staff,35,0,35,0
1714640875015,CSS 202S,A01,494387,Staff,35,0,35,0
1714640876043,DSC 197,001,628532,Eldridge; Justin Matthew,9996,0,9999,3
1714640877072,EAP 100,A00,516065,Staff,9797,0,9999,202
1714640878098,ECE 45,A01,507414,Staff,33,0,60,27
1714640880156,ECE 111,A01,507420,Staff,15,0,50,35
1714640881181,ECE 197,001,548057,Sievenpiper; Daniel F.,9993,0,9999,6
1714640882211,EDS 115,A00,507243,Choi; Bailey Miyeon,10,0,28,18
1714640883237,EDS 117,A01,494379,Staff,0,4,30,30
1714640884261,EDS 125,A00,507246,Hopkins; Megan Beth,9,0,30,21
1714640885287,EDS 128A,A01,507264,Fargason; Sharon Gayle,8,0,26,18
1714640886311,EDS 128B,A01,507293,Pappas; Elizabeth,12,0,30,18
1714640887336,EDS 139,A00,507294,Fargason; Sharon Gayle,13,0,30,17
1714640887336,EDS 139,B00,507313,Pappas; Elizabeth,13,0,30,17
1714640888361,EDS 201,A00,507315,Staff,13,0,30,17
1714640889387,EDS 203,A01,507317,Halter; Christopher P.,12,0,30,18
1714640890414,EDS 204R,A01,507319,Halter; Christopher P.,0,3,30,30
1714640890414,EDS 204R,B01,507331,Heinzman; Erica M.,16,0,30,14
1714640891438,EDS 206R,A00,507332,Staff,0,4,30,30
1714640891438,EDS 206R,B00,507343,Staff,17,0,30,13
1714640892465,EDS 250,A00,507344,Hemans; Patricia Ann Benitez,22,0,40,18
1714640893492,EDS 281,A00,507345,Daly; Alan J.,18,0,18,0
1714640894517,EDS 284,A00,507350,Daly; Alan J.,16,0,16,0
1714640895542,EDS 286,A00,507359,Fine; Sarah,18,0,18,0
1714640896570,EDS 289C,A01,507361,Daly; Alan J.,18,0,18,0
1714640897597,EDS 290,A00,507366,Hofstetter; Carolyn,15,0,15,0
1714640898623,LIGM 5A,A00,507421,Fischer-Grunski; Eva K,18,0,20,2
1714640899649,LIGM 5B,A00,507423,Fischer-Grunski; Eva K,19,0,20,1
1714640900678,LIGM 5C,A00,507425,Fischer-Grunski; Eva K,19,0,20,1
1714640901706,LIIT 5AS,A00,507427,Carnelos; Chiara,20,0,20,0
1714640902736,LIIT 5BS,A00,507430,Carnelos; Chiara,20,0,20,0
1714640903764,LIIT 5CS,A00,507432,Carnelos; Chiara,20,0,20,0
1714640904794,LISP 5A,A00,507541,Munoz Sanchez; Alicia,11,0,20,9
1714640905820,LISP 5B,A00,507671,Munoz Sanchez; Alicia,8,0,20,12
1714640906845,LISP 5C,A00,507696,Munoz Sanchez; Alicia,9,0,20,11
1714640907870,MAE 197,001,528363,Boechler; Nicholas Sebastia,9998,0,9999,1
1714640908895,MATH 197,001,523477,Kedlaya; Kiran S.,9995,0,9999,4
1714640908895,MATH 197,002,563811,Zhang; Danna,9995,0,9999,4
1714640908895,MATH 197,003,628552,Dumitriu; Ioana,9998,0,9999,1
1714640909920,MCWP 40R,A00,518780,Staff,2,0,20,18
1714640909920,MCWP 40R,B00,518781,Staff,8,0,20,12
1714640909920,MCWP 40R,C00,518783,Staff,6,0,20,14
1714640910949,MCWP 50R,A00,518791,Staff,0,0,20,20
1714640910949,MCWP 50R,B00,518792,Staff,0,2,20,20
1714640910949,MCWP 50R,C00,518793,Staff,0,2,20,20
1714640910949,MCWP 50R,D00,518794,Staff,0,1,20,20
1714640910949,MCWP 50R,E00,518795,Staff,0,2,20,20
1714640910949,MCWP 50R,F00,518796,Staff,0,0,20,20
1714640910949,MCWP 50R,G00,518797,Staff,0,1,20,20
1714640911975,MMW 12R,A01,514034,Herbst; Matthew,0,0,16,16
1714640911975,MMW 12R,A02,514035,Herbst; Matthew,1,0,16,15
1714640913000,MMW 13R,A01,514037,Staff,0,4,16,16
1714640913000,MMW 13R,A02,514039,Staff,0,2,16,16
1714640913000,MMW 13R,A03,628519,Staff,0,2,16,16
1714640915052,SIO 295LS,A00,523233,Staff,10,0,30,20
1714640916077,SIO 295S,A00,523232,Staff,10,0,30,20
1714640917105,SIOC 290S,A01,637330,Merrifield; Mark A,23,0,30,7
1714640918131,SIOC 291S,A01,637333,Gabriel; Corey John,23,0,30,7
1714640919158,SOCI 117,A01,494376,Staff,0,4,5,5
1714640920187,WES 237B,A00,494380,Staff,9,0,20,11
1714640922349,AESE 279B,A00,494370,Wade; Jon P,0,0,33,33
1714640923375,AIP 197,001,627712,Vespa; Emanuel Ignacio,9998,0,9999,1
1714640924403,ANAR 135S,A00,494369,Braswell; Geoffrey E.,0,0,0,0
1714640925429,BENG 196,001,628496,Engler; Adam J.,9998,0,9999,1
1714640926456,CAT 124RS,A01,519847,Geibel; William,0,0,20,20
1714640927481,CAT 125RS,A01,515971,Geibel; William,0,0,20,20
1714640928511,CLRE 250,A00,511389,Morris; Sheldon,9993,0,9999,6
1714640929541,CLRE 251,A00,507176,Mehta; Ravindra L.,9993,0,9999,6
1714640929541,CLRE 251,B00,511410,Mehta; Ravindra L.,9998,0,9999,1
1714640930569,CLRE 252,A00,507189,Cuomo; Raphael Eduardo,9995,0,9999,4
1714640931599,CLRE 253,A00,507199,Vaida; Florin,9994,0,9999,5
1714640931599,CLRE 253,B00,507202,Vaida; Florin,9999,0,9999,0
1714640932628,CLRE 259,A00,507211,Patel; Hemal,9996,0,9999,3
1714640933658,CLRE 260,A00,507221,Cuomo; Raphael Eduardo,9999,0,9999,0
1714640934683,CLRE 297,001,507242,Cuomo; Raphael Eduardo,9999,0,9999,0
1714640935709,COGS 197,001,638244,Voytek; Bradley Thomas,9998,0,9999,1
1714640936734,CSE 191,A00,516875,Minnes Kemp; Mor Mia,9992,0,9999,7
1714640937760,CSE 197,001,637388,Minnes Kemp; Mor Mia,9998,0,9999,1
1714640938787,CSS 201S,A01,494383,Staff,35,0,35,0
1714640939811,CSS 202S,A01,494387,Staff,35,0,35,0
1714640940838,DSC 197,001,628532,Eldridge; Justin Matthew,9996,0,9999,3
1714640941867,EAP 100,A00,516065,Staff,9797,0,9999,202
1714640942897,ECE 45,A01,507414,Staff,33,0,60,27
1714640944950,ECE 111,A01,507420,Staff,15,0,50,35
1714640945976,ECE 197,001,548057,Sievenpiper; Daniel F.,9993,0,9999,6
1714640947005,EDS 115,A00,507243,Choi; Bailey Miyeon,10,0,28,18
1714640948032,EDS 117,A01,494379,Staff,0,4,30,30
1714640949060,EDS 125,A00,507246,Hopkins; Megan Beth,9,0,30,21
1714640950089,EDS 128A,A01,507264,Fargason; Sharon Gayle,8,0,26,18
1714640951118,EDS 128B,A01,507293,Pappas; Elizabeth,12,0,30,18
1714640952145,EDS 139,A00,507294,Fargason; Sharon Gayle,13,0,30,17
1714640952145,EDS 139,B00,507313,Pappas; Elizabeth,13,0,30,17
1714640953172,EDS 201,A00,507315,Staff,13,0,30,17
1714640954205,EDS 203,A01,507317,Halter; Christopher P.,12,0,30,18
1714640955230,EDS 204R,A01,507319,Halter; Christopher P.,0,3,30,30
1714640955230,EDS 204R,B01,507331,Heinzman; Erica M.,16,0,30,14
1714640956253,EDS 206R,A00,507332,Staff,0,4,30,30
1714640956253,EDS 206R,B00,507343,Staff,17,0,30,13
1714640957280,EDS 250,A00,507344,Hemans; Patricia Ann Benitez,22,0,40,18
1714640958305,EDS 281,A00,507345,Daly; Alan J.,18,0,18,0
1714640959330,EDS 284,A00,507350,Daly; Alan J.,16,0,16,0
1714640960358,EDS 286,A00,507359,Fine; Sarah,18,0,18,0
1714640961384,EDS 289C,A01,507361,Daly; Alan J.,18,0,18,0
1714640962408,EDS 290,A00,507366,Hofstetter; Carolyn,15,0,15,0
1714640963441,LIGM 5A,A00,507421,Fischer-Grunski; Eva K,18,0,20,2
1714640964467,LIGM 5B,A00,507423,Fischer-Grunski; Eva K,19,0,20,1
1714640965494,LIGM 5C,A00,507425,Fischer-Grunski; Eva K,19,0,20,1
1714640966519,LIIT 5AS,A00,507427,Carnelos; Chiara,20,0,20,0
1714640967549,LIIT 5BS,A00,507430,Carnelos; Chiara,20,0,20,0
1714640968574,LIIT 5CS,A00,507432,Carnelos; Chiara,20,0,20,0
1714640969605,LISP 5A,A00,507541,Munoz Sanchez; Alicia,11,0,20,9
1714640970631,LISP 5B,A00,507671,Munoz Sanchez; Alicia,8,0,20,12
1714640971661,LISP 5C,A00,507696,Munoz Sanchez; Alicia,9,0,20,11
1714640972687,MAE 197,001,528363,Boechler; Nicholas Sebastia,9998,0,9999,1
1714640973719,MATH 197,001,523477,Kedlaya; Kiran S.,9995,0,9999,4
1714640973719,MATH 197,002,563811,Zhang; Danna,9995,0,9999,4
1714640973719,MATH 197,003,628552,Dumitriu; Ioana,9998,0,9999,1
1714640974750,MCWP 40R,A00,518780,Staff,2,0,20,18
1714640974750,MCWP 40R,B00,518781,Staff,8,0,20,12
1714640974750,MCWP 40R,C00,518783,Staff,6,0,20,14
1714640975781,MCWP 50R,A00,518791,Staff,0,0,20,20
1714640975781,MCWP 50R,B00,518792,Staff,0,2,20,20
1714640975781,MCWP 50R,C00,518793,Staff,0,2,20,20
1714640975781,MCWP 50R,D00,518794,Staff,0,1,20,20
1714640975781,MCWP 50R,E00,518795,Staff,0,2,20,20
1714640975781,MCWP 50R,F00,518796,Staff,0,0,20,20
1714640975781,MCWP 50R,G00,518797,Staff,0,1,20,20
1714640976808,MMW 12R,A01,514034,Herbst; Matthew,0,0,16,16
1714640976808,MMW 12R,A02,514035,Herbst; Matthew,1,0,16,15
1714640977832,MMW 13R,A01,514037,Staff,0,4,16,16
1714640977832,MMW 13R,A02,514039,Staff,0,2,16,16
1714640977832,MMW 13R,A03,628519,Staff,0,2,16,16
1714640979891,SIO 295LS,A00,523233,Staff,10,0,30,20
1714640980916,SIO 295S,A00,523232,Staff,10,0,30,20
1714640981945,SIOC 290S,A01,637330,Merrifield; Mark A,23,0,30,7
1714640982977,SIOC 291S,A01,637333,Gabriel; Corey John,23,0,30,7
1714640984003,SOCI 117,A01,494376,Staff,0,4,5,5
1714640985032,WES 237B,A00,494380,Staff,9,0,20,11
1714640987120,AESE 279B,A00,494370,Wade; Jon P,0,0,33,33
1714640988147,AIP 197,001,627712,Vespa; Emanuel Ignacio,9998,0,9999,1
1714640989172,ANAR 135S,A00,494369,Braswell; Geoffrey E.,0,0,0,0
1714640990197,BENG 196,001,628496,Engler; Adam J.,9998,0,9999,1
1714640991226,CAT 124RS,A01,519847,Geibel; William,0,0,20,20
1714640992253,CAT 125RS,A01,515971,Geibel; William,0,0,20,20
1714640993283,CLRE 250,A00,511389,Morris; Sheldon,9993,0,9999,6
1714640994319,CLRE 251,A00,507176,Mehta; Ravindra L.,9993,0,9999,6
1714640994319,CLRE 251,B00,511410,Mehta; Ravindra L.,9998,0,9999,1
1714640995343,CLRE 252,A00,507189,Cuomo; Raphael Eduardo,9995,0,9999,4
1714640996372,CLRE 253,A00,507199,Vaida; Florin,9994,0,9999,5
1714640996372,CLRE 253,B00,507202,Vaida; Florin,9999,0,9999,0
1714640997399,CLRE 259,A00,507211,Patel; Hemal,9996,0,9999,3
1714640998425,CLRE 260,A00,507221,Cuomo; Raphael Eduardo,9999,0,9999,0
1714640999451,CLRE 297,001,507242,Cuomo; Raphael Eduardo,9999,0,9999,0
1714641000477,COGS 197,001,638244,Voytek; Bradley Thomas,9998,0,9999,1
1714641001508,CSE 191,A00,516875,Minnes Kemp; Mor Mia,9992,0,9999,7
1714641002537,CSE 197,001,637388,Minnes Kemp; Mor Mia,9998,0,9999,1
1714641003568,CSS 201S,A01,494383,Staff,35,0,35,0
1714641004594,CSS 202S,A01,494387,Staff,35,0,35,0
1714641005625,DSC 197,001,628532,Eldridge; Justin Matthew,9996,0,9999,3
1714641006654,EAP 100,A00,516065,Staff,9797,0,9999,202
1714641007684,ECE 45,A01,507414,Staff,33,0,60,27
1714641009735,ECE 111,A01,507420,Staff,15,0,50,35
1714641010760,ECE 197,001,548057,Sievenpiper; Daniel F.,9993,0,9999,6
1714641011789,EDS 115,A00,507243,Choi; Bailey Miyeon,10,0,28,18
1714641012816,EDS 117,A01,494379,Staff,0,4,30,30
1714641013849,EDS 125,A00,507246,Hopkins; Megan Beth,9,0,30,21
1714641014876,EDS 128A,A01,507264,Fargason; Sharon Gayle,8,0,26,18
1714641015902,EDS 128B,A01,507293,Pappas; Elizabeth,12,0,30,18
1714641016930,EDS 139,A00,507294,Fargason; Sharon Gayle,13,0,30,17
1714641016930,EDS 139,B00,507313,Pappas; Elizabeth,13,0,30,17
1714641017957,EDS 201,A00,507315,Staff,13,0,30,17
1714641018986,EDS 203,A01,507317,Halter; Christopher P.,12,0,30,18
1714641020010,EDS 204R,A01,507319,Halter; Christopher P.,0,3,30,30
1714641020010,EDS 204R,B01,507331,Heinzman; Erica M.,16,0,30,14
1714641021035,EDS 206R,A00,507332,Staff,0,4,30,30
1714641021035,EDS 206R,B00,507343,Staff,17,0,30,13
1714641022065,EDS 250,A00,507344,Hemans; Patricia Ann Benitez,22,0,40,18
1714641023093,EDS 281,A00,507345,Daly; Alan J.,18,0,18,0
1714641024120,EDS 284,A00,507350,Daly; Alan J.,16,0,16,0
1714641025152,EDS 286,A00,507359,Fine; Sarah,18,0,18,0
1714641026177,EDS 289C,A01,507361,Daly; Alan J.,18,0,18,0
1714641027203,EDS 290,A00,507366,Hofstetter; Carolyn,15,0,15,0
1714641028235,LIGM 5A,A00,507421,Fischer-Grunski; Eva K,18,0,20,2
1714641029261,LIGM 5B,A00,507423,Fischer-Grunski; Eva K,19,0,20,1
1714641030287,LIGM 5C,A00,507425,Fischer-Grunski; Eva K,19,0,20,1
1714641031313,LIIT 5AS,A00,507427,Carnelos; Chiara,20,0,20,0
1714641032339,LIIT 5BS,A00,507430,Carnelos; Chiara,20,0,20,0
1714641033368,LIIT 5CS,A00,507432,Carnelos; Chiara,20,0,20,0
1714641034395,LISP 5A,A00,507541,Munoz Sanchez; Alicia,11,0,20,9
1714641035421,LISP 5B,A00,507671,Munoz Sanchez; Alicia,8,0,20,12
1714641036448,LISP 5C,A00,507696,Munoz Sanchez; Alicia,9,0,20,11
1714641037474,MAE 197,001,528363,Boechler; Nicholas Sebastia,9998,0,9999,1
1714641038505,MATH 197,001,523477,Kedlaya; Kiran S.,9995,0,9999,4
1714641038505,MATH 197,002,563811,Zhang; Danna,9995,0,9999,4
1714641038505,MATH 197,003,628552,Dumitriu; Ioana,9998,0,9999,1
1714641039531,MCWP 40R,A00,518780,Staff,2,0,20,18
1714641039531,MCWP 40R,B00,518781,Staff,8,0,20,12
1714641039531,MCWP 40R,C00,518783,Staff,6,0,20,14
1714641040558,MCWP 50R,A00,518791,Staff,0,0,20,20
1714641040558,MCWP 50R,B00,518792,Staff,0,2,20,20
1714641040558,MCWP 50R,C00,518793,Staff,0,2,20,20
1714641040558,MCWP 50R,D00,518794,Staff,0,1,20,20
1714641040558,MCWP 50R,E00,518795,Staff,0,2,20,20
1714641040558,MCWP 50R,F00,518796,Staff,0,0,20,20
1714641040558,MCWP 50R,G00,518797,Staff,0,1,20,20
1714641041585,MMW 12R,A01,514034,Herbst; Matthew,0,0,16,16
1714641041585,MMW 12R,A02,514035,Herbst; Matthew,1,0,16,15
1714641042615,MMW 13R,A01,514037,Staff,0,4,16,16
1714641042615,MMW 13R,A02,514039,Staff,0,2,16,16
1714641042615,MMW 13R,A03,628519,Staff,0,2,16,16
1714641044664,SIO 295LS,A00,523233,Staff,10,0,30,20
1714641045691,SIO 295S,A00,523232,Staff,10,0,30,20
1714641046719,SIOC 290S,A01,637330,Merrifield; Mark A,23,0,30,7
1714641047751,SIOC 291S,A01,637333,Gabriel; Corey John,23,0,30,7
1714641048777,SOCI 117,A01,494376,Staff,0,4,5,5
1714641049801,WES 237B,A00,494380,Staff,9,0,20,11
1714641051886,AESE 279B,A00,494370,Wade; Jon P,0,0,33,33
1714641052914,AIP 197,001,627712,Vespa; Emanuel Ignacio,9998,0,9999,1
1714641053942,ANAR 135S,A00,494369,Braswell; Geoffrey E.,0,0,0,0
1714641054967,BENG 196,001,628496,Engler; Adam J.,9998,0,9999,1
1714641055996,CAT 124RS,A01,519847,Geibel; William,0,0,20,20
1714641057021,CAT 125RS,A01,515971,Geibel; William,0,0,20,20
1714641058048,CLRE 250,A00,511389,Morris; Sheldon,9993,0,9999,6
1714641059075,CLRE 251,A00,507176,Mehta; Ravindra L.,9993,0,9999,6
1714641059075,CLRE 251,B00,511410,Mehta; Ravindra L.,9998,0,9999,1
1714641060104,CLRE 252,A00,507189,Cuomo; Raphael Eduardo,9995,0,9999,4
1714641061137,CLRE 253,A00,507199,Vaida; Florin,9994,0,9999,5
1714641061137,CLRE 253,B00,507202,Vaida; Florin,9999,0,9999,0
1714641062163,CLRE 259,A00,507211,Patel; Hemal,9996,0,9999,3
1714641063187,CLRE 260,A00,507221,Cuomo; Raphael Eduardo,9999,0,9999,0
1714641064212,CLRE 297,001,507242,Cuomo; Raphael Eduardo,9999,0,9999,0
1714641065239,COGS 197,001,638244,Voytek; Bradley Thomas,9998,0,9999,1
1714641066265,CSE 191,A00,516875,Minnes Kemp; Mor Mia,9992,0,9999,7
1714641067295,CSE 197,001,637388,Minnes Kemp; Mor Mia,9998,0,9999,1
1714641068326,CSS 201S,A01,494383,Staff,35,0,35,0
1714641069356,CSS 202S,A01,494387,Staff,35,0,35,0
1714641070384,DSC 197,001,628532,Eldridge; Justin Matthew,9996,0,9999,3
1714641071412,EAP 100,A00,516065,Staff,9797,0,9999,202
1714641072438,ECE 45,A01,507414,Staff,33,0,60,27
1714641074490,ECE 111,A01,507420,Staff,15,0,50,35
1714641075515,ECE 197,001,548057,Sievenpiper; Daniel F.,9993,0,9999,6
1714641076544,EDS 115,A00,507243,Choi; Bailey Miyeon,10,0,28,18
1714641077570,EDS 117,A01,494379,Staff,0,4,30,30
1714641078601,EDS 125,A00,507246,Hopkins; Megan Beth,9,0,30,21
1714641079628,EDS 128A,A01,507264,Fargason; Sharon Gayle,8,0,26,18
1714641080657,EDS 128B,A01,507293,Pappas; Elizabeth,12,0,30,18
1714641081683,EDS 139,A00,507294,Fargason; Sharon Gayle,13,0,30,17
1714641081683,EDS 139,B00,507313,Pappas; Elizabeth,13,0,30,17
1714641082710,EDS 201,A00,507315,Staff,13,0,30,17
1714641083740,EDS 203,A01,507317,Halter; Christopher P.,12,0,30,18
1714641084765,EDS 204R,A01,507319,Halter; Christopher P.,0,3,30,30
1714641084765,EDS 204R,B01,507331,Heinzman; Erica M.,16,0,30,14
1714641085793,EDS 206R,A00,507332,Staff,0,4,30,30
1714641085793,EDS 206R,B00,507343,Staff,17,0,30,13
1714641086822,EDS 250,A00,507344,Hemans; Patricia Ann Benitez,22,0,40,18
1714641087846,EDS 281,A00,507345,Daly; Alan J.,18,0,18,0
1714641088872,EDS 284,A00,507350,Daly; Alan J.,16,0,16,0
1714641089898,EDS 286,A00,507359,Fine; Sarah,18,0,18,0
1714641090926,EDS 289C,A01,507361,Daly; Alan J.,18,0,18,0
1714641091957,EDS 290,A00,507366,Hofstetter; Carolyn,15,0,15,0
1714641092983,LIGM 5A,A00,507421,Fischer-Grunski; Eva K,18,0,20,2
1714641094013,LIGM 5B,A00,507423,Fischer-Grunski; Eva K,19,0,20,1
1714641095039,LIGM 5C,A00,507425,Fischer-Grunski; Eva K,19,0,20,1
1714641096072,LIIT 5AS,A00,507427,Carnelos; Chiara,20,0,20,0
1714641097096,LIIT 5BS,A00,507430,Carnelos; Chiara,20,0,20,0
1714641098126,LIIT 5CS,A00,507432,Carnelos; Chiara,20,0,20,0
1714641099152,LISP 5A,A00,507541,Munoz Sanchez; Alicia,11,0,20,9
1714641100178,LISP 5B,A00,507671,Munoz Sanchez; Alicia,8,0,20,12
1714641101208,LISP 5C,A00,507696,Munoz Sanchez; Alicia,9,0,20,11
1714641102236,MAE 197,001,528363,Boechler; Nicholas Sebastia,9998,0,9999,1
1714641103264,MATH 197,001,523477,Kedlaya; Kiran S.,9995,0,9999,4
1714641103264,MATH 197,002,563811,Zhang; Danna,9995,0,9999,4
1714641103264,MATH 197,003,628552,Dumitriu; Ioana,9998,0,9999,1
1714641104293,MCWP 40R,A00,518780,Staff,2,0,20,18
1714641104293,MCWP 40R,B00,518781,Staff,8,0,20,12
1714641104293,MCWP 40R,C00,518783,Staff,6,0,20,14
1714641105324,MCWP 50R,A00,518791,Staff,0,0,20,20
1714641105324,MCWP 50R,B00,518792,Staff,0,2,20,20
1714641105324,MCWP 50R,C00,518793,Staff,0,2,20,20
1714641105324,MCWP 50R,D00,518794,Staff,0,1,20,20
1714641105324,MCWP 50R,E00,518795,Staff,0,2,20,20
1714641105324,MCWP 50R,F00,518796,Staff,0,0,20,20
1714641105324,MCWP 50R,G00,518797,Staff,0,1,20,20
1714641106350,MMW 12R,A01,514034,Herbst; Matthew,0,0,16,16
1714641106350,MMW 12R,A02,514035,Herbst; Matthew,1,0,16,15
1714641107375,MMW 13R,A01,514037,Staff,0,4,16,16
1714641107375,MMW 13R,A02,514039,Staff,0,2,16,16
1714641107375,MMW 13R,A03,628519,Staff,0,2,16,16
1714641109432,SIO 295LS,A00,523233,Staff,10,0,30,20
1714641110462,SIO 295S,A00,523232,Staff,10,0,30,20
1714641111498,SIOC 290S,A01,637330,Merrifield; Mark A,23,0,30,7
1714641112529,SIOC 291S,A01,637333,Gabriel; Corey John,23,0,30,7
1714641113557,SOCI 117,A01,494376,Staff,0,4,5,5
1714641114586,WES 237B,A00,494380,Staff,9,0,20,11
1714641116670,AESE 279B,A00,494370,Wade; Jon P,0,0,33,33
1714641117698,AIP 197,001,627712,Vespa; Emanuel Ignacio,9998,0,9999,1
1714641118724,ANAR 135S,A00,494369,Braswell; Geoffrey E.,0,0,0,0
1714641119751,BENG 196,001,628496,Engler; Adam J.,9998,0,9999,1
1714641120778,CAT 124RS,A01,519847,Geibel; William,0,0,20,20
1714641121807,CAT 125RS,A01,515971,Geibel; William,0,0,20,20
1714641122834,CLRE 250,A00,511389,Morris; Sheldon,9993,0,9999,6
1714641123880,CLRE 251,A00,507176,Mehta; Ravindra L.,9993,0,9999,6
1714641123880,CLRE 251,B00,511410,Mehta; Ravindra L.,9998,0,9999,1
1714641124905,CLRE 252,A00,507189,Cuomo; Raphael Eduardo,9995,0,9999,4
1714641125932,CLRE 253,A00,507199,Vaida; Florin,9994,0,9999,5
1714641125932,CLRE 253,B00,507202,Vaida; Florin,9999,0,9999,0
1714641126957,CLRE 259,A00,507211,Patel; Hemal,9996,0,9999,3
1714641127986,CLRE 260,A00,507221,Cuomo; Raphael Eduardo,9999,0,9999,0
1714641129015,CLRE 297,001,507242,Cuomo; Raphael Eduardo,9999,0,9999,0
1714641130040,COGS 197,001,638244,Voytek; Bradley Thomas,9998,0,9999,1
1714641131070,CSE 191,A00,516875,Minnes Kemp; Mor Mia,9992,0,9999,7
1714641132097,CSE 197,001,637388,Minnes Kemp; Mor Mia,9998,0,9999,1
1714641133140,CSS 201S,A01,494383,Staff,35,0,35,0
1714641134168,CSS 202S,A01,494387,Staff,35,0,35,0
1714641135194,DSC 197,001,628532,Eldridge; Justin Matthew,9996,0,9999,3
1714641136222,EAP 100,A00,516065,Staff,9797,0,9999,202
1714641137253,ECE 45,A01,507414,Staff,33,0,60,27
1714641139307,ECE 111,A01,507420,Staff,15,0,50,35
1714641140335,ECE 197,001,548057,Sievenpiper; Daniel F.,9993,0,9999,6
1714641141366,EDS 115,A00,507243,Choi; Bailey Miyeon,10,0,28,18
1714641142391,EDS 117,A01,494379,Staff,0,4,30,30
1714641143418,EDS 125,A00,507246,Hopkins; Megan Beth,9,0,30,21
1714641144445,EDS 128A,A01,507264,Fargason; Sharon Gayle,8,0,26,18
1714641145471,EDS 128B,A01,507293,Pappas; Elizabeth,12,0,30,18
1714641146497,EDS 139,A00,507294,Fargason; Sharon Gayle,13,0,30,17
1714641146497,EDS 139,B00,507313,Pappas; Elizabeth,13,0,30,17
1714641147525,EDS 201,A00,507315,Staff,13,0,30,17
1714641148556,EDS 203,A01,507317,Halter; Christopher P.,12,0,30,18
1714641149584,EDS 204R,A01,507319,Halter; Christopher P.,0,3,30,30
1714641149584,EDS 204R,B01,507331,Heinzman; Erica M.,16,0,30,14
1714641150610,EDS 206R,A00,507332,Staff,0,4,30,30
1714641150610,EDS 206R,B00,507343,Staff,17,0,30,13
1714641151635,EDS 250,A00,507344,Hemans; Patricia Ann Benitez,22,0,40,18
1714641152660,EDS 281,A00,507345,Daly; Alan J.,18,0,18,0
1714641153688,EDS 284,A00,507350,Daly; Alan J.,16,0,16,0
1714641154718,EDS 286,A00,507359,Fine; Sarah,18,0,18,0
1714641155744,EDS 289C,A01,507361,Daly; Alan J.,18,0,18,0
1714641156769,EDS 290,A00,507366,Hofstetter; Carolyn,15,0,15,0
1714641157799,LIGM 5A,A00,507421,Fischer-Grunski; Eva K,18,0,20,2
1714641158827,LIGM 5B,A00,507423,Fischer-Grunski; Eva K,19,0,20,1
1714641159856,LIGM 5C,A00,507425,Fischer-Grunski; Eva K,19,0,20,1
1714641160887,LIIT 5AS,A00,507427,Carnelos; Chiara,20,0,20,0
1714641161913,LIIT 5BS,A00,507430,Carnelos; Chiara,20,0,20,0
1714641162939,LIIT 5CS,A00,507432,Carnelos; Chiara,20,0,20,0
1714641163963,LISP 5A,A00,507541,Munoz Sanchez; Alicia,11,0,20,9
1714641164988,LISP 5B,A00,507671,Munoz Sanchez; Alicia,8,0,20,12
1714641166017,LISP 5C,A00,507696,Munoz Sanchez; Alicia,9,0,20,11
1714641167045,MAE 197,001,528363,Boechler; Nicholas Sebastia,9998,0,9999,1
1714641168070,MATH 197,001,523477,Kedlaya; Kiran S.,9995,0,9999,4
1714641168070,MATH 197,002,563811,Zhang; Danna,9995,0,9999,4
1714641168070,MATH 197,003,628552,Dumitriu; Ioana,9998,0,9999,1
1714641169151,MCWP 40R,A00,518780,Staff,2,0,20,18
1714641169151,MCWP 40R,B00,518781,Staff,8,0,20,12
1714641169151,MCWP 40R,C00,518783,Staff,6,0,20,14
1714641170182,MCWP 50R,A00,518791,Staff,0,0,20,20
1714641170182,MCWP 50R,B00,518792,Staff,0,2,20,20
1714641170182,MCWP 50R,C00,518793,Staff,0,2,20,20
1714641170182,MCWP 50R,D00,518794,Staff,0,1,20,20
1714641170182,MCWP 50R,E00,518795,Staff,0,2,20,20
1714641170182,MCWP 50R,F00,518796,Staff,0,0,20,20
1714641170182,MCWP 50R,G00,518797,Staff,0,1,20,20
1714641171213,MMW 12R,A01,514034,Herbst; Matthew,0,0,16,16
1714641171213,MMW 12R,A02,514035,Herbst; Matthew,1,0,16,15
1714641172238,MMW 13R,A01,514037,Staff,0,4,16,16
1714641172238,MMW 13R,A02,514039,Staff,0,2,16,16
1714641172238,MMW 13R,A03,628519,Staff,0,2,16,16
1714641174291,SIO 295LS,A00,523233,Staff,10,0,30,20
1714641175321,SIO 295S,A00,523232,Staff,10,0,30,20
1714641176350,SIOC 290S,A01,637330,Merrifield; Mark A,23,0,30,7
1714641177378,SIOC 291S,A01,637333,Gabriel; Corey John,23,0,30,7
1714641178403,SOCI 117,A01,494376,Staff,0,4,5,5
1714641179429,WES 237B,A00,494380,Staff,9,0,20,11
1714641181501,AESE 279B,A00,494370,Wade; Jon P,0,0,33,33
1714641182527,AIP 197,001,627712,Vespa; Emanuel Ignacio,9998,0,9999,1
1714641183556,ANAR 135S,A00,494369,Braswell; Geoffrey E.,0,0,0,0
1714641184581,BENG 196,001,628496,Engler; Adam J.,9998,0,9999,1
1714641185608,CAT 124RS,A01,519847,Geibel; William,0,0,20,20
1714641186638,CAT 125RS,A01,515971,Geibel; William,0,0,20,20
1714641187667,CLRE 250,A00,511389,Morris; Sheldon,9993,0,9999,6
1714641188694,CLRE 251,A00,507176,Mehta; Ravindra L.,9993,0,9999,6
1714641188694,CLRE 251,B00,511410,Mehta; Ravindra L.,9998,0,9999,1
1714641189719,CLRE 252,A00,507189,Cuomo; Raphael Eduardo,9995,0,9999,4
1714641190745,CLRE 253,A00,507199,Vaida; Florin,9994,0,9999,5
1714641190745,CLRE 253,B00,507202,Vaida; Florin,9999,0,9999,0
1714641191775,CLRE 259,A00,507211,Patel; Hemal,9996,0,9999,3
1714641192800,CLRE 260,A00,507221,Cuomo; Raphael Eduardo,9999,0,9999,0
1714641193825,CLRE 297,001,507242,Cuomo; Raphael Eduardo,9999,0,9999,0
1714641194851,COGS 197,001,638244,Voytek; Bradley Thomas,9998,0,9999,1
1714641195878,CSE 191,A00,516875,Minnes Kemp; Mor Mia,9992,0,9999,7
1714641196904,CSE 197,001,637388,Minnes Kemp; Mor Mia,9998,0,9999,1
1714641197936,CSS 201S,A01,494383,Staff,35,0,35,0
1714641198960,CSS 202S,A01,494387,Staff,35,0,35,0
1714641199987,DSC 197,001,628532,Eldridge; Justin Matthew,9996,0,9999,3
1714641201014,EAP 100,A00,516065,Staff,9797,0,9999,202
1714641202038,ECE 45,A01,507414,Staff,33,0,60,27
1714641204093,ECE 111,A01,507420,Staff,15,0,50,35
1714641205120,ECE 197,001,548057,Sievenpiper; Daniel F.,9993,0,9999,6
1714641206148,EDS 115,A00,507243,Choi; Bailey Miyeon,10,0,28,18
1714641207179,EDS 117,A01,494379,Staff,0,4,30,30
1714641208205,EDS 125,A00,507246,Hopkins; Megan Beth,9,0,30,21
1714641209231,EDS 128A,A01,507264,Fargason; Sharon Gayle,8,0,26,18
1714641210259,EDS 128B,A01,507293,Pappas; Elizabeth,12,0,30,18
1714641211284,EDS 139,A00,507294,Fargason; Sharon Gayle,13,0,30,17
1714641211284,EDS 139,B00,507313,Pappas; Elizabeth,13,0,30,17
1714641212312,EDS 201,A00,507315,Staff,13,0,30,17
1714641213336,EDS 203,A01,507317,Halter; Christopher P.,12,0,30,18
1714641214364,EDS 204R,A01,507319,Halter; Christopher P.,0,3,30,30
1714641214364,EDS 204R,B01,507331,Heinzman; Erica M.,16,0,30,14
1714641215389,EDS 206R,A00,507332,Staff,0,4,30,30
1714641215389,EDS 206R,B00,507343,Staff,17,0,30,13
1714641216414,EDS 250,A00,507344,Hemans; Patricia Ann Benitez,22,0,40,18
1714641217438,EDS 281,A00,507345,Daly; Alan J.,18,0,18,0
1714641218464,EDS 284,A00,507350,Daly; Alan J.,16,0,16,0
1714641219489,EDS 286,A00,507359,Fine; Sarah,18,0,18,0
1714641220517,EDS 289C,A01,507361,Daly; Alan J.,18,0,18,0
1714641221543,EDS 290,A00,507366,Hofstetter; Carolyn,15,0,15,0
1714641222582,LIGM 5A,A00,507421,Fischer-Grunski; Eva K,18,0,20,2
1714641223610,LIGM 5B,A00,507423,Fischer-Grunski; Eva K,19,0,20,1
1714641224636,LIGM 5C,A00,507425,Fischer-Grunski; Eva K,19,0,20,1
1714641225666,LIIT 5AS,A00,507427,Carnelos; Chiara,20,0,20,0
1714641226693,LIIT 5BS,A00,507430,Carnelos; Chiara,20,0,20,0
1714641227721,LIIT 5CS,A00,507432,Carnelos; Chiara,20,0,20,0
1714641228752,LISP 5A,A00,507541,Munoz Sanchez; Alicia,11,0,20,9
1714641229778,LISP 5B,A00,507671,Munoz Sanchez; Alicia,8,0,20,12
1714641230807,LISP 5C,A00,507696,Munoz Sanchez; Alicia,9,0,20,11
1714641231837,MAE 197,001,528363,Boechler; Nicholas Sebastia,9998,0,9999,1
1714641232868,MATH 197,001,523477,Kedlaya; Kiran S.,9995,0,9999,4
1714641232868,MATH 197,002,563811,Zhang; Danna,9995,0,9999,4
1714641232868,MATH 197,003,628552,Dumitriu; Ioana,9998,0,9999,1
1714641233895,MCWP 40R,A00,518780,Staff,2,0,20,18
1714641233895,MCWP 40R,B00,518781,Staff,8,0,20,12
1714641233895,MCWP 40R,C00,518783,Staff,6,0,20,14
1714641234921,MCWP 50R,A00,518791,Staff,0,0,20,20
1714641234921,MCWP 50R,B00,518792,Staff,0,2,20,20
1714641234921,MCWP 50R,C00,518793,Staff,0,2,20,20
1714641234921,MCWP 50R,D00,518794,Staff,0,1,20,20
1714641234921,MCWP 50R,E00,518795,Staff,0,2,20,20
1714641234921,MCWP 50R,F00,518796,Staff,0,0,20,20
1714641234921,MCWP 50R,G00,518797,Staff,0,1,20,20
1714641235949,MMW 12R,A01,514034,Herbst; Matthew,0,0,16,16
1714641235949,MMW 12R,A02,514035,Herbst; Matthew,1,0,16,15
1714641236977,MMW 13R,A01,514037,Staff,0,4,16,16
1714641236977,MMW 13R,A02,514039,Staff,0,2,16,16
1714641236977,MMW 13R,A03,628519,Staff,0,2,16,16
1714641239034,SIO 295LS,A00,523233,Staff,10,0,30,20
1714641240059,SIO 295S,A00,523232,Staff,10,0,30,20
1714641241087,SIOC 290S,A01,637330,Merrifield; Mark A,23,0,30,7
1714641242112,SIOC 291S,A01,637333,Gabriel; Corey John,23,0,30,7
1714641243143,SOCI 117,A01,494376,Staff,0,4,5,5
1714641244167,WES 237B,A00,494380,Staff,9,0,20,11
1714641246240,AESE 279B,A00,494370,Wade; Jon P,0,0,33,33
1714641247266,AIP 197,001,627712,Vespa; Emanuel Ignacio,9998,0,9999,1
1714641248296,ANAR 135S,A00,494369,Braswell; Geoffrey E.,0,0,0,0
1714641249328,BENG 196,001,628496,Engler; Adam J.,9998,0,9999,1
1714641250354,CAT 124RS,A01,519847,Geibel; William,0,0,20,20
1714641251380,CAT 125RS,A01,515971,Geibel; William,0,0,20,20
1714641252410,CLRE 250,A00,511389,Morris; Sheldon,9993,0,9999,6
1714641253439,CLRE 251,A00,507176,Mehta; Ravindra L.,9993,0,9999,6
1714641253439,CLRE 251,B00,511410,Mehta; Ravindra L.,9998,0,9999,1
1714641254467,CLRE 252,A00,507189,Cuomo; Raphael Eduardo,9995,0,9999,4
1714641255699,CLRE 253,A00,507199,Vaida; Florin,9994,0,9999,5
1714641255699,CLRE 253,B00,507202,Vaida; Florin,9999,0,9999,0
1714641256723,CLRE 259,A00,507211,Patel; Hemal,9996,0,9999,3
1714641257749,CLRE 260,A00,507221,Cuomo; Raphael Eduardo,9999,0,9999,0
1714641258774,CLRE 297,001,507242,Cuomo; Raphael Eduardo,9999,0,9999,0
1714641259802,COGS 197,001,638244,Voytek; Bradley Thomas,9998,0,9999,1
1714641260827,CSE 191,A00,516875,Minnes Kemp; Mor Mia,9992,0,9999,7
1714641261854,CSE 197,001,637388,Minnes Kemp; Mor Mia,9998,0,9999,1
1714641262881,CSS 201S,A01,494383,Staff,35,0,35,0
1714641263907,CSS 202S,A01,494387,Staff,35,0,35,0
1714641264931,DSC 197,001,628532,Eldridge; Justin Matthew,9996,0,9999,3
1714641265955,EAP 100,A00,516065,Staff,9797,0,9999,202
1714641266985,ECE 45,A01,507414,Staff,33,0,60,27
1714641269041,ECE 111,A01,507420,Staff,15,0,50,35
1714641270069,ECE 197,001,548057,Sievenpiper; Daniel F.,9993,0,9999,6
1714641271096,EDS 115,A00,507243,Choi; Bailey Miyeon,10,0,28,18
1714641272122,EDS 117,A01,494379,Staff,0,4,30,30
1714641273203,EDS 125,A00,507246,Hopkins; Megan Beth,9,0,30,21
1714641274233,EDS 128A,A01,507264,Fargason; Sharon Gayle,8,0,26,18
1714641275261,EDS 128B,A01,507293,Pappas; Elizabeth,12,0,30,18
1714641276287,EDS 139,A00,507294,Fargason; Sharon Gayle,13,0,30,17
1714641276287,EDS 139,B00,507313,Pappas; Elizabeth,13,0,30,17
1714641277312,EDS 201,A00,507315,Staff,13,0,30,17
1714641278338,EDS 203,A01,507317,Halter; Christopher P.,12,0,30,18
1714641279365,EDS 204R,A01,507319,Halter; Christopher P.,0,3,30,30
1714641279365,EDS 204R,B01,507331,Heinzman; Erica M.,16,0,30,14
1714641280389,EDS 206R,A00,507332,Staff,0,4,30,30
1714641280389,EDS 206R,B00,507343,Staff,17,0,30,13
1714641281419,EDS 250,A00,507344,Hemans; Patricia Ann Benitez,22,0,40,18
1714641282445,EDS 281,A00,507345,Daly; Alan J.,18,0,18,0
1714641283473,EDS 284,A00,507350,Daly; Alan J.,16,0,16,0
1714641284499,EDS 286,A00,507359,Fine; Sarah,18,0,18,0
1714641285528,EDS 289C,A01,507361,Daly; Alan J.,18,0,18,0
1714641286557,EDS 290,A00,507366,Hofstetter; Carolyn,15,0,15,0
1714641287582,LIGM 5A,A00,507421,Fischer-Grunski; Eva K,18,0,20,2
1714641288613,LIGM 5B,A00,507423,Fischer-Grunski; Eva K,19,0,20,1
1714641289638,LIGM 5C,A00,507425,Fischer-Grunski; Eva K,19,0,20,1
1714641290664,LIIT 5AS,A00,507427,Carnelos; Chiara,20,0,20,0
1714641291690,LIIT 5BS,A00,507430,Carnelos; Chiara,20,0,20,0
1714641292719,LIIT 5CS,A00,507432,Carnelos; Chiara,20,0,20,0
1714641293748,LISP 5A,A00,507541,Munoz Sanchez; Alicia,11,0,20,9
1714641294775,LISP 5B,A00,507671,Munoz Sanchez; Alicia,8,0,20,12
1714641295802,LISP 5C,A00,507696,Munoz Sanchez; Alicia,9,0,20,11
1714641296828,MAE 197,001,528363,Boechler; Nicholas Sebastia,9998,0,9999,1
1714641297859,MATH 197,001,523477,Kedlaya; Kiran S.,9995,0,9999,4
1714641297859,MATH 197,002,563811,Zhang; Danna,9995,0,9999,4
1714641297859,MATH 197,003,628552,Dumitriu; Ioana,9998,0,9999,1
1714641298888,MCWP 40R,A00,518780,Staff,2,0,20,18
1714641298888,MCWP 40R,B00,518781,Staff,8,0,20,12
1714641298888,MCWP 40R,C00,518783,Staff,6,0,20,14
1714641299915,MCWP 50R,A00,518791,Staff,0,0,20,20
1714641299915,MCWP 50R,B00,518792,Staff,0,2,20,20
1714641299915,MCWP 50R,C00,518793,Staff,0,2,20,20
1714641299915,MCWP 50R,D00,518794,Staff,0,1,20,20
1714641299915,MCWP 50R,E00,518795,Staff,0,2,20,20
1714641299915,MCWP 50R,F00,518796,Staff,0,0,20,20
1714641299915,MCWP 50R,G00,518797,Staff,0,1,20,20
1714641300941,MMW 12R,A01,514034,Herbst; Matthew,0,0,16,16
1714641300941,MMW 12R,A02,514035,Herbst; Matthew,1,0,16,15
1714641301968,MMW 13R,A01,514037,Staff,0,4,16,16
1714641301968,MMW 13R,A02,514039,Staff,0,2,16,16
1714641301968,MMW 13R,A03,628519,Staff,0,2,16,16
1714641304017,SIO 295LS,A00,523233,Staff,10,0,30,20
1714641305043,SIO 295S,A00,523232,Staff,10,0,30,20
1714641306073,SIOC 290S,A01,637330,Merrifield; Mark A,23,0,30,7
1714641307100,SIOC 291S,A01,637333,Gabriel; Corey John,23,0,30,7
1714641308127,SOCI 117,A01,494376,Staff,0,4,5,5
1714641309155,WES 237B,A00,494380,Staff,9,0,20,11
1714641311226,AESE 279B,A00,494370,Wade; Jon P,0,0,33,33
1714641312251,AIP 197,001,627712,Vespa; Emanuel Ignacio,9998,0,9999,1
1714641313279,ANAR 135S,A00,494369,Braswell; Geoffrey E.,0,0,0,0
1714641314305,BENG 196,001,628496,Engler; Adam J.,9998,0,9999,1
1714641315330,CAT 124RS,A01,519847,Geibel; William,0,0,20,20
1714641316353,CAT 125RS,A01,515971,Geibel; William,0,0,20,20
1714641317379,CLRE 250,A00,511389,Morris; Sheldon,9993,0,9999,6
1714641318407,CLRE 251,A00,507176,Mehta; Ravindra L.,9993,0,9999,6
1714641318407,CLRE 251,B00,511410,Mehta; Ravindra L.,9998,0,9999,1
1714641319436,CLRE 252,A00,507189,Cuomo; Raphael Eduardo,9995,0,9999,4
1714641320469,CLRE 253,A00,507199,Vaida; Florin,9994,0,9999,5
1714641320469,CLRE 253,B00,507202,Vaida; Florin,9999,0,9999,0
1714641321499,CLRE 259,A00,507211,Patel; Hemal,9996,0,9999,3
1714641322530,CLRE 260,A00,507221,Cuomo; Raphael Eduardo,9999,0,9999,0
1714641323556,CLRE 297,001,507242,Cuomo; Raphael Eduardo,9999,0,9999,0
1714641324584,COGS 197,001,638244,Voytek; Bradley Thomas,9998,0,9999,1
1714641325608,CSE 191,A00,516875,Minnes Kemp; Mor Mia,9992,0,9999,7
1714641326636,CSE 197,001,637388,Minnes Kemp; Mor Mia,9998,0,9999,1
1714641327663,CSS 201S,A01,494383,Staff,35,0,35,0
1714641328689,CSS 202S,A01,494387,Staff,35,0,35,0
1714641329714,DSC 197,001,628532,Eldridge; Justin Matthew,9996,0,9999,3
1714641330742,EAP 100,A00,516065,Staff,9797,0,9999,202
1714641331769,ECE 45,A01,507414,Staff,33,0,60,27
1714641333826,ECE 111,A01,507420,Staff,15,0,50,35
1714641334853,ECE 197,001,548057,Sievenpiper; Daniel F.,9993,0,9999,6
1714641335880,EDS 115,A00,507243,Choi; Bailey Miyeon,10,0,28,18
1714641336909,EDS 117,A01,494379,Staff,0,4,30,30
1714641337940,EDS 125,A00,507246,Hopkins; Megan Beth,9,0,30,21
1714641338966,EDS 128A,A01,507264,Fargason; Sharon Gayle,8,0,26,18
1714641339992,EDS 128B,A01,507293,Pappas; Elizabeth,12,0,30,18
1714641341021,EDS 139,A00,507294,Fargason; Sharon Gayle,13,0,30,17
1714641341021,EDS 139,B00,507313,Pappas; Elizabeth,13,0,30,17
1714641342047,EDS 201,A00,507315,Staff,13,0,30,17
1714641343072,EDS 203,A01,507317,Halter; Christopher P.,12,0,30,18
1714641344098,EDS 204R,A01,507319,Halter; Christopher P.,0,3,30,30
1714641344098,EDS 204R,B01,507331,Heinzman; Erica M.,16,0,30,14
1714641345125,EDS 206R,A00,507332,Staff,0,4,30,30
1714641345125,EDS 206R,B00,507343,Staff,17,0,30,13
1714641346154,EDS 250,A00,507344,Hemans; Patricia Ann Benitez,22,0,40,18
1714641347182,EDS 281,A00,507345,Daly; Alan J.,18,0,18,0
1714641348208,EDS 284,A00,507350,Daly; Alan J.,16,0,16,0
1714641349233,EDS 286,A00,507359,Fine; Sarah,18,0,18,0
1714641350259,EDS 289C,A01,507361,Daly; Alan J.,18,0,18,0
1714641351285,EDS 290,A00,507366,Hofstetter; Carolyn,15,0,15,0
1714641352312,LIGM 5A,A00,507421,Fischer-Grunski; Eva K,18,0,20,2
1714641353336,LIGM 5B,A00,507423,Fischer-Grunski; Eva K,19,0,20,1
1714641354365,LIGM 5C,A00,507425,Fischer-Grunski; Eva K,19,0,20,1
1714641355393,LIIT 5AS,A00,507427,Carnelos; Chiara,20,0,20,0
1714641356419,LIIT 5BS,A00,507430,Carnelos; Chiara,20,0,20,0
1714641357449,LIIT 5CS,A00,507432,Carnelos; Chiara,20,0,20,0
1714641358475,LISP 5A,A00,507541,Munoz Sanchez; Alicia,11,0,20,9
1714641359501,LISP 5B,A00,507671,Munoz Sanchez; Alicia,8,0,20,12
1714641360528,LISP 5C,A00,507696,Munoz Sanchez; Alicia,9,0,20,11
1714641361554,MAE 197,001,528363,Boechler; Nicholas Sebastia,9998,0,9999,1
1714641362583,MATH 197,001,523477,Kedlaya; Kiran S.,9995,0,9999,4
1714641362583,MATH 197,002,563811,Zhang; Danna,9995,0,9999,4
1714641362583,MATH 197,003,628552,Dumitriu; Ioana,9998,0,9999,1
1714641363612,MCWP 40R,A00,518780,Staff,2,0,20,18
1714641363612,MCWP 40R,B00,518781,Staff,8,0,20,12
1714641363612,MCWP 40R,C00,518783,Staff,6,0,20,14
1714641364639,MCWP 50R,A00,518791,Staff,0,0,20,20
1714641364639,MCWP 50R,B00,518792,Staff,0,2,20,20
1714641364639,MCWP 50R,C00,518793,Staff,0,2,20,20
1714641364639,MCWP 50R,D00,518794,Staff,0,1,20,20
1714641364639,MCWP 50R,E00,518795,Staff,0,2,20,20
1714641364639,MCWP 50R,F00,518796,Staff,0,0,20,20
1714641364639,MCWP 50R,G00,518797,Staff,0,1,20,20
1714641365665,MMW 12R,A01,514034,Herbst; Matthew,0,0,16,16
1714641365665,MMW 12R,A02,514035,Herbst; Matthew,1,0,16,15
1714641366692,MMW 13R,A01,514037,Staff,0,4,16,16
1714641366692,MMW 13R,A02,514039,Staff,0,2,16,16
1714641366692,MMW 13R,A03,628519,Staff,0,2,16,16
1714641368744,SIO 295LS,A00,523233,Staff,10,0,30,20
1714641369772,SIO 295S,A00,523232,Staff,10,0,30,20
1714641370800,SIOC 290S,A01,637330,Merrifield; Mark A,23,0,30,7
1714641371830,SIOC 291S,A01,637333,Gabriel; Corey John,23,0,30,7
1714641372861,SOCI 117,A01,494376,Staff,0,4,5,5
1714641373886,WES 237B,A00,494380,Staff,9,0,20,11
1714641375960,AESE 279B,A00,494370,Wade; Jon P,0,0,33,33
1714641377042,AIP 197,001,627712,Vespa; Emanuel Ignacio,9998,0,9999,1
1714641378068,ANAR 135S,A00,494369,Braswell; Geoffrey E.,0,0,0,0
1714641379094,BENG 196,001,628496,Engler; Adam J.,9998,0,9999,1
1714641380127,CAT 124RS,A01,519847,Geibel; William,0,0,20,20
1714641381154,CAT 125RS,A01,515971,Geibel; William,0,0,20,20
1714641382186,CLRE 250,A00,511389,Morris; Sheldon,9993,0,9999,6
1714641383217,CLRE 251,A00,507176,Mehta; Ravindra L.,9993,0,9999,6
1714641383217,CLRE 251,B00,511410,Mehta; Ravindra L.,9998,0,9999,1
1714641384244,CLRE 252,A00,507189,Cuomo; Raphael Eduardo,9995,0,9999,4
1714641385273,CLRE 253,A00,507199,Vaida; Florin,9994,0,9999,5
1714641385273,CLRE 253,B00,507202,Vaida; Florin,9999,0,9999,0
1714641386299,CLRE 259,A00,507211,Patel; Hemal,9996,0,9999,3
1714641387323,CLRE 260,A00,507221,Cuomo; Raphael Eduardo,9999,0,9999,0
1714641388349,CLRE 297,001,507242,Cuomo; Raphael Eduardo,9999,0,9999,0
1714641389378,COGS 197,001,638244,Voytek; Bradley Thomas,9998,0,9999,1
1714641390405,CSE 191,A00,516875,Minnes Kemp; Mor Mia,9992,0,9999,7
1714641391431,CSE 197,001,637388,Minnes Kemp; Mor Mia,9998,0,9999,1
1714641392461,CSS 201S,A01,494383,Staff,35,0,35,0
1714641393487,CSS 202S,A01,494387,Staff,35,0,35,0
1714641394513,DSC 197,001,628532,Eldridge; Justin Matthew,9996,0,9999,3
1714641395540,EAP 100,A00,516065,Staff,9797,0,9999,202
1714641396571,ECE 45,A01,507414,Staff,33,0,60,27
1714641398620,ECE 111,A01,507420,Staff,15,0,50,35
1714641399644,ECE 197,001,548057,Sievenpiper; Daniel F.,9993,0,9999,6
1714641400675,EDS 115,A00,507243,Choi; Bailey Miyeon,10,0,28,18
1714641401702,EDS 117,A01,494379,Staff,0,4,30,30
1714641402732,EDS 125,A00,507246,Hopkins; Megan Beth,9,0,30,21
1714641403758,EDS 128A,A01,507264,Fargason; Sharon Gayle,8,0,26,18
1714641404783,EDS 128B,A01,507293,Pappas; Elizabeth,12,0,30,18
1714641405807,EDS 139,A00,507294,Fargason; Sharon Gayle,13,0,30,17
1714641405807,EDS 139,B00,507313,Pappas; Elizabeth,13,0,30,17
1714641406830,EDS 201,A00,507315,Staff,13,0,30,17
1714641407859,EDS 203,A01,507317,Halter; Christopher P.,12,0,30,18
1714641408886,EDS 204R,A01,507319,Halter; Christopher P.,0,3,30,30
1714641408886,EDS 204R,B01,507331,Heinzman; Erica M.,16,0,30,14
1714641409913,EDS 206R,A00,507332,Staff,0,4,30,30
1714641409913,EDS 206R,B00,507343,Staff,17,0,30,13
1714641410938,EDS 250,A00,507344,Hemans; Patricia Ann Benitez,22,0,40,18
1714641411964,EDS 281,A00,507345,Daly; Alan J.,18,0,18,0
1714641412989,EDS 284,A00,507350,Daly; Alan J.,16,0,16,0
1714641414021,EDS 286,A00,507359,Fine; Sarah,18,0,18,0
1714641415047,EDS 289C,A01,507361,Daly; Alan J.,18,0,18,0
1714641416075,EDS 290,A00,507366,Hofstetter; Carolyn,15,0,15,0
1714641417101,LIGM 5A,A00,507421,Fischer-Grunski; Eva K,18,0,20,2
1714641418126,LIGM 5B,A00,507423,Fischer-Grunski; Eva K,19,0,20,1
1714641419153,LIGM 5C,A00,507425,Fischer-Grunski; Eva K,19,0,20,1
1714641420214,LIIT 5AS,A00,507427,Carnelos; Chiara,20,0,20,0
1714641421245,LIIT 5BS,A00,507430,Carnelos; Chiara,20,0,20,0
1714641422271,LIIT 5CS,A00,507432,Carnelos; Chiara,20,0,20,0
1714641423297,LISP 5A,A00,507541,Munoz Sanchez; Alicia,11,0,20,9
1714641424324,LISP 5B,A00,507671,Munoz Sanchez; Alicia,8,0,20,12
1714641425349,LISP 5C,A00,507696,Munoz Sanchez; Alicia,9,0,20,11
1714641426379,MAE 197,001,528363,Boechler; Nicholas Sebastia,9998,0,9999,1
1714641427406,MATH 197,001,523477,Kedlaya; Kiran S.,9995,0,9999,4
1714641427406,MATH 197,002,563811,Zhang; Danna,9995,0,9999,4
1714641427406,MATH 197,003,628552,Dumitriu; Ioana,9998,0,9999,1
1714641428436,MCWP 40R,A00,518780,Staff,2,0,20,18
1714641428436,MCWP 40R,B00,518781,Staff,8,0,20,12
1714641428436,MCWP 40R,C00,518783,Staff,6,0,20,14
1714641429466,MCWP 50R,A00,518791,Staff,0,0,20,20
1714641429466,MCWP 50R,B00,518792,Staff,0,2,20,20
1714641429466,MCWP 50R,C00,518793,Staff,0,2,20,20
1714641429466,MCWP 50R,D00,518794,Staff,0,1,20,20
1714641429466,MCWP 50R,E00,518795,Staff,0,2,20,20
1714641429466,MCWP 50R,F00,518796,Staff,0,0,20,20
1714641429466,MCWP 50R,G00,518797,Staff,0,1,20,20
1714641430494,MMW 12R,A01,514034,Herbst; Matthew,0,0,16,16
1714641430494,MMW 12R,A02,514035,Herbst; Matthew,1,0,16,15
1714641431519,MMW 13R,A01,514037,Staff,0,4,16,16
1714641431519,MMW 13R,A02,514039,Staff,0,2,16,16
1714641431519,MMW 13R,A03,628519,Staff,0,2,16,16
1714641433574,SIO 295LS,A00,523233,Staff,10,0,30,20
1714641434600,SIO 295S,A00,523232,Staff,10,0,30,20
1714641435625,SIOC 290S,A01,637330,Merrifield; Mark A,23,0,30,7
1714641436654,SIOC 291S,A01,637333,Gabriel; Corey John,23,0,30,7
1714641437678,SOCI 117,A01,494376,Staff,0,4,5,5
1714641438707,WES 237B,A00,494380,Staff,9,0,20,11
1714641440783,AESE 279B,A00,494370,Wade; Jon P,0,0,33,33
1714641441811,AIP 197,001,627712,Vespa; Emanuel Ignacio,9998,0,9999,1
1714641442836,ANAR 135S,A00,494369,Braswell; Geoffrey E.,0,0,0,0
1714641443874,BENG 196,001,628496,Engler; Adam J.,9998,0,9999,1
1714641444899,CAT 124RS,A01,519847,Geibel; William,0,0,20,20
1714641445924,CAT 125RS,A01,515971,Geibel; William,0,0,20,20
1714641446955,CLRE 250,A00,511389,Morris; Sheldon,9993,0,9999,6
1714641447981,CLRE 251,A00,507176,Mehta; Ravindra L.,9993,0,9999,6
1714641447981,CLRE 251,B00,511410,Mehta; Ravindra L.,9998,0,9999,1
1714641449006,CLRE 252,A00,507189,Cuomo; Raphael Eduardo,9995,0,9999,4
1714641450035,CLRE 253,A00,507199,Vaida; Florin,9994,0,9999,5
1714641450035,CLRE 253,B00,507202,Vaida; Florin,9999,0,9999,0
1714641451063,CLRE 259,A00,507211,Patel; Hemal,9996,0,9999,3
1714641452089,CLRE 260,A00,507221,Cuomo; Raphael Eduardo,9999,0,9999,0
1714641453117,CLRE 297,001,507242,Cuomo; Raphael Eduardo,9999,0,9999,0
1714641454142,COGS 197,001,638244,Voytek; Bradley Thomas,9998,0,9999,1
1714641455171,CSE 191,A00,516875,Minnes Kemp; Mor Mia,9992,0,9999,7
1714641456198,CSE 197,001,637388,Minnes Kemp; Mor Mia,9998,0,9999,1
1714641457233,CSS 201S,A01,494383,Staff,35,0,35,0
1714641458260,CSS 202S,A01,494387,Staff,35,0,35,0
1714641459290,DSC 197,001,628532,Eldridge; Justin Matthew,9996,0,9999,3
1714641460317,EAP 100,A00,516065,Staff,9797,0,9999,202
1714641461343,ECE 45,A01,507414,Staff,33,0,60,27
1714641463392,ECE 111,A01,507420,Staff,15,0,50,35
1714641464420,ECE 197,001,548057,Sievenpiper; Daniel F.,9993,0,9999,6
1714641465448,EDS 115,A00,507243,Choi; Bailey Miyeon,10,0,28,18
1714641466479,EDS 117,A01,494379,Staff,0,4,30,30
1714641467504,EDS 125,A00,507246,Hopkins; Megan Beth,9,0,30,21
1714641468530,EDS 128A,A01,507264,Fargason; Sharon Gayle,8,0,26,18
1714641469557,EDS 128B,A01,507293,Pappas; Elizabeth,12,0,30,18
1714641470584,EDS 139,A00,507294,Fargason; Sharon Gayle,13,0,30,17
1714641470584,EDS 139,B00,507313,Pappas; Elizabeth,13,0,30,17
1714641471610,EDS 201,A00,507315,Staff,13,0,30,17
1714641472641,EDS 203,A01,507317,Halter; Christopher P.,12,0,30,18
1714641473669,EDS 204R,A01,507319,Halter; Christopher P.,0,3,30,30
1714641473669,EDS 204R,B01,507331,Heinzman; Erica M.,16,0,30,14
1714641474697,EDS 206R,A00,507332,Staff,0,4,30,30
1714641474697,EDS 206R,B00,507343,Staff,17,0,30,13
1714641475722,EDS 250,A00,507344,Hemans; Patricia Ann Benitez,22,0,40,18
1714641476750,EDS 281,A00,507345,Daly; Alan J.,18,0,18,0
1714641477775,EDS 284,A00,507350,Daly; Alan J.,16,0,16,0
1714641478804,EDS 286,A00,507359,Fine; Sarah,18,0,18,0
1714641479829,EDS 289C,A01,507361,Daly; Alan J.,18,0,18,0
1714641480909,EDS 290,A00,507366,Hofstetter; Carolyn,15,0,15,0
1714641481935,LIGM 5A,A00,507421,Fischer-Grunski; Eva K,18,0,20,2
1714641482961,LIGM 5B,A00,507423,Fischer-Grunski; Eva K,19,0,20,1
1714641483989,LIGM 5C,A00,507425,Fischer-Grunski; Eva K,19,0,20,1
1714641485015,LIIT 5AS,A00,507427,Carnelos; Chiara,20,0,20,0
1714641486045,LIIT 5BS,A00,507430,Carnelos; Chiara,20,0,20,0
1714641487076,LIIT 5CS,A00,507432,Carnelos; Chiara,20,0,20,0
1714641488102,LISP 5A,A00,507541,Munoz Sanchez; Alicia,11,0,20,9
1714641489130,LISP 5B,A00,507671,Munoz Sanchez; Alicia,8,0,20,12
1714641490155,LISP 5C,A00,507696,Munoz Sanchez; Alicia,9,0,20,11
1714641491186,MAE 197,001,528363,Boechler; Nicholas Sebastia,9998,0,9999,1
1714641492215,MATH 197,001,523477,Kedlaya; Kiran S.,9995,0,9999,4
1714641492215,MATH 197,002,563811,Zhang; Danna,9995,0,9999,4
1714641492215,MATH 197,003,628552,Dumitriu; Ioana,9998,0,9999,1
1714641493242,MCWP 40R,A00,518780,Staff,2,0,20,18
1714641493242,MCWP 40R,B00,518781,Staff,8,0,20,12
1714641493242,MCWP 40R,C00,518783,Staff,6,0,20,14
1714641494272,MCWP 50R,A00,518791,Staff,0,0,20,20
1714641494272,MCWP 50R,B00,518792,Staff,0,2,20,20
1714641494272,MCWP 50R,C00,518793,Staff,0,2,20,20
1714641494272,MCWP 50R,D00,518794,Staff,0,1,20,20
1714641494272,MCWP 50R,E00,518795,Staff,0,2,20,20
1714641494272,MCWP 50R,F00,518796,Staff,0,0,20,20
1714641494272,MCWP 50R,G00,518797,Staff,0,1,20,20
1714641495298,MMW 12R,A01,514034,Herbst; Matthew,0,0,16,16
1714641495298,MMW 12R,A02,514035,Herbst; Matthew,1,0,16,15
1714641496323,MMW 13R,A01,514037,Staff,0,4,16,16
1714641496323,MMW 13R,A02,514039,Staff,0,2,16,16
1714641496323,MMW 13R,A03,628519,Staff,0,2,16,16
1714641498379,SIO 295LS,A00,523233,Staff,10,0,30,20
1714641499406,SIO 295S,A00,523232,Staff,10,0,30,20
1714641500433,SIOC 290S,A01,637330,Merrifield; Mark A,23,0,30,7
1714641501459,SIOC 291S,A01,637333,Gabriel; Corey John,23,0,30,7
1714641502484,SOCI 117,A01,494376,Staff,0,4,5,5
1714641503511,WES 237B,A00,494380,Staff,9,0,20,11
1714641505595,AESE 279B,A00,494370,Wade; Jon P,0,0,33,33
1714641506624,AIP 197,001,627712,Vespa; Emanuel Ignacio,9998,0,9999,1
1714641507650,ANAR 135S,A00,494369,Braswell; Geoffrey E.,0,0,0,0
1714641508677,BENG 196,001,628496,Engler; Adam J.,9998,0,9999,1
1714641509706,CAT 124RS,A01,519847,Geibel; William,0,0,20,20
1714641510735,CAT 125RS,A01,515971,Geibel; William,0,0,20,20
1714641511766,CLRE 250,A00,511389,Morris; Sheldon,9993,0,9999,6
1714641512797,CLRE 251,A00,507176,Mehta; Ravindra L.,9993,0,9999,6
1714641512797,CLRE 251,B00,511410,Mehta; Ravindra L.,9998,0,9999,1
1714641513822,CLRE 252,A00,507189,Cuomo; Raphael Eduardo,9995,0,9999,4
1714641514853,CLRE 253,A00,507199,Vaida; Florin,9994,0,9999,5
1714641514853,CLRE 253,B00,507202,Vaida; Florin,9999,0,9999,0
1714641515879,CLRE 259,A00,507211,Patel; Hemal,9996,0,9999,3
1714641516905,CLRE 260,A00,507221,Cuomo; Raphael Eduardo,9999,0,9999,0
1714641517931,CLRE 297,001,507242,Cuomo; Raphael Eduardo,9999,0,9999,0
1714641518956,COGS 197,001,638244,Voytek; Bradley Thomas,9998,0,9999,1
1714641519986,CSE 191,A00,516875,Minnes Kemp; Mor Mia,9992,0,9999,7
1714641521011,CSE 197,001,637388,Minnes Kemp; Mor Mia,9998,0,9999,1
1714641522039,CSS 201S,A01,494383,Staff,35,0,35,0
1714641523069,CSS 202S,A01,494387,Staff,35,0,35,0
1714641524094,DSC 197,001,628532,Eldridge; Justin Matthew,9996,0,9999,3
1714641525122,EAP 100,A00,516065,Staff,9797,0,9999,202
1714641526147,ECE 45,A01,507414,Staff,33,0,60,27
1714641528197,ECE 111,A01,507420,Staff,15,0,50,35
1714641529226,ECE 197,001,548057,Sievenpiper; Daniel F.,9993,0,9999,6
1714641530255,EDS 115,A00,507243,Choi; Bailey Miyeon,10,0,28,18
1714641531282,EDS 117,A01,494379,Staff,0,4,30,30
1714641532308,EDS 125,A00,507246,Hopkins; Megan Beth,9,0,30,21
1714641533333,EDS 128A,A01,507264,Fargason; Sharon Gayle,8,0,26,18
1714641534362,EDS 128B,A01,507293,Pappas; Elizabeth,12,0,30,18
1714641535387,EDS 139,A00,507294,Fargason; Sharon Gayle,13,0,30,17
1714641535387,EDS 139,B00,507313,Pappas; Elizabeth,13,0,30,17
1714641536412,EDS 201,A00,507315,Staff,13,0,30,17
1714641537441,EDS 203,A01,507317,Halter; Christopher P.,12,0,30,18
1714641538466,EDS 204R,A01,507319,Halter; Christopher P.,0,3,30,30
1714641538466,EDS 204R,B01,507331,Heinzman; Erica M.,16,0,30,14
1714641539492,EDS 206R,A00,507332,Staff,0,4,30,30
1714641539492,EDS 206R,B00,507343,Staff,17,0,30,13
1714641540518,EDS 250,A00,507344,Hemans; Patricia Ann Benitez,22,0,40,18
1714641541542,EDS 281,A00,507345,Daly; Alan J.,18,0,18,0
1714641542569,EDS 284,A00,507350,Daly; Alan J.,16,0,16,0
1714641543599,EDS 286,A00,507359,Fine; Sarah,18,0,18,0
1714641544623,EDS 289C,A01,507361,Daly; Alan J.,18,0,18,0
1714641545648,EDS 290,A00,507366,Hofstetter; Carolyn,15,0,15,0
1714641546677,LIGM 5A,A00,507421,Fischer-Grunski; Eva K,18,0,20,2
1714641547704,LIGM 5B,A00,507423,Fischer-Grunski; Eva K,19,0,20,1
1714641548728,LIGM 5C,A00,507425,Fischer-Grunski; Eva K,19,0,20,1
1714641549756,LIIT 5AS,A00,507427,Carnelos; Chiara,20,0,20,0
1714641550780,LIIT 5BS,A00,507430,Carnelos; Chiara,20,0,20,0
1714641551805,LIIT 5CS,A00,507432,Carnelos; Chiara,20,0,20,0
1714641552831,LISP 5A,A00,507541,Munoz Sanchez; Alicia,11,0,20,9
1714641553859,LISP 5B,A00,507671,Munoz Sanchez; Alicia,8,0,20,12
1714641554885,LISP 5C,A00,507696,Munoz Sanchez; Alicia,9,0,20,11
1714641555910,MAE 197,001,528363,Boechler; Nicholas Sebastia,9998,0,9999,1
1714641556938,MATH 197,001,523477,Kedlaya; Kiran S.,9995,0,9999,4
1714641556938,MATH 197,002,563811,Zhang; Danna,9995,0,9999,4
1714641556938,MATH 197,003,628552,Dumitriu; Ioana,9998,0,9999,1
1714641557970,MCWP 40R,A00,518780,Staff,2,0,20,18
1714641557970,MCWP 40R,B00,518781,Staff,8,0,20,12
1714641557970,MCWP 40R,C00,518783,Staff,6,0,20,14
1714641558997,MCWP 50R,A00,518791,Staff,0,0,20,20
1714641558997,MCWP 50R,B00,518792,Staff,0,2,20,20
1714641558997,MCWP 50R,C00,518793,Staff,0,2,20,20
1714641558997,MCWP 50R,D00,518794,Staff,0,1,20,20
1714641558997,MCWP 50R,E00,518795,Staff,0,2,20,20
1714641558997,MCWP 50R,F00,518796,Staff,0,0,20,20
1714641558997,MCWP 50R,G00,518797,Staff,0,1,20,20
1714641560023,MMW 12R,A01,514034,Herbst; Matthew,0,0,16,16
1714641560023,MMW 12R,A02,514035,Herbst; Matthew,1,0,16,15
1714641561049,MMW 13R,A01,514037,Staff,0,4,16,16
1714641561049,MMW 13R,A02,514039,Staff,0,2,16,16
1714641561049,MMW 13R,A03,628519,Staff,0,2,16,16
1714641563098,SIO 295LS,A00,523233,Staff,10,0,30,20
1714641564125,SIO 295S,A00,523232,Staff,10,0,30,20
1714641565150,SIOC 290S,A01,637330,Merrifield; Mark A,23,0,30,7
1714641566180,SIOC 291S,A01,637333,Gabriel; Corey John,23,0,30,7
1714641567207,SOCI 117,A01,494376,Staff,0,4,5,5
1714641568237,WES 237B,A00,494380,Staff,9,0,20,11
1714641570312,AESE 279B,A00,494370,Wade; Jon P,0,0,33,33
1714641571339,AIP 197,001,627712,Vespa; Emanuel Ignacio,9998,0,9999,1
1714641572365,ANAR 135S,A00,494369,Braswell; Geoffrey E.,0,0,0,0
1714641573390,BENG 196,001,628496,Engler; Adam J.,9998,0,9999,1
1714641574418,CAT 124RS,A01,519847,Geibel; William,0,0,20,20
1714641575445,CAT 125RS,A01,515971,Geibel; William,0,0,20,20
1714641576475,CLRE 250,A00,511389,Morris; Sheldon,9993,0,9999,6
1714641577501,CLRE 251,A00,507176,Mehta; Ravindra L.,9993,0,9999,6
1714641577501,CLRE 251,B00,511410,Mehta; Ravindra L.,9998,0,9999,1
1714641578532,CLRE 252,A00,507189,Cuomo; Raphael Eduardo,9995,0,9999,4
1714641579563,CLRE 253,A00,507199,Vaida; Florin,9994,0,9999,5
1714641579563,CLRE 253,B00,507202,Vaida; Florin,9999,0,9999,0
1714641580589,CLRE 259,A00,507211,Patel; Hemal,9996,0,9999,3
1714641581618,CLRE 260,A00,507221,Cuomo; Raphael Eduardo,9999,0,9999,0
1714641582644,CLRE 297,001,507242,Cuomo; Raphael Eduardo,9999,0,9999,0
1714641583671,COGS 197,001,638244,Voytek; Bradley Thomas,9998,0,9999,1
1714641584751,CSE 191,A00,516875,Minnes Kemp; Mor Mia,9992,0,9999,7
1714641585776,CSE 197,001,637388,Minnes Kemp; Mor Mia,9998,0,9999,1
1714641586801,CSS 201S,A01,494383,Staff,35,0,35,0
1714641587830,CSS 202S,A01,494387,Staff,35,0,35,0
1714641588857,DSC 197,001,628532,Eldridge; Justin Matthew,9996,0,9999,3
1714641589882,EAP 100,A00,516065,Staff,9797,0,9999,202
1714641590908,ECE 45,A01,507414,Staff,33,0,60,27
1714641592958,ECE 111,A01,507420,Staff,15,0,50,35
1714641593984,ECE 197,001,548057,Sievenpiper; Daniel F.,9993,0,9999,6
1714641595010,EDS 115,A00,507243,Choi; Bailey Miyeon,10,0,28,18
1714641596039,EDS 117,A01,494379,Staff,0,4,30,30
1714641597066,EDS 125,A00,507246,Hopkins; Megan Beth,9,0,30,21
1714641598094,EDS 128A,A01,507264,Fargason; Sharon Gayle,8,0,26,18
1714641599120,EDS 128B,A01,507293,Pappas; Elizabeth,12,0,30,18
1714641600148,EDS 139,A00,507294,Fargason; Sharon Gayle,13,0,30,17
1714641600148,EDS 139,B00,507313,Pappas; Elizabeth,13,0,30,17
1714641601175,EDS 201,A00,507315,Staff,13,0,30,17
1714641602202,EDS 203,A01,507317,Halter; Christopher P.,12,0,30,18
1714641603231,EDS 204R,A01,507319,Halter; Christopher P.,0,3,30,30
1714641603231,EDS 204R,B01,507331,Heinzman; Erica M.,16,0,30,14
1714641604255,EDS 206R,A00,507332,Staff,0,4,30,30
1714641604255,EDS 206R,B00,507343,Staff,17,0,30,13
1714641605283,EDS 250,A00,507344,Hemans; Patricia Ann Benitez,22,0,40,18
1714641606310,EDS 281,A00,507345,Daly; Alan J.,18,0,18,0
1714641607336,EDS 284,A00,507350,Daly; Alan J.,16,0,16,0
1714641608367,EDS 286,A00,507359,Fine; Sarah,18,0,18,0
1714641609392,EDS 289C,A01,507361,Daly; Alan J.,18,0,18,0
1714641610417,EDS 290,A00,507366,Hofstetter; Carolyn,15,0,15,0
1714641611444,LIGM 5A,A00,507421,Fischer-Grunski; Eva K,18,0,20,2
1714641612473,LIGM 5B,A00,507423,Fischer-Grunski; Eva K,19,0,20,1
1714641613497,LIGM 5C,A00,507425,Fischer-Grunski; Eva K,19,0,20,1
1714641614521,LIIT 5AS,A00,507427,Carnelos; Chiara,20,0,20,0
1714641615551,LIIT 5BS,A00,507430,Carnelos; Chiara,20,0,20,0
1714641616575,LIIT 5CS,A00,507432,Carnelos; Chiara,20,0,20,0
1714641617602,LISP 5A,A00,507541,Munoz Sanchez; Alicia,11,0,20,9
1714641618629,LISP 5B,A00,507671,Munoz Sanchez; Alicia,8,0,20,12
1714641619656,LISP 5C,A00,507696,Munoz Sanchez; Alicia,9,0,20,11
1714641620683,MAE 197,001,528363,Boechler; Nicholas Sebastia,9998,0,9999,1
1714641621711,MATH 197,001,523477,Kedlaya; Kiran S.,9995,0,9999,4
1714641621711,MATH 197,002,563811,Zhang; Danna,9995,0,9999,4
1714641621711,MATH 197,003,628552,Dumitriu; Ioana,9998,0,9999,1
1714641622740,MCWP 40R,A00,518780,Staff,2,0,20,18
1714641622740,MCWP 40R,B00,518781,Staff,8,0,20,12
1714641622740,MCWP 40R,C00,518783,Staff,6,0,20,14
1714641623773,MCWP 50R,A00,518791,Staff,0,0,20,20
1714641623773,MCWP 50R,B00,518792,Staff,0,2,20,20
1714641623773,MCWP 50R,C00,518793,Staff,0,2,20,20
1714641623773,MCWP 50R,D00,518794,Staff,0,1,20,20
1714641623773,MCWP 50R,E00,518795,Staff,0,2,20,20
1714641623773,MCWP 50R,F00,518796,Staff,0,0,20,20
1714641623773,MCWP 50R,G00,518797,Staff,0,1,20,20
1714641624800,MMW 12R,A01,514034,Herbst; Matthew,0,0,16,16
1714641624800,MMW 12R,A02,514035,Herbst; Matthew,1,0,16,15
1714641625829,MMW 13R,A01,514037,Staff,0,4,16,16
1714641625829,MMW 13R,A02,514039,Staff,0,2,16,16
1714641625829,MMW 13R,A03,628519,Staff,0,2,16,16
1714641627878,SIO 295LS,A00,523233,Staff,10,0,30,20
1714641628907,SIO 295S,A00,523232,Staff,10,0,30,20
1714641629937,SIOC 290S,A01,637330,Merrifield; Mark A,23,0,30,7
1714641630963,SIOC 291S,A01,637333,Gabriel; Corey John,23,0,30,7
1714641631987,SOCI 117,A01,494376,Staff,0,4,5,5
1714641633016,WES 237B,A00,494380,Staff,9,0,20,11
1714641635088,AESE 279B,A00,494370,Wade; Jon P,0,0,33,33
1714641636115,AIP 197,001,627712,Vespa; Emanuel Ignacio,9998,0,9999,1
1714641637139,ANAR 135S,A00,494369,Braswell; Geoffrey E.,0,0,0,0
1714641638168,BENG 196,001,628496,Engler; Adam J.,9998,0,9999,1
1714641639194,CAT 124RS,A01,519847,Geibel; William,0,0,20,20
1714641640222,CAT 125RS,A01,515971,Geibel; William,0,0,20,20
1714641641249,CLRE 250,A00,511389,Morris; Sheldon,9993,0,9999,6
1714641642275,CLRE 251,A00,507176,Mehta; Ravindra L.,9993,0,9999,6
1714641642275,CLRE 251,B00,511410,Mehta; Ravindra L.,9998,0,9999,1
1714641643306,CLRE 252,A00,507189,Cuomo; Raphael Eduardo,9995,0,9999,4
1714641644331,CLRE 253,A00,507199,Vaida; Florin,9994,0,9999,5
1714641644331,CLRE 253,B00,507202,Vaida; Florin,9999,0,9999,0
1714641645355,CLRE 259,A00,507211,Patel; Hemal,9996,0,9999,3
1714641646380,CLRE 260,A00,507221,Cuomo; Raphael Eduardo,9999,0,9999,0
1714641647405,CLRE 297,001,507242,Cuomo; Raphael Eduardo,9999,0,9999,0
1714641648431,COGS 197,001,638244,Voytek; Bradley Thomas,9998,0,9999,1
1714641649455,CSE 191,A00,516875,Minnes Kemp; Mor Mia,9992,0,9999,7
1714641650484,CSE 197,001,637388,Minnes Kemp; Mor Mia,9998,0,9999,1
1714641651512,CSS 201S,A01,494383,Staff,35,0,35,0
1714641652543,CSS 202S,A01,494387,Staff,35,0,35,0
1714641653569,DSC 197,001,628532,Eldridge; Justin Matthew,9996,0,9999,3
1714641654595,EAP 100,A00,516065,Staff,9797,0,9999,202
1714641655620,ECE 45,A01,507414,Staff,33,0,60,27
1714641657673,ECE 111,A01,507420,Staff,15,0,50,35
1714641658698,ECE 197,001,548057,Sievenpiper; Daniel F.,9993,0,9999,6
1714641659729,EDS 115,A00,507243,Choi; Bailey Miyeon,10,0,28,18
1714641660757,EDS 117,A01,494379,Staff,0,4,30,30
1714641661785,EDS 125,A00,507246,Hopkins; Megan Beth,9,0,30,21
1714641662814,EDS 128A,A01,507264,Fargason; Sharon Gayle,8,0,26,18
1714641663840,EDS 128B,A01,507293,Pappas; Elizabeth,12,0,30,18
1714641664866,EDS 139,A00,507294,Fargason; Sharon Gayle,13,0,30,17
1714641664866,EDS 139,B00,507313,Pappas; Elizabeth,13,0,30,17
1714641665891,EDS 201,A00,507315,Staff,13,0,30,17
1714641666917,EDS 203,A01,507317,Halter; Christopher P.,12,0,30,18
1714641667945,EDS 204R,A01,507319,Halter; Christopher P.,0,3,30,30
1714641667945,EDS 204R,B01,507331,Heinzman; Erica M.,16,0,30,14
1714641668971,EDS 206R,A00,507332,Staff,0,4,30,30
1714641668971,EDS 206R,B00,507343,Staff,17,0,30,13
1714641669995,EDS 250,A00,507344,Hemans; Patricia Ann Benitez,22,0,40,18
1714641671025,EDS 281,A00,507345,Daly; Alan J.,18,0,18,0
1714641672049,EDS 284,A00,507350,Daly; Alan J.,16,0,16,0
1714641673079,EDS 286,A00,507359,Fine; Sarah,18,0,18,0
1714641674107,EDS 289C,A01,507361,Daly; Alan J.,18,0,18,0
1714641675136,EDS 290,A00,507366,Hofstetter; Carolyn,15,0,15,0
1714641676168,LIGM 5A,A00,507421,Fischer-Grunski; Eva K,18,0,20,2
1714641677196,LIGM 5B,A00,507423,Fischer-Grunski; Eva K,19,0,20,1
1714641678224,LIGM 5C,A00,507425,Fischer-Grunski; Eva K,19,0,20,1
1714641679249,LIIT 5AS,A00,507427,Carnelos; Chiara,20,0,20,0
1714641680276,LIIT 5BS,A00,507430,Carnelos; Chiara,20,0,20,0
1714641681306,LIIT 5CS,A00,507432,Carnelos; Chiara,20,0,20,0
1714641682336,LISP 5A,A00,507541,Munoz Sanchez; Alicia,11,0,20,9
1714641683362,LISP 5B,A00,507671,Munoz Sanchez; Alicia,8,0,20,12
1714641684389,LISP 5C,A00,507696,Munoz Sanchez; Alicia,9,0,20,11
1714641685419,MAE 197,001,528363,Boechler; Nicholas Sebastia,9998,0,9999,1
1714641686447,MATH 197,001,523477,Kedlaya; Kiran S.,9995,0,9999,4
1714641686447,MATH 197,002,563811,Zhang; Danna,9995,0,9999,4
1714641686447,MATH 197,003,628552,Dumitriu; Ioana,9998,0,9999,1
1714641687472,MCWP 40R,A00,518780,Staff,2,0,20,18
1714641687472,MCWP 40R,B00,518781,Staff,8,0,20,12
1714641687472,MCWP 40R,C00,518783,Staff,6,0,20,14
1714641688552,MCWP 50R,A00,518791,Staff,0,0,20,20
1714641688552,MCWP 50R,B00,518792,Staff,0,2,20,20
1714641688552,MCWP 50R,C00,518793,Staff,0,2,20,20
1714641688552,MCWP 50R,D00,518794,Staff,0,1,20,20
1714641688552,MCWP 50R,E00,518795,Staff,0,2,20,20
1714641688552,MCWP 50R,F00,518796,Staff,0,0,20,20
1714641688552,MCWP 50R,G00,518797,Staff,0,1,20,20
1714641689578,MMW 12R,A01,514034,Herbst; Matthew,0,0,16,16
1714641689578,MMW 12R,A02,514035,Herbst; Matthew,1,0,16,15
1714641690606,MMW 13R,A01,514037,Staff,0,4,16,16
1714641690606,MMW 13R,A02,514039,Staff,0,2,16,16
1714641690606,MMW 13R,A03,628519,Staff,0,2,16,16
1714641692658,SIO 295LS,A00,523233,Staff,10,0,30,20
1714641693682,SIO 295S,A00,523232,Staff,10,0,30,20
1714641694707,SIOC 290S,A01,637330,Merrifield; Mark A,23,0,30,7
1714641695734,SIOC 291S,A01,637333,Gabriel; Corey John,23,0,30,7
1714641696763,SOCI 117,A01,494376,Staff,0,4,5,5
1714641697794,WES 237B,A00,494380,Staff,9,0,20,11
1714641699880,AESE 279B,A00,494370,Wade; Jon P,0,0,33,33
1714641700908,AIP 197,001,627712,Vespa; Emanuel Ignacio,9998,0,9999,1
1714641701933,ANAR 135S,A00,494369,Braswell; Geoffrey E.,0,0,0,0
1714641702961,BENG 196,001,628496,Engler; Adam J.,9998,0,9999,1
1714641703988,CAT 124RS,A01,519847,Geibel; William,0,0,20,20
1714641705018,CAT 125RS,A01,515971,Geibel; William,0,0,20,20
1714641706044,CLRE 250,A00,511389,Morris; Sheldon,9993,0,9999,6
1714641707077,CLRE 251,A00,507176,Mehta; Ravindra L.,9993,0,9999,6
1714641707077,CLRE 251,B00,511410,Mehta; Ravindra L.,9998,0,9999,1
1714641708106,CLRE 252,A00,507189,Cuomo; Raphael Eduardo,9995,0,9999,4
1714641709136,CLRE 253,A00,507199,Vaida; Florin,9994,0,9999,5
1714641709136,CLRE 253,B00,507202,Vaida; Florin,9999,0,9999,0
1714641710166,CLRE 259,A00,507211,Patel; Hemal,9996,0,9999,3
1714641711191,CLRE 260,A00,507221,Cuomo; Raphael Eduardo,9999,0,9999,0
1714641712218,CLRE 297,001,507242,Cuomo; Raphael Eduardo,9999,0,9999,0
1714641713247,COGS 197,001,638244,Voytek; Bradley Thomas,9998,0,9999,1
1714641714272,CSE 191,A00,516875,Minnes Kemp; Mor Mia,9992,0,9999,7
1714641715296,CSE 197,001,637388,Minnes Kemp; Mor Mia,9998,0,9999,1
1714641716321,CSS 201S,A01,494383,Staff,35,0,35,0
1714641717346,CSS 202S,A01,494387,Staff,35,0,35,0
1714641718375,DSC 197,001,628532,Eldridge; Justin Matthew,9996,0,9999,3
1714641719399,EAP 100,A00,516065,Staff,9797,0,9999,202
1714641720428,ECE 45,A01,507414,Staff,33,0,60,27
1714641722477,ECE 111,A01,507420,Staff,15,0,50,35
1714641723506,ECE 197,001,548057,Sievenpiper; Daniel F.,9993,0,9999,6
1714641724530,EDS 115,A00,507243,Choi; Bailey Miyeon,10,0,28,18
1714641725561,EDS 117,A01,494379,Staff,0,4,30,30
1714641726586,EDS 125,A00,507246,Hopkins; Megan Beth,9,0,30,21
1714641727611,EDS 128A,A01,507264,Fargason; Sharon Gayle,8,0,26,18
1714641728638,EDS 128B,A01,507293,Pappas; Elizabeth,12,0,30,18
1714641729662,EDS 139,A00,507294,Fargason; Sharon Gayle,13,0,30,17
1714641729662,EDS 139,B00,507313,Pappas; Elizabeth,13,0,30,17
1714641730690,EDS 201,A00,507315,Staff,13,0,30,17
1714641731715,EDS 203,A01,507317,Halter; Christopher P.,12,0,30,18
1714641732742,EDS 204R,A01,507319,Halter; Christopher P.,0,3,30,30
1714641732742,EDS 204R,B01,507331,Heinzman; Erica M.,16,0,30,14
1714641733767,EDS 206R,A00,507332,Staff,0,4,30,30
1714641733767,EDS 206R,B00,507343,Staff,17,0,30,13
1714641734794,EDS 250,A00,507344,Hemans; Patricia Ann Benitez,22,0,40,18
1714641735818,EDS 281,A00,507345,Daly; Alan J.,18,0,18,0
1714641736845,EDS 284,A00,507350,Daly; Alan J.,16,0,16,0
1714641737871,EDS 286,A00,507359,Fine; Sarah,18,0,18,0
1714641738895,EDS 289C,A01,507361,Daly; Alan J.,18,0,18,0
1714641739923,EDS 290,A00,507366,Hofstetter; Carolyn,15,0,15,0
1714641740951,LIGM 5A,A00,507421,Fischer-Grunski; Eva K,18,0,20,2
1714641741983,LIGM 5B,A00,507423,Fischer-Grunski; Eva K,19,0,20,1
1714641743010,LIGM 5C,A00,507425,Fischer-Grunski; Eva K,19,0,20,1
1714641744038,LIIT 5AS,A00,507427,Carnelos; Chiara,20,0,20,0
1714641745063,LIIT 5BS,A00,507430,Carnelos; Chiara,20,0,20,0
1714641746091,LIIT 5CS,A00,507432,Carnelos; Chiara,20,0,20,0
1714641747122,LISP 5A,A00,507541,Munoz Sanchez; Alicia,11,0,20,9
1714641748148,LISP 5B,A00,507671,Munoz Sanchez; Alicia,8,0,20,12
1714641749178,LISP 5C,A00,507696,Munoz Sanchez; Alicia,9,0,20,11
1714641750204,MAE 197,001,528363,Boechler; Nicholas Sebastia,9998,0,9999,1
1714641751236,MATH 197,001,523477,Kedlaya; Kiran S.,9995,0,9999,4
1714641751236,MATH 197,002,563811,Zhang; Danna,9995,0,9999,4
1714641751236,MATH 197,003,628552,Dumitriu; Ioana,9998,0,9999,1
1714641752261,MCWP 40R,A00,518780,Staff,2,0,20,18
1714641752261,MCWP 40R,B00,518781,Staff,8,0,20,12
1714641752261,MCWP 40R,C00,518783,Staff,6,0,20,14
1714641753286,MCWP 50R,A00,518791,Staff,0,0,20,20
1714641753286,MCWP 50R,B00,518792,Staff,0,2,20,20
1714641753286,MCWP 50R,C00,518793,Staff,0,2,20,20
1714641753286,MCWP 50R,D00,518794,Staff,0,1,20,20
1714641753286,MCWP 50R,E00,518795,Staff,0,2,20,20
1714641753286,MCWP 50R,F00,518796,Staff,0,0,20,20
1714641753286,MCWP 50R,G00,518797,Staff,0,1,20,20
1714641754311,MMW 12R,A01,514034,Herbst; Matthew,0,0,16,16
1714641754311,MMW 12R,A02,514035,Herbst; Matthew,1,0,16,15
1714641755335,MMW 13R,A01,514037,Staff,0,4,16,16
1714641755335,MMW 13R,A02,514039,Staff,0,2,16,16
1714641755335,MMW 13R,A03,628519,Staff,0,2,16,16
1714641757385,SIO 295LS,A00,523233,Staff,10,0,30,20
1714641758412,SIO 295S,A00,523232,Staff,10,0,30,20
1714641759439,SIOC 290S,A01,637330,Merrifield; Mark A,23,0,30,7
1714641760468,SIOC 291S,A01,637333,Gabriel; Corey John,23,0,30,7
1714641761497,SOCI 117,A01,494376,Staff,0,4,5,5
1714641762522,WES 237B,A00,494380,Staff,9,0,20,11
1714641764597,AESE 279B,A00,494370,Wade; Jon P,0,0,33,33
1714641765624,AIP 197,001,627712,Vespa; Emanuel Ignacio,9998,0,9999,1
1714641766651,ANAR 135S,A00,494369,Braswell; Geoffrey E.,0,0,0,0
1714641767676,BENG 196,001,628496,Engler; Adam J.,9998,0,9999,1
1714641768703,CAT 124RS,A01,519847,Geibel; William,0,0,20,20
1714641769729,CAT 125RS,A01,515971,Geibel; William,0,0,20,20
1714641770757,CLRE 250,A00,511389,Morris; Sheldon,9993,0,9999,6
1714641771790,CLRE 251,A00,507176,Mehta; Ravindra L.,9993,0,9999,6
1714641771790,CLRE 251,B00,511410,Mehta; Ravindra L.,9998,0,9999,1
1714641772820,CLRE 252,A00,507189,Cuomo; Raphael Eduardo,9995,0,9999,4
1714641773851,CLRE 253,A00,507199,Vaida; Florin,9994,0,9999,5
1714641773851,CLRE 253,B00,507202,Vaida; Florin,9999,0,9999,0
1714641774880,CLRE 259,A00,507211,Patel; Hemal,9996,0,9999,3
1714641775904,CLRE 260,A00,507221,Cuomo; Raphael Eduardo,9999,0,9999,0
1714641776934,CLRE 297,001,507242,Cuomo; Raphael Eduardo,9999,0,9999,0
1714641777960,COGS 197,001,638244,Voytek; Bradley Thomas,9998,0,9999,1
1714641778987,CSE 191,A00,516875,Minnes Kemp; Mor Mia,9992,0,9999,7
1714641780012,CSE 197,001,637388,Minnes Kemp; Mor Mia,9998,0,9999,1
1714641781042,CSS 201S,A01,494383,Staff,35,0,35,0
1714641782069,CSS 202S,A01,494387,Staff,35,0,35,0
1714641783097,DSC 197,001,628532,Eldridge; Justin Matthew,9996,0,9999,3
1714641784124,EAP 100,A00,516065,Staff,9797,0,9999,202
1714641785149,ECE 45,A01,507414,Staff,33,0,60,27
1714641787201,ECE 111,A01,507420,Staff,15,0,50,35
1714641788226,ECE 197,001,548057,Sievenpiper; Daniel F.,9993,0,9999,6
1714641789259,EDS 115,A00,507243,Choi; Bailey Miyeon,10,0,28,18
1714641790289,EDS 117,A01,494379,Staff,0,4,30,30
1714641791316,EDS 125,A00,507246,Hopkins; Megan Beth,9,0,30,21
1714641792342,EDS 128A,A01,507264,Fargason; Sharon Gayle,8,0,26,18
1714641793370,EDS 128B,A01,507293,Pappas; Elizabeth,12,0,30,18
1714641794395,EDS 139,A00,507294,Fargason; Sharon Gayle,13,0,30,17
1714641794395,EDS 139,B00,507313,Pappas; Elizabeth,13,0,30,17
1714641795422,EDS 201,A00,507315,Staff,13,0,30,17
1714641796450,EDS 203,A01,507317,Halter; Christopher P.,12,0,30,18
1714641797478,EDS 204R,A01,507319,Halter; Christopher P.,0,3,30,30
1714641797478,EDS 204R,B01,507331,Heinzman; Erica M.,16,0,30,14
1714641798503,EDS 206R,A00,507332,Staff,0,4,30,30
1714641798503,EDS 206R,B00,507343,Staff,17,0,30,13
1714641799533,EDS 250,A00,507344,Hemans; Patricia Ann Benitez,22,0,40,18
1714641800562,EDS 281,A00,507345,Daly; Alan J.,18,0,18,0
1714641801591,EDS 284,A00,507350,Daly; Alan J.,16,0,16,0
1714641802616,EDS 286,A00,507359,Fine; Sarah,18,0,18,0
1714641803645,EDS 289C,A01,507361,Daly; Alan J.,18,0,18,0
1714641804672,EDS 290,A00,507366,Hofstetter; Carolyn,15,0,15,0
1714641805701,LIGM 5A,A00,507421,Fischer-Grunski; Eva K,18,0,20,2
1714641806725,LIGM 5B,A00,507423,Fischer-Grunski; Eva K,19,0,20,1
1714641807754,LIGM 5C,A00,507425,Fischer-Grunski; Eva K,19,0,20,1
1714641808781,LIIT 5AS,A00,507427,Carnelos; Chiara,20,0,20,0
1714641809806,LIIT 5BS,A00,507430,Carnelos; Chiara,20,0,20,0
1714641810830,LIIT 5CS,A00,507432,Carnelos; Chiara,20,0,20,0
1714641811855,LISP 5A,A00,507541,Munoz Sanchez; Alicia,11,0,20,9
1714641812884,LISP 5B,A00,507671,Munoz Sanchez; Alicia,8,0,20,12
1714641813914,LISP 5C,A00,507696,Munoz Sanchez; Alicia,9,0,20,11
1714641814943,MAE 197,001,528363,Boechler; Nicholas Sebastia,9998,0,9999,1
1714641815976,MATH 197,001,523477,Kedlaya; Kiran S.,9995,0,9999,4
1714641815976,MATH 197,002,563811,Zhang; Danna,9995,0,9999,4
1714641815976,MATH 197,003,628552,Dumitriu; Ioana,9998,0,9999,1
1714641817001,MCWP 40R,A00,518780,Staff,2,0,20,18
1714641817001,MCWP 40R,B00,518781,Staff,8,0,20,12
1714641817001,MCWP 40R,C00,518783,Staff,6,0,20,14
1714641818025,MCWP 50R,A00,518791,Staff,0,0,20,20
1714641818025,MCWP 50R,B00,518792,Staff,0,2,20,20
1714641818025,MCWP 50R,C00,518793,Staff,0,2,20,20
1714641818025,MCWP 50R,D00,518794,Staff,0,1,20,20
1714641818025,MCWP 50R,E00,518795,Staff,0,2,20,20
1714641818025,MCWP 50R,F00,518796,Staff,0,0,20,20
1714641818025,MCWP 50R,G00,518797,Staff,0,1,20,20
1714641819052,MMW 12R,A01,514034,Herbst; Matthew,0,0,16,16
1714641819052,MMW 12R,A02,514035,Herbst; Matthew,1,0,16,15
1714641820080,MMW 13R,A01,514037,Staff,0,4,16,16
1714641820080,MMW 13R,A02,514039,Staff,0,2,16,16
1714641820080,MMW 13R,A03,628519,Staff,0,2,16,16
1714641822133,SIO 295LS,A00,523233,Staff,10,0,30,20
1714641823158,SIO 295S,A00,523232,Staff,10,0,30,20
1714641824188,SIOC 290S,A01,637330,Merrifield; Mark A,23,0,30,7
1714641825215,SIOC 291S,A01,637333,Gabriel; Corey John,23,0,30,7
1714641826241,SOCI 117,A01,494376,Staff,0,4,5,5
1714641827267,WES 237B,A00,494380,Staff,9,0,20,11
1714641829340,AESE 279B,A00,494370,Wade; Jon P,0,0,33,33
1714641830365,AIP 197,001,627712,Vespa; Emanuel Ignacio,9998,0,9999,1
1714641831390,ANAR 135S,A00,494369,Braswell; Geoffrey E.,0,0,0,0
1714641832414,BENG 196,001,628496,Engler; Adam J.,9998,0,9999,1
1714641833440,CAT 124RS,A01,519847,Geibel; William,0,0,20,20
1714641834466,CAT 125RS,A01,515971,Geibel; William,0,0,20,20
1714641835492,CLRE 250,A00,511389,Morris; Sheldon,9993,0,9999,6
1714641836519,CLRE 251,A00,507176,Mehta; Ravindra L.,9993,0,9999,6
1714641836519,CLRE 251,B00,511410,Mehta; Ravindra L.,9998,0,9999,1
1714641837550,CLRE 252,A00,507189,Cuomo; Raphael Eduardo,9995,0,9999,4
1714641838575,CLRE 253,A00,507199,Vaida; Florin,9994,0,9999,5
1714641838575,CLRE 253,B00,507202,Vaida; Florin,9999,0,9999,0
1714641839601,CLRE 259,A00,507211,Patel; Hemal,9996,0,9999,3
1714641840629,CLRE 260,A00,507221,Cuomo; Raphael Eduardo,9999,0,9999,0
1714641841656,CLRE 297,001,507242,Cuomo; Raphael Eduardo,9999,0,9999,0
1714641842681,COGS 197,001,638244,Voytek; Bradley Thomas,9998,0,9999,1
1714641843704,CSE 191,A00,516875,Minnes Kemp; Mor Mia,9992,0,9999,7
1714641844730,CSE 197,001,637388,Minnes Kemp; Mor Mia,9998,0,9999,1
1714641845756,CSS 201S,A01,494383,Staff,35,0,35,0
1714641846781,CSS 202S,A01,494387,Staff,35,0,35,0
1714641847806,DSC 197,001,628532,Eldridge; Justin Matthew,9996,0,9999,3
1714641848832,EAP 100,A00,516065,Staff,9797,0,9999,202
1714641849861,ECE 45,A01,507414,Staff,33,0,60,27
1714641851912,ECE 111,A01,507420,Staff,15,0,50,35
1714641852940,ECE 197,001,548057,Sievenpiper; Daniel F.,9993,0,9999,6
1714641853970,EDS 115,A00,507243,Choi; Bailey Miyeon,10,0,28,18
1714641855000,EDS 117,A01,494379,Staff,0,4,30,30
1714641856027,EDS 125,A00,507246,Hopkins; Megan Beth,9,0,30,21
1714641857053,EDS 128A,A01,507264,Fargason; Sharon Gayle,8,0,26,18
1714641858082,EDS 128B,A01,507293,Pappas; Elizabeth,12,0,30,18
1714641859108,EDS 139,A00,507294,Fargason; Sharon Gayle,13,0,30,17
1714641859108,EDS 139,B00,507313,Pappas; Elizabeth,13,0,30,17
1714641860133,EDS 201,A00,507315,Staff,13,0,30,17
1714641861162,EDS 203,A01,507317,Halter; Christopher P.,12,0,30,18
1714641862188,EDS 204R,A01,507319,Halter; Christopher P.,0,3,30,30
1714641862188,EDS 204R,B01,507331,Heinzman; Erica M.,16,0,30,14
1714641863213,EDS 206R,A00,507332,Staff,0,4,30,30
1714641863213,EDS 206R,B00,507343,Staff,17,0,30,13
1714641864240,EDS 250,A00,507344,Hemans; Patricia Ann Benitez,22,0,40,18
1714641865265,EDS 281,A00,507345,Daly; Alan J.,18,0,18,0
1714641866293,EDS 284,A00,507350,Daly; Alan J.,16,0,16,0
1714641867318,EDS 286,A00,507359,Fine; Sarah,18,0,18,0
1714641868343,EDS 289C,A01,507361,Daly; Alan J.,18,0,18,0
1714641869372,EDS 290,A00,507366,Hofstetter; Carolyn,15,0,15,0
1714641870401,LIGM 5A,A00,507421,Fischer-Grunski; Eva K,18,0,20,2
1714641871424,LIGM 5B,A00,507423,Fischer-Grunski; Eva K,19,0,20,1
1714641872448,LIGM 5C,A00,507425,Fischer-Grunski; Eva K,19,0,20,1
1714641873479,LIIT 5AS,A00,507427,Carnelos; Chiara,20,0,20,0
1714641874502,LIIT 5BS,A00,507430,Carnelos; Chiara,20,0,20,0
1714641875527,LIIT 5CS,A00,507432,Carnelos; Chiara,20,0,20,0
1714641876555,LISP 5A,A00,507541,Munoz Sanchez; Alicia,11,0,20,9
1714641877580,LISP 5B,A00,507671,Munoz Sanchez; Alicia,8,0,20,12
1714641878605,LISP 5C,A00,507696,Munoz Sanchez; Alicia,9,0,20,11
1714641879631,MAE 197,001,528363,Boechler; Nicholas Sebastia,9998,0,9999,1
1714641880657,MATH 197,001,523477,Kedlaya; Kiran S.,9995,0,9999,4
1714641880657,MATH 197,002,563811,Zhang; Danna,9995,0,9999,4
1714641880657,MATH 197,003,628552,Dumitriu; Ioana,9998,0,9999,1
1714641881683,MCWP 40R,A00,518780,Staff,2,0,20,18
1714641881683,MCWP 40R,B00,518781,Staff,8,0,20,12
1714641881683,MCWP 40R,C00,518783,Staff,6,0,20,14
1714641882714,MCWP 50R,A00,518791,Staff,0,0,20,20
1714641882714,MCWP 50R,B00,518792,Staff,0,2,20,20
1714641882714,MCWP 50R,C00,518793,Staff,0,2,20,20
1714641882714,MCWP 50R,D00,518794,Staff,0,1,20,20
1714641882714,MCWP 50R,E00,518795,Staff,0,2,20,20
1714641882714,MCWP 50R,F00,518796,Staff,0,0,20,20
1714641882714,MCWP 50R,G00,518797,Staff,0,1,20,20
1714641883741,MMW 12R,A01,514034,Herbst; Matthew,0,0,16,16
1714641883741,MMW 12R,A02,514035,Herbst; Matthew,1,0,16,15
1714641884768,MMW 13R,A01,514037,Staff,0,4,16,16
1714641884768,MMW 13R,A02,514039,Staff,0,2,16,16
1714641884768,MMW 13R,A03,628519,Staff,0,2,16,16
1714641886821,SIO 295LS,A00,523233,Staff,10,0,30,20
1714641887846,SIO 295S,A00,523232,Staff,10,0,30,20
1714641888872,SIOC 290S,A01,637330,Merrifield; Mark A,23,0,30,7
1714641889903,SIOC 291S,A01,637333,Gabriel; Corey John,23,0,30,7
1714641890933,SOCI 117,A01,494376,Staff,0,4,5,5
1714641891957,WES 237B,A00,494380,Staff,9,0,20,11
1714641894040,AESE 279B,A00,494370,Wade; Jon P,0,0,33,33
1714641895067,AIP 197,001,627712,Vespa; Emanuel Ignacio,9998,0,9999,1
1714641896091,ANAR 135S,A00,494369,Braswell; Geoffrey E.,0,0,0,0
1714641897117,BENG 196,001,628496,Engler; Adam J.,9998,0,9999,1
1714641898144,CAT 124RS,A01,519847,Geibel; William,0,0,20,20
1714641899170,CAT 125RS,A01,515971,Geibel; William,0,0,20,20
1714641900215,CLRE 250,A00,511389,Morris; Sheldon,9993,0,9999,6
1714641901245,CLRE 251,A00,507176,Mehta; Ravindra L.,9993,0,9999,6
1714641901245,CLRE 251,B00,511410,Mehta; Ravindra L.,9998,0,9999,1
1714641902274,CLRE 252,A00,507189,Cuomo; Raphael Eduardo,9995,0,9999,4
1714641903355,CLRE 253,A00,507199,Vaida; Florin,9994,0,9999,5
1714641903355,CLRE 253,B00,507202,Vaida; Florin,9999,0,9999,0
1714641904380,CLRE 259,A00,507211,Patel; Hemal,9996,0,9999,3
1714641905408,CLRE 260,A00,507221,Cuomo; Raphael Eduardo,9999,0,9999,0
1714641906432,CLRE 297,001,507242,Cuomo; Raphael Eduardo,9999,0,9999,0
1714641907457,COGS 197,001,638244,Voytek; Bradley Thomas,9998,0,9999,1
1714641908483,CSE 191,A00,516875,Minnes Kemp; Mor Mia,9992,0,9999,7
1714641909508,CSE 197,001,637388,Minnes Kemp; Mor Mia,9998,0,9999,1
1714641910533,CSS 201S,A01,494383,Staff,35,0,35,0
1714641911564,CSS 202S,A01,494387,Staff,35,0,35,0
1714641912588,DSC 197,001,628532,Eldridge; Justin Matthew,9996,0,9999,3
1714641913615,EAP 100,A00,516065,Staff,9797,0,9999,202
1714641914645,ECE 45,A01,507414,Staff,33,0,60,27
1714641916699,ECE 111,A01,507420,Staff,15,0,50,35
1714641917729,ECE 197,001,548057,Sievenpiper; Daniel F.,9993,0,9999,6
1714641918760,EDS 115,A00,507243,Choi; Bailey Miyeon,10,0,28,18
1714641919788,EDS 117,A01,494379,Staff,0,4,30,30
1714641920817,EDS 125,A00,507246,Hopkins; Megan Beth,9,0,30,21
1714641921842,EDS 128A,A01,507264,Fargason; Sharon Gayle,8,0,26,18
1714641922867,EDS 128B,A01,507293,Pappas; Elizabeth,12,0,30,18
1714641923893,EDS 139,A00,507294,Fargason; Sharon Gayle,13,0,30,17
1714641923893,EDS 139,B00,507313,Pappas; Elizabeth,13,0,30,17
1714641924920,EDS 201,A00,507315,Staff,13,0,30,17
1714641925946,EDS 203,A01,507317,Halter; Christopher P.,12,0,30,18
1714641926976,EDS 204R,A01,507319,Halter; Christopher P.,0,3,30,30
1714641926976,EDS 204R,B01,507331,Heinzman; Erica M.,16,0,30,14
1714641927999,EDS 206R,A00,507332,Staff,0,4,30,30
1714641927999,EDS 206R,B00,507343,Staff,17,0,30,13
1714641929028,EDS 250,A00,507344,Hemans; Patricia Ann Benitez,22,0,40,18
1714641930056,EDS 281,A00,507345,Daly; Alan J.,18,0,18,0
1714641931083,EDS 284,A00,507350,Daly; Alan J.,16,0,16,0
1714641932108,EDS 286,A00,507359,Fine; Sarah,18,0,18,0
1714641933134,EDS 289C,A01,507361,Daly; Alan J.,18,0,18,0
1714641934160,EDS 290,A00,507366,Hofstetter; Carolyn,15,0,15,0
1714641935192,LIGM 5A,A00,507421,Fischer-Grunski; Eva K,18,0,20,2
1714641936218,LIGM 5B,A00,507423,Fischer-Grunski; Eva K,19,0,20,1
1714641937246,LIGM 5C,A00,507425,Fischer-Grunski; Eva K,19,0,20,1
1714641938276,LIIT 5AS,A00,507427,Carnelos; Chiara,20,0,20,0
1714641939305,LIIT 5BS,A00,507430,Carnelos; Chiara,20,0,20,0
1714641940331,LIIT 5CS,A00,507432,Carnelos; Chiara,20,0,20,0
1714641941362,LISP 5A,A00,507541,Munoz Sanchez; Alicia,11,0,20,9
1714641942387,LISP 5B,A00,507671,Munoz Sanchez; Alicia,8,0,20,12
1714641943413,LISP 5C,A00,507696,Munoz Sanchez; Alicia,9,0,20,11
1714641944440,MAE 197,001,528363,Boechler; Nicholas Sebastia,9998,0,9999,1
1714641945474,MATH 197,001,523477,Kedlaya; Kiran S.,9995,0,9999,4
1714641945474,MATH 197,002,563811,Zhang; Danna,9995,0,9999,4
1714641945474,MATH 197,003,628552,Dumitriu; Ioana,9998,0,9999,1
1714641946503,MCWP 40R,A00,518780,Staff,2,0,20,18
1714641946503,MCWP 40R,B00,518781,Staff,8,0,20,12
1714641946503,MCWP 40R,C00,518783,Staff,6,0,20,14
1714641947534,MCWP 50R,A00,518791,Staff,0,0,20,20
1714641947534,MCWP 50R,B00,518792,Staff,0,2,20,20
1714641947534,MCWP 50R,C00,518793,Staff,0,2,20,20
1714641947534,MCWP 50R,D00,518794,Staff,0,1,20,20
1714641947534,MCWP 50R,E00,518795,Staff,0,2,20,20
1714641947534,MCWP 50R,F00,518796,Staff,0,0,20,20
1714641947534,MCWP 50R,G00,518797,Staff,0,1,20,20
1714641948559,MMW 12R,A01,514034,Herbst; Matthew,0,0,16,16
1714641948559,MMW 12R,A02,514035,Herbst; Matthew,1,0,16,15
1714641949583,MMW 13R,A01,514037,Staff,0,4,16,16
1714641949583,MMW 13R,A02,514039,Staff,0,2,16,16
1714641949583,MMW 13R,A03,628519,Staff,0,2,16,16
1714641951634,SIO 295LS,A00,523233,Staff,10,0,30,20
1714641952658,SIO 295S,A00,523232,Staff,10,0,30,20
1714641953690,SIOC 290S,A01,637330,Merrifield; Mark A,23,0,30,7
1714641954720,SIOC 291S,A01,637333,Gabriel; Corey John,23,0,30,7
1714641955748,SOCI 117,A01,494376,Staff,0,4,5,5
1714641956775,WES 237B,A00,494380,Staff,9,0,20,11
1714641958855,AESE 279B,A00,494370,Wade; Jon P,0,0,33,33
1714641959882,AIP 197,001,627712,Vespa; Emanuel Ignacio,9998,0,9999,1
1714641960911,ANAR 135S,A00,494369,Braswell; Geoffrey E.,0,0,0,0
1714641961938,BENG 196,001,628496,Engler; Adam J.,9998,0,9999,1
1714641962964,CAT 124RS,A01,519847,Geibel; William,0,0,20,20
1714641963989,CAT 125RS,A01,515971,Geibel; William,0,0,20,20
1714641965014,CLRE 250,A00,511389,Morris; Sheldon,9993,0,9999,6
1714641966043,CLRE 251,A00,507176,Mehta; Ravindra L.,9993,0,9999,6
1714641966043,CLRE 251,B00,511410,Mehta; Ravindra L.,9998,0,9999,1
1714641967072,CLRE 252,A00,507189,Cuomo; Raphael Eduardo,9995,0,9999,4
1714641968096,CLRE 253,A00,507199,Vaida; Florin,9994,0,9999,5
1714641968096,CLRE 253,B00,507202,Vaida; Florin,9999,0,9999,0
1714641969121,CLRE 259,A00,507211,Patel; Hemal,9996,0,9999,3
1714641970146,CLRE 260,A00,507221,Cuomo; Raphael Eduardo,9999,0,9999,0
1714641971170,CLRE 297,001,507242,Cuomo; Raphael Eduardo,9999,0,9999,0
1714641972199,COGS 197,001,638244,Voytek; Bradley Thomas,9998,0,9999,1
1714641973228,CSE 191,A00,516875,Minnes Kemp; Mor Mia,9992,0,9999,7
1714641974257,CSE 197,001,637388,Minnes Kemp; Mor Mia,9998,0,9999,1
1714641975284,CSS 201S,A01,494383,Staff,35,0,35,0
1714641976313,CSS 202S,A01,494387,Staff,35,0,35,0
1714641977342,DSC 197,001,628532,Eldridge; Justin Matthew,9996,0,9999,3
1714641978368,EAP 100,A00,516065,Staff,9797,0,9999,202
1714641979395,ECE 45,A01,507414,Staff,33,0,60,27
1714641981444,ECE 111,A01,507420,Staff,15,0,50,35
1714641982471,ECE 197,001,548057,Sievenpiper; Daniel F.,9993,0,9999,6
1714641983497,EDS 115,A00,507243,Choi; Bailey Miyeon,10,0,28,18
1714641984522,EDS 117,A01,494379,Staff,0,4,30,30
1714641985548,EDS 125,A00,507246,Hopkins; Megan Beth,9,0,30,21
1714641986574,EDS 128A,A01,507264,Fargason; Sharon Gayle,8,0,26,18
1714641987599,EDS 128B,A01,507293,Pappas; Elizabeth,12,0,30,18
1714641988628,EDS 139,A00,507294,Fargason; Sharon Gayle,13,0,30,17
1714641988628,EDS 139,B00,507313,Pappas; Elizabeth,13,0,30,17
1714641989652,EDS 201,A00,507315,Staff,13,0,30,17
1714641990680,EDS 203,A01,507317,Halter; Christopher P.,12,0,30,18
1714641991708,EDS 204R,A01,507319,Halter; Christopher P.,0,3,30,30
1714641991708,EDS 204R,B01,507331,Heinzman; Erica M.,16,0,30,14
1714641992734,EDS 206R,A00,507332,Staff,0,4,30,30
1714641992734,EDS 206R,B00,507343,Staff,17,0,30,13
1714641993758,EDS 250,A00,507344,Hemans; Patricia Ann Benitez,22,0,40,18
1714641994786,EDS 281,A00,507345,Daly; Alan J.,18,0,18,0
1714641995815,EDS 284,A00,507350,Daly; Alan J.,16,0,16,0
1714641996840,EDS 286,A00,507359,Fine; Sarah,18,0,18,0
1714641997865,EDS 289C,A01,507361,Daly; Alan J.,18,0,18,0
1714641998890,EDS 290,A00,507366,Hofstetter; Carolyn,15,0,15,0
1714641999915,LIGM 5A,A00,507421,Fischer-Grunski; Eva K,18,0,20,2
1714642000942,LIGM 5B,A00,507423,Fischer-Grunski; Eva K,19,0,20,1
1714642001972,LIGM 5C,A00,507425,Fischer-Grunski; Eva K,19,0,20,1
1714642002997,LIIT 5AS,A00,507427,Carnelos; Chiara,20,0,20,0
1714642004022,LIIT 5BS,A00,507430,Carnelos; Chiara,20,0,20,0
1714642005052,LIIT 5CS,A00,507432,Carnelos; Chiara,20,0,20,0
1714642006078,LISP 5A,A00,507541,Munoz Sanchez; Alicia,11,0,20,9
1714642007103,LISP 5B,A00,507671,Munoz Sanchez; Alicia,8,0,20,12
1714642008130,LISP 5C,A00,507696,Munoz Sanchez; Alicia,9,0,20,11
1714642009155,MAE 197,001,528363,Boechler; Nicholas Sebastia,9998,0,9999,1
1714642010183,MATH 197,001,523477,Kedlaya; Kiran S.,9995,0,9999,4
1714642010183,MATH 197,002,563811,Zhang; Danna,9995,0,9999,4
1714642010183,MATH 197,003,628552,Dumitriu; Ioana,9998,0,9999,1
1714642011212,MCWP 40R,A00,518780,Staff,2,0,20,18
1714642011212,MCWP 40R,B00,518781,Staff,8,0,20,12
1714642011212,MCWP 40R,C00,518783,Staff,6,0,20,14
1714642012242,MCWP 50R,A00,518791,Staff,0,0,20,20
1714642012242,MCWP 50R,B00,518792,Staff,0,2,20,20
1714642012242,MCWP 50R,C00,518793,Staff,0,2,20,20
1714642012242,MCWP 50R,D00,518794,Staff,0,1,20,20
1714642012242,MCWP 50R,E00,518795,Staff,0,2,20,20
1714642012242,MCWP 50R,F00,518796,Staff,0,0,20,20
1714642012242,MCWP 50R,G00,518797,Staff,0,1,20,20
1714642013267,MMW 12R,A01,514034,Herbst; Matthew,0,0,16,16
1714642013267,MMW 12R,A02,514035,Herbst; Matthew,1,0,16,15
1714642014295,MMW 13R,A01,514037,Staff,0,4,16,16
1714642014295,MMW 13R,A02,514039,Staff,0,2,16,16
1714642014295,MMW 13R,A03,628519,Staff,0,2,16,16
1714642016349,SIO 295LS,A00,523233,Staff,10,0,30,20
1714642017429,SIO 295S,A00,523232,Staff,10,0,30,20
1714642018457,SIOC 290S,A01,637330,Merrifield; Mark A,23,0,30,7
1714642019486,SIOC 291S,A01,637333,Gabriel; Corey John,23,0,30,7
1714642020513,SOCI 117,A01,494376,Staff,0,4,5,5
1714642021540,WES 237B,A00,494380,Staff,9,0,20,11
1714642023612,AESE 279B,A00,494370,Wade; Jon P,0,0,33,33
1714642024639,AIP 197,001,627712,Vespa; Emanuel Ignacio,9998,0,9999,1
1714642025668,ANAR 135S,A00,494369,Braswell; Geoffrey E.,0,0,0,0
1714642026692,BENG 196,001,628496,Engler; Adam J.,9998,0,9999,1
1714642027716,CAT 124RS,A01,519847,Geibel; William,0,0,20,20
1714642028742,CAT 125RS,A01,515971,Geibel; William,0,0,20,20
1714642029972,CLRE 250,A00,511389,Morris; Sheldon,9993,0,9999,6
1714642031004,CLRE 251,A00,507176,Mehta; Ravindra L.,9993,0,9999,6
1714642031004,CLRE 251,B00,511410,Mehta; Ravindra L.,9998,0,9999,1
1714642032032,CLRE 252,A00,507189,Cuomo; Raphael Eduardo,9995,0,9999,4
1714642033062,CLRE 253,A00,507199,Vaida; Florin,9994,0,9999,5
1714642033062,CLRE 253,B00,507202,Vaida; Florin,9999,0,9999,0
1714642034089,CLRE 259,A00,507211,Patel; Hemal,9996,0,9999,3
1714642035112,CLRE 260,A00,507221,Cuomo; Raphael Eduardo,9999,0,9999,0
1714642036138,CLRE 297,001,507242,Cuomo; Raphael Eduardo,9999,0,9999,0
1714642037163,COGS 197,001,638244,Voytek; Bradley Thomas,9998,0,9999,1
1714642038192,CSE 191,A00,516875,Minnes Kemp; Mor Mia,9992,0,9999,7
1714642039221,CSE 197,001,637388,Minnes Kemp; Mor Mia,9998,0,9999,1
1714642040246,CSS 201S,A01,494383,Staff,35,0,35,0
1714642041272,CSS 202S,A01,494387,Staff,35,0,35,0
1714642042298,DSC 197,001,628532,Eldridge; Justin Matthew,9996,0,9999,3
1714642043325,EAP 100,A00,516065,Staff,9797,0,9999,202
1714642044351,ECE 45,A01,507414,Staff,33,0,60,27
1714642046400,ECE 111,A01,507420,Staff,15,0,50,35
1714642047426,ECE 197,001,548057,Sievenpiper; Daniel F.,9993,0,9999,6
1714642048457,EDS 115,A00,507243,Choi; Bailey Miyeon,10,0,28,18
1714642049483,EDS 117,A01,494379,Staff,0,4,30,30
1714642050508,EDS 125,A00,507246,Hopkins; Megan Beth,9,0,30,21
1714642051534,EDS 128A,A01,507264,Fargason; Sharon Gayle,8,0,26,18
1714642052561,EDS 128B,A01,507293,Pappas; Elizabeth,12,0,30,18
1714642053588,EDS 139,A00,507294,Fargason; Sharon Gayle,13,0,30,17
1714642053588,EDS 139,B00,507313,Pappas; Elizabeth,13,0,30,17
1714642054613,EDS 201,A00,507315,Staff,13,0,30,17
1714642055638,EDS 203,A01,507317,Halter; Christopher P.,12,0,30,18
1714642056665,EDS 204R,A01,507319,Halter; Christopher P.,0,3,30,30
1714642056665,EDS 204R,B01,507331,Heinzman; Erica M.,16,0,30,14
1714642057690,EDS 206R,A00,507332,Staff,0,4,30,30
1714642057690,EDS 206R,B00,507343,Staff,17,0,30,13
1714642058717,EDS 250,A00,507344,Hemans; Patricia Ann Benitez,22,0,40,18
1714642059744,EDS 281,A00,507345,Daly; Alan J.,18,0,18,0
1714642060772,EDS 284,A00,507350,Daly; Alan J.,16,0,16,0
1714642061797,EDS 286,A00,507359,Fine; Sarah,18,0,18,0
1714642062824,EDS 289C,A01,507361,Daly; Alan J.,18,0,18,0
1714642063852,EDS 290,A00,507366,Hofstetter; Carolyn,15,0,15,0
1714642064882,LIGM 5A,A00,507421,Fischer-Grunski; Eva K,18,0,20,2
1714642065909,LIGM 5B,A00,507423,Fischer-Grunski; Eva K,19,0,20,1
1714642066938,LIGM 5C,A00,507425,Fischer-Grunski; Eva K,19,0,20,1
1714642067963,LIIT 5AS,A00,507427,Carnelos; Chiara,20,0,20,0
1714642068989,LIIT 5BS,A00,507430,Carnelos; Chiara,20,0,20,0
1714642070014,LIIT 5CS,A00,507432,Carnelos; Chiara,20,0,20,0
1714642071040,LISP 5A,A00,507541,Munoz Sanchez; Alicia,11,0,20,9
1714642072065,LISP 5B,A00,507671,Munoz Sanchez; Alicia,8,0,20,12
1714642073091,LISP 5C,A00,507696,Munoz Sanchez; Alicia,9,0,20,11
1714642074119,MAE 197,001,528363,Boechler; Nicholas Sebastia,9998,0,9999,1
1714642075154,MATH 197,001,523477,Kedlaya; Kiran S.,9995,0,9999,4
1714642075154,MATH 197,002,563811,Zhang; Danna,9995,0,9999,4
1714642075154,MATH 197,003,628552,Dumitriu; Ioana,9998,0,9999,1
1714642076185,MCWP 40R,A00,518780,Staff,2,0,20,18
1714642076185,MCWP 40R,B00,518781,Staff,8,0,20,12
1714642076185,MCWP 40R,C00,518783,Staff,6,0,20,14
1714642077210,MCWP 50R,A00,518791,Staff,0,0,20,20
1714642077210,MCWP 50R,B00,518792,Staff,0,2,20,20
1714642077210,MCWP 50R,C00,518793,Staff,0,2,20,20
1714642077210,MCWP 50R,D00,518794,Staff,0,1,20,20
1714642077210,MCWP 50R,E00,518795,Staff,0,2,20,20
1714642077210,MCWP 50R,F00,518796,Staff,0,0,20,20
1714642077210,MCWP 50R,G00,518797,Staff,0,1,20,20
1714642078240,MMW 12R,A01,514034,Herbst; Matthew,0,0,16,16
1714642078240,MMW 12R,A02,514035,Herbst; Matthew,1,0,16,15
1714642079268,MMW 13R,A01,514037,Staff,0,4,16,16
1714642079268,MMW 13R,A02,514039,Staff,0,2,16,16
1714642079268,MMW 13R,A03,628519,Staff,0,2,16,16
1714642081321,SIO 295LS,A00,523233,Staff,10,0,30,20
1714642082345,SIO 295S,A00,523232,Staff,10,0,30,20
1714642083372,SIOC 290S,A01,637330,Merrifield; Mark A,23,0,30,7
1714642084397,SIOC 291S,A01,637333,Gabriel; Corey John,23,0,30,7
1714642085425,SOCI 117,A01,494376,Staff,0,4,5,5
1714642086450,WES 237B,A00,494380,Staff,9,0,20,11
1714642088537,AESE 279B,A00,494370,Wade; Jon P,0,0,33,33
1714642089564,AIP 197,001,627712,Vespa; Emanuel Ignacio,9998,0,9999,1
1714642090590,ANAR 135S,A00,494369,Braswell; Geoffrey E.,0,0,0,0
1714642091617,BENG 196,001,628496,Engler; Adam J.,9998,0,9999,1
1714642092642,CAT 124RS,A01,519847,Geibel; William,0,0,20,20
1714642093670,CAT 125RS,A01,515971,Geibel; William,0,0,20,20
1714642094700,CLRE 250,A00,511389,Morris; Sheldon,9993,0,9999,6
1714642095726,CLRE 251,A00,507176,Mehta; Ravindra L.,9993,0,9999,6
1714642095726,CLRE 251,B00,511410,Mehta; Ravindra L.,9998,0,9999,1
1714642096753,CLRE 252,A00,507189,Cuomo; Raphael Eduardo,9995,0,9999,4
1714642097783,CLRE 253,A00,507199,Vaida; Florin,9994,0,9999,5
1714642097783,CLRE 253,B00,507202,Vaida; Florin,9999,0,9999,0
1714642098869,CLRE 259,A00,507211,Patel; Hemal,9996,0,9999,3
1714642099892,CLRE 260,A00,507221,Cuomo; Raphael Eduardo,9999,0,9999,0
1714642100921,CLRE 297,001,507242,Cuomo; Raphael Eduardo,9999,0,9999,0
1714642101951,COGS 197,001,638244,Voytek; Bradley Thomas,9998,0,9999,1
1714642102974,CSE 191,A00,516875,Minnes Kemp; Mor Mia,9992,0,9999,7
1714642104003,CSE 197,001,637388,Minnes Kemp; Mor Mia,9998,0,9999,1
1714642105031,CSS 201S,A01,494383,Staff,35,0,35,0
1714642106057,CSS 202S,A01,494387,Staff,35,0,35,0
1714642107084,DSC 197,001,628532,Eldridge; Justin Matthew,9996,0,9999,3
1714642108110,EAP 100,A00,516065,Staff,9797,0,9999,202
1714642109136,ECE 45,A01,507414,Staff,33,0,60,27
1714642111184,ECE 111,A01,507420,Staff,15,0,50,35
1714642112211,ECE 197,001,548057,Sievenpiper; Daniel F.,9993,0,9999,6
1714642113239,EDS 115,A00,507243,Choi; Bailey Miyeon,10,0,28,18
1714642114264,EDS 117,A01,494379,Staff,0,4,30,30
1714642115295,EDS 125,A00,507246,Hopkins; Megan Beth,9,0,30,21
1714642116320,EDS 128A,A01,507264,Fargason; Sharon Gayle,8,0,26,18
1714642117349,EDS 128B,A01,507293,Pappas; Elizabeth,12,0,30,18
1714642118378,EDS 139,A00,507294,Fargason; Sharon Gayle,13,0,30,17
1714642118378,EDS 139,B00,507313,Pappas; Elizabeth,13,0,30,17
1714642119402,EDS 201,A00,507315,Staff,13,0,30,17
1714642120426,EDS 203,A01,507317,Halter; Christopher P.,12,0,30,18
1714642121453,EDS 204R,A01,507319,Halter; Christopher P.,0,3,30,30
1714642121453,EDS 204R,B01,507331,Heinzman; Erica M.,16,0,30,14
1714642122478,EDS 206R,A00,507332,Staff,0,4,30,30
1714642122478,EDS 206R,B00,507343,Staff,17,0,30,13
1714642123504,EDS 250,A00,507344,Hemans; Patricia Ann Benitez,22,0,40,18
1714642124530,EDS 281,A00,507345,Daly; Alan J.,18,0,18,0
1714642125557,EDS 284,A00,507350,Daly; Alan J.,16,0,16,0
1714642126586,EDS 286,A00,507359,Fine; Sarah,18,0,18,0
1714642127615,EDS 289C,A01,507361,Daly; Alan J.,18,0,18,0
1714642128640,EDS 290,A00,507366,Hofstetter; Carolyn,15,0,15,0
1714642129670,LIGM 5A,A00,507421,Fischer-Grunski; Eva K,18,0,20,2
1714642130696,LIGM 5B,A00,507423,Fischer-Grunski; Eva K,19,0,20,1
1714642131726,LIGM 5C,A00,507425,Fischer-Grunski; Eva K,19,0,20,1
1714642132752,LIIT 5AS,A00,507427,Carnelos; Chiara,20,0,20,0
1714642133777,LIIT 5BS,A00,507430,Carnelos; Chiara,20,0,20,0
1714642134805,LIIT 5CS,A00,507432,Carnelos; Chiara,20,0,20,0
1714642135830,LISP 5A,A00,507541,Munoz Sanchez; Alicia,11,0,20,9
1714642136857,LISP 5B,A00,507671,Munoz Sanchez; Alicia,8,0,20,12
1714642137886,LISP 5C,A00,507696,Munoz Sanchez; Alicia,9,0,20,11
1714642138916,MAE 197,001,528363,Boechler; Nicholas Sebastia,9998,0,9999,1
1714642139942,MATH 197,001,523477,Kedlaya; Kiran S.,9995,0,9999,4
1714642139942,MATH 197,002,563811,Zhang; Danna,9995,0,9999,4
1714642139942,MATH 197,003,628552,Dumitriu; Ioana,9998,0,9999,1
1714642140972,MCWP 40R,A00,518780,Staff,2,0,20,18
1714642140972,MCWP 40R,B00,518781,Staff,8,0,20,12
1714642140972,MCWP 40R,C00,518783,Staff,6,0,20,14
1714642141999,MCWP 50R,A00,518791,Staff,0,0,20,20
1714642141999,MCWP 50R,B00,518792,Staff,0,2,20,20
1714642141999,MCWP 50R,C00,518793,Staff,0,2,20,20
1714642141999,MCWP 50R,D00,518794,Staff,0,1,20,20
1714642141999,MCWP 50R,E00,518795,Staff,0,2,20,20
1714642141999,MCWP 50R,F00,518796,Staff,0,0,20,20
1714642141999,MCWP 50R,G00,518797,Staff,0,1,20,20
1714642143029,MMW 12R,A01,514034,Herbst; Matthew,0,0,16,16
1714642143029,MMW 12R,A02,514035,Herbst; Matthew,1,0,16,15
1714642144054,MMW 13R,A01,514037,Staff,0,4,16,16
1714642144054,MMW 13R,A02,514039,Staff,0,2,16,16
1714642144054,MMW 13R,A03,628519,Staff,0,2,16,16
1714642146107,SIO 295LS,A00,523233,Staff,10,0,30,20
1714642147136,SIO 295S,A00,523232,Staff,10,0,30,20
1714642148163,SIOC 290S,A01,637330,Merrifield; Mark A,23,0,30,7
1714642149192,SIOC 291S,A01,637333,Gabriel; Corey John,23,0,30,7
1714642150220,SOCI 117,A01,494376,Staff,0,4,5,5
1714642151245,WES 237B,A00,494380,Staff,9,0,20,11
1714642153322,AESE 279B,A00,494370,Wade; Jon P,0,0,33,33
1714642154348,AIP 197,001,627712,Vespa; Emanuel Ignacio,9998,0,9999,1
1714642155377,ANAR 135S,A00,494369,Braswell; Geoffrey E.,0,0,0,0
1714642156403,BENG 196,001,628496,Engler; Adam J.,9998,0,9999,1
1714642157432,CAT 124RS,A01,519847,Geibel; William,0,0,20,20
1714642158458,CAT 125RS,A01,515971,Geibel; William,0,0,20,20
1714642159483,CLRE 250,A00,511389,Morris; Sheldon,9993,0,9999,6
1714642160511,CLRE 251,A00,507176,Mehta; Ravindra L.,9993,0,9999,6
1714642160511,CLRE 251,B00,511410,Mehta; Ravindra L.,9998,0,9999,1
1714642161541,CLRE 252,A00,507189,Cuomo; Raphael Eduardo,9995,0,9999,4
1714642162572,CLRE 253,A00,507199,Vaida; Florin,9994,0,9999,5
1714642162572,CLRE 253,B00,507202,Vaida; Florin,9999,0,9999,0
1714642163604,CLRE 259,A00,507211,Patel; Hemal,9996,0,9999,3
1714642164633,CLRE 260,A00,507221,Cuomo; Raphael Eduardo,9999,0,9999,0
1714642165657,CLRE 297,001,507242,Cuomo; Raphael Eduardo,9999,0,9999,0
1714642166687,COGS 197,001,638244,Voytek; Bradley Thomas,9998,0,9999,1
1714642167715,CSE 191,A00,516875,Minnes Kemp; Mor Mia,9992,0,9999,7
1714642168743,CSE 197,001,637388,Minnes Kemp; Mor Mia,9998,0,9999,1
1714642169821,CSS 201S,A01,494383,Staff,35,0,35,0
1714642170846,CSS 202S,A01,494387,Staff,35,0,35,0
1714642171873,DSC 197,001,628532,Eldridge; Justin Matthew,9996,0,9999,3
1714642172899,EAP 100,A00,516065,Staff,9797,0,9999,202
1714642173925,ECE 45,A01,507414,Staff,33,0,60,27
1714642175975,ECE 111,A01,507420,Staff,15,0,50,35
1714642177000,ECE 197,001,548057,Sievenpiper; Daniel F.,9993,0,9999,6
1714642178030,EDS 115,A00,507243,Choi; Bailey Miyeon,10,0,28,18
1714642179054,EDS 117,A01,494379,Staff,0,4,30,30
1714642180080,EDS 125,A00,507246,Hopkins; Megan Beth,9,0,30,21
1714642181106,EDS 128A,A01,507264,Fargason; Sharon Gayle,8,0,26,18
1714642182136,EDS 128B,A01,507293,Pappas; Elizabeth,12,0,30,18
1714642183161,EDS 139,A00,507294,Fargason; Sharon Gayle,13,0,30,17
1714642183161,EDS 139,B00,507313,Pappas; Elizabeth,13,0,30,17
1714642184185,EDS 201,A00,507315,Staff,13,0,30,17
1714642185215,EDS 203,A01,507317,Halter; Christopher P.,12,0,30,18
1714642186246,EDS 204R,A01,507319,Halter; Christopher P.,0,3,30,30
1714642186246,EDS 204R,B01,507331,Heinzman; Erica M.,16,0,30,14
1714642187271,EDS 206R,A00,507332,Staff,0,4,30,30
1714642187271,EDS 206R,B00,507343,Staff,17,0,30,13
1714642188299,EDS 250,A00,507344,Hemans; Patricia Ann Benitez,22,0,40,18
1714642189328,EDS 281,A00,507345,Daly; Alan J.,18,0,18,0
1714642190353,EDS 284,A00,507350,Daly; Alan J.,16,0,16,0
1714642191381,EDS 286,A00,507359,Fine; Sarah,18,0,18,0
1714642192408,EDS 289C,A01,507361,Daly; Alan J.,18,0,18,0
1714642193437,EDS 290,A00,507366,Hofstetter; Carolyn,15,0,15,0
1714642194464,LIGM 5A,A00,507421,Fischer-Grunski; Eva K,18,0,20,2
1714642195492,LIGM 5B,A00,507423,Fischer-Grunski; Eva K,19,0,20,1
1714642196521,LIGM 5C,A00,507425,Fischer-Grunski; Eva K,19,0,20,1
1714642197550,LIIT 5AS,A00,507427,Carnelos; Chiara,20,0,20,0
1714642198576,LIIT 5BS,A00,507430,Carnelos; Chiara,20,0,20,0
1714642199604,LIIT 5CS,A00,507432,Carnelos; Chiara,20,0,20,0
1714642200634,LISP 5A,A00,507541,Munoz Sanchez; Alicia,11,0,20,9
1714642201664,LISP 5B,A00,507671,Munoz Sanchez; Alicia,8,0,20,12
1714642202690,LISP 5C,A00,507696,Munoz Sanchez; Alicia,9,0,20,11
1714642203718,MAE 197,001,528363,Boechler; Nicholas Sebastia,9998,0,9999,1
1714642204747,MATH 197,001,523477,Kedlaya; Kiran S.,9995,0,9999,4
1714642204747,MATH 197,002,563811,Zhang; Danna,9995,0,9999,4
1714642204747,MATH 197,003,628552,Dumitriu; Ioana,9998,0,9999,1
1714642205775,MCWP 40R,A00,518780,Staff,2,0,20,18
1714642205775,MCWP 40R,B00,518781,Staff,8,0,20,12
1714642205775,MCWP 40R,C00,518783,Staff,6,0,20,14
1714642206801,MCWP 50R,A00,518791,Staff,0,0,20,20
1714642206801,MCWP 50R,B00,518792,Staff,0,2,20,20
1714642206801,MCWP 50R,C00,518793,Staff,0,2,20,20
1714642206801,MCWP 50R,D00,518794,Staff,0,1,20,20
1714642206801,MCWP 50R,E00,518795,Staff,0,2,20,20
1714642206801,MCWP 50R,F00,518796,Staff,0,0,20,20
1714642206801,MCWP 50R,G00,518797,Staff,0,1,20,20
1714642207828,MMW 12R,A01,514034,Herbst; Matthew,0,0,16,16
1714642207828,MMW 12R,A02,514035,Herbst; Matthew,1,0,16,15
1714642208857,MMW 13R,A01,514037,Staff,0,4,16,16
1714642208857,MMW 13R,A02,514039,Staff,0,2,16,16
1714642208857,MMW 13R,A03,628519,Staff,0,2,16,16
1714642210911,SIO 295LS,A00,523233,Staff,10,0,30,20
1714642211939,SIO 295S,A00,523232,Staff,10,0,30,20
1714642212971,SIOC 290S,A01,637330,Merrifield; Mark A,23,0,30,7
1714642213999,SIOC 291S,A01,637333,Gabriel; Corey John,23,0,30,7
1714642215025,SOCI 117,A01,494376,Staff,0,4,5,5
1714642216051,WES 237B,A00,494380,Staff,9,0,20,11
1714642218137,AESE 279B,A00,494370,Wade; Jon P,0,0,33,33
1714642219164,AIP 197,001,627712,Vespa; Emanuel Ignacio,9998,0,9999,1
1714642220191,ANAR 135S,A00,494369,Braswell; Geoffrey E.,0,0,0,0
1714642221216,BENG 196,001,628496,Engler; Adam J.,9998,0,9999,1
1714642222241,CAT 124RS,A01,519847,Geibel; William,0,0,20,20
1714642223268,CAT 125RS,A01,515971,Geibel; William,0,0,20,20
1714642224298,CLRE 250,A00,511389,Morris; Sheldon,9993,0,9999,6
1714642225325,CLRE 251,A00,507176,Mehta; Ravindra L.,9993,0,9999,6
1714642225325,CLRE 251,B00,511410,Mehta; Ravindra L.,9998,0,9999,1
1714642226355,CLRE 252,A00,507189,Cuomo; Raphael Eduardo,9995,0,9999,4
1714642227386,CLRE 253,A00,507199,Vaida; Florin,9994,0,9999,5
1714642227386,CLRE 253,B00,507202,Vaida; Florin,9999,0,9999,0
1714642228410,CLRE 259,A00,507211,Patel; Hemal,9996,0,9999,3
1714642229435,CLRE 260,A00,507221,Cuomo; Raphael Eduardo,9999,0,9999,0
1714642230463,CLRE 297,001,507242,Cuomo; Raphael Eduardo,9999,0,9999,0
1714642231489,COGS 197,001,638244,Voytek; Bradley Thomas,9998,0,9999,1
1714642232514,CSE 191,A00,516875,Minnes Kemp; Mor Mia,9992,0,9999,7
1714642233539,CSE 197,001,637388,Minnes Kemp; Mor Mia,9998,0,9999,1
1714642234570,CSS 201S,A01,494383,Staff,35,0,35,0
1714642235596,CSS 202S,A01,494387,Staff,35,0,35,0
1714642236624,DSC 197,001,628532,Eldridge; Justin Matthew,9996,0,9999,3
1714642237652,EAP 100,A00,516065,Staff,9797,0,9999,202
1714642238680,ECE 45,A01,507414,Staff,33,0,60,27
1714642240736,ECE 111,A01,507420,Staff,15,0,50,35
1714642241761,ECE 197,001,548057,Sievenpiper; Daniel F.,9993,0,9999,6
1714642242788,EDS 115,A00,507243,Choi; Bailey Miyeon,10,0,28,18
1714642243814,EDS 117,A01,494379,Staff,0,4,30,30
1714642244845,EDS 125,A00,507246,Hopkins; Megan Beth,9,0,30,21
1714642245871,EDS 128A,A01,507264,Fargason; Sharon Gayle,8,0,26,18
1714642246899,EDS 128B,A01,507293,Pappas; Elizabeth,12,0,30,18
1714642247924,EDS 139,A00,507294,Fargason; Sharon Gayle,13,0,30,17
1714642247924,EDS 139,B00,507313,Pappas; Elizabeth,13,0,30,17
1714642248951,EDS 201,A00,507315,Staff,13,0,30,17
1714642249977,EDS 203,A01,507317,Halter; Christopher P.,12,0,30,18
1714642251002,EDS 204R,A01,507319,Halter; Christopher P.,0,3,30,30
1714642251002,EDS 204R,B01,507331,Heinzman; Erica M.,16,0,30,14
1714642252029,EDS 206R,A00,507332,Staff,0,4,30,30
1714642252029,EDS 206R,B00,507343,Staff,17,0,30,13
1714642253056,EDS 250,A00,507344,Hemans; Patricia Ann Benitez,22,0,40,18
1714642254084,EDS 281,A00,507345,Daly; Alan J.,18,0,18,0
1714642255112,EDS 284,A00,507350,Daly; Alan J.,16,0,16,0
1714642256137,EDS 286,A00,507359,Fine; Sarah,18,0,18,0
1714642257165,EDS 289C,A01,507361,Daly; Alan J.,18,0,18,0
1714642258195,EDS 290,A00,507366,Hofstetter; Carolyn,15,0,15,0
1714642259222,LIGM 5A,A00,507421,Fischer-Grunski; Eva K,18,0,20,2
1714642260248,LIGM 5B,A00,507423,Fischer-Grunski; Eva K,19,0,20,1
1714642261277,LIGM 5C,A00,507425,Fischer-Grunski; Eva K,19,0,20,1
1714642262304,LIIT 5AS,A00,507427,Carnelos; Chiara,20,0,20,0
1714642263334,LIIT 5BS,A00,507430,Carnelos; Chiara,20,0,20,0
1714642264365,LIIT 5CS,A00,507432,Carnelos; Chiara,20,0,20,0
1714642265396,LISP 5A,A00,507541,Munoz Sanchez; Alicia,11,0,20,9
1714642266422,LISP 5B,A00,507671,Munoz Sanchez; Alicia,8,0,20,12
1714642267449,LISP 5C,A00,507696,Munoz Sanchez; Alicia,9,0,20,11
1714642268475,MAE 197,001,528363,Boechler; Nicholas Sebastia,9998,0,9999,1
1714642269502,MATH 197,001,523477,Kedlaya; Kiran S.,9995,0,9999,4
1714642269502,MATH 197,002,563811,Zhang; Danna,9995,0,9999,4
1714642269502,MATH 197,003,628552,Dumitriu; Ioana,9998,0,9999,1
1714642270527,MCWP 40R,A00,518780,Staff,2,0,20,18
1714642270527,MCWP 40R,B00,518781,Staff,8,0,20,12
1714642270527,MCWP 40R,C00,518783,Staff,6,0,20,14
1714642271555,MCWP 50R,A00,518791,Staff,0,0,20,20
1714642271555,MCWP 50R,B00,518792,Staff,0,2,20,20
1714642271555,MCWP 50R,C00,518793,Staff,0,2,20,20
1714642271555,MCWP 50R,D00,518794,Staff,0,1,20,20
1714642271555,MCWP 50R,E00,518795,Staff,0,2,20,20
1714642271555,MCWP 50R,F00,518796,Staff,0,0,20,20
1714642271555,MCWP 50R,G00,518797,Staff,0,1,20,20
1714642272584,MMW 12R,A01,514034,Herbst; Matthew,0,0,16,16
1714642272584,MMW 12R,A02,514035,Herbst; Matthew,1,0,16,15
1714642273610,MMW 13R,A01,514037,Staff,0,4,16,16
1714642273610,MMW 13R,A02,514039,Staff,0,2,16,16
1714642273610,MMW 13R,A03,628519,Staff,0,2,16,16
1714642275660,SIO 295LS,A00,523233,Staff,10,0,30,20
1714642276687,SIO 295S,A00,523232,Staff,10,0,30,20
1714642277715,SIOC 290S,A01,637330,Merrifield; Mark A,23,0,30,7
1714642278743,SIOC 291S,A01,637333,Gabriel; Corey John,23,0,30,7
1714642279772,SOCI 117,A01,494376,Staff,0,4,5,5
1714642280800,WES 237B,A00,494380,Staff,9,0,20,11
1714642282886,AESE 279B,A00,494370,Wade; Jon P,0,0,33,33
1714642283913,AIP 197,001,627712,Vespa; Emanuel Ignacio,9998,0,9999,1
1714642284938,ANAR 135S,A00,494369,Braswell; Geoffrey E.,0,0,0,0
1714642285967,BENG 196,001,628496,Engler; Adam J.,9998,0,9999,1
1714642286991,CAT 124RS,A01,519847,Geibel; William,0,0,20,20
1714642288018,CAT 125RS,A01,515971,Geibel; William,0,0,20,20
1714642289044,CLRE 250,A00,511389,Morris; Sheldon,9993,0,9999,6
1714642290073,CLRE 251,A00,507176,Mehta; Ravindra L.,9993,0,9999,6
1714642290073,CLRE 251,B00,511410,Mehta; Ravindra L.,9998,0,9999,1
1714642291097,CLRE 252,A00,507189,Cuomo; Raphael Eduardo,9995,0,9999,4
1714642292162,CLRE 253,A00,507199,Vaida; Florin,9994,0,9999,5
1714642292162,CLRE 253,B00,507202,Vaida; Florin,9999,0,9999,0
1714642293190,CLRE 259,A00,507211,Patel; Hemal,9996,0,9999,3
1714642294215,CLRE 260,A00,507221,Cuomo; Raphael Eduardo,9999,0,9999,0
1714642295241,CLRE 297,001,507242,Cuomo; Raphael Eduardo,9999,0,9999,0
1714642296269,COGS 197,001,638244,Voytek; Bradley Thomas,9998,0,9999,1
1714642297294,CSE 191,A00,516875,Minnes Kemp; Mor Mia,9992,0,9999,7
1714642298321,CSE 197,001,637388,Minnes Kemp; Mor Mia,9998,0,9999,1
1714642299347,CSS 201S,A01,494383,Staff,35,0,35,0
1714642300372,CSS 202S,A01,494387,Staff,35,0,35,0
1714642301398,DSC 197,001,628532,Eldridge; Justin Matthew,9996,0,9999,3
1714642302424,EAP 100,A00,516065,Staff,9797,0,9999,202
1714642303451,ECE 45,A01,507414,Staff,33,0,60,27
1714642305502,ECE 111,A01,507420,Staff,15,0,50,35
1714642306532,ECE 197,001,548057,Sievenpiper; Daniel F.,9993,0,9999,6
1714642307559,EDS 115,A00,507243,Choi; Bailey Miyeon,10,0,28,18
1714642308585,EDS 117,A01,494379,Staff,0,4,30,30
1714642309613,EDS 125,A00,507246,Hopkins; Megan Beth,9,0,30,21
1714642310640,EDS 128A,A01,507264,Fargason; Sharon Gayle,8,0,26,18
1714642311664,EDS 128B,A01,507293,Pappas; Elizabeth,12,0,30,18
1714642312689,EDS 139,A00,507294,Fargason; Sharon Gayle,13,0,30,17
1714642312689,EDS 139,B00,507313,Pappas; Elizabeth,13,0,30,17
1714642313715,EDS 201,A00,507315,Staff,13,0,30,17
1714642314739,EDS 203,A01,507317,Halter; Christopher P.,12,0,30,18
1714642315766,EDS 204R,A01,507319,Halter; Christopher P.,0,3,30,30
1714642315766,EDS 204R,B01,507331,Heinzman; Erica M.,16,0,30,14
1714642316790,EDS 206R,A00,507332,Staff,0,4,30,30
1714642316790,EDS 206R,B00,507343,Staff,17,0,30,13
1714642317816,EDS 250,A00,507344,Hemans; Patricia Ann Benitez,22,0,40,18
1714642318843,EDS 281,A00,507345,Daly; Alan J.,18,0,18,0
1714642319871,EDS 284,A00,507350,Daly; Alan J.,16,0,16,0
1714642320901,EDS 286,A00,507359,Fine; Sarah,18,0,18,0
1714642321926,EDS 289C,A01,507361,Daly; Alan J.,18,0,18,0
1714642322951,EDS 290,A00,507366,Hofstetter; Carolyn,15,0,15,0
1714642323977,LIGM 5A,A00,507421,Fischer-Grunski; Eva K,18,0,20,2
1714642325007,LIGM 5B,A00,507423,Fischer-Grunski; Eva K,19,0,20,1
1714642326036,LIGM 5C,A00,507425,Fischer-Grunski; Eva K,19,0,20,1
1714642327061,LIIT 5AS,A00,507427,Carnelos; Chiara,20,0,20,0
1714642328088,LIIT 5BS,A00,507430,Carnelos; Chiara,20,0,20,0
1714642329115,LIIT 5CS,A00,507432,Carnelos; Chiara,20,0,20,0
1714642330141,LISP 5A,A00,507541,Munoz Sanchez; Alicia,11,0,20,9
1714642331167,LISP 5B,A00,507671,Munoz Sanchez; Alicia,8,0,20,12
1714642332197,LISP 5C,A00,507696,Munoz Sanchez; Alicia,9,0,20,11
1714642333221,MAE 197,001,528363,Boechler; Nicholas Sebastia,9998,0,9999,1
1714642334248,MATH 197,001,523477,Kedlaya; Kiran S.,9995,0,9999,4
1714642334248,MATH 197,002,563811,Zhang; Danna,9995,0,9999,4
1714642334248,MATH 197,003,628552,Dumitriu; Ioana,9998,0,9999,1
1714642335273,MCWP 40R,A00,518780,Staff,2,0,20,18
1714642335273,MCWP 40R,B00,518781,Staff,8,0,20,12
1714642335273,MCWP 40R,C00,518783,Staff,6,0,20,14
1714642336303,MCWP 50R,A00,518791,Staff,0,0,20,20
1714642336303,MCWP 50R,B00,518792,Staff,0,2,20,20
1714642336303,MCWP 50R,C00,518793,Staff,0,2,20,20
1714642336303,MCWP 50R,D00,518794,Staff,0,1,20,20
1714642336303,MCWP 50R,E00,518795,Staff,0,2,20,20
1714642336303,MCWP 50R,F00,518796,Staff,0,0,20,20
1714642336303,MCWP 50R,G00,518797,Staff,0,1,20,20
1714642337327,MMW 12R,A01,514034,Herbst; Matthew,0,0,16,16
1714642337327,MMW 12R,A02,514035,Herbst; Matthew,1,0,16,15
1714642338350,MMW 13R,A01,514037,Staff,0,4,16,16
1714642338350,MMW 13R,A02,514039,Staff,0,2,16,16
1714642338350,MMW 13R,A03,628519,Staff,0,2,16,16
1714642340400,SIO 295LS,A00,523233,Staff,10,0,30,20
1714642341430,SIO 295S,A00,523232,Staff,10,0,30,20
1714642342457,SIOC 290S,A01,637330,Merrifield; Mark A,23,0,30,7
1714642343481,SIOC 291S,A01,637333,Gabriel; Corey John,23,0,30,7
1714642344509,SOCI 117,A01,494376,Staff,0,4,5,5
1714642345537,WES 237B,A00,494380,Staff,9,0,20,11
1714642347610,AESE 279B,A00,494370,Wade; Jon P,0,0,33,33
1714642348635,AIP 197,001,627712,Vespa; Emanuel Ignacio,9998,0,9999,1
1714642349659,ANAR 135S,A00,494369,Braswell; Geoffrey E.,0,0,0,0
1714642350685,BENG 196,001,628496,Engler; Adam J.,9998,0,9999,1
1714642351711,CAT 124RS,A01,519847,Geibel; William,0,0,20,20
1714642352735,CAT 125RS,A01,515971,Geibel; William,0,0,20,20
1714642353761,CLRE 250,A00,511389,Morris; Sheldon,9993,0,9999,6
1714642354788,CLRE 251,A00,507176,Mehta; Ravindra L.,9993,0,9999,6
1714642354788,CLRE 251,B00,511410,Mehta; Ravindra L.,9998,0,9999,1
1714642355818,CLRE 252,A00,507189,Cuomo; Raphael Eduardo,9995,0,9999,4
1714642356844,CLRE 253,A00,507199,Vaida; Florin,9994,0,9999,5
1714642356844,CLRE 253,B00,507202,Vaida; Florin,9999,0,9999,0
1714642357872,CLRE 259,A00,507211,Patel; Hemal,9996,0,9999,3
1714642358897,CLRE 260,A00,507221,Cuomo; Raphael Eduardo,9999,0,9999,0
1714642359922,CLRE 297,001,507242,Cuomo; Raphael Eduardo,9999,0,9999,0
1714642360948,COGS 197,001,638244,Voytek; Bradley Thomas,9998,0,9999,1
1714642361974,CSE 191,A00,516875,Minnes Kemp; Mor Mia,9992,0,9999,7
1714642363003,CSE 197,001,637388,Minnes Kemp; Mor Mia,9998,0,9999,1
1714642364033,CSS 201S,A01,494383,Staff,35,0,35,0
1714642365057,CSS 202S,A01,494387,Staff,35,0,35,0
1714642366087,DSC 197,001,628532,Eldridge; Justin Matthew,9996,0,9999,3
1714642367114,EAP 100,A00,516065,Staff,9797,0,9999,202
1714642368143,ECE 45,A01,507414,Staff,33,0,60,27
1714642370199,ECE 111,A01,507420,Staff,15,0,50,35
1714642371225,ECE 197,001,548057,Sievenpiper; Daniel F.,9993,0,9999,6
1714642372256,EDS 115,A00,507243,Choi; Bailey Miyeon,10,0,28,18
1714642373286,EDS 117,A01,494379,Staff,0,4,30,30
1714642374312,EDS 125,A00,507246,Hopkins; Megan Beth,9,0,30,21
1714642375338,EDS 128A,A01,507264,Fargason; Sharon Gayle,8,0,26,18
1714642376364,EDS 128B,A01,507293,Pappas; Elizabeth,12,0,30,18
1714642377389,EDS 139,A00,507294,Fargason; Sharon Gayle,13,0,30,17
1714642377389,EDS 139,B00,507313,Pappas; Elizabeth,13,0,30,17
1714642378417,EDS 201,A00,507315,Staff,13,0,30,17
1714642379445,EDS 203,A01,507317,Halter; Christopher P.,12,0,30,18
1714642380470,EDS 204R,A01,507319,Halter; Christopher P.,0,3,30,30
1714642380470,EDS 204R,B01,507331,Heinzman; Erica M.,16,0,30,14
1714642381496,EDS 206R,A00,507332,Staff,0,4,30,30
1714642381496,EDS 206R,B00,507343,Staff,17,0,30,13
1714642382527,EDS 250,A00,507344,Hemans; Patricia Ann Benitez,22,0,40,18
1714642383556,EDS 281,A00,507345,Daly; Alan J.,18,0,18,0
1714642384582,EDS 284,A00,507350,Daly; Alan J.,16,0,16,0
1714642385613,EDS 286,A00,507359,Fine; Sarah,18,0,18,0
1714642386638,EDS 289C,A01,507361,Daly; Alan J.,18,0,18,0
1714642387663,EDS 290,A00,507366,Hofstetter; Carolyn,15,0,15,0
1714642388689,LIGM 5A,A00,507421,Fischer-Grunski; Eva K,18,0,20,2
1714642389717,LIGM 5B,A00,507423,Fischer-Grunski; Eva K,19,0,20,1
1714642390744,LIGM 5C,A00,507425,Fischer-Grunski; Eva K,19,0,20,1
1714642391768,LIIT 5AS,A00,507427,Carnelos; Chiara,20,0,20,0
1714642392793,LIIT 5BS,A00,507430,Carnelos; Chiara,20,0,20,0
1714642393817,LIIT 5CS,A00,507432,Carnelos; Chiara,20,0,20,0
1714642394844,LISP 5A,A00,507541,Munoz Sanchez; Alicia,11,0,20,9
1714642395872,LISP 5B,A00,507671,Munoz Sanchez; Alicia,8,0,20,12
1714642396900,LISP 5C,A00,507696,Munoz Sanchez; Alicia,9,0,20,11
1714642397926,MAE 197,001,528363,Boechler; Nicholas Sebastia,9998,0,9999,1
1714642398954,MATH 197,001,523477,Kedlaya; Kiran S.,9995,0,9999,4
1714642398954,MATH 197,002,563811,Zhang; Danna,9995,0,9999,4
1714642398954,MATH 197,003,628552,Dumitriu; Ioana,9998,0,9999,1
1714642399979,MCWP 40R,A00,518780,Staff,2,0,20,18
1714642399979,MCWP 40R,B00,518781,Staff,8,0,20,12
1714642399979,MCWP 40R,C00,518783,Staff,6,0,20,14
1714642401009,MCWP 50R,A00,518791,Staff,0,0,20,20
1714642401009,MCWP 50R,B00,518792,Staff,0,2,20,20
1714642401009,MCWP 50R,C00,518793,Staff,0,2,20,20
1714642401009,MCWP 50R,D00,518794,Staff,0,1,20,20
1714642401009,MCWP 50R,E00,518795,Staff,0,2,20,20
1714642401009,MCWP 50R,F00,518796,Staff,0,0,20,20
1714642401009,MCWP 50R,G00,518797,Staff,0,1,20,20
1714642402034,MMW 12R,A01,514034,Herbst; Matthew,0,0,16,16
1714642402034,MMW 12R,A02,514035,Herbst; Matthew,1,0,16,15
1714642403061,MMW 13R,A01,514037,Staff,0,4,16,16
1714642403061,MMW 13R,A02,514039,Staff,0,2,16,16
1714642403061,MMW 13R,A03,628519,Staff,0,2,16,16
1714642405114,SIO 295LS,A00,523233,Staff,10,0,30,20
1714642406144,SIO 295S,A00,523232,Staff,10,0,30,20
1714642407173,SIOC 290S,A01,637330,Merrifield; Mark A,23,0,30,7
1714642408202,SIOC 291S,A01,637333,Gabriel; Corey John,23,0,30,7
1714642409228,SOCI 117,A01,494376,Staff,0,4,5,5
1714642410253,WES 237B,A00,494380,Staff,9,0,20,11
1714642412334,AESE 279B,A00,494370,Wade; Jon P,0,0,33,33
1714642413363,AIP 197,001,627712,Vespa; Emanuel Ignacio,9998,0,9999,1
1714642414389,ANAR 135S,A00,494369,Braswell; Geoffrey E.,0,0,0,0
1714642415413,BENG 196,001,628496,Engler; Adam J.,9998,0,9999,1
1714642416441,CAT 124RS,A01,519847,Geibel; William,0,0,20,20
1714642417465,CAT 125RS,A01,515971,Geibel; William,0,0,20,20
1714642418490,CLRE 250,A00,511389,Morris; Sheldon,9993,0,9999,6
1714642419522,CLRE 251,A00,507176,Mehta; Ravindra L.,9993,0,9999,6
1714642419522,CLRE 251,B00,511410,Mehta; Ravindra L.,9998,0,9999,1
1714642420548,CLRE 252,A00,507189,Cuomo; Raphael Eduardo,9995,0,9999,4
1714642421574,CLRE 253,A00,507199,Vaida; Florin,9994,0,9999,5
1714642421574,CLRE 253,B00,507202,Vaida; Florin,9999,0,9999,0
1714642422600,CLRE 259,A00,507211,Patel; Hemal,9996,0,9999,3
1714642423624,CLRE 260,A00,507221,Cuomo; Raphael Eduardo,9999,0,9999,0
1714642424648,CLRE 297,001,507242,Cuomo; Raphael Eduardo,9999,0,9999,0
1714642425673,COGS 197,001,638244,Voytek; Bradley Thomas,9998,0,9999,1
1714642426699,CSE 191,A00,516875,Minnes Kemp; Mor Mia,9992,0,9999,7
1714642427724,CSE 197,001,637388,Minnes Kemp; Mor Mia,9998,0,9999,1
1714642428750,CSS 201S,A01,494383,Staff,35,0,35,0
1714642429779,CSS 202S,A01,494387,Staff,35,0,35,0
1714642430805,DSC 197,001,628532,Eldridge; Justin Matthew,9996,0,9999,3
1714642431833,EAP 100,A00,516065,Staff,9797,0,9999,202
1714642432858,ECE 45,A01,507414,Staff,33,0,60,27
1714642434919,ECE 111,A01,507420,Staff,15,0,50,35
1714642435945,ECE 197,001,548057,Sievenpiper; Daniel F.,9993,0,9999,6
1714642436975,EDS 115,A00,507243,Choi; Bailey Miyeon,10,0,28,18
1714642438002,EDS 117,A01,494379,Staff,0,4,30,30
1714642439033,EDS 125,A00,507246,Hopkins; Megan Beth,9,0,30,21
1714642440057,EDS 128A,A01,507264,Fargason; Sharon Gayle,8,0,26,18
1714642441086,EDS 128B,A01,507293,Pappas; Elizabeth,12,0,30,18
1714642442112,EDS 139,A00,507294,Fargason; Sharon Gayle,13,0,30,17
1714642442112,EDS 139,B00,507313,Pappas; Elizabeth,13,0,30,17
1714642443137,EDS 201,A00,507315,Staff,13,0,30,17
1714642444162,EDS 203,A01,507317,Halter; Christopher P.,12,0,30,18
1714642445188,EDS 204R,A01,507319,Halter; Christopher P.,0,3,30,30
1714642445188,EDS 204R,B01,507331,Heinzman; Erica M.,16,0,30,14
1714642446213,EDS 206R,A00,507332,Staff,0,4,30,30
1714642446213,EDS 206R,B00,507343,Staff,17,0,30,13
1714642447242,EDS 250,A00,507344,Hemans; Patricia Ann Benitez,22,0,40,18
1714642448273,EDS 281,A00,507345,Daly; Alan J.,18,0,18,0
1714642449301,EDS 284,A00,507350,Daly; Alan J.,16,0,16,0
1714642450329,EDS 286,A00,507359,Fine; Sarah,18,0,18,0
1714642451357,EDS 289C,A01,507361,Daly; Alan J.,18,0,18,0
1714642452384,EDS 290,A00,507366,Hofstetter; Carolyn,15,0,15,0
1714642453413,LIGM 5A,A00,507421,Fischer-Grunski; Eva K,18,0,20,2
1714642454440,LIGM 5B,A00,507423,Fischer-Grunski; Eva K,19,0,20,1
1714642455466,LIGM 5C,A00,507425,Fischer-Grunski; Eva K,19,0,20,1
1714642456496,LIIT 5AS,A00,507427,Carnelos; Chiara,20,0,20,0
1714642457521,LIIT 5BS,A00,507430,Carnelos; Chiara,20,0,20,0
1714642458548,LIIT 5CS,A00,507432,Carnelos; Chiara,20,0,20,0
1714642459574,LISP 5A,A00,507541,Munoz Sanchez; Alicia,11,0,20,9
1714642460602,LISP 5B,A00,507671,Munoz Sanchez; Alicia,8,0,20,12
1714642461631,LISP 5C,A00,507696,Munoz Sanchez; Alicia,9,0,20,11
1714642462660,MAE 197,001,528363,Boechler; Nicholas Sebastia,9998,0,9999,1
1714642463686,MATH 197,001,523477,Kedlaya; Kiran S.,9995,0,9999,4
1714642463686,MATH 197,002,563811,Zhang; Danna,9995,0,9999,4
1714642463686,MATH 197,003,628552,Dumitriu; Ioana,9998,0,9999,1
1714642464710,MCWP 40R,A00,518780,Staff,2,0,20,18
1714642464710,MCWP 40R,B00,518781,Staff,8,0,20,12
1714642464710,MCWP 40R,C00,518783,Staff,6,0,20,14
1714642465737,MCWP 50R,A00,518791,Staff,0,0,20,20
1714642465737,MCWP 50R,B00,518792,Staff,0,2,20,20
1714642465737,MCWP 50R,C00,518793,Staff,0,2,20,20
1714642465737,MCWP 50R,D00,518794,Staff,0,1,20,20
1714642465737,MCWP 50R,E00,518795,Staff,0,2,20,20
1714642465737,MCWP 50R,F00,518796,Staff,0,0,20,20
1714642465737,MCWP 50R,G00,518797,Staff,0,1,20,20
1714642466768,MMW 12R,A01,514034,Herbst; Matthew,0,0,16,16
1714642466768,MMW 12R,A02,514035,Herbst; Matthew,1,0,16,15
1714642467793,MMW 13R,A01,514037,Staff,0,4,16,16
1714642467793,MMW 13R,A02,514039,Staff,0,2,16,16
1714642467793,MMW 13R,A03,628519,Staff,0,2,16,16
1714642469847,SIO 295LS,A00,523233,Staff,10,0,30,20
1714642470928,SIO 295S,A00,523232,Staff,10,0,30,20
1714642471959,SIOC 290S,A01,637330,Merrifield; Mark A,23,0,30,7
1714642472989,SIOC 291S,A01,637333,Gabriel; Corey John,23,0,30,7
1714642474028,SOCI 117,A01,494376,Staff,0,4,5,5
1714642475054,WES 237B,A00,494380,Staff,9,0,20,11
1714642477126,AESE 279B,A00,494370,Wade; Jon P,0,0,33,33
1714642478154,AIP 197,001,627712,Vespa; Emanuel Ignacio,9998,0,9999,1
1714642479178,ANAR 135S,A00,494369,Braswell; Geoffrey E.,0,0,0,0
1714642480202,BENG 196,001,628496,Engler; Adam J.,9998,0,9999,1
1714642481230,CAT 124RS,A01,519847,Geibel; William,0,0,20,20
1714642482253,CAT 125RS,A01,515971,Geibel; William,0,0,20,20
1714642483280,CLRE 250,A00,511389,Morris; Sheldon,9993,0,9999,6
1714642484306,CLRE 251,A00,507176,Mehta; Ravindra L.,9993,0,9999,6
1714642484306,CLRE 251,B00,511410,Mehta; Ravindra L.,9998,0,9999,1
1714642485331,CLRE 252,A00,507189,Cuomo; Raphael Eduardo,9995,0,9999,4
1714642486355,CLRE 253,A00,507199,Vaida; Florin,9994,0,9999,5
1714642486355,CLRE 253,B00,507202,Vaida; Florin,9999,0,9999,0
1714642487379,CLRE 259,A00,507211,Patel; Hemal,9996,0,9999,3
1714642488404,CLRE 260,A00,507221,Cuomo; Raphael Eduardo,9999,0,9999,0
1714642489431,CLRE 297,001,507242,Cuomo; Raphael Eduardo,9999,0,9999,0
1714642490458,COGS 197,001,638244,Voytek; Bradley Thomas,9998,0,9999,1
1714642491486,CSE 191,A00,516875,Minnes Kemp; Mor Mia,9992,0,9999,7
1714642492511,CSE 197,001,637388,Minnes Kemp; Mor Mia,9998,0,9999,1
1714642493542,CSS 201S,A01,494383,Staff,35,0,35,0
1714642494568,CSS 202S,A01,494387,Staff,35,0,35,0
1714642495596,DSC 197,001,628532,Eldridge; Justin Matthew,9996,0,9999,3
1714642496622,EAP 100,A00,516065,Staff,9797,0,9999,202
1714642497649,ECE 45,A01,507414,Staff,33,0,60,27
1714642499703,ECE 111,A01,507420,Staff,15,0,50,35
1714642500731,ECE 197,001,548057,Sievenpiper; Daniel F.,9993,0,9999,6
1714642501760,EDS 115,A00,507243,Choi; Bailey Miyeon,10,0,28,18
1714642502791,EDS 117,A01,494379,Staff,0,4,30,30
1714642503817,EDS 125,A00,507246,Hopkins; Megan Beth,9,0,30,21
1714642504843,EDS 128A,A01,507264,Fargason; Sharon Gayle,8,0,26,18
1714642505870,EDS 128B,A01,507293,Pappas; Elizabeth,12,0,30,18
1714642506895,EDS 139,A00,507294,Fargason; Sharon Gayle,13,0,30,17
1714642506895,EDS 139,B00,507313,Pappas; Elizabeth,13,0,30,17
1714642507923,EDS 201,A00,507315,Staff,13,0,30,17
1714642508953,EDS 203,A01,507317,Halter; Christopher P.,12,0,30,18
1714642509984,EDS 204R,A01,507319,Halter; Christopher P.,0,3,30,30
1714642509984,EDS 204R,B01,507331,Heinzman; Erica M.,16,0,30,14
1714642511012,EDS 206R,A00,507332,Staff,0,4,30,30
1714642511012,EDS 206R,B00,507343,Staff,17,0,30,13
1714642512038,EDS 250,A00,507344,Hemans; Patricia Ann Benitez,22,0,40,18
1714642513064,EDS 281,A00,507345,Daly; Alan J.,18,0,18,0
1714642514090,EDS 284,A00,507350,Daly; Alan J.,16,0,16,0
1714642515117,EDS 286,A00,507359,Fine; Sarah,18,0,18,0
1714642516142,EDS 289C,A01,507361,Daly; Alan J.,18,0,18,0
1714642517167,EDS 290,A00,507366,Hofstetter; Carolyn,15,0,15,0
1714642518195,LIGM 5A,A00,507421,Fischer-Grunski; Eva K,18,0,20,2
1714642519224,LIGM 5B,A00,507423,Fischer-Grunski; Eva K,19,0,20,1
1714642520255,LIGM 5C,A00,507425,Fischer-Grunski; Eva K,19,0,20,1
1714642521282,LIIT 5AS,A00,507427,Carnelos; Chiara,20,0,20,0
1714642522305,LIIT 5BS,A00,507430,Carnelos; Chiara,20,0,20,0
1714642523330,LIIT 5CS,A00,507432,Carnelos; Chiara,20,0,20,0
1714642524358,LISP 5A,A00,507541,Munoz Sanchez; Alicia,11,0,20,9
1714642525385,LISP 5B,A00,507671,Munoz Sanchez; Alicia,8,0,20,12
1714642526410,LISP 5C,A00,507696,Munoz Sanchez; Alicia,9,0,20,11
1714642527437,MAE 197,001,528363,Boechler; Nicholas Sebastia,9998,0,9999,1
1714642528464,MATH 197,001,523477,Kedlaya; Kiran S.,9995,0,9999,4
1714642528464,MATH 197,002,563811,Zhang; Danna,9995,0,9999,4
1714642528464,MATH 197,003,628552,Dumitriu; Ioana,9998,0,9999,1
1714642529494,MCWP 40R,A00,518780,Staff,2,0,20,18
1714642529494,MCWP 40R,B00,518781,Staff,8,0,20,12
1714642529494,MCWP 40R,C00,518783,Staff,6,0,20,14
1714642530726,MCWP 50R,A00,518791,Staff,0,0,20,20
1714642530726,MCWP 50R,B00,518792,Staff,0,2,20,20
1714642530726,MCWP 50R,C00,518793,Staff,0,2,20,20
1714642530726,MCWP 50R,D00,518794,Staff,0,1,20,20
1714642530726,MCWP 50R,E00,518795,Staff,0,2,20,20
1714642530726,MCWP 50R,F00,518796,Staff,0,0,20,20
1714642530726,MCWP 50R,G00,518797,Staff,0,1,20,20
1714642531753,MMW 12R,A01,514034,Herbst; Matthew,0,0,16,16
1714642531753,MMW 12R,A02,514035,Herbst; Matthew,1,0,16,15
1714642532780,MMW 13R,A01,514037,Staff,0,4,16,16
1714642532780,MMW 13R,A02,514039,Staff,0,2,16,16
1714642532780,MMW 13R,A03,628519,Staff,0,2,16,16
1714642534833,SIO 295LS,A00,523233,Staff,10,0,30,20
1714642535859,SIO 295S,A00,523232,Staff,10,0,30,20
1714642536885,SIOC 290S,A01,637330,Merrifield; Mark A,23,0,30,7
1714642537911,SIOC 291S,A01,637333,Gabriel; Corey John,23,0,30,7
1714642538938,SOCI 117,A01,494376,Staff,0,4,5,5
1714642540017,WES 237B,A00,494380,Staff,9,0,20,11
1714642542076,AESE 279B,A00,494370,Wade; Jon P,0,0,33,33
1714642543100,AIP 197,001,627712,Vespa; Emanuel Ignacio,9998,0,9999,1
1714642544128,ANAR 135S,A00,494369,Braswell; Geoffrey E.,0,0,0,0
1714642545156,BENG 196,001,628496,Engler; Adam J.,9998,0,9999,1
1714642546186,CAT 124RS,A01,519847,Geibel; William,0,0,20,20
1714642547210,CAT 125RS,A01,515971,Geibel; William,0,0,20,20
1714642548237,CLRE 250,A00,511389,Morris; Sheldon,9993,0,9999,6
1714642549265,CLRE 251,A00,507176,Mehta; Ravindra L.,9993,0,9999,6
1714642549265,CLRE 251,B00,511410,Mehta; Ravindra L.,9998,0,9999,1
1714642550290,CLRE 252,A00,507189,Cuomo; Raphael Eduardo,9995,0,9999,4
1714642551317,CLRE 253,A00,507199,Vaida; Florin,9994,0,9999,5
1714642551317,CLRE 253,B00,507202,Vaida; Florin,9999,0,9999,0
1714642552343,CLRE 259,A00,507211,Patel; Hemal,9996,0,9999,3
1714642553372,CLRE 260,A00,507221,Cuomo; Raphael Eduardo,9999,0,9999,0
1714642554399,CLRE 297,001,507242,Cuomo; Raphael Eduardo,9999,0,9999,0
1714642555427,COGS 197,001,638244,Voytek; Bradley Thomas,9998,0,9999,1
1714642556457,CSE 191,A00,516875,Minnes Kemp; Mor Mia,9992,0,9999,7
1714642557484,CSE 197,001,637388,Minnes Kemp; Mor Mia,9998,0,9999,1
1714642558514,CSS 201S,A01,494383,Staff,35,0,35,0
1714642559540,CSS 202S,A01,494387,Staff,35,0,35,0
1714642560568,DSC 197,001,628532,Eldridge; Justin Matthew,9996,0,9999,3
1714642561592,EAP 100,A00,516065,Staff,9797,0,9999,202
1714642562617,ECE 45,A01,507414,Staff,33,0,60,27
1714642564672,ECE 111,A01,507420,Staff,15,0,50,35
1714642565698,ECE 197,001,548057,Sievenpiper; Daniel F.,9993,0,9999,6
1714642566730,EDS 115,A00,507243,Choi; Bailey Miyeon,10,0,28,18
1714642567762,EDS 117,A01,494379,Staff,0,4,30,30
1714642568790,EDS 125,A00,507246,Hopkins; Megan Beth,9,0,30,21
1714642569814,EDS 128A,A01,507264,Fargason; Sharon Gayle,8,0,26,18
1714642570841,EDS 128B,A01,507293,Pappas; Elizabeth,12,0,30,18
1714642571869,EDS 139,A00,507294,Fargason; Sharon Gayle,13,0,30,17
1714642571869,EDS 139,B00,507313,Pappas; Elizabeth,13,0,30,17
1714642572894,EDS 201,A00,507315,Staff,13,0,30,17
1714642573923,EDS 203,A01,507317,Halter; Christopher P.,12,0,30,18
1714642574951,EDS 204R,A01,507319,Halter; Christopher P.,0,3,30,30
1714642574951,EDS 204R,B01,507331,Heinzman; Erica M.,16,0,30,14
1714642575978,EDS 206R,A00,507332,Staff,0,4,30,30
1714642575978,EDS 206R,B00,507343,Staff,17,0,30,13
1714642577005,EDS 250,A00,507344,Hemans; Patricia Ann Benitez,22,0,40,18
1714642578034,EDS 281,A00,507345,Daly; Alan J.,18,0,18,0
1714642579058,EDS 284,A00,507350,Daly; Alan J.,16,0,16,0
1714642580084,EDS 286,A00,507359,Fine; Sarah,18,0,18,0
1714642581110,EDS 289C,A01,507361,Daly; Alan J.,18,0,18,0
1714642582135,EDS 290,A00,507366,Hofstetter; Carolyn,15,0,15,0
1714642583163,LIGM 5A,A00,507421,Fischer-Grunski; Eva K,18,0,20,2
1714642584186,LIGM 5B,A00,507423,Fischer-Grunski; Eva K,19,0,20,1
1714642585213,LIGM 5C,A00,507425,Fischer-Grunski; Eva K,19,0,20,1
1714642586241,LIIT 5AS,A00,507427,Carnelos; Chiara,20,0,20,0
1714642587266,LIIT 5BS,A00,507430,Carnelos; Chiara,20,0,20,0
1714642588295,LIIT 5CS,A00,507432,Carnelos; Chiara,20,0,20,0
1714642589327,LISP 5A,A00,507541,Munoz Sanchez; Alicia,11,0,20,9
1714642590354,LISP 5B,A00,507671,Munoz Sanchez; Alicia,8,0,20,12
1714642591378,LISP 5C,A00,507696,Munoz Sanchez; Alicia,9,0,20,11
1714642592407,MAE 197,001,528363,Boechler; Nicholas Sebastia,9998,0,9999,1
1714642593437,MATH 197,001,523477,Kedlaya; Kiran S.,9995,0,9999,4
1714642593437,MATH 197,002,563811,Zhang; Danna,9995,0,9999,4
1714642593437,MATH 197,003,628552,Dumitriu; Ioana,9998,0,9999,1
1714642594465,MCWP 40R,A00,518780,Staff,2,0,20,18
1714642594465,MCWP 40R,B00,518781,Staff,8,0,20,12
1714642594465,MCWP 40R,C00,518783,Staff,6,0,20,14
1714642595493,MCWP 50R,A00,518791,Staff,0,0,20,20
1714642595493,MCWP 50R,B00,518792,Staff,0,2,20,20
1714642595493,MCWP 50R,C00,518793,Staff,0,2,20,20
1714642595493,MCWP 50R,D00,518794,Staff,0,1,20,20
1714642595493,MCWP 50R,E00,518795,Staff,0,2,20,20
1714642595493,MCWP 50R,F00,518796,Staff,0,0,20,20
1714642595493,MCWP 50R,G00,518797,Staff,0,1,20,20
1714642596522,MMW 12R,A01,514034,Herbst; Matthew,0,0,16,16
1714642596522,MMW 12R,A02,514035,Herbst; Matthew,1,0,16,15
1714642597548,MMW 13R,A01,514037,Staff,0,4,16,16
1714642597548,MMW 13R,A02,514039,Staff,0,2,16,16
1714642597548,MMW 13R,A03,628519,Staff,0,2,16,16
1714642599596,SIO 295LS,A00,523233,Staff,10,0,30,20
1714642600623,SIO 295S,A00,523232,Staff,10,0,30,20
1714642601655,SIOC 290S,A01,637330,Merrifield; Mark A,23,0,30,7
1714642602680,SIOC 291S,A01,637333,Gabriel; Corey John,23,0,30,7
1714642603706,SOCI 117,A01,494376,Staff,0,4,5,5
1714642604735,WES 237B,A00,494380,Staff,9,0,20,11
1714642606809,AESE 279B,A00,494370,Wade; Jon P,0,0,33,33
1714642607834,AIP 197,001,627712,Vespa; Emanuel Ignacio,9998,0,9999,1
1714642608859,ANAR 135S,A00,494369,Braswell; Geoffrey E.,0,0,0,0
1714642609887,BENG 196,001,628496,Engler; Adam J.,9998,0,9999,1
1714642610912,CAT 124RS,A01,519847,Geibel; William,0,0,20,20
1714642611938,CAT 125RS,A01,515971,Geibel; William,0,0,20,20
1714642612968,CLRE 250,A00,511389,Morris; Sheldon,9993,0,9999,6
1714642613995,CLRE 251,A00,507176,Mehta; Ravindra L.,9993,0,9999,6
1714642613995,CLRE 251,B00,511410,Mehta; Ravindra L.,9998,0,9999,1
1714642615024,CLRE 252,A00,507189,Cuomo; Raphael Eduardo,9995,0,9999,4
1714642616052,CLRE 253,A00,507199,Vaida; Florin,9994,0,9999,5
1714642616052,CLRE 253,B00,507202,Vaida; Florin,9999,0,9999,0
1714642617082,CLRE 259,A00,507211,Patel; Hemal,9996,0,9999,3
1714642618109,CLRE 260,A00,507221,Cuomo; Raphael Eduardo,9999,0,9999,0
1714642619133,CLRE 297,001,507242,Cuomo; Raphael Eduardo,9999,0,9999,0
1714642620159,COGS 197,001,638244,Voytek; Bradley Thomas,9998,0,9999,1
1714642621188,CSE 191,A00,516875,Minnes Kemp; Mor Mia,9992,0,9999,7
1714642622216,CSE 197,001,637388,Minnes Kemp; Mor Mia,9998,0,9999,1
1714642623249,CSS 201S,A01,494383,Staff,35,0,35,0
1714642624278,CSS 202S,A01,494387,Staff,35,0,35,0
1714642625309,DSC 197,001,628532,Eldridge; Justin Matthew,9996,0,9999,3
1714642626333,EAP 100,A00,516065,Staff,9797,0,9999,202
1714642627362,ECE 45,A01,507414,Staff,33,0,60,27
1714642629416,ECE 111,A01,507420,Staff,15,0,50,35
1714642630445,ECE 197,001,548057,Sievenpiper; Daniel F.,9993,0,9999,6
1714642631475,EDS 115,A00,507243,Choi; Bailey Miyeon,10,0,28,18
1714642632500,EDS 117,A01,494379,Staff,0,4,30,30
1714642633530,EDS 125,A00,507246,Hopkins; Megan Beth,9,0,30,21
1714642634558,EDS 128A,A01,507264,Fargason; Sharon Gayle,8,0,26,18
1714642635585,EDS 128B,A01,507293,Pappas; Elizabeth,12,0,30,18
1714642636613,EDS 139,A00,507294,Fargason; Sharon Gayle,13,0,30,17
1714642636613,EDS 139,B00,507313,Pappas; Elizabeth,13,0,30,17
1714642637641,EDS 201,A00,507315,Staff,13,0,30,17
1714642638666,EDS 203,A01,507317,Halter; Christopher P.,12,0,30,18
1714642639693,EDS 204R,A01,507319,Halter; Christopher P.,0,3,30,30
1714642639693,EDS 204R,B01,507331,Heinzman; Erica M.,16,0,30,14
1714642640716,EDS 206R,A00,507332,Staff,0,4,30,30
1714642640716,EDS 206R,B00,507343,Staff,17,0,30,13
1714642641745,EDS 250,A00,507344,Hemans; Patricia Ann Benitez,22,0,40,18
1714642642773,EDS 281,A00,507345,Daly; Alan J.,18,0,18,0
1714642643866,EDS 284,A00,507350,Daly; Alan J.,16,0,16,0
1714642644891,EDS 286,A00,507359,Fine; Sarah,18,0,18,0
1714642645919,EDS 289C,A01,507361,Daly; Alan J.,18,0,18,0
1714642646947,EDS 290,A00,507366,Hofstetter; Carolyn,15,0,15,0
1714642647973,LIGM 5A,A00,507421,Fischer-Grunski; Eva K,18,0,20,2
1714642648997,LIGM 5B,A00,507423,Fischer-Grunski; Eva K,19,0,20,1
1714642650021,LIGM 5C,A00,507425,Fischer-Grunski; Eva K,19,0,20,1
1714642651051,LIIT 5AS,A00,507427,Carnelos; Chiara,20,0,20,0
1714642652079,LIIT 5BS,A00,507430,Carnelos; Chiara,20,0,20,0
1714642653103,LIIT 5CS,A00,507432,Carnelos; Chiara,20,0,20,0
1714642654133,LISP 5A,A00,507541,Munoz Sanchez; Alicia,11,0,20,9
1714642655158,LISP 5B,A00,507671,Munoz Sanchez; Alicia,8,0,20,12
1714642656183,LISP 5C,A00,507696,Munoz Sanchez; Alicia,9,0,20,11
1714642657211,MAE 197,001,528363,Boechler; Nicholas Sebastia,9998,0,9999,1
1714642658240,MATH 197,001,523477,Kedlaya; Kiran S.,9995,0,9999,4
1714642658240,MATH 197,002,563811,Zhang; Danna,9995,0,9999,4
1714642658240,MATH 197,003,628552,Dumitriu; Ioana,9998,0,9999,1
1714642659265,MCWP 40R,A00,518780,Staff,2,0,20,18
1714642659265,MCWP 40R,B00,518781,Staff,8,0,20,12
1714642659265,MCWP 40R,C00,518783,Staff,6,0,20,14
1714642660292,MCWP 50R,A00,518791,Staff,0,0,20,20
1714642660292,MCWP 50R,B00,518792,Staff,0,2,20,20
1714642660292,MCWP 50R,C00,518793,Staff,0,2,20,20
1714642660292,MCWP 50R,D00,518794,Staff,0,1,20,20
1714642660292,MCWP 50R,E00,518795,Staff,0,2,20,20
1714642660292,MCWP 50R,F00,518796,Staff,0,0,20,20
1714642660292,MCWP 50R,G00,518797,Staff,0,1,20,20
1714642661321,MMW 12R,A01,514034,Herbst; Matthew,0,0,16,16
1714642661321,MMW 12R,A02,514035,Herbst; Matthew,1,0,16,15
1714642662350,MMW 13R,A01,514037,Staff,0,4,16,16
1714642662350,MMW 13R,A02,514039,Staff,0,2,16,16
1714642662350,MMW 13R,A03,628519,Staff,0,2,16,16
1714642664401,SIO 295LS,A00,523233,Staff,10,0,30,20
1714642665425,SIO 295S,A00,523232,Staff,10,0,30,20
1714642666457,SIOC 290S,A01,637330,Merrifield; Mark A,23,0,30,7
1714642667487,SIOC 291S,A01,637333,Gabriel; Corey John,23,0,30,7
1714642668518,SOCI 117,A01,494376,Staff,0,4,5,5
1714642669543,WES 237B,A00,494380,Staff,9,0,20,11
1714642671616,AESE 279B,A00,494370,Wade; Jon P,0,0,33,33
1714642672641,AIP 197,001,627712,Vespa; Emanuel Ignacio,9998,0,9999,1
1714642673668,ANAR 135S,A00,494369,Braswell; Geoffrey E.,0,0,0,0
1714642674696,BENG 196,001,628496,Engler; Adam J.,9998,0,9999,1
1714642675723,CAT 124RS,A01,519847,Geibel; William,0,0,20,20
1714642676750,CAT 125RS,A01,515971,Geibel; William,0,0,20,20
1714642677776,CLRE 250,A00,511389,Morris; Sheldon,9993,0,9999,6
1714642678802,CLRE 251,A00,507176,Mehta; Ravindra L.,9993,0,9999,6
1714642678802,CLRE 251,B00,511410,Mehta; Ravindra L.,9998,0,9999,1
1714642679826,CLRE 252,A00,507189,Cuomo; Raphael Eduardo,9995,0,9999,4
1714642680852,CLRE 253,A00,507199,Vaida; Florin,9994,0,9999,5
1714642680852,CLRE 253,B00,507202,Vaida; Florin,9999,0,9999,0
1714642681880,CLRE 259,A00,507211,Patel; Hemal,9996,0,9999,3
1714642682906,CLRE 260,A00,507221,Cuomo; Raphael Eduardo,9999,0,9999,0
1714642683931,CLRE 297,001,507242,Cuomo; Raphael Eduardo,9999,0,9999,0
1714642684958,COGS 197,001,638244,Voytek; Bradley Thomas,9998,0,9999,1
1714642685987,CSE 191,A00,516875,Minnes Kemp; Mor Mia,9992,0,9999,7
1714642687011,CSE 197,001,637388,Minnes Kemp; Mor Mia,9998,0,9999,1
1714642688037,CSS 201S,A01,494383,Staff,35,0,35,0
1714642689065,CSS 202S,A01,494387,Staff,35,0,35,0
1714642690091,DSC 197,001,628532,Eldridge; Justin Matthew,9996,0,9999,3
1714642691118,EAP 100,A00,516065,Staff,9797,0,9999,202
1714642692146,ECE 45,A01,507414,Staff,33,0,60,27
1714642694195,ECE 111,A01,507420,Staff,15,0,50,35
1714642695222,ECE 197,001,548057,Sievenpiper; Daniel F.,9993,0,9999,6
1714642696248,EDS 115,A00,507243,Choi; Bailey Miyeon,10,0,28,18
1714642697276,EDS 117,A01,494379,Staff,0,4,30,30
1714642698301,EDS 125,A00,507246,Hopkins; Megan Beth,9,0,30,21
1714642699328,EDS 128A,A01,507264,Fargason; Sharon Gayle,8,0,26,18
1714642700359,EDS 128B,A01,507293,Pappas; Elizabeth,12,0,30,18
1714642701383,EDS 139,A00,507294,Fargason; Sharon Gayle,13,0,30,17
1714642701383,EDS 139,B00,507313,Pappas; Elizabeth,13,0,30,17
1714642702406,EDS 201,A00,507315,Staff,13,0,30,17
1714642703434,EDS 203,A01,507317,Halter; Christopher P.,12,0,30,18
1714642704461,EDS 204R,A01,507319,Halter; Christopher P.,0,3,30,30
1714642704461,EDS 204R,B01,507331,Heinzman; Erica M.,16,0,30,14
1714642705487,EDS 206R,A00,507332,Staff,0,4,30,30
1714642705487,EDS 206R,B00,507343,Staff,17,0,30,13
1714642706512,EDS 250,A00,507344,Hemans; Patricia Ann Benitez,22,0,40,18
1714642707541,EDS 281,A00,507345,Daly; Alan J.,18,0,18,0
1714642708568,EDS 284,A00,507350,Daly; Alan J.,16,0,16,0
1714642709592,EDS 286,A00,507359,Fine; Sarah,18,0,18,0
1714642710620,EDS 289C,A01,507361,Daly; Alan J.,18,0,18,0
1714642711644,EDS 290,A00,507366,Hofstetter; Carolyn,15,0,15,0
1714642712677,LIGM 5A,A00,507421,Fischer-Grunski; Eva K,18,0,20,2
1714642713704,LIGM 5B,A00,507423,Fischer-Grunski; Eva K,19,0,20,1
1714642714730,LIGM 5C,A00,507425,Fischer-Grunski; Eva K,19,0,20,1
1714642715760,LIIT 5AS,A00,507427,Carnelos; Chiara,20,0,20,0
1714642716789,LIIT 5BS,A00,507430,Carnelos; Chiara,20,0,20,0
1714642717818,LIIT 5CS,A00,507432,Carnelos; Chiara,20,0,20,0
1714642718844,LISP 5A,A00,507541,Munoz Sanchez; Alicia,11,0,20,9
1714642719872,LISP 5B,A00,507671,Munoz Sanchez; Alicia,8,0,20,12
1714642720900,LISP 5C,A00,507696,Munoz Sanchez; Alicia,9,0,20,11
1714642721931,MAE 197,001,528363,Boechler; Nicholas Sebastia,9998,0,9999,1
1714642722963,MATH 197,001,523477,Kedlaya; Kiran S.,9995,0,9999,4
1714642722963,MATH 197,002,563811,Zhang; Danna,9995,0,9999,4
1714642722963,MATH 197,003,628552,Dumitriu; Ioana,9998,0,9999,1
1714642723991,MCWP 40R,A00,518780,Staff,2,0,20,18
1714642723991,MCWP 40R,B00,518781,Staff,8,0,20,12
1714642723991,MCWP 40R,C00,518783,Staff,6,0,20,14
1714642725022,MCWP 50R,A00,518791,Staff,0,0,20,20
1714642725022,MCWP 50R,B00,518792,Staff,0,2,20,20
1714642725022,MCWP 50R,C00,518793,Staff,0,2,20,20
1714642725022,MCWP 50R,D00,518794,Staff,0,1,20,20
1714642725022,MCWP 50R,E00,518795,Staff,0,2,20,20
1714642725022,MCWP 50R,F00,518796,Staff,0,0,20,20
1714642725022,MCWP 50R,G00,518797,Staff,0,1,20,20
1714642726049,MMW 12R,A01,514034,Herbst; Matthew,0,0,16,16
1714642726049,MMW 12R,A02,514035,Herbst; Matthew,1,0,16,15
1714642727075,MMW 13R,A01,514037,Staff,0,4,16,16
1714642727075,MMW 13R,A02,514039,Staff,0,2,16,16
1714642727075,MMW 13R,A03,628519,Staff,0,2,16,16
1714642729128,SIO 295LS,A00,523233,Staff,10,0,30,20
1714642730154,SIO 295S,A00,523232,Staff,10,0,30,20
1714642731185,SIOC 290S,A01,637330,Merrifield; Mark A,23,0,30,7
1714642732211,SIOC 291S,A01,637333,Gabriel; Corey John,23,0,30,7
1714642733236,SOCI 117,A01,494376,Staff,0,4,5,5
1714642734262,WES 237B,A00,494380,Staff,9,0,20,11
1714642736334,AESE 279B,A00,494370,Wade; Jon P,0,0,33,33
1714642737361,AIP 197,001,627712,Vespa; Emanuel Ignacio,9998,0,9999,1
1714642738388,ANAR 135S,A00,494369,Braswell; Geoffrey E.,0,0,0,0
1714642739414,BENG 196,001,628496,Engler; Adam J.,9998,0,9999,1
1714642740441,CAT 124RS,A01,519847,Geibel; William,0,0,20,20
1714642741468,CAT 125RS,A01,515971,Geibel; William,0,0,20,20
1714642742494,CLRE 250,A00,511389,Morris; Sheldon,9993,0,9999,6
1714642743526,CLRE 251,A00,507176,Mehta; Ravindra L.,9993,0,9999,6
1714642743526,CLRE 251,B00,511410,Mehta; Ravindra L.,9998,0,9999,1
1714642744555,CLRE 252,A00,507189,Cuomo; Raphael Eduardo,9995,0,9999,4
1714642745584,CLRE 253,A00,507199,Vaida; Florin,9994,0,9999,5
1714642745584,CLRE 253,B00,507202,Vaida; Florin,9999,0,9999,0
1714642746611,CLRE 259,A00,507211,Patel; Hemal,9996,0,9999,3
1714642747691,CLRE 260,A00,507221,Cuomo; Raphael Eduardo,9999,0,9999,0
1714642748726,CLRE 297,001,507242,Cuomo; Raphael Eduardo,9999,0,9999,0
1714642749754,COGS 197,001,638244,Voytek; Bradley Thomas,9998,0,9999,1
1714642750780,CSE 191,A00,516875,Minnes Kemp; Mor Mia,9992,0,9999,7
1714642751808,CSE 197,001,637388,Minnes Kemp; Mor Mia,9998,0,9999,1
1714642752837,CSS 201S,A01,494383,Staff,35,0,35,0
1714642753868,CSS 202S,A01,494387,Staff,35,0,35,0
1714642754899,DSC 197,001,628532,Eldridge; Justin Matthew,9996,0,9999,3
1714642755922,EAP 100,A00,516065,Staff,9797,0,9999,202
1714642756948,ECE 45,A01,507414,Staff,33,0,60,27
1714642759002,ECE 111,A01,507420,Staff,15,0,50,35
1714642760031,ECE 197,001,548057,Sievenpiper; Daniel F.,9993,0,9999,6
1714642761062,EDS 115,A00,507243,Choi; Bailey Miyeon,10,0,28,18
1714642762092,EDS 117,A01,494379,Staff,0,4,30,30
1714642763117,EDS 125,A00,507246,Hopkins; Megan Beth,9,0,30,21
1714642764143,EDS 128A,A01,507264,Fargason; Sharon Gayle,8,0,26,18
1714642765169,EDS 128B,A01,507293,Pappas; Elizabeth,12,0,30,18
1714642766194,EDS 139,A00,507294,Fargason; Sharon Gayle,13,0,30,17
1714642766194,EDS 139,B00,507313,Pappas; Elizabeth,13,0,30,17
1714642767220,EDS 201,A00,507315,Staff,13,0,30,17
1714642768249,EDS 203,A01,507317,Halter; Christopher P.,12,0,30,18
1714642769276,EDS 204R,A01,507319,Halter; Christopher P.,0,3,30,30
1714642769276,EDS 204R,B01,507331,Heinzman; Erica M.,16,0,30,14
1714642770301,EDS 206R,A00,507332,Staff,0,4,30,30
1714642770301,EDS 206R,B00,507343,Staff,17,0,30,13
1714642771331,EDS 250,A00,507344,Hemans; Patricia Ann Benitez,22,0,40,18
1714642772356,EDS 281,A00,507345,Daly; Alan J.,18,0,18,0
1714642773382,EDS 284,A00,507350,Daly; Alan J.,16,0,16,0
1714642774406,EDS 286,A00,507359,Fine; Sarah,18,0,18,0
1714642775433,EDS 289C,A01,507361,Daly; Alan J.,18,0,18,0
1714642776461,EDS 290,A00,507366,Hofstetter; Carolyn,15,0,15,0
1714642777487,LIGM 5A,A00,507421,Fischer-Grunski; Eva K,18,0,20,2
1714642778517,LIGM 5B,A00,507423,Fischer-Grunski; Eva K,19,0,20,1
1714642779545,LIGM 5C,A00,507425,Fischer-Grunski; Eva K,19,0,20,1
1714642780572,LIIT 5AS,A00,507427,Carnelos; Chiara,20,0,20,0
1714642781598,LIIT 5BS,A00,507430,Carnelos; Chiara,20,0,20,0
1714642782627,LIIT 5CS,A00,507432,Carnelos; Chiara,20,0,20,0
1714642783654,LISP 5A,A00,507541,Munoz Sanchez; Alicia,11,0,20,9
1714642784683,LISP 5B,A00,507671,Munoz Sanchez; Alicia,8,0,20,12
1714642785712,LISP 5C,A00,507696,Munoz Sanchez; Alicia,9,0,20,11
1714642786741,MAE 197,001,528363,Boechler; Nicholas Sebastia,9998,0,9999,1
1714642787769,MATH 197,001,523477,Kedlaya; Kiran S.,9995,0,9999,4
1714642787769,MATH 197,002,563811,Zhang; Danna,9995,0,9999,4
1714642787769,MATH 197,003,628552,Dumitriu; Ioana,9998,0,9999,1
1714642788793,MCWP 40R,A00,518780,Staff,2,0,20,18
1714642788793,MCWP 40R,B00,518781,Staff,8,0,20,12
1714642788793,MCWP 40R,C00,518783,Staff,6,0,20,14
1714642789822,MCWP 50R,A00,518791,Staff,0,0,20,20
1714642789822,MCWP 50R,B00,518792,Staff,0,2,20,20
1714642789822,MCWP 50R,C00,518793,Staff,0,2,20,20
1714642789822,MCWP 50R,D00,518794,Staff,0,1,20,20
1714642789822,MCWP 50R,E00,518795,Staff,0,2,20,20
1714642789822,MCWP 50R,F00,518796,Staff,0,0,20,20
1714642789822,MCWP 50R,G00,518797,Staff,0,1,20,20
1714642790848,MMW 12R,A01,514034,Herbst; Matthew,0,0,16,16
1714642790848,MMW 12R,A02,514035,Herbst; Matthew,1,0,16,15
1714642791873,MMW 13R,A01,514037,Staff,0,4,16,16
1714642791873,MMW 13R,A02,514039,Staff,0,2,16,16
1714642791873,MMW 13R,A03,628519,Staff,0,2,16,16
1714642793925,SIO 295LS,A00,523233,Staff,10,0,30,20
1714642794952,SIO 295S,A00,523232,Staff,10,0,30,20
1714642795978,SIOC 290S,A01,637330,Merrifield; Mark A,23,0,30,7
1714642797003,SIOC 291S,A01,637333,Gabriel; Corey John,23,0,30,7
1714642798031,SOCI 117,A01,494376,Staff,0,4,5,5
1714642799057,WES 237B,A00,494380,Staff,9,0,20,11
1714642801133,AESE 279B,A00,494370,Wade; Jon P,0,0,33,33
1714642802161,AIP 197,001,627712,Vespa; Emanuel Ignacio,9998,0,9999,1
1714642803186,ANAR 135S,A00,494369,Braswell; Geoffrey E.,0,0,0,0
1714642804210,BENG 196,001,628496,Engler; Adam J.,9998,0,9999,1
1714642805239,CAT 124RS,A01,519847,Geibel; William,0,0,20,20
1714642806269,CAT 125RS,A01,515971,Geibel; William,0,0,20,20
1714642807295,CLRE 250,A00,511389,Morris; Sheldon,9993,0,9999,6
1714642808329,CLRE 251,A00,507176,Mehta; Ravindra L.,9993,0,9999,6
1714642808329,CLRE 251,B00,511410,Mehta; Ravindra L.,9998,0,9999,1
1714642809359,CLRE 252,A00,507189,Cuomo; Raphael Eduardo,9995,0,9999,4
1714642810385,CLRE 253,A00,507199,Vaida; Florin,9994,0,9999,5
1714642810385,CLRE 253,B00,507202,Vaida; Florin,9999,0,9999,0
1714642811414,CLRE 259,A00,507211,Patel; Hemal,9996,0,9999,3
1714642812443,CLRE 260,A00,507221,Cuomo; Raphael Eduardo,9999,0,9999,0
1714642813470,CLRE 297,001,507242,Cuomo; Raphael Eduardo,9999,0,9999,0
1714642814497,COGS 197,001,638244,Voytek; Bradley Thomas,9998,0,9999,1
1714642815522,CSE 191,A00,516875,Minnes Kemp; Mor Mia,9992,0,9999,7
1714642816550,CSE 197,001,637388,Minnes Kemp; Mor Mia,9998,0,9999,1
1714642817575,CSS 201S,A01,494383,Staff,35,0,35,0
1714642818602,CSS 202S,A01,494387,Staff,35,0,35,0
1714642819626,DSC 197,001,628532,Eldridge; Justin Matthew,9996,0,9999,3
1714642820652,EAP 100,A00,516065,Staff,9797,0,9999,202
1714642821677,ECE 45,A01,507414,Staff,33,0,60,27
1714642823727,ECE 111,A01,507420,Staff,15,0,50,35
1714642824757,ECE 197,001,548057,Sievenpiper; Daniel F.,9993,0,9999,6
1714642825784,EDS 115,A00,507243,Choi; Bailey Miyeon,10,0,28,18
1714642826811,EDS 117,A01,494379,Staff,0,4,30,30
1714642827840,EDS 125,A00,507246,Hopkins; Megan Beth,9,0,30,21
1714642828867,EDS 128A,A01,507264,Fargason; Sharon Gayle,8,0,26,18
1714642829893,EDS 128B,A01,507293,Pappas; Elizabeth,12,0,30,18
1714642830915,EDS 139,A00,507294,Fargason; Sharon Gayle,13,0,30,17
1714642830915,EDS 139,B00,507313,Pappas; Elizabeth,13,0,30,17
1714642831942,EDS 201,A00,507315,Staff,13,0,30,17
1714642832966,EDS 203,A01,507317,Halter; Christopher P.,12,0,30,18
1714642833997,EDS 204R,A01,507319,Halter; Christopher P.,0,3,30,30
1714642833997,EDS 204R,B01,507331,Heinzman; Erica M.,16,0,30,14
1714642835023,EDS 206R,A00,507332,Staff,0,4,30,30
1714642835023,EDS 206R,B00,507343,Staff,17,0,30,13
1714642836048,EDS 250,A00,507344,Hemans; Patricia Ann Benitez,22,0,40,18
1714642837076,EDS 281,A00,507345,Daly; Alan J.,18,0,18,0
1714642838102,EDS 284,A00,507350,Daly; Alan J.,16,0,16,0
1714642839132,EDS 286,A00,507359,Fine; Sarah,18,0,18,0
1714642840158,EDS 289C,A01,507361,Daly; Alan J.,18,0,18,0
1714642841187,EDS 290,A00,507366,Hofstetter; Carolyn,15,0,15,0
1714642842215,LIGM 5A,A00,507421,Fischer-Grunski; Eva K,18,0,20,2
1714642843240,LIGM 5B,A00,507423,Fischer-Grunski; Eva K,19,0,20,1
1714642844264,LIGM 5C,A00,507425,Fischer-Grunski; Eva K,19,0,20,1
1714642845294,LIIT 5AS,A00,507427,Carnelos; Chiara,20,0,20,0
1714642846319,LIIT 5BS,A00,507430,Carnelos; Chiara,20,0,20,0
1714642847348,LIIT 5CS,A00,507432,Carnelos; Chiara,20,0,20,0
1714642848379,LISP 5A,A00,507541,Munoz Sanchez; Alicia,11,0,20,9
1714642849404,LISP 5B,A00,507671,Munoz Sanchez; Alicia,8,0,20,12
1714642850429,LISP 5C,A00,507696,Munoz Sanchez; Alicia,9,0,20,11
1714642851511,MAE 197,001,528363,Boechler; Nicholas Sebastia,9998,0,9999,1
1714642852541,MATH 197,001,523477,Kedlaya; Kiran S.,9995,0,9999,4
1714642852541,MATH 197,002,563811,Zhang; Danna,9995,0,9999,4
1714642852541,MATH 197,003,628552,Dumitriu; Ioana,9998,0,9999,1
1714642853568,MCWP 40R,A00,518780,Staff,2,0,20,18
1714642853568,MCWP 40R,B00,518781,Staff,8,0,20,12
1714642853568,MCWP 40R,C00,518783,Staff,6,0,20,14
1714642854594,MCWP 50R,A00,518791,Staff,0,0,20,20
1714642854594,MCWP 50R,B00,518792,Staff,0,2,20,20
1714642854594,MCWP 50R,C00,518793,Staff,0,2,20,20
1714642854594,MCWP 50R,D00,518794,Staff,0,1,20,20
1714642854594,MCWP 50R,E00,518795,Staff,0,2,20,20
1714642854594,MCWP 50R,F00,518796,Staff,0,0,20,20
1714642854594,MCWP 50R,G00,518797,Staff,0,1,20,20
1714642855623,MMW 12R,A01,514034,Herbst; Matthew,0,0,16,16
1714642855623,MMW 12R,A02,514035,Herbst; Matthew,1,0,16,15
1714642856648,MMW 13R,A01,514037,Staff,0,4,16,16
1714642856648,MMW 13R,A02,514039,Staff,0,2,16,16
1714642856648,MMW 13R,A03,628519,Staff,0,2,16,16
1714642858700,SIO 295LS,A00,523233,Staff,10,0,30,20
1714642859729,SIO 295S,A00,523232,Staff,10,0,30,20
1714642860763,SIOC 290S,A01,637330,Merrifield; Mark A,23,0,30,7
1714642861790,SIOC 291S,A01,637333,Gabriel; Corey John,23,0,30,7
1714642862816,SOCI 117,A01,494376,Staff,0,4,5,5
1714642863843,WES 237B,A00,494380,Staff,9,0,20,11
1714642865912,AESE 279B,A00,494370,Wade; Jon P,0,0,33,33
1714642866937,AIP 197,001,627712,Vespa; Emanuel Ignacio,9998,0,9999,1
1714642867963,ANAR 135S,A00,494369,Braswell; Geoffrey E.,0,0,0,0
1714642868993,BENG 196,001,628496,Engler; Adam J.,9998,0,9999,1
1714642870019,CAT 124RS,A01,519847,Geibel; William,0,0,20,20
1714642871044,CAT 125RS,A01,515971,Geibel; William,0,0,20,20
1714642872071,CLRE 250,A00,511389,Morris; Sheldon,9993,0,9999,6
1714642873103,CLRE 251,A00,507176,Mehta; Ravindra L.,9993,0,9999,6
1714642873103,CLRE 251,B00,511410,Mehta; Ravindra L.,9998,0,9999,1
1714642874129,CLRE 252,A00,507189,Cuomo; Raphael Eduardo,9995,0,9999,4
1714642875155,CLRE 253,A00,507199,Vaida; Florin,9994,0,9999,5
1714642875155,CLRE 253,B00,507202,Vaida; Florin,9999,0,9999,0
1714642876184,CLRE 259,A00,507211,Patel; Hemal,9996,0,9999,3
1714642877211,CLRE 260,A00,507221,Cuomo; Raphael Eduardo,9999,0,9999,0
1714642878239,CLRE 297,001,507242,Cuomo; Raphael Eduardo,9999,0,9999,0
1714642879265,COGS 197,001,638244,Voytek; Bradley Thomas,9998,0,9999,1
1714642880292,CSE 191,A00,516875,Minnes Kemp; Mor Mia,9992,0,9999,7
1714642881319,CSE 197,001,637388,Minnes Kemp; Mor Mia,9998,0,9999,1
1714642882348,CSS 201S,A01,494383,Staff,35,0,35,0
1714642883375,CSS 202S,A01,494387,Staff,35,0,35,0
1714642884399,DSC 197,001,628532,Eldridge; Justin Matthew,9996,0,9999,3
1714642885425,EAP 100,A00,516065,Staff,9797,0,9999,202
1714642886455,ECE 45,A01,507414,Staff,33,0,60,27
1714642888507,ECE 111,A01,507420,Staff,15,0,50,35
1714642889536,ECE 197,001,548057,Sievenpiper; Daniel F.,9993,0,9999,6
1714642890564,EDS 115,A00,507243,Choi; Bailey Miyeon,10,0,28,18
1714642891591,EDS 117,A01,494379,Staff,0,4,30,30
1714642892617,EDS 125,A00,507246,Hopkins; Megan Beth,9,0,30,21
1714642893645,EDS 128A,A01,507264,Fargason; Sharon Gayle,8,0,26,18
1714642894670,EDS 128B,A01,507293,Pappas; Elizabeth,12,0,30,18
1714642895695,EDS 139,A00,507294,Fargason; Sharon Gayle,13,0,30,17
1714642895695,EDS 139,B00,507313,Pappas; Elizabeth,13,0,30,17
1714642896724,EDS 201,A00,507315,Staff,13,0,30,17
1714642897749,EDS 203,A01,507317,Halter; Christopher P.,12,0,30,18
1714642898774,EDS 204R,A01,507319,Halter; Christopher P.,0,3,30,30
1714642898774,EDS 204R,B01,507331,Heinzman; Erica M.,16,0,30,14
1714642899798,EDS 206R,A00,507332,Staff,0,4,30,30
1714642899798,EDS 206R,B00,507343,Staff,17,0,30,13
1714642900827,EDS 250,A00,507344,Hemans; Patricia Ann Benitez,22,0,40,18
1714642901852,EDS 281,A00,507345,Daly; Alan J.,18,0,18,0
1714642902882,EDS 284,A00,507350,Daly; Alan J.,16,0,16,0
1714642903911,EDS 286,A00,507359,Fine; Sarah,18,0,18,0
1714642904938,EDS 289C,A01,507361,Daly; Alan J.,18,0,18,0
1714642905970,EDS 290,A00,507366,Hofstetter; Carolyn,15,0,15,0
1714642906995,LIGM 5A,A00,507421,Fischer-Grunski; Eva K,18,0,20,2
1714642908023,LIGM 5B,A00,507423,Fischer-Grunski; Eva K,19,0,20,1
1714642909053,LIGM 5C,A00,507425,Fischer-Grunski; Eva K,19,0,20,1
1714642910100,LIIT 5AS,A00,507427,Carnelos; Chiara,20,0,20,0
1714642911125,LIIT 5BS,A00,507430,Carnelos; Chiara,20,0,20,0
1714642912700,LIIT 5CS,A00,507432,Carnelos; Chiara,20,0,20,0
1714642913727,LISP 5A,A00,507541,Munoz Sanchez; Alicia,11,0,20,9
1714642914753,LISP 5B,A00,507671,Munoz Sanchez; Alicia,8,0,20,12
1714642915782,LISP 5C,A00,507696,Munoz Sanchez; Alicia,9,0,20,11
1714642916809,MAE 197,001,528363,Boechler; Nicholas Sebastia,9998,0,9999,1
1714642917842,MATH 197,001,523477,Kedlaya; Kiran S.,9995,0,9999,4
1714642917842,MATH 197,002,563811,Zhang; Danna,9995,0,9999,4
1714642917842,MATH 197,003,628552,Dumitriu; Ioana,9998,0,9999,1
1714642918878,MCWP 40R,A00,518780,Staff,2,0,20,18
1714642918878,MCWP 40R,B00,518781,Staff,8,0,20,12
1714642918878,MCWP 40R,C00,518783,Staff,6,0,20,14
1714642919906,MCWP 50R,A00,518791,Staff,0,0,20,20
1714642919906,MCWP 50R,B00,518792,Staff,0,2,20,20
1714642919906,MCWP 50R,C00,518793,Staff,0,2,20,20
1714642919906,MCWP 50R,D00,518794,Staff,0,1,20,20
1714642919906,MCWP 50R,E00,518795,Staff,0,2,20,20
1714642919906,MCWP 50R,F00,518796,Staff,0,0,20,20
1714642919906,MCWP 50R,G00,518797,Staff,0,1,20,20
1714642920932,MMW 12R,A01,514034,Herbst; Matthew,0,0,16,16
1714642920932,MMW 12R,A02,514035,Herbst; Matthew,1,0,16,15
1714642921958,MMW 13R,A01,514037,Staff,0,4,16,16
1714642921958,MMW 13R,A02,514039,Staff,0,2,16,16
1714642921958,MMW 13R,A03,628519,Staff,0,2,16,16
1714642924011,SIO 295LS,A00,523233,Staff,10,0,30,20
1714642925039,SIO 295S,A00,523232,Staff,10,0,30,20
1714642926067,SIOC 290S,A01,637330,Merrifield; Mark A,23,0,30,7
1714642927093,SIOC 291S,A01,637333,Gabriel; Corey John,23,0,30,7
1714642928120,SOCI 117,A01,494376,Staff,0,4,5,5
1714642929145,WES 237B,A00,494380,Staff,9,0,20,11
1714642931225,AESE 279B,A00,494370,Wade; Jon P,0,0,33,33
1714642932253,AIP 197,001,627712,Vespa; Emanuel Ignacio,9998,0,9999,1
1714642933279,ANAR 135S,A00,494369,Braswell; Geoffrey E.,0,0,0,0
1714642934309,BENG 196,001,628496,Engler; Adam J.,9998,0,9999,1
1714642935334,CAT 124RS,A01,519847,Geibel; William,0,0,20,20
1714642936357,CAT 125RS,A01,515971,Geibel; William,0,0,20,20
1714642937384,CLRE 250,A00,511389,Morris; Sheldon,9993,0,9999,6
1714642938414,CLRE 251,A00,507176,Mehta; Ravindra L.,9993,0,9999,6
1714642938414,CLRE 251,B00,511410,Mehta; Ravindra L.,9998,0,9999,1
1714642939440,CLRE 252,A00,507189,Cuomo; Raphael Eduardo,9995,0,9999,4
1714642940465,CLRE 253,A00,507199,Vaida; Florin,9994,0,9999,5
1714642940465,CLRE 253,B00,507202,Vaida; Florin,9999,0,9999,0
1714642941493,CLRE 259,A00,507211,Patel; Hemal,9996,0,9999,3
1714642942518,CLRE 260,A00,507221,Cuomo; Raphael Eduardo,9999,0,9999,0
1714642943542,CLRE 297,001,507242,Cuomo; Raphael Eduardo,9999,0,9999,0
1714642944571,COGS 197,001,638244,Voytek; Bradley Thomas,9998,0,9999,1
1714642945597,CSE 191,A00,516875,Minnes Kemp; Mor Mia,9992,0,9999,7
1714642946622,CSE 197,001,637388,Minnes Kemp; Mor Mia,9998,0,9999,1
1714642947648,CSS 201S,A01,494383,Staff,35,0,35,0
1714642948673,CSS 202S,A01,494387,Staff,35,0,35,0
1714642949701,DSC 197,001,628532,Eldridge; Justin Matthew,9996,0,9999,3
1714642950784,EAP 100,A00,516065,Staff,9797,0,9999,202
1714642951810,ECE 45,A01,507414,Staff,33,0,60,27
1714642953879,ECE 111,A01,507420,Staff,15,0,50,35
1714642954903,ECE 197,001,548057,Sievenpiper; Daniel F.,9993,0,9999,6
1714642955987,EDS 115,A00,507243,Choi; Bailey Miyeon,10,0,28,18
1714642957012,EDS 117,A01,494379,Staff,0,4,30,30
1714642958037,EDS 125,A00,507246,Hopkins; Megan Beth,9,0,30,21
1714642959066,EDS 128A,A01,507264,Fargason; Sharon Gayle,8,0,26,18
1714642960096,EDS 128B,A01,507293,Pappas; Elizabeth,12,0,30,18
1714642961123,EDS 139,A00,507294,Fargason; Sharon Gayle,13,0,30,17
1714642961123,EDS 139,B00,507313,Pappas; Elizabeth,13,0,30,17
1714642962150,EDS 201,A00,507315,Staff,13,0,30,17
1714642963176,EDS 203,A01,507317,Halter; Christopher P.,12,0,30,18
1714642964205,EDS 204R,A01,507319,Halter; Christopher P.,0,3,30,30
1714642964205,EDS 204R,B01,507331,Heinzman; Erica M.,16,0,30,14
1714642965233,EDS 206R,A00,507332,Staff,0,4,30,30
1714642965233,EDS 206R,B00,507343,Staff,17,0,30,13
1714642966259,EDS 250,A00,507344,Hemans; Patricia Ann Benitez,22,0,40,18
1714642967285,EDS 281,A00,507345,Daly; Alan J.,18,0,18,0
1714642968310,EDS 284,A00,507350,Daly; Alan J.,16,0,16,0
1714642969339,EDS 286,A00,507359,Fine; Sarah,18,0,18,0
1714642970365,EDS 289C,A01,507361,Daly; Alan J.,18,0,18,0
1714642971390,EDS 290,A00,507366,Hofstetter; Carolyn,15,0,15,0
1714642972419,LIGM 5A,A00,507421,Fischer-Grunski; Eva K,18,0,20,2
1714642973445,LIGM 5B,A00,507423,Fischer-Grunski; Eva K,19,0,20,1
1714642974476,LIGM 5C,A00,507425,Fischer-Grunski; Eva K,19,0,20,1
1714642975505,LIIT 5AS,A00,507427,Carnelos; Chiara,20,0,20,0
1714642976533,LIIT 5BS,A00,507430,Carnelos; Chiara,20,0,20,0
1714642977562,LIIT 5CS,A00,507432,Carnelos; Chiara,20,0,20,0
1714642978588,LISP 5A,A00,507541,Munoz Sanchez; Alicia,11,0,20,9
1714642979616,LISP 5B,A00,507671,Munoz Sanchez; Alicia,8,0,20,12
1714642980646,LISP 5C,A00,507696,Munoz Sanchez; Alicia,9,0,20,11
1714642981671,MAE 197,001,528363,Boechler; Nicholas Sebastia,9998,0,9999,1
1714642982698,MATH 197,001,523477,Kedlaya; Kiran S.,9995,0,9999,4
1714642982698,MATH 197,002,563811,Zhang; Danna,9995,0,9999,4
1714642982698,MATH 197,003,628552,Dumitriu; Ioana,9998,0,9999,1
1714642983723,MCWP 40R,A00,518780,Staff,2,0,20,18
1714642983723,MCWP 40R,B00,518781,Staff,8,0,20,12
1714642983723,MCWP 40R,C00,518783,Staff,6,0,20,14
1714642984747,MCWP 50R,A00,518791,Staff,0,0,20,20
1714642984747,MCWP 50R,B00,518792,Staff,0,2,20,20
1714642984747,MCWP 50R,C00,518793,Staff,0,2,20,20
1714642984747,MCWP 50R,D00,518794,Staff,0,1,20,20
1714642984747,MCWP 50R,E00,518795,Staff,0,2,20,20
1714642984747,MCWP 50R,F00,518796,Staff,0,0,20,20
1714642984747,MCWP 50R,G00,518797,Staff,0,1,20,20
1714642985776,MMW 12R,A01,514034,Herbst; Matthew,0,0,16,16
1714642985776,MMW 12R,A02,514035,Herbst; Matthew,1,0,16,15
1714642986802,MMW 13R,A01,514037,Staff,0,4,16,16
1714642986802,MMW 13R,A02,514039,Staff,0,2,16,16
1714642986802,MMW 13R,A03,628519,Staff,0,2,16,16
1714642988854,SIO 295LS,A00,523233,Staff,10,0,30,20
1714642989882,SIO 295S,A00,523232,Staff,10,0,30,20
1714642990908,SIOC 290S,A01,637330,Merrifield; Mark A,23,0,30,7
1714642991937,SIOC 291S,A01,637333,Gabriel; Corey John,23,0,30,7
1714642992962,SOCI 117,A01,494376,Staff,0,4,5,5
1714642993991,WES 237B,A00,494380,Staff,9,0,20,11
1714642996078,AESE 279B,A00,494370,Wade; Jon P,0,0,33,33
1714642997104,AIP 197,001,627712,Vespa; Emanuel Ignacio,9998,0,9999,1
1714642998129,ANAR 135S,A00,494369,Braswell; Geoffrey E.,0,0,0,0
1714642999154,BENG 196,001,628496,Engler; Adam J.,9998,0,9999,1
1714643000178,CAT 124RS,A01,519847,Geibel; William,0,0,20,20
1714643001204,CAT 125RS,A01,515971,Geibel; William,0,0,20,20
1714643002238,CLRE 250,A00,511389,Morris; Sheldon,9993,0,9999,6
1714643003266,CLRE 251,A00,507176,Mehta; Ravindra L.,9993,0,9999,6
1714643003266,CLRE 251,B00,511410,Mehta; Ravindra L.,9998,0,9999,1
1714643004293,CLRE 252,A00,507189,Cuomo; Raphael Eduardo,9995,0,9999,4
1714643005321,CLRE 253,A00,507199,Vaida; Florin,9994,0,9999,5
1714643005321,CLRE 253,B00,507202,Vaida; Florin,9999,0,9999,0
1714643006348,CLRE 259,A00,507211,Patel; Hemal,9996,0,9999,3
1714643007375,CLRE 260,A00,507221,Cuomo; Raphael Eduardo,9999,0,9999,0
1714643008401,CLRE 297,001,507242,Cuomo; Raphael Eduardo,9999,0,9999,0
1714643009429,COGS 197,001,638244,Voytek; Bradley Thomas,9998,0,9999,1
1714643010457,CSE 191,A00,516875,Minnes Kemp; Mor Mia,9992,0,9999,7
1714643011483,CSE 197,001,637388,Minnes Kemp; Mor Mia,9998,0,9999,1
1714643012517,CSS 201S,A01,494383,Staff,35,0,35,0
1714643013542,CSS 202S,A01,494387,Staff,35,0,35,0
1714643014565,DSC 197,001,628532,Eldridge; Justin Matthew,9996,0,9999,3
1714643015592,EAP 100,A00,516065,Staff,9797,0,9999,202
1714643016621,ECE 45,A01,507414,Staff,33,0,60,27
1714643018679,ECE 111,A01,507420,Staff,15,0,50,35
1714643019705,ECE 197,001,548057,Sievenpiper; Daniel F.,9993,0,9999,6
1714643020731,EDS 115,A00,507243,Choi; Bailey Miyeon,10,0,28,18
1714643021782,EDS 117,A01,494379,Staff,0,4,30,30
1714643022807,EDS 125,A00,507246,Hopkins; Megan Beth,9,0,30,21
1714643023835,EDS 128A,A01,507264,Fargason; Sharon Gayle,8,0,26,18
1714643024861,EDS 128B,A01,507293,Pappas; Elizabeth,12,0,30,18
1714643025887,EDS 139,A00,507294,Fargason; Sharon Gayle,13,0,30,17
1714643025887,EDS 139,B00,507313,Pappas; Elizabeth,13,0,30,17
1714643026912,EDS 201,A00,507315,Staff,13,0,30,17
1714643027938,EDS 203,A01,507317,Halter; Christopher P.,12,0,30,18
1714643028967,EDS 204R,A01,507319,Halter; Christopher P.,0,3,30,30
1714643028967,EDS 204R,B01,507331,Heinzman; Erica M.,16,0,30,14
1714643029994,EDS 206R,A00,507332,Staff,0,4,30,30
1714643029994,EDS 206R,B00,507343,Staff,17,0,30,13
1714643031018,EDS 250,A00,507344,Hemans; Patricia Ann Benitez,22,0,40,18
1714643032044,EDS 281,A00,507345,Daly; Alan J.,18,0,18,0
1714643033071,EDS 284,A00,507350,Daly; Alan J.,16,0,16,0
1714643034096,EDS 286,A00,507359,Fine; Sarah,18,0,18,0
1714643035120,EDS 289C,A01,507361,Daly; Alan J.,18,0,18,0
1714643036147,EDS 290,A00,507366,Hofstetter; Carolyn,15,0,15,0
1714643037176,LIGM 5A,A00,507421,Fischer-Grunski; Eva K,18,0,20,2
1714643038204,LIGM 5B,A00,507423,Fischer-Grunski; Eva K,19,0,20,1
1714643039229,LIGM 5C,A00,507425,Fischer-Grunski; Eva K,19,0,20,1
1714643040255,LIIT 5AS,A00,507427,Carnelos; Chiara,20,0,20,0
1714643041280,LIIT 5BS,A00,507430,Carnelos; Chiara,20,0,20,0
1714643042309,LIIT 5CS,A00,507432,Carnelos; Chiara,20,0,20,0
1714643043336,LISP 5A,A00,507541,Munoz Sanchez; Alicia,11,0,20,9
1714643044359,LISP 5B,A00,507671,Munoz Sanchez; Alicia,8,0,20,12
1714643045385,LISP 5C,A00,507696,Munoz Sanchez; Alicia,9,0,20,11
1714643046409,MAE 197,001,528363,Boechler; Nicholas Sebastia,9998,0,9999,1
1714643047435,MATH 197,001,523477,Kedlaya; Kiran S.,9995,0,9999,4
1714643047435,MATH 197,002,563811,Zhang; Danna,9995,0,9999,4
1714643047435,MATH 197,003,628552,Dumitriu; Ioana,9998,0,9999,1
1714643048461,MCWP 40R,A00,518780,Staff,2,0,20,18
1714643048461,MCWP 40R,B00,518781,Staff,8,0,20,12
1714643048461,MCWP 40R,C00,518783,Staff,6,0,20,14
1714643049487,MCWP 50R,A00,518791,Staff,0,0,20,20
1714643049487,MCWP 50R,B00,518792,Staff,0,2,20,20
1714643049487,MCWP 50R,C00,518793,Staff,0,2,20,20
1714643049487,MCWP 50R,D00,518794,Staff,0,1,20,20
1714643049487,MCWP 50R,E00,518795,Staff,0,2,20,20
1714643049487,MCWP 50R,F00,518796,Staff,0,0,20,20
1714643049487,MCWP 50R,G00,518797,Staff,0,1,20,20
1714643050511,MMW 12R,A01,514034,Herbst; Matthew,0,0,16,16
1714643050511,MMW 12R,A02,514035,Herbst; Matthew,1,0,16,15
1714643051538,MMW 13R,A01,514037,Staff,0,4,16,16
1714643051538,MMW 13R,A02,514039,Staff,0,2,16,16
1714643051538,MMW 13R,A03,628519,Staff,0,2,16,16
1714643053588,SIO 295LS,A00,523233,Staff,10,0,30,20
1714643054612,SIO 295S,A00,523232,Staff,10,0,30,20
1714643055639,SIOC 290S,A01,637330,Merrifield; Mark A,23,0,30,7
1714643056662,SIOC 291S,A01,637333,Gabriel; Corey John,23,0,30,7
1714643057689,SOCI 117,A01,494376,Staff,0,4,5,5
1714643058718,WES 237B,A00,494380,Staff,9,0,20,11
1714643060791,AESE 279B,A00,494370,Wade; Jon P,0,0,33,33
1714643061819,AIP 197,001,627712,Vespa; Emanuel Ignacio,9998,0,9999,1
1714643062848,ANAR 135S,A00,494369,Braswell; Geoffrey E.,0,0,0,0
1714643063872,BENG 196,001,628496,Engler; Adam J.,9998,0,9999,1
1714643064899,CAT 124RS,A01,519847,Geibel; William,0,0,20,20
1714643065926,CAT 125RS,A01,515971,Geibel; William,0,0,20,20
1714643066951,CLRE 250,A00,511389,Morris; Sheldon,9993,0,9999,6
1714643067978,CLRE 251,A00,507176,Mehta; Ravindra L.,9993,0,9999,6
1714643067978,CLRE 251,B00,511410,Mehta; Ravindra L.,9998,0,9999,1
1714643069003,CLRE 252,A00,507189,Cuomo; Raphael Eduardo,9995,0,9999,4
1714643070029,CLRE 253,A00,507199,Vaida; Florin,9994,0,9999,5
1714643070029,CLRE 253,B00,507202,Vaida; Florin,9999,0,9999,0
1714643071055,CLRE 259,A00,507211,Patel; Hemal,9996,0,9999,3
1714643072080,CLRE 260,A00,507221,Cuomo; Raphael Eduardo,9999,0,9999,0
1714643073105,CLRE 297,001,507242,Cuomo; Raphael Eduardo,9999,0,9999,0
1714643074132,COGS 197,001,638244,Voytek; Bradley Thomas,9998,0,9999,1
1714643075159,CSE 191,A00,516875,Minnes Kemp; Mor Mia,9992,0,9999,7
1714643076187,CSE 197,001,637388,Minnes Kemp; Mor Mia,9998,0,9999,1
1714643077214,CSS 201S,A01,494383,Staff,35,0,35,0
1714643078244,CSS 202S,A01,494387,Staff,35,0,35,0
1714643079269,DSC 197,001,628532,Eldridge; Justin Matthew,9996,0,9999,3
1714643080295,EAP 100,A00,516065,Staff,9797,0,9999,202
1714643081321,ECE 45,A01,507414,Staff,33,0,60,27
1714643083374,ECE 111,A01,507420,Staff,15,0,50,35
1714643084401,ECE 197,001,548057,Sievenpiper; Daniel F.,9993,0,9999,6
1714643085432,EDS 115,A00,507243,Choi; Bailey Miyeon,10,0,28,18
1714643086459,EDS 117,A01,494379,Staff,0,4,30,30
1714643087484,EDS 125,A00,507246,Hopkins; Megan Beth,9,0,30,21
1714643088512,EDS 128A,A01,507264,Fargason; Sharon Gayle,8,0,26,18
1714643089536,EDS 128B,A01,507293,Pappas; Elizabeth,12,0,30,18
1714643090564,EDS 139,A00,507294,Fargason; Sharon Gayle,13,0,30,17
1714643090564,EDS 139,B00,507313,Pappas; Elizabeth,13,0,30,17
1714643091590,EDS 201,A00,507315,Staff,13,0,30,17
1714643092617,EDS 203,A01,507317,Halter; Christopher P.,12,0,30,18
1714643093643,EDS 204R,A01,507319,Halter; Christopher P.,0,3,30,30
1714643093643,EDS 204R,B01,507331,Heinzman; Erica M.,16,0,30,14
1714643094673,EDS 206R,A00,507332,Staff,0,4,30,30
1714643094673,EDS 206R,B00,507343,Staff,17,0,30,13
1714643095700,EDS 250,A00,507344,Hemans; Patricia Ann Benitez,22,0,40,18
1714643096727,EDS 281,A00,507345,Daly; Alan J.,18,0,18,0
1714643097751,EDS 284,A00,507350,Daly; Alan J.,16,0,16,0
1714643098778,EDS 286,A00,507359,Fine; Sarah,18,0,18,0
1714643099806,EDS 289C,A01,507361,Daly; Alan J.,18,0,18,0
1714643100835,EDS 290,A00,507366,Hofstetter; Carolyn,15,0,15,0
1714643101862,LIGM 5A,A00,507421,Fischer-Grunski; Eva K,18,0,20,2
1714643102887,LIGM 5B,A00,507423,Fischer-Grunski; Eva K,19,0,20,1
1714643103916,LIGM 5C,A00,507425,Fischer-Grunski; Eva K,19,0,20,1
1714643104942,LIIT 5AS,A00,507427,Carnelos; Chiara,20,0,20,0
1714643105969,LIIT 5BS,A00,507430,Carnelos; Chiara,20,0,20,0
1714643106992,LIIT 5CS,A00,507432,Carnelos; Chiara,20,0,20,0
1714643108017,LISP 5A,A00,507541,Munoz Sanchez; Alicia,11,0,20,9
1714643109046,LISP 5B,A00,507671,Munoz Sanchez; Alicia,8,0,20,12
1714643110077,LISP 5C,A00,507696,Munoz Sanchez; Alicia,9,0,20,11
1714643111103,MAE 197,001,528363,Boechler; Nicholas Sebastia,9998,0,9999,1
1714643112133,MATH 197,001,523477,Kedlaya; Kiran S.,9995,0,9999,4
1714643112133,MATH 197,002,563811,Zhang; Danna,9995,0,9999,4
1714643112133,MATH 197,003,628552,Dumitriu; Ioana,9998,0,9999,1
1714643113160,MCWP 40R,A00,518780,Staff,2,0,20,18
1714643113160,MCWP 40R,B00,518781,Staff,8,0,20,12
1714643113160,MCWP 40R,C00,518783,Staff,6,0,20,14
1714643114187,MCWP 50R,A00,518791,Staff,0,0,20,20
1714643114187,MCWP 50R,B00,518792,Staff,0,2,20,20
1714643114187,MCWP 50R,C00,518793,Staff,0,2,20,20
1714643114187,MCWP 50R,D00,518794,Staff,0,1,20,20
1714643114187,MCWP 50R,E00,518795,Staff,0,2,20,20
1714643114187,MCWP 50R,F00,518796,Staff,0,0,20,20
1714643114187,MCWP 50R,G00,518797,Staff,0,1,20,20
1714643115218,MMW 12R,A01,514034,Herbst; Matthew,0,0,16,16
1714643115218,MMW 12R,A02,514035,Herbst; Matthew,1,0,16,15
1714643116246,MMW 13R,A01,514037,Staff,0,4,16,16
1714643116246,MMW 13R,A02,514039,Staff,0,2,16,16
1714643116246,MMW 13R,A03,628519,Staff,0,2,16,16
1714643118298,SIO 295LS,A00,523233,Staff,10,0,30,20
1714643119325,SIO 295S,A00,523232,Staff,10,0,30,20
1714643120351,SIOC 290S,A01,637330,Merrifield; Mark A,23,0,30,7
1714643121377,SIOC 291S,A01,637333,Gabriel; Corey John,23,0,30,7
1714643122402,SOCI 117,A01,494376,Staff,0,4,5,5
1714643123430,WES 237B,A00,494380,Staff,9,0,20,11
1714643125508,AESE 279B,A00,494370,Wade; Jon P,0,0,33,33
1714643126533,AIP 197,001,627712,Vespa; Emanuel Ignacio,9998,0,9999,1
1714643127558,ANAR 135S,A00,494369,Braswell; Geoffrey E.,0,0,0,0
1714643128586,BENG 196,001,628496,Engler; Adam J.,9998,0,9999,1
1714643129617,CAT 124RS,A01,519847,Geibel; William,0,0,20,20
1714643130642,CAT 125RS,A01,515971,Geibel; William,0,0,20,20
1714643131666,CLRE 250,A00,511389,Morris; Sheldon,9993,0,9999,6
1714643132699,CLRE 251,A00,507176,Mehta; Ravindra L.,9993,0,9999,6
1714643132699,CLRE 251,B00,511410,Mehta; Ravindra L.,9998,0,9999,1
1714643133724,CLRE 252,A00,507189,Cuomo; Raphael Eduardo,9995,0,9999,4
1714643134753,CLRE 253,A00,507199,Vaida; Florin,9994,0,9999,5
1714643134753,CLRE 253,B00,507202,Vaida; Florin,9999,0,9999,0
1714643135781,CLRE 259,A00,507211,Patel; Hemal,9996,0,9999,3
1714643136808,CLRE 260,A00,507221,Cuomo; Raphael Eduardo,9999,0,9999,0
1714643137836,CLRE 297,001,507242,Cuomo; Raphael Eduardo,9999,0,9999,0
1714643138862,COGS 197,001,638244,Voytek; Bradley Thomas,9998,0,9999,1
1714643139890,CSE 191,A00,516875,Minnes Kemp; Mor Mia,9992,0,9999,7
1714643140916,CSE 197,001,637388,Minnes Kemp; Mor Mia,9998,0,9999,1
1714643141947,CSS 201S,A01,494383,Staff,35,0,35,0
1714643142975,CSS 202S,A01,494387,Staff,35,0,35,0
1714643144000,DSC 197,001,628532,Eldridge; Justin Matthew,9996,0,9999,3
1714643145024,EAP 100,A00,516065,Staff,9797,0,9999,202
1714643146055,ECE 45,A01,507414,Staff,33,0,60,27
1714643148110,ECE 111,A01,507420,Staff,15,0,50,35
1714643149141,ECE 197,001,548057,Sievenpiper; Daniel F.,9993,0,9999,6
1714643150165,EDS 115,A00,507243,Choi; Bailey Miyeon,10,0,28,18
1714643151190,EDS 117,A01,494379,Staff,0,4,30,30
1714643152221,EDS 125,A00,507246,Hopkins; Megan Beth,9,0,30,21
1714643153248,EDS 128A,A01,507264,Fargason; Sharon Gayle,8,0,26,18
1714643154273,EDS 128B,A01,507293,Pappas; Elizabeth,12,0,30,18
1714643155299,EDS 139,A00,507294,Fargason; Sharon Gayle,13,0,30,17
1714643155299,EDS 139,B00,507313,Pappas; Elizabeth,13,0,30,17
1714643156323,EDS 201,A00,507315,Staff,13,0,30,17
1714643157354,EDS 203,A01,507317,Halter; Christopher P.,12,0,30,18
1714643158382,EDS 204R,A01,507319,Halter; Christopher P.,0,3,30,30
1714643158382,EDS 204R,B01,507331,Heinzman; Erica M.,16,0,30,14
1714643159408,EDS 206R,A00,507332,Staff,0,4,30,30
1714643159408,EDS 206R,B00,507343,Staff,17,0,30,13
1714643160457,EDS 250,A00,507344,Hemans; Patricia Ann Benitez,22,0,40,18
1714643161481,EDS 281,A00,507345,Daly; Alan J.,18,0,18,0
1714643162504,EDS 284,A00,507350,Daly; Alan J.,16,0,16,0
1714643163529,EDS 286,A00,507359,Fine; Sarah,18,0,18,0
1714643164553,EDS 289C,A01,507361,Daly; Alan J.,18,0,18,0
1714643165581,EDS 290,A00,507366,Hofstetter; Carolyn,15,0,15,0
1714643166624,LIGM 5A,A00,507421,Fischer-Grunski; Eva K,18,0,20,2
1714643167649,LIGM 5B,A00,507423,Fischer-Grunski; Eva K,19,0,20,1
1714643168675,LIGM 5C,A00,507425,Fischer-Grunski; Eva K,19,0,20,1
1714643169699,LIIT 5AS,A00,507427,Carnelos; Chiara,20,0,20,0
1714643170726,LIIT 5BS,A00,507430,Carnelos; Chiara,20,0,20,0
1714643171754,LIIT 5CS,A00,507432,Carnelos; Chiara,20,0,20,0
1714643172784,LISP 5A,A00,507541,Munoz Sanchez; Alicia,11,0,20,9
1714643173808,LISP 5B,A00,507671,Munoz Sanchez; Alicia,8,0,20,12
1714643174833,LISP 5C,A00,507696,Munoz Sanchez; Alicia,9,0,20,11
1714643175858,MAE 197,001,528363,Boechler; Nicholas Sebastia,9998,0,9999,1
1714643176888,MATH 197,001,523477,Kedlaya; Kiran S.,9995,0,9999,4
1714643176888,MATH 197,002,563811,Zhang; Danna,9995,0,9999,4
1714643176888,MATH 197,003,628552,Dumitriu; Ioana,9998,0,9999,1
1714643177914,MCWP 40R,A00,518780,Staff,2,0,20,18
1714643177914,MCWP 40R,B00,518781,Staff,8,0,20,12
1714643177914,MCWP 40R,C00,518783,Staff,6,0,20,14
1714643178939,MCWP 50R,A00,518791,Staff,0,0,20,20
1714643178939,MCWP 50R,B00,518792,Staff,0,2,20,20
1714643178939,MCWP 50R,C00,518793,Staff,0,2,20,20
1714643178939,MCWP 50R,D00,518794,Staff,0,1,20,20
1714643178939,MCWP 50R,E00,518795,Staff,0,2,20,20
1714643178939,MCWP 50R,F00,518796,Staff,0,0,20,20
1714643178939,MCWP 50R,G00,518797,Staff,0,1,20,20
1714643179964,MMW 12R,A01,514034,Herbst; Matthew,0,0,16,16
1714643179964,MMW 12R,A02,514035,Herbst; Matthew,1,0,16,15
1714643180989,MMW 13R,A01,514037,Staff,0,4,16,16
1714643180989,MMW 13R,A02,514039,Staff,0,2,16,16
1714643180989,MMW 13R,A03,628519,Staff,0,2,16,16
1714643183044,SIO 295LS,A00,523233,Staff,10,0,30,20
1714643184073,SIO 295S,A00,523232,Staff,10,0,30,20
1714643185098,SIOC 290S,A01,637330,Merrifield; Mark A,23,0,30,7
1714643186129,SIOC 291S,A01,637333,Gabriel; Corey John,23,0,30,7
1714643187154,SOCI 117,A01,494376,Staff,0,4,5,5
1714643188179,WES 237B,A00,494380,Staff,9,0,20,11
1714643190267,AESE 279B,A00,494370,Wade; Jon P,0,0,33,33
1714643191292,AIP 197,001,627712,Vespa; Emanuel Ignacio,9998,0,9999,1
1714643192317,ANAR 135S,A00,494369,Braswell; Geoffrey E.,0,0,0,0
1714643193343,BENG 196,001,628496,Engler; Adam J.,9998,0,9999,1
1714643194370,CAT 124RS,A01,519847,Geibel; William,0,0,20,20
1714643195395,CAT 125RS,A01,515971,Geibel; William,0,0,20,20
1714643196421,CLRE 250,A00,511389,Morris; Sheldon,9993,0,9999,6
1714643197454,CLRE 251,A00,507176,Mehta; Ravindra L.,9993,0,9999,6
1714643197454,CLRE 251,B00,511410,Mehta; Ravindra L.,9998,0,9999,1
1714643198478,CLRE 252,A00,507189,Cuomo; Raphael Eduardo,9995,0,9999,4
1714643199507,CLRE 253,A00,507199,Vaida; Florin,9994,0,9999,5
1714643199507,CLRE 253,B00,507202,Vaida; Florin,9999,0,9999,0
1714643200535,CLRE 259,A00,507211,Patel; Hemal,9996,0,9999,3
1714643201562,CLRE 260,A00,507221,Cuomo; Raphael Eduardo,9999,0,9999,0
1714643202585,CLRE 297,001,507242,Cuomo; Raphael Eduardo,9999,0,9999,0
1714643203610,COGS 197,001,638244,Voytek; Bradley Thomas,9998,0,9999,1
1714643204640,CSE 191,A00,516875,Minnes Kemp; Mor Mia,9992,0,9999,7
1714643205665,CSE 197,001,637388,Minnes Kemp; Mor Mia,9998,0,9999,1
1714643206693,CSS 201S,A01,494383,Staff,35,0,35,0
1714643207718,CSS 202S,A01,494387,Staff,35,0,35,0
1714643208743,DSC 197,001,628532,Eldridge; Justin Matthew,9996,0,9999,3
1714643209770,EAP 100,A00,516065,Staff,9797,0,9999,202
1714643210795,ECE 45,A01,507414,Staff,33,0,60,27
1714643212843,ECE 111,A01,507420,Staff,15,0,50,35
1714643213870,ECE 197,001,548057,Sievenpiper; Daniel F.,9993,0,9999,6
1714643214899,EDS 115,A00,507243,Choi; Bailey Miyeon,10,0,28,18
1714643215928,EDS 117,A01,494379,Staff,0,4,30,30
1714643216956,EDS 125,A00,507246,Hopkins; Megan Beth,9,0,30,21
1714643217981,EDS 128A,A01,507264,Fargason; Sharon Gayle,8,0,26,18
1714643219007,EDS 128B,A01,507293,Pappas; Elizabeth,12,0,30,18
1714643220033,EDS 139,A00,507294,Fargason; Sharon Gayle,13,0,30,17
1714643220033,EDS 139,B00,507313,Pappas; Elizabeth,13,0,30,17
1714643221058,EDS 201,A00,507315,Staff,13,0,30,17
1714643222087,EDS 203,A01,507317,Halter; Christopher P.,12,0,30,18
1714643223121,EDS 204R,A01,507319,Halter; Christopher P.,0,3,30,30
1714643223121,EDS 204R,B01,507331,Heinzman; Erica M.,16,0,30,14
1714643224147,EDS 206R,A00,507332,Staff,0,4,30,30
1714643224147,EDS 206R,B00,507343,Staff,17,0,30,13
1714643225175,EDS 250,A00,507344,Hemans; Patricia Ann Benitez,22,0,40,18
1714643226202,EDS 281,A00,507345,Daly; Alan J.,18,0,18,0
1714643227230,EDS 284,A00,507350,Daly; Alan J.,16,0,16,0
1714643228259,EDS 286,A00,507359,Fine; Sarah,18,0,18,0
1714643229284,EDS 289C,A01,507361,Daly; Alan J.,18,0,18,0
1714643230311,EDS 290,A00,507366,Hofstetter; Carolyn,15,0,15,0
1714643231338,LIGM 5A,A00,507421,Fischer-Grunski; Eva K,18,0,20,2
1714643232368,LIGM 5B,A00,507423,Fischer-Grunski; Eva K,19,0,20,1
1714643233393,LIGM 5C,A00,507425,Fischer-Grunski; Eva K,19,0,20,1
1714643234422,LIIT 5AS,A00,507427,Carnelos; Chiara,20,0,20,0
1714643235447,LIIT 5BS,A00,507430,Carnelos; Chiara,20,0,20,0
1714643236474,LIIT 5CS,A00,507432,Carnelos; Chiara,20,0,20,0
1714643237506,LISP 5A,A00,507541,Munoz Sanchez; Alicia,11,0,20,9
1714643238532,LISP 5B,A00,507671,Munoz Sanchez; Alicia,8,0,20,12
1714643239561,LISP 5C,A00,507696,Munoz Sanchez; Alicia,9,0,20,11
1714643240586,MAE 197,001,528363,Boechler; Nicholas Sebastia,9998,0,9999,1
1714643241620,MATH 197,001,523477,Kedlaya; Kiran S.,9995,0,9999,4
1714643241620,MATH 197,002,563811,Zhang; Danna,9995,0,9999,4
1714643241620,MATH 197,003,628552,Dumitriu; Ioana,9998,0,9999,1
1714643242646,MCWP 40R,A00,518780,Staff,2,0,20,18
1714643242646,MCWP 40R,B00,518781,Staff,8,0,20,12
1714643242646,MCWP 40R,C00,518783,Staff,6,0,20,14
1714643243672,MCWP 50R,A00,518791,Staff,0,0,20,20
1714643243672,MCWP 50R,B00,518792,Staff,0,2,20,20
1714643243672,MCWP 50R,C00,518793,Staff,0,2,20,20
1714643243672,MCWP 50R,D00,518794,Staff,0,1,20,20
1714643243672,MCWP 50R,E00,518795,Staff,0,2,20,20
1714643243672,MCWP 50R,F00,518796,Staff,0,0,20,20
1714643243672,MCWP 50R,G00,518797,Staff,0,1,20,20
1714643244702,MMW 12R,A01,514034,Herbst; Matthew,0,0,16,16
1714643244702,MMW 12R,A02,514035,Herbst; Matthew,1,0,16,15
1714643245731,MMW 13R,A01,514037,Staff,0,4,16,16
1714643245731,MMW 13R,A02,514039,Staff,0,2,16,16
1714643245731,MMW 13R,A03,628519,Staff,0,2,16,16
1714643247787,SIO 295LS,A00,523233,Staff,10,0,30,20
1714643248816,SIO 295S,A00,523232,Staff,10,0,30,20
1714643249844,SIOC 290S,A01,637330,Merrifield; Mark A,23,0,30,7
1714643250874,SIOC 291S,A01,637333,Gabriel; Corey John,23,0,30,7
1714643251900,SOCI 117,A01,494376,Staff,0,4,5,5
1714643252926,WES 237B,A00,494380,Staff,9,0,20,11
1714643255000,AESE 279B,A00,494370,Wade; Jon P,0,0,33,33
1714643256030,AIP 197,001,627712,Vespa; Emanuel Ignacio,9998,0,9999,1
1714643257059,ANAR 135S,A00,494369,Braswell; Geoffrey E.,0,0,0,0
1714643258086,BENG 196,001,628496,Engler; Adam J.,9998,0,9999,1
1714643259115,CAT 124RS,A01,519847,Geibel; William,0,0,20,20
1714643260141,CAT 125RS,A01,515971,Geibel; William,0,0,20,20
1714643261170,CLRE 250,A00,511389,Morris; Sheldon,9993,0,9999,6
1714643262201,CLRE 251,A00,507176,Mehta; Ravindra L.,9993,0,9999,6
1714643262201,CLRE 251,B00,511410,Mehta; Ravindra L.,9998,0,9999,1
1714643263227,CLRE 252,A00,507189,Cuomo; Raphael Eduardo,9995,0,9999,4
1714643264255,CLRE 253,A00,507199,Vaida; Florin,9994,0,9999,5
1714643264255,CLRE 253,B00,507202,Vaida; Florin,9999,0,9999,0
1714643265282,CLRE 259,A00,507211,Patel; Hemal,9996,0,9999,3
1714643266307,CLRE 260,A00,507221,Cuomo; Raphael Eduardo,9999,0,9999,0
1714643267335,CLRE 297,001,507242,Cuomo; Raphael Eduardo,9999,0,9999,0
1714643268363,COGS 197,001,638244,Voytek; Bradley Thomas,9998,0,9999,1
1714643269393,CSE 191,A00,516875,Minnes Kemp; Mor Mia,9992,0,9999,7
1714643270422,CSE 197,001,637388,Minnes Kemp; Mor Mia,9998,0,9999,1
1714643271450,CSS 201S,A01,494383,Staff,35,0,35,0
1714643272477,CSS 202S,A01,494387,Staff,35,0,35,0
1714643273502,DSC 197,001,628532,Eldridge; Justin Matthew,9996,0,9999,3
1714643274530,EAP 100,A00,516065,Staff,9797,0,9999,202
1714643275558,ECE 45,A01,507414,Staff,33,0,60,27
1714643277608,ECE 111,A01,507420,Staff,15,0,50,35
1714643278633,ECE 197,001,548057,Sievenpiper; Daniel F.,9993,0,9999,6
1714643279661,EDS 115,A00,507243,Choi; Bailey Miyeon,10,0,28,18
1714643280687,EDS 117,A01,494379,Staff,0,4,30,30
1714643281711,EDS 125,A00,507246,Hopkins; Megan Beth,9,0,30,21
1714643282740,EDS 128A,A01,507264,Fargason; Sharon Gayle,8,0,26,18
1714643283766,EDS 128B,A01,507293,Pappas; Elizabeth,12,0,30,18
1714643284796,EDS 139,A00,507294,Fargason; Sharon Gayle,13,0,30,17
1714643284796,EDS 139,B00,507313,Pappas; Elizabeth,13,0,30,17
1714643285821,EDS 201,A00,507315,Staff,13,0,30,17
1714643286849,EDS 203,A01,507317,Halter; Christopher P.,12,0,30,18
1714643287876,EDS 204R,A01,507319,Halter; Christopher P.,0,3,30,30
1714643287876,EDS 204R,B01,507331,Heinzman; Erica M.,16,0,30,14
1714643288900,EDS 206R,A00,507332,Staff,0,4,30,30
1714643288900,EDS 206R,B00,507343,Staff,17,0,30,13
1714643289932,EDS 250,A00,507344,Hemans; Patricia Ann Benitez,22,0,40,18
1714643290959,EDS 281,A00,507345,Daly; Alan J.,18,0,18,0
1714643291986,EDS 284,A00,507350,Daly; Alan J.,16,0,16,0
1714643293011,EDS 286,A00,507359,Fine; Sarah,18,0,18,0
1714643294039,EDS 289C,A01,507361,Daly; Alan J.,18,0,18,0
1714643295066,EDS 290,A00,507366,Hofstetter; Carolyn,15,0,15,0
1714643296096,LIGM 5A,A00,507421,Fischer-Grunski; Eva K,18,0,20,2
1714643297124,LIGM 5B,A00,507423,Fischer-Grunski; Eva K,19,0,20,1
1714643298150,LIGM 5C,A00,507425,Fischer-Grunski; Eva K,19,0,20,1
1714643299179,LIIT 5AS,A00,507427,Carnelos; Chiara,20,0,20,0
1714643300205,LIIT 5BS,A00,507430,Carnelos; Chiara,20,0,20,0
1714643301229,LIIT 5CS,A00,507432,Carnelos; Chiara,20,0,20,0
1714643302257,LISP 5A,A00,507541,Munoz Sanchez; Alicia,11,0,20,9
1714643303285,LISP 5B,A00,507671,Munoz Sanchez; Alicia,8,0,20,12
1714643304315,LISP 5C,A00,507696,Munoz Sanchez; Alicia,9,0,20,11
1714643305347,MAE 197,001,528363,Boechler; Nicholas Sebastia,9998,0,9999,1
1714643306374,MATH 197,001,523477,Kedlaya; Kiran S.,9995,0,9999,4
1714643306374,MATH 197,002,563811,Zhang; Danna,9995,0,9999,4
1714643306374,MATH 197,003,628552,Dumitriu; Ioana,9998,0,9999,1
1714643307403,MCWP 40R,A00,518780,Staff,2,0,20,18
1714643307403,MCWP 40R,B00,518781,Staff,8,0,20,12
1714643307403,MCWP 40R,C00,518783,Staff,6,0,20,14
1714643308429,MCWP 50R,A00,518791,Staff,0,0,20,20
1714643308429,MCWP 50R,B00,518792,Staff,0,2,20,20
1714643308429,MCWP 50R,C00,518793,Staff,0,2,20,20
1714643308429,MCWP 50R,D00,518794,Staff,0,1,20,20
1714643308429,MCWP 50R,E00,518795,Staff,0,2,20,20
1714643308429,MCWP 50R,F00,518796,Staff,0,0,20,20
1714643308429,MCWP 50R,G00,518797,Staff,0,1,20,20
1714643309455,MMW 12R,A01,514034,Herbst; Matthew,0,0,16,16
1714643309455,MMW 12R,A02,514035,Herbst; Matthew,1,0,16,15
1714643310479,MMW 13R,A01,514037,Staff,0,4,16,16
1714643310479,MMW 13R,A02,514039,Staff,0,2,16,16
1714643310479,MMW 13R,A03,628519,Staff,0,2,16,16
1714643312534,SIO 295LS,A00,523233,Staff,10,0,30,20
1714643313559,SIO 295S,A00,523232,Staff,10,0,30,20
1714643314590,SIOC 290S,A01,637330,Merrifield; Mark A,23,0,30,7
1714643315614,SIOC 291S,A01,637333,Gabriel; Corey John,23,0,30,7
1714643316645,SOCI 117,A01,494376,Staff,0,4,5,5
1714643317671,WES 237B,A00,494380,Staff,9,0,20,11
1714643319757,AESE 279B,A00,494370,Wade; Jon P,0,0,33,33
1714643320784,AIP 197,001,627712,Vespa; Emanuel Ignacio,9998,0,9999,1
1714643321810,ANAR 135S,A00,494369,Braswell; Geoffrey E.,0,0,0,0
1714643322836,BENG 196,001,628496,Engler; Adam J.,9998,0,9999,1
1714643323876,CAT 124RS,A01,519847,Geibel; William,0,0,20,20
1714643324901,CAT 125RS,A01,515971,Geibel; William,0,0,20,20
1714643325928,CLRE 250,A00,511389,Morris; Sheldon,9993,0,9999,6
1714643326957,CLRE 251,A00,507176,Mehta; Ravindra L.,9993,0,9999,6
1714643326957,CLRE 251,B00,511410,Mehta; Ravindra L.,9998,0,9999,1
1714643327987,CLRE 252,A00,507189,Cuomo; Raphael Eduardo,9995,0,9999,4
1714643329015,CLRE 253,A00,507199,Vaida; Florin,9994,0,9999,5
1714643329015,CLRE 253,B00,507202,Vaida; Florin,9999,0,9999,0
1714643330040,CLRE 259,A00,507211,Patel; Hemal,9996,0,9999,3
1714643331066,CLRE 260,A00,507221,Cuomo; Raphael Eduardo,9999,0,9999,0
1714643332093,CLRE 297,001,507242,Cuomo; Raphael Eduardo,9999,0,9999,0
1714643333118,COGS 197,001,638244,Voytek; Bradley Thomas,9998,0,9999,1
1714643334146,CSE 191,A00,516875,Minnes Kemp; Mor Mia,9992,0,9999,7
1714643335171,CSE 197,001,637388,Minnes Kemp; Mor Mia,9998,0,9999,1
1714643336199,CSS 201S,A01,494383,Staff,35,0,35,0
1714643337225,CSS 202S,A01,494387,Staff,35,0,35,0
1714643338249,DSC 197,001,628532,Eldridge; Justin Matthew,9996,0,9999,3
1714643339276,EAP 100,A00,516065,Staff,9797,0,9999,202
1714643340308,ECE 45,A01,507414,Staff,33,0,60,27
1714643342359,ECE 111,A01,507420,Staff,15,0,50,35
1714643343389,ECE 197,001,548057,Sievenpiper; Daniel F.,9993,0,9999,6
1714643344413,EDS 115,A00,507243,Choi; Bailey Miyeon,10,0,28,18
1714643345444,EDS 117,A01,494379,Staff,0,4,30,30
1714643346474,EDS 125,A00,507246,Hopkins; Megan Beth,9,0,30,21
1714643347499,EDS 128A,A01,507264,Fargason; Sharon Gayle,8,0,26,18
1714643348525,EDS 128B,A01,507293,Pappas; Elizabeth,12,0,30,18
1714643349550,EDS 139,A00,507294,Fargason; Sharon Gayle,13,0,30,17
1714643349550,EDS 139,B00,507313,Pappas; Elizabeth,13,0,30,17
1714643350574,EDS 201,A00,507315,Staff,13,0,30,17
1714643351600,EDS 203,A01,507317,Halter; Christopher P.,12,0,30,18
1714643352631,EDS 204R,A01,507319,Halter; Christopher P.,0,3,30,30
1714643352631,EDS 204R,B01,507331,Heinzman; Erica M.,16,0,30,14
1714643353655,EDS 206R,A00,507332,Staff,0,4,30,30
1714643353655,EDS 206R,B00,507343,Staff,17,0,30,13
1714643354683,EDS 250,A00,507344,Hemans; Patricia Ann Benitez,22,0,40,18
1714643355709,EDS 281,A00,507345,Daly; Alan J.,18,0,18,0
1714643356733,EDS 284,A00,507350,Daly; Alan J.,16,0,16,0
1714643357759,EDS 286,A00,507359,Fine; Sarah,18,0,18,0
1714643358784,EDS 289C,A01,507361,Daly; Alan J.,18,0,18,0
1714643359811,EDS 290,A00,507366,Hofstetter; Carolyn,15,0,15,0
1714643360838,LIGM 5A,A00,507421,Fischer-Grunski; Eva K,18,0,20,2
1714643361865,LIGM 5B,A00,507423,Fischer-Grunski; Eva K,19,0,20,1
1714643362890,LIGM 5C,A00,507425,Fischer-Grunski; Eva K,19,0,20,1
1714643363916,LIIT 5AS,A00,507427,Carnelos; Chiara,20,0,20,0
1714643364939,LIIT 5BS,A00,507430,Carnelos; Chiara,20,0,20,0
1714643365967,LIIT 5CS,A00,507432,Carnelos; Chiara,20,0,20,0
1714643366998,LISP 5A,A00,507541,Munoz Sanchez; Alicia,11,0,20,9
1714643368022,LISP 5B,A00,507671,Munoz Sanchez; Alicia,8,0,20,12
1714643369047,LISP 5C,A00,507696,Munoz Sanchez; Alicia,9,0,20,11
1714643370073,MAE 197,001,528363,Boechler; Nicholas Sebastia,9998,0,9999,1
1714643371175,MATH 197,001,523477,Kedlaya; Kiran S.,9995,0,9999,4
1714643371175,MATH 197,002,563811,Zhang; Danna,9995,0,9999,4
1714643371175,MATH 197,003,628552,Dumitriu; Ioana,9998,0,9999,1
1714643372201,MCWP 40R,A00,518780,Staff,2,0,20,18
1714643372201,MCWP 40R,B00,518781,Staff,8,0,20,12
1714643372201,MCWP 40R,C00,518783,Staff,6,0,20,14
1714643373226,MCWP 50R,A00,518791,Staff,0,0,20,20
1714643373226,MCWP 50R,B00,518792,Staff,0,2,20,20
1714643373226,MCWP 50R,C00,518793,Staff,0,2,20,20
1714643373226,MCWP 50R,D00,518794,Staff,0,1,20,20
1714643373226,MCWP 50R,E00,518795,Staff,0,2,20,20
1714643373226,MCWP 50R,F00,518796,Staff,0,0,20,20
1714643373226,MCWP 50R,G00,518797,Staff,0,1,20,20
1714643374255,MMW 12R,A01,514034,Herbst; Matthew,0,0,16,16
1714643374255,MMW 12R,A02,514035,Herbst; Matthew,1,0,16,15
1714643375283,MMW 13R,A01,514037,Staff,0,4,16,16
1714643375283,MMW 13R,A02,514039,Staff,0,2,16,16
1714643375283,MMW 13R,A03,628519,Staff,0,2,16,16
1714643377336,SIO 295LS,A00,523233,Staff,10,0,30,20
1714643378364,SIO 295S,A00,523232,Staff,10,0,30,20
1714643379390,SIOC 290S,A01,637330,Merrifield; Mark A,23,0,30,7
1714643380416,SIOC 291S,A01,637333,Gabriel; Corey John,23,0,30,7
1714643381444,SOCI 117,A01,494376,Staff,0,4,5,5
1714643382473,WES 237B,A00,494380,Staff,9,0,20,11
1714643384545,AESE 279B,A00,494370,Wade; Jon P,0,0,33,33
1714643385571,AIP 197,001,627712,Vespa; Emanuel Ignacio,9998,0,9999,1
1714643386596,ANAR 135S,A00,494369,Braswell; Geoffrey E.,0,0,0,0
1714643387623,BENG 196,001,628496,Engler; Adam J.,9998,0,9999,1
1714643388649,CAT 124RS,A01,519847,Geibel; William,0,0,20,20
1714643389673,CAT 125RS,A01,515971,Geibel; William,0,0,20,20
1714643390698,CLRE 250,A00,511389,Morris; Sheldon,9993,0,9999,6
1714643391725,CLRE 251,A00,507176,Mehta; Ravindra L.,9993,0,9999,6
1714643391725,CLRE 251,B00,511410,Mehta; Ravindra L.,9998,0,9999,1
1714643392752,CLRE 252,A00,507189,Cuomo; Raphael Eduardo,9995,0,9999,4
1714643393784,CLRE 253,A00,507199,Vaida; Florin,9994,0,9999,5
1714643393784,CLRE 253,B00,507202,Vaida; Florin,9999,0,9999,0
1714643394811,CLRE 259,A00,507211,Patel; Hemal,9996,0,9999,3
1714643395837,CLRE 260,A00,507221,Cuomo; Raphael Eduardo,9999,0,9999,0
1714643396863,CLRE 297,001,507242,Cuomo; Raphael Eduardo,9999,0,9999,0
1714643397894,COGS 197,001,638244,Voytek; Bradley Thomas,9998,0,9999,1
1714643398922,CSE 191,A00,516875,Minnes Kemp; Mor Mia,9992,0,9999,7
1714643399948,CSE 197,001,637388,Minnes Kemp; Mor Mia,9998,0,9999,1
1714643400973,CSS 201S,A01,494383,Staff,35,0,35,0
1714643402000,CSS 202S,A01,494387,Staff,35,0,35,0
1714643403028,DSC 197,001,628532,Eldridge; Justin Matthew,9996,0,9999,3
1714643404052,EAP 100,A00,516065,Staff,9797,0,9999,202
1714643405081,ECE 45,A01,507414,Staff,33,0,60,27
1714643407136,ECE 111,A01,507420,Staff,15,0,50,35
1714643408160,ECE 197,001,548057,Sievenpiper; Daniel F.,9993,0,9999,6
1714643409185,EDS 115,A00,507243,Choi; Bailey Miyeon,10,0,28,18
1714643410216,EDS 117,A01,494379,Staff,0,4,30,30
1714643411246,EDS 125,A00,507246,Hopkins; Megan Beth,9,0,30,21
1714643412276,EDS 128A,A01,507264,Fargason; Sharon Gayle,8,0,26,18
1714643413302,EDS 128B,A01,507293,Pappas; Elizabeth,12,0,30,18
1714643414327,EDS 139,A00,507294,Fargason; Sharon Gayle,13,0,30,17
1714643414327,EDS 139,B00,507313,Pappas; Elizabeth,13,0,30,17
1714643415351,EDS 201,A00,507315,Staff,13,0,30,17
1714643416378,EDS 203,A01,507317,Halter; Christopher P.,12,0,30,18
1714643417406,EDS 204R,A01,507319,Halter; Christopher P.,0,3,30,30
1714643417406,EDS 204R,B01,507331,Heinzman; Erica M.,16,0,30,14
1714643418435,EDS 206R,A00,507332,Staff,0,4,30,30
1714643418435,EDS 206R,B00,507343,Staff,17,0,30,13
1714643419464,EDS 250,A00,507344,Hemans; Patricia Ann Benitez,22,0,40,18
1714643420493,EDS 281,A00,507345,Daly; Alan J.,18,0,18,0
1714643421519,EDS 284,A00,507350,Daly; Alan J.,16,0,16,0
1714643422545,EDS 286,A00,507359,Fine; Sarah,18,0,18,0
1714643423573,EDS 289C,A01,507361,Daly; Alan J.,18,0,18,0
1714643424600,EDS 290,A00,507366,Hofstetter; Carolyn,15,0,15,0
1714643425627,LIGM 5A,A00,507421,Fischer-Grunski; Eva K,18,0,20,2
1714643426651,LIGM 5B,A00,507423,Fischer-Grunski; Eva K,19,0,20,1
1714643427676,LIGM 5C,A00,507425,Fischer-Grunski; Eva K,19,0,20,1
1714643428701,LIIT 5AS,A00,507427,Carnelos; Chiara,20,0,20,0
1714643429729,LIIT 5BS,A00,507430,Carnelos; Chiara,20,0,20,0
1714643430755,LIIT 5CS,A00,507432,Carnelos; Chiara,20,0,20,0
1714643431786,LISP 5A,A00,507541,Munoz Sanchez; Alicia,11,0,20,9
1714643432814,LISP 5B,A00,507671,Munoz Sanchez; Alicia,8,0,20,12
1714643433841,LISP 5C,A00,507696,Munoz Sanchez; Alicia,9,0,20,11
1714643434867,MAE 197,001,528363,Boechler; Nicholas Sebastia,9998,0,9999,1
1714643435893,MATH 197,001,523477,Kedlaya; Kiran S.,9995,0,9999,4
1714643435893,MATH 197,002,563811,Zhang; Danna,9995,0,9999,4
1714643435893,MATH 197,003,628552,Dumitriu; Ioana,9998,0,9999,1
1714643436919,MCWP 40R,A00,518780,Staff,2,0,20,18
1714643436919,MCWP 40R,B00,518781,Staff,8,0,20,12
1714643436919,MCWP 40R,C00,518783,Staff,6,0,20,14
1714643437945,MCWP 50R,A00,518791,Staff,0,0,20,20
1714643437945,MCWP 50R,B00,518792,Staff,0,2,20,20
1714643437945,MCWP 50R,C00,518793,Staff,0,2,20,20
1714643437945,MCWP 50R,D00,518794,Staff,0,1,20,20
1714643437945,MCWP 50R,E00,518795,Staff,0,2,20,20
1714643437945,MCWP 50R,F00,518796,Staff,0,0,20,20
1714643437945,MCWP 50R,G00,518797,Staff,0,1,20,20
1714643438970,MMW 12R,A01,514034,Herbst; Matthew,0,0,16,16
1714643438970,MMW 12R,A02,514035,Herbst; Matthew,1,0,16,15
1714643439995,MMW 13R,A01,514037,Staff,0,4,16,16
1714643439995,MMW 13R,A02,514039,Staff,0,2,16,16
1714643439995,MMW 13R,A03,628519,Staff,0,2,16,16
1714643442046,SIO 295LS,A00,523233,Staff,10,0,30,20
1714643443073,SIO 295S,A00,523232,Staff,10,0,30,20
1714643444103,SIOC 290S,A01,637330,Merrifield; Mark A,23,0,30,7
1714643445133,SIOC 291S,A01,637333,Gabriel; Corey John,23,0,30,7
1714643446162,SOCI 117,A01,494376,Staff,0,4,5,5
1714643447187,WES 237B,A00,494380,Staff,9,0,20,11
1714643449264,AESE 279B,A00,494370,Wade; Jon P,0,0,33,33
1714643450290,AIP 197,001,627712,Vespa; Emanuel Ignacio,9998,0,9999,1
1714643451317,ANAR 135S,A00,494369,Braswell; Geoffrey E.,0,0,0,0
1714643452343,BENG 196,001,628496,Engler; Adam J.,9998,0,9999,1
1714643453371,CAT 124RS,A01,519847,Geibel; William,0,0,20,20
1714643454396,CAT 125RS,A01,515971,Geibel; William,0,0,20,20
1714643455423,CLRE 250,A00,511389,Morris; Sheldon,9993,0,9999,6
1714643456449,CLRE 251,A00,507176,Mehta; Ravindra L.,9993,0,9999,6
1714643456449,CLRE 251,B00,511410,Mehta; Ravindra L.,9998,0,9999,1
1714643457475,CLRE 252,A00,507189,Cuomo; Raphael Eduardo,9995,0,9999,4
1714643458501,CLRE 253,A00,507199,Vaida; Florin,9994,0,9999,5
1714643458501,CLRE 253,B00,507202,Vaida; Florin,9999,0,9999,0
1714643459527,CLRE 259,A00,507211,Patel; Hemal,9996,0,9999,3
1714643460551,CLRE 260,A00,507221,Cuomo; Raphael Eduardo,9999,0,9999,0
1714643461574,CLRE 297,001,507242,Cuomo; Raphael Eduardo,9999,0,9999,0
1714643462602,COGS 197,001,638244,Voytek; Bradley Thomas,9998,0,9999,1
1714643463627,CSE 191,A00,516875,Minnes Kemp; Mor Mia,9992,0,9999,7
1714643464654,CSE 197,001,637388,Minnes Kemp; Mor Mia,9998,0,9999,1
1714643465702,CSS 201S,A01,494383,Staff,35,0,35,0
1714643466727,CSS 202S,A01,494387,Staff,35,0,35,0
1714643467752,DSC 197,001,628532,Eldridge; Justin Matthew,9996,0,9999,3
1714643468776,EAP 100,A00,516065,Staff,9797,0,9999,202
1714643469803,ECE 45,A01,507414,Staff,33,0,60,27
1714643471856,ECE 111,A01,507420,Staff,15,0,50,35
1714643472880,ECE 197,001,548057,Sievenpiper; Daniel F.,9993,0,9999,6
1714643473906,EDS 115,A00,507243,Choi; Bailey Miyeon,10,0,28,18
1714643474935,EDS 117,A01,494379,Staff,0,4,30,30
1714643475961,EDS 125,A00,507246,Hopkins; Megan Beth,9,0,30,21
1714643476989,EDS 128A,A01,507264,Fargason; Sharon Gayle,8,0,26,18
1714643478017,EDS 128B,A01,507293,Pappas; Elizabeth,12,0,30,18
1714643479045,EDS 139,A00,507294,Fargason; Sharon Gayle,13,0,30,17
1714643479045,EDS 139,B00,507313,Pappas; Elizabeth,13,0,30,17
1714643480071,EDS 201,A00,507315,Staff,13,0,30,17
1714643481099,EDS 203,A01,507317,Halter; Christopher P.,12,0,30,18
1714643482129,EDS 204R,A01,507319,Halter; Christopher P.,0,3,30,30
1714643482129,EDS 204R,B01,507331,Heinzman; Erica M.,16,0,30,14
1714643483153,EDS 206R,A00,507332,Staff,0,4,30,30
1714643483153,EDS 206R,B00,507343,Staff,17,0,30,13
1714643484181,EDS 250,A00,507344,Hemans; Patricia Ann Benitez,22,0,40,18
1714643485207,EDS 281,A00,507345,Daly; Alan J.,18,0,18,0
1714643486231,EDS 284,A00,507350,Daly; Alan J.,16,0,16,0
1714643487262,EDS 286,A00,507359,Fine; Sarah,18,0,18,0
1714643488287,EDS 289C,A01,507361,Daly; Alan J.,18,0,18,0
1714643489312,EDS 290,A00,507366,Hofstetter; Carolyn,15,0,15,0
1714643490345,LIGM 5A,A00,507421,Fischer-Grunski; Eva K,18,0,20,2
1714643491368,LIGM 5B,A00,507423,Fischer-Grunski; Eva K,19,0,20,1
1714643492393,LIGM 5C,A00,507425,Fischer-Grunski; Eva K,19,0,20,1
1714643493419,LIIT 5AS,A00,507427,Carnelos; Chiara,20,0,20,0
1714643494447,LIIT 5BS,A00,507430,Carnelos; Chiara,20,0,20,0
1714643495475,LIIT 5CS,A00,507432,Carnelos; Chiara,20,0,20,0
1714643496499,LISP 5A,A00,507541,Munoz Sanchez; Alicia,11,0,20,9
1714643497522,LISP 5B,A00,507671,Munoz Sanchez; Alicia,8,0,20,12
1714643498547,LISP 5C,A00,507696,Munoz Sanchez; Alicia,9,0,20,11
1714643499573,MAE 197,001,528363,Boechler; Nicholas Sebastia,9998,0,9999,1
1714643500600,MATH 197,001,523477,Kedlaya; Kiran S.,9995,0,9999,4
1714643500600,MATH 197,002,563811,Zhang; Danna,9995,0,9999,4
1714643500600,MATH 197,003,628552,Dumitriu; Ioana,9998,0,9999,1
1714643501629,MCWP 40R,A00,518780,Staff,2,0,20,18
1714643501629,MCWP 40R,B00,518781,Staff,8,0,20,12
1714643501629,MCWP 40R,C00,518783,Staff,6,0,20,14
1714643502653,MCWP 50R,A00,518791,Staff,0,0,20,20
1714643502653,MCWP 50R,B00,518792,Staff,0,2,20,20
1714643502653,MCWP 50R,C00,518793,Staff,0,2,20,20
1714643502653,MCWP 50R,D00,518794,Staff,0,1,20,20
1714643502653,MCWP 50R,E00,518795,Staff,0,2,20,20
1714643502653,MCWP 50R,F00,518796,Staff,0,0,20,20
1714643502653,MCWP 50R,G00,518797,Staff,0,1,20,20
1714643503681,MMW 12R,A01,514034,Herbst; Matthew,0,0,16,16
1714643503681,MMW 12R,A02,514035,Herbst; Matthew,1,0,16,15
1714643504711,MMW 13R,A01,514037,Staff,0,4,16,16
1714643504711,MMW 13R,A02,514039,Staff,0,2,16,16
1714643504711,MMW 13R,A03,628519,Staff,0,2,16,16
1714643506764,SIO 295LS,A00,523233,Staff,10,0,30,20
1714643507792,SIO 295S,A00,523232,Staff,10,0,30,20
1714643508819,SIOC 290S,A01,637330,Merrifield; Mark A,23,0,30,7
1714643509848,SIOC 291S,A01,637333,Gabriel; Corey John,23,0,30,7
1714643510874,SOCI 117,A01,494376,Staff,0,4,5,5
1714643511901,WES 237B,A00,494380,Staff,9,0,20,11
1714643513964,AESE 279B,A00,494370,Wade; Jon P,0,0,33,33
1714643514988,AIP 197,001,627712,Vespa; Emanuel Ignacio,9998,0,9999,1
1714643516018,ANAR 135S,A00,494369,Braswell; Geoffrey E.,0,0,0,0
1714643517049,BENG 196,001,628496,Engler; Adam J.,9998,0,9999,1
1714643518076,CAT 124RS,A01,519847,Geibel; William,0,0,20,20
1714643519100,CAT 125RS,A01,515971,Geibel; William,0,0,20,20
1714643520132,CLRE 250,A00,511389,Morris; Sheldon,9993,0,9999,6
1714643521161,CLRE 251,A00,507176,Mehta; Ravindra L.,9993,0,9999,6
1714643521161,CLRE 251,B00,511410,Mehta; Ravindra L.,9998,0,9999,1
1714643522188,CLRE 252,A00,507189,Cuomo; Raphael Eduardo,9995,0,9999,4
1714643523215,CLRE 253,A00,507199,Vaida; Florin,9994,0,9999,5
1714643523215,CLRE 253,B00,507202,Vaida; Florin,9999,0,9999,0
1714643524241,CLRE 259,A00,507211,Patel; Hemal,9996,0,9999,3
1714643525264,CLRE 260,A00,507221,Cuomo; Raphael Eduardo,9999,0,9999,0
1714643526292,CLRE 297,001,507242,Cuomo; Raphael Eduardo,9999,0,9999,0
1714643527318,COGS 197,001,638244,Voytek; Bradley Thomas,9998,0,9999,1
1714643528344,CSE 191,A00,516875,Minnes Kemp; Mor Mia,9992,0,9999,7
1714643529369,CSE 197,001,637388,Minnes Kemp; Mor Mia,9998,0,9999,1
1714643530395,CSS 201S,A01,494383,Staff,35,0,35,0
1714643531423,CSS 202S,A01,494387,Staff,35,0,35,0
1714643532448,DSC 197,001,628532,Eldridge; Justin Matthew,9996,0,9999,3
1714643533473,EAP 100,A00,516065,Staff,9797,0,9999,202
1714643534504,ECE 45,A01,507414,Staff,33,0,60,27
1714643536558,ECE 111,A01,507420,Staff,15,0,50,35
1714643537583,ECE 197,001,548057,Sievenpiper; Daniel F.,9993,0,9999,6
1714643538608,EDS 115,A00,507243,Choi; Bailey Miyeon,10,0,28,18
1714643539637,EDS 117,A01,494379,Staff,0,4,30,30
1714643540661,EDS 125,A00,507246,Hopkins; Megan Beth,9,0,30,21
1714643541686,EDS 128A,A01,507264,Fargason; Sharon Gayle,8,0,26,18
1714643542715,EDS 128B,A01,507293,Pappas; Elizabeth,12,0,30,18
1714643543741,EDS 139,A00,507294,Fargason; Sharon Gayle,13,0,30,17
1714643543741,EDS 139,B00,507313,Pappas; Elizabeth,13,0,30,17
1714643544767,EDS 201,A00,507315,Staff,13,0,30,17
1714643545793,EDS 203,A01,507317,Halter; Christopher P.,12,0,30,18
1714643546822,EDS 204R,A01,507319,Halter; Christopher P.,0,3,30,30
1714643546822,EDS 204R,B01,507331,Heinzman; Erica M.,16,0,30,14
1714643547847,EDS 206R,A00,507332,Staff,0,4,30,30
1714643547847,EDS 206R,B00,507343,Staff,17,0,30,13
1714643548877,EDS 250,A00,507344,Hemans; Patricia Ann Benitez,22,0,40,18
1714643549902,EDS 281,A00,507345,Daly; Alan J.,18,0,18,0
1714643550931,EDS 284,A00,507350,Daly; Alan J.,16,0,16,0
1714643551961,EDS 286,A00,507359,Fine; Sarah,18,0,18,0
1714643552987,EDS 289C,A01,507361,Daly; Alan J.,18,0,18,0
1714643554010,EDS 290,A00,507366,Hofstetter; Carolyn,15,0,15,0
1714643555042,LIGM 5A,A00,507421,Fischer-Grunski; Eva K,18,0,20,2
1714643556068,LIGM 5B,A00,507423,Fischer-Grunski; Eva K,19,0,20,1
1714643557092,LIGM 5C,A00,507425,Fischer-Grunski; Eva K,19,0,20,1
1714643558123,LIIT 5AS,A00,507427,Carnelos; Chiara,20,0,20,0
1714643559154,LIIT 5BS,A00,507430,Carnelos; Chiara,20,0,20,0
1714643560178,LIIT 5CS,A00,507432,Carnelos; Chiara,20,0,20,0
1714643561205,LISP 5A,A00,507541,Munoz Sanchez; Alicia,11,0,20,9
1714643562230,LISP 5B,A00,507671,Munoz Sanchez; Alicia,8,0,20,12
1714643563258,LISP 5C,A00,507696,Munoz Sanchez; Alicia,9,0,20,11
1714643564285,MAE 197,001,528363,Boechler; Nicholas Sebastia,9998,0,9999,1
1714643565317,MATH 197,001,523477,Kedlaya; Kiran S.,9995,0,9999,4
1714643565317,MATH 197,002,563811,Zhang; Danna,9995,0,9999,4
1714643565317,MATH 197,003,628552,Dumitriu; Ioana,9998,0,9999,1
1714643566342,MCWP 40R,A00,518780,Staff,2,0,20,18
1714643566342,MCWP 40R,B00,518781,Staff,8,0,20,12
1714643566342,MCWP 40R,C00,518783,Staff,6,0,20,14
1714643567367,MCWP 50R,A00,518791,Staff,0,0,20,20
1714643567367,MCWP 50R,B00,518792,Staff,0,2,20,20
1714643567367,MCWP 50R,C00,518793,Staff,0,2,20,20
1714643567367,MCWP 50R,D00,518794,Staff,0,1,20,20
1714643567367,MCWP 50R,E00,518795,Staff,0,2,20,20
1714643567367,MCWP 50R,F00,518796,Staff,0,0,20,20
1714643567367,MCWP 50R,G00,518797,Staff,0,1,20,20
1714643568394,MMW 12R,A01,514034,Herbst; Matthew,0,0,16,16
1714643568394,MMW 12R,A02,514035,Herbst; Matthew,1,0,16,15
1714643569422,MMW 13R,A01,514037,Staff,0,4,16,16
1714643569422,MMW 13R,A02,514039,Staff,0,2,16,16
1714643569422,MMW 13R,A03,628519,Staff,0,2,16,16
1714643571474,SIO 295LS,A00,523233,Staff,10,0,30,20
1714643572501,SIO 295S,A00,523232,Staff,10,0,30,20
1714643573527,SIOC 290S,A01,637330,Merrifield; Mark A,23,0,30,7
1714643574553,SIOC 291S,A01,637333,Gabriel; Corey John,23,0,30,7
1714643575577,SOCI 117,A01,494376,Staff,0,4,5,5
1714643576601,WES 237B,A00,494380,Staff,9,0,20,11
1714643578677,AESE 279B,A00,494370,Wade; Jon P,0,0,33,33
1714643579701,AIP 197,001,627712,Vespa; Emanuel Ignacio,9998,0,9999,1
1714643580731,ANAR 135S,A00,494369,Braswell; Geoffrey E.,0,0,0,0
1714643581758,BENG 196,001,628496,Engler; Adam J.,9998,0,9999,1
1714643582784,CAT 124RS,A01,519847,Geibel; William,0,0,20,20
1714643583808,CAT 125RS,A01,515971,Geibel; William,0,0,20,20
1714643584833,CLRE 250,A00,511389,Morris; Sheldon,9993,0,9999,6
1714643585866,CLRE 251,A00,507176,Mehta; Ravindra L.,9993,0,9999,6
1714643585866,CLRE 251,B00,511410,Mehta; Ravindra L.,9998,0,9999,1
1714643586891,CLRE 252,A00,507189,Cuomo; Raphael Eduardo,9995,0,9999,4
1714643587917,CLRE 253,A00,507199,Vaida; Florin,9994,0,9999,5
1714643587917,CLRE 253,B00,507202,Vaida; Florin,9999,0,9999,0
1714643588945,CLRE 259,A00,507211,Patel; Hemal,9996,0,9999,3
1714643589970,CLRE 260,A00,507221,Cuomo; Raphael Eduardo,9999,0,9999,0
1714643590996,CLRE 297,001,507242,Cuomo; Raphael Eduardo,9999,0,9999,0
1714643592021,COGS 197,001,638244,Voytek; Bradley Thomas,9998,0,9999,1
1714643593050,CSE 191,A00,516875,Minnes Kemp; Mor Mia,9992,0,9999,7
1714643594078,CSE 197,001,637388,Minnes Kemp; Mor Mia,9998,0,9999,1
1714643595104,CSS 201S,A01,494383,Staff,35,0,35,0
1714643596130,CSS 202S,A01,494387,Staff,35,0,35,0
1714643597153,DSC 197,001,628532,Eldridge; Justin Matthew,9996,0,9999,3
1714643598179,EAP 100,A00,516065,Staff,9797,0,9999,202
1714643599205,ECE 45,A01,507414,Staff,33,0,60,27
1714643601257,ECE 111,A01,507420,Staff,15,0,50,35
1714643602282,ECE 197,001,548057,Sievenpiper; Daniel F.,9993,0,9999,6
1714643603312,EDS 115,A00,507243,Choi; Bailey Miyeon,10,0,28,18
1714643604339,EDS 117,A01,494379,Staff,0,4,30,30
1714643605362,EDS 125,A00,507246,Hopkins; Megan Beth,9,0,30,21
1714643606389,EDS 128A,A01,507264,Fargason; Sharon Gayle,8,0,26,18
1714643607414,EDS 128B,A01,507293,Pappas; Elizabeth,12,0,30,18
1714643608438,EDS 139,A00,507294,Fargason; Sharon Gayle,13,0,30,17
1714643608438,EDS 139,B00,507313,Pappas; Elizabeth,13,0,30,17
1714643609463,EDS 201,A00,507315,Staff,13,0,30,17
1714643610490,EDS 203,A01,507317,Halter; Christopher P.,12,0,30,18
1714643611517,EDS 204R,A01,507319,Halter; Christopher P.,0,3,30,30
1714643611517,EDS 204R,B01,507331,Heinzman; Erica M.,16,0,30,14
1714643612540,EDS 206R,A00,507332,Staff,0,4,30,30
1714643612540,EDS 206R,B00,507343,Staff,17,0,30,13
1714643613566,EDS 250,A00,507344,Hemans; Patricia Ann Benitez,22,0,40,18
1714643614593,EDS 281,A00,507345,Daly; Alan J.,18,0,18,0
1714643615620,EDS 284,A00,507350,Daly; Alan J.,16,0,16,0
1714643616649,EDS 286,A00,507359,Fine; Sarah,18,0,18,0
1714643617673,EDS 289C,A01,507361,Daly; Alan J.,18,0,18,0
1714643618698,EDS 290,A00,507366,Hofstetter; Carolyn,15,0,15,0
1714643619728,LIGM 5A,A00,507421,Fischer-Grunski; Eva K,18,0,20,2
1714643620753,LIGM 5B,A00,507423,Fischer-Grunski; Eva K,19,0,20,1
1714643621780,LIGM 5C,A00,507425,Fischer-Grunski; Eva K,19,0,20,1
1714643622810,LIIT 5AS,A00,507427,Carnelos; Chiara,20,0,20,0
1714643623835,LIIT 5BS,A00,507430,Carnelos; Chiara,20,0,20,0
1714643624860,LIIT 5CS,A00,507432,Carnelos; Chiara,20,0,20,0
1714643625889,LISP 5A,A00,507541,Munoz Sanchez; Alicia,11,0,20,9
1714643626918,LISP 5B,A00,507671,Munoz Sanchez; Alicia,8,0,20,12
1714643627941,LISP 5C,A00,507696,Munoz Sanchez; Alicia,9,0,20,11
1714643628972,MAE 197,001,528363,Boechler; Nicholas Sebastia,9998,0,9999,1
1714643630000,MATH 197,001,523477,Kedlaya; Kiran S.,9995,0,9999,4
1714643630000,MATH 197,002,563811,Zhang; Danna,9995,0,9999,4
1714643630000,MATH 197,003,628552,Dumitriu; Ioana,9998,0,9999,1
1714643631026,MCWP 40R,A00,518780,Staff,2,0,20,18
1714643631026,MCWP 40R,B00,518781,Staff,8,0,20,12
1714643631026,MCWP 40R,C00,518783,Staff,6,0,20,14
1714643632057,MCWP 50R,A00,518791,Staff,0,0,20,20
1714643632057,MCWP 50R,B00,518792,Staff,0,2,20,20
1714643632057,MCWP 50R,C00,518793,Staff,0,2,20,20
1714643632057,MCWP 50R,D00,518794,Staff,0,1,20,20
1714643632057,MCWP 50R,E00,518795,Staff,0,2,20,20
1714643632057,MCWP 50R,F00,518796,Staff,0,0,20,20
1714643632057,MCWP 50R,G00,518797,Staff,0,1,20,20
1714643633084,MMW 12R,A01,514034,Herbst; Matthew,0,0,16,16
1714643633084,MMW 12R,A02,514035,Herbst; Matthew,1,0,16,15
1714643634108,MMW 13R,A01,514037,Staff,0,4,16,16
1714643634108,MMW 13R,A02,514039,Staff,0,2,16,16
1714643634108,MMW 13R,A03,628519,Staff,0,2,16,16
1714643636160,SIO 295LS,A00,523233,Staff,10,0,30,20
1714643637186,SIO 295S,A00,523232,Staff,10,0,30,20
1714643638214,SIOC 290S,A01,637330,Merrifield; Mark A,23,0,30,7
1714643639240,SIOC 291S,A01,637333,Gabriel; Corey John,23,0,30,7
1714643640269,SOCI 117,A01,494376,Staff,0,4,5,5
1714643641295,WES 237B,A00,494380,Staff,9,0,20,11
1714643643391,AESE 279B,A00,494370,Wade; Jon P,0,0,33,33
1714643644417,AIP 197,001,627712,Vespa; Emanuel Ignacio,9998,0,9999,1
1714643645442,ANAR 135S,A00,494369,Braswell; Geoffrey E.,0,0,0,0
1714643646468,BENG 196,001,628496,Engler; Adam J.,9998,0,9999,1
1714643647496,CAT 124RS,A01,519847,Geibel; William,0,0,20,20
1714643648522,CAT 125RS,A01,515971,Geibel; William,0,0,20,20
1714643649546,CLRE 250,A00,511389,Morris; Sheldon,9993,0,9999,6
1714643650572,CLRE 251,A00,507176,Mehta; Ravindra L.,9993,0,9999,6
1714643650572,CLRE 251,B00,511410,Mehta; Ravindra L.,9998,0,9999,1
1714643651598,CLRE 252,A00,507189,Cuomo; Raphael Eduardo,9995,0,9999,4
1714643652622,CLRE 253,A00,507199,Vaida; Florin,9994,0,9999,5
1714643652622,CLRE 253,B00,507202,Vaida; Florin,9999,0,9999,0
1714643653647,CLRE 259,A00,507211,Patel; Hemal,9996,0,9999,3
1714643654674,CLRE 260,A00,507221,Cuomo; Raphael Eduardo,9999,0,9999,0
1714643655702,CLRE 297,001,507242,Cuomo; Raphael Eduardo,9999,0,9999,0
1714643656739,COGS 197,001,638244,Voytek; Bradley Thomas,9998,0,9999,1
1714643657765,CSE 191,A00,516875,Minnes Kemp; Mor Mia,9992,0,9999,7
1714643658792,CSE 197,001,637388,Minnes Kemp; Mor Mia,9998,0,9999,1
1714643659821,CSS 201S,A01,494383,Staff,35,0,35,0
1714643660847,CSS 202S,A01,494387,Staff,35,0,35,0
1714643661874,DSC 197,001,628532,Eldridge; Justin Matthew,9996,0,9999,3
1714643662899,EAP 100,A00,516065,Staff,9797,0,9999,202
1714643663925,ECE 45,A01,507414,Staff,33,0,60,27
1714643665978,ECE 111,A01,507420,Staff,15,0,50,35
1714643667005,ECE 197,001,548057,Sievenpiper; Daniel F.,9993,0,9999,6
1714643668030,EDS 115,A00,507243,Choi; Bailey Miyeon,10,0,28,18
1714643669055,EDS 117,A01,494379,Staff,0,4,30,30
1714643670082,EDS 125,A00,507246,Hopkins; Megan Beth,9,0,30,21
1714643671106,EDS 128A,A01,507264,Fargason; Sharon Gayle,8,0,26,18
1714643672134,EDS 128B,A01,507293,Pappas; Elizabeth,12,0,30,18
1714643673162,EDS 139,A00,507294,Fargason; Sharon Gayle,13,0,30,17
1714643673162,EDS 139,B00,507313,Pappas; Elizabeth,13,0,30,17
1714643674186,EDS 201,A00,507315,Staff,13,0,30,17
1714643675210,EDS 203,A01,507317,Halter; Christopher P.,12,0,30,18
1714643676239,EDS 204R,A01,507319,Halter; Christopher P.,0,3,30,30
1714643676239,EDS 204R,B01,507331,Heinzman; Erica M.,16,0,30,14
1714643677262,EDS 206R,A00,507332,Staff,0,4,30,30
1714643677262,EDS 206R,B00,507343,Staff,17,0,30,13
1714643678292,EDS 250,A00,507344,Hemans; Patricia Ann Benitez,22,0,40,18
1714643679320,EDS 281,A00,507345,Daly; Alan J.,18,0,18,0
1714643680345,EDS 284,A00,507350,Daly; Alan J.,16,0,16,0
1714643681370,EDS 286,A00,507359,Fine; Sarah,18,0,18,0
1714643682398,EDS 289C,A01,507361,Daly; Alan J.,18,0,18,0
1714643683426,EDS 290,A00,507366,Hofstetter; Carolyn,15,0,15,0
1714643684451,LIGM 5A,A00,507421,Fischer-Grunski; Eva K,18,0,20,2
1714643685478,LIGM 5B,A00,507423,Fischer-Grunski; Eva K,19,0,20,1
1714643686506,LIGM 5C,A00,507425,Fischer-Grunski; Eva K,19,0,20,1
1714643687536,LIIT 5AS,A00,507427,Carnelos; Chiara,20,0,20,0
1714643688561,LIIT 5BS,A00,507430,Carnelos; Chiara,20,0,20,0
1714643689584,LIIT 5CS,A00,507432,Carnelos; Chiara,20,0,20,0
1714643690610,LISP 5A,A00,507541,Munoz Sanchez; Alicia,11,0,20,9
1714643691638,LISP 5B,A00,507671,Munoz Sanchez; Alicia,8,0,20,12
1714643692665,LISP 5C,A00,507696,Munoz Sanchez; Alicia,9,0,20,11
1714643693691,MAE 197,001,528363,Boechler; Nicholas Sebastia,9998,0,9999,1
1714643694723,MATH 197,001,523477,Kedlaya; Kiran S.,9995,0,9999,4
1714643694723,MATH 197,002,563811,Zhang; Danna,9995,0,9999,4
1714643694723,MATH 197,003,628552,Dumitriu; Ioana,9998,0,9999,1
1714643695747,MCWP 40R,A00,518780,Staff,2,0,20,18
1714643695747,MCWP 40R,B00,518781,Staff,8,0,20,12
1714643695747,MCWP 40R,C00,518783,Staff,6,0,20,14
1714643696772,MCWP 50R,A00,518791,Staff,0,0,20,20
1714643696772,MCWP 50R,B00,518792,Staff,0,2,20,20
1714643696772,MCWP 50R,C00,518793,Staff,0,2,20,20
1714643696772,MCWP 50R,D00,518794,Staff,0,1,20,20
1714643696772,MCWP 50R,E00,518795,Staff,0,2,20,20
1714643696772,MCWP 50R,F00,518796,Staff,0,0,20,20
1714643696772,MCWP 50R,G00,518797,Staff,0,1,20,20
1714643697796,MMW 12R,A01,514034,Herbst; Matthew,0,0,16,16
1714643697796,MMW 12R,A02,514035,Herbst; Matthew,1,0,16,15
1714643698822,MMW 13R,A01,514037,Staff,0,4,16,16
1714643698822,MMW 13R,A02,514039,Staff,0,2,16,16
1714643698822,MMW 13R,A03,628519,Staff,0,2,16,16
1714643700877,SIO 295LS,A00,523233,Staff,10,0,30,20
1714643701903,SIO 295S,A00,523232,Staff,10,0,30,20
1714643702931,SIOC 290S,A01,637330,Merrifield; Mark A,23,0,30,7
1714643703960,SIOC 291S,A01,637333,Gabriel; Corey John,23,0,30,7
1714643704986,SOCI 117,A01,494376,Staff,0,4,5,5
1714643706009,WES 237B,A00,494380,Staff,9,0,20,11
1714643708080,AESE 279B,A00,494370,Wade; Jon P,0,0,33,33
1714643709109,AIP 197,001,627712,Vespa; Emanuel Ignacio,9998,0,9999,1
1714643710136,ANAR 135S,A00,494369,Braswell; Geoffrey E.,0,0,0,0
1714643711163,BENG 196,001,628496,Engler; Adam J.,9998,0,9999,1
1714643712191,CAT 124RS,A01,519847,Geibel; William,0,0,20,20
1714643713218,CAT 125RS,A01,515971,Geibel; William,0,0,20,20
1714643714244,CLRE 250,A00,511389,Morris; Sheldon,9993,0,9999,6
1714643715276,CLRE 251,A00,507176,Mehta; Ravindra L.,9993,0,9999,6
1714643715276,CLRE 251,B00,511410,Mehta; Ravindra L.,9998,0,9999,1
1714643716303,CLRE 252,A00,507189,Cuomo; Raphael Eduardo,9995,0,9999,4
1714643717400,CLRE 253,A00,507199,Vaida; Florin,9994,0,9999,5
1714643717400,CLRE 253,B00,507202,Vaida; Florin,9999,0,9999,0
1714643718425,CLRE 259,A00,507211,Patel; Hemal,9996,0,9999,3
1714643719453,CLRE 260,A00,507221,Cuomo; Raphael Eduardo,9999,0,9999,0
1714643720477,CLRE 297,001,507242,Cuomo; Raphael Eduardo,9999,0,9999,0
1714643721501,COGS 197,001,638244,Voytek; Bradley Thomas,9998,0,9999,1
1714643722526,CSE 191,A00,516875,Minnes Kemp; Mor Mia,9992,0,9999,7
1714643723555,CSE 197,001,637388,Minnes Kemp; Mor Mia,9998,0,9999,1
1714643724581,CSS 201S,A01,494383,Staff,35,0,35,0
1714643725605,CSS 202S,A01,494387,Staff,35,0,35,0
1714643726632,DSC 197,001,628532,Eldridge; Justin Matthew,9996,0,9999,3
1714643727658,EAP 100,A00,516065,Staff,9797,0,9999,202
1714643728772,ECE 45,A01,507414,Staff,33,0,60,27
1714643730885,ECE 111,A01,507420,Staff,15,0,50,35
1714643731910,ECE 197,001,548057,Sievenpiper; Daniel F.,9993,0,9999,6
1714643732995,EDS 115,A00,507243,Choi; Bailey Miyeon,10,0,28,18
1714643734025,EDS 117,A01,494379,Staff,0,4,30,30
1714643735049,EDS 125,A00,507246,Hopkins; Megan Beth,9,0,30,21
1714643736081,EDS 128A,A01,507264,Fargason; Sharon Gayle,8,0,26,18
1714643737105,EDS 128B,A01,507293,Pappas; Elizabeth,12,0,30,18
1714643738134,EDS 139,A00,507294,Fargason; Sharon Gayle,13,0,30,17
1714643738134,EDS 139,B00,507313,Pappas; Elizabeth,13,0,30,17
1714643739160,EDS 201,A00,507315,Staff,13,0,30,17
1714643740185,EDS 203,A01,507317,Halter; Christopher P.,12,0,30,18
1714643741212,EDS 204R,A01,507319,Halter; Christopher P.,0,3,30,30
1714643741212,EDS 204R,B01,507331,Heinzman; Erica M.,16,0,30,14
1714643742237,EDS 206R,A00,507332,Staff,0,4,30,30
1714643742237,EDS 206R,B00,507343,Staff,17,0,30,13
1714643743266,EDS 250,A00,507344,Hemans; Patricia Ann Benitez,22,0,40,18
1714643744297,EDS 281,A00,507345,Daly; Alan J.,18,0,18,0
1714643745321,EDS 284,A00,507350,Daly; Alan J.,16,0,16,0
1714643746346,EDS 286,A00,507359,Fine; Sarah,18,0,18,0
1714643747374,EDS 289C,A01,507361,Daly; Alan J.,18,0,18,0
1714643748404,EDS 290,A00,507366,Hofstetter; Carolyn,15,0,15,0
1714643749430,LIGM 5A,A00,507421,Fischer-Grunski; Eva K,18,0,20,2
1714643750458,LIGM 5B,A00,507423,Fischer-Grunski; Eva K,19,0,20,1
1714643751481,LIGM 5C,A00,507425,Fischer-Grunski; Eva K,19,0,20,1
1714643752508,LIIT 5AS,A00,507427,Carnelos; Chiara,20,0,20,0
1714643753533,LIIT 5BS,A00,507430,Carnelos; Chiara,20,0,20,0
1714643754562,LIIT 5CS,A00,507432,Carnelos; Chiara,20,0,20,0
1714643755589,LISP 5A,A00,507541,Munoz Sanchez; Alicia,11,0,20,9
1714643756618,LISP 5B,A00,507671,Munoz Sanchez; Alicia,8,0,20,12
1714643757646,LISP 5C,A00,507696,Munoz Sanchez; Alicia,9,0,20,11
1714643758673,MAE 197,001,528363,Boechler; Nicholas Sebastia,9998,0,9999,1
1714643759705,MATH 197,001,523477,Kedlaya; Kiran S.,9995,0,9999,4
1714643759705,MATH 197,002,563811,Zhang; Danna,9995,0,9999,4
1714643759705,MATH 197,003,628552,Dumitriu; Ioana,9998,0,9999,1
1714643760730,MCWP 40R,A00,518780,Staff,2,0,20,18
1714643760730,MCWP 40R,B00,518781,Staff,8,0,20,12
1714643760730,MCWP 40R,C00,518783,Staff,6,0,20,14
1714643761754,MCWP 50R,A00,518791,Staff,0,0,20,20
1714643761754,MCWP 50R,B00,518792,Staff,0,2,20,20
1714643761754,MCWP 50R,C00,518793,Staff,0,2,20,20
1714643761754,MCWP 50R,D00,518794,Staff,0,1,20,20
1714643761754,MCWP 50R,E00,518795,Staff,0,2,20,20
1714643761754,MCWP 50R,F00,518796,Staff,0,0,20,20
1714643761754,MCWP 50R,G00,518797,Staff,0,1,20,20
1714643762780,MMW 12R,A01,514034,Herbst; Matthew,0,0,16,16
1714643762780,MMW 12R,A02,514035,Herbst; Matthew,1,0,16,15
1714643763805,MMW 13R,A01,514037,Staff,0,4,16,16
1714643763805,MMW 13R,A02,514039,Staff,0,2,16,16
1714643763805,MMW 13R,A03,628519,Staff,0,2,16,16
1714643765856,SIO 295LS,A00,523233,Staff,10,0,30,20
1714643766881,SIO 295S,A00,523232,Staff,10,0,30,20
1714643767922,SIOC 290S,A01,637330,Merrifield; Mark A,23,0,30,7
1714643768953,SIOC 291S,A01,637333,Gabriel; Corey John,23,0,30,7
1714643770007,SOCI 117,A01,494376,Staff,0,4,5,5
1714643771032,WES 237B,A00,494380,Staff,9,0,20,11
1714643773107,AESE 279B,A00,494370,Wade; Jon P,0,0,33,33
1714643774132,AIP 197,001,627712,Vespa; Emanuel Ignacio,9998,0,9999,1
1714643775160,ANAR 135S,A00,494369,Braswell; Geoffrey E.,0,0,0,0
1714643776184,BENG 196,001,628496,Engler; Adam J.,9998,0,9999,1
1714643777213,CAT 124RS,A01,519847,Geibel; William,0,0,20,20
1714643778237,CAT 125RS,A01,515971,Geibel; William,0,0,20,20
1714643779266,CLRE 250,A00,511389,Morris; Sheldon,9993,0,9999,6
1714643780295,CLRE 251,A00,507176,Mehta; Ravindra L.,9993,0,9999,6
1714643780295,CLRE 251,B00,511410,Mehta; Ravindra L.,9998,0,9999,1
1714643781321,CLRE 252,A00,507189,Cuomo; Raphael Eduardo,9995,0,9999,4
1714643782344,CLRE 253,A00,507199,Vaida; Florin,9994,0,9999,5
1714643782344,CLRE 253,B00,507202,Vaida; Florin,9999,0,9999,0
1714643783373,CLRE 259,A00,507211,Patel; Hemal,9996,0,9999,3
1714643784397,CLRE 260,A00,507221,Cuomo; Raphael Eduardo,9999,0,9999,0
1714643785423,CLRE 297,001,507242,Cuomo; Raphael Eduardo,9999,0,9999,0
1714643786449,COGS 197,001,638244,Voytek; Bradley Thomas,9998,0,9999,1
1714643787475,CSE 191,A00,516875,Minnes Kemp; Mor Mia,9992,0,9999,7
1714643788499,CSE 197,001,637388,Minnes Kemp; Mor Mia,9998,0,9999,1
1714643789558,CSS 201S,A01,494383,Staff,35,0,35,0
1714643790588,CSS 202S,A01,494387,Staff,35,0,35,0
1714643791614,DSC 197,001,628532,Eldridge; Justin Matthew,9996,0,9999,3
1714643792639,EAP 100,A00,516065,Staff,9797,0,9999,202
1714643793669,ECE 45,A01,507414,Staff,33,0,60,27
1714643795743,ECE 111,A01,507420,Staff,15,0,50,35
1714643796768,ECE 197,001,548057,Sievenpiper; Daniel F.,9993,0,9999,6
1714643797797,EDS 115,A00,507243,Choi; Bailey Miyeon,10,0,28,18
1714643798826,EDS 117,A01,494379,Staff,0,4,30,30
1714643799850,EDS 125,A00,507246,Hopkins; Megan Beth,9,0,30,21
1714643800879,EDS 128A,A01,507264,Fargason; Sharon Gayle,8,0,26,18
1714643801909,EDS 128B,A01,507293,Pappas; Elizabeth,12,0,30,18
1714643802934,EDS 139,A00,507294,Fargason; Sharon Gayle,13,0,30,17
1714643802934,EDS 139,B00,507313,Pappas; Elizabeth,13,0,30,17
1714643803958,EDS 201,A00,507315,Staff,13,0,30,17
1714643804983,EDS 203,A01,507317,Halter; Christopher P.,12,0,30,18
1714643806038,EDS 204R,A01,507319,Halter; Christopher P.,0,3,30,30
1714643806038,EDS 204R,B01,507331,Heinzman; Erica M.,16,0,30,14
1714643807063,EDS 206R,A00,507332,Staff,0,4,30,30
1714643807063,EDS 206R,B00,507343,Staff,17,0,30,13
1714643808088,EDS 250,A00,507344,Hemans; Patricia Ann Benitez,22,0,40,18
1714643809113,EDS 281,A00,507345,Daly; Alan J.,18,0,18,0
1714643810138,EDS 284,A00,507350,Daly; Alan J.,16,0,16,0
1714643811167,EDS 286,A00,507359,Fine; Sarah,18,0,18,0
1714643812192,EDS 289C,A01,507361,Daly; Alan J.,18,0,18,0
1714643813222,EDS 290,A00,507366,Hofstetter; Carolyn,15,0,15,0
1714643814251,LIGM 5A,A00,507421,Fischer-Grunski; Eva K,18,0,20,2
1714643815280,LIGM 5B,A00,507423,Fischer-Grunski; Eva K,19,0,20,1
1714643816305,LIGM 5C,A00,507425,Fischer-Grunski; Eva K,19,0,20,1
1714643817332,LIIT 5AS,A00,507427,Carnelos; Chiara,20,0,20,0
1714643818358,LIIT 5BS,A00,507430,Carnelos; Chiara,20,0,20,0
1714643819382,LIIT 5CS,A00,507432,Carnelos; Chiara,20,0,20,0
1714643820412,LISP 5A,A00,507541,Munoz Sanchez; Alicia,11,0,20,9
1714643821437,LISP 5B,A00,507671,Munoz Sanchez; Alicia,8,0,20,12
1714643822463,LISP 5C,A00,507696,Munoz Sanchez; Alicia,9,0,20,11
1714643823488,MAE 197,001,528363,Boechler; Nicholas Sebastia,9998,0,9999,1
1714643824516,MATH 197,001,523477,Kedlaya; Kiran S.,9995,0,9999,4
1714643824516,MATH 197,002,563811,Zhang; Danna,9995,0,9999,4
1714643824516,MATH 197,003,628552,Dumitriu; Ioana,9998,0,9999,1
1714643825542,MCWP 40R,A00,518780,Staff,2,0,20,18
1714643825542,MCWP 40R,B00,518781,Staff,8,0,20,12
1714643825542,MCWP 40R,C00,518783,Staff,6,0,20,14
1714643826578,MCWP 50R,A00,518791,Staff,0,0,20,20
1714643826578,MCWP 50R,B00,518792,Staff,0,2,20,20
1714643826578,MCWP 50R,C00,518793,Staff,0,2,20,20
1714643826578,MCWP 50R,D00,518794,Staff,0,1,20,20
1714643826578,MCWP 50R,E00,518795,Staff,0,2,20,20
1714643826578,MCWP 50R,F00,518796,Staff,0,0,20,20
1714643826578,MCWP 50R,G00,518797,Staff,0,1,20,20
1714643827637,MMW 12R,A01,514034,Herbst; Matthew,0,0,16,16
1714643827637,MMW 12R,A02,514035,Herbst; Matthew,1,0,16,15
1714643828665,MMW 13R,A01,514037,Staff,0,4,16,16
1714643828665,MMW 13R,A02,514039,Staff,0,2,16,16
1714643828665,MMW 13R,A03,628519,Staff,0,2,16,16
1714643830715,SIO 295LS,A00,523233,Staff,10,0,30,20
1714643831743,SIO 295S,A00,523232,Staff,10,0,30,20
1714643832769,SIOC 290S,A01,637330,Merrifield; Mark A,23,0,30,7
1714643833794,SIOC 291S,A01,637333,Gabriel; Corey John,23,0,30,7
1714643834821,SOCI 117,A01,494376,Staff,0,4,5,5
1714643835846,WES 237B,A00,494380,Staff,9,0,20,11
1714643837918,AESE 279B,A00,494370,Wade; Jon P,0,0,33,33
1714643838942,AIP 197,001,627712,Vespa; Emanuel Ignacio,9998,0,9999,1
1714643839970,ANAR 135S,A00,494369,Braswell; Geoffrey E.,0,0,0,0
1714643840995,BENG 196,001,628496,Engler; Adam J.,9998,0,9999,1
1714643842024,CAT 124RS,A01,519847,Geibel; William,0,0,20,20
1714643843049,CAT 125RS,A01,515971,Geibel; William,0,0,20,20
1714643844073,CLRE 250,A00,511389,Morris; Sheldon,9993,0,9999,6
1714643845099,CLRE 251,A00,507176,Mehta; Ravindra L.,9993,0,9999,6
1714643845099,CLRE 251,B00,511410,Mehta; Ravindra L.,9998,0,9999,1
1714643846125,CLRE 252,A00,507189,Cuomo; Raphael Eduardo,9995,0,9999,4
1714643847154,CLRE 253,A00,507199,Vaida; Florin,9994,0,9999,5
1714643847154,CLRE 253,B00,507202,Vaida; Florin,9999,0,9999,0
1714643848181,CLRE 259,A00,507211,Patel; Hemal,9996,0,9999,3
1714643849205,CLRE 260,A00,507221,Cuomo; Raphael Eduardo,9999,0,9999,0
1714643850230,CLRE 297,001,507242,Cuomo; Raphael Eduardo,9999,0,9999,0
1714643851255,COGS 197,001,638244,Voytek; Bradley Thomas,9998,0,9999,1
1714643852280,CSE 191,A00,516875,Minnes Kemp; Mor Mia,9992,0,9999,7
1714643853305,CSE 197,001,637388,Minnes Kemp; Mor Mia,9998,0,9999,1
1714643854332,CSS 201S,A01,494383,Staff,35,0,35,0
1714643855357,CSS 202S,A01,494387,Staff,35,0,35,0
1714643856384,DSC 197,001,628532,Eldridge; Justin Matthew,9996,0,9999,3
1714643857412,EAP 100,A00,516065,Staff,9797,0,9999,202
1714643858439,ECE 45,A01,507414,Staff,33,0,60,27
1714643860494,ECE 111,A01,507420,Staff,15,0,50,35
1714643861519,ECE 197,001,548057,Sievenpiper; Daniel F.,9993,0,9999,6
1714643862589,EDS 115,A00,507243,Choi; Bailey Miyeon,10,0,28,18
1714643863626,EDS 117,A01,494379,Staff,0,4,30,30
1714643864654,EDS 125,A00,507246,Hopkins; Megan Beth,9,0,30,21
1714643865679,EDS 128A,A01,507264,Fargason; Sharon Gayle,8,0,26,18
1714643866704,EDS 128B,A01,507293,Pappas; Elizabeth,12,0,30,18
1714643867731,EDS 139,A00,507294,Fargason; Sharon Gayle,13,0,30,17
1714643867731,EDS 139,B00,507313,Pappas; Elizabeth,13,0,30,17
1714643868757,EDS 201,A00,507315,Staff,13,0,30,17
1714643869785,EDS 203,A01,507317,Halter; Christopher P.,12,0,30,18
1714643870811,EDS 204R,A01,507319,Halter; Christopher P.,0,3,30,30
1714643870811,EDS 204R,B01,507331,Heinzman; Erica M.,16,0,30,14
1714643871840,EDS 206R,A00,507332,Staff,0,4,30,30
1714643871840,EDS 206R,B00,507343,Staff,17,0,30,13
1714643872865,EDS 250,A00,507344,Hemans; Patricia Ann Benitez,22,0,40,18
1714643873892,EDS 281,A00,507345,Daly; Alan J.,18,0,18,0
1714643874920,EDS 284,A00,507350,Daly; Alan J.,16,0,16,0
1714643875950,EDS 286,A00,507359,Fine; Sarah,18,0,18,0
1714643876974,EDS 289C,A01,507361,Daly; Alan J.,18,0,18,0
1714643878001,EDS 290,A00,507366,Hofstetter; Carolyn,15,0,15,0
1714643879028,LIGM 5A,A00,507421,Fischer-Grunski; Eva K,18,0,20,2
1714643880055,LIGM 5B,A00,507423,Fischer-Grunski; Eva K,19,0,20,1
1714643881080,LIGM 5C,A00,507425,Fischer-Grunski; Eva K,19,0,20,1
1714643882106,LIIT 5AS,A00,507427,Carnelos; Chiara,20,0,20,0
1714643883132,LIIT 5BS,A00,507430,Carnelos; Chiara,20,0,20,0
1714643884167,LIIT 5CS,A00,507432,Carnelos; Chiara,20,0,20,0
1714643885196,LISP 5A,A00,507541,Munoz Sanchez; Alicia,11,0,20,9
1714643886222,LISP 5B,A00,507671,Munoz Sanchez; Alicia,8,0,20,12
1714643887251,LISP 5C,A00,507696,Munoz Sanchez; Alicia,9,0,20,11
1714643888276,MAE 197,001,528363,Boechler; Nicholas Sebastia,9998,0,9999,1
1714643889312,MATH 197,001,523477,Kedlaya; Kiran S.,9995,0,9999,4
1714643889312,MATH 197,002,563811,Zhang; Danna,9995,0,9999,4
1714643889312,MATH 197,003,628552,Dumitriu; Ioana,9998,0,9999,1
1714643890338,MCWP 40R,A00,518780,Staff,2,0,20,18
1714643890338,MCWP 40R,B00,518781,Staff,8,0,20,12
1714643890338,MCWP 40R,C00,518783,Staff,6,0,20,14
1714643891369,MCWP 50R,A00,518791,Staff,0,0,20,20
1714643891369,MCWP 50R,B00,518792,Staff,0,2,20,20
1714643891369,MCWP 50R,C00,518793,Staff,0,2,20,20
1714643891369,MCWP 50R,D00,518794,Staff,0,1,20,20
1714643891369,MCWP 50R,E00,518795,Staff,0,2,20,20
1714643891369,MCWP 50R,F00,518796,Staff,0,0,20,20
1714643891369,MCWP 50R,G00,518797,Staff,0,1,20,20
1714643892399,MMW 12R,A01,514034,Herbst; Matthew,0,0,16,16
1714643892399,MMW 12R,A02,514035,Herbst; Matthew,1,0,16,15
1714643893425,MMW 13R,A01,514037,Staff,0,4,16,16
1714643893425,MMW 13R,A02,514039,Staff,0,2,16,16
1714643893425,MMW 13R,A03,628519,Staff,0,2,16,16
1714643895481,SIO 295LS,A00,523233,Staff,10,0,30,20
1714643896505,SIO 295S,A00,523232,Staff,10,0,30,20
1714643897530,SIOC 290S,A01,637330,Merrifield; Mark A,23,0,30,7
1714643898613,SIOC 291S,A01,637333,Gabriel; Corey John,23,0,30,7
1714643899638,SOCI 117,A01,494376,Staff,0,4,5,5
1714643900665,WES 237B,A00,494380,Staff,9,0,20,11
1714643902740,AESE 279B,A00,494370,Wade; Jon P,0,0,33,33
1714643903765,AIP 197,001,627712,Vespa; Emanuel Ignacio,9998,0,9999,1
1714643904791,ANAR 135S,A00,494369,Braswell; Geoffrey E.,0,0,0,0
1714643905822,BENG 196,001,628496,Engler; Adam J.,9998,0,9999,1
1714643906850,CAT 124RS,A01,519847,Geibel; William,0,0,20,20
1714643907878,CAT 125RS,A01,515971,Geibel; William,0,0,20,20
1714643908905,CLRE 250,A00,511389,Morris; Sheldon,9993,0,9999,6
1714643909937,CLRE 251,A00,507176,Mehta; Ravindra L.,9993,0,9999,6
1714643909937,CLRE 251,B00,511410,Mehta; Ravindra L.,9998,0,9999,1
1714643910962,CLRE 252,A00,507189,Cuomo; Raphael Eduardo,9995,0,9999,4
1714643911988,CLRE 253,A00,507199,Vaida; Florin,9994,0,9999,5
1714643911988,CLRE 253,B00,507202,Vaida; Florin,9999,0,9999,0
1714643913013,CLRE 259,A00,507211,Patel; Hemal,9996,0,9999,3
1714643914040,CLRE 260,A00,507221,Cuomo; Raphael Eduardo,9999,0,9999,0
1714643915066,CLRE 297,001,507242,Cuomo; Raphael Eduardo,9999,0,9999,0
1714643916094,COGS 197,001,638244,Voytek; Bradley Thomas,9998,0,9999,1
1714643917123,CSE 191,A00,516875,Minnes Kemp; Mor Mia,9992,0,9999,7
1714643918148,CSE 197,001,637388,Minnes Kemp; Mor Mia,9998,0,9999,1
1714643919173,CSS 201S,A01,494383,Staff,35,0,35,0
1714643920199,CSS 202S,A01,494387,Staff,35,0,35,0
1714643921228,DSC 197,001,628532,Eldridge; Justin Matthew,9996,0,9999,3
1714643922252,EAP 100,A00,516065,Staff,9797,0,9999,202
1714643923283,ECE 45,A01,507414,Staff,33,0,60,27
1714643925334,ECE 111,A01,507420,Staff,15,0,50,35
1714643926359,ECE 197,001,548057,Sievenpiper; Daniel F.,9993,0,9999,6
1714643927386,EDS 115,A00,507243,Choi; Bailey Miyeon,10,0,28,18
1714643928415,EDS 117,A01,494379,Staff,0,4,30,30
1714643929442,EDS 125,A00,507246,Hopkins; Megan Beth,9,0,30,21
1714643930467,EDS 128A,A01,507264,Fargason; Sharon Gayle,8,0,26,18
1714643931493,EDS 128B,A01,507293,Pappas; Elizabeth,12,0,30,18
1714643932518,EDS 139,A00,507294,Fargason; Sharon Gayle,13,0,30,17
1714643932518,EDS 139,B00,507313,Pappas; Elizabeth,13,0,30,17
1714643933544,EDS 201,A00,507315,Staff,13,0,30,17
1714643934570,EDS 203,A01,507317,Halter; Christopher P.,12,0,30,18
1714643935597,EDS 204R,A01,507319,Halter; Christopher P.,0,3,30,30
1714643935597,EDS 204R,B01,507331,Heinzman; Erica M.,16,0,30,14
1714643936625,EDS 206R,A00,507332,Staff,0,4,30,30
1714643936625,EDS 206R,B00,507343,Staff,17,0,30,13
1714643937651,EDS 250,A00,507344,Hemans; Patricia Ann Benitez,22,0,40,18
1714643938677,EDS 281,A00,507345,Daly; Alan J.,18,0,18,0
1714643939702,EDS 284,A00,507350,Daly; Alan J.,16,0,16,0
1714643940730,EDS 286,A00,507359,Fine; Sarah,18,0,18,0
1714643941756,EDS 289C,A01,507361,Daly; Alan J.,18,0,18,0
1714643942780,EDS 290,A00,507366,Hofstetter; Carolyn,15,0,15,0
1714643943808,LIGM 5A,A00,507421,Fischer-Grunski; Eva K,18,0,20,2
1714643944832,LIGM 5B,A00,507423,Fischer-Grunski; Eva K,19,0,20,1
1714643945859,LIGM 5C,A00,507425,Fischer-Grunski; Eva K,19,0,20,1
1714643946888,LIIT 5AS,A00,507427,Carnelos; Chiara,20,0,20,0
1714643947913,LIIT 5BS,A00,507430,Carnelos; Chiara,20,0,20,0
1714643948942,LIIT 5CS,A00,507432,Carnelos; Chiara,20,0,20,0
1714643949973,LISP 5A,A00,507541,Munoz Sanchez; Alicia,11,0,20,9
1714643951001,LISP 5B,A00,507671,Munoz Sanchez; Alicia,8,0,20,12
1714643952027,LISP 5C,A00,507696,Munoz Sanchez; Alicia,9,0,20,11
1714643953054,MAE 197,001,528363,Boechler; Nicholas Sebastia,9998,0,9999,1
1714643954089,MATH 197,001,523477,Kedlaya; Kiran S.,9995,0,9999,4
1714643954089,MATH 197,002,563811,Zhang; Danna,9995,0,9999,4
1714643954089,MATH 197,003,628552,Dumitriu; Ioana,9998,0,9999,1
1714643955117,MCWP 40R,A00,518780,Staff,2,0,20,18
1714643955117,MCWP 40R,B00,518781,Staff,8,0,20,12
1714643955117,MCWP 40R,C00,518783,Staff,6,0,20,14
1714643956147,MCWP 50R,A00,518791,Staff,0,0,20,20
1714643956147,MCWP 50R,B00,518792,Staff,0,2,20,20
1714643956147,MCWP 50R,C00,518793,Staff,0,2,20,20
1714643956147,MCWP 50R,D00,518794,Staff,0,1,20,20
1714643956147,MCWP 50R,E00,518795,Staff,0,2,20,20
1714643956147,MCWP 50R,F00,518796,Staff,0,0,20,20
1714643956147,MCWP 50R,G00,518797,Staff,0,1,20,20
1714643957175,MMW 12R,A01,514034,Herbst; Matthew,0,0,16,16
1714643957175,MMW 12R,A02,514035,Herbst; Matthew,1,0,16,15
1714643958204,MMW 13R,A01,514037,Staff,0,4,16,16
1714643958204,MMW 13R,A02,514039,Staff,0,2,16,16
1714643958204,MMW 13R,A03,628519,Staff,0,2,16,16
1714643960261,SIO 295LS,A00,523233,Staff,10,0,30,20
1714643961290,SIO 295S,A00,523232,Staff,10,0,30,20
1714643962316,SIOC 290S,A01,637330,Merrifield; Mark A,23,0,30,7
1714643963345,SIOC 291S,A01,637333,Gabriel; Corey John,23,0,30,7
1714643964374,SOCI 117,A01,494376,Staff,0,4,5,5
1714643965404,WES 237B,A00,494380,Staff,9,0,20,11
1714643967473,AESE 279B,A00,494370,Wade; Jon P,0,0,33,33
1714643968499,AIP 197,001,627712,Vespa; Emanuel Ignacio,9998,0,9999,1
1714643969528,ANAR 135S,A00,494369,Braswell; Geoffrey E.,0,0,0,0
1714643970554,BENG 196,001,628496,Engler; Adam J.,9998,0,9999,1
1714643971583,CAT 124RS,A01,519847,Geibel; William,0,0,20,20
1714643972607,CAT 125RS,A01,515971,Geibel; William,0,0,20,20
1714643973633,CLRE 250,A00,511389,Morris; Sheldon,9993,0,9999,6
1714643974664,CLRE 251,A00,507176,Mehta; Ravindra L.,9993,0,9999,6
1714643974664,CLRE 251,B00,511410,Mehta; Ravindra L.,9998,0,9999,1
1714643975689,CLRE 252,A00,507189,Cuomo; Raphael Eduardo,9995,0,9999,4
1714643976714,CLRE 253,A00,507199,Vaida; Florin,9994,0,9999,5
1714643976714,CLRE 253,B00,507202,Vaida; Florin,9999,0,9999,0
1714643977741,CLRE 259,A00,507211,Patel; Hemal,9996,0,9999,3
1714643978767,CLRE 260,A00,507221,Cuomo; Raphael Eduardo,9999,0,9999,0
1714643979791,CLRE 297,001,507242,Cuomo; Raphael Eduardo,9999,0,9999,0
1714643980815,COGS 197,001,638244,Voytek; Bradley Thomas,9998,0,9999,1
1714643981842,CSE 191,A00,516875,Minnes Kemp; Mor Mia,9992,0,9999,7
1714643982872,CSE 197,001,637388,Minnes Kemp; Mor Mia,9998,0,9999,1
1714643983901,CSS 201S,A01,494383,Staff,35,0,35,0
1714643984935,CSS 202S,A01,494387,Staff,35,0,35,0
1714643985961,DSC 197,001,628532,Eldridge; Justin Matthew,9996,0,9999,3
1714643986986,EAP 100,A00,516065,Staff,9797,0,9999,202
1714643988013,ECE 45,A01,507414,Staff,33,0,60,27
1714643990071,ECE 111,A01,507420,Staff,15,0,50,35
1714643991097,ECE 197,001,548057,Sievenpiper; Daniel F.,9993,0,9999,6
1714643992123,EDS 115,A00,507243,Choi; Bailey Miyeon,10,0,28,18
1714643993151,EDS 117,A01,494379,Staff,0,4,30,30
1714643994176,EDS 125,A00,507246,Hopkins; Megan Beth,9,0,30,21
1714643995206,EDS 128A,A01,507264,Fargason; Sharon Gayle,8,0,26,18
1714643996232,EDS 128B,A01,507293,Pappas; Elizabeth,12,0,30,18
1714643997261,EDS 139,A00,507294,Fargason; Sharon Gayle,13,0,30,17
1714643997261,EDS 139,B00,507313,Pappas; Elizabeth,13,0,30,17
1714643998290,EDS 201,A00,507315,Staff,13,0,30,17
1714643999316,EDS 203,A01,507317,Halter; Christopher P.,12,0,30,18
1714644000342,EDS 204R,A01,507319,Halter; Christopher P.,0,3,30,30
1714644000342,EDS 204R,B01,507331,Heinzman; Erica M.,16,0,30,14
1714644001371,EDS 206R,A00,507332,Staff,0,4,30,30
1714644001371,EDS 206R,B00,507343,Staff,17,0,30,13
1714644002396,EDS 250,A00,507344,Hemans; Patricia Ann Benitez,22,0,40,18
1714644003421,EDS 281,A00,507345,Daly; Alan J.,18,0,18,0
1714644004447,EDS 284,A00,507350,Daly; Alan J.,16,0,16,0
1714644005476,EDS 286,A00,507359,Fine; Sarah,18,0,18,0
1714644006503,EDS 289C,A01,507361,Daly; Alan J.,18,0,18,0
1714644007527,EDS 290,A00,507366,Hofstetter; Carolyn,15,0,15,0
1714644008559,LIGM 5A,A00,507421,Fischer-Grunski; Eva K,18,0,20,2
1714644009587,LIGM 5B,A00,507423,Fischer-Grunski; Eva K,19,0,20,1
1714644010612,LIGM 5C,A00,507425,Fischer-Grunski; Eva K,19,0,20,1
1714644011639,LIIT 5AS,A00,507427,Carnelos; Chiara,20,0,20,0
1714644012668,LIIT 5BS,A00,507430,Carnelos; Chiara,20,0,20,0
1714644013693,LIIT 5CS,A00,507432,Carnelos; Chiara,20,0,20,0
1714644014723,LISP 5A,A00,507541,Munoz Sanchez; Alicia,11,0,20,9
1714644015746,LISP 5B,A00,507671,Munoz Sanchez; Alicia,8,0,20,12
1714644016778,LISP 5C,A00,507696,Munoz Sanchez; Alicia,9,0,20,11
1714644017808,MAE 197,001,528363,Boechler; Nicholas Sebastia,9998,0,9999,1
1714644018835,MATH 197,001,523477,Kedlaya; Kiran S.,9995,0,9999,4
1714644018835,MATH 197,002,563811,Zhang; Danna,9995,0,9999,4
1714644018835,MATH 197,003,628552,Dumitriu; Ioana,9998,0,9999,1
1714644019862,MCWP 40R,A00,518780,Staff,2,0,20,18
1714644019862,MCWP 40R,B00,518781,Staff,8,0,20,12
1714644019862,MCWP 40R,C00,518783,Staff,6,0,20,14
1714644020891,MCWP 50R,A00,518791,Staff,0,0,20,20
1714644020891,MCWP 50R,B00,518792,Staff,0,2,20,20
1714644020891,MCWP 50R,C00,518793,Staff,0,2,20,20
1714644020891,MCWP 50R,D00,518794,Staff,0,1,20,20
1714644020891,MCWP 50R,E00,518795,Staff,0,2,20,20
1714644020891,MCWP 50R,F00,518796,Staff,0,0,20,20
1714644020891,MCWP 50R,G00,518797,Staff,0,1,20,20
1714644021917,MMW 12R,A01,514034,Herbst; Matthew,0,0,16,16
1714644021917,MMW 12R,A02,514035,Herbst; Matthew,1,0,16,15
1714644022945,MMW 13R,A01,514037,Staff,0,4,16,16
1714644022945,MMW 13R,A02,514039,Staff,0,2,16,16
1714644022945,MMW 13R,A03,628519,Staff,0,2,16,16
1714644025000,SIO 295LS,A00,523233,Staff,10,0,30,20
1714644026029,SIO 295S,A00,523232,Staff,10,0,30,20
1714644027055,SIOC 290S,A01,637330,Merrifield; Mark A,23,0,30,7
1714644028083,SIOC 291S,A01,637333,Gabriel; Corey John,23,0,30,7
1714644029111,SOCI 117,A01,494376,Staff,0,4,5,5
1714644030136,WES 237B,A00,494380,Staff,9,0,20,11
1714644032222,AESE 279B,A00,494370,Wade; Jon P,0,0,33,33
1714644033250,AIP 197,001,627712,Vespa; Emanuel Ignacio,9998,0,9999,1
1714644034280,ANAR 135S,A00,494369,Braswell; Geoffrey E.,0,0,0,0
1714644035309,BENG 196,001,628496,Engler; Adam J.,9998,0,9999,1
1714644036335,CAT 124RS,A01,519847,Geibel; William,0,0,20,20
1714644037362,CAT 125RS,A01,515971,Geibel; William,0,0,20,20
1714644038393,CLRE 250,A00,511389,Morris; Sheldon,9993,0,9999,6
1714644039473,CLRE 251,A00,507176,Mehta; Ravindra L.,9993,0,9999,6
1714644039473,CLRE 251,B00,511410,Mehta; Ravindra L.,9998,0,9999,1
1714644040501,CLRE 252,A00,507189,Cuomo; Raphael Eduardo,9995,0,9999,4
1714644041526,CLRE 253,A00,507199,Vaida; Florin,9994,0,9999,5
1714644041526,CLRE 253,B00,507202,Vaida; Florin,9999,0,9999,0
1714644042554,CLRE 259,A00,507211,Patel; Hemal,9996,0,9999,3
1714644043579,CLRE 260,A00,507221,Cuomo; Raphael Eduardo,9999,0,9999,0
1714644044607,CLRE 297,001,507242,Cuomo; Raphael Eduardo,9999,0,9999,0
1714644045636,COGS 197,001,638244,Voytek; Bradley Thomas,9998,0,9999,1
1714644046660,CSE 191,A00,516875,Minnes Kemp; Mor Mia,9992,0,9999,7
1714644047685,CSE 197,001,637388,Minnes Kemp; Mor Mia,9998,0,9999,1
1714644048710,CSS 201S,A01,494383,Staff,35,0,35,0
1714644049734,CSS 202S,A01,494387,Staff,35,0,35,0
1714644050759,DSC 197,001,628532,Eldridge; Justin Matthew,9996,0,9999,3
1714644051784,EAP 100,A00,516065,Staff,9797,0,9999,202
1714644052814,ECE 45,A01,507414,Staff,33,0,60,27
1714644054871,ECE 111,A01,507420,Staff,15,0,50,35
1714644055900,ECE 197,001,548057,Sievenpiper; Daniel F.,9993,0,9999,6
1714644056926,EDS 115,A00,507243,Choi; Bailey Miyeon,10,0,28,18
1714644057952,EDS 117,A01,494379,Staff,0,4,30,30
1714644058977,EDS 125,A00,507246,Hopkins; Megan Beth,9,0,30,21
1714644060134,EDS 128A,A01,507264,Fargason; Sharon Gayle,8,0,26,18
1714644061164,EDS 128B,A01,507293,Pappas; Elizabeth,12,0,30,18
1714644062193,EDS 139,A00,507294,Fargason; Sharon Gayle,13,0,30,17
1714644062193,EDS 139,B00,507313,Pappas; Elizabeth,13,0,30,17
1714644063218,EDS 201,A00,507315,Staff,13,0,30,17
1714644064245,EDS 203,A01,507317,Halter; Christopher P.,12,0,30,18
1714644065278,EDS 204R,A01,507319,Halter; Christopher P.,0,3,30,30
1714644065278,EDS 204R,B01,507331,Heinzman; Erica M.,16,0,30,14
1714644066307,EDS 206R,A00,507332,Staff,0,4,30,30
1714644066307,EDS 206R,B00,507343,Staff,17,0,30,13
1714644067332,EDS 250,A00,507344,Hemans; Patricia Ann Benitez,22,0,40,18
1714644068362,EDS 281,A00,507345,Daly; Alan J.,18,0,18,0
1714644069387,EDS 284,A00,507350,Daly; Alan J.,16,0,16,0
1714644070411,EDS 286,A00,507359,Fine; Sarah,18,0,18,0
1714644071440,EDS 289C,A01,507361,Daly; Alan J.,18,0,18,0
1714644072465,EDS 290,A00,507366,Hofstetter; Carolyn,15,0,15,0
1714644073491,LIGM 5A,A00,507421,Fischer-Grunski; Eva K,18,0,20,2
1714644074518,LIGM 5B,A00,507423,Fischer-Grunski; Eva K,19,0,20,1
1714644075546,LIGM 5C,A00,507425,Fischer-Grunski; Eva K,19,0,20,1
1714644076572,LIIT 5AS,A00,507427,Carnelos; Chiara,20,0,20,0
1714644077603,LIIT 5BS,A00,507430,Carnelos; Chiara,20,0,20,0
1714644078631,LIIT 5CS,A00,507432,Carnelos; Chiara,20,0,20,0
1714644079657,LISP 5A,A00,507541,Munoz Sanchez; Alicia,11,0,20,9
1714644080684,LISP 5B,A00,507671,Munoz Sanchez; Alicia,8,0,20,12
1714644081714,LISP 5C,A00,507696,Munoz Sanchez; Alicia,9,0,20,11
1714644082739,MAE 197,001,528363,Boechler; Nicholas Sebastia,9998,0,9999,1
1714644083768,MATH 197,001,523477,Kedlaya; Kiran S.,9995,0,9999,4
1714644083768,MATH 197,002,563811,Zhang; Danna,9995,0,9999,4
1714644083768,MATH 197,003,628552,Dumitriu; Ioana,9998,0,9999,1
1714644084798,MCWP 40R,A00,518780,Staff,2,0,20,18
1714644084798,MCWP 40R,B00,518781,Staff,8,0,20,12
1714644084798,MCWP 40R,C00,518783,Staff,6,0,20,14
1714644085827,MCWP 50R,A00,518791,Staff,0,0,20,20
1714644085827,MCWP 50R,B00,518792,Staff,0,2,20,20
1714644085827,MCWP 50R,C00,518793,Staff,0,2,20,20
1714644085827,MCWP 50R,D00,518794,Staff,0,1,20,20
1714644085827,MCWP 50R,E00,518795,Staff,0,2,20,20
1714644085827,MCWP 50R,F00,518796,Staff,0,0,20,20
1714644085827,MCWP 50R,G00,518797,Staff,0,1,20,20
1714644086853,MMW 12R,A01,514034,Herbst; Matthew,0,0,16,16
1714644086853,MMW 12R,A02,514035,Herbst; Matthew,1,0,16,15
1714644087878,MMW 13R,A01,514037,Staff,0,4,16,16
1714644087878,MMW 13R,A02,514039,Staff,0,2,16,16
1714644087878,MMW 13R,A03,628519,Staff,0,2,16,16
1714644089929,SIO 295LS,A00,523233,Staff,10,0,30,20
1714644090954,SIO 295S,A00,523232,Staff,10,0,30,20
1714644091981,SIOC 290S,A01,637330,Merrifield; Mark A,23,0,30,7
1714644093010,SIOC 291S,A01,637333,Gabriel; Corey John,23,0,30,7
1714644094038,SOCI 117,A01,494376,Staff,0,4,5,5
1714644095063,WES 237B,A00,494380,Staff,9,0,20,11
1714644097142,AESE 279B,A00,494370,Wade; Jon P,0,0,33,33
1714644098169,AIP 197,001,627712,Vespa; Emanuel Ignacio,9998,0,9999,1
1714644099193,ANAR 135S,A00,494369,Braswell; Geoffrey E.,0,0,0,0
1714644100224,BENG 196,001,628496,Engler; Adam J.,9998,0,9999,1
1714644101254,CAT 124RS,A01,519847,Geibel; William,0,0,20,20
1714644102280,CAT 125RS,A01,515971,Geibel; William,0,0,20,20
1714644103305,CLRE 250,A00,511389,Morris; Sheldon,9993,0,9999,6
1714644104333,CLRE 251,A00,507176,Mehta; Ravindra L.,9993,0,9999,6
1714644104333,CLRE 251,B00,511410,Mehta; Ravindra L.,9998,0,9999,1
1714644105359,CLRE 252,A00,507189,Cuomo; Raphael Eduardo,9995,0,9999,4
1714644106384,CLRE 253,A00,507199,Vaida; Florin,9994,0,9999,5
1714644106384,CLRE 253,B00,507202,Vaida; Florin,9999,0,9999,0
1714644107412,CLRE 259,A00,507211,Patel; Hemal,9996,0,9999,3
1714644108438,CLRE 260,A00,507221,Cuomo; Raphael Eduardo,9999,0,9999,0
1714644109462,CLRE 297,001,507242,Cuomo; Raphael Eduardo,9999,0,9999,0
1714644110490,COGS 197,001,638244,Voytek; Bradley Thomas,9998,0,9999,1
1714644111519,CSE 191,A00,516875,Minnes Kemp; Mor Mia,9992,0,9999,7
1714644112543,CSE 197,001,637388,Minnes Kemp; Mor Mia,9998,0,9999,1
1714644113576,CSS 201S,A01,494383,Staff,35,0,35,0
1714644114615,CSS 202S,A01,494387,Staff,35,0,35,0
1714644115641,DSC 197,001,628532,Eldridge; Justin Matthew,9996,0,9999,3
1714644116669,EAP 100,A00,516065,Staff,9797,0,9999,202
1714644117698,ECE 45,A01,507414,Staff,33,0,60,27
1714644119754,ECE 111,A01,507420,Staff,15,0,50,35
1714644120785,ECE 197,001,548057,Sievenpiper; Daniel F.,9993,0,9999,6
1714644121817,EDS 115,A00,507243,Choi; Bailey Miyeon,10,0,28,18
1714644122843,EDS 117,A01,494379,Staff,0,4,30,30
1714644123870,EDS 125,A00,507246,Hopkins; Megan Beth,9,0,30,21
1714644124896,EDS 128A,A01,507264,Fargason; Sharon Gayle,8,0,26,18
1714644125923,EDS 128B,A01,507293,Pappas; Elizabeth,12,0,30,18
1714644126948,EDS 139,A00,507294,Fargason; Sharon Gayle,13,0,30,17
1714644126948,EDS 139,B00,507313,Pappas; Elizabeth,13,0,30,17
1714644127972,EDS 201,A00,507315,Staff,13,0,30,17
1714644129002,EDS 203,A01,507317,Halter; Christopher P.,12,0,30,18
1714644130027,EDS 204R,A01,507319,Halter; Christopher P.,0,3,30,30
1714644130027,EDS 204R,B01,507331,Heinzman; Erica M.,16,0,30,14
1714644131058,EDS 206R,A00,507332,Staff,0,4,30,30
1714644131058,EDS 206R,B00,507343,Staff,17,0,30,13
1714644132088,EDS 250,A00,507344,Hemans; Patricia Ann Benitez,22,0,40,18
1714644133114,EDS 281,A00,507345,Daly; Alan J.,18,0,18,0
1714644134142,EDS 284,A00,507350,Daly; Alan J.,16,0,16,0
1714644135171,EDS 286,A00,507359,Fine; Sarah,18,0,18,0
1714644136195,EDS 289C,A01,507361,Daly; Alan J.,18,0,18,0
1714644137222,EDS 290,A00,507366,Hofstetter; Carolyn,15,0,15,0
1714644138252,LIGM 5A,A00,507421,Fischer-Grunski; Eva K,18,0,20,2
1714644139281,LIGM 5B,A00,507423,Fischer-Grunski; Eva K,19,0,20,1
1714644140308,LIGM 5C,A00,507425,Fischer-Grunski; Eva K,19,0,20,1
1714644141333,LIIT 5AS,A00,507427,Carnelos; Chiara,20,0,20,0
1714644142356,LIIT 5BS,A00,507430,Carnelos; Chiara,20,0,20,0
1714644143385,LIIT 5CS,A00,507432,Carnelos; Chiara,20,0,20,0
1714644144412,LISP 5A,A00,507541,Munoz Sanchez; Alicia,11,0,20,9
1714644145440,LISP 5B,A00,507671,Munoz Sanchez; Alicia,8,0,20,12
1714644146464,LISP 5C,A00,507696,Munoz Sanchez; Alicia,9,0,20,11
1714644147490,MAE 197,001,528363,Boechler; Nicholas Sebastia,9998,0,9999,1
1714644148519,MATH 197,001,523477,Kedlaya; Kiran S.,9995,0,9999,4
1714644148519,MATH 197,002,563811,Zhang; Danna,9995,0,9999,4
1714644148519,MATH 197,003,628552,Dumitriu; Ioana,9998,0,9999,1
1714644149545,MCWP 40R,A00,518780,Staff,2,0,20,18
1714644149545,MCWP 40R,B00,518781,Staff,8,0,20,12
1714644149545,MCWP 40R,C00,518783,Staff,6,0,20,14
1714644150572,MCWP 50R,A00,518791,Staff,0,0,20,20
1714644150572,MCWP 50R,B00,518792,Staff,0,2,20,20
1714644150572,MCWP 50R,C00,518793,Staff,0,2,20,20
1714644150572,MCWP 50R,D00,518794,Staff,0,1,20,20
1714644150572,MCWP 50R,E00,518795,Staff,0,2,20,20
1714644150572,MCWP 50R,F00,518796,Staff,0,0,20,20
1714644150572,MCWP 50R,G00,518797,Staff,0,1,20,20
1714644151598,MMW 12R,A01,514034,Herbst; Matthew,0,0,16,16
1714644151598,MMW 12R,A02,514035,Herbst; Matthew,1,0,16,15
1714644152628,MMW 13R,A01,514037,Staff,0,4,16,16
1714644152628,MMW 13R,A02,514039,Staff,0,2,16,16
1714644152628,MMW 13R,A03,628519,Staff,0,2,16,16
1714644154683,SIO 295LS,A00,523233,Staff,10,0,30,20
1714644155713,SIO 295S,A00,523232,Staff,10,0,30,20
1714644156739,SIOC 290S,A01,637330,Merrifield; Mark A,23,0,30,7
1714644157767,SIOC 291S,A01,637333,Gabriel; Corey John,23,0,30,7
1714644158793,SOCI 117,A01,494376,Staff,0,4,5,5
1714644159820,WES 237B,A00,494380,Staff,9,0,20,11
1714644161896,AESE 279B,A00,494370,Wade; Jon P,0,0,33,33
1714644162924,AIP 197,001,627712,Vespa; Emanuel Ignacio,9998,0,9999,1
1714644163954,ANAR 135S,A00,494369,Braswell; Geoffrey E.,0,0,0,0
1714644164981,BENG 196,001,628496,Engler; Adam J.,9998,0,9999,1
1714644166005,CAT 124RS,A01,519847,Geibel; William,0,0,20,20
1714644167032,CAT 125RS,A01,515971,Geibel; William,0,0,20,20
1714644168059,CLRE 250,A00,511389,Morris; Sheldon,9993,0,9999,6
1714644169091,CLRE 251,A00,507176,Mehta; Ravindra L.,9993,0,9999,6
1714644169091,CLRE 251,B00,511410,Mehta; Ravindra L.,9998,0,9999,1
1714644170121,CLRE 252,A00,507189,Cuomo; Raphael Eduardo,9995,0,9999,4
1714644171153,CLRE 253,A00,507199,Vaida; Florin,9994,0,9999,5
1714644171153,CLRE 253,B00,507202,Vaida; Florin,9999,0,9999,0
1714644172181,CLRE 259,A00,507211,Patel; Hemal,9996,0,9999,3
1714644173208,CLRE 260,A00,507221,Cuomo; Raphael Eduardo,9999,0,9999,0
1714644174289,CLRE 297,001,507242,Cuomo; Raphael Eduardo,9999,0,9999,0
1714644175318,COGS 197,001,638244,Voytek; Bradley Thomas,9998,0,9999,1
1714644176344,CSE 191,A00,516875,Minnes Kemp; Mor Mia,9992,0,9999,7
1714644177373,CSE 197,001,637388,Minnes Kemp; Mor Mia,9998,0,9999,1
1714644178399,CSS 201S,A01,494383,Staff,35,0,35,0
1714644179427,CSS 202S,A01,494387,Staff,35,0,35,0
1714644180453,DSC 197,001,628532,Eldridge; Justin Matthew,9996,0,9999,3
1714644181480,EAP 100,A00,516065,Staff,9797,0,9999,202
1714644182520,ECE 45,A01,507414,Staff,33,0,60,27
1714644184573,ECE 111,A01,507420,Staff,15,0,50,35
1714644185599,ECE 197,001,548057,Sievenpiper; Daniel F.,9993,0,9999,6
1714644186641,EDS 115,A00,507243,Choi; Bailey Miyeon,10,0,28,18
1714644187672,EDS 117,A01,494379,Staff,0,4,30,30
1714644188698,EDS 125,A00,507246,Hopkins; Megan Beth,9,0,30,21
1714644189725,EDS 128A,A01,507264,Fargason; Sharon Gayle,8,0,26,18
1714644190754,EDS 128B,A01,507293,Pappas; Elizabeth,12,0,30,18
1714644191780,EDS 139,A00,507294,Fargason; Sharon Gayle,13,0,30,17
1714644191780,EDS 139,B00,507313,Pappas; Elizabeth,13,0,30,17
1714644192805,EDS 201,A00,507315,Staff,13,0,30,17
1714644193836,EDS 203,A01,507317,Halter; Christopher P.,12,0,30,18
1714644194866,EDS 204R,A01,507319,Halter; Christopher P.,0,3,30,30
1714644194866,EDS 204R,B01,507331,Heinzman; Erica M.,16,0,30,14
1714644195892,EDS 206R,A00,507332,Staff,0,4,30,30
1714644195892,EDS 206R,B00,507343,Staff,17,0,30,13
1714644196921,EDS 250,A00,507344,Hemans; Patricia Ann Benitez,22,0,40,18
1714644197945,EDS 281,A00,507345,Daly; Alan J.,18,0,18,0
1714644198971,EDS 284,A00,507350,Daly; Alan J.,16,0,16,0
1714644200001,EDS 286,A00,507359,Fine; Sarah,18,0,18,0
1714644201027,EDS 289C,A01,507361,Daly; Alan J.,18,0,18,0
1714644202053,EDS 290,A00,507366,Hofstetter; Carolyn,15,0,15,0
1714644203080,LIGM 5A,A00,507421,Fischer-Grunski; Eva K,18,0,20,2
1714644204107,LIGM 5B,A00,507423,Fischer-Grunski; Eva K,19,0,20,1
1714644205133,LIGM 5C,A00,507425,Fischer-Grunski; Eva K,19,0,20,1
1714644206159,LIIT 5AS,A00,507427,Carnelos; Chiara,20,0,20,0
1714644207188,LIIT 5BS,A00,507430,Carnelos; Chiara,20,0,20,0
1714644208217,LIIT 5CS,A00,507432,Carnelos; Chiara,20,0,20,0
1714644209242,LISP 5A,A00,507541,Munoz Sanchez; Alicia,11,0,20,9
1714644210266,LISP 5B,A00,507671,Munoz Sanchez; Alicia,8,0,20,12
1714644211293,LISP 5C,A00,507696,Munoz Sanchez; Alicia,9,0,20,11
1714644212318,MAE 197,001,528363,Boechler; Nicholas Sebastia,9998,0,9999,1
1714644213350,MATH 197,001,523477,Kedlaya; Kiran S.,9995,0,9999,4
1714644213350,MATH 197,002,563811,Zhang; Danna,9995,0,9999,4
1714644213350,MATH 197,003,628552,Dumitriu; Ioana,9998,0,9999,1
1714644214376,MCWP 40R,A00,518780,Staff,2,0,20,18
1714644214376,MCWP 40R,B00,518781,Staff,8,0,20,12
1714644214376,MCWP 40R,C00,518783,Staff,6,0,20,14
1714644215405,MCWP 50R,A00,518791,Staff,0,0,20,20
1714644215405,MCWP 50R,B00,518792,Staff,0,2,20,20
1714644215405,MCWP 50R,C00,518793,Staff,0,2,20,20
1714644215405,MCWP 50R,D00,518794,Staff,0,1,20,20
1714644215405,MCWP 50R,E00,518795,Staff,0,2,20,20
1714644215405,MCWP 50R,F00,518796,Staff,0,0,20,20
1714644215405,MCWP 50R,G00,518797,Staff,0,1,20,20
1714644216442,MMW 12R,A01,514034,Herbst; Matthew,0,0,16,16
1714644216442,MMW 12R,A02,514035,Herbst; Matthew,1,0,16,15
1714644217471,MMW 13R,A01,514037,Staff,0,4,16,16
1714644217471,MMW 13R,A02,514039,Staff,0,2,16,16
1714644217471,MMW 13R,A03,628519,Staff,0,2,16,16
1714644219530,SIO 295LS,A00,523233,Staff,10,0,30,20
1714644220555,SIO 295S,A00,523232,Staff,10,0,30,20
1714644221587,SIOC 290S,A01,637330,Merrifield; Mark A,23,0,30,7
1714644222617,SIOC 291S,A01,637333,Gabriel; Corey John,23,0,30,7
1714644223644,SOCI 117,A01,494376,Staff,0,4,5,5
1714644224672,WES 237B,A00,494380,Staff,9,0,20,11
1714644226756,AESE 279B,A00,494370,Wade; Jon P,0,0,33,33
1714644227784,AIP 197,001,627712,Vespa; Emanuel Ignacio,9998,0,9999,1
1714644228812,ANAR 135S,A00,494369,Braswell; Geoffrey E.,0,0,0,0
1714644229838,BENG 196,001,628496,Engler; Adam J.,9998,0,9999,1
1714644230867,CAT 124RS,A01,519847,Geibel; William,0,0,20,20
1714644231895,CAT 125RS,A01,515971,Geibel; William,0,0,20,20
1714644232925,CLRE 250,A00,511389,Morris; Sheldon,9993,0,9999,6
1714644233951,CLRE 251,A00,507176,Mehta; Ravindra L.,9993,0,9999,6
1714644233951,CLRE 251,B00,511410,Mehta; Ravindra L.,9998,0,9999,1
1714644234981,CLRE 252,A00,507189,Cuomo; Raphael Eduardo,9995,0,9999,4
1714644236008,CLRE 253,A00,507199,Vaida; Florin,9994,0,9999,5
1714644236008,CLRE 253,B00,507202,Vaida; Florin,9999,0,9999,0
1714644237039,CLRE 259,A00,507211,Patel; Hemal,9996,0,9999,3
1714644238067,CLRE 260,A00,507221,Cuomo; Raphael Eduardo,9999,0,9999,0
1714644239092,CLRE 297,001,507242,Cuomo; Raphael Eduardo,9999,0,9999,0
1714644240118,COGS 197,001,638244,Voytek; Bradley Thomas,9998,0,9999,1
1714644241142,CSE 191,A00,516875,Minnes Kemp; Mor Mia,9992,0,9999,7
1714644242168,CSE 197,001,637388,Minnes Kemp; Mor Mia,9998,0,9999,1
1714644243195,CSS 201S,A01,494383,Staff,35,0,35,0
1714644244225,CSS 202S,A01,494387,Staff,35,0,35,0
1714644245255,DSC 197,001,628532,Eldridge; Justin Matthew,9996,0,9999,3
1714644246282,EAP 100,A00,516065,Staff,9797,0,9999,202
1714644247309,ECE 45,A01,507414,Staff,33,0,60,27
1714644249365,ECE 111,A01,507420,Staff,15,0,50,35
1714644250447,ECE 197,001,548057,Sievenpiper; Daniel F.,9993,0,9999,6
1714644251477,EDS 115,A00,507243,Choi; Bailey Miyeon,10,0,28,18
1714644252514,EDS 117,A01,494379,Staff,0,4,30,30
1714644253542,EDS 125,A00,507246,Hopkins; Megan Beth,9,0,30,21
1714644254570,EDS 128A,A01,507264,Fargason; Sharon Gayle,8,0,26,18
1714644255596,EDS 128B,A01,507293,Pappas; Elizabeth,12,0,30,18
1714644256622,EDS 139,A00,507294,Fargason; Sharon Gayle,13,0,30,17
1714644256622,EDS 139,B00,507313,Pappas; Elizabeth,13,0,30,17
1714644257646,EDS 201,A00,507315,Staff,13,0,30,17
1714644258671,EDS 203,A01,507317,Halter; Christopher P.,12,0,30,18
1714644259699,EDS 204R,A01,507319,Halter; Christopher P.,0,3,30,30
1714644259699,EDS 204R,B01,507331,Heinzman; Erica M.,16,0,30,14
1714644260728,EDS 206R,A00,507332,Staff,0,4,30,30
1714644260728,EDS 206R,B00,507343,Staff,17,0,30,13
1714644261756,EDS 250,A00,507344,Hemans; Patricia Ann Benitez,22,0,40,18
1714644262787,EDS 281,A00,507345,Daly; Alan J.,18,0,18,0
1714644263815,EDS 284,A00,507350,Daly; Alan J.,16,0,16,0
1714644264844,EDS 286,A00,507359,Fine; Sarah,18,0,18,0
1714644265871,EDS 289C,A01,507361,Daly; Alan J.,18,0,18,0
1714644266900,EDS 290,A00,507366,Hofstetter; Carolyn,15,0,15,0
1714644267926,LIGM 5A,A00,507421,Fischer-Grunski; Eva K,18,0,20,2
1714644268953,LIGM 5B,A00,507423,Fischer-Grunski; Eva K,19,0,20,1
1714644269981,LIGM 5C,A00,507425,Fischer-Grunski; Eva K,19,0,20,1
1714644271011,LIIT 5AS,A00,507427,Carnelos; Chiara,20,0,20,0
1714644272035,LIIT 5BS,A00,507430,Carnelos; Chiara,20,0,20,0
1714644273066,LIIT 5CS,A00,507432,Carnelos; Chiara,20,0,20,0
1714644274094,LISP 5A,A00,507541,Munoz Sanchez; Alicia,11,0,20,9
1714644275122,LISP 5B,A00,507671,Munoz Sanchez; Alicia,8,0,20,12
1714644276147,LISP 5C,A00,507696,Munoz Sanchez; Alicia,9,0,20,11
1714644277175,MAE 197,001,528363,Boechler; Nicholas Sebastia,9998,0,9999,1
1714644278206,MATH 197,001,523477,Kedlaya; Kiran S.,9995,0,9999,4
1714644278206,MATH 197,002,563811,Zhang; Danna,9995,0,9999,4
1714644278206,MATH 197,003,628552,Dumitriu; Ioana,9998,0,9999,1
1714644279290,MCWP 40R,A00,518780,Staff,2,0,20,18
1714644279290,MCWP 40R,B00,518781,Staff,8,0,20,12
1714644279290,MCWP 40R,C00,518783,Staff,6,0,20,14
1714644280316,MCWP 50R,A00,518791,Staff,0,0,20,20
1714644280316,MCWP 50R,B00,518792,Staff,0,2,20,20
1714644280316,MCWP 50R,C00,518793,Staff,0,2,20,20
1714644280316,MCWP 50R,D00,518794,Staff,0,1,20,20
1714644280316,MCWP 50R,E00,518795,Staff,0,2,20,20
1714644280316,MCWP 50R,F00,518796,Staff,0,0,20,20
1714644280316,MCWP 50R,G00,518797,Staff,0,1,20,20
1714644281344,MMW 12R,A01,514034,Herbst; Matthew,0,0,16,16
1714644281344,MMW 12R,A02,514035,Herbst; Matthew,1,0,16,15
1714644282369,MMW 13R,A01,514037,Staff,0,4,16,16
1714644282369,MMW 13R,A02,514039,Staff,0,2,16,16
1714644282369,MMW 13R,A03,628519,Staff,0,2,16,16
1714644284420,SIO 295LS,A00,523233,Staff,10,0,30,20
1714644285444,SIO 295S,A00,523232,Staff,10,0,30,20
1714644286474,SIOC 290S,A01,637330,Merrifield; Mark A,23,0,30,7
1714644287503,SIOC 291S,A01,637333,Gabriel; Corey John,23,0,30,7
1714644288533,SOCI 117,A01,494376,Staff,0,4,5,5
1714644289560,WES 237B,A00,494380,Staff,9,0,20,11
1714644291643,AESE 279B,A00,494370,Wade; Jon P,0,0,33,33
1714644292674,AIP 197,001,627712,Vespa; Emanuel Ignacio,9998,0,9999,1
1714644293704,ANAR 135S,A00,494369,Braswell; Geoffrey E.,0,0,0,0
1714644294728,BENG 196,001,628496,Engler; Adam J.,9998,0,9999,1
1714644295754,CAT 124RS,A01,519847,Geibel; William,0,0,20,20
1714644296781,CAT 125RS,A01,515971,Geibel; William,0,0,20,20
1714644297806,CLRE 250,A00,511389,Morris; Sheldon,9993,0,9999,6
1714644298838,CLRE 251,A00,507176,Mehta; Ravindra L.,9993,0,9999,6
1714644298838,CLRE 251,B00,511410,Mehta; Ravindra L.,9998,0,9999,1
1714644299866,CLRE 252,A00,507189,Cuomo; Raphael Eduardo,9995,0,9999,4
1714644300895,CLRE 253,A00,507199,Vaida; Florin,9994,0,9999,5
1714644300895,CLRE 253,B00,507202,Vaida; Florin,9999,0,9999,0
1714644301924,CLRE 259,A00,507211,Patel; Hemal,9996,0,9999,3
1714644302948,CLRE 260,A00,507221,Cuomo; Raphael Eduardo,9999,0,9999,0
1714644303974,CLRE 297,001,507242,Cuomo; Raphael Eduardo,9999,0,9999,0
1714644305001,COGS 197,001,638244,Voytek; Bradley Thomas,9998,0,9999,1
1714644306029,CSE 191,A00,516875,Minnes Kemp; Mor Mia,9992,0,9999,7
1714644307053,CSE 197,001,637388,Minnes Kemp; Mor Mia,9998,0,9999,1
1714644308086,CSS 201S,A01,494383,Staff,35,0,35,0
1714644309114,CSS 202S,A01,494387,Staff,35,0,35,0
1714644310142,DSC 197,001,628532,Eldridge; Justin Matthew,9996,0,9999,3
1714644311186,EAP 100,A00,516065,Staff,9797,0,9999,202
1714644312218,ECE 45,A01,507414,Staff,33,0,60,27
1714644314304,ECE 111,A01,507420,Staff,15,0,50,35
1714644315329,ECE 197,001,548057,Sievenpiper; Daniel F.,9993,0,9999,6
1714644316357,EDS 115,A00,507243,Choi; Bailey Miyeon,10,0,28,18
1714644317389,EDS 117,A01,494379,Staff,0,4,30,30
1714644318415,EDS 125,A00,507246,Hopkins; Megan Beth,9,0,30,21
1714644319442,EDS 128A,A01,507264,Fargason; Sharon Gayle,8,0,26,18
1714644320471,EDS 128B,A01,507293,Pappas; Elizabeth,12,0,30,18
1714644321496,EDS 139,A00,507294,Fargason; Sharon Gayle,13,0,30,17
1714644321496,EDS 139,B00,507313,Pappas; Elizabeth,13,0,30,17
1714644322520,EDS 201,A00,507315,Staff,13,0,30,17
1714644323547,EDS 203,A01,507317,Halter; Christopher P.,12,0,30,18
1714644324573,EDS 204R,A01,507319,Halter; Christopher P.,0,3,30,30
1714644324573,EDS 204R,B01,507331,Heinzman; Erica M.,16,0,30,14
1714644325597,EDS 206R,A00,507332,Staff,0,4,30,30
1714644325597,EDS 206R,B00,507343,Staff,17,0,30,13
1714644326627,EDS 250,A00,507344,Hemans; Patricia Ann Benitez,22,0,40,18
1714644327652,EDS 281,A00,507345,Daly; Alan J.,18,0,18,0
1714644328679,EDS 284,A00,507350,Daly; Alan J.,16,0,16,0
1714644329704,EDS 286,A00,507359,Fine; Sarah,18,0,18,0
1714644330734,EDS 289C,A01,507361,Daly; Alan J.,18,0,18,0
1714644331773,EDS 290,A00,507366,Hofstetter; Carolyn,15,0,15,0
1714644332805,LIGM 5A,A00,507421,Fischer-Grunski; Eva K,18,0,20,2
1714644333835,LIGM 5B,A00,507423,Fischer-Grunski; Eva K,19,0,20,1
1714644334860,LIGM 5C,A00,507425,Fischer-Grunski; Eva K,19,0,20,1
1714644335886,LIIT 5AS,A00,507427,Carnelos; Chiara,20,0,20,0
1714644336911,LIIT 5BS,A00,507430,Carnelos; Chiara,20,0,20,0
1714644337940,LIIT 5CS,A00,507432,Carnelos; Chiara,20,0,20,0
1714644338967,LISP 5A,A00,507541,Munoz Sanchez; Alicia,11,0,20,9
1714644339995,LISP 5B,A00,507671,Munoz Sanchez; Alicia,8,0,20,12
1714644341023,LISP 5C,A00,507696,Munoz Sanchez; Alicia,9,0,20,11
1714644342051,MAE 197,001,528363,Boechler; Nicholas Sebastia,9998,0,9999,1
1714644343079,MATH 197,001,523477,Kedlaya; Kiran S.,9995,0,9999,4
1714644343079,MATH 197,002,563811,Zhang; Danna,9995,0,9999,4
1714644343079,MATH 197,003,628552,Dumitriu; Ioana,9998,0,9999,1
1714644344107,MCWP 40R,A00,518780,Staff,2,0,20,18
1714644344107,MCWP 40R,B00,518781,Staff,8,0,20,12
1714644344107,MCWP 40R,C00,518783,Staff,6,0,20,14
1714644345134,MCWP 50R,A00,518791,Staff,0,0,20,20
1714644345134,MCWP 50R,B00,518792,Staff,0,2,20,20
1714644345134,MCWP 50R,C00,518793,Staff,0,2,20,20
1714644345134,MCWP 50R,D00,518794,Staff,0,1,20,20
1714644345134,MCWP 50R,E00,518795,Staff,0,2,20,20
1714644345134,MCWP 50R,F00,518796,Staff,0,0,20,20
1714644345134,MCWP 50R,G00,518797,Staff,0,1,20,20
1714644346164,MMW 12R,A01,514034,Herbst; Matthew,0,0,16,16
1714644346164,MMW 12R,A02,514035,Herbst; Matthew,1,0,16,15
1714644347192,MMW 13R,A01,514037,Staff,0,4,16,16
1714644347192,MMW 13R,A02,514039,Staff,0,2,16,16
1714644347192,MMW 13R,A03,628519,Staff,0,2,16,16
1714644349248,SIO 295LS,A00,523233,Staff,10,0,30,20
1714644350277,SIO 295S,A00,523232,Staff,10,0,30,20
1714644351306,SIOC 290S,A01,637330,Merrifield; Mark A,23,0,30,7
1714644352334,SIOC 291S,A01,637333,Gabriel; Corey John,23,0,30,7
1714644353363,SOCI 117,A01,494376,Staff,0,4,5,5
1714644354390,WES 237B,A00,494380,Staff,9,0,20,11
1714644356469,AESE 279B,A00,494370,Wade; Jon P,0,0,33,33
1714644357495,AIP 197,001,627712,Vespa; Emanuel Ignacio,9998,0,9999,1
1714644358525,ANAR 135S,A00,494369,Braswell; Geoffrey E.,0,0,0,0
1714644359551,BENG 196,001,628496,Engler; Adam J.,9998,0,9999,1
1714644360577,CAT 124RS,A01,519847,Geibel; William,0,0,20,20
1714644361604,CAT 125RS,A01,515971,Geibel; William,0,0,20,20
1714644362638,CLRE 250,A00,511389,Morris; Sheldon,9993,0,9999,6
1714644363672,CLRE 251,A00,507176,Mehta; Ravindra L.,9993,0,9999,6
1714644363672,CLRE 251,B00,511410,Mehta; Ravindra L.,9998,0,9999,1
1714644364698,CLRE 252,A00,507189,Cuomo; Raphael Eduardo,9995,0,9999,4
1714644365729,CLRE 253,A00,507199,Vaida; Florin,9994,0,9999,5
1714644365729,CLRE 253,B00,507202,Vaida; Florin,9999,0,9999,0
1714644366757,CLRE 259,A00,507211,Patel; Hemal,9996,0,9999,3
1714644367781,CLRE 260,A00,507221,Cuomo; Raphael Eduardo,9999,0,9999,0
1714644368809,CLRE 297,001,507242,Cuomo; Raphael Eduardo,9999,0,9999,0
1714644369835,COGS 197,001,638244,Voytek; Bradley Thomas,9998,0,9999,1
1714644370859,CSE 191,A00,516875,Minnes Kemp; Mor Mia,9992,0,9999,7
1714644371888,CSE 197,001,637388,Minnes Kemp; Mor Mia,9998,0,9999,1
1714644372920,CSS 201S,A01,494383,Staff,35,0,35,0
1714644373951,CSS 202S,A01,494387,Staff,35,0,35,0
1714644374982,DSC 197,001,628532,Eldridge; Justin Matthew,9996,0,9999,3
1714644376006,EAP 100,A00,516065,Staff,9797,0,9999,202
1714644377056,ECE 45,A01,507414,Staff,33,0,60,27
1714644379119,ECE 111,A01,507420,Staff,15,0,50,35
1714644380146,ECE 197,001,548057,Sievenpiper; Daniel F.,9993,0,9999,6
1714644381177,EDS 115,A00,507243,Choi; Bailey Miyeon,10,0,28,18
1714644382203,EDS 117,A01,494379,Staff,0,4,30,30
1714644383233,EDS 125,A00,507246,Hopkins; Megan Beth,9,0,30,21
1714644384263,EDS 128A,A01,507264,Fargason; Sharon Gayle,8,0,26,18
1714644385287,EDS 128B,A01,507293,Pappas; Elizabeth,12,0,30,18
1714644386315,EDS 139,A00,507294,Fargason; Sharon Gayle,13,0,30,17
1714644386315,EDS 139,B00,507313,Pappas; Elizabeth,13,0,30,17
1714644387340,EDS 201,A00,507315,Staff,13,0,30,17
1714644388366,EDS 203,A01,507317,Halter; Christopher P.,12,0,30,18
1714644389398,EDS 204R,A01,507319,Halter; Christopher P.,0,3,30,30
1714644389398,EDS 204R,B01,507331,Heinzman; Erica M.,16,0,30,14
1714644390423,EDS 206R,A00,507332,Staff,0,4,30,30
1714644390423,EDS 206R,B00,507343,Staff,17,0,30,13
1714644391450,EDS 250,A00,507344,Hemans; Patricia Ann Benitez,22,0,40,18
1714644392475,EDS 281,A00,507345,Daly; Alan J.,18,0,18,0
1714644393502,EDS 284,A00,507350,Daly; Alan J.,16,0,16,0
1714644394528,EDS 286,A00,507359,Fine; Sarah,18,0,18,0
1714644395553,EDS 289C,A01,507361,Daly; Alan J.,18,0,18,0
1714644396576,EDS 290,A00,507366,Hofstetter; Carolyn,15,0,15,0
1714644397602,LIGM 5A,A00,507421,Fischer-Grunski; Eva K,18,0,20,2
1714644398630,LIGM 5B,A00,507423,Fischer-Grunski; Eva K,19,0,20,1
1714644399670,LIGM 5C,A00,507425,Fischer-Grunski; Eva K,19,0,20,1
1714644400701,LIIT 5AS,A00,507427,Carnelos; Chiara,20,0,20,0
1714644401730,LIIT 5BS,A00,507430,Carnelos; Chiara,20,0,20,0
1714644402753,LIIT 5CS,A00,507432,Carnelos; Chiara,20,0,20,0
1714644403778,LISP 5A,A00,507541,Munoz Sanchez; Alicia,11,0,20,9
1714644404803,LISP 5B,A00,507671,Munoz Sanchez; Alicia,8,0,20,12
1714644405829,LISP 5C,A00,507696,Munoz Sanchez; Alicia,9,0,20,11
1714644406857,MAE 197,001,528363,Boechler; Nicholas Sebastia,9998,0,9999,1
1714644407889,MATH 197,001,523477,Kedlaya; Kiran S.,9995,0,9999,4
1714644407889,MATH 197,002,563811,Zhang; Danna,9995,0,9999,4
1714644407889,MATH 197,003,628552,Dumitriu; Ioana,9998,0,9999,1
1714644408915,MCWP 40R,A00,518780,Staff,2,0,20,18
1714644408915,MCWP 40R,B00,518781,Staff,8,0,20,12
1714644408915,MCWP 40R,C00,518783,Staff,6,0,20,14
1714644409943,MCWP 50R,A00,518791,Staff,0,0,20,20
1714644409943,MCWP 50R,B00,518792,Staff,0,2,20,20
1714644409943,MCWP 50R,C00,518793,Staff,0,2,20,20
1714644409943,MCWP 50R,D00,518794,Staff,0,1,20,20
1714644409943,MCWP 50R,E00,518795,Staff,0,2,20,20
1714644409943,MCWP 50R,F00,518796,Staff,0,0,20,20
1714644409943,MCWP 50R,G00,518797,Staff,0,1,20,20
1714644410969,MMW 12R,A01,514034,Herbst; Matthew,0,0,16,16
1714644410969,MMW 12R,A02,514035,Herbst; Matthew,1,0,16,15
1714644411997,MMW 13R,A01,514037,Staff,0,4,16,16
1714644411997,MMW 13R,A02,514039,Staff,0,2,16,16
1714644411997,MMW 13R,A03,628519,Staff,0,2,16,16
1714644414052,SIO 295LS,A00,523233,Staff,10,0,30,20
1714644415076,SIO 295S,A00,523232,Staff,10,0,30,20
1714644416106,SIOC 290S,A01,637330,Merrifield; Mark A,23,0,30,7
1714644417135,SIOC 291S,A01,637333,Gabriel; Corey John,23,0,30,7
1714644418162,SOCI 117,A01,494376,Staff,0,4,5,5
1714644419187,WES 237B,A00,494380,Staff,9,0,20,11
1714644421288,AESE 279B,A00,494370,Wade; Jon P,0,0,33,33
1714644422318,AIP 197,001,627712,Vespa; Emanuel Ignacio,9998,0,9999,1
1714644423344,ANAR 135S,A00,494369,Braswell; Geoffrey E.,0,0,0,0
1714644424369,BENG 196,001,628496,Engler; Adam J.,9998,0,9999,1
1714644425397,CAT 124RS,A01,519847,Geibel; William,0,0,20,20
1714644426425,CAT 125RS,A01,515971,Geibel; William,0,0,20,20
1714644427449,CLRE 250,A00,511389,Morris; Sheldon,9993,0,9999,6
1714644428477,CLRE 251,A00,507176,Mehta; Ravindra L.,9993,0,9999,6
1714644428477,CLRE 251,B00,511410,Mehta; Ravindra L.,9998,0,9999,1
1714644429502,CLRE 252,A00,507189,Cuomo; Raphael Eduardo,9995,0,9999,4
1714644430528,CLRE 253,A00,507199,Vaida; Florin,9994,0,9999,5
1714644430528,CLRE 253,B00,507202,Vaida; Florin,9999,0,9999,0
1714644431553,CLRE 259,A00,507211,Patel; Hemal,9996,0,9999,3
1714644432578,CLRE 260,A00,507221,Cuomo; Raphael Eduardo,9999,0,9999,0
1714644433601,CLRE 297,001,507242,Cuomo; Raphael Eduardo,9999,0,9999,0
1714644434625,COGS 197,001,638244,Voytek; Bradley Thomas,9998,0,9999,1
1714644435654,CSE 191,A00,516875,Minnes Kemp; Mor Mia,9992,0,9999,7
1714644436678,CSE 197,001,637388,Minnes Kemp; Mor Mia,9998,0,9999,1
1714644437708,CSS 201S,A01,494383,Staff,35,0,35,0
1714644438736,CSS 202S,A01,494387,Staff,35,0,35,0
1714644439762,DSC 197,001,628532,Eldridge; Justin Matthew,9996,0,9999,3
1714644440789,EAP 100,A00,516065,Staff,9797,0,9999,202
1714644441866,ECE 45,A01,507414,Staff,33,0,60,27
1714644443917,ECE 111,A01,507420,Staff,15,0,50,35
1714644444946,ECE 197,001,548057,Sievenpiper; Daniel F.,9993,0,9999,6
1714644445976,EDS 115,A00,507243,Choi; Bailey Miyeon,10,0,28,18
1714644447010,EDS 117,A01,494379,Staff,0,4,30,30
1714644448037,EDS 125,A00,507246,Hopkins; Megan Beth,9,0,30,21
1714644449065,EDS 128A,A01,507264,Fargason; Sharon Gayle,8,0,26,18
1714644450090,EDS 128B,A01,507293,Pappas; Elizabeth,12,0,30,18
1714644451118,EDS 139,A00,507294,Fargason; Sharon Gayle,13,0,30,17
1714644451118,EDS 139,B00,507313,Pappas; Elizabeth,13,0,30,17
1714644452143,EDS 201,A00,507315,Staff,13,0,30,17
1714644453173,EDS 203,A01,507317,Halter; Christopher P.,12,0,30,18
1714644454198,EDS 204R,A01,507319,Halter; Christopher P.,0,3,30,30
1714644454198,EDS 204R,B01,507331,Heinzman; Erica M.,16,0,30,14
1714644455222,EDS 206R,A00,507332,Staff,0,4,30,30
1714644455222,EDS 206R,B00,507343,Staff,17,0,30,13
1714644456247,EDS 250,A00,507344,Hemans; Patricia Ann Benitez,22,0,40,18
1714644457277,EDS 281,A00,507345,Daly; Alan J.,18,0,18,0
1714644458302,EDS 284,A00,507350,Daly; Alan J.,16,0,16,0
1714644459329,EDS 286,A00,507359,Fine; Sarah,18,0,18,0
1714644460356,EDS 289C,A01,507361,Daly; Alan J.,18,0,18,0
1714644461381,EDS 290,A00,507366,Hofstetter; Carolyn,15,0,15,0
1714644462408,LIGM 5A,A00,507421,Fischer-Grunski; Eva K,18,0,20,2
1714644463434,LIGM 5B,A00,507423,Fischer-Grunski; Eva K,19,0,20,1
1714644464459,LIGM 5C,A00,507425,Fischer-Grunski; Eva K,19,0,20,1
1714644465483,LIIT 5AS,A00,507427,Carnelos; Chiara,20,0,20,0
1714644466507,LIIT 5BS,A00,507430,Carnelos; Chiara,20,0,20,0
1714644467536,LIIT 5CS,A00,507432,Carnelos; Chiara,20,0,20,0
1714644468562,LISP 5A,A00,507541,Munoz Sanchez; Alicia,11,0,20,9
1714644469589,LISP 5B,A00,507671,Munoz Sanchez; Alicia,8,0,20,12
1714644470616,LISP 5C,A00,507696,Munoz Sanchez; Alicia,9,0,20,11
1714644471642,MAE 197,001,528363,Boechler; Nicholas Sebastia,9998,0,9999,1
1714644472669,MATH 197,001,523477,Kedlaya; Kiran S.,9995,0,9999,4
1714644472669,MATH 197,002,563811,Zhang; Danna,9995,0,9999,4
1714644472669,MATH 197,003,628552,Dumitriu; Ioana,9998,0,9999,1
1714644473694,MCWP 40R,A00,518780,Staff,2,0,20,18
1714644473694,MCWP 40R,B00,518781,Staff,8,0,20,12
1714644473694,MCWP 40R,C00,518783,Staff,6,0,20,14
1714644474720,MCWP 50R,A00,518791,Staff,0,0,20,20
1714644474720,MCWP 50R,B00,518792,Staff,0,2,20,20
1714644474720,MCWP 50R,C00,518793,Staff,0,2,20,20
1714644474720,MCWP 50R,D00,518794,Staff,0,1,20,20
1714644474720,MCWP 50R,E00,518795,Staff,0,2,20,20
1714644474720,MCWP 50R,F00,518796,Staff,0,0,20,20
1714644474720,MCWP 50R,G00,518797,Staff,0,1,20,20
1714644475747,MMW 12R,A01,514034,Herbst; Matthew,0,0,16,16
1714644475747,MMW 12R,A02,514035,Herbst; Matthew,1,0,16,15
1714644476772,MMW 13R,A01,514037,Staff,0,4,16,16
1714644476772,MMW 13R,A02,514039,Staff,0,2,16,16
1714644476772,MMW 13R,A03,628519,Staff,0,2,16,16
1714644478823,SIO 295LS,A00,523233,Staff,10,0,30,20
1714644479847,SIO 295S,A00,523232,Staff,10,0,30,20
1714644480874,SIOC 290S,A01,637330,Merrifield; Mark A,23,0,30,7
1714644481898,SIOC 291S,A01,637333,Gabriel; Corey John,23,0,30,7
1714644482924,SOCI 117,A01,494376,Staff,0,4,5,5
1714644483950,WES 237B,A00,494380,Staff,9,0,20,11
1714644486019,AESE 279B,A00,494370,Wade; Jon P,0,0,33,33
1714644487045,AIP 197,001,627712,Vespa; Emanuel Ignacio,9998,0,9999,1
1714644488073,ANAR 135S,A00,494369,Braswell; Geoffrey E.,0,0,0,0
1714644489101,BENG 196,001,628496,Engler; Adam J.,9998,0,9999,1
1714644490127,CAT 124RS,A01,519847,Geibel; William,0,0,20,20
1714644491152,CAT 125RS,A01,515971,Geibel; William,0,0,20,20
1714644492181,CLRE 250,A00,511389,Morris; Sheldon,9993,0,9999,6
1714644493213,CLRE 251,A00,507176,Mehta; Ravindra L.,9993,0,9999,6
1714644493213,CLRE 251,B00,511410,Mehta; Ravindra L.,9998,0,9999,1
1714644494238,CLRE 252,A00,507189,Cuomo; Raphael Eduardo,9995,0,9999,4
1714644495266,CLRE 253,A00,507199,Vaida; Florin,9994,0,9999,5
1714644495266,CLRE 253,B00,507202,Vaida; Florin,9999,0,9999,0
1714644496291,CLRE 259,A00,507211,Patel; Hemal,9996,0,9999,3
1714644497314,CLRE 260,A00,507221,Cuomo; Raphael Eduardo,9999,0,9999,0
1714644498338,CLRE 297,001,507242,Cuomo; Raphael Eduardo,9999,0,9999,0
1714644499363,COGS 197,001,638244,Voytek; Bradley Thomas,9998,0,9999,1
1714644500389,CSE 191,A00,516875,Minnes Kemp; Mor Mia,9992,0,9999,7
1714644501415,CSE 197,001,637388,Minnes Kemp; Mor Mia,9998,0,9999,1
1714644502441,CSS 201S,A01,494383,Staff,35,0,35,0
1714644503467,CSS 202S,A01,494387,Staff,35,0,35,0
1714644504492,DSC 197,001,628532,Eldridge; Justin Matthew,9996,0,9999,3
1714644505515,EAP 100,A00,516065,Staff,9797,0,9999,202
1714644506544,ECE 45,A01,507414,Staff,33,0,60,27
1714644508612,ECE 111,A01,507420,Staff,15,0,50,35
1714644509640,ECE 197,001,548057,Sievenpiper; Daniel F.,9993,0,9999,6
1714644510668,EDS 115,A00,507243,Choi; Bailey Miyeon,10,0,28,18
1714644511697,EDS 117,A01,494379,Staff,0,4,30,30
1714644512722,EDS 125,A00,507246,Hopkins; Megan Beth,9,0,30,21
1714644513746,EDS 128A,A01,507264,Fargason; Sharon Gayle,8,0,26,18
1714644514772,EDS 128B,A01,507293,Pappas; Elizabeth,12,0,30,18
1714644515798,EDS 139,A00,507294,Fargason; Sharon Gayle,13,0,30,17
1714644515798,EDS 139,B00,507313,Pappas; Elizabeth,13,0,30,17
1714644516822,EDS 201,A00,507315,Staff,13,0,30,17
1714644517853,EDS 203,A01,507317,Halter; Christopher P.,12,0,30,18
1714644518878,EDS 204R,A01,507319,Halter; Christopher P.,0,3,30,30
1714644518878,EDS 204R,B01,507331,Heinzman; Erica M.,16,0,30,14
1714644519905,EDS 206R,A00,507332,Staff,0,4,30,30
1714644519905,EDS 206R,B00,507343,Staff,17,0,30,13
1714644520929,EDS 250,A00,507344,Hemans; Patricia Ann Benitez,22,0,40,18
1714644521953,EDS 281,A00,507345,Daly; Alan J.,18,0,18,0
1714644522981,EDS 284,A00,507350,Daly; Alan J.,16,0,16,0
1714644524007,EDS 286,A00,507359,Fine; Sarah,18,0,18,0
1714644525032,EDS 289C,A01,507361,Daly; Alan J.,18,0,18,0
1714644526061,EDS 290,A00,507366,Hofstetter; Carolyn,15,0,15,0
1714644527095,LIGM 5A,A00,507421,Fischer-Grunski; Eva K,18,0,20,2
1714644528120,LIGM 5B,A00,507423,Fischer-Grunski; Eva K,19,0,20,1
1714644529145,LIGM 5C,A00,507425,Fischer-Grunski; Eva K,19,0,20,1
1714644530174,LIIT 5AS,A00,507427,Carnelos; Chiara,20,0,20,0
1714644531200,LIIT 5BS,A00,507430,Carnelos; Chiara,20,0,20,0
1714644532225,LIIT 5CS,A00,507432,Carnelos; Chiara,20,0,20,0
1714644533254,LISP 5A,A00,507541,Munoz Sanchez; Alicia,11,0,20,9
1714644534282,LISP 5B,A00,507671,Munoz Sanchez; Alicia,8,0,20,12
1714644535311,LISP 5C,A00,507696,Munoz Sanchez; Alicia,9,0,20,11
1714644536338,MAE 197,001,528363,Boechler; Nicholas Sebastia,9998,0,9999,1
1714644537365,MATH 197,001,523477,Kedlaya; Kiran S.,9995,0,9999,4
1714644537365,MATH 197,002,563811,Zhang; Danna,9995,0,9999,4
1714644537365,MATH 197,003,628552,Dumitriu; Ioana,9998,0,9999,1
1714644538389,MCWP 40R,A00,518780,Staff,2,0,20,18
1714644538389,MCWP 40R,B00,518781,Staff,8,0,20,12
1714644538389,MCWP 40R,C00,518783,Staff,6,0,20,14
1714644539413,MCWP 50R,A00,518791,Staff,0,0,20,20
1714644539413,MCWP 50R,B00,518792,Staff,0,2,20,20
1714644539413,MCWP 50R,C00,518793,Staff,0,2,20,20
1714644539413,MCWP 50R,D00,518794,Staff,0,1,20,20
1714644539413,MCWP 50R,E00,518795,Staff,0,2,20,20
1714644539413,MCWP 50R,F00,518796,Staff,0,0,20,20
1714644539413,MCWP 50R,G00,518797,Staff,0,1,20,20
1714644540439,MMW 12R,A01,514034,Herbst; Matthew,0,0,16,16
1714644540439,MMW 12R,A02,514035,Herbst; Matthew,1,0,16,15
1714644541468,MMW 13R,A01,514037,Staff,0,4,16,16
1714644541468,MMW 13R,A02,514039,Staff,0,2,16,16
1714644541468,MMW 13R,A03,628519,Staff,0,2,16,16
1714644543516,SIO 295LS,A00,523233,Staff,10,0,30,20
1714644544541,SIO 295S,A00,523232,Staff,10,0,30,20
1714644545567,SIOC 290S,A01,637330,Merrifield; Mark A,23,0,30,7
1714644546595,SIOC 291S,A01,637333,Gabriel; Corey John,23,0,30,7
1714644547623,SOCI 117,A01,494376,Staff,0,4,5,5
1714644548653,WES 237B,A00,494380,Staff,9,0,20,11
1714644550734,AESE 279B,A00,494370,Wade; Jon P,0,0,33,33
1714644551758,AIP 197,001,627712,Vespa; Emanuel Ignacio,9998,0,9999,1
1714644552783,ANAR 135S,A00,494369,Braswell; Geoffrey E.,0,0,0,0
1714644553811,BENG 196,001,628496,Engler; Adam J.,9998,0,9999,1
1714644554845,CAT 124RS,A01,519847,Geibel; William,0,0,20,20
1714644555871,CAT 125RS,A01,515971,Geibel; William,0,0,20,20
1714644556899,CLRE 250,A00,511389,Morris; Sheldon,9993,0,9999,6
1714644557924,CLRE 251,A00,507176,Mehta; Ravindra L.,9993,0,9999,6
1714644557924,CLRE 251,B00,511410,Mehta; Ravindra L.,9998,0,9999,1
1714644558951,CLRE 252,A00,507189,Cuomo; Raphael Eduardo,9995,0,9999,4
1714644559979,CLRE 253,A00,507199,Vaida; Florin,9994,0,9999,5
1714644559979,CLRE 253,B00,507202,Vaida; Florin,9999,0,9999,0
1714644561004,CLRE 259,A00,507211,Patel; Hemal,9996,0,9999,3
1714644562032,CLRE 260,A00,507221,Cuomo; Raphael Eduardo,9999,0,9999,0
1714644563061,CLRE 297,001,507242,Cuomo; Raphael Eduardo,9999,0,9999,0
1714644564090,COGS 197,001,638244,Voytek; Bradley Thomas,9998,0,9999,1
1714644565118,CSE 191,A00,516875,Minnes Kemp; Mor Mia,9992,0,9999,7
1714644566145,CSE 197,001,637388,Minnes Kemp; Mor Mia,9998,0,9999,1
1714644567171,CSS 201S,A01,494383,Staff,35,0,35,0
1714644568198,CSS 202S,A01,494387,Staff,35,0,35,0
1714644569224,DSC 197,001,628532,Eldridge; Justin Matthew,9996,0,9999,3
1714644570250,EAP 100,A00,516065,Staff,9797,0,9999,202
1714644571275,ECE 45,A01,507414,Staff,33,0,60,27
1714644573332,ECE 111,A01,507420,Staff,15,0,50,35
1714644574357,ECE 197,001,548057,Sievenpiper; Daniel F.,9993,0,9999,6
1714644575384,EDS 115,A00,507243,Choi; Bailey Miyeon,10,0,28,18
1714644576413,EDS 117,A01,494379,Staff,0,4,30,30
1714644577438,EDS 125,A00,507246,Hopkins; Megan Beth,9,0,30,21
1714644578466,EDS 128A,A01,507264,Fargason; Sharon Gayle,8,0,26,18
1714644579490,EDS 128B,A01,507293,Pappas; Elizabeth,12,0,30,18
1714644580517,EDS 139,A00,507294,Fargason; Sharon Gayle,13,0,30,17
1714644580517,EDS 139,B00,507313,Pappas; Elizabeth,13,0,30,17
1714644581542,EDS 201,A00,507315,Staff,13,0,30,17
1714644582567,EDS 203,A01,507317,Halter; Christopher P.,12,0,30,18
1714644583592,EDS 204R,A01,507319,Halter; Christopher P.,0,3,30,30
1714644583592,EDS 204R,B01,507331,Heinzman; Erica M.,16,0,30,14
1714644584617,EDS 206R,A00,507332,Staff,0,4,30,30
1714644584617,EDS 206R,B00,507343,Staff,17,0,30,13
1714644585643,EDS 250,A00,507344,Hemans; Patricia Ann Benitez,22,0,40,18
1714644586671,EDS 281,A00,507345,Daly; Alan J.,18,0,18,0
1714644587697,EDS 284,A00,507350,Daly; Alan J.,16,0,16,0
1714644588722,EDS 286,A00,507359,Fine; Sarah,18,0,18,0
1714644589748,EDS 289C,A01,507361,Daly; Alan J.,18,0,18,0
1714644590773,EDS 290,A00,507366,Hofstetter; Carolyn,15,0,15,0
1714644591800,LIGM 5A,A00,507421,Fischer-Grunski; Eva K,18,0,20,2
1714644592825,LIGM 5B,A00,507423,Fischer-Grunski; Eva K,19,0,20,1
1714644593866,LIGM 5C,A00,507425,Fischer-Grunski; Eva K,19,0,20,1
1714644594892,LIIT 5AS,A00,507427,Carnelos; Chiara,20,0,20,0
1714644595920,LIIT 5BS,A00,507430,Carnelos; Chiara,20,0,20,0
1714644596946,LIIT 5CS,A00,507432,Carnelos; Chiara,20,0,20,0
1714644597970,LISP 5A,A00,507541,Munoz Sanchez; Alicia,11,0,20,9
1714644598997,LISP 5B,A00,507671,Munoz Sanchez; Alicia,8,0,20,12
1714644600025,LISP 5C,A00,507696,Munoz Sanchez; Alicia,9,0,20,11
1714644601051,MAE 197,001,528363,Boechler; Nicholas Sebastia,9998,0,9999,1
1714644602088,MATH 197,001,523477,Kedlaya; Kiran S.,9995,0,9999,4
1714644602088,MATH 197,002,563811,Zhang; Danna,9995,0,9999,4
1714644602088,MATH 197,003,628552,Dumitriu; Ioana,9998,0,9999,1
1714644603129,MCWP 40R,A00,518780,Staff,2,0,20,18
1714644603129,MCWP 40R,B00,518781,Staff,8,0,20,12
1714644603129,MCWP 40R,C00,518783,Staff,6,0,20,14
1714644604160,MCWP 50R,A00,518791,Staff,0,0,20,20
1714644604160,MCWP 50R,B00,518792,Staff,0,2,20,20
1714644604160,MCWP 50R,C00,518793,Staff,0,2,20,20
1714644604160,MCWP 50R,D00,518794,Staff,0,1,20,20
1714644604160,MCWP 50R,E00,518795,Staff,0,2,20,20
1714644604160,MCWP 50R,F00,518796,Staff,0,0,20,20
1714644604160,MCWP 50R,G00,518797,Staff,0,1,20,20
1714644605188,MMW 12R,A01,514034,Herbst; Matthew,0,0,16,16
1714644605188,MMW 12R,A02,514035,Herbst; Matthew,1,0,16,15
1714644606215,MMW 13R,A01,514037,Staff,0,4,16,16
1714644606215,MMW 13R,A02,514039,Staff,0,2,16,16
1714644606215,MMW 13R,A03,628519,Staff,0,2,16,16
1714644608269,SIO 295LS,A00,523233,Staff,10,0,30,20
1714644609293,SIO 295S,A00,523232,Staff,10,0,30,20
1714644610319,SIOC 290S,A01,637330,Merrifield; Mark A,23,0,30,7
1714644611345,SIOC 291S,A01,637333,Gabriel; Corey John,23,0,30,7
1714644612371,SOCI 117,A01,494376,Staff,0,4,5,5
1714644613395,WES 237B,A00,494380,Staff,9,0,20,11
1714644615468,AESE 279B,A00,494370,Wade; Jon P,0,0,33,33
1714644616497,AIP 197,001,627712,Vespa; Emanuel Ignacio,9998,0,9999,1
1714644617525,ANAR 135S,A00,494369,Braswell; Geoffrey E.,0,0,0,0
1714644618551,BENG 196,001,628496,Engler; Adam J.,9998,0,9999,1
1714644619579,CAT 124RS,A01,519847,Geibel; William,0,0,20,20
1714644620603,CAT 125RS,A01,515971,Geibel; William,0,0,20,20
1714644621630,CLRE 250,A00,511389,Morris; Sheldon,9993,0,9999,6
1714644622658,CLRE 251,A00,507176,Mehta; Ravindra L.,9993,0,9999,6
1714644622658,CLRE 251,B00,511410,Mehta; Ravindra L.,9998,0,9999,1
1714644623688,CLRE 252,A00,507189,Cuomo; Raphael Eduardo,9995,0,9999,4
1714644624719,CLRE 253,A00,507199,Vaida; Florin,9994,0,9999,5
1714644624719,CLRE 253,B00,507202,Vaida; Florin,9999,0,9999,0
1714644625746,CLRE 259,A00,507211,Patel; Hemal,9996,0,9999,3
1714644626773,CLRE 260,A00,507221,Cuomo; Raphael Eduardo,9999,0,9999,0
1714644627800,CLRE 297,001,507242,Cuomo; Raphael Eduardo,9999,0,9999,0
1714644628825,COGS 197,001,638244,Voytek; Bradley Thomas,9998,0,9999,1
1714644629851,CSE 191,A00,516875,Minnes Kemp; Mor Mia,9992,0,9999,7
1714644630877,CSE 197,001,637388,Minnes Kemp; Mor Mia,9998,0,9999,1
1714644631905,CSS 201S,A01,494383,Staff,35,0,35,0
1714644632929,CSS 202S,A01,494387,Staff,35,0,35,0
1714644633953,DSC 197,001,628532,Eldridge; Justin Matthew,9996,0,9999,3
1714644634987,EAP 100,A00,516065,Staff,9797,0,9999,202
1714644636019,ECE 45,A01,507414,Staff,33,0,60,27
1714644638071,ECE 111,A01,507420,Staff,15,0,50,35
1714644639098,ECE 197,001,548057,Sievenpiper; Daniel F.,9993,0,9999,6
1714644640124,EDS 115,A00,507243,Choi; Bailey Miyeon,10,0,28,18
1714644641150,EDS 117,A01,494379,Staff,0,4,30,30
1714644642179,EDS 125,A00,507246,Hopkins; Megan Beth,9,0,30,21
1714644643206,EDS 128A,A01,507264,Fargason; Sharon Gayle,8,0,26,18
1714644644237,EDS 128B,A01,507293,Pappas; Elizabeth,12,0,30,18
1714644645264,EDS 139,A00,507294,Fargason; Sharon Gayle,13,0,30,17
1714644645264,EDS 139,B00,507313,Pappas; Elizabeth,13,0,30,17
1714644646289,EDS 201,A00,507315,Staff,13,0,30,17
1714644647314,EDS 203,A01,507317,Halter; Christopher P.,12,0,30,18
1714644648342,EDS 204R,A01,507319,Halter; Christopher P.,0,3,30,30
1714644648342,EDS 204R,B01,507331,Heinzman; Erica M.,16,0,30,14
1714644649368,EDS 206R,A00,507332,Staff,0,4,30,30
1714644649368,EDS 206R,B00,507343,Staff,17,0,30,13
1714644650397,EDS 250,A00,507344,Hemans; Patricia Ann Benitez,22,0,40,18
1714644651426,EDS 281,A00,507345,Daly; Alan J.,18,0,18,0
1714644652452,EDS 284,A00,507350,Daly; Alan J.,16,0,16,0
1714644653478,EDS 286,A00,507359,Fine; Sarah,18,0,18,0
1714644654505,EDS 289C,A01,507361,Daly; Alan J.,18,0,18,0
1714644655529,EDS 290,A00,507366,Hofstetter; Carolyn,15,0,15,0
1714644656558,LIGM 5A,A00,507421,Fischer-Grunski; Eva K,18,0,20,2
1714644657588,LIGM 5B,A00,507423,Fischer-Grunski; Eva K,19,0,20,1
1714644658612,LIGM 5C,A00,507425,Fischer-Grunski; Eva K,19,0,20,1
1714644659641,LIIT 5AS,A00,507427,Carnelos; Chiara,20,0,20,0
1714644660670,LIIT 5BS,A00,507430,Carnelos; Chiara,20,0,20,0
1714644661695,LIIT 5CS,A00,507432,Carnelos; Chiara,20,0,20,0
1714644662723,LISP 5A,A00,507541,Munoz Sanchez; Alicia,11,0,20,9
1714644663750,LISP 5B,A00,507671,Munoz Sanchez; Alicia,8,0,20,12
1714644664776,LISP 5C,A00,507696,Munoz Sanchez; Alicia,9,0,20,11
1714644665801,MAE 197,001,528363,Boechler; Nicholas Sebastia,9998,0,9999,1
1714644666829,MATH 197,001,523477,Kedlaya; Kiran S.,9995,0,9999,4
1714644666829,MATH 197,002,563811,Zhang; Danna,9995,0,9999,4
1714644666829,MATH 197,003,628552,Dumitriu; Ioana,9998,0,9999,1
1714644667862,MCWP 40R,A00,518780,Staff,2,0,20,18
1714644667862,MCWP 40R,B00,518781,Staff,8,0,20,12
1714644667862,MCWP 40R,C00,518783,Staff,6,0,20,14
1714644668886,MCWP 50R,A00,518791,Staff,0,0,20,20
1714644668886,MCWP 50R,B00,518792,Staff,0,2,20,20
1714644668886,MCWP 50R,C00,518793,Staff,0,2,20,20
1714644668886,MCWP 50R,D00,518794,Staff,0,1,20,20
1714644668886,MCWP 50R,E00,518795,Staff,0,2,20,20
1714644668886,MCWP 50R,F00,518796,Staff,0,0,20,20
1714644668886,MCWP 50R,G00,518797,Staff,0,1,20,20
1714644669915,MMW 12R,A01,514034,Herbst; Matthew,0,0,16,16
1714644669915,MMW 12R,A02,514035,Herbst; Matthew,1,0,16,15
1714644670943,MMW 13R,A01,514037,Staff,0,4,16,16
1714644670943,MMW 13R,A02,514039,Staff,0,2,16,16
1714644670943,MMW 13R,A03,628519,Staff,0,2,16,16
1714644672996,SIO 295LS,A00,523233,Staff,10,0,30,20
1714644674022,SIO 295S,A00,523232,Staff,10,0,30,20
1714644675048,SIOC 290S,A01,637330,Merrifield; Mark A,23,0,30,7
1714644676078,SIOC 291S,A01,637333,Gabriel; Corey John,23,0,30,7
1714644677107,SOCI 117,A01,494376,Staff,0,4,5,5
1714644678132,WES 237B,A00,494380,Staff,9,0,20,11
1714644680219,AESE 279B,A00,494370,Wade; Jon P,0,0,33,33
1714644681244,AIP 197,001,627712,Vespa; Emanuel Ignacio,9998,0,9999,1
1714644682269,ANAR 135S,A00,494369,Braswell; Geoffrey E.,0,0,0,0
1714644683298,BENG 196,001,628496,Engler; Adam J.,9998,0,9999,1
1714644684327,CAT 124RS,A01,519847,Geibel; William,0,0,20,20
1714644685350,CAT 125RS,A01,515971,Geibel; William,0,0,20,20
1714644686378,CLRE 250,A00,511389,Morris; Sheldon,9993,0,9999,6
1714644687406,CLRE 251,A00,507176,Mehta; Ravindra L.,9993,0,9999,6
1714644687406,CLRE 251,B00,511410,Mehta; Ravindra L.,9998,0,9999,1
1714644688435,CLRE 252,A00,507189,Cuomo; Raphael Eduardo,9995,0,9999,4
1714644689465,CLRE 253,A00,507199,Vaida; Florin,9994,0,9999,5
1714644689465,CLRE 253,B00,507202,Vaida; Florin,9999,0,9999,0
1714644690491,CLRE 259,A00,507211,Patel; Hemal,9996,0,9999,3
1714644691516,CLRE 260,A00,507221,Cuomo; Raphael Eduardo,9999,0,9999,0
1714644692543,CLRE 297,001,507242,Cuomo; Raphael Eduardo,9999,0,9999,0
1714644693567,COGS 197,001,638244,Voytek; Bradley Thomas,9998,0,9999,1
1714644694594,CSE 191,A00,516875,Minnes Kemp; Mor Mia,9992,0,9999,7
1714644695620,CSE 197,001,637388,Minnes Kemp; Mor Mia,9998,0,9999,1
1714644696646,CSS 201S,A01,494383,Staff,35,0,35,0
1714644697677,CSS 202S,A01,494387,Staff,35,0,35,0
1714644698707,DSC 197,001,628532,Eldridge; Justin Matthew,9996,0,9999,3
1714644699731,EAP 100,A00,516065,Staff,9797,0,9999,202
1714644700758,ECE 45,A01,507414,Staff,33,0,60,27
1714644702810,ECE 111,A01,507420,Staff,15,0,50,35
1714644703836,ECE 197,001,548057,Sievenpiper; Daniel F.,9993,0,9999,6
1714644704864,EDS 115,A00,507243,Choi; Bailey Miyeon,10,0,28,18
1714644705895,EDS 117,A01,494379,Staff,0,4,30,30
1714644706922,EDS 125,A00,507246,Hopkins; Megan Beth,9,0,30,21
1714644707953,EDS 128A,A01,507264,Fargason; Sharon Gayle,8,0,26,18
1714644708983,EDS 128B,A01,507293,Pappas; Elizabeth,12,0,30,18
1714644710008,EDS 139,A00,507294,Fargason; Sharon Gayle,13,0,30,17
1714644710008,EDS 139,B00,507313,Pappas; Elizabeth,13,0,30,17
1714644711035,EDS 201,A00,507315,Staff,13,0,30,17
1714644712086,EDS 203,A01,507317,Halter; Christopher P.,12,0,30,18
1714644713114,EDS 204R,A01,507319,Halter; Christopher P.,0,3,30,30
1714644713114,EDS 204R,B01,507331,Heinzman; Erica M.,16,0,30,14
1714644714137,EDS 206R,A00,507332,Staff,0,4,30,30
1714644714137,EDS 206R,B00,507343,Staff,17,0,30,13
1714644715168,EDS 250,A00,507344,Hemans; Patricia Ann Benitez,22,0,40,18
1714644716193,EDS 281,A00,507345,Daly; Alan J.,18,0,18,0
1714644717219,EDS 284,A00,507350,Daly; Alan J.,16,0,16,0
1714644718243,EDS 286,A00,507359,Fine; Sarah,18,0,18,0
1714644719268,EDS 289C,A01,507361,Daly; Alan J.,18,0,18,0
1714644720299,EDS 290,A00,507366,Hofstetter; Carolyn,15,0,15,0
1714644721331,LIGM 5A,A00,507421,Fischer-Grunski; Eva K,18,0,20,2
1714644722357,LIGM 5B,A00,507423,Fischer-Grunski; Eva K,19,0,20,1
1714644723382,LIGM 5C,A00,507425,Fischer-Grunski; Eva K,19,0,20,1
1714644724408,LIIT 5AS,A00,507427,Carnelos; Chiara,20,0,20,0
1714644725433,LIIT 5BS,A00,507430,Carnelos; Chiara,20,0,20,0
1714644726462,LIIT 5CS,A00,507432,Carnelos; Chiara,20,0,20,0
1714644727487,LISP 5A,A00,507541,Munoz Sanchez; Alicia,11,0,20,9
1714644728512,LISP 5B,A00,507671,Munoz Sanchez; Alicia,8,0,20,12
1714644729541,LISP 5C,A00,507696,Munoz Sanchez; Alicia,9,0,20,11
1714644730565,MAE 197,001,528363,Boechler; Nicholas Sebastia,9998,0,9999,1
1714644731595,MATH 197,001,523477,Kedlaya; Kiran S.,9995,0,9999,4
1714644731595,MATH 197,002,563811,Zhang; Danna,9995,0,9999,4
1714644731595,MATH 197,003,628552,Dumitriu; Ioana,9998,0,9999,1
1714644732621,MCWP 40R,A00,518780,Staff,2,0,20,18
1714644732621,MCWP 40R,B00,518781,Staff,8,0,20,12
1714644732621,MCWP 40R,C00,518783,Staff,6,0,20,14
1714644733647,MCWP 50R,A00,518791,Staff,0,0,20,20
1714644733647,MCWP 50R,B00,518792,Staff,0,2,20,20
1714644733647,MCWP 50R,C00,518793,Staff,0,2,20,20
1714644733647,MCWP 50R,D00,518794,Staff,0,1,20,20
1714644733647,MCWP 50R,E00,518795,Staff,0,2,20,20
1714644733647,MCWP 50R,F00,518796,Staff,0,0,20,20
1714644733647,MCWP 50R,G00,518797,Staff,0,1,20,20
1714644734673,MMW 12R,A01,514034,Herbst; Matthew,0,0,16,16
1714644734673,MMW 12R,A02,514035,Herbst; Matthew,1,0,16,15
1714644735701,MMW 13R,A01,514037,Staff,0,4,16,16
1714644735701,MMW 13R,A02,514039,Staff,0,2,16,16
1714644735701,MMW 13R,A03,628519,Staff,0,2,16,16
1714644737761,SIO 295LS,A00,523233,Staff,10,0,30,20
1714644738787,SIO 295S,A00,523232,Staff,10,0,30,20
1714644739813,SIOC 290S,A01,637330,Merrifield; Mark A,23,0,30,7
1714644740838,SIOC 291S,A01,637333,Gabriel; Corey John,23,0,30,7
1714644741863,SOCI 117,A01,494376,Staff,0,4,5,5
1714644742891,WES 237B,A00,494380,Staff,9,0,20,11
1714644744980,AESE 279B,A00,494370,Wade; Jon P,0,0,33,33
1714644746007,AIP 197,001,627712,Vespa; Emanuel Ignacio,9998,0,9999,1
1714644747031,ANAR 135S,A00,494369,Braswell; Geoffrey E.,0,0,0,0
1714644748056,BENG 196,001,628496,Engler; Adam J.,9998,0,9999,1
1714644749086,CAT 124RS,A01,519847,Geibel; William,0,0,20,20
1714644750113,CAT 125RS,A01,515971,Geibel; William,0,0,20,20
1714644751138,CLRE 250,A00,511389,Morris; Sheldon,9993,0,9999,6
1714644752166,CLRE 251,A00,507176,Mehta; Ravindra L.,9993,0,9999,6
1714644752166,CLRE 251,B00,511410,Mehta; Ravindra L.,9998,0,9999,1
1714644753192,CLRE 252,A00,507189,Cuomo; Raphael Eduardo,9995,0,9999,4
1714644754220,CLRE 253,A00,507199,Vaida; Florin,9994,0,9999,5
1714644754220,CLRE 253,B00,507202,Vaida; Florin,9999,0,9999,0
1714644755246,CLRE 259,A00,507211,Patel; Hemal,9996,0,9999,3
1714644756273,CLRE 260,A00,507221,Cuomo; Raphael Eduardo,9999,0,9999,0
1714644757301,CLRE 297,001,507242,Cuomo; Raphael Eduardo,9999,0,9999,0
1714644758329,COGS 197,001,638244,Voytek; Bradley Thomas,9998,0,9999,1
1714644759357,CSE 191,A00,516875,Minnes Kemp; Mor Mia,9992,0,9999,7
1714644760385,CSE 197,001,637388,Minnes Kemp; Mor Mia,9998,0,9999,1
1714644761410,CSS 201S,A01,494383,Staff,35,0,35,0
1714644762434,CSS 202S,A01,494387,Staff,35,0,35,0
1714644763458,DSC 197,001,628532,Eldridge; Justin Matthew,9996,0,9999,3
1714644764483,EAP 100,A00,516065,Staff,9797,0,9999,202
1714644765513,ECE 45,A01,507414,Staff,33,0,60,27
1714644767566,ECE 111,A01,507420,Staff,15,0,50,35
1714644768594,ECE 197,001,548057,Sievenpiper; Daniel F.,9993,0,9999,6
1714644769625,EDS 115,A00,507243,Choi; Bailey Miyeon,10,0,28,18
1714644770655,EDS 117,A01,494379,Staff,0,4,30,30
1714644771679,EDS 125,A00,507246,Hopkins; Megan Beth,9,0,30,21
1714644772704,EDS 128A,A01,507264,Fargason; Sharon Gayle,8,0,26,18
1714644773729,EDS 128B,A01,507293,Pappas; Elizabeth,12,0,30,18
1714644774753,EDS 139,A00,507294,Fargason; Sharon Gayle,13,0,30,17
1714644774753,EDS 139,B00,507313,Pappas; Elizabeth,13,0,30,17
1714644775778,EDS 201,A00,507315,Staff,13,0,30,17
1714644776809,EDS 203,A01,507317,Halter; Christopher P.,12,0,30,18
1714644777838,EDS 204R,A01,507319,Halter; Christopher P.,0,3,30,30
1714644777838,EDS 204R,B01,507331,Heinzman; Erica M.,16,0,30,14
1714644778867,EDS 206R,A00,507332,Staff,0,4,30,30
1714644778867,EDS 206R,B00,507343,Staff,17,0,30,13
1714644779896,EDS 250,A00,507344,Hemans; Patricia Ann Benitez,22,0,40,18
1714644780921,EDS 281,A00,507345,Daly; Alan J.,18,0,18,0
1714644781948,EDS 284,A00,507350,Daly; Alan J.,16,0,16,0
1714644782977,EDS 286,A00,507359,Fine; Sarah,18,0,18,0
1714644784001,EDS 289C,A01,507361,Daly; Alan J.,18,0,18,0
1714644785029,EDS 290,A00,507366,Hofstetter; Carolyn,15,0,15,0
1714644786057,LIGM 5A,A00,507421,Fischer-Grunski; Eva K,18,0,20,2
1714644787081,LIGM 5B,A00,507423,Fischer-Grunski; Eva K,19,0,20,1
1714644788104,LIGM 5C,A00,507425,Fischer-Grunski; Eva K,19,0,20,1
1714644789187,LIIT 5AS,A00,507427,Carnelos; Chiara,20,0,20,0
1714644790213,LIIT 5BS,A00,507430,Carnelos; Chiara,20,0,20,0
1714644791238,LIIT 5CS,A00,507432,Carnelos; Chiara,20,0,20,0
1714644792264,LISP 5A,A00,507541,Munoz Sanchez; Alicia,11,0,20,9
1714644793293,LISP 5B,A00,507671,Munoz Sanchez; Alicia,8,0,20,12
1714644794318,LISP 5C,A00,507696,Munoz Sanchez; Alicia,9,0,20,11
1714644795347,MAE 197,001,528363,Boechler; Nicholas Sebastia,9998,0,9999,1
1714644796373,MATH 197,001,523477,Kedlaya; Kiran S.,9995,0,9999,4
1714644796373,MATH 197,002,563811,Zhang; Danna,9995,0,9999,4
1714644796373,MATH 197,003,628552,Dumitriu; Ioana,9998,0,9999,1
1714644797402,MCWP 40R,A00,518780,Staff,2,0,20,18
1714644797402,MCWP 40R,B00,518781,Staff,8,0,20,12
1714644797402,MCWP 40R,C00,518783,Staff,6,0,20,14
1714644798433,MCWP 50R,A00,518791,Staff,0,0,20,20
1714644798433,MCWP 50R,B00,518792,Staff,0,2,20,20
1714644798433,MCWP 50R,C00,518793,Staff,0,2,20,20
1714644798433,MCWP 50R,D00,518794,Staff,0,1,20,20
1714644798433,MCWP 50R,E00,518795,Staff,0,2,20,20
1714644798433,MCWP 50R,F00,518796,Staff,0,0,20,20
1714644798433,MCWP 50R,G00,518797,Staff,0,1,20,20
1714644799460,MMW 12R,A01,514034,Herbst; Matthew,0,0,16,16
1714644799460,MMW 12R,A02,514035,Herbst; Matthew,1,0,16,15
1714644800488,MMW 13R,A01,514037,Staff,0,4,16,16
1714644800488,MMW 13R,A02,514039,Staff,0,2,16,16
1714644800488,MMW 13R,A03,628519,Staff,0,2,16,16
1714644802538,SIO 295LS,A00,523233,Staff,10,0,30,20
1714644803565,SIO 295S,A00,523232,Staff,10,0,30,20
1714644804591,SIOC 290S,A01,637330,Merrifield; Mark A,23,0,30,7
1714644805616,SIOC 291S,A01,637333,Gabriel; Corey John,23,0,30,7
1714644806644,SOCI 117,A01,494376,Staff,0,4,5,5
1714644807674,WES 237B,A00,494380,Staff,9,0,20,11
1714644809760,AESE 279B,A00,494370,Wade; Jon P,0,0,33,33
1714644810785,AIP 197,001,627712,Vespa; Emanuel Ignacio,9998,0,9999,1
1714644811815,ANAR 135S,A00,494369,Braswell; Geoffrey E.,0,0,0,0
1714644812847,BENG 196,001,628496,Engler; Adam J.,9998,0,9999,1
1714644813874,CAT 124RS,A01,519847,Geibel; William,0,0,20,20
1714644814900,CAT 125RS,A01,515971,Geibel; William,0,0,20,20
1714644815935,CLRE 250,A00,511389,Morris; Sheldon,9993,0,9999,6
1714644816965,CLRE 251,A00,507176,Mehta; Ravindra L.,9993,0,9999,6
1714644816965,CLRE 251,B00,511410,Mehta; Ravindra L.,9998,0,9999,1
1714644817992,CLRE 252,A00,507189,Cuomo; Raphael Eduardo,9995,0,9999,4
1714644819022,CLRE 253,A00,507199,Vaida; Florin,9994,0,9999,5
1714644819022,CLRE 253,B00,507202,Vaida; Florin,9999,0,9999,0
1714644820048,CLRE 259,A00,507211,Patel; Hemal,9996,0,9999,3
1714644821078,CLRE 260,A00,507221,Cuomo; Raphael Eduardo,9999,0,9999,0
1714644822105,CLRE 297,001,507242,Cuomo; Raphael Eduardo,9999,0,9999,0
1714644823134,COGS 197,001,638244,Voytek; Bradley Thomas,9998,0,9999,1
1714644824159,CSE 191,A00,516875,Minnes Kemp; Mor Mia,9992,0,9999,7
1714644825183,CSE 197,001,637388,Minnes Kemp; Mor Mia,9998,0,9999,1
1714644826208,CSS 201S,A01,494383,Staff,35,0,35,0
1714644827233,CSS 202S,A01,494387,Staff,35,0,35,0
1714644828259,DSC 197,001,628532,Eldridge; Justin Matthew,9996,0,9999,3
1714644829286,EAP 100,A00,516065,Staff,9797,0,9999,202
1714644830311,ECE 45,A01,507414,Staff,33,0,60,27
1714644832366,ECE 111,A01,507420,Staff,15,0,50,35
1714644833394,ECE 197,001,548057,Sievenpiper; Daniel F.,9993,0,9999,6
1714644834421,EDS 115,A00,507243,Choi; Bailey Miyeon,10,0,28,18
1714644835445,EDS 117,A01,494379,Staff,0,4,30,30
1714644836470,EDS 125,A00,507246,Hopkins; Megan Beth,9,0,30,21
1714644837496,EDS 128A,A01,507264,Fargason; Sharon Gayle,8,0,26,18
1714644838524,EDS 128B,A01,507293,Pappas; Elizabeth,12,0,30,18
1714644839551,EDS 139,A00,507294,Fargason; Sharon Gayle,13,0,30,17
1714644839551,EDS 139,B00,507313,Pappas; Elizabeth,13,0,30,17
1714644840575,EDS 201,A00,507315,Staff,13,0,30,17
1714644841605,EDS 203,A01,507317,Halter; Christopher P.,12,0,30,18
1714644842635,EDS 204R,A01,507319,Halter; Christopher P.,0,3,30,30
1714644842635,EDS 204R,B01,507331,Heinzman; Erica M.,16,0,30,14
1714644843664,EDS 206R,A00,507332,Staff,0,4,30,30
1714644843664,EDS 206R,B00,507343,Staff,17,0,30,13
1714644844691,EDS 250,A00,507344,Hemans; Patricia Ann Benitez,22,0,40,18
1714644845717,EDS 281,A00,507345,Daly; Alan J.,18,0,18,0
1714644846742,EDS 284,A00,507350,Daly; Alan J.,16,0,16,0
1714644847769,EDS 286,A00,507359,Fine; Sarah,18,0,18,0
1714644848796,EDS 289C,A01,507361,Daly; Alan J.,18,0,18,0
1714644849826,EDS 290,A00,507366,Hofstetter; Carolyn,15,0,15,0
1714644850857,LIGM 5A,A00,507421,Fischer-Grunski; Eva K,18,0,20,2
1714644851883,LIGM 5B,A00,507423,Fischer-Grunski; Eva K,19,0,20,1
1714644852909,LIGM 5C,A00,507425,Fischer-Grunski; Eva K,19,0,20,1
1714644853939,LIIT 5AS,A00,507427,Carnelos; Chiara,20,0,20,0
1714644854967,LIIT 5BS,A00,507430,Carnelos; Chiara,20,0,20,0
1714644855992,LIIT 5CS,A00,507432,Carnelos; Chiara,20,0,20,0
1714644857018,LISP 5A,A00,507541,Munoz Sanchez; Alicia,11,0,20,9
1714644858043,LISP 5B,A00,507671,Munoz Sanchez; Alicia,8,0,20,12
1714644859071,LISP 5C,A00,507696,Munoz Sanchez; Alicia,9,0,20,11
1714644860096,MAE 197,001,528363,Boechler; Nicholas Sebastia,9998,0,9999,1
1714644861131,MATH 197,001,523477,Kedlaya; Kiran S.,9995,0,9999,4
1714644861131,MATH 197,002,563811,Zhang; Danna,9995,0,9999,4
1714644861131,MATH 197,003,628552,Dumitriu; Ioana,9998,0,9999,1
1714644862156,MCWP 40R,A00,518780,Staff,2,0,20,18
1714644862156,MCWP 40R,B00,518781,Staff,8,0,20,12
1714644862156,MCWP 40R,C00,518783,Staff,6,0,20,14
1714644863183,MCWP 50R,A00,518791,Staff,0,0,20,20
1714644863183,MCWP 50R,B00,518792,Staff,0,2,20,20
1714644863183,MCWP 50R,C00,518793,Staff,0,2,20,20
1714644863183,MCWP 50R,D00,518794,Staff,0,1,20,20
1714644863183,MCWP 50R,E00,518795,Staff,0,2,20,20
1714644863183,MCWP 50R,F00,518796,Staff,0,0,20,20
1714644863183,MCWP 50R,G00,518797,Staff,0,1,20,20
1714644864211,MMW 12R,A01,514034,Herbst; Matthew,0,0,16,16
1714644864211,MMW 12R,A02,514035,Herbst; Matthew,1,0,16,15
1714644865238,MMW 13R,A01,514037,Staff,0,4,16,16
1714644865238,MMW 13R,A02,514039,Staff,0,2,16,16
1714644865238,MMW 13R,A03,628519,Staff,0,2,16,16
1714644867291,SIO 295LS,A00,523233,Staff,10,0,30,20
1714644868317,SIO 295S,A00,523232,Staff,10,0,30,20
1714644869343,SIOC 290S,A01,637330,Merrifield; Mark A,23,0,30,7
1714644870369,SIOC 291S,A01,637333,Gabriel; Corey John,23,0,30,7
1714644871392,SOCI 117,A01,494376,Staff,0,4,5,5
1714644872420,WES 237B,A00,494380,Staff,9,0,20,11
1714644874500,AESE 279B,A00,494370,Wade; Jon P,0,0,33,33
1714644875525,AIP 197,001,627712,Vespa; Emanuel Ignacio,9998,0,9999,1
1714644876552,ANAR 135S,A00,494369,Braswell; Geoffrey E.,0,0,0,0
1714644877579,BENG 196,001,628496,Engler; Adam J.,9998,0,9999,1
1714644878608,CAT 124RS,A01,519847,Geibel; William,0,0,20,20
1714644879637,CAT 125RS,A01,515971,Geibel; William,0,0,20,20
1714644880662,CLRE 250,A00,511389,Morris; Sheldon,9993,0,9999,6
1714644881694,CLRE 251,A00,507176,Mehta; Ravindra L.,9993,0,9999,6
1714644881694,CLRE 251,B00,511410,Mehta; Ravindra L.,9998,0,9999,1
1714644882722,CLRE 252,A00,507189,Cuomo; Raphael Eduardo,9995,0,9999,4
1714644883748,CLRE 253,A00,507199,Vaida; Florin,9994,0,9999,5
1714644883748,CLRE 253,B00,507202,Vaida; Florin,9999,0,9999,0
1714644884776,CLRE 259,A00,507211,Patel; Hemal,9996,0,9999,3
1714644885800,CLRE 260,A00,507221,Cuomo; Raphael Eduardo,9999,0,9999,0
1714644886825,CLRE 297,001,507242,Cuomo; Raphael Eduardo,9999,0,9999,0
1714644887851,COGS 197,001,638244,Voytek; Bradley Thomas,9998,0,9999,1
1714644888879,CSE 191,A00,516875,Minnes Kemp; Mor Mia,9992,0,9999,7
1714644889905,CSE 197,001,637388,Minnes Kemp; Mor Mia,9998,0,9999,1
1714644890930,CSS 201S,A01,494383,Staff,35,0,35,0
1714644891955,CSS 202S,A01,494387,Staff,35,0,35,0
1714644892984,DSC 197,001,628532,Eldridge; Justin Matthew,9996,0,9999,3
1714644894009,EAP 100,A00,516065,Staff,9797,0,9999,202
1714644895034,ECE 45,A01,507414,Staff,33,0,60,27
1714644897091,ECE 111,A01,507420,Staff,15,0,50,35
1714644898121,ECE 197,001,548057,Sievenpiper; Daniel F.,9993,0,9999,6
1714644899148,EDS 115,A00,507243,Choi; Bailey Miyeon,10,0,28,18
1714644900175,EDS 117,A01,494379,Staff,0,4,30,30
1714644901201,EDS 125,A00,507246,Hopkins; Megan Beth,9,0,30,21
1714644902230,EDS 128A,A01,507264,Fargason; Sharon Gayle,8,0,26,18
1714644903258,EDS 128B,A01,507293,Pappas; Elizabeth,12,0,30,18
1714644904281,EDS 139,A00,507294,Fargason; Sharon Gayle,13,0,30,17
1714644904281,EDS 139,B00,507313,Pappas; Elizabeth,13,0,30,17
1714644905305,EDS 201,A00,507315,Staff,13,0,30,17
1714644906329,EDS 203,A01,507317,Halter; Christopher P.,12,0,30,18
1714644907353,EDS 204R,A01,507319,Halter; Christopher P.,0,3,30,30
1714644907353,EDS 204R,B01,507331,Heinzman; Erica M.,16,0,30,14
1714644908379,EDS 206R,A00,507332,Staff,0,4,30,30
1714644908379,EDS 206R,B00,507343,Staff,17,0,30,13
1714644909404,EDS 250,A00,507344,Hemans; Patricia Ann Benitez,22,0,40,18
1714644910428,EDS 281,A00,507345,Daly; Alan J.,18,0,18,0
1714644911456,EDS 284,A00,507350,Daly; Alan J.,16,0,16,0
1714644912485,EDS 286,A00,507359,Fine; Sarah,18,0,18,0
1714644913508,EDS 289C,A01,507361,Daly; Alan J.,18,0,18,0
1714644914534,EDS 290,A00,507366,Hofstetter; Carolyn,15,0,15,0
1714644915560,LIGM 5A,A00,507421,Fischer-Grunski; Eva K,18,0,20,2
1714644916591,LIGM 5B,A00,507423,Fischer-Grunski; Eva K,19,0,20,1
1714644917614,LIGM 5C,A00,507425,Fischer-Grunski; Eva K,19,0,20,1
1714644918638,LIIT 5AS,A00,507427,Carnelos; Chiara,20,0,20,0
1714644919662,LIIT 5BS,A00,507430,Carnelos; Chiara,20,0,20,0
1714644920689,LIIT 5CS,A00,507432,Carnelos; Chiara,20,0,20,0
1714644921720,LISP 5A,A00,507541,Munoz Sanchez; Alicia,11,0,20,9
1714644922750,LISP 5B,A00,507671,Munoz Sanchez; Alicia,8,0,20,12
1714644923778,LISP 5C,A00,507696,Munoz Sanchez; Alicia,9,0,20,11
1714644924805,MAE 197,001,528363,Boechler; Nicholas Sebastia,9998,0,9999,1
1714644925834,MATH 197,001,523477,Kedlaya; Kiran S.,9995,0,9999,4
1714644925834,MATH 197,002,563811,Zhang; Danna,9995,0,9999,4
1714644925834,MATH 197,003,628552,Dumitriu; Ioana,9998,0,9999,1
1714644926863,MCWP 40R,A00,518780,Staff,2,0,20,18
1714644926863,MCWP 40R,B00,518781,Staff,8,0,20,12
1714644926863,MCWP 40R,C00,518783,Staff,6,0,20,14
1714644927893,MCWP 50R,A00,518791,Staff,0,0,20,20
1714644927893,MCWP 50R,B00,518792,Staff,0,2,20,20
1714644927893,MCWP 50R,C00,518793,Staff,0,2,20,20
1714644927893,MCWP 50R,D00,518794,Staff,0,1,20,20
1714644927893,MCWP 50R,E00,518795,Staff,0,2,20,20
1714644927893,MCWP 50R,F00,518796,Staff,0,0,20,20
1714644927893,MCWP 50R,G00,518797,Staff,0,1,20,20
1714644928921,MMW 12R,A01,514034,Herbst; Matthew,0,0,16,16
1714644928921,MMW 12R,A02,514035,Herbst; Matthew,1,0,16,15
1714644929949,MMW 13R,A01,514037,Staff,0,4,16,16
1714644929949,MMW 13R,A02,514039,Staff,0,2,16,16
1714644929949,MMW 13R,A03,628519,Staff,0,2,16,16
1714644931997,SIO 295LS,A00,523233,Staff,10,0,30,20
1714644933025,SIO 295S,A00,523232,Staff,10,0,30,20
1714644934048,SIOC 290S,A01,637330,Merrifield; Mark A,23,0,30,7
1714644935075,SIOC 291S,A01,637333,Gabriel; Corey John,23,0,30,7
1714644936103,SOCI 117,A01,494376,Staff,0,4,5,5
1714644937133,WES 237B,A00,494380,Staff,9,0,20,11
1714644939210,AESE 279B,A00,494370,Wade; Jon P,0,0,33,33
1714644940235,AIP 197,001,627712,Vespa; Emanuel Ignacio,9998,0,9999,1
1714644941263,ANAR 135S,A00,494369,Braswell; Geoffrey E.,0,0,0,0
1714644942288,BENG 196,001,628496,Engler; Adam J.,9998,0,9999,1
1714644943313,CAT 124RS,A01,519847,Geibel; William,0,0,20,20
1714644944337,CAT 125RS,A01,515971,Geibel; William,0,0,20,20
1714644945364,CLRE 250,A00,511389,Morris; Sheldon,9993,0,9999,6
1714644946391,CLRE 251,A00,507176,Mehta; Ravindra L.,9993,0,9999,6
1714644946391,CLRE 251,B00,511410,Mehta; Ravindra L.,9998,0,9999,1
1714644947419,CLRE 252,A00,507189,Cuomo; Raphael Eduardo,9995,0,9999,4
1714644948445,CLRE 253,A00,507199,Vaida; Florin,9994,0,9999,5
1714644948445,CLRE 253,B00,507202,Vaida; Florin,9999,0,9999,0
1714644949473,CLRE 259,A00,507211,Patel; Hemal,9996,0,9999,3
1714644950498,CLRE 260,A00,507221,Cuomo; Raphael Eduardo,9999,0,9999,0
1714644951527,CLRE 297,001,507242,Cuomo; Raphael Eduardo,9999,0,9999,0
1714644952556,COGS 197,001,638244,Voytek; Bradley Thomas,9998,0,9999,1
1714644953584,CSE 191,A00,516875,Minnes Kemp; Mor Mia,9992,0,9999,7
1714644954610,CSE 197,001,637388,Minnes Kemp; Mor Mia,9998,0,9999,1
1714644955637,CSS 201S,A01,494383,Staff,35,0,35,0
1714644956665,CSS 202S,A01,494387,Staff,35,0,35,0
1714644957695,DSC 197,001,628532,Eldridge; Justin Matthew,9996,0,9999,3
1714644958721,EAP 100,A00,516065,Staff,9797,0,9999,202
1714644959749,ECE 45,A01,507414,Staff,33,0,60,27
1714644961800,ECE 111,A01,507420,Staff,15,0,50,35
1714644962832,ECE 197,001,548057,Sievenpiper; Daniel F.,9993,0,9999,6
1714644963859,EDS 115,A00,507243,Choi; Bailey Miyeon,10,0,28,18
1714644964889,EDS 117,A01,494379,Staff,0,4,30,30
1714644965920,EDS 125,A00,507246,Hopkins; Megan Beth,9,0,30,21
1714644966951,EDS 128A,A01,507264,Fargason; Sharon Gayle,8,0,26,18
1714644967978,EDS 128B,A01,507293,Pappas; Elizabeth,12,0,30,18
1714644969002,EDS 139,A00,507294,Fargason; Sharon Gayle,13,0,30,17
1714644969002,EDS 139,B00,507313,Pappas; Elizabeth,13,0,30,17
1714644970038,EDS 201,A00,507315,Staff,13,0,30,17
1714644971067,EDS 203,A01,507317,Halter; Christopher P.,12,0,30,18
1714644972094,EDS 204R,A01,507319,Halter; Christopher P.,0,3,30,30
1714644972094,EDS 204R,B01,507331,Heinzman; Erica M.,16,0,30,14
1714644973117,EDS 206R,A00,507332,Staff,0,4,30,30
1714644973117,EDS 206R,B00,507343,Staff,17,0,30,13
1714644974146,EDS 250,A00,507344,Hemans; Patricia Ann Benitez,22,0,40,18
1714644975175,EDS 281,A00,507345,Daly; Alan J.,18,0,18,0
1714644976199,EDS 284,A00,507350,Daly; Alan J.,16,0,16,0
1714644977227,EDS 286,A00,507359,Fine; Sarah,18,0,18,0
1714644978267,EDS 289C,A01,507361,Daly; Alan J.,18,0,18,0
1714644979298,EDS 290,A00,507366,Hofstetter; Carolyn,15,0,15,0
1714644980324,LIGM 5A,A00,507421,Fischer-Grunski; Eva K,18,0,20,2
1714644981350,LIGM 5B,A00,507423,Fischer-Grunski; Eva K,19,0,20,1
1714644982379,LIGM 5C,A00,507425,Fischer-Grunski; Eva K,19,0,20,1
1714644983407,LIIT 5AS,A00,507427,Carnelos; Chiara,20,0,20,0
1714644984437,LIIT 5BS,A00,507430,Carnelos; Chiara,20,0,20,0
1714644985464,LIIT 5CS,A00,507432,Carnelos; Chiara,20,0,20,0
1714644986489,LISP 5A,A00,507541,Munoz Sanchez; Alicia,11,0,20,9
1714644987520,LISP 5B,A00,507671,Munoz Sanchez; Alicia,8,0,20,12
1714644988546,LISP 5C,A00,507696,Munoz Sanchez; Alicia,9,0,20,11
1714644989578,MAE 197,001,528363,Boechler; Nicholas Sebastia,9998,0,9999,1
1714644990611,MATH 197,001,523477,Kedlaya; Kiran S.,9995,0,9999,4
1714644990611,MATH 197,002,563811,Zhang; Danna,9995,0,9999,4
1714644990611,MATH 197,003,628552,Dumitriu; Ioana,9998,0,9999,1
1714644991636,MCWP 40R,A00,518780,Staff,2,0,20,18
1714644991636,MCWP 40R,B00,518781,Staff,8,0,20,12
1714644991636,MCWP 40R,C00,518783,Staff,6,0,20,14
1714644992688,MCWP 50R,A00,518791,Staff,0,0,20,20
1714644992688,MCWP 50R,B00,518792,Staff,0,2,20,20
1714644992688,MCWP 50R,C00,518793,Staff,0,2,20,20
1714644992688,MCWP 50R,D00,518794,Staff,0,1,20,20
1714644992688,MCWP 50R,E00,518795,Staff,0,2,20,20
1714644992688,MCWP 50R,F00,518796,Staff,0,0,20,20
1714644992688,MCWP 50R,G00,518797,Staff,0,1,20,20
1714644993714,MMW 12R,A01,514034,Herbst; Matthew,0,0,16,16
1714644993714,MMW 12R,A02,514035,Herbst; Matthew,1,0,16,15
1714644994739,MMW 13R,A01,514037,Staff,0,4,16,16
1714644994739,MMW 13R,A02,514039,Staff,0,2,16,16
1714644994739,MMW 13R,A03,628519,Staff,0,2,16,16
1714644996804,SIO 295LS,A00,523233,Staff,10,0,30,20
1714644997831,SIO 295S,A00,523232,Staff,10,0,30,20
1714644998862,SIOC 290S,A01,637330,Merrifield; Mark A,23,0,30,7
1714644999893,SIOC 291S,A01,637333,Gabriel; Corey John,23,0,30,7
1714645000920,SOCI 117,A01,494376,Staff,0,4,5,5
1714645001948,WES 237B,A00,494380,Staff,9,0,20,11
1714645004020,AESE 279B,A00,494370,Wade; Jon P,0,0,33,33
1714645005045,AIP 197,001,627712,Vespa; Emanuel Ignacio,9998,0,9999,1
1714645006074,ANAR 135S,A00,494369,Braswell; Geoffrey E.,0,0,0,0
1714645007097,BENG 196,001,628496,Engler; Adam J.,9998,0,9999,1
1714645008123,CAT 124RS,A01,519847,Geibel; William,0,0,20,20
1714645009152,CAT 125RS,A01,515971,Geibel; William,0,0,20,20
1714645010180,CLRE 250,A00,511389,Morris; Sheldon,9993,0,9999,6
1714645011208,CLRE 251,A00,507176,Mehta; Ravindra L.,9993,0,9999,6
1714645011208,CLRE 251,B00,511410,Mehta; Ravindra L.,9998,0,9999,1
1714645012239,CLRE 252,A00,507189,Cuomo; Raphael Eduardo,9995,0,9999,4
1714645013269,CLRE 253,A00,507199,Vaida; Florin,9994,0,9999,5
1714645013269,CLRE 253,B00,507202,Vaida; Florin,9999,0,9999,0
1714645014294,CLRE 259,A00,507211,Patel; Hemal,9996,0,9999,3
1714645015318,CLRE 260,A00,507221,Cuomo; Raphael Eduardo,9999,0,9999,0
1714645016342,CLRE 297,001,507242,Cuomo; Raphael Eduardo,9999,0,9999,0
1714645017368,COGS 197,001,638244,Voytek; Bradley Thomas,9998,0,9999,1
1714645018392,CSE 191,A00,516875,Minnes Kemp; Mor Mia,9992,0,9999,7
1714645019420,CSE 197,001,637388,Minnes Kemp; Mor Mia,9998,0,9999,1
1714645020447,CSS 201S,A01,494383,Staff,35,0,35,0
1714645021474,CSS 202S,A01,494387,Staff,35,0,35,0
1714645022503,DSC 197,001,628532,Eldridge; Justin Matthew,9996,0,9999,3
1714645023529,EAP 100,A00,516065,Staff,9797,0,9999,202
1714645024557,ECE 45,A01,507414,Staff,33,0,60,27
1714645026607,ECE 111,A01,507420,Staff,15,0,50,35
1714645027635,ECE 197,001,548057,Sievenpiper; Daniel F.,9993,0,9999,6
1714645028665,EDS 115,A00,507243,Choi; Bailey Miyeon,10,0,28,18
1714645029691,EDS 117,A01,494379,Staff,0,4,30,30
1714645030717,EDS 125,A00,507246,Hopkins; Megan Beth,9,0,30,21
1714645031743,EDS 128A,A01,507264,Fargason; Sharon Gayle,8,0,26,18
1714645032774,EDS 128B,A01,507293,Pappas; Elizabeth,12,0,30,18
1714645033802,EDS 139,A00,507294,Fargason; Sharon Gayle,13,0,30,17
1714645033802,EDS 139,B00,507313,Pappas; Elizabeth,13,0,30,17
1714645034828,EDS 201,A00,507315,Staff,13,0,30,17
1714645035853,EDS 203,A01,507317,Halter; Christopher P.,12,0,30,18
1714645036877,EDS 204R,A01,507319,Halter; Christopher P.,0,3,30,30
1714645036877,EDS 204R,B01,507331,Heinzman; Erica M.,16,0,30,14
1714645037901,EDS 206R,A00,507332,Staff,0,4,30,30
1714645037901,EDS 206R,B00,507343,Staff,17,0,30,13
1714645038929,EDS 250,A00,507344,Hemans; Patricia Ann Benitez,22,0,40,18
1714645039954,EDS 281,A00,507345,Daly; Alan J.,18,0,18,0
1714645040982,EDS 284,A00,507350,Daly; Alan J.,16,0,16,0
1714645042009,EDS 286,A00,507359,Fine; Sarah,18,0,18,0
1714645043034,EDS 289C,A01,507361,Daly; Alan J.,18,0,18,0
1714645044062,EDS 290,A00,507366,Hofstetter; Carolyn,15,0,15,0
1714645045091,LIGM 5A,A00,507421,Fischer-Grunski; Eva K,18,0,20,2
1714645046116,LIGM 5B,A00,507423,Fischer-Grunski; Eva K,19,0,20,1
1714645047141,LIGM 5C,A00,507425,Fischer-Grunski; Eva K,19,0,20,1
1714645048165,LIIT 5AS,A00,507427,Carnelos; Chiara,20,0,20,0
1714645049190,LIIT 5BS,A00,507430,Carnelos; Chiara,20,0,20,0
1714645050216,LIIT 5CS,A00,507432,Carnelos; Chiara,20,0,20,0
1714645051248,LISP 5A,A00,507541,Munoz Sanchez; Alicia,11,0,20,9
1714645052274,LISP 5B,A00,507671,Munoz Sanchez; Alicia,8,0,20,12
1714645053300,LISP 5C,A00,507696,Munoz Sanchez; Alicia,9,0,20,11
1714645054327,MAE 197,001,528363,Boechler; Nicholas Sebastia,9998,0,9999,1
1714645055356,MATH 197,001,523477,Kedlaya; Kiran S.,9995,0,9999,4
1714645055356,MATH 197,002,563811,Zhang; Danna,9995,0,9999,4
1714645055356,MATH 197,003,628552,Dumitriu; Ioana,9998,0,9999,1
1714645056388,MCWP 40R,A00,518780,Staff,2,0,20,18
1714645056388,MCWP 40R,B00,518781,Staff,8,0,20,12
1714645056388,MCWP 40R,C00,518783,Staff,6,0,20,14
1714645057413,MCWP 50R,A00,518791,Staff,0,0,20,20
1714645057413,MCWP 50R,B00,518792,Staff,0,2,20,20
1714645057413,MCWP 50R,C00,518793,Staff,0,2,20,20
1714645057413,MCWP 50R,D00,518794,Staff,0,1,20,20
1714645057413,MCWP 50R,E00,518795,Staff,0,2,20,20
1714645057413,MCWP 50R,F00,518796,Staff,0,0,20,20
1714645057413,MCWP 50R,G00,518797,Staff,0,1,20,20
1714645058443,MMW 12R,A01,514034,Herbst; Matthew,0,0,16,16
1714645058443,MMW 12R,A02,514035,Herbst; Matthew,1,0,16,15
1714645059468,MMW 13R,A01,514037,Staff,0,4,16,16
1714645059468,MMW 13R,A02,514039,Staff,0,2,16,16
1714645059468,MMW 13R,A03,628519,Staff,0,2,16,16
1714645061518,SIO 295LS,A00,523233,Staff,10,0,30,20
1714645062544,SIO 295S,A00,523232,Staff,10,0,30,20
1714645063571,SIOC 290S,A01,637330,Merrifield; Mark A,23,0,30,7
1714645064600,SIOC 291S,A01,637333,Gabriel; Corey John,23,0,30,7
1714645065625,SOCI 117,A01,494376,Staff,0,4,5,5
1714645066653,WES 237B,A00,494380,Staff,9,0,20,11
1714645068742,AESE 279B,A00,494370,Wade; Jon P,0,0,33,33
1714645069767,AIP 197,001,627712,Vespa; Emanuel Ignacio,9998,0,9999,1
1714645070794,ANAR 135S,A00,494369,Braswell; Geoffrey E.,0,0,0,0
1714645071819,BENG 196,001,628496,Engler; Adam J.,9998,0,9999,1
1714645072846,CAT 124RS,A01,519847,Geibel; William,0,0,20,20
1714645073872,CAT 125RS,A01,515971,Geibel; William,0,0,20,20
1714645074898,CLRE 250,A00,511389,Morris; Sheldon,9993,0,9999,6
1714645075924,CLRE 251,A00,507176,Mehta; Ravindra L.,9993,0,9999,6
1714645075924,CLRE 251,B00,511410,Mehta; Ravindra L.,9998,0,9999,1
1714645076950,CLRE 252,A00,507189,Cuomo; Raphael Eduardo,9995,0,9999,4
1714645077980,CLRE 253,A00,507199,Vaida; Florin,9994,0,9999,5
1714645077980,CLRE 253,B00,507202,Vaida; Florin,9999,0,9999,0
1714645079007,CLRE 259,A00,507211,Patel; Hemal,9996,0,9999,3
1714645080036,CLRE 260,A00,507221,Cuomo; Raphael Eduardo,9999,0,9999,0
1714645081061,CLRE 297,001,507242,Cuomo; Raphael Eduardo,9999,0,9999,0
1714645082089,COGS 197,001,638244,Voytek; Bradley Thomas,9998,0,9999,1
1714645083113,CSE 191,A00,516875,Minnes Kemp; Mor Mia,9992,0,9999,7
1714645084136,CSE 197,001,637388,Minnes Kemp; Mor Mia,9998,0,9999,1
1714645085163,CSS 201S,A01,494383,Staff,35,0,35,0
1714645086190,CSS 202S,A01,494387,Staff,35,0,35,0
1714645087216,DSC 197,001,628532,Eldridge; Justin Matthew,9996,0,9999,3
1714645088241,EAP 100,A00,516065,Staff,9797,0,9999,202
1714645089268,ECE 45,A01,507414,Staff,33,0,60,27
1714645091322,ECE 111,A01,507420,Staff,15,0,50,35
1714645092355,ECE 197,001,548057,Sievenpiper; Daniel F.,9993,0,9999,6
1714645093381,EDS 115,A00,507243,Choi; Bailey Miyeon,10,0,28,18
1714645094409,EDS 117,A01,494379,Staff,0,4,30,30
1714645095434,EDS 125,A00,507246,Hopkins; Megan Beth,9,0,30,21
1714645096462,EDS 128A,A01,507264,Fargason; Sharon Gayle,8,0,26,18
1714645097487,EDS 128B,A01,507293,Pappas; Elizabeth,12,0,30,18
1714645098512,EDS 139,A00,507294,Fargason; Sharon Gayle,13,0,30,17
1714645098512,EDS 139,B00,507313,Pappas; Elizabeth,13,0,30,17
1714645099537,EDS 201,A00,507315,Staff,13,0,30,17
1714645100568,EDS 203,A01,507317,Halter; Christopher P.,12,0,30,18
1714645101593,EDS 204R,A01,507319,Halter; Christopher P.,0,3,30,30
1714645101593,EDS 204R,B01,507331,Heinzman; Erica M.,16,0,30,14
1714645102620,EDS 206R,A00,507332,Staff,0,4,30,30
1714645102620,EDS 206R,B00,507343,Staff,17,0,30,13
1714645103650,EDS 250,A00,507344,Hemans; Patricia Ann Benitez,22,0,40,18
1714645104679,EDS 281,A00,507345,Daly; Alan J.,18,0,18,0
1714645105703,EDS 284,A00,507350,Daly; Alan J.,16,0,16,0
1714645106731,EDS 286,A00,507359,Fine; Sarah,18,0,18,0
1714645107758,EDS 289C,A01,507361,Daly; Alan J.,18,0,18,0
1714645108783,EDS 290,A00,507366,Hofstetter; Carolyn,15,0,15,0
1714645109809,LIGM 5A,A00,507421,Fischer-Grunski; Eva K,18,0,20,2
1714645110834,LIGM 5B,A00,507423,Fischer-Grunski; Eva K,19,0,20,1
1714645111862,LIGM 5C,A00,507425,Fischer-Grunski; Eva K,19,0,20,1
1714645112887,LIIT 5AS,A00,507427,Carnelos; Chiara,20,0,20,0
1714645113930,LIIT 5BS,A00,507430,Carnelos; Chiara,20,0,20,0
1714645114959,LIIT 5CS,A00,507432,Carnelos; Chiara,20,0,20,0
1714645115983,LISP 5A,A00,507541,Munoz Sanchez; Alicia,11,0,20,9
1714645117009,LISP 5B,A00,507671,Munoz Sanchez; Alicia,8,0,20,12
1714645118034,LISP 5C,A00,507696,Munoz Sanchez; Alicia,9,0,20,11
1714645119058,MAE 197,001,528363,Boechler; Nicholas Sebastia,9998,0,9999,1
1714645120089,MATH 197,001,523477,Kedlaya; Kiran S.,9995,0,9999,4
1714645120089,MATH 197,002,563811,Zhang; Danna,9995,0,9999,4
1714645120089,MATH 197,003,628552,Dumitriu; Ioana,9998,0,9999,1
1714645121113,MCWP 40R,A00,518780,Staff,2,0,20,18
1714645121113,MCWP 40R,B00,518781,Staff,8,0,20,12
1714645121113,MCWP 40R,C00,518783,Staff,6,0,20,14
1714645122142,MCWP 50R,A00,518791,Staff,0,0,20,20
1714645122142,MCWP 50R,B00,518792,Staff,0,2,20,20
1714645122142,MCWP 50R,C00,518793,Staff,0,2,20,20
1714645122142,MCWP 50R,D00,518794,Staff,0,1,20,20
1714645122142,MCWP 50R,E00,518795,Staff,0,2,20,20
1714645122142,MCWP 50R,F00,518796,Staff,0,0,20,20
1714645122142,MCWP 50R,G00,518797,Staff,0,1,20,20
1714645123167,MMW 12R,A01,514034,Herbst; Matthew,0,0,16,16
1714645123167,MMW 12R,A02,514035,Herbst; Matthew,1,0,16,15
1714645124216,MMW 13R,A01,514037,Staff,0,4,16,16
1714645124216,MMW 13R,A02,514039,Staff,0,2,16,16
1714645124216,MMW 13R,A03,628519,Staff,0,2,16,16
1714645126270,SIO 295LS,A00,523233,Staff,10,0,30,20
1714645127297,SIO 295S,A00,523232,Staff,10,0,30,20
1714645128324,SIOC 290S,A01,637330,Merrifield; Mark A,23,0,30,7
1714645129350,SIOC 291S,A01,637333,Gabriel; Corey John,23,0,30,7
1714645130379,SOCI 117,A01,494376,Staff,0,4,5,5
1714645131405,WES 237B,A00,494380,Staff,9,0,20,11
1714645133481,AESE 279B,A00,494370,Wade; Jon P,0,0,33,33
1714645134515,AIP 197,001,627712,Vespa; Emanuel Ignacio,9998,0,9999,1
1714645135541,ANAR 135S,A00,494369,Braswell; Geoffrey E.,0,0,0,0
1714645136566,BENG 196,001,628496,Engler; Adam J.,9998,0,9999,1
1714645137591,CAT 124RS,A01,519847,Geibel; William,0,0,20,20
1714645138615,CAT 125RS,A01,515971,Geibel; William,0,0,20,20
1714645139646,CLRE 250,A00,511389,Morris; Sheldon,9993,0,9999,6
1714645140673,CLRE 251,A00,507176,Mehta; Ravindra L.,9993,0,9999,6
1714645140673,CLRE 251,B00,511410,Mehta; Ravindra L.,9998,0,9999,1
1714645141697,CLRE 252,A00,507189,Cuomo; Raphael Eduardo,9995,0,9999,4
1714645142729,CLRE 253,A00,507199,Vaida; Florin,9994,0,9999,5
1714645142729,CLRE 253,B00,507202,Vaida; Florin,9999,0,9999,0
1714645143753,CLRE 259,A00,507211,Patel; Hemal,9996,0,9999,3
1714645144778,CLRE 260,A00,507221,Cuomo; Raphael Eduardo,9999,0,9999,0
1714645145802,CLRE 297,001,507242,Cuomo; Raphael Eduardo,9999,0,9999,0
1714645146831,COGS 197,001,638244,Voytek; Bradley Thomas,9998,0,9999,1
1714645147858,CSE 191,A00,516875,Minnes Kemp; Mor Mia,9992,0,9999,7
1714645148889,CSE 197,001,637388,Minnes Kemp; Mor Mia,9998,0,9999,1
1714645149921,CSS 201S,A01,494383,Staff,35,0,35,0
1714645150945,CSS 202S,A01,494387,Staff,35,0,35,0
1714645151977,DSC 197,001,628532,Eldridge; Justin Matthew,9996,0,9999,3
1714645153005,EAP 100,A00,516065,Staff,9797,0,9999,202
1714645154035,ECE 45,A01,507414,Staff,33,0,60,27
1714645156089,ECE 111,A01,507420,Staff,15,0,50,35
1714645157117,ECE 197,001,548057,Sievenpiper; Daniel F.,9993,0,9999,6
1714645158142,EDS 115,A00,507243,Choi; Bailey Miyeon,10,0,28,18
1714645159169,EDS 117,A01,494379,Staff,0,4,30,30
1714645160194,EDS 125,A00,507246,Hopkins; Megan Beth,9,0,30,21
1714645161220,EDS 128A,A01,507264,Fargason; Sharon Gayle,8,0,26,18
1714645162279,EDS 128B,A01,507293,Pappas; Elizabeth,12,0,30,18
1714645163303,EDS 139,A00,507294,Fargason; Sharon Gayle,13,0,30,17
1714645163303,EDS 139,B00,507313,Pappas; Elizabeth,13,0,30,17
1714645164330,EDS 201,A00,507315,Staff,13,0,30,17
1714645165357,EDS 203,A01,507317,Halter; Christopher P.,12,0,30,18
1714645166387,EDS 204R,A01,507319,Halter; Christopher P.,0,3,30,30
1714645166387,EDS 204R,B01,507331,Heinzman; Erica M.,16,0,30,14
1714645167415,EDS 206R,A00,507332,Staff,0,4,30,30
1714645167415,EDS 206R,B00,507343,Staff,17,0,30,13
1714645168439,EDS 250,A00,507344,Hemans; Patricia Ann Benitez,22,0,40,18
1714645169468,EDS 281,A00,507345,Daly; Alan J.,18,0,18,0
1714645170491,EDS 284,A00,507350,Daly; Alan J.,16,0,16,0
1714645171518,EDS 286,A00,507359,Fine; Sarah,18,0,18,0
1714645172545,EDS 289C,A01,507361,Daly; Alan J.,18,0,18,0
1714645173570,EDS 290,A00,507366,Hofstetter; Carolyn,15,0,15,0
1714645174598,LIGM 5A,A00,507421,Fischer-Grunski; Eva K,18,0,20,2
1714645175628,LIGM 5B,A00,507423,Fischer-Grunski; Eva K,19,0,20,1
1714645176656,LIGM 5C,A00,507425,Fischer-Grunski; Eva K,19,0,20,1
1714645177687,LIIT 5AS,A00,507427,Carnelos; Chiara,20,0,20,0
1714645178712,LIIT 5BS,A00,507430,Carnelos; Chiara,20,0,20,0
1714645179742,LIIT 5CS,A00,507432,Carnelos; Chiara,20,0,20,0
1714645180769,LISP 5A,A00,507541,Munoz Sanchez; Alicia,11,0,20,9
1714645181798,LISP 5B,A00,507671,Munoz Sanchez; Alicia,8,0,20,12
1714645182826,LISP 5C,A00,507696,Munoz Sanchez; Alicia,9,0,20,11
1714645183850,MAE 197,001,528363,Boechler; Nicholas Sebastia,9998,0,9999,1
1714645184881,MATH 197,001,523477,Kedlaya; Kiran S.,9995,0,9999,4
1714645184881,MATH 197,002,563811,Zhang; Danna,9995,0,9999,4
1714645184881,MATH 197,003,628552,Dumitriu; Ioana,9998,0,9999,1
1714645185906,MCWP 40R,A00,518780,Staff,2,0,20,18
1714645185906,MCWP 40R,B00,518781,Staff,8,0,20,12
1714645185906,MCWP 40R,C00,518783,Staff,6,0,20,14
1714645186933,MCWP 50R,A00,518791,Staff,0,0,20,20
1714645186933,MCWP 50R,B00,518792,Staff,0,2,20,20
1714645186933,MCWP 50R,C00,518793,Staff,0,2,20,20
1714645186933,MCWP 50R,D00,518794,Staff,0,1,20,20
1714645186933,MCWP 50R,E00,518795,Staff,0,2,20,20
1714645186933,MCWP 50R,F00,518796,Staff,0,0,20,20
1714645186933,MCWP 50R,G00,518797,Staff,0,1,20,20
1714645187960,MMW 12R,A01,514034,Herbst; Matthew,0,0,16,16
1714645187960,MMW 12R,A02,514035,Herbst; Matthew,1,0,16,15
1714645188984,MMW 13R,A01,514037,Staff,0,4,16,16
1714645188984,MMW 13R,A02,514039,Staff,0,2,16,16
1714645188984,MMW 13R,A03,628519,Staff,0,2,16,16
1714645191041,SIO 295LS,A00,523233,Staff,10,0,30,20
1714645192066,SIO 295S,A00,523232,Staff,10,0,30,20
1714645193095,SIOC 290S,A01,637330,Merrifield; Mark A,23,0,30,7
1714645194124,SIOC 291S,A01,637333,Gabriel; Corey John,23,0,30,7
1714645195158,SOCI 117,A01,494376,Staff,0,4,5,5
1714645196183,WES 237B,A00,494380,Staff,9,0,20,11
1714645198266,AESE 279B,A00,494370,Wade; Jon P,0,0,33,33
1714645199297,AIP 197,001,627712,Vespa; Emanuel Ignacio,9998,0,9999,1
1714645200328,ANAR 135S,A00,494369,Braswell; Geoffrey E.,0,0,0,0
1714645201353,BENG 196,001,628496,Engler; Adam J.,9998,0,9999,1
1714645202380,CAT 124RS,A01,519847,Geibel; William,0,0,20,20
1714645203405,CAT 125RS,A01,515971,Geibel; William,0,0,20,20
1714645204432,CLRE 250,A00,511389,Morris; Sheldon,9993,0,9999,6
1714645205460,CLRE 251,A00,507176,Mehta; Ravindra L.,9993,0,9999,6
1714645205460,CLRE 251,B00,511410,Mehta; Ravindra L.,9998,0,9999,1
1714645206489,CLRE 252,A00,507189,Cuomo; Raphael Eduardo,9995,0,9999,4
1714645207513,CLRE 253,A00,507199,Vaida; Florin,9994,0,9999,5
1714645207513,CLRE 253,B00,507202,Vaida; Florin,9999,0,9999,0
1714645208538,CLRE 259,A00,507211,Patel; Hemal,9996,0,9999,3
1714645209564,CLRE 260,A00,507221,Cuomo; Raphael Eduardo,9999,0,9999,0
1714645210591,CLRE 297,001,507242,Cuomo; Raphael Eduardo,9999,0,9999,0
1714645211617,COGS 197,001,638244,Voytek; Bradley Thomas,9998,0,9999,1
1714645212641,CSE 191,A00,516875,Minnes Kemp; Mor Mia,9992,0,9999,7
1714645213666,CSE 197,001,637388,Minnes Kemp; Mor Mia,9998,0,9999,1
1714645214694,CSS 201S,A01,494383,Staff,35,0,35,0
1714645215721,CSS 202S,A01,494387,Staff,35,0,35,0
1714645216746,DSC 197,001,628532,Eldridge; Justin Matthew,9996,0,9999,3
1714645217771,EAP 100,A00,516065,Staff,9797,0,9999,202
1714645218801,ECE 45,A01,507414,Staff,33,0,60,27
1714645220905,ECE 111,A01,507420,Staff,15,0,50,35
1714645221934,ECE 197,001,548057,Sievenpiper; Daniel F.,9993,0,9999,6
1714645222961,EDS 115,A00,507243,Choi; Bailey Miyeon,10,0,28,18
1714645223985,EDS 117,A01,494379,Staff,0,4,30,30
1714645225010,EDS 125,A00,507246,Hopkins; Megan Beth,9,0,30,21
1714645226037,EDS 128A,A01,507264,Fargason; Sharon Gayle,8,0,26,18
1714645227062,EDS 128B,A01,507293,Pappas; Elizabeth,12,0,30,18
1714645228086,EDS 139,A00,507294,Fargason; Sharon Gayle,13,0,30,17
1714645228086,EDS 139,B00,507313,Pappas; Elizabeth,13,0,30,17
1714645229111,EDS 201,A00,507315,Staff,13,0,30,17
1714645230139,EDS 203,A01,507317,Halter; Christopher P.,12,0,30,18
1714645231166,EDS 204R,A01,507319,Halter; Christopher P.,0,3,30,30
1714645231166,EDS 204R,B01,507331,Heinzman; Erica M.,16,0,30,14
1714645232192,EDS 206R,A00,507332,Staff,0,4,30,30
1714645232192,EDS 206R,B00,507343,Staff,17,0,30,13
1714645233218,EDS 250,A00,507344,Hemans; Patricia Ann Benitez,22,0,40,18
1714645234246,EDS 281,A00,507345,Daly; Alan J.,18,0,18,0
1714645235271,EDS 284,A00,507350,Daly; Alan J.,16,0,16,0
1714645236299,EDS 286,A00,507359,Fine; Sarah,18,0,18,0
1714645237327,EDS 289C,A01,507361,Daly; Alan J.,18,0,18,0
1714645238352,EDS 290,A00,507366,Hofstetter; Carolyn,15,0,15,0
1714645239377,LIGM 5A,A00,507421,Fischer-Grunski; Eva K,18,0,20,2
1714645240402,LIGM 5B,A00,507423,Fischer-Grunski; Eva K,19,0,20,1
1714645241426,LIGM 5C,A00,507425,Fischer-Grunski; Eva K,19,0,20,1
1714645242455,LIIT 5AS,A00,507427,Carnelos; Chiara,20,0,20,0
1714645243480,LIIT 5BS,A00,507430,Carnelos; Chiara,20,0,20,0
1714645244503,LIIT 5CS,A00,507432,Carnelos; Chiara,20,0,20,0
1714645245530,LISP 5A,A00,507541,Munoz Sanchez; Alicia,11,0,20,9
1714645246560,LISP 5B,A00,507671,Munoz Sanchez; Alicia,8,0,20,12
1714645247589,LISP 5C,A00,507696,Munoz Sanchez; Alicia,9,0,20,11
1714645248618,MAE 197,001,528363,Boechler; Nicholas Sebastia,9998,0,9999,1
1714645249653,MATH 197,001,523477,Kedlaya; Kiran S.,9995,0,9999,4
1714645249653,MATH 197,002,563811,Zhang; Danna,9995,0,9999,4
1714645249653,MATH 197,003,628552,Dumitriu; Ioana,9998,0,9999,1
1714645250678,MCWP 40R,A00,518780,Staff,2,0,20,18
1714645250678,MCWP 40R,B00,518781,Staff,8,0,20,12
1714645250678,MCWP 40R,C00,518783,Staff,6,0,20,14
1714645251709,MCWP 50R,A00,518791,Staff,0,0,20,20
1714645251709,MCWP 50R,B00,518792,Staff,0,2,20,20
1714645251709,MCWP 50R,C00,518793,Staff,0,2,20,20
1714645251709,MCWP 50R,D00,518794,Staff,0,1,20,20
1714645251709,MCWP 50R,E00,518795,Staff,0,2,20,20
1714645251709,MCWP 50R,F00,518796,Staff,0,0,20,20
1714645251709,MCWP 50R,G00,518797,Staff,0,1,20,20
1714645252733,MMW 12R,A01,514034,Herbst; Matthew,0,0,16,16
1714645252733,MMW 12R,A02,514035,Herbst; Matthew,1,0,16,15
1714645253762,MMW 13R,A01,514037,Staff,0,4,16,16
1714645253762,MMW 13R,A02,514039,Staff,0,2,16,16
1714645253762,MMW 13R,A03,628519,Staff,0,2,16,16
1714645255815,SIO 295LS,A00,523233,Staff,10,0,30,20
1714645256839,SIO 295S,A00,523232,Staff,10,0,30,20
1714645257869,SIOC 290S,A01,637330,Merrifield; Mark A,23,0,30,7
1714645258899,SIOC 291S,A01,637333,Gabriel; Corey John,23,0,30,7
1714645259932,SOCI 117,A01,494376,Staff,0,4,5,5
1714645260964,WES 237B,A00,494380,Staff,9,0,20,11
1714645263084,AESE 279B,A00,494370,Wade; Jon P,0,0,33,33
1714645264109,AIP 197,001,627712,Vespa; Emanuel Ignacio,9998,0,9999,1
1714645265136,ANAR 135S,A00,494369,Braswell; Geoffrey E.,0,0,0,0
1714645266168,BENG 196,001,628496,Engler; Adam J.,9998,0,9999,1
1714645267194,CAT 124RS,A01,519847,Geibel; William,0,0,20,20
1714645268218,CAT 125RS,A01,515971,Geibel; William,0,0,20,20
1714645269243,CLRE 250,A00,511389,Morris; Sheldon,9993,0,9999,6
1714645270270,CLRE 251,A00,507176,Mehta; Ravindra L.,9993,0,9999,6
1714645270270,CLRE 251,B00,511410,Mehta; Ravindra L.,9998,0,9999,1
1714645271300,CLRE 252,A00,507189,Cuomo; Raphael Eduardo,9995,0,9999,4
1714645272331,CLRE 253,A00,507199,Vaida; Florin,9994,0,9999,5
1714645272331,CLRE 253,B00,507202,Vaida; Florin,9999,0,9999,0
1714645273356,CLRE 259,A00,507211,Patel; Hemal,9996,0,9999,3
1714645274381,CLRE 260,A00,507221,Cuomo; Raphael Eduardo,9999,0,9999,0
1714645275406,CLRE 297,001,507242,Cuomo; Raphael Eduardo,9999,0,9999,0
1714645276434,COGS 197,001,638244,Voytek; Bradley Thomas,9998,0,9999,1
1714645277467,CSE 191,A00,516875,Minnes Kemp; Mor Mia,9992,0,9999,7
1714645278494,CSE 197,001,637388,Minnes Kemp; Mor Mia,9998,0,9999,1
1714645279520,CSS 201S,A01,494383,Staff,35,0,35,0
1714645280545,CSS 202S,A01,494387,Staff,35,0,35,0
1714645281575,DSC 197,001,628532,Eldridge; Justin Matthew,9996,0,9999,3
1714645282603,EAP 100,A00,516065,Staff,9797,0,9999,202
1714645283629,ECE 45,A01,507414,Staff,33,0,60,27
1714645285681,ECE 111,A01,507420,Staff,15,0,50,35
1714645286710,ECE 197,001,548057,Sievenpiper; Daniel F.,9993,0,9999,6
1714645287737,EDS 115,A00,507243,Choi; Bailey Miyeon,10,0,28,18
1714645288767,EDS 117,A01,494379,Staff,0,4,30,30
1714645289793,EDS 125,A00,507246,Hopkins; Megan Beth,9,0,30,21
1714645290823,EDS 128A,A01,507264,Fargason; Sharon Gayle,8,0,26,18
1714645291848,EDS 128B,A01,507293,Pappas; Elizabeth,12,0,30,18
1714645292878,EDS 139,A00,507294,Fargason; Sharon Gayle,13,0,30,17
1714645292878,EDS 139,B00,507313,Pappas; Elizabeth,13,0,30,17
1714645293906,EDS 201,A00,507315,Staff,13,0,30,17
1714645294932,EDS 203,A01,507317,Halter; Christopher P.,12,0,30,18
1714645295963,EDS 204R,A01,507319,Halter; Christopher P.,0,3,30,30
1714645295963,EDS 204R,B01,507331,Heinzman; Erica M.,16,0,30,14
1714645296992,EDS 206R,A00,507332,Staff,0,4,30,30
1714645296992,EDS 206R,B00,507343,Staff,17,0,30,13
1714645298018,EDS 250,A00,507344,Hemans; Patricia Ann Benitez,22,0,40,18
1714645299043,EDS 281,A00,507345,Daly; Alan J.,18,0,18,0
1714645300066,EDS 284,A00,507350,Daly; Alan J.,16,0,16,0
1714645301093,EDS 286,A00,507359,Fine; Sarah,18,0,18,0
1714645302119,EDS 289C,A01,507361,Daly; Alan J.,18,0,18,0
1714645303145,EDS 290,A00,507366,Hofstetter; Carolyn,15,0,15,0
1714645304174,LIGM 5A,A00,507421,Fischer-Grunski; Eva K,18,0,20,2
1714645305198,LIGM 5B,A00,507423,Fischer-Grunski; Eva K,19,0,20,1
1714645306227,LIGM 5C,A00,507425,Fischer-Grunski; Eva K,19,0,20,1
1714645307257,LIIT 5AS,A00,507427,Carnelos; Chiara,20,0,20,0
1714645308287,LIIT 5BS,A00,507430,Carnelos; Chiara,20,0,20,0
1714645309315,LIIT 5CS,A00,507432,Carnelos; Chiara,20,0,20,0
1714645310345,LISP 5A,A00,507541,Munoz Sanchez; Alicia,11,0,20,9
1714645311370,LISP 5B,A00,507671,Munoz Sanchez; Alicia,8,0,20,12
1714645312397,LISP 5C,A00,507696,Munoz Sanchez; Alicia,9,0,20,11
1714645313428,MAE 197,001,528363,Boechler; Nicholas Sebastia,9998,0,9999,1
1714645314455,MATH 197,001,523477,Kedlaya; Kiran S.,9995,0,9999,4
1714645314455,MATH 197,002,563811,Zhang; Danna,9995,0,9999,4
1714645314455,MATH 197,003,628552,Dumitriu; Ioana,9998,0,9999,1
1714645315482,MCWP 40R,A00,518780,Staff,2,0,20,18
1714645315482,MCWP 40R,B00,518781,Staff,8,0,20,12
1714645315482,MCWP 40R,C00,518783,Staff,6,0,20,14
1714645316513,MCWP 50R,A00,518791,Staff,0,0,20,20
1714645316513,MCWP 50R,B00,518792,Staff,0,2,20,20
1714645316513,MCWP 50R,C00,518793,Staff,0,2,20,20
1714645316513,MCWP 50R,D00,518794,Staff,0,1,20,20
1714645316513,MCWP 50R,E00,518795,Staff,0,2,20,20
1714645316513,MCWP 50R,F00,518796,Staff,0,0,20,20
1714645316513,MCWP 50R,G00,518797,Staff,0,1,20,20
1714645317542,MMW 12R,A01,514034,Herbst; Matthew,0,0,16,16
1714645317542,MMW 12R,A02,514035,Herbst; Matthew,1,0,16,15
1714645318567,MMW 13R,A01,514037,Staff,0,4,16,16
1714645318567,MMW 13R,A02,514039,Staff,0,2,16,16
1714645318567,MMW 13R,A03,628519,Staff,0,2,16,16
1714645320622,SIO 295LS,A00,523233,Staff,10,0,30,20
1714645321650,SIO 295S,A00,523232,Staff,10,0,30,20
1714645322682,SIOC 290S,A01,637330,Merrifield; Mark A,23,0,30,7
1714645323707,SIOC 291S,A01,637333,Gabriel; Corey John,23,0,30,7
1714645324737,SOCI 117,A01,494376,Staff,0,4,5,5
1714645325762,WES 237B,A00,494380,Staff,9,0,20,11
1714645327846,AESE 279B,A00,494370,Wade; Jon P,0,0,33,33
1714645328875,AIP 197,001,627712,Vespa; Emanuel Ignacio,9998,0,9999,1
1714645329900,ANAR 135S,A00,494369,Braswell; Geoffrey E.,0,0,0,0
1714645330924,BENG 196,001,628496,Engler; Adam J.,9998,0,9999,1
1714645331954,CAT 124RS,A01,519847,Geibel; William,0,0,20,20
1714645333035,CAT 125RS,A01,515971,Geibel; William,0,0,20,20
1714645334066,CLRE 250,A00,511389,Morris; Sheldon,9993,0,9999,6
1714645335094,CLRE 251,A00,507176,Mehta; Ravindra L.,9993,0,9999,6
1714645335094,CLRE 251,B00,511410,Mehta; Ravindra L.,9998,0,9999,1
1714645336119,CLRE 252,A00,507189,Cuomo; Raphael Eduardo,9995,0,9999,4
1714645337144,CLRE 253,A00,507199,Vaida; Florin,9994,0,9999,5
1714645337144,CLRE 253,B00,507202,Vaida; Florin,9999,0,9999,0
1714645338173,CLRE 259,A00,507211,Patel; Hemal,9996,0,9999,3
1714645339200,CLRE 260,A00,507221,Cuomo; Raphael Eduardo,9999,0,9999,0
1714645340227,CLRE 297,001,507242,Cuomo; Raphael Eduardo,9999,0,9999,0
1714645341256,COGS 197,001,638244,Voytek; Bradley Thomas,9998,0,9999,1
1714645342283,CSE 191,A00,516875,Minnes Kemp; Mor Mia,9992,0,9999,7
1714645343310,CSE 197,001,637388,Minnes Kemp; Mor Mia,9998,0,9999,1
1714645344336,CSS 201S,A01,494383,Staff,35,0,35,0
1714645345361,CSS 202S,A01,494387,Staff,35,0,35,0
1714645346390,DSC 197,001,628532,Eldridge; Justin Matthew,9996,0,9999,3
1714645347417,EAP 100,A00,516065,Staff,9797,0,9999,202
1714645348441,ECE 45,A01,507414,Staff,33,0,60,27
1714645350491,ECE 111,A01,507420,Staff,15,0,50,35
1714645351518,ECE 197,001,548057,Sievenpiper; Daniel F.,9993,0,9999,6
1714645352547,EDS 115,A00,507243,Choi; Bailey Miyeon,10,0,28,18
1714645353577,EDS 117,A01,494379,Staff,0,4,30,30
1714645354603,EDS 125,A00,507246,Hopkins; Megan Beth,9,0,30,21
1714645355632,EDS 128A,A01,507264,Fargason; Sharon Gayle,8,0,26,18
1714645356657,EDS 128B,A01,507293,Pappas; Elizabeth,12,0,30,18
1714645357684,EDS 139,A00,507294,Fargason; Sharon Gayle,13,0,30,17
1714645357684,EDS 139,B00,507313,Pappas; Elizabeth,13,0,30,17
1714645358713,EDS 201,A00,507315,Staff,13,0,30,17
1714645359742,EDS 203,A01,507317,Halter; Christopher P.,12,0,30,18
1714645360771,EDS 204R,A01,507319,Halter; Christopher P.,0,3,30,30
1714645360771,EDS 204R,B01,507331,Heinzman; Erica M.,16,0,30,14
1714645361799,EDS 206R,A00,507332,Staff,0,4,30,30
1714645361799,EDS 206R,B00,507343,Staff,17,0,30,13
1714645362825,EDS 250,A00,507344,Hemans; Patricia Ann Benitez,22,0,40,18
1714645363851,EDS 281,A00,507345,Daly; Alan J.,18,0,18,0
1714645364876,EDS 284,A00,507350,Daly; Alan J.,16,0,16,0
1714645365905,EDS 286,A00,507359,Fine; Sarah,18,0,18,0
1714645366930,EDS 289C,A01,507361,Daly; Alan J.,18,0,18,0
1714645367958,EDS 290,A00,507366,Hofstetter; Carolyn,15,0,15,0
1714645368985,LIGM 5A,A00,507421,Fischer-Grunski; Eva K,18,0,20,2
1714645370014,LIGM 5B,A00,507423,Fischer-Grunski; Eva K,19,0,20,1
1714645371039,LIGM 5C,A00,507425,Fischer-Grunski; Eva K,19,0,20,1
1714645372064,LIIT 5AS,A00,507427,Carnelos; Chiara,20,0,20,0
1714645373093,LIIT 5BS,A00,507430,Carnelos; Chiara,20,0,20,0
1714645374120,LIIT 5CS,A00,507432,Carnelos; Chiara,20,0,20,0
1714645375147,LISP 5A,A00,507541,Munoz Sanchez; Alicia,11,0,20,9
1714645376177,LISP 5B,A00,507671,Munoz Sanchez; Alicia,8,0,20,12
1714645377206,LISP 5C,A00,507696,Munoz Sanchez; Alicia,9,0,20,11
1714645378234,MAE 197,001,528363,Boechler; Nicholas Sebastia,9998,0,9999,1
1714645379266,MATH 197,001,523477,Kedlaya; Kiran S.,9995,0,9999,4
1714645379266,MATH 197,002,563811,Zhang; Danna,9995,0,9999,4
1714645379266,MATH 197,003,628552,Dumitriu; Ioana,9998,0,9999,1
1714645380322,MCWP 40R,A00,518780,Staff,2,0,20,18
1714645380322,MCWP 40R,B00,518781,Staff,8,0,20,12
1714645380322,MCWP 40R,C00,518783,Staff,6,0,20,14
1714645381351,MCWP 50R,A00,518791,Staff,0,0,20,20
1714645381351,MCWP 50R,B00,518792,Staff,0,2,20,20
1714645381351,MCWP 50R,C00,518793,Staff,0,2,20,20
1714645381351,MCWP 50R,D00,518794,Staff,0,1,20,20
1714645381351,MCWP 50R,E00,518795,Staff,0,2,20,20
1714645381351,MCWP 50R,F00,518796,Staff,0,0,20,20
1714645381351,MCWP 50R,G00,518797,Staff,0,1,20,20
1714645382377,MMW 12R,A01,514034,Herbst; Matthew,0,0,16,16
1714645382377,MMW 12R,A02,514035,Herbst; Matthew,1,0,16,15
1714645383405,MMW 13R,A01,514037,Staff,0,4,16,16
1714645383405,MMW 13R,A02,514039,Staff,0,2,16,16
1714645383405,MMW 13R,A03,628519,Staff,0,2,16,16
1714645385456,SIO 295LS,A00,523233,Staff,10,0,30,20
1714645386479,SIO 295S,A00,523232,Staff,10,0,30,20
1714645387510,SIOC 290S,A01,637330,Merrifield; Mark A,23,0,30,7
1714645388535,SIOC 291S,A01,637333,Gabriel; Corey John,23,0,30,7
1714645389560,SOCI 117,A01,494376,Staff,0,4,5,5
1714645390587,WES 237B,A00,494380,Staff,9,0,20,11
1714645392666,AESE 279B,A00,494370,Wade; Jon P,0,0,33,33
1714645393690,AIP 197,001,627712,Vespa; Emanuel Ignacio,9998,0,9999,1
1714645394715,ANAR 135S,A00,494369,Braswell; Geoffrey E.,0,0,0,0
1714645395743,BENG 196,001,628496,Engler; Adam J.,9998,0,9999,1
1714645396771,CAT 124RS,A01,519847,Geibel; William,0,0,20,20
1714645397797,CAT 125RS,A01,515971,Geibel; William,0,0,20,20
1714645398823,CLRE 250,A00,511389,Morris; Sheldon,9993,0,9999,6
1714645399850,CLRE 251,A00,507176,Mehta; Ravindra L.,9993,0,9999,6
1714645399850,CLRE 251,B00,511410,Mehta; Ravindra L.,9998,0,9999,1
1714645400878,CLRE 252,A00,507189,Cuomo; Raphael Eduardo,9995,0,9999,4
1714645401908,CLRE 253,A00,507199,Vaida; Florin,9994,0,9999,5
1714645401908,CLRE 253,B00,507202,Vaida; Florin,9999,0,9999,0
1714645402933,CLRE 259,A00,507211,Patel; Hemal,9996,0,9999,3
1714645403961,CLRE 260,A00,507221,Cuomo; Raphael Eduardo,9999,0,9999,0
1714645404985,CLRE 297,001,507242,Cuomo; Raphael Eduardo,9999,0,9999,0
1714645406012,COGS 197,001,638244,Voytek; Bradley Thomas,9998,0,9999,1
1714645407041,CSE 191,A00,516875,Minnes Kemp; Mor Mia,9992,0,9999,7
1714645408070,CSE 197,001,637388,Minnes Kemp; Mor Mia,9998,0,9999,1
1714645409100,CSS 201S,A01,494383,Staff,35,0,35,0
1714645410126,CSS 202S,A01,494387,Staff,35,0,35,0
1714645411154,DSC 197,001,628532,Eldridge; Justin Matthew,9996,0,9999,3
1714645412180,EAP 100,A00,516065,Staff,9797,0,9999,202
1714645413206,ECE 45,A01,507414,Staff,33,0,60,27
1714645415258,ECE 111,A01,507420,Staff,15,0,50,35
1714645416285,ECE 197,001,548057,Sievenpiper; Daniel F.,9993,0,9999,6
1714645417313,EDS 115,A00,507243,Choi; Bailey Miyeon,10,0,28,18
1714645418342,EDS 117,A01,494379,Staff,0,4,30,30
1714645419370,EDS 125,A00,507246,Hopkins; Megan Beth,9,0,30,21
1714645420395,EDS 128A,A01,507264,Fargason; Sharon Gayle,8,0,26,18
1714645421424,EDS 128B,A01,507293,Pappas; Elizabeth,12,0,30,18
1714645422450,EDS 139,A00,507294,Fargason; Sharon Gayle,13,0,30,17
1714645422450,EDS 139,B00,507313,Pappas; Elizabeth,13,0,30,17
1714645423476,EDS 201,A00,507315,Staff,13,0,30,17
1714645424508,EDS 203,A01,507317,Halter; Christopher P.,12,0,30,18
1714645425538,EDS 204R,A01,507319,Halter; Christopher P.,0,3,30,30
1714645425538,EDS 204R,B01,507331,Heinzman; Erica M.,16,0,30,14
1714645426562,EDS 206R,A00,507332,Staff,0,4,30,30
1714645426562,EDS 206R,B00,507343,Staff,17,0,30,13
1714645427588,EDS 250,A00,507344,Hemans; Patricia Ann Benitez,22,0,40,18
1714645428612,EDS 281,A00,507345,Daly; Alan J.,18,0,18,0
1714645429638,EDS 284,A00,507350,Daly; Alan J.,16,0,16,0
1714645430663,EDS 286,A00,507359,Fine; Sarah,18,0,18,0
1714645431692,EDS 289C,A01,507361,Daly; Alan J.,18,0,18,0
1714645432723,EDS 290,A00,507366,Hofstetter; Carolyn,15,0,15,0
1714645433750,LIGM 5A,A00,507421,Fischer-Grunski; Eva K,18,0,20,2
1714645434775,LIGM 5B,A00,507423,Fischer-Grunski; Eva K,19,0,20,1
1714645435800,LIGM 5C,A00,507425,Fischer-Grunski; Eva K,19,0,20,1
1714645436831,LIIT 5AS,A00,507427,Carnelos; Chiara,20,0,20,0
1714645437856,LIIT 5BS,A00,507430,Carnelos; Chiara,20,0,20,0
1714645438884,LIIT 5CS,A00,507432,Carnelos; Chiara,20,0,20,0
1714645439915,LISP 5A,A00,507541,Munoz Sanchez; Alicia,11,0,20,9
1714645440941,LISP 5B,A00,507671,Munoz Sanchez; Alicia,8,0,20,12
1714645441967,LISP 5C,A00,507696,Munoz Sanchez; Alicia,9,0,20,11
1714645442991,MAE 197,001,528363,Boechler; Nicholas Sebastia,9998,0,9999,1
1714645444022,MATH 197,001,523477,Kedlaya; Kiran S.,9995,0,9999,4
1714645444022,MATH 197,002,563811,Zhang; Danna,9995,0,9999,4
1714645444022,MATH 197,003,628552,Dumitriu; Ioana,9998,0,9999,1
1714645445049,MCWP 40R,A00,518780,Staff,2,0,20,18
1714645445049,MCWP 40R,B00,518781,Staff,8,0,20,12
1714645445049,MCWP 40R,C00,518783,Staff,6,0,20,14
1714645446078,MCWP 50R,A00,518791,Staff,0,0,20,20
1714645446078,MCWP 50R,B00,518792,Staff,0,2,20,20
1714645446078,MCWP 50R,C00,518793,Staff,0,2,20,20
1714645446078,MCWP 50R,D00,518794,Staff,0,1,20,20
1714645446078,MCWP 50R,E00,518795,Staff,0,2,20,20
1714645446078,MCWP 50R,F00,518796,Staff,0,0,20,20
1714645446078,MCWP 50R,G00,518797,Staff,0,1,20,20
1714645447106,MMW 12R,A01,514034,Herbst; Matthew,0,0,16,16
1714645447106,MMW 12R,A02,514035,Herbst; Matthew,1,0,16,15
1714645448134,MMW 13R,A01,514037,Staff,0,4,16,16
1714645448134,MMW 13R,A02,514039,Staff,0,2,16,16
1714645448134,MMW 13R,A03,628519,Staff,0,2,16,16
1714645450191,SIO 295LS,A00,523233,Staff,10,0,30,20
1714645451218,SIO 295S,A00,523232,Staff,10,0,30,20
1714645452245,SIOC 290S,A01,637330,Merrifield; Mark A,23,0,30,7
1714645453269,SIOC 291S,A01,637333,Gabriel; Corey John,23,0,30,7
1714645454300,SOCI 117,A01,494376,Staff,0,4,5,5
1714645455327,WES 237B,A00,494380,Staff,9,0,20,11
1714645457387,AESE 279B,A00,494370,Wade; Jon P,0,0,33,33
1714645458412,AIP 197,001,627712,Vespa; Emanuel Ignacio,9998,0,9999,1
1714645459443,ANAR 135S,A00,494369,Braswell; Geoffrey E.,0,0,0,0
1714645460468,BENG 196,001,628496,Engler; Adam J.,9998,0,9999,1
1714645461494,CAT 124RS,A01,519847,Geibel; William,0,0,20,20
1714645462523,CAT 125RS,A01,515971,Geibel; William,0,0,20,20
1714645463549,CLRE 250,A00,511389,Morris; Sheldon,9993,0,9999,6
1714645464578,CLRE 251,A00,507176,Mehta; Ravindra L.,9993,0,9999,6
1714645464578,CLRE 251,B00,511410,Mehta; Ravindra L.,9998,0,9999,1
1714645465609,CLRE 252,A00,507189,Cuomo; Raphael Eduardo,9995,0,9999,4
1714645466638,CLRE 253,A00,507199,Vaida; Florin,9994,0,9999,5
1714645466638,CLRE 253,B00,507202,Vaida; Florin,9999,0,9999,0
1714645467665,CLRE 259,A00,507211,Patel; Hemal,9996,0,9999,3
1714645468690,CLRE 260,A00,507221,Cuomo; Raphael Eduardo,9999,0,9999,0
1714645469715,CLRE 297,001,507242,Cuomo; Raphael Eduardo,9999,0,9999,0
1714645470744,COGS 197,001,638244,Voytek; Bradley Thomas,9998,0,9999,1
1714645471770,CSE 191,A00,516875,Minnes Kemp; Mor Mia,9992,0,9999,7
1714645472801,CSE 197,001,637388,Minnes Kemp; Mor Mia,9998,0,9999,1
1714645473828,CSS 201S,A01,494383,Staff,35,0,35,0
1714645474852,CSS 202S,A01,494387,Staff,35,0,35,0
1714645475883,DSC 197,001,628532,Eldridge; Justin Matthew,9996,0,9999,3
1714645476911,EAP 100,A00,516065,Staff,9797,0,9999,202
1714645477942,ECE 45,A01,507414,Staff,33,0,60,27
1714645479992,ECE 111,A01,507420,Staff,15,0,50,35
1714645481021,ECE 197,001,548057,Sievenpiper; Daniel F.,9993,0,9999,6
1714645482051,EDS 115,A00,507243,Choi; Bailey Miyeon,10,0,28,18
1714645483081,EDS 117,A01,494379,Staff,0,4,30,30
1714645484107,EDS 125,A00,507246,Hopkins; Megan Beth,9,0,30,21
1714645485135,EDS 128A,A01,507264,Fargason; Sharon Gayle,8,0,26,18
1714645486163,EDS 128B,A01,507293,Pappas; Elizabeth,12,0,30,18
1714645487187,EDS 139,A00,507294,Fargason; Sharon Gayle,13,0,30,17
1714645487187,EDS 139,B00,507313,Pappas; Elizabeth,13,0,30,17
1714645488214,EDS 201,A00,507315,Staff,13,0,30,17
1714645489238,EDS 203,A01,507317,Halter; Christopher P.,12,0,30,18
1714645490266,EDS 204R,A01,507319,Halter; Christopher P.,0,3,30,30
1714645490266,EDS 204R,B01,507331,Heinzman; Erica M.,16,0,30,14
1714645491293,EDS 206R,A00,507332,Staff,0,4,30,30
1714645491293,EDS 206R,B00,507343,Staff,17,0,30,13
1714645492320,EDS 250,A00,507344,Hemans; Patricia Ann Benitez,22,0,40,18
1714645493347,EDS 281,A00,507345,Daly; Alan J.,18,0,18,0
1714645494372,EDS 284,A00,507350,Daly; Alan J.,16,0,16,0
1714645495402,EDS 286,A00,507359,Fine; Sarah,18,0,18,0
1714645496428,EDS 289C,A01,507361,Daly; Alan J.,18,0,18,0
1714645497457,EDS 290,A00,507366,Hofstetter; Carolyn,15,0,15,0
1714645498483,LIGM 5A,A00,507421,Fischer-Grunski; Eva K,18,0,20,2
1714645499509,LIGM 5B,A00,507423,Fischer-Grunski; Eva K,19,0,20,1
1714645500536,LIGM 5C,A00,507425,Fischer-Grunski; Eva K,19,0,20,1
1714645501562,LIIT 5AS,A00,507427,Carnelos; Chiara,20,0,20,0
1714645502588,LIIT 5BS,A00,507430,Carnelos; Chiara,20,0,20,0
1714645503613,LIIT 5CS,A00,507432,Carnelos; Chiara,20,0,20,0
1714645504645,LISP 5A,A00,507541,Munoz Sanchez; Alicia,11,0,20,9
1714645505671,LISP 5B,A00,507671,Munoz Sanchez; Alicia,8,0,20,12
1714645506697,LISP 5C,A00,507696,Munoz Sanchez; Alicia,9,0,20,11
1714645507721,MAE 197,001,528363,Boechler; Nicholas Sebastia,9998,0,9999,1
1714645508756,MATH 197,001,523477,Kedlaya; Kiran S.,9995,0,9999,4
1714645508756,MATH 197,002,563811,Zhang; Danna,9995,0,9999,4
1714645508756,MATH 197,003,628552,Dumitriu; Ioana,9998,0,9999,1
1714645509783,MCWP 40R,A00,518780,Staff,2,0,20,18
1714645509783,MCWP 40R,B00,518781,Staff,8,0,20,12
1714645509783,MCWP 40R,C00,518783,Staff,6,0,20,14
1714645510814,MCWP 50R,A00,518791,Staff,0,0,20,20
1714645510814,MCWP 50R,B00,518792,Staff,0,2,20,20
1714645510814,MCWP 50R,C00,518793,Staff,0,2,20,20
1714645510814,MCWP 50R,D00,518794,Staff,0,1,20,20
1714645510814,MCWP 50R,E00,518795,Staff,0,2,20,20
1714645510814,MCWP 50R,F00,518796,Staff,0,0,20,20
1714645510814,MCWP 50R,G00,518797,Staff,0,1,20,20
1714645511840,MMW 12R,A01,514034,Herbst; Matthew,0,0,16,16
1714645511840,MMW 12R,A02,514035,Herbst; Matthew,1,0,16,15
1714645512868,MMW 13R,A01,514037,Staff,0,4,16,16
1714645512868,MMW 13R,A02,514039,Staff,0,2,16,16
1714645512868,MMW 13R,A03,628519,Staff,0,2,16,16
1714645514922,SIO 295LS,A00,523233,Staff,10,0,30,20
1714645515952,SIO 295S,A00,523232,Staff,10,0,30,20
1714645516977,SIOC 290S,A01,637330,Merrifield; Mark A,23,0,30,7
1714645518007,SIOC 291S,A01,637333,Gabriel; Corey John,23,0,30,7
1714645519035,SOCI 117,A01,494376,Staff,0,4,5,5
1714645520059,WES 237B,A00,494380,Staff,9,0,20,11
1714645522132,AESE 279B,A00,494370,Wade; Jon P,0,0,33,33
1714645523159,AIP 197,001,627712,Vespa; Emanuel Ignacio,9998,0,9999,1
1714645524184,ANAR 135S,A00,494369,Braswell; Geoffrey E.,0,0,0,0
1714645525209,BENG 196,001,628496,Engler; Adam J.,9998,0,9999,1
1714645526238,CAT 124RS,A01,519847,Geibel; William,0,0,20,20
1714645527269,CAT 125RS,A01,515971,Geibel; William,0,0,20,20
1714645528296,CLRE 250,A00,511389,Morris; Sheldon,9993,0,9999,6
1714645529323,CLRE 251,A00,507176,Mehta; Ravindra L.,9993,0,9999,6
1714645529323,CLRE 251,B00,511410,Mehta; Ravindra L.,9998,0,9999,1
1714645530352,CLRE 252,A00,507189,Cuomo; Raphael Eduardo,9995,0,9999,4
1714645531377,CLRE 253,A00,507199,Vaida; Florin,9994,0,9999,5
1714645531377,CLRE 253,B00,507202,Vaida; Florin,9999,0,9999,0
1714645532402,CLRE 259,A00,507211,Patel; Hemal,9996,0,9999,3
1714645533428,CLRE 260,A00,507221,Cuomo; Raphael Eduardo,9999,0,9999,0
1714645534453,CLRE 297,001,507242,Cuomo; Raphael Eduardo,9999,0,9999,0
1714645535484,COGS 197,001,638244,Voytek; Bradley Thomas,9998,0,9999,1
1714645536508,CSE 191,A00,516875,Minnes Kemp; Mor Mia,9992,0,9999,7
1714645537534,CSE 197,001,637388,Minnes Kemp; Mor Mia,9998,0,9999,1
1714645538563,CSS 201S,A01,494383,Staff,35,0,35,0
1714645539594,CSS 202S,A01,494387,Staff,35,0,35,0
1714645540619,DSC 197,001,628532,Eldridge; Justin Matthew,9996,0,9999,3
1714645541645,EAP 100,A00,516065,Staff,9797,0,9999,202
1714645542675,ECE 45,A01,507414,Staff,33,0,60,27
1714645544726,ECE 111,A01,507420,Staff,15,0,50,35
1714645545756,ECE 197,001,548057,Sievenpiper; Daniel F.,9993,0,9999,6
1714645546782,EDS 115,A00,507243,Choi; Bailey Miyeon,10,0,28,18
1714645547811,EDS 117,A01,494379,Staff,0,4,30,30
1714645548839,EDS 125,A00,507246,Hopkins; Megan Beth,9,0,30,21
1714645549863,EDS 128A,A01,507264,Fargason; Sharon Gayle,8,0,26,18
1714645550889,EDS 128B,A01,507293,Pappas; Elizabeth,12,0,30,18
1714645551914,EDS 139,A00,507294,Fargason; Sharon Gayle,13,0,30,17
1714645551914,EDS 139,B00,507313,Pappas; Elizabeth,13,0,30,17
1714645552941,EDS 201,A00,507315,Staff,13,0,30,17
1714645553967,EDS 203,A01,507317,Halter; Christopher P.,12,0,30,18
1714645554993,EDS 204R,A01,507319,Halter; Christopher P.,0,3,30,30
1714645554993,EDS 204R,B01,507331,Heinzman; Erica M.,16,0,30,14
1714645556021,EDS 206R,A00,507332,Staff,0,4,30,30
1714645556021,EDS 206R,B00,507343,Staff,17,0,30,13
1714645557045,EDS 250,A00,507344,Hemans; Patricia Ann Benitez,22,0,40,18
1714645558072,EDS 281,A00,507345,Daly; Alan J.,18,0,18,0
1714645559097,EDS 284,A00,507350,Daly; Alan J.,16,0,16,0
1714645560127,EDS 286,A00,507359,Fine; Sarah,18,0,18,0
1714645561157,EDS 289C,A01,507361,Daly; Alan J.,18,0,18,0
1714645562181,EDS 290,A00,507366,Hofstetter; Carolyn,15,0,15,0
1714645563210,LIGM 5A,A00,507421,Fischer-Grunski; Eva K,18,0,20,2
1714645564234,LIGM 5B,A00,507423,Fischer-Grunski; Eva K,19,0,20,1
1714645565259,LIGM 5C,A00,507425,Fischer-Grunski; Eva K,19,0,20,1
1714645566285,LIIT 5AS,A00,507427,Carnelos; Chiara,20,0,20,0
1714645567311,LIIT 5BS,A00,507430,Carnelos; Chiara,20,0,20,0
1714645568340,LIIT 5CS,A00,507432,Carnelos; Chiara,20,0,20,0
1714645569368,LISP 5A,A00,507541,Munoz Sanchez; Alicia,11,0,20,9
1714645570394,LISP 5B,A00,507671,Munoz Sanchez; Alicia,8,0,20,12
1714645571418,LISP 5C,A00,507696,Munoz Sanchez; Alicia,9,0,20,11
1714645572445,MAE 197,001,528363,Boechler; Nicholas Sebastia,9998,0,9999,1
1714645573473,MATH 197,001,523477,Kedlaya; Kiran S.,9995,0,9999,4
1714645573473,MATH 197,002,563811,Zhang; Danna,9995,0,9999,4
1714645573473,MATH 197,003,628552,Dumitriu; Ioana,9998,0,9999,1
1714645574499,MCWP 40R,A00,518780,Staff,2,0,20,18
1714645574499,MCWP 40R,B00,518781,Staff,8,0,20,12
1714645574499,MCWP 40R,C00,518783,Staff,6,0,20,14
1714645575526,MCWP 50R,A00,518791,Staff,0,0,20,20
1714645575526,MCWP 50R,B00,518792,Staff,0,2,20,20
1714645575526,MCWP 50R,C00,518793,Staff,0,2,20,20
1714645575526,MCWP 50R,D00,518794,Staff,0,1,20,20
1714645575526,MCWP 50R,E00,518795,Staff,0,2,20,20
1714645575526,MCWP 50R,F00,518796,Staff,0,0,20,20
1714645575526,MCWP 50R,G00,518797,Staff,0,1,20,20
1714645576552,MMW 12R,A01,514034,Herbst; Matthew,0,0,16,16
1714645576552,MMW 12R,A02,514035,Herbst; Matthew,1,0,16,15
1714645577578,MMW 13R,A01,514037,Staff,0,4,16,16
1714645577578,MMW 13R,A02,514039,Staff,0,2,16,16
1714645577578,MMW 13R,A03,628519,Staff,0,2,16,16
1714645579627,SIO 295LS,A00,523233,Staff,10,0,30,20
1714645580656,SIO 295S,A00,523232,Staff,10,0,30,20
1714645581681,SIOC 290S,A01,637330,Merrifield; Mark A,23,0,30,7
1714645582709,SIOC 291S,A01,637333,Gabriel; Corey John,23,0,30,7
1714645583736,SOCI 117,A01,494376,Staff,0,4,5,5
1714645584761,WES 237B,A00,494380,Staff,9,0,20,11
1714645586847,AESE 279B,A00,494370,Wade; Jon P,0,0,33,33
1714645587876,AIP 197,001,627712,Vespa; Emanuel Ignacio,9998,0,9999,1
1714645588905,ANAR 135S,A00,494369,Braswell; Geoffrey E.,0,0,0,0
1714645589930,BENG 196,001,628496,Engler; Adam J.,9998,0,9999,1
1714645590956,CAT 124RS,A01,519847,Geibel; William,0,0,20,20
1714645591979,CAT 125RS,A01,515971,Geibel; William,0,0,20,20
1714645593004,CLRE 250,A00,511389,Morris; Sheldon,9993,0,9999,6
1714645594040,CLRE 251,A00,507176,Mehta; Ravindra L.,9993,0,9999,6
1714645594040,CLRE 251,B00,511410,Mehta; Ravindra L.,9998,0,9999,1
1714645595065,CLRE 252,A00,507189,Cuomo; Raphael Eduardo,9995,0,9999,4
1714645596089,CLRE 253,A00,507199,Vaida; Florin,9994,0,9999,5
1714645596089,CLRE 253,B00,507202,Vaida; Florin,9999,0,9999,0
1714645597114,CLRE 259,A00,507211,Patel; Hemal,9996,0,9999,3
1714645598138,CLRE 260,A00,507221,Cuomo; Raphael Eduardo,9999,0,9999,0
1714645599162,CLRE 297,001,507242,Cuomo; Raphael Eduardo,9999,0,9999,0
1714645600190,COGS 197,001,638244,Voytek; Bradley Thomas,9998,0,9999,1
1714645601219,CSE 191,A00,516875,Minnes Kemp; Mor Mia,9992,0,9999,7
1714645602244,CSE 197,001,637388,Minnes Kemp; Mor Mia,9998,0,9999,1
1714645603273,CSS 201S,A01,494383,Staff,35,0,35,0
1714645604301,CSS 202S,A01,494387,Staff,35,0,35,0
1714645605329,DSC 197,001,628532,Eldridge; Justin Matthew,9996,0,9999,3
1714645606353,EAP 100,A00,516065,Staff,9797,0,9999,202
1714645607378,ECE 45,A01,507414,Staff,33,0,60,27
1714645609427,ECE 111,A01,507420,Staff,15,0,50,35
1714645610457,ECE 197,001,548057,Sievenpiper; Daniel F.,9993,0,9999,6
1714645611483,EDS 115,A00,507243,Choi; Bailey Miyeon,10,0,28,18
1714645612511,EDS 117,A01,494379,Staff,0,4,30,30
1714645613539,EDS 125,A00,507246,Hopkins; Megan Beth,9,0,30,21
1714645614567,EDS 128A,A01,507264,Fargason; Sharon Gayle,8,0,26,18
1714645615593,EDS 128B,A01,507293,Pappas; Elizabeth,12,0,30,18
1714645616618,EDS 139,A00,507294,Fargason; Sharon Gayle,13,0,30,17
1714645616618,EDS 139,B00,507313,Pappas; Elizabeth,13,0,30,17
1714645617645,EDS 201,A00,507315,Staff,13,0,30,17
1714645618670,EDS 203,A01,507317,Halter; Christopher P.,12,0,30,18
1714645619699,EDS 204R,A01,507319,Halter; Christopher P.,0,3,30,30
1714645619699,EDS 204R,B01,507331,Heinzman; Erica M.,16,0,30,14
1714645620725,EDS 206R,A00,507332,Staff,0,4,30,30
1714645620725,EDS 206R,B00,507343,Staff,17,0,30,13
1714645621750,EDS 250,A00,507344,Hemans; Patricia Ann Benitez,22,0,40,18
1714645622777,EDS 281,A00,507345,Daly; Alan J.,18,0,18,0
1714645623802,EDS 284,A00,507350,Daly; Alan J.,16,0,16,0
1714645624833,EDS 286,A00,507359,Fine; Sarah,18,0,18,0
1714645625862,EDS 289C,A01,507361,Daly; Alan J.,18,0,18,0
1714645626889,EDS 290,A00,507366,Hofstetter; Carolyn,15,0,15,0
1714645627919,LIGM 5A,A00,507421,Fischer-Grunski; Eva K,18,0,20,2
1714645628946,LIGM 5B,A00,507423,Fischer-Grunski; Eva K,19,0,20,1
1714645629969,LIGM 5C,A00,507425,Fischer-Grunski; Eva K,19,0,20,1
1714645630997,LIIT 5AS,A00,507427,Carnelos; Chiara,20,0,20,0
1714645632021,LIIT 5BS,A00,507430,Carnelos; Chiara,20,0,20,0
1714645633047,LIIT 5CS,A00,507432,Carnelos; Chiara,20,0,20,0
1714645634072,LISP 5A,A00,507541,Munoz Sanchez; Alicia,11,0,20,9
1714645635100,LISP 5B,A00,507671,Munoz Sanchez; Alicia,8,0,20,12
1714645636129,LISP 5C,A00,507696,Munoz Sanchez; Alicia,9,0,20,11
1714645637155,MAE 197,001,528363,Boechler; Nicholas Sebastia,9998,0,9999,1
1714645638187,MATH 197,001,523477,Kedlaya; Kiran S.,9995,0,9999,4
1714645638187,MATH 197,002,563811,Zhang; Danna,9995,0,9999,4
1714645638187,MATH 197,003,628552,Dumitriu; Ioana,9998,0,9999,1
1714645639212,MCWP 40R,A00,518780,Staff,2,0,20,18
1714645639212,MCWP 40R,B00,518781,Staff,8,0,20,12
1714645639212,MCWP 40R,C00,518783,Staff,6,0,20,14
1714645640241,MCWP 50R,A00,518791,Staff,0,0,20,20
1714645640241,MCWP 50R,B00,518792,Staff,0,2,20,20
1714645640241,MCWP 50R,C00,518793,Staff,0,2,20,20
1714645640241,MCWP 50R,D00,518794,Staff,0,1,20,20
1714645640241,MCWP 50R,E00,518795,Staff,0,2,20,20
1714645640241,MCWP 50R,F00,518796,Staff,0,0,20,20
1714645640241,MCWP 50R,G00,518797,Staff,0,1,20,20
1714645641269,MMW 12R,A01,514034,Herbst; Matthew,0,0,16,16
1714645641269,MMW 12R,A02,514035,Herbst; Matthew,1,0,16,15
1714645642296,MMW 13R,A01,514037,Staff,0,4,16,16
1714645642296,MMW 13R,A02,514039,Staff,0,2,16,16
1714645642296,MMW 13R,A03,628519,Staff,0,2,16,16
1714645644402,SIO 295LS,A00,523233,Staff,10,0,30,20
1714645645429,SIO 295S,A00,523232,Staff,10,0,30,20
1714645646458,SIOC 290S,A01,637330,Merrifield; Mark A,23,0,30,7
1714645647485,SIOC 291S,A01,637333,Gabriel; Corey John,23,0,30,7
1714645648514,SOCI 117,A01,494376,Staff,0,4,5,5
1714645649542,WES 237B,A00,494380,Staff,9,0,20,11
1714645651609,AESE 279B,A00,494370,Wade; Jon P,0,0,33,33
1714645652635,AIP 197,001,627712,Vespa; Emanuel Ignacio,9998,0,9999,1
1714645653663,ANAR 135S,A00,494369,Braswell; Geoffrey E.,0,0,0,0
1714645654690,BENG 196,001,628496,Engler; Adam J.,9998,0,9999,1
1714645655721,CAT 124RS,A01,519847,Geibel; William,0,0,20,20
1714645656750,CAT 125RS,A01,515971,Geibel; William,0,0,20,20
1714645657774,CLRE 250,A00,511389,Morris; Sheldon,9993,0,9999,6
1714645658808,CLRE 251,A00,507176,Mehta; Ravindra L.,9993,0,9999,6
1714645658808,CLRE 251,B00,511410,Mehta; Ravindra L.,9998,0,9999,1
1714645659833,CLRE 252,A00,507189,Cuomo; Raphael Eduardo,9995,0,9999,4
1714645660859,CLRE 253,A00,507199,Vaida; Florin,9994,0,9999,5
1714645660859,CLRE 253,B00,507202,Vaida; Florin,9999,0,9999,0
1714645661884,CLRE 259,A00,507211,Patel; Hemal,9996,0,9999,3
1714645662908,CLRE 260,A00,507221,Cuomo; Raphael Eduardo,9999,0,9999,0
1714645663934,CLRE 297,001,507242,Cuomo; Raphael Eduardo,9999,0,9999,0
1714645664961,COGS 197,001,638244,Voytek; Bradley Thomas,9998,0,9999,1
1714645665986,CSE 191,A00,516875,Minnes Kemp; Mor Mia,9992,0,9999,7
1714645667012,CSE 197,001,637388,Minnes Kemp; Mor Mia,9998,0,9999,1
1714645668042,CSS 201S,A01,494383,Staff,35,0,35,0
1714645669067,CSS 202S,A01,494387,Staff,35,0,35,0
1714645670097,DSC 197,001,628532,Eldridge; Justin Matthew,9996,0,9999,3
1714645671124,EAP 100,A00,516065,Staff,9797,0,9999,202
1714645672152,ECE 45,A01,507414,Staff,33,0,60,27
1714645674205,ECE 111,A01,507420,Staff,15,0,50,35
1714645675230,ECE 197,001,548057,Sievenpiper; Daniel F.,9993,0,9999,6
1714645676256,EDS 115,A00,507243,Choi; Bailey Miyeon,10,0,28,18
1714645677281,EDS 117,A01,494379,Staff,0,4,30,30
1714645678306,EDS 125,A00,507246,Hopkins; Megan Beth,9,0,30,21
1714645679332,EDS 128A,A01,507264,Fargason; Sharon Gayle,8,0,26,18
1714645680357,EDS 128B,A01,507293,Pappas; Elizabeth,12,0,30,18
1714645681381,EDS 139,A00,507294,Fargason; Sharon Gayle,13,0,30,17
1714645681381,EDS 139,B00,507313,Pappas; Elizabeth,13,0,30,17
1714645682406,EDS 201,A00,507315,Staff,13,0,30,17
1714645683432,EDS 203,A01,507317,Halter; Christopher P.,12,0,30,18
1714645684459,EDS 204R,A01,507319,Halter; Christopher P.,0,3,30,30
1714645684459,EDS 204R,B01,507331,Heinzman; Erica M.,16,0,30,14
1714645685487,EDS 206R,A00,507332,Staff,0,4,30,30
1714645685487,EDS 206R,B00,507343,Staff,17,0,30,13
1714645686513,EDS 250,A00,507344,Hemans; Patricia Ann Benitez,22,0,40,18
1714645687542,EDS 281,A00,507345,Daly; Alan J.,18,0,18,0
1714645688568,EDS 284,A00,507350,Daly; Alan J.,16,0,16,0
1714645689596,EDS 286,A00,507359,Fine; Sarah,18,0,18,0
1714645690621,EDS 289C,A01,507361,Daly; Alan J.,18,0,18,0
1714645691648,EDS 290,A00,507366,Hofstetter; Carolyn,15,0,15,0
1714645692674,LIGM 5A,A00,507421,Fischer-Grunski; Eva K,18,0,20,2
1714645693701,LIGM 5B,A00,507423,Fischer-Grunski; Eva K,19,0,20,1
1714645694731,LIGM 5C,A00,507425,Fischer-Grunski; Eva K,19,0,20,1
1714645695757,LIIT 5AS,A00,507427,Carnelos; Chiara,20,0,20,0
1714645696785,LIIT 5BS,A00,507430,Carnelos; Chiara,20,0,20,0
1714645697809,LIIT 5CS,A00,507432,Carnelos; Chiara,20,0,20,0
1714645698837,LISP 5A,A00,507541,Munoz Sanchez; Alicia,11,0,20,9
1714645699864,LISP 5B,A00,507671,Munoz Sanchez; Alicia,8,0,20,12
1714645700896,LISP 5C,A00,507696,Munoz Sanchez; Alicia,9,0,20,11
1714645701925,MAE 197,001,528363,Boechler; Nicholas Sebastia,9998,0,9999,1
1714645702957,MATH 197,001,523477,Kedlaya; Kiran S.,9995,0,9999,4
1714645702957,MATH 197,002,563811,Zhang; Danna,9995,0,9999,4
1714645702957,MATH 197,003,628552,Dumitriu; Ioana,9998,0,9999,1
1714645703989,MCWP 40R,A00,518780,Staff,2,0,20,18
1714645703989,MCWP 40R,B00,518781,Staff,8,0,20,12
1714645703989,MCWP 40R,C00,518783,Staff,6,0,20,14
1714645705015,MCWP 50R,A00,518791,Staff,0,0,20,20
1714645705015,MCWP 50R,B00,518792,Staff,0,2,20,20
1714645705015,MCWP 50R,C00,518793,Staff,0,2,20,20
1714645705015,MCWP 50R,D00,518794,Staff,0,1,20,20
1714645705015,MCWP 50R,E00,518795,Staff,0,2,20,20
1714645705015,MCWP 50R,F00,518796,Staff,0,0,20,20
1714645705015,MCWP 50R,G00,518797,Staff,0,1,20,20
1714645706042,MMW 12R,A01,514034,Herbst; Matthew,0,0,16,16
1714645706042,MMW 12R,A02,514035,Herbst; Matthew,1,0,16,15
1714645707069,MMW 13R,A01,514037,Staff,0,4,16,16
1714645707069,MMW 13R,A02,514039,Staff,0,2,16,16
1714645707069,MMW 13R,A03,628519,Staff,0,2,16,16
1714645709120,SIO 295LS,A00,523233,Staff,10,0,30,20
1714645710144,SIO 295S,A00,523232,Staff,10,0,30,20
1714645711178,SIOC 290S,A01,637330,Merrifield; Mark A,23,0,30,7
1714645712207,SIOC 291S,A01,637333,Gabriel; Corey John,23,0,30,7
1714645713239,SOCI 117,A01,494376,Staff,0,4,5,5
1714645714264,WES 237B,A00,494380,Staff,9,0,20,11
1714645716351,AESE 279B,A00,494370,Wade; Jon P,0,0,33,33
1714645717379,AIP 197,001,627712,Vespa; Emanuel Ignacio,9998,0,9999,1
1714645718405,ANAR 135S,A00,494369,Braswell; Geoffrey E.,0,0,0,0
1714645719435,BENG 196,001,628496,Engler; Adam J.,9998,0,9999,1
1714645720460,CAT 124RS,A01,519847,Geibel; William,0,0,20,20
1714645721486,CAT 125RS,A01,515971,Geibel; William,0,0,20,20
1714645722513,CLRE 250,A00,511389,Morris; Sheldon,9993,0,9999,6
1714645723545,CLRE 251,A00,507176,Mehta; Ravindra L.,9993,0,9999,6
1714645723545,CLRE 251,B00,511410,Mehta; Ravindra L.,9998,0,9999,1
1714645724570,CLRE 252,A00,507189,Cuomo; Raphael Eduardo,9995,0,9999,4
1714645725596,CLRE 253,A00,507199,Vaida; Florin,9994,0,9999,5
1714645725596,CLRE 253,B00,507202,Vaida; Florin,9999,0,9999,0
1714645726622,CLRE 259,A00,507211,Patel; Hemal,9996,0,9999,3
1714645727647,CLRE 260,A00,507221,Cuomo; Raphael Eduardo,9999,0,9999,0
1714645728671,CLRE 297,001,507242,Cuomo; Raphael Eduardo,9999,0,9999,0
1714645729695,COGS 197,001,638244,Voytek; Bradley Thomas,9998,0,9999,1
1714645730721,CSE 191,A00,516875,Minnes Kemp; Mor Mia,9992,0,9999,7
1714645731749,CSE 197,001,637388,Minnes Kemp; Mor Mia,9998,0,9999,1
1714645732782,CSS 201S,A01,494383,Staff,35,0,35,0
1714645733812,CSS 202S,A01,494387,Staff,35,0,35,0
1714645734841,DSC 197,001,628532,Eldridge; Justin Matthew,9996,0,9999,3
1714645735867,EAP 100,A00,516065,Staff,9797,0,9999,202
1714645736893,ECE 45,A01,507414,Staff,33,0,60,27
1714645738945,ECE 111,A01,507420,Staff,15,0,50,35
1714645739975,ECE 197,001,548057,Sievenpiper; Daniel F.,9993,0,9999,6
1714645741006,EDS 115,A00,507243,Choi; Bailey Miyeon,10,0,28,18
1714645742033,EDS 117,A01,494379,Staff,0,4,30,30
1714645743062,EDS 125,A00,507246,Hopkins; Megan Beth,9,0,30,21
1714645744088,EDS 128A,A01,507264,Fargason; Sharon Gayle,8,0,26,18
1714645745117,EDS 128B,A01,507293,Pappas; Elizabeth,12,0,30,18
1714645746147,EDS 139,A00,507294,Fargason; Sharon Gayle,13,0,30,17
1714645746147,EDS 139,B00,507313,Pappas; Elizabeth,13,0,30,17
1714645747173,EDS 201,A00,507315,Staff,13,0,30,17
1714645748202,EDS 203,A01,507317,Halter; Christopher P.,12,0,30,18
1714645749231,EDS 204R,A01,507319,Halter; Christopher P.,0,3,30,30
1714645749231,EDS 204R,B01,507331,Heinzman; Erica M.,16,0,30,14
1714645750255,EDS 206R,A00,507332,Staff,0,4,30,30
1714645750255,EDS 206R,B00,507343,Staff,17,0,30,13
1714645751286,EDS 250,A00,507344,Hemans; Patricia Ann Benitez,22,0,40,18
1714645752312,EDS 281,A00,507345,Daly; Alan J.,18,0,18,0
1714645753338,EDS 284,A00,507350,Daly; Alan J.,16,0,16,0
1714645754361,EDS 286,A00,507359,Fine; Sarah,18,0,18,0
1714645755390,EDS 289C,A01,507361,Daly; Alan J.,18,0,18,0
1714645756419,EDS 290,A00,507366,Hofstetter; Carolyn,15,0,15,0
1714645757451,LIGM 5A,A00,507421,Fischer-Grunski; Eva K,18,0,20,2
1714645758479,LIGM 5B,A00,507423,Fischer-Grunski; Eva K,19,0,20,1
1714645759503,LIGM 5C,A00,507425,Fischer-Grunski; Eva K,19,0,20,1
1714645760548,LIIT 5AS,A00,507427,Carnelos; Chiara,20,0,20,0
1714645761574,LIIT 5BS,A00,507430,Carnelos; Chiara,20,0,20,0
1714645762599,LIIT 5CS,A00,507432,Carnelos; Chiara,20,0,20,0
1714645763626,LISP 5A,A00,507541,Munoz Sanchez; Alicia,11,0,20,9
1714645764652,LISP 5B,A00,507671,Munoz Sanchez; Alicia,8,0,20,12
1714645765675,LISP 5C,A00,507696,Munoz Sanchez; Alicia,9,0,20,11
1714645766705,MAE 197,001,528363,Boechler; Nicholas Sebastia,9998,0,9999,1
1714645767733,MATH 197,001,523477,Kedlaya; Kiran S.,9995,0,9999,4
1714645767733,MATH 197,002,563811,Zhang; Danna,9995,0,9999,4
1714645767733,MATH 197,003,628552,Dumitriu; Ioana,9998,0,9999,1
1714645768758,MCWP 40R,A00,518780,Staff,2,0,20,18
1714645768758,MCWP 40R,B00,518781,Staff,8,0,20,12
1714645768758,MCWP 40R,C00,518783,Staff,6,0,20,14
1714645769784,MCWP 50R,A00,518791,Staff,0,0,20,20
1714645769784,MCWP 50R,B00,518792,Staff,0,2,20,20
1714645769784,MCWP 50R,C00,518793,Staff,0,2,20,20
1714645769784,MCWP 50R,D00,518794,Staff,0,1,20,20
1714645769784,MCWP 50R,E00,518795,Staff,0,2,20,20
1714645769784,MCWP 50R,F00,518796,Staff,0,0,20,20
1714645769784,MCWP 50R,G00,518797,Staff,0,1,20,20
1714645770810,MMW 12R,A01,514034,Herbst; Matthew,0,0,16,16
1714645770810,MMW 12R,A02,514035,Herbst; Matthew,1,0,16,15
1714645771839,MMW 13R,A01,514037,Staff,0,4,16,16
1714645771839,MMW 13R,A02,514039,Staff,0,2,16,16
1714645771839,MMW 13R,A03,628519,Staff,0,2,16,16
1714645773893,SIO 295LS,A00,523233,Staff,10,0,30,20
1714645774920,SIO 295S,A00,523232,Staff,10,0,30,20
1714645775952,SIOC 290S,A01,637330,Merrifield; Mark A,23,0,30,7
1714645776978,SIOC 291S,A01,637333,Gabriel; Corey John,23,0,30,7
1714645778008,SOCI 117,A01,494376,Staff,0,4,5,5
1714645779038,WES 237B,A00,494380,Staff,9,0,20,11
1714645781119,AESE 279B,A00,494370,Wade; Jon P,0,0,33,33
1714645782144,AIP 197,001,627712,Vespa; Emanuel Ignacio,9998,0,9999,1
1714645783168,ANAR 135S,A00,494369,Braswell; Geoffrey E.,0,0,0,0
1714645784196,BENG 196,001,628496,Engler; Adam J.,9998,0,9999,1
1714645785225,CAT 124RS,A01,519847,Geibel; William,0,0,20,20
1714645786250,CAT 125RS,A01,515971,Geibel; William,0,0,20,20
1714645787276,CLRE 250,A00,511389,Morris; Sheldon,9993,0,9999,6
1714645788303,CLRE 251,A00,507176,Mehta; Ravindra L.,9993,0,9999,6
1714645788303,CLRE 251,B00,511410,Mehta; Ravindra L.,9998,0,9999,1
1714645789330,CLRE 252,A00,507189,Cuomo; Raphael Eduardo,9995,0,9999,4
1714645790353,CLRE 253,A00,507199,Vaida; Florin,9994,0,9999,5
1714645790353,CLRE 253,B00,507202,Vaida; Florin,9999,0,9999,0
1714645791382,CLRE 259,A00,507211,Patel; Hemal,9996,0,9999,3
1714645792406,CLRE 260,A00,507221,Cuomo; Raphael Eduardo,9999,0,9999,0
1714645793432,CLRE 297,001,507242,Cuomo; Raphael Eduardo,9999,0,9999,0
1714645794456,COGS 197,001,638244,Voytek; Bradley Thomas,9998,0,9999,1
1714645795482,CSE 191,A00,516875,Minnes Kemp; Mor Mia,9992,0,9999,7
1714645796511,CSE 197,001,637388,Minnes Kemp; Mor Mia,9998,0,9999,1
1714645797537,CSS 201S,A01,494383,Staff,35,0,35,0
1714645798562,CSS 202S,A01,494387,Staff,35,0,35,0
1714645799590,DSC 197,001,628532,Eldridge; Justin Matthew,9996,0,9999,3
1714645800617,EAP 100,A00,516065,Staff,9797,0,9999,202
1714645801647,ECE 45,A01,507414,Staff,33,0,60,27
1714645803695,ECE 111,A01,507420,Staff,15,0,50,35
1714645804727,ECE 197,001,548057,Sievenpiper; Daniel F.,9993,0,9999,6
1714645805757,EDS 115,A00,507243,Choi; Bailey Miyeon,10,0,28,18
1714645806783,EDS 117,A01,494379,Staff,0,4,30,30
1714645807809,EDS 125,A00,507246,Hopkins; Megan Beth,9,0,30,21
1714645808836,EDS 128A,A01,507264,Fargason; Sharon Gayle,8,0,26,18
1714645809861,EDS 128B,A01,507293,Pappas; Elizabeth,12,0,30,18
1714645810886,EDS 139,A00,507294,Fargason; Sharon Gayle,13,0,30,17
1714645810886,EDS 139,B00,507313,Pappas; Elizabeth,13,0,30,17
1714645811912,EDS 201,A00,507315,Staff,13,0,30,17
1714645812942,EDS 203,A01,507317,Halter; Christopher P.,12,0,30,18
1714645813965,EDS 204R,A01,507319,Halter; Christopher P.,0,3,30,30
1714645813965,EDS 204R,B01,507331,Heinzman; Erica M.,16,0,30,14
1714645814994,EDS 206R,A00,507332,Staff,0,4,30,30
1714645814994,EDS 206R,B00,507343,Staff,17,0,30,13
1714645816022,EDS 250,A00,507344,Hemans; Patricia Ann Benitez,22,0,40,18
1714645817045,EDS 281,A00,507345,Daly; Alan J.,18,0,18,0
1714645818072,EDS 284,A00,507350,Daly; Alan J.,16,0,16,0
1714645819097,EDS 286,A00,507359,Fine; Sarah,18,0,18,0
1714645820123,EDS 289C,A01,507361,Daly; Alan J.,18,0,18,0
1714645821148,EDS 290,A00,507366,Hofstetter; Carolyn,15,0,15,0
1714645822183,LIGM 5A,A00,507421,Fischer-Grunski; Eva K,18,0,20,2
1714645823211,LIGM 5B,A00,507423,Fischer-Grunski; Eva K,19,0,20,1
1714645824235,LIGM 5C,A00,507425,Fischer-Grunski; Eva K,19,0,20,1
1714645825261,LIIT 5AS,A00,507427,Carnelos; Chiara,20,0,20,0
1714645826286,LIIT 5BS,A00,507430,Carnelos; Chiara,20,0,20,0
1714645827315,LIIT 5CS,A00,507432,Carnelos; Chiara,20,0,20,0
1714645828341,LISP 5A,A00,507541,Munoz Sanchez; Alicia,11,0,20,9
1714645829370,LISP 5B,A00,507671,Munoz Sanchez; Alicia,8,0,20,12
1714645830397,LISP 5C,A00,507696,Munoz Sanchez; Alicia,9,0,20,11
1714645831422,MAE 197,001,528363,Boechler; Nicholas Sebastia,9998,0,9999,1
1714645832447,MATH 197,001,523477,Kedlaya; Kiran S.,9995,0,9999,4
1714645832447,MATH 197,002,563811,Zhang; Danna,9995,0,9999,4
1714645832447,MATH 197,003,628552,Dumitriu; Ioana,9998,0,9999,1
1714645833472,MCWP 40R,A00,518780,Staff,2,0,20,18
1714645833472,MCWP 40R,B00,518781,Staff,8,0,20,12
1714645833472,MCWP 40R,C00,518783,Staff,6,0,20,14
1714645834497,MCWP 50R,A00,518791,Staff,0,0,20,20
1714645834497,MCWP 50R,B00,518792,Staff,0,2,20,20
1714645834497,MCWP 50R,C00,518793,Staff,0,2,20,20
1714645834497,MCWP 50R,D00,518794,Staff,0,1,20,20
1714645834497,MCWP 50R,E00,518795,Staff,0,2,20,20
1714645834497,MCWP 50R,F00,518796,Staff,0,0,20,20
1714645834497,MCWP 50R,G00,518797,Staff,0,1,20,20
1714645835524,MMW 12R,A01,514034,Herbst; Matthew,0,0,16,16
1714645835524,MMW 12R,A02,514035,Herbst; Matthew,1,0,16,15
1714645836553,MMW 13R,A01,514037,Staff,0,4,16,16
1714645836553,MMW 13R,A02,514039,Staff,0,2,16,16
1714645836553,MMW 13R,A03,628519,Staff,0,2,16,16
1714645838608,SIO 295LS,A00,523233,Staff,10,0,30,20
1714645839633,SIO 295S,A00,523232,Staff,10,0,30,20
1714645840660,SIOC 290S,A01,637330,Merrifield; Mark A,23,0,30,7
1714645841691,SIOC 291S,A01,637333,Gabriel; Corey John,23,0,30,7
1714645842720,SOCI 117,A01,494376,Staff,0,4,5,5
1714645843749,WES 237B,A00,494380,Staff,9,0,20,11
1714645845814,AESE 279B,A00,494370,Wade; Jon P,0,0,33,33
1714645846840,AIP 197,001,627712,Vespa; Emanuel Ignacio,9998,0,9999,1
1714645847869,ANAR 135S,A00,494369,Braswell; Geoffrey E.,0,0,0,0
1714645848894,BENG 196,001,628496,Engler; Adam J.,9998,0,9999,1
1714645849922,CAT 124RS,A01,519847,Geibel; William,0,0,20,20
1714645850952,CAT 125RS,A01,515971,Geibel; William,0,0,20,20
1714645851981,CLRE 250,A00,511389,Morris; Sheldon,9993,0,9999,6
1714645853015,CLRE 251,A00,507176,Mehta; Ravindra L.,9993,0,9999,6
1714645853015,CLRE 251,B00,511410,Mehta; Ravindra L.,9998,0,9999,1
1714645854045,CLRE 252,A00,507189,Cuomo; Raphael Eduardo,9995,0,9999,4
1714645855069,CLRE 253,A00,507199,Vaida; Florin,9994,0,9999,5
1714645855069,CLRE 253,B00,507202,Vaida; Florin,9999,0,9999,0
1714645856097,CLRE 259,A00,507211,Patel; Hemal,9996,0,9999,3
1714645857123,CLRE 260,A00,507221,Cuomo; Raphael Eduardo,9999,0,9999,0
1714645858150,CLRE 297,001,507242,Cuomo; Raphael Eduardo,9999,0,9999,0
1714645859180,COGS 197,001,638244,Voytek; Bradley Thomas,9998,0,9999,1
1714645860208,CSE 191,A00,516875,Minnes Kemp; Mor Mia,9992,0,9999,7
1714645861231,CSE 197,001,637388,Minnes Kemp; Mor Mia,9998,0,9999,1
1714645862257,CSS 201S,A01,494383,Staff,35,0,35,0
1714645863287,CSS 202S,A01,494387,Staff,35,0,35,0
1714645864316,DSC 197,001,628532,Eldridge; Justin Matthew,9996,0,9999,3
1714645865342,EAP 100,A00,516065,Staff,9797,0,9999,202
1714645866372,ECE 45,A01,507414,Staff,33,0,60,27
1714645868426,ECE 111,A01,507420,Staff,15,0,50,35
1714645869457,ECE 197,001,548057,Sievenpiper; Daniel F.,9993,0,9999,6
1714645870483,EDS 115,A00,507243,Choi; Bailey Miyeon,10,0,28,18
1714645871513,EDS 117,A01,494379,Staff,0,4,30,30
1714645872540,EDS 125,A00,507246,Hopkins; Megan Beth,9,0,30,21
1714645873565,EDS 128A,A01,507264,Fargason; Sharon Gayle,8,0,26,18
1714645874593,EDS 128B,A01,507293,Pappas; Elizabeth,12,0,30,18
1714645875618,EDS 139,A00,507294,Fargason; Sharon Gayle,13,0,30,17
1714645875618,EDS 139,B00,507313,Pappas; Elizabeth,13,0,30,17
1714645876644,EDS 201,A00,507315,Staff,13,0,30,17
1714645877670,EDS 203,A01,507317,Halter; Christopher P.,12,0,30,18
1714645878696,EDS 204R,A01,507319,Halter; Christopher P.,0,3,30,30
1714645878696,EDS 204R,B01,507331,Heinzman; Erica M.,16,0,30,14
1714645879720,EDS 206R,A00,507332,Staff,0,4,30,30
1714645879720,EDS 206R,B00,507343,Staff,17,0,30,13
1714645880746,EDS 250,A00,507344,Hemans; Patricia Ann Benitez,22,0,40,18
1714645881774,EDS 281,A00,507345,Daly; Alan J.,18,0,18,0
1714645882800,EDS 284,A00,507350,Daly; Alan J.,16,0,16,0
1714645883826,EDS 286,A00,507359,Fine; Sarah,18,0,18,0
1714645884850,EDS 289C,A01,507361,Daly; Alan J.,18,0,18,0
1714645885876,EDS 290,A00,507366,Hofstetter; Carolyn,15,0,15,0
1714645886903,LIGM 5A,A00,507421,Fischer-Grunski; Eva K,18,0,20,2
1714645887931,LIGM 5B,A00,507423,Fischer-Grunski; Eva K,19,0,20,1
1714645888957,LIGM 5C,A00,507425,Fischer-Grunski; Eva K,19,0,20,1
1714645889981,LIIT 5AS,A00,507427,Carnelos; Chiara,20,0,20,0
1714645891006,LIIT 5BS,A00,507430,Carnelos; Chiara,20,0,20,0
1714645892036,LIIT 5CS,A00,507432,Carnelos; Chiara,20,0,20,0
1714645893062,LISP 5A,A00,507541,Munoz Sanchez; Alicia,11,0,20,9
1714645894090,LISP 5B,A00,507671,Munoz Sanchez; Alicia,8,0,20,12
1714645895115,LISP 5C,A00,507696,Munoz Sanchez; Alicia,9,0,20,11
1714645896141,MAE 197,001,528363,Boechler; Nicholas Sebastia,9998,0,9999,1
1714645897175,MATH 197,001,523477,Kedlaya; Kiran S.,9995,0,9999,4
1714645897175,MATH 197,002,563811,Zhang; Danna,9995,0,9999,4
1714645897175,MATH 197,003,628552,Dumitriu; Ioana,9998,0,9999,1
1714645898204,MCWP 40R,A00,518780,Staff,2,0,20,18
1714645898204,MCWP 40R,B00,518781,Staff,8,0,20,12
1714645898204,MCWP 40R,C00,518783,Staff,6,0,20,14
1714645899230,MCWP 50R,A00,518791,Staff,0,0,20,20
1714645899230,MCWP 50R,B00,518792,Staff,0,2,20,20
1714645899230,MCWP 50R,C00,518793,Staff,0,2,20,20
1714645899230,MCWP 50R,D00,518794,Staff,0,1,20,20
1714645899230,MCWP 50R,E00,518795,Staff,0,2,20,20
1714645899230,MCWP 50R,F00,518796,Staff,0,0,20,20
1714645899230,MCWP 50R,G00,518797,Staff,0,1,20,20
1714645900259,MMW 12R,A01,514034,Herbst; Matthew,0,0,16,16
1714645900259,MMW 12R,A02,514035,Herbst; Matthew,1,0,16,15
1714645901285,MMW 13R,A01,514037,Staff,0,4,16,16
1714645901285,MMW 13R,A02,514039,Staff,0,2,16,16
1714645901285,MMW 13R,A03,628519,Staff,0,2,16,16
1714645903340,SIO 295LS,A00,523233,Staff,10,0,30,20
1714645904364,SIO 295S,A00,523232,Staff,10,0,30,20
1714645905392,SIOC 290S,A01,637330,Merrifield; Mark A,23,0,30,7
1714645906422,SIOC 291S,A01,637333,Gabriel; Corey John,23,0,30,7
1714645907453,SOCI 117,A01,494376,Staff,0,4,5,5
1714645908478,WES 237B,A00,494380,Staff,9,0,20,11
1714645910559,AESE 279B,A00,494370,Wade; Jon P,0,0,33,33
1714645911585,AIP 197,001,627712,Vespa; Emanuel Ignacio,9998,0,9999,1
1714645912610,ANAR 135S,A00,494369,Braswell; Geoffrey E.,0,0,0,0
1714645913635,BENG 196,001,628496,Engler; Adam J.,9998,0,9999,1
1714645914660,CAT 124RS,A01,519847,Geibel; William,0,0,20,20
1714645915688,CAT 125RS,A01,515971,Geibel; William,0,0,20,20
1714645916713,CLRE 250,A00,511389,Morris; Sheldon,9993,0,9999,6
1714645917740,CLRE 251,A00,507176,Mehta; Ravindra L.,9993,0,9999,6
1714645917740,CLRE 251,B00,511410,Mehta; Ravindra L.,9998,0,9999,1
1714645918770,CLRE 252,A00,507189,Cuomo; Raphael Eduardo,9995,0,9999,4
1714645919801,CLRE 253,A00,507199,Vaida; Florin,9994,0,9999,5
1714645919801,CLRE 253,B00,507202,Vaida; Florin,9999,0,9999,0
1714645920834,CLRE 259,A00,507211,Patel; Hemal,9996,0,9999,3
1714645921858,CLRE 260,A00,507221,Cuomo; Raphael Eduardo,9999,0,9999,0
1714645922885,CLRE 297,001,507242,Cuomo; Raphael Eduardo,9999,0,9999,0
1714645923915,COGS 197,001,638244,Voytek; Bradley Thomas,9998,0,9999,1
1714645924939,CSE 191,A00,516875,Minnes Kemp; Mor Mia,9992,0,9999,7
1714645925967,CSE 197,001,637388,Minnes Kemp; Mor Mia,9998,0,9999,1
1714645926999,CSS 201S,A01,494383,Staff,35,0,35,0
1714645928028,CSS 202S,A01,494387,Staff,35,0,35,0
1714645929054,DSC 197,001,628532,Eldridge; Justin Matthew,9996,0,9999,3
1714645930079,EAP 100,A00,516065,Staff,9797,0,9999,202
1714645931104,ECE 45,A01,507414,Staff,33,0,60,27
1714645933162,ECE 111,A01,507420,Staff,15,0,50,35
1714645934192,ECE 197,001,548057,Sievenpiper; Daniel F.,9993,0,9999,6
1714645935218,EDS 115,A00,507243,Choi; Bailey Miyeon,10,0,28,18
1714645936246,EDS 117,A01,494379,Staff,0,4,30,30
1714645937273,EDS 125,A00,507246,Hopkins; Megan Beth,9,0,30,21
1714645938299,EDS 128A,A01,507264,Fargason; Sharon Gayle,8,0,26,18
1714645939328,EDS 128B,A01,507293,Pappas; Elizabeth,12,0,30,18
1714645940354,EDS 139,A00,507294,Fargason; Sharon Gayle,13,0,30,17
1714645940354,EDS 139,B00,507313,Pappas; Elizabeth,13,0,30,17
1714645941379,EDS 201,A00,507315,Staff,13,0,30,17
1714645942404,EDS 203,A01,507317,Halter; Christopher P.,12,0,30,18
1714645943430,EDS 204R,A01,507319,Halter; Christopher P.,0,3,30,30
1714645943430,EDS 204R,B01,507331,Heinzman; Erica M.,16,0,30,14
1714645944458,EDS 206R,A00,507332,Staff,0,4,30,30
1714645944458,EDS 206R,B00,507343,Staff,17,0,30,13
1714645945482,EDS 250,A00,507344,Hemans; Patricia Ann Benitez,22,0,40,18
1714645946514,EDS 281,A00,507345,Daly; Alan J.,18,0,18,0
1714645947539,EDS 284,A00,507350,Daly; Alan J.,16,0,16,0
1714645948565,EDS 286,A00,507359,Fine; Sarah,18,0,18,0
1714645949592,EDS 289C,A01,507361,Daly; Alan J.,18,0,18,0
1714645950618,EDS 290,A00,507366,Hofstetter; Carolyn,15,0,15,0
1714645951649,LIGM 5A,A00,507421,Fischer-Grunski; Eva K,18,0,20,2
1714645952675,LIGM 5B,A00,507423,Fischer-Grunski; Eva K,19,0,20,1
1714645953700,LIGM 5C,A00,507425,Fischer-Grunski; Eva K,19,0,20,1
1714645954726,LIIT 5AS,A00,507427,Carnelos; Chiara,20,0,20,0
1714645955753,LIIT 5BS,A00,507430,Carnelos; Chiara,20,0,20,0
1714645956780,LIIT 5CS,A00,507432,Carnelos; Chiara,20,0,20,0
1714645957808,LISP 5A,A00,507541,Munoz Sanchez; Alicia,11,0,20,9
1714645958834,LISP 5B,A00,507671,Munoz Sanchez; Alicia,8,0,20,12
1714645959859,LISP 5C,A00,507696,Munoz Sanchez; Alicia,9,0,20,11
1714645960890,MAE 197,001,528363,Boechler; Nicholas Sebastia,9998,0,9999,1
1714645961923,MATH 197,001,523477,Kedlaya; Kiran S.,9995,0,9999,4
1714645961923,MATH 197,002,563811,Zhang; Danna,9995,0,9999,4
1714645961923,MATH 197,003,628552,Dumitriu; Ioana,9998,0,9999,1
1714645962949,MCWP 40R,A00,518780,Staff,2,0,20,18
1714645962949,MCWP 40R,B00,518781,Staff,8,0,20,12
1714645962949,MCWP 40R,C00,518783,Staff,6,0,20,14
1714645963979,MCWP 50R,A00,518791,Staff,0,0,20,20
1714645963979,MCWP 50R,B00,518792,Staff,0,2,20,20
1714645963979,MCWP 50R,C00,518793,Staff,0,2,20,20
1714645963979,MCWP 50R,D00,518794,Staff,0,1,20,20
1714645963979,MCWP 50R,E00,518795,Staff,0,2,20,20
1714645963979,MCWP 50R,F00,518796,Staff,0,0,20,20
1714645963979,MCWP 50R,G00,518797,Staff,0,1,20,20
1714645965013,MMW 12R,A01,514034,Herbst; Matthew,0,0,16,16
1714645965013,MMW 12R,A02,514035,Herbst; Matthew,1,0,16,15
1714645966039,MMW 13R,A01,514037,Staff,0,4,16,16
1714645966039,MMW 13R,A02,514039,Staff,0,2,16,16
1714645966039,MMW 13R,A03,628519,Staff,0,2,16,16
1714645968095,SIO 295LS,A00,523233,Staff,10,0,30,20
1714645969120,SIO 295S,A00,523232,Staff,10,0,30,20
1714645970145,SIOC 290S,A01,637330,Merrifield; Mark A,23,0,30,7
1714645971175,SIOC 291S,A01,637333,Gabriel; Corey John,23,0,30,7
1714645972201,SOCI 117,A01,494376,Staff,0,4,5,5
1714645973227,WES 237B,A00,494380,Staff,9,0,20,11
1714645975302,AESE 279B,A00,494370,Wade; Jon P,0,0,33,33
1714645976329,AIP 197,001,627712,Vespa; Emanuel Ignacio,9998,0,9999,1
1714645977359,ANAR 135S,A00,494369,Braswell; Geoffrey E.,0,0,0,0
1714645978387,BENG 196,001,628496,Engler; Adam J.,9998,0,9999,1
1714645979412,CAT 124RS,A01,519847,Geibel; William,0,0,20,20
1714645980441,CAT 125RS,A01,515971,Geibel; William,0,0,20,20
1714645981471,CLRE 250,A00,511389,Morris; Sheldon,9993,0,9999,6
1714645982498,CLRE 251,A00,507176,Mehta; Ravindra L.,9993,0,9999,6
1714645982498,CLRE 251,B00,511410,Mehta; Ravindra L.,9998,0,9999,1
1714645983538,CLRE 252,A00,507189,Cuomo; Raphael Eduardo,9995,0,9999,4
1714645984562,CLRE 253,A00,507199,Vaida; Florin,9994,0,9999,5
1714645984562,CLRE 253,B00,507202,Vaida; Florin,9999,0,9999,0
1714645985592,CLRE 259,A00,507211,Patel; Hemal,9996,0,9999,3
1714645986616,CLRE 260,A00,507221,Cuomo; Raphael Eduardo,9999,0,9999,0
1714645987641,CLRE 297,001,507242,Cuomo; Raphael Eduardo,9999,0,9999,0
1714645988666,COGS 197,001,638244,Voytek; Bradley Thomas,9998,0,9999,1
1714645989692,CSE 191,A00,516875,Minnes Kemp; Mor Mia,9992,0,9999,7
1714645990730,CSE 197,001,637388,Minnes Kemp; Mor Mia,9998,0,9999,1
1714645991760,CSS 201S,A01,494383,Staff,35,0,35,0
1714645992786,CSS 202S,A01,494387,Staff,35,0,35,0
1714645993814,DSC 197,001,628532,Eldridge; Justin Matthew,9996,0,9999,3
1714645994838,EAP 100,A00,516065,Staff,9797,0,9999,202
1714645995868,ECE 45,A01,507414,Staff,33,0,60,27
1714645997922,ECE 111,A01,507420,Staff,15,0,50,35
1714645998950,ECE 197,001,548057,Sievenpiper; Daniel F.,9993,0,9999,6
1714645999977,EDS 115,A00,507243,Choi; Bailey Miyeon,10,0,28,18
1714646001002,EDS 117,A01,494379,Staff,0,4,30,30
1714646002028,EDS 125,A00,507246,Hopkins; Megan Beth,9,0,30,21
1714646003056,EDS 128A,A01,507264,Fargason; Sharon Gayle,8,0,26,18
1714646004079,EDS 128B,A01,507293,Pappas; Elizabeth,12,0,30,18
1714646005104,EDS 139,A00,507294,Fargason; Sharon Gayle,13,0,30,17
1714646005104,EDS 139,B00,507313,Pappas; Elizabeth,13,0,30,17
1714646006131,EDS 201,A00,507315,Staff,13,0,30,17
1714646007157,EDS 203,A01,507317,Halter; Christopher P.,12,0,30,18
1714646008183,EDS 204R,A01,507319,Halter; Christopher P.,0,3,30,30
1714646008183,EDS 204R,B01,507331,Heinzman; Erica M.,16,0,30,14
1714646009211,EDS 206R,A00,507332,Staff,0,4,30,30
1714646009211,EDS 206R,B00,507343,Staff,17,0,30,13
1714646010238,EDS 250,A00,507344,Hemans; Patricia Ann Benitez,22,0,40,18
1714646011268,EDS 281,A00,507345,Daly; Alan J.,18,0,18,0
1714646012296,EDS 284,A00,507350,Daly; Alan J.,16,0,16,0
1714646013323,EDS 286,A00,507359,Fine; Sarah,18,0,18,0
1714646014350,EDS 289C,A01,507361,Daly; Alan J.,18,0,18,0
1714646015376,EDS 290,A00,507366,Hofstetter; Carolyn,15,0,15,0
1714646016408,LIGM 5A,A00,507421,Fischer-Grunski; Eva K,18,0,20,2
1714646017433,LIGM 5B,A00,507423,Fischer-Grunski; Eva K,19,0,20,1
1714646018458,LIGM 5C,A00,507425,Fischer-Grunski; Eva K,19,0,20,1
1714646019485,LIIT 5AS,A00,507427,Carnelos; Chiara,20,0,20,0
1714646020510,LIIT 5BS,A00,507430,Carnelos; Chiara,20,0,20,0
1714646021537,LIIT 5CS,A00,507432,Carnelos; Chiara,20,0,20,0
1714646022564,LISP 5A,A00,507541,Munoz Sanchez; Alicia,11,0,20,9
1714646023591,LISP 5B,A00,507671,Munoz Sanchez; Alicia,8,0,20,12
1714646024620,LISP 5C,A00,507696,Munoz Sanchez; Alicia,9,0,20,11
1714646025653,MAE 197,001,528363,Boechler; Nicholas Sebastia,9998,0,9999,1
1714646026679,MATH 197,001,523477,Kedlaya; Kiran S.,9995,0,9999,4
1714646026679,MATH 197,002,563811,Zhang; Danna,9995,0,9999,4
1714646026679,MATH 197,003,628552,Dumitriu; Ioana,9998,0,9999,1
1714646027711,MCWP 40R,A00,518780,Staff,2,0,20,18
1714646027711,MCWP 40R,B00,518781,Staff,8,0,20,12
1714646027711,MCWP 40R,C00,518783,Staff,6,0,20,14
1714646028742,MCWP 50R,A00,518791,Staff,0,0,20,20
1714646028742,MCWP 50R,B00,518792,Staff,0,2,20,20
1714646028742,MCWP 50R,C00,518793,Staff,0,2,20,20
1714646028742,MCWP 50R,D00,518794,Staff,0,1,20,20
1714646028742,MCWP 50R,E00,518795,Staff,0,2,20,20
1714646028742,MCWP 50R,F00,518796,Staff,0,0,20,20
1714646028742,MCWP 50R,G00,518797,Staff,0,1,20,20
1714646029771,MMW 12R,A01,514034,Herbst; Matthew,0,0,16,16
1714646029771,MMW 12R,A02,514035,Herbst; Matthew,1,0,16,15
1714646030799,MMW 13R,A01,514037,Staff,0,4,16,16
1714646030799,MMW 13R,A02,514039,Staff,0,2,16,16
1714646030799,MMW 13R,A03,628519,Staff,0,2,16,16
1714646032849,SIO 295LS,A00,523233,Staff,10,0,30,20
1714646033874,SIO 295S,A00,523232,Staff,10,0,30,20
1714646034905,SIOC 290S,A01,637330,Merrifield; Mark A,23,0,30,7
1714646035931,SIOC 291S,A01,637333,Gabriel; Corey John,23,0,30,7
1714646036959,SOCI 117,A01,494376,Staff,0,4,5,5
1714646037989,WES 237B,A00,494380,Staff,9,0,20,11
1714646040062,AESE 279B,A00,494370,Wade; Jon P,0,0,33,33
1714646041093,AIP 197,001,627712,Vespa; Emanuel Ignacio,9998,0,9999,1
1714646042118,ANAR 135S,A00,494369,Braswell; Geoffrey E.,0,0,0,0
1714646043143,BENG 196,001,628496,Engler; Adam J.,9998,0,9999,1
1714646044174,CAT 124RS,A01,519847,Geibel; William,0,0,20,20
1714646045198,CAT 125RS,A01,515971,Geibel; William,0,0,20,20
1714646046223,CLRE 250,A00,511389,Morris; Sheldon,9993,0,9999,6
1714646047248,CLRE 251,A00,507176,Mehta; Ravindra L.,9993,0,9999,6
1714646047248,CLRE 251,B00,511410,Mehta; Ravindra L.,9998,0,9999,1
1714646048274,CLRE 252,A00,507189,Cuomo; Raphael Eduardo,9995,0,9999,4
1714646049302,CLRE 253,A00,507199,Vaida; Florin,9994,0,9999,5
1714646049302,CLRE 253,B00,507202,Vaida; Florin,9999,0,9999,0
1714646050328,CLRE 259,A00,507211,Patel; Hemal,9996,0,9999,3
1714646051353,CLRE 260,A00,507221,Cuomo; Raphael Eduardo,9999,0,9999,0
1714646052378,CLRE 297,001,507242,Cuomo; Raphael Eduardo,9999,0,9999,0
1714646053404,COGS 197,001,638244,Voytek; Bradley Thomas,9998,0,9999,1
1714646054431,CSE 191,A00,516875,Minnes Kemp; Mor Mia,9992,0,9999,7
1714646055456,CSE 197,001,637388,Minnes Kemp; Mor Mia,9998,0,9999,1
1714646056482,CSS 201S,A01,494383,Staff,35,0,35,0
1714646057507,CSS 202S,A01,494387,Staff,35,0,35,0
1714646058537,DSC 197,001,628532,Eldridge; Justin Matthew,9996,0,9999,3
1714646059562,EAP 100,A00,516065,Staff,9797,0,9999,202
1714646060587,ECE 45,A01,507414,Staff,33,0,60,27
1714646062637,ECE 111,A01,507420,Staff,15,0,50,35
1714646063664,ECE 197,001,548057,Sievenpiper; Daniel F.,9993,0,9999,6
1714646064690,EDS 115,A00,507243,Choi; Bailey Miyeon,10,0,28,18
1714646065716,EDS 117,A01,494379,Staff,0,4,30,30
1714646066746,EDS 125,A00,507246,Hopkins; Megan Beth,9,0,30,21
1714646067775,EDS 128A,A01,507264,Fargason; Sharon Gayle,8,0,26,18
1714646068801,EDS 128B,A01,507293,Pappas; Elizabeth,12,0,30,18
1714646069825,EDS 139,A00,507294,Fargason; Sharon Gayle,13,0,30,17
1714646069825,EDS 139,B00,507313,Pappas; Elizabeth,13,0,30,17
1714646070853,EDS 201,A00,507315,Staff,13,0,30,17
1714646071879,EDS 203,A01,507317,Halter; Christopher P.,12,0,30,18
1714646072908,EDS 204R,A01,507319,Halter; Christopher P.,0,3,30,30
1714646072908,EDS 204R,B01,507331,Heinzman; Erica M.,16,0,30,14
1714646073932,EDS 206R,A00,507332,Staff,0,4,30,30
1714646073932,EDS 206R,B00,507343,Staff,17,0,30,13
1714646074958,EDS 250,A00,507344,Hemans; Patricia Ann Benitez,22,0,40,18
1714646075983,EDS 281,A00,507345,Daly; Alan J.,18,0,18,0
1714646077009,EDS 284,A00,507350,Daly; Alan J.,16,0,16,0
1714646078036,EDS 286,A00,507359,Fine; Sarah,18,0,18,0
1714646079065,EDS 289C,A01,507361,Daly; Alan J.,18,0,18,0
1714646080090,EDS 290,A00,507366,Hofstetter; Carolyn,15,0,15,0
1714646081117,LIGM 5A,A00,507421,Fischer-Grunski; Eva K,18,0,20,2
1714646082146,LIGM 5B,A00,507423,Fischer-Grunski; Eva K,19,0,20,1
1714646083172,LIGM 5C,A00,507425,Fischer-Grunski; Eva K,19,0,20,1
1714646084204,LIIT 5AS,A00,507427,Carnelos; Chiara,20,0,20,0
1714646085232,LIIT 5BS,A00,507430,Carnelos; Chiara,20,0,20,0
1714646086259,LIIT 5CS,A00,507432,Carnelos; Chiara,20,0,20,0
1714646087287,LISP 5A,A00,507541,Munoz Sanchez; Alicia,11,0,20,9
1714646088315,LISP 5B,A00,507671,Munoz Sanchez; Alicia,8,0,20,12
1714646089344,LISP 5C,A00,507696,Munoz Sanchez; Alicia,9,0,20,11
1714646090372,MAE 197,001,528363,Boechler; Nicholas Sebastia,9998,0,9999,1
1714646091410,MATH 197,001,523477,Kedlaya; Kiran S.,9995,0,9999,4
1714646091410,MATH 197,002,563811,Zhang; Danna,9995,0,9999,4
1714646091410,MATH 197,003,628552,Dumitriu; Ioana,9998,0,9999,1
1714646092441,MCWP 40R,A00,518780,Staff,2,0,20,18
1714646092441,MCWP 40R,B00,518781,Staff,8,0,20,12
1714646092441,MCWP 40R,C00,518783,Staff,6,0,20,14
1714646093470,MCWP 50R,A00,518791,Staff,0,0,20,20
1714646093470,MCWP 50R,B00,518792,Staff,0,2,20,20
1714646093470,MCWP 50R,C00,518793,Staff,0,2,20,20
1714646093470,MCWP 50R,D00,518794,Staff,0,1,20,20
1714646093470,MCWP 50R,E00,518795,Staff,0,2,20,20
1714646093470,MCWP 50R,F00,518796,Staff,0,0,20,20
1714646093470,MCWP 50R,G00,518797,Staff,0,1,20,20
1714646094499,MMW 12R,A01,514034,Herbst; Matthew,0,0,16,16
1714646094499,MMW 12R,A02,514035,Herbst; Matthew,1,0,16,15
1714646095524,MMW 13R,A01,514037,Staff,0,4,16,16
1714646095524,MMW 13R,A02,514039,Staff,0,2,16,16
1714646095524,MMW 13R,A03,628519,Staff,0,2,16,16
1714646097578,SIO 295LS,A00,523233,Staff,10,0,30,20
1714646098605,SIO 295S,A00,523232,Staff,10,0,30,20
1714646099635,SIOC 290S,A01,637330,Merrifield; Mark A,23,0,30,7
1714646100666,SIOC 291S,A01,637333,Gabriel; Corey John,23,0,30,7
1714646101692,SOCI 117,A01,494376,Staff,0,4,5,5
1714646102719,WES 237B,A00,494380,Staff,9,0,20,11
1714646104810,AESE 279B,A00,494370,Wade; Jon P,0,0,33,33
1714646105840,AIP 197,001,627712,Vespa; Emanuel Ignacio,9998,0,9999,1
1714646106869,ANAR 135S,A00,494369,Braswell; Geoffrey E.,0,0,0,0
1714646107900,BENG 196,001,628496,Engler; Adam J.,9998,0,9999,1
1714646108930,CAT 124RS,A01,519847,Geibel; William,0,0,20,20
1714646109958,CAT 125RS,A01,515971,Geibel; William,0,0,20,20
1714646110983,CLRE 250,A00,511389,Morris; Sheldon,9993,0,9999,6
1714646112010,CLRE 251,A00,507176,Mehta; Ravindra L.,9993,0,9999,6
1714646112010,CLRE 251,B00,511410,Mehta; Ravindra L.,9998,0,9999,1
1714646113040,CLRE 252,A00,507189,Cuomo; Raphael Eduardo,9995,0,9999,4
1714646114071,CLRE 253,A00,507199,Vaida; Florin,9994,0,9999,5
1714646114071,CLRE 253,B00,507202,Vaida; Florin,9999,0,9999,0
1714646115097,CLRE 259,A00,507211,Patel; Hemal,9996,0,9999,3
1714646116124,CLRE 260,A00,507221,Cuomo; Raphael Eduardo,9999,0,9999,0
1714646117153,CLRE 297,001,507242,Cuomo; Raphael Eduardo,9999,0,9999,0
1714646118182,COGS 197,001,638244,Voytek; Bradley Thomas,9998,0,9999,1
1714646119206,CSE 191,A00,516875,Minnes Kemp; Mor Mia,9992,0,9999,7
1714646120235,CSE 197,001,637388,Minnes Kemp; Mor Mia,9998,0,9999,1
1714646121263,CSS 201S,A01,494383,Staff,35,0,35,0
1714646122290,CSS 202S,A01,494387,Staff,35,0,35,0
1714646123321,DSC 197,001,628532,Eldridge; Justin Matthew,9996,0,9999,3
1714646124347,EAP 100,A00,516065,Staff,9797,0,9999,202
1714646125373,ECE 45,A01,507414,Staff,33,0,60,27
1714646127426,ECE 111,A01,507420,Staff,15,0,50,35
1714646128452,ECE 197,001,548057,Sievenpiper; Daniel F.,9993,0,9999,6
1714646129478,EDS 115,A00,507243,Choi; Bailey Miyeon,10,0,28,18
1714646130503,EDS 117,A01,494379,Staff,0,4,30,30
1714646131534,EDS 125,A00,507246,Hopkins; Megan Beth,9,0,30,21
1714646132558,EDS 128A,A01,507264,Fargason; Sharon Gayle,8,0,26,18
1714646133585,EDS 128B,A01,507293,Pappas; Elizabeth,12,0,30,18
1714646134610,EDS 139,A00,507294,Fargason; Sharon Gayle,13,0,30,17
1714646134610,EDS 139,B00,507313,Pappas; Elizabeth,13,0,30,17
1714646135639,EDS 201,A00,507315,Staff,13,0,30,17
1714646136669,EDS 203,A01,507317,Halter; Christopher P.,12,0,30,18
1714646137699,EDS 204R,A01,507319,Halter; Christopher P.,0,3,30,30
1714646137699,EDS 204R,B01,507331,Heinzman; Erica M.,16,0,30,14
1714646138726,EDS 206R,A00,507332,Staff,0,4,30,30
1714646138726,EDS 206R,B00,507343,Staff,17,0,30,13
1714646139755,EDS 250,A00,507344,Hemans; Patricia Ann Benitez,22,0,40,18
1714646140825,EDS 281,A00,507345,Daly; Alan J.,18,0,18,0
1714646141853,EDS 284,A00,507350,Daly; Alan J.,16,0,16,0
1714646142880,EDS 286,A00,507359,Fine; Sarah,18,0,18,0
1714646143908,EDS 289C,A01,507361,Daly; Alan J.,18,0,18,0
1714646144936,EDS 290,A00,507366,Hofstetter; Carolyn,15,0,15,0
1714646145960,LIGM 5A,A00,507421,Fischer-Grunski; Eva K,18,0,20,2
1714646146987,LIGM 5B,A00,507423,Fischer-Grunski; Eva K,19,0,20,1
1714646148014,LIGM 5C,A00,507425,Fischer-Grunski; Eva K,19,0,20,1
1714646149039,LIIT 5AS,A00,507427,Carnelos; Chiara,20,0,20,0
1714646150066,LIIT 5BS,A00,507430,Carnelos; Chiara,20,0,20,0
1714646151091,LIIT 5CS,A00,507432,Carnelos; Chiara,20,0,20,0
1714646152121,LISP 5A,A00,507541,Munoz Sanchez; Alicia,11,0,20,9
1714646153148,LISP 5B,A00,507671,Munoz Sanchez; Alicia,8,0,20,12
1714646154173,LISP 5C,A00,507696,Munoz Sanchez; Alicia,9,0,20,11
1714646155201,MAE 197,001,528363,Boechler; Nicholas Sebastia,9998,0,9999,1
1714646156232,MATH 197,001,523477,Kedlaya; Kiran S.,9995,0,9999,4
1714646156232,MATH 197,002,563811,Zhang; Danna,9995,0,9999,4
1714646156232,MATH 197,003,628552,Dumitriu; Ioana,9998,0,9999,1
1714646157259,MCWP 40R,A00,518780,Staff,2,0,20,18
1714646157259,MCWP 40R,B00,518781,Staff,8,0,20,12
1714646157259,MCWP 40R,C00,518783,Staff,6,0,20,14
1714646158285,MCWP 50R,A00,518791,Staff,0,0,20,20
1714646158285,MCWP 50R,B00,518792,Staff,0,2,20,20
1714646158285,MCWP 50R,C00,518793,Staff,0,2,20,20
1714646158285,MCWP 50R,D00,518794,Staff,0,1,20,20
1714646158285,MCWP 50R,E00,518795,Staff,0,2,20,20
1714646158285,MCWP 50R,F00,518796,Staff,0,0,20,20
1714646158285,MCWP 50R,G00,518797,Staff,0,1,20,20
1714646159312,MMW 12R,A01,514034,Herbst; Matthew,0,0,16,16
1714646159312,MMW 12R,A02,514035,Herbst; Matthew,1,0,16,15
1714646160340,MMW 13R,A01,514037,Staff,0,4,16,16
1714646160340,MMW 13R,A02,514039,Staff,0,2,16,16
1714646160340,MMW 13R,A03,628519,Staff,0,2,16,16
1714646162395,SIO 295LS,A00,523233,Staff,10,0,30,20
1714646163420,SIO 295S,A00,523232,Staff,10,0,30,20
1714646164447,SIOC 290S,A01,637330,Merrifield; Mark A,23,0,30,7
1714646165472,SIOC 291S,A01,637333,Gabriel; Corey John,23,0,30,7
1714646166501,SOCI 117,A01,494376,Staff,0,4,5,5
1714646167526,WES 237B,A00,494380,Staff,9,0,20,11
1714646169589,AESE 279B,A00,494370,Wade; Jon P,0,0,33,33
1714646170617,AIP 197,001,627712,Vespa; Emanuel Ignacio,9998,0,9999,1
1714646171655,ANAR 135S,A00,494369,Braswell; Geoffrey E.,0,0,0,0
1714646172683,BENG 196,001,628496,Engler; Adam J.,9998,0,9999,1
1714646173713,CAT 124RS,A01,519847,Geibel; William,0,0,20,20
1714646174739,CAT 125RS,A01,515971,Geibel; William,0,0,20,20
1714646175769,CLRE 250,A00,511389,Morris; Sheldon,9993,0,9999,6
1714646176802,CLRE 251,A00,507176,Mehta; Ravindra L.,9993,0,9999,6
1714646176802,CLRE 251,B00,511410,Mehta; Ravindra L.,9998,0,9999,1
1714646177832,CLRE 252,A00,507189,Cuomo; Raphael Eduardo,9995,0,9999,4
1714646178863,CLRE 253,A00,507199,Vaida; Florin,9994,0,9999,5
1714646178863,CLRE 253,B00,507202,Vaida; Florin,9999,0,9999,0
1714646179889,CLRE 259,A00,507211,Patel; Hemal,9996,0,9999,3
1714646180915,CLRE 260,A00,507221,Cuomo; Raphael Eduardo,9999,0,9999,0
1714646181940,CLRE 297,001,507242,Cuomo; Raphael Eduardo,9999,0,9999,0
1714646182966,COGS 197,001,638244,Voytek; Bradley Thomas,9998,0,9999,1
1714646183992,CSE 191,A00,516875,Minnes Kemp; Mor Mia,9992,0,9999,7
1714646185018,CSE 197,001,637388,Minnes Kemp; Mor Mia,9998,0,9999,1
1714646186046,CSS 201S,A01,494383,Staff,35,0,35,0
1714646187071,CSS 202S,A01,494387,Staff,35,0,35,0
1714646188100,DSC 197,001,628532,Eldridge; Justin Matthew,9996,0,9999,3
1714646189125,EAP 100,A00,516065,Staff,9797,0,9999,202
1714646190151,ECE 45,A01,507414,Staff,33,0,60,27
1714646192203,ECE 111,A01,507420,Staff,15,0,50,35
1714646193247,ECE 197,001,548057,Sievenpiper; Daniel F.,9993,0,9999,6
1714646194278,EDS 115,A00,507243,Choi; Bailey Miyeon,10,0,28,18
1714646195308,EDS 117,A01,494379,Staff,0,4,30,30
1714646196333,EDS 125,A00,507246,Hopkins; Megan Beth,9,0,30,21
1714646197358,EDS 128A,A01,507264,Fargason; Sharon Gayle,8,0,26,18
1714646198383,EDS 128B,A01,507293,Pappas; Elizabeth,12,0,30,18
1714646199410,EDS 139,A00,507294,Fargason; Sharon Gayle,13,0,30,17
1714646199410,EDS 139,B00,507313,Pappas; Elizabeth,13,0,30,17
1714646200433,EDS 201,A00,507315,Staff,13,0,30,17
1714646201464,EDS 203,A01,507317,Halter; Christopher P.,12,0,30,18
1714646202493,EDS 204R,A01,507319,Halter; Christopher P.,0,3,30,30
1714646202493,EDS 204R,B01,507331,Heinzman; Erica M.,16,0,30,14
1714646203517,EDS 206R,A00,507332,Staff,0,4,30,30
1714646203517,EDS 206R,B00,507343,Staff,17,0,30,13
1714646204543,EDS 250,A00,507344,Hemans; Patricia Ann Benitez,22,0,40,18
1714646205569,EDS 281,A00,507345,Daly; Alan J.,18,0,18,0
1714646206595,EDS 284,A00,507350,Daly; Alan J.,16,0,16,0
1714646207624,EDS 286,A00,507359,Fine; Sarah,18,0,18,0
1714646208649,EDS 289C,A01,507361,Daly; Alan J.,18,0,18,0
1714646209679,EDS 290,A00,507366,Hofstetter; Carolyn,15,0,15,0
1714646210710,LIGM 5A,A00,507421,Fischer-Grunski; Eva K,18,0,20,2
1714646211738,LIGM 5B,A00,507423,Fischer-Grunski; Eva K,19,0,20,1
1714646212770,LIGM 5C,A00,507425,Fischer-Grunski; Eva K,19,0,20,1
1714646213795,LIIT 5AS,A00,507427,Carnelos; Chiara,20,0,20,0
1714646214820,LIIT 5BS,A00,507430,Carnelos; Chiara,20,0,20,0
1714646215844,LIIT 5CS,A00,507432,Carnelos; Chiara,20,0,20,0
1714646216870,LISP 5A,A00,507541,Munoz Sanchez; Alicia,11,0,20,9
1714646217897,LISP 5B,A00,507671,Munoz Sanchez; Alicia,8,0,20,12
1714646218920,LISP 5C,A00,507696,Munoz Sanchez; Alicia,9,0,20,11
1714646219948,MAE 197,001,528363,Boechler; Nicholas Sebastia,9998,0,9999,1
1714646220974,MATH 197,001,523477,Kedlaya; Kiran S.,9995,0,9999,4
1714646220974,MATH 197,002,563811,Zhang; Danna,9995,0,9999,4
1714646220974,MATH 197,003,628552,Dumitriu; Ioana,9998,0,9999,1
1714646222004,MCWP 40R,A00,518780,Staff,2,0,20,18
1714646222004,MCWP 40R,B00,518781,Staff,8,0,20,12
1714646222004,MCWP 40R,C00,518783,Staff,6,0,20,14
1714646223029,MCWP 50R,A00,518791,Staff,0,0,20,20
1714646223029,MCWP 50R,B00,518792,Staff,0,2,20,20
1714646223029,MCWP 50R,C00,518793,Staff,0,2,20,20
1714646223029,MCWP 50R,D00,518794,Staff,0,1,20,20
1714646223029,MCWP 50R,E00,518795,Staff,0,2,20,20
1714646223029,MCWP 50R,F00,518796,Staff,0,0,20,20
1714646223029,MCWP 50R,G00,518797,Staff,0,1,20,20
1714646224058,MMW 12R,A01,514034,Herbst; Matthew,0,0,16,16
1714646224058,MMW 12R,A02,514035,Herbst; Matthew,1,0,16,15
1714646225083,MMW 13R,A01,514037,Staff,0,4,16,16
1714646225083,MMW 13R,A02,514039,Staff,0,2,16,16
1714646225083,MMW 13R,A03,628519,Staff,0,2,16,16
1714646227131,SIO 295LS,A00,523233,Staff,10,0,30,20
1714646228158,SIO 295S,A00,523232,Staff,10,0,30,20
1714646229188,SIOC 290S,A01,637330,Merrifield; Mark A,23,0,30,7
1714646230212,SIOC 291S,A01,637333,Gabriel; Corey John,23,0,30,7
1714646231238,SOCI 117,A01,494376,Staff,0,4,5,5
1714646232267,WES 237B,A00,494380,Staff,9,0,20,11
1714646234350,AESE 279B,A00,494370,Wade; Jon P,0,0,33,33
1714646235375,AIP 197,001,627712,Vespa; Emanuel Ignacio,9998,0,9999,1
1714646236402,ANAR 135S,A00,494369,Braswell; Geoffrey E.,0,0,0,0
1714646237429,BENG 196,001,628496,Engler; Adam J.,9998,0,9999,1
1714646238452,CAT 124RS,A01,519847,Geibel; William,0,0,20,20
1714646239515,CAT 125RS,A01,515971,Geibel; William,0,0,20,20
1714646240541,CLRE 250,A00,511389,Morris; Sheldon,9993,0,9999,6
1714646241575,CLRE 251,A00,507176,Mehta; Ravindra L.,9993,0,9999,6
1714646241575,CLRE 251,B00,511410,Mehta; Ravindra L.,9998,0,9999,1
1714646242600,CLRE 252,A00,507189,Cuomo; Raphael Eduardo,9995,0,9999,4
1714646243625,CLRE 253,A00,507199,Vaida; Florin,9994,0,9999,5
1714646243625,CLRE 253,B00,507202,Vaida; Florin,9999,0,9999,0
1714646244649,CLRE 259,A00,507211,Patel; Hemal,9996,0,9999,3
1714646245674,CLRE 260,A00,507221,Cuomo; Raphael Eduardo,9999,0,9999,0
1714646246700,CLRE 297,001,507242,Cuomo; Raphael Eduardo,9999,0,9999,0
1714646247728,COGS 197,001,638244,Voytek; Bradley Thomas,9998,0,9999,1
1714646248757,CSE 191,A00,516875,Minnes Kemp; Mor Mia,9992,0,9999,7
1714646249784,CSE 197,001,637388,Minnes Kemp; Mor Mia,9998,0,9999,1
1714646250814,CSS 201S,A01,494383,Staff,35,0,35,0
1714646251841,CSS 202S,A01,494387,Staff,35,0,35,0
1714646252867,DSC 197,001,628532,Eldridge; Justin Matthew,9996,0,9999,3
1714646253905,EAP 100,A00,516065,Staff,9797,0,9999,202
1714646254930,ECE 45,A01,507414,Staff,33,0,60,27
1714646256979,ECE 111,A01,507420,Staff,15,0,50,35
1714646258005,ECE 197,001,548057,Sievenpiper; Daniel F.,9993,0,9999,6
1714646259031,EDS 115,A00,507243,Choi; Bailey Miyeon,10,0,28,18
1714646260055,EDS 117,A01,494379,Staff,0,4,30,30
1714646261082,EDS 125,A00,507246,Hopkins; Megan Beth,9,0,30,21
1714646262112,EDS 128A,A01,507264,Fargason; Sharon Gayle,8,0,26,18
1714646263141,EDS 128B,A01,507293,Pappas; Elizabeth,12,0,30,18
1714646264165,EDS 139,A00,507294,Fargason; Sharon Gayle,13,0,30,17
1714646264165,EDS 139,B00,507313,Pappas; Elizabeth,13,0,30,17
1714646265189,EDS 201,A00,507315,Staff,13,0,30,17
1714646266215,EDS 203,A01,507317,Halter; Christopher P.,12,0,30,18
1714646267247,EDS 204R,A01,507319,Halter; Christopher P.,0,3,30,30
1714646267247,EDS 204R,B01,507331,Heinzman; Erica M.,16,0,30,14
1714646268278,EDS 206R,A00,507332,Staff,0,4,30,30
1714646268278,EDS 206R,B00,507343,Staff,17,0,30,13
1714646269302,EDS 250,A00,507344,Hemans; Patricia Ann Benitez,22,0,40,18
1714646270330,EDS 281,A00,507345,Daly; Alan J.,18,0,18,0
1714646271354,EDS 284,A00,507350,Daly; Alan J.,16,0,16,0
1714646272379,EDS 286,A00,507359,Fine; Sarah,18,0,18,0
1714646273405,EDS 289C,A01,507361,Daly; Alan J.,18,0,18,0
1714646274430,EDS 290,A00,507366,Hofstetter; Carolyn,15,0,15,0
1714646275457,LIGM 5A,A00,507421,Fischer-Grunski; Eva K,18,0,20,2
1714646276482,LIGM 5B,A00,507423,Fischer-Grunski; Eva K,19,0,20,1
1714646277512,LIGM 5C,A00,507425,Fischer-Grunski; Eva K,19,0,20,1
1714646278542,LIIT 5AS,A00,507427,Carnelos; Chiara,20,0,20,0
1714646279568,LIIT 5BS,A00,507430,Carnelos; Chiara,20,0,20,0
1714646280597,LIIT 5CS,A00,507432,Carnelos; Chiara,20,0,20,0
1714646281627,LISP 5A,A00,507541,Munoz Sanchez; Alicia,11,0,20,9
1714646282653,LISP 5B,A00,507671,Munoz Sanchez; Alicia,8,0,20,12
1714646283680,LISP 5C,A00,507696,Munoz Sanchez; Alicia,9,0,20,11
1714646284709,MAE 197,001,528363,Boechler; Nicholas Sebastia,9998,0,9999,1
1714646285737,MATH 197,001,523477,Kedlaya; Kiran S.,9995,0,9999,4
1714646285737,MATH 197,002,563811,Zhang; Danna,9995,0,9999,4
1714646285737,MATH 197,003,628552,Dumitriu; Ioana,9998,0,9999,1
1714646286765,MCWP 40R,A00,518780,Staff,2,0,20,18
1714646286765,MCWP 40R,B00,518781,Staff,8,0,20,12
1714646286765,MCWP 40R,C00,518783,Staff,6,0,20,14
1714646287789,MCWP 50R,A00,518791,Staff,0,0,20,20
1714646287789,MCWP 50R,B00,518792,Staff,0,2,20,20
1714646287789,MCWP 50R,C00,518793,Staff,0,2,20,20
1714646287789,MCWP 50R,D00,518794,Staff,0,1,20,20
1714646287789,MCWP 50R,E00,518795,Staff,0,2,20,20
1714646287789,MCWP 50R,F00,518796,Staff,0,0,20,20
1714646287789,MCWP 50R,G00,518797,Staff,0,1,20,20
1714646288820,MMW 12R,A01,514034,Herbst; Matthew,0,0,16,16
1714646288820,MMW 12R,A02,514035,Herbst; Matthew,1,0,16,15
1714646289848,MMW 13R,A01,514037,Staff,0,4,16,16
1714646289848,MMW 13R,A02,514039,Staff,0,2,16,16
1714646289848,MMW 13R,A03,628519,Staff,0,2,16,16
1714646291925,SIO 295LS,A00,523233,Staff,10,0,30,20
1714646292949,SIO 295S,A00,523232,Staff,10,0,30,20
1714646293975,SIOC 290S,A01,637330,Merrifield; Mark A,23,0,30,7
1714646295002,SIOC 291S,A01,637333,Gabriel; Corey John,23,0,30,7
1714646296028,SOCI 117,A01,494376,Staff,0,4,5,5
1714646297057,WES 237B,A00,494380,Staff,9,0,20,11
1714646299133,AESE 279B,A00,494370,Wade; Jon P,0,0,33,33
1714646300159,AIP 197,001,627712,Vespa; Emanuel Ignacio,9998,0,9999,1
1714646301188,ANAR 135S,A00,494369,Braswell; Geoffrey E.,0,0,0,0
1714646302213,BENG 196,001,628496,Engler; Adam J.,9998,0,9999,1
1714646303239,CAT 124RS,A01,519847,Geibel; William,0,0,20,20
1714646304265,CAT 125RS,A01,515971,Geibel; William,0,0,20,20
1714646305291,CLRE 250,A00,511389,Morris; Sheldon,9993,0,9999,6
1714646306317,CLRE 251,A00,507176,Mehta; Ravindra L.,9993,0,9999,6
1714646306317,CLRE 251,B00,511410,Mehta; Ravindra L.,9998,0,9999,1
1714646307342,CLRE 252,A00,507189,Cuomo; Raphael Eduardo,9995,0,9999,4
1714646308366,CLRE 253,A00,507199,Vaida; Florin,9994,0,9999,5
1714646308366,CLRE 253,B00,507202,Vaida; Florin,9999,0,9999,0
1714646309391,CLRE 259,A00,507211,Patel; Hemal,9996,0,9999,3
1714646310417,CLRE 260,A00,507221,Cuomo; Raphael Eduardo,9999,0,9999,0
1714646311445,CLRE 297,001,507242,Cuomo; Raphael Eduardo,9999,0,9999,0
1714646312471,COGS 197,001,638244,Voytek; Bradley Thomas,9998,0,9999,1
1714646313497,CSE 191,A00,516875,Minnes Kemp; Mor Mia,9992,0,9999,7
1714646314528,CSE 197,001,637388,Minnes Kemp; Mor Mia,9998,0,9999,1
1714646315553,CSS 201S,A01,494383,Staff,35,0,35,0
1714646316583,CSS 202S,A01,494387,Staff,35,0,35,0
1714646317606,DSC 197,001,628532,Eldridge; Justin Matthew,9996,0,9999,3
1714646318633,EAP 100,A00,516065,Staff,9797,0,9999,202
1714646319657,ECE 45,A01,507414,Staff,33,0,60,27
1714646321713,ECE 111,A01,507420,Staff,15,0,50,35
1714646322741,ECE 197,001,548057,Sievenpiper; Daniel F.,9993,0,9999,6
1714646323767,EDS 115,A00,507243,Choi; Bailey Miyeon,10,0,28,18
1714646324794,EDS 117,A01,494379,Staff,0,4,30,30
1714646325819,EDS 125,A00,507246,Hopkins; Megan Beth,9,0,30,21
1714646326844,EDS 128A,A01,507264,Fargason; Sharon Gayle,8,0,26,18
1714646327872,EDS 128B,A01,507293,Pappas; Elizabeth,12,0,30,18
1714646328897,EDS 139,A00,507294,Fargason; Sharon Gayle,13,0,30,17
1714646328897,EDS 139,B00,507313,Pappas; Elizabeth,13,0,30,17
1714646329922,EDS 201,A00,507315,Staff,13,0,30,17
1714646330952,EDS 203,A01,507317,Halter; Christopher P.,12,0,30,18
1714646331977,EDS 204R,A01,507319,Halter; Christopher P.,0,3,30,30
1714646331977,EDS 204R,B01,507331,Heinzman; Erica M.,16,0,30,14
1714646333000,EDS 206R,A00,507332,Staff,0,4,30,30
1714646333000,EDS 206R,B00,507343,Staff,17,0,30,13
1714646334026,EDS 250,A00,507344,Hemans; Patricia Ann Benitez,22,0,40,18
1714646335049,EDS 281,A00,507345,Daly; Alan J.,18,0,18,0
1714646336077,EDS 284,A00,507350,Daly; Alan J.,16,0,16,0
1714646337103,EDS 286,A00,507359,Fine; Sarah,18,0,18,0
1714646338131,EDS 289C,A01,507361,Daly; Alan J.,18,0,18,0
1714646339160,EDS 290,A00,507366,Hofstetter; Carolyn,15,0,15,0
1714646340205,LIGM 5A,A00,507421,Fischer-Grunski; Eva K,18,0,20,2
1714646341230,LIGM 5B,A00,507423,Fischer-Grunski; Eva K,19,0,20,1
1714646342258,LIGM 5C,A00,507425,Fischer-Grunski; Eva K,19,0,20,1
1714646343289,LIIT 5AS,A00,507427,Carnelos; Chiara,20,0,20,0
1714646344313,LIIT 5BS,A00,507430,Carnelos; Chiara,20,0,20,0
1714646345339,LIIT 5CS,A00,507432,Carnelos; Chiara,20,0,20,0
1714646346365,LISP 5A,A00,507541,Munoz Sanchez; Alicia,11,0,20,9
1714646347394,LISP 5B,A00,507671,Munoz Sanchez; Alicia,8,0,20,12
1714646348417,LISP 5C,A00,507696,Munoz Sanchez; Alicia,9,0,20,11
1714646349447,MAE 197,001,528363,Boechler; Nicholas Sebastia,9998,0,9999,1
1714646350475,MATH 197,001,523477,Kedlaya; Kiran S.,9995,0,9999,4
1714646350475,MATH 197,002,563811,Zhang; Danna,9995,0,9999,4
1714646350475,MATH 197,003,628552,Dumitriu; Ioana,9998,0,9999,1
1714646351502,MCWP 40R,A00,518780,Staff,2,0,20,18
1714646351502,MCWP 40R,B00,518781,Staff,8,0,20,12
1714646351502,MCWP 40R,C00,518783,Staff,6,0,20,14
1714646352533,MCWP 50R,A00,518791,Staff,0,0,20,20
1714646352533,MCWP 50R,B00,518792,Staff,0,2,20,20
1714646352533,MCWP 50R,C00,518793,Staff,0,2,20,20
1714646352533,MCWP 50R,D00,518794,Staff,0,1,20,20
1714646352533,MCWP 50R,E00,518795,Staff,0,2,20,20
1714646352533,MCWP 50R,F00,518796,Staff,0,0,20,20
1714646352533,MCWP 50R,G00,518797,Staff,0,1,20,20
1714646353561,MMW 12R,A01,514034,Herbst; Matthew,0,0,16,16
1714646353561,MMW 12R,A02,514035,Herbst; Matthew,1,0,16,15
1714646354585,MMW 13R,A01,514037,Staff,0,4,16,16
1714646354585,MMW 13R,A02,514039,Staff,0,2,16,16
1714646354585,MMW 13R,A03,628519,Staff,0,2,16,16
1714646356641,SIO 295LS,A00,523233,Staff,10,0,30,20
1714646357667,SIO 295S,A00,523232,Staff,10,0,30,20
1714646358693,SIOC 290S,A01,637330,Merrifield; Mark A,23,0,30,7
1714646359718,SIOC 291S,A01,637333,Gabriel; Corey John,23,0,30,7
1714646360749,SOCI 117,A01,494376,Staff,0,4,5,5
1714646361779,WES 237B,A00,494380,Staff,9,0,20,11
1714646363869,AESE 279B,A00,494370,Wade; Jon P,0,0,33,33
1714646364898,AIP 197,001,627712,Vespa; Emanuel Ignacio,9998,0,9999,1
1714646365922,ANAR 135S,A00,494369,Braswell; Geoffrey E.,0,0,0,0
1714646366952,BENG 196,001,628496,Engler; Adam J.,9998,0,9999,1
1714646367981,CAT 124RS,A01,519847,Geibel; William,0,0,20,20
1714646369009,CAT 125RS,A01,515971,Geibel; William,0,0,20,20
1714646370038,CLRE 250,A00,511389,Morris; Sheldon,9993,0,9999,6
1714646371074,CLRE 251,A00,507176,Mehta; Ravindra L.,9993,0,9999,6
1714646371074,CLRE 251,B00,511410,Mehta; Ravindra L.,9998,0,9999,1
1714646372101,CLRE 252,A00,507189,Cuomo; Raphael Eduardo,9995,0,9999,4
1714646373130,CLRE 253,A00,507199,Vaida; Florin,9994,0,9999,5
1714646373130,CLRE 253,B00,507202,Vaida; Florin,9999,0,9999,0
1714646374155,CLRE 259,A00,507211,Patel; Hemal,9996,0,9999,3
1714646375179,CLRE 260,A00,507221,Cuomo; Raphael Eduardo,9999,0,9999,0
1714646376205,CLRE 297,001,507242,Cuomo; Raphael Eduardo,9999,0,9999,0
1714646377231,COGS 197,001,638244,Voytek; Bradley Thomas,9998,0,9999,1
1714646378257,CSE 191,A00,516875,Minnes Kemp; Mor Mia,9992,0,9999,7
1714646379282,CSE 197,001,637388,Minnes Kemp; Mor Mia,9998,0,9999,1
1714646380308,CSS 201S,A01,494383,Staff,35,0,35,0
1714646381333,CSS 202S,A01,494387,Staff,35,0,35,0
1714646382357,DSC 197,001,628532,Eldridge; Justin Matthew,9996,0,9999,3
1714646383383,EAP 100,A00,516065,Staff,9797,0,9999,202
1714646384408,ECE 45,A01,507414,Staff,33,0,60,27
1714646386459,ECE 111,A01,507420,Staff,15,0,50,35
1714646387485,ECE 197,001,548057,Sievenpiper; Daniel F.,9993,0,9999,6
1714646388511,EDS 115,A00,507243,Choi; Bailey Miyeon,10,0,28,18
1714646389537,EDS 117,A01,494379,Staff,0,4,30,30
1714646390562,EDS 125,A00,507246,Hopkins; Megan Beth,9,0,30,21
1714646391591,EDS 128A,A01,507264,Fargason; Sharon Gayle,8,0,26,18
1714646392616,EDS 128B,A01,507293,Pappas; Elizabeth,12,0,30,18
1714646393645,EDS 139,A00,507294,Fargason; Sharon Gayle,13,0,30,17
1714646393645,EDS 139,B00,507313,Pappas; Elizabeth,13,0,30,17
1714646394670,EDS 201,A00,507315,Staff,13,0,30,17
1714646395696,EDS 203,A01,507317,Halter; Christopher P.,12,0,30,18
1714646396722,EDS 204R,A01,507319,Halter; Christopher P.,0,3,30,30
1714646396722,EDS 204R,B01,507331,Heinzman; Erica M.,16,0,30,14
1714646397747,EDS 206R,A00,507332,Staff,0,4,30,30
1714646397747,EDS 206R,B00,507343,Staff,17,0,30,13
1714646398776,EDS 250,A00,507344,Hemans; Patricia Ann Benitez,22,0,40,18
1714646399801,EDS 281,A00,507345,Daly; Alan J.,18,0,18,0
1714646400826,EDS 284,A00,507350,Daly; Alan J.,16,0,16,0
1714646401877,EDS 286,A00,507359,Fine; Sarah,18,0,18,0
1714646402905,EDS 289C,A01,507361,Daly; Alan J.,18,0,18,0
1714646403934,EDS 290,A00,507366,Hofstetter; Carolyn,15,0,15,0
1714646404964,LIGM 5A,A00,507421,Fischer-Grunski; Eva K,18,0,20,2
1714646405992,LIGM 5B,A00,507423,Fischer-Grunski; Eva K,19,0,20,1
1714646407018,LIGM 5C,A00,507425,Fischer-Grunski; Eva K,19,0,20,1
1714646408045,LIIT 5AS,A00,507427,Carnelos; Chiara,20,0,20,0
1714646409070,LIIT 5BS,A00,507430,Carnelos; Chiara,20,0,20,0
1714646410095,LIIT 5CS,A00,507432,Carnelos; Chiara,20,0,20,0
1714646411126,LISP 5A,A00,507541,Munoz Sanchez; Alicia,11,0,20,9
1714646412151,LISP 5B,A00,507671,Munoz Sanchez; Alicia,8,0,20,12
1714646413179,LISP 5C,A00,507696,Munoz Sanchez; Alicia,9,0,20,11
1714646414207,MAE 197,001,528363,Boechler; Nicholas Sebastia,9998,0,9999,1
1714646415240,MATH 197,001,523477,Kedlaya; Kiran S.,9995,0,9999,4
1714646415240,MATH 197,002,563811,Zhang; Danna,9995,0,9999,4
1714646415240,MATH 197,003,628552,Dumitriu; Ioana,9998,0,9999,1
1714646416271,MCWP 40R,A00,518780,Staff,2,0,20,18
1714646416271,MCWP 40R,B00,518781,Staff,8,0,20,12
1714646416271,MCWP 40R,C00,518783,Staff,6,0,20,14
1714646417302,MCWP 50R,A00,518791,Staff,0,0,20,20
1714646417302,MCWP 50R,B00,518792,Staff,0,2,20,20
1714646417302,MCWP 50R,C00,518793,Staff,0,2,20,20
1714646417302,MCWP 50R,D00,518794,Staff,0,1,20,20
1714646417302,MCWP 50R,E00,518795,Staff,0,2,20,20
1714646417302,MCWP 50R,F00,518796,Staff,0,0,20,20
1714646417302,MCWP 50R,G00,518797,Staff,0,1,20,20
1714646418330,MMW 12R,A01,514034,Herbst; Matthew,0,0,16,16
1714646418330,MMW 12R,A02,514035,Herbst; Matthew,1,0,16,15
1714646419365,MMW 13R,A01,514037,Staff,0,4,16,16
1714646419365,MMW 13R,A02,514039,Staff,0,2,16,16
1714646419365,MMW 13R,A03,628519,Staff,0,2,16,16
1714646421416,SIO 295LS,A00,523233,Staff,10,0,30,20
1714646422441,SIO 295S,A00,523232,Staff,10,0,30,20
1714646423471,SIOC 290S,A01,637330,Merrifield; Mark A,23,0,30,7
1714646424501,SIOC 291S,A01,637333,Gabriel; Corey John,23,0,30,7
1714646425533,SOCI 117,A01,494376,Staff,0,4,5,5
1714646426559,WES 237B,A00,494380,Staff,9,0,20,11
1714646428616,AESE 279B,A00,494370,Wade; Jon P,0,0,33,33
1714646429642,AIP 197,001,627712,Vespa; Emanuel Ignacio,9998,0,9999,1
1714646430670,ANAR 135S,A00,494369,Braswell; Geoffrey E.,0,0,0,0
1714646431694,BENG 196,001,628496,Engler; Adam J.,9998,0,9999,1
1714646432721,CAT 124RS,A01,519847,Geibel; William,0,0,20,20
1714646433746,CAT 125RS,A01,515971,Geibel; William,0,0,20,20
1714646434773,CLRE 250,A00,511389,Morris; Sheldon,9993,0,9999,6
1714646435800,CLRE 251,A00,507176,Mehta; Ravindra L.,9993,0,9999,6
1714646435800,CLRE 251,B00,511410,Mehta; Ravindra L.,9998,0,9999,1
1714646436826,CLRE 252,A00,507189,Cuomo; Raphael Eduardo,9995,0,9999,4
1714646437857,CLRE 253,A00,507199,Vaida; Florin,9994,0,9999,5
1714646437857,CLRE 253,B00,507202,Vaida; Florin,9999,0,9999,0
1714646438887,CLRE 259,A00,507211,Patel; Hemal,9996,0,9999,3
1714646439914,CLRE 260,A00,507221,Cuomo; Raphael Eduardo,9999,0,9999,0
1714646440945,CLRE 297,001,507242,Cuomo; Raphael Eduardo,9999,0,9999,0
1714646441972,COGS 197,001,638244,Voytek; Bradley Thomas,9998,0,9999,1
1714646442998,CSE 191,A00,516875,Minnes Kemp; Mor Mia,9992,0,9999,7
1714646444026,CSE 197,001,637388,Minnes Kemp; Mor Mia,9998,0,9999,1
1714646445051,CSS 201S,A01,494383,Staff,35,0,35,0
1714646446077,CSS 202S,A01,494387,Staff,35,0,35,0
1714646447106,DSC 197,001,628532,Eldridge; Justin Matthew,9996,0,9999,3
1714646448132,EAP 100,A00,516065,Staff,9797,0,9999,202
1714646449159,ECE 45,A01,507414,Staff,33,0,60,27
1714646451216,ECE 111,A01,507420,Staff,15,0,50,35
1714646452244,ECE 197,001,548057,Sievenpiper; Daniel F.,9993,0,9999,6
1714646453271,EDS 115,A00,507243,Choi; Bailey Miyeon,10,0,28,18
1714646454297,EDS 117,A01,494379,Staff,0,4,30,30
1714646455322,EDS 125,A00,507246,Hopkins; Megan Beth,9,0,30,21
1714646456349,EDS 128A,A01,507264,Fargason; Sharon Gayle,8,0,26,18
1714646457375,EDS 128B,A01,507293,Pappas; Elizabeth,12,0,30,18
1714646458401,EDS 139,A00,507294,Fargason; Sharon Gayle,13,0,30,17
1714646458401,EDS 139,B00,507313,Pappas; Elizabeth,13,0,30,17
1714646459429,EDS 201,A00,507315,Staff,13,0,30,17
1714646460461,EDS 203,A01,507317,Halter; Christopher P.,12,0,30,18
1714646461486,EDS 204R,A01,507319,Halter; Christopher P.,0,3,30,30
1714646461486,EDS 204R,B01,507331,Heinzman; Erica M.,16,0,30,14
1714646462513,EDS 206R,A00,507332,Staff,0,4,30,30
1714646462513,EDS 206R,B00,507343,Staff,17,0,30,13
1714646463541,EDS 250,A00,507344,Hemans; Patricia Ann Benitez,22,0,40,18
1714646464567,EDS 281,A00,507345,Daly; Alan J.,18,0,18,0
1714646465594,EDS 284,A00,507350,Daly; Alan J.,16,0,16,0
1714646466620,EDS 286,A00,507359,Fine; Sarah,18,0,18,0
1714646467644,EDS 289C,A01,507361,Daly; Alan J.,18,0,18,0
1714646468673,EDS 290,A00,507366,Hofstetter; Carolyn,15,0,15,0
1714646469700,LIGM 5A,A00,507421,Fischer-Grunski; Eva K,18,0,20,2
1714646470729,LIGM 5B,A00,507423,Fischer-Grunski; Eva K,19,0,20,1
1714646471755,LIGM 5C,A00,507425,Fischer-Grunski; Eva K,19,0,20,1
1714646472780,LIIT 5AS,A00,507427,Carnelos; Chiara,20,0,20,0
1714646473807,LIIT 5BS,A00,507430,Carnelos; Chiara,20,0,20,0
1714646474837,LIIT 5CS,A00,507432,Carnelos; Chiara,20,0,20,0
1714646475868,LISP 5A,A00,507541,Munoz Sanchez; Alicia,11,0,20,9
1714646476895,LISP 5B,A00,507671,Munoz Sanchez; Alicia,8,0,20,12
1714646477921,LISP 5C,A00,507696,Munoz Sanchez; Alicia,9,0,20,11
1714646478948,MAE 197,001,528363,Boechler; Nicholas Sebastia,9998,0,9999,1
1714646479982,MATH 197,001,523477,Kedlaya; Kiran S.,9995,0,9999,4
1714646479982,MATH 197,002,563811,Zhang; Danna,9995,0,9999,4
1714646479982,MATH 197,003,628552,Dumitriu; Ioana,9998,0,9999,1
1714646481018,MCWP 40R,A00,518780,Staff,2,0,20,18
1714646481018,MCWP 40R,B00,518781,Staff,8,0,20,12
1714646481018,MCWP 40R,C00,518783,Staff,6,0,20,14
1714646482044,MCWP 50R,A00,518791,Staff,0,0,20,20
1714646482044,MCWP 50R,B00,518792,Staff,0,2,20,20
1714646482044,MCWP 50R,C00,518793,Staff,0,2,20,20
1714646482044,MCWP 50R,D00,518794,Staff,0,1,20,20
1714646482044,MCWP 50R,E00,518795,Staff,0,2,20,20
1714646482044,MCWP 50R,F00,518796,Staff,0,0,20,20
1714646482044,MCWP 50R,G00,518797,Staff,0,1,20,20
1714646483075,MMW 12R,A01,514034,Herbst; Matthew,0,0,16,16
1714646483075,MMW 12R,A02,514035,Herbst; Matthew,1,0,16,15
1714646484102,MMW 13R,A01,514037,Staff,0,4,16,16
1714646484102,MMW 13R,A02,514039,Staff,0,2,16,16
1714646484102,MMW 13R,A03,628519,Staff,0,2,16,16
1714646486162,SIO 295LS,A00,523233,Staff,10,0,30,20
1714646487188,SIO 295S,A00,523232,Staff,10,0,30,20
1714646488215,SIOC 290S,A01,637330,Merrifield; Mark A,23,0,30,7
1714646489248,SIOC 291S,A01,637333,Gabriel; Corey John,23,0,30,7
1714646490272,SOCI 117,A01,494376,Staff,0,4,5,5
1714646491298,WES 237B,A00,494380,Staff,9,0,20,11
1714646493379,AESE 279B,A00,494370,Wade; Jon P,0,0,33,33
1714646494410,AIP 197,001,627712,Vespa; Emanuel Ignacio,9998,0,9999,1
1714646495435,ANAR 135S,A00,494369,Braswell; Geoffrey E.,0,0,0,0
1714646496460,BENG 196,001,628496,Engler; Adam J.,9998,0,9999,1
1714646497486,CAT 124RS,A01,519847,Geibel; William,0,0,20,20
1714646498510,CAT 125RS,A01,515971,Geibel; William,0,0,20,20
1714646499536,CLRE 250,A00,511389,Morris; Sheldon,9993,0,9999,6
1714646500563,CLRE 251,A00,507176,Mehta; Ravindra L.,9993,0,9999,6
1714646500563,CLRE 251,B00,511410,Mehta; Ravindra L.,9998,0,9999,1
1714646501587,CLRE 252,A00,507189,Cuomo; Raphael Eduardo,9995,0,9999,4
1714646502616,CLRE 253,A00,507199,Vaida; Florin,9994,0,9999,5
1714646502616,CLRE 253,B00,507202,Vaida; Florin,9999,0,9999,0
1714646503645,CLRE 259,A00,507211,Patel; Hemal,9996,0,9999,3
1714646504670,CLRE 260,A00,507221,Cuomo; Raphael Eduardo,9999,0,9999,0
1714646505697,CLRE 297,001,507242,Cuomo; Raphael Eduardo,9999,0,9999,0
1714646506726,COGS 197,001,638244,Voytek; Bradley Thomas,9998,0,9999,1
1714646507752,CSE 191,A00,516875,Minnes Kemp; Mor Mia,9992,0,9999,7
1714646508780,CSE 197,001,637388,Minnes Kemp; Mor Mia,9998,0,9999,1
1714646509806,CSS 201S,A01,494383,Staff,35,0,35,0
1714646510832,CSS 202S,A01,494387,Staff,35,0,35,0
1714646511857,DSC 197,001,628532,Eldridge; Justin Matthew,9996,0,9999,3
1714646512886,EAP 100,A00,516065,Staff,9797,0,9999,202
1714646513918,ECE 45,A01,507414,Staff,33,0,60,27
1714646515973,ECE 111,A01,507420,Staff,15,0,50,35
1714646517023,ECE 197,001,548057,Sievenpiper; Daniel F.,9993,0,9999,6
1714646518049,EDS 115,A00,507243,Choi; Bailey Miyeon,10,0,28,18
1714646519076,EDS 117,A01,494379,Staff,0,4,30,30
1714646520105,EDS 125,A00,507246,Hopkins; Megan Beth,9,0,30,21
1714646521131,EDS 128A,A01,507264,Fargason; Sharon Gayle,8,0,26,18
1714646522160,EDS 128B,A01,507293,Pappas; Elizabeth,12,0,30,18
1714646523190,EDS 139,A00,507294,Fargason; Sharon Gayle,13,0,30,17
1714646523190,EDS 139,B00,507313,Pappas; Elizabeth,13,0,30,17
1714646524217,EDS 201,A00,507315,Staff,13,0,30,17
1714646525242,EDS 203,A01,507317,Halter; Christopher P.,12,0,30,18
1714646526267,EDS 204R,A01,507319,Halter; Christopher P.,0,3,30,30
1714646526267,EDS 204R,B01,507331,Heinzman; Erica M.,16,0,30,14
1714646527292,EDS 206R,A00,507332,Staff,0,4,30,30
1714646527292,EDS 206R,B00,507343,Staff,17,0,30,13
1714646528318,EDS 250,A00,507344,Hemans; Patricia Ann Benitez,22,0,40,18
1714646529342,EDS 281,A00,507345,Daly; Alan J.,18,0,18,0
1714646530366,EDS 284,A00,507350,Daly; Alan J.,16,0,16,0
1714646531393,EDS 286,A00,507359,Fine; Sarah,18,0,18,0
1714646532419,EDS 289C,A01,507361,Daly; Alan J.,18,0,18,0
1714646533443,EDS 290,A00,507366,Hofstetter; Carolyn,15,0,15,0
1714646534475,LIGM 5A,A00,507421,Fischer-Grunski; Eva K,18,0,20,2
1714646535500,LIGM 5B,A00,507423,Fischer-Grunski; Eva K,19,0,20,1
1714646536525,LIGM 5C,A00,507425,Fischer-Grunski; Eva K,19,0,20,1
1714646537549,LIIT 5AS,A00,507427,Carnelos; Chiara,20,0,20,0
1714646538580,LIIT 5BS,A00,507430,Carnelos; Chiara,20,0,20,0
1714646539604,LIIT 5CS,A00,507432,Carnelos; Chiara,20,0,20,0
1714646540629,LISP 5A,A00,507541,Munoz Sanchez; Alicia,11,0,20,9
1714646541653,LISP 5B,A00,507671,Munoz Sanchez; Alicia,8,0,20,12
1714646542677,LISP 5C,A00,507696,Munoz Sanchez; Alicia,9,0,20,11
1714646543704,MAE 197,001,528363,Boechler; Nicholas Sebastia,9998,0,9999,1
1714646544733,MATH 197,001,523477,Kedlaya; Kiran S.,9995,0,9999,4
1714646544733,MATH 197,002,563811,Zhang; Danna,9995,0,9999,4
1714646544733,MATH 197,003,628552,Dumitriu; Ioana,9998,0,9999,1
1714646545761,MCWP 40R,A00,518780,Staff,2,0,20,18
1714646545761,MCWP 40R,B00,518781,Staff,8,0,20,12
1714646545761,MCWP 40R,C00,518783,Staff,6,0,20,14
1714646546789,MCWP 50R,A00,518791,Staff,0,0,20,20
1714646546789,MCWP 50R,B00,518792,Staff,0,2,20,20
1714646546789,MCWP 50R,C00,518793,Staff,0,2,20,20
1714646546789,MCWP 50R,D00,518794,Staff,0,1,20,20
1714646546789,MCWP 50R,E00,518795,Staff,0,2,20,20
1714646546789,MCWP 50R,F00,518796,Staff,0,0,20,20
1714646546789,MCWP 50R,G00,518797,Staff,0,1,20,20
1714646547817,MMW 12R,A01,514034,Herbst; Matthew,0,0,16,16
1714646547817,MMW 12R,A02,514035,Herbst; Matthew,1,0,16,15
1714646548848,MMW 13R,A01,514037,Staff,0,4,16,16
1714646548848,MMW 13R,A02,514039,Staff,0,2,16,16
1714646548848,MMW 13R,A03,628519,Staff,0,2,16,16
1714646550900,SIO 295LS,A00,523233,Staff,10,0,30,20
1714646551928,SIO 295S,A00,523232,Staff,10,0,30,20
1714646552962,SIOC 290S,A01,637330,Merrifield; Mark A,23,0,30,7
1714646553991,SIOC 291S,A01,637333,Gabriel; Corey John,23,0,30,7
1714646555022,SOCI 117,A01,494376,Staff,0,4,5,5
1714646556049,WES 237B,A00,494380,Staff,9,0,20,11
1714646558125,AESE 279B,A00,494370,Wade; Jon P,0,0,33,33
1714646559150,AIP 197,001,627712,Vespa; Emanuel Ignacio,9998,0,9999,1
1714646560176,ANAR 135S,A00,494369,Braswell; Geoffrey E.,0,0,0,0
1714646561205,BENG 196,001,628496,Engler; Adam J.,9998,0,9999,1
1714646562235,CAT 124RS,A01,519847,Geibel; William,0,0,20,20
1714646563259,CAT 125RS,A01,515971,Geibel; William,0,0,20,20
1714646564283,CLRE 250,A00,511389,Morris; Sheldon,9993,0,9999,6
1714646565311,CLRE 251,A00,507176,Mehta; Ravindra L.,9993,0,9999,6
1714646565311,CLRE 251,B00,511410,Mehta; Ravindra L.,9998,0,9999,1
1714646566339,CLRE 252,A00,507189,Cuomo; Raphael Eduardo,9995,0,9999,4
1714646567369,CLRE 253,A00,507199,Vaida; Florin,9994,0,9999,5
1714646567369,CLRE 253,B00,507202,Vaida; Florin,9999,0,9999,0
1714646568398,CLRE 259,A00,507211,Patel; Hemal,9996,0,9999,3
1714646569422,CLRE 260,A00,507221,Cuomo; Raphael Eduardo,9999,0,9999,0
1714646570448,CLRE 297,001,507242,Cuomo; Raphael Eduardo,9999,0,9999,0
1714646571474,COGS 197,001,638244,Voytek; Bradley Thomas,9998,0,9999,1
1714646572501,CSE 191,A00,516875,Minnes Kemp; Mor Mia,9992,0,9999,7
1714646573525,CSE 197,001,637388,Minnes Kemp; Mor Mia,9998,0,9999,1
1714646574553,CSS 201S,A01,494383,Staff,35,0,35,0
1714646575577,CSS 202S,A01,494387,Staff,35,0,35,0
1714646576604,DSC 197,001,628532,Eldridge; Justin Matthew,9996,0,9999,3
1714646577630,EAP 100,A00,516065,Staff,9797,0,9999,202
1714646578654,ECE 45,A01,507414,Staff,33,0,60,27
1714646580717,ECE 111,A01,507420,Staff,15,0,50,35
1714646581744,ECE 197,001,548057,Sievenpiper; Daniel F.,9993,0,9999,6
1714646582771,EDS 115,A00,507243,Choi; Bailey Miyeon,10,0,28,18
1714646583797,EDS 117,A01,494379,Staff,0,4,30,30
1714646584823,EDS 125,A00,507246,Hopkins; Megan Beth,9,0,30,21
1714646585848,EDS 128A,A01,507264,Fargason; Sharon Gayle,8,0,26,18
1714646586873,EDS 128B,A01,507293,Pappas; Elizabeth,12,0,30,18
1714646587902,EDS 139,A00,507294,Fargason; Sharon Gayle,13,0,30,17
1714646587902,EDS 139,B00,507313,Pappas; Elizabeth,13,0,30,17
1714646588930,EDS 201,A00,507315,Staff,13,0,30,17
1714646589961,EDS 203,A01,507317,Halter; Christopher P.,12,0,30,18
1714646590991,EDS 204R,A01,507319,Halter; Christopher P.,0,3,30,30
1714646590991,EDS 204R,B01,507331,Heinzman; Erica M.,16,0,30,14
1714646592018,EDS 206R,A00,507332,Staff,0,4,30,30
1714646592018,EDS 206R,B00,507343,Staff,17,0,30,13
1714646593043,EDS 250,A00,507344,Hemans; Patricia Ann Benitez,22,0,40,18
1714646594071,EDS 281,A00,507345,Daly; Alan J.,18,0,18,0
1714646595100,EDS 284,A00,507350,Daly; Alan J.,16,0,16,0
1714646596129,EDS 286,A00,507359,Fine; Sarah,18,0,18,0
1714646597157,EDS 289C,A01,507361,Daly; Alan J.,18,0,18,0
1714646598184,EDS 290,A00,507366,Hofstetter; Carolyn,15,0,15,0
1714646599210,LIGM 5A,A00,507421,Fischer-Grunski; Eva K,18,0,20,2
1714646600236,LIGM 5B,A00,507423,Fischer-Grunski; Eva K,19,0,20,1
1714646601264,LIGM 5C,A00,507425,Fischer-Grunski; Eva K,19,0,20,1
1714646602291,LIIT 5AS,A00,507427,Carnelos; Chiara,20,0,20,0
1714646603317,LIIT 5BS,A00,507430,Carnelos; Chiara,20,0,20,0
1714646604345,LIIT 5CS,A00,507432,Carnelos; Chiara,20,0,20,0
1714646605369,LISP 5A,A00,507541,Munoz Sanchez; Alicia,11,0,20,9
1714646606398,LISP 5B,A00,507671,Munoz Sanchez; Alicia,8,0,20,12
1714646607423,LISP 5C,A00,507696,Munoz Sanchez; Alicia,9,0,20,11
1714646608452,MAE 197,001,528363,Boechler; Nicholas Sebastia,9998,0,9999,1
1714646609485,MATH 197,001,523477,Kedlaya; Kiran S.,9995,0,9999,4
1714646609485,MATH 197,002,563811,Zhang; Danna,9995,0,9999,4
1714646609485,MATH 197,003,628552,Dumitriu; Ioana,9998,0,9999,1
1714646610511,MCWP 40R,A00,518780,Staff,2,0,20,18
1714646610511,MCWP 40R,B00,518781,Staff,8,0,20,12
1714646610511,MCWP 40R,C00,518783,Staff,6,0,20,14
1714646611536,MCWP 50R,A00,518791,Staff,0,0,20,20
1714646611536,MCWP 50R,B00,518792,Staff,0,2,20,20
1714646611536,MCWP 50R,C00,518793,Staff,0,2,20,20
1714646611536,MCWP 50R,D00,518794,Staff,0,1,20,20
1714646611536,MCWP 50R,E00,518795,Staff,0,2,20,20
1714646611536,MCWP 50R,F00,518796,Staff,0,0,20,20
1714646611536,MCWP 50R,G00,518797,Staff,0,1,20,20
1714646612567,MMW 12R,A01,514034,Herbst; Matthew,0,0,16,16
1714646612567,MMW 12R,A02,514035,Herbst; Matthew,1,0,16,15
1714646613592,MMW 13R,A01,514037,Staff,0,4,16,16
1714646613592,MMW 13R,A02,514039,Staff,0,2,16,16
1714646613592,MMW 13R,A03,628519,Staff,0,2,16,16
1714646615649,SIO 295LS,A00,523233,Staff,10,0,30,20
1714646616676,SIO 295S,A00,523232,Staff,10,0,30,20
1714646617706,SIOC 290S,A01,637330,Merrifield; Mark A,23,0,30,7
1714646618732,SIOC 291S,A01,637333,Gabriel; Corey John,23,0,30,7
1714646619758,SOCI 117,A01,494376,Staff,0,4,5,5
1714646620786,WES 237B,A00,494380,Staff,9,0,20,11
1714646623065,AESE 279B,A00,494370,Wade; Jon P,0,0,33,33
1714646624096,AIP 197,001,627712,Vespa; Emanuel Ignacio,9998,0,9999,1
1714646625122,ANAR 135S,A00,494369,Braswell; Geoffrey E.,0,0,0,0
1714646626147,BENG 196,001,628496,Engler; Adam J.,9998,0,9999,1
1714646627173,CAT 124RS,A01,519847,Geibel; William,0,0,20,20
1714646628198,CAT 125RS,A01,515971,Geibel; William,0,0,20,20
1714646629221,CLRE 250,A00,511389,Morris; Sheldon,9993,0,9999,6
1714646630252,CLRE 251,A00,507176,Mehta; Ravindra L.,9993,0,9999,6
1714646630252,CLRE 251,B00,511410,Mehta; Ravindra L.,9998,0,9999,1
1714646631278,CLRE 252,A00,507189,Cuomo; Raphael Eduardo,9995,0,9999,4
1714646632309,CLRE 253,A00,507199,Vaida; Florin,9994,0,9999,5
1714646632309,CLRE 253,B00,507202,Vaida; Florin,9999,0,9999,0
1714646633334,CLRE 259,A00,507211,Patel; Hemal,9996,0,9999,3
1714646634358,CLRE 260,A00,507221,Cuomo; Raphael Eduardo,9999,0,9999,0
1714646635384,CLRE 297,001,507242,Cuomo; Raphael Eduardo,9999,0,9999,0
1714646636411,COGS 197,001,638244,Voytek; Bradley Thomas,9998,0,9999,1
1714646637442,CSE 191,A00,516875,Minnes Kemp; Mor Mia,9992,0,9999,7
1714646638468,CSE 197,001,637388,Minnes Kemp; Mor Mia,9998,0,9999,1
1714646639497,CSS 201S,A01,494383,Staff,35,0,35,0
1714646640522,CSS 202S,A01,494387,Staff,35,0,35,0
1714646641551,DSC 197,001,628532,Eldridge; Justin Matthew,9996,0,9999,3
1714646642580,EAP 100,A00,516065,Staff,9797,0,9999,202
1714646643605,ECE 45,A01,507414,Staff,33,0,60,27
1714646645662,ECE 111,A01,507420,Staff,15,0,50,35
1714646646688,ECE 197,001,548057,Sievenpiper; Daniel F.,9993,0,9999,6
1714646647713,EDS 115,A00,507243,Choi; Bailey Miyeon,10,0,28,18
1714646648738,EDS 117,A01,494379,Staff,0,4,30,30
1714646649765,EDS 125,A00,507246,Hopkins; Megan Beth,9,0,30,21
1714646650790,EDS 128A,A01,507264,Fargason; Sharon Gayle,8,0,26,18
1714646651821,EDS 128B,A01,507293,Pappas; Elizabeth,12,0,30,18
1714646652851,EDS 139,A00,507294,Fargason; Sharon Gayle,13,0,30,17
1714646652851,EDS 139,B00,507313,Pappas; Elizabeth,13,0,30,17
1714646653878,EDS 201,A00,507315,Staff,13,0,30,17
1714646654909,EDS 203,A01,507317,Halter; Christopher P.,12,0,30,18
1714646655935,EDS 204R,A01,507319,Halter; Christopher P.,0,3,30,30
1714646655935,EDS 204R,B01,507331,Heinzman; Erica M.,16,0,30,14
1714646656962,EDS 206R,A00,507332,Staff,0,4,30,30
1714646656962,EDS 206R,B00,507343,Staff,17,0,30,13
1714646657987,EDS 250,A00,507344,Hemans; Patricia Ann Benitez,22,0,40,18
1714646659016,EDS 281,A00,507345,Daly; Alan J.,18,0,18,0
1714646660043,EDS 284,A00,507350,Daly; Alan J.,16,0,16,0
1714646661088,EDS 286,A00,507359,Fine; Sarah,18,0,18,0
1714646662115,EDS 289C,A01,507361,Daly; Alan J.,18,0,18,0
1714646663145,EDS 290,A00,507366,Hofstetter; Carolyn,15,0,15,0
1714646664173,LIGM 5A,A00,507421,Fischer-Grunski; Eva K,18,0,20,2
1714646665198,LIGM 5B,A00,507423,Fischer-Grunski; Eva K,19,0,20,1
1714646666228,LIGM 5C,A00,507425,Fischer-Grunski; Eva K,19,0,20,1
1714646667255,LIIT 5AS,A00,507427,Carnelos; Chiara,20,0,20,0
1714646668280,LIIT 5BS,A00,507430,Carnelos; Chiara,20,0,20,0
1714646669306,LIIT 5CS,A00,507432,Carnelos; Chiara,20,0,20,0
1714646670333,LISP 5A,A00,507541,Munoz Sanchez; Alicia,11,0,20,9
1714646671359,LISP 5B,A00,507671,Munoz Sanchez; Alicia,8,0,20,12
1714646672386,LISP 5C,A00,507696,Munoz Sanchez; Alicia,9,0,20,11
1714646673413,MAE 197,001,528363,Boechler; Nicholas Sebastia,9998,0,9999,1
1714646674441,MATH 197,001,523477,Kedlaya; Kiran S.,9995,0,9999,4
1714646674441,MATH 197,002,563811,Zhang; Danna,9995,0,9999,4
1714646674441,MATH 197,003,628552,Dumitriu; Ioana,9998,0,9999,1
1714646675465,MCWP 40R,A00,518780,Staff,2,0,20,18
1714646675465,MCWP 40R,B00,518781,Staff,8,0,20,12
1714646675465,MCWP 40R,C00,518783,Staff,6,0,20,14
1714646676493,MCWP 50R,A00,518791,Staff,0,0,20,20
1714646676493,MCWP 50R,B00,518792,Staff,0,2,20,20
1714646676493,MCWP 50R,C00,518793,Staff,0,2,20,20
1714646676493,MCWP 50R,D00,518794,Staff,0,1,20,20
1714646676493,MCWP 50R,E00,518795,Staff,0,2,20,20
1714646676493,MCWP 50R,F00,518796,Staff,0,0,20,20
1714646676493,MCWP 50R,G00,518797,Staff,0,1,20,20
1714646677517,MMW 12R,A01,514034,Herbst; Matthew,0,0,16,16
1714646677517,MMW 12R,A02,514035,Herbst; Matthew,1,0,16,15
1714646678545,MMW 13R,A01,514037,Staff,0,4,16,16
1714646678545,MMW 13R,A02,514039,Staff,0,2,16,16
1714646678545,MMW 13R,A03,628519,Staff,0,2,16,16
1714646680598,SIO 295LS,A00,523233,Staff,10,0,30,20
1714646681625,SIO 295S,A00,523232,Staff,10,0,30,20
1714646682656,SIOC 290S,A01,637330,Merrifield; Mark A,23,0,30,7
1714646683681,SIOC 291S,A01,637333,Gabriel; Corey John,23,0,30,7
1714646684707,SOCI 117,A01,494376,Staff,0,4,5,5
1714646685734,WES 237B,A00,494380,Staff,9,0,20,11
1714646687803,AESE 279B,A00,494370,Wade; Jon P,0,0,33,33
1714646688828,AIP 197,001,627712,Vespa; Emanuel Ignacio,9998,0,9999,1
1714646689853,ANAR 135S,A00,494369,Braswell; Geoffrey E.,0,0,0,0
1714646690879,BENG 196,001,628496,Engler; Adam J.,9998,0,9999,1
1714646691906,CAT 124RS,A01,519847,Geibel; William,0,0,20,20
1714646692931,CAT 125RS,A01,515971,Geibel; William,0,0,20,20
1714646693962,CLRE 250,A00,511389,Morris; Sheldon,9993,0,9999,6
1714646694990,CLRE 251,A00,507176,Mehta; Ravindra L.,9993,0,9999,6
1714646694990,CLRE 251,B00,511410,Mehta; Ravindra L.,9998,0,9999,1
1714646696020,CLRE 252,A00,507189,Cuomo; Raphael Eduardo,9995,0,9999,4
1714646697050,CLRE 253,A00,507199,Vaida; Florin,9994,0,9999,5
1714646697050,CLRE 253,B00,507202,Vaida; Florin,9999,0,9999,0
1714646698080,CLRE 259,A00,507211,Patel; Hemal,9996,0,9999,3
1714646699110,CLRE 260,A00,507221,Cuomo; Raphael Eduardo,9999,0,9999,0
1714646700134,CLRE 297,001,507242,Cuomo; Raphael Eduardo,9999,0,9999,0
1714646701163,COGS 197,001,638244,Voytek; Bradley Thomas,9998,0,9999,1
1714646702191,CSE 191,A00,516875,Minnes Kemp; Mor Mia,9992,0,9999,7
1714646703215,CSE 197,001,637388,Minnes Kemp; Mor Mia,9998,0,9999,1
1714646704241,CSS 201S,A01,494383,Staff,35,0,35,0
1714646705269,CSS 202S,A01,494387,Staff,35,0,35,0
1714646706294,DSC 197,001,628532,Eldridge; Justin Matthew,9996,0,9999,3
1714646707320,EAP 100,A00,516065,Staff,9797,0,9999,202
1714646708346,ECE 45,A01,507414,Staff,33,0,60,27
1714646710400,ECE 111,A01,507420,Staff,15,0,50,35
1714646711430,ECE 197,001,548057,Sievenpiper; Daniel F.,9993,0,9999,6
1714646712461,EDS 115,A00,507243,Choi; Bailey Miyeon,10,0,28,18
1714646713488,EDS 117,A01,494379,Staff,0,4,30,30
1714646714515,EDS 125,A00,507246,Hopkins; Megan Beth,9,0,30,21
1714646715541,EDS 128A,A01,507264,Fargason; Sharon Gayle,8,0,26,18
1714646716571,EDS 128B,A01,507293,Pappas; Elizabeth,12,0,30,18
1714646717597,EDS 139,A00,507294,Fargason; Sharon Gayle,13,0,30,17
1714646717597,EDS 139,B00,507313,Pappas; Elizabeth,13,0,30,17
1714646718622,EDS 201,A00,507315,Staff,13,0,30,17
1714646719652,EDS 203,A01,507317,Halter; Christopher P.,12,0,30,18
1714646720677,EDS 204R,A01,507319,Halter; Christopher P.,0,3,30,30
1714646720677,EDS 204R,B01,507331,Heinzman; Erica M.,16,0,30,14
1714646721704,EDS 206R,A00,507332,Staff,0,4,30,30
1714646721704,EDS 206R,B00,507343,Staff,17,0,30,13
1714646722730,EDS 250,A00,507344,Hemans; Patricia Ann Benitez,22,0,40,18
1714646723813,EDS 281,A00,507345,Daly; Alan J.,18,0,18,0
1714646724841,EDS 284,A00,507350,Daly; Alan J.,16,0,16,0
1714646725869,EDS 286,A00,507359,Fine; Sarah,18,0,18,0
1714646726893,EDS 289C,A01,507361,Daly; Alan J.,18,0,18,0
1714646727919,EDS 290,A00,507366,Hofstetter; Carolyn,15,0,15,0
1714646728946,LIGM 5A,A00,507421,Fischer-Grunski; Eva K,18,0,20,2
1714646729975,LIGM 5B,A00,507423,Fischer-Grunski; Eva K,19,0,20,1
1714646730999,LIGM 5C,A00,507425,Fischer-Grunski; Eva K,19,0,20,1
1714646732027,LIIT 5AS,A00,507427,Carnelos; Chiara,20,0,20,0
1714646733056,LIIT 5BS,A00,507430,Carnelos; Chiara,20,0,20,0
1714646734081,LIIT 5CS,A00,507432,Carnelos; Chiara,20,0,20,0
1714646735107,LISP 5A,A00,507541,Munoz Sanchez; Alicia,11,0,20,9
1714646736137,LISP 5B,A00,507671,Munoz Sanchez; Alicia,8,0,20,12
1714646737167,LISP 5C,A00,507696,Munoz Sanchez; Alicia,9,0,20,11
1714646738192,MAE 197,001,528363,Boechler; Nicholas Sebastia,9998,0,9999,1
1714646739221,MATH 197,001,523477,Kedlaya; Kiran S.,9995,0,9999,4
1714646739221,MATH 197,002,563811,Zhang; Danna,9995,0,9999,4
1714646739221,MATH 197,003,628552,Dumitriu; Ioana,9998,0,9999,1
1714646740248,MCWP 40R,A00,518780,Staff,2,0,20,18
1714646740248,MCWP 40R,B00,518781,Staff,8,0,20,12
1714646740248,MCWP 40R,C00,518783,Staff,6,0,20,14
1714646741279,MCWP 50R,A00,518791,Staff,0,0,20,20
1714646741279,MCWP 50R,B00,518792,Staff,0,2,20,20
1714646741279,MCWP 50R,C00,518793,Staff,0,2,20,20
1714646741279,MCWP 50R,D00,518794,Staff,0,1,20,20
1714646741279,MCWP 50R,E00,518795,Staff,0,2,20,20
1714646741279,MCWP 50R,F00,518796,Staff,0,0,20,20
1714646741279,MCWP 50R,G00,518797,Staff,0,1,20,20
1714646742306,MMW 12R,A01,514034,Herbst; Matthew,0,0,16,16
1714646742306,MMW 12R,A02,514035,Herbst; Matthew,1,0,16,15
1714646743333,MMW 13R,A01,514037,Staff,0,4,16,16
1714646743333,MMW 13R,A02,514039,Staff,0,2,16,16
1714646743333,MMW 13R,A03,628519,Staff,0,2,16,16
1714646745388,SIO 295LS,A00,523233,Staff,10,0,30,20
1714646746413,SIO 295S,A00,523232,Staff,10,0,30,20
1714646747442,SIOC 290S,A01,637330,Merrifield; Mark A,23,0,30,7
1714646748467,SIOC 291S,A01,637333,Gabriel; Corey John,23,0,30,7
1714646749493,SOCI 117,A01,494376,Staff,0,4,5,5
1714646750520,WES 237B,A00,494380,Staff,9,0,20,11
1714646752590,AESE 279B,A00,494370,Wade; Jon P,0,0,33,33
1714646753615,AIP 197,001,627712,Vespa; Emanuel Ignacio,9998,0,9999,1
1714646754644,ANAR 135S,A00,494369,Braswell; Geoffrey E.,0,0,0,0
1714646755669,BENG 196,001,628496,Engler; Adam J.,9998,0,9999,1
1714646756695,CAT 124RS,A01,519847,Geibel; William,0,0,20,20
1714646757723,CAT 125RS,A01,515971,Geibel; William,0,0,20,20
1714646758748,CLRE 250,A00,511389,Morris; Sheldon,9993,0,9999,6
1714646759775,CLRE 251,A00,507176,Mehta; Ravindra L.,9993,0,9999,6
1714646759775,CLRE 251,B00,511410,Mehta; Ravindra L.,9998,0,9999,1
1714646760800,CLRE 252,A00,507189,Cuomo; Raphael Eduardo,9995,0,9999,4
1714646761830,CLRE 253,A00,507199,Vaida; Florin,9994,0,9999,5
1714646761830,CLRE 253,B00,507202,Vaida; Florin,9999,0,9999,0
1714646762856,CLRE 259,A00,507211,Patel; Hemal,9996,0,9999,3
1714646763882,CLRE 260,A00,507221,Cuomo; Raphael Eduardo,9999,0,9999,0
1714646764906,CLRE 297,001,507242,Cuomo; Raphael Eduardo,9999,0,9999,0
1714646765933,COGS 197,001,638244,Voytek; Bradley Thomas,9998,0,9999,1
1714646766964,CSE 191,A00,516875,Minnes Kemp; Mor Mia,9992,0,9999,7
1714646767991,CSE 197,001,637388,Minnes Kemp; Mor Mia,9998,0,9999,1
1714646769022,CSS 201S,A01,494383,Staff,35,0,35,0
1714646770052,CSS 202S,A01,494387,Staff,35,0,35,0
1714646771077,DSC 197,001,628532,Eldridge; Justin Matthew,9996,0,9999,3
1714646772103,EAP 100,A00,516065,Staff,9797,0,9999,202
1714646773133,ECE 45,A01,507414,Staff,33,0,60,27
1714646775191,ECE 111,A01,507420,Staff,15,0,50,35
1714646776216,ECE 197,001,548057,Sievenpiper; Daniel F.,9993,0,9999,6
1714646777242,EDS 115,A00,507243,Choi; Bailey Miyeon,10,0,28,18
1714646778273,EDS 117,A01,494379,Staff,0,4,30,30
1714646779301,EDS 125,A00,507246,Hopkins; Megan Beth,9,0,30,21
1714646780328,EDS 128A,A01,507264,Fargason; Sharon Gayle,8,0,26,18
1714646781354,EDS 128B,A01,507293,Pappas; Elizabeth,12,0,30,18
1714646782379,EDS 139,A00,507294,Fargason; Sharon Gayle,13,0,30,17
1714646782379,EDS 139,B00,507313,Pappas; Elizabeth,13,0,30,17
1714646783406,EDS 201,A00,507315,Staff,13,0,30,17
1714646784431,EDS 203,A01,507317,Halter; Christopher P.,12,0,30,18
1714646785461,EDS 204R,A01,507319,Halter; Christopher P.,0,3,30,30
1714646785461,EDS 204R,B01,507331,Heinzman; Erica M.,16,0,30,14
1714646786487,EDS 206R,A00,507332,Staff,0,4,30,30
1714646786487,EDS 206R,B00,507343,Staff,17,0,30,13
1714646787512,EDS 250,A00,507344,Hemans; Patricia Ann Benitez,22,0,40,18
1714646788535,EDS 281,A00,507345,Daly; Alan J.,18,0,18,0
1714646789563,EDS 284,A00,507350,Daly; Alan J.,16,0,16,0
1714646790593,EDS 286,A00,507359,Fine; Sarah,18,0,18,0
1714646791616,EDS 289C,A01,507361,Daly; Alan J.,18,0,18,0
1714646792646,EDS 290,A00,507366,Hofstetter; Carolyn,15,0,15,0
1714646793677,LIGM 5A,A00,507421,Fischer-Grunski; Eva K,18,0,20,2
1714646794703,LIGM 5B,A00,507423,Fischer-Grunski; Eva K,19,0,20,1
1714646795728,LIGM 5C,A00,507425,Fischer-Grunski; Eva K,19,0,20,1
1714646796759,LIIT 5AS,A00,507427,Carnelos; Chiara,20,0,20,0
1714646797782,LIIT 5BS,A00,507430,Carnelos; Chiara,20,0,20,0
1714646798811,LIIT 5CS,A00,507432,Carnelos; Chiara,20,0,20,0
1714646799835,LISP 5A,A00,507541,Munoz Sanchez; Alicia,11,0,20,9
1714646800865,LISP 5B,A00,507671,Munoz Sanchez; Alicia,8,0,20,12
1714646801890,LISP 5C,A00,507696,Munoz Sanchez; Alicia,9,0,20,11
1714646802916,MAE 197,001,528363,Boechler; Nicholas Sebastia,9998,0,9999,1
1714646803952,MATH 197,001,523477,Kedlaya; Kiran S.,9995,0,9999,4
1714646803952,MATH 197,002,563811,Zhang; Danna,9995,0,9999,4
1714646803952,MATH 197,003,628552,Dumitriu; Ioana,9998,0,9999,1
1714646804977,MCWP 40R,A00,518780,Staff,2,0,20,18
1714646804977,MCWP 40R,B00,518781,Staff,8,0,20,12
1714646804977,MCWP 40R,C00,518783,Staff,6,0,20,14
1714646806002,MCWP 50R,A00,518791,Staff,0,0,20,20
1714646806002,MCWP 50R,B00,518792,Staff,0,2,20,20
1714646806002,MCWP 50R,C00,518793,Staff,0,2,20,20
1714646806002,MCWP 50R,D00,518794,Staff,0,1,20,20
1714646806002,MCWP 50R,E00,518795,Staff,0,2,20,20
1714646806002,MCWP 50R,F00,518796,Staff,0,0,20,20
1714646806002,MCWP 50R,G00,518797,Staff,0,1,20,20
1714646807036,MMW 12R,A01,514034,Herbst; Matthew,0,0,16,16
1714646807036,MMW 12R,A02,514035,Herbst; Matthew,1,0,16,15
1714646808060,MMW 13R,A01,514037,Staff,0,4,16,16
1714646808060,MMW 13R,A02,514039,Staff,0,2,16,16
1714646808060,MMW 13R,A03,628519,Staff,0,2,16,16
1714646810115,SIO 295LS,A00,523233,Staff,10,0,30,20
1714646811139,SIO 295S,A00,523232,Staff,10,0,30,20
1714646812166,SIOC 290S,A01,637330,Merrifield; Mark A,23,0,30,7
1714646813198,SIOC 291S,A01,637333,Gabriel; Corey John,23,0,30,7
1714646814223,SOCI 117,A01,494376,Staff,0,4,5,5
1714646815246,WES 237B,A00,494380,Staff,9,0,20,11
1714646817313,AESE 279B,A00,494370,Wade; Jon P,0,0,33,33
1714646818341,AIP 197,001,627712,Vespa; Emanuel Ignacio,9998,0,9999,1
1714646819370,ANAR 135S,A00,494369,Braswell; Geoffrey E.,0,0,0,0
1714646820399,BENG 196,001,628496,Engler; Adam J.,9998,0,9999,1
1714646821423,CAT 124RS,A01,519847,Geibel; William,0,0,20,20
1714646822451,CAT 125RS,A01,515971,Geibel; William,0,0,20,20
1714646823477,CLRE 250,A00,511389,Morris; Sheldon,9993,0,9999,6
1714646824507,CLRE 251,A00,507176,Mehta; Ravindra L.,9993,0,9999,6
1714646824507,CLRE 251,B00,511410,Mehta; Ravindra L.,9998,0,9999,1
1714646825532,CLRE 252,A00,507189,Cuomo; Raphael Eduardo,9995,0,9999,4
1714646826559,CLRE 253,A00,507199,Vaida; Florin,9994,0,9999,5
1714646826559,CLRE 253,B00,507202,Vaida; Florin,9999,0,9999,0
1714646827584,CLRE 259,A00,507211,Patel; Hemal,9996,0,9999,3
1714646828608,CLRE 260,A00,507221,Cuomo; Raphael Eduardo,9999,0,9999,0
1714646829636,CLRE 297,001,507242,Cuomo; Raphael Eduardo,9999,0,9999,0
1714646830664,COGS 197,001,638244,Voytek; Bradley Thomas,9998,0,9999,1
1714646831692,CSE 191,A00,516875,Minnes Kemp; Mor Mia,9992,0,9999,7
1714646832718,CSE 197,001,637388,Minnes Kemp; Mor Mia,9998,0,9999,1
1714646833743,CSS 201S,A01,494383,Staff,35,0,35,0
1714646834771,CSS 202S,A01,494387,Staff,35,0,35,0
1714646835795,DSC 197,001,628532,Eldridge; Justin Matthew,9996,0,9999,3
1714646836818,EAP 100,A00,516065,Staff,9797,0,9999,202
1714646837845,ECE 45,A01,507414,Staff,33,0,60,27
1714646839921,ECE 111,A01,507420,Staff,15,0,50,35
1714646840946,ECE 197,001,548057,Sievenpiper; Daniel F.,9993,0,9999,6
1714646841974,EDS 115,A00,507243,Choi; Bailey Miyeon,10,0,28,18
1714646843000,EDS 117,A01,494379,Staff,0,4,30,30
1714646844025,EDS 125,A00,507246,Hopkins; Megan Beth,9,0,30,21
1714646845055,EDS 128A,A01,507264,Fargason; Sharon Gayle,8,0,26,18
1714646846083,EDS 128B,A01,507293,Pappas; Elizabeth,12,0,30,18
1714646847111,EDS 139,A00,507294,Fargason; Sharon Gayle,13,0,30,17
1714646847111,EDS 139,B00,507313,Pappas; Elizabeth,13,0,30,17
1714646848141,EDS 201,A00,507315,Staff,13,0,30,17
1714646849166,EDS 203,A01,507317,Halter; Christopher P.,12,0,30,18
1714646850191,EDS 204R,A01,507319,Halter; Christopher P.,0,3,30,30
1714646850191,EDS 204R,B01,507331,Heinzman; Erica M.,16,0,30,14
1714646851216,EDS 206R,A00,507332,Staff,0,4,30,30
1714646851216,EDS 206R,B00,507343,Staff,17,0,30,13
1714646852245,EDS 250,A00,507344,Hemans; Patricia Ann Benitez,22,0,40,18
1714646853271,EDS 281,A00,507345,Daly; Alan J.,18,0,18,0
1714646854294,EDS 284,A00,507350,Daly; Alan J.,16,0,16,0
1714646855319,EDS 286,A00,507359,Fine; Sarah,18,0,18,0
1714646856348,EDS 289C,A01,507361,Daly; Alan J.,18,0,18,0
1714646857375,EDS 290,A00,507366,Hofstetter; Carolyn,15,0,15,0
1714646858401,LIGM 5A,A00,507421,Fischer-Grunski; Eva K,18,0,20,2
1714646859432,LIGM 5B,A00,507423,Fischer-Grunski; Eva K,19,0,20,1
1714646860458,LIGM 5C,A00,507425,Fischer-Grunski; Eva K,19,0,20,1
1714646861487,LIIT 5AS,A00,507427,Carnelos; Chiara,20,0,20,0
1714646862511,LIIT 5BS,A00,507430,Carnelos; Chiara,20,0,20,0
1714646863536,LIIT 5CS,A00,507432,Carnelos; Chiara,20,0,20,0
1714646864561,LISP 5A,A00,507541,Munoz Sanchez; Alicia,11,0,20,9
1714646865585,LISP 5B,A00,507671,Munoz Sanchez; Alicia,8,0,20,12
1714646866615,LISP 5C,A00,507696,Munoz Sanchez; Alicia,9,0,20,11
1714646867647,MAE 197,001,528363,Boechler; Nicholas Sebastia,9998,0,9999,1
1714646868681,MATH 197,001,523477,Kedlaya; Kiran S.,9995,0,9999,4
1714646868681,MATH 197,002,563811,Zhang; Danna,9995,0,9999,4
1714646868681,MATH 197,003,628552,Dumitriu; Ioana,9998,0,9999,1
1714646869707,MCWP 40R,A00,518780,Staff,2,0,20,18
1714646869707,MCWP 40R,B00,518781,Staff,8,0,20,12
1714646869707,MCWP 40R,C00,518783,Staff,6,0,20,14
1714646870733,MCWP 50R,A00,518791,Staff,0,0,20,20
1714646870733,MCWP 50R,B00,518792,Staff,0,2,20,20
1714646870733,MCWP 50R,C00,518793,Staff,0,2,20,20
1714646870733,MCWP 50R,D00,518794,Staff,0,1,20,20
1714646870733,MCWP 50R,E00,518795,Staff,0,2,20,20
1714646870733,MCWP 50R,F00,518796,Staff,0,0,20,20
1714646870733,MCWP 50R,G00,518797,Staff,0,1,20,20
1714646871759,MMW 12R,A01,514034,Herbst; Matthew,0,0,16,16
1714646871759,MMW 12R,A02,514035,Herbst; Matthew,1,0,16,15
1714646872785,MMW 13R,A01,514037,Staff,0,4,16,16
1714646872785,MMW 13R,A02,514039,Staff,0,2,16,16
1714646872785,MMW 13R,A03,628519,Staff,0,2,16,16
1714646874839,SIO 295LS,A00,523233,Staff,10,0,30,20
1714646875867,SIO 295S,A00,523232,Staff,10,0,30,20
1714646876939,SIOC 290S,A01,637330,Merrifield; Mark A,23,0,30,7
1714646877965,SIOC 291S,A01,637333,Gabriel; Corey John,23,0,30,7
1714646879010,SOCI 117,A01,494376,Staff,0,4,5,5
1714646880036,WES 237B,A00,494380,Staff,9,0,20,11
1714646882109,AESE 279B,A00,494370,Wade; Jon P,0,0,33,33
1714646883135,AIP 197,001,627712,Vespa; Emanuel Ignacio,9998,0,9999,1
1714646884161,ANAR 135S,A00,494369,Braswell; Geoffrey E.,0,0,0,0
1714646885187,BENG 196,001,628496,Engler; Adam J.,9998,0,9999,1
1714646886213,CAT 124RS,A01,519847,Geibel; William,0,0,20,20
1714646887242,CAT 125RS,A01,515971,Geibel; William,0,0,20,20
1714646888270,CLRE 250,A00,511389,Morris; Sheldon,9993,0,9999,6
1714646889297,CLRE 251,A00,507176,Mehta; Ravindra L.,9993,0,9999,6
1714646889297,CLRE 251,B00,511410,Mehta; Ravindra L.,9998,0,9999,1
1714646890322,CLRE 252,A00,507189,Cuomo; Raphael Eduardo,9995,0,9999,4
1714646891348,CLRE 253,A00,507199,Vaida; Florin,9994,0,9999,5
1714646891348,CLRE 253,B00,507202,Vaida; Florin,9999,0,9999,0
1714646892373,CLRE 259,A00,507211,Patel; Hemal,9996,0,9999,3
1714646893398,CLRE 260,A00,507221,Cuomo; Raphael Eduardo,9999,0,9999,0
1714646894426,CLRE 297,001,507242,Cuomo; Raphael Eduardo,9999,0,9999,0
1714646895453,COGS 197,001,638244,Voytek; Bradley Thomas,9998,0,9999,1
1714646896478,CSE 191,A00,516875,Minnes Kemp; Mor Mia,9992,0,9999,7
1714646897502,CSE 197,001,637388,Minnes Kemp; Mor Mia,9998,0,9999,1
1714646898528,CSS 201S,A01,494383,Staff,35,0,35,0
1714646899556,CSS 202S,A01,494387,Staff,35,0,35,0
1714646900581,DSC 197,001,628532,Eldridge; Justin Matthew,9996,0,9999,3
1714646901607,EAP 100,A00,516065,Staff,9797,0,9999,202
1714646902635,ECE 45,A01,507414,Staff,33,0,60,27
1714646904714,ECE 111,A01,507420,Staff,15,0,50,35
1714646905744,ECE 197,001,548057,Sievenpiper; Daniel F.,9993,0,9999,6
1714646906769,EDS 115,A00,507243,Choi; Bailey Miyeon,10,0,28,18
1714646907799,EDS 117,A01,494379,Staff,0,4,30,30
1714646908825,EDS 125,A00,507246,Hopkins; Megan Beth,9,0,30,21
1714646909853,EDS 128A,A01,507264,Fargason; Sharon Gayle,8,0,26,18
1714646910877,EDS 128B,A01,507293,Pappas; Elizabeth,12,0,30,18
1714646911906,EDS 139,A00,507294,Fargason; Sharon Gayle,13,0,30,17
1714646911906,EDS 139,B00,507313,Pappas; Elizabeth,13,0,30,17
1714646912931,EDS 201,A00,507315,Staff,13,0,30,17
1714646913955,EDS 203,A01,507317,Halter; Christopher P.,12,0,30,18
1714646914981,EDS 204R,A01,507319,Halter; Christopher P.,0,3,30,30
1714646914981,EDS 204R,B01,507331,Heinzman; Erica M.,16,0,30,14
1714646916005,EDS 206R,A00,507332,Staff,0,4,30,30
1714646916005,EDS 206R,B00,507343,Staff,17,0,30,13
1714646917035,EDS 250,A00,507344,Hemans; Patricia Ann Benitez,22,0,40,18
1714646918059,EDS 281,A00,507345,Daly; Alan J.,18,0,18,0
1714646919083,EDS 284,A00,507350,Daly; Alan J.,16,0,16,0
1714646920109,EDS 286,A00,507359,Fine; Sarah,18,0,18,0
1714646921137,EDS 289C,A01,507361,Daly; Alan J.,18,0,18,0
1714646922166,EDS 290,A00,507366,Hofstetter; Carolyn,15,0,15,0
1714646923192,LIGM 5A,A00,507421,Fischer-Grunski; Eva K,18,0,20,2
1714646924222,LIGM 5B,A00,507423,Fischer-Grunski; Eva K,19,0,20,1
1714646925247,LIGM 5C,A00,507425,Fischer-Grunski; Eva K,19,0,20,1
1714646926275,LIIT 5AS,A00,507427,Carnelos; Chiara,20,0,20,0
1714646927303,LIIT 5BS,A00,507430,Carnelos; Chiara,20,0,20,0
1714646928330,LIIT 5CS,A00,507432,Carnelos; Chiara,20,0,20,0
1714646929356,LISP 5A,A00,507541,Munoz Sanchez; Alicia,11,0,20,9
1714646930382,LISP 5B,A00,507671,Munoz Sanchez; Alicia,8,0,20,12
1714646931410,LISP 5C,A00,507696,Munoz Sanchez; Alicia,9,0,20,11
1714646932434,MAE 197,001,528363,Boechler; Nicholas Sebastia,9998,0,9999,1
1714646933463,MATH 197,001,523477,Kedlaya; Kiran S.,9995,0,9999,4
1714646933463,MATH 197,002,563811,Zhang; Danna,9995,0,9999,4
1714646933463,MATH 197,003,628552,Dumitriu; Ioana,9998,0,9999,1
1714646934490,MCWP 40R,A00,518780,Staff,2,0,20,18
1714646934490,MCWP 40R,B00,518781,Staff,8,0,20,12
1714646934490,MCWP 40R,C00,518783,Staff,6,0,20,14
1714646935522,MCWP 50R,A00,518791,Staff,0,0,20,20
1714646935522,MCWP 50R,B00,518792,Staff,0,2,20,20
1714646935522,MCWP 50R,C00,518793,Staff,0,2,20,20
1714646935522,MCWP 50R,D00,518794,Staff,0,1,20,20
1714646935522,MCWP 50R,E00,518795,Staff,0,2,20,20
1714646935522,MCWP 50R,F00,518796,Staff,0,0,20,20
1714646935522,MCWP 50R,G00,518797,Staff,0,1,20,20
1714646936548,MMW 12R,A01,514034,Herbst; Matthew,0,0,16,16
1714646936548,MMW 12R,A02,514035,Herbst; Matthew,1,0,16,15
1714646937573,MMW 13R,A01,514037,Staff,0,4,16,16
1714646937573,MMW 13R,A02,514039,Staff,0,2,16,16
1714646937573,MMW 13R,A03,628519,Staff,0,2,16,16
1714646939627,SIO 295LS,A00,523233,Staff,10,0,30,20
1714646940653,SIO 295S,A00,523232,Staff,10,0,30,20
1714646941682,SIOC 290S,A01,637330,Merrifield; Mark A,23,0,30,7
1714646942709,SIOC 291S,A01,637333,Gabriel; Corey John,23,0,30,7
1714646943739,SOCI 117,A01,494376,Staff,0,4,5,5
1714646944765,WES 237B,A00,494380,Staff,9,0,20,11
1714646946857,AESE 279B,A00,494370,Wade; Jon P,0,0,33,33
1714646947885,AIP 197,001,627712,Vespa; Emanuel Ignacio,9998,0,9999,1
1714646948911,ANAR 135S,A00,494369,Braswell; Geoffrey E.,0,0,0,0
1714646949936,BENG 196,001,628496,Engler; Adam J.,9998,0,9999,1
1714646950962,CAT 124RS,A01,519847,Geibel; William,0,0,20,20
1714646951991,CAT 125RS,A01,515971,Geibel; William,0,0,20,20
1714646953027,CLRE 250,A00,511389,Morris; Sheldon,9993,0,9999,6
1714646954062,CLRE 251,A00,507176,Mehta; Ravindra L.,9993,0,9999,6
1714646954062,CLRE 251,B00,511410,Mehta; Ravindra L.,9998,0,9999,1
1714646955090,CLRE 252,A00,507189,Cuomo; Raphael Eduardo,9995,0,9999,4
1714646956130,CLRE 253,A00,507199,Vaida; Florin,9994,0,9999,5
1714646956130,CLRE 253,B00,507202,Vaida; Florin,9999,0,9999,0
1714646957155,CLRE 259,A00,507211,Patel; Hemal,9996,0,9999,3
1714646958179,CLRE 260,A00,507221,Cuomo; Raphael Eduardo,9999,0,9999,0
1714646959208,CLRE 297,001,507242,Cuomo; Raphael Eduardo,9999,0,9999,0
1714646960233,COGS 197,001,638244,Voytek; Bradley Thomas,9998,0,9999,1
1714646961287,CSE 191,A00,516875,Minnes Kemp; Mor Mia,9992,0,9999,7
1714646962312,CSE 197,001,637388,Minnes Kemp; Mor Mia,9998,0,9999,1
1714646963362,CSS 201S,A01,494383,Staff,35,0,35,0
1714646964393,CSS 202S,A01,494387,Staff,35,0,35,0
1714646965421,DSC 197,001,628532,Eldridge; Justin Matthew,9996,0,9999,3
1714646966448,EAP 100,A00,516065,Staff,9797,0,9999,202
1714646967477,ECE 45,A01,507414,Staff,33,0,60,27
1714646969529,ECE 111,A01,507420,Staff,15,0,50,35
1714646970561,ECE 197,001,548057,Sievenpiper; Daniel F.,9993,0,9999,6
1714646971591,EDS 115,A00,507243,Choi; Bailey Miyeon,10,0,28,18
1714646972703,EDS 117,A01,494379,Staff,0,4,30,30
1714646973728,EDS 125,A00,507246,Hopkins; Megan Beth,9,0,30,21
1714646974755,EDS 128A,A01,507264,Fargason; Sharon Gayle,8,0,26,18
1714646975782,EDS 128B,A01,507293,Pappas; Elizabeth,12,0,30,18
1714646976811,EDS 139,A00,507294,Fargason; Sharon Gayle,13,0,30,17
1714646976811,EDS 139,B00,507313,Pappas; Elizabeth,13,0,30,17
1714646977836,EDS 201,A00,507315,Staff,13,0,30,17
1714646978863,EDS 203,A01,507317,Halter; Christopher P.,12,0,30,18
1714646979889,EDS 204R,A01,507319,Halter; Christopher P.,0,3,30,30
1714646979889,EDS 204R,B01,507331,Heinzman; Erica M.,16,0,30,14
1714646980916,EDS 206R,A00,507332,Staff,0,4,30,30
1714646980916,EDS 206R,B00,507343,Staff,17,0,30,13
1714646981942,EDS 250,A00,507344,Hemans; Patricia Ann Benitez,22,0,40,18
1714646982967,EDS 281,A00,507345,Daly; Alan J.,18,0,18,0
1714646983993,EDS 284,A00,507350,Daly; Alan J.,16,0,16,0
1714646985061,EDS 286,A00,507359,Fine; Sarah,18,0,18,0
1714646986086,EDS 289C,A01,507361,Daly; Alan J.,18,0,18,0
1714646987118,EDS 290,A00,507366,Hofstetter; Carolyn,15,0,15,0
1714646988158,LIGM 5A,A00,507421,Fischer-Grunski; Eva K,18,0,20,2
1714646989186,LIGM 5B,A00,507423,Fischer-Grunski; Eva K,19,0,20,1
1714646990214,LIGM 5C,A00,507425,Fischer-Grunski; Eva K,19,0,20,1
1714646991241,LIIT 5AS,A00,507427,Carnelos; Chiara,20,0,20,0
1714646992271,LIIT 5BS,A00,507430,Carnelos; Chiara,20,0,20,0
1714646993296,LIIT 5CS,A00,507432,Carnelos; Chiara,20,0,20,0
1714646994331,LISP 5A,A00,507541,Munoz Sanchez; Alicia,11,0,20,9
1714646995359,LISP 5B,A00,507671,Munoz Sanchez; Alicia,8,0,20,12
1714646996411,LISP 5C,A00,507696,Munoz Sanchez; Alicia,9,0,20,11
1714646997438,MAE 197,001,528363,Boechler; Nicholas Sebastia,9998,0,9999,1
1714646998464,MATH 197,001,523477,Kedlaya; Kiran S.,9995,0,9999,4
1714646998464,MATH 197,002,563811,Zhang; Danna,9995,0,9999,4
1714646998464,MATH 197,003,628552,Dumitriu; Ioana,9998,0,9999,1
1714646999489,MCWP 40R,A00,518780,Staff,2,0,20,18
1714646999489,MCWP 40R,B00,518781,Staff,8,0,20,12
1714646999489,MCWP 40R,C00,518783,Staff,6,0,20,14
1714647000519,MCWP 50R,A00,518791,Staff,0,0,20,20
1714647000519,MCWP 50R,B00,518792,Staff,0,2,20,20
1714647000519,MCWP 50R,C00,518793,Staff,0,2,20,20
1714647000519,MCWP 50R,D00,518794,Staff,0,1,20,20
1714647000519,MCWP 50R,E00,518795,Staff,0,2,20,20
1714647000519,MCWP 50R,F00,518796,Staff,0,0,20,20
1714647000519,MCWP 50R,G00,518797,Staff,0,1,20,20
1714647001547,MMW 12R,A01,514034,Herbst; Matthew,0,0,16,16
1714647001547,MMW 12R,A02,514035,Herbst; Matthew,1,0,16,15
1714647002572,MMW 13R,A01,514037,Staff,0,4,16,16
1714647002572,MMW 13R,A02,514039,Staff,0,2,16,16
1714647002572,MMW 13R,A03,628519,Staff,0,2,16,16
1714647004622,SIO 295LS,A00,523233,Staff,10,0,30,20
1714647005650,SIO 295S,A00,523232,Staff,10,0,30,20
1714647006683,SIOC 290S,A01,637330,Merrifield; Mark A,23,0,30,7
1714647007716,SIOC 291S,A01,637333,Gabriel; Corey John,23,0,30,7
1714647008750,SOCI 117,A01,494376,Staff,0,4,5,5
1714647009777,WES 237B,A00,494380,Staff,9,0,20,11
1714647011870,AESE 279B,A00,494370,Wade; Jon P,0,0,33,33
1714647012896,AIP 197,001,627712,Vespa; Emanuel Ignacio,9998,0,9999,1
1714647013927,ANAR 135S,A00,494369,Braswell; Geoffrey E.,0,0,0,0
1714647014953,BENG 196,001,628496,Engler; Adam J.,9998,0,9999,1
1714647015984,CAT 124RS,A01,519847,Geibel; William,0,0,20,20
1714647017009,CAT 125RS,A01,515971,Geibel; William,0,0,20,20
1714647018041,CLRE 250,A00,511389,Morris; Sheldon,9993,0,9999,6
1714647019129,CLRE 251,A00,507176,Mehta; Ravindra L.,9993,0,9999,6
1714647019129,CLRE 251,B00,511410,Mehta; Ravindra L.,9998,0,9999,1
1714647020155,CLRE 252,A00,507189,Cuomo; Raphael Eduardo,9995,0,9999,4
1714647021182,CLRE 253,A00,507199,Vaida; Florin,9994,0,9999,5
1714647021182,CLRE 253,B00,507202,Vaida; Florin,9999,0,9999,0
1714647022209,CLRE 259,A00,507211,Patel; Hemal,9996,0,9999,3
1714647023235,CLRE 260,A00,507221,Cuomo; Raphael Eduardo,9999,0,9999,0
1714647024262,CLRE 297,001,507242,Cuomo; Raphael Eduardo,9999,0,9999,0
1714647025288,COGS 197,001,638244,Voytek; Bradley Thomas,9998,0,9999,1
1714647026313,CSE 191,A00,516875,Minnes Kemp; Mor Mia,9992,0,9999,7
1714647027339,CSE 197,001,637388,Minnes Kemp; Mor Mia,9998,0,9999,1
1714647028365,CSS 201S,A01,494383,Staff,35,0,35,0
1714647029390,CSS 202S,A01,494387,Staff,35,0,35,0
1714647030423,DSC 197,001,628532,Eldridge; Justin Matthew,9996,0,9999,3
1714647031449,EAP 100,A00,516065,Staff,9797,0,9999,202
1714647032473,ECE 45,A01,507414,Staff,33,0,60,27
1714647034522,ECE 111,A01,507420,Staff,15,0,50,35
1714647035555,ECE 197,001,548057,Sievenpiper; Daniel F.,9993,0,9999,6
1714647036585,EDS 115,A00,507243,Choi; Bailey Miyeon,10,0,28,18
1714647037615,EDS 117,A01,494379,Staff,0,4,30,30
1714647038641,EDS 125,A00,507246,Hopkins; Megan Beth,9,0,30,21
1714647039667,EDS 128A,A01,507264,Fargason; Sharon Gayle,8,0,26,18
1714647040697,EDS 128B,A01,507293,Pappas; Elizabeth,12,0,30,18
1714647041730,EDS 139,A00,507294,Fargason; Sharon Gayle,13,0,30,17
1714647041730,EDS 139,B00,507313,Pappas; Elizabeth,13,0,30,17
1714647042756,EDS 201,A00,507315,Staff,13,0,30,17
1714647043782,EDS 203,A01,507317,Halter; Christopher P.,12,0,30,18
1714647044814,EDS 204R,A01,507319,Halter; Christopher P.,0,3,30,30
1714647044814,EDS 204R,B01,507331,Heinzman; Erica M.,16,0,30,14
1714647045843,EDS 206R,A00,507332,Staff,0,4,30,30
1714647045843,EDS 206R,B00,507343,Staff,17,0,30,13
1714647046873,EDS 250,A00,507344,Hemans; Patricia Ann Benitez,22,0,40,18
1714647047903,EDS 281,A00,507345,Daly; Alan J.,18,0,18,0
1714647048928,EDS 284,A00,507350,Daly; Alan J.,16,0,16,0
1714647049957,EDS 286,A00,507359,Fine; Sarah,18,0,18,0
1714647050983,EDS 289C,A01,507361,Daly; Alan J.,18,0,18,0
1714647052012,EDS 290,A00,507366,Hofstetter; Carolyn,15,0,15,0
1714647053039,LIGM 5A,A00,507421,Fischer-Grunski; Eva K,18,0,20,2
1714647054065,LIGM 5B,A00,507423,Fischer-Grunski; Eva K,19,0,20,1
1714647055097,LIGM 5C,A00,507425,Fischer-Grunski; Eva K,19,0,20,1
1714647056128,LIIT 5AS,A00,507427,Carnelos; Chiara,20,0,20,0
1714647057157,LIIT 5BS,A00,507430,Carnelos; Chiara,20,0,20,0
1714647058185,LIIT 5CS,A00,507432,Carnelos; Chiara,20,0,20,0
1714647059218,LISP 5A,A00,507541,Munoz Sanchez; Alicia,11,0,20,9
1714647060245,LISP 5B,A00,507671,Munoz Sanchez; Alicia,8,0,20,12
1714647061278,LISP 5C,A00,507696,Munoz Sanchez; Alicia,9,0,20,11
1714647062313,MAE 197,001,528363,Boechler; Nicholas Sebastia,9998,0,9999,1
1714647063450,MATH 197,001,523477,Kedlaya; Kiran S.,9995,0,9999,4
1714647063450,MATH 197,002,563811,Zhang; Danna,9995,0,9999,4
1714647063450,MATH 197,003,628552,Dumitriu; Ioana,9998,0,9999,1
1714647064478,MCWP 40R,A00,518780,Staff,2,0,20,18
1714647064478,MCWP 40R,B00,518781,Staff,8,0,20,12
1714647064478,MCWP 40R,C00,518783,Staff,6,0,20,14
1714647065536,MCWP 50R,A00,518791,Staff,0,0,20,20
1714647065536,MCWP 50R,B00,518792,Staff,0,2,20,20
1714647065536,MCWP 50R,C00,518793,Staff,0,2,20,20
1714647065536,MCWP 50R,D00,518794,Staff,0,1,20,20
1714647065536,MCWP 50R,E00,518795,Staff,0,2,20,20
1714647065536,MCWP 50R,F00,518796,Staff,0,0,20,20
1714647065536,MCWP 50R,G00,518797,Staff,0,1,20,20
1714647066562,MMW 12R,A01,514034,Herbst; Matthew,0,0,16,16
1714647066562,MMW 12R,A02,514035,Herbst; Matthew,1,0,16,15
1714647067592,MMW 13R,A01,514037,Staff,0,4,16,16
1714647067592,MMW 13R,A02,514039,Staff,0,2,16,16
1714647067592,MMW 13R,A03,628519,Staff,0,2,16,16
1714647069646,SIO 295LS,A00,523233,Staff,10,0,30,20
1714647070671,SIO 295S,A00,523232,Staff,10,0,30,20
1714647071697,SIOC 290S,A01,637330,Merrifield; Mark A,23,0,30,7
1714647072724,SIOC 291S,A01,637333,Gabriel; Corey John,23,0,30,7
1714647073750,SOCI 117,A01,494376,Staff,0,4,5,5
1714647074775,WES 237B,A00,494380,Staff,9,0,20,11
1714647076924,AESE 279B,A00,494370,Wade; Jon P,0,0,33,33
1714647077967,AIP 197,001,627712,Vespa; Emanuel Ignacio,9998,0,9999,1
1714647078992,ANAR 135S,A00,494369,Braswell; Geoffrey E.,0,0,0,0
1714647080027,BENG 196,001,628496,Engler; Adam J.,9998,0,9999,1
1714647081134,CAT 124RS,A01,519847,Geibel; William,0,0,20,20
1714647082163,CAT 125RS,A01,515971,Geibel; William,0,0,20,20
1714647083190,CLRE 250,A00,511389,Morris; Sheldon,9993,0,9999,6
1714647084225,CLRE 251,A00,507176,Mehta; Ravindra L.,9993,0,9999,6
1714647084225,CLRE 251,B00,511410,Mehta; Ravindra L.,9998,0,9999,1
1714647085251,CLRE 252,A00,507189,Cuomo; Raphael Eduardo,9995,0,9999,4
1714647086278,CLRE 253,A00,507199,Vaida; Florin,9994,0,9999,5
1714647086278,CLRE 253,B00,507202,Vaida; Florin,9999,0,9999,0
1714647087304,CLRE 259,A00,507211,Patel; Hemal,9996,0,9999,3
1714647088328,CLRE 260,A00,507221,Cuomo; Raphael Eduardo,9999,0,9999,0
1714647089360,CLRE 297,001,507242,Cuomo; Raphael Eduardo,9999,0,9999,0
1714647090392,COGS 197,001,638244,Voytek; Bradley Thomas,9998,0,9999,1
1714647091421,CSE 191,A00,516875,Minnes Kemp; Mor Mia,9992,0,9999,7
1714647092453,CSE 197,001,637388,Minnes Kemp; Mor Mia,9998,0,9999,1
1714647093480,CSS 201S,A01,494383,Staff,35,0,35,0
1714647094513,CSS 202S,A01,494387,Staff,35,0,35,0
1714647095539,DSC 197,001,628532,Eldridge; Justin Matthew,9996,0,9999,3
1714647096564,EAP 100,A00,516065,Staff,9797,0,9999,202
1714647097591,ECE 45,A01,507414,Staff,33,0,60,27
1714647099642,ECE 111,A01,507420,Staff,15,0,50,35
1714647100667,ECE 197,001,548057,Sievenpiper; Daniel F.,9993,0,9999,6
1714647101697,EDS 115,A00,507243,Choi; Bailey Miyeon,10,0,28,18
1714647102730,EDS 117,A01,494379,Staff,0,4,30,30
1714647103757,EDS 125,A00,507246,Hopkins; Megan Beth,9,0,30,21
1714647104817,EDS 128A,A01,507264,Fargason; Sharon Gayle,8,0,26,18
1714647105842,EDS 128B,A01,507293,Pappas; Elizabeth,12,0,30,18
1714647106867,EDS 139,A00,507294,Fargason; Sharon Gayle,13,0,30,17
1714647106867,EDS 139,B00,507313,Pappas; Elizabeth,13,0,30,17
1714647107896,EDS 201,A00,507315,Staff,13,0,30,17
1714647108921,EDS 203,A01,507317,Halter; Christopher P.,12,0,30,18
1714647109948,EDS 204R,A01,507319,Halter; Christopher P.,0,3,30,30
1714647109948,EDS 204R,B01,507331,Heinzman; Erica M.,16,0,30,14
1714647110977,EDS 206R,A00,507332,Staff,0,4,30,30
1714647110977,EDS 206R,B00,507343,Staff,17,0,30,13
1714647112024,EDS 250,A00,507344,Hemans; Patricia Ann Benitez,22,0,40,18
1714647113051,EDS 281,A00,507345,Daly; Alan J.,18,0,18,0
1714647114076,EDS 284,A00,507350,Daly; Alan J.,16,0,16,0
1714647115114,EDS 286,A00,507359,Fine; Sarah,18,0,18,0
1714647116142,EDS 289C,A01,507361,Daly; Alan J.,18,0,18,0
1714647117166,EDS 290,A00,507366,Hofstetter; Carolyn,15,0,15,0
1714647118195,LIGM 5A,A00,507421,Fischer-Grunski; Eva K,18,0,20,2
1714647119220,LIGM 5B,A00,507423,Fischer-Grunski; Eva K,19,0,20,1
1714647120247,LIGM 5C,A00,507425,Fischer-Grunski; Eva K,19,0,20,1
1714647121277,LIIT 5AS,A00,507427,Carnelos; Chiara,20,0,20,0
1714647122356,LIIT 5BS,A00,507430,Carnelos; Chiara,20,0,20,0
1714647123382,LIIT 5CS,A00,507432,Carnelos; Chiara,20,0,20,0
1714647124415,LISP 5A,A00,507541,Munoz Sanchez; Alicia,11,0,20,9
1714647125444,LISP 5B,A00,507671,Munoz Sanchez; Alicia,8,0,20,12
1714647126469,LISP 5C,A00,507696,Munoz Sanchez; Alicia,9,0,20,11
1714647127495,MAE 197,001,528363,Boechler; Nicholas Sebastia,9998,0,9999,1
1714647128524,MATH 197,001,523477,Kedlaya; Kiran S.,9995,0,9999,4
1714647128524,MATH 197,002,563811,Zhang; Danna,9995,0,9999,4
1714647128524,MATH 197,003,628552,Dumitriu; Ioana,9998,0,9999,1
1714647129614,MCWP 40R,A00,518780,Staff,2,0,20,18
1714647129614,MCWP 40R,B00,518781,Staff,8,0,20,12
1714647129614,MCWP 40R,C00,518783,Staff,6,0,20,14
1714647130645,MCWP 50R,A00,518791,Staff,0,0,20,20
1714647130645,MCWP 50R,B00,518792,Staff,0,2,20,20
1714647130645,MCWP 50R,C00,518793,Staff,0,2,20,20
1714647130645,MCWP 50R,D00,518794,Staff,0,1,20,20
1714647130645,MCWP 50R,E00,518795,Staff,0,2,20,20
1714647130645,MCWP 50R,F00,518796,Staff,0,0,20,20
1714647130645,MCWP 50R,G00,518797,Staff,0,1,20,20
1714647131670,MMW 12R,A01,514034,Herbst; Matthew,0,0,16,16
1714647131670,MMW 12R,A02,514035,Herbst; Matthew,1,0,16,15
1714647132697,MMW 13R,A01,514037,Staff,0,4,16,16
1714647132697,MMW 13R,A02,514039,Staff,0,2,16,16
1714647132697,MMW 13R,A03,628519,Staff,0,2,16,16
1714647134747,SIO 295LS,A00,523233,Staff,10,0,30,20
1714647135782,SIO 295S,A00,523232,Staff,10,0,30,20
1714647136816,SIOC 290S,A01,637330,Merrifield; Mark A,23,0,30,7
1714647137845,SIOC 291S,A01,637333,Gabriel; Corey John,23,0,30,7
1714647138873,SOCI 117,A01,494376,Staff,0,4,5,5
1714647139901,WES 237B,A00,494380,Staff,9,0,20,11
1714647142019,AESE 279B,A00,494370,Wade; Jon P,0,0,33,33
1714647143046,AIP 197,001,627712,Vespa; Emanuel Ignacio,9998,0,9999,1
1714647144071,ANAR 135S,A00,494369,Braswell; Geoffrey E.,0,0,0,0
1714647145096,BENG 196,001,628496,Engler; Adam J.,9998,0,9999,1
1714647146124,CAT 124RS,A01,519847,Geibel; William,0,0,20,20
1714647147154,CAT 125RS,A01,515971,Geibel; William,0,0,20,20
1714647148189,CLRE 250,A00,511389,Morris; Sheldon,9993,0,9999,6
1714647149214,CLRE 251,A00,507176,Mehta; Ravindra L.,9993,0,9999,6
1714647149214,CLRE 251,B00,511410,Mehta; Ravindra L.,9998,0,9999,1
1714647150248,CLRE 252,A00,507189,Cuomo; Raphael Eduardo,9995,0,9999,4
1714647151274,CLRE 253,A00,507199,Vaida; Florin,9994,0,9999,5
1714647151274,CLRE 253,B00,507202,Vaida; Florin,9999,0,9999,0
1714647152303,CLRE 259,A00,507211,Patel; Hemal,9996,0,9999,3
1714647153327,CLRE 260,A00,507221,Cuomo; Raphael Eduardo,9999,0,9999,0
1714647154351,CLRE 297,001,507242,Cuomo; Raphael Eduardo,9999,0,9999,0
1714647155377,COGS 197,001,638244,Voytek; Bradley Thomas,9998,0,9999,1
1714647156413,CSE 191,A00,516875,Minnes Kemp; Mor Mia,9992,0,9999,7
1714647157438,CSE 197,001,637388,Minnes Kemp; Mor Mia,9998,0,9999,1
1714647158519,CSS 201S,A01,494383,Staff,35,0,35,0
1714647159545,CSS 202S,A01,494387,Staff,35,0,35,0
1714647160888,DSC 197,001,628532,Eldridge; Justin Matthew,9996,0,9999,3
1714647161913,EAP 100,A00,516065,Staff,9797,0,9999,202
1714647162943,ECE 45,A01,507414,Staff,33,0,60,27
1714647165000,ECE 111,A01,507420,Staff,15,0,50,35
1714647166027,ECE 197,001,548057,Sievenpiper; Daniel F.,9993,0,9999,6
1714647167053,EDS 115,A00,507243,Choi; Bailey Miyeon,10,0,28,18
1714647168081,EDS 117,A01,494379,Staff,0,4,30,30
1714647169117,EDS 125,A00,507246,Hopkins; Megan Beth,9,0,30,21
1714647170143,EDS 128A,A01,507264,Fargason; Sharon Gayle,8,0,26,18
1714647171169,EDS 128B,A01,507293,Pappas; Elizabeth,12,0,30,18
1714647172194,EDS 139,A00,507294,Fargason; Sharon Gayle,13,0,30,17
1714647172194,EDS 139,B00,507313,Pappas; Elizabeth,13,0,30,17
1714647173220,EDS 201,A00,507315,Staff,13,0,30,17
1714647174245,EDS 203,A01,507317,Halter; Christopher P.,12,0,30,18
1714647175272,EDS 204R,A01,507319,Halter; Christopher P.,0,3,30,30
1714647175272,EDS 204R,B01,507331,Heinzman; Erica M.,16,0,30,14
1714647176305,EDS 206R,A00,507332,Staff,0,4,30,30
1714647176305,EDS 206R,B00,507343,Staff,17,0,30,13
1714647177338,EDS 250,A00,507344,Hemans; Patricia Ann Benitez,22,0,40,18
1714647178365,EDS 281,A00,507345,Daly; Alan J.,18,0,18,0
1714647179389,EDS 284,A00,507350,Daly; Alan J.,16,0,16,0
1714647180416,EDS 286,A00,507359,Fine; Sarah,18,0,18,0
1714647181446,EDS 289C,A01,507361,Daly; Alan J.,18,0,18,0
1714647182473,EDS 290,A00,507366,Hofstetter; Carolyn,15,0,15,0
1714647183514,LIGM 5A,A00,507421,Fischer-Grunski; Eva K,18,0,20,2
1714647184547,LIGM 5B,A00,507423,Fischer-Grunski; Eva K,19,0,20,1
1714647185579,LIGM 5C,A00,507425,Fischer-Grunski; Eva K,19,0,20,1
1714647186613,LIIT 5AS,A00,507427,Carnelos; Chiara,20,0,20,0
1714647187645,LIIT 5BS,A00,507430,Carnelos; Chiara,20,0,20,0
1714647188671,LIIT 5CS,A00,507432,Carnelos; Chiara,20,0,20,0
1714647189700,LISP 5A,A00,507541,Munoz Sanchez; Alicia,11,0,20,9
1714647190732,LISP 5B,A00,507671,Munoz Sanchez; Alicia,8,0,20,12
1714647191758,LISP 5C,A00,507696,Munoz Sanchez; Alicia,9,0,20,11
1714647192784,MAE 197,001,528363,Boechler; Nicholas Sebastia,9998,0,9999,1
1714647193815,MATH 197,001,523477,Kedlaya; Kiran S.,9995,0,9999,4
1714647193815,MATH 197,002,563811,Zhang; Danna,9995,0,9999,4
1714647193815,MATH 197,003,628552,Dumitriu; Ioana,9998,0,9999,1
1714647194842,MCWP 40R,A00,518780,Staff,2,0,20,18
1714647194842,MCWP 40R,B00,518781,Staff,8,0,20,12
1714647194842,MCWP 40R,C00,518783,Staff,6,0,20,14
1714647195874,MCWP 50R,A00,518791,Staff,0,0,20,20
1714647195874,MCWP 50R,B00,518792,Staff,0,2,20,20
1714647195874,MCWP 50R,C00,518793,Staff,0,2,20,20
1714647195874,MCWP 50R,D00,518794,Staff,0,1,20,20
1714647195874,MCWP 50R,E00,518795,Staff,0,2,20,20
1714647195874,MCWP 50R,F00,518796,Staff,0,0,20,20
1714647195874,MCWP 50R,G00,518797,Staff,0,1,20,20
1714647196902,MMW 12R,A01,514034,Herbst; Matthew,0,0,16,16
1714647196902,MMW 12R,A02,514035,Herbst; Matthew,1,0,16,15
1714647197927,MMW 13R,A01,514037,Staff,0,4,16,16
1714647197927,MMW 13R,A02,514039,Staff,0,2,16,16
1714647197927,MMW 13R,A03,628519,Staff,0,2,16,16
1714647199979,SIO 295LS,A00,523233,Staff,10,0,30,20
1714647201009,SIO 295S,A00,523232,Staff,10,0,30,20
1714647202037,SIOC 290S,A01,637330,Merrifield; Mark A,23,0,30,7
1714647203063,SIOC 291S,A01,637333,Gabriel; Corey John,23,0,30,7
1714647204089,SOCI 117,A01,494376,Staff,0,4,5,5
1714647205115,WES 237B,A00,494380,Staff,9,0,20,11
1714647207201,AESE 279B,A00,494370,Wade; Jon P,0,0,33,33
1714647208227,AIP 197,001,627712,Vespa; Emanuel Ignacio,9998,0,9999,1
1714647209252,ANAR 135S,A00,494369,Braswell; Geoffrey E.,0,0,0,0
1714647210284,BENG 196,001,628496,Engler; Adam J.,9998,0,9999,1
1714647211310,CAT 124RS,A01,519847,Geibel; William,0,0,20,20
1714647212338,CAT 125RS,A01,515971,Geibel; William,0,0,20,20
1714647213365,CLRE 250,A00,511389,Morris; Sheldon,9993,0,9999,6
1714647214392,CLRE 251,A00,507176,Mehta; Ravindra L.,9993,0,9999,6
1714647214392,CLRE 251,B00,511410,Mehta; Ravindra L.,9998,0,9999,1
1714647215418,CLRE 252,A00,507189,Cuomo; Raphael Eduardo,9995,0,9999,4
1714647216445,CLRE 253,A00,507199,Vaida; Florin,9994,0,9999,5
1714647216445,CLRE 253,B00,507202,Vaida; Florin,9999,0,9999,0
1714647217471,CLRE 259,A00,507211,Patel; Hemal,9996,0,9999,3
1714647218501,CLRE 260,A00,507221,Cuomo; Raphael Eduardo,9999,0,9999,0
1714647219531,CLRE 297,001,507242,Cuomo; Raphael Eduardo,9999,0,9999,0
1714647220561,COGS 197,001,638244,Voytek; Bradley Thomas,9998,0,9999,1
1714647221608,CSE 191,A00,516875,Minnes Kemp; Mor Mia,9992,0,9999,7
1714647222634,CSE 197,001,637388,Minnes Kemp; Mor Mia,9998,0,9999,1
1714647223669,CSS 201S,A01,494383,Staff,35,0,35,0
1714647224695,CSS 202S,A01,494387,Staff,35,0,35,0
1714647225721,DSC 197,001,628532,Eldridge; Justin Matthew,9996,0,9999,3
1714647226750,EAP 100,A00,516065,Staff,9797,0,9999,202
1714647227776,ECE 45,A01,507414,Staff,33,0,60,27
1714647229834,ECE 111,A01,507420,Staff,15,0,50,35
1714647230862,ECE 197,001,548057,Sievenpiper; Daniel F.,9993,0,9999,6
1714647231889,EDS 115,A00,507243,Choi; Bailey Miyeon,10,0,28,18
1714647232920,EDS 117,A01,494379,Staff,0,4,30,30
1714647233946,EDS 125,A00,507246,Hopkins; Megan Beth,9,0,30,21
1714647234975,EDS 128A,A01,507264,Fargason; Sharon Gayle,8,0,26,18
1714647236001,EDS 128B,A01,507293,Pappas; Elizabeth,12,0,30,18
1714647237029,EDS 139,A00,507294,Fargason; Sharon Gayle,13,0,30,17
1714647237029,EDS 139,B00,507313,Pappas; Elizabeth,13,0,30,17
1714647238056,EDS 201,A00,507315,Staff,13,0,30,17
1714647239083,EDS 203,A01,507317,Halter; Christopher P.,12,0,30,18
1714647240115,EDS 204R,A01,507319,Halter; Christopher P.,0,3,30,30
1714647240115,EDS 204R,B01,507331,Heinzman; Erica M.,16,0,30,14
1714647241141,EDS 206R,A00,507332,Staff,0,4,30,30
1714647241141,EDS 206R,B00,507343,Staff,17,0,30,13
1714647242168,EDS 250,A00,507344,Hemans; Patricia Ann Benitez,22,0,40,18
1714647243194,EDS 281,A00,507345,Daly; Alan J.,18,0,18,0
1714647244219,EDS 284,A00,507350,Daly; Alan J.,16,0,16,0
1714647245249,EDS 286,A00,507359,Fine; Sarah,18,0,18,0
1714647246277,EDS 289C,A01,507361,Daly; Alan J.,18,0,18,0
1714647247306,EDS 290,A00,507366,Hofstetter; Carolyn,15,0,15,0
1714647248340,LIGM 5A,A00,507421,Fischer-Grunski; Eva K,18,0,20,2
1714647249369,LIGM 5B,A00,507423,Fischer-Grunski; Eva K,19,0,20,1
1714647250395,LIGM 5C,A00,507425,Fischer-Grunski; Eva K,19,0,20,1
1714647251420,LIIT 5AS,A00,507427,Carnelos; Chiara,20,0,20,0
1714647252446,LIIT 5BS,A00,507430,Carnelos; Chiara,20,0,20,0
1714647253471,LIIT 5CS,A00,507432,Carnelos; Chiara,20,0,20,0
1714647254498,LISP 5A,A00,507541,Munoz Sanchez; Alicia,11,0,20,9
1714647255528,LISP 5B,A00,507671,Munoz Sanchez; Alicia,8,0,20,12
1714647256555,LISP 5C,A00,507696,Munoz Sanchez; Alicia,9,0,20,11
1714647257583,MAE 197,001,528363,Boechler; Nicholas Sebastia,9998,0,9999,1
1714647258619,MATH 197,001,523477,Kedlaya; Kiran S.,9995,0,9999,4
1714647258619,MATH 197,002,563811,Zhang; Danna,9995,0,9999,4
1714647258619,MATH 197,003,628552,Dumitriu; Ioana,9998,0,9999,1
1714647259645,MCWP 40R,A00,518780,Staff,2,0,20,18
1714647259645,MCWP 40R,B00,518781,Staff,8,0,20,12
1714647259645,MCWP 40R,C00,518783,Staff,6,0,20,14
1714647260679,MCWP 50R,A00,518791,Staff,0,0,20,20
1714647260679,MCWP 50R,B00,518792,Staff,0,2,20,20
1714647260679,MCWP 50R,C00,518793,Staff,0,2,20,20
1714647260679,MCWP 50R,D00,518794,Staff,0,1,20,20
1714647260679,MCWP 50R,E00,518795,Staff,0,2,20,20
1714647260679,MCWP 50R,F00,518796,Staff,0,0,20,20
1714647260679,MCWP 50R,G00,518797,Staff,0,1,20,20
1714647261711,MMW 12R,A01,514034,Herbst; Matthew,0,0,16,16
1714647261711,MMW 12R,A02,514035,Herbst; Matthew,1,0,16,15
1714647262738,MMW 13R,A01,514037,Staff,0,4,16,16
1714647262738,MMW 13R,A02,514039,Staff,0,2,16,16
1714647262738,MMW 13R,A03,628519,Staff,0,2,16,16
1714647264797,SIO 295LS,A00,523233,Staff,10,0,30,20
1714647265822,SIO 295S,A00,523232,Staff,10,0,30,20
1714647266850,SIOC 290S,A01,637330,Merrifield; Mark A,23,0,30,7
1714647267878,SIOC 291S,A01,637333,Gabriel; Corey John,23,0,30,7
1714647268909,SOCI 117,A01,494376,Staff,0,4,5,5
1714647269936,WES 237B,A00,494380,Staff,9,0,20,11
1714647272008,AESE 279B,A00,494370,Wade; Jon P,0,0,33,33
1714647273036,AIP 197,001,627712,Vespa; Emanuel Ignacio,9998,0,9999,1
1714647274066,ANAR 135S,A00,494369,Braswell; Geoffrey E.,0,0,0,0
1714647275092,BENG 196,001,628496,Engler; Adam J.,9998,0,9999,1
1714647276124,CAT 124RS,A01,519847,Geibel; William,0,0,20,20
1714647277152,CAT 125RS,A01,515971,Geibel; William,0,0,20,20
1714647278179,CLRE 250,A00,511389,Morris; Sheldon,9993,0,9999,6
1714647279209,CLRE 251,A00,507176,Mehta; Ravindra L.,9993,0,9999,6
1714647279209,CLRE 251,B00,511410,Mehta; Ravindra L.,9998,0,9999,1
1714647280238,CLRE 252,A00,507189,Cuomo; Raphael Eduardo,9995,0,9999,4
1714647281267,CLRE 253,A00,507199,Vaida; Florin,9994,0,9999,5
1714647281267,CLRE 253,B00,507202,Vaida; Florin,9999,0,9999,0
1714647282292,CLRE 259,A00,507211,Patel; Hemal,9996,0,9999,3
1714647283317,CLRE 260,A00,507221,Cuomo; Raphael Eduardo,9999,0,9999,0
1714647284345,CLRE 297,001,507242,Cuomo; Raphael Eduardo,9999,0,9999,0
1714647285376,COGS 197,001,638244,Voytek; Bradley Thomas,9998,0,9999,1
1714647286401,CSE 191,A00,516875,Minnes Kemp; Mor Mia,9992,0,9999,7
1714647287429,CSE 197,001,637388,Minnes Kemp; Mor Mia,9998,0,9999,1
1714647288455,CSS 201S,A01,494383,Staff,35,0,35,0
1714647289485,CSS 202S,A01,494387,Staff,35,0,35,0
1714647290511,DSC 197,001,628532,Eldridge; Justin Matthew,9996,0,9999,3
1714647291540,EAP 100,A00,516065,Staff,9797,0,9999,202
1714647292568,ECE 45,A01,507414,Staff,33,0,60,27
1714647294624,ECE 111,A01,507420,Staff,15,0,50,35
1714647295654,ECE 197,001,548057,Sievenpiper; Daniel F.,9993,0,9999,6
1714647296681,EDS 115,A00,507243,Choi; Bailey Miyeon,10,0,28,18
1714647297707,EDS 117,A01,494379,Staff,0,4,30,30
1714647298732,EDS 125,A00,507246,Hopkins; Megan Beth,9,0,30,21
1714647299758,EDS 128A,A01,507264,Fargason; Sharon Gayle,8,0,26,18
1714647300789,EDS 128B,A01,507293,Pappas; Elizabeth,12,0,30,18
1714647301817,EDS 139,A00,507294,Fargason; Sharon Gayle,13,0,30,17
1714647301817,EDS 139,B00,507313,Pappas; Elizabeth,13,0,30,17
1714647302843,EDS 201,A00,507315,Staff,13,0,30,17
1714647303874,EDS 203,A01,507317,Halter; Christopher P.,12,0,30,18
1714647304901,EDS 204R,A01,507319,Halter; Christopher P.,0,3,30,30
1714647304901,EDS 204R,B01,507331,Heinzman; Erica M.,16,0,30,14
1714647305926,EDS 206R,A00,507332,Staff,0,4,30,30
1714647305926,EDS 206R,B00,507343,Staff,17,0,30,13
1714647306954,EDS 250,A00,507344,Hemans; Patricia Ann Benitez,22,0,40,18
1714647307981,EDS 281,A00,507345,Daly; Alan J.,18,0,18,0
1714647309009,EDS 284,A00,507350,Daly; Alan J.,16,0,16,0
1714647310035,EDS 286,A00,507359,Fine; Sarah,18,0,18,0
1714647311063,EDS 289C,A01,507361,Daly; Alan J.,18,0,18,0
1714647312094,EDS 290,A00,507366,Hofstetter; Carolyn,15,0,15,0
1714647313126,LIGM 5A,A00,507421,Fischer-Grunski; Eva K,18,0,20,2
1714647314156,LIGM 5B,A00,507423,Fischer-Grunski; Eva K,19,0,20,1
1714647315183,LIGM 5C,A00,507425,Fischer-Grunski; Eva K,19,0,20,1
1714647316217,LIIT 5AS,A00,507427,Carnelos; Chiara,20,0,20,0
1714647317248,LIIT 5BS,A00,507430,Carnelos; Chiara,20,0,20,0
1714647318273,LIIT 5CS,A00,507432,Carnelos; Chiara,20,0,20,0
1714647319299,LISP 5A,A00,507541,Munoz Sanchez; Alicia,11,0,20,9
1714647320324,LISP 5B,A00,507671,Munoz Sanchez; Alicia,8,0,20,12
1714647321420,LISP 5C,A00,507696,Munoz Sanchez; Alicia,9,0,20,11
1714647322451,MAE 197,001,528363,Boechler; Nicholas Sebastia,9998,0,9999,1
1714647323481,MATH 197,001,523477,Kedlaya; Kiran S.,9995,0,9999,4
1714647323481,MATH 197,002,563811,Zhang; Danna,9995,0,9999,4
1714647323481,MATH 197,003,628552,Dumitriu; Ioana,9998,0,9999,1
1714647324506,MCWP 40R,A00,518780,Staff,2,0,20,18
1714647324506,MCWP 40R,B00,518781,Staff,8,0,20,12
1714647324506,MCWP 40R,C00,518783,Staff,6,0,20,14
1714647325532,MCWP 50R,A00,518791,Staff,0,0,20,20
1714647325532,MCWP 50R,B00,518792,Staff,0,2,20,20
1714647325532,MCWP 50R,C00,518793,Staff,0,2,20,20
1714647325532,MCWP 50R,D00,518794,Staff,0,1,20,20
1714647325532,MCWP 50R,E00,518795,Staff,0,2,20,20
1714647325532,MCWP 50R,F00,518796,Staff,0,0,20,20
1714647325532,MCWP 50R,G00,518797,Staff,0,1,20,20
1714647326557,MMW 12R,A01,514034,Herbst; Matthew,0,0,16,16
1714647326557,MMW 12R,A02,514035,Herbst; Matthew,1,0,16,15
1714647327587,MMW 13R,A01,514037,Staff,0,4,16,16
1714647327587,MMW 13R,A02,514039,Staff,0,2,16,16
1714647327587,MMW 13R,A03,628519,Staff,0,2,16,16
1714647329642,SIO 295LS,A00,523233,Staff,10,0,30,20
1714647330669,SIO 295S,A00,523232,Staff,10,0,30,20
1714647331696,SIOC 290S,A01,637330,Merrifield; Mark A,23,0,30,7
1714647332721,SIOC 291S,A01,637333,Gabriel; Corey John,23,0,30,7
1714647333748,SOCI 117,A01,494376,Staff,0,4,5,5
1714647334773,WES 237B,A00,494380,Staff,9,0,20,11
1714647336841,AESE 279B,A00,494370,Wade; Jon P,0,0,33,33
1714647337866,AIP 197,001,627712,Vespa; Emanuel Ignacio,9998,0,9999,1
1714647338891,ANAR 135S,A00,494369,Braswell; Geoffrey E.,0,0,0,0
1714647339918,BENG 196,001,628496,Engler; Adam J.,9998,0,9999,1
1714647340947,CAT 124RS,A01,519847,Geibel; William,0,0,20,20
1714647341974,CAT 125RS,A01,515971,Geibel; William,0,0,20,20
1714647343007,CLRE 250,A00,511389,Morris; Sheldon,9993,0,9999,6
1714647344033,CLRE 251,A00,507176,Mehta; Ravindra L.,9993,0,9999,6
1714647344033,CLRE 251,B00,511410,Mehta; Ravindra L.,9998,0,9999,1
1714647345058,CLRE 252,A00,507189,Cuomo; Raphael Eduardo,9995,0,9999,4
1714647346084,CLRE 253,A00,507199,Vaida; Florin,9994,0,9999,5
1714647346084,CLRE 253,B00,507202,Vaida; Florin,9999,0,9999,0
1714647347114,CLRE 259,A00,507211,Patel; Hemal,9996,0,9999,3
1714647348138,CLRE 260,A00,507221,Cuomo; Raphael Eduardo,9999,0,9999,0
1714647349165,CLRE 297,001,507242,Cuomo; Raphael Eduardo,9999,0,9999,0
1714647350196,COGS 197,001,638244,Voytek; Bradley Thomas,9998,0,9999,1
1714647351222,CSE 191,A00,516875,Minnes Kemp; Mor Mia,9992,0,9999,7
1714647352252,CSE 197,001,637388,Minnes Kemp; Mor Mia,9998,0,9999,1
1714647353282,CSS 201S,A01,494383,Staff,35,0,35,0
1714647354307,CSS 202S,A01,494387,Staff,35,0,35,0
1714647355333,DSC 197,001,628532,Eldridge; Justin Matthew,9996,0,9999,3
1714647356358,EAP 100,A00,516065,Staff,9797,0,9999,202
1714647357384,ECE 45,A01,507414,Staff,33,0,60,27
1714647359442,ECE 111,A01,507420,Staff,15,0,50,35
1714647360469,ECE 197,001,548057,Sievenpiper; Daniel F.,9993,0,9999,6
1714647361498,EDS 115,A00,507243,Choi; Bailey Miyeon,10,0,28,18
1714647362526,EDS 117,A01,494379,Staff,0,4,30,30
1714647363556,EDS 125,A00,507246,Hopkins; Megan Beth,9,0,30,21
1714647364583,EDS 128A,A01,507264,Fargason; Sharon Gayle,8,0,26,18
1714647365613,EDS 128B,A01,507293,Pappas; Elizabeth,12,0,30,18
1714647366637,EDS 139,A00,507294,Fargason; Sharon Gayle,13,0,30,17
1714647366637,EDS 139,B00,507313,Pappas; Elizabeth,13,0,30,17
1714647367662,EDS 201,A00,507315,Staff,13,0,30,17
1714647368694,EDS 203,A01,507317,Halter; Christopher P.,12,0,30,18
1714647369720,EDS 204R,A01,507319,Halter; Christopher P.,0,3,30,30
1714647369720,EDS 204R,B01,507331,Heinzman; Erica M.,16,0,30,14
1714647370746,EDS 206R,A00,507332,Staff,0,4,30,30
1714647370746,EDS 206R,B00,507343,Staff,17,0,30,13
1714647371771,EDS 250,A00,507344,Hemans; Patricia Ann Benitez,22,0,40,18
1714647372801,EDS 281,A00,507345,Daly; Alan J.,18,0,18,0
1714647373827,EDS 284,A00,507350,Daly; Alan J.,16,0,16,0
1714647374856,EDS 286,A00,507359,Fine; Sarah,18,0,18,0
1714647375883,EDS 289C,A01,507361,Daly; Alan J.,18,0,18,0
1714647376913,EDS 290,A00,507366,Hofstetter; Carolyn,15,0,15,0
1714647377945,LIGM 5A,A00,507421,Fischer-Grunski; Eva K,18,0,20,2
1714647378971,LIGM 5B,A00,507423,Fischer-Grunski; Eva K,19,0,20,1
1714647379995,LIGM 5C,A00,507425,Fischer-Grunski; Eva K,19,0,20,1
1714647381021,LIIT 5AS,A00,507427,Carnelos; Chiara,20,0,20,0
1714647382046,LIIT 5BS,A00,507430,Carnelos; Chiara,20,0,20,0
1714647383077,LIIT 5CS,A00,507432,Carnelos; Chiara,20,0,20,0
1714647384104,LISP 5A,A00,507541,Munoz Sanchez; Alicia,11,0,20,9
1714647385129,LISP 5B,A00,507671,Munoz Sanchez; Alicia,8,0,20,12
1714647386156,LISP 5C,A00,507696,Munoz Sanchez; Alicia,9,0,20,11
1714647387182,MAE 197,001,528363,Boechler; Nicholas Sebastia,9998,0,9999,1
1714647388211,MATH 197,001,523477,Kedlaya; Kiran S.,9995,0,9999,4
1714647388211,MATH 197,002,563811,Zhang; Danna,9995,0,9999,4
1714647388211,MATH 197,003,628552,Dumitriu; Ioana,9998,0,9999,1
1714647389238,MCWP 40R,A00,518780,Staff,2,0,20,18
1714647389238,MCWP 40R,B00,518781,Staff,8,0,20,12
1714647389238,MCWP 40R,C00,518783,Staff,6,0,20,14
1714647390266,MCWP 50R,A00,518791,Staff,0,0,20,20
1714647390266,MCWP 50R,B00,518792,Staff,0,2,20,20
1714647390266,MCWP 50R,C00,518793,Staff,0,2,20,20
1714647390266,MCWP 50R,D00,518794,Staff,0,1,20,20
1714647390266,MCWP 50R,E00,518795,Staff,0,2,20,20
1714647390266,MCWP 50R,F00,518796,Staff,0,0,20,20
1714647390266,MCWP 50R,G00,518797,Staff,0,1,20,20
1714647391292,MMW 12R,A01,514034,Herbst; Matthew,0,0,16,16
1714647391292,MMW 12R,A02,514035,Herbst; Matthew,1,0,16,15
1714647392318,MMW 13R,A01,514037,Staff,0,4,16,16
1714647392318,MMW 13R,A02,514039,Staff,0,2,16,16
1714647392318,MMW 13R,A03,628519,Staff,0,2,16,16
1714647394371,SIO 295LS,A00,523233,Staff,10,0,30,20
1714647395398,SIO 295S,A00,523232,Staff,10,0,30,20
1714647396425,SIOC 290S,A01,637330,Merrifield; Mark A,23,0,30,7
1714647397450,SIOC 291S,A01,637333,Gabriel; Corey John,23,0,30,7
1714647398475,SOCI 117,A01,494376,Staff,0,4,5,5
1714647399500,WES 237B,A00,494380,Staff,9,0,20,11
1714647401601,AESE 279B,A00,494370,Wade; Jon P,0,0,33,33
1714647402626,AIP 197,001,627712,Vespa; Emanuel Ignacio,9998,0,9999,1
1714647403657,ANAR 135S,A00,494369,Braswell; Geoffrey E.,0,0,0,0
1714647404686,BENG 196,001,628496,Engler; Adam J.,9998,0,9999,1
1714647405715,CAT 124RS,A01,519847,Geibel; William,0,0,20,20
1714647406745,CAT 125RS,A01,515971,Geibel; William,0,0,20,20
1714647407769,CLRE 250,A00,511389,Morris; Sheldon,9993,0,9999,6
1714647408797,CLRE 251,A00,507176,Mehta; Ravindra L.,9993,0,9999,6
1714647408797,CLRE 251,B00,511410,Mehta; Ravindra L.,9998,0,9999,1
1714647409822,CLRE 252,A00,507189,Cuomo; Raphael Eduardo,9995,0,9999,4
1714647410853,CLRE 253,A00,507199,Vaida; Florin,9994,0,9999,5
1714647410853,CLRE 253,B00,507202,Vaida; Florin,9999,0,9999,0
1714647411878,CLRE 259,A00,507211,Patel; Hemal,9996,0,9999,3
1714647412905,CLRE 260,A00,507221,Cuomo; Raphael Eduardo,9999,0,9999,0
1714647413933,CLRE 297,001,507242,Cuomo; Raphael Eduardo,9999,0,9999,0
1714647414957,COGS 197,001,638244,Voytek; Bradley Thomas,9998,0,9999,1
1714647415983,CSE 191,A00,516875,Minnes Kemp; Mor Mia,9992,0,9999,7
1714647417009,CSE 197,001,637388,Minnes Kemp; Mor Mia,9998,0,9999,1
1714647418035,CSS 201S,A01,494383,Staff,35,0,35,0
1714647419059,CSS 202S,A01,494387,Staff,35,0,35,0
1714647420128,DSC 197,001,628532,Eldridge; Justin Matthew,9996,0,9999,3
1714647421154,EAP 100,A00,516065,Staff,9797,0,9999,202
1714647422182,ECE 45,A01,507414,Staff,33,0,60,27
1714647424234,ECE 111,A01,507420,Staff,15,0,50,35
1714647425320,ECE 197,001,548057,Sievenpiper; Daniel F.,9993,0,9999,6
1714647426348,EDS 115,A00,507243,Choi; Bailey Miyeon,10,0,28,18
1714647427376,EDS 117,A01,494379,Staff,0,4,30,30
1714647428403,EDS 125,A00,507246,Hopkins; Megan Beth,9,0,30,21
1714647429429,EDS 128A,A01,507264,Fargason; Sharon Gayle,8,0,26,18
1714647430454,EDS 128B,A01,507293,Pappas; Elizabeth,12,0,30,18
1714647431480,EDS 139,A00,507294,Fargason; Sharon Gayle,13,0,30,17
1714647431480,EDS 139,B00,507313,Pappas; Elizabeth,13,0,30,17
1714647432505,EDS 201,A00,507315,Staff,13,0,30,17
1714647433539,EDS 203,A01,507317,Halter; Christopher P.,12,0,30,18
1714647434566,EDS 204R,A01,507319,Halter; Christopher P.,0,3,30,30
1714647434566,EDS 204R,B01,507331,Heinzman; Erica M.,16,0,30,14
1714647435593,EDS 206R,A00,507332,Staff,0,4,30,30
1714647435593,EDS 206R,B00,507343,Staff,17,0,30,13
1714647436620,EDS 250,A00,507344,Hemans; Patricia Ann Benitez,22,0,40,18
1714647437650,EDS 281,A00,507345,Daly; Alan J.,18,0,18,0
1714647438678,EDS 284,A00,507350,Daly; Alan J.,16,0,16,0
1714647439707,EDS 286,A00,507359,Fine; Sarah,18,0,18,0
1714647440735,EDS 289C,A01,507361,Daly; Alan J.,18,0,18,0
1714647441761,EDS 290,A00,507366,Hofstetter; Carolyn,15,0,15,0
1714647442787,LIGM 5A,A00,507421,Fischer-Grunski; Eva K,18,0,20,2
1714647443817,LIGM 5B,A00,507423,Fischer-Grunski; Eva K,19,0,20,1
1714647444843,LIGM 5C,A00,507425,Fischer-Grunski; Eva K,19,0,20,1
1714647445872,LIIT 5AS,A00,507427,Carnelos; Chiara,20,0,20,0
1714647446900,LIIT 5BS,A00,507430,Carnelos; Chiara,20,0,20,0
1714647447927,LIIT 5CS,A00,507432,Carnelos; Chiara,20,0,20,0
1714647448955,LISP 5A,A00,507541,Munoz Sanchez; Alicia,11,0,20,9
1714647449982,LISP 5B,A00,507671,Munoz Sanchez; Alicia,8,0,20,12
1714647451011,LISP 5C,A00,507696,Munoz Sanchez; Alicia,9,0,20,11
1714647452039,MAE 197,001,528363,Boechler; Nicholas Sebastia,9998,0,9999,1
1714647453069,MATH 197,001,523477,Kedlaya; Kiran S.,9995,0,9999,4
1714647453069,MATH 197,002,563811,Zhang; Danna,9995,0,9999,4
1714647453069,MATH 197,003,628552,Dumitriu; Ioana,9998,0,9999,1
1714647454093,MCWP 40R,A00,518780,Staff,2,0,20,18
1714647454093,MCWP 40R,B00,518781,Staff,8,0,20,12
1714647454093,MCWP 40R,C00,518783,Staff,6,0,20,14
1714647455123,MCWP 50R,A00,518791,Staff,0,0,20,20
1714647455123,MCWP 50R,B00,518792,Staff,0,2,20,20
1714647455123,MCWP 50R,C00,518793,Staff,0,2,20,20
1714647455123,MCWP 50R,D00,518794,Staff,0,1,20,20
1714647455123,MCWP 50R,E00,518795,Staff,0,2,20,20
1714647455123,MCWP 50R,F00,518796,Staff,0,0,20,20
1714647455123,MCWP 50R,G00,518797,Staff,0,1,20,20
1714647456149,MMW 12R,A01,514034,Herbst; Matthew,0,0,16,16
1714647456149,MMW 12R,A02,514035,Herbst; Matthew,1,0,16,15
1714647457175,MMW 13R,A01,514037,Staff,0,4,16,16
1714647457175,MMW 13R,A02,514039,Staff,0,2,16,16
1714647457175,MMW 13R,A03,628519,Staff,0,2,16,16
1714647459233,SIO 295LS,A00,523233,Staff,10,0,30,20
1714647460261,SIO 295S,A00,523232,Staff,10,0,30,20
1714647461291,SIOC 290S,A01,637330,Merrifield; Mark A,23,0,30,7
1714647462317,SIOC 291S,A01,637333,Gabriel; Corey John,23,0,30,7
1714647463342,SOCI 117,A01,494376,Staff,0,4,5,5
1714647464369,WES 237B,A00,494380,Staff,9,0,20,11
1714647466471,AESE 279B,A00,494370,Wade; Jon P,0,0,33,33
1714647467496,AIP 197,001,627712,Vespa; Emanuel Ignacio,9998,0,9999,1
1714647468522,ANAR 135S,A00,494369,Braswell; Geoffrey E.,0,0,0,0
1714647469548,BENG 196,001,628496,Engler; Adam J.,9998,0,9999,1
1714647470575,CAT 124RS,A01,519847,Geibel; William,0,0,20,20
1714647471600,CAT 125RS,A01,515971,Geibel; William,0,0,20,20
1714647472632,CLRE 250,A00,511389,Morris; Sheldon,9993,0,9999,6
1714647473663,CLRE 251,A00,507176,Mehta; Ravindra L.,9993,0,9999,6
1714647473663,CLRE 251,B00,511410,Mehta; Ravindra L.,9998,0,9999,1
1714647474690,CLRE 252,A00,507189,Cuomo; Raphael Eduardo,9995,0,9999,4
1714647475718,CLRE 253,A00,507199,Vaida; Florin,9994,0,9999,5
1714647475718,CLRE 253,B00,507202,Vaida; Florin,9999,0,9999,0
1714647476747,CLRE 259,A00,507211,Patel; Hemal,9996,0,9999,3
1714647477773,CLRE 260,A00,507221,Cuomo; Raphael Eduardo,9999,0,9999,0
1714647478799,CLRE 297,001,507242,Cuomo; Raphael Eduardo,9999,0,9999,0
1714647479825,COGS 197,001,638244,Voytek; Bradley Thomas,9998,0,9999,1
1714647480854,CSE 191,A00,516875,Minnes Kemp; Mor Mia,9992,0,9999,7
1714647481881,CSE 197,001,637388,Minnes Kemp; Mor Mia,9998,0,9999,1
1714647482908,CSS 201S,A01,494383,Staff,35,0,35,0
1714647483935,CSS 202S,A01,494387,Staff,35,0,35,0
1714647484962,DSC 197,001,628532,Eldridge; Justin Matthew,9996,0,9999,3
1714647485989,EAP 100,A00,516065,Staff,9797,0,9999,202
1714647487017,ECE 45,A01,507414,Staff,33,0,60,27
1714647489070,ECE 111,A01,507420,Staff,15,0,50,35
1714647490094,ECE 197,001,548057,Sievenpiper; Daniel F.,9993,0,9999,6
1714647491121,EDS 115,A00,507243,Choi; Bailey Miyeon,10,0,28,18
1714647492149,EDS 117,A01,494379,Staff,0,4,30,30
1714647493173,EDS 125,A00,507246,Hopkins; Megan Beth,9,0,30,21
1714647494199,EDS 128A,A01,507264,Fargason; Sharon Gayle,8,0,26,18
1714647495228,EDS 128B,A01,507293,Pappas; Elizabeth,12,0,30,18
1714647496254,EDS 139,A00,507294,Fargason; Sharon Gayle,13,0,30,17
1714647496254,EDS 139,B00,507313,Pappas; Elizabeth,13,0,30,17
1714647497279,EDS 201,A00,507315,Staff,13,0,30,17
1714647498305,EDS 203,A01,507317,Halter; Christopher P.,12,0,30,18
1714647499332,EDS 204R,A01,507319,Halter; Christopher P.,0,3,30,30
1714647499332,EDS 204R,B01,507331,Heinzman; Erica M.,16,0,30,14
1714647500359,EDS 206R,A00,507332,Staff,0,4,30,30
1714647500359,EDS 206R,B00,507343,Staff,17,0,30,13
1714647501385,EDS 250,A00,507344,Hemans; Patricia Ann Benitez,22,0,40,18
1714647502409,EDS 281,A00,507345,Daly; Alan J.,18,0,18,0
1714647503435,EDS 284,A00,507350,Daly; Alan J.,16,0,16,0
1714647504464,EDS 286,A00,507359,Fine; Sarah,18,0,18,0
1714647505489,EDS 289C,A01,507361,Daly; Alan J.,18,0,18,0
1714647506519,EDS 290,A00,507366,Hofstetter; Carolyn,15,0,15,0
1714647507546,LIGM 5A,A00,507421,Fischer-Grunski; Eva K,18,0,20,2
1714647508577,LIGM 5B,A00,507423,Fischer-Grunski; Eva K,19,0,20,1
1714647509602,LIGM 5C,A00,507425,Fischer-Grunski; Eva K,19,0,20,1
1714647510627,LIIT 5AS,A00,507427,Carnelos; Chiara,20,0,20,0
1714647511653,LIIT 5BS,A00,507430,Carnelos; Chiara,20,0,20,0
1714647512677,LIIT 5CS,A00,507432,Carnelos; Chiara,20,0,20,0
1714647513708,LISP 5A,A00,507541,Munoz Sanchez; Alicia,11,0,20,9
1714647514734,LISP 5B,A00,507671,Munoz Sanchez; Alicia,8,0,20,12
1714647515760,LISP 5C,A00,507696,Munoz Sanchez; Alicia,9,0,20,11
1714647516787,MAE 197,001,528363,Boechler; Nicholas Sebastia,9998,0,9999,1
1714647517853,MATH 197,001,523477,Kedlaya; Kiran S.,9995,0,9999,4
1714647517853,MATH 197,002,563811,Zhang; Danna,9995,0,9999,4
1714647517853,MATH 197,003,628552,Dumitriu; Ioana,9998,0,9999,1
1714647518878,MCWP 40R,A00,518780,Staff,2,0,20,18
1714647518878,MCWP 40R,B00,518781,Staff,8,0,20,12
1714647518878,MCWP 40R,C00,518783,Staff,6,0,20,14
1714647519904,MCWP 50R,A00,518791,Staff,0,0,20,20
1714647519904,MCWP 50R,B00,518792,Staff,0,2,20,20
1714647519904,MCWP 50R,C00,518793,Staff,0,2,20,20
1714647519904,MCWP 50R,D00,518794,Staff,0,1,20,20
1714647519904,MCWP 50R,E00,518795,Staff,0,2,20,20
1714647519904,MCWP 50R,F00,518796,Staff,0,0,20,20
1714647519904,MCWP 50R,G00,518797,Staff,0,1,20,20
1714647520930,MMW 12R,A01,514034,Herbst; Matthew,0,0,16,16
1714647520930,MMW 12R,A02,514035,Herbst; Matthew,1,0,16,15
1714647521960,MMW 13R,A01,514037,Staff,0,4,16,16
1714647521960,MMW 13R,A02,514039,Staff,0,2,16,16
1714647521960,MMW 13R,A03,628519,Staff,0,2,16,16
1714647524015,SIO 295LS,A00,523233,Staff,10,0,30,20
1714647525040,SIO 295S,A00,523232,Staff,10,0,30,20
1714647526069,SIOC 290S,A01,637330,Merrifield; Mark A,23,0,30,7
1714647527100,SIOC 291S,A01,637333,Gabriel; Corey John,23,0,30,7
1714647528131,SOCI 117,A01,494376,Staff,0,4,5,5
1714647529211,WES 237B,A00,494380,Staff,9,0,20,11
1714647531311,AESE 279B,A00,494370,Wade; Jon P,0,0,33,33
1714647532337,AIP 197,001,627712,Vespa; Emanuel Ignacio,9998,0,9999,1
1714647533367,ANAR 135S,A00,494369,Braswell; Geoffrey E.,0,0,0,0
1714647534391,BENG 196,001,628496,Engler; Adam J.,9998,0,9999,1
1714647535419,CAT 124RS,A01,519847,Geibel; William,0,0,20,20
1714647536447,CAT 125RS,A01,515971,Geibel; William,0,0,20,20
1714647537472,CLRE 250,A00,511389,Morris; Sheldon,9993,0,9999,6
1714647538500,CLRE 251,A00,507176,Mehta; Ravindra L.,9993,0,9999,6
1714647538500,CLRE 251,B00,511410,Mehta; Ravindra L.,9998,0,9999,1
1714647539533,CLRE 252,A00,507189,Cuomo; Raphael Eduardo,9995,0,9999,4
1714647540563,CLRE 253,A00,507199,Vaida; Florin,9994,0,9999,5
1714647540563,CLRE 253,B00,507202,Vaida; Florin,9999,0,9999,0
1714647541594,CLRE 259,A00,507211,Patel; Hemal,9996,0,9999,3
1714647542621,CLRE 260,A00,507221,Cuomo; Raphael Eduardo,9999,0,9999,0
1714647543649,CLRE 297,001,507242,Cuomo; Raphael Eduardo,9999,0,9999,0
1714647544677,COGS 197,001,638244,Voytek; Bradley Thomas,9998,0,9999,1
1714647545703,CSE 191,A00,516875,Minnes Kemp; Mor Mia,9992,0,9999,7
1714647546730,CSE 197,001,637388,Minnes Kemp; Mor Mia,9998,0,9999,1
1714647547757,CSS 201S,A01,494383,Staff,35,0,35,0
1714647548787,CSS 202S,A01,494387,Staff,35,0,35,0
1714647549814,DSC 197,001,628532,Eldridge; Justin Matthew,9996,0,9999,3
1714647550841,EAP 100,A00,516065,Staff,9797,0,9999,202
1714647551869,ECE 45,A01,507414,Staff,33,0,60,27
1714647553925,ECE 111,A01,507420,Staff,15,0,50,35
1714647554957,ECE 197,001,548057,Sievenpiper; Daniel F.,9993,0,9999,6
1714647555988,EDS 115,A00,507243,Choi; Bailey Miyeon,10,0,28,18
1714647557019,EDS 117,A01,494379,Staff,0,4,30,30
1714647558048,EDS 125,A00,507246,Hopkins; Megan Beth,9,0,30,21
1714647559080,EDS 128A,A01,507264,Fargason; Sharon Gayle,8,0,26,18
1714647560106,EDS 128B,A01,507293,Pappas; Elizabeth,12,0,30,18
1714647561135,EDS 139,A00,507294,Fargason; Sharon Gayle,13,0,30,17
1714647561135,EDS 139,B00,507313,Pappas; Elizabeth,13,0,30,17
1714647562161,EDS 201,A00,507315,Staff,13,0,30,17
1714647563197,EDS 203,A01,507317,Halter; Christopher P.,12,0,30,18
1714647564225,EDS 204R,A01,507319,Halter; Christopher P.,0,3,30,30
1714647564225,EDS 204R,B01,507331,Heinzman; Erica M.,16,0,30,14
1714647565250,EDS 206R,A00,507332,Staff,0,4,30,30
1714647565250,EDS 206R,B00,507343,Staff,17,0,30,13
1714647566277,EDS 250,A00,507344,Hemans; Patricia Ann Benitez,22,0,40,18
1714647567306,EDS 281,A00,507345,Daly; Alan J.,18,0,18,0
1714647568331,EDS 284,A00,507350,Daly; Alan J.,16,0,16,0
1714647569360,EDS 286,A00,507359,Fine; Sarah,18,0,18,0
1714647570384,EDS 289C,A01,507361,Daly; Alan J.,18,0,18,0
1714647571413,EDS 290,A00,507366,Hofstetter; Carolyn,15,0,15,0
1714647572439,LIGM 5A,A00,507421,Fischer-Grunski; Eva K,18,0,20,2
1714647573469,LIGM 5B,A00,507423,Fischer-Grunski; Eva K,19,0,20,1
1714647574494,LIGM 5C,A00,507425,Fischer-Grunski; Eva K,19,0,20,1
1714647575526,LIIT 5AS,A00,507427,Carnelos; Chiara,20,0,20,0
1714647576550,LIIT 5BS,A00,507430,Carnelos; Chiara,20,0,20,0
1714647577578,LIIT 5CS,A00,507432,Carnelos; Chiara,20,0,20,0
1714647578608,LISP 5A,A00,507541,Munoz Sanchez; Alicia,11,0,20,9
1714647579639,LISP 5B,A00,507671,Munoz Sanchez; Alicia,8,0,20,12
1714647580663,LISP 5C,A00,507696,Munoz Sanchez; Alicia,9,0,20,11
1714647581690,MAE 197,001,528363,Boechler; Nicholas Sebastia,9998,0,9999,1
1714647582724,MATH 197,001,523477,Kedlaya; Kiran S.,9995,0,9999,4
1714647582724,MATH 197,002,563811,Zhang; Danna,9995,0,9999,4
1714647582724,MATH 197,003,628552,Dumitriu; Ioana,9998,0,9999,1
1714647583753,MCWP 40R,A00,518780,Staff,2,0,20,18
1714647583753,MCWP 40R,B00,518781,Staff,8,0,20,12
1714647583753,MCWP 40R,C00,518783,Staff,6,0,20,14
1714647584781,MCWP 50R,A00,518791,Staff,0,0,20,20
1714647584781,MCWP 50R,B00,518792,Staff,0,2,20,20
1714647584781,MCWP 50R,C00,518793,Staff,0,2,20,20
1714647584781,MCWP 50R,D00,518794,Staff,0,1,20,20
1714647584781,MCWP 50R,E00,518795,Staff,0,2,20,20
1714647584781,MCWP 50R,F00,518796,Staff,0,0,20,20
1714647584781,MCWP 50R,G00,518797,Staff,0,1,20,20
1714647585809,MMW 12R,A01,514034,Herbst; Matthew,0,0,16,16
1714647585809,MMW 12R,A02,514035,Herbst; Matthew,1,0,16,15
1714647586834,MMW 13R,A01,514037,Staff,0,4,16,16
1714647586834,MMW 13R,A02,514039,Staff,0,2,16,16
1714647586834,MMW 13R,A03,628519,Staff,0,2,16,16
1714647588890,SIO 295LS,A00,523233,Staff,10,0,30,20
1714647589913,SIO 295S,A00,523232,Staff,10,0,30,20
1714647590949,SIOC 290S,A01,637330,Merrifield; Mark A,23,0,30,7
1714647591979,SIOC 291S,A01,637333,Gabriel; Corey John,23,0,30,7
1714647593010,SOCI 117,A01,494376,Staff,0,4,5,5
1714647594037,WES 237B,A00,494380,Staff,9,0,20,11
1714647596119,AESE 279B,A00,494370,Wade; Jon P,0,0,33,33
1714647597146,AIP 197,001,627712,Vespa; Emanuel Ignacio,9998,0,9999,1
1714647598179,ANAR 135S,A00,494369,Braswell; Geoffrey E.,0,0,0,0
1714647599206,BENG 196,001,628496,Engler; Adam J.,9998,0,9999,1
1714647600232,CAT 124RS,A01,519847,Geibel; William,0,0,20,20
1714647601259,CAT 125RS,A01,515971,Geibel; William,0,0,20,20
1714647602290,CLRE 250,A00,511389,Morris; Sheldon,9993,0,9999,6
1714647603320,CLRE 251,A00,507176,Mehta; Ravindra L.,9993,0,9999,6
1714647603320,CLRE 251,B00,511410,Mehta; Ravindra L.,9998,0,9999,1
1714647604350,CLRE 252,A00,507189,Cuomo; Raphael Eduardo,9995,0,9999,4
1714647605377,CLRE 253,A00,507199,Vaida; Florin,9994,0,9999,5
1714647605377,CLRE 253,B00,507202,Vaida; Florin,9999,0,9999,0
1714647606403,CLRE 259,A00,507211,Patel; Hemal,9996,0,9999,3
1714647607430,CLRE 260,A00,507221,Cuomo; Raphael Eduardo,9999,0,9999,0
1714647608457,CLRE 297,001,507242,Cuomo; Raphael Eduardo,9999,0,9999,0
1714647609487,COGS 197,001,638244,Voytek; Bradley Thomas,9998,0,9999,1
1714647610513,CSE 191,A00,516875,Minnes Kemp; Mor Mia,9992,0,9999,7
1714647611540,CSE 197,001,637388,Minnes Kemp; Mor Mia,9998,0,9999,1
1714647612567,CSS 201S,A01,494383,Staff,35,0,35,0
1714647613593,CSS 202S,A01,494387,Staff,35,0,35,0
1714647614620,DSC 197,001,628532,Eldridge; Justin Matthew,9996,0,9999,3
1714647615649,EAP 100,A00,516065,Staff,9797,0,9999,202
1714647616678,ECE 45,A01,507414,Staff,33,0,60,27
1714647618730,ECE 111,A01,507420,Staff,15,0,50,35
1714647619757,ECE 197,001,548057,Sievenpiper; Daniel F.,9993,0,9999,6
1714647620790,EDS 115,A00,507243,Choi; Bailey Miyeon,10,0,28,18
1714647621821,EDS 117,A01,494379,Staff,0,4,30,30
1714647622855,EDS 125,A00,507246,Hopkins; Megan Beth,9,0,30,21
1714647623897,EDS 128A,A01,507264,Fargason; Sharon Gayle,8,0,26,18
1714647624926,EDS 128B,A01,507293,Pappas; Elizabeth,12,0,30,18
1714647625953,EDS 139,A00,507294,Fargason; Sharon Gayle,13,0,30,17
1714647625953,EDS 139,B00,507313,Pappas; Elizabeth,13,0,30,17
1714647626977,EDS 201,A00,507315,Staff,13,0,30,17
1714647628003,EDS 203,A01,507317,Halter; Christopher P.,12,0,30,18
1714647629028,EDS 204R,A01,507319,Halter; Christopher P.,0,3,30,30
1714647629028,EDS 204R,B01,507331,Heinzman; Erica M.,16,0,30,14
1714647630054,EDS 206R,A00,507332,Staff,0,4,30,30
1714647630054,EDS 206R,B00,507343,Staff,17,0,30,13
1714647631081,EDS 250,A00,507344,Hemans; Patricia Ann Benitez,22,0,40,18
1714647632108,EDS 281,A00,507345,Daly; Alan J.,18,0,18,0
1714647633203,EDS 284,A00,507350,Daly; Alan J.,16,0,16,0
1714647634230,EDS 286,A00,507359,Fine; Sarah,18,0,18,0
1714647635261,EDS 289C,A01,507361,Daly; Alan J.,18,0,18,0
1714647636287,EDS 290,A00,507366,Hofstetter; Carolyn,15,0,15,0
1714647637320,LIGM 5A,A00,507421,Fischer-Grunski; Eva K,18,0,20,2
1714647638347,LIGM 5B,A00,507423,Fischer-Grunski; Eva K,19,0,20,1
1714647639377,LIGM 5C,A00,507425,Fischer-Grunski; Eva K,19,0,20,1
1714647640407,LIIT 5AS,A00,507427,Carnelos; Chiara,20,0,20,0
1714647641433,LIIT 5BS,A00,507430,Carnelos; Chiara,20,0,20,0
1714647642463,LIIT 5CS,A00,507432,Carnelos; Chiara,20,0,20,0
1714647643491,LISP 5A,A00,507541,Munoz Sanchez; Alicia,11,0,20,9
1714647644520,LISP 5B,A00,507671,Munoz Sanchez; Alicia,8,0,20,12
1714647645550,LISP 5C,A00,507696,Munoz Sanchez; Alicia,9,0,20,11
1714647646574,MAE 197,001,528363,Boechler; Nicholas Sebastia,9998,0,9999,1
1714647647612,MATH 197,001,523477,Kedlaya; Kiran S.,9995,0,9999,4
1714647647612,MATH 197,002,563811,Zhang; Danna,9995,0,9999,4
1714647647612,MATH 197,003,628552,Dumitriu; Ioana,9998,0,9999,1
1714647648638,MCWP 40R,A00,518780,Staff,2,0,20,18
1714647648638,MCWP 40R,B00,518781,Staff,8,0,20,12
1714647648638,MCWP 40R,C00,518783,Staff,6,0,20,14
1714647649662,MCWP 50R,A00,518791,Staff,0,0,20,20
1714647649662,MCWP 50R,B00,518792,Staff,0,2,20,20
1714647649662,MCWP 50R,C00,518793,Staff,0,2,20,20
1714647649662,MCWP 50R,D00,518794,Staff,0,1,20,20
1714647649662,MCWP 50R,E00,518795,Staff,0,2,20,20
1714647649662,MCWP 50R,F00,518796,Staff,0,0,20,20
1714647649662,MCWP 50R,G00,518797,Staff,0,1,20,20
1714647650693,MMW 12R,A01,514034,Herbst; Matthew,0,0,16,16
1714647650693,MMW 12R,A02,514035,Herbst; Matthew,1,0,16,15
1714647651723,MMW 13R,A01,514037,Staff,0,4,16,16
1714647651723,MMW 13R,A02,514039,Staff,0,2,16,16
1714647651723,MMW 13R,A03,628519,Staff,0,2,16,16
1714647653779,SIO 295LS,A00,523233,Staff,10,0,30,20
1714647654809,SIO 295S,A00,523232,Staff,10,0,30,20
1714647655840,SIOC 290S,A01,637330,Merrifield; Mark A,23,0,30,7
1714647656866,SIOC 291S,A01,637333,Gabriel; Corey John,23,0,30,7
1714647657891,SOCI 117,A01,494376,Staff,0,4,5,5
1714647658921,WES 237B,A00,494380,Staff,9,0,20,11
1714647661002,AESE 279B,A00,494370,Wade; Jon P,0,0,33,33
1714647662028,AIP 197,001,627712,Vespa; Emanuel Ignacio,9998,0,9999,1
1714647663053,ANAR 135S,A00,494369,Braswell; Geoffrey E.,0,0,0,0
1714647664081,BENG 196,001,628496,Engler; Adam J.,9998,0,9999,1
1714647665110,CAT 124RS,A01,519847,Geibel; William,0,0,20,20
1714647666134,CAT 125RS,A01,515971,Geibel; William,0,0,20,20
1714647667165,CLRE 250,A00,511389,Morris; Sheldon,9993,0,9999,6
1714647668191,CLRE 251,A00,507176,Mehta; Ravindra L.,9993,0,9999,6
1714647668191,CLRE 251,B00,511410,Mehta; Ravindra L.,9998,0,9999,1
1714647669217,CLRE 252,A00,507189,Cuomo; Raphael Eduardo,9995,0,9999,4
1714647670246,CLRE 253,A00,507199,Vaida; Florin,9994,0,9999,5
1714647670246,CLRE 253,B00,507202,Vaida; Florin,9999,0,9999,0
1714647671272,CLRE 259,A00,507211,Patel; Hemal,9996,0,9999,3
1714647672298,CLRE 260,A00,507221,Cuomo; Raphael Eduardo,9999,0,9999,0
1714647673329,CLRE 297,001,507242,Cuomo; Raphael Eduardo,9999,0,9999,0
1714647674359,COGS 197,001,638244,Voytek; Bradley Thomas,9998,0,9999,1
1714647675390,CSE 191,A00,516875,Minnes Kemp; Mor Mia,9992,0,9999,7
1714647676415,CSE 197,001,637388,Minnes Kemp; Mor Mia,9998,0,9999,1
1714647677446,CSS 201S,A01,494383,Staff,35,0,35,0
1714647678471,CSS 202S,A01,494387,Staff,35,0,35,0
1714647679498,DSC 197,001,628532,Eldridge; Justin Matthew,9996,0,9999,3
1714647680525,EAP 100,A00,516065,Staff,9797,0,9999,202
1714647681550,ECE 45,A01,507414,Staff,33,0,60,27
1714647683605,ECE 111,A01,507420,Staff,15,0,50,35
1714647684635,ECE 197,001,548057,Sievenpiper; Daniel F.,9993,0,9999,6
1714647685660,EDS 115,A00,507243,Choi; Bailey Miyeon,10,0,28,18
1714647686687,EDS 117,A01,494379,Staff,0,4,30,30
1714647687718,EDS 125,A00,507246,Hopkins; Megan Beth,9,0,30,21
1714647688742,EDS 128A,A01,507264,Fargason; Sharon Gayle,8,0,26,18
1714647689769,EDS 128B,A01,507293,Pappas; Elizabeth,12,0,30,18
1714647690793,EDS 139,A00,507294,Fargason; Sharon Gayle,13,0,30,17
1714647690793,EDS 139,B00,507313,Pappas; Elizabeth,13,0,30,17
1714647691822,EDS 201,A00,507315,Staff,13,0,30,17
1714647692848,EDS 203,A01,507317,Halter; Christopher P.,12,0,30,18
1714647693878,EDS 204R,A01,507319,Halter; Christopher P.,0,3,30,30
1714647693878,EDS 204R,B01,507331,Heinzman; Erica M.,16,0,30,14
1714647694906,EDS 206R,A00,507332,Staff,0,4,30,30
1714647694906,EDS 206R,B00,507343,Staff,17,0,30,13
1714647695936,EDS 250,A00,507344,Hemans; Patricia Ann Benitez,22,0,40,18
1714647696966,EDS 281,A00,507345,Daly; Alan J.,18,0,18,0
1714647697990,EDS 284,A00,507350,Daly; Alan J.,16,0,16,0
1714647699021,EDS 286,A00,507359,Fine; Sarah,18,0,18,0
1714647700050,EDS 289C,A01,507361,Daly; Alan J.,18,0,18,0
1714647701077,EDS 290,A00,507366,Hofstetter; Carolyn,15,0,15,0
1714647702103,LIGM 5A,A00,507421,Fischer-Grunski; Eva K,18,0,20,2
1714647703129,LIGM 5B,A00,507423,Fischer-Grunski; Eva K,19,0,20,1
1714647704160,LIGM 5C,A00,507425,Fischer-Grunski; Eva K,19,0,20,1
1714647705186,LIIT 5AS,A00,507427,Carnelos; Chiara,20,0,20,0
1714647706212,LIIT 5BS,A00,507430,Carnelos; Chiara,20,0,20,0
1714647707240,LIIT 5CS,A00,507432,Carnelos; Chiara,20,0,20,0
1714647708268,LISP 5A,A00,507541,Munoz Sanchez; Alicia,11,0,20,9
1714647709297,LISP 5B,A00,507671,Munoz Sanchez; Alicia,8,0,20,12
1714647710329,LISP 5C,A00,507696,Munoz Sanchez; Alicia,9,0,20,11
1714647711354,MAE 197,001,528363,Boechler; Nicholas Sebastia,9998,0,9999,1
1714647712388,MATH 197,001,523477,Kedlaya; Kiran S.,9995,0,9999,4
1714647712388,MATH 197,002,563811,Zhang; Danna,9995,0,9999,4
1714647712388,MATH 197,003,628552,Dumitriu; Ioana,9998,0,9999,1
1714647713418,MCWP 40R,A00,518780,Staff,2,0,20,18
1714647713418,MCWP 40R,B00,518781,Staff,8,0,20,12
1714647713418,MCWP 40R,C00,518783,Staff,6,0,20,14
1714647714445,MCWP 50R,A00,518791,Staff,0,0,20,20
1714647714445,MCWP 50R,B00,518792,Staff,0,2,20,20
1714647714445,MCWP 50R,C00,518793,Staff,0,2,20,20
1714647714445,MCWP 50R,D00,518794,Staff,0,1,20,20
1714647714445,MCWP 50R,E00,518795,Staff,0,2,20,20
1714647714445,MCWP 50R,F00,518796,Staff,0,0,20,20
1714647714445,MCWP 50R,G00,518797,Staff,0,1,20,20
1714647715477,MMW 12R,A01,514034,Herbst; Matthew,0,0,16,16
1714647715477,MMW 12R,A02,514035,Herbst; Matthew,1,0,16,15
1714647716503,MMW 13R,A01,514037,Staff,0,4,16,16
1714647716503,MMW 13R,A02,514039,Staff,0,2,16,16
1714647716503,MMW 13R,A03,628519,Staff,0,2,16,16
1714647718554,SIO 295LS,A00,523233,Staff,10,0,30,20
1714647719581,SIO 295S,A00,523232,Staff,10,0,30,20
1714647720614,SIOC 290S,A01,637330,Merrifield; Mark A,23,0,30,7
1714647721640,SIOC 291S,A01,637333,Gabriel; Corey John,23,0,30,7
1714647722664,SOCI 117,A01,494376,Staff,0,4,5,5
1714647723693,WES 237B,A00,494380,Staff,9,0,20,11
1714647725759,AESE 279B,A00,494370,Wade; Jon P,0,0,33,33
1714647726785,AIP 197,001,627712,Vespa; Emanuel Ignacio,9998,0,9999,1
1714647727810,ANAR 135S,A00,494369,Braswell; Geoffrey E.,0,0,0,0
1714647728836,BENG 196,001,628496,Engler; Adam J.,9998,0,9999,1
1714647729863,CAT 124RS,A01,519847,Geibel; William,0,0,20,20
1714647730889,CAT 125RS,A01,515971,Geibel; William,0,0,20,20
1714647731921,CLRE 250,A00,511389,Morris; Sheldon,9993,0,9999,6
1714647732947,CLRE 251,A00,507176,Mehta; Ravindra L.,9993,0,9999,6
1714647732947,CLRE 251,B00,511410,Mehta; Ravindra L.,9998,0,9999,1
1714647733974,CLRE 252,A00,507189,Cuomo; Raphael Eduardo,9995,0,9999,4
1714647734999,CLRE 253,A00,507199,Vaida; Florin,9994,0,9999,5
1714647734999,CLRE 253,B00,507202,Vaida; Florin,9999,0,9999,0
1714647736029,CLRE 259,A00,507211,Patel; Hemal,9996,0,9999,3
1714647737055,CLRE 260,A00,507221,Cuomo; Raphael Eduardo,9999,0,9999,0
1714647738082,CLRE 297,001,507242,Cuomo; Raphael Eduardo,9999,0,9999,0
1714647739111,COGS 197,001,638244,Voytek; Bradley Thomas,9998,0,9999,1
1714647740141,CSE 191,A00,516875,Minnes Kemp; Mor Mia,9992,0,9999,7
1714647741170,CSE 197,001,637388,Minnes Kemp; Mor Mia,9998,0,9999,1
1714647742201,CSS 201S,A01,494383,Staff,35,0,35,0
1714647743231,CSS 202S,A01,494387,Staff,35,0,35,0
1714647744258,DSC 197,001,628532,Eldridge; Justin Matthew,9996,0,9999,3
1714647745284,EAP 100,A00,516065,Staff,9797,0,9999,202
1714647746310,ECE 45,A01,507414,Staff,33,0,60,27
1714647748360,ECE 111,A01,507420,Staff,15,0,50,35
1714647749386,ECE 197,001,548057,Sievenpiper; Daniel F.,9993,0,9999,6
1714647750420,EDS 115,A00,507243,Choi; Bailey Miyeon,10,0,28,18
1714647751445,EDS 117,A01,494379,Staff,0,4,30,30
1714647752471,EDS 125,A00,507246,Hopkins; Megan Beth,9,0,30,21
1714647753497,EDS 128A,A01,507264,Fargason; Sharon Gayle,8,0,26,18
1714647754529,EDS 128B,A01,507293,Pappas; Elizabeth,12,0,30,18
1714647755558,EDS 139,A00,507294,Fargason; Sharon Gayle,13,0,30,17
1714647755558,EDS 139,B00,507313,Pappas; Elizabeth,13,0,30,17
1714647756584,EDS 201,A00,507315,Staff,13,0,30,17
1714647757609,EDS 203,A01,507317,Halter; Christopher P.,12,0,30,18
1714647758638,EDS 204R,A01,507319,Halter; Christopher P.,0,3,30,30
1714647758638,EDS 204R,B01,507331,Heinzman; Erica M.,16,0,30,14
1714647759665,EDS 206R,A00,507332,Staff,0,4,30,30
1714647759665,EDS 206R,B00,507343,Staff,17,0,30,13
1714647760691,EDS 250,A00,507344,Hemans; Patricia Ann Benitez,22,0,40,18
1714647761716,EDS 281,A00,507345,Daly; Alan J.,18,0,18,0
1714647762740,EDS 284,A00,507350,Daly; Alan J.,16,0,16,0
1714647763765,EDS 286,A00,507359,Fine; Sarah,18,0,18,0
1714647764792,EDS 289C,A01,507361,Daly; Alan J.,18,0,18,0
1714647765816,EDS 290,A00,507366,Hofstetter; Carolyn,15,0,15,0
1714647766845,LIGM 5A,A00,507421,Fischer-Grunski; Eva K,18,0,20,2
1714647767871,LIGM 5B,A00,507423,Fischer-Grunski; Eva K,19,0,20,1
1714647768898,LIGM 5C,A00,507425,Fischer-Grunski; Eva K,19,0,20,1
1714647769922,LIIT 5AS,A00,507427,Carnelos; Chiara,20,0,20,0
1714647770949,LIIT 5BS,A00,507430,Carnelos; Chiara,20,0,20,0
1714647771981,LIIT 5CS,A00,507432,Carnelos; Chiara,20,0,20,0
1714647773007,LISP 5A,A00,507541,Munoz Sanchez; Alicia,11,0,20,9
1714647774032,LISP 5B,A00,507671,Munoz Sanchez; Alicia,8,0,20,12
1714647775058,LISP 5C,A00,507696,Munoz Sanchez; Alicia,9,0,20,11
1714647776090,MAE 197,001,528363,Boechler; Nicholas Sebastia,9998,0,9999,1
1714647777117,MATH 197,001,523477,Kedlaya; Kiran S.,9995,0,9999,4
1714647777117,MATH 197,002,563811,Zhang; Danna,9995,0,9999,4
1714647777117,MATH 197,003,628552,Dumitriu; Ioana,9998,0,9999,1
1714647778148,MCWP 40R,A00,518780,Staff,2,0,20,18
1714647778148,MCWP 40R,B00,518781,Staff,8,0,20,12
1714647778148,MCWP 40R,C00,518783,Staff,6,0,20,14
1714647779173,MCWP 50R,A00,518791,Staff,0,0,20,20
1714647779173,MCWP 50R,B00,518792,Staff,0,2,20,20
1714647779173,MCWP 50R,C00,518793,Staff,0,2,20,20
1714647779173,MCWP 50R,D00,518794,Staff,0,1,20,20
1714647779173,MCWP 50R,E00,518795,Staff,0,2,20,20
1714647779173,MCWP 50R,F00,518796,Staff,0,0,20,20
1714647779173,MCWP 50R,G00,518797,Staff,0,1,20,20
1714647780216,MMW 12R,A01,514034,Herbst; Matthew,0,0,16,16
1714647780216,MMW 12R,A02,514035,Herbst; Matthew,1,0,16,15
1714647781241,MMW 13R,A01,514037,Staff,0,4,16,16
1714647781241,MMW 13R,A02,514039,Staff,0,2,16,16
1714647781241,MMW 13R,A03,628519,Staff,0,2,16,16
1714647783295,SIO 295LS,A00,523233,Staff,10,0,30,20
1714647784319,SIO 295S,A00,523232,Staff,10,0,30,20
1714647785351,SIOC 290S,A01,637330,Merrifield; Mark A,23,0,30,7
1714647786382,SIOC 291S,A01,637333,Gabriel; Corey John,23,0,30,7
1714647787412,SOCI 117,A01,494376,Staff,0,4,5,5
1714647788436,WES 237B,A00,494380,Staff,9,0,20,11
1714647790533,AESE 279B,A00,494370,Wade; Jon P,0,0,33,33
1714647791558,AIP 197,001,627712,Vespa; Emanuel Ignacio,9998,0,9999,1
1714647792589,ANAR 135S,A00,494369,Braswell; Geoffrey E.,0,0,0,0
1714647793618,BENG 196,001,628496,Engler; Adam J.,9998,0,9999,1
1714647794646,CAT 124RS,A01,519847,Geibel; William,0,0,20,20
1714647795674,CAT 125RS,A01,515971,Geibel; William,0,0,20,20
1714647796706,CLRE 250,A00,511389,Morris; Sheldon,9993,0,9999,6
1714647797740,CLRE 251,A00,507176,Mehta; Ravindra L.,9993,0,9999,6
1714647797740,CLRE 251,B00,511410,Mehta; Ravindra L.,9998,0,9999,1
1714647798765,CLRE 252,A00,507189,Cuomo; Raphael Eduardo,9995,0,9999,4
1714647799795,CLRE 253,A00,507199,Vaida; Florin,9994,0,9999,5
1714647799795,CLRE 253,B00,507202,Vaida; Florin,9999,0,9999,0
1714647800821,CLRE 259,A00,507211,Patel; Hemal,9996,0,9999,3
1714647801849,CLRE 260,A00,507221,Cuomo; Raphael Eduardo,9999,0,9999,0
1714647802878,CLRE 297,001,507242,Cuomo; Raphael Eduardo,9999,0,9999,0
1714647803905,COGS 197,001,638244,Voytek; Bradley Thomas,9998,0,9999,1
1714647804933,CSE 191,A00,516875,Minnes Kemp; Mor Mia,9992,0,9999,7
1714647805959,CSE 197,001,637388,Minnes Kemp; Mor Mia,9998,0,9999,1
1714647806992,CSS 201S,A01,494383,Staff,35,0,35,0
1714647808016,CSS 202S,A01,494387,Staff,35,0,35,0
1714647809045,DSC 197,001,628532,Eldridge; Justin Matthew,9996,0,9999,3
1714647810070,EAP 100,A00,516065,Staff,9797,0,9999,202
1714647811100,ECE 45,A01,507414,Staff,33,0,60,27
1714647813157,ECE 111,A01,507420,Staff,15,0,50,35
1714647814182,ECE 197,001,548057,Sievenpiper; Daniel F.,9993,0,9999,6
1714647815215,EDS 115,A00,507243,Choi; Bailey Miyeon,10,0,28,18
1714647816242,EDS 117,A01,494379,Staff,0,4,30,30
1714647817267,EDS 125,A00,507246,Hopkins; Megan Beth,9,0,30,21
1714647818295,EDS 128A,A01,507264,Fargason; Sharon Gayle,8,0,26,18
1714647819325,EDS 128B,A01,507293,Pappas; Elizabeth,12,0,30,18
1714647820350,EDS 139,A00,507294,Fargason; Sharon Gayle,13,0,30,17
1714647820350,EDS 139,B00,507313,Pappas; Elizabeth,13,0,30,17
1714647821378,EDS 201,A00,507315,Staff,13,0,30,17
1714647822409,EDS 203,A01,507317,Halter; Christopher P.,12,0,30,18
1714647823434,EDS 204R,A01,507319,Halter; Christopher P.,0,3,30,30
1714647823434,EDS 204R,B01,507331,Heinzman; Erica M.,16,0,30,14
1714647824460,EDS 206R,A00,507332,Staff,0,4,30,30
1714647824460,EDS 206R,B00,507343,Staff,17,0,30,13
1714647825489,EDS 250,A00,507344,Hemans; Patricia Ann Benitez,22,0,40,18
1714647826517,EDS 281,A00,507345,Daly; Alan J.,18,0,18,0
1714647827541,EDS 284,A00,507350,Daly; Alan J.,16,0,16,0
1714647828565,EDS 286,A00,507359,Fine; Sarah,18,0,18,0
1714647829589,EDS 289C,A01,507361,Daly; Alan J.,18,0,18,0
1714647830614,EDS 290,A00,507366,Hofstetter; Carolyn,15,0,15,0
1714647831640,LIGM 5A,A00,507421,Fischer-Grunski; Eva K,18,0,20,2
1714647832669,LIGM 5B,A00,507423,Fischer-Grunski; Eva K,19,0,20,1
1714647833699,LIGM 5C,A00,507425,Fischer-Grunski; Eva K,19,0,20,1
1714647834725,LIIT 5AS,A00,507427,Carnelos; Chiara,20,0,20,0
1714647835750,LIIT 5BS,A00,507430,Carnelos; Chiara,20,0,20,0
1714647836779,LIIT 5CS,A00,507432,Carnelos; Chiara,20,0,20,0
1714647837811,LISP 5A,A00,507541,Munoz Sanchez; Alicia,11,0,20,9
1714647838837,LISP 5B,A00,507671,Munoz Sanchez; Alicia,8,0,20,12
1714647839863,LISP 5C,A00,507696,Munoz Sanchez; Alicia,9,0,20,11
1714647840895,MAE 197,001,528363,Boechler; Nicholas Sebastia,9998,0,9999,1
1714647841922,MATH 197,001,523477,Kedlaya; Kiran S.,9995,0,9999,4
1714647841922,MATH 197,002,563811,Zhang; Danna,9995,0,9999,4
1714647841922,MATH 197,003,628552,Dumitriu; Ioana,9998,0,9999,1
1714647842950,MCWP 40R,A00,518780,Staff,2,0,20,18
1714647842950,MCWP 40R,B00,518781,Staff,8,0,20,12
1714647842950,MCWP 40R,C00,518783,Staff,6,0,20,14
1714647843976,MCWP 50R,A00,518791,Staff,0,0,20,20
1714647843976,MCWP 50R,B00,518792,Staff,0,2,20,20
1714647843976,MCWP 50R,C00,518793,Staff,0,2,20,20
1714647843976,MCWP 50R,D00,518794,Staff,0,1,20,20
1714647843976,MCWP 50R,E00,518795,Staff,0,2,20,20
1714647843976,MCWP 50R,F00,518796,Staff,0,0,20,20
1714647843976,MCWP 50R,G00,518797,Staff,0,1,20,20
1714647845008,MMW 12R,A01,514034,Herbst; Matthew,0,0,16,16
1714647845008,MMW 12R,A02,514035,Herbst; Matthew,1,0,16,15
1714647846036,MMW 13R,A01,514037,Staff,0,4,16,16
1714647846036,MMW 13R,A02,514039,Staff,0,2,16,16
1714647846036,MMW 13R,A03,628519,Staff,0,2,16,16
1714647848086,SIO 295LS,A00,523233,Staff,10,0,30,20
1714647849113,SIO 295S,A00,523232,Staff,10,0,30,20
1714647850139,SIOC 290S,A01,637330,Merrifield; Mark A,23,0,30,7
1714647851168,SIOC 291S,A01,637333,Gabriel; Corey John,23,0,30,7
1714647852200,SOCI 117,A01,494376,Staff,0,4,5,5
1714647853225,WES 237B,A00,494380,Staff,9,0,20,11
1714647855307,AESE 279B,A00,494370,Wade; Jon P,0,0,33,33
1714647856336,AIP 197,001,627712,Vespa; Emanuel Ignacio,9998,0,9999,1
1714647857364,ANAR 135S,A00,494369,Braswell; Geoffrey E.,0,0,0,0
1714647858390,BENG 196,001,628496,Engler; Adam J.,9998,0,9999,1
1714647859415,CAT 124RS,A01,519847,Geibel; William,0,0,20,20
1714647860444,CAT 125RS,A01,515971,Geibel; William,0,0,20,20
1714647861471,CLRE 250,A00,511389,Morris; Sheldon,9993,0,9999,6
1714647862498,CLRE 251,A00,507176,Mehta; Ravindra L.,9993,0,9999,6
1714647862498,CLRE 251,B00,511410,Mehta; Ravindra L.,9998,0,9999,1
1714647863527,CLRE 252,A00,507189,Cuomo; Raphael Eduardo,9995,0,9999,4
1714647864555,CLRE 253,A00,507199,Vaida; Florin,9994,0,9999,5
1714647864555,CLRE 253,B00,507202,Vaida; Florin,9999,0,9999,0
1714647865579,CLRE 259,A00,507211,Patel; Hemal,9996,0,9999,3
1714647866609,CLRE 260,A00,507221,Cuomo; Raphael Eduardo,9999,0,9999,0
1714647867636,CLRE 297,001,507242,Cuomo; Raphael Eduardo,9999,0,9999,0
1714647868669,COGS 197,001,638244,Voytek; Bradley Thomas,9998,0,9999,1
1714647869699,CSE 191,A00,516875,Minnes Kemp; Mor Mia,9992,0,9999,7
1714647870727,CSE 197,001,637388,Minnes Kemp; Mor Mia,9998,0,9999,1
1714647871755,CSS 201S,A01,494383,Staff,35,0,35,0
1714647872784,CSS 202S,A01,494387,Staff,35,0,35,0
1714647873808,DSC 197,001,628532,Eldridge; Justin Matthew,9996,0,9999,3
1714647874833,EAP 100,A00,516065,Staff,9797,0,9999,202
1714647875860,ECE 45,A01,507414,Staff,33,0,60,27
1714647877915,ECE 111,A01,507420,Staff,15,0,50,35
1714647878947,ECE 197,001,548057,Sievenpiper; Daniel F.,9993,0,9999,6
1714647879973,EDS 115,A00,507243,Choi; Bailey Miyeon,10,0,28,18
1714647880999,EDS 117,A01,494379,Staff,0,4,30,30
1714647882029,EDS 125,A00,507246,Hopkins; Megan Beth,9,0,30,21
1714647883059,EDS 128A,A01,507264,Fargason; Sharon Gayle,8,0,26,18
1714647884084,EDS 128B,A01,507293,Pappas; Elizabeth,12,0,30,18
1714647885111,EDS 139,A00,507294,Fargason; Sharon Gayle,13,0,30,17
1714647885111,EDS 139,B00,507313,Pappas; Elizabeth,13,0,30,17
1714647886142,EDS 201,A00,507315,Staff,13,0,30,17
1714647887169,EDS 203,A01,507317,Halter; Christopher P.,12,0,30,18
1714647888194,EDS 204R,A01,507319,Halter; Christopher P.,0,3,30,30
1714647888194,EDS 204R,B01,507331,Heinzman; Erica M.,16,0,30,14
1714647889222,EDS 206R,A00,507332,Staff,0,4,30,30
1714647889222,EDS 206R,B00,507343,Staff,17,0,30,13
1714647890247,EDS 250,A00,507344,Hemans; Patricia Ann Benitez,22,0,40,18
1714647891273,EDS 281,A00,507345,Daly; Alan J.,18,0,18,0
1714647892297,EDS 284,A00,507350,Daly; Alan J.,16,0,16,0
1714647893325,EDS 286,A00,507359,Fine; Sarah,18,0,18,0
1714647894349,EDS 289C,A01,507361,Daly; Alan J.,18,0,18,0
1714647895374,EDS 290,A00,507366,Hofstetter; Carolyn,15,0,15,0
1714647896423,LIGM 5A,A00,507421,Fischer-Grunski; Eva K,18,0,20,2
1714647897452,LIGM 5B,A00,507423,Fischer-Grunski; Eva K,19,0,20,1
1714647898478,LIGM 5C,A00,507425,Fischer-Grunski; Eva K,19,0,20,1
1714647899505,LIIT 5AS,A00,507427,Carnelos; Chiara,20,0,20,0
1714647900531,LIIT 5BS,A00,507430,Carnelos; Chiara,20,0,20,0
1714647901556,LIIT 5CS,A00,507432,Carnelos; Chiara,20,0,20,0
1714647902590,LISP 5A,A00,507541,Munoz Sanchez; Alicia,11,0,20,9
1714647903614,LISP 5B,A00,507671,Munoz Sanchez; Alicia,8,0,20,12
1714647904642,LISP 5C,A00,507696,Munoz Sanchez; Alicia,9,0,20,11
1714647905671,MAE 197,001,528363,Boechler; Nicholas Sebastia,9998,0,9999,1
1714647906699,MATH 197,001,523477,Kedlaya; Kiran S.,9995,0,9999,4
1714647906699,MATH 197,002,563811,Zhang; Danna,9995,0,9999,4
1714647906699,MATH 197,003,628552,Dumitriu; Ioana,9998,0,9999,1
1714647907724,MCWP 40R,A00,518780,Staff,2,0,20,18
1714647907724,MCWP 40R,B00,518781,Staff,8,0,20,12
1714647907724,MCWP 40R,C00,518783,Staff,6,0,20,14
1714647908749,MCWP 50R,A00,518791,Staff,0,0,20,20
1714647908749,MCWP 50R,B00,518792,Staff,0,2,20,20
1714647908749,MCWP 50R,C00,518793,Staff,0,2,20,20
1714647908749,MCWP 50R,D00,518794,Staff,0,1,20,20
1714647908749,MCWP 50R,E00,518795,Staff,0,2,20,20
1714647908749,MCWP 50R,F00,518796,Staff,0,0,20,20
1714647908749,MCWP 50R,G00,518797,Staff,0,1,20,20
1714647909775,MMW 12R,A01,514034,Herbst; Matthew,0,0,16,16
1714647909775,MMW 12R,A02,514035,Herbst; Matthew,1,0,16,15
1714647910799,MMW 13R,A01,514037,Staff,0,4,16,16
1714647910799,MMW 13R,A02,514039,Staff,0,2,16,16
1714647910799,MMW 13R,A03,628519,Staff,0,2,16,16
1714647912856,SIO 295LS,A00,523233,Staff,10,0,30,20
1714647913881,SIO 295S,A00,523232,Staff,10,0,30,20
1714647914913,SIOC 290S,A01,637330,Merrifield; Mark A,23,0,30,7
1714647915944,SIOC 291S,A01,637333,Gabriel; Corey John,23,0,30,7
1714647916976,SOCI 117,A01,494376,Staff,0,4,5,5
1714647918004,WES 237B,A00,494380,Staff,9,0,20,11
1714647920089,AESE 279B,A00,494370,Wade; Jon P,0,0,33,33
1714647921119,AIP 197,001,627712,Vespa; Emanuel Ignacio,9998,0,9999,1
1714647922145,ANAR 135S,A00,494369,Braswell; Geoffrey E.,0,0,0,0
1714647923173,BENG 196,001,628496,Engler; Adam J.,9998,0,9999,1
1714647924201,CAT 124RS,A01,519847,Geibel; William,0,0,20,20
1714647925227,CAT 125RS,A01,515971,Geibel; William,0,0,20,20
1714647926259,CLRE 250,A00,511389,Morris; Sheldon,9993,0,9999,6
1714647927291,CLRE 251,A00,507176,Mehta; Ravindra L.,9993,0,9999,6
1714647927291,CLRE 251,B00,511410,Mehta; Ravindra L.,9998,0,9999,1
1714647928320,CLRE 252,A00,507189,Cuomo; Raphael Eduardo,9995,0,9999,4
1714647929346,CLRE 253,A00,507199,Vaida; Florin,9994,0,9999,5
1714647929346,CLRE 253,B00,507202,Vaida; Florin,9999,0,9999,0
1714647930374,CLRE 259,A00,507211,Patel; Hemal,9996,0,9999,3
1714647931403,CLRE 260,A00,507221,Cuomo; Raphael Eduardo,9999,0,9999,0
1714647932433,CLRE 297,001,507242,Cuomo; Raphael Eduardo,9999,0,9999,0
1714647933460,COGS 197,001,638244,Voytek; Bradley Thomas,9998,0,9999,1
1714647934489,CSE 191,A00,516875,Minnes Kemp; Mor Mia,9992,0,9999,7
1714647935519,CSE 197,001,637388,Minnes Kemp; Mor Mia,9998,0,9999,1
1714647936546,CSS 201S,A01,494383,Staff,35,0,35,0
1714647937569,CSS 202S,A01,494387,Staff,35,0,35,0
1714647938596,DSC 197,001,628532,Eldridge; Justin Matthew,9996,0,9999,3
1714647939622,EAP 100,A00,516065,Staff,9797,0,9999,202
1714647940651,ECE 45,A01,507414,Staff,33,0,60,27
1714647942705,ECE 111,A01,507420,Staff,15,0,50,35
1714647943731,ECE 197,001,548057,Sievenpiper; Daniel F.,9993,0,9999,6
1714647944757,EDS 115,A00,507243,Choi; Bailey Miyeon,10,0,28,18
1714647945784,EDS 117,A01,494379,Staff,0,4,30,30
1714647946814,EDS 125,A00,507246,Hopkins; Megan Beth,9,0,30,21
1714647947845,EDS 128A,A01,507264,Fargason; Sharon Gayle,8,0,26,18
1714647948869,EDS 128B,A01,507293,Pappas; Elizabeth,12,0,30,18
1714647949897,EDS 139,A00,507294,Fargason; Sharon Gayle,13,0,30,17
1714647949897,EDS 139,B00,507313,Pappas; Elizabeth,13,0,30,17
1714647950926,EDS 201,A00,507315,Staff,13,0,30,17
1714647951975,EDS 203,A01,507317,Halter; Christopher P.,12,0,30,18
1714647953006,EDS 204R,A01,507319,Halter; Christopher P.,0,3,30,30
1714647953006,EDS 204R,B01,507331,Heinzman; Erica M.,16,0,30,14
1714647954030,EDS 206R,A00,507332,Staff,0,4,30,30
1714647954030,EDS 206R,B00,507343,Staff,17,0,30,13
1714647955062,EDS 250,A00,507344,Hemans; Patricia Ann Benitez,22,0,40,18
1714647956087,EDS 281,A00,507345,Daly; Alan J.,18,0,18,0
1714647957113,EDS 284,A00,507350,Daly; Alan J.,16,0,16,0
1714647958138,EDS 286,A00,507359,Fine; Sarah,18,0,18,0
1714647959166,EDS 289C,A01,507361,Daly; Alan J.,18,0,18,0
1714647960198,EDS 290,A00,507366,Hofstetter; Carolyn,15,0,15,0
1714647961232,LIGM 5A,A00,507421,Fischer-Grunski; Eva K,18,0,20,2
1714647962258,LIGM 5B,A00,507423,Fischer-Grunski; Eva K,19,0,20,1
1714647963284,LIGM 5C,A00,507425,Fischer-Grunski; Eva K,19,0,20,1
1714647964314,LIIT 5AS,A00,507427,Carnelos; Chiara,20,0,20,0
1714647965345,LIIT 5BS,A00,507430,Carnelos; Chiara,20,0,20,0
1714647966374,LIIT 5CS,A00,507432,Carnelos; Chiara,20,0,20,0
1714647967406,LISP 5A,A00,507541,Munoz Sanchez; Alicia,11,0,20,9
1714647968436,LISP 5B,A00,507671,Munoz Sanchez; Alicia,8,0,20,12
1714647969464,LISP 5C,A00,507696,Munoz Sanchez; Alicia,9,0,20,11
1714647970490,MAE 197,001,528363,Boechler; Nicholas Sebastia,9998,0,9999,1
1714647971522,MATH 197,001,523477,Kedlaya; Kiran S.,9995,0,9999,4
1714647971522,MATH 197,002,563811,Zhang; Danna,9995,0,9999,4
1714647971522,MATH 197,003,628552,Dumitriu; Ioana,9998,0,9999,1
1714647972547,MCWP 40R,A00,518780,Staff,2,0,20,18
1714647972547,MCWP 40R,B00,518781,Staff,8,0,20,12
1714647972547,MCWP 40R,C00,518783,Staff,6,0,20,14
1714647973570,MCWP 50R,A00,518791,Staff,0,0,20,20
1714647973570,MCWP 50R,B00,518792,Staff,0,2,20,20
1714647973570,MCWP 50R,C00,518793,Staff,0,2,20,20
1714647973570,MCWP 50R,D00,518794,Staff,0,1,20,20
1714647973570,MCWP 50R,E00,518795,Staff,0,2,20,20
1714647973570,MCWP 50R,F00,518796,Staff,0,0,20,20
1714647973570,MCWP 50R,G00,518797,Staff,0,1,20,20
1714647974601,MMW 12R,A01,514034,Herbst; Matthew,0,0,16,16
1714647974601,MMW 12R,A02,514035,Herbst; Matthew,1,0,16,15
1714647975627,MMW 13R,A01,514037,Staff,0,4,16,16
1714647975627,MMW 13R,A02,514039,Staff,0,2,16,16
1714647975627,MMW 13R,A03,628519,Staff,0,2,16,16
1714647977678,SIO 295LS,A00,523233,Staff,10,0,30,20
1714647978707,SIO 295S,A00,523232,Staff,10,0,30,20
1714647979733,SIOC 290S,A01,637330,Merrifield; Mark A,23,0,30,7
1714647980760,SIOC 291S,A01,637333,Gabriel; Corey John,23,0,30,7
1714647981786,SOCI 117,A01,494376,Staff,0,4,5,5
1714647982814,WES 237B,A00,494380,Staff,9,0,20,11
1714647984900,AESE 279B,A00,494370,Wade; Jon P,0,0,33,33
1714647985925,AIP 197,001,627712,Vespa; Emanuel Ignacio,9998,0,9999,1
1714647986955,ANAR 135S,A00,494369,Braswell; Geoffrey E.,0,0,0,0
1714647987980,BENG 196,001,628496,Engler; Adam J.,9998,0,9999,1
1714647989014,CAT 124RS,A01,519847,Geibel; William,0,0,20,20
1714647990045,CAT 125RS,A01,515971,Geibel; William,0,0,20,20
1714647991076,CLRE 250,A00,511389,Morris; Sheldon,9993,0,9999,6
1714647992103,CLRE 251,A00,507176,Mehta; Ravindra L.,9993,0,9999,6
1714647992103,CLRE 251,B00,511410,Mehta; Ravindra L.,9998,0,9999,1
1714647993129,CLRE 252,A00,507189,Cuomo; Raphael Eduardo,9995,0,9999,4
1714647994161,CLRE 253,A00,507199,Vaida; Florin,9994,0,9999,5
1714647994161,CLRE 253,B00,507202,Vaida; Florin,9999,0,9999,0
1714647995188,CLRE 259,A00,507211,Patel; Hemal,9996,0,9999,3
1714647996214,CLRE 260,A00,507221,Cuomo; Raphael Eduardo,9999,0,9999,0
1714647997241,CLRE 297,001,507242,Cuomo; Raphael Eduardo,9999,0,9999,0
1714647998268,COGS 197,001,638244,Voytek; Bradley Thomas,9998,0,9999,1
1714647999297,CSE 191,A00,516875,Minnes Kemp; Mor Mia,9992,0,9999,7
1714648000327,CSE 197,001,637388,Minnes Kemp; Mor Mia,9998,0,9999,1
1714648001356,CSS 201S,A01,494383,Staff,35,0,35,0
1714648002381,CSS 202S,A01,494387,Staff,35,0,35,0
1714648003406,DSC 197,001,628532,Eldridge; Justin Matthew,9996,0,9999,3
1714648004436,EAP 100,A00,516065,Staff,9797,0,9999,202
1714648005463,ECE 45,A01,507414,Staff,33,0,60,27
1714648007519,ECE 111,A01,507420,Staff,15,0,50,35
1714648008551,ECE 197,001,548057,Sievenpiper; Daniel F.,9993,0,9999,6
1714648009578,EDS 115,A00,507243,Choi; Bailey Miyeon,10,0,28,18
1714648010603,EDS 117,A01,494379,Staff,0,4,30,30
1714648011635,EDS 125,A00,507246,Hopkins; Megan Beth,9,0,30,21
1714648012663,EDS 128A,A01,507264,Fargason; Sharon Gayle,8,0,26,18
1714648013696,EDS 128B,A01,507293,Pappas; Elizabeth,12,0,30,18
1714648014721,EDS 139,A00,507294,Fargason; Sharon Gayle,13,0,30,17
1714648014721,EDS 139,B00,507313,Pappas; Elizabeth,13,0,30,17
1714648015749,EDS 201,A00,507315,Staff,13,0,30,17
1714648016774,EDS 203,A01,507317,Halter; Christopher P.,12,0,30,18
1714648017800,EDS 204R,A01,507319,Halter; Christopher P.,0,3,30,30
1714648017800,EDS 204R,B01,507331,Heinzman; Erica M.,16,0,30,14
1714648018826,EDS 206R,A00,507332,Staff,0,4,30,30
1714648018826,EDS 206R,B00,507343,Staff,17,0,30,13
1714648019871,EDS 250,A00,507344,Hemans; Patricia Ann Benitez,22,0,40,18
1714648020895,EDS 281,A00,507345,Daly; Alan J.,18,0,18,0
1714648021922,EDS 284,A00,507350,Daly; Alan J.,16,0,16,0
1714648022947,EDS 286,A00,507359,Fine; Sarah,18,0,18,0
1714648023977,EDS 289C,A01,507361,Daly; Alan J.,18,0,18,0
1714648025002,EDS 290,A00,507366,Hofstetter; Carolyn,15,0,15,0
1714648036590,LIGM 5A,A00,507421,Fischer-Grunski; Eva K,18,0,20,2
1714648037623,LIGM 5B,A00,507423,Fischer-Grunski; Eva K,19,0,20,1
1714648038650,LIGM 5C,A00,507425,Fischer-Grunski; Eva K,19,0,20,1
1714648039677,LIIT 5AS,A00,507427,Carnelos; Chiara,20,0,20,0
1714648040706,LIIT 5BS,A00,507430,Carnelos; Chiara,20,0,20,0
1714648041731,LIIT 5CS,A00,507432,Carnelos; Chiara,20,0,20,0
1714648042758,LISP 5A,A00,507541,Munoz Sanchez; Alicia,11,0,20,9
1714648043785,LISP 5B,A00,507671,Munoz Sanchez; Alicia,8,0,20,12
1714648044810,LISP 5C,A00,507696,Munoz Sanchez; Alicia,9,0,20,11
1714648045838,MAE 197,001,528363,Boechler; Nicholas Sebastia,9998,0,9999,1
1714648046867,MATH 197,001,523477,Kedlaya; Kiran S.,9995,0,9999,4
1714648046867,MATH 197,002,563811,Zhang; Danna,9995,0,9999,4
1714648046867,MATH 197,003,628552,Dumitriu; Ioana,9998,0,9999,1
1714648047894,MCWP 40R,A00,518780,Staff,2,0,20,18
1714648047894,MCWP 40R,B00,518781,Staff,8,0,20,12
1714648047894,MCWP 40R,C00,518783,Staff,6,0,20,14
1714648048922,MCWP 50R,A00,518791,Staff,0,0,20,20
1714648048922,MCWP 50R,B00,518792,Staff,0,2,20,20
1714648048922,MCWP 50R,C00,518793,Staff,0,2,20,20
1714648048922,MCWP 50R,D00,518794,Staff,0,1,20,20
1714648048922,MCWP 50R,E00,518795,Staff,0,2,20,20
1714648048922,MCWP 50R,F00,518796,Staff,0,0,20,20
1714648048922,MCWP 50R,G00,518797,Staff,0,1,20,20
1714648049949,MMW 12R,A01,514034,Herbst; Matthew,0,0,16,16
1714648049949,MMW 12R,A02,514035,Herbst; Matthew,1,0,16,15
1714648050974,MMW 13R,A01,514037,Staff,0,4,16,16
1714648050974,MMW 13R,A02,514039,Staff,0,2,16,16
1714648050974,MMW 13R,A03,628519,Staff,0,2,16,16
1714648053031,SIO 295LS,A00,523233,Staff,10,0,30,20
1714648054054,SIO 295S,A00,523232,Staff,10,0,30,20
1714648055080,SIOC 290S,A01,637330,Merrifield; Mark A,23,0,30,7
1714648056109,SIOC 291S,A01,637333,Gabriel; Corey John,23,0,30,7
1714648057136,SOCI 117,A01,494376,Staff,0,4,5,5
1714648058167,WES 237B,A00,494380,Staff,9,0,20,11
1714648060248,AESE 279B,A00,494370,Wade; Jon P,0,0,33,33
1714648061273,AIP 197,001,627712,Vespa; Emanuel Ignacio,9998,0,9999,1
1714648062298,ANAR 135S,A00,494369,Braswell; Geoffrey E.,0,0,0,0
1714648063323,BENG 196,001,628496,Engler; Adam J.,9998,0,9999,1
1714648064353,CAT 124RS,A01,519847,Geibel; William,0,0,20,20
1714648065382,CAT 125RS,A01,515971,Geibel; William,0,0,20,20
1714648066406,CLRE 250,A00,511389,Morris; Sheldon,9993,0,9999,6
1714648067433,CLRE 251,A00,507176,Mehta; Ravindra L.,9993,0,9999,6
1714648067433,CLRE 251,B00,511410,Mehta; Ravindra L.,9998,0,9999,1
1714648068457,CLRE 252,A00,507189,Cuomo; Raphael Eduardo,9995,0,9999,4
1714648069481,CLRE 253,A00,507199,Vaida; Florin,9994,0,9999,5
1714648069481,CLRE 253,B00,507202,Vaida; Florin,9999,0,9999,0
1714648070506,CLRE 259,A00,507211,Patel; Hemal,9996,0,9999,3
1714648071535,CLRE 260,A00,507221,Cuomo; Raphael Eduardo,9999,0,9999,0
1714648072559,CLRE 297,001,507242,Cuomo; Raphael Eduardo,9999,0,9999,0
1714648073589,COGS 197,001,638244,Voytek; Bradley Thomas,9998,0,9999,1
1714648074617,CSE 191,A00,516875,Minnes Kemp; Mor Mia,9992,0,9999,7
1714648075641,CSE 197,001,637388,Minnes Kemp; Mor Mia,9998,0,9999,1
1714648076668,CSS 201S,A01,494383,Staff,35,0,35,0
1714648077700,CSS 202S,A01,494387,Staff,35,0,35,0
1714648078725,DSC 197,001,628532,Eldridge; Justin Matthew,9996,0,9999,3
1714648079750,EAP 100,A00,516065,Staff,9797,0,9999,202
1714648080781,ECE 45,A01,507414,Staff,33,0,60,27
1714648082833,ECE 111,A01,507420,Staff,15,0,50,35
1714648083859,ECE 197,001,548057,Sievenpiper; Daniel F.,9993,0,9999,6
1714648084893,EDS 115,A00,507243,Choi; Bailey Miyeon,10,0,28,18
1714648085919,EDS 117,A01,494379,Staff,0,4,30,30
1714648086945,EDS 125,A00,507246,Hopkins; Megan Beth,9,0,30,21
1714648087973,EDS 128A,A01,507264,Fargason; Sharon Gayle,8,0,26,18
1714648089005,EDS 128B,A01,507293,Pappas; Elizabeth,12,0,30,18
1714648090029,EDS 139,A00,507294,Fargason; Sharon Gayle,13,0,30,17
1714648090029,EDS 139,B00,507313,Pappas; Elizabeth,13,0,30,17
1714648091054,EDS 201,A00,507315,Staff,13,0,30,17
1714648092079,EDS 203,A01,507317,Halter; Christopher P.,12,0,30,18
1714648093104,EDS 204R,A01,507319,Halter; Christopher P.,0,3,30,30
1714648093104,EDS 204R,B01,507331,Heinzman; Erica M.,16,0,30,14
1714648094129,EDS 206R,A00,507332,Staff,0,4,30,30
1714648094129,EDS 206R,B00,507343,Staff,17,0,30,13
1714648095159,EDS 250,A00,507344,Hemans; Patricia Ann Benitez,22,0,40,18
1714648096189,EDS 281,A00,507345,Daly; Alan J.,18,0,18,0
1714648097215,EDS 284,A00,507350,Daly; Alan J.,16,0,16,0
1714648098245,EDS 286,A00,507359,Fine; Sarah,18,0,18,0
1714648099274,EDS 289C,A01,507361,Daly; Alan J.,18,0,18,0
1714648100303,EDS 290,A00,507366,Hofstetter; Carolyn,15,0,15,0
1714648101331,LIGM 5A,A00,507421,Fischer-Grunski; Eva K,18,0,20,2
1714648102360,LIGM 5B,A00,507423,Fischer-Grunski; Eva K,19,0,20,1
1714648103387,LIGM 5C,A00,507425,Fischer-Grunski; Eva K,19,0,20,1
1714648104421,LIIT 5AS,A00,507427,Carnelos; Chiara,20,0,20,0
1714648105451,LIIT 5BS,A00,507430,Carnelos; Chiara,20,0,20,0
1714648106481,LIIT 5CS,A00,507432,Carnelos; Chiara,20,0,20,0
1714648107508,LISP 5A,A00,507541,Munoz Sanchez; Alicia,11,0,20,9
1714648108532,LISP 5B,A00,507671,Munoz Sanchez; Alicia,8,0,20,12
1714648109557,LISP 5C,A00,507696,Munoz Sanchez; Alicia,9,0,20,11
1714648110638,MAE 197,001,528363,Boechler; Nicholas Sebastia,9998,0,9999,1
1714648111667,MATH 197,001,523477,Kedlaya; Kiran S.,9995,0,9999,4
1714648111667,MATH 197,002,563811,Zhang; Danna,9995,0,9999,4
1714648111667,MATH 197,003,628552,Dumitriu; Ioana,9998,0,9999,1
1714648112694,MCWP 40R,A00,518780,Staff,2,0,20,18
1714648112694,MCWP 40R,B00,518781,Staff,8,0,20,12
1714648112694,MCWP 40R,C00,518783,Staff,6,0,20,14
1714648113719,MCWP 50R,A00,518791,Staff,0,0,20,20
1714648113719,MCWP 50R,B00,518792,Staff,0,2,20,20
1714648113719,MCWP 50R,C00,518793,Staff,0,2,20,20
1714648113719,MCWP 50R,D00,518794,Staff,0,1,20,20
1714648113719,MCWP 50R,E00,518795,Staff,0,2,20,20
1714648113719,MCWP 50R,F00,518796,Staff,0,0,20,20
1714648113719,MCWP 50R,G00,518797,Staff,0,1,20,20
1714648114746,MMW 12R,A01,514034,Herbst; Matthew,0,0,16,16
1714648114746,MMW 12R,A02,514035,Herbst; Matthew,1,0,16,15
1714648115773,MMW 13R,A01,514037,Staff,0,4,16,16
1714648115773,MMW 13R,A02,514039,Staff,0,2,16,16
1714648115773,MMW 13R,A03,628519,Staff,0,2,16,16
1714648117824,SIO 295LS,A00,523233,Staff,10,0,30,20
1714648118848,SIO 295S,A00,523232,Staff,10,0,30,20
1714648119874,SIOC 290S,A01,637330,Merrifield; Mark A,23,0,30,7
1714648120904,SIOC 291S,A01,637333,Gabriel; Corey John,23,0,30,7
1714648121934,SOCI 117,A01,494376,Staff,0,4,5,5
1714648122962,WES 237B,A00,494380,Staff,9,0,20,11
1714648125055,AESE 279B,A00,494370,Wade; Jon P,0,0,33,33
1714648126087,AIP 197,001,627712,Vespa; Emanuel Ignacio,9998,0,9999,1
1714648127117,ANAR 135S,A00,494369,Braswell; Geoffrey E.,0,0,0,0
1714648128148,BENG 196,001,628496,Engler; Adam J.,9998,0,9999,1
1714648129175,CAT 124RS,A01,519847,Geibel; William,0,0,20,20
1714648130201,CAT 125RS,A01,515971,Geibel; William,0,0,20,20
1714648131233,CLRE 250,A00,511389,Morris; Sheldon,9993,0,9999,6
1714648132260,CLRE 251,A00,507176,Mehta; Ravindra L.,9993,0,9999,6
1714648132260,CLRE 251,B00,511410,Mehta; Ravindra L.,9998,0,9999,1
1714648133289,CLRE 252,A00,507189,Cuomo; Raphael Eduardo,9995,0,9999,4
1714648134320,CLRE 253,A00,507199,Vaida; Florin,9994,0,9999,5
1714648134320,CLRE 253,B00,507202,Vaida; Florin,9999,0,9999,0
1714648135346,CLRE 259,A00,507211,Patel; Hemal,9996,0,9999,3
1714648136371,CLRE 260,A00,507221,Cuomo; Raphael Eduardo,9999,0,9999,0
1714648137398,CLRE 297,001,507242,Cuomo; Raphael Eduardo,9999,0,9999,0
1714648138422,COGS 197,001,638244,Voytek; Bradley Thomas,9998,0,9999,1
1714648139447,CSE 191,A00,516875,Minnes Kemp; Mor Mia,9992,0,9999,7
1714648140473,CSE 197,001,637388,Minnes Kemp; Mor Mia,9998,0,9999,1
1714648141501,CSS 201S,A01,494383,Staff,35,0,35,0
1714648142527,CSS 202S,A01,494387,Staff,35,0,35,0
1714648143554,DSC 197,001,628532,Eldridge; Justin Matthew,9996,0,9999,3
1714648144578,EAP 100,A00,516065,Staff,9797,0,9999,202
1714648145610,ECE 45,A01,507414,Staff,33,0,60,27
1714648147663,ECE 111,A01,507420,Staff,15,0,50,35
1714648148689,ECE 197,001,548057,Sievenpiper; Daniel F.,9993,0,9999,6
1714648149722,EDS 115,A00,507243,Choi; Bailey Miyeon,10,0,28,18
1714648150747,EDS 117,A01,494379,Staff,0,4,30,30
1714648151779,EDS 125,A00,507246,Hopkins; Megan Beth,9,0,30,21
1714648152810,EDS 128A,A01,507264,Fargason; Sharon Gayle,8,0,26,18
1714648153839,EDS 128B,A01,507293,Pappas; Elizabeth,12,0,30,18
1714648154863,EDS 139,A00,507294,Fargason; Sharon Gayle,13,0,30,17
1714648154863,EDS 139,B00,507313,Pappas; Elizabeth,13,0,30,17
1714648155890,EDS 201,A00,507315,Staff,13,0,30,17
1714648156915,EDS 203,A01,507317,Halter; Christopher P.,12,0,30,18
1714648157940,EDS 204R,A01,507319,Halter; Christopher P.,0,3,30,30
1714648157940,EDS 204R,B01,507331,Heinzman; Erica M.,16,0,30,14
1714648158966,EDS 206R,A00,507332,Staff,0,4,30,30
1714648158966,EDS 206R,B00,507343,Staff,17,0,30,13
1714648159991,EDS 250,A00,507344,Hemans; Patricia Ann Benitez,22,0,40,18
1714648161017,EDS 281,A00,507345,Daly; Alan J.,18,0,18,0
1714648162045,EDS 284,A00,507350,Daly; Alan J.,16,0,16,0
1714648163071,EDS 286,A00,507359,Fine; Sarah,18,0,18,0
1714648164097,EDS 289C,A01,507361,Daly; Alan J.,18,0,18,0
1714648165128,EDS 290,A00,507366,Hofstetter; Carolyn,15,0,15,0
1714648166158,LIGM 5A,A00,507421,Fischer-Grunski; Eva K,18,0,20,2
1714648167187,LIGM 5B,A00,507423,Fischer-Grunski; Eva K,19,0,20,1
1714648168213,LIGM 5C,A00,507425,Fischer-Grunski; Eva K,19,0,20,1
1714648169242,LIIT 5AS,A00,507427,Carnelos; Chiara,20,0,20,0
1714648170268,LIIT 5BS,A00,507430,Carnelos; Chiara,20,0,20,0
1714648171293,LIIT 5CS,A00,507432,Carnelos; Chiara,20,0,20,0
1714648172319,LISP 5A,A00,507541,Munoz Sanchez; Alicia,11,0,20,9
1714648173344,LISP 5B,A00,507671,Munoz Sanchez; Alicia,8,0,20,12
1714648174374,LISP 5C,A00,507696,Munoz Sanchez; Alicia,9,0,20,11
1714648175400,MAE 197,001,528363,Boechler; Nicholas Sebastia,9998,0,9999,1
1714648176428,MATH 197,001,523477,Kedlaya; Kiran S.,9995,0,9999,4
1714648176428,MATH 197,002,563811,Zhang; Danna,9995,0,9999,4
1714648176428,MATH 197,003,628552,Dumitriu; Ioana,9998,0,9999,1
1714648177452,MCWP 40R,A00,518780,Staff,2,0,20,18
1714648177452,MCWP 40R,B00,518781,Staff,8,0,20,12
1714648177452,MCWP 40R,C00,518783,Staff,6,0,20,14
1714648178484,MCWP 50R,A00,518791,Staff,0,0,20,20
1714648178484,MCWP 50R,B00,518792,Staff,0,2,20,20
1714648178484,MCWP 50R,C00,518793,Staff,0,2,20,20
1714648178484,MCWP 50R,D00,518794,Staff,0,1,20,20
1714648178484,MCWP 50R,E00,518795,Staff,0,2,20,20
1714648178484,MCWP 50R,F00,518796,Staff,0,0,20,20
1714648178484,MCWP 50R,G00,518797,Staff,0,1,20,20
1714648179509,MMW 12R,A01,514034,Herbst; Matthew,0,0,16,16
1714648179509,MMW 12R,A02,514035,Herbst; Matthew,1,0,16,15
1714648180535,MMW 13R,A01,514037,Staff,0,4,16,16
1714648180535,MMW 13R,A02,514039,Staff,0,2,16,16
1714648180535,MMW 13R,A03,628519,Staff,0,2,16,16
1714648182593,SIO 295LS,A00,523233,Staff,10,0,30,20
1714648183617,SIO 295S,A00,523232,Staff,10,0,30,20
1714648184648,SIOC 290S,A01,637330,Merrifield; Mark A,23,0,30,7
1714648185678,SIOC 291S,A01,637333,Gabriel; Corey John,23,0,30,7
1714648186708,SOCI 117,A01,494376,Staff,0,4,5,5
1714648187733,WES 237B,A00,494380,Staff,9,0,20,11
1714648189840,AESE 279B,A00,494370,Wade; Jon P,0,0,33,33
1714648190868,AIP 197,001,627712,Vespa; Emanuel Ignacio,9998,0,9999,1
1714648191893,ANAR 135S,A00,494369,Braswell; Geoffrey E.,0,0,0,0
1714648192922,BENG 196,001,628496,Engler; Adam J.,9998,0,9999,1
1714648193947,CAT 124RS,A01,519847,Geibel; William,0,0,20,20
1714648194974,CAT 125RS,A01,515971,Geibel; William,0,0,20,20
1714648196002,CLRE 250,A00,511389,Morris; Sheldon,9993,0,9999,6
1714648197038,CLRE 251,A00,507176,Mehta; Ravindra L.,9993,0,9999,6
1714648197038,CLRE 251,B00,511410,Mehta; Ravindra L.,9998,0,9999,1
1714648198064,CLRE 252,A00,507189,Cuomo; Raphael Eduardo,9995,0,9999,4
1714648199089,CLRE 253,A00,507199,Vaida; Florin,9994,0,9999,5
1714648199089,CLRE 253,B00,507202,Vaida; Florin,9999,0,9999,0
1714648200115,CLRE 259,A00,507211,Patel; Hemal,9996,0,9999,3
1714648201140,CLRE 260,A00,507221,Cuomo; Raphael Eduardo,9999,0,9999,0
1714648202169,CLRE 297,001,507242,Cuomo; Raphael Eduardo,9999,0,9999,0
1714648203196,COGS 197,001,638244,Voytek; Bradley Thomas,9998,0,9999,1
1714648204226,CSE 191,A00,516875,Minnes Kemp; Mor Mia,9992,0,9999,7
1714648205252,CSE 197,001,637388,Minnes Kemp; Mor Mia,9998,0,9999,1
1714648206286,CSS 201S,A01,494383,Staff,35,0,35,0
1714648207317,CSS 202S,A01,494387,Staff,35,0,35,0
1714648208342,DSC 197,001,628532,Eldridge; Justin Matthew,9996,0,9999,3
1714648209369,EAP 100,A00,516065,Staff,9797,0,9999,202
1714648210395,ECE 45,A01,507414,Staff,33,0,60,27
1714648212447,ECE 111,A01,507420,Staff,15,0,50,35
1714648213480,ECE 197,001,548057,Sievenpiper; Daniel F.,9993,0,9999,6
1714648214509,EDS 115,A00,507243,Choi; Bailey Miyeon,10,0,28,18
1714648215537,EDS 117,A01,494379,Staff,0,4,30,30
1714648216571,EDS 125,A00,507246,Hopkins; Megan Beth,9,0,30,21
1714648217650,EDS 128A,A01,507264,Fargason; Sharon Gayle,8,0,26,18
1714648218674,EDS 128B,A01,507293,Pappas; Elizabeth,12,0,30,18
1714648219700,EDS 139,A00,507294,Fargason; Sharon Gayle,13,0,30,17
1714648219700,EDS 139,B00,507313,Pappas; Elizabeth,13,0,30,17
1714648220729,EDS 201,A00,507315,Staff,13,0,30,17
1714648221761,EDS 203,A01,507317,Halter; Christopher P.,12,0,30,18
1714648222788,EDS 204R,A01,507319,Halter; Christopher P.,0,3,30,30
1714648222788,EDS 204R,B01,507331,Heinzman; Erica M.,16,0,30,14
1714648223814,EDS 206R,A00,507332,Staff,0,4,30,30
1714648223814,EDS 206R,B00,507343,Staff,17,0,30,13
1714648224840,EDS 250,A00,507344,Hemans; Patricia Ann Benitez,22,0,40,18
1714648225869,EDS 281,A00,507345,Daly; Alan J.,18,0,18,0
1714648226898,EDS 284,A00,507350,Daly; Alan J.,16,0,16,0
1714648227924,EDS 286,A00,507359,Fine; Sarah,18,0,18,0
1714648228953,EDS 289C,A01,507361,Daly; Alan J.,18,0,18,0
1714648229983,EDS 290,A00,507366,Hofstetter; Carolyn,15,0,15,0
1714648231011,LIGM 5A,A00,507421,Fischer-Grunski; Eva K,18,0,20,2
1714648232037,LIGM 5B,A00,507423,Fischer-Grunski; Eva K,19,0,20,1
1714648233064,LIGM 5C,A00,507425,Fischer-Grunski; Eva K,19,0,20,1
1714648234090,LIIT 5AS,A00,507427,Carnelos; Chiara,20,0,20,0
1714648235118,LIIT 5BS,A00,507430,Carnelos; Chiara,20,0,20,0
1714648236148,LIIT 5CS,A00,507432,Carnelos; Chiara,20,0,20,0
1714648237173,LISP 5A,A00,507541,Munoz Sanchez; Alicia,11,0,20,9
1714648238199,LISP 5B,A00,507671,Munoz Sanchez; Alicia,8,0,20,12
1714648239229,LISP 5C,A00,507696,Munoz Sanchez; Alicia,9,0,20,11
1714648240256,MAE 197,001,528363,Boechler; Nicholas Sebastia,9998,0,9999,1
1714648241283,MATH 197,001,523477,Kedlaya; Kiran S.,9995,0,9999,4
1714648241283,MATH 197,002,563811,Zhang; Danna,9995,0,9999,4
1714648241283,MATH 197,003,628552,Dumitriu; Ioana,9998,0,9999,1
1714648242309,MCWP 40R,A00,518780,Staff,2,0,20,18
1714648242309,MCWP 40R,B00,518781,Staff,8,0,20,12
1714648242309,MCWP 40R,C00,518783,Staff,6,0,20,14
1714648243334,MCWP 50R,A00,518791,Staff,0,0,20,20
1714648243334,MCWP 50R,B00,518792,Staff,0,2,20,20
1714648243334,MCWP 50R,C00,518793,Staff,0,2,20,20
1714648243334,MCWP 50R,D00,518794,Staff,0,1,20,20
1714648243334,MCWP 50R,E00,518795,Staff,0,2,20,20
1714648243334,MCWP 50R,F00,518796,Staff,0,0,20,20
1714648243334,MCWP 50R,G00,518797,Staff,0,1,20,20
1714648244359,MMW 12R,A01,514034,Herbst; Matthew,0,0,16,16
1714648244359,MMW 12R,A02,514035,Herbst; Matthew,1,0,16,15
1714648245385,MMW 13R,A01,514037,Staff,0,4,16,16
1714648245385,MMW 13R,A02,514039,Staff,0,2,16,16
1714648245385,MMW 13R,A03,628519,Staff,0,2,16,16
1714648247437,SIO 295LS,A00,523233,Staff,10,0,30,20
1714648248466,SIO 295S,A00,523232,Staff,10,0,30,20
1714648249492,SIOC 290S,A01,637330,Merrifield; Mark A,23,0,30,7
1714648250517,SIOC 291S,A01,637333,Gabriel; Corey John,23,0,30,7
1714648251543,SOCI 117,A01,494376,Staff,0,4,5,5
1714648252567,WES 237B,A00,494380,Staff,9,0,20,11
1714648254645,AESE 279B,A00,494370,Wade; Jon P,0,0,33,33
1714648255669,AIP 197,001,627712,Vespa; Emanuel Ignacio,9998,0,9999,1
1714648256694,ANAR 135S,A00,494369,Braswell; Geoffrey E.,0,0,0,0
1714648257722,BENG 196,001,628496,Engler; Adam J.,9998,0,9999,1
1714648258752,CAT 124RS,A01,519847,Geibel; William,0,0,20,20
1714648259777,CAT 125RS,A01,515971,Geibel; William,0,0,20,20
1714648260803,CLRE 250,A00,511389,Morris; Sheldon,9993,0,9999,6
1714648261842,CLRE 251,A00,507176,Mehta; Ravindra L.,9993,0,9999,6
1714648261842,CLRE 251,B00,511410,Mehta; Ravindra L.,9998,0,9999,1
1714648262868,CLRE 252,A00,507189,Cuomo; Raphael Eduardo,9995,0,9999,4
1714648263904,CLRE 253,A00,507199,Vaida; Florin,9994,0,9999,5
1714648263904,CLRE 253,B00,507202,Vaida; Florin,9999,0,9999,0
1714648264929,CLRE 259,A00,507211,Patel; Hemal,9996,0,9999,3
1714648265953,CLRE 260,A00,507221,Cuomo; Raphael Eduardo,9999,0,9999,0
1714648266981,CLRE 297,001,507242,Cuomo; Raphael Eduardo,9999,0,9999,0
1714648268011,COGS 197,001,638244,Voytek; Bradley Thomas,9998,0,9999,1
1714648269035,CSE 191,A00,516875,Minnes Kemp; Mor Mia,9992,0,9999,7
1714648270058,CSE 197,001,637388,Minnes Kemp; Mor Mia,9998,0,9999,1
1714648271137,CSS 201S,A01,494383,Staff,35,0,35,0
1714648272174,CSS 202S,A01,494387,Staff,35,0,35,0
1714648273203,DSC 197,001,628532,Eldridge; Justin Matthew,9996,0,9999,3
1714648274231,EAP 100,A00,516065,Staff,9797,0,9999,202
1714648275256,ECE 45,A01,507414,Staff,33,0,60,27
1714648277309,ECE 111,A01,507420,Staff,15,0,50,35
1714648278335,ECE 197,001,548057,Sievenpiper; Daniel F.,9993,0,9999,6
1714648279365,EDS 115,A00,507243,Choi; Bailey Miyeon,10,0,28,18
1714648280394,EDS 117,A01,494379,Staff,0,4,30,30
1714648281420,EDS 125,A00,507246,Hopkins; Megan Beth,9,0,30,21
1714648282450,EDS 128A,A01,507264,Fargason; Sharon Gayle,8,0,26,18
1714648283476,EDS 128B,A01,507293,Pappas; Elizabeth,12,0,30,18
1714648284501,EDS 139,A00,507294,Fargason; Sharon Gayle,13,0,30,17
1714648284501,EDS 139,B00,507313,Pappas; Elizabeth,13,0,30,17
1714648285526,EDS 201,A00,507315,Staff,13,0,30,17
1714648286551,EDS 203,A01,507317,Halter; Christopher P.,12,0,30,18
1714648287579,EDS 204R,A01,507319,Halter; Christopher P.,0,3,30,30
1714648287579,EDS 204R,B01,507331,Heinzman; Erica M.,16,0,30,14
1714648288606,EDS 206R,A00,507332,Staff,0,4,30,30
1714648288606,EDS 206R,B00,507343,Staff,17,0,30,13
1714648289637,EDS 250,A00,507344,Hemans; Patricia Ann Benitez,22,0,40,18
1714648290665,EDS 281,A00,507345,Daly; Alan J.,18,0,18,0
1714648291689,EDS 284,A00,507350,Daly; Alan J.,16,0,16,0
1714648292714,EDS 286,A00,507359,Fine; Sarah,18,0,18,0
1714648293738,EDS 289C,A01,507361,Daly; Alan J.,18,0,18,0
1714648294766,EDS 290,A00,507366,Hofstetter; Carolyn,15,0,15,0
1714648295791,LIGM 5A,A00,507421,Fischer-Grunski; Eva K,18,0,20,2
1714648296818,LIGM 5B,A00,507423,Fischer-Grunski; Eva K,19,0,20,1
1714648297842,LIGM 5C,A00,507425,Fischer-Grunski; Eva K,19,0,20,1
1714648298871,LIIT 5AS,A00,507427,Carnelos; Chiara,20,0,20,0
1714648299899,LIIT 5BS,A00,507430,Carnelos; Chiara,20,0,20,0
1714648300925,LIIT 5CS,A00,507432,Carnelos; Chiara,20,0,20,0
1714648301956,LISP 5A,A00,507541,Munoz Sanchez; Alicia,11,0,20,9
1714648302981,LISP 5B,A00,507671,Munoz Sanchez; Alicia,8,0,20,12
1714648304008,LISP 5C,A00,507696,Munoz Sanchez; Alicia,9,0,20,11
1714648305034,MAE 197,001,528363,Boechler; Nicholas Sebastia,9998,0,9999,1
1714648306062,MATH 197,001,523477,Kedlaya; Kiran S.,9995,0,9999,4
1714648306062,MATH 197,002,563811,Zhang; Danna,9995,0,9999,4
1714648306062,MATH 197,003,628552,Dumitriu; Ioana,9998,0,9999,1
1714648307114,MCWP 40R,A00,518780,Staff,2,0,20,18
1714648307114,MCWP 40R,B00,518781,Staff,8,0,20,12
1714648307114,MCWP 40R,C00,518783,Staff,6,0,20,14
1714648308141,MCWP 50R,A00,518791,Staff,0,0,20,20
1714648308141,MCWP 50R,B00,518792,Staff,0,2,20,20
1714648308141,MCWP 50R,C00,518793,Staff,0,2,20,20
1714648308141,MCWP 50R,D00,518794,Staff,0,1,20,20
1714648308141,MCWP 50R,E00,518795,Staff,0,2,20,20
1714648308141,MCWP 50R,F00,518796,Staff,0,0,20,20
1714648308141,MCWP 50R,G00,518797,Staff,0,1,20,20
1714648309172,MMW 12R,A01,514034,Herbst; Matthew,0,0,16,16
1714648309172,MMW 12R,A02,514035,Herbst; Matthew,1,0,16,15
1714648310203,MMW 13R,A01,514037,Staff,0,4,16,16
1714648310203,MMW 13R,A02,514039,Staff,0,2,16,16
1714648310203,MMW 13R,A03,628519,Staff,0,2,16,16
1714648312273,SIO 295LS,A00,523233,Staff,10,0,30,20
1714648313299,SIO 295S,A00,523232,Staff,10,0,30,20
1714648314325,SIOC 290S,A01,637330,Merrifield; Mark A,23,0,30,7
1714648315356,SIOC 291S,A01,637333,Gabriel; Corey John,23,0,30,7
1714648316381,SOCI 117,A01,494376,Staff,0,4,5,5
1714648317405,WES 237B,A00,494380,Staff,9,0,20,11
1714648319485,AESE 279B,A00,494370,Wade; Jon P,0,0,33,33
1714648320510,AIP 197,001,627712,Vespa; Emanuel Ignacio,9998,0,9999,1
1714648321534,ANAR 135S,A00,494369,Braswell; Geoffrey E.,0,0,0,0
1714648322561,BENG 196,001,628496,Engler; Adam J.,9998,0,9999,1
1714648323587,CAT 124RS,A01,519847,Geibel; William,0,0,20,20
1714648324615,CAT 125RS,A01,515971,Geibel; William,0,0,20,20
1714648325645,CLRE 250,A00,511389,Morris; Sheldon,9993,0,9999,6
1714648326673,CLRE 251,A00,507176,Mehta; Ravindra L.,9993,0,9999,6
1714648326673,CLRE 251,B00,511410,Mehta; Ravindra L.,9998,0,9999,1
1714648327697,CLRE 252,A00,507189,Cuomo; Raphael Eduardo,9995,0,9999,4
1714648328728,CLRE 253,A00,507199,Vaida; Florin,9994,0,9999,5
1714648328728,CLRE 253,B00,507202,Vaida; Florin,9999,0,9999,0
1714648329757,CLRE 259,A00,507211,Patel; Hemal,9996,0,9999,3
1714648330783,CLRE 260,A00,507221,Cuomo; Raphael Eduardo,9999,0,9999,0
1714648331808,CLRE 297,001,507242,Cuomo; Raphael Eduardo,9999,0,9999,0
1714648332834,COGS 197,001,638244,Voytek; Bradley Thomas,9998,0,9999,1
1714648333875,CSE 191,A00,516875,Minnes Kemp; Mor Mia,9992,0,9999,7
1714648334900,CSE 197,001,637388,Minnes Kemp; Mor Mia,9998,0,9999,1
1714648335926,CSS 201S,A01,494383,Staff,35,0,35,0
1714648336956,CSS 202S,A01,494387,Staff,35,0,35,0
1714648337987,DSC 197,001,628532,Eldridge; Justin Matthew,9996,0,9999,3
1714648339011,EAP 100,A00,516065,Staff,9797,0,9999,202
1714648340036,ECE 45,A01,507414,Staff,33,0,60,27
1714648342091,ECE 111,A01,507420,Staff,15,0,50,35
1714648343117,ECE 197,001,548057,Sievenpiper; Daniel F.,9993,0,9999,6
1714648344143,EDS 115,A00,507243,Choi; Bailey Miyeon,10,0,28,18
1714648345170,EDS 117,A01,494379,Staff,0,4,30,30
1714648346196,EDS 125,A00,507246,Hopkins; Megan Beth,9,0,30,21
1714648347227,EDS 128A,A01,507264,Fargason; Sharon Gayle,8,0,26,18
1714648348253,EDS 128B,A01,507293,Pappas; Elizabeth,12,0,30,18
1714648349277,EDS 139,A00,507294,Fargason; Sharon Gayle,13,0,30,17
1714648349277,EDS 139,B00,507313,Pappas; Elizabeth,13,0,30,17
1714648350305,EDS 201,A00,507315,Staff,13,0,30,17
1714648351331,EDS 203,A01,507317,Halter; Christopher P.,12,0,30,18
1714648352360,EDS 204R,A01,507319,Halter; Christopher P.,0,3,30,30
1714648352360,EDS 204R,B01,507331,Heinzman; Erica M.,16,0,30,14
1714648353385,EDS 206R,A00,507332,Staff,0,4,30,30
1714648353385,EDS 206R,B00,507343,Staff,17,0,30,13
1714648354410,EDS 250,A00,507344,Hemans; Patricia Ann Benitez,22,0,40,18
1714648355436,EDS 281,A00,507345,Daly; Alan J.,18,0,18,0
1714648356460,EDS 284,A00,507350,Daly; Alan J.,16,0,16,0
1714648357485,EDS 286,A00,507359,Fine; Sarah,18,0,18,0
1714648358511,EDS 289C,A01,507361,Daly; Alan J.,18,0,18,0
1714648359541,EDS 290,A00,507366,Hofstetter; Carolyn,15,0,15,0
1714648360567,LIGM 5A,A00,507421,Fischer-Grunski; Eva K,18,0,20,2
1714648361596,LIGM 5B,A00,507423,Fischer-Grunski; Eva K,19,0,20,1
1714648362620,LIGM 5C,A00,507425,Fischer-Grunski; Eva K,19,0,20,1
1714648363647,LIIT 5AS,A00,507427,Carnelos; Chiara,20,0,20,0
1714648364675,LIIT 5BS,A00,507430,Carnelos; Chiara,20,0,20,0
1714648365702,LIIT 5CS,A00,507432,Carnelos; Chiara,20,0,20,0
1714648366729,LISP 5A,A00,507541,Munoz Sanchez; Alicia,11,0,20,9
1714648367753,LISP 5B,A00,507671,Munoz Sanchez; Alicia,8,0,20,12
1714648368782,LISP 5C,A00,507696,Munoz Sanchez; Alicia,9,0,20,11
1714648369814,MAE 197,001,528363,Boechler; Nicholas Sebastia,9998,0,9999,1
1714648370841,MATH 197,001,523477,Kedlaya; Kiran S.,9995,0,9999,4
1714648370841,MATH 197,002,563811,Zhang; Danna,9995,0,9999,4
1714648370841,MATH 197,003,628552,Dumitriu; Ioana,9998,0,9999,1
1714648371868,MCWP 40R,A00,518780,Staff,2,0,20,18
1714648371868,MCWP 40R,B00,518781,Staff,8,0,20,12
1714648371868,MCWP 40R,C00,518783,Staff,6,0,20,14
1714648372895,MCWP 50R,A00,518791,Staff,0,0,20,20
1714648372895,MCWP 50R,B00,518792,Staff,0,2,20,20
1714648372895,MCWP 50R,C00,518793,Staff,0,2,20,20
1714648372895,MCWP 50R,D00,518794,Staff,0,1,20,20
1714648372895,MCWP 50R,E00,518795,Staff,0,2,20,20
1714648372895,MCWP 50R,F00,518796,Staff,0,0,20,20
1714648372895,MCWP 50R,G00,518797,Staff,0,1,20,20
1714648373922,MMW 12R,A01,514034,Herbst; Matthew,0,0,16,16
1714648373922,MMW 12R,A02,514035,Herbst; Matthew,1,0,16,15
1714648374949,MMW 13R,A01,514037,Staff,0,4,16,16
1714648374949,MMW 13R,A02,514039,Staff,0,2,16,16
1714648374949,MMW 13R,A03,628519,Staff,0,2,16,16
1714648377023,SIO 295LS,A00,523233,Staff,10,0,30,20
1714648378050,SIO 295S,A00,523232,Staff,10,0,30,20
1714648379080,SIOC 290S,A01,637330,Merrifield; Mark A,23,0,30,7
1714648380108,SIOC 291S,A01,637333,Gabriel; Corey John,23,0,30,7
1714648381138,SOCI 117,A01,494376,Staff,0,4,5,5
1714648382165,WES 237B,A00,494380,Staff,9,0,20,11
1714648384244,AESE 279B,A00,494370,Wade; Jon P,0,0,33,33
1714648385273,AIP 197,001,627712,Vespa; Emanuel Ignacio,9998,0,9999,1
1714648386298,ANAR 135S,A00,494369,Braswell; Geoffrey E.,0,0,0,0
1714648387323,BENG 196,001,628496,Engler; Adam J.,9998,0,9999,1
1714648388349,CAT 124RS,A01,519847,Geibel; William,0,0,20,20
1714648389374,CAT 125RS,A01,515971,Geibel; William,0,0,20,20
1714648390398,CLRE 250,A00,511389,Morris; Sheldon,9993,0,9999,6
1714648391427,CLRE 251,A00,507176,Mehta; Ravindra L.,9993,0,9999,6
1714648391427,CLRE 251,B00,511410,Mehta; Ravindra L.,9998,0,9999,1
1714648392451,CLRE 252,A00,507189,Cuomo; Raphael Eduardo,9995,0,9999,4
1714648393480,CLRE 253,A00,507199,Vaida; Florin,9994,0,9999,5
1714648393480,CLRE 253,B00,507202,Vaida; Florin,9999,0,9999,0
1714648394506,CLRE 259,A00,507211,Patel; Hemal,9996,0,9999,3
1714648395531,CLRE 260,A00,507221,Cuomo; Raphael Eduardo,9999,0,9999,0
1714648396559,CLRE 297,001,507242,Cuomo; Raphael Eduardo,9999,0,9999,0
1714648397587,COGS 197,001,638244,Voytek; Bradley Thomas,9998,0,9999,1
1714648398611,CSE 191,A00,516875,Minnes Kemp; Mor Mia,9992,0,9999,7
1714648399636,CSE 197,001,637388,Minnes Kemp; Mor Mia,9998,0,9999,1
1714648400662,CSS 201S,A01,494383,Staff,35,0,35,0
1714648401693,CSS 202S,A01,494387,Staff,35,0,35,0
1714648402720,DSC 197,001,628532,Eldridge; Justin Matthew,9996,0,9999,3
1714648403745,EAP 100,A00,516065,Staff,9797,0,9999,202
1714648404774,ECE 45,A01,507414,Staff,33,0,60,27
1714648406832,ECE 111,A01,507420,Staff,15,0,50,35
1714648407858,ECE 197,001,548057,Sievenpiper; Daniel F.,9993,0,9999,6
1714648408888,EDS 115,A00,507243,Choi; Bailey Miyeon,10,0,28,18
1714648409920,EDS 117,A01,494379,Staff,0,4,30,30
1714648410951,EDS 125,A00,507246,Hopkins; Megan Beth,9,0,30,21
1714648411978,EDS 128A,A01,507264,Fargason; Sharon Gayle,8,0,26,18
1714648413008,EDS 128B,A01,507293,Pappas; Elizabeth,12,0,30,18
1714648414034,EDS 139,A00,507294,Fargason; Sharon Gayle,13,0,30,17
1714648414034,EDS 139,B00,507313,Pappas; Elizabeth,13,0,30,17
1714648415061,EDS 201,A00,507315,Staff,13,0,30,17
1714648416087,EDS 203,A01,507317,Halter; Christopher P.,12,0,30,18
1714648417113,EDS 204R,A01,507319,Halter; Christopher P.,0,3,30,30
1714648417113,EDS 204R,B01,507331,Heinzman; Erica M.,16,0,30,14
1714648418138,EDS 206R,A00,507332,Staff,0,4,30,30
1714648418138,EDS 206R,B00,507343,Staff,17,0,30,13
1714648419163,EDS 250,A00,507344,Hemans; Patricia Ann Benitez,22,0,40,18
1714648420188,EDS 281,A00,507345,Daly; Alan J.,18,0,18,0
1714648421214,EDS 284,A00,507350,Daly; Alan J.,16,0,16,0
1714648422238,EDS 286,A00,507359,Fine; Sarah,18,0,18,0
1714648423264,EDS 289C,A01,507361,Daly; Alan J.,18,0,18,0
1714648424294,EDS 290,A00,507366,Hofstetter; Carolyn,15,0,15,0
1714648425320,LIGM 5A,A00,507421,Fischer-Grunski; Eva K,18,0,20,2
1714648426348,LIGM 5B,A00,507423,Fischer-Grunski; Eva K,19,0,20,1
1714648427373,LIGM 5C,A00,507425,Fischer-Grunski; Eva K,19,0,20,1
1714648428401,LIIT 5AS,A00,507427,Carnelos; Chiara,20,0,20,0
1714648429427,LIIT 5BS,A00,507430,Carnelos; Chiara,20,0,20,0
1714648430456,LIIT 5CS,A00,507432,Carnelos; Chiara,20,0,20,0
1714648431483,LISP 5A,A00,507541,Munoz Sanchez; Alicia,11,0,20,9
1714648432510,LISP 5B,A00,507671,Munoz Sanchez; Alicia,8,0,20,12
1714648433535,LISP 5C,A00,507696,Munoz Sanchez; Alicia,9,0,20,11
1714648434565,MAE 197,001,528363,Boechler; Nicholas Sebastia,9998,0,9999,1
1714648435599,MATH 197,001,523477,Kedlaya; Kiran S.,9995,0,9999,4
1714648435599,MATH 197,002,563811,Zhang; Danna,9995,0,9999,4
1714648435599,MATH 197,003,628552,Dumitriu; Ioana,9998,0,9999,1
1714648436629,MCWP 40R,A00,518780,Staff,2,0,20,18
1714648436629,MCWP 40R,B00,518781,Staff,8,0,20,12
1714648436629,MCWP 40R,C00,518783,Staff,6,0,20,14
1714648437661,MCWP 50R,A00,518791,Staff,0,0,20,20
1714648437661,MCWP 50R,B00,518792,Staff,0,2,20,20
1714648437661,MCWP 50R,C00,518793,Staff,0,2,20,20
1714648437661,MCWP 50R,D00,518794,Staff,0,1,20,20
1714648437661,MCWP 50R,E00,518795,Staff,0,2,20,20
1714648437661,MCWP 50R,F00,518796,Staff,0,0,20,20
1714648437661,MCWP 50R,G00,518797,Staff,0,1,20,20
1714648438692,MMW 12R,A01,514034,Herbst; Matthew,0,0,16,16
1714648438692,MMW 12R,A02,514035,Herbst; Matthew,1,0,16,15
1714648439718,MMW 13R,A01,514037,Staff,0,4,16,16
1714648439718,MMW 13R,A02,514039,Staff,0,2,16,16
1714648439718,MMW 13R,A03,628519,Staff,0,2,16,16
1714648441784,SIO 295LS,A00,523233,Staff,10,0,30,20
1714648442809,SIO 295S,A00,523232,Staff,10,0,30,20
1714648443836,SIOC 290S,A01,637330,Merrifield; Mark A,23,0,30,7
1714648444867,SIOC 291S,A01,637333,Gabriel; Corey John,23,0,30,7
1714648445893,SOCI 117,A01,494376,Staff,0,4,5,5
1714648446918,WES 237B,A00,494380,Staff,9,0,20,11
1714648448991,AESE 279B,A00,494370,Wade; Jon P,0,0,33,33
1714648450021,AIP 197,001,627712,Vespa; Emanuel Ignacio,9998,0,9999,1
1714648451051,ANAR 135S,A00,494369,Braswell; Geoffrey E.,0,0,0,0
1714648452076,BENG 196,001,628496,Engler; Adam J.,9998,0,9999,1
1714648453106,CAT 124RS,A01,519847,Geibel; William,0,0,20,20
1714648454130,CAT 125RS,A01,515971,Geibel; William,0,0,20,20
1714648455154,CLRE 250,A00,511389,Morris; Sheldon,9993,0,9999,6
1714648456180,CLRE 251,A00,507176,Mehta; Ravindra L.,9993,0,9999,6
1714648456180,CLRE 251,B00,511410,Mehta; Ravindra L.,9998,0,9999,1
1714648457205,CLRE 252,A00,507189,Cuomo; Raphael Eduardo,9995,0,9999,4
1714648458230,CLRE 253,A00,507199,Vaida; Florin,9994,0,9999,5
1714648458230,CLRE 253,B00,507202,Vaida; Florin,9999,0,9999,0
1714648459254,CLRE 259,A00,507211,Patel; Hemal,9996,0,9999,3
1714648460280,CLRE 260,A00,507221,Cuomo; Raphael Eduardo,9999,0,9999,0
1714648461305,CLRE 297,001,507242,Cuomo; Raphael Eduardo,9999,0,9999,0
1714648462362,COGS 197,001,638244,Voytek; Bradley Thomas,9998,0,9999,1
1714648463390,CSE 191,A00,516875,Minnes Kemp; Mor Mia,9992,0,9999,7
1714648464415,CSE 197,001,637388,Minnes Kemp; Mor Mia,9998,0,9999,1
1714648465446,CSS 201S,A01,494383,Staff,35,0,35,0
1714648466471,CSS 202S,A01,494387,Staff,35,0,35,0
1714648467496,DSC 197,001,628532,Eldridge; Justin Matthew,9996,0,9999,3
1714648468521,EAP 100,A00,516065,Staff,9797,0,9999,202
1714648469553,ECE 45,A01,507414,Staff,33,0,60,27
1714648471606,ECE 111,A01,507420,Staff,15,0,50,35
1714648472632,ECE 197,001,548057,Sievenpiper; Daniel F.,9993,0,9999,6
1714648473664,EDS 115,A00,507243,Choi; Bailey Miyeon,10,0,28,18
1714648474693,EDS 117,A01,494379,Staff,0,4,30,30
1714648475719,EDS 125,A00,507246,Hopkins; Megan Beth,9,0,30,21
1714648476744,EDS 128A,A01,507264,Fargason; Sharon Gayle,8,0,26,18
1714648477775,EDS 128B,A01,507293,Pappas; Elizabeth,12,0,30,18
1714648478802,EDS 139,A00,507294,Fargason; Sharon Gayle,13,0,30,17
1714648478802,EDS 139,B00,507313,Pappas; Elizabeth,13,0,30,17
1714648479831,EDS 201,A00,507315,Staff,13,0,30,17
1714648480855,EDS 203,A01,507317,Halter; Christopher P.,12,0,30,18
1714648481887,EDS 204R,A01,507319,Halter; Christopher P.,0,3,30,30
1714648481887,EDS 204R,B01,507331,Heinzman; Erica M.,16,0,30,14
1714648482912,EDS 206R,A00,507332,Staff,0,4,30,30
1714648482912,EDS 206R,B00,507343,Staff,17,0,30,13
1714648483941,EDS 250,A00,507344,Hemans; Patricia Ann Benitez,22,0,40,18
1714648484965,EDS 281,A00,507345,Daly; Alan J.,18,0,18,0
1714648485991,EDS 284,A00,507350,Daly; Alan J.,16,0,16,0
1714648487016,EDS 286,A00,507359,Fine; Sarah,18,0,18,0
1714648488040,EDS 289C,A01,507361,Daly; Alan J.,18,0,18,0
1714648489072,EDS 290,A00,507366,Hofstetter; Carolyn,15,0,15,0
1714648490103,LIGM 5A,A00,507421,Fischer-Grunski; Eva K,18,0,20,2
1714648491133,LIGM 5B,A00,507423,Fischer-Grunski; Eva K,19,0,20,1
1714648492161,LIGM 5C,A00,507425,Fischer-Grunski; Eva K,19,0,20,1
1714648493187,LIIT 5AS,A00,507427,Carnelos; Chiara,20,0,20,0
1714648494211,LIIT 5BS,A00,507430,Carnelos; Chiara,20,0,20,0
1714648495237,LIIT 5CS,A00,507432,Carnelos; Chiara,20,0,20,0
1714648496269,LISP 5A,A00,507541,Munoz Sanchez; Alicia,11,0,20,9
1714648497298,LISP 5B,A00,507671,Munoz Sanchez; Alicia,8,0,20,12
1714648498323,LISP 5C,A00,507696,Munoz Sanchez; Alicia,9,0,20,11
1714648499351,MAE 197,001,528363,Boechler; Nicholas Sebastia,9998,0,9999,1
1714648500377,MATH 197,001,523477,Kedlaya; Kiran S.,9995,0,9999,4
1714648500377,MATH 197,002,563811,Zhang; Danna,9995,0,9999,4
1714648500377,MATH 197,003,628552,Dumitriu; Ioana,9998,0,9999,1
1714648501406,MCWP 40R,A00,518780,Staff,2,0,20,18
1714648501406,MCWP 40R,B00,518781,Staff,8,0,20,12
1714648501406,MCWP 40R,C00,518783,Staff,6,0,20,14
1714648502437,MCWP 50R,A00,518791,Staff,0,0,20,20
1714648502437,MCWP 50R,B00,518792,Staff,0,2,20,20
1714648502437,MCWP 50R,C00,518793,Staff,0,2,20,20
1714648502437,MCWP 50R,D00,518794,Staff,0,1,20,20
1714648502437,MCWP 50R,E00,518795,Staff,0,2,20,20
1714648502437,MCWP 50R,F00,518796,Staff,0,0,20,20
1714648502437,MCWP 50R,G00,518797,Staff,0,1,20,20
1714648503464,MMW 12R,A01,514034,Herbst; Matthew,0,0,16,16
1714648503464,MMW 12R,A02,514035,Herbst; Matthew,1,0,16,15
1714648504492,MMW 13R,A01,514037,Staff,0,4,16,16
1714648504492,MMW 13R,A02,514039,Staff,0,2,16,16
1714648504492,MMW 13R,A03,628519,Staff,0,2,16,16
1714648506544,SIO 295LS,A00,523233,Staff,10,0,30,20
1714648507568,SIO 295S,A00,523232,Staff,10,0,30,20
1714648508598,SIOC 290S,A01,637330,Merrifield; Mark A,23,0,30,7
1714648509632,SIOC 291S,A01,637333,Gabriel; Corey John,23,0,30,7
1714648510657,SOCI 117,A01,494376,Staff,0,4,5,5
1714648511688,WES 237B,A00,494380,Staff,9,0,20,11
1714648513778,AESE 279B,A00,494370,Wade; Jon P,0,0,33,33
1714648514807,AIP 197,001,627712,Vespa; Emanuel Ignacio,9998,0,9999,1
1714648515893,ANAR 135S,A00,494369,Braswell; Geoffrey E.,0,0,0,0
1714648516923,BENG 196,001,628496,Engler; Adam J.,9998,0,9999,1
1714648517954,CAT 124RS,A01,519847,Geibel; William,0,0,20,20
1714648518986,CAT 125RS,A01,515971,Geibel; William,0,0,20,20
1714648520011,CLRE 250,A00,511389,Morris; Sheldon,9993,0,9999,6
1714648521037,CLRE 251,A00,507176,Mehta; Ravindra L.,9993,0,9999,6
1714648521037,CLRE 251,B00,511410,Mehta; Ravindra L.,9998,0,9999,1
1714648522068,CLRE 252,A00,507189,Cuomo; Raphael Eduardo,9995,0,9999,4
1714648523096,CLRE 253,A00,507199,Vaida; Florin,9994,0,9999,5
1714648523096,CLRE 253,B00,507202,Vaida; Florin,9999,0,9999,0
1714648524121,CLRE 259,A00,507211,Patel; Hemal,9996,0,9999,3
1714648525151,CLRE 260,A00,507221,Cuomo; Raphael Eduardo,9999,0,9999,0
1714648526177,CLRE 297,001,507242,Cuomo; Raphael Eduardo,9999,0,9999,0
1714648527204,COGS 197,001,638244,Voytek; Bradley Thomas,9998,0,9999,1
1714648528233,CSE 191,A00,516875,Minnes Kemp; Mor Mia,9992,0,9999,7
1714648529263,CSE 197,001,637388,Minnes Kemp; Mor Mia,9998,0,9999,1
1714648530290,CSS 201S,A01,494383,Staff,35,0,35,0
1714648531314,CSS 202S,A01,494387,Staff,35,0,35,0
1714648532344,DSC 197,001,628532,Eldridge; Justin Matthew,9996,0,9999,3
1714648533369,EAP 100,A00,516065,Staff,9797,0,9999,202
1714648534398,ECE 45,A01,507414,Staff,33,0,60,27
1714648536446,ECE 111,A01,507420,Staff,15,0,50,35
1714648537479,ECE 197,001,548057,Sievenpiper; Daniel F.,9993,0,9999,6
1714648538507,EDS 115,A00,507243,Choi; Bailey Miyeon,10,0,28,18
1714648539533,EDS 117,A01,494379,Staff,0,4,30,30
1714648540558,EDS 125,A00,507246,Hopkins; Megan Beth,9,0,30,21
1714648541588,EDS 128A,A01,507264,Fargason; Sharon Gayle,8,0,26,18
1714648542613,EDS 128B,A01,507293,Pappas; Elizabeth,12,0,30,18
1714648543641,EDS 139,A00,507294,Fargason; Sharon Gayle,13,0,30,17
1714648543641,EDS 139,B00,507313,Pappas; Elizabeth,13,0,30,17
1714648544667,EDS 201,A00,507315,Staff,13,0,30,17
1714648545693,EDS 203,A01,507317,Halter; Christopher P.,12,0,30,18
1714648546719,EDS 204R,A01,507319,Halter; Christopher P.,0,3,30,30
1714648546719,EDS 204R,B01,507331,Heinzman; Erica M.,16,0,30,14
1714648547744,EDS 206R,A00,507332,Staff,0,4,30,30
1714648547744,EDS 206R,B00,507343,Staff,17,0,30,13
1714648548770,EDS 250,A00,507344,Hemans; Patricia Ann Benitez,22,0,40,18
1714648549796,EDS 281,A00,507345,Daly; Alan J.,18,0,18,0
1714648550820,EDS 284,A00,507350,Daly; Alan J.,16,0,16,0
1714648551849,EDS 286,A00,507359,Fine; Sarah,18,0,18,0
1714648552878,EDS 289C,A01,507361,Daly; Alan J.,18,0,18,0
1714648553904,EDS 290,A00,507366,Hofstetter; Carolyn,15,0,15,0
1714648554930,LIGM 5A,A00,507421,Fischer-Grunski; Eva K,18,0,20,2
1714648555957,LIGM 5B,A00,507423,Fischer-Grunski; Eva K,19,0,20,1
1714648556982,LIGM 5C,A00,507425,Fischer-Grunski; Eva K,19,0,20,1
1714648558010,LIIT 5AS,A00,507427,Carnelos; Chiara,20,0,20,0
1714648559035,LIIT 5BS,A00,507430,Carnelos; Chiara,20,0,20,0
1714648560095,LIIT 5CS,A00,507432,Carnelos; Chiara,20,0,20,0
1714648561121,LISP 5A,A00,507541,Munoz Sanchez; Alicia,11,0,20,9
1714648562144,LISP 5B,A00,507671,Munoz Sanchez; Alicia,8,0,20,12
1714648563177,LISP 5C,A00,507696,Munoz Sanchez; Alicia,9,0,20,11
1714648564206,MAE 197,001,528363,Boechler; Nicholas Sebastia,9998,0,9999,1
1714648565235,MATH 197,001,523477,Kedlaya; Kiran S.,9995,0,9999,4
1714648565235,MATH 197,002,563811,Zhang; Danna,9995,0,9999,4
1714648565235,MATH 197,003,628552,Dumitriu; Ioana,9998,0,9999,1
1714648566261,MCWP 40R,A00,518780,Staff,2,0,20,18
1714648566261,MCWP 40R,B00,518781,Staff,8,0,20,12
1714648566261,MCWP 40R,C00,518783,Staff,6,0,20,14
1714648567286,MCWP 50R,A00,518791,Staff,0,0,20,20
1714648567286,MCWP 50R,B00,518792,Staff,0,2,20,20
1714648567286,MCWP 50R,C00,518793,Staff,0,2,20,20
1714648567286,MCWP 50R,D00,518794,Staff,0,1,20,20
1714648567286,MCWP 50R,E00,518795,Staff,0,2,20,20
1714648567286,MCWP 50R,F00,518796,Staff,0,0,20,20
1714648567286,MCWP 50R,G00,518797,Staff,0,1,20,20
1714648568311,MMW 12R,A01,514034,Herbst; Matthew,0,0,16,16
1714648568311,MMW 12R,A02,514035,Herbst; Matthew,1,0,16,15
1714648569337,MMW 13R,A01,514037,Staff,0,4,16,16
1714648569337,MMW 13R,A02,514039,Staff,0,2,16,16
1714648569337,MMW 13R,A03,628519,Staff,0,2,16,16
1714648571388,SIO 295LS,A00,523233,Staff,10,0,30,20
1714648572416,SIO 295S,A00,523232,Staff,10,0,30,20
1714648573449,SIOC 290S,A01,637330,Merrifield; Mark A,23,0,30,7
1714648574475,SIOC 291S,A01,637333,Gabriel; Corey John,23,0,30,7
1714648575501,SOCI 117,A01,494376,Staff,0,4,5,5
1714648576526,WES 237B,A00,494380,Staff,9,0,20,11
1714648578601,AESE 279B,A00,494370,Wade; Jon P,0,0,33,33
1714648579626,AIP 197,001,627712,Vespa; Emanuel Ignacio,9998,0,9999,1
1714648580652,ANAR 135S,A00,494369,Braswell; Geoffrey E.,0,0,0,0
1714648581681,BENG 196,001,628496,Engler; Adam J.,9998,0,9999,1
1714648582709,CAT 124RS,A01,519847,Geibel; William,0,0,20,20
1714648583734,CAT 125RS,A01,515971,Geibel; William,0,0,20,20
1714648584759,CLRE 250,A00,511389,Morris; Sheldon,9993,0,9999,6
1714648585790,CLRE 251,A00,507176,Mehta; Ravindra L.,9993,0,9999,6
1714648585790,CLRE 251,B00,511410,Mehta; Ravindra L.,9998,0,9999,1
1714648586820,CLRE 252,A00,507189,Cuomo; Raphael Eduardo,9995,0,9999,4
1714648587848,CLRE 253,A00,507199,Vaida; Florin,9994,0,9999,5
1714648587848,CLRE 253,B00,507202,Vaida; Florin,9999,0,9999,0
1714648588877,CLRE 259,A00,507211,Patel; Hemal,9996,0,9999,3
1714648589902,CLRE 260,A00,507221,Cuomo; Raphael Eduardo,9999,0,9999,0
1714648590928,CLRE 297,001,507242,Cuomo; Raphael Eduardo,9999,0,9999,0
1714648591953,COGS 197,001,638244,Voytek; Bradley Thomas,9998,0,9999,1
1714648592978,CSE 191,A00,516875,Minnes Kemp; Mor Mia,9992,0,9999,7
1714648594003,CSE 197,001,637388,Minnes Kemp; Mor Mia,9998,0,9999,1
1714648595032,CSS 201S,A01,494383,Staff,35,0,35,0
1714648596058,CSS 202S,A01,494387,Staff,35,0,35,0
1714648597083,DSC 197,001,628532,Eldridge; Justin Matthew,9996,0,9999,3
